TGTGCCAGCAGCTTACAGGGCACCTACGAGCAGTACTTC	CASSLQGTYEQYF	TRBV7-9	TRBJ2-7
TGTGCCAGCAGTTACGGGGCCCTGGAAAAACTGTTTTTT	CASSYGALEKLFF	TRBV6-2	TRBJ1-4
TGTGCCAGCAGCCACCCGGGACATCTCCAAGAGACCCAGTACTTC	CASSHPGHLQETQYF	TRBV7-9	TRBJ2-5
TGTGCCAGCAGTTGCTGGGGCCAAGGCCAAGAGACCCAGTACTTC	CASSCWGQGQETQYF	TRBV27	TRBJ2-5
TGTGCCAGCAGAGGGGACAGGGGGGGGAACACTGAAGCTTTCTTT	CASRGDRGGNTEAFF	TRBV6-3	TRBJ1-1
TGCGCCAGCGCAGGGACAGGCAATGGCTACACCTTC	CASAGTGNGYTF	TRBV10-1	TRBJ1-2
TGCGCCAGCAGCTTGGGATGGACAGGGGGCCCGAATCAGCCCCAGCATTTT	CASSLGWTGGPNQPQHF	TRBV5-1	TRBJ1-5
TGTGCCAGCAGTTACTCGCGGAGTAATGCGGGAGTGGAGGACGAGCAGTACTTC	CASSYSRSNAGVEDEQYF	TRBV6-5	TRBJ2-7
TGTGCCAGCGATACGCGCTCACTCACTGAAGCTTTCTTT	CASDTRSLTEAFF	TRBV2	TRBJ1-1
TGCAGTGCTAGAGATCAATTCGGACTTAATGAGCAGTTCTTC	CSARDQFGLNEQFF	TRBV20-1	TRBJ2-1
TGCGCCAGCAGTGCCTCCCAAAGGGGTCCGCGGGACAGTACTCGGTCTTCACCCCTCCACTTT	CASSASQRGPRDSTRSSPLHF	TRBV10-1	TRBJ1-6
TGTGCCAGCAGTTACTATCTAGCGCCAGGAGCCAAAAACATTCAGTACTTC	CASSYYLAPGAKNIQYF	TRBV6-3	TRBJ2-4
TGTGCCAGCAGTCGAGAACAGGGGCACTATGGCTACACCTTC	CASSREQGHYGYTF	TRBV6-2	TRBJ1-2
TGTGCCAGCAGTTTACTAGTTATGGAGGTTACCCTATCCACCGGGGAGCTGTTTTTT	CASSLLVMEVTLSTGELFF	TRBV27	TRBJ2-2
TGTGCCACGGTTGTCCTGGACAGGGGGCCTATTAATCAGCCCCAGCATTTT	CATVVLDRGPINQPQHF	TRBV15	TRBJ1-5
TGTGCCATAATAGTCAGCACAGATACGCAGTATTTT	CAIIVSTDTQYF	TRBV27	TRBJ2-3
TGTGCCAGCAGTGACATCCCGGGCTCCAGGGGGAGTGAAACTGAAGCTTTCTTT	CASSDIPGSRGSETEAFF	TRBV6-4	TRBJ1-1
TGTGCCTGGAGTGTACCCGGGGCTAGGTCCCTAGGCGGGGGGAGGCAGCCCCAGCATTTT	CAWSVPGARSLGGGRQPQHF	TRBV30	TRBJ1-5
TGCGCCAGCAGCGGGGACAGCGGAGAATGCACAGATACGCAGTATTTT	CASSGDSGECTDTQYF	TRBV4-1	TRBJ2-3
TGCAGTGCGAGCCTCCCAGGGGGCAATCAGCCCCAGCATTTT	CSASLPGGNQPQHF	TRBV20-1	TRBJ1-5
TGTGCCAGCAGCCTGGACGTAGGGGACAGGGGGACCGGGGAGCTGTTTTTT	CASSLDVGDRGTGELFF	TRBV7-3	TRBJ2-2
TGTGCCACCAGTGACTTCCTCCCGGGACAAAGGGGAAGCTCCGCCTATGGCTACACCTTC	CATSDFLPGQRGSSAYGYTF	TRBV24-1	TRBJ1-2
TGTGCCAGCAGCGTAGACTGGGCCGGGACTAGACTGAAGCAGTACTTC	CASSVDWAGTRLKQYF	TRBV9	TRBJ2-7
TGTGCCAGCAGCGAGGGGAAAGATACGCAGTATTTT	CASSEGKDTQYF	TRBV7-9	TRBJ2-3
TGTGCCAGCAGTACGATATCAATCAATAAACACGAGCAGTACTTC	CASSTISINKHEQYF	TRBV27	TRBJ2-7
TGTGCCAGCAGTTACCACCTGGGCGGCGAGGGCTCACCCCTCCACTTT	CASSYHLGGEGSPLHF	TRBV6-3	TRBJ1-6
TGTGCCAGCAGCCGGGGGGGACTGGGGAGCTCCTACAATGAGCAGTTCTTC	CASSRGGLGSSYNEQFF	TRBV7-9	TRBJ2-1
TGTGCCAGCAGCCCAGCCCTACAGGGGTGCAATCAGCCCCAGCATTTT	CASSPALQGCNQPQHF	TRBV7-2	TRBJ1-5
TGTGCCACCAGTGATCTCTGGGGTAGGGGAAAACTCAACACTGAAGCTTTCTTT	CATSDLWGRGKLNTEAFF	TRBV24-1	TRBJ1-1
TGTGCCACCAGTGGGTTAAGGTACAGGGGGTCTCAGCCCCAGCATTTT	CATSGLRYRGSQPQHF	TRBV24-1	TRBJ1-5
TGTGCCAGCCACAGATATGAGAGTAATAGCAATCAGCCCCAGCATTTT	CASHRYESNSNQPQHF	TRBV5-5	TRBJ1-5
TGTGCCCGCTCCCCGACTAGCGGGAGGGCGTATAATTCACCCCTCCACTTT	CARSPTSGRAYNSPLHF	TRBV28	TRBJ1-6
TGTGCCAGCAGTTGTTTGGGGGGGTCATACAATGAGCAGTTCTTC	CASSCLGGSYNEQFF	TRBV6-9	TRBJ2-1
TGTGCCAGCAGTGAAGCCCCCTTGAACCTAAAGGGCGGGAGGAGGACGACCATATTTAGCGAGACCCAGTACTTC	CASSEAPLNLKGGRRTTIFSETQYF	TRBV25-1	TRBJ2-5
TGTGCCAGCCAAGTAGGTGGATCCCCCAATTCACCCCTCCACTTT	CASQVGGSPNSPLHF	TRBV9	TRBJ1-6
TGTGCCACCACGCCCCGGGACAGCGAAACTTCACCCCTCCACTTT	CATTPRDSETSPLHF	TRBV24-1	TRBJ1-6
TGCAGTGCTCCCTGGGACAGGGTCTCGAACACTGAAGCTTTCTTT	CSAPWDRVSNTEAFF	TRBV20-1	TRBJ1-1
TGTGCCAGCAGCTTAGTCAGGACGGACAGGGATGAGCAGTTCTTC	CASSLVRTDRDEQFF	TRBV7-9	TRBJ2-1
TGTGCCAGCAGCGGGTTCGGACAGGGGGCGATAAACTATGGCTACACCTTC	CASSGFGQGAINYGYTF	TRBV13	TRBJ1-2
TGTGCCAGCAGCTTGACAGGATACGAGACCCAGTACTTC	CASSLTGYETQYF	TRBV7-9	TRBJ2-5
TGTGCCAGCAAAGGCATTTCTGGGGCCAACGTCCTGACTTTC	CASKGISGANVLTF	TRBV6-1	TRBJ2-6
TGTGCCAGCAGCTCGGGAGAGGTAATGGCTTTCTTT	CASSSGEVMAFF	TRBV7-2	TRBJ1-1
TGTGCCACCAGAAGCCGGGACAGGGTGACCGGTAGCACAGATACGCAGTATTTT	CATRSRDRVTGSTDTQYF	TRBV24-1	TRBJ2-3
TGTGCCAGCAGTTTTCGTACAGGGGACACCATATATTTT	CASSFRTGDTIYF	TRBV6-6	TRBJ1-3
TGTGCCAGCAGCCGGGGCTCTAAGAGCTACGAGCAGTACTTC	CASSRGSKSYEQYF	TRBV7-3	TRBJ2-7
TGTGCCAGCAGCGAGAACCACCTTCGGGACTACGAGCAGTACTTC	CASSENHLRDYEQYF	TRBV5-4	TRBJ2-7
TGCAGTGCTAGTGGGACAGACGCGAACTATGGCTACACCTTC	CSASGTDANYGYTF	TRBV20-1	TRBJ1-2
TGTGCCAGCAGCGTAAACAACTGTTGGGAGCAGTACTTC	CASSVNNCWEQYF	TRBV7-4	TRBJ2-7
TGTGCCAGCAGCGTAGTGGGGGGGGGCCGACTTGGCACAGATACGCAGTATTTT	CASSVVGGGRLGTDTQYF	TRBV9	TRBJ2-3
TGTGCCAGCAGCCTGAGAGTATCCATCTCGGATGGCTACACCTTC	CASSLRVSISDGYTF	TRBV6-4	TRBJ1-2
TGCGCCAGCAGCCGTCAATGTAGAAATGGCTACACCTTC	CASSRQCRNGYTF	TRBV4-1	TRBJ1-2
TGTGCCACCAGCACGACTTTTGCCTACGAGCAGTACTTC	CATSTTFAYEQYF	TRBV24-1	TRBJ2-7
TGTGCCAGCAGCGGGGCGGTTACTAGCGCAACGTCCTACAATGAGCAGTTCTTC	CASSGAVTSATSYNEQFF	TRBV7-9	TRBJ2-1
TGTGCCACCAGTGAGTGGGAGGGAGGTACGGGGGCCGGCACAGATACGCAGTATTTT	CATSEWEGGTGAGTDTQYF	TRBV24-1	TRBJ2-3
TGTGCTCGGGGGGTAGGTCGGGATACGCAGTATTTT	CARGVGRDTQYF	TRBV3-1	TRBJ2-3
TGTGCCAGCAGTCCAGTCCCGGGACTAGCGGGATCGACTGCCCATGAGCAGTTCTTC	CASSPVPGLAGSTAHEQFF	TRBV27	TRBJ2-1
TGTGCCAGCATATGGGACAGGACGGAAAAACTGTTTTTT	CASIWDRTEKLFF	TRBV7-9	TRBJ1-4
TGTGCCAGCAGTATGGCAGGCAGTCGCAGGTTAAACACCGGGGAGCTGTTTTTT	CASSMAGSRRLNTGELFF	TRBV27	TRBJ2-2
TGTGCCAGCAGCGGGCTCTTTCCAGACAGGGGTGGCAACACCGGGGAGCTGTTTTTT	CASSGLFPDRGGNTGELFF	TRBV5-5	TRBJ2-2
TGTGCCAGCAGCTTAGCAACTGTTTCCGAGCAGTACTTC	CASSLATVSEQYF	TRBV11-2	TRBJ2-7
TGTGCCAGCAGCCAGAACAGGGGGCAAGCCTACACCTTC	CASSQNRGQAYTF	TRBV5-4	TRBJ1-2
TGTGCCAGCAGTTCCACGGTACAGGGGATGCAGAGCAATCAGCCCCAGCATTTT	CASSSTVQGMQSNQPQHF	TRBV27	TRBJ1-5
TGTGCCAGCAGCTTACAGGGCGGGGAGCTGTTTTTT	CASSLQGGELFF	TRBV7-4	TRBJ2-2
TGTGCCAGCAGTGGGGGGAGGGAAGAGACCCAGTACTTC	CASSGGREETQYF	TRBV28	TRBJ2-5
TGTGCCAGCAGCCACAGGGTACACACTGAAGCTTTCTTT	CASSHRVHTEAFF	TRBV28	TRBJ1-1
TGTGCCAGCAGGGATAACCCCTGGCACAGGGCACAAGAGACCCAGTACTTC	CASRDNPWHRAQETQYF	TRBV11-2	TRBJ2-5
TGTGCCAGCAGCTTGCCCGCTAGGGGTTTTTGCAATCAGCCCCAGCATTTT	CASSLPARGFCNQPQHF	TRBV11-2	TRBJ1-5
TGCAGTGCTAGCAGGACAGGGGGCGGGACTAATGAAAAACTGTTTTTT	CSASRTGGGTNEKLFF	TRBV20-1	TRBJ1-4
TGTGCCAGCAGCAGACAGGGGGCGGTTGGCGGTAGCAATCAGCCCCAGCATTTT	CASSRQGAVGGSNQPQHF	TRBV5-5	TRBJ1-5
TGTGCCAGCAGTTACATAGCGGCAGATGAGCAGTACTTC	CASSYIAADEQYF	TRBV6-9	TRBJ2-7
TGTGCCAGCAGCATCCGGGACGACCCGAACACCGGGGAGCTGTTTTTT	CASSIRDDPNTGELFF	TRBV3-1	TRBJ2-2
TGTGCCAGCAGCCAAAAGCGGTTCAGGCGTCGGGAGCAGTACTTC	CASSQKRFRRREQYF	TRBV7-9	TRBJ2-7
TGTGCCAGCAGCCAAGAAAGGCGGCCCCAGCATTTT	CASSQERRPQHF	TRBV3-1	TRBJ1-5
TGTGCCAGCAGCTTGTTGGAACAGGGTCGCAACACAGATACGCAGTATTTT	CASSLLEQGRNTDTQYF	TRBV7-9	TRBJ2-3
TGTGCCAGCAGCCAATGGCCGAGGAGGGGGCGATTGAACACTGAAGCTTTCTTT	CASSQWPRRGRLNTEAFF	TRBV3-1	TRBJ1-1
TGTGCCAGTAGTTCCAGGGGGGACGAGCAGTACTTC	CASSSRGDEQYF	TRBV19	TRBJ2-7
TGCGCCAGCAGCGGAGGGGAGGATCGGAAAGGCTATGGCTACACCTTC	CASSGGEDRKGYGYTF	TRBV5-1	TRBJ1-2
TGCGCCAGCAGCCCTTGCCGGGGGGGGACGCAGTATTTT	CASSPCRGGTQYF	TRBV4-1	TRBJ2-3
TGTGCCAGCAGCGATGGGGGAAAAACACGCTACGAGCAGTACTTC	CASSDGGKTRYEQYF	TRBV9	TRBJ2-7
TGTGCCAGCAGCTTAAGTCTGGGGACCCGACGGACTCTTTATGAGCAGTTCTTC	CASSLSLGTRRTLYEQFF	TRBV7-4	TRBJ2-1
TGTGCCAGCAGCTTTCCCGGGACAGGGGGGGAAAAACTGTTTTTT	CASSFPGTGGEKLFF	TRBV7-9	TRBJ1-4
TGCGCCAGCAGCTTCTATTGGGGTTGTACTAATGAAAAACTGTTTTTT	CASSFYWGCTNEKLFF	TRBV5-1	TRBJ1-4
TGTGCCAGTAGTATAGATCCCTGTATGAACACTGAAGCTTTCTTT	CASSIDPCMNTEAFF	TRBV19	TRBJ1-1
TGTGCCAGCGGCCGAACACAGCTATCTCATGGCTACACCTTC	CASGRTQLSHGYTF	TRBV19	TRBJ1-2
TGCAGTGCTTCCATGGGCGGGGGCCAGCCCCAGCATTTT	CSASMGGGQPQHF	TRBV20-1	TRBJ1-5
TGTGCCAGCAGCTTGACAGGGGTAGGTAATCAGCCCCAGCATTTT	CASSLTGVGNQPQHF	TRBV7-2	TRBJ1-5
TGTGCCAGTAGGTTATCGCTAGCGTCCGAGCAGTACTTC	CASRLSLASEQYF	TRBV19	TRBJ2-7
TGTGCCAAAAGGGCCCAAGAGACCCAGTACTTC	CAKRAQETQYF	TRBV2	TRBJ2-5
TGTGCCAGCAGTGCCCCCGATGGAGAGTTAGCGAGCTCCTACAATGAGCAGTTCTTC	CASSAPDGELASSYNEQFF	TRBV25-1	TRBJ2-1
TGTGCCAGCAGTTTAGTAGCGGGAGATGAGCAGTTCTTC	CASSLVAGDEQFF	TRBV28	TRBJ2-1
TGTGCCAGCAGTGAAGAGGACCGGGACAGGAGGGGTACCGCGAACACCGGGGAGCTGTTTTTT	CASSEEDRDRRGTANTGELFF	TRBV6-1	TRBJ2-2
TGTGCCAGTAGGGGGACGGACTGCACAGATACGCAGTATTTT	CASRGTDCTDTQYF	TRBV19	TRBJ2-3
TGCGCCAGCAGCTGGGAGGGAGGGGCCAATGAGCAGTTCTTC	CASSWEGGANEQFF	TRBV5-1	TRBJ2-1
TGTGCCAGCAGCTTAGCCAAACTAGCGGGAGTCGGGTACGAGCAGTACTTC	CASSLAKLAGVGYEQYF	TRBV11-3	TRBJ2-7
TGTGCCAGCAGCGTAGCGACAGCCCTTGAGCAGTTCTTC	CASSVATALEQFF	TRBV9	TRBJ2-1
TGCAGTGCTAGAGCCCGGGACAGTGCACCTCAGGACACTGAAGCTTTCTTT	CSARARDSAPQDTEAFF	TRBV20-1	TRBJ1-1
TGTGCCAGCAGCTTATCGCCGGGCTCTGAAGCTTTCTTT	CASSLSPGSEAFF	TRBV7-6	TRBJ1-1
TGTGCCAGCAGTCGTGGCTACGAGCAGTACTTC	CASSRGYEQYF	TRBV27	TRBJ2-7
TGTGCCAGCAGCAAAGAGGGCAGGTATGGCTACACCTTC	CASSKEGRYGYTF	TRBV5-6	TRBJ1-2
TGTGCCAGCAGTTTAGGCGGGAGGTCTTCCTCCTACGAGCAGTACTTC	CASSLGGRSSSYEQYF	TRBV12-4	TRBJ2-7
TGCAGTGCTAGAGCTCAGGGACTAGCGGGGATTAACACCGGGGAGCTGTTTTTT	CSARAQGLAGINTGELFF	TRBV20-1	TRBJ2-2
TGTGCCAGCAGCTTAGCGCCCCGGACTAGCGGGAGGGCAATATCCGAAAAACTGTTTTTT	CASSLAPRTSGRAISEKLFF	TRBV11-1	TRBJ1-4
TGCAGCGTGGTCAGGAGAGCAACTAATGAAAAACTGTTTTTT	CSVVRRATNEKLFF	TRBV29-1	TRBJ1-4
TGTGCCTGGAGTGTACACTTACTACTTGGCTACACCTTC	CAWSVHLLLGYTF	TRBV30	TRBJ1-2
TGTGCCAGCAACAGGGGGCTGGGGGATGCCTATGGCTACACCTTC	CASNRGLGDAYGYTF	TRBV7-3	TRBJ1-2
TGTGCCAGCAGCTTGGGGTTTCGGGCAAGAATCTACGAGCAGTACTTC	CASSLGFRARIYEQYF	TRBV5-6	TRBJ2-7
TGTGCCACCAGTGATATATTGGGGTCTGGAAACACCATATATTTT	CATSDILGSGNTIYF	TRBV24-1	TRBJ1-3
TGTGCCAGCAGTGAAGCGCGGGGTGGAGGGGGGAGAGAGACCCAGTACTTC	CASSEARGGGGRETQYF	TRBV6-1	TRBJ2-5
TGCGCCAGCAGCAGACTAGCGGGGCATACCTGCACAGATACGCAGTATTTT	CASSRLAGHTCTDTQYF	TRBV5-1	TRBJ2-3
TGTGCCAGCAGTTCCGGGGGTGGACAGCTTGGGCCGAACACTGAAGCTTTCTTT	CASSSGGGQLGPNTEAFF	TRBV27	TRBJ1-1
TGTGCCACCAGTGAGCGGGATTCAGGGGGGGGGAGAAACCCGGTCTGGAACACTGAAGCTTTCTTT	CATSERDSGGGRNPVWNTEAFF	TRBV24-1	TRBJ1-1
TGTGCCAGCATTGATGTGGGACGTTCCTATGGCTACACCTTC	CASIDVGRSYGYTF	TRBV11-2	TRBJ1-2
TGTGCCAGCAGCCTTTGGGACCTAACAGATACGCAGTATTTT	CASSLWDLTDTQYF	TRBV28	TRBJ2-3
TGTGCCAGCAGTTTACCCTTCCAGGATCTGGAGGATAGCAATCAGCCCCAGCATTTT	CASSLPFQDLEDSNQPQHF	TRBV12-3	TRBJ1-5
TGTGCCTGGACCAAAAGGGGGGCCTCTGGAAACACCATATATTTT	CAWTKRGASGNTIYF	TRBV30	TRBJ1-3
TGCAGCGTTGGCATCTGGACTAGCGGGAGAGCCAAAAACATTCAGTACTTC	CSVGIWTSGRAKNIQYF	TRBV29-1	TRBJ2-4
TGCGCCAGCAGCTTGAACACCCCTCTTCCAGGGGGCGCGTGGGATAATCAGCCCCAGCATTTT	CASSLNTPLPGGAWDNQPQHF	TRBV5-1	TRBJ1-5
TGTGCCAGCAGCTTAGCAAGTGGGGGGGCCTCCTACAATGAGCAGTTCTTC	CASSLASGGASYNEQFF	TRBV7-9	TRBJ2-1
TGTGCCAGCAGCCAAGGGACCAAGGCCAAAAACATTCAGTACTTC	CASSQGTKAKNIQYF	TRBV14	TRBJ2-4
TGTGCCAGCAGCCACGGGAGAGGGGATATTAGGAGGAGGACTGAAGCTTTCTTT	CASSHGRGDIRRRTEAFF	TRBV14	TRBJ1-1
TGTGCCAGCAGCTTAGTTCGACTAGCGGGAGAAACCTACGAGCAGTACTTC	CASSLVRLAGETYEQYF	TRBV11-2	TRBJ2-7
TGTGCCAGCAGCGTAGCTATGGGGCTCTTTTTCTTGAACACCGGGGAGCTGTTTTTT	CASSVAMGLFFLNTGELFF	TRBV9	TRBJ2-2
TGTGCCAGCAGGCTAGCGGACGAGCAGTACTTC	CASRLADEQYF	TRBV6-3	TRBJ2-7
TGTGCCAGCAAAGGTGGGGGGGGGGGGAATGAGCAGTTCTTC	CASKGGGGGNEQFF	TRBV6-4	TRBJ2-1
TGTGCCAGCATCCCGCGGGAGGGGACCCAGTACTTC	CASIPREGTQYF	TRBV7-3	TRBJ2-5
TGTGCCAGCAGCGTAAGGGGGGGTAACACCGGGGAGCTGTTTTTT	CASSVRGGNTGELFF	TRBV9	TRBJ2-2
TGTGCCAGCAGCGTAGCGAGGGCGGGGGACGAGCAGTACTTC	CASSVARAGDEQYF	TRBV9	TRBJ2-7
TGCAGTGCTAGCCGACTAGCGGGGCCCTACGAGCAGTACTTC	CSASRLAGPYEQYF	TRBV20-1	TRBJ2-7
TGCGCCAGCAGCTTGGTTCACACCCTAGGTCATGAGCAGTTCTTC	CASSLVHTLGHEQFF	TRBV5-1	TRBJ2-1
TGTGCCAGCAGCTCATCCTGCCTAGGCGATAGCAATCAGCCCCAGCATTTT	CASSSSCLGDSNQPQHF	TRBV5-6	TRBJ1-5
TGTGCCAGCATAAATGGGGGTCCCGGCTACACCTTC	CASINGGPGYTF	TRBV12-3	TRBJ1-2
TGTGCCATCAGTGGGCCAACGGGACAGGGACCTCGCCAGTACGAGCAGTACTTC	CAISGPTGQGPRQYEQYF	TRBV10-3	TRBJ2-7
TGTGCCAGCAGCTTGGCGGCCTGGAGGGGGAACACTGAAGCTTTCTTT	CASSLAAWRGNTEAFF	TRBV5-6	TRBJ1-1
TGTGCCAGCTCACCGACCCTACAGGGGCAGGTTAGCAATCAGCCCCAGCATTTT	CASSPTLQGQVSNQPQHF	TRBV18	TRBJ1-5
TGCGCCAGCAGCTGTCGACAGCTCGTCGTCTTGAACACTGAAGCTTTCTTT	CASSCRQLVVLNTEAFF	TRBV5-1	TRBJ1-1
TGTGCCAGCAGGTCCAAGACCGGGACAGGGGAAGAGACCCAGTACTTC	CASRSKTGTGEETQYF	TRBV2	TRBJ2-5
TGTGTCGAAAGACAGGGTGACACCTTC	CVERQGDTF	TRBV12-3	TRBJ1-2
TGTGCCTCGGGGGGGCTCATGAACACTGAAGCTTTCTTT	CASGGLMNTEAFF	TRBV12-3	TRBJ1-1
TGTGCCAGCAGTGGCATAGTCCCGAGATTTATTAAGGCCAGCTCCTACGAGCAGTACTTC	CASSGIVPRFIKASSYEQYF	TRBV2	TRBJ2-7
TGTGCCAGTAGTATCCCCCTTTCCCAGACAGGGGGTCGTCAGCCCCAGCATTTT	CASSIPLSQTGGRQPQHF	TRBV19	TRBJ1-5
TGTGCCAGCAGCGAGCACCGGATGGGGAACACTGAAGCTTTCTTT	CASSEHRMGNTEAFF	TRBV7-3	TRBJ1-1
TGTGCCAGCAGTTTCCCCGACAGGGAGGGTGGCTACACCTTC	CASSFPDREGGYTF	TRBV6-5	TRBJ1-2
TGTGCCTGGAGGGTTTGTCTGGGGCGGGCTTTGGATGGCCCGAGCCCCCGGGGGAGCTCTGGAAACACCATATATTTT	CAWRVCLGRALDGPSPRGSSGNTIYF	TRBV30	TRBJ1-3
TGCAGCGTAACAGATACGCAGTATTTT	CSVTDTQYF	TRBV29-1	TRBJ2-3
TGTGCCAGCAGCTTGCCCCTGGGGGCTAGAGGCCGGGTGTCCTACGAGCAGTACTTC	CASSLPLGARGRVSYEQYF	TRBV5-5	TRBJ2-7
TGTGCCAGTAGTATGTCGGTGGTTGGGGCGGGAAGGGGATCTGAAGCTTTCTTT	CASSMSVVGAGRGSEAFF	TRBV19	TRBJ1-1
TGCGCCAGCAGCTTGGGGGCAGGGGAACTAGACGGAGTGACCAACAATTCACCCCTCCACTTT	CASSLGAGELDGVTNNSPLHF	TRBV5-1	TRBJ1-6
TGTGCCAGCAGACAGGGTAGCAATCAGCCCCAGCATTTT	CASRQGSNQPQHF	TRBV28	TRBJ1-5
TGTGCCAGCAGCCAAGACGTGGGCAATGAGCAGTTCTTC	CASSQDVGNEQFF	TRBV3-1	TRBJ2-1
TGCGCCAGCGAAGACCGGGACAGACGTACAGATACGCAGTATTTT	CASEDRDRRTDTQYF	TRBV5-1	TRBJ2-3
TGCGCCAGCAGTTGTTCCAGGGTAACCTCAGTTAGCTACAATGAGCAGTTCTTC	CASSCSRVTSVSYNEQFF	TRBV10-1	TRBJ2-1
TGCGCCAGCAGCCAAGATGCCCCCAGGGCCCGGGGTCCATCGGTCTACGAGCAGTACTTC	CASSQDAPRARGPSVYEQYF	TRBV4-3	TRBJ2-7
TGCAGTGCTAGAAGGGGGGGGTGCTCTGGGGCCAACGTCCTGACTTTC	CSARRGGCSGANVLTF	TRBV20-1	TRBJ2-6
TGTGCCACCAGCAGAGTCAGCCACAGGGTGAGTACTAACTATGGCTACACCTTC	CATSRVSHRVSTNYGYTF	TRBV15	TRBJ1-2
TGTGCCAGCAGTTGGAAACGACAGGTTCGGGGGGTAGAGACCCAGTACTTC	CASSWKRQVRGVETQYF	TRBV27	TRBJ2-5
TGCAGTGCTAGGGGGGTAGAAATCTTC	CSARGVEIF	TRBV20-1	TRBJ2-7
TGTGCCAGCAGCTTAGGGAGGAGAAGCTACGAGCAGTACTTC	CASSLGRRSYEQYF	TRBV7-6	TRBJ2-7
TGCAGTGCTAGAGACGTTGAAAAAAGACTAGCGGGACCGAACACCGGGGAGCTGTTTTTT	CSARDVEKRLAGPNTGELFF	TRBV20-1	TRBJ2-2
TGTGCCAGCAGTTACTGGACTAGCGTCTACGAGCAGTACTTC	CASSYWTSVYEQYF	TRBV6-5	TRBJ2-7
TGCGCCAGCAGAGGAGGTAGAAAACTGTTTTTT	CASRGGRKLFF	TRBV10-1	TRBJ1-4
TGTGCCAGCAGTAGCAGCGCGGGCGAGCAGTACTTC	CASSSSAGEQYF	TRBV27	TRBJ2-7
TGTGCCAGCAGCTTATTGCCGTGTCGGGAGGGTGCGGAGACCCAGTACTTC	CASSLLPCREGAETQYF	TRBV11-3	TRBJ2-5
TGTGCCAGCAGCTTAACGAACGTCTTCTTGATTGAGACCCAGTACTTC	CASSLTNVFLIETQYF	TRBV11-3	TRBJ2-5
TGTGCCCGCTTAATAGCAAGTTGGTTAGCCAAAAACATTCAGTACTTC	CARLIASWLAKNIQYF	TRBV30	TRBJ2-4
TGTGCCAGCAGTCCCCCGGTACTACACAGGGAATGGGCCTACGAGCAGTACTTC	CASSPPVLHREWAYEQYF	TRBV25-1	TRBJ2-7
TGTGCCAGCAGACGGGACGTATCGGCTGGGGCCAACGTCCTGACTTTC	CASRRDVSAGANVLTF	TRBV7-9	TRBJ2-6
TGTGCCAGCAGTCCACCGAGGGTCATGAACACTGAAGCTTTCTTT	CASSPPRVMNTEAFF	TRBV27	TRBJ1-1
TGTGCCAGCATGGAGTTTGGACCTACCTACGAGCAGTACTTC	CASMEFGPTYEQYF	TRBV6-5	TRBJ2-7
TGTGCCAGCAGTGCCGGACAGGGGAGGGGCAATGAAAAACTGTTTTTT	CASSAGQGRGNEKLFF	TRBV6-4	TRBJ1-4
TGCGCCAGCAGCTTAAGGGGGGGGAACGAGCAGTACTTC	CASSLRGGNEQYF	TRBV5-1	TRBJ2-7
TGTGCCTGGAGTGTACCATCCCCCCGGGACTGGGCTTTCTTT	CAWSVPSPRDWAFF	TRBV30	TRBJ1-1
TGTGCCAGCAGCCCATCCCGCTGGAGACTTCTGGGACTAGCGGGAGGAACTGAGGGCACAGATACGCAGTATTTT	CASSPSRWRLLGLAGGTEGTDTQYF	TRBV7-4	TRBJ2-3
TGTGCCACCAGCAGAGAAGGTCAGTTCATAGAGACCCAGTACTTC	CATSREGQFIETQYF	TRBV15	TRBJ2-5
TGTGCCTGGAGAGACAGGGAGCAGTTCTTC	CAWRDREQFF	TRBV30	TRBJ2-1
TGTGCCAGCAGCCGGGACAGGGAAGAGACCCAGTACTTC	CASSRDREETQYF	TRBV7-9	TRBJ2-5
TGTGCCAGCAGTTTAGTGACGAGGAGGGCTTGCAAAAACATTCAGTACTTC	CASSLVTRRACKNIQYF	TRBV12-3	TRBJ2-4
TGTGCCAGCAGCCGGACAGATACGCAGTATTTT	CASSRTDTQYF	TRBV7-2	TRBJ2-3
TGTGCCAGCAGCTTTGGGGGCGGCAACGAGCAGTACTTC	CASSFGGGNEQYF	TRBV7-9	TRBJ2-7
TGTGCCAGCAGCTTGGACCGGGAGGGTCACTACACCTTC	CASSLDREGHYTF	TRBV5-4	TRBJ1-2
TGTGCCAGCAGCCAAAGGGGAATGGGGCCCTATGGCTACACCTTC	CASSQRGMGPYGYTF	TRBV14	TRBJ1-2
TGTGCCAGCAGTCCTAATTCGTCGAAGGGACTGTCCTCAGATACGCAGTATTTT	CASSPNSSKGLSSDTQYF	TRBV28	TRBJ2-3
TGTGCCAGCAGCTTAACGACTAACGAGCAGTACTTC	CASSLTTNEQYF	TRBV7-3	TRBJ2-7
TGTGCCAGCAGCTCGGACAGGGGGTACGAGCAGTACTTC	CASSSDRGYEQYF	TRBV5-6	TRBJ2-7
TGTGCCAGTAGTAGTCAGACCGGGAAGACCCAGTACTTC	CASSSQTGKTQYF	TRBV19	TRBJ2-5
TGTGCCAGCAGTAGACCGGGACTAGCGGCTAACAATGAGCAGTTCTTC	CASSRPGLAANNEQFF	TRBV2	TRBJ2-1
TGCGCCAGCAGCTTGCAGTACAATGAGCAGTTCTTC	CASSLQYNEQFF	TRBV5-1	TRBJ2-1
TGTGCCAGCAGTTATGGCGACTTCGGGGCCACAGATACGCAGTATTTT	CASSYGDFGATDTQYF	TRBV6-2	TRBJ2-3
TGTGCCAGCAGCACCCCCCGGACCACAGATACGCAGTATTTT	CASSTPRTTDTQYF	TRBV9	TRBJ2-3
TGTGCCAGCAGCCAACAGGGGGCGTCCCCAGTTGCCTACGAGCAGTACTTC	CASSQQGASPVAYEQYF	TRBV14	TRBJ2-7
TGCGCCAGCAGCGGCTACACCTCCTACGAGCAGTACTTC	CASSGYTSYEQYF	TRBV5-1	TRBJ2-7
TGTGCCAGCAGATTTGGGGGCTCTGAAGGCTACACCTTC	CASRFGGSEGYTF	TRBV27	TRBJ1-2
TGTGCCAGCAAATGGGGGGGGAGCAATGAGCAGTTCTTC	CASKWGGSNEQFF	TRBV6-5	TRBJ2-1
TGTGCCACCAGTGAAACAGACAGGTGGTCCGCTAACACTGAAGCTTTCTTT	CATSETDRWSANTEAFF	TRBV24-1	TRBJ1-1
TGCAGGTCGAGGGGCGGTTCACCCCTCCACTTT	CRSRGGSPLHF	TRBV20-1	TRBJ1-6
TGTGCCTGGCTAACCTGGGGGCCAAGCTTCTACAATGAGCAGTTCTTC	CAWLTWGPSFYNEQFF	TRBV30	TRBJ2-1
TGTGCCACCGAGAGTGATGGAAGAAAGGAAAAACTGTTTTTT	CATESDGRKEKLFF	TRBV27	TRBJ1-4
TGCGCCAGCAGCTTGGAGGGGGACAGGGATACCGCTAGGAACACTGAAGCTTTCTTT	CASSLEGDRDTARNTEAFF	TRBV5-1	TRBJ1-1
TGTGCCATCAGTGAGGACGCGTGTAACACCATATATTTT	CAISEDACNTIYF	TRBV10-3	TRBJ1-3
TGTGCCTGGAGTGTAGGCGGAACTGGGCTAAACATTCAGTACTTC	CAWSVGGTGLNIQYF	TRBV30	TRBJ2-4
TGCAGTGCGGGGGCGAACACAGATACGCAGTATTTT	CSAGANTDTQYF	TRBV20-1	TRBJ2-3
TGTGCCAGCAGTCCGGGAGGACAGGGGAGTAACTATGGCTACACCTTC	CASSPGGQGSNYGYTF	TRBV27	TRBJ1-2
TGCGCCAGCAGTAGGGGCCGTAGGGACGCCTACGAGCAGTACTTC	CASSRGRRDAYEQYF	TRBV10-1	TRBJ2-7
TGCGCCAGCAGCCTCCCCGCGGAGAACACCGGGGAGCTGTTTTTT	CASSLPAENTGELFF	TRBV4-3	TRBJ2-2
TGCGCCAGCAGCTTGTCCCGGGAGGGTCGATCCTACGAGCAGTACTTC	CASSLSREGRSYEQYF	TRBV5-1	TRBJ2-7
TGTGCCACCAGTGGACCCTTTCACAGGGGGTCCGGACTCAAGCCCCAGCATTTT	CATSGPFHRGSGLKPQHF	TRBV24-1	TRBJ1-5
TGTGCCAGCAGCTTTACGGGGCATAGAGCAAAACTGTTTTTT	CASSFTGHRAKLFF	TRBV9	TRBJ1-4
TGTGCCAGACAGCGCACTGAAGCTTTCTTT	CARQRTEAFF	TRBV6-5	TRBJ1-1
TGTGCCAGCAGCGTAACCGTGGACGGATACGAGCAGTACTTC	CASSVTVDGYEQYF	TRBV6-4	TRBJ2-7
TGTGCCAGCAGCCCCCGCAGGGGCAATCAGCCCCAGCATTTT	CASSPRRGNQPQHF	TRBV7-3	TRBJ1-5
TGCAGTGCTACTCCAGGGATGGGGAATGACGAGCAGTACTTC	CSATPGMGNDEQYF	TRBV20-1	TRBJ2-7
TGTGCCAGCGGACACGGGAATGGCTACACCTTC	CASGHGNGYTF	TRBV6-4	TRBJ1-2
TGTGCCACCAGTGATTTGCCCGGGGCTATTCAACTAGTGCCCCTAGTCGAAGAGACCCAGTACTTC	CATSDLPGAIQLVPLVEETQYF	TRBV24-1	TRBJ2-5
TGTGCCAGCAGCGTAGGGCAGCGGGACAGGGCTGGAAACACCATATATTTT	CASSVGQRDRAGNTIYF	TRBV9	TRBJ1-3
TGTGCCAGCAGTTACGCGGGACAGGCCAAGGGAAACACTGAAGCTTTCTTT	CASSYAGQAKGNTEAFF	TRBV6-5	TRBJ1-1
TGTGCTAACGGGACAGGGTGGCCCCAGCATTTT	CANGTGWPQHF	TRBV12-5	TRBJ1-5
TGCAGTGCTAGGACCCCTCCGGGACAAGCTAACTATGGCTACACCTTC	CSARTPPGQANYGYTF	TRBV20-1	TRBJ1-2
TGCGCCAGCAGCTTGGGCCTCCCCAACCAGGGAAGTCATGGCTACACCTTC	CASSLGLPNQGSHGYTF	TRBV5-1	TRBJ1-2
TGTGCCAGCAGTTACCTGGAAGGGGTTACACAAATGAACACTGAAGCTTTCTTT	CASSYLEGVTQMNTEAFF	TRBV6-8	TRBJ1-1
TGTGCCAGCCCCGAGCCGGGGGCATACTTGAACACTGAAGCTTTCTTT	CASPEPGAYLNTEAFF	TRBV19	TRBJ1-1
TGTGCCAGCAGTGCCGAACTACTGTTTTTT	CASSAELLFF	TRBV6-1	TRBJ1-4
TGTGCCAGCAGCATCCGGGACAGGGCTAATCAGCCCCAGCATTTT	CASSIRDRANQPQHF	TRBV13	TRBJ1-5
TGTGCCAGCAGTTTCAGGCTAAACCAAGAGACCCAGTACTTC	CASSFRLNQETQYF	TRBV28	TRBJ2-5
TGCAGTGCTAGAGATCTCCAGGGGAGAACGACCCAGTACTTC	CSARDLQGRTTQYF	TRBV20-1	TRBJ2-5
TGTGCCAGCAGCCAAGAGAGTTTGGCGGGGGATACGCAGTATTTT	CASSQESLAGDTQYF	TRBV14	TRBJ2-3
TGTGCCACCAGGGGCGGAGCTTACGAGCAGTACTTC	CATRGGAYEQYF	TRBV24-1	TRBJ2-7
TGTGCCAGCAGCTTTTCCTTACAGAACACTGAAGCTTTCTTT	CASSFSLQNTEAFF	TRBV7-9	TRBJ1-1
TGTGCCATCAGTGAAAAGCAACAGCCCCAGCATTTT	CAISEKQQPQHF	TRBV10-3	TRBJ1-5
TGTGCCAGCAGTTGCCATGGGGGCCTAGGCAATCAGCCCCAGCATTTT	CASSCHGGLGNQPQHF	TRBV13	TRBJ1-5
TGTGCCAGCAGTTTGAAACGGGTTTATAGCAATCAGCCCCAGCATTTT	CASSLKRVYSNQPQHF	TRBV27	TRBJ1-5
TGTGCCAGCAGTGACTCCACGCACGTACCGGGCTCTTACGAGCAGTACTTC	CASSDSTHVPGSYEQYF	TRBV6-4	TRBJ2-7
TGTGCCAGCAGGCGGAGAGCCTACGAGCAGTACTTC	CASRRRAYEQYF	TRBV6-2	TRBJ2-7
TGCAGCGACCCAGGGGGCGTAAATGAGCAGTTCTTC	CSDPGGVNEQFF	TRBV29-1	TRBJ2-1
TGCGCCAGCTGGAAGGTTTCCGGGAGGCAGCCCCAGCATTTT	CASWKVSGRQPQHF	TRBV10-1	TRBJ1-5
TGTGCCAGCACCCGCAGGTACAGCGAGCAGTACTTC	CASTRRYSEQYF	TRBV12-3	TRBJ2-7
TGTGCCAGCAGCTCCTCTAGCGTATGCACAGATACGCAGTATTTT	CASSSSSVCTDTQYF	TRBV5-5	TRBJ2-3
TGTGCCTGGAGTGTACACGGCGGGCATGACACTGAAGCTTTCTTT	CAWSVHGGHDTEAFF	TRBV30	TRBJ1-1
TGTGCCAGCAGTACTCACCCGCGGACAGCTCCTAACACTGAAGCTTTCTTT	CASSTHPRTAPNTEAFF	TRBV6-5	TRBJ1-1
TGTGCCAGCATCTTGACAGGGGTGGGAAACGAGCAGTACTTC	CASILTGVGNEQYF	TRBV2	TRBJ2-7
TGTGCCAGCAGTGCGACGGGGTCCTACGAGCAGTACTTC	CASSATGSYEQYF	TRBV6-5	TRBJ2-7
TGTGCCAGCAGTGTCTGTCGGCTTGGGGATCAAGAGACCCAGTACTTC	CASSVCRLGDQETQYF	TRBV12-4	TRBJ2-5
TGTGCCCGGGACAGGGCCCCAGCTGCAAGCTATGAAAAACTGTTTTTT	CARDRAPAASYEKLFF	TRBV7-9	TRBJ1-4
TGCGCCAGCAGCTGGGTCCCCGTTAACGACAGGGAGGCCTACAATGAGCAGTTCTTC	CASSWVPVNDREAYNEQFF	TRBV5-1	TRBJ2-1
TGTGCCAGCAGTTACTCCACCCGGCGTGGAGAACTAGCGGGAGCTAACTATGGCTACACCTTC	CASSYSTRRGELAGANYGYTF	TRBV6-5	TRBJ1-2
TGCAGTGCTAGAGCCCGTGGGGGAACTATCTCCTACGAGCAGTACTTC	CSARARGGTISYEQYF	TRBV20-1	TRBJ2-7
TGTGCCAGCAGCCCAAGTTTAGCGGGAAAAGACGAGCAGTACTTC	CASSPSLAGKDEQYF	TRBV3-1	TRBJ2-7
TGTGCCAGCAGTCACAGGACGTCCTATGGCTACACCTTC	CASSHRTSYGYTF	TRBV27	TRBJ1-2
TGCGCCAGCAGCCAAGACAAGCGGGACACCTACGAGCAGTACTTC	CASSQDKRDTYEQYF	TRBV4-1	TRBJ2-7
TGTGCCAGCAGCCAAGAACACCCCCCACCGGGACTAGCCTGGGGAATCCAAGAGACCCAGTACTTC	CASSQEHPPPGLAWGIQETQYF	TRBV4-2	TRBJ2-5
TGTGCCAGCAGTTACCGGGGACAAGGCTTGTCGGAATCCTTC	CASSYRGQGLSESF	TRBV6-9	TRBJ1-2
TGTGCCAGCTCACCGAGAACAGGCAACTACGAGCAGTACTTC	CASSPRTGNYEQYF	TRBV18	TRBJ2-7
TGTGCCAGCAGTTTCTCGGCCCCCGGTTTTTCGAAGTTGGAGAACACTGAAGCTTTCTTT	CASSFSAPGFSKLENTEAFF	TRBV27	TRBJ1-1
TGTGCCAGCAGCCGGGTTCAGTCTGGACAGGGGCCCCAGCATTTT	CASSRVQSGQGPQHF	TRBV6-4	TRBJ1-5
TGTGCCAGCAGCTACGCGTCCGGTCATTATGGAAACACCATATATTTT	CASSYASGHYGNTIYF	TRBV11-2	TRBJ1-3
TGTGCCAGCAGTCGAGTCGCACCGGGACCGAGCGAGCAGTACTTC	CASSRVAPGPSEQYF	TRBV28	TRBJ2-7
TGTGCCAGCACTTCCCAAATAGGGACAGGGGCGGCCGGGGAGCTGTTTTTT	CASTSQIGTGAAGELFF	TRBV12-3	TRBJ2-2
TGTGCCAGCAGTTACTCGAGAGACAGGATGGGCTACGAGCAGTACTTC	CASSYSRDRMGYEQYF	TRBV6-5	TRBJ2-7
TGTGCCAGCAGTTTACCGGGACTAGCGCCGGGGAGAAAGGACTCGATGACAGATACGCAGTATTTT	CASSLPGLAPGRKDSMTDTQYF	TRBV27	TRBJ2-3
TGTGCCAGCAGTTACTCGAGAGGGGGGGGCGTGCACGGGGAGCTGTTTTTT	CASSYSRGGGVHGELFF	TRBV6-6	TRBJ2-2
TGCGCCAGCAGGCACAGGGTTTCTAGCAAGAACGAGCAGTACTTC	CASRHRVSSKNEQYF	TRBV4-1	TRBJ2-7
TGTGCCACCAGTATCAGACAGGGAAGACTTAGCAATCAGCCCCAGCATTTT	CATSIRQGRLSNQPQHF	TRBV24-1	TRBJ1-5
TGTGCCATCCGGACAGGGGGGTCCCAAAGCACTGAAGCTTTCTTT	CAIRTGGSQSTEAFF	TRBV10-3	TRBJ1-1
TGTGCCACCAGCCAAAGACAAGGGGCCGGGGATGGCTACACCTTC	CATSQRQGAGDGYTF	TRBV15	TRBJ1-2
TGTGCCAGCAGCGTAATCGACATCCGGAATCAGCCCCAGCATTTT	CASSVIDIRNQPQHF	TRBV9	TRBJ1-5
TGTGCCAGCAGATTGCAGGGGGGGGTCTCCTACGAGCAGTACTTC	CASRLQGGVSYEQYF	TRBV6-5	TRBJ2-7
TGTGCCTGGAGTGTAGTCAATCTGCATCGGGACCACCATGAGCAGTTCTTC	CAWSVVNLHRDHHEQFF	TRBV30	TRBJ2-1
TGTGCCAGCAGGGGGCTTACAGGAATATGGAATCAGCCCCAGCATTTT	CASRGLTGIWNQPQHF	TRBV6-4	TRBJ1-5
TGTGCCAGCTCCGAACAGGGGGCTAGGGATACGCAGTATTTT	CASSEQGARDTQYF	TRBV18	TRBJ2-3
TGTGCCAGCAGAGTAACCTGGAACTCGGACAGGTCCATGAACACTGAAGCTTTCTTT	CASRVTWNSDRSMNTEAFF	TRBV27	TRBJ1-1
TGCGCCAGCCGACAGGACTCCTACGAGCAGTACTTC	CASRQDSYEQYF	TRBV10-1	TRBJ2-7
TGCGCCAGAGAGGATCAGGGGCGTAATGAAAAACTGTTTTTT	CAREDQGRNEKLFF	TRBV5-1	TRBJ1-4
TGTGCCAGCAGTGACTCTCCCCTTCGAGGGGGCGCTAGCACAGATACGCAGTATTTT	CASSDSPLRGGASTDTQYF	TRBV6-4	TRBJ2-3
TGTGCCAATCGCAGGGCTGCCCACTATGGCTACACCTTC	CANRRAAHYGYTF	TRBV5-4	TRBJ1-2
TGTGCTAGTGGTTTGATAACTAGCGGGAGAACCCCACATCAAGAGACCCAGTACTTC	CASGLITSGRTPHQETQYF	TRBV12-5	TRBJ2-5
TGTGCCAGCAGTGGGCAGGGCGACGAGCAGTACTTC	CASSGQGDEQYF	TRBV6-5	TRBJ2-7
TGCGCCAGCAGGTCAAGGGGGGTCTACGAGCAGTACTTC	CASRSRGVYEQYF	TRBV10-1	TRBJ2-7
TGTGCCAGCCGACCAAGCAATCAGCCCCAGCATTTT	CASRPSNQPQHF	TRBV6-5	TRBJ1-5
TGTGCCAGCAGTGAGCAGGCGGGTATCCAAGAGACCCAGTACTTC	CASSEQAGIQETQYF	TRBV6-8	TRBJ2-5
TGTGCCAGCAGCCCCCGCAGGACTGAAGCTTTCTTT	CASSPRRTEAFF	TRBV11-3	TRBJ1-1
TGTGCCAGCAGCCAAGGCGGTCGGTTGTACGAGCAGTACTTC	CASSQGGRLYEQYF	TRBV14	TRBJ2-7
TGTGCCAGCAGCGAGCCTTCGACGGACGAAAAAAATGAGCAGTTCTTC	CASSEPSTDEKNEQFF	TRBV3-1	TRBJ2-1
TGTGCCAGCAGTATCCTCCCTACAGGGGGGCTGGCTTATACGCAGTATTTT	CASSILPTGGLAYTQYF	TRBV6-2	TRBJ2-3
TGTGCCAGCAGCCAGTACGAGGGACGATCGTACAATGAGCAGTTCTTC	CASSQYEGRSYNEQFF	TRBV14	TRBJ2-1
TGTGCCAGCAGCTTAGATCTAAGGGGTCGTGTTAACTCTGGAAACACCATATATTTT	CASSLDLRGRVNSGNTIYF	TRBV11-2	TRBJ1-3
TGTGCCAGCAACGGACAGGGCCTCTCTGGAAACACCATATATTTT	CASNGQGLSGNTIYF	TRBV6-3	TRBJ1-3
TGTGCCAGCAGCGGCCTCTCCACTATTCTCTACGAGCAGTACTTC	CASSGLSTILYEQYF	TRBV9	TRBJ2-7
TGTGCCAGCAGCTCCCGGGAGGGGACAGGGGGTTGGCAATCCCGCAATCAGCCCCAGCATTTT	CASSSREGTGGWQSRNQPQHF	TRBV5-4	TRBJ1-5
TGTGCTAGTGGTTTGGGGGGCCCGGGGATCAATCAGCCCCAGCATTTT	CASGLGGPGINQPQHF	TRBV12-5	TRBJ1-5
TGTGCCAGCAGCTGTCACGTAGTGGGGTCTTACAATGAGCAGTTCTTC	CASSCHVVGSYNEQFF	TRBV7-9	TRBJ2-1
TGTGCCAGCACCCCAGAGGACAGTCCGGGACAAGAGACCCAGTACTTC	CASTPEDSPGQETQYF	TRBV6-2	TRBJ2-5
TGCAGTGCTAGCTCCAACCTCGGGTTCGGCGAGCAGTACTTC	CSASSNLGFGEQYF	TRBV20-1	TRBJ2-7
TGTGCCAGCAGTTTTCTGGGACAGGGTGAAAAACTGTTTTTT	CASSFLGQGEKLFF	TRBV27	TRBJ1-4
TGTGCCAGCAGTAGGGTGGGGGAAATAAACAATGAGCAGTTCTTC	CASSRVGEINNEQFF	TRBV6-2	TRBJ2-1
TGCAGCGTTGGGATCCCGAAGGGAGCGGGGGATTCACCCCTCCACTTT	CSVGIPKGAGDSPLHF	TRBV29-1	TRBJ1-6
TGTGCCAGTAGTAAAGCTAGCGGGTCCAACCAAGAGACCCAGTACTTC	CASSKASGSNQETQYF	TRBV19	TRBJ2-5
TGTGCCAGCAGCTTAGCAGGGGGCTACGAGCAGTACTTC	CASSLAGGYEQYF	TRBV7-2	TRBJ2-7
TGTGCCAGCAGTGACAAAGTCCCAGATACGCAGTATTTT	CASSDKVPDTQYF	TRBV6-4	TRBJ2-3
TGTGCCAGCAGCTTGCTGAAGGGGGGTCCCGGCTACGAGCAGTACTTC	CASSLLKGGPGYEQYF	TRBV5-6	TRBJ2-7
TGCGCCAGCAGCAGGGGGGAAGGTGGAGCGGTAACGAATAACTATGGCTACACCTTC	CASSRGEGGAVTNNYGYTF	TRBV5-1	TRBJ1-2
TGTGCCAGCAGCTTTTCCGCCAGGGGGCGGGAAGAAAAACTGTTTTTT	CASSFSARGREEKLFF	TRBV7-8	TRBJ1-4
TGTGCCAGCTCACCTGCTAGCCACGGTGAGCAGTACTTC	CASSPASHGEQYF	TRBV18	TRBJ2-7
TGCAGTGCGGACAGGGGATGGATCTCCTACAATGAGCAGTTCTTC	CSADRGWISYNEQFF	TRBV20-1	TRBJ2-1
TGTGCCAGCAGCAGTGGCCATTTGAGATATCAGCCCCAGCATTTT	CASSSGHLRYQPQHF	TRBV7-4	TRBJ1-5
TGTGCCAGCAGCCATATGCGGGGTTGTGCCACCTACGAGCAGTACTTC	CASSHMRGCATYEQYF	TRBV14	TRBJ2-7
TGTGCCAGCGAGATGTCACCCCATTATGGCTACACCTTC	CASEMSPHYGYTF	TRBV9	TRBJ1-2
TGTGCTAGTGGTTCTCAGGGCTACCCCGGGGAGCTGTTTTTT	CASGSQGYPGELFF	TRBV12-5	TRBJ2-2
TGCAGTGCTGGTTCAGGGGGGGGTTCACCCCTCCACTTT	CSAGSGGGSPLHF	TRBV20-1	TRBJ1-6
TGTGCCAGCAGCTGGGGACCGGGACTAGTTGACAATGAGCAGTTCTTC	CASSWGPGLVDNEQFF	TRBV5-6	TRBJ2-1
TGTGCCAGCAGCTGGGGTGAAAAACTGTTTTTT	CASSWGEKLFF	TRBV7-6	TRBJ1-4
TGTGCCAGCAGCTTAGAAAAGACATTCTATGGCTACACCTTC	CASSLEKTFYGYTF	TRBV7-9	TRBJ1-2
TGTGCCGAATTGGATTTCTCGGGACCGTTCTATGGCTACACCTTC	CAELDFSGPFYGYTF	TRBV6-5	TRBJ1-2
TGTGCCAGCAGTGAGGAGGGTAATAGCAATCAGCCCCAGCATTTT	CASSEEGNSNQPQHF	TRBV12-3	TRBJ1-5
TGTGCCAGCAGCTTAGCCTTCAGGGGGCGCTGCGAGCAGTACTTC	CASSLAFRGRCEQYF	TRBV11-2	TRBJ2-7
TGCAGTGCTAGGAGGGGACTAGTTCACCAAGAGACCCAGTACTTC	CSARRGLVHQETQYF	TRBV20-1	TRBJ2-5
TGTGCCAGCAGCCCCGGGACAGGGGGCAAATTAGCTTTCTTT	CASSPGTGGKLAFF	TRBV7-3	TRBJ1-1
TGTGCCACGGGCACATGGGTGTACCGAGATACGCAGTATTTT	CATGTWVYRDTQYF	TRBV10-3	TRBJ2-3
TGTGCCAGCAGCGTAGCTGAACTTAAGGGGCAGAACACTGAAGCTTTCTTT	CASSVAELKGQNTEAFF	TRBV9	TRBJ1-1
TGTGCCACAGTCCCGATCCGGGGGCCGGGGCCTAGAGTAGACAACACCGGGGAGCTGTTTTTT	CATVPIRGPGPRVDNTGELFF	TRBV18	TRBJ2-2
TGTGCCACCAGTGATTTCTTAGTAGCGGGTGACTACAATGAGCAGTTCTTC	CATSDFLVAGDYNEQFF	TRBV24-1	TRBJ2-1
TGTGCCAGCAGATACCCACTAGCGAATGAGCAGTTCTTC	CASRYPLANEQFF	TRBV25-1	TRBJ2-1
TGCGCCAGCAGCTACATAGTTTTTCCACTCACAGATACGCAGTATTTT	CASSYIVFPLTDTQYF	TRBV5-1	TRBJ2-3
TGTGCCAGCAGCCAAGAAACCGGACAGGGTGAAGCTTTCTTT	CASSQETGQGEAFF	TRBV4-2	TRBJ1-1
TGCGCCAGCAGCCCGCCCCCTCCCGGGACAGTCCCCCAGCATTTT	CASSPPPPGTVPQHF	TRBV4-1	TRBJ1-5
TGCGCCAGCAGTGAATTGGTTCCGGGACATGAGCAGTTCTTC	CASSELVPGHEQFF	TRBV10-1	TRBJ2-1
TGTGCCAGCAGTGAACAGCCAGCCAATGAAAAACTGTTTTTT	CASSEQPANEKLFF	TRBV6-1	TRBJ1-4
TGTGCCAGCAGTAATCTTCACCCCAGGAATTCACCCCTCCACTTT	CASSNLHPRNSPLHF	TRBV27	TRBJ1-6
TGTGCCAGCAGGGTCCTCCAGGGTCGCCGTTCGGGACACAATGAGCAGTTCTTC	CASRVLQGRRSGHNEQFF	TRBV6-5	TRBJ2-1
TGTGCCAGCAGTGAATGCAGTCAGCCCCAGCATTTT	CASSECSQPQHF	TRBV6-1	TRBJ1-5
TGTGCCTGGAGGCCGGGCCTACCCACCTACGAGCAGTACTTC	CAWRPGLPTYEQYF	TRBV30	TRBJ2-7
TGTGCCAGCAGCCACCGCGGATTCTATGGCTACACCTTC	CASSHRGFYGYTF	TRBV6-3	TRBJ1-2
TGTGCCAGCTCACCATCGGTTGGAGAGACTCTCCAACCGGGACACAAGTACAATGAGCAGTTCTTC	CASSPSVGETLQPGHKYNEQFF	TRBV18	TRBJ2-1
TGTGCCCCCCCGGGACAGGGAAGGGAGACCCAGTACTTC	CAPPGQGRETQYF	TRBV27	TRBJ2-5
TGCGCCAGCAGCCTCCCGGTCCGAAACACAGATACGCAGTATTTT	CASSLPVRNTDTQYF	TRBV4-3	TRBJ2-3
TGTGCCAGCAGCGCTCCGGGACAGGAGGAGGGTCACTACGAGCAGTACTTC	CASSAPGQEEGHYEQYF	TRBV5-6	TRBJ2-7
TGTGCAGGGAGCGTCTCTGGAAACACCATATATTTT	CAGSVSGNTIYF	TRBV5-4	TRBJ1-3
TGCGCCAGCAGTGAAGGACCTAAAGAGACCCAGTACTTC	CASSEGPKETQYF	TRBV10-1	TRBJ2-5
TGTGCCAGCAGTTATTACAGGGAATGCGGGAACACCATATATTTT	CASSYYRECGNTIYF	TRBV27	TRBJ1-3
TGTGCCAGCAGCGTTCGAGAGAGGTCGAACACCGGGGAGCTGTTTTTT	CASSVRERSNTGELFF	TRBV9	TRBJ2-2
TGTGCCAGCAGTTCCGACAGGGGGGTAGCAACTAATGAAAAACTGTTTTTT	CASSSDRGVATNEKLFF	TRBV28	TRBJ1-4
TGTGCCCCCCTAGCGGGTCGGAGCCAAGAGACCCAGTACTTC	CAPLAGRSQETQYF	TRBV3-1	TRBJ2-5
TGTGCCAGCAAGCCGGGACTAGCGGGAGTCAGGGACTCCTATAATTCACCCCTCCACTTT	CASKPGLAGVRDSYNSPLHF	TRBV11-3	TRBJ1-6
TGTGCCAGCAGCTTCCGGGATAGCAATCAGCCCCAGCATTTT	CASSFRDSNQPQHF	TRBV13	TRBJ1-5
TGTGCCAGCAGCGACCCTTTCGGACCCTACAATGAGCAGTTCTTC	CASSDPFGPYNEQFF	TRBV7-6	TRBJ2-1
TGTGCCAGCAGACAGTGGGCTTTCTTT	CASRQWAFF	TRBV6-4	TRBJ1-1
TGTGCCAGCAGCCAAGGTGCAGGACAGAAAAACGAGCAGTACTTC	CASSQGAGQKNEQYF	TRBV14	TRBJ2-7
TGCGCCAGCAGCTTGTGGAATAGCGGGTGCACAGATACGCAGTATTTT	CASSLWNSGCTDTQYF	TRBV5-1	TRBJ2-3
TGTGCCAGCAGCGCAGGGACCTGCCGGGTTGAAGCTTTCTTT	CASSAGTCRVEAFF	TRBV9	TRBJ1-1
TGTGCCAGCAGTCAGGGTGTACTGCCTTCCTACGAGCAGTACTTC	CASSQGVLPSYEQYF	TRBV6-1	TRBJ2-7
TGTGCCAGCAGTTACGGGACAGATAGCCATGGCTACACCTTC	CASSYGTDSHGYTF	TRBV6-5	TRBJ1-2
TGTGCCATCAGTGTGGGAAGTAGGGAGCCTTCCCCCTACGAGCAGTACTTC	CAISVGSREPSPYEQYF	TRBV10-3	TRBJ2-7
TGCGCCAGCAGCTTGCGAGTTAAAAACATTCAGTACTTC	CASSLRVKNIQYF	TRBV5-1	TRBJ2-4
TGTGCCAGTAGTATCCCTACGGCCAGTAACATTCAGTACTTC	CASSIPTASNIQYF	TRBV19	TRBJ2-4
TGTGCTAGCAGCTTAAGTTGCCGATGGACTAGCGGGACAGATACGCAGTATTTT	CASSLSCRWTSGTDTQYF	TRBV7-7	TRBJ2-3
TGCAATTCCCTAGCGGGCCCCTCCTACGAGCAGTACTTC	CNSLAGPSYEQYF	TRBV20-1	TRBJ2-7
TGTGCCAGCAACAGGGCGGGAGGGGGGAACACTGAAGCTTTCTTT	CASNRAGGGNTEAFF	TRBV2	TRBJ1-1
TGTGCCAGCAGCTTAGGCTCTGAAAAACTGTTTTTT	CASSLGSEKLFF	TRBV11-2	TRBJ1-4
TGTGCCACCCAAAATACAGCCAACACTGAAGCTTTCTTT	CATQNTANTEAFF	TRBV24-1	TRBJ1-1
TGTGCCAGCAGCGCCGGTAGACAGGAGCAGTACTTC	CASSAGRQEQYF	TRBV9	TRBJ2-7
TGTGCCAGCAGCGAGCAGGGCTCGGGGTTAGACGAGCAGTACTTC	CASSEQGSGLDEQYF	TRBV7-9	TRBJ2-7
TGTGCCACCACCTTAGCGGGCTACGAGCAGTACTTC	CATTLAGYEQYF	TRBV24-1	TRBJ2-7
TGCGCCAGCCCGCTGGCCCGTGTAGAGACCCAGTACTTC	CASPLARVETQYF	TRBV10-1	TRBJ2-5
TGTGCCAGCAGCAGCCTAGGGAACAATGAAAAACTGTTTTTT	CASSSLGNNEKLFF	TRBV6-5	TRBJ1-4
TGTGCCAGCAGCCAGGGGAGAACTGAGACCCAGTACTTC	CASSQGRTETQYF	TRBV9	TRBJ2-5
TGCAGTGCTAGAGATGACCAGCCTAGCGAGAACCAGCCCCAGCATTTT	CSARDDQPSENQPQHF	TRBV20-1	TRBJ1-5
TGCGCCAGCAGCCAAGAGGACAGGGGAGGGGGAGCTAATGAAAAACTGTTTTTT	CASSQEDRGGGANEKLFF	TRBV4-1	TRBJ1-4
TGTGCCAGCAGTTACGGGGGGACCGGGGAGCTGTTTTTT	CASSYGGTGELFF	TRBV6-5	TRBJ2-2
TGTGCCTGGAGGCGTGGGCTAGCGGGGTCCCAAGAGACCCAGTACTTC	CAWRRGLAGSQETQYF	TRBV30	TRBJ2-5
TGTGCCACCATATCGGGGTGCATTGGCTACACCTTC	CATISGCIGYTF	TRBV24-1	TRBJ1-2
TGCGCCGGGGACACAGGGCGGTACGAGCAGTACTTC	CAGDTGRYEQYF	TRBV10-1	TRBJ2-7
TGTGCCAGCAGATGTGACCGAGTTCTTCGCTATGGCTACACCTTC	CASRCDRVLRYGYTF	TRBV12-4	TRBJ1-2
TGTGCCAGCAAGCCCAGGGGGCAAGAGACCCAGTACTTC	CASKPRGQETQYF	TRBV6-5	TRBJ2-5
TGTGCCAGCAGTGACTCGAGATCCACGGTTTCACAGCCCCAGCATTTT	CASSDSRSTVSQPQHF	TRBV6-4	TRBJ1-5
TGTGCCAGCAGCTTGGGGACAGGGGGCGACTCTGGGGCCAACGTCCTGACTTTC	CASSLGTGGDSGANVLTF	TRBV5-6	TRBJ2-6
TGTGCCAGCAGCCCCCCGCCTCGGGACAGAATCACCTTC	CASSPPPRDRITF	TRBV7-3	TRBJ1-2
TGTGCCAGGCCCCATTTAGGAAGCAAAGACTGCACAGATACGCAGTATTTT	CARPHLGSKDCTDTQYF	TRBV7-9	TRBJ2-3
TGCAGTGCTGTTACAAGGCAGGGGGTACGAGCGATGAACTATGGCTACACCTTC	CSAVTRQGVRAMNYGYTF	TRBV20-1	TRBJ1-2
TGCGCCAGCAGCTTCGTTGGGGGAAGTCCGACCCAGTACTTC	CASSFVGGSPTQYF	TRBV5-1	TRBJ2-5
TGTGCCAGCAGTTTCTATGGACACGAGGTGGGGCCTGAAGCTTTCTTT	CASSFYGHEVGPEAFF	TRBV27	TRBJ1-1
TGTGCCAGCAGCTTGCTCGGACAGGGGGAGACCCAGTACTTC	CASSLLGQGETQYF	TRBV5-4	TRBJ2-5
TGCGCCAGCAGTGAGAACCTAACTGACAGGGCAGAGGGACATCAGCCCCAGCATTTT	CASSENLTDRAEGHQPQHF	TRBV10-1	TRBJ1-5
TGTGCCAGCAGCCGGTGCTTGCAGTTCTTC	CASSRCLQFF	TRBV4-2	TRBJ2-1
TGTGCCAGTAGCCTGCGTCCCCCGGGGGGTTATGGCTACACCTTC	CASSLRPPGGYGYTF	TRBV19	TRBJ1-2
TGTGCCAGCAGCCAAGATGTAGACGCCTCACGGGGCCATAGCAATCAGCCCCAGCATTTT	CASSQDVDASRGHSNQPQHF	TRBV3-1	TRBJ1-5
TGCAGTGCAGCGATGAGTGGAATAGCAGAGCACACTGAAGCTTTCTTT	CSAAMSGIAEHTEAFF	TRBV20-1	TRBJ1-1
TGTGCCAGCCGCAAGTACTTC	CASRKYF	TRBV27	TRBJ2-7
TGTGCCAGCAGCTATCGGGGGCTTAGAGTTGGAAGTTACTATGGCTACACCTTC	CASSYRGLRVGSYYGYTF	TRBV7-2	TRBJ1-2
TGCAGTGCTAGAGAAACGTACGAGCAGTACTTC	CSARETYEQYF	TRBV20-1	TRBJ2-7
TGTGCCAGCAGTGGGGAAGGAGATACGCAGTATTTT	CASSGEGDTQYF	TRBV12-4	TRBJ2-3
TGTGCCAGTAGGTTTAGTGAGGGTTCCCTGGCCTACGAGCAGTACTTC	CASRFSEGSLAYEQYF	TRBV19	TRBJ2-7
TGTGCCAGCAGCGTTCTCCTACAGGGTGGACTCCGCTCCTACGAGCAGTACTTC	CASSVLLQGGLRSYEQYF	TRBV9	TRBJ2-7
TGTGCCAGCTGGTGGGGGGGTGAAGCTTTCTTT	CASWWGGEAFF	TRBV28	TRBJ1-1
TGTGCCATCAGTGAGGACAACACAGATACGCAGTATTTT	CAISEDNTDTQYF	TRBV10-3	TRBJ2-3
TGTGCCATCATATCCGGAACTAGCGGGAGTAATGAAAAACTGTTTTTT	CAIISGTSGSNEKLFF	TRBV10-3	TRBJ1-4
TGTGCCAGCAGCCTGTCTAACAGGGGGGATTGGGTGGGGCCCAATGAGCAGTTCTTC	CASSLSNRGDWVGPNEQFF	TRBV11-2	TRBJ2-1
TGTGCCATCCAGGGGAGCTACGAGCAGTACTTC	CAIQGSYEQYF	TRBV28	TRBJ2-7
TGCGCCAGCAGCCCCGGGCCTGACAGGGGGCTGATATACGAGCAGTACTTC	CASSPGPDRGLIYEQYF	TRBV4-1	TRBJ2-7
TGTGCCAGCAGTTCCCCCCGGCGCCGCTCTGGGGCCAACGTCCTGACTTTC	CASSSPRRRSGANVLTF	TRBV6-5	TRBJ2-6
TGTGCTAGGGGGGACTATGGCTACACCTTC	CARGDYGYTF	TRBV12-5	TRBJ1-2
TGTGCCAGCAGTGACGAGGGATCCACAGATACGCAGTATTTT	CASSDEGSTDTQYF	TRBV6-4	TRBJ2-3
TGCGCCAGCAGCTTGGGGACAGCCCATACGGGGTACGAGCAGTACTTC	CASSLGTAHTGYEQYF	TRBV5-1	TRBJ2-7
TGTGCTAGTGGTTTCGTACAGGTCGGGAATCAGCCCCAGCATTTT	CASGFVQVGNQPQHF	TRBV12-5	TRBJ1-5
TGTGCCAGCAGCAGCGGGAACCGGGACACCGATACGCAGTATTTT	CASSSGNRDTDTQYF	TRBV7-2	TRBJ2-3
TGTGCCAGCAGCTCTCCGGGGGGGATCGGGGAGCTGTTTTTT	CASSSPGGIGELFF	TRBV7-3	TRBJ2-2
TGTGCCAGCAGCGCAGACAAGGCCTACGAGCAGTACTTC	CASSADKAYEQYF	TRBV28	TRBJ2-7
TGTGCCAGAATAAAACAGAATAGAACTGAAGCTTTCTTT	CARIKQNRTEAFF	TRBV6-1	TRBJ1-1
TGTGCCACAATTCTCCGGGACCGGGTCGAGCAGTACTTC	CATILRDRVEQYF	TRBV13	TRBJ2-7
TGCGCCAGCAGCTTGGAAAATTCCCTTGGTGGTTCTATAGAGACCCAGTACTTC	CASSLENSLGGSIETQYF	TRBV5-1	TRBJ2-5
TGTGCCAGCAGTTTGAACACAGGGGGGAGGAGTCACTCTGGGGCCAACGTCCTGACTTTC	CASSLNTGGRSHSGANVLTF	TRBV27	TRBJ2-6
TGCAGTGCTGCCAGGATCACTGAAGCTTTCTTT	CSAARITEAFF	TRBV20-1	TRBJ1-1
TGTGCCAGCAGCTTAGAGATACCCGTGTGGGGGGGTCGAACCACAGATACGCAGTATTTT	CASSLEIPVWGGRTTDTQYF	TRBV7-9	TRBJ2-3
TGTGCCAGGGCAAACAGCCAGGACACCGGGGAGCTGTTTTTT	CARANSQDTGELFF	TRBV6-2	TRBJ2-2
TGTGCCAGCAGTCCCGTACAGGGCCCGGTCCTGTTTTTT	CASSPVQGPVLFF	TRBV6-6	TRBJ1-4
TGCGCCAGCAGCTTGCCTGCTACTAGGATCCAAGAGACCCAGTACTTC	CASSLPATRIQETQYF	TRBV5-1	TRBJ2-5
TGTGCCAGCAGCAGTGAACTTCACAAAAGTGAGCAGTTCTTC	CASSSELHKSEQFF	TRBV7-3	TRBJ2-1
TGTGCCAGCAGCTTGGGGGGTAATAGCAATCAGCCCCAGCATTTT	CASSLGGNSNQPQHF	TRBV7-8	TRBJ1-5
TGTGCCAGCAGCGAGAGGGGGCTGGGCCGCACAGATACGCAGTATTTT	CASSERGLGRTDTQYF	TRBV7-3	TRBJ2-3
TGTGCCAGCAGCTGGTGGATGCAGTATTTT	CASSWWMQYF	TRBV7-9	TRBJ2-3
TGCGCCAGCCTGGCAGTAGGACAGAACACTGAAGCTTTCTTT	CASLAVGQNTEAFF	TRBV10-1	TRBJ1-1
TGCAGTGCGAGCATTCGGGACAGGGGGCCTTGGGGCAATCAGCCCCAGCATTTT	CSASIRDRGPWGNQPQHF	TRBV20-1	TRBJ1-5
TGTGCCAGCAGCGTAGTCAGCCTGACCCTGTGGAGCAATCAGCCCCAGCATTTT	CASSVVSLTLWSNQPQHF	TRBV9	TRBJ1-5
TGTGCCAGCAGTGAAAATCAGGACCCGATGACAGGGAAATACACAGATACGCAGTATTTT	CASSENQDPMTGKYTDTQYF	TRBV2	TRBJ2-3
TGCAGCACCGACAGGGGGGGAAACACCATATATTTT	CSTDRGGNTIYF	TRBV29-1	TRBJ1-3
TGTGCCAGCAGGGGTCAGGGGGGCTACACCTTC	CASRGQGGYTF	TRBV3-1	TRBJ1-2
TGTGCCGGACAGGGGTCCGACTTC	CAGQGSDF	TRBV19	TRBJ2-7
TGTGCCAGCAGCCCCCCACTTAGTGGGCTTGAGCAGTTCTTC	CASSPPLSGLEQFF	TRBV13	TRBJ2-1
TGTGCCAGCAGCAATTCTAGCGGGCAGATACCATACGAGCAGTACTTC	CASSNSSGQIPYEQYF	TRBV7-3	TRBJ2-7
TGCGCCAGCAGCCGGAGTGGGGACAGGGGGTCCTACAATGAGCAGTTCTTC	CASSRSGDRGSYNEQFF	TRBV4-3	TRBJ2-1
TGTGCCATCCTCAGGATCCAGGGCAACACCATATATTTT	CAILRIQGNTIYF	TRBV7-3	TRBJ1-3
TGTGCCAGCAGCTTGGACCGGGACAGGGGCCATCGAGGGTACGAGCAGTACTTC	CASSLDRDRGHRGYEQYF	TRBV5-5	TRBJ2-7
TGTGCCAGCAGCCCGGGAGGGCTAAGGTGGGCAGACGTAGACTACAATGAGCAGTTCTTC	CASSPGGLRWADVDYNEQFF	TRBV3-1	TRBJ2-1
TGCAGTGCTAATTGGAGTAGGGACAGGGTGAACACTGAAGCTTTCTTT	CSANWSRDRVNTEAFF	TRBV20-1	TRBJ1-1
TGCGCCAGCAGGAGGGGGACCTTCTATGGCTACACCTTC	CASRRGTFYGYTF	TRBV5-1	TRBJ1-2
TGCGCCAGCAGCTTGGTCCCTACCAAAGGACAGGGGAATGGGGTGGACGGCACCGGGGAGCTGTTTTTT	CASSLVPTKGQGNGVDGTGELFF	TRBV5-1	TRBJ2-2
TGTGCCAGCAGCAATAGAGTTTCCGCCCCGGGACAGGGCTTGTATATTTCCTACGAGCAGTACTTC	CASSNRVSAPGQGLYISYEQYF	TRBV13	TRBJ2-7
TGTGCCAGCAGCTTGTTGGGGGACAGGGGCAATGAAAAACTGTTTTTT	CASSLLGDRGNEKLFF	TRBV5-4	TRBJ1-4
TGCAGTGCTCGGACTCCGTACGAGCAGTACTTC	CSARTPYEQYF	TRBV20-1	TRBJ2-7
TGTGCCAGCAGTCTAGAGGGAAGAAGGGGGCCATACTACGAGCAGTACTTC	CASSLEGRRGPYYEQYF	TRBV27	TRBJ2-7
TGCAGTGCGGGGGGGGGGAACTACAATGAGCAGTTCTTC	CSAGGGNYNEQFF	TRBV20-1	TRBJ2-1
TGCAGTGCTAGCCCCCCGTGGACAGGGAGAGATAATGAAAAACTGTTTTTT	CSASPPWTGRDNEKLFF	TRBV20-1	TRBJ1-4
TGCGCCAGCACGGGGGGGTACGAAGGCTACACCTTC	CASTGGYEGYTF	TRBV10-1	TRBJ1-2
TGTGCCAGCAGCTTAGGCCCACAGGGGTGTTCGCAGTACTTC	CASSLGPQGCSQYF	TRBV7-2	TRBJ2-7
TGCAGTGCTAGTCCGGGCCTACGAAACACCATATATTTT	CSASPGLRNTIYF	TRBV20-1	TRBJ1-3
TGCGCGGGCGGTCCGGGACAGGGGGAGTGTTCTGAAGCTTTCTTT	CAGGPGQGECSEAFF	TRBV10-2	TRBJ1-1
TGTGCCAGCAAACAGCCCTCCTACAATGAGCAGTTCTTC	CASKQPSYNEQFF	TRBV28	TRBJ2-1
TGTGCCAGCAGAACGACTAGAGAAGAGGTCAATGAGCAGTTCTTC	CASRTTREEVNEQFF	TRBV7-9	TRBJ2-1
TGCAGTGCACCCACTGAAGCTTTCTTT	CSAPTEAFF	TRBV20-1	TRBJ1-1
TGCAGCGTTGGTGGTGGGACATGGGAGACCCAGTACTTC	CSVGGGTWETQYF	TRBV29-1	TRBJ2-5
TGTGCCAGCAGTTACGCTAGTCAGGGCCCGGGGAACTATGGCTACACCTTC	CASSYASQGPGNYGYTF	TRBV6-5	TRBJ1-2
TGTGCCAGCAGTTTATCTGGGTACAATGAGCAGTTCTTC	CASSLSGYNEQFF	TRBV27	TRBJ2-1
TGTGCCAGCAGGGTCGGGGGGATCATTCAGTACTTC	CASRVGGIIQYF	TRBV2	TRBJ2-4
TGTGCCTGGAACCTTATAGCATACGAGCAGTACTTC	CAWNLIAYEQYF	TRBV30	TRBJ2-7
TGTGCCAGCAAGTTGACAGTAGGTCACAATGAGCAGTTCTTC	CASKLTVGHNEQFF	TRBV12-3	TRBJ2-1
TGTGCCAGCAGCTTATGCGTACAAGACAGGGCTTTACCAGCTTTCTTT	CASSLCVQDRALPAFF	TRBV7-3	TRBJ1-1
TGCGCCAGCAGCAACGGGAGGGCGACGAACACTGAAGCTTTCTTT	CASSNGRATNTEAFF	TRBV5-1	TRBJ1-1
TGTGCCAGCAGTCCAGCGGGACCCGGAAACACCATATATTTT	CASSPAGPGNTIYF	TRBV27	TRBJ1-3
TGCAGTGCTAGAACACCGGGACAGGGCGAATACGAGCAGTACTTC	CSARTPGQGEYEQYF	TRBV20-1	TRBJ2-7
TGTGCCAGCATCACGCCTATAGTCACGGAGACCCAGTACTTC	CASITPIVTETQYF	TRBV2	TRBJ2-5
TGTGCCAGCCGTTGGGTCGGGAACTACGAGCAGTACTTC	CASRWVGNYEQYF	TRBV6-4	TRBJ2-7
TGTGCCAGCACATCTAGTACTTGCCCTAGCACAGATACGCAGTATTTT	CASTSSTCPSTDTQYF	TRBV25-1	TRBJ2-3
TGTGCCAGCAGTTCTATTTTCGGGACTAGCGGGGCCCCCTTCTCCTCCTACAATGAGCAGTTCTTC	CASSSIFGTSGAPFSSYNEQFF	TRBV6-5	TRBJ2-1
TGTGCCAGCAGCCAAGATGGACAGACTGAAGCTTTCTTT	CASSQDGQTEAFF	TRBV4-2	TRBJ1-1
TGTGCCAGCAGTTTAGAACGGGGATCCTATGGCTACACCTTC	CASSLERGSYGYTF	TRBV27	TRBJ1-2
TGTGCCAGCAGTCCTCCGCCAGAGGGGAAAAACAATCAGCCCCAGCATTTT	CASSPPPEGKNNQPQHF	TRBV27	TRBJ1-5
TGTGCCAGCAGTGACCCGGGGGCGCCGAACACCGGGGAGCTGTTTTTT	CASSDPGAPNTGELFF	TRBV2	TRBJ2-2
TGTGCCAGCAGCCAAGCCAGTAGCTCTGGAAACACCATATATTTT	CASSQASSSGNTIYF	TRBV14	TRBJ1-3
TGTGCCAGCTTTGGGGAGACTGAAGCTTTCTTT	CASFGETEAFF	TRBV6-1	TRBJ1-1
TGTGCCAGCTCACCAACAGGGAGCTCTGGAAACACCATATATTTT	CASSPTGSSGNTIYF	TRBV18	TRBJ1-3
TGTGCCAGCAGCCCCGGCCGACCGGCCAAAGGGATCGCTATGAACACTGAAGCTTTCTTT	CASSPGRPAKGIAMNTEAFF	TRBV7-4	TRBJ1-1
TGTGCCAGCTCAAGGTGGAAGGACAGGGGCAGCTATGAAAAACTGTTTTTT	CASSRWKDRGSYEKLFF	TRBV18	TRBJ1-4
TGCAGTGCTAGAGCAGCATGGGAGGGTCCCTATGGCTACACCTTC	CSARAAWEGPYGYTF	TRBV20-1	TRBJ1-2
TGTGCCAGCAAACTGACAGATTACGCCAGCAATCAGCCCCAGCATTTT	CASKLTDYASNQPQHF	TRBV12-4	TRBJ1-5
TGTGCCAGCAGCTTAGATCCTGGAAATAATCAGCCCCAGCATTTT	CASSLDPGNNQPQHF	TRBV11-2	TRBJ1-5
TGTGCCAGCAGCGTACGAGGGGCTGAGTATGGCTACACCTTC	CASSVRGAEYGYTF	TRBV5-6	TRBJ1-2
TGTGCCAGCAGTTTTTGTACCTGGGCGGGAGAGGGTGAAAAACTGTTTTTT	CASSFCTWAGEGEKLFF	TRBV28	TRBJ1-4
TGTGCCAGCAGCTTCTGGGGCACGGGCTACACCTTC	CASSFWGTGYTF	TRBV7-9	TRBJ1-2
TGTGCCAGCAGCCAAGATACCGCTAGCGGGACGGGCACAGATACGCAGTATTTT	CASSQDTASGTGTDTQYF	TRBV14	TRBJ2-3
TGCGCCAGCAGCCAAGATAAGTTTAGGGACATAGGCCTCCACTTC	CASSQDKFRDIGLHF	TRBV4-1	TRBJ2-5
TGTGCCAGCAGTTATGGGCCAAGGGGGCTGAAGCTGTTTTTT	CASSYGPRGLKLFF	TRBV6-3	TRBJ2-2
TGTGCCAGCAGTTCTAGTCGGTCACCGGACAGGGGATCGGACACTGAAGCTTTCTTT	CASSSSRSPDRGSDTEAFF	TRBV27	TRBJ1-1
TGTGCCAGCAGCTCCGGGGTATTTTATGAGCAGTTCTTC	CASSSGVFYEQFF	TRBV7-6	TRBJ2-1
TGTGCCAGCGTGGCCTTGGGCATAGCGGGGAGCACAGATACGCAGTATTTT	CASVALGIAGSTDTQYF	TRBV6-4	TRBJ2-3
TGTGCCTGGACTGCTTTTCAGACGGGATACGAGCAGTACTTC	CAWTAFQTGYEQYF	TRBV30	TRBJ2-7
TGTGCCACCAGTGATGGACCTGGGGGGCCCAACTCCTACAATGAGCAGTTCTTC	CATSDGPGGPNSYNEQFF	TRBV24-1	TRBJ2-1
TGTGCCAGCAGGGCAGACTCCTATAATTCACCCCTCCACTTT	CASRADSYNSPLHF	TRBV7-8	TRBJ1-6
TGCGCCAGCAGTGACCCAACCGGGACCCATTCACCCCTCCACTTT	CASSDPTGTHSPLHF	TRBV10-2	TRBJ1-6
TGCAGTGCTAGCGGGAGATCCTACGAGCAGTACTTC	CSASGRSYEQYF	TRBV20-1	TRBJ2-7
TGCAGTGCTAGAGCCCTCGGGTTGAGGGACAGGTCTGAGCAGTACTTC	CSARALGLRDRSEQYF	TRBV20-1	TRBJ2-7
TGTGCCAGCAGCCAAGTGCTCCTTGCCTACGAGCAGTACTTC	CASSQVLLAYEQYF	TRBV4-2	TRBJ2-7
TGTGCCAGCAGTTTATACCTACCCTCCTTGACTAGCGGATTCAATTTGTACCAAGAGACCCAGTACTTC	CASSLYLPSLTSGFNLYQETQYF	TRBV27	TRBJ2-5
TGTGCCAGCAGCGTGGGGAGGAGGGGAGTGAACACTGAAGCTTTCTTT	CASSVGRRGVNTEAFF	TRBV9	TRBJ1-1
TGTGCCAGCAGCCTCCTACACGAGCAGTACTTC	CASSLLHEQYF	TRBV12-4	TRBJ2-7
TGTGCCACCAGTGCGCCCGCTAAGACTTCAGTTTCACCCCTCCACTTT	CATSAPAKTSVSPLHF	TRBV24-1	TRBJ1-6
TGTGCCAGCAGCGCGGGAGAGCCTCCAGGATACGAGCAGTACTTC	CASSAGEPPGYEQYF	TRBV9	TRBJ2-7
TGCAGCGTTCGGGGGGGGAGCACAGATACGCAGTATTTT	CSVRGGSTDTQYF	TRBV29-1	TRBJ2-3
TGTGCCAGCAGTACGAGACAGCCCTTGGTTGACGAGCAGTACTTC	CASSTRQPLVDEQYF	TRBV2	TRBJ2-7
TGTGCCAGCAGTTACAGGGACAGTCGGTCGCCCCGGGGGCGCTCCTACGAGCAGTACTTC	CASSYRDSRSPRGRSYEQYF	TRBV6-3	TRBJ2-7
TGTGCCAGCAGCTCCCCGGAAGACACGCTTGGCTACACCTTC	CASSSPEDTLGYTF	TRBV11-2	TRBJ1-2
TGCAGTGCCGCCTCCGGCCGACTAGTAAGGGAGAGCGGGGCCAACGTCCTGACTTTC	CSAASGRLVRESGANVLTF	TRBV20-1	TRBJ2-6
TGTGCCATCAGAAACAGCCACCACACTGAAGCTTTCTTT	CAIRNSHHTEAFF	TRBV10-3	TRBJ1-1
TGTGCCAGCTCACCACTTCCGGAGCTTCGATTTTTGAACACTGAAGCTTTCTTT	CASSPLPELRFLNTEAFF	TRBV18	TRBJ1-1
TGTGCCAGCAGTGAAAACCCGGGACAGGGCATGGAGTTAACCTATAATTCACCCCTCCACTTT	CASSENPGQGMELTYNSPLHF	TRBV6-4	TRBJ1-6
TGTGCCAGCAGTTCTCACAGGGGGCGTGGCTGGCCCTGCACTGAAGCTTTCTTT	CASSSHRGRGWPCTEAFF	TRBV6-5	TRBJ1-1
TGTGCCAGCACTCTATACCATACATTCTTTAACTATGGCTACACCTTC	CASTLYHTFFNYGYTF	TRBV6-2	TRBJ1-2
TGTGCCAGCAGTGAAGCACTGACCAGGACAGCCAAGGAGAACACTGAAGCTTTCTTT	CASSEALTRTAKENTEAFF	TRBV6-1	TRBJ1-1
TGTGCCAGCAAACGACTAGCGGGGAGCGAGCAGTACTTC	CASKRLAGSEQYF	TRBV6-2	TRBJ2-7
TGTGCCAGCAGCCAGTTCAGGGAGAGGTTCACCGCCTACGAGCAGTACTTC	CASSQFRERFTAYEQYF	TRBV14	TRBJ2-7
TGTGCCTTCCTAGGGTGTTGCACGCGTATTACCAGCAATCAGCCCCAGCATTTT	CAFLGCCTRITSNQPQHF	TRBV14	TRBJ1-5
TGTGCCAGCAGCTGGCTCGACGGAGCGAACACCGGGGAGCTGTTTTTT	CASSWLDGANTGELFF	TRBV13	TRBJ2-2
TGTGCCAGCTCACCGGGGGGGCCCTCTTATGAGCAGTTCTTC	CASSPGGPSYEQFF	TRBV18	TRBJ2-1
TGTGCCAGCAGCTTTGGGGCAGGGCAGCCCCAGCATTTT	CASSFGAGQPQHF	TRBV7-3	TRBJ1-5
TGTGCCAGCGAAACCGACAGCAATCAGCCCCAGCATTTT	CASETDSNQPQHF	TRBV6-4	TRBJ1-5
TGTGCCAGTAGTGACAGGTGCTATAATTCACCCCTCCACTTT	CASSDRCYNSPLHF	TRBV19	TRBJ1-6
TGTGCCAGCAGCTGGACCGGGGAGGCGAATTCACCCCTCCACTTT	CASSWTGEANSPLHF	TRBV5-6	TRBJ1-6
TGTGCCAGCAGCTTAAGACCTAGCTCTGGAAACACCATATATTTT	CASSLRPSSGNTIYF	TRBV7-3	TRBJ1-3
TGTGCCAGCAGCGTACCGGGGCTGTGGGCCTACGAGCAGTACTTC	CASSVPGLWAYEQYF	TRBV9	TRBJ2-7
TGTGCCTGGAGTGTACCCAGGGGTGAGCAGTTCTTC	CAWSVPRGEQFF	TRBV30	TRBJ2-1
TGCGCCAGCAGCTATACGTCGGACAATGAGCAGTTCTTC	CASSYTSDNEQFF	TRBV5-1	TRBJ2-1
TGTGCCAGCAGTCTGAACCTCGGGGGCACCGGGGAGCTGTTTTTT	CASSLNLGGTGELFF	TRBV27	TRBJ2-2
TGTGCTAGCAGCTTAGTCCGCGCAGGCTACACCTTC	CASSLVRAGYTF	TRBV7-7	TRBJ1-2
TGTGCCAGCAGCCCCCAGGGGTCCACTGGAAACACCATATATTTT	CASSPQGSTGNTIYF	TRBV6-6	TRBJ1-3
TGCGCCAGTAAACGGCTAGTGAACACTGAAGCTTTCTTT	CASKRLVNTEAFF	TRBV10-2	TRBJ1-1
TGCGCCAGCAGCCTAGCGGGCCCAGGGAGCTACGAGCAGTACTTC	CASSLAGPGSYEQYF	TRBV5-1	TRBJ2-7
TGCAGTGCTAGAACGGAAGGGGGGAGTAGCTCTGGAAACACCATATATTTT	CSARTEGGSSSGNTIYF	TRBV20-1	TRBJ1-3
TGTGGAATGGGGGCCAGGCAGGCCGGGACAGGGGGGTACTCTGGAAACACCATATATTTT	CGMGARQAGTGGYSGNTIYF	TRBV7-9	TRBJ1-3
TGTGCCAGCAGCCGCCTGGACAGGGGCGAGCAGTACTTC	CASSRLDRGEQYF	TRBV7-2	TRBJ2-7
TGTGCCAGCAGCCTAGGGGGGGCCTCCCCTCCAGCCAAAAACATTCAGTACTTC	CASSLGGASPPAKNIQYF	TRBV9	TRBJ2-4
TGTGCCACTACTAGCGGGAATCACAATGAGCAGTTCTTC	CATTSGNHNEQFF	TRBV15	TRBJ2-1
TGCAGTGCTAGAGATCCGGCCGACGGGACGGACTTGAACACTGAAGCTTTCTTT	CSARDPADGTDLNTEAFF	TRBV20-1	TRBJ1-1
TGCGCCAGCAGCCAAGCACTGGGGTACCTCGGGGCGGGTTCTGGGGGGAACACTGAAGCTTTCTTT	CASSQALGYLGAGSGGNTEAFF	TRBV4-1	TRBJ1-1
TGTGCCAGCATCCGGCACCTGGACACTAATGAAAAACTGTTTTTT	CASIRHLDTNEKLFF	TRBV28	TRBJ1-4
TGTGCCAGCGGGGCCCCCACAGATACGCAGTATTTT	CASGAPTDTQYF	TRBV12-3	TRBJ2-3
TGTGCCAGCAGTTTAGCCAGGACGGTGAACACTGAAGCTTTCTTT	CASSLARTVNTEAFF	TRBV12-4	TRBJ1-1
TGTGCCAGCAGGGGGACAGCCGTCAATCAGCCCCAGCATTTT	CASRGTAVNQPQHF	TRBV6-6	TRBJ1-5
TGTGCCAGCACCCGACCAGGACAGCCCCAGCATTTT	CASTRPGQPQHF	TRBV6-5	TRBJ1-5
TGTGCCAGCAGTATGGCAGGGGATCGAACAACTGAAGCTTTCTTT	CASSMAGDRTTEAFF	TRBV27	TRBJ1-1
TGTGCCAGCAGCTTGGACGTTTGGGACGATGAGCAGTTCTTC	CASSLDVWDDEQFF	TRBV11-3	TRBJ2-1
TGCAGTGCTAGAGAAACCGGGACAGGGGGCGCCTGCACAGATACGCAGTATTTT	CSARETGTGGACTDTQYF	TRBV20-1	TRBJ2-3
TGTGCCAGCAGTTATCTAGCGCGGGGGGGTTACACCGGGGAGCTGTTTTTT	CASSYLARGGYTGELFF	TRBV6-5	TRBJ2-2
TGTGCCAGCAGCTTAGGGGGAGAGAACCACGCGGACAGGGGGCCTCGCGGGGAGCTGTTTTTT	CASSLGGENHADRGPRGELFF	TRBV7-9	TRBJ2-2
TGTGCCAGCAGCGTACCCGGGCCTCGAAACAGGTTGGGCCCTGAAGCTTTCTTT	CASSVPGPRNRLGPEAFF	TRBV9	TRBJ1-1
TGTGCCAGCAGTCCAATTGTCAAAGTGGAATATGGCTACACCTTC	CASSPIVKVEYGYTF	TRBV2	TRBJ1-2
TGTGCCACCAGTGATAAGCGGCGGGAGGGGGTCACTGAAGCTTTCTTT	CATSDKRREGVTEAFF	TRBV24-1	TRBJ1-1
TGCGCCAGCAGCCAAGATCCACGACGGGAATACTATGGCTACACCTTC	CASSQDPRREYYGYTF	TRBV4-1	TRBJ1-2
TGTGCCAGCAGCCCCGAGGACAGGGGAGAGAAAGAGACCCAGTACTTC	CASSPEDRGEKETQYF	TRBV3-1	TRBJ2-5
TGTGCCACCAGTGAGAAAAGACTAGCGGGGGGGCCTAGGCAAGAGACCCAGTACTTC	CATSEKRLAGGPRQETQYF	TRBV24-1	TRBJ2-5
TGTGCCACCTCCCCGACAGGGGAACAGGTGAACACTGAAGCTTTCTTT	CATSPTGEQVNTEAFF	TRBV24-1	TRBJ1-1
TGTGCCAGCAGTCGCTGGACAGGGGAGTCACCCCTCCACTTT	CASSRWTGESPLHF	TRBV6-5	TRBJ1-6
TGTGCCAGCTCACCACGTCACGGTACGGCCTACGAGCAGTACTTC	CASSPRHGTAYEQYF	TRBV18	TRBJ2-7
TGTGCCAGCAGCTTGGTAGAGGACGGGGCATCGAACAATAGCAATCAGCCCCAGCATTTT	CASSLVEDGASNNSNQPQHF	TRBV5-4	TRBJ1-5
TGTGCCAGCAGCCCAACAGGGGCCAAAAACATTCAGTACTTC	CASSPTGAKNIQYF	TRBV3-1	TRBJ2-4
TGCAGTGCTAGGAGGGATGGGACAGGGCGTGCTTTCTTT	CSARRDGTGRAFF	TRBV20-1	TRBJ1-1
TGTGCCACCAGCCCAGTGGACAGGGGCTCCTACGAGCAGTACTTC	CATSPVDRGSYEQYF	TRBV15	TRBJ2-7
TGTGCCAGCAGTTTACTCCGATACGGGGACGAGCAGTACTTC	CASSLLRYGDEQYF	TRBV12-3	TRBJ2-7
TGTGCCAGCAGTTTGAGAAGCTCCTACGAGCAGTACTTC	CASSLRSSYEQYF	TRBV27	TRBJ2-7
TGTGCCAGCAGCCAAGGGGCTGACACTGAAGCTTTCTTT	CASSQGADTEAFF	TRBV5-4	TRBJ1-1
TGCGCCAGCAGCTTGGGAGGGGTTGCTGGAAACACCATATATTTT	CASSLGGVAGNTIYF	TRBV5-1	TRBJ1-3
TGTGCCAGCAGTTTTTGGGGAAAGGGGCTAGCTTTCTTT	CASSFWGKGLAFF	TRBV12-4	TRBJ1-1
TGTGCCAGCAGCCAAAGGTCCGGGGACGAATTATATGGCTACACCTTC	CASSQRSGDELYGYTF	TRBV3-1	TRBJ1-2
TGTGCCAGTCGCGGAACCCTATCCAATCAGCCCCAGCATTTT	CASRGTLSNQPQHF	TRBV28	TRBJ1-5
TGCGCCAGCAGTGAATCGGACGTAGCTCCAGGTAGCACAGATACGCAGTATTTT	CASSESDVAPGSTDTQYF	TRBV10-1	TRBJ2-3
TGTGCTAGCTTTGGGCCGGAGGTGGCCTACGAGCAGTACTTC	CASFGPEVAYEQYF	TRBV7-7	TRBJ2-7
TGTGCCTCTGTCACAGGGAAAACGGGGCTAGAGCAGTACTTC	CASVTGKTGLEQYF	TRBV25-1	TRBJ2-7
TGTGCCAGCAGCCACGGTCCGGGACTAGCGGGAGGAAACACCATATATTTT	CASSHGPGLAGGNTIYF	TRBV14	TRBJ1-3
TGTGCCAGCAGCTTGTACGGACTAGGCACAGATACGCAGTATTTT	CASSLYGLGTDTQYF	TRBV5-6	TRBJ2-3
TGTGCCACCAGCGGTAGCGGGGAATTCGAGACCCAGTACTTC	CATSGSGEFETQYF	TRBV24-1	TRBJ2-5
TGTGCCACCATGTGGTCCATAGCGGGAGGGGCTGGGGCCAACGTCCTGACTTTC	CATMWSIAGGAGANVLTF	TRBV14	TRBJ2-6
TGTGCCAGATCCGGGACATTCCATGAGACCCAGTACTTC	CARSGTFHETQYF	TRBV10-3	TRBJ2-5
TGTGCCACCTCAGGGGCCACCTTC	CATSGATF	TRBV24-1	TRBJ1-2
TGTGCCACCAGTGGTTGGACCTATCGTCGGGGAAATGAAAAACTGTTTTTT	CATSGWTYRRGNEKLFF	TRBV24-1	TRBJ1-4
TGTGCCATCAGTGAGTCACGAAACACTAATGAAAAACTGTTTTTT	CAISESRNTNEKLFF	TRBV10-3	TRBJ1-4
TGTGCCAGCAGTCCAACCCGGGACGAGCATGAGCAGTTCTTC	CASSPTRDEHEQFF	TRBV28	TRBJ2-1
TGCGCCAGCAGCCACGCGCCCTCGGGTCATCAGCCCCAGCATTTT	CASSHAPSGHQPQHF	TRBV4-1	TRBJ1-5
TGTGCCAGCCGGGAAGGGGTCCGTGGGGCTGGTAATGAAAAACTGTTTTTT	CASREGVRGAGNEKLFF	TRBV5-6	TRBJ1-4
TGTGCCAGCAAATTCTTCCATCTTAGGGGGGCTGAAAAACTGTTTTTT	CASKFFHLRGAEKLFF	TRBV2	TRBJ1-4
TGTGCCAGCAGCCCCCTCCCAGGACAGGGGGGGAGCAATCAGCCCCAGCATTTT	CASSPLPGQGGSNQPQHF	TRBV13	TRBJ1-5
TGTGCCATCGGGACTAGCGGGAGGAACTCCTACGAGCAGTACTTC	CAIGTSGRNSYEQYF	TRBV10-3	TRBJ2-7
TGTGCCAGCAGCCAGAAGGGTAGGTCCTATAATTCACCCCTCCACTTT	CASSQKGRSYNSPLHF	TRBV14	TRBJ1-6
TGTGCCAGCCTAGGGTTTGAAGGCTACACCTTC	CASLGFEGYTF	TRBV27	TRBJ1-2
TGTGCCAGCAGTTCCGCCGGGACCAGGGGCAATCAGCCCCAGCATTTT	CASSSAGTRGNQPQHF	TRBV6-1	TRBJ1-5
TGTGCCAGCAGTCTGGGGCCGTCAGATACGCAGTATTTT	CASSLGPSDTQYF	TRBV28	TRBJ2-3
TGTGCCAGCAGCCAAGGGACCCACACCGGGGAGCTGTTTTTT	CASSQGTHTGELFF	TRBV7-3	TRBJ2-2
TGTGCCACCAGTGACCTAGGTCCCTACGAGCAGTACTTC	CATSDLGPYEQYF	TRBV24-1	TRBJ2-7
TGTGCCAGCAGCTTAAGGGCGAGGGAAATCTACTATGGCTACACCTTC	CASSLRAREIYYGYTF	TRBV7-2	TRBJ1-2
TGTGCCAGCAGCGGCACTGGACGGGGAAAAGTAAACACCATATATTTT	CASSGTGRGKVNTIYF	TRBV12-3	TRBJ1-3
TGTGCCAGTAGTATCGGGGGGACAGAAAGCTCCTACGAGCAGTACTTC	CASSIGGTESSYEQYF	TRBV19	TRBJ2-7
TGTGCCAGCAGCGGTTCGGCAAATCAGCCCCAGCATTTT	CASSGSANQPQHF	TRBV7-4	TRBJ1-5
TGCATTCCTAGCGGGACAGGTAGGTACGAGCAGTACTTC	CIPSGTGRYEQYF	TRBV20-1	TRBJ2-7
TGCGCCAGCAGCCTTCATAGCGGGTACACAGATACGCAGTATTTT	CASSLHSGYTDTQYF	TRBV5-1	TRBJ2-3
TGTGCCAGCAGTTTATGTCTTTGGACAGGGAGGCGGACTAACTATGGCTACACCTTC	CASSLCLWTGRRTNYGYTF	TRBV27	TRBJ1-2
TGTGCCAGCAGTTCCGAAAATAAGGGCGCCTACGAGCAGTACTTC	CASSSENKGAYEQYF	TRBV6-5	TRBJ2-7
TGTGCCAGCAGCTTAGTGACTCGACAGGGGAGCGATAGCAATCAGCCCCAGCATTTT	CASSLVTRQGSDSNQPQHF	TRBV7-4	TRBJ1-5
TGTGCCTCTGCCGGGACCCGCTCCTACGAGCAGTACTTC	CASAGTRSYEQYF	TRBV7-9	TRBJ2-7
TGTGCCAGAAAGCGGTTTAATAAGAGCTCCTACAATGAGCAGTTCTTC	CARKRFNKSSYNEQFF	TRBV27	TRBJ2-1
TGTGCCAGCAGCGTAGACCCGCGGGTCTACAATGAGCAGTTCTTC	CASSVDPRVYNEQFF	TRBV9	TRBJ2-1
TGTGCCACCAGTGATTTGACCAGGGGCTTAAGCAATCAGCCCCAGCATTTT	CATSDLTRGLSNQPQHF	TRBV24-1	TRBJ1-5
TGTGCCAGCAGCTTAGAAGCTAGGGGCACAGATACGCAGTATTTT	CASSLEARGTDTQYF	TRBV7-9	TRBJ2-3
TGCGCCAGCAGCTTGACAGTAGAGGGCACGTATTTT	CASSLTVEGTYF	TRBV5-1	TRBJ2-3
TGTGCCTGGAGTGTCTCCATGATGACAGATACGCAGTATTTT	CAWSVSMMTDTQYF	TRBV30	TRBJ2-3
TGTGCCAGCAGCGGGGGACTAGTATTGGGCGAGCAGTACTTC	CASSGGLVLGEQYF	TRBV7-3	TRBJ2-7
TGTGCCAGTACAGGGGACTATAATCAGCCCCAGCATTTT	CASTGDYNQPQHF	TRBV19	TRBJ1-5
TGTGCCAGCAGCTCCCACCCGGGGCACGAGCAGTACTTC	CASSSHPGHEQYF	TRBV5-4	TRBJ2-7
TGTGCCAGTAGTATCGCGGGCCCAACCCAAGAGACCCAGTACTTC	CASSIAGPTQETQYF	TRBV19	TRBJ2-5
TGTGCCAGCAGTTCCCCTCGCTGTCTTTCCTACGAGCAGTACTTC	CASSSPRCLSYEQYF	TRBV27	TRBJ2-7
TGTGCCAGTATCCGGCACCGCGAGCAGTACTTC	CASIRHREQYF	TRBV6-5	TRBJ2-7
TGCGCCAGCAGCAGCCTCTTGGACAGAGGAAGAACTAATGAAAAACTGTTTTTT	CASSSLLDRGRTNEKLFF	TRBV5-1	TRBJ1-4
TGTGCCAGCAGCACCAACTACTACAGGGGGGGCTACGAGCAGTACTTC	CASSTNYYRGGYEQYF	TRBV13	TRBJ2-7
TGTGCCAGCATGGGGCGGCTTAACTACGAGCAGTACTTC	CASMGRLNYEQYF	TRBV27	TRBJ2-7
TGTGCCAGCAGTTGTCGGCGGGGAAGCTCCTACGAGCAGTACTTC	CASSCRRGSSYEQYF	TRBV6-5	TRBJ2-7
TGTGCCAGCACAGGGGAAGTAGAGACCCAGTACTTC	CASTGEVETQYF	TRBV25-1	TRBJ2-5
TGTGCCAGCAGTCCACACGAGGGACAGCGGGCTTATAGCAATCAGCCCCAGCATTTT	CASSPHEGQRAYSNQPQHF	TRBV27	TRBJ1-5
TGCACCCGGGACAGAGGGAACACTGAAGCTTTCTTT	CTRDRGNTEAFF	TRBV20-1	TRBJ1-1
TGTGCCAGCAGTGGGCGGGTGGAAGCTTTCTTT	CASSGRVEAFF	TRBV28	TRBJ1-1
TGCGCCAGCAGCCCGCGGACAGGGGGCCTACGCTACGAGCAGTACTTC	CASSPRTGGLRYEQYF	TRBV5-1	TRBJ2-7
TGCGCCAGCAGCCAAGGGGGGCTTGCGGGGGAGACCCAGTACTTC	CASSQGGLAGETQYF	TRBV4-1	TRBJ2-5
TGTGCCAGCAGTCGGATCTACGAGCAGTACTTC	CASSRIYEQYF	TRBV28	TRBJ2-7
TGTGCCAGCAGTGAACCAATACAGGGGAACACCGGGGAGCTGTTTTTT	CASSEPIQGNTGELFF	TRBV6-1	TRBJ2-2
TGTGCCAGCAGGGGGGGCAGTGTGGAAGCAGATACGCAGTATTTT	CASRGGSVEADTQYF	TRBV6-4	TRBJ2-3
TGCGCCAGCAGCCAGACGACAGGGTCCTACGAGCAGTACTTC	CASSQTTGSYEQYF	TRBV4-1	TRBJ2-7
TGTGCCCAACCCATAAGGGGTGCTGAAGCTTTCTTT	CAQPIRGAEAFF	TRBV6-5	TRBJ1-1
TGTGCCTGGGGGTTTTCACTAGCGGGAGGGCAAGGGTATGAGCAGTTCTTC	CAWGFSLAGGQGYEQFF	TRBV30	TRBJ2-1
TGTGCTAGTGGTTTGAATGACCTGAGGGGGGAGTACACCGGGGAGCTGTTTTTT	CASGLNDLRGEYTGELFF	TRBV12-5	TRBJ2-2
TGCAGTGCTAGCCCTTCTGCACTAGCGGGTTTAATCACCGGGGAGCTGTTTTTT	CSASPSALAGLITGELFF	TRBV20-1	TRBJ2-2
TGTGCCAGCAGCTTCCTCTCGGGGGGGGGGGCAGATACGCAGTATTTT	CASSFLSGGGADTQYF	TRBV11-2	TRBJ2-3
TGTGCCCGGGACGATACGCAGTATTTT	CARDDTQYF	TRBV6-1	TRBJ2-3
TGTGCCAGCCGGGTACAAGAGACCCAGTACTTC	CASRVQETQYF	TRBV5-4	TRBJ2-5
TGCGCCAGCAGCCGGGAGGACAGCAATCAGCCCCAGCATTTT	CASSREDSNQPQHF	TRBV4-1	TRBJ1-5
TGCAGTGCTAGAGTGAAGACAGGGGGAAATGAAAAACTGTTTTTT	CSARVKTGGNEKLFF	TRBV20-1	TRBJ1-4
TGTGCCAGCCCTGTTCCAGGAGCCCCCCCGACTGAAGCTTTCTTT	CASPVPGAPPTEAFF	TRBV7-9	TRBJ1-1
TGTGCCAGCATTGGGACTAGCGGGGTGACCTACGAGCAGTACTTC	CASIGTSGVTYEQYF	TRBV9	TRBJ2-7
TGCAGTGGGGCACCCGGGGAGCTGTTTTTT	CSGAPGELFF	TRBV20-1	TRBJ2-2
TGCAGTGCTAGAGGGGCGACAGGCCCCAGCTCCTACGAGCAGTACTTC	CSARGATGPSSYEQYF	TRBV20-1	TRBJ2-7
TGTGCCAGCAGTTTTTATCACAAACCTCATCAGCCCCAGCATTTT	CASSFYHKPHQPQHF	TRBV27	TRBJ1-5
TGTGCCAGCAGCCAAGCCCCCGACGGGAATGAGCAGTTCTTC	CASSQAPDGNEQFF	TRBV7-9	TRBJ2-1
TGTGCCAGCAGAAGGGACAGGGCGGCCTCTGGAAACACCATATATTTT	CASRRDRAASGNTIYF	TRBV6-2	TRBJ1-3
TGTGCCAGCAGTGACCAGGGACTGGGGGACTCTGGGGCCAACGTCCTGACTTTC	CASSDQGLGDSGANVLTF	TRBV6-4	TRBJ2-6
TGTGCCACCGGACTAGCGGGACATAGCTCCTACAATGAGCAGTTCTTC	CATGLAGHSSYNEQFF	TRBV24-1	TRBJ2-1
TGCAGCGTGAGCCCGGAGGGAGGAAACTCCTACGAGCAGTACTTC	CSVSPEGGNSYEQYF	TRBV29-1	TRBJ2-7
TGCGCCAGCCAAACCGGGACAGGGGTCGGGAACACTGAAGCTTTCTTT	CASQTGTGVGNTEAFF	TRBV10-1	TRBJ1-1
TGCAGTGCTAGAGACCTTTTTCGGACATATGGCTACACCTTC	CSARDLFRTYGYTF	TRBV20-1	TRBJ1-2
TGTGCCAGCAAACACTTTTGGCAGGGGAACAACATTCAGTACTTC	CASKHFWQGNNIQYF	TRBV13	TRBJ2-4
TGCGCCAGCAGCCGGACCCTATACGAGCAGTACTTC	CASSRTLYEQYF	TRBV4-3	TRBJ2-7
TGTGCCAGCAGCACGGGGGTGCATAATTCACCCCTCCACTTT	CASSTGVHNSPLHF	TRBV7-4	TRBJ1-6
TGCGCCAGCAAAATAACGTTTATCCACCCAGCGGGAGTAGCAACAGATACGCAGTATTTT	CASKITFIHPAGVATDTQYF	TRBV10-1	TRBJ2-3
TGTGCCAGCAGAATGGGGGCAAATTCACCCCTCCACTTT	CASRMGANSPLHF	TRBV12-3	TRBJ1-6
TGTGCCAGCAGCTTCCCCCTGGGGGAACGCACACACGGTGGCTACACCTTC	CASSFPLGERTHGGYTF	TRBV7-9	TRBJ1-2
TGTGCCAGCAGTCGACCCCGGACTGAAGCTTTCTTT	CASSRPRTEAFF	TRBV27	TRBJ1-1
TGCGCCAGCAGTGAGTCTGGGCCGAGTAAGTTGGGCTACACCTTC	CASSESGPSKLGYTF	TRBV10-1	TRBJ1-2
TGTGCCCGAAGGGGGGACGAGCAGTACTTC	CARRGDEQYF	TRBV2	TRBJ2-7
TGTGCCAGCAGGACGCTAGCGGGATACAATGAGCAGTTCTTC	CASRTLAGYNEQFF	TRBV7-3	TRBJ2-1
TGTGCCAGCAGCCATTCAGGGACAATGGTCAAGCAATCGTACGAGCAGTACTTC	CASSHSGTMVKQSYEQYF	TRBV11-3	TRBJ2-7
TGTGCCAGCAGTTTATTTGGGACGTATGCTTATAGCAATCAGCCCCAGCATTTT	CASSLFGTYAYSNQPQHF	TRBV28	TRBJ1-5
TGTGCCAGCAGGCCAATATTGCAACAGCCCCAGCATTTT	CASRPILQQPQHF	TRBV7-9	TRBJ1-5
TGTGCCAGCAGCCAAGAAGCACCTGGCAATCAGCCCCAGCATTTT	CASSQEAPGNQPQHF	TRBV14	TRBJ1-5
TGTGCCAGCAGCGGACCCCGGGGGGGCAAAGCAACGGTCAAGGGCGAGCAGTACTTC	CASSGPRGGKATVKGEQYF	TRBV9	TRBJ2-7
TGTGCCAGCAGCCCGGACAGTCCCTCTGGGGCCAACGTCCTGACTTTC	CASSPDSPSGANVLTF	TRBV5-4	TRBJ2-6
TGTGCCAGCAGCCCCGAGTCCCAGGGGGCTTCCTACGAGCAGTACTTC	CASSPESQGASYEQYF	TRBV7-4	TRBJ2-7
TGTGCCAGCTCACCACCCTCGGAGGGGCCCCAAGAGACCCAGTACTTC	CASSPPSEGPQETQYF	TRBV18	TRBJ2-5
TGTGCCAGCAGCTCTGACGGCTACGAGCAGTACTTC	CASSSDGYEQYF	TRBV7-2	TRBJ2-7
TGTGCCAGCAGTGGCTCCGGGACGCGTGCAACTAATGAAAAACTGTTTTTT	CASSGSGTRATNEKLFF	TRBV6-1	TRBJ1-4
TGCAGTGCTCTCCCGGGACTTAACAATGAGCAGTTCTTC	CSALPGLNNEQFF	TRBV20-1	TRBJ2-1
TGCGCCAGCAGCTTAATGCTCGGGTTTATCTACACCTTC	CASSLMLGFIYTF	TRBV5-1	TRBJ1-2
TGCGCCAGCAGTCTTTGGGGAGTTTCTGGGGCCAACGTCCTGACTTTC	CASSLWGVSGANVLTF	TRBV10-2	TRBJ2-6
TGTGCCACCAGTGATTCCCGTAGGGGACTGGATCATGAGCAGTTCTTC	CATSDSRRGLDHEQFF	TRBV24-1	TRBJ2-1
TGCAGTGCTACGGACAGGCGGTGCTCCTACAATGAGCAGTTCTTC	CSATDRRCSYNEQFF	TRBV20-1	TRBJ2-1
TGTGCCAGCAGTCTAATGGACAGGGAACTAAACTACGAGCAGTACTTC	CASSLMDRELNYEQYF	TRBV27	TRBJ2-7
TGCGCCAGCCGGCAGGGAGGAACACCCTATGGCTACACCTTC	CASRQGGTPYGYTF	TRBV10-1	TRBJ1-2
TGTGCCAGCAGCAGGGGCGCAATGAACACTGAAGCTTTCTTT	CASSRGAMNTEAFF	TRBV13	TRBJ1-1
TGTGCCACCAGTGACCAGGGCGCTCAGCCCCAGCATTTT	CATSDQGAQPQHF	TRBV24-1	TRBJ1-5
TGTGCCAGTAGTAATGTAAACTCCGGACTAGGCCCCTACGAGCAGTACTTC	CASSNVNSGLGPYEQYF	TRBV19	TRBJ2-7
TGTGCCAGTTGGGGGGGCACTAGCTCCTACAATGAGCAGTTCTTC	CASWGGTSSYNEQFF	TRBV19	TRBJ2-1
TGCAGTGCCCACAAGGGAAACACCATATATTTT	CSAHKGNTIYF	TRBV20-1	TRBJ1-3
TGCGCCAGCAGAAGACAGGGAACCCACACTGAAGCTTTCTTT	CASRRQGTHTEAFF	TRBV5-1	TRBJ1-1
TGTGCCAGCAGCTTAGAACTCCAGTCCACAGATACGCAGTATTTT	CASSLELQSTDTQYF	TRBV11-2	TRBJ2-3
TGCAGTGCCCTTCAGAACTATGTAACCGGTAACTATGGCTACACCTTC	CSALQNYVTGNYGYTF	TRBV20-1	TRBJ1-2
TGTGCCAGCCACAGGGACCCGAGGGCGAACCGTCAGCCCCAGCATTTT	CASHRDPRANRQPQHF	TRBV3-1	TRBJ1-5
TGTGCCAGCAGCGGAAGGACATCTGCGAATCACCATGAGCAGTTCTTC	CASSGRTSANHHEQFF	TRBV7-2	TRBJ2-1
TGTGCCAGCAAAGGGACAGGTCGTAGCACAGATACGCAGTATTTT	CASKGTGRSTDTQYF	TRBV9	TRBJ2-3
TGTGCCAGCAGCTCCACACCCTACGAGCAGTACTTC	CASSSTPYEQYF	TRBV13	TRBJ2-7
TGTGCCAGCAGCGTACTCCATACGGGACAGGGCCCTCTCTACGAGCAGTACTTC	CASSVLHTGQGPLYEQYF	TRBV9	TRBJ2-7
TGCAGTGCTAGAGTTGCGGTAACTGAAGCTTTCTTT	CSARVAVTEAFF	TRBV20-1	TRBJ1-1
TGTGCCAGCAGCATCCCCTCGACGGAAATAGACCGTAGAGAGCGATACAATGAGCAGTTCTTC	CASSIPSTEIDRRERYNEQFF	TRBV7-8	TRBJ2-1
TGTGCCAGCAGCGTAGTCCCGGGACAGAATGAAAAACTGTTTTTT	CASSVVPGQNEKLFF	TRBV9	TRBJ1-4
TGTGCTAGTGGTTTGCTGGGACCGGGGCGCAAAGAGACCCAGTACTTC	CASGLLGPGRKETQYF	TRBV12-5	TRBJ2-5
TGTGCCAGTAGTATAGCTAGCGTTAGTTCCTACGAGCAGTACTTC	CASSIASVSSYEQYF	TRBV19	TRBJ2-7
TGCGCCAGCAGCTCTCCCTCAGGAGAGGAAAAACTGTTTTTT	CASSSPSGEEKLFF	TRBV10-1	TRBJ1-4
TGTGCCTGGGGGGGGGGTAATGAGCAGTTCTTC	CAWGGGNEQFF	TRBV30	TRBJ2-1
TGTGCCAACCGGAGACAGGGTCAGCCCCAGCATTTT	CANRRQGQPQHF	TRBV27	TRBJ1-5
TGTGCCAGCAGTGAAACAGGGGTTAATTCCTACGAGCAGTACTTC	CASSETGVNSYEQYF	TRBV2	TRBJ2-7
TGTGCCAGCAGCTTACCCGCACTATGCGAGCAGTACTTC	CASSLPALCEQYF	TRBV11-1	TRBJ2-7
TGTGCCAGCAGCCAAGATCTGAGCTGCGGGACAGGAATATCAAGCTCTGGAAACACCATATATTTT	CASSQDLSCGTGISSSGNTIYF	TRBV3-1	TRBJ1-3
TGCAGTGCTTACGTACCACAGGAAGACAGGGCCCGGACTGAAGCTTTCTTT	CSAYVPQEDRARTEAFF	TRBV20-1	TRBJ1-1
TGCAGTGCTAGCATTACGAGTAAGCTCTCCTACGAGCAGTACTTC	CSASITSKLSYEQYF	TRBV20-1	TRBJ2-7
TGTGCCAGCAGCGTAGTCGGGACAGGGGGATACGAGCAGTACTTC	CASSVVGTGGYEQYF	TRBV9	TRBJ2-7
TGCAGTGCCAGGCGGGGCCCCTACGAGCAGTACTTC	CSARRGPYEQYF	TRBV20-1	TRBJ2-7
TGCGCCACAAGGGGAACGCGGCCCCGCCAAGAGACCCAGTACTTC	CATRGTRPRQETQYF	TRBV10-1	TRBJ2-5
TGCGCCAGCAGCCAAGTGCCCGGAGTCACAGATACGCAGTATTTT	CASSQVPGVTDTQYF	TRBV4-1	TRBJ2-3
TGTGCCACCAGTGATTTGCCCGGACAGGACCTCTATGGCTACACCTTC	CATSDLPGQDLYGYTF	TRBV24-1	TRBJ1-2
TGTGCCAGCAGCTTCAGGGGCTATCCGGGCACGAACACCGGGGAGCTGTTTTTT	CASSFRGYPGTNTGELFF	TRBV7-3	TRBJ2-2
TGTGCCAGCAGTGACGGGGCGGGGCCCTACGAGCAGTACTTC	CASSDGAGPYEQYF	TRBV6-4	TRBJ2-7
TGTGCCAGCTCACCTACTAAAGGGGGGGCGATAGACAATGAGCAGTTCTTC	CASSPTKGGAIDNEQFF	TRBV18	TRBJ2-1
TGTGCCAGCAGCCAAGACATCGGGGGTAATTCACCCCTCCACTTT	CASSQDIGGNSPLHF	TRBV14	TRBJ1-6
TGTGCCAGCAGCTTAAGGTGGACAGGGGGCGGAGATACGCAGTATTTT	CASSLRWTGGGDTQYF	TRBV7-3	TRBJ2-3
TGCAGTGCTAGAGGGATTGAATCCCCCACCGGGGAGCTGTTTTTT	CSARGIESPTGELFF	TRBV20-1	TRBJ2-2
TGTGCCATATCGGAATTTGTCCGAGAGACCCAGTACTTC	CAISEFVRETQYF	TRBV5-4	TRBJ2-5
TGTGCCAGCAGCCCCCTAGCGGGTTTTAGCCCGGTTGAGCAGTACTTC	CASSPLAGFSPVEQYF	TRBV13	TRBJ2-7
TGTGCCAGCACCTGGACAGAAGGTCGCTCCTACGAGCAGTACTTC	CASTWTEGRSYEQYF	TRBV5-4	TRBJ2-7
TGTGCCAGCAGCGACGGGGAATTGAACACTGAAGCTTTCTTT	CASSDGELNTEAFF	TRBV7-3	TRBJ1-1
TGTGCCACCAGTGACCCCAAAGGAGGGAAGGCCCGAGATTCACCCCTCCACTTT	CATSDPKGGKARDSPLHF	TRBV24-1	TRBJ1-6
TGTGCCACCAGTGATGGGACTATGGGTGGGTGTCAGCCCCAGCATTTT	CATSDGTMGGCQPQHF	TRBV24-1	TRBJ1-5
TGTGCCAGCAGTTTCTCCCGCGGGTTAGAGTCCTACGAGCAGTACTTC	CASSFSRGLESYEQYF	TRBV12-4	TRBJ2-7
TGTGCCAGCAGTTTAGGTCCGGGACAGAAAGCTAACTATGGCTACACCTTC	CASSLGPGQKANYGYTF	TRBV27	TRBJ1-2
TGTGCCAGCGTAATACGGACAGGAGGTAACTATGGCTACACCTTC	CASVIRTGGNYGYTF	TRBV6-4	TRBJ1-2
TGTGCCAGCTCACTCGACCTCAACTATGGCTACACCTTC	CASSLDLNYGYTF	TRBV18	TRBJ1-2
TGCAGTGCAGGGGATGAAAAACTGTTTTTT	CSAGDEKLFF	TRBV20-1	TRBJ1-4
TGCAGTGCTAGGACGGAGGAGAGCAATCAGCCCCAGCATTTT	CSARTEESNQPQHF	TRBV20-1	TRBJ1-5
TGCGCCAGCAGCTTGGCCGAGAGGAGGGGAAATTCACCCCTCCACTTT	CASSLAERRGNSPLHF	TRBV5-1	TRBJ1-6
TGTGCCAGCAGCTTCGGGGGGCCCGGGTCCTACAATGAGCAGTTCTTC	CASSFGGPGSYNEQFF	TRBV16	TRBJ2-1
TGTGCCAGCAGCTTCCCGGGACTAGCGGGTGAGCAGTTCTTC	CASSFPGLAGEQFF	TRBV7-3	TRBJ2-1
TGTGCCAGCAGCAGTTCAGACAGGCGCTTTGACGATAGAGGGGATCCCCCTGAAGCTTTCTTT	CASSSSDRRFDDRGDPPEAFF	TRBV13	TRBJ1-1
TGTGCCAGCAGCTTGACAGGGGGCTACAATGAGCAGTTCTTC	CASSLTGGYNEQFF	TRBV5-6	TRBJ2-1
TGTGCCAGCAGCTTAGGGACCGTGGATGCAACTAATGAAAAACTGTTTTTT	CASSLGTVDATNEKLFF	TRBV11-2	TRBJ1-4
TGTGCCAGCACCCCTTACAGCCGGGATTCCGAGCAGTACTTC	CASTPYSRDSEQYF	TRBV6-4	TRBJ2-7
TGTGCCAGCAATTCCCTAGGTTATAAAGGGGACAGTCGTCGCCAAGAGACCCAGTACTTC	CASNSLGYKGDSRRQETQYF	TRBV12-3	TRBJ2-5
TGTGCCTGGAGTGGGTCAGGGGCCTACGAGCAGTACTTC	CAWSGSGAYEQYF	TRBV30	TRBJ2-7
TGTGCCAGCAGCTTAGGGAGAGGCTACAATGAGCAGTTCTTC	CASSLGRGYNEQFF	TRBV11-3	TRBJ2-1
TGTGCCAGCAGCTCCCCTGGACGATCGGACACTGAAGCTTTCTTT	CASSSPGRSDTEAFF	TRBV7-9	TRBJ1-1
TGTGCCAGCAGTTCCCCTTCCATCCGTGGCTACACCTTC	CASSSPSIRGYTF	TRBV28	TRBJ1-2
TGTGCCAGCAGTGACCCACCCCGGGGGGGGGGGGTGGTAGCCAAAAACATTCAGTACTTC	CASSDPPRGGGVVAKNIQYF	TRBV6-4	TRBJ2-4
TGTGCCACCAGTGAAGTTCTTAGCTACAATGAGCAGTTCTTC	CATSEVLSYNEQFF	TRBV24-1	TRBJ2-1
TGCAGCGTTTCCGGACTAGCGGGCTACAATGAGCAGTTCTTC	CSVSGLAGYNEQFF	TRBV29-1	TRBJ2-1
TGTGCCAGCAGTTTAGTGCTAGCGGTAGACTCATACAATGAGCAGTTCTTC	CASSLVLAVDSYNEQFF	TRBV12-3	TRBJ2-1
TGTGCCAGCAGTGAATATCGGACAGATGGCTACACCTTC	CASSEYRTDGYTF	TRBV25-1	TRBJ1-2
TGTGCCAGCAGCTTTGGGGGCGGCCCCCGCAATCAGCCCCAGCATTTT	CASSFGGGPRNQPQHF	TRBV11-3	TRBJ1-5
TGTGCCAGCAGTGAAGAGCGGGAAGGGGGTAATGAAAAACTGTTTTTT	CASSEEREGGNEKLFF	TRBV25-1	TRBJ1-4
TGCGCCAGCCCGTATCCGGGAGAGACCCAGTACTTC	CASPYPGETQYF	TRBV5-1	TRBJ2-5
TGTGCCACCAACCGGGAGGCTAGCACAGATACGCAGTATTTT	CATNREASTDTQYF	TRBV24-1	TRBJ2-3
TGCGCCAGCAGCGGGGTATTCAATCAGCCCCAGCATTTT	CASSGVFNQPQHF	TRBV5-1	TRBJ1-5
TGTGCCAGCAGTGGAGCCAACTGGCTGTCCTACGAGCAGTACTTC	CASSGANWLSYEQYF	TRBV27	TRBJ2-7
TGTGCCAGCAGTCGCATTAGCACAGATACGCAGTATTTT	CASSRISTDTQYF	TRBV6-6	TRBJ2-3
TGCAGTGCTAGCCTGAGGGTATACTACGAGCAGTACTTC	CSASLRVYYEQYF	TRBV20-1	TRBJ2-7
TGTGCCAGCTCACCTCCTAGCGGGATATGGCTCTATGGCTACACCTTC	CASSPPSGIWLYGYTF	TRBV18	TRBJ1-2
TGTGCCTGGAGCCGTAGTGGGGCCAACGTCCTGACTTTC	CAWSRSGANVLTF	TRBV30	TRBJ2-6
TGTGCCAGCAGCTTAGATGGCTCAACGGACAGGGGCTCCTACGAGCAGTACTTC	CASSLDGSTDRGSYEQYF	TRBV11-3	TRBJ2-7
TGTGCTAGTGGTTTGGTACGTCTGGGTTACCTGGTAAGTGATGAAAAACTGTTTTTT	CASGLVRLGYLVSDEKLFF	TRBV12-5	TRBJ1-4
TGTGCCAGCAGGACTAGTGACCACCCCTGGGCCAACGTCCTGACTTTC	CASRTSDHPWANVLTF	TRBV6-8	TRBJ2-6
TGTACCTATTGGGGGCGGGTGACAACCGGGGAGCTGTTTTTT	CTYWGRVTTGELFF	TRBV6-5	TRBJ2-2
TGTGCCAGCAGCGCCCTCCGGCAGGGACAGGGGTCTGGCTACGAGCAGTACTTC	CASSALRQGQGSGYEQYF	TRBV13	TRBJ2-7
TGTGCCAGCGAGCCGGACAGGAGGAACGAGCAGTACTTC	CASEPDRRNEQYF	TRBV5-8	TRBJ2-7
TGTGCCAGCCCAGAAGAGCCCCAGCATTTT	CASPEEPQHF	TRBV13	TRBJ1-5
TGTGCCAGCAGCTTAGTCCCCTGGGGGACAGGGGGGGGCTACACCTTC	CASSLVPWGTGGGYTF	TRBV7-3	TRBJ1-2
TGCGCCAGCAGCGAGTTTCCCGTTAGGGGGGGCCGTTATGAGACCCAGTACTTC	CASSEFPVRGGRYETQYF	TRBV5-1	TRBJ2-5
TGTGCCAGCAGCATCCAGGGGGGGTTACACACCGGGGAGCTGTTTTTT	CASSIQGGLHTGELFF	TRBV7-9	TRBJ2-2
TGTGCCAGCAGTCGGGGCGGGAGTTTTACGCTGCTGCTGTTTTTT	CASSRGGSFTLLLFF	TRBV6-5	TRBJ2-2
TGCGCCAGCAGCCAGGCCGCGGTCGTCCTGAACACTGAAGCTTTCTTT	CASSQAAVVLNTEAFF	TRBV4-1	TRBJ1-1
TGCAGTGCTAGAGACGTGGGGACAGGGGGACATCAGCCCCAGCATTTT	CSARDVGTGGHQPQHF	TRBV20-1	TRBJ1-5
TGCGCCAGCAGCCAAGTCTGGACAGGGGACTACACTGAAGCTTTCTTT	CASSQVWTGDYTEAFF	TRBV4-1	TRBJ1-1
TGTGCCAGCAGCCCCGTGGGACCGACAGGGAGGTCAGGGGGCTACACCTTC	CASSPVGPTGRSGGYTF	TRBV14	TRBJ1-2
TGTGCCAGCAGGTTCAAGCGTAGAACTCAGCCCCAGCATTTT	CASRFKRRTQPQHF	TRBV6-5	TRBJ1-5
TGTGCCAGCAGCATTAAGGGCTCTGGGGCCAACGTCCTGACTTTC	CASSIKGSGANVLTF	TRBV5-5	TRBJ2-6
TGTGCCAGCAGCCCAGTCAGTAAAGGCAAGGGTCCTTCTAACTATGGCTACACCTTC	CASSPVSKGKGPSNYGYTF	TRBV5-4	TRBJ1-2
TGCAGTGCTAGAGATTTGGGGGGTACCGACAATGAGCAGTTCTTC	CSARDLGGTDNEQFF	TRBV20-1	TRBJ2-1
TGTGCCAGCAGCTTTCTGCACAGGCATTGCAATCAGCCCCAGCATTTT	CASSFLHRHCNQPQHF	TRBV5-6	TRBJ1-5
TGTGCCAGCAGTTTACATCCCGGGACAGCCTACGAGCAGTACTTC	CASSLHPGTAYEQYF	TRBV12-4	TRBJ2-7
TGTGCCAGTATATGCTACGAGCAGTACTTC	CASICYEQYF	TRBV19	TRBJ2-7
TGTGCCAGCAGCGTGGCGTGTTTTCGGGGCTGGACCCATGAAAAACTGTTTTTT	CASSVACFRGWTHEKLFF	TRBV11-1	TRBJ1-4
TGTGCCAAGGACACAGATACGCAGTATTTT	CAKDTDTQYF	TRBV19	TRBJ2-3
TGTGCCAGCAGCCCAAGCCGGGACGGTAGCTATGGCTACACCTTC	CASSPSRDGSYGYTF	TRBV9	TRBJ1-2
TGTGCCAGCAGTTTAGCGGGTAGCCATGAGCAGTTCTTC	CASSLAGSHEQFF	TRBV27	TRBJ2-1
TGTGCCAGCAGCGGGAGAGGTGCGGAAATTCTTGAGACCCAGTACTTC	CASSGRGAEILETQYF	TRBV7-4	TRBJ2-5
TGTGCCAGCAGCCCGGAGGGGGGGACAGGGGCTGAAAAACTGTTTTTT	CASSPEGGTGAEKLFF	TRBV7-7	TRBJ1-4
TGTGCCAGCAGTGAATATCTGACACCGAAAAGGGCCGATGAAGCTTTCTTT	CASSEYLTPKRADEAFF	TRBV25-1	TRBJ1-1
TGTGCCAGCTCACCACGGGGGGGGCGACAGCCCCAGCATTTT	CASSPRGGRQPQHF	TRBV18	TRBJ1-5
TGTGCCAGCAGCTTCGTTCCCGCCGGGACAGGCAGCGAAGAGACCCAGTACTTC	CASSFVPAGTGSEETQYF	TRBV7-9	TRBJ2-5
TGCAGTGCTAGAGAGGGACGTTCAACCTACGAGCAGTACTTC	CSAREGRSTYEQYF	TRBV20-1	TRBJ2-7
TGTGCCAGCAGTGGGGGGGGCTATGGCTACACCTTC	CASSGGGYGYTF	TRBV6-3	TRBJ1-2
TGTGCCAGCAACCCCAGGCAGGGTGGCGCCAAAAACATTCAGTACTTC	CASNPRQGGAKNIQYF	TRBV5-6	TRBJ2-4
TGCAGTGCCCGGGTCCCAGGGAATCAGGGGGCTAACTATGGCTACACCTTC	CSARVPGNQGANYGYTF	TRBV20-1	TRBJ1-2
TGCGCCAGCAAGGGGGGCACAGCTTTCTTT	CASKGGTAFF	TRBV5-1	TRBJ1-1
TGTGCCAGTATTCGGACTAGCCTCTACTCCTACGAGCAGTACTTC	CASIRTSLYSYEQYF	TRBV19	TRBJ2-7
TGTGCCAGCAAGGCCCTTTACCAACGTACGGGCACCGGGGAGCTGTTTTTT	CASKALYQRTGTGELFF	TRBV5-6	TRBJ2-2
TGTGCTAGCCACGCGACCGGACAGGGGGACATTCAGTACTTC	CASHATGQGDIQYF	TRBV7-7	TRBJ2-4
TGTGCCACCCGGAGCCGCGGGTCACCCCTCCACTTT	CATRSRGSPLHF	TRBV24-1	TRBJ1-6
TGCAGCGTTGAGGCCCGGGGGGGAGGGAACACCGGGGAGCTGTTTTTT	CSVEARGGGNTGELFF	TRBV29-1	TRBJ2-2
TGTGCCAGTAGGGCCGGGACTAGCGGATCTCAGTCCTACAATGAGCAGTTCTTC	CASRAGTSGSQSYNEQFF	TRBV19	TRBJ2-1
TGTGCCAGCATCCCGATCGACCACCCCTACGAGCAGTACTTC	CASIPIDHPYEQYF	TRBV28	TRBJ2-7
TGCGCCTCCCAGGGGGGGGGGGGCTACACCTTC	CASQGGGGYTF	TRBV10-1	TRBJ1-2
TGCAGTGCTAGAGCGGTTCCAGGGCGAATTCAGTACTTC	CSARAVPGRIQYF	TRBV20-1	TRBJ2-4
TGTGCCTGGTTGAGGGTGGGGAATTTCTACGAGCAGTACTTC	CAWLRVGNFYEQYF	TRBV30	TRBJ2-7
TGTGCCAGCAGCCGTCGAAAGGGGGCCGTTAACTATGGCTACACCTTC	CASSRRKGAVNYGYTF	TRBV4-2	TRBJ1-2
TGTGCCACCAGTGATTGGACCAGGGGGGTTAACTATGGCTACACCTTC	CATSDWTRGVNYGYTF	TRBV24-1	TRBJ1-2
TGTGCCAGAGCCCAGAGACCTAGGCCTCCTGTCGAGCAGTACTTC	CARAQRPRPPVEQYF	TRBV25-1	TRBJ2-7
TGTGCCAGGAGCGGATGGAGATTACACGAGCAGTACTTC	CARSGWRLHEQYF	TRBV28	TRBJ2-7
TGTGCCAGCAGCCAACAACCGGGACACGATTACGAGCAGTACTTC	CASSQQPGHDYEQYF	TRBV4-2	TRBJ2-7
TGCGCCAGCAGTGGAGCGGGAGTTACCACAGATACGCAGTATTTT	CASSGAGVTTDTQYF	TRBV10-1	TRBJ2-3
TGTGCCAGCAGTTTTACATACAAAGGGGCTAGCAATCAGCCCCAGCATTTT	CASSFTYKGASNQPQHF	TRBV27	TRBJ1-5
TGCGCCAGCAGCCACCATGTAGGGGGGGGGTATGGCTACACCTTC	CASSHHVGGGYGYTF	TRBV4-1	TRBJ1-2
TGCAGTGCCCTCCCGGGACTCCCTTCCTACGAGCAGTACTTC	CSALPGLPSYEQYF	TRBV20-1	TRBJ2-7
TGTGCCAGTAGCTGTACGATGACTGAAGCTTTCTTT	CASSCTMTEAFF	TRBV19	TRBJ1-1
TGTGCCAGCAGTTACACAGGGCATCCTGGAAACACCATATATTTT	CASSYTGHPGNTIYF	TRBV6-5	TRBJ1-3
TGTGCCAGCAGTTCTAACAGGGGGGGCTACACCTTC	CASSSNRGGYTF	TRBV27	TRBJ1-2
TGTGCCAGCAAGCCCGGGACTAGCGGGAGTTTGTACAATGAGCAGTTCTTC	CASKPGTSGSLYNEQFF	TRBV25-1	TRBJ2-1
TGCGCCAGCAGCCAAGATAAAACCGGACAGGATAGCGAGCAGTACTTC	CASSQDKTGQDSEQYF	TRBV4-3	TRBJ2-7
TGTGCCAGCCAAAGGGGGGGGGAGACGAGCTCCTACAATGAGCAGTTCTTC	CASQRGGETSSYNEQFF	TRBV6-1	TRBJ2-1
TGTGCTAGTGCGGACAGGGCCCGAGGGAACTATGGCTACACCTTC	CASADRARGNYGYTF	TRBV12-5	TRBJ1-2
TGTGCCAGCAGCTTAGCTAGCGGGGGTGGATATGAGCAGTTCTTC	CASSLASGGGYEQFF	TRBV11-3	TRBJ2-1
TGTGCCGGTAGGCGTCTGAACACTGAAGCTTTCTTT	CAGRRLNTEAFF	TRBV24-1	TRBJ1-1
TGTGCCTGGACGGGTCGGGTCAGCAATCAGCCCCAGCATTTT	CAWTGRVSNQPQHF	TRBV27	TRBJ1-5
TGTGCCAGCAGTTTATTTTCGTGGAGACAGCCCGGCACTGAAGCTTTCTTT	CASSLFSWRQPGTEAFF	TRBV27	TRBJ1-1
TGTGCCAGCAGTGCACACATCAGCAATCAGCCCCAGCATTTT	CASSAHISNQPQHF	TRBV27	TRBJ1-5
TGTGCCAGCAGGAGGGCAGTGACCTACGAGCAGTACTTC	CASRRAVTYEQYF	TRBV6-4	TRBJ2-7
TGTGCCAGCAGTGACGTCCGGGACAGGGGACCGAGCTCTGGGGCCAACGTCCTGACTTTC	CASSDVRDRGPSSGANVLTF	TRBV6-4	TRBJ2-6
TGTGCCAGCAGCTTAGCGCCTGTCGGGGTTAGCGAGCAGTACTTC	CASSLAPVGVSEQYF	TRBV11-3	TRBJ2-7
TGTGCCAGCAGTTACTCGATAAGGGGTGGGTTAGAGACCCAGTACTTC	CASSYSIRGGLETQYF	TRBV6-5	TRBJ2-5
TGCAGCGTTTTCGGGGTCCTTGATAACACCGGGGAGCTGTTTTTT	CSVFGVLDNTGELFF	TRBV29-1	TRBJ2-2
TGTGCCAGCAGCCAAGGGGGAGCGAACGGCTCCTACGAGCAGTACTTC	CASSQGGANGSYEQYF	TRBV14	TRBJ2-7
TGTGCCAGCAGTTACATGTCTTGGAGAGGCTCCTACGAGCAGTACTTC	CASSYMSWRGSYEQYF	TRBV6-5	TRBJ2-7
TGTGCCTACAAGGGGAGAATCCCCGGGGAGCTGTTTTTT	CAYKGRIPGELFF	TRBV9	TRBJ2-2
TGTGCCAGCAGGATCCGGAGAGACAACCAAGAGACCCAGTACTTC	CASRIRRDNQETQYF	TRBV2	TRBJ2-5
TGTGCCAGCAGTCGATCCGGCAGGAAGGGCTATGGCTACACCTTC	CASSRSGRKGYGYTF	TRBV11-3	TRBJ1-2
TGTGCCACCCGGGGGGGGAAGTCAAGCTCCTATAATTCACCCCTCCACTTT	CATRGGKSSSYNSPLHF	TRBV24-1	TRBJ1-6
TGTGCCAGCAGCATTTCGCCGGGACTCTCCCAGCCCCAGCATTTT	CASSISPGLSQPQHF	TRBV7-6	TRBJ1-5
TGTGTACAGGATCATGGGACTAGCGCTTTCAATGAGCAGTTCTTC	CVQDHGTSAFNEQFF	TRBV6-4	TRBJ2-1
TGCGCCAGCAGCCAAGCGACGGGCCGGGACAGGAAAGAGACCCAGTACTTC	CASSQATGRDRKETQYF	TRBV4-1	TRBJ2-5
TGTGCCAGCAGCTTAGCCGCAACGGCAGGGGGCAGCCACACTGAAGCTTTCTTT	CASSLAATAGGSHTEAFF	TRBV13	TRBJ1-1
TGCGCCAAAGACGGACAGGATAAGAGCAATCAGCCCCAGCATTTT	CAKDGQDKSNQPQHF	TRBV10-1	TRBJ1-5
TGTGCCAGCAGTTACTCGCCGCGGGACAGATTCGGGGGGTGGGAAACTGAAGCTTTCTTT	CASSYSPRDRFGGWETEAFF	TRBV6-2	TRBJ1-1
TGTGCCAGCAGCCAAGCTCGGGGGTTTGAAACTGAAGCTTTCTTT	CASSQARGFETEAFF	TRBV3-1	TRBJ1-1
TGTGCCAGCTCACCACCGACCGGGAACGAGCAGTACTTC	CASSPPTGNEQYF	TRBV18	TRBJ2-7
TGTGCCAGCAGCTCCCCTAGACGGAGCTCCTACAATGAGCAGTTCTTC	CASSSPRRSSYNEQFF	TRBV7-2	TRBJ2-1
TGCACGGGGGATAGCACAGATACGCAGTATTTT	CTGDSTDTQYF	TRBV20-1	TRBJ2-3
TGTGCCACCAGTGATACGACCCGTAGCTCTACCTACAATGAGCAGTTCTTC	CATSDTTRSSTYNEQFF	TRBV24-1	TRBJ2-1
TGTGCCAGCAGTCACACCTGCAAAACAGGGAATAACGAGCAGTACTTC	CASSHTCKTGNNEQYF	TRBV6-5	TRBJ2-7
TGTGCCAGCAGCCAAGGGTCCGGGGGTTGCAGGCGCCTCCCCTCACCCCTCCACTTT	CASSQGSGGCRRLPSPLHF	TRBV3-1	TRBJ1-6
TGCGCCAGCAGCCCCAACGTTAATAAGGGGGGGCTAAGAGAGACCCAGTACTTC	CASSPNVNKGGLRETQYF	TRBV4-1	TRBJ2-5
TGTGCCACCAGTGGGGTGACCGTACGCAGGTACGAGCAGTACTTC	CATSGVTVRRYEQYF	TRBV24-1	TRBJ2-7
TGCGCCAGCAGCCAAGATGAACGGAGGGCCTCTTCGCAGTATTTT	CASSQDERRASSQYF	TRBV4-1	TRBJ2-3
TGTGCCAGCAGCTCTAGACGTACCGCCTACAATGAGCAGTTCTTC	CASSSRRTAYNEQFF	TRBV5-6	TRBJ2-1
TGTGCCAGCAGCGGCGGCGCCGGGACAGGGGTAATTGAGGATGGCTACACCTTC	CASSGGAGTGVIEDGYTF	TRBV9	TRBJ1-2
TGTGCCAGCAGCTCGCTACGGGACAGGGTTGAGGCTTATGAAAAACTGTTTTTT	CASSSLRDRVEAYEKLFF	TRBV13	TRBJ1-4
TGTGCCTGGAGTGTAAGGAGAACGTTCTGCAGGAAAGAAAACATTCAGTACTTC	CAWSVRRTFCRKENIQYF	TRBV30	TRBJ2-4
TGTGCCTGGAGTGTACGTAGACTAGCGGGAAGTTGTAACACAGATACGCAGTATTTT	CAWSVRRLAGSCNTDTQYF	TRBV30	TRBJ2-3
TGTGCCAGCAGCTTGGAGGGGCGCTCTGGGGCCAACGTCCTGACTTTC	CASSLEGRSGANVLTF	TRBV5-8	TRBJ2-6
TGTGCCAGCAGCTCCCTGCAGGGGGGGGGCTACACCTTC	CASSSLQGGGYTF	TRBV12-4	TRBJ1-2
TGCGCCAGCAGCTTGAGGGGCCGACAGGGTCCGAGGATCACTGAAGCTTTCTTT	CASSLRGRQGPRITEAFF	TRBV5-1	TRBJ1-1
TGTGCCAGCAGCGACCAGGACAGGGGGACTGAAGCTTTCTTT	CASSDQDRGTEAFF	TRBV9	TRBJ1-1
TGTGCCAGGGACACCTTC	CARDTF	TRBV7-9	TRBJ1-2
TGTGCCAGCAGTCACTTGGAGGGGGAGTTGAAAAAGGGTTGCTACACCTTC	CASSHLEGELKKGCYTF	TRBV27	TRBJ1-2
TGTGCCAGCAGCACGGACAGGAATTCCTCGGGGTCTTATGAGCAGTTCTTC	CASSTDRNSSGSYEQFF	TRBV27	TRBJ2-1
TGTGCCAGCAGTTACTCATATATCCCGGGACTAGCGGGAGGGTCACCCCTCCACTTT	CASSYSYIPGLAGGSPLHF	TRBV6-5	TRBJ1-6
TGTGCCAGCAGTTTACACATGAATCAGCCCCAGCATTTT	CASSLHMNQPQHF	TRBV12-3	TRBJ1-5
TGTGCCAGCAGTTGTCCGTTCCGGGACGGACGGGACACTGAAGCTTTCTTT	CASSCPFRDGRDTEAFF	TRBV6-2	TRBJ1-1
TGTGCCAGCATCGGCGGCTCACGTGTAGAGCAGTTCTTC	CASIGGSRVEQFF	TRBV7-9	TRBJ2-1
TGTGCCAGCAGCCGGAAGGGAATTGACCCTGAAAAACTGTTTTTT	CASSRKGIDPEKLFF	TRBV11-3	TRBJ1-4
TGTGCCAGCAGTTGGCAGGGCTTAGTTCAGCCCCAGCATTTT	CASSWQGLVQPQHF	TRBV28	TRBJ1-5
TGTGCTAGTGGTTTGGCGTTGGAACCAGGCGGGGCTCCCTACGAGCAGTACTTC	CASGLALEPGGAPYEQYF	TRBV12-5	TRBJ2-7
TGTGCCAGCAGCCGCCAGGGGGGCGGCCCGACATCCAGCTCCTACAATGAGCAGTTCTTC	CASSRQGGGPTSSSYNEQFF	TRBV4-2	TRBJ2-1
TGTGCCAGTAGTATGACGGTAGGGACGAATGCAGCTGAAGCTTTCTTT	CASSMTVGTNAAEAFF	TRBV19	TRBJ1-1
TGCAGTGCTAGAGTCCCGGGACAGGGGCAGAATCCTGACACCGGGGAGCTGTTTTTT	CSARVPGQGQNPDTGELFF	TRBV20-1	TRBJ2-2
TGTGCCAGCGAAACTAGCGGGAGGGCCCCGAACACCGGGGAGCTGTTTTTT	CASETSGRAPNTGELFF	TRBV6-2	TRBJ2-2
TGTGCCAGCAGTGGGACAGGGAATTACTATGGCTACACCTTC	CASSGTGNYYGYTF	TRBV27	TRBJ1-2
TGCAGTGCAGTCGGGGACAATGAGCAGTTCTTC	CSAVGDNEQFF	TRBV20-1	TRBJ2-1
TGTGAAGGGGGGTACAATGAGCAGTTCTTC	CEGGYNEQFF	TRBV12-3	TRBJ2-1
TGTGCCAGCAGCTTCTGCCACGAAGGCCGGGACTTTTATGAGCAGTTCTTC	CASSFCHEGRDFYEQFF	TRBV5-4	TRBJ2-1
TGTGCCATCAGTGAGTCGCCCGTGACTAGCGAAGGTATGCTCCTCGACTACGAGCAGTACTTC	CAISESPVTSEGMLLDYEQYF	TRBV10-3	TRBJ2-7
TGTGCCAGCAACTGGGACAGGGACAATCAGCCCCAGCATTTT	CASNWDRDNQPQHF	TRBV6-1	TRBJ1-5
TGTGCCAGCAGCGGGACTAGCGGGAGAGGGGCAGATACGCAGTATTTT	CASSGTSGRGADTQYF	TRBV7-3	TRBJ2-3
TGTGCCAGCGGGCAGGGGGCCTATAGCAATCAGCCCCAGCATTTT	CASGQGAYSNQPQHF	TRBV4-2	TRBJ1-5
TGCGCCAGCAGCTTGGCGCGGGAGACTTCGCAGTTCTTC	CASSLARETSQFF	TRBV10-1	TRBJ2-1
TGTGCCAGCAGTTTCTATCGGGGATTCGGCGACCAAGAGACCCAGTACTTC	CASSFYRGFGDQETQYF	TRBV27	TRBJ2-5
TGTGCCAGCAGTTTTGGACTAGCGGGTCTAGTTTACGAGCAGTACTTC	CASSFGLAGLVYEQYF	TRBV6-9	TRBJ2-7
TGTGCCAGCAGCAGGGGGGGGAGCAATCAGCCCCAGCATTTT	CASSRGGSNQPQHF	TRBV6-4	TRBJ1-5
TGCGCCAGCAGTGAGGCGCACAGGGGGGGGGTGTGGATCGTGGGAATAGCTAACTATGGCTACACCTTC	CASSEAHRGGVWIVGIANYGYTF	TRBV10-1	TRBJ1-2
TGTGCCAGCAGCGGAGGGACAGGGTTCGGGGAGCTGTTTTTT	CASSGGTGFGELFF	TRBV9	TRBJ2-2
TGTGCCAGCAGCTTAGGAGGGGACAGCCAGTACTTC	CASSLGGDSQYF	TRBV7-6	TRBJ2-7
TGTGCTAGTGGTTTGAATATCCCTCCTGGGGGGTATTCGTCCTACGAGCAGTACTTC	CASGLNIPPGGYSSYEQYF	TRBV12-5	TRBJ2-7
TGCGCCAGCAGCCAAGACGGTGACAGGGGCTATGGCTACACCTTC	CASSQDGDRGYGYTF	TRBV4-1	TRBJ1-2
TGTGCCAGCGATTCCACAGGGCAGTATGGCTACACCTTC	CASDSTGQYGYTF	TRBV5-6	TRBJ1-2
TGTGCCAGCAGCTTGGCCGACAGGGGGCGTGAGGGCACAGATACGCAGTATTTT	CASSLADRGREGTDTQYF	TRBV5-6	TRBJ2-3
TGTGCCAGCTCACCACCCCTGGGGACCGCCTATGGCTACACCTTC	CASSPPLGTAYGYTF	TRBV18	TRBJ1-2
TGTGCCAGCAGCGGGCCCGGGGTCTCCTACGAGCAGTACTTC	CASSGPGVSYEQYF	TRBV7-2	TRBJ2-7
TGTGCCAGCAGTCCTAGTGGGACAGGAGATCACCGTACTAACTATGGCTACACCTTC	CASSPSGTGDHRTNYGYTF	TRBV27	TRBJ1-2
TGTGCCAGTTTACCCCTCGGGATTTACGAGCAGTACTTC	CASLPLGIYEQYF	TRBV19	TRBJ2-7
TGTGCCAGCAGCCGGGACAGGGGGAGCAATCAGCCCCAGCATTTT	CASSRDRGSNQPQHF	TRBV12-4	TRBJ1-5
TGTGCCAGCAGCTCCCCCAGTAGGGCAAAACTGTTTTTT	CASSSPSRAKLFF	TRBV7-3	TRBJ1-4
TGTGCCAGCAGCTCCTTTCTCTCCTACGAGCAGTACTTC	CASSSFLSYEQYF	TRBV13	TRBJ2-7
TGTGCCACCAGCAAGGAAGGTGGACCAACTCAACTGAACACTGAAGCTTTCTTT	CATSKEGGPTQLNTEAFF	TRBV15	TRBJ1-1
TGTGCCAGCAGTTTACATACTACAGGTTTCGCTTTCTTT	CASSLHTTGFAFF	TRBV28	TRBJ1-1
TGTGCCAGCAGTTTTCCCGGGGCCTACTACGAGCAGTACTTC	CASSFPGAYYEQYF	TRBV27	TRBJ2-7
TGTGCCAGCAGCTCTACGAGGGATCAACGGGCGGAAAGGGAGACCCAGTACTTC	CASSSTRDQRAERETQYF	TRBV11-2	TRBJ2-5
TGTGCCAGCAGTGTAGTATCGACCTATGGCTACACCTTC	CASSVVSTYGYTF	TRBV25-1	TRBJ1-2
TGTGCCAGCAGCAGCGGCCCTCAGCCCCAGCATTTT	CASSSGPQPQHF	TRBV6-4	TRBJ1-5
TGTGCCAGCAGCTTCTCGATCACCCATTGCCGTCATAGTAACCGCCTCCCGAGCACAGATACGCAGTATTTT	CASSFSITHCRHSNRLPSTDTQYF	TRBV7-6	TRBJ2-3
TGTGCCAGCAGCTTAGCTGGGGGGGCCTCCTACAATGAGCAGTTCTTC	CASSLAGGASYNEQFF	TRBV7-4	TRBJ2-1
TGTGCCAGCAGCTTACATGCACAGGGGGCAAAGGGCTACACCTTC	CASSLHAQGAKGYTF	TRBV11-2	TRBJ1-2
TGTGCCAGCAGCGTAAGTGCGGGAGTGCACACCGGGGAGCTGTTTTTT	CASSVSAGVHTGELFF	TRBV13	TRBJ2-2
TGTGCCAGCATTTCGGCATGGTCCAGGAAAGCAGATACGCAGTATTTT	CASISAWSRKADTQYF	TRBV11-3	TRBJ2-3
TGTGCCAGCAGCTACCTCAGTACTAGCACTGAAGCTTTCTTT	CASSYLSTSTEAFF	TRBV7-3	TRBJ1-1
TGTGCTAGTGTCCCGTCGACAGGGGGCGGAATGTATTCTGGAAACACCATATATTTT	CASVPSTGGGMYSGNTIYF	TRBV12-5	TRBJ1-3
TGTGCCAGCAGCCCCGTCGGGACAGGGGCCTCTGGAAACACCATATATTTT	CASSPVGTGASGNTIYF	TRBV7-3	TRBJ1-3
TGTGCCACCAGCACAATCGGGGCTTGTTGGGTCTCTGGGGCCAACGTCCTGACTTTC	CATSTIGACWVSGANVLTF	TRBV24-1	TRBJ2-6
TGTGCCAGCAGTACGCCCCGGGGGTTGAATGGCTACACCTTC	CASSTPRGLNGYTF	TRBV28	TRBJ1-2
TGTGCCTGGAGTGAAGACATGGAAAAACTGTTTTTT	CAWSEDMEKLFF	TRBV30	TRBJ1-4
TGTGCCAGCACGGTGGGGTCCAGACAAGAGACCCAGTACTTC	CASTVGSRQETQYF	TRBV6-8	TRBJ2-5
TGTGCCAGCAGTGAATTTTACCCAGGAGTCTCTGGAAACACCATATATTTT	CASSEFYPGVSGNTIYF	TRBV6-4	TRBJ1-3
TGTGCCAGCAGTGAAAACACAGGGCTGCGGAACACTGAAGCTTTCTTT	CASSENTGLRNTEAFF	TRBV25-1	TRBJ1-1
TGTGCCAGCAGTGCTCGAGGGGCCCGTAACTATGGCTACACCTTC	CASSARGARNYGYTF	TRBV12-3	TRBJ1-2
TGTGCCAGCAGCGTAGGTTACCGGGACACGCACTACGAGCAGTACTTC	CASSVGYRDTHYEQYF	TRBV9	TRBJ2-7
TGCGCCAGCAGCCATCACGATGAAAGCAATCAGCCCCAGCATTTT	CASSHHDESNQPQHF	TRBV10-1	TRBJ1-5
TGTGCCAGCAGTCTTTATGGCCATCCCTCCCCGGTGCACACTGAAGCTTTCTTT	CASSLYGHPSPVHTEAFF	TRBV6-1	TRBJ1-1
TGTGCCAGCAAGCGGAGACGCTCGGAGGTTGAGCAGTTCTTC	CASKRRRSEVEQFF	TRBV13	TRBJ2-1
TGTGCCAGCAGTTTATGCCGTGGGAGCGCAGGGGGCAAGGGGTACTTC	CASSLCRGSAGGKGYF	TRBV28	TRBJ2-7
TGCATAAGGGACAGGGCAATAGGGGGGGTACCCTACGAGCAGTACTTC	CIRDRAIGGVPYEQYF	TRBV29-1	TRBJ2-7
TGTGCTTTCGAGGGGGCCAGATTCTACGAGCAGTACTTC	CAFEGARFYEQYF	TRBV5-4	TRBJ2-7
TGCGCCAGCAGCTTGGGACATACTTTTAATGAAAAACTGTTTTTT	CASSLGHTFNEKLFF	TRBV5-1	TRBJ1-4
TGCAGTGCTAGCTCACGAGTTAGCAATCAGCCCCAGCATTTT	CSASSRVSNQPQHF	TRBV20-1	TRBJ1-5
TGCAGTGCTAGAGATCCGGCAGATACGCAGTATTTT	CSARDPADTQYF	TRBV20-1	TRBJ2-3
TGTGCCAGTAGTATCCCCCTGACTAGAATAACAGATACGCAGTATTTT	CASSIPLTRITDTQYF	TRBV19	TRBJ2-3
TGTGCCAGCAGCGCAGATAGCGACACTGAAGCTTTCTTT	CASSADSDTEAFF	TRBV9	TRBJ1-1
TGCAGCGAATTTTTCTACGAGCAGTACTTC	CSEFFYEQYF	TRBV29-1	TRBJ2-7
TGTGCCAGCAGCCAAGCCTCGGGGGGGGGGCGCGACTACGAGCAGTACTTC	CASSQASGGGRDYEQYF	TRBV14	TRBJ2-7
TGTGCCAGCAGCCAAGCCCCACAGGGGGAGAAGCCCAATGAGCAGTTCTTC	CASSQAPQGEKPNEQFF	TRBV4-2	TRBJ2-1
TGTGCCAGCAGTTTTATACCCTCCTACGAGCAGTACTTC	CASSFIPSYEQYF	TRBV6-5	TRBJ2-7
TGTGCCAGCAGTGTCTCCGGCGTAAGTTGCAATCAGCCCCAGCATTTT	CASSVSGVSCNQPQHF	TRBV27	TRBJ1-5
TGTGCCAGCATTCCACTGGGGGACTCTATCTCCTACGAGCAGTACTTC	CASIPLGDSISYEQYF	TRBV6-2	TRBJ2-7
TGTGCCAGCAGTAAAAGAGGATGGACAGGGGTGAGGGCCATTAACTATGGCTACACCTTC	CASSKRGWTGVRAINYGYTF	TRBV28	TRBJ1-2
TGCAGTGCGCCAACCGGGACAGGAATAGGGGGAAACACCATATATTTT	CSAPTGTGIGGNTIYF	TRBV20-1	TRBJ1-3
TGTGCCACCAGTGATTTGAAGGGACATTACGAGCAGTACTTC	CATSDLKGHYEQYF	TRBV24-1	TRBJ2-7
TGTGCCAGCAGGTGGGGCGGGAGCATAAACATTCAGTACTTC	CASRWGGSINIQYF	TRBV27	TRBJ2-4
TGTGCCATCGCTGACGAGCAGTACTTC	CAIADEQYF	TRBV27	TRBJ2-7
TGTGCTAGTGGTTTGTTATTGGGGAGGGACAATGAGCAGTTCTTC	CASGLLLGRDNEQFF	TRBV12-5	TRBJ2-1
TGTGCCAGCACAACCCGACAGGGCCTGAGAGGAGGAAATGGCTACACCTTC	CASTTRQGLRGGNGYTF	TRBV7-9	TRBJ1-2
TGTGCCAGCAGTTGTCGCCAAGTCGTGGGAGTTGCCAAAAACATTCAGTACTTC	CASSCRQVVGVAKNIQYF	TRBV12-3	TRBJ2-4
TGTGCCAGCAGTTTATGGGACGGGCAGCTTGATGCGTCGTCCCTCCACTTT	CASSLWDGQLDASSLHF	TRBV28	TRBJ1-6
TGCGCCAGCAGCGTGACAGGGGGGGACTCTGGGGCCAACGTCCTGACTTTC	CASSVTGGDSGANVLTF	TRBV10-1	TRBJ2-6
TGTGGGTGGCCAGGAGGTACCGAACCGCGGAGGAATACGCAGTATTTT	CGWPGGTEPRRNTQYF	TRBV27	TRBJ2-3
TGTGCTAGTGGCAAGGGGACCCACTCCTACGAGCAGTACTTC	CASGKGTHSYEQYF	TRBV12-5	TRBJ2-7
TGCAGTGCATGGTCGGACTTCCGGGGCTATGGCTACACCTTC	CSAWSDFRGYGYTF	TRBV20-1	TRBJ1-2
TGCAGTGCCCCCCAGGGGGCGTTCCAAGAGACCCAGTACTTC	CSAPQGAFQETQYF	TRBV20-1	TRBJ2-5
TGCGCCAGCAGCGGACACTGGGGCTACGAGCAGTACTTC	CASSGHWGYEQYF	TRBV5-1	TRBJ2-7
TGCAGCGTTGAAGAGAACTTCTTC	CSVEENFF	TRBV29-1	TRBJ1-2
TGTGCCAGCAGTTTCATCACAGGGGGTCATCGCAGCTCCTATAATTCACCCCTCCACTTT	CASSFITGGHRSSYNSPLHF	TRBV12-3	TRBJ1-6
TGTGCCAGCAGCCCGGGGAGGCTGGGCGCTTTCTTT	CASSPGRLGAFF	TRBV28	TRBJ1-1
TGTGCCAGCAGGCCCGGGGCAAAGTCCTACGAGCAGTACTTC	CASRPGAKSYEQYF	TRBV12-3	TRBJ2-7
TGTGCCAGCACCGGGACAGGGTCGGCCCAGCATTTT	CASTGTGSAQHF	TRBV28	TRBJ1-5
TGTGCCAGCAGTGATGCTGGACATCGCACTGAAGCTTTCTTT	CASSDAGHRTEAFF	TRBV6-1	TRBJ1-1
TGTGCCAGCAGCTTACCGCCGGCACGGCGAGGAGAGACCCAGTACTTC	CASSLPPARRGETQYF	TRBV11-2	TRBJ2-5
TGTGCCTGGCGTAGGGGAGGGTTGGATGAGCAGTTCTTC	CAWRRGGLDEQFF	TRBV30	TRBJ2-1
TGTGCCAGCAGCTTAGCCGGTCAGCGAGATCGGGGTCGGACCTACGAGCAGTACTTC	CASSLAGQRDRGRTYEQYF	TRBV7-2	TRBJ2-7
TGCAGTGCTAGTCGACTAGCGTCTAACACCGGGGAGCTGTTTTTT	CSASRLASNTGELFF	TRBV20-1	TRBJ2-2
TGCAGTGCTAGAGATCCATGCAGGGGGAGCAATCAGCCCCAGCATTTT	CSARDPCRGSNQPQHF	TRBV20-1	TRBJ1-5
TGTGCCAGCAGCGAGAGGGGGCGGGTTTCACCCCTCCACTTT	CASSERGRVSPLHF	TRBV7-6	TRBJ1-6
TGTGCCAGCAGCCGAGGTAGGGGTCCTCACACTGAAGCTTTCTTT	CASSRGRGPHTEAFF	TRBV9	TRBJ1-1
TGTGCCAGCAGATACAGACGAAATGAAAAACTGTTTTTT	CASRYRRNEKLFF	TRBV3-1	TRBJ1-4
TGCGCCAGCAGTGTACTAAAGCCCTATGTGACAGGGGGTTTGACTAACACCGGGGAGCTGTTTTTT	CASSVLKPYVTGGLTNTGELFF	TRBV10-1	TRBJ2-2
TGTGCCAGCAGTCCCAGGGAGACCGAGCAGTACTTC	CASSPRETEQYF	TRBV2	TRBJ2-7
TGCGCCAGCAGTGAGTCCTGCGGACGGGGCTTTTCACCCCTCCACTTT	CASSESCGRGFSPLHF	TRBV10-1	TRBJ1-6
TGCAGTGCTAGAGACGGGTCCGGGGCTTTCCAAGAGACCCAGTACTTC	CSARDGSGAFQETQYF	TRBV20-1	TRBJ2-5
TGTGCCACCAAACCGACAGGGACCAGCAATCAGCCCCAGCATTTT	CATKPTGTSNQPQHF	TRBV24-1	TRBJ1-5
TGTGCCAGCAGCACGCAACTGCCCTACAATGAGCAGTTCTTC	CASSTQLPYNEQFF	TRBV5-6	TRBJ2-1
TGCAGTGCTAGAAGGGACAGGTCTTTGAACACTGAAGCTTTCTTT	CSARRDRSLNTEAFF	TRBV20-1	TRBJ1-1
TGTGCCAGCACCTCCCAGGGGACAGGGTGGGAGCAGTACTTC	CASTSQGTGWEQYF	TRBV6-4	TRBJ2-7
TGTGCCAGCAGCCAAGACCATGGGACAGCTGAAGCTTTCTTT	CASSQDHGTAEAFF	TRBV3-1	TRBJ1-1
TGTGCCAGCAGTTACTCGAGAAGCACCAGGGGGTATCGAAACACCATATATTTT	CASSYSRSTRGYRNTIYF	TRBV6-2	TRBJ1-3
TGTGCCAGCAGAACTGAGACAGGGGCTCAGCCCCAGCATTTT	CASRTETGAQPQHF	TRBV6-5	TRBJ1-5
TGTGCCAGCAGCGTGGTGCCGACTGGGGCTGGCACAGATACGCAGTATTTT	CASSVVPTGAGTDTQYF	TRBV4-2	TRBJ2-3
TGTGCCAGCAGTTACTCGATTGACCGGACGGGCGATGGCAATCAGCCCCAGCATTTT	CASSYSIDRTGDGNQPQHF	TRBV6-6	TRBJ1-5
TGTGCCAGCAGCTTCACAGGGGTTCGGGTCTCTGGAAACACCATATATTTT	CASSFTGVRVSGNTIYF	TRBV5-8	TRBJ1-3
TGTGCCACCAGTGATGGGACAGGGGATCGCTCTGGGGCCAACGTCCTGACTTTC	CATSDGTGDRSGANVLTF	TRBV24-1	TRBJ2-6
TGTGCACCGGGGGAAAATTATAGCAATCAGCCCCAGCATTTT	CAPGENYSNQPQHF	TRBV12-5	TRBJ1-5
TGCGCCAGCAGCCAAGATAGGGGACAGGGGGCTACGAGGGGCAATCAGCCCCAGCATTTT	CASSQDRGQGATRGNQPQHF	TRBV4-1	TRBJ1-5
TGTGCCAGCAGTGAACCTCGCCACAATCAGCCCCAGCATTTT	CASSEPRHNQPQHF	TRBV2	TRBJ1-5
TGTGCCAGCTCACCGGACGATGAGCAGTTCTTC	CASSPDDEQFF	TRBV18	TRBJ2-1
TGTGCCAGCAGTTACCCGGCGGGAAAAAGCAATCAGCCCCAGCATTTT	CASSYPAGKSNQPQHF	TRBV6-3	TRBJ1-5
TGCAGTGACAGGGGGCATTTCGAGCAGTACTTC	CSDRGHFEQYF	TRBV20-1	TRBJ2-7
TGTGCCAGCAGTTTATCAAGCTACGAGCAGTACTTC	CASSLSSYEQYF	TRBV28	TRBJ2-7
TGTGCCAGCAGTCCACATTGGGGGGACATTCAGTACTTC	CASSPHWGDIQYF	TRBV27	TRBJ2-4
TGTGCCAGCAGCAAAGACGGACAGACATTCTCTGGAAACACCATATATTTT	CASSKDGQTFSGNTIYF	TRBV9	TRBJ1-3
TGCAGTGCTAGAGGTTTGGACAGCAGCTCCTACAATGAGCAGTTCTTC	CSARGLDSSSYNEQFF	TRBV20-1	TRBJ2-1
TGTGCCAGCAGCTTAGTTCAGGCTAGGAGCAATCAGCCCCAGCATTTT	CASSLVQARSNQPQHF	TRBV13	TRBJ1-5
TGCAGTGCGGCAGGGGGGCCGTACGAGCAGTACTTC	CSAAGGPYEQYF	TRBV20-1	TRBJ2-7
TGTGCCAGTAATCTTAGGGACTCCTACGAGCAGTACTTC	CASNLRDSYEQYF	TRBV19	TRBJ2-7
TGTGCCAGTAAACCTCCCGTAAGGAGGGGGGATAGGAGCACAGATACGCAGTATTTT	CASKPPVRRGDRSTDTQYF	TRBV19	TRBJ2-3
TGTGCCACCAGTGTACCGCAGAAGGGGGATCGACAAGAGACCCAGTACTTC	CATSVPQKGDRQETQYF	TRBV24-1	TRBJ2-5
TGTGCCAGCAGCCAAGATATAGGCTTTGGCACAGATACGCAGTATTTT	CASSQDIGFGTDTQYF	TRBV14	TRBJ2-3
TGTGCCAGCAGCCAAGGGGTTCCAGGACCTGAGACCCAGTACTTC	CASSQGVPGPETQYF	TRBV14	TRBJ2-5
TGTGCTAGCAGCCTTACAGGGAACCACTATAATTCACCCCTCCACTTT	CASSLTGNHYNSPLHF	TRBV7-7	TRBJ1-6
TGTGCCAGCAGCTTTCCCAACGGGGACAGGGGAAATGAAAAACTGTTTTTT	CASSFPNGDRGNEKLFF	TRBV7-8	TRBJ1-4
TGTGCCAGCAGTTGGACTAGCGGGATCCAAGAGACCCAGTACTTC	CASSWTSGIQETQYF	TRBV28	TRBJ2-5
TGTGCCTGGAGTGTATTGGGGGGGCCCTCCTACGAGCAGTACTTC	CAWSVLGGPSYEQYF	TRBV30	TRBJ2-7
TGTGCCAGCAGCCAAGAGAGGGTACCGGGATACGAGCAGTACTTC	CASSQERVPGYEQYF	TRBV4-2	TRBJ2-7
TGTGCCAGCAGCTTAGAGCGACAGATCTACGAGCAGTACTTC	CASSLERQIYEQYF	TRBV11-1	TRBJ2-7
TGTGCCTGGCGTTGTCAGGGGAGTTTGACCCAGTACTTC	CAWRCQGSLTQYF	TRBV30	TRBJ2-5
TGTGCCAGATTGGGGGGGCCACCGACCCAGTACTTC	CARLGGPPTQYF	TRBV6-5	TRBJ2-5
TGCAGCGTTCAGAAATCGGCAGGGTTTACCTACGAGCAGTACTTC	CSVQKSAGFTYEQYF	TRBV29-1	TRBJ2-7
TGTGCCTGGAGCTCAGGGAGGGGCGCCAGGGCTTACGAGCAGTACTTC	CAWSSGRGARAYEQYF	TRBV30	TRBJ2-7
TGTGCCAGCAGTGCGCAGAGCAATCAGCCCCAGCATTTT	CASSAQSNQPQHF	TRBV6-2	TRBJ1-5
TGTGCCAGCAGCCAAGACGGTAGCTGCCGGGGTCGAAAGGGTTATCACAATGAGCAGTTCTTC	CASSQDGSCRGRKGYHNEQFF	TRBV3-1	TRBJ2-1
TGCAGTGCTAGAACGTATGAGGGGTACCCGACCTACGAGCAGTACTTC	CSARTYEGYPTYEQYF	TRBV20-1	TRBJ2-7
TGTGCCAGCAGTTTACCCCCCAATTATGGCAGAAGCTCCTATAATTCACCCCTCCACTTT	CASSLPPNYGRSSYNSPLHF	TRBV12-4	TRBJ1-6
TGTGCCAGCAGTGACTCAAGGGGCTCTGGGAGCTCCTACGAGCAGTACTTC	CASSDSRGSGSSYEQYF	TRBV6-4	TRBJ2-7
TGCGCCAGCAGCTTGTTTTCAGGGGGGGGGCGTGCAGGGAATCAGCCCCAGCATTTT	CASSLFSGGGRAGNQPQHF	TRBV5-1	TRBJ1-5
