TGTGCCTGGAGAGTTCTAGGGGACTCCGAGCAGTACTTC	CAWRVLGDSEQYF	TRBV30	TRBJ2-7
TGTGCCAGCAGCGCCACCCCGAGTTATAACTATGGCTACACCTTC	CASSATPSYNYGYTF	TRBV7-3	TRBJ1-2
TGTGCCAGCAGCCAAGAAATTATTTCACTAGCGACAAATCAGGAAGGCAAAAACATTCAGTACTTC	CASSQEIISLATNQEGKNIQYF	TRBV3-1	TRBJ2-4
TGCAGCGTTGAAGCAGGGGGCGACCAAGAGACCCAGTACTTC	CSVEAGGDQETQYF	TRBV29-1	TRBJ2-5
TGCGCCAGCAGCCAAGGGTCCCGAGGGGGGGAGGGGTCTAAGTACGAGCAGTACTTC	CASSQGSRGGEGSKYEQYF	TRBV4-1	TRBJ2-7
TGTGCCAGCGTCAGAAGGCCGACGGGGAGCGAAACGCAGTACTTC	CASVRRPTGSETQYF	TRBV14	TRBJ2-7
TGTGCCAGCAGCCTGGGGGGGACAGGGGCCGGATACAATGAGCAGTTCTTC	CASSLGGTGAGYNEQFF	TRBV11-3	TRBJ2-1
TGCAGTGCTAGTGGGGCGGGACTAGCGGGGGGGGGCCTTCACCTGACCGGGGAGCTGTTTTTT	CSASGAGLAGGGLHLTGELFF	TRBV20-1	TRBJ2-2
TGTGCCACCAACCTACGCTCCACTGAAGCTTTCTTT	CATNLRSTEAFF	TRBV6-3	TRBJ1-1
TGTGCCCGGAGCTACGAGCAGTACTTC	CARSYEQYF	TRBV24-1	TRBJ2-7
TGTGCCAGCAGCAGGGGGGCCGGGACCCAGTACTTC	CASSRGAGTQYF	TRBV5-8	TRBJ2-5
TGTGCCAGCAGCCAAGATTGGAGAGGCAGGGACAATTCACCCCTCCACTTT	CASSQDWRGRDNSPLHF	TRBV3-1	TRBJ1-6
TGCAGCGTTGAACGCCCCAGGGAGCAGTACTTC	CSVERPREQYF	TRBV29-1	TRBJ2-7
TGTGCCAGCAGACTGCCTATCTTC	CASRLPIF	TRBV27	TRBJ2-1
TGTGCCAGCAGCAGGGGACAGGGGGCATCGGTTGCAACTAATGAAAAACTGTTTTTT	CASSRGQGASVATNEKLFF	TRBV9	TRBJ1-4
TGTGCCAGCAGCATCCGGGGTTCGGGAACATTAAGAGGCGGGGAACACCACGAGCAGTACTTC	CASSIRGSGTLRGGEHHEQYF	TRBV13	TRBJ2-7
TGCAGTGCTAGCCCCCATCCGACTAGCGGGGGGATCTCTAGCACAGATACGCAGTATTTT	CSASPHPTSGGISSTDTQYF	TRBV20-1	TRBJ2-3
TGTGCCACCAGGGACTACGAGCAGTACTTC	CATRDYEQYF	TRBV25-1	TRBJ2-7
TGTGCCAGCAGCTTACCGTCTACTGAAGCTTTCTTT	CASSLPSTEAFF	TRBV7-7	TRBJ1-1
TGTGCCACCGGAATAGCGGGGATCGCCTACAATGAGCAGTTCTTC	CATGIAGIAYNEQFF	TRBV24-1	TRBJ2-1
TGTGCCAGCACTATACTAGCGGGAGGTGAGACCCAGTACTTC	CASTILAGGETQYF	TRBV27	TRBJ2-5
TGTGCCAGCAGTTACTCGACAAGGGAAGCTTTCTTT	CASSYSTREAFF	TRBV6-5	TRBJ1-1
TGCGCCAGCAGCCGGTACTTCGGCGGGGAAGGGGAGACCTACGAGCAGTACTTC	CASSRYFGGEGETYEQYF	TRBV4-1	TRBJ2-7
TGTGCCAGCAGTGAAAAGGGGAAATATAGCAATCAGCCCCAGCATTTT	CASSEKGKYSNQPQHF	TRBV2	TRBJ1-5
TGTGCCAGCAGTTTATCTAAGCGGGAATTTTTAGGCACAGATACGCAGTATTTT	CASSLSKREFLGTDTQYF	TRBV27	TRBJ2-3
TGCGCCAGCAGTGAGTCGGACCCGGGGCATAACACTGAAGCTTTCTTT	CASSESDPGHNTEAFF	TRBV10-1	TRBJ1-1
TGCGCCAGTAACAGGGGGCGGATGGATGGCTACACCTTC	CASNRGRMDGYTF	TRBV5-1	TRBJ1-2
TGTGCCAGCAGTGACCTGGACAGACCGAGGGGTGAGCAGTTCTTC	CASSDLDRPRGEQFF	TRBV25-1	TRBJ2-1
TGCGCCAGCGCATGTCGCAGGGGGACCGAGCAGTACTTC	CASACRRGTEQYF	TRBV5-1	TRBJ2-7
TGTGCCAGCAGCCTAGCGGCGGCAGGGACGTACACAGATACGCAGTATTTT	CASSLAAAGTYTDTQYF	TRBV7-9	TRBJ2-3
TGTGCCAGCAGCGGGACCTTTGAAGCTTTCTTT	CASSGTFEAFF	TRBV6-2	TRBJ1-1
TGTGCCAGCAGTTTATTCTCCGGGACCCGGGACAGGCCCCAGCATTTT	CASSLFSGTRDRPQHF	TRBV27	TRBJ1-5
TGTGCCACCAGGCACAGGGAAGAATCCTACGAGCAGTACTTC	CATRHREESYEQYF	TRBV24-1	TRBJ2-7
TGTGCCGCCCCGGAGGGAGAGACCCAGTACTTC	CAAPEGETQYF	TRBV10-3	TRBJ2-5
TGTGCCTGGCCTGCAGGGGAGGCTTTCACTGAAGCTTTCTTT	CAWPAGEAFTEAFF	TRBV30	TRBJ1-1
TGTGCCAGCTCACCACGGACGGCCGGGGAGCTGTTTTTT	CASSPRTAGELFF	TRBV18	TRBJ2-2
TGTGCCACCAGTGATTTGACCCCTCACGGGAAAGAGACCCAGTACTTC	CATSDLTPHGKETQYF	TRBV24-1	TRBJ2-5
TGCAGCGTATCGGGGGAATGCTACGAGCAGTACTTC	CSVSGECYEQYF	TRBV29-1	TRBJ2-7
TGTGCCGGGTGTAGCAATCAGCCCCAGCATTTT	CAGCSNQPQHF	TRBV27	TRBJ1-5
TGTGCCATCAGTGAATCAAGACAGGGCAATGAAAAACTGTTTTTT	CAISESRQGNEKLFF	TRBV10-3	TRBJ1-4
TGTGCCAGCAGTGAAGCTGTACTAGGGAAACCAGATACGCAGTATTTT	CASSEAVLGKPDTQYF	TRBV6-1	TRBJ2-3
TGCGCCAGCAGCCCGGGGGAGGGGTCGAACACTGAAGCTTTCTTT	CASSPGEGSNTEAFF	TRBV5-1	TRBJ1-1
TGTGCCAGTAGTATAGAGACCCCCCCGGGACAGCACTCCGGGGAGCAGTACTTC	CASSIETPPGQHSGEQYF	TRBV19	TRBJ2-7
TGTGCCAGCTCAGTCAGTCGACTCAAAGATTCTGGAAACACCATATATTTT	CASSVSRLKDSGNTIYF	TRBV18	TRBJ1-3
TGCAGCGTTGGGGACAGACCTTACGTCTACGAGCAGTACTTC	CSVGDRPYVYEQYF	TRBV29-1	TRBJ2-7
TGTGCCAGCAGAACTAGGGTTCAGAGATACAATGAGCAGTTCTTC	CASRTRVQRYNEQFF	TRBV6-4	TRBJ2-1
TGTGCCAGCAGGATCGGGGGGACGATCCTTTCGTCAGTTGAAGCTTTCTTT	CASRIGGTILSSVEAFF	TRBV12-3	TRBJ1-1
TGTGCCAGCCCCCCCCTAGGCTACACCTTC	CASPPLGYTF	TRBV13	TRBJ1-2
TGTGCCAGTAGTGATCTAGCGGAAAGGGAGACCCAGTACTTC	CASSDLAERETQYF	TRBV19	TRBJ2-5
TGTGCCAGCAGTTACGACCTAGAGCCCGCAGATACGCAGTATTTT	CASSYDLEPADTQYF	TRBV6-5	TRBJ2-3
TGTGCCAGCGTCCGGGCGAGCTCCTACAATGAGCAGTTCTTC	CASVRASSYNEQFF	TRBV6-4	TRBJ2-1
TGTGCCAGTAGTATAGCGGGACTCTCTACAGAGACCCAGTACTTC	CASSIAGLSTETQYF	TRBV19	TRBJ2-5
TGCGCCAGCAGTGTATTCAGCAGGTACTATGGCTACACCTTC	CASSVFSRYYGYTF	TRBV10-1	TRBJ1-2
TGTGCCAGCAGCCTACAGGACAGGGGAATATCCTACGAGCAGTACTTC	CASSLQDRGISYEQYF	TRBV3-1	TRBJ2-7
TGTGCCTGGAGTAACTGGACCATGTGCTATGGCTACACCTTC	CAWSNWTMCYGYTF	TRBV30	TRBJ1-2
TGTGCCAGCAGCACTTTGGGACTGAAAATCAATGAGCAGTTCTTC	CASSTLGLKINEQFF	TRBV13	TRBJ2-1
TGTGCCAGCAGCTTCCCCGTAGGAGGGTGTAGACATAACACTGAAGCTTTCTTT	CASSFPVGGCRHNTEAFF	TRBV7-7	TRBJ1-1
TGTGCCAGCAGCCGTTGGAGGAATGCAGATACGCAGTATTTT	CASSRWRNADTQYF	TRBV13	TRBJ2-3
TGTGATCCCAGGGAAAAATTTGGGTACTTC	CDPREKFGYF	TRBV2	TRBJ2-5
TGTGCCAGCAGCCCCGGACTAGCGGGTAATACGTGCTCCTACGAGCAGTACTTC	CASSPGLAGNTCSYEQYF	TRBV5-4	TRBJ2-7
TGTGCCACCAGTGCCGCAATTTTCGGGTACGAGCAGTACTTC	CATSAAIFGYEQYF	TRBV24-1	TRBJ2-7
TGCGCGGAGACGGGGCCGGGACTAGCGGGGGGAAGCTACGAGCAGTACTTC	CAETGPGLAGGSYEQYF	TRBV10-1	TRBJ2-7
TGTGCCAGCAACCAGGGCCATGCTCGGGACGGCTATGGCTACACCTTC	CASNQGHARDGYGYTF	TRBV6-4	TRBJ1-2
TGCAGTGCAGTAAACCAAGAGACCCAGTACTTC	CSAVNQETQYF	TRBV20-1	TRBJ2-5
TGTGCCAGCAGCCCCGGTCACGGCTCTGGAAACACCATATATTTT	CASSPGHGSGNTIYF	TRBV7-4	TRBJ1-3
TGCGCCAGCAGCGGTCTGGGACGGTTCTCGAATGGCTACACCTTC	CASSGLGRFSNGYTF	TRBV5-1	TRBJ1-2
TGTGCCAGCAGTGATGCTACAGGCTATGGCTACACCTTC	CASSDATGYGYTF	TRBV6-4	TRBJ1-2
TGTGCCAGCAGCCGGAAGGGGGAGCAAGAGCAGTACTTC	CASSRKGEQEQYF	TRBV11-3	TRBJ2-7
TGCAGTGCTAGGGCATGGGAGGGCGTATTGTCCAATAATTCACCCCTCCACTTT	CSARAWEGVLSNNSPLHF	TRBV20-1	TRBJ1-6
TGTGCCACCAGTGATATCGGGACAGGGGTGAGTGACAACTACAATGAGCAGTTCTTC	CATSDIGTGVSDNYNEQFF	TRBV24-1	TRBJ2-1
TGCGCCAGCAGTGCGAGCAGCTACGAGCAGTACTTC	CASSASSYEQYF	TRBV10-1	TRBJ2-7
TGTCGGGACCGGAACACTGAAGCTTTCTTT	CRDRNTEAFF	TRBV6-5	TRBJ1-1
TGTGCCAGCAGTTTCACGGGCCTGGCCAAAAACATTCAGTACTTC	CASSFTGLAKNIQYF	TRBV27	TRBJ2-4
TGCAGTGCTAGAGACTGGGGCCGCAATCAGCCCCAGCATTTT	CSARDWGRNQPQHF	TRBV20-1	TRBJ1-5
TGTGCCAGCAGCGCCTTTCATCAAACTAGCGGGTGTGAGCAGTACTTC	CASSAFHQTSGCEQYF	TRBV13	TRBJ2-7
TGTGCCATCAGTGAAATACGGGCAGGGTTTGCAGATACGCAGTATTTT	CAISEIRAGFADTQYF	TRBV10-3	TRBJ2-3
TGTGCCAGTAGCCAGGGCTGGGACCCGAACACTGAAGCTTTCTTT	CASSQGWDPNTEAFF	TRBV19	TRBJ1-1
TGCGCCAGCAGCCAGAGGAGCGACCCAAAATATAGCAATCAGCCCCAGCATTTT	CASSQRSDPKYSNQPQHF	TRBV4-1	TRBJ1-5
TGCGCCAGCAGCCAAGATGGTCCGGACAGGGGCATACTGTTTTTT	CASSQDGPDRGILFF	TRBV4-3	TRBJ1-4
TGTGCCAGCAGATGTGATTGGACTAGCGGGAGGAGCACAGATACGCAGTATTTT	CASRCDWTSGRSTDTQYF	TRBV12-4	TRBJ2-3
TGTGCCAGCAGTTTTACCGGGAATAGCTCCTACAATGAGCAGTTCTTC	CASSFTGNSSYNEQFF	TRBV12-3	TRBJ2-1
TGCGCCAGCAGGCCAGGCCCGCGGGAGCCGGCCAAAAACATTCAGTACTTC	CASRPGPREPAKNIQYF	TRBV5-1	TRBJ2-4
TGCAGTGCTAGAGCCGGGGACAGGGAATTGTCCTCTGGGGCCAACGTCCTGACTTTC	CSARAGDRELSSGANVLTF	TRBV20-1	TRBJ2-6
TGTGCCAGCAGCCCCTTCTACCGTAGAAAAGATACGCAGTATTTT	CASSPFYRRKDTQYF	TRBV13	TRBJ2-3
TGTGCCAGCAGCCGCAGGGACCTCTCTGGGGCCAACGTCCTGACTTTC	CASSRRDLSGANVLTF	TRBV3-1	TRBJ2-6
TGTGCCAGCAGCTTCATTGACCCCTTAACTAGCGGGGCCGCCGGGGAGCTGTTTTTT	CASSFIDPLTSGAAGELFF	TRBV5-5	TRBJ2-2
TGCGCCAGCAGTGGGACAGGGTTAACGGAGAGTCCCTACGAGCAGTACTTC	CASSGTGLTESPYEQYF	TRBV10-1	TRBJ2-7
TGTGCCAGCAGGTCGAAGAGTGAGCCAGACCGTCCCCTATACAATGAGCAGTTCTTC	CASRSKSEPDRPLYNEQFF	TRBV27	TRBJ2-1
TGTGCCTGGAGTGTTAGACAGGGAAGTAGAATCCCCCTGGATGAAGCTTTCTTT	CAWSVRQGSRIPLDEAFF	TRBV30	TRBJ1-1
TGCAGTGCTATCCGGGAGCTTGGGCCCCGGGGAAACACCATATATTTT	CSAIRELGPRGNTIYF	TRBV20-1	TRBJ1-3
TGTGCCAGCAGCTTAGGCACTAGCGGGGTAAAAGAGACCCAGTACTTC	CASSLGTSGVKETQYF	TRBV7-4	TRBJ2-5
TGTGCCAGCAGCCAAGATCATGCAGGGTACAATGAGCAGTTCTTC	CASSQDHAGYNEQFF	TRBV3-1	TRBJ2-1
TGTGCCAGCAGTGGTCCCCAGGGGGCCGGCTACGAGCAGTACTTC	CASSGPQGAGYEQYF	TRBV12-3	TRBJ2-7
TGTGCCAGCAGCTTAGCCAAAAGAATATCGGGACGGGGAACTGAAGCTTTCTTT	CASSLAKRISGRGTEAFF	TRBV7-6	TRBJ1-1
TGTGCCAGCAGTGAGCTCGCCAGCGTCAACTTGTCCAATGAGCAGTTCTTC	CASSELASVNLSNEQFF	TRBV2	TRBJ2-1
TGTGCCAGCGGCGGGACAGGGGGGGGGTACGAGCAGTACTTC	CASGGTGGGYEQYF	TRBV9	TRBJ2-7
TGTGCCAGCAGCTTGAAGAGGGACTGGTCTGGAAACACCATATATTTT	CASSLKRDWSGNTIYF	TRBV7-9	TRBJ1-3
TGCAGTGCTAGTGAAGGTCAGAACCATCAGCCCCAGCATTTT	CSASEGQNHQPQHF	TRBV20-1	TRBJ1-5
TGTGCCAGCAGCCAAGATACGGTAGGACTAGCGGGCGGCCCGGGCTACGAGCAGTACTTC	CASSQDTVGLAGGPGYEQYF	TRBV3-1	TRBJ2-7
TGTGCCAGCATCTCACAAAAGACCTTTTCACCCCTCCACTTT	CASISQKTFSPLHF	TRBV7-6	TRBJ1-6
TGCAGCGTTGAGGAGGCCTACGAGCAGTACTTC	CSVEEAYEQYF	TRBV29-1	TRBJ2-7
TGCAGCGTTGCGCGGGACAACCCCCGAACCTACGAGCAGTACTTC	CSVARDNPRTYEQYF	TRBV29-1	TRBJ2-7
TGCGCCAGCAGCGCGGCTGGAACAATTCAAGAGACCCAGTACTTC	CASSAAGTIQETQYF	TRBV10-1	TRBJ2-5
TGTGCCAGCAGTTTACCGGTCCCTCTGGGGGATGCCTACGAGCAGTACTTC	CASSLPVPLGDAYEQYF	TRBV27	TRBJ2-7
TGCGCCAGCAGCAACCAAAGCCCCCACCGGGACAGGGGGAATAGCAATCAGCCCCAGCATTTT	CASSNQSPHRDRGNSNQPQHF	TRBV5-1	TRBJ1-5
TGTGCCAGGAAGCTAGGACAGGAATACAATGAGCAGTTCTTC	CARKLGQEYNEQFF	TRBV6-1	TRBJ2-1
TGTGCCAGCAGCTTCCCCTGTGGGACAGGGGAGACCCAGTACTTC	CASSFPCGTGETQYF	TRBV7-3	TRBJ2-5
TGTGCCACCAGTGATTTACTTTACGAGCAGTACTTC	CATSDLLYEQYF	TRBV24-1	TRBJ2-7
TGTGCCAGCAGTCCTCCCCCTGCAACTAATGAAAAACTGTTTTTT	CASSPPPATNEKLFF	TRBV27	TRBJ1-4
TGCGCCAGCAGCTTGAACGGGGGGAATTCACCCCTCCACTTT	CASSLNGGNSPLHF	TRBV5-1	TRBJ1-6
TGTGCCAGCGGCAGAGGCTCTGGAAACACCATATATTTT	CASGRGSGNTIYF	TRBV11-3	TRBJ1-3
TGTGCCAGCCTGGGGGGCGAGCAGTACTTC	CASLGGEQYF	TRBV6-4	TRBJ2-7
TGTGCCAGCAAAATAGGACAGGGGTCATGCGGTTCATACGAGCAGTACTTC	CASKIGQGSCGSYEQYF	TRBV11-2	TRBJ2-7
TGCGCCAAATCGTCCGGGGCGCTCGAACGTCAGTACTTC	CAKSSGALERQYF	TRBV5-1	TRBJ2-7
TGTGCCAGTAGTATCAAGGGTAGCCCGCAGCCCCAGCATTTT	CASSIKGSPQPQHF	TRBV19	TRBJ1-5
TGCAGTGCTAGGTTAGCTGACCGAAGCAATCAGCCCCAGCATTTT	CSARLADRSNQPQHF	TRBV20-1	TRBJ1-5
TGTGCCACCAGTGATCCGACAGGTATAACAAAAAATCAGCCCCAGCATTTT	CATSDPTGITKNQPQHF	TRBV24-1	TRBJ1-5
TGTGCCAGCCGCGCTTTCAGCGCGCACGAGCAGTACTTC	CASRAFSAHEQYF	TRBV6-5	TRBJ2-7
TGTGCCAGCAGTATCGATAGGCCCTCTGGAAACACCATATATTTT	CASSIDRPSGNTIYF	TRBV6-3	TRBJ1-3
TGTGCCAGCCTGGCCGAAAGAGGGGGGGTGGCCAAAAACATTCAGTACTTC	CASLAERGGVAKNIQYF	TRBV13	TRBJ2-4
TGTGCCAGCAGTGGGGGGGATCCCTACGAGCAGTACTTC	CASSGGDPYEQYF	TRBV12-4	TRBJ2-7
TGTGCCAGCATTCGGCGGGAGGCACCCGGAGAGACCCAGTACTTC	CASIRREAPGETQYF	TRBV25-1	TRBJ2-5
TGCGCCAGCAGCTTAGAACAGTCTTACGAGCAGTACTTC	CASSLEQSYEQYF	TRBV5-1	TRBJ2-7
TGCGCCAGCAGCCAAGAGGACAGGGGGGACAATCAGCCCCAGCATTTT	CASSQEDRGDNQPQHF	TRBV4-1	TRBJ1-5
TGCAGCGTTGAAATAACTGAGGAGCAGTACTTC	CSVEITEEQYF	TRBV29-1	TRBJ2-7
TGCGCCACTGGACTAAACGAGCAGTACTTC	CATGLNEQYF	TRBV5-1	TRBJ2-7
TGTGCCAGCAGCTACGGGCAGGTGGGGGAGCACGGGGAGCTGTTTTTT	CASSYGQVGEHGELFF	TRBV13	TRBJ2-2
TGTGCCAGCAGTTCGGCGCACGAGACCCAGTACTTC	CASSSAHETQYF	TRBV12-3	TRBJ2-5
TGCGCCAGCAGTTACCCCCCCAGGGGTTACTATGGCTACACCTTC	CASSYPPRGYYGYTF	TRBV10-1	TRBJ1-2
TGTGCCTGGCCAGGTTCCAGGCCGGGACAGGGGTGGATGGGCAATCAGCCCCAGCATTTT	CAWPGSRPGQGWMGNQPQHF	TRBV30	TRBJ1-5
TGCAGTGCTAGACAGGGCACCGGGAGCACAGATACGCAGTATTTT	CSARQGTGSTDTQYF	TRBV20-1	TRBJ2-3
TGCGCCAGCAGCCGCCCAAACCCGGGACTAATAACGGGCTACAATGAGCAGTTCTTC	CASSRPNPGLITGYNEQFF	TRBV4-1	TRBJ2-1
TGCAGCGTAGTTTCGACTGGTCCCCGAAAGTTAGAGACCCAGTACTTC	CSVVSTGPRKLETQYF	TRBV29-1	TRBJ2-5
TGTGCCATGGTATACAGGGAGTCACCCCTCCACTTT	CAMVYRESPLHF	TRBV10-3	TRBJ1-6
TGTGCCAGCAGCTTTGTTAACAGGGTGGACTCTGGGGCCAACGTCCTGACTTTC	CASSFVNRVDSGANVLTF	TRBV5-6	TRBJ2-6
TGTGCCAGCGGGAACCCTAGGGGCGAGCAGTACTTC	CASGNPRGEQYF	TRBV6-5	TRBJ2-7
TGCGCCAGAGGGGACCACGAGCAGTACTTC	CARGDHEQYF	TRBV10-1	TRBJ2-7
TGCGCCAGCAGTGAACAAGTCGCAGGGGAGGGCTACACCTTC	CASSEQVAGEGYTF	TRBV10-1	TRBJ1-2
TGTGCCATCAGTGACAACTTTTCCACTGAAGCTTTCTTT	CAISDNFSTEAFF	TRBV10-3	TRBJ1-1
TGCAGTGCCCTTAGGGCACACGAGCAGTACTTC	CSALRAHEQYF	TRBV20-1	TRBJ2-7
TGTGCCAGCAGTTTCCTTGAAAGACTAGCGGGAGGGGCCTACGAGCAGTACTTC	CASSFLERLAGGAYEQYF	TRBV27	TRBJ2-7
TGTGCCTGGAGTGTACGGTCTCCCCCGATCCGGGACAGGGAAGTGAACTCCTACGAGCAGTACTTC	CAWSVRSPPIRDREVNSYEQYF	TRBV30	TRBJ2-7
TGTGCCAGCAGTGAACTTCCCCCGCCGACAGGGTTAGGCTCCTACGAGCAGTACTTC	CASSELPPPTGLGSYEQYF	TRBV2	TRBJ2-7
TGTGGGGACCTACGACAGGTCCCTAATGAAAAACTGTTTTTT	CGDLRQVPNEKLFF	TRBV27	TRBJ1-4
TGTGCCAGCAGCGAGCTACTAGCGCCAGATACGCAGTATTTT	CASSELLAPDTQYF	TRBV11-3	TRBJ2-3
TGTGCCAGCAGCCCACATTCCAAGGTCGAAGCTTTCTTT	CASSPHSKVEAFF	TRBV13	TRBJ1-1
TGCGCCAGCAGCTTATGGGCGGGAAACGAGCAGTACTTC	CASSLWAGNEQYF	TRBV5-1	TRBJ2-7
TGCAGCGTCCCCAGGGCAGTCTCGTCCTACGAGCAGTACTTC	CSVPRAVSSYEQYF	TRBV29-1	TRBJ2-7
TGTGCCAGAAGGGACAGGGGGAGAGCCTATAATTCACCCCTCCACTTT	CARRDRGRAYNSPLHF	TRBV5-5	TRBJ1-6
TGTGCCAGCAGCCGTCCACTAGCGGACGAGCAGTACTTC	CASSRPLADEQYF	TRBV27	TRBJ2-7
TGTGCCAGCAGCTTATCTGGTGACAGGGAGTTAAGGGACCAGAGGATGAACACTGAAGCTTTCTTT	CASSLSGDRELRDQRMNTEAFF	TRBV7-9	TRBJ1-1
TGCAGCGTGGGGGACAGGCATTTAGGCAAAAACATTCAGTACTTC	CSVGDRHLGKNIQYF	TRBV29-1	TRBJ2-4
TGTGCCAGCAGCAAAGGGGCCCTTTCGATGTTGACCCAGTACTTC	CASSKGALSMLTQYF	TRBV7-8	TRBJ2-5
TGTGCCAGCAGTCAACGGGGGGGCCCCGAGCAGTACTTC	CASSQRGGPEQYF	TRBV28	TRBJ2-7
TGTGCCAGCAGTTGTTTGTTCAGTGATCAGCCCCAGCATTTT	CASSCLFSDQPQHF	TRBV6-6	TRBJ1-5
TGTTTCCGGGATAGCACTGATACGCAGTATTTT	CFRDSTDTQYF	TRBV7-9	TRBJ2-3
TGTGCCAGCAGATTGGGGGCTGGCGGCGAAAACCATGGCTACACCTTC	CASRLGAGGENHGYTF	TRBV28	TRBJ1-2
TGTGCCAGCAGTGGACCGATTGGACAGGAAGACTTGGAAGATACGCAGTATTTT	CASSGPIGQEDLEDTQYF	TRBV12-4	TRBJ2-3
TGCAGTGCTAGGGGACTAGTTGGCCAAGAGACCCAGTACTTC	CSARGLVGQETQYF	TRBV20-1	TRBJ2-5
TGTGCCAGCAGCTTACCGTTGACATTTTATGGCTACACCTTC	CASSLPLTFYGYTF	TRBV7-3	TRBJ1-2
TGTGCCAGCAGCAGACTAGCGGGAGAGACCCAGTACTTC	CASSRLAGETQYF	TRBV7-9	TRBJ2-5
TGCGCCAGCAGCCAAGAAATGGGGGTCGGGGAAGAGACCCAGTACTTC	CASSQEMGVGEETQYF	TRBV4-3	TRBJ2-5
TGTGCCAGCAGTATGCAGGGCGCCGAGACCCAGTACTTC	CASSMQGAETQYF	TRBV6-1	TRBJ2-5
TGTGCCAGCAGCAGGTGGCCGGGGGGGGACCAAGAGACCCAGTACTTC	CASSRWPGGDQETQYF	TRBV5-4	TRBJ2-5
TGCAGTGCTAGCCGAGCGGTTCAGTACTTC	CSASRAVQYF	TRBV20-1	TRBJ2-5
TGTGCCAAGGGGGCAAAGAACACTGAAGCTTTCTTT	CAKGAKNTEAFF	TRBV6-5	TRBJ1-1
TGTGCCAGCAGCGTTGACAGGGGGCGCGGGGCCTACGAGCAGTACTTC	CASSVDRGRGAYEQYF	TRBV11-3	TRBJ2-7
TGTGCCAGTAGTATACTCGTTCAAAAGGGACAGCCCTCTGGGGCCAACGTCCTGACTTTC	CASSILVQKGQPSGANVLTF	TRBV19	TRBJ2-6
TGCAGTGGACCCCGACAGCAGGAATGCTTC	CSGPRQQECF	TRBV20-1	TRBJ2-7
TGTGCCAGCAGTCCGTTCGACGGCGATAGCAATCAGCCCCAGCATTTT	CASSPFDGDSNQPQHF	TRBV27	TRBJ1-5
TGCGCCAGCAGCCAAGATGCCGGGGTCACCTCCGCCTACGAGCAGTACTTC	CASSQDAGVTSAYEQYF	TRBV4-3	TRBJ2-7
TGCGCCAGCAGTGAGCCCCAACCTTGGGGGACAGGAAGCAATCAGCCCCAGCATTTT	CASSEPQPWGTGSNQPQHF	TRBV10-1	TRBJ1-5
TGCAGTGCTAGAGATCCCGGGGGGCGCTACAATGAGCAGTTCTTC	CSARDPGGRYNEQFF	TRBV20-1	TRBJ2-1
TGTGCCAGCAGTTGCCCGACGGGACCTGAAGCTTTCTTT	CASSCPTGPEAFF	TRBV27	TRBJ1-1
TGCAGTGCTAGAGTTGAGGGGTCCTACGAGCAGTACTTC	CSARVEGSYEQYF	TRBV20-1	TRBJ2-7
TGTGCCTGGAGTGTGACTGGGGGTCGGACTGAAGCTTTCTTT	CAWSVTGGRTEAFF	TRBV30	TRBJ1-1
TGTGCCAGCAACCCCCTCCACAGGGTGAACACTGAAGCTTTCTTT	CASNPLHRVNTEAFF	TRBV6-1	TRBJ1-1
TGTGCCAGCAGCTACTCCTCCCGAACTCTTGGCTATGGCTACACCTTC	CASSYSSRTLGYGYTF	TRBV7-2	TRBJ1-2
TGTGCCAGCATAACTGGACCTCAAGCGACAAACACAGATACGCAGTATTTT	CASITGPQATNTDTQYF	TRBV6-8	TRBJ2-3
TGTGCCAGCAGCTCTACAGGTGTCTCGACGCCCCAAGAGACCCAGTACTTC	CASSSTGVSTPQETQYF	TRBV7-3	TRBJ2-5
TGTGCCAGCAGCTTGCGGACAGGCACGGTGAACACTGAAGCTTTCTTT	CASSLRTGTVNTEAFF	TRBV5-4	TRBJ1-1
TGTGCCAGCAGTTTAAAGGGTATAGCCTACGAGCAGTACTTC	CASSLKGIAYEQYF	TRBV12-4	TRBJ2-7
TGTGCCAGCCGCGGACAGGGGGAAACTGAAGCTTTCTTT	CASRGQGETEAFF	TRBV5-6	TRBJ1-1
TGTGCCAGCAGCTTAACAGGGTTGTACCAGCCCCAGCATTTT	CASSLTGLYQPQHF	TRBV7-9	TRBJ1-5
TGCAGCGTTGAAGATCCCCCAAGCAGGGGGGGCCGGGCTTGCCCCTACGAGCAGTACTTC	CSVEDPPSRGGRACPYEQYF	TRBV29-1	TRBJ2-7
TGTGCCAGCAGTCCGGCCGGGACAGGAGGCGCCTACGAGCAGTACTTC	CASSPAGTGGAYEQYF	TRBV2	TRBJ2-7
TGTGCCACCAGTGACATAACACGCTTCATTCAGTACTTC	CATSDITRFIQYF	TRBV24-1	TRBJ2-4
TGCGCCAGCAGCTTAACTGAGGGACAGGGGGAGGCCGGGGAGCTGTTTTTT	CASSLTEGQGEAGELFF	TRBV5-1	TRBJ2-2
TGTGCCAGCAGCATCGGTCAGGGGCTACATAATGAAAAACTGTTTTTT	CASSIGQGLHNEKLFF	TRBV7-2	TRBJ1-4
TGTGCTAGTGGTTTAGCGGGTGGGGGAGAGCGGACTGGGGCCAACGTCCTGACTTTC	CASGLAGGGERTGANVLTF	TRBV12-5	TRBJ2-6
TGTGCCAGCAGTGATCAAGGACTAGCTTCAGTACACGAGCAGTACTTC	CASSDQGLASVHEQYF	TRBV6-1	TRBJ2-7
TGTGCCAGCAGCCCTCGGGGAGTTGCACACGAAGCTTTCTTT	CASSPRGVAHEAFF	TRBV7-3	TRBJ1-1
TGTGCCAGCGCGGGAACGGGACATGAGCAGTTCTTC	CASAGTGHEQFF	TRBV27	TRBJ2-1
TGTGCCAGCAGCTTAGCGCGAATACCTTGGGTGGGACCCCATCGGCGGGGGCAGGGGGAGCTGTTTTTT	CASSLARIPWVGPHRRGQGELFF	TRBV7-2	TRBJ2-2
TGTGCCAGTGTTCCGGGGACAGGTTACTTGCAGGACAATCAGCCCCAGCATTTT	CASVPGTGYLQDNQPQHF	TRBV19	TRBJ1-5
TGTGCCAGCAGTGCTTCATTTAGCGGGTTTCGCTCCTACAATGAGCAGTTCTTC	CASSASFSGFRSYNEQFF	TRBV12-4	TRBJ2-1
TGTGCGGGGGGGGGGAACACTGAAGCTTTCTTT	CAGGGNTEAFF	TRBV27	TRBJ1-1
TGTGCCAGCAGAAGGGGTTGCAATCAGCCCCAGCATTTT	CASRRGCNQPQHF	TRBV6-6	TRBJ1-5
TGTGCCAGCAGCACGCACATACCGTTGGGGCGATCCTCCGAGCAGTACTTC	CASSTHIPLGRSSEQYF	TRBV7-4	TRBJ2-7
TGTGCCAGCAGTGACTCGCCCTGGGGCTACGAGCAGTACTTC	CASSDSPWGYEQYF	TRBV6-4	TRBJ2-7
TGTGCCTGGCTCTCAGGGGACGAGCAGTACTTC	CAWLSGDEQYF	TRBV30	TRBJ2-7
TGTGCCTGGAGTGTACCCCCCCCGGAGGGCAGGGGGAGGCCGAAGAACTACGAGCAGTACTTC	CAWSVPPPEGRGRPKNYEQYF	TRBV30	TRBJ2-7
TGTGCCAGCAGCGCTTTCAACCAAGAGGGACAGGGCAGCGTTCCCAGTGGGGCCAACGTCCTGACTTTC	CASSAFNQEGQGSVPSGANVLTF	TRBV5-6	TRBJ2-6
TGTGCCACCAGTGATTTGCAGGGGAAGGGAAATCAGCCCCAGCATTTT	CATSDLQGKGNQPQHF	TRBV24-1	TRBJ1-5
TGCGCCAGCAGTGACTGGACAGGCACAGATACGCAGTATTTT	CASSDWTGTDTQYF	TRBV10-1	TRBJ2-3
TGTGCCAGCTCACCCCGGGGACATAGCAATCAGCCCCAGCATTTT	CASSPRGHSNQPQHF	TRBV18	TRBJ1-5
TGTGCCAGCACCTATATAAGGGCGGTGACTAGCGGGGGGTGGACGACTGAGCAGTTCTTC	CASTYIRAVTSGGWTTEQFF	TRBV25-1	TRBJ2-1
TGTGCCACCAGCAGGTGGGCCGATTCCTACGAGCAGTACTTC	CATSRWADSYEQYF	TRBV15	TRBJ2-7
TGTGCCAGCAATGGGGCTCGGGGCTACACCTTC	CASNGARGYTF	TRBV7-3	TRBJ1-2
TGTGCCAGCAGCTCAACCGAACCCGGGGAGCCCCAGCATTTT	CASSSTEPGEPQHF	TRBV7-8	TRBJ1-5
TGTGCCACCAGTGATTTCCCGGGACAGGGAGTACACTACAATGAGCAGTTCTTC	CATSDFPGQGVHYNEQFF	TRBV24-1	TRBJ2-1
TGTGCCAGCAGGAATGGGGCCCGGGACAGGGTGGCTTTCTTT	CASRNGARDRVAFF	TRBV18	TRBJ1-1
TGTGCCAGCAGCGTACTCCTGGATCAGCCCCAGCATTTT	CASSVLLDQPQHF	TRBV9	TRBJ1-5
TGTGCCAGCAGTTACTCGTGGGACCGGCTGTGTCAGCCCCAGCATTTT	CASSYSWDRLCQPQHF	TRBV6-8	TRBJ1-5
TGTGCCTACGCATCTAGCGGGCCCGCAGATACGCAGTATTTT	CAYASSGPADTQYF	TRBV30	TRBJ2-3
TGTGCCAGCAGGGGGGCGGTTGAGCAGTACTTC	CASRGAVEQYF	TRBV9	TRBJ2-7
TGTGCCAGCAGCTTAGACACCCCCTCGGGGGGGAGTGGCTCCTACGAGCAGTACTTC	CASSLDTPSGGSGSYEQYF	TRBV13	TRBJ2-7
TGTGCCAGCAGCTTAACCCGAGCGGGAGTCACAGATACGCAGTATTTT	CASSLTRAGVTDTQYF	TRBV7-3	TRBJ2-3
TGCAGTGGGATCCTTTTATTGGGAAACACCATATATTTT	CSGILLLGNTIYF	TRBV20-1	TRBJ1-3
TGTGCCAGTACGGGTCAGCCCCAGCATTTT	CASTGQPQHF	TRBV6-1	TRBJ1-5
TGTGCCAGCAGCGGCTACCGACTAGAGTACGAGCAGTACTTC	CASSGYRLEYEQYF	TRBV7-3	TRBJ2-7
TGTGCCAGCAGTGACTCGAGTCGGAGGGGTTACAATGAGCAGTTCTTC	CASSDSSRRGYNEQFF	TRBV6-4	TRBJ2-1
TGTGCCAGCAGTTCCGGAGGCCTAATTCTTGCGGGAGATTACTTAAACACTGAAGCTTTCTTT	CASSSGGLILAGDYLNTEAFF	TRBV27	TRBJ1-1
TGTGCCAGCAGTGCGTTGAAGGGGAGGGACGCCGGAAATCAGCCCCAGCATTTT	CASSALKGRDAGNQPQHF	TRBV27	TRBJ1-5
TGTGCCACCGAGGCAAGGGGGGCGATGTACGAGCAGTACTTC	CATEARGAMYEQYF	TRBV15	TRBJ2-7
TGTGCCAGCAGCCCCCAAGGACAGGGAGGCTACGAGCAGTACTTC	CASSPQGQGGYEQYF	TRBV7-3	TRBJ2-7
TGTGCCAGCAGCCAAGCGGGACGGGGGCTATTAGAAGCTTTCTTT	CASSQAGRGLLEAFF	TRBV3-1	TRBJ1-1
TGTGCCAGCACAACGACAGGGCCTGGAGCTAACTATGGCTACACCTTC	CASTTTGPGANYGYTF	TRBV27	TRBJ1-2
TGTACAGAGTCCACCTACGAGCAGTACTTC	CTESTYEQYF	TRBV7-9	TRBJ2-7
TGTGCCACCAGTGACCGAATTGAGGGCAGAGGGGCCAACGTCCTGACTTTC	CATSDRIEGRGANVLTF	TRBV24-1	TRBJ2-6
TGTGCCAGCAGCTTGGGAGCCACGGGGGGGCTGTACCGCACAGATACGCAGTATTTT	CASSLGATGGLYRTDTQYF	TRBV5-4	TRBJ2-3
TGCAGTGCTAGAGCATGGATCGCCGGGTGTTCTTACTACGAGCAGTACTTC	CSARAWIAGCSYYEQYF	TRBV20-1	TRBJ2-7
TGTGCCAGCAGGCACATCCAGACCTTTGGGGCCAACGTCCTGACTTTC	CASRHIQTFGANVLTF	TRBV6-6	TRBJ2-6
TGTGCCAGCAGCCCGGGGGGGACTGAAGCTTTCTTT	CASSPGGTEAFF	TRBV13	TRBJ1-1
TGTGCCAGCAGTAAACTAGTCTCCCTCTCCTACAATGAGCAGTTCTTC	CASSKLVSLSYNEQFF	TRBV28	TRBJ2-1
TGTGCCAGCAGTTTCGAGGACAGGGGGCGGGACAGCAATCAGCCCCAGCATTTT	CASSFEDRGRDSNQPQHF	TRBV28	TRBJ1-5
TGTGCCAGCAGCTATGGGAGCAAACAAGAGACCCAGTACTTC	CASSYGSKQETQYF	TRBV7-2	TRBJ2-5
TGCGCCAGCAGCTTGGCAGGGGGCTTGGATGTCGAGCGAAAGAATGAAAAACTGTTTTTT	CASSLAGGLDVERKNEKLFF	TRBV5-1	TRBJ1-4
TGTGCCAGCAGCCCCCACGACTCCAGTCTAGGACCGGGAGGCCAAGAGACCCAGTACTTC	CASSPHDSSLGPGGQETQYF	TRBV11-2	TRBJ2-5
TGTGCCAGCAGGGCTGTTCACACAGATACGCAGTATTTT	CASRAVHTDTQYF	TRBV25-1	TRBJ2-3
TGTGCCAGCAGCCCGTTTAAGAGGGGAGACACCTTC	CASSPFKRGDTF	TRBV5-8	TRBJ1-2
TGCGCCAGCAGCACCCCGACAGGGGGCTTTGTGGTAAGTGAGCAGTTCTTC	CASSTPTGGFVVSEQFF	TRBV5-1	TRBJ2-1
TGCGCCAGCAGGGTAGGGGGCACTGAAGCTTTCTTT	CASRVGGTEAFF	TRBV10-1	TRBJ1-1
TGTGCCAGCAGCTTCATTATGAGGACATGGTTACGGGTGAACACTGAAGCTTTCTTT	CASSFIMRTWLRVNTEAFF	TRBV7-6	TRBJ1-1
TGCAGTGCTAGTCGGGGGGTGTCGAGCACAGATACGCAGTATTTT	CSASRGVSSTDTQYF	TRBV20-1	TRBJ2-3
TGTGCCACCAGGAAGGGGACAGGGGGAAACCAAGAGACCCAGTACTTC	CATRKGTGGNQETQYF	TRBV24-1	TRBJ2-5
TGTGCCAGCAGCAGTGGTGGGTACGGGTTTGCTTTCTTT	CASSSGGYGFAFF	TRBV13	TRBJ1-1
TGTGCCAGCAGCCGAGGGCAACAGGGAGGGGGTGAGCAGTTCTTC	CASSRGQQGGGEQFF	TRBV6-1	TRBJ2-1
TGTGCCAGCAGCTTAAGCCTTGACAGATCACCCTACGAGCAGTACTTC	CASSLSLDRSPYEQYF	TRBV11-3	TRBJ2-7
TGTGCTAGTGGAATAGGGGGGGCCAATCAGCCCCAGCATTTT	CASGIGGANQPQHF	TRBV12-5	TRBJ1-5
TGTGCCACCAGTGATACCGCTTGGGACTGGACGAACACTGAAGCTTTCTTT	CATSDTAWDWTNTEAFF	TRBV24-1	TRBJ1-1
TGTGCCAGCACTCGGGTAGGGGCGGGAGAGACCCAGTACTTC	CASTRVGAGETQYF	TRBV27	TRBJ2-5
TGCAGTGCTCCGACAGCTCACGAGAACACTGAAGCTTTCTTT	CSAPTAHENTEAFF	TRBV20-1	TRBJ1-1
TGTGCCAGCAGCCGTCGATGGGTCCCGACCCCTAACTATGGCTACACCTTC	CASSRRWVPTPNYGYTF	TRBV7-9	TRBJ1-2
TGTGCTAGTGGTAAATCGGACTTAGGAGATACGCAGTATTTT	CASGKSDLGDTQYF	TRBV12-5	TRBJ2-3
TGTGCCAGCAGAAGGGGGGGAGAAGCTTTCTTT	CASRRGGEAFF	TRBV12-4	TRBJ1-1
TGTGCCAGCAGGGGCATCCACTTC	CASRGIHF	TRBV24-1	TRBJ2-5
TGTGCTAGTGGTTTGGTACTCCCCATGAGCGGTAACTATGGCTACACCTTC	CASGLVLPMSGNYGYTF	TRBV12-5	TRBJ1-2
TGTGCCAGCAGCGGCAGGGGGGCCTACGAGCAGTACTTC	CASSGRGAYEQYF	TRBV11-2	TRBJ2-7
TGTGCCAGCAGTATTGGAGGAAGCTCTGGAAACACCATATATTTT	CASSIGGSSGNTIYF	TRBV6-5	TRBJ1-3
TGTGCCAGCAGTTACACCGACAGGGACCATATGAACACTGAAGCTTTCTTT	CASSYTDRDHMNTEAFF	TRBV6-8	TRBJ1-1
TGTGCCAGCAGTTTATTCATACAGAAGGGGGGGAATCTAACAAAACTGTTTTTT	CASSLFIQKGGNLTKLFF	TRBV27	TRBJ1-4
TGCGCCAGCAGCCTTCCCCAGGCGTACATATTCTATAATTCACCCCTCCACTTT	CASSLPQAYIFYNSPLHF	TRBV4-1	TRBJ1-6
TGTGCCAGCAGTTATCGGGGGGGCCACAGCTCCTACAATGAGCAGTTCTTC	CASSYRGGHSSYNEQFF	TRBV6-2	TRBJ2-1
TGTGCCACCAGCAGACGCTCATCTGGGAGGACAGGGGACACTGAAGCTTTCTTT	CATSRRSSGRTGDTEAFF	TRBV15	TRBJ1-1
TGTGCCAGCATGGGGGGGGCCACTGAAGCTTTCTTT	CASMGGATEAFF	TRBV3-1	TRBJ1-1
TGTGCCAGAGGCCGGGAGCAGTACTTC	CARGREQYF	TRBV19	TRBJ2-7
TGCGCCAGCAGCCGCGCCCCGGACTACGAGCAGTACTTC	CASSRAPDYEQYF	TRBV5-1	TRBJ2-7
TGTGCCAGCAGTGAATATGCCCGCCTAAACCACAGGGGAAGATCCTACGAGCAGTACTTC	CASSEYARLNHRGRSYEQYF	TRBV25-1	TRBJ2-7
TGTGCCAGCAGCTTAATTGAGGGAGGCTACACCTTC	CASSLIEGGYTF	TRBV7-6	TRBJ1-2
TGTGCCAGCAGCTTCGACAGGGTTGTCACTGAAGCTTTCTTT	CASSFDRVVTEAFF	TRBV7-9	TRBJ1-1
TGCGCCAGCAGCCCCGGCGGAGTGAACACTGAAGCTTTCTTT	CASSPGGVNTEAFF	TRBV5-1	TRBJ1-1
TGTGCCAGTAGTAGTGGGGGTGGTATCTCCTACGAGCAGTACTTC	CASSSGGGISYEQYF	TRBV19	TRBJ2-7
TGTGCCAGCAGGATAGTTCGCACAGATACGCAGTATTTT	CASRIVRTDTQYF	TRBV27	TRBJ2-3
TGTGCCAGCTCACCCGTGACCGGGACAGGGCGGTCTGGGGCCAACGTCCTGACTTTC	CASSPVTGTGRSGANVLTF	TRBV18	TRBJ2-6
TGTGCCAGCAGGGACAGGGGCCATCAATCCTACGAGCAGTACTTC	CASRDRGHQSYEQYF	TRBV6-5	TRBJ2-7
TGTGCCAGCTCACCTGCGGGAGGGGAAGAGACCCAGTACTTC	CASSPAGGEETQYF	TRBV18	TRBJ2-5
TGTGCCAGACTTTGCCGGGACAGGAAAAAACGTTCACCCCTCCACTTT	CARLCRDRKKRSPLHF	TRBV6-1	TRBJ1-6
TGTGCCAGCAGCTGTGGGGGACAGGGCCTTAGGCGGGGGGGCTACGAGCAGTACTTC	CASSCGGQGLRRGGYEQYF	TRBV5-6	TRBJ2-7
TGTGCCAGCAGCCAAGAGTTTAAAGCGCGGGTCACCGGGGAGCTGTTTTTT	CASSQEFKARVTGELFF	TRBV3-1	TRBJ2-2
TGCAGCTGCGCGGGAGCCTGCACAGATACGCAGTATTTT	CSCAGACTDTQYF	TRBV29-1	TRBJ2-3
TGCAGCCCGGGGGACAGGGGTTTAGATACGCAGTATTTT	CSPGDRGLDTQYF	TRBV29-1	TRBJ2-3
TGCGCCAGCAGCATTACGGACAGGGGACTGGACCTGAACACTGAAGCTTTCTTT	CASSITDRGLDLNTEAFF	TRBV5-1	TRBJ1-1
TGTGCCAGCAGTCTTTTTCGAGAACAGGGGGGTAGAGGTGAAAAACTGTTTTTT	CASSLFREQGGRGEKLFF	TRBV28	TRBJ1-4
TGTGCCAGCAGTTACCGGAGGTTGGACAGGGGGAACTATGGCTACACCTTC	CASSYRRLDRGNYGYTF	TRBV6-5	TRBJ1-2
TGTGCCAGCAGCGACAGGGAAATTAGAAATTCACCCCTCCACTTT	CASSDREIRNSPLHF	TRBV9	TRBJ1-6
TGTGCCAGCAGCCTCCCTAGGGCCGGGACATCAAGACAGGGCTACACCTTC	CASSLPRAGTSRQGYTF	TRBV14	TRBJ1-2
TGTGCCAGCAGCCGGGCTTACGAGCAGTACTTC	CASSRAYEQYF	TRBV14	TRBJ2-7
TGTGCCACCCGAGGCCGGACCTGTGATGGCTACACCTTC	CATRGRTCDGYTF	TRBV15	TRBJ1-2
TGTGCCAGCAGTGACTCGTGGCGGGGGCCGAACACTGAAGCTTTCTTT	CASSDSWRGPNTEAFF	TRBV6-4	TRBJ1-1
TGTGCCAGCAGCTATGTAAGGACAGGGCTAGCTTTCTTT	CASSYVRTGLAFF	TRBV11-2	TRBJ1-1
TGTGCCAGCAGCCAAGTCCGGACACACTACGAGCAGTACTTC	CASSQVRTHYEQYF	TRBV3-1	TRBJ2-7
TGTGCCGAAAGTCGAGGCAATGAGCAGTTCTTC	CAESRGNEQFF	TRBV27	TRBJ2-1
TGCACTGATCGGGGGTACGAGCAGTACTTC	CTDRGYEQYF	TRBV29-1	TRBJ2-7
TGTGCCAGCTCACGACAGGGAACGGAAGGGAACACTGAAGCTTTCTTT	CASSRQGTEGNTEAFF	TRBV18	TRBJ1-1
TGTGCCAGCAGTTTTCTAGCGGGGCATTACAATGAGCAGTTCTTC	CASSFLAGHYNEQFF	TRBV27	TRBJ2-1
TGCGCCAGCAGCCAATCCCTCTGGGGGGCGCGAGAGTCCTACGAGCAGTACTTC	CASSQSLWGARESYEQYF	TRBV4-3	TRBJ2-7
TGTGCCAGCAGGGACAGGGGTTTTCCTGAAAAACTGTTTTTT	CASRDRGFPEKLFF	TRBV3-1	TRBJ1-4
TGCGCCAGCAGCCCCCCGTTGACTAGCGGGAGCAATGAGCAGTTCTTC	CASSPPLTSGSNEQFF	TRBV5-1	TRBJ2-1
TGTGCCCCGTCGGGAGGTAGCACAGATACGCAGTATTTT	CAPSGGSTDTQYF	TRBV6-2	TRBJ2-3
TGTGCCAGCAAAAAAGGTCCCCGGGGACCTCTTGGAGCTAACTATGGCTACACCTTC	CASKKGPRGPLGANYGYTF	TRBV7-9	TRBJ1-2
TGTGCCAGCAGCTTTGCAGGGGGCACTTCTGGCTACACCTTC	CASSFAGGTSGYTF	TRBV5-4	TRBJ1-2
TGTGCCAGAAAATGGGGGGACGATACGCAGTATTTT	CARKWGDDTQYF	TRBV27	TRBJ2-3
TGTGCTAGTGGTCGCGGGACAGGGGTCCCATACGAGCAGTACTTC	CASGRGTGVPYEQYF	TRBV12-5	TRBJ2-7
TGTGCCATCTGGCCGGGACTAGCGGGCAGGACCTACGAGCAGTACTTC	CAIWPGLAGRTYEQYF	TRBV6-5	TRBJ2-7
TGTGCCAGCAGCACTGGGACTAGCGGGGAATATTTCTACGAGCAGTACTTC	CASSTGTSGEYFYEQYF	TRBV13	TRBJ2-7
TGCGCCAGCAGCTTGCTTCATGTGATTGGGGACGAGCAGTACTTC	CASSLLHVIGDEQYF	TRBV5-1	TRBJ2-7
TGTGCCAGCAGCTTAAGGCGCGGGGGTGCCCCTACCTACGAGCAGTACTTC	CASSLRRGGAPTYEQYF	TRBV7-3	TRBJ2-7
TGCAGTGCCAAAGTGTGGGGGGGGGAGGGGTACGAGCAGTACTTC	CSAKVWGGEGYEQYF	TRBV20-1	TRBJ2-7
TGTGCCATCATGGGACAGGGTTTGAACACTGAAGCTTTCTTT	CAIMGQGLNTEAFF	TRBV10-3	TRBJ1-1
TGTGCCAGCAGTGACTCGACACGCACTCGTTCCGGTTCGGACAAGAACACTGAAGCTTTCTTT	CASSDSTRTRSGSDKNTEAFF	TRBV6-4	TRBJ1-1
TGTGCTAGCAGCTCCACGTCAGGACAGGGGGGCTACACCTTC	CASSSTSGQGGYTF	TRBV7-7	TRBJ1-2
TGTGCCAGCAGCTTGGTTCAGGACAGCACCCAGCATTTT	CASSLVQDSTQHF	TRBV5-6	TRBJ1-5
TGTGCCAGCAGCGGACCGAAGGGCCTAGTTGGGGGCTACGAGCAGTACTTC	CASSGPKGLVGGYEQYF	TRBV14	TRBJ2-7
TGTGCCAGCAGCGGCCTGGGGGGGTGGTCTAGCACAGATACGCAGTATTTT	CASSGLGGWSSTDTQYF	TRBV7-3	TRBJ2-3
TGTGCCAGCACCTATTGGCCCTATGGCTACACCTTC	CASTYWPYGYTF	TRBV6-5	TRBJ1-2
TGTGCCAGCACGGGACAGGGGGGAGGCACAGATACGCAGTATTTT	CASTGQGGGTDTQYF	TRBV7-2	TRBJ2-3
TGCGCCAGCAGCAAAGCGGGAAGCCAAGCTTTCTTT	CASSKAGSQAFF	TRBV4-1	TRBJ1-1
TGTGCCAGCAGTTGCGAACTTAGGGAGTACGAGCAGTACTTC	CASSCELREYEQYF	TRBV27	TRBJ2-7
TGCGCCAGCAGCACCACAGGGGAGCCACGTGAGGACTATCCCGATCAGCCCCAGCATTTT	CASSTTGEPREDYPDQPQHF	TRBV5-1	TRBJ1-5
TGTGCCAGCAGATTTCTACAGTACGAGCAGTACTTC	CASRFLQYEQYF	TRBV6-1	TRBJ2-7
TGTGCCAGCAGCCAAAATCACCCCACCCTCTCTTGGGGCGGGGAAGGCAATCAGCCCCAGCATTTT	CASSQNHPTLSWGGEGNQPQHF	TRBV7-4	TRBJ1-5
TGCGCCAGCCTCCGGGCCTCGGGACTCTCTGGAAACACCATATATTTT	CASLRASGLSGNTIYF	TRBV10-1	TRBJ1-3
TGTGCCAGCAGCCGGTGGAGCAGGAGAGGGGTTACAACTAATGAAAAACTGTTTTTT	CASSRWSRRGVTTNEKLFF	TRBV9	TRBJ1-4
TGTGCCACCAGCAGAGATCCAGCTAGACAGGGAGGCACTAACTATGGCTACACCTTC	CATSRDPARQGGTNYGYTF	TRBV15	TRBJ1-2
TGTGCCAGCAGCTTCTCTCTCTCCTACGAGCAGTACTTC	CASSFSLSYEQYF	TRBV11-2	TRBJ2-7
TGTGCTAGTGGTTATCCCTCCTTAGAGGGGGCAGATACGCAGTATTTT	CASGYPSLEGADTQYF	TRBV12-5	TRBJ2-3
TGTGCCAGCAGCCGCGACGCGGACGAGCAGTACTTC	CASSRDADEQYF	TRBV7-2	TRBJ2-7
TGCGCCAGCAGCCCATTGCCCCCGGAGGGATGGTGGAGCTCCTACGAGCAGTACTTC	CASSPLPPEGWWSSYEQYF	TRBV4-1	TRBJ2-7
TGCGCCAGCATCAAGAAACGGGGGGGCGGACAAGAGACCCAGTACTTC	CASIKKRGGGQETQYF	TRBV10-2	TRBJ2-5
TGTGCCAGCAGGATACGGGGGGAAGGCTCTGGGGCCAACGTCCTGACTTTC	CASRIRGEGSGANVLTF	TRBV14	TRBJ2-6
TGTGCCAGCAGCCAAGGGGGTGAGTTCCACGAGCAGTACTTC	CASSQGGEFHEQYF	TRBV3-1	TRBJ2-7
TGTGCCAGCAGTGCTGCTTATGGCGAGCAGTACTTC	CASSAAYGEQYF	TRBV6-4	TRBJ2-7
TGCAGCGGGAAACCGACAGAGTCTGAAGCTTTCTTT	CSGKPTESEAFF	TRBV29-1	TRBJ1-1
TGTGCCAGCAGTGACCGCTGGGGGATTCAGCCCCAGCATTTT	CASSDRWGIQPQHF	TRBV25-1	TRBJ1-5
TGTGCCAGCAGTCCAATTTGGGAGGCACTAAACACTGAAGCTTTCTTT	CASSPIWEALNTEAFF	TRBV27	TRBJ1-1
TGTGCCAGCTCACCACATACCGGGGACGAACTCGGGAGAGGTGGGGCTGAAGCTTTCTTT	CASSPHTGDELGRGGAEAFF	TRBV18	TRBJ1-1
TGTGCCAGCAGGATCGAGGACAGCTATGGCTACACCTTC	CASRIEDSYGYTF	TRBV5-6	TRBJ1-2
TGTGCCAACACGGACAGATTTGCGAACACCGGGGAGCTGTTTTTT	CANTDRFANTGELFF	TRBV27	TRBJ2-2
TGTGCCAGTAGTATTGGACAGGAGGAGCAGTACTTC	CASSIGQEEQYF	TRBV19	TRBJ2-7
TGTGCCAGCCCCGCTTATAGAGTCAATGAGCAGTTCTTC	CASPAYRVNEQFF	TRBV7-3	TRBJ2-1
TGCAGTGCTAGCAGCCCGGACAGGGGGCTATCAGTTAGCTCCTACAATGAGCAGTTCTTC	CSASSPDRGLSVSSYNEQFF	TRBV20-1	TRBJ2-1
TGTGACGACCCCCTAGCGGGAGGGCGGACAGATCAGCCCCAGCATTTT	CDDPLAGGRTDQPQHF	TRBV12-3	TRBJ1-5
TGTGCCAGCAGTTACCAGTTCTTAGCTAGCACAGATACGCAGTATTTT	CASSYQFLASTDTQYF	TRBV6-2	TRBJ2-3
TGCGCCAGCAGCCAAAACAGTTCAACGAGGGGGGACGTCCCGCAGTACTTC	CASSQNSSTRGDVPQYF	TRBV4-1	TRBJ2-5
TGTGCCAGCAGCTTAGAAATGAATATCTCACCCCTCCACTTT	CASSLEMNISPLHF	TRBV7-8	TRBJ1-6
TGTGCCAGCAGCGCGACAGGACTGAAGAAGCCGATGAACACTGAAGCTTTCTTT	CASSATGLKKPMNTEAFF	TRBV5-4	TRBJ1-1
TGTGCCAGCAGTGATCGGGGTGGGGCTTTCTTT	CASSDRGGAFF	TRBV25-1	TRBJ1-1
TGTGCCAGCAGACCTAAGGCAGATACGCAGTATTTT	CASRPKADTQYF	TRBV6-4	TRBJ2-3
TGTGCCAGCAGCTTTCGACATGAGCAGTTCTTC	CASSFRHEQFF	TRBV7-3	TRBJ2-1
TGTGCCAGCAGGCTCCGGATCGTAGCCAAAAACATTCAGTACTTC	CASRLRIVAKNIQYF	TRBV6-5	TRBJ2-4
TGCGCCAGCCACCACGACAAACCGGTGAACACTGAAGCTTTCTTT	CASHHDKPVNTEAFF	TRBV5-1	TRBJ1-1
TGTGCCAGCAGGAGGGCCGGCTACGAGCAGTACTTC	CASRRAGYEQYF	TRBV6-2	TRBJ2-7
TGCACGAAGAGTAGGGCTGAAGCTTTCTTT	CTKSRAEAFF	TRBV20-1	TRBJ1-1
TGTGCCAGGACTTTCAGGAGCTCCTACAATGAGCAGTTCTTC	CARTFRSSYNEQFF	TRBV6-5	TRBJ2-1
TGTGCCAGCAGCCAAGGGGGAGGAGCAGCGGCTCGGGTGGACAATGAAAAACTGTTTTTT	CASSQGGGAAARVDNEKLFF	TRBV12-3	TRBJ1-4
TGTGCCAGCAGCAAGGGGTATCTTAATGAAAAACTGTTTTTT	CASSKGYLNEKLFF	TRBV7-3	TRBJ1-4
TGTGCCAGCAGAGCGTCAGGGGATTCAGCTTTCTTT	CASRASGDSAFF	TRBV12-4	TRBJ1-1
TGTGCCAGCAGCTCCCAACGGCGCTCGCCAAACTTC	CASSSQRRSPNF	TRBV13	TRBJ2-7
TGTGCCAGCAGCTTTATTTTCCCCGGGACAGGGGTTAGTCTCCGCTATGGCTACACCTTC	CASSFIFPGTGVSLRYGYTF	TRBV5-6	TRBJ1-2
TGCAGCGTTATAGGCTATGGCTACACCTTC	CSVIGYGYTF	TRBV29-1	TRBJ1-2
TGTGCCAGCAGTTCCACGGAACCTCAAGAGACCCAGTACTTC	CASSSTEPQETQYF	TRBV27	TRBJ2-5
TGTGCTAGCAGCGATGCGGCCTTGAACAATGAGCAGTTCTTC	CASSDAALNNEQFF	TRBV7-7	TRBJ2-1
TGCGCCAGCAGCAGCGGGAGGAGCCCGGCATATAGCAATCAGCCCCAGCATTTT	CASSSGRSPAYSNQPQHF	TRBV5-1	TRBJ1-5
TGCGCTTCGGCTTCGAGCACAGATACGCAGTATTTT	CASASSTDTQYF	TRBV10-1	TRBJ2-3
TGTGCCAGCAGCCAAGATTCTAGGAGGGACGGGAAACAGGTCGTGGGGCCCTACGAGCAGTACTTC	CASSQDSRRDGKQVVGPYEQYF	TRBV14	TRBJ2-7
TGTGCCAGCAGCCAAGAGAACAGGACAGGGGGCGAAAGAGCCTACGAGCAGTACTTC	CASSQENRTGGERAYEQYF	TRBV14	TRBJ2-7
TGTGCCAGCAGCTTACCGGGGCGACTGGGAAACTTCTCCTATAATTCACCCCTCCACTTT	CASSLPGRLGNFSYNSPLHF	TRBV7-3	TRBJ1-6
TGTGCCACCAGTGATTTGGCAGATAGACAGGGCAGGTGCTACGAGCAGTACTTC	CATSDLADRQGRCYEQYF	TRBV24-1	TRBJ2-7
TGTGCCAGCAGCAACCGAAGGGGGGGCCGGCACTACGAGCAGTACTTC	CASSNRRGGRHYEQYF	TRBV7-4	TRBJ2-7
TGCAGTGCTGGGACAGCACCACTAGAAAAACTGTTTTTT	CSAGTAPLEKLFF	TRBV20-1	TRBJ1-4
TGTGCCAGCTCACGGCTCCTTTCTCACCGGGACTCCTACGAGCAGTACTTC	CASSRLLSHRDSYEQYF	TRBV18	TRBJ2-7
TGTGCCAGCAGCTTACGACAGAATGAAAAACTGTTTTTT	CASSLRQNEKLFF	TRBV7-7	TRBJ1-4
TGTGCCAGCAGCGGTGAGGGTTACAATGAGCAGTTCTTC	CASSGEGYNEQFF	TRBV9	TRBJ2-1
TGTGCCACCAGCAAGGGCCGGGAAGTGGAGACCCAGTACTTC	CATSKGREVETQYF	TRBV15	TRBJ2-5
TGCGCCAGCAGCGACGGACAGCGCCCCCTCCACTTT	CASSDGQRPLHF	TRBV5-1	TRBJ1-6
TGTGCCAGAAGGGACAGGGCATATGCGCGAAGTGATCAGCCCCAGCATTTT	CARRDRAYARSDQPQHF	TRBV5-6	TRBJ1-5
TGTGCCAGCAGGCCCAGCCGGGACAGGGGAGCAAGGTACAATGAGCAGTTCTTC	CASRPSRDRGARYNEQFF	TRBV6-5	TRBJ2-1
TGTGCCAGCAAAAGCTGGGACAGGGGCTCCTACGAGCAGTACTTC	CASKSWDRGSYEQYF	TRBV6-2	TRBJ2-7
TGCGCCAGCAGCTTGGAAAAGGACAGGGAGTATAATGAAAAACTGTTTTTT	CASSLEKDREYNEKLFF	TRBV5-1	TRBJ1-4
TGTGCCAGTTTCCTGTCCGGGACTAGCATCACCGGGGAGCTGTTTTTT	CASFLSGTSITGELFF	TRBV19	TRBJ2-2
TGTGCCAGCAAACCGGGGCCCAGGAATGAAAAACTGTTTTTT	CASKPGPRNEKLFF	TRBV9	TRBJ1-4
TGTGCTAGTGGGCCGGGTGCACCCCAAGAGACCCAGTACTTC	CASGPGAPQETQYF	TRBV12-5	TRBJ2-5
TGTGCCAGCAGTAACTTTTGGGACATGAACACTGAAGCTTTCTTT	CASSNFWDMNTEAFF	TRBV6-6	TRBJ1-1
TGTGCCAGCAGTCCACTAGCGGGAGGGCATGAGACCCAGTACTTC	CASSPLAGGHETQYF	TRBV27	TRBJ2-5
TGTGCCAGCTCACACTTACTAGTCTACGAGCAGTACTTC	CASSHLLVYEQYF	TRBV18	TRBJ2-7
TGTGCCAGCAGTGGGAGCCTAGCGGGACCCGGGGAGCTGTTTTTT	CASSGSLAGPGELFF	TRBV6-1	TRBJ2-2
TGCGCCAGCAGTGGCCACTCAGACGGGGTATACAATGAGCAGTTCTTC	CASSGHSDGVYNEQFF	TRBV5-1	TRBJ2-1
TGTGCCTGGAGCAGGCTGGACCCTTTCCCTGACACAGATACGCAGTATTTT	CAWSRLDPFPDTDTQYF	TRBV30	TRBJ2-3
TGTGCCAGCAGTCGATCTCAGGGCTATGAGCAGTTCTTC	CASSRSQGYEQFF	TRBV14	TRBJ2-1
TGCACAGAGGACTATGGCTACACCTTC	CTEDYGYTF	TRBV20-1	TRBJ1-2
TGTGCCAGAGCCAGGGCCAACTCTGGAAACACCATATATTTT	CARARANSGNTIYF	TRBV14	TRBJ1-3
TGCGCCAGCAGCCGCGGCACAGATACGCAGTATTTT	CASSRGTDTQYF	TRBV5-1	TRBJ2-3
TGTGCCAGCAGGAGAACAGGGCGAGAGCAGTACTTC	CASRRTGREQYF	TRBV11-2	TRBJ2-7
TGTGCCAGCAGTTGGCAGGGCTCGACCTCCTACGAGCAGTACTTC	CASSWQGSTSYEQYF	TRBV27	TRBJ2-7
TGTGCCAGCAGTTGTGAGAAGACAGTCACAGATACGCAGTATTTT	CASSCEKTVTDTQYF	TRBV6-2	TRBJ2-3
TGTGCCAGCAGCACCGCGACAGGGGGAGACCCAGCTTTCTTT	CASSTATGGDPAFF	TRBV7-9	TRBJ1-1
TGTGCCAGTAGGAGGGGGGGCGTAGAAAACACTGAAGCTTTCTTT	CASRRGGVENTEAFF	TRBV28	TRBJ1-1
TGCAGCGTTGGGGTTGGGGACTTGGGGGAGGATGGCTACACCTTC	CSVGVGDLGEDGYTF	TRBV29-1	TRBJ1-2
TGCGCCAGGGGTCCCGGGACTAGGGTACTTGGTACAAAGAGGCGTGAGCAAGAGACCCAGTACTTC	CARGPGTRVLGTKRREQETQYF	TRBV5-1	TRBJ2-5
TGTGCCAGCAGCCAAGTGTCCCCGGGACTAGCGGGAGCAAACGAGCAGTACTTC	CASSQVSPGLAGANEQYF	TRBV14	TRBJ2-7
TGTGCCAGCAGCCCCGCGGGAGTACCTGAAAAACTGTTTTTT	CASSPAGVPEKLFF	TRBV13	TRBJ1-4
TGTGCCCTAACAGGGGGAGACACCGGGGAGCTGTTTTTT	CALTGGDTGELFF	TRBV12-3	TRBJ2-2
TGCATCCCCCGCAGTCTGAAAAGGGGAAGGTGTGGCTACACCTTC	CIPRSLKRGRCGYTF	TRBV20-1	TRBJ1-2
TGCAGTGCACCTAAGCAGTACTTC	CSAPKQYF	TRBV20-1	TRBJ2-7
TGTGCCAGCAGTGGGGGGGGATACAATGAGCAGTTCTTC	CASSGGGYNEQFF	TRBV27	TRBJ2-1
TGTGCCAGCAGTTATCAGAGACTTGGGACTAGCTCTTCAGACATTCAGTACTTC	CASSYQRLGTSSSDIQYF	TRBV6-5	TRBJ2-4
TGTGCCAGCGACGCAGGGGGCAACTACGAGCAGTACTTC	CASDAGGNYEQYF	TRBV2	TRBJ2-7
TGCAGTGCGAGGTCCGTGCCGCCGTTCCCAAGGGGGGTCACCGGGGAGCTGTTTTTT	CSARSVPPFPRGVTGELFF	TRBV20-1	TRBJ2-2
TGTGCCAGCAGATGGGGGGGTCGTAGGGGGAACACCGGGGAGCTGTTTTTT	CASRWGGRRGNTGELFF	TRBV28	TRBJ2-2
TGTGCCAGCAGTCGGTACGAGCAGTACTTC	CASSRYEQYF	TRBV27	TRBJ2-7
TGTGCCAGCAGTGAAGACTCTTCATGCGCCACAGATACGCAGTATTTT	CASSEDSSCATDTQYF	TRBV6-1	TRBJ2-3
TGCAGTGCTACCCGCTACGAGCAGTACTTC	CSATRYEQYF	TRBV20-1	TRBJ2-7
TGTGCCCGGATCCGGGAGGGCCCTACTCAGCCCCAGCATTTT	CARIREGPTQPQHF	TRBV19	TRBJ1-5
TGCGCCAGCAGCGTCCCGACCAATGGCTACACCTTC	CASSVPTNGYTF	TRBV5-1	TRBJ1-2
TGTGCCAGCTCACCCTGGGGGCTAAGCAATCAGCCCCAGCATTTT	CASSPWGLSNQPQHF	TRBV18	TRBJ1-5
TGTGCCAGCAGTAGCGTGAGCTCCTACGAGCAGTACTTC	CASSSVSSYEQYF	TRBV28	TRBJ2-7
TGTGCTAGTGTAACTAGCGGGAGCCCCTGGGGGCTCAGCACAGATACGCAGTATTTT	CASVTSGSPWGLSTDTQYF	TRBV12-5	TRBJ2-3
TGCAGTGCACTGGGGCAAGAGCAGTTCTTC	CSALGQEQFF	TRBV20-1	TRBJ2-1
TGTGCCAGCAGCTGTCAGACAGGGCGCGTAAATCAGCCCCAGCATTTT	CASSCQTGRVNQPQHF	TRBV5-5	TRBJ1-5
TGCAGTGCTAGATTCAGCGGACAGGATGGGAACACTGAAGCTTTCTTT	CSARFSGQDGNTEAFF	TRBV20-1	TRBJ1-1
TGCAGTGCTATGCAGGGAGGGGAATATCGCAGGTTCTCTGGGGCCAACGTCCTGACTTTC	CSAMQGGEYRRFSGANVLTF	TRBV20-1	TRBJ2-6
TGTGCCAGCAGGCCGGACAGGGTGGGCCATAGCAATCAGCCCCAGCATTTT	CASRPDRVGHSNQPQHF	TRBV11-1	TRBJ1-5
TGCGCCAGCAGCCAAGATGGAGGGAAAAATTCACCCCTCCACTTT	CASSQDGGKNSPLHF	TRBV4-1	TRBJ1-6
TGTGCCAGCAGTTGGGACGACTACGAGCAGTACTTC	CASSWDDYEQYF	TRBV12-3	TRBJ2-7
TGTGCCAGCAGTTCGTCCCCGGGACGACCCCCTTACAATGAGCAGTTCTTC	CASSSSPGRPPYNEQFF	TRBV6-6	TRBJ2-1
TGTGCCAGCAGGGCGGGGGAGACCCAGTACTTC	CASRAGETQYF	TRBV6-5	TRBJ2-5
TGTGCCAGCAGTGAGGGCGGCTACACCTTC	CASSEGGYTF	TRBV6-4	TRBJ1-2
TGTGCCAGCAGCAACGGCGCGGGAGACCTAAACTATGGCTACACCTTC	CASSNGAGDLNYGYTF	TRBV9	TRBJ1-2
TGCAGTGCCACGGCGCGCAGTCCCATGAACACTGAAGCTTTCTTT	CSATARSPMNTEAFF	TRBV20-1	TRBJ1-1
TGTGCTAGTGGTTTGCCCTACGGCGAGCAGTTCTTC	CASGLPYGEQFF	TRBV12-5	TRBJ2-1
TGTGCCAGCAGCGGGGACAGGGTGGGGGATAGTAACTATGGCTACACCTTC	CASSGDRVGDSNYGYTF	TRBV13	TRBJ1-2
TGTGCAACGGGACGCTATGGCTACACCTTC	CATGRYGYTF	TRBV6-5	TRBJ1-2
TGTGCCACAGGGACCCGACAATTTGAGACCCAGTACTTC	CATGTRQFETQYF	TRBV24-1	TRBJ2-5
TGCAGTGCTACGTGGGGAGCCCTCGTTCTGACAGATACGCAGTATTTT	CSATWGALVLTDTQYF	TRBV20-1	TRBJ2-3
TGTGCCAGCAGCTTGTCAGGAGGGGGGGAAGAGATAGGTCGGTCCTATAATTCACCCCTCCACTTT	CASSLSGGGEEIGRSYNSPLHF	TRBV6-5	TRBJ1-6
TGTGCCAGCAGCGCGGGCGAAATTAGGAGGGCCTACAATGAGCAGTTCTTC	CASSAGEIRRAYNEQFF	TRBV7-4	TRBJ2-1
TGTGCCAGCAGCCAAGATTGTCTAGGGGGACCTGAGCAGTACTTC	CASSQDCLGGPEQYF	TRBV14	TRBJ2-7
TGTGCCAGCAGTGACTCGGTGTGGGACACGCAGTATTTT	CASSDSVWDTQYF	TRBV6-4	TRBJ2-3
TGTGCCAGCAGACCGGTGGACGTAGGGGAGCAGTTCTTC	CASRPVDVGEQFF	TRBV6-3	TRBJ2-1
TGTGCCAGCAGCTCCAGGGCGTATTATACTGAAGCTTTCTTT	CASSSRAYYTEAFF	TRBV7-2	TRBJ1-1
TGTGCCAGCAGACGGAAGGGGGCGAATAGCAATCAGCCCCAGCATTTT	CASRRKGANSNQPQHF	TRBV13	TRBJ1-5
TGTGCCTGGAGTCCTCCCCAGGAACATGCTGGAAACACCATATATTTT	CAWSPPQEHAGNTIYF	TRBV30	TRBJ1-3
TGTGCCAGCAACAGGGAACCTCAGTTGAACATTCAGTACTTC	CASNREPQLNIQYF	TRBV28	TRBJ2-4
TGTGCCAGCAGCTTGGTACGATTCATAACCAAAGTCACTAATGAAAAACTGTTTTTT	CASSLVRFITKVTNEKLFF	TRBV5-4	TRBJ1-4
TGTGCCAGCAGCCAACCTACAGGGACCAGTCAAGAGACCCAGTACTTC	CASSQPTGTSQETQYF	TRBV4-2	TRBJ2-5
TGTGCCAGCAGGAGCGCGGACAGTAAAGAGACCCAGTACTTC	CASRSADSKETQYF	TRBV11-3	TRBJ2-5
TGTGCCAGCAGTGAATCAAGGGGACAGGGTTCACCCCTCCACTTT	CASSESRGQGSPLHF	TRBV2	TRBJ1-6
TGTGCCAGCAGCTTAAGGGGGGAGGGCGAGCAGTACTTC	CASSLRGEGEQYF	TRBV7-2	TRBJ2-7
TGTGCTAGTGGTTTGGGGACAGATAACACTGAAGCTTTCTTT	CASGLGTDNTEAFF	TRBV12-5	TRBJ1-1
TGTGCCAGCAGCTGTTCGCCCCCCTACGAGCAGTACTTC	CASSCSPPYEQYF	TRBV7-9	TRBJ2-7
TGTGCCCCGGGACAGGGTACTGAAGCTTTCTTT	CAPGQGTEAFF	TRBV28	TRBJ1-1
TGTGCCAGCAGCTTAAAAGTCTCTAGGGGAGATCTAACAGAGACCCAGTACTTC	CASSLKVSRGDLTETQYF	TRBV11-1	TRBJ2-5
TGTGCCAGCAGCGAGAGGGCTTGGGGCGAGACCCAGTACTTC	CASSERAWGETQYF	TRBV11-3	TRBJ2-5
TGTGCCAGTAGTATAGCAAACCCCGGGACAGGGTACCCGGACAATCAGCCCCAGCATTTT	CASSIANPGTGYPDNQPQHF	TRBV19	TRBJ1-5
TGTGCCAGCAGCTCCCGCCGAGAGGAAGAGAATTCACCCCTCCACTTT	CASSSRREEENSPLHF	TRBV7-2	TRBJ1-6
TGTGCCAGCAGCAGAGGATCGGACAGGGATATTGGCTACACCTTC	CASSRGSDRDIGYTF	TRBV7-2	TRBJ1-2
TGCAGTGCTAGCAACGGGACCCGAACTGACGAGCAGTACTTC	CSASNGTRTDEQYF	TRBV20-1	TRBJ2-7
TGTGCCAGCAGCCTTGACAGTCCTCCGAACACTGAAGCTTTCTTT	CASSLDSPPNTEAFF	TRBV7-4	TRBJ1-1
TGTGCCAGTATACGGACTAGCGGGAAACTCGAGCAGTACTTC	CASIRTSGKLEQYF	TRBV19	TRBJ2-7
TGTGCCATCAGTGAGCAACGAGGGTCTACCGGGGAGCTGTTTTTT	CAISEQRGSTGELFF	TRBV10-3	TRBJ2-2
TGTGCCAGCAGCGTTATGAAATGGAAGACAGGGGGCAATGGCTACACCTTC	CASSVMKWKTGGNGYTF	TRBV11-2	TRBJ1-2
TGTGCCAGCAGCTCAGGACAGGGTGCACAATTCTACGAGCAGTACTTC	CASSSGQGAQFYEQYF	TRBV13	TRBJ2-7
TGTGCCAGCAGAGGGGGTGGGATGAACACTGAAGCTTTCTTT	CASRGGGMNTEAFF	TRBV12-3	TRBJ1-1
TGTGCCAGTAGTGGATTCCCAATACTACGGGAGCGTCAACTAGATCAAGAGACCCAGTACTTC	CASSGFPILRERQLDQETQYF	TRBV19	TRBJ2-5
TGTGCCAGCAGTTCTTCAGGGGGATCTGGAAACACCATATATTTT	CASSSSGGSGNTIYF	TRBV28	TRBJ1-3
TGTGCCAGCAGCAACCTGGGACTAGCGGGGGGGTTCTTC	CASSNLGLAGGFF	TRBV28	TRBJ2-1
TGTGCCAGCAGCGACCTCACAGATACGCAGTATTTT	CASSDLTDTQYF	TRBV7-9	TRBJ2-3
TGTGCCAGCAGCCGACAAGGACAGGGGGAGAACACTGAAGCTTTCTTT	CASSRQGQGENTEAFF	TRBV13	TRBJ1-1
TGTGCCAGCAGTTTAAGGCCAACCCCTGAGCAGTACTTC	CASSLRPTPEQYF	TRBV27	TRBJ2-7
TGCGCCAGCAGCTGGGGGGGTAGCTTTCGGACTGAAGCTTTCTTT	CASSWGGSFRTEAFF	TRBV5-1	TRBJ1-1
TGTGGCAGGCCGCGGTCTAATGAAAAACTGTTTTTT	CGRPRSNEKLFF	TRBV6-4	TRBJ1-4
TGTGCCACCAGGGGAGGCATCAAAGACAATGAAAAACTGTTTTTT	CATRGGIKDNEKLFF	TRBV24-1	TRBJ1-4
TGTGCCAGCGGGCACCAACAGGGGGCCGAGACCCAGTACTTC	CASGHQQGAETQYF	TRBV11-3	TRBJ2-5
TGTGCCAACCTGACTAGAGCAGATACGCAGTATTTT	CANLTRADTQYF	TRBV27	TRBJ2-3
TGTGCCAGCAGCATCCACAGGGACGAGCAGTACTTC	CASSIHRDEQYF	TRBV7-9	TRBJ2-7
TGCGCCAGCAGCCATGCGACAGGGGGAGGTGGGGAGAATCAGCCCCAGCATTTT	CASSHATGGGGENQPQHF	TRBV4-1	TRBJ1-5
TGTGCCAGCAGCCAGACAGCGGGATACGAGCAGTACTTC	CASSQTAGYEQYF	TRBV14	TRBJ2-7
TGCGCCAGCAGTGAGGGACAGACCCATGAAAAACTGTTTTTT	CASSEGQTHEKLFF	TRBV10-1	TRBJ1-4
TGTGCCAGCAGCCCTCGGAAAGAGACCCAGTACTTC	CASSPRKETQYF	TRBV3-1	TRBJ2-5
TGCGCCAGCAGTGTGGCAGGTGCTTTCTTT	CASSVAGAFF	TRBV10-1	TRBJ1-1
TGCGCCAGCAGCTTGGGGCAACTCTCCGATCAGCCCCAGCATTTT	CASSLGQLSDQPQHF	TRBV4-1	TRBJ1-5
TGTGCCAGCAGCCCCCGGGACAGGGTAGACTATGGCTACACCTTC	CASSPRDRVDYGYTF	TRBV7-2	TRBJ1-2
TGTGCCAGCAGCCGCGCGTCCGGACAGGGAGAGGATGCGAGTAATGAAAAACTGTTTTTT	CASSRASGQGEDASNEKLFF	TRBV13	TRBJ1-4
TGTGCCAGCATTGGGGACGAGCAGTACTTC	CASIGDEQYF	TRBV27	TRBJ2-7
TGTGCCAGCAGCCCCCACAGGTCCCGGGGAGACTATGGCTACACCTTC	CASSPHRSRGDYGYTF	TRBV9	TRBJ1-2
TGTGCCAGCACGAGGGGAGGGGGCCCCCGTAACAATGAGCAGTTCTTC	CASTRGGGPRNNEQFF	TRBV12-3	TRBJ2-1
TGTGCCATCAGTGCGATCATAGGACAGGGAGGCACCGGGGAGCTGTTTTTT	CAISAIIGQGGTGELFF	TRBV10-3	TRBJ2-2
TGCAGCGTTGTCGACAGGGCTAATACTGAAGCTTTCTTT	CSVVDRANTEAFF	TRBV29-1	TRBJ1-1
TGTGCCAGCAGCTTAGTCCCCTGGTCCGTTAATGGACAGGGGAACCTTACTGAAGCTTTCTTT	CASSLVPWSVNGQGNLTEAFF	TRBV7-2	TRBJ1-1
TGTGCCAGCAGCCTCCCCAAGAGGGCCGGCAATCAGCCCCAGCATTTT	CASSLPKRAGNQPQHF	TRBV11-3	TRBJ1-5
TGCGCCAGCATTTGGCTCTTACTAGCGGGAGATGAGCAGTTCTTC	CASIWLLLAGDEQFF	TRBV5-1	TRBJ2-1
TGTGCTAGCAGCATAAATGGGGGGGCCGGGTCTATCCCGGGGACAGATACGCAGTATTTT	CASSINGGAGSIPGTDTQYF	TRBV7-7	TRBJ2-3
TGCGCCAGCAGCTTTGTCCCCTGGGGCCCCGGAACCGGGGAGCTGTTTTTT	CASSFVPWGPGTGELFF	TRBV5-1	TRBJ2-2
TGTGCCAGCAGCTCGCTAGCCTACGAGCAGTACTTC	CASSSLAYEQYF	TRBV11-2	TRBJ2-7
TGTGCCAGCAGCCAAGATGCCCGGGACAGAGGCTACGAGCAGTACTTC	CASSQDARDRGYEQYF	TRBV4-2	TRBJ2-7
TGTGCCAGCAGCTCAGTCTGGGACGAGCAGTACTTC	CASSSVWDEQYF	TRBV7-3	TRBJ2-7
TGTGCCAGCAGCTTGGCCTTAGGGGCATGCAATCAGCCCCAGCATTTT	CASSLALGACNQPQHF	TRBV5-4	TRBJ1-5
TGTGCCAGCAGAAGGGACAGGTACCTTTGGGGCTACACCTTC	CASRRDRYLWGYTF	TRBV6-4	TRBJ1-2
TGTGCCAGCAGTGACTGTTTTCATGGACAGGGTCACGAAAAACTGTTTTTT	CASSDCFHGQGHEKLFF	TRBV6-4	TRBJ1-4
TGTGCCAGCAGTTTGGAGGAGACCCAGTACTTC	CASSLEETQYF	TRBV12-4	TRBJ2-5
TGTGCCAGCAGCCAAGCCGTTGGTCCGTGGGACAGGGGGGGTCACAATGAGCAGTTCTTC	CASSQAVGPWDRGGHNEQFF	TRBV14	TRBJ2-1
TGTGCCAGCAGCTTGGTAAGACGGACTGAGACGAGCCCTGGGGCCAACGTCCTGACTTTC	CASSLVRRTETSPGANVLTF	TRBV5-4	TRBJ2-6
TGTGCCAGCAGTTTCAAAAACCCGGGACAGGGAGGGGGCGGTTATTCACCCCTCCACTTT	CASSFKNPGQGGGGYSPLHF	TRBV27	TRBJ1-6
TGTGCCACCAGTGATAGGGGGGACCATGAGCAGTTCTTC	CATSDRGDHEQFF	TRBV24-1	TRBJ2-1
TGTGCCAGCCGCCCAGAAGATACGCAGTATTTT	CASRPEDTQYF	TRBV12-3	TRBJ2-3
TGTGCTAGTGGTTTCTCGTCTAGCGGGGTAAACACCGGGGAGCTGTTTTTT	CASGFSSSGVNTGELFF	TRBV12-5	TRBJ2-2
TGTGCCAGCAGTTACGCCGACCCGGGGGCGGCAGATACGCAGTATTTT	CASSYADPGAADTQYF	TRBV6-5	TRBJ2-3
TGTGCCAGCAGTTATGAGGTCCCCAGCAATCAGCCCCAGCATTTT	CASSYEVPSNQPQHF	TRBV6-6	TRBJ1-5
TGTGCCAGCAGTTTTAATAAGCCGACCTTTGGCTACACCTTC	CASSFNKPTFGYTF	TRBV27	TRBJ1-2
TGTGCCAGCAGCGAGGCACCCCCCGTGAACACTGAAGCTTTCTTT	CASSEAPPVNTEAFF	TRBV12-3	TRBJ1-1
TGTGCCAGCAGCTTGCCCCACGTGATACCAGGGACAGGGCTTGATACGCAGTATTTT	CASSLPHVIPGTGLDTQYF	TRBV5-4	TRBJ2-3
TGTGCCAGCAGCAATACATCGGGACTAGCGGGCGCCTCTGGCTACGAGCAGTACTTC	CASSNTSGLAGASGYEQYF	TRBV13	TRBJ2-7
TGTGCCATCAGTGTTCGGCTCAATGAGCAGTTCTTC	CAISVRLNEQFF	TRBV10-3	TRBJ2-1
TGTGCCAGCAGCCCTGGTCCTCATAGCCCCGGGACAGGGGGGAACACTGAAGCTTTCTTT	CASSPGPHSPGTGGNTEAFF	TRBV7-2	TRBJ1-1
TGTGCCAGCAGCCCTCTCGGGGGCGTTTCCTACGAGCAGTACTTC	CASSPLGGVSYEQYF	TRBV13	TRBJ2-7
TGTGCCAGCAGCTCTAGCGGCAGCTCCTACAATGAGCAGTTCTTC	CASSSSGSSYNEQFF	TRBV7-7	TRBJ2-1
TGTGCCAGCAGCTTACCTACCTATGGCTACACCTTC	CASSLPTYGYTF	TRBV7-3	TRBJ1-2
TGCGCCAGCAGCCCAGGGACAGTCTTCTACGAGCAGTACTTC	CASSPGTVFYEQYF	TRBV5-1	TRBJ2-7
TGCAGTGCTATGTCGATCCTTGGACAGGGGACCTACGAGCAGTACTTC	CSAMSILGQGTYEQYF	TRBV20-1	TRBJ2-7
TGTGCCAGCAGTACACAACCGGGGTGGGGAATCGATTCCAATCAGCCCCAGCATTTT	CASSTQPGWGIDSNQPQHF	TRBV6-5	TRBJ1-5
TGTGCCTCCCCTCCGGTGTCAGGAGGCGAGCAGTACTTC	CASPPVSGGEQYF	TRBV27	TRBJ2-7
TGCAGTGCTAGTCCGGGAGGTTTAACGGCGAATAGTTACTTGTCCTACGAGCAGTACTTC	CSASPGGLTANSYLSYEQYF	TRBV20-1	TRBJ2-7
TGTGCCAGCAGCCATCCGGGACAGGGGTGTGGACCTCGCAATCAGCCCCAGCATTTT	CASSHPGQGCGPRNQPQHF	TRBV13	TRBJ1-5
TGTGCCAGCAGTTACGCGAACCCCCCAAGGACAGCGTACGAGCAGTACTTC	CASSYANPPRTAYEQYF	TRBV6-5	TRBJ2-7
TGCGCCAGCAGCAAGGACAGGGAGATCGCGAATCAGCCCCAGCATTTT	CASSKDREIANQPQHF	TRBV5-1	TRBJ1-5
TGTGCCAGCTCACCCTCAGCTAACACTGAAGCTTTCTTT	CASSPSANTEAFF	TRBV18	TRBJ1-1
TGCGCCAGCAGCAGGACTAGGGCTGGAAACACCATATATTTT	CASSRTRAGNTIYF	TRBV10-1	TRBJ1-3
TGTGCCAGCAGCTCCTTCCCCCGGACGATCGCAACTAATGAAAAACTGTTTTTT	CASSSFPRTIATNEKLFF	TRBV13	TRBJ1-4
TGTGCCAGCAGCTCAAGACAGACTCAGCCCCAGCATTTT	CASSSRQTQPQHF	TRBV7-2	TRBJ1-5
TGTGCCAGCCGGTCAGGGGGCGAGCCTTATCCAGGGGTTCGGACCAGCAATCAGCCCCAGCATTTT	CASRSGGEPYPGVRTSNQPQHF	TRBV2	TRBJ1-5
TGTGCCAGCAGCCAAGGCGAAGGGGCGCGGGATTCTCACACTGAAGCTTTCTTT	CASSQGEGARDSHTEAFF	TRBV14	TRBJ1-1
TGTGCCAGCAGCCAAGATGGTCACAGCTCCCAGGGCGTAAACTATGGCTACACCTTC	CASSQDGHSSQGVNYGYTF	TRBV3-1	TRBJ1-2
TGTGCCAGCAGCTTGGCCCGGACCTCTCCCGCCGTTGGCTACACCTTC	CASSLARTSPAVGYTF	TRBV5-5	TRBJ1-2
TGCAGTGCTAGCCGGGGGGCTGCCGGGGGATTGCAGTACTTC	CSASRGAAGGLQYF	TRBV20-1	TRBJ2-5
TGTGCCAGCAGCGGTTTCACGGATAAGGGGGAGCTGTTTTTT	CASSGFTDKGELFF	TRBV7-6	TRBJ2-2
TGTGCCAGCAGGACAGGAGTTCCCTACGAGCAGTACTTC	CASRTGVPYEQYF	TRBV5-8	TRBJ2-7
TGTGCCAGGGACAGGGGAGGGGCCAACGTCCTGACTTTC	CARDRGGANVLTF	TRBV19	TRBJ2-6
TGTGCCAGCAGGAAACCCGGGACAGATAATGAAAAACTGTTTTTT	CASRKPGTDNEKLFF	TRBV6-4	TRBJ1-4
TGCGCCAGCAGTGGGGAGACTAGCGGGACCGTGACTAGCCCCCGAACCGGGGAGCTGTTTTTT	CASSGETSGTVTSPRTGELFF	TRBV10-1	TRBJ2-2
TGCGCCAGCAGCCAAAAATCAAGATTGACTGAAGCTTTCTTT	CASSQKSRLTEAFF	TRBV4-3	TRBJ1-1
TGTGCCCTTGGGGACAGTAATGAAAAACTGTTTTTT	CALGDSNEKLFF	TRBV7-9	TRBJ1-4
TGTGCCAGCAGCAAGGACAGAGAGTTGCAGCCCCAGCATTTT	CASSKDRELQPQHF	TRBV5-4	TRBJ1-5
TGTGCCACCAGTGTTGGTCAGGGGGTGAATGTGACCTACGAGCAGTACTTC	CATSVGQGVNVTYEQYF	TRBV24-1	TRBJ2-7
TGTGCCAGCAGCTCGGAAGGACAGGGGGGGGAAAAACTGTTTTTT	CASSSEGQGGEKLFF	TRBV5-6	TRBJ1-4
TGCAGTGCTAGGACAGGGAGCAATCAGCCCCAGCATTTT	CSARTGSNQPQHF	TRBV20-1	TRBJ1-5
TGTGCCAGCAGTTACTCGGGAACAGTTCTAGCGGGCTACGAGCAGTACTTC	CASSYSGTVLAGYEQYF	TRBV6-5	TRBJ2-7
TGTGCCAGCACAGCTAGCGGGACTATCTTC	CASTASGTIF	TRBV7-8	TRBJ2-1
TGTGCCAGAGAGGAGACTGAAGCTTTCTTT	CAREETEAFF	TRBV5-6	TRBJ1-1
TGTGCCAGCAGTGAATTGCACAGGGGGGAAAGGCCCCAGCATTTT	CASSELHRGERPQHF	TRBV25-1	TRBJ1-5
TGTGCCAGTAGTATGGGGGACGGGTGCCAAGAGACCCAGTACTTC	CASSMGDGCQETQYF	TRBV19	TRBJ2-5
TGTGCCAGCAGCTTGCCTATGAACACCTTC	CASSLPMNTF	TRBV11-2	TRBJ1-2
TGTGCCACCAGTGACGGCGGGACTAGCGCGATTTTAGCGCACAGGGGCGAGCAGTACTTC	CATSDGGTSAILAHRGEQYF	TRBV24-1	TRBJ2-7
TGTGCCAGCAGCGTAATCCGGACAGGTCACAATGAGCAGTTCTTC	CASSVIRTGHNEQFF	TRBV9	TRBJ2-1
TGTGCCAGCAGCTGGCAGCTGTATGGCTACACCTTC	CASSWQLYGYTF	TRBV7-9	TRBJ1-2
TGTGCCAGTAGTCCAACATGGACTAGCGGGGAGGGGTCAGATACGCAGTATTTT	CASSPTWTSGEGSDTQYF	TRBV19	TRBJ2-3
TGTGCCAGCAGTTTAAAGCTTCGACTAGGCTACGAGCAGTACTTC	CASSLKLRLGYEQYF	TRBV27	TRBJ2-7
TGCAGTGCTAGGAGTCCGGGGGGACAGGGCTATAGCAATCAGCCCCAGCATTTT	CSARSPGGQGYSNQPQHF	TRBV20-1	TRBJ1-5
TGTGCCAGCAGTTTATTTAGAAAGGGGGCAGAGCTTGGGAACACTGAAGCTTTCTTT	CASSLFRKGAELGNTEAFF	TRBV12-3	TRBJ1-1
TGTGCCAGCTCACCACCGGTCCTCCGGCGAGAAACCCAGTACTTC	CASSPPVLRRETQYF	TRBV18	TRBJ2-5
TGTGCCAGTAGGCAACGAGGACAGGGGAGTGAGGGTAACAATCAGCCCCAGCATTTT	CASRQRGQGSEGNNQPQHF	TRBV19	TRBJ1-5
TGTGCCAGCAGGAGAGACAGGTGTCACGAAGCTTTCTTT	CASRRDRCHEAFF	TRBV13	TRBJ1-1
TGTGCCAGCAGCTTAGTTTCCAGGGGTCCCAAGGAATATACGCAGTATTTT	CASSLVSRGPKEYTQYF	TRBV7-4	TRBJ2-3
TGTGCCAGCAGTTTAGAGGGGAGCGGGCGTGGGGCCCTCCACTTT	CASSLEGSGRGALHF	TRBV27	TRBJ1-6
TGTGCCAGCAGTGACCGAGAGGCCTCTTCATACGAGCAGTACTTC	CASSDREASSYEQYF	TRBV2	TRBJ2-7
TGTGCGCGGGGGTTTGGCTACACCTTC	CARGFGYTF	TRBV7-7	TRBJ1-2
TGTGCCAGCAGTTACAAGCGGGAGCAGTTCTTC	CASSYKREQFF	TRBV6-5	TRBJ2-1
TGTGCCAGCAGCCCGGGACAGGGGGAGCAGTACTTC	CASSPGQGEQYF	TRBV7-4	TRBJ2-7
TGCGCCAGCAGCGATTTTTTAGACGGCCCACCCGGGGAGCTGTTTTTT	CASSDFLDGPPGELFF	TRBV5-1	TRBJ2-2
TGTGCCAGCAGCCCCAGTTCGAACTTC	CASSPSSNF	TRBV7-4	TRBJ2-7
TGTGCCAGCAGTTTACGGGGGGGCCCCGCAGGTGAGCAGTTCTTC	CASSLRGGPAGEQFF	TRBV12-4	TRBJ2-1
TGTGCCAGCATAGCGCTGCCTCACGAGCAGTACTTC	CASIALPHEQYF	TRBV6-6	TRBJ2-7
TGCAATAATCCGACTGCAACTAATGAAAAACTGTTTTTT	CNNPTATNEKLFF	TRBV20-1	TRBJ1-4
TGTGCCAGCAGCGTAGGGGGCAGGGGGGGTAACTATGGCTACACCTTC	CASSVGGRGGNYGYTF	TRBV9	TRBJ1-2
TGCGCCAGCTCTCCAGGGGGGGAACAGCCCCAGCATTTT	CASSPGGEQPQHF	TRBV4-3	TRBJ1-5
TGCGCCAGCAGCCAAGATCGGGGACAGCACGGAGGGTACGGCACAGATACGCAGTATTTT	CASSQDRGQHGGYGTDTQYF	TRBV4-1	TRBJ2-3
TGTGCCAGCAGTTACAAGCGGGAGCCGTCCTACAATGAGCAGTTCTTC	CASSYKREPSYNEQFF	TRBV6-6	TRBJ2-1
TGTGCCAGCAGGTTATCCACGACAGGGACCGGGCGTCTCCTCAGCTCCTACGAGCAGTACTTC	CASRLSTTGTGRLLSSYEQYF	TRBV28	TRBJ2-7
TGCAGTGCTAGCAAGGGTCCAACGGGCTCCTACGAGCAGTACTTC	CSASKGPTGSYEQYF	TRBV20-1	TRBJ2-7
TGCGCCAGCAGCAATCGGGCCTCAGATACGCAGTATTTT	CASSNRASDTQYF	TRBV5-1	TRBJ2-3
TGTGCCAGCAGCTCTCGGAGTAAGGGAAACACCATATATTTT	CASSSRSKGNTIYF	TRBV13	TRBJ1-3
TGTGCCAGCAGCCAGTCAGACAGCTCCTACAATGAGCAGTTCTTC	CASSQSDSSYNEQFF	TRBV14	TRBJ2-1
TGTGCCAGCAGCCCCCCGCTAGCTCCCATCGATACGCAGTATTTT	CASSPPLAPIDTQYF	TRBV7-9	TRBJ2-3
TGTGCCACCAGTGCGCCGACAGGGGAAACTCAGCCCCAGCATTTT	CATSAPTGETQPQHF	TRBV24-1	TRBJ1-5
TGTGCCAGCAGCCAAGATAGGCCTCCTCAGGGTACTACTGAAGCTTTCTTT	CASSQDRPPQGTTEAFF	TRBV4-2	TRBJ1-1
TGTGCCAGCAGCGACAGGGGGGACGAGCAGTACTTC	CASSDRGDEQYF	TRBV3-1	TRBJ2-7
TGTGCCAGCAGCCGTGGGGACAGGGGGATGAACACTGAAGCTTTCTTT	CASSRGDRGMNTEAFF	TRBV9	TRBJ1-1
TGTGCCAGCAGTTACAAGGACAGGGTGCCCCAGCATTTT	CASSYKDRVPQHF	TRBV6-6	TRBJ1-5
TGTGCCAGCAGCTTACTAGCGGGAGTGTACAATGAGCAGTTCTTC	CASSLLAGVYNEQFF	TRBV13	TRBJ2-1
TGTGCCAGCAGCGTGGGGCAAGCCCACACAGATACGCAGTATTTT	CASSVGQAHTDTQYF	TRBV13	TRBJ2-3
TGTGCCAGCAGCGGAGAAAGGGTCTCCTATAATTCACCCCTCCACTTT	CASSGERVSYNSPLHF	TRBV7-9	TRBJ1-6
TGCGCCAGCAGCTTTCACCCCGCCAAATATGAAAAACTGTTTTTT	CASSFHPAKYEKLFF	TRBV5-1	TRBJ1-4
TGTGCCAGCAAGGGCCGGGGCGGGAGCATACGATTCAATCAGCCCCAGCATTTT	CASKGRGGSIRFNQPQHF	TRBV7-9	TRBJ1-5
TGTGCCAGCAGTTCGGGACAGGGGGTGATCGAAAAACTGTTTTTT	CASSSGQGVIEKLFF	TRBV12-3	TRBJ1-4
TGTGCCAGCGGGACTAGCGGGGGGGCCATAGATACGCAGTATTTT	CASGTSGGAIDTQYF	TRBV6-5	TRBJ2-3
TGTGCCAGCAGTTTGTCGTGGGCGGACGGTATTTCGGAAGCTTTCTTT	CASSLSWADGISEAFF	TRBV12-4	TRBJ1-1
TGCAGTGCTAGAACGGACAGGGGGCAATGCTTATCCTACGAGCAGTACTTC	CSARTDRGQCLSYEQYF	TRBV20-1	TRBJ2-7
TGTGCCAGCAGCTTAGCCAGAGGGGCAGAGGAGCAGTACTTC	CASSLARGAEEQYF	TRBV13	TRBJ2-7
TGTGCCAGCAGTCCTGGATCTGGGCCCTACAATGAGCAGTTCTTC	CASSPGSGPYNEQFF	TRBV6-2	TRBJ2-1
TGTGCCAGCAGCGTAGTCGGGGGGGCGGAGCAGTTCTTC	CASSVVGGAEQFF	TRBV9	TRBJ2-1
TGTGCCACCAGCAGGGTCGGGGAGAGGTTCTACAATGAGCAGTTCTTC	CATSRVGERFYNEQFF	TRBV15	TRBJ2-1
TGTGCCAGCAGCGTAGGGTCGGATAACACTGAAGCTTTCTTT	CASSVGSDNTEAFF	TRBV7-3	TRBJ1-1
TGTGCCAGCAGCTTCCCACCCCGGGGGGGGCCCCAGCATTTT	CASSFPPRGGPQHF	TRBV7-9	TRBJ1-5
TGTGCCAGCAGCGTGGCGGGACAGGGCGAGAGTACTAACTATGGCTACACCTTC	CASSVAGQGESTNYGYTF	TRBV9	TRBJ1-2
TGTGCCAGCAGTTACGTGATAGCAGATACGCAGTATTTT	CASSYVIADTQYF	TRBV6-2	TRBJ2-3
TGTGCCAGCAGCTTGGGCATCGAACTGACAGGGAACACCATATATTTT	CASSLGIELTGNTIYF	TRBV5-6	TRBJ1-3
TGTGCCAGCAAAAGCGGGGGGGATGGTTCCGAGCAGTACTTC	CASKSGGDGSEQYF	TRBV27	TRBJ2-7
TGCGCCAGCAGCCAAAGGGAGAACTATGGCTACACCTTC	CASSQRENYGYTF	TRBV4-1	TRBJ1-2
TGTGCCAGCAAGGACAGGGGACGCTACAATGAGCAGTTCTTC	CASKDRGRYNEQFF	TRBV6-1	TRBJ2-1
TGTGCCAGCAGCGTCGTAGCGGGCGGAGTAGGGCAGTTCTTC	CASSVVAGGVGQFF	TRBV6-4	TRBJ2-1
TGCAGCGTTGAAGCCGAGGACAGAGAAGAGACCCAGTACTTC	CSVEAEDREETQYF	TRBV29-1	TRBJ2-5
TGTGCCAGCGGGACATGGCTGAACACTGAAGCTTTCTTT	CASGTWLNTEAFF	TRBV27	TRBJ1-1
TGTGCCAGCAGCTTAAACCGGGACGGCTACAATGAGCAGTTCTTC	CASSLNRDGYNEQFF	TRBV11-3	TRBJ2-1
TGTGCCAGCAGCTGTATACCCGGCGGGAGCAATCAGCCCCAGCATTTT	CASSCIPGGSNQPQHF	TRBV5-6	TRBJ1-5
TGTGCCAGTAGTATATCCTTCCACGGGGCCAAACAGGGGGCCTACGAGCAGTACTTC	CASSISFHGAKQGAYEQYF	TRBV19	TRBJ2-7
TGTGCCAGCAGCCGGGGTCGGGGCTCTGGAAACACCATATATTTT	CASSRGRGSGNTIYF	TRBV7-9	TRBJ1-3
TGTGCCAGCAGCTTAGGTCAGAGACAGGGCCCGAGAATAGGCGCTAACTCTCCCTACGAGCAGTACTTC	CASSLGQRQGPRIGANSPYEQYF	TRBV7-2	TRBJ2-7
TGTGCCAGTAGTATCACCCCGGGACAGCCTGACACTGAAGCTTTCTTT	CASSITPGQPDTEAFF	TRBV19	TRBJ1-1
TGCGCCAGCAGCTACCCCGGGACTGAAGGCACTGAAGCTTTCTTT	CASSYPGTEGTEAFF	TRBV5-1	TRBJ1-1
TGCAGCAAACGACTAGCGCTTCGAGCCGACTACAATGAGCAGTTCTTC	CSKRLALRADYNEQFF	TRBV29-1	TRBJ2-1
TGTGACTCAGTCCCGGGACTAGGGATATACAATGAGCAGTTCTTC	CDSVPGLGIYNEQFF	TRBV11-3	TRBJ2-1
TGTGCCAGCAGCCCCAGGGGACTCCCCACTGAAGCTTTCTTT	CASSPRGLPTEAFF	TRBV13	TRBJ1-1
TGTGCCAGCAGTGTGAGCCTGTTACCGGGGGGCAACACCGGGGAGCTGTTTTTT	CASSVSLLPGGNTGELFF	TRBV25-1	TRBJ2-2
TGTGCCAGCAGCCGCGTAATAAGGGGGCCCGTGGTCTATGGCTACACCTTC	CASSRVIRGPVVYGYTF	TRBV7-3	TRBJ1-2
TGTGCCTTCAGCGGGATGGGGTTAGAGACCCAGTACTTC	CAFSGMGLETQYF	TRBV7-2	TRBJ2-5
TGTGCCACTAACAGGGGGCAATTCACAGATACGCAGTATTTT	CATNRGQFTDTQYF	TRBV24-1	TRBJ2-3
TGTGCCAGCAGTTCAGACAGCCTTTATAGCAATCAGCCCCAGCATTTT	CASSSDSLYSNQPQHF	TRBV6-1	TRBJ1-5
TGCGCCAGCAGCAGTAGTGGGGAAGCTTTCTTT	CASSSSGEAFF	TRBV5-1	TRBJ1-1
TGTGCCAGCAGTTATCCTGTTACTAGCGGGAGCGGATTCGAGCAGTACTTC	CASSYPVTSGSGFEQYF	TRBV6-8	TRBJ2-7
TGTGCCCGGGGGGAGGGTCTTAGAGAGACCCAGTACTTC	CARGEGLRETQYF	TRBV10-3	TRBJ2-5
TGTGCCAGCAGCAAGCCGGGGTCGTATGAAAAACTGTTTTTT	CASSKPGSYEKLFF	TRBV9	TRBJ1-4
TGTGCCAGCAGCTATGGGGACAGGGGGACGGAGCAGTACTTC	CASSYGDRGTEQYF	TRBV11-3	TRBJ2-7
TGCGCCAGCAGCCAGAGACCGGGGTGTCCCGTCGTGAAGGCTCTGAACACTGAAGCTTTCTTT	CASSQRPGCPVVKALNTEAFF	TRBV4-3	TRBJ1-1
TGTGCCAGCAGCTTACCAGGGGAACAAGAGACCCAGTACTTC	CASSLPGEQETQYF	TRBV11-1	TRBJ2-5
TGTGCCAGCAGCGACGGCACTGAAGCTTTCTTT	CASSDGTEAFF	TRBV11-3	TRBJ1-1
TGCACCATCCCTAGCGGGGGGGCCAAATTGACAGATACGCAGTATTTT	CTIPSGGAKLTDTQYF	TRBV20-1	TRBJ2-3
TGTGCCATCAGAAGGCAGGGGGCATCCGGGCACACCATATATTTT	CAIRRQGASGHTIYF	TRBV10-3	TRBJ1-3
TGTGCCAGCACCGGCGGGACTAGCGTGGGCTCCGGGGAGCTGTTTTTT	CASTGGTSVGSGELFF	TRBV11-2	TRBJ2-2
TGTGCCAGCATTCCCTCCCAGGTTGACACTGAAGCTTTCTTT	CASIPSQVDTEAFF	TRBV12-3	TRBJ1-1
TGTGCCAGCAGCTCACGGGACAGGGTCGTAGAGACCCAGTACTTC	CASSSRDRVVETQYF	TRBV5-8	TRBJ2-5
TGTGCCTGGATACCAAAGGGGATAATCACCTACGAGCAGTACTTC	CAWIPKGIITYEQYF	TRBV30	TRBJ2-7
TGTGCCAGCAGCTTGGCCCCACGGGAGAGGTTGGATACGCAGTATTTT	CASSLAPRERLDTQYF	TRBV5-6	TRBJ2-3
TGTGCCACCAGTGATGAGGTAGCGGGCACAGATACGCAGTATTTT	CATSDEVAGTDTQYF	TRBV24-1	TRBJ2-3
TGTGCCAGCAGTGCTCCGGGGGCGTTGGGGGTATACGAGCAGTACTTC	CASSAPGALGVYEQYF	TRBV25-1	TRBJ2-7
TGTGCCACCTCAGACAGCGTTAAAAGCTCCTACGAGCAGTACTTC	CATSDSVKSSYEQYF	TRBV15	TRBJ2-7
TGCGCCAGCAGTGAGACTAGCGGGAGCCGTAAGACCGGGGAGCTGTTTTTT	CASSETSGSRKTGELFF	TRBV10-2	TRBJ2-2
TGTGCCAGCAGCTCGAGGGACAAAGGGGGGGGTGACTTC	CASSSRDKGGGDF	TRBV7-9	TRBJ2-7
TGTGCCACCAGTGATGGACAGGGCGAGCAGTACTTC	CATSDGQGEQYF	TRBV24-1	TRBJ2-7
TGTGCCAGCAGCGTCCGGGACACTGAGAAGTTCACTGAAGCTTTCTTT	CASSVRDTEKFTEAFF	TRBV12-4	TRBJ1-1
TGTGCCAGCAGTAGCAGATCCTATGGCTACACCTTC	CASSSRSYGYTF	TRBV12-3	TRBJ1-2
TGTGCCAGCAGTCACGACAGGGTGGACGGTAACTATGGCTACACCTTC	CASSHDRVDGNYGYTF	TRBV27	TRBJ1-2
TGTGCCAGCAGCGAGGGACTAGATTTCACCGGGGAGCTGTTTTTT	CASSEGLDFTGELFF	TRBV13	TRBJ2-2
TGTGCCAGCGGGCCTCCCGGACGTAACACTGAAGCTTTCTTT	CASGPPGRNTEAFF	TRBV9	TRBJ1-1
TGTGCCAGCAGCTTAGCCGGGGGTCCATACTATGGCTACACCTTC	CASSLAGGPYYGYTF	TRBV7-8	TRBJ1-2
TGTGCCAGCAGCTGCAAACAGGGACATAGCAATCAGCCCCAGCATTTT	CASSCKQGHSNQPQHF	TRBV11-2	TRBJ1-5
TGTGCCACCATAGGCTATGGCTACACCTTC	CATIGYGYTF	TRBV15	TRBJ1-2
TGTGCCAGTAGTATGGAGGGCGGTGAAAAACTGTTTTTT	CASSMEGGEKLFF	TRBV19	TRBJ1-4
TGTGCCAGACGGCGCCGTGGGACAGCCGGGGAGCTGTTTTTT	CARRRRGTAGELFF	TRBV18	TRBJ2-2
TGTGCCAGCAGTTACAGGACAGATACGCAGTATTTT	CASSYRTDTQYF	TRBV6-2	TRBJ2-3
TGTGCTAGTGGTTTGGCTCGGGAGGGCCTGCAGTTCTTC	CASGLAREGLQFF	TRBV12-5	TRBJ2-1
TGTGCCAGCAGCTTAGTGGAGCATGCGGGACCTAATGAAAAACTGTTTTTT	CASSLVEHAGPNEKLFF	TRBV11-3	TRBJ1-4
TGTGCCACCACGGAGCCGGGACAGGGGGCTGACCCAAGCTACGAGCAGTACTTC	CATTEPGQGADPSYEQYF	TRBV24-1	TRBJ2-7
TGTGCCAGCAGTCCCGTCCTGGGACAGGGAGGTGAAGCTTTCTTT	CASSPVLGQGGEAFF	TRBV6-2	TRBJ1-1
TGTGCCAGCAGCTTGCCGGGACTAGGGATCGGGGAGCTGTTTTTT	CASSLPGLGIGELFF	TRBV7-6	TRBJ2-2
TGTGCCAGCACACCCAATCCAGGGACCAATCAGCCCCAGCATTTT	CASTPNPGTNQPQHF	TRBV6-4	TRBJ1-5
TGTGCCAGCAGCCCCAGGCTATACCAACCCGAGCAGTACTTC	CASSPRLYQPEQYF	TRBV3-1	TRBJ2-7
TGTGCCAGTAGCACTGCAGGGCGCACAGATACGCAGTATTTT	CASSTAGRTDTQYF	TRBV19	TRBJ2-3
TGTGCCACCAGCAGGTTTCATCGCGCGGCCCTCTACGAGCAGTACTTC	CATSRFHRAALYEQYF	TRBV15	TRBJ2-7
TGCGCCAGCAGTGTTCTAGCGACAGGGGGGTTTCCTAATGAAAAACTGTTTTTT	CASSVLATGGFPNEKLFF	TRBV10-1	TRBJ1-4
TGTGCCAGCATAGATCGCAGACTTCTGCACTATGGCTACACCTTC	CASIDRRLLHYGYTF	TRBV28	TRBJ1-2
TGTGCCACCACTGATAATGAGCAGTTCTTC	CATTDNEQFF	TRBV14	TRBJ2-1
TGTGCCAGCAGCTGGGGCGATAGGGGGGCTAGAGGCTACACCTTC	CASSWGDRGARGYTF	TRBV11-2	TRBJ1-2
TGTGCCAGCAGCTCCCCAACCAGGGGGGGAGAGCCCCAGCATTTT	CASSSPTRGGEPQHF	TRBV5-4	TRBJ1-5
TGTGCCAGCAGGAAATGGCCCCAATCCGACATTCAGTACTTC	CASRKWPQSDIQYF	TRBV12-3	TRBJ2-4
TGTGCCAGCAGCTATGACCAGGGGTCCTCCTATGGCTACACCTTC	CASSYDQGSSYGYTF	TRBV7-2	TRBJ1-2
TGTGCCACCAGTGACGAGGACAGGTCCGGCTACACCTTC	CATSDEDRSGYTF	TRBV24-1	TRBJ1-2
TGCGCCAGCAGCTTAGACAGGGGGAACACTGAAGCTTTCTTT	CASSLDRGNTEAFF	TRBV5-1	TRBJ1-1
TGTGCCAGCAGCACAGGCGATACGCAGTATTTT	CASSTGDTQYF	TRBV13	TRBJ2-3
TGTGCCAGCAGCTTGTCCCGGACTCCCAGCTCCTACAATGAGCAGTTCTTC	CASSLSRTPSSYNEQFF	TRBV5-5	TRBJ2-1
TGTGCCACTCTTCGGATATTTTACGAGCAGTACTTC	CATLRIFYEQYF	TRBV2	TRBJ2-7
TGTGCCTGGGGCCTGCACGTAGCCAAAAACATTCAGTACTTC	CAWGLHVAKNIQYF	TRBV30	TRBJ2-4
TGTGCCAGCAGTTATCGCTACAGTGTCTTC	CASSYRYSVF	TRBV6-3	TRBJ2-1
TGTGCCAGCTCTCCAGGGGATAGGCCGAGCAACGAGCAGTACTTC	CASSPGDRPSNEQYF	TRBV28	TRBJ2-7
TGTGCCAGGGGGATAATCCTTGTGTACGAGCAGTACTTC	CARGIILVYEQYF	TRBV2	TRBJ2-7
TGTGCCAGCAGCGTAGACTCCGGGACAGGGTGGGCCTACGAGCAGTACTTC	CASSVDSGTGWAYEQYF	TRBV9	TRBJ2-7
TGTGCCAGCAGTTTACGGGGGGCTGGAAACACCATATATTTT	CASSLRGAGNTIYF	TRBV6-2	TRBJ1-3
TGTGCCAGCTCACCAGGGGGGAGAGATGAGCAGTTCTTC	CASSPGGRDEQFF	TRBV18	TRBJ2-1
TGTGCCAGCAGCTTAGCCAAAGAAGAGACCCAGTACTTC	CASSLAKEETQYF	TRBV7-9	TRBJ2-5
TGTGCCAGCAGCGAAGAGCGGGAAGAGCAGTACTTC	CASSEEREEQYF	TRBV13	TRBJ2-7
TGTGCCAGCAGCGTAGCCCCGGGACAGGGTCGGACGATTCAGCCCCAGCATTTT	CASSVAPGQGRTIQPQHF	TRBV9	TRBJ1-5
TGTGCCACCAGTTGTTGGGGACAGGGGGCGGGGGGTTATAGCAATCAGCCCCAGCATTTT	CATSCWGQGAGGYSNQPQHF	TRBV24-1	TRBJ1-5
TGCGCCAGCAGCCAGGGGAATAGCTACACCTTC	CASSQGNSYTF	TRBV10-1	TRBJ1-2
TGTGCCAGCAGCGAACAGACTAGCGGGAGTTGCTACGAGCAGTACTTC	CASSEQTSGSCYEQYF	TRBV9	TRBJ2-7
TGTGCCACCAGTGATTGTACTTCAGGGGGCCAAGAGACCCAGTACTTC	CATSDCTSGGQETQYF	TRBV24-1	TRBJ2-5
TGTGCCAGCAGCGATCCAGCGGGAGGAGTCGGCACAGATACGCAGTATTTT	CASSDPAGGVGTDTQYF	TRBV5-4	TRBJ2-3
TGCGCCAGAAGGTGGGGGGGGAAAGGGTGTGGCTACACCTTC	CARRWGGKGCGYTF	TRBV5-1	TRBJ1-2
TGTGCCAGCATGACAGGGTACAATGAGCAGTTCTTC	CASMTGYNEQFF	TRBV6-2	TRBJ2-1
TGTGCCAGTGATAGAGGGGGCGGCTACACCTTC	CASDRGGGYTF	TRBV19	TRBJ1-2
TGTGCCAGCAGCCCGACTAGCGGAGACAAAAACATTCAGTACTTC	CASSPTSGDKNIQYF	TRBV6-5	TRBJ2-4
TGTGCTAGTGGTTTGGGTTCGGCCAAAAACATTCAGTACTTC	CASGLGSAKNIQYF	TRBV12-5	TRBJ2-4
TGTGCCAGCAGCAGGGGACAGGGGGGGGTAGGCTACACCTTC	CASSRGQGGVGYTF	TRBV13	TRBJ1-2
TGTGCCAGGGGACAGGGGGCGAGGGGCTATGGCTACACCTTC	CARGQGARGYGYTF	TRBV30	TRBJ1-2
TGTGCTAGTGGTATCAGGGGCAGGTCCTACGAGCAGTACTTC	CASGIRGRSYEQYF	TRBV12-5	TRBJ2-7
TGTGCCCTCGCCACAGATACGCAGTATTTT	CALATDTQYF	TRBV19	TRBJ2-3
TGTGCCAGCCCCGGGACAGGAAGGTATCAGCCCCAGCATTTT	CASPGTGRYQPQHF	TRBV7-2	TRBJ1-5
TGTGCCAGCACGACAGGGGGAGTGCATACTGAAGCTTTCTTT	CASTTGGVHTEAFF	TRBV27	TRBJ1-1
TGTGCCAGCAGCTACAATGAGCAGTTCTTC	CASSYNEQFF	TRBV7-9	TRBJ2-1
TGTGCCAGCAGTAGGCTGGTTGGACAGGGGGCCTTCGAGGACACCTTC	CASSRLVGQGAFEDTF	TRBV6-5	TRBJ1-2
TGTGCCAGCAGGCAGGGACTACTCGATACGCAGTATTTT	CASRQGLLDTQYF	TRBV6-3	TRBJ2-3
TGTGCCAGCAGAGGACAGGATAGGCATGGCTACACCTTC	CASRGQDRHGYTF	TRBV6-4	TRBJ1-2
TGTGCCAGCATTCCTTGGGACAGTTCAAAATCCTACGAGCAGTACTTC	CASIPWDSSKSYEQYF	TRBV6-6	TRBJ2-7
TGTGCCAGCAGGTTACTTAGGAAGACAGGGACAAGCTCCTATAATTCACCCCTCCACTTT	CASRLLRKTGTSSYNSPLHF	TRBV11-2	TRBJ1-6
TGTGCCAGTCGCTACAGGGTTAGGATTTGGTCGAACACTGAAGCTTTCTTT	CASRYRVRIWSNTEAFF	TRBV19	TRBJ1-1
TGCGCCAGCGTTAAAGCCGTGATAGACTACGAGCAGTACTTC	CASVKAVIDYEQYF	TRBV10-1	TRBJ2-7
TGTGCCAGCAGTTTAGCGGGGGGGCCACCACCCTACAATGAGCAGTTCTTC	CASSLAGGPPPYNEQFF	TRBV28	TRBJ2-1
TGTGCCCACCGACGGGGGTCATACAATGAGCAGTTCTTC	CAHRRGSYNEQFF	TRBV7-9	TRBJ2-1
TGTGCCATAACGTCCGTTAGGGACACGGAATCTAGCACAGATACGCAGTATTTT	CAITSVRDTESSTDTQYF	TRBV19	TRBJ2-3
TGTGCCAGCAGTAAAGACAGGCGACCCAGCTCTGGGGCCAACGTCCTGACTTTC	CASSKDRRPSSGANVLTF	TRBV27	TRBJ2-6
TGTGCCAGCAGCCCCAGGCAGATGGCCTCCAATGAGCAGTTCTTC	CASSPRQMASNEQFF	TRBV7-4	TRBJ2-1
TGTGCCAGCACCCCGGTGAAATACAATGAGCAGTTCTTC	CASTPVKYNEQFF	TRBV13	TRBJ2-1
TGTGCCAGCAGCTGCAAAGAGGGACTGTACAATGAGCAGTTCTTC	CASSCKEGLYNEQFF	TRBV7-3	TRBJ2-1
TGTGCCACCAGTGATTTGGCCGGAACCGGGACAGGGGCAGTTTGCAGGGGCTACACCTTC	CATSDLAGTGTGAVCRGYTF	TRBV24-1	TRBJ1-2
TGTGCCAGCAGAGCGCAATTTCGCACAGATACGCAGTATTTT	CASRAQFRTDTQYF	TRBV6-2	TRBJ2-3
TGCAGTACCACTAGAGCGCCCACCGGGGAGCTGTTTTTT	CSTTRAPTGELFF	TRBV20-1	TRBJ2-2
TGTGCCTGGGCAGGAAGGACTGAAGCTTTCTTT	CAWAGRTEAFF	TRBV30	TRBJ1-1
TGTGCCACCAGTGAAATCGGACAGGGGCGCCCATACACCTTC	CATSEIGQGRPYTF	TRBV24-1	TRBJ1-2
TGTGCCAGCAGTGGAGATAGGGGGGCCAGCACAGATACGCAGTATTTT	CASSGDRGASTDTQYF	TRBV6-3	TRBJ2-3
TGTGCCAGCAGCTTGGTGAGGCATTTCAGGTATCACACTGAAGCTTTCTTT	CASSLVRHFRYHTEAFF	TRBV5-5	TRBJ1-1
TGTGCCAGCAGCTTGTTTTGGGCTACGGAGGATTCCTACAATGAGCAGTTCTTC	CASSLFWATEDSYNEQFF	TRBV13	TRBJ2-1
TGTGCCACCAGTGACGGGACGGGAGGCCAAGAGACCCAGTACTTC	CATSDGTGGQETQYF	TRBV24-1	TRBJ2-5
TGTGCCACCAGACAGGGGAAAACTGAAGCTTTCTTT	CATRQGKTEAFF	TRBV24-1	TRBJ1-1
TGTGCCAGCAGTGAAACCAGGGGGGCTTATGGCTACACCTTC	CASSETRGAYGYTF	TRBV25-1	TRBJ1-2
TGTGCCAGCAAACATTTTAAACGCTTAGCAAAAGTGGATACGCAGTATTTT	CASKHFKRLAKVDTQYF	TRBV28	TRBJ2-3
TGTGCCAGCAGCCCCGGGGGCTCCTGCTATAATTCACCCCTCCACTTT	CASSPGGSCYNSPLHF	TRBV14	TRBJ1-6
TGTGCCAGCAGCAGGGGGCCTAACTATGGCTACACCTTC	CASSRGPNYGYTF	TRBV6-5	TRBJ1-2
TGTGCCAGCAGCTTAATTTACAGATTCGGGACAGGGGGGTTTCAAGGGACTGAAGCTTTCTTT	CASSLIYRFGTGGFQGTEAFF	TRBV7-2	TRBJ1-1
TGTGCCAGCAGCTTAGTCAGGGGGTTGCAGCCCCAGCATTTT	CASSLVRGLQPQHF	TRBV7-8	TRBJ1-5
TGTGCCAGCAGCTTACCAGAGGATACGCAGTATTTT	CASSLPEDTQYF	TRBV7-9	TRBJ2-3
TGTGCCAGCAGCCCCTTACGTCGACAGGGTGAAAATTCACCCCTCCACTTT	CASSPLRRQGENSPLHF	TRBV7-9	TRBJ1-6
TGTGCCAGCAAAAGACGGGCAACTAATGAAAAACTGTTTTTT	CASKRRATNEKLFF	TRBV2	TRBJ1-4
TGTGCCAGCAGTGAATTACCTAGACAGGGAGTCAGGGGCTACACCTTC	CASSELPRQGVRGYTF	TRBV25-1	TRBJ1-2
TGTGCCAGTCCTCTAGCGGGTAGCACAGATACGCAGTATTTT	CASPLAGSTDTQYF	TRBV19	TRBJ2-3
TGTGCCAGCAGTCTGCCCATAGGGGGTGATAACACTGAAGCTTTCTTT	CASSLPIGGDNTEAFF	TRBV27	TRBJ1-1
TGTGCCAGCAGCGACAGGGGAGCTAACTATGGCTACACCTTC	CASSDRGANYGYTF	TRBV13	TRBJ1-2
TGTGCCAGCAGCCCACGGGACAGGGGCGTAGATCAGCCCCAGCATTTT	CASSPRDRGVDQPQHF	TRBV9	TRBJ1-5
TGTGCCAGCAGTTGGGGACGGCTTCCCCCCGGACAGCCCCAGCATTTT	CASSWGRLPPGQPQHF	TRBV6-1	TRBJ1-5
TGTGCCAGCAGCTTAAGACACCGGGACAACGACGCTAACTATGGCTACACCTTC	CASSLRHRDNDANYGYTF	TRBV13	TRBJ1-2
TGTGCCAGCGGGGACAGGAAGTCCTACGAGCAGTACTTC	CASGDRKSYEQYF	TRBV14	TRBJ2-7
TGTGCCACCAGTGAGGAGGCCTACGAGCAGTACTTC	CATSEEAYEQYF	TRBV24-1	TRBJ2-7
TGTGCCAGCAGCTGCCAGGGGGAGGGTGAGCAGTTCTTC	CASSCQGEGEQFF	TRBV13	TRBJ2-1
TGTGCCAGCAGCTTAGAGCCCCCGGGGCGCCATTCAGGGGAGCTGTTTTTT	CASSLEPPGRHSGELFF	TRBV11-2	TRBJ2-2
TGTGCCAGCAGTAAAGGGGAGGGGCCCGGGGAGCTGTTTTTT	CASSKGEGPGELFF	TRBV6-1	TRBJ2-2
TGTGCCAGCAGTGACAAAAGGGGGGGGTTTTGCACAGATACGCAGTATTTT	CASSDKRGGFCTDTQYF	TRBV6-4	TRBJ2-3
TGTGCAGTCCCAGGGGGCGGTCACACTGAAGCTTTCTTT	CAVPGGGHTEAFF	TRBV15	TRBJ1-1
TGTGCCAGCAGCGCTCCCACCGGGGAGCTGTTTTTT	CASSAPTGELFF	TRBV7-4	TRBJ2-2
TGTGCCAGCAGCGATGGACTCCCCTACGAGCAGTACTTC	CASSDGLPYEQYF	TRBV7-3	TRBJ2-7
TGTGCCAGCACCCGCAGGGGAAGATTACGTAATTCACCCCTCCACTTT	CASTRRGRLRNSPLHF	TRBV27	TRBJ1-6
TGTGCCAGCAGCCACAGGGTTCTAGAGACCCAGTACTTC	CASSHRVLETQYF	TRBV13	TRBJ2-5
TGTGCCAGCAGCGCATCTAGCGGGTCGTTCACAGATACGCAGTATTTT	CASSASSGSFTDTQYF	TRBV7-3	TRBJ2-3
TGTGCCAGCAGTTTCGGTTTGCGGTTTGCTTTCTTT	CASSFGLRFAFF	TRBV27	TRBJ1-1
TGTGCCAGTAGAGAGCGAGGGACAGGGTCTCAGCCCCAGCATTTT	CASRERGTGSQPQHF	TRBV19	TRBJ1-5
TGTGCCAGTAGTATTTGGGACAGGAAGATCTACGAGCAGTACTTC	CASSIWDRKIYEQYF	TRBV19	TRBJ2-7
TGCAGTGCCCGGGCTCCCTGGAATGGCTACACCTTC	CSARAPWNGYTF	TRBV20-1	TRBJ1-2
TGTGCCAGCAGTTACTCGAAGGGTAGGGAACCCTTTGGGGATGAGCAGTACTTC	CASSYSKGREPFGDEQYF	TRBV6-6	TRBJ2-7
TGCAGCTATGCGGGAGATTGGGCTCATCAGCCCCAGCATTTT	CSYAGDWAHQPQHF	TRBV29-1	TRBJ1-5
TGTGCCTGGAGTACCGTGATAGTCGCGACCGGGGAGCTGTTTTTT	CAWSTVIVATGELFF	TRBV30	TRBJ2-2
TGCGCCAGCAGTGCCGGGGGGGGAGCAGAGTCCTACAATGAGCAGTTCTTC	CASSAGGGAESYNEQFF	TRBV10-1	TRBJ2-1
TGTGCCAGCAGTTACCTAGAGACCCCCGGGACGCCCTATGGCTACACCTTC	CASSYLETPGTPYGYTF	TRBV6-6	TRBJ1-2
TGTGCCCACCAGGGGGGACGCACTGAAGCTTTCTTT	CAHQGGRTEAFF	TRBV28	TRBJ1-1
TGTGCCAGCAACGATCAGCCCCAGCATTTT	CASNDQPQHF	TRBV27	TRBJ1-5
TGCGCCAGCACGTCTGACAGCTGGACCCAGTACTTC	CASTSDSWTQYF	TRBV10-1	TRBJ2-5
TGCAGTGCTAGAGCGGGGAAGGATAGGGTCGGGGCCAACGTCCTGACTTTC	CSARAGKDRVGANVLTF	TRBV20-1	TRBJ2-6
TGTGCCAGCAGCGGCACCGGGACCCCCGCAGATACGCAGTATTTT	CASSGTGTPADTQYF	TRBV7-3	TRBJ2-3
TGTGCCAGCAGTTGGCTCTATGTGGAGCAGTACTTC	CASSWLYVEQYF	TRBV6-6	TRBJ2-7
TGCGCCAGCAGCTCACAGGTAGGCTCCTACGAGCAGTACTTC	CASSSQVGSYEQYF	TRBV5-1	TRBJ2-7
TGCAGTGCTAGCGGGAGTAGTCAAGAGACCCAGTACTTC	CSASGSSQETQYF	TRBV20-1	TRBJ2-5
TGTGCCAGCAGTAAGAGTACTAGCGGGTGGCTGGATACTACCGCGAACACCGGGGAGCTGTTTTTT	CASSKSTSGWLDTTANTGELFF	TRBV11-2	TRBJ2-2
TGTGCCAGCAGTAAGGACAGGAAGCACAATGAGCAGTTCTTC	CASSKDRKHNEQFF	TRBV6-5	TRBJ2-1
TGCAGTGCGGCGGAGGCCTACGAGCAGTACTTC	CSAAEAYEQYF	TRBV20-1	TRBJ2-7
TGTGACGGAGGGGAAAAACTGTTTTTT	CDGGEKLFF	TRBV7-9	TRBJ1-4
TGTGCCACCAGTGCCACGGTGGGTTACTATGGCTACACCTTC	CATSATVGYYGYTF	TRBV24-1	TRBJ1-2
TGTGCCAGCAGCTCTAGCAGAGATACGCAGTATTTT	CASSSSRDTQYF	TRBV5-6	TRBJ2-3
TGTGCCAGCAGCCAAGGACAGGCAAGGACGGCTGAAGCTTTCTTT	CASSQGQARTAEAFF	TRBV3-1	TRBJ1-1
TGTGCCAGCAGTGCGGACTCGACAGGGGGCATGTGGCCTAATAATGAAAAACTGTTTTTT	CASSADSTGGMWPNNEKLFF	TRBV6-1	TRBJ1-4
TGTGCCAGTACCACTGCCACAGGGGGGCCAGTTCTAAATCAGCCCCAGCATTTT	CASTTATGGPVLNQPQHF	TRBV19	TRBJ1-5
TGCGCCAGCAGACAGACTGGTTCCTTTGAAGAGGACAATGAGCAGTTCTTC	CASRQTGSFEEDNEQFF	TRBV5-1	TRBJ2-1
TGTGCCAGCAGTTACTCGAGGACGGGGACATACGAGCAGTACTTC	CASSYSRTGTYEQYF	TRBV6-5	TRBJ2-7
TGTGCCACCCAAGGGGGCAGCCGCACTGAAGCTTTCTTT	CATQGGSRTEAFF	TRBV24-1	TRBJ1-1
TGCTTGAGAACCAGATCCTACGAGCAGTACTTC	CLRTRSYEQYF	TRBV29-1	TRBJ2-7
TGTGCCAGCAGCCCCCCGGGGATGGGGAATCAGCCCCAGCATTTT	CASSPPGMGNQPQHF	TRBV14	TRBJ1-5
TGTGCCAGCAGCGGCGGCAGGGGGCGGAGATCTAACTATGGCTACACCTTC	CASSGGRGRRSNYGYTF	TRBV5-5	TRBJ1-2
TGCAGTGTGTACGGGAGTGCTAGCACAGATACGCAGTATTTT	CSVYGSASTDTQYF	TRBV20-1	TRBJ2-3
TGTGCCAGCAGCCAAGATTCGACGCAGCCGCCACTGGATAGCAATCAGCCCCAGCATTTT	CASSQDSTQPPLDSNQPQHF	TRBV4-2	TRBJ1-5
TGTGCCAGCAGTTACCTTAGGGGCTTC	CASSYLRGF	TRBV6-2	TRBJ2-7
TGTGCCAGCAGCCTCGCTAGCGGTAGCACCGGGGAGCTGTTTTTT	CASSLASGSTGELFF	TRBV7-4	TRBJ2-2
TGTGCCAGCAGCTCTCACACAGATACGCAGTATTTT	CASSSHTDTQYF	TRBV7-2	TRBJ2-3
TGTGCCATCAGTGAGCGGGTGAACACTGAAGCTTTCTTT	CAISERVNTEAFF	TRBV10-3	TRBJ1-1
TGTGCCAGTAGTAGGACTAGCGGGAGCTCCTACAATGAGCAGTTCTTC	CASSRTSGSSYNEQFF	TRBV19	TRBJ2-1
TGTGCCACCAGTGTTCGCACCGGGACAGAGCCTAATGAAAAACTGTTTTTT	CATSVRTGTEPNEKLFF	TRBV24-1	TRBJ1-4
TGTGCCAGCAGCGGAGCGGGCACTGAAGCTTTCTTT	CASSGAGTEAFF	TRBV5-5	TRBJ1-1
TGTGCCAGCAGCTTAGCGTCCAGGAGGGGGCCTGAGACCCAGTACTTC	CASSLASRRGPETQYF	TRBV7-4	TRBJ2-5
TGTGCCAGCAGGGTTCCCGGGGCCCTCCACTTT	CASRVPGALHF	TRBV27	TRBJ1-6
TGTGCCAGCCGGCGGGGAAACCCAGATACGCAGTATTTT	CASRRGNPDTQYF	TRBV11-1	TRBJ2-3
TGTGCCAGCAGCTTAGAACCGGGACAGGGGGGTCCCGAGCAGTACTTC	CASSLEPGQGGPEQYF	TRBV11-2	TRBJ2-7
TGTGCCAGCAGCCACAGGACGGGACTAGCGGGTCCAGATACGCAGTATTTT	CASSHRTGLAGPDTQYF	TRBV3-1	TRBJ2-3
TGTGCCAGCACGGACCGATCTGGCACAGATACGCAGTATTTT	CASTDRSGTDTQYF	TRBV6-4	TRBJ2-3
TGCAGTGCTAGATTCCCCCGGGACAGGGGTCCTCCAAGCGGAACTGGAAACACCATATATTTT	CSARFPRDRGPPSGTGNTIYF	TRBV20-1	TRBJ1-3
TGTGCTATGTTGCGGCACAGGGGGAACTATGGCTACACCTTC	CAMLRHRGNYGYTF	TRBV6-2	TRBJ1-2
TGTGCCAGCAGCTTAGTGTATACGGGACTAGCGGGAAGGGGGACCCAGTACTTC	CASSLVYTGLAGRGTQYF	TRBV11-3	TRBJ2-5
TGCAGTGCTTACCCTCCGGGACTAGGGATTCCGTCCCAGTACTTC	CSAYPPGLGIPSQYF	TRBV20-1	TRBJ2-5
TGTGCCAGCAGTTCCCTAGAACCCAGTTCCTACAATGAGCAGTTCTTC	CASSSLEPSSYNEQFF	TRBV12-4	TRBJ2-1
TGCAGTGGTCACCGGACAGGGGGGGTCTACGAGCAGTACTTC	CSGHRTGGVYEQYF	TRBV20-1	TRBJ2-7
TGTGCCAGCAGCTTAGGGGACCGGGGCAGGGCGGAAGCCGAGCAGTACTTC	CASSLGDRGRAEAEQYF	TRBV7-9	TRBJ2-7
TGTGCCAGCAGCCAAGATGATCCCGAGGGTGGCTATGGCTACACCTTC	CASSQDDPEGGYGYTF	TRBV14	TRBJ1-2
TGTGCCAGCTTAACAGGGGGCTTGTATGGCTACACCTTC	CASLTGGLYGYTF	TRBV6-4	TRBJ1-2
TGTGCCAGCAGGGGGGGGTCCTATAATTCACCCCTCCACTTT	CASRGGSYNSPLHF	TRBV11-2	TRBJ1-6
TGTGCCAGCACCAACCCTACCAGGCGGAAGGGCTACGAGCAGTACTTC	CASTNPTRRKGYEQYF	TRBV3-1	TRBJ2-7
TGTGCCAGCATAGGCCCCATACCTTATAGCAATCAGCCCCAGCATTTT	CASIGPIPYSNQPQHF	TRBV7-9	TRBJ1-5
TGTGCCAGCAGCCAAGCCACCGACAGGGTCGAAATGAACACTGAAGCTTTCTTT	CASSQATDRVEMNTEAFF	TRBV3-1	TRBJ1-1
TGTGCCAGCAGGGCAGGGGTCAATCACTACGAGCAGTACTTC	CASRAGVNHYEQYF	TRBV6-3	TRBJ2-7
TGTGCCTGGAGTGTGATGGGACAGGGGCGAGACCCGCACGAGCAGTACTTC	CAWSVMGQGRDPHEQYF	TRBV30	TRBJ2-7
TGTGCCAGCAGCCCCCGGTCCGGGGTTACTCCTGGGGCCAACGTCCTGACTTTC	CASSPRSGVTPGANVLTF	TRBV4-2	TRBJ2-6
TGTGCCAGCAGCCAAGATCGAGGCAAAAGACAGGGCGAGCAGTACTTC	CASSQDRGKRQGEQYF	TRBV4-2	TRBJ2-7
TGTGCCAGCAGCATCGGGACCGGGTCCTACGAGCAGTACTTC	CASSIGTGSYEQYF	TRBV13	TRBJ2-7
TGTGCCAGCAGTTACTGCCAGGGCAGCGCGAACACCGGGGAGCTGTTTTTT	CASSYCQGSANTGELFF	TRBV6-9	TRBJ2-2
TGTGCCTGGGGCCGCCCCTTTCCGGGACTCTACAATGAGCAGTTCTTC	CAWGRPFPGLYNEQFF	TRBV30	TRBJ2-1
TGTGCCACCAACCCCCCACTAGAGAATGAGCAGTTCTTC	CATNPPLENEQFF	TRBV24-1	TRBJ2-1
TGCGCCAGCAGCTTGGCCCGGGAGGATGAGCAGTTCTTC	CASSLAREDEQFF	TRBV5-1	TRBJ2-1
TGTGCCAGCAGCTTATGTGGGGGTTTGTATAGCAATCAGCCCCAGCATTTT	CASSLCGGLYSNQPQHF	TRBV7-2	TRBJ1-5
TGTGCTAGTAATGCCCTCAGGGGCAATGAAAAACTGTTTTTT	CASNALRGNEKLFF	TRBV12-5	TRBJ1-4
TGCAGTGCTAGAGGGAGGGACAGACGTCTCAATGAGCAGTTCTTC	CSARGRDRRLNEQFF	TRBV20-1	TRBJ2-1
TGTGCCAGCAGTTATCGAGGGACAGGGAATGAAAAACTGTTTTTT	CASSYRGTGNEKLFF	TRBV27	TRBJ1-4
TGTGCCAGCAGCGGGTTGGCAGCGGGAGAATCCCTTAGCACTGAAGCTTTCTTT	CASSGLAAGESLSTEAFF	TRBV13	TRBJ1-1
TGTGCCAGCAGCTTAGACATAATGAAGTCCTACGAGCAGTACTTC	CASSLDIMKSYEQYF	TRBV7-2	TRBJ2-7
TGTGCCAGCGAGACAGGGGCAGGAGAGACCCAGTACTTC	CASETGAGETQYF	TRBV7-3	TRBJ2-5
TGTGCCTGGAGAACGCATCTGAGTACAGCTTTCTTT	CAWRTHLSTAFF	TRBV30	TRBJ1-1
TGTGCCAGCACCCCCCCGACCCTGCCCCAGCATTTT	CASTPPTLPQHF	TRBV14	TRBJ1-5
TGTGCCACAAAGGGACAGGCGGTCGGGTATGGCTACACCTTC	CATKGQAVGYGYTF	TRBV7-9	TRBJ1-2
TGCGCCCGGGCCTACACTGAAGCTTTCTTT	CARAYTEAFF	TRBV10-1	TRBJ1-1
TGTGCCAGCAGTAGGACAGGGGAGGTATACAATGAGCAGTTCTTC	CASSRTGEVYNEQFF	TRBV6-4	TRBJ2-1
TGTGCCGGGCAAGATGAGCAGTTCTTC	CAGQDEQFF	TRBV10-3	TRBJ2-1
TGTGCCAGCAGTGCCAACTCCACTCCCCCGGGACAGGGTGTTTGGCACACTGAAGCTTTCTTT	CASSANSTPPGQGVWHTEAFF	TRBV2	TRBJ1-1
TGTGCCAGCGCAAGTAGCGTAGCCTACAATGAGCAGTTCTTC	CASASSVAYNEQFF	TRBV27	TRBJ2-1
TGTGCTAGTGGTTTGGAGCCGGGTGGACTAGATGAGCAGTTCTTC	CASGLEPGGLDEQFF	TRBV12-5	TRBJ2-1
TGTGCCAGCAGCACCCCCCCCCCCGGGCAAGAGACCCAGTACTTC	CASSTPPPGQETQYF	TRBV13	TRBJ2-5
TGTGCCAGCAGCGCTCCGAACAGGGGTGCTTTCTTT	CASSAPNRGAFF	TRBV7-8	TRBJ1-1
TGTGCCAGCAAGAGGGCTGGTAACACCGGGGAGCTGTTTTTT	CASKRAGNTGELFF	TRBV12-3	TRBJ2-2
TGTGCCAGCAGCTTGAAGGGGGAAGGCAATCAGCCCCAGCATTTT	CASSLKGEGNQPQHF	TRBV7-2	TRBJ1-5
TGTGCCACAAAGATCTACAATGAGCAGTTCTTC	CATKIYNEQFF	TRBV24-1	TRBJ2-1
TGTGCCGATTACACCGGGGAGCTGTTTTTT	CADYTGELFF	TRBV11-2	TRBJ2-2
TGTGCCAGCACCCGGGACAGAAGAACTGAAGCTTTCTTT	CASTRDRRTEAFF	TRBV14	TRBJ1-1
TGTGCCAGCAGCGTGCGACAGGTTGCAAGCAATCAGCCCCAGCATTTT	CASSVRQVASNQPQHF	TRBV7-8	TRBJ1-5
TGTGCCAGCAGCCCCTTCAGGGAAGAGTACGAGCAGTACTTC	CASSPFREEYEQYF	TRBV7-4	TRBJ2-7
TGTGCCAGCAGCCCACCCCCGACGACCCAGTACTTC	CASSPPPTTQYF	TRBV5-4	TRBJ2-5
TGCAGTGCGGGGCCCGAGCAGTACTTC	CSAGPEQYF	TRBV20-1	TRBJ2-7
TGTGCCACCAGTGAGAGGGGGGATTACACTGAAGCTTTCTTT	CATSERGDYTEAFF	TRBV24-1	TRBJ1-1
TGCAGTGCCAGGGAGGTCTCTAACTATGGCTACACCTTC	CSAREVSNYGYTF	TRBV20-1	TRBJ1-2
TGTGCCAGCTCACGGGTAGAGGTCCCTGGAAACACCATATATTTT	CASSRVEVPGNTIYF	TRBV18	TRBJ1-3
TGTGCCAGGACCGAGGGGTACGAGCAGTACTTC	CARTEGYEQYF	TRBV19	TRBJ2-7
TGTGCCAGCAGCTTAGATGGGAGACAGGGGGACCCCAATCAGCCCCAGCATTTT	CASSLDGRQGDPNQPQHF	TRBV11-3	TRBJ1-5
TGTGCCAGCAGGGGTCCCCCCCCGGGGGGGGCCTATAATTCACCCCTCCACTTT	CASRGPPPGGAYNSPLHF	TRBV7-9	TRBJ1-6
TGTGCCAGCAGACGGGATAGAGAGACCCAGTACTTC	CASRRDRETQYF	TRBV9	TRBJ2-5
TGTGCCAGCAGTTACCGCGTGGACCCGCTCGTTCCGTGCGGACCACGACGTTTCCCCTACGAGCAGTACTTC	CASSYRVDPLVPCGPRRFPYEQYF	TRBV6-5	TRBJ2-7
TGTGCCAGCAGCACCCGGACAGGGTTAGCTGAAGCTTTCTTT	CASSTRTGLAEAFF	TRBV7-9	TRBJ1-1
TGTGCCAGCAGCTTAGTGCGGACAGGGGCGCTACCAAACTATGGCTACACCTTC	CASSLVRTGALPNYGYTF	TRBV11-3	TRBJ1-2
TGTGCCAGCAGTTTAGAACCGACAGGGGGATCAAATGAGCAGTTCTTC	CASSLEPTGGSNEQFF	TRBV27	TRBJ2-1
TGTGCCACGGGACAGGGGGCGTACAACACCGGGGAGCTGTTTTTT	CATGQGAYNTGELFF	TRBV6-5	TRBJ2-2
TGTGCCGCTCCTACCACAGATACGCAGTATTTT	CAAPTTDTQYF	TRBV9	TRBJ2-3
TGTGCCAGCAGTCGGGACAGGAATTCACCCCTCCACTTT	CASSRDRNSPLHF	TRBV27	TRBJ1-6
TGCGCCAGCAGCTGGGGGCCAAGGAATCAGCCCCAGCATTTT	CASSWGPRNQPQHF	TRBV5-1	TRBJ1-5
TGTGCCAGCAGTTTATACTGGGGGGCCCAAGAGACCCAGTACTTC	CASSLYWGAQETQYF	TRBV27	TRBJ2-5
TGTGCCAGCAGCTTAGTAAGACAGGGATTATACGAGCAGTACTTC	CASSLVRQGLYEQYF	TRBV11-1	TRBJ2-7
TGTGCCAGCAGCCAAGGGGACATTTGTCAGCCCCAGCATTTT	CASSQGDICQPQHF	TRBV14	TRBJ1-5
TGTGCCAGCGACAACGGGGTGCCCTACGAGCAGTACTTC	CASDNGVPYEQYF	TRBV12-3	TRBJ2-7
TGTGCCAGCAGCACTAATGAGGCGGGACAGTGGAAAATCTCCAATGAGCAGTTCTTC	CASSTNEAGQWKISNEQFF	TRBV7-3	TRBJ2-1
TGTGCCAGCAGTTTTTACAGGGGGCCAGTATTGTTTAGCAATCAGCCCCAGCATTTT	CASSFYRGPVLFSNQPQHF	TRBV28	TRBJ1-5
TGTGCCTGGATCTGCCGAGGCCTATTTGTGCTCAATCAGCCCCAGCATTTT	CAWICRGLFVLNQPQHF	TRBV30	TRBJ1-5
TGTGCCAGCAGAGGGGACACGCCTAATGAAAAACTGTTTTTT	CASRGDTPNEKLFF	TRBV6-4	TRBJ1-4
TGCGCCAGCAGCCAAGCCTCTCGCAGGACGGACGAGCAGTACTTC	CASSQASRRTDEQYF	TRBV4-1	TRBJ2-7
TGTGCCATCAGTGACCGGACAGGGGGGACCAACTCGCCCCAGCATTTT	CAISDRTGGTNSPQHF	TRBV10-3	TRBJ1-5
TGTGCCAGCAGATTTTCTATGGAGGAGCAGTTCTTC	CASRFSMEEQFF	TRBV6-5	TRBJ2-1
TGTGCCAGCAGTCGTGAGGGAAGGGCTTTCTTT	CASSREGRAFF	TRBV27	TRBJ1-1
TGTGCCAGCAGTGGGGGGGACAGACACAAGCAGTACTTC	CASSGGDRHKQYF	TRBV25-1	TRBJ2-7
TGTGCCAGCAGCCGAGGCAACAATCAGCCCCAGCATTTT	CASSRGNNQPQHF	TRBV7-9	TRBJ1-5
TGCGCCAGCAAAGCGGCAGGGGAAAAACTGTTTTTT	CASKAAGEKLFF	TRBV10-1	TRBJ1-4
TGTGCCATCATCCGGGAAGCCGGGACTAGCGGATTCAACACCGGGGAGCTGTTTTTT	CAIIREAGTSGFNTGELFF	TRBV10-3	TRBJ2-2
TGTGCCAGCAGTGACTACTTGCGGAAGGGACCAGATACGCAGTATTTT	CASSDYLRKGPDTQYF	TRBV6-4	TRBJ2-3
TGTGCCAGCAGCCCACAGCTCCGCTGGAACACTGAAGCTTTCTTT	CASSPQLRWNTEAFF	TRBV9	TRBJ1-1
TGTGCCAGCAGCTTAACTACCCGGGCTAACTATGGCTACACCTTC	CASSLTTRANYGYTF	TRBV11-3	TRBJ1-2
TGTGCCAGCAGCCGGCTGCACACAGATACGCAGTATTTT	CASSRLHTDTQYF	TRBV7-2	TRBJ2-3
TGTGCCAGCAGGTGGGGGCTTGTTGAGATGAACACTGAAGCTTTCTTT	CASRWGLVEMNTEAFF	TRBV6-2	TRBJ1-1
TGCAGTGCTTCGCGCCAGTTTAATATGGACCTGGGGATGGCTCTTTGCGAGCAGTACTTC	CSASRQFNMDLGMALCEQYF	TRBV20-1	TRBJ2-7
TGCAGTGCCGGGTCGGGACAGGGCCAAAAGGGAAGGGGATACAATGAGCAGTTCTTC	CSAGSGQGQKGRGYNEQFF	TRBV20-1	TRBJ2-1
TGTGCCAGCAGTGCCCTTACAGGGAGAACAAACACTGAAGCTTTCTTT	CASSALTGRTNTEAFF	TRBV6-1	TRBJ1-1
TGTGCCAGCAGCCGGACAGGGGGGGAGGACCCGGGCGAGCAGTACTTC	CASSRTGGEDPGEQYF	TRBV7-9	TRBJ2-7
TGTGCCAGCAGTGAAGACGTTCTCCAGGGGCAGGGCTCCTGCTACACCTTC	CASSEDVLQGQGSCYTF	TRBV6-1	TRBJ1-2
TGTGCCACCAGCAGAGAAAACGGGACGCTTTATAATGAAAAACTGTTTTTT	CATSRENGTLYNEKLFF	TRBV15	TRBJ1-4
TGTGCCAGCAGCGGACAGGGGATGAACACTGAAGCTTTCTTT	CASSGQGMNTEAFF	TRBV13	TRBJ1-1
TGTGCCAGCAGCGCGGGGAACTACGAGCAGTACTTC	CASSAGNYEQYF	TRBV13	TRBJ2-7
TGTGCCAGCAGCAGACGCCCCAGCGACCCTTATGTGAACACCGGGGAGCTGTTTTTT	CASSRRPSDPYVNTGELFF	TRBV7-3	TRBJ2-2
TGTGCCAGCAGCCCTCTTAGCTCCTACGAGCAGTACTTC	CASSPLSSYEQYF	TRBV7-9	TRBJ2-7
TGTGCCAGCAGTTCGGTCGGGATTGGCGAATTATCCAACAATGAGCAGTTCTTC	CASSSVGIGELSNNEQFF	TRBV6-5	TRBJ2-1
TGTGCCAGCAGCTTGCCACGGACCGAGCAGTACTTC	CASSLPRTEQYF	TRBV9	TRBJ2-7
TGTGCCAGCAGTCTGGGAGACACCGGGGAGCTGTTTTTT	CASSLGDTGELFF	TRBV6-2	TRBJ2-2
TGTGCTAGCAGCTTAATCCTAAGACAGGGACATGAAAAACTGTTTTTT	CASSLILRQGHEKLFF	TRBV7-7	TRBJ1-4
TGTGCCAGCAGCTTTATTGCCTTTCACTATGGCTACACCTTC	CASSFIAFHYGYTF	TRBV7-3	TRBJ1-2
TGTGCCAGCAGGGGGACAGGGCCCTGCTCTGGAAACACCATATATTTT	CASRGTGPCSGNTIYF	TRBV14	TRBJ1-3
TGTGCCAGCAGCTTGAACAGGGTGGACAATGAGCAGTTCTTC	CASSLNRVDNEQFF	TRBV5-6	TRBJ2-1
TGTGCCAGCAGCCATCTGTCCCAGGGTTTGATGAACACTGAAGCTTTCTTT	CASSHLSQGLMNTEAFF	TRBV14	TRBJ1-1
TGTGCCAGCAGTGAAGCGGCAAAGCAGAGCCGAACCTGTGAAGCTTTCTTT	CASSEAAKQSRTCEAFF	TRBV2	TRBJ1-1
TGCGCCAGCAGCCACGGGAATTTCTTCAATGAGCAGTTCTTC	CASSHGNFFNEQFF	TRBV4-3	TRBJ2-1
TGTGCCAGCAGCCTAACGGGGGCCTACGAGCAGTACTTC	CASSLTGAYEQYF	TRBV13	TRBJ2-7
TGTGCCAGCAGTGGGGTTGGGACCAGCAATCAGCCCCAGCATTTT	CASSGVGTSNQPQHF	TRBV6-1	TRBJ1-5
TGTGCCAGCAGCTTCGTCGGACTCAACAGGGGGAGATCCTACGAGCAGTACTTC	CASSFVGLNRGRSYEQYF	TRBV5-4	TRBJ2-7
TGTGCCAGCAGCCGGACTGGGCCCGGTCACGAGCAGTACTTC	CASSRTGPGHEQYF	TRBV13	TRBJ2-7
TGTGCCAGCAGCTTGGCTCCCACGAAACAGCATTTT	CASSLAPTKQHF	TRBV7-3	TRBJ1-5
TGCGCCAGCAGCTTGCCTCCTAGCGGCGCCGAAGAGACCCAGTACTTC	CASSLPPSGAEETQYF	TRBV5-1	TRBJ2-5
TGTGCCAGCAGTTTCGACAGGGGCTTT	CASSFDRGF	TRBV28	TRBJ1-1
TGTGCCAGCAGGAGTGGACAGCATAATCAGCCCCAGCATTTT	CASRSGQHNQPQHF	TRBV27	TRBJ1-5
TGTGCCAGCAGCGTAGAGGCCCATACTAGGGTCTACGAGCAGTACTTC	CASSVEAHTRVYEQYF	TRBV9	TRBJ2-7
TGTTCGCCCCCGGGGCATTCTGGAGCCTATGGCTACACCTTC	CSPPGHSGAYGYTF	TRBV6-6	TRBJ1-2
TGTGCCAGCAGCCCGGGACTCTACGAGCAGTACTTC	CASSPGLYEQYF	TRBV11-1	TRBJ2-7
TGTGCCAGCAGCTTAGGCCGGGACAGGGGGAAGGATACGCAGTATTTT	CASSLGRDRGKDTQYF	TRBV11-1	TRBJ2-3
TGTGCCAGCAGCAGTACCGTTACCGGGACAGAATATGGCTACACCTTC	CASSSTVTGTEYGYTF	TRBV7-3	TRBJ1-2
TGTGCCACCAGCAGAGATTTAAGAGGAGTAGGACATGAGCAGTTCTTC	CATSRDLRGVGHEQFF	TRBV15	TRBJ2-1
TGTGCCAGCAGCGCCGGGGACCATCAACATAGCTCCTACAATGAGCAGTTCTTC	CASSAGDHQHSSYNEQFF	TRBV7-3	TRBJ2-1
TGCAGTGCCCCCAACCCTCGGTCCTACGAGCAGTACTTC	CSAPNPRSYEQYF	TRBV20-1	TRBJ2-7
TGTGCCAGCAGCGGTGGCTGGCGTGGGGAGCAGTTCTTC	CASSGGWRGEQFF	TRBV5-4	TRBJ2-1
TGTGCCAGCACCATGGGACTAGCGGGAGCGGAGACCCAGTACTTC	CASTMGLAGAETQYF	TRBV7-2	TRBJ2-5
TGTGCCAGTAGTCACACGGAATCCGTCCCGACAGATACGCAGTATTTT	CASSHTESVPTDTQYF	TRBV19	TRBJ2-3
TGTGCCAGCAGTTACGGGGGACAGGGCACAGATACGCAGTATTTT	CASSYGGQGTDTQYF	TRBV6-5	TRBJ2-3
TGTGCCAGCAGCTGGACCGGGACAGGCGAGCAGTACTTC	CASSWTGTGEQYF	TRBV9	TRBJ2-7
TGTGCCACCAGTGAAGCAAGGGGGGAGCGCACAGATACGCAGTATTTT	CATSEARGERTDTQYF	TRBV24-1	TRBJ2-3
TGTGCCAGCAGCCAAACCCCAAATGGGGGGTGGCGTAACTGTTCCTACGAGCAGTACTTC	CASSQTPNGGWRNCSYEQYF	TRBV13	TRBJ2-7
TGTGCCAGCAGCGTGGACAGGGCTACTGAAGCTTTCTTT	CASSVDRATEAFF	TRBV9	TRBJ1-1
TGTGCCAGCAGTTTTTGGGTGACACAGAACACTGAAGCTTTCTTT	CASSFWVTQNTEAFF	TRBV28	TRBJ1-1
TGTGCCAGCAGAGAAGAGGACGGGATGAACACTGAAGCTTTCTTT	CASREEDGMNTEAFF	TRBV12-3	TRBJ1-1
TGCAGATCCGGGGTACAGGGTGGGGTCGATGGCTACACCTTC	CRSGVQGGVDGYTF	TRBV20-1	TRBJ1-2
TGTGCCAGCACTCCGTGGCATCCCCGGGGGCGGACCCGGATTCGGGCGTCTGGAAACACCATATATTTT	CASTPWHPRGRTRIRASGNTIYF	TRBV6-1	TRBJ1-3
TGTGCCAGCAGCACACCAAGCTACTACGAGCAGTACTTC	CASSTPSYYEQYF	TRBV7-3	TRBJ2-7
TGCGCCAGCATACAGGGCGGAAACTACGAGCAGTACTTC	CASIQGGNYEQYF	TRBV10-1	TRBJ2-7
TGTGCCAGCATCACTAGCGGGAGCGGGGAAACTGAAGCTTTCTTT	CASITSGSGETEAFF	TRBV28	TRBJ1-1
TGTGCCCCAGGGACTACTCAGCCCCAGCATTTT	CAPGTTQPQHF	TRBV6-2	TRBJ1-5
TGCAGTGCATCAGATAAAGCCATGGGACAGGAGATGAACACTGAAGCTTTCTTT	CSASDKAMGQEMNTEAFF	TRBV20-1	TRBJ1-1
TGTGCCAGCGCTAGCAATGAGCAGTTCTTC	CASASNEQFF	TRBV27	TRBJ2-1
TGTGCCAGCCGAAACCTCAGAAATTCACCCCTCCACTTT	CASRNLRNSPLHF	TRBV7-9	TRBJ1-6
TGTGCCAGCTCACCACATGAGGGTAGCTCCTACAATGAGCAGTTCTTC	CASSPHEGSSYNEQFF	TRBV18	TRBJ2-1
TGTGCCAGCAGATTCGGGCGGGAGGACTCAGATACGCAGTATTTT	CASRFGREDSDTQYF	TRBV6-3	TRBJ2-3
TGTGCCTGGAGTCCCGTGGGACTAGCGGGAGGGACCCAGTACTTC	CAWSPVGLAGGTQYF	TRBV30	TRBJ2-5
TGTGCCAGCAGCTCCTCAAGAGACAGGACAGAGGAGGACTATGGCTACACCTTC	CASSSSRDRTEEDYGYTF	TRBV5-6	TRBJ1-2
TGCGCCAGCATTAGGCCTTTCCGGCAGGGAACCTACGAGCAGTACTTC	CASIRPFRQGTYEQYF	TRBV10-1	TRBJ2-7
TGTGCCAGCAGCCCCTTTAGAGCAGGGGGGGGATATAGCAATCAGCCCCAGCATTTT	CASSPFRAGGGYSNQPQHF	TRBV7-3	TRBJ1-5
TGTGCTAGTGGAGCACCGAGCCGGTCTTACACCTTC	CASGAPSRSYTF	TRBV12-5	TRBJ1-2
TGCGCCAGCAGCTTGGCCGGGAACTACGAGCAGTACTTC	CASSLAGNYEQYF	TRBV5-1	TRBJ2-7
TGTGCCAGCAGCGAGGGACATGTGGCTTTCTTT	CASSEGHVAFF	TRBV7-4	TRBJ1-1
TGTGCCAGTAGTGATCGTGTGGGAAGCATGAACACTGAAGCTTTCTTT	CASSDRVGSMNTEAFF	TRBV19	TRBJ1-1
TGTGCCACCCGGGAGACTGGCGATAGCAATCAGCCCCAGCATTTT	CATRETGDSNQPQHF	TRBV24-1	TRBJ1-5
TGTGCCAGCTCGACCCAAGGACAGTACAATGAGCAGTTCTTC	CASSTQGQYNEQFF	TRBV6-5	TRBJ2-1
TGTGCTAGTGGTTTGGTACGACCCAGGGGGCAAAGTCAGCCCCAGCATTTT	CASGLVRPRGQSQPQHF	TRBV12-5	TRBJ1-5
TGTGCCAGCAGCCACCGTCCGTCGCCCTACGAGCAGTACTTC	CASSHRPSPYEQYF	TRBV14	TRBJ2-7
TGTGCCATCAGTTCACCTAGTAACGAGCAGTACTTC	CAISSPSNEQYF	TRBV10-3	TRBJ2-7
TGTGCCAGCAGCTTGGGGGAATTAGCCAAAAACATTCAGTACTTC	CASSLGELAKNIQYF	TRBV11-3	TRBJ2-4
TGTGCCAGCAGCTTGCTTCGGGAGAACACTGAAGCTTTCTTT	CASSLLRENTEAFF	TRBV5-4	TRBJ1-1
TGTGCCAGCAGCTTAGAAGGTGGGGTTATCCTTGGCGAGACCCAGTACTTC	CASSLEGGVILGETQYF	TRBV11-3	TRBJ2-5
TGTGCCAGCAGTGGCGGTAGCGGGTTAGCCAAAAACATTCAGTACTTC	CASSGGSGLAKNIQYF	TRBV12-3	TRBJ2-4
TGTGCCAGTAGTACCCCCGGGGGGATGTATGGCTACACCTTC	CASSTPGGMYGYTF	TRBV19	TRBJ1-2
TGCGCCAGCAGTGAGGAGTCACACAAATGGTCCTACGAGCAGTACTTC	CASSEESHKWSYEQYF	TRBV10-1	TRBJ2-7
TGTGCCAGCAGCGTGCCATGGGACAGGGGAGCTAACTATGGCTACACCTTC	CASSVPWDRGANYGYTF	TRBV13	TRBJ1-2
TGTGCCAGCAGCTTAGACCTTCTACTAGCGGGAGAGCCCTCCTACAATGAGCAGTTCTTC	CASSLDLLLAGEPSYNEQFF	TRBV7-9	TRBJ2-1
TGTGCCAGCAGCTCTAGCGGGCGGAGAGACGAAACAGATACGCAGTATTTT	CASSSSGRRDETDTQYF	TRBV7-3	TRBJ2-3
TGTGCCAGCAGGGAAACAGGGGGCTATGGCTACACCTTC	CASRETGGYGYTF	TRBV28	TRBJ1-2
TGTGCCAGCAGACTGGAGGAGGCGTACCAAGAGACCCAGTACTTC	CASRLEEAYQETQYF	TRBV2	TRBJ2-5
TGTGCTAGTGGCGCAGGGATCAGGCCCACAGATACGCAGTATTTT	CASGAGIRPTDTQYF	TRBV12-5	TRBJ2-3
TGTGTGACTAGGGGGCAGCTCAATGAGCAGTTCTTC	CVTRGQLNEQFF	TRBV6-6	TRBJ2-1
TGTGCCAGCAGCTCACCGGGACTGTGTGAGCAGTTCTTC	CASSSPGLCEQFF	TRBV5-5	TRBJ2-1
TGTGCCATGTCCACACAGGGGGCTGGGGATAATTCACCCCTCCACTTT	CAMSTQGAGDNSPLHF	TRBV10-3	TRBJ1-6
TGTGCCAGCAGCCAAAGAAAAACGATTTCCTCCACCGGGGAGCTGTTTTTT	CASSQRKTISSTGELFF	TRBV3-1	TRBJ2-2
TGTGCCAGCAGCTCTCCCGGACAGGGGCCTGGGGACACCGGGGAGCTGTTTTTT	CASSSPGQGPGDTGELFF	TRBV7-3	TRBJ2-2
TGTGCCAGCAGCTCCAGGGTCTGTGGCTACACCTTC	CASSSRVCGYTF	TRBV7-9	TRBJ1-2
TGTGCCACTACGATATCAATCAGCAATGAGCAGTTCTTC	CATTISISNEQFF	TRBV28	TRBJ2-1
TGCGCCAGCAGCTTGCTGATTAGCCGGGGACCCAGCACAGATACGCAGTATTTT	CASSLLISRGPSTDTQYF	TRBV5-1	TRBJ2-3
TGCGCCAGCTCGGGACAGGGACACGCTGGGGCCAACGTCCTGACTTTC	CASSGQGHAGANVLTF	TRBV5-1	TRBJ2-6
TGTGCCAGCAGTTACCCCGAAACTATAGCCTACGAGCAGTACTTC	CASSYPETIAYEQYF	TRBV6-5	TRBJ2-7
TGCGCCAGCAGCCCAACAGGGAGGTTATCCCCCGGTCCTTTTTGGCCCTTC	CASSPTGRLSPGPFWPF	TRBV5-1	TRBJ1-2
TGTGCCAGCAGAGGAAGGACAGTTGCACATAAGCAGTACTTC	CASRGRTVAHKQYF	TRBV9	TRBJ2-7
TGCGCCAGCAGCCAAGACAGGGGGCAGTTGAACACTGAAGCTTTCTTT	CASSQDRGQLNTEAFF	TRBV4-1	TRBJ1-1
TGTGCCAGCAGTTGGACAGGCATATCTAATGAAAAACTGTTTTTT	CASSWTGISNEKLFF	TRBV6-2	TRBJ1-4
TGTGCCAGCAGCTTCCTTATCCTGGGGTTCTATAGCAATCAGCCCCAGCATTTT	CASSFLILGFYSNQPQHF	TRBV7-3	TRBJ1-5
TGTGCCACCAGCAGACCGGGGGGGGTATACAATGAGCAGTTCTTC	CATSRPGGVYNEQFF	TRBV15	TRBJ2-1
TGTGCCAGCAGAACTACTCTATTTTACGAGCAGTACTTC	CASRTTLFYEQYF	TRBV12-4	TRBJ2-7
TGTGCCAGCAGGGACTATACGGTCGAACAGCCCCAGCATTTT	CASRDYTVEQPQHF	TRBV16	TRBJ1-5
TGTGCCAGCCTAGCGGGGAACACCGGGGAGCTGTTTTTT	CASLAGNTGELFF	TRBV11-3	TRBJ2-2
TGTGCCACCAGCAGAGTTCGTCTAGCTAGCGGGGAAGGAGAGACCCAGTACTTC	CATSRVRLASGEGETQYF	TRBV15	TRBJ2-5
TGTGCCACCAGTGACAATCTCCCCCTGACAGCCTATGAAAAACTGTTTTTT	CATSDNLPLTAYEKLFF	TRBV24-1	TRBJ1-4
TGCGCCAGCAGCGGCAACACGACATATGGCTACACCTTC	CASSGNTTYGYTF	TRBV5-1	TRBJ1-2
TGTGCCAGCAGCTACCCCCCGGACAGACAGCCCCAGCATTTT	CASSYPPDRQPQHF	TRBV7-3	TRBJ1-5
TGTGCCAGCAGCTTACCCACCAGGGGGATCGGGGCCAACGTCCTGACTTTC	CASSLPTRGIGANVLTF	TRBV7-9	TRBJ2-6
TGTGCCAGCAGCGGATCGGGGGGGGAGACCCAGTACTTC	CASSGSGGETQYF	TRBV7-3	TRBJ2-5
TGTGCCAGCAGCTTGGAAGGTAGTTGCCCGGGACAGGGGCACAATCAGCCCCAGCATTTT	CASSLEGSCPGQGHNQPQHF	TRBV7-7	TRBJ1-5
TGTGCTAGTGGTTGGCCAGGCACCGGGACAGCATACGAGCAGTACTTC	CASGWPGTGTAYEQYF	TRBV12-5	TRBJ2-7
