TGTGCCAGCAGTTTGCGACAAAAGACAGATCAGCCCCAGCATTTT	CASSLRQKTDQPQHF	TRBV28	TRBJ1-5
TGTGCCAGCAGTTGCTCTAAGGGGGGGGACTACGAGCAGTACTTC	CASSCSKGGDYEQYF	TRBV6-6	TRBJ2-7
TGTGCCAGTAGATTTACTAGCGGGCTGAGCGCCTACAATGAGCAGTTCTTC	CASRFTSGLSAYNEQFF	TRBV19	TRBJ2-1
TGTGCCAGCAGCTTACCCCGGGACAGAACCGGGAGGCGGAGCTCCTACAATGAGCAGTTCTTC	CASSLPRDRTGRRSSYNEQFF	TRBV7-6	TRBJ2-1
TGTGCCAGCAGGGGGACAGTCGGAGGTTTCCAGCTGTTTTTT	CASRGTVGGFQLFF	TRBV25-1	TRBJ2-2
TGTGCCATCAGTGGGGCCCATTGGGAACAGCAGAGCTCCTACAATGAGCAGTTCTTC	CAISGAHWEQQSSYNEQFF	TRBV10-3	TRBJ2-1
TGCAGTGCTAGTAGCCCGAGACAGGTTCCCTTGAACACTGAAGCTTTCTTT	CSASSPRQVPLNTEAFF	TRBV20-1	TRBJ1-1
TGTGCCAGCAAGGTGAGCATTATTCCCGGGGAGCTGTTTTTT	CASKVSIIPGELFF	TRBV7-9	TRBJ2-2
TGTGCCAGCAGTTTATCTTTACAGTTCGGTCGAAAATCCGGGGAGCTGTTTTTT	CASSLSLQFGRKSGELFF	TRBV28	TRBJ2-2
TGTGCCAGCAGCTTAGGCTCCATCTGGCGGGGGCTGAACACTGAAGCTTTCTTT	CASSLGSIWRGLNTEAFF	TRBV11-2	TRBJ1-1
TGTGCCAGCAGCGGACAGGGGGGTAACACTGAAGCTTTCTTT	CASSGQGGNTEAFF	TRBV9	TRBJ1-1
TGTGCCAGCACAGTCCACGAGCAGTACTTC	CASTVHEQYF	TRBV25-1	TRBJ2-7
TGTGCCAGCAGCCAACCCCACTGCCTAGCGGCTAGCGAGCAGTACTTC	CASSQPHCLAASEQYF	TRBV3-1	TRBJ2-7
TGTGCCAGCAGCTTGGCCGGGGACGAGCAGTACTTC	CASSLAGDEQYF	TRBV5-6	TRBJ2-7
TGTGCCAGCCGGACCTACAATGAGCAGTTCTTC	CASRTYNEQFF	TRBV11-1	TRBJ2-1
TGCAGCGTTGAAGATCTTATCGACAGGGAAGAGACCCAGTACTTC	CSVEDLIDREETQYF	TRBV29-1	TRBJ2-5
TGTGCCACCAGTTTGAGCAATCAGCCCCAGCATTTT	CATSLSNQPQHF	TRBV24-1	TRBJ1-5
TGTGCCAGCAGCCCCCCTCCCGGGACAGGGCCCTGCTCCTACGAGCAGTACTTC	CASSPPPGTGPCSYEQYF	TRBV9	TRBJ2-7
TGTGCCAGCAGCCAAGATAGTGAAGTAGAGTCTGGCACAGATACGCAGTATTTT	CASSQDSEVESGTDTQYF	TRBV14	TRBJ2-3
TGCAGTGCTAGACTTCAGGGGGGTGGCTACACCTTC	CSARLQGGGYTF	TRBV20-1	TRBJ1-2
TGTGCCATTGGAGACAGGGACACCTACGAGCAGTACTTC	CAIGDRDTYEQYF	TRBV10-3	TRBJ2-7
TGCAGTGCTAGAGATCCACCGGGCGATGACGAGCAGTACTTC	CSARDPPGDDEQYF	TRBV20-1	TRBJ2-7
TGTGCCAGCAGTTTGGGGAGCTCCTACGAGCAGTACTTC	CASSLGSSYEQYF	TRBV12-3	TRBJ2-7
TGTGCCAGCAGCACCACTGTACCGCCGGACAGGGACCAGAAAGAGACCCAGTACTTC	CASSTTVPPDRDQKETQYF	TRBV7-8	TRBJ2-5
TGCAGTGCTAGAGCCGAAAATCATCAAGGGACTAGCGGGGGGGAAGACGAGCAGTACTTC	CSARAENHQGTSGGEDEQYF	TRBV20-1	TRBJ2-7
TGCGCCAGCAGCTTGTATCCCGCTGTTGCTCCGGGACACTTGAGCCCAACTAATGAAAAACTGTTTTTT	CASSLYPAVAPGHLSPTNEKLFF	TRBV5-1	TRBJ1-4
TGTGCCACAGGGGATGATGATGAGCAGTTCTTC	CATGDDDEQFF	TRBV10-3	TRBJ2-1
TGCGCCAGCTTCCCTAGGGGGCGATTCTCCTACGAGCAGTACTTC	CASFPRGRFSYEQYF	TRBV5-1	TRBJ2-7
TGTGCCAGCAGCCCCCCTGGGATAGGGGGCGTTCCGGGCTACACCTTC	CASSPPGIGGVPGYTF	TRBV5-6	TRBJ1-2
TGTGCCAGCAGCGACCCGGGGAGCCTCGGGGCCAACGTCCTGACTTTC	CASSDPGSLGANVLTF	TRBV5-6	TRBJ2-6
TGTGCCAGCAGTTATCGGAAGAGCGAAAGAATCGATGAGCAGTTCTTC	CASSYRKSERIDEQFF	TRBV6-2	TRBJ2-1
TGTGCCAGCAGTTTACAGGGGGGGCAAATTGAGCCTGAGCAGTTCTTC	CASSLQGGQIEPEQFF	TRBV12-4	TRBJ2-1
TGCGCCAGCAGAAAGACGGAGATGAACACTGAAGCTTTCTTT	CASRKTEMNTEAFF	TRBV5-1	TRBJ1-1
TGTGCCAGCAGTAAACCTATCGTTCTCCGGACAGGGCCCGCTTTCTTT	CASSKPIVLRTGPAFF	TRBV25-1	TRBJ1-1
TGTGCCAGCAGCCAACCGATGACAGGCGGCACAGATACGCAGTATTTT	CASSQPMTGGTDTQYF	TRBV3-1	TRBJ2-3
TGCAGTGCTACCTTCACAGATACGCAGTATTTT	CSATFTDTQYF	TRBV20-1	TRBJ2-3
TGTGCCAGCACAGTAAGTCCCGGGACTAGCGGGAGCGGTTTAGATGTACCCCTCCACTTT	CASTVSPGTSGSGLDVPLHF	TRBV7-4	TRBJ1-6
TGTGCCAGCAGCGAAGCTCCTTCAGTGGGATTGGGGAACACCATATATTTT	CASSEAPSVGLGNTIYF	TRBV9	TRBJ1-3
TGTGCCACCAGATTTCGACGGGACTACAACACCGGGGAGCTGTTTTTT	CATRFRRDYNTGELFF	TRBV15	TRBJ2-2
TGTGCCAGCAGCTCGCGTCAGGGGGCGGGCCTCCAAGAGACCCAGTACTTC	CASSSRQGAGLQETQYF	TRBV5-4	TRBJ2-5
TGTGCCAGCAGCCACCGAGGGGGCTATGGCTACACCTTC	CASSHRGGYGYTF	TRBV14	TRBJ1-2
TGTGCCAGCAGAATGGAAGAAGCGGGAGGGGCAGATACGCAGTATTTT	CASRMEEAGGADTQYF	TRBV7-6	TRBJ2-3
TGTGCCAGCAGCTTCCGGGACAGAGATCAGCCCCAGCATTTT	CASSFRDRDQPQHF	TRBV11-3	TRBJ1-5
TGTGCCAGCAGCGTACAGGGTGTTCAGCCCCAGCATTTT	CASSVQGVQPQHF	TRBV7-9	TRBJ1-5
TGTGCCAGCAGCTTGGGAACAGACTCAAGCAATCAGCCCCAGCATTTT	CASSLGTDSSNQPQHF	TRBV5-4	TRBJ1-5
TGTGCCAGCAGCCAGGGGGATGAAAAACTGTTTTTT	CASSQGDEKLFF	TRBV7-9	TRBJ1-4
TGTGCCAGCAGAAAGTCGGGGACAGGGGAGACCCAGTACTTC	CASRKSGTGETQYF	TRBV9	TRBJ2-5
TGTGCCACCGGGACAGGGGGGGGCCGGTTGCCTAACTATGGCTACACCTTC	CATGTGGGRLPNYGYTF	TRBV24-1	TRBJ1-2
TGTGCCAGCAGCGTGATGGGACTAGCGGGCTATTCCTACAATGAGCAGTTCTTC	CASSVMGLAGYSYNEQFF	TRBV7-3	TRBJ2-1
TGTGCCAGCAGCTCGGACAGGGCCGACGAGCAGTACTTC	CASSSDRADEQYF	TRBV9	TRBJ2-7
TGTGCCAGCAGCCAAGAGTTCCGGGCCCAGGGGGTGGCTCTAAGTGACTATGGCTACACCTTC	CASSQEFRAQGVALSDYGYTF	TRBV3-1	TRBJ1-2
TGTGCCAGCAGTTACTCTCGGGACATGCAAACGTATGTGGAGAGCTCCTACGAGCAGTACTTC	CASSYSRDMQTYVESSYEQYF	TRBV6-2	TRBJ2-7
TGCGCCAGCAGCCGGGGACAGGGCATCACCGGGGAGCTGTTTTTT	CASSRGQGITGELFF	TRBV4-1	TRBJ2-2
TGTGCCAGCAGCCAAGATCTCCGGGGGGGTAGGTTTGAAGAGACCCAGTACTTC	CASSQDLRGGRFEETQYF	TRBV4-2	TRBJ2-5
TGTGCCAGCAGTTCCCGCGTGGGTCCGGGACTAGCGGGAGGCGAAAACACTTACGAGCAGTACTTC	CASSSRVGPGLAGGENTYEQYF	TRBV12-3	TRBJ2-7
TGTGCCAGCAGCCAAGGGCTAAGTCGGGGCGGGAGACAATATTGCGTGGAGACCCAGTACTTC	CASSQGLSRGGRQYCVETQYF	TRBV4-2	TRBJ2-5
TGTGCCAGCAGACCCGGGGGCGCGTCCGCCTCCTATGGCTACACCTTC	CASRPGGASASYGYTF	TRBV6-5	TRBJ1-2
TGTGCCAGCAGTGAATATTCCTCGGGACTTTCGCAGTTCTTC	CASSEYSSGLSQFF	TRBV25-1	TRBJ2-1
TGTGCCAGCAGCCACCCGAGAGAGGAGCAGTACTTC	CASSHPREEQYF	TRBV3-1	TRBJ2-7
TGTGCCAGTAGTCTGAATCGGGACAGGTTTGGTCCCTACGAGCAGTACTTC	CASSLNRDRFGPYEQYF	TRBV19	TRBJ2-7
TGCGCCAGCAGCTCTAGCGGGGGACCCTACGAGCAGTACTTC	CASSSSGGPYEQYF	TRBV5-1	TRBJ2-7
TGCGCCAGCCCCAGGGAACCGGACAGGGGGAGCACAGATACGCAGTATTTT	CASPREPDRGSTDTQYF	TRBV4-1	TRBJ2-3
TGCAGTGCTAGAGTTAAACGATTTGACAGGGGGGGCAACACTGAAGCTTTCTTT	CSARVKRFDRGGNTEAFF	TRBV20-1	TRBJ1-1
TGCGCCAGGAGAGCAGGGCCAGAGACCCAGTACTTC	CARRAGPETQYF	TRBV5-1	TRBJ2-5
TGTGCCAGCAGCGGACCCGGGACAGGCTACACCTTC	CASSGPGTGYTF	TRBV7-9	TRBJ1-2
TGTGCCAGCAGCTGTATACAGGGGTTATGGGGCCACTACTATGGCTACACCTTC	CASSCIQGLWGHYYGYTF	TRBV7-3	TRBJ1-2
TGTGCCAGCAGTCGAGAGGTCTGTCGCTCCTACAATGAGCAGTTCTTC	CASSREVCRSYNEQFF	TRBV2	TRBJ2-1
TGTGCCAGCAACAAACCGGCCAACGTCCTGACTTTC	CASNKPANVLTF	TRBV6-5	TRBJ2-6
TGTGCCAGCAGTTACGGAGGCGCGGGAGATAACCATGAGCAGTTCTTC	CASSYGGAGDNHEQFF	TRBV6-2	TRBJ2-1
TGTGCCACCAGTGATCGACAACGACTTATCTACGAGCAGTACTTC	CATSDRQRLIYEQYF	TRBV24-1	TRBJ2-7
TGTGGCCAGGGGCAGCCCCAGCATTTT	CGQGQPQHF	TRBV10-3	TRBJ1-5
TGTGCCAGCAGGGGGGGGACCGAGCAGTACTTC	CASRGGTEQYF	TRBV7-3	TRBJ2-7
TGTGCCAGCAGCCAGGGGGGAAGGGCTACTGGCACAGATACGCAGTATTTT	CASSQGGRATGTDTQYF	TRBV9	TRBJ2-3
TGTGCCAGCCCCGTCACAGGGGGCGCCTATGGCTACACCTTC	CASPVTGGAYGYTF	TRBV7-7	TRBJ1-2
TGTGCCAGCAGCAGAATGCGGGGCCGTCTAGAGACCCAGTACTTC	CASSRMRGRLETQYF	TRBV13	TRBJ2-5
TGTGCCAGCAAGCGGGAGAGTGGGGATAATCAGCCCCAGCATTTT	CASKRESGDNQPQHF	TRBV6-4	TRBJ1-5
TGCAGTGCACAGGGCCAGGGTAAATCACCCCTCCACTTT	CSAQGQGKSPLHF	TRBV20-1	TRBJ1-6
TGCGCCAGCAGCTCACAGAGGGGGCCTGGAAACACCATATATTTT	CASSSQRGPGNTIYF	TRBV5-1	TRBJ1-3
TGTGCCAGCAGTGGGCCGGGCACCGTACTCCACTTT	CASSGPGTVLHF	TRBV6-1	TRBJ1-6
TGTGCCAGCAGCTTGAGGGGGACAGGACGCGCCTACGAGCAGTACTTC	CASSLRGTGRAYEQYF	TRBV5-5	TRBJ2-7
TGTGCCAGGACAGGGGGCGAGCCCGAGGAGACCCAGTACTTC	CARTGGEPEETQYF	TRBV12-4	TRBJ2-5
TGTGCCAGCAGTGAATCACGGGGACCGTACACTGAAGCTTTCTTT	CASSESRGPYTEAFF	TRBV6-1	TRBJ1-1
TGCAGTGCACCGACAAGCTCCTACGAGCAGTACTTC	CSAPTSSYEQYF	TRBV20-1	TRBJ2-7
TGTGCCATGGCCCAAAAAGCGGGAGACGCCCACGAGCAGTACTTC	CAMAQKAGDAHEQYF	TRBV10-3	TRBJ2-7
TGTGCCAGCAGCGGTGAAGGGACAGGTTCCTACAATGAGCAGTTCTTC	CASSGEGTGSYNEQFF	TRBV7-3	TRBJ2-1
TGTGCCATCAGTGAGTCAAGGGTAGCGGGAAACCTAAATGAAAAACTGTTTTTT	CAISESRVAGNLNEKLFF	TRBV10-3	TRBJ1-4
TGTGCCACCAGTGATTCGGGGGGGAATGAGCAGTTCTTC	CATSDSGGNEQFF	TRBV24-1	TRBJ2-1
TGTGCCAGTAGTTCCGGGACTAGCGGGGGGGCAGGAAAGCGAGGGTACAATGAGCAGTTCTTC	CASSSGTSGGAGKRGYNEQFF	TRBV19	TRBJ2-1
TGTGCCAGAGCTGCCTTGCCAAGCCGGGACGCAGGTAACACTGAAGCTTTCTTT	CARAALPSRDAGNTEAFF	TRBV3-1	TRBJ1-1
TGTGCCAGCAGCTTTATTGACAGGGACTTC	CASSFIDRDF	TRBV7-2	TRBJ2-5
TGTGCCATGTATTTCCTAGAGGGCCTCCCGGCCGGGGAGCTGTTTTTT	CAMYFLEGLPAGELFF	TRBV12-4	TRBJ2-2
TGTGCCAGCTCACCACCGCACCCGGACAGCACTCAGCCCCAGCATTTT	CASSPPHPDSTQPQHF	TRBV18	TRBJ1-5
TGTGCCAGCAGCCAGCATTGGCAAGAGACCCAGTACTTC	CASSQHWQETQYF	TRBV7-9	TRBJ2-5
TGCAGTGCAGTTCATACCGGGGACAGGGGTGGGGTGGCCTACGAGCAGTACTTC	CSAVHTGDRGGVAYEQYF	TRBV20-1	TRBJ2-7
TGTGCCAGCAGCCAAGGAACAAGCGGGAGCGGGCCAAGCTCCTATAATTCACCCCTCCACTTT	CASSQGTSGSGPSSYNSPLHF	TRBV4-2	TRBJ1-6
TGTGCCAGCAGTTGGCCTCCTAGACAGAACACTGAAGCTTTCTTT	CASSWPPRQNTEAFF	TRBV6-9	TRBJ1-1
TGTGCCAGCAGGGGGTACGTGAACACTGAAGCTTTCTTT	CASRGYVNTEAFF	TRBV11-2	TRBJ1-1
TGTGCCAGCAGCTTAGCGGTTCCTCGGCCCTCCTACAATGAGCAGTTCTTC	CASSLAVPRPSYNEQFF	TRBV11-2	TRBJ2-1
TGTGCCAGCAGCTCACCCCCGGTCAAGACTCCCTCAGATACGCAGTATTTT	CASSSPPVKTPSDTQYF	TRBV11-3	TRBJ2-3
TGCGCCAGCAGCCAAGAGCCCGAAGGGGGGCAAGAATACAATGAGCAGTTCTTC	CASSQEPEGGQEYNEQFF	TRBV4-3	TRBJ2-1
TGTGCCAGCAGTTTAACTCAGGCAGCCAGGGGATCGGAAAAACTGTTTTTT	CASSLTQAARGSEKLFF	TRBV27	TRBJ1-4
TGTGCCAGCAAGGCGGGACAGGGGCTCTATGGCTACACCTTC	CASKAGQGLYGYTF	TRBV7-9	TRBJ1-2
TGTGCCAGTAGTATAGTCCAGGGCCCCATTCAGCCCCAGCATTTT	CASSIVQGPIQPQHF	TRBV19	TRBJ1-5
TGCGCCAGCAGCTTGATGACCCGTGGGGGCGGAAAGGGTAACACTGAAGCTTTCTTT	CASSLMTRGGGKGNTEAFF	TRBV5-1	TRBJ1-1
TGTGCCACAGGGGAAGGACTGTTTTTT	CATGEGLFF	TRBV3-1	TRBJ1-4
TGTGCCAGCAACATGGGGGGGCGGGGCGGGGAGCTGTTTTTT	CASNMGGRGGELFF	TRBV2	TRBJ2-2
TGTGCCACCTCACGTCCCGGGGCCAACACTGAAGCTTTCTTT	CATSRPGANTEAFF	TRBV7-9	TRBJ1-1
TGCGCCAGCAGCTCAGGGAGCCTTCTTCCTACCGGGGAGCTGTTTTTT	CASSSGSLLPTGELFF	TRBV5-1	TRBJ2-2
TGTGCCAGCAGTTCTGTGCGACTAGCCGGGGAGCTGTTTTTT	CASSSVRLAGELFF	TRBV6-3	TRBJ2-2
TGTGCCAGCAGCGGCATCACCGGGGAGCTGTTTTTT	CASSGITGELFF	TRBV9	TRBJ2-2
TGTGCCAAGGGGGGAGCGGGAAGCACAGATACGCAGTATTTT	CAKGGAGSTDTQYF	TRBV6-6	TRBJ2-3
TGCGCCAGCAGCGAAGCCGGGACTAGCGAGCAGTACTTC	CASSEAGTSEQYF	TRBV5-1	TRBJ2-7
TGCGCCAGCATGGTCCGGGACAGGGCCGAGGGGAGCTCCTACGAGCAGTACTTC	CASMVRDRAEGSSYEQYF	TRBV10-2	TRBJ2-7
TGTGCCAATGACAGTTCGCGGAGCTCCTACAATGAGCAGTTCTTC	CANDSSRSSYNEQFF	TRBV18	TRBJ2-1
TGTGCCAGCAGCGCTCGACAGGGTCTGAGCTCCTACGAGCAGTACTTC	CASSARQGLSSYEQYF	TRBV7-2	TRBJ2-7
TGTGCCAGCAGAGCCTTCGGGGGTCCGAACACCGGGGAGCTGTTTTTT	CASRAFGGPNTGELFF	TRBV28	TRBJ2-2
TGTGCCAGCAGCTGCGGGAGGGATGAGTACAATGAGCAGTTCTTC	CASSCGRDEYNEQFF	TRBV11-2	TRBJ2-1
TGTGCCAGCAGCCAAGCTAAGGTAGTAGCTTGGACTGAAGCTTTCTTT	CASSQAKVVAWTEAFF	TRBV3-1	TRBJ1-1
TGTGCCAGTAGTATTAGGAGAGGAGGAGGTCAGCCCCAGCATTTT	CASSIRRGGGQPQHF	TRBV19	TRBJ1-5
TGCGCCAGCAGCTTGCCCCGGGACAGGGGGCTTTCCTATAATTCACCCCTCCACTTT	CASSLPRDRGLSYNSPLHF	TRBV5-1	TRBJ1-6
TGTGCCAGCAGTTCCACCGGGACAGTTCGGCGTAGCAATCAGCCCCAGCATTTT	CASSSTGTVRRSNQPQHF	TRBV6-1	TRBJ1-5
TGTGCCAGCAGTTACGGGCAGCGTAACTATGGCTACACCTTC	CASSYGQRNYGYTF	TRBV6-2	TRBJ1-2
TGTGCCAGCAGCGGCCGGGCTATTCACACTGAAGCTTTCTTT	CASSGRAIHTEAFF	TRBV11-1	TRBJ1-1
TGCGCCAGCAGCTTCCCAGAATCCGGGACTGTGAGCTCCTACAATGAGCAGTTCTTC	CASSFPESGTVSSYNEQFF	TRBV5-1	TRBJ2-1
TGTGCCAGCAGTATGGGACAGCGGGGCTATAATTCACCCCTCCACTTT	CASSMGQRGYNSPLHF	TRBV27	TRBJ1-6
TGTGCCAGCAGCCCCTTCACAGGACAGGACTCACAGGGCTACGAGCAGTACTTC	CASSPFTGQDSQGYEQYF	TRBV3-1	TRBJ2-7
TGTGCCAGCAGTGCTGACAGGACAGGGCTCCAGGGTGGGCATGACTCTGGAAACACCATATATTTT	CASSADRTGLQGGHDSGNTIYF	TRBV6-4	TRBJ1-3
TGTGCCAGCAGTGAGGAAGGACTAGCTAAGGGGAGCTCCTACAATGAGCAGTTCTTC	CASSEEGLAKGSSYNEQFF	TRBV6-4	TRBJ2-1
TGTGCCAGCAGCCAGTTTAGGTTCACTGAAGCTTTCTTT	CASSQFRFTEAFF	TRBV14	TRBJ1-1
TGTGCCAGCAGCCCTGGACAGGGATGTGGGAACACTGAAGCTTTCTTT	CASSPGQGCGNTEAFF	TRBV27	TRBJ1-1
TGTGCCAGCAGCGAGACAGGGGGAGGGCGTGGCTACACCTTC	CASSETGGGRGYTF	TRBV7-2	TRBJ1-2
TGCGCCAGCAGTTACCCGGGGGTGGCTTTCTTT	CASSYPGVAFF	TRBV10-1	TRBJ1-1
TGTGCCAGTCTTGCACAGGGAACGCGTTTGTCGAGCAATCAGCCCCAGCATTTT	CASLAQGTRLSSNQPQHF	TRBV19	TRBJ1-5
TGTGCCAGCAGCGCACCACAGGGTCAAAGGAATCAGCCCCAGCATTTT	CASSAPQGQRNQPQHF	TRBV7-4	TRBJ1-5
TGTGCCAGTACACCAGACCCTGCAGATACGCAGTATTTT	CASTPDPADTQYF	TRBV19	TRBJ2-3
TGCACGAGACCCCCGGGACAGGGAGCGATTAATTCACCCCTCCACTTT	CTRPPGQGAINSPLHF	TRBV20-1	TRBJ1-6
TGTGCCAGCAGCTTAAAACTGTTTCCTGGGGGGGGGGATGAGCAGTTCTTC	CASSLKLFPGGGDEQFF	TRBV7-3	TRBJ2-1
TGTGCCAGTAGTCTGACCGGGGAGCTGTTTTTT	CASSLTGELFF	TRBV19	TRBJ2-2
TGCAGCGTTGGCCGGGGCCATAGCAATCAGCCCCAGCATTTT	CSVGRGHSNQPQHF	TRBV29-1	TRBJ1-5
TGTGCCAGCAGCTTAGAGGACAGGGGGGAAACAGATACGCAGTATTTT	CASSLEDRGETDTQYF	TRBV7-2	TRBJ2-3
TGTGCCACCAGTGATTTGATCGACCGACAGGGCGACGGCTATGGCTACACCTTC	CATSDLIDRQGDGYGYTF	TRBV24-1	TRBJ1-2
TGTGCCAGCAGTTTATCGCCGGGAACCGGATACAATGAGCAGTTCTTC	CASSLSPGTGYNEQFF	TRBV27	TRBJ2-1
TGTGCCAGCAGTGACTCTAAGAACACTGAAGCTTTCTTT	CASSDSKNTEAFF	TRBV6-4	TRBJ1-1
TGTGCTAGTGGGGTTCAGGGAGTCAACACTGAAGCTTTCTTT	CASGVQGVNTEAFF	TRBV12-5	TRBJ1-1
TGTGCCAGCAGCGGATGTCGGGCGGGAGCTTTCGGGGAGCTGTTTTTT	CASSGCRAGAFGELFF	TRBV13	TRBJ2-2
TGCGCCAGCAGCTTGGGCGACAGGTATGGCTACGAGCAGTACTTC	CASSLGDRYGYEQYF	TRBV5-1	TRBJ2-7
TGTGCCAGCAGCGGGGGGGTTAATGGCTACACCTTC	CASSGGVNGYTF	TRBV13	TRBJ1-2
TGCGCCAGCAGTCCCATTCCGGACGGACAGGGATATCAGCCCCAGCATTTT	CASSPIPDGQGYQPQHF	TRBV4-1	TRBJ1-5
TGTGCCAGCAGCTTGGGGACAGCCCTGAACACTGAAGCTTTCTTT	CASSLGTALNTEAFF	TRBV7-2	TRBJ1-1
TGTGCCACCAGTGTTGTCAATTCGTACAGGGAGCGAGAGACCCAGTACTTC	CATSVVNSYRERETQYF	TRBV24-1	TRBJ2-5
TGTGCCAGCAGTCTAATAACACGAGACAGGGGGCGCTCCTATAATTCACCCCTCCACTTT	CASSLITRDRGRSYNSPLHF	TRBV28	TRBJ1-6
TGTGCCAGCAGCGGGACAGGGTCCTATAGCAATCAGCCCCAGCATTTT	CASSGTGSYSNQPQHF	TRBV7-8	TRBJ1-5
TGTGCCAGCAGCTTGGGGCTTGGAGCAGATACGCAGTATTTT	CASSLGLGADTQYF	TRBV7-8	TRBJ2-3
TGTGCCAGCACAGGCCCGGACAGGCCCCGAGAGACCCAGTACTTC	CASTGPDRPRETQYF	TRBV13	TRBJ2-5
TGTGCCAGCACATGGCTGGGGGGGGGGTTAGTGGATTTTGGATATTCACCCCTCCACTTT	CASTWLGGGLVDFGYSPLHF	TRBV14	TRBJ1-6
TGTGCCAGCAGTTCTGGTAAGCGGGAGGACGAGCAGTACTTC	CASSSGKREDEQYF	TRBV6-4	TRBJ2-7
TGTGCCAGCAGCTTCTTAGGCTCGGGACAGAGCTGGCCCAATGAGCAGTTCTTC	CASSFLGSGQSWPNEQFF	TRBV5-6	TRBJ2-1
TGTGCCAGCAGTGCGGAGAAAGGGGATAATTCACCCCTCCACTTT	CASSAEKGDNSPLHF	TRBV6-3	TRBJ1-6
TGCGCCAGCAGCTTGTCCCGGTTTTGTAGAGGGGGCGGCTATGGCTACACCTTC	CASSLSRFCRGGGYGYTF	TRBV5-1	TRBJ1-2
TGTGCCAGCAGCCCGGGACTAGCCAATGAGCAGTACTTC	CASSPGLANEQYF	TRBV3-1	TRBJ2-7
TGTGCCAGCAGTGAATATCTAGGGACAGTTAGCACAGATACGCAGTATTTT	CASSEYLGTVSTDTQYF	TRBV25-1	TRBJ2-3
TGTGCCAGCATATGGCAAGAAAAAGATGGCTACACCTTC	CASIWQEKDGYTF	TRBV28	TRBJ1-2
TGTGCCAGTAGTGCAGTTGGTCAAGGGCAGCCCCAGCATTTT	CASSAVGQGQPQHF	TRBV19	TRBJ1-5
TGTGCCAGCAGCCAATCGGTCATGGGGGGCCGCTACAATGAGCAGTTCTTC	CASSQSVMGGRYNEQFF	TRBV16	TRBJ2-1
TGCGCCAGCAACGATTTGGGGCACCATTCCTACGAGCAGTACTTC	CASNDLGHHSYEQYF	TRBV4-3	TRBJ2-7
TGTGCCAGCAAGGGGGGTATCAATCAGCCCCAGCATTTT	CASKGGINQPQHF	TRBV3-1	TRBJ1-5
TGCAGTGCTAGATTCCGGGACAGTCGAATCTATGGCTACACCTTC	CSARFRDSRIYGYTF	TRBV20-1	TRBJ1-2
TGCGCCAGCAGTGAAAATTGTGTACGGGGGGGCCAAAAGGGGTTCTTC	CASSENCVRGGQKGFF	TRBV10-1	TRBJ2-1
TGTGCCAGCAGCCCAAACGACAGGGGGCGGTATGGCTACACCTTC	CASSPNDRGRYGYTF	TRBV7-9	TRBJ1-2
TGTGCCACTCGGGGGAATCGCGGGGAGCTGTTTTTT	CATRGNRGELFF	TRBV24-1	TRBJ2-2
TGTGCCAGCAGTCACAGGGCTGAGCAGTTCTTC	CASSHRAEQFF	TRBV27	TRBJ2-1
TGTGCCAGCAGCCAAGCTCAGGGCGGTTATAGCAATCAGCCCCAGCATTTT	CASSQAQGGYSNQPQHF	TRBV4-2	TRBJ1-5
TGTGCCAGCAGTGCAGGGGGGCTCATCAGCTCCTATAATTCACCCCTCCACTTT	CASSAGGLISSYNSPLHF	TRBV6-4	TRBJ1-6
TGTGCTAGTGGTTTGGAGGGACAGTCCGAAGCTTTCTTT	CASGLEGQSEAFF	TRBV12-5	TRBJ1-1
TGTGCCAGCAGACGGAAAGAGTATAGCAATCAGCCCCAGCATTTT	CASRRKEYSNQPQHF	TRBV28	TRBJ1-5
TGTGCCAGCAGCCGACGGCCCGGGACTAGCGGGAGCCGGAACACCGGGGAGCTGTTTTTT	CASSRRPGTSGSRNTGELFF	TRBV11-3	TRBJ2-2
TGTGCCAGCAGAGGCACACAGGGACCCGAGACCCAGTACTTC	CASRGTQGPETQYF	TRBV28	TRBJ2-5
TGTGCCAGCCCCCGTGAGGGACGCAATGAGCAGTTCTTC	CASPREGRNEQFF	TRBV2	TRBJ2-1
TGTGCCAGCAGCGTAGCCGGATGGCGGAAAAAATCTAATGAAAAACTGTTTTTT	CASSVAGWRKKSNEKLFF	TRBV9	TRBJ1-4
TGTGCCAGCAGCCAAGGAACTGTCTCAGGGGTAGATGAAAAACTGTTTTTT	CASSQGTVSGVDEKLFF	TRBV4-2	TRBJ1-4
TGTGCCGTCAGGGGTTTGAACACTGAAGCTTTCTTT	CAVRGLNTEAFF	TRBV25-1	TRBJ1-1
TGTGCCAGCAGTGACCGCCGGGACAGGAGGCCTCAGCCCCAGCATTTT	CASSDRRDRRPQPQHF	TRBV6-4	TRBJ1-5
TGTGCCAGCAAGAGGGGCCGGCGACAGGGTCACGAGCAGTACTTC	CASKRGRRQGHEQYF	TRBV9	TRBJ2-7
TGTGCCACCAGTGATCTGGCCCCCCCCGGACACAACACTGAAGCTTTCTTT	CATSDLAPPGHNTEAFF	TRBV24-1	TRBJ1-1
TGTGCCAGCAGCCACTTAGAGTCTGGGGCCAACGTCCTGACTTTC	CASSHLESGANVLTF	TRBV14	TRBJ2-6
TGTGCCAGCAGTGCCCGACTAGCGGGAGGGCTTGCCTACGAGCAGTACTTC	CASSARLAGGLAYEQYF	TRBV2	TRBJ2-7
TGTGCCACCAGTGATCATACCTCCTACGAGCAGTACTTC	CATSDHTSYEQYF	TRBV24-1	TRBJ2-7
TGTGCCAGCAGCTCTTGTAGTAATGAGCAGTTCTTC	CASSSCSNEQFF	TRBV7-3	TRBJ2-1
TGTGCCAGCAGAGGTGGAAATTCCACCGGGGAGCTGTTTTTT	CASRGGNSTGELFF	TRBV6-4	TRBJ2-2
TGCGCCAGCAGCCGGCTCGGGACAGGGTTGGACTCTGGAAACACCATATATTTT	CASSRLGTGLDSGNTIYF	TRBV5-1	TRBJ1-3
TGCAGTGCCCCGGGGGGGCCAGATGAGCAGTTCTTC	CSAPGGPDEQFF	TRBV20-1	TRBJ2-1
TGTGCCAGCAGCAAAGGGGGGGGCCGGGGGATTGCTTCCTACAATGAGCAGTTCTTC	CASSKGGGRGIASYNEQFF	TRBV6-5	TRBJ2-1
TGTGCCACCAGTGATCCACATCACCACAGGGGGGAGAACACTGAAGCTTTCTTT	CATSDPHHHRGENTEAFF	TRBV24-1	TRBJ1-1
TGTGCCAGCAAGACTGGGGGACACGGCGGCACTAACTATGGCTACACCTTC	CASKTGGHGGTNYGYTF	TRBV6-5	TRBJ1-2
TGTGCCAGCATCAACAGGGAAAATTCACCCCTCCACTTT	CASINRENSPLHF	TRBV6-5	TRBJ1-6
TGTGCCTGGAGTGTACCGGGACGGTGTTGCCAAGAGACCCAGTACTTC	CAWSVPGRCCQETQYF	TRBV30	TRBJ2-5
TGTGCCAGCAGGATAAGGGAGGACAGTACCCTAACAGATACGCAGTATTTT	CASRIREDSTLTDTQYF	TRBV6-4	TRBJ2-3
TGTGCCAGCAGTGGGGACAGGGGTAACTATGGCTACACCTTC	CASSGDRGNYGYTF	TRBV6-4	TRBJ1-2
TGTGCCAGCAGCTCAAGACAGTTTTTGAACACTGAAGCTTTCTTT	CASSSRQFLNTEAFF	TRBV7-2	TRBJ1-1
TGCATAGAAAGGACAGGGGCTTCTGGGGCCAACGTCCTGACTTTC	CIERTGASGANVLTF	TRBV20-1	TRBJ2-6
TGTGCCAGCAGCCAGCGGGGGGGCCAGTACTTC	CASSQRGGQYF	TRBV7-9	TRBJ2-5
TGTGCCAGCAGCGGGGGTAGGGGGGGCAATGAGCAGTTCTTC	CASSGGRGGNEQFF	TRBV11-2	TRBJ2-1
TGTGCCATCAGTGAGTCACAGGGTTATCGAGACACTGAAGCTTTCTTT	CAISESQGYRDTEAFF	TRBV10-3	TRBJ1-1
TGTGCCAGCAGCCCGAACAACAGGGCCTGGGCAGCTAACTATGGCTACACCTTC	CASSPNNRAWAANYGYTF	TRBV7-3	TRBJ1-2
TGTGCCACCAGTGATTTGCTGACTACGACAGGGGGGTCAGGCCTAGAGACCCAGTACTTC	CATSDLLTTTGGSGLETQYF	TRBV24-1	TRBJ2-5
TGTGCCAGCAGCTTAGGACCAGACGAGGAAGCTTTCTTT	CASSLGPDEEAFF	TRBV7-8	TRBJ1-1
TGTGCCAGCAGACCGGACAGGGCACGACGGTGCACAGATACGCAGTATTTT	CASRPDRARRCTDTQYF	TRBV28	TRBJ2-3
TGTGCCAGCAGCGGGGGGTATTCTCTCCAAGAGACCCAGTACTTC	CASSGGYSLQETQYF	TRBV7-3	TRBJ2-5
TGTGCCAGCAGCAAGAGGGACAATAATCAGCCCCAGCATTTT	CASSKRDNNQPQHF	TRBV7-3	TRBJ1-5
TGCGCCAGCAGCCAACAGGGGGCCGGACTAGCGGGGGTGGCGAACACCGGGGAGCTGTTTTTT	CASSQQGAGLAGVANTGELFF	TRBV4-3	TRBJ2-2
TGCGCCAGCAGCCGGATGACAGGCACTGAAGCTTTCTTT	CASSRMTGTEAFF	TRBV5-1	TRBJ1-1
TGTGCCATCACCAGACAGGGGGGATACTCAGAGACCCAGTACTTC	CAITRQGGYSETQYF	TRBV10-3	TRBJ2-5
TGTGCCAGCAGCTTAGTCGGCGGAGCAGATACGCAGTATTTT	CASSLVGGADTQYF	TRBV7-2	TRBJ2-3
TGTGCCAGCAGCCGACCCGCAGGGAGGCTAGCTTTCTTT	CASSRPAGRLAFF	TRBV9	TRBJ1-1
TGTGCCAGCAGCGGCACAGGGGGCGAGGCCGACTATGGCTACACCTTC	CASSGTGGEADYGYTF	TRBV9	TRBJ1-2
TGCGCCAGCAGCAATCGAAGTCGAGCTGAGCAGTTCTTC	CASSNRSRAEQFF	TRBV5-1	TRBJ2-1
TGTGCCAGCAGCGAAGACAGGCCGGGGGACACAGATACGCAGTATTTT	CASSEDRPGDTDTQYF	TRBV9	TRBJ2-3
TGTGCCAGCAGCTGTTCCGACCACAGCACTTACAACTCTGGGGCCAACGTCCTGACTTTC	CASSCSDHSTYNSGANVLTF	TRBV11-2	TRBJ2-6
TGTGCCAGCAGCTTCTCGGCTTTGGGCGGGGACTACGAGCAGTACTTC	CASSFSALGGDYEQYF	TRBV11-1	TRBJ2-7
TGTGCCAGCAGCTTAGGCCCGACTAGCGGGAGTTTCGATACGCAGTATTTT	CASSLGPTSGSFDTQYF	TRBV7-9	TRBJ2-3
TGTGCCAGCCGGGTCCCAGAGACCCAGTACTTC	CASRVPETQYF	TRBV6-5	TRBJ2-5
TGTGCCAGCAGACCCGAATACTCTGGAAACACCATATATTTT	CASRPEYSGNTIYF	TRBV6-1	TRBJ1-3
TGTGCCGACTTACGTACCCCCAAAAACATTCAGTACTTC	CADLRTPKNIQYF	TRBV25-1	TRBJ2-4
TGTGCCAGCACTGGCCCTCCATTACCGAATCAGCCCCAGCATTTT	CASTGPPLPNQPQHF	TRBV2	TRBJ1-5
TGTGCCAGTAGTATAGCGGGACAGGGGTATAGCAATCAGCCCCAGCATTTT	CASSIAGQGYSNQPQHF	TRBV19	TRBJ1-5
TGTGCCAGCAGCCAAGACAAGACAGTACTCAACGAGCAGTACTTC	CASSQDKTVLNEQYF	TRBV14	TRBJ2-7
TGCGCCAGCAGCTTGCCAGCAGGGGTCACCTACGAGCAGTACTTC	CASSLPAGVTYEQYF	TRBV5-1	TRBJ2-7
TGTGCCACCCTCAGCCACAGACAGGGCTATCAGCCCCAGCATTTT	CATLSHRQGYQPQHF	TRBV15	TRBJ1-5
TGTGCCAGTAGTACTAGCGGGCTCTTGAGAAACGGTAACTACAATGAGCAGTTCTTC	CASSTSGLLRNGNYNEQFF	TRBV19	TRBJ2-1
TGCGCCAGCAGTGAGTCTAGCGGGGGAGAGACCCAGTACTTC	CASSESSGGETQYF	TRBV10-1	TRBJ2-5
TGTGCCAGCAGCCCCGGGGGCCCCTACGAGCAGTACTTC	CASSPGGPYEQYF	TRBV7-3	TRBJ2-7
TGTGCCAGCAGTGACCGAGGCTTCACAGATACGCAGTATTTT	CASSDRGFTDTQYF	TRBV2	TRBJ2-3
TGTGCCAGCAGTTACGAGCTTTCCCGACAGGGCAGGGTAGAGGATGGCTACACCTTC	CASSYELSRQGRVEDGYTF	TRBV6-5	TRBJ1-2
TGTGCCAGTAGCCGGACACTAGCGGGGATCCACAGAGTTTCCTACGAGCAGTACTTC	CASSRTLAGIHRVSYEQYF	TRBV19	TRBJ2-7
TGTGCCAGCAGCAGGACAGGCCCCACAGATACGCAGTATTTT	CASSRTGPTDTQYF	TRBV7-2	TRBJ2-3
TGTGCCAGCAGCCAAAGTGGGCGAGAAGGCTACACCTTC	CASSQSGREGYTF	TRBV11-3	TRBJ1-2
TGTGCCAGCAGTGAGTCCGGGACGTACCAAGAGACCCAGTACTTC	CASSESGTYQETQYF	TRBV6-4	TRBJ2-5
TGTGCCAGCAGGGGGTGGGGGGGTGCCGAGCAGTACTTC	CASRGWGGAEQYF	TRBV6-1	TRBJ2-7
TGTGCCATGAAGAAACGTTGTATAAACCCCGGGACAGGGGGGGGTACTGAAGCTTTCTTT	CAMKKRCINPGTGGGTEAFF	TRBV28	TRBJ1-1
TGTGCCAGCAGTAGAACGGCCCCGGGACTAGACAGGCGCACAGATACGCAGTATTTT	CASSRTAPGLDRRTDTQYF	TRBV27	TRBJ2-3
TGTGCCAGCAAAGAATCCGAGAAGTTGTCACCCCTCCACTTT	CASKESEKLSPLHF	TRBV6-5	TRBJ1-6
TGTGCCAGCAGCTTAGTCCGATGGACCGCTGGGGGGTTTGGCTACACCTTC	CASSLVRWTAGGFGYTF	TRBV7-4	TRBJ1-2
TGTGCCAGCAGTCTTCACAGGGTCGTCACAGATACGCAGTATTTT	CASSLHRVVTDTQYF	TRBV6-1	TRBJ2-3
TGCGCCAGCAGCCGGACAGGGGGCGGCTACACCTTC	CASSRTGGGYTF	TRBV4-1	TRBJ1-2
TGTGCCAGCAGCGTGGGCGAAGGGACCGGCTACACCTTC	CASSVGEGTGYTF	TRBV7-9	TRBJ1-2
TGTGCCACCAAGGGACTATCCTACAATGAGCAGTTCTTC	CATKGLSYNEQFF	TRBV24-1	TRBJ2-1
TGTGCCAGCAGTGGGGTGACTAGGGGAAATGAGCAGTTCTTC	CASSGVTRGNEQFF	TRBV2	TRBJ2-1
TGTGCCAGGATCCCAACTGCAGTAGATTACTCTGGGGCCAACGTCCTGACTTTC	CARIPTAVDYSGANVLTF	TRBV19	TRBJ2-6
TGCAGTGCTAGAGATCTCGCATCAGGCCAGGGCCGTGAGCAGTTCTTC	CSARDLASGQGREQFF	TRBV20-1	TRBJ2-1
TGTGCCACCAGTGATGGGGGGGGCCTGGTAGCCAAAAACATTCAGTACTTC	CATSDGGGLVAKNIQYF	TRBV24-1	TRBJ2-4
TGTGCCAGCACCGGCTTACTAGACTACAATGAGCAGTTCTTC	CASTGLLDYNEQFF	TRBV27	TRBJ2-1
TGTGCCAGCAGCCAGGGGGAAGCTTTCTTT	CASSQGEAFF	TRBV13	TRBJ1-1
TGTGCCAGCAGCCAAGAACGGACAGGGAGGGATAAAGATACGCAGTATTTT	CASSQERTGRDKDTQYF	TRBV3-1	TRBJ2-3
TGTGCCAGCAGCTTTCCCCATTGGGGGGCGGAAGACGGCGGCTACACCTTC	CASSFPHWGAEDGGYTF	TRBV13	TRBJ1-2
TGTGCCAGCAGCACAGGGAATCCTAATGAAAAACTGTTTTTT	CASSTGNPNEKLFF	TRBV11-3	TRBJ1-4
TGTGCCACCAGTGGGGACAAACATGAGCAGTTCTTC	CATSGDKHEQFF	TRBV15	TRBJ2-1
TGTGCCAGCAGCTTCCAGGGAGACGCAGATACGCAGTATTTT	CASSFQGDADTQYF	TRBV5-4	TRBJ2-3
TGCGCCAGCAGCTTAATTGAGGAGGGGTTGTTAAGGGGCTACACCTTC	CASSLIEEGLLRGYTF	TRBV5-1	TRBJ1-2
TGTGCCAGCAGTGTCCCCTCAGTGTGGGATCAGCCCCAGCATTTT	CASSVPSVWDQPQHF	TRBV6-3	TRBJ1-5
TGTGCCAGCAGTATTTCCCGGGGGGCTGGGTGGAGTCCCGGGCCGGGCTACAATGAGCAGTTCTTC	CASSISRGAGWSPGPGYNEQFF	TRBV25-1	TRBJ2-1
TGTGCCAGCAGCTTAATGGGGGGGACGGATACGCAGTATTTT	CASSLMGGTDTQYF	TRBV7-6	TRBJ2-3
TGTGCCAGTACCGATGTGATCGGGGCTCCCTTGTACGAGCAGTACTTC	CASTDVIGAPLYEQYF	TRBV19	TRBJ2-7
TGTGCCAGCAGCCAAGATGACCAGAGGTACTTCACAGATACGCAGTATTTT	CASSQDDQRYFTDTQYF	TRBV14	TRBJ2-3
TGTGCTGGCCCAGGGGAGCCTGGGGCCAACGTCCTGACTTTC	CAGPGEPGANVLTF	TRBV19	TRBJ2-6
TGTATGACAGGGCTAAGCTATGGCTACACCTTC	CMTGLSYGYTF	TRBV19	TRBJ1-2
TGTGCCAGTAGTATCGAATGGATTCAGCCCCAGCATTTT	CASSIEWIQPQHF	TRBV19	TRBJ1-5
TGTGCCACCCCCAATGGGGGATCTTGGATCTACAATGAGCAGTTCTTC	CATPNGGSWIYNEQFF	TRBV7-8	TRBJ2-1
TGTGCCAGCAGCTTCCTTCTGAGGCAAGAGACCCAGTACTTC	CASSFLLRQETQYF	TRBV7-6	TRBJ2-5
TGCAGTGCTAGAGACAGGGTCCTCTACAATGAGCAGTTCTTC	CSARDRVLYNEQFF	TRBV20-1	TRBJ2-1
TGTGCCAGAACAGGGGGTATAAGAACCGGGGAGCTGTTTTTT	CARTGGIRTGELFF	TRBV3-1	TRBJ2-2
TGTGCCAGCAGTTACGCGGAAAGGGGGGGTTACGAGCAGTACTTC	CASSYAERGGYEQYF	TRBV6-6	TRBJ2-7
TGTGCCATCAGTGAGCTCCATGTCGGAAACACCATATATTTT	CAISELHVGNTIYF	TRBV10-3	TRBJ1-3
TGTGCCAGTCTTAAGGACGAGCAGTACTTC	CASLKDEQYF	TRBV2	TRBJ2-7
TGTGCCACCAGTGGGGGGGTGTGCTACAATGAGCAGTTCTTC	CATSGGVCYNEQFF	TRBV24-1	TRBJ2-1
TGCGCCAGCAGCTTGCTCTACGAGCAGTACTTC	CASSLLYEQYF	TRBV5-1	TRBJ2-7
TGCATCCCTAGGACCTACGAGCAGTACTTC	CIPRTYEQYF	TRBV20-1	TRBJ2-7
TGCGCCAGCAGCCGCGAGGGGGCTGAGCAGTTCTTC	CASSREGAEQFF	TRBV4-1	TRBJ2-1
TGTGCCAGCAGCAGCGGGACACCCCGAGGGGCTTACAATGAGCAGTTCTTC	CASSSGTPRGAYNEQFF	TRBV7-9	TRBJ2-1
TGTGCCAGCAATCATCAGGGGTGGGGGGTGGGCGGGGAGCTGTTTTTT	CASNHQGWGVGGELFF	TRBV2	TRBJ2-2
TGCGCCAACCGGGGCCGCTCTGGAAACACCATATATTTT	CANRGRSGNTIYF	TRBV4-1	TRBJ1-3
TGTGCCAGCAGTTTACAGGGGGGCCATGGCTACACCTTC	CASSLQGGHGYTF	TRBV28	TRBJ1-2
TGTGCCAGAGTTGGTGGCTCCGTCTACGACGCTTTCTTT	CARVGGSVYDAFF	TRBV6-1	TRBJ1-1
TGCGCCAGCAGTTTCACAGGGGGCGAGAGTTCACCCCTCCACTTT	CASSFTGGESSPLHF	TRBV10-2	TRBJ1-6
TGTGCCAGCAGGTCCAGGGGGCCTAAGGCGGGGAATCAGCCCCAGCATTTT	CASRSRGPKAGNQPQHF	TRBV6-5	TRBJ1-5
TGCGCCAGCAGCGGTTTCCGTAGTAGCAATGAGCAGTTCTTC	CASSGFRSSNEQFF	TRBV5-1	TRBJ2-1
TGTGCCAGCAGCGGTGAGGAGACCAATGAAAAACTGTTTTTT	CASSGEETNEKLFF	TRBV9	TRBJ1-4
TGTGCCAGCTCACCACGAAATGGGACGCAGTATTTT	CASSPRNGTQYF	TRBV18	TRBJ2-3
TGTGCCAGCAGTTTAAAATCAAATACGGGACAGGGGGCATCCTACAATGAGCAGTTCTTC	CASSLKSNTGQGASYNEQFF	TRBV28	TRBJ2-1
TGCAGTGCTAGAGGACAGGGTTATTCACCCCTCCACTTT	CSARGQGYSPLHF	TRBV20-1	TRBJ1-6
TGTGCCAGCAGCTTCTTTTACGCCCAAGAGACCCAGTACTTC	CASSFFYAQETQYF	TRBV11-2	TRBJ2-5
TGTGCCAGCAGCCTCAACCCCGGGACTAGCGGGTACCAATTCAATGAGCAGTTCTTC	CASSLNPGTSGYQFNEQFF	TRBV13	TRBJ2-1
TGCGCCAGCCCAAGACAGGATCAGCCCCAGCATTTT	CASPRQDQPQHF	TRBV5-1	TRBJ1-5
TGCAGTGCTAGAGCGACAGTTGGGAACACTGAAGCTTTCTTT	CSARATVGNTEAFF	TRBV20-1	TRBJ1-1
TGTGCCAAGTTTGGCCTCGACAGGGTTTATGGCTACACCTTC	CAKFGLDRVYGYTF	TRBV6-4	TRBJ1-2
TGTGCCAGCAGCTTGCTGTCCGGGACATGGACGGCCCAGCATTTT	CASSLLSGTWTAQHF	TRBV5-4	TRBJ1-5
TGTGCCAGCAGCTTAGGTCGGGGGAGCCCTAGCAATCAGCCCCAGCATTTT	CASSLGRGSPSNQPQHF	TRBV11-3	TRBJ1-5
TGTGCCAGCAGTAAATGGCATGAGCAGTTCTTC	CASSKWHEQFF	TRBV6-3	TRBJ2-1
TGTGCCAGCACTCACGGGGTCGCTGACAGGGGTGCAACTAATGAAAAACTGTTTTTT	CASTHGVADRGATNEKLFF	TRBV6-5	TRBJ1-4
TGTGCCACCAACGACAGGGGGCACCGGACCGGGAGGATTCCAGCAACTAATGAAAAACTGTTTTTT	CATNDRGHRTGRIPATNEKLFF	TRBV24-1	TRBJ1-4
TGTGCCAGCAGCTTCCCCCGGGACAGGGCGGTAAGATCTGGAAACACCATATATTTT	CASSFPRDRAVRSGNTIYF	TRBV7-9	TRBJ1-3
TGTGCCAGCAGCTTGGAGCGGCCGCCAGATACGCAGTATTTT	CASSLERPPDTQYF	TRBV9	TRBJ2-3
TGCGCCAGCAGCACCGCCACCTCGGGACTAGCGGGTTATGAGCAGTTCTTC	CASSTATSGLAGYEQFF	TRBV4-1	TRBJ2-1
TGCAGGGGAGAGACCGAGACCCAGTACTTC	CRGETETQYF	TRBV29-1	TRBJ2-5
TGTGCCAGCAGTGAACCTTTAGTCATTAAGTTAAACTATGGCTACACCTTC	CASSEPLVIKLNYGYTF	TRBV2	TRBJ1-2
TGTGCCACCAGCCATACTAGCGGGAGGGCGACCTACGAGCAGTACTTC	CATSHTSGRATYEQYF	TRBV15	TRBJ2-7
TGTGCCAGCAGCTTTCCCAGAAGTTACGAGCAGTACTTC	CASSFPRSYEQYF	TRBV5-6	TRBJ2-7
TGTGCCAGCAGTGGGCTGGACAGGGACCATGAGACAAACTATGGCTACACCTTC	CASSGLDRDHETNYGYTF	TRBV6-1	TRBJ1-2
TGTGCCAGCAGCACGGGACAGTACGTGTATCAAGAGACCCAGTACTTC	CASSTGQYVYQETQYF	TRBV5-8	TRBJ2-5
TGTGCCAGCAGCTTGGTGTACACAGGGACGGGAACTGAAGCTTTCTTT	CASSLVYTGTGTEAFF	TRBV5-4	TRBJ1-1
TGTGCCAGCAGCCTGCACGGGTGGGGGGAAGAGACCCAGTACTTC	CASSLHGWGEETQYF	TRBV14	TRBJ2-5
TGTGCCAGCAGTTGTAACTCGCGGTGGCAGCCCCAGCATTTT	CASSCNSRWQPQHF	TRBV6-5	TRBJ1-5
TGCGCCGCGGGCCGTATAAACACTGAAGCTTTCTTT	CAAGRINTEAFF	TRBV10-1	TRBJ1-1
TGTGCCAGCAGCGAAGCAGAGAATTGGATCAATAATTCACCCCTCCACTTT	CASSEAENWINNSPLHF	TRBV13	TRBJ1-6
TGTGCCAGCAGTGGGGGACTAGCGGGGGGGCCTTCCAGCACAGATACGCAGTATTTT	CASSGGLAGGPSSTDTQYF	TRBV6-4	TRBJ2-3
TGTGCCAGCATAACCGGGACGGAGGGCGAGCAGTACTTC	CASITGTEGEQYF	TRBV27	TRBJ2-7
TGTGCCAGCAGCTTCCCCCTAGAGAGGATCGTGCAAGAGACCCAGTACTTC	CASSFPLERIVQETQYF	TRBV7-3	TRBJ2-5
TGTGCCAGTAGTATTGGGGAGGCGACAACTAATGAAAAACTGTTTTTT	CASSIGEATTNEKLFF	TRBV19	TRBJ1-4
TGTGCCAGCAGCCCGACAGGCGCCGGTCAGCCCCAGCATTTT	CASSPTGAGQPQHF	TRBV9	TRBJ1-5
TGTGCCAGCAGTTTACAGTCCCCCGCGGGAGAGGGCTTCTACGAGCAGTACTTC	CASSLQSPAGEGFYEQYF	TRBV12-4	TRBJ2-7
TGCGCCAGCACGACAGATCACAATGAGCAGTTCTTC	CASTTDHNEQFF	TRBV10-1	TRBJ2-1
TGTGCCAGCAGTGACCCAGAGGGCACTGAAGCTTTCTTT	CASSDPEGTEAFF	TRBV6-4	TRBJ1-1
TGTGCCAGCAGTCTCCCCTGGGACAAGGCCTACGAGCAGTACTTC	CASSLPWDKAYEQYF	TRBV27	TRBJ2-7
TGCAGTGCGACGGGCTACGAGCAGTACTTC	CSATGYEQYF	TRBV20-1	TRBJ2-7
TGTGCCAGCCTAACTCAGGGCCCCTACGAGCAGTACTTC	CASLTQGPYEQYF	TRBV7-3	TRBJ2-7
TGCAGTGCGAAGCAGGGCGGGGGCTACACCTTC	CSAKQGGGYTF	TRBV20-1	TRBJ1-2
TGTGCCAGCAGTTTTTGCAGGGTATCCTACGAGCAGTACTTC	CASSFCRVSYEQYF	TRBV12-4	TRBJ2-7
TGTGCCAGCTCACTGAGAGGGGGGGATGAGACCCAGTACTTC	CASSLRGGDETQYF	TRBV18	TRBJ2-5
TGTGCCAGCAGTGACTTACGAATAACGAAGATTTCTTCGGATAGCGGGAATCAGCCCCAGCATTTT	CASSDLRITKISSDSGNQPQHF	TRBV6-4	TRBJ1-5
TGTGCCAGCAGCCAACCCGGGACTCGGGATCGGACCGGGGAGCTGTTTTTT	CASSQPGTRDRTGELFF	TRBV3-1	TRBJ2-2
TGTGCCAGCAGTGGGAGGGCCGAGGAGACGAACACCGGGGAGCTGTTTTTT	CASSGRAEETNTGELFF	TRBV5-4	TRBJ2-2
TGTGCCACCAGTGACCTTTATGACGCGGACTCTGGAAACACCATATATTTT	CATSDLYDADSGNTIYF	TRBV24-1	TRBJ1-3
TGTGCCAGCAGTTTATCGCCGACAATTAATGAGCAGTTCTTC	CASSLSPTINEQFF	TRBV27	TRBJ2-1
TGCGCCAGCAGCTTGGTGACTAGCGGGAGGGCTGGAGCGAAAAACATTCAGTACTTC	CASSLVTSGRAGAKNIQYF	TRBV5-1	TRBJ2-4
TGTGCCAGCAGCGATGAGGGACAGGGAAAAAGCTCTGGAAACACCATATATTTT	CASSDEGQGKSSGNTIYF	TRBV13	TRBJ1-3
TGCGCCAGCAGCCACTACGGACTCTTC	CASSHYGLF	TRBV5-1	TRBJ2-1
TGTGCCAGCAGCTTAGTCCCGGGGGGCCAAGAGACCCAGTACTTC	CASSLVPGGQETQYF	TRBV11-2	TRBJ2-5
TGTGCCAGCAGCTTTGATCCCCCAGCCGTTGCCGGGGAGCTGTTTTTT	CASSFDPPAVAGELFF	TRBV7-4	TRBJ2-2
TGCGCCAGCAGCCAAGATGACAGGGGCCATGGCTACACCTTC	CASSQDDRGHGYTF	TRBV4-3	TRBJ1-2
TGTGCCAGCAGCGGGTCCCGACAGGGAACGCGGATAAGTCAGCCCCAGCATTTT	CASSGSRQGTRISQPQHF	TRBV13	TRBJ1-5
TGTGCCACCAGTCTTAGGAGAAGGCATCAGCCCCAGCATTTT	CATSLRRRHQPQHF	TRBV24-1	TRBJ1-5
TGTGCTAGTGGAGGGGACAGGGGAACTGAAGCTTTCTTT	CASGGDRGTEAFF	TRBV12-5	TRBJ1-1
TGTGCCAAGACAATCGACAGGTCCCCCTACGAGCAGTACTTC	CAKTIDRSPYEQYF	TRBV12-3	TRBJ2-7
TGTGCCACCCCCCCGACCGGATCCTACGAGCAGTACTTC	CATPPTGSYEQYF	TRBV15	TRBJ2-7
TGTGCCAGCAGCCCTACTTGTTGTATCGGGTTTCTCACTGAAGCTTTCTTT	CASSPTCCIGFLTEAFF	TRBV13	TRBJ1-1
TGTGCCAGCCGTCCTAGCGGACCCTACGAGCAGTACTTC	CASRPSGPYEQYF	TRBV3-1	TRBJ2-7
TGCGCCAGCCCGGACCTGACGGAAGGCAATGAGCAGTTCTTC	CASPDLTEGNEQFF	TRBV5-1	TRBJ2-1
TGTGCCTGGAGTACCGACGGGGCCGTCCAGGCCTACGAGCAGTACTTC	CAWSTDGAVQAYEQYF	TRBV30	TRBJ2-7
TGTGCCTGGAGTGGTGGACAGGCAGAAAAACTGTTTTTT	CAWSGGQAEKLFF	TRBV30	TRBJ1-4
TGTGCCAGCAGCCGGGTAATCGACAGGGGGAGGGAGACCCAGTACTTC	CASSRVIDRGRETQYF	TRBV5-6	TRBJ2-5
TGTGCCAGCAGCTTCCCAGGGGGCTACACCTTC	CASSFPGGYTF	TRBV11-2	TRBJ1-2
TGTGCCAGCAGCCGCCGGCGAGGGGCTCTCTACGAGCAGTACTTC	CASSRRRGALYEQYF	TRBV13	TRBJ2-7
TGCGCCAGAAATTGTTATAGGGCGGGGAGGAATTCACCCCTCCACTTT	CARNCYRAGRNSPLHF	TRBV4-1	TRBJ1-6
TGTGCCACCAGTGATCCAAAATTGATAAGGGAGAGCGGGGAGCTGTTTTTT	CATSDPKLIRESGELFF	TRBV24-1	TRBJ2-2
TGTGCCAGCAGCGGAGATGGCAATCAGCCCCAGCATTTT	CASSGDGNQPQHF	TRBV5-4	TRBJ1-5
TGTGCCAGCAGGGGAGACAGTCGACAGTACTTC	CASRGDSRQYF	TRBV12-3	TRBJ2-7
TGTGCCAGCAGTTACGGCCCAGGGGCGGTCAGCTCTGGGGCCAACGTCCTGACTTTC	CASSYGPGAVSSGANVLTF	TRBV6-2	TRBJ2-6
TGTGCCAGCCGTCGGACGGGCTCTGGGGCCAACGTCCTGACTTTC	CASRRTGSGANVLTF	TRBV28	TRBJ2-6
TGTGCCAGCAGCTCCCCCGCCCCCAGCCCGACAGGGGGTAGCTCCTACGAGCAGTACTTC	CASSSPAPSPTGGSSYEQYF	TRBV7-4	TRBJ2-7
TGTGCCAGCAGCCCGACCATTCCGGTCGAGCAGTACTTC	CASSPTIPVEQYF	TRBV9	TRBJ2-7
TGTGCCAGCAGCGGTCAGACTAGTGGAAATGAGCAGTTCTTC	CASSGQTSGNEQFF	TRBV11-3	TRBJ2-1
TGTGCCACCAGTGATTTGAACCACCCCGGGGGGGATGAGCAGTTCTTC	CATSDLNHPGGDEQFF	TRBV24-1	TRBJ2-1
TGCGCCAGCAGCTTGGTGCCAACGAGGACTAGTGATACGCAGTATTTT	CASSLVPTRTSDTQYF	TRBV5-1	TRBJ2-3
TGCGCCAGCAGCCTCAGGTTACACACCTCCTACGAGCAGTACTTC	CASSLRLHTSYEQYF	TRBV4-1	TRBJ2-7
TGTGCCACCAGCCCCTGGGGACTAGCGTGGCGAGATGAGCAGTTCTTC	CATSPWGLAWRDEQFF	TRBV15	TRBJ2-1
TGTGCCAGCAAGGGCCTAACGCTCACAGGGGGCCGCCCCTATGGCTACACCTTC	CASKGLTLTGGRPYGYTF	TRBV28	TRBJ1-2
TGCATCTCCTTAGACAGTAATTCACCCCTCCACTTT	CISLDSNSPLHF	TRBV20-1	TRBJ1-6
TGTGCCAGCAGCCAAGGACATAGACAGTTGGATTATAATTCACCCCTCCACTTT	CASSQGHRQLDYNSPLHF	TRBV3-1	TRBJ1-6
TGTGCCACTAAGATAGAGACCCAGTACTTC	CATKIETQYF	TRBV28	TRBJ2-5
TGTGCCAGCAGTTTATTAGCGGTGGAAGGTTACTACGAGCAGTACTTC	CASSLLAVEGYYEQYF	TRBV27	TRBJ2-7
TGCGCCAGCAGCTTAATGACAGGGGGATTCCCAGGATCACCCCTCCACTTT	CASSLMTGGFPGSPLHF	TRBV5-1	TRBJ1-6
TGCGCCAGCAGCTTGGACGACAATCAGCCCCAGCATTTT	CASSLDDNQPQHF	TRBV5-1	TRBJ1-5
TGCGCCAGCAGCATCCTAGCGGGCCTAACCGAGCAGTACTTC	CASSILAGLTEQYF	TRBV5-1	TRBJ2-7
TGTGCCAGCAGTTGTAGGAAAGAGGGCTATGGCTACACCTTC	CASSCRKEGYGYTF	TRBV9	TRBJ1-2
TGTGCCAGCAGCGGAGGGGTATACGAGCAGTACTTC	CASSGGVYEQYF	TRBV7-3	TRBJ2-7
TGTGCCAGCAGTGCGGTCCAAGAGACCCAGTACTTC	CASSAVQETQYF	TRBV6-4	TRBJ2-5
TGTGCCAGTCCCAGGGACCGGGCTGAAGCTTTCTTT	CASPRDRAEAFF	TRBV27	TRBJ1-1
TGTGCCAGCAGCCCGAGGGAGAGCCCCTCCTACGAGCAGTACTTC	CASSPRESPSYEQYF	TRBV3-1	TRBJ2-7
TGTGCCAGTAGTATCCGAGACAGGGGCAGCAATCAGCCCCAGCATTTT	CASSIRDRGSNQPQHF	TRBV19	TRBJ1-5
TGTGCCAGCACCGGCCCCCGTGACAGTGTCTATGAAAAACTGTTTTTT	CASTGPRDSVYEKLFF	TRBV12-3	TRBJ1-4
TGTGCCAGCAGATCGGGACAGGGAGGCGGGTACGAGCAGTACTTC	CASRSGQGGGYEQYF	TRBV11-3	TRBJ2-7
TGTGCCAGCAGCAACTTAACCTACAATGAGCAGTTCTTC	CASSNLTYNEQFF	TRBV6-1	TRBJ2-1
TGTGCCAGCAGCTTAGCTCCCCGGGGCACGATCAACGAGCAGTACTTC	CASSLAPRGTINEQYF	TRBV7-9	TRBJ2-7
TGTGCCAGCAGCCAAGATACAGGGCAGACCCTCCACTTT	CASSQDTGQTLHF	TRBV4-2	TRBJ1-6
TGCGCCAGAGGGGACGCTCGACGAGAGACCCAGTACTTC	CARGDARRETQYF	TRBV10-1	TRBJ2-5
TGTGCCAGCAGCTGCCCATGCGAGGGGACAGATACGCAGTATTTT	CASSCPCEGTDTQYF	TRBV7-9	TRBJ2-3
TGTGCCAGCACGAACAGAAGCGGGGAGCTGTTTTTT	CASTNRSGELFF	TRBV6-4	TRBJ2-2
TGTGCCAGCAGCTATATGACAGGGAAGGACTATGGCTACACCTTC	CASSYMTGKDYGYTF	TRBV7-7	TRBJ1-2
TGTGCCAGCAGCTGGACCCAGATTTCCAAAAACATTCAGTACTTC	CASSWTQISKNIQYF	TRBV7-2	TRBJ2-4
TGCAGTGCTAGAGATGCCCGTCCGCATCCCCGACAGGGGGCTGAAGGCTACACCTTC	CSARDARPHPRQGAEGYTF	TRBV20-1	TRBJ1-2
TGCGCCAGCAGCTCGGGGGGGCCTACTGGAAACACCATATATTTT	CASSSGGPTGNTIYF	TRBV5-1	TRBJ1-3
TGTGCCAGCCCCTCAGGGGACCCCATGAACACTGAAGCTTTCTTT	CASPSGDPMNTEAFF	TRBV19	TRBJ1-1
TGTGCCACCACTGAGCAGTACTTC	CATTEQYF	TRBV24-1	TRBJ2-7
TGCGCCAGCAGCCGCGTTTGCGACAATGAGCAGTTCTTC	CASSRVCDNEQFF	TRBV4-1	TRBJ2-1
TGCGCCAGCAGTGAGTCGAAATTCCGGGAGCAGTACTTC	CASSESKFREQYF	TRBV10-2	TRBJ2-7
TGCGCCAGCAGCTTGGGGGACAGGGGGACCACTGGAAACACCATATATTTT	CASSLGDRGTTGNTIYF	TRBV5-1	TRBJ1-3
TGTGCCAGCAGCTTACACTGTGGGGATGACAGGGGTCCCTACGAGCAGTACTTC	CASSLHCGDDRGPYEQYF	TRBV11-3	TRBJ2-7
TGCAGTGCTAGAGGTATATCCCACTCCAGCCTTGCCACAGGGGGCTGTTCAGATACGCAGTATTTT	CSARGISHSSLATGGCSDTQYF	TRBV20-1	TRBJ2-3
TGTGCCAGCAGCTTAAGGCCCCAGGGCCCTAGGGTACACAATGAGCAGTTCTTC	CASSLRPQGPRVHNEQFF	TRBV7-3	TRBJ2-1
TGTGCCACCAGCAGTTCGGACAGGGGTAGGGTGGGTGAAAGCAATCAGCCCCAGCATTTT	CATSSSDRGRVGESNQPQHF	TRBV15	TRBJ1-5
TGTGCCAGTAGTATAGTGACTAGCGGGAGAGAAACAGATACGCAGTATTTT	CASSIVTSGRETDTQYF	TRBV19	TRBJ2-3
TGTGCCAGCAGCCGACAGGGGGCTAATGAAAAACTGTTTTTT	CASSRQGANEKLFF	TRBV14	TRBJ1-4
TGCGCCAGCAGCTTGGACCAGCCCCAGCATTTT	CASSLDQPQHF	TRBV5-1	TRBJ1-5
TGTGCCAGCAGCTCCCCTGTTGAAGACAGGAACACCGGGGAGCTGTTTTTT	CASSSPVEDRNTGELFF	TRBV13	TRBJ2-2
TGCAGTGCGAAACCCAGGAGGTCACCCCTCCACTTT	CSAKPRRSPLHF	TRBV20-1	TRBJ1-6
TGTGCCAGCAGCAAACTAAAAGGAAGCTACGAGCAGTACTTC	CASSKLKGSYEQYF	TRBV13	TRBJ2-7
TGTGCCATCACGGTCACACGGGGATTCGGAGGGGCCAACGTCCTGACTTTC	CAITVTRGFGGANVLTF	TRBV10-3	TRBJ2-6
TGCGCCAGCAGCGTGGTGCGGTACTACGAGCAGTACTTC	CASSVVRYYEQYF	TRBV5-1	TRBJ2-7
TGTGCCAGCAGCTCCTTTGCCGGGACGTGGGCTTATGGCTACACCTTC	CASSSFAGTWAYGYTF	TRBV5-4	TRBJ1-2
TGTGCCACCGACAGGGGATTTATATATGGCTACACCTTC	CATDRGFIYGYTF	TRBV10-3	TRBJ1-2
TGTGCCAGCAGCTTACCCCGTCGGGACCCCTACGAGCAGTACTTC	CASSLPRRDPYEQYF	TRBV7-4	TRBJ2-7
TGTGCCAGCAGCTTATTCACAGGGGGGGGCTCTGGGGCCAACGTCCTGACTTTC	CASSLFTGGGSGANVLTF	TRBV11-2	TRBJ2-6
TGTGCCAGCAGTACCGGGACAGGGACCTCCTACGAGCAGTACTTC	CASSTGTGTSYEQYF	TRBV27	TRBJ2-7
TGTGCCAACTGTCCTAACGGGGTGCAGCCCCAGCATTTT	CANCPNGVQPQHF	TRBV6-4	TRBJ1-5
TGTGCCAGCAGGAGACTACGGAGCTCCTACGAGCAGTACTTC	CASRRLRSSYEQYF	TRBV14	TRBJ2-7
TGCAGTGCTAGAGATATGAGCCCCCGGGACTACGAGCAGTACTTC	CSARDMSPRDYEQYF	TRBV20-1	TRBJ2-7
TGTGCCAGCAGCCAAACTGGGGTCAATCTGAGGGAGGGACAGTCCCACTACGAGCAGTACTTC	CASSQTGVNLREGQSHYEQYF	TRBV3-1	TRBJ2-7
TGTGCCAGCAGGGGGAAAGGAGACCCGTCAGAAAAACTGTTTTTT	CASRGKGDPSEKLFF	TRBV14	TRBJ1-4
TGTGCCAGCAGCTGGGGCCTAGCCAAAAACATTCAGTACTTC	CASSWGLAKNIQYF	TRBV7-7	TRBJ2-4
TGTGCCAGCATTCCCGGGGCCGAGCAGTACTTC	CASIPGAEQYF	TRBV3-1	TRBJ2-7
TGCAGTGCCCTCCGACAGGGTTTCTACGAGCAGTACTTC	CSALRQGFYEQYF	TRBV20-1	TRBJ2-7
TGCAGTGCTAGCGGGCTAGTGGGGGAAGAGCAGTTCTTC	CSASGLVGEEQFF	TRBV20-1	TRBJ2-1
TGCAGCGTTGACGGACAGCTCTCCTATAATTCACCCCTCCACTTT	CSVDGQLSYNSPLHF	TRBV29-1	TRBJ1-6
TGTGCCACCAGTGATTTCCACAACAGGGGGCGACCATCAGATACGCAGTATTTT	CATSDFHNRGRPSDTQYF	TRBV24-1	TRBJ2-3
TGTGCCAGCAAAGGGGGTTTAGAGCAGTTCTTC	CASKGGLEQFF	TRBV6-2	TRBJ2-1
TGCGCCAGCAGCTTGGATGGGGGACAGGGGGAAACTGAAGCTTTCTTT	CASSLDGGQGETEAFF	TRBV5-1	TRBJ1-1
TGTGCCAGCAGCGTTTCGGGGCCTGACTACGAGCAGTACTTC	CASSVSGPDYEQYF	TRBV9	TRBJ2-7
TGTGCCAGCTCACCGGGGACAGATGACTACGAGCAGTACTTC	CASSPGTDDYEQYF	TRBV18	TRBJ2-7
TGTCCTAGCGGAACACACACCGGGGAGCTGTTTTTT	CPSGTHTGELFF	TRBV30	TRBJ2-2
TGTGCCAGCAGTTATAGGTCAACCGGGACAGGGGGCGGGCCAGCGAACACCGGGGAGCTGTTTTTT	CASSYRSTGTGGGPANTGELFF	TRBV6-2	TRBJ2-2
TGCGCCAGCAGGTGGGCCTTTGGGGAGCTGTTTTTT	CASRWAFGELFF	TRBV4-1	TRBJ2-2
TGCGCCAGCAGCTTAGAGGAGCCTAAAGTTTACAGGGGCGCAGGAAACACCATATATTTT	CASSLEEPKVYRGAGNTIYF	TRBV5-1	TRBJ1-3
TGTGCCAGCAGCAAGGGGGCGTCCAACACTGAAGCTTTCTTT	CASSKGASNTEAFF	TRBV7-3	TRBJ1-1
TGTGCGGGGGCTTTTGAGACCCAGTACTTC	CAGAFETQYF	TRBV6-2	TRBJ2-5
TGCGCCAGCAGCGGACAGGGTCTAACCAATCAGCCCCAGCATTTT	CASSGQGLTNQPQHF	TRBV5-1	TRBJ1-5
TGTGCCATCAAGGAAGGGGGCGGGCAAGAGACCCAGTACTTC	CAIKEGGGQETQYF	TRBV10-3	TRBJ2-5
TGCGCCAGCAGCTATGAAGCGGGGGCTAGGTACGAGCAGTACTTC	CASSYEAGARYEQYF	TRBV4-1	TRBJ2-7
TGTGCCAGCAGTGTCAGGGAGGTTAACTATGGCTACACCTTC	CASSVREVNYGYTF	TRBV27	TRBJ1-2
TGCAGTGCTAGTAAGACAGGGTTAATGGAGCAGTACTTC	CSASKTGLMEQYF	TRBV20-1	TRBJ2-7
TGTGCCAGCAGCAAAACAGTCATGTTCACAGATACGCAGTATTTT	CASSKTVMFTDTQYF	TRBV9	TRBJ2-3
TGTGCCAGCGCCCCCCGGGACACTCCCACTGAAGCTTTCTTT	CASAPRDTPTEAFF	TRBV14	TRBJ1-1
TGTGCCAGCAGCTCCGGCCCAGGGCCCTACAATGAGCAGTTCTTC	CASSSGPGPYNEQFF	TRBV7-8	TRBJ2-1
TGCGCCAGCGGCCAGGGGTTAGGCACCGGGGAGCTGTTTTTT	CASGQGLGTGELFF	TRBV10-1	TRBJ2-2
TGTGCCAGCAGCTTAGAAATAAAATTTTTGGGACAGGGGACTGAAGCTTTCTTT	CASSLEIKFLGQGTEAFF	TRBV11-3	TRBJ1-1
TGTGCCAAGAAGGGGGCCGAGACAGTTCGAGGGGACACTGAAGCTTTCTTT	CAKKGAETVRGDTEAFF	TRBV7-9	TRBJ1-1
TGTGCCATCAGTTCCTGGGGTTCGAACACTGAAGCTTTCTTT	CAISSWGSNTEAFF	TRBV10-3	TRBJ1-1
TGCGCCAGCACACGAAGAGCCTACGAGCAGTACTTC	CASTRRAYEQYF	TRBV10-1	TRBJ2-7
TGTGCCCCCCCGGTTAGCTCCTACGAGCAGTACTTC	CAPPVSSYEQYF	TRBV3-1	TRBJ2-7
TGCAGTGCTAAGAGGATCTTGGTGGCTCAGCCCCAGCATTTT	CSAKRILVAQPQHF	TRBV20-1	TRBJ1-5
TGTGCCAGCAGCAACCGCGGGAGAAACCTGACGCAGTATTTT	CASSNRGRNLTQYF	TRBV7-2	TRBJ2-3
TGCGCCAGCAGCCAAGATAGGACAGGGATCTATGGCTACACCTTC	CASSQDRTGIYGYTF	TRBV4-3	TRBJ1-2
TGCGCCAGCAGCTTGCGACGGGGACAATTCACAGATACGCAGTATTTT	CASSLRRGQFTDTQYF	TRBV5-1	TRBJ2-3
TGTGCCAGCAGCCCGGTGGTAAGGACTAGCGGGATGGAGACCCAGTACTTC	CASSPVVRTSGMETQYF	TRBV7-9	TRBJ2-5
TGTGCCAGCAGCTATGTCGGGACAGGCCCCGCTAATGAAAAACTGTTTTTT	CASSYVGTGPANEKLFF	TRBV5-5	TRBJ1-4
TGTGCCAGCATAGGCTTAGGGAGGCCACTACAGGGCTACACCTTC	CASIGLGRPLQGYTF	TRBV27	TRBJ1-2
TGTGCCAGCTCACGTCTCCGGGGGGGGCAGTTCTTC	CASSRLRGGQFF	TRBV18	TRBJ2-1
TGTGCCAGCAGCCATCAAGGTCCGAACACCGGGGAGCTGTTTTTT	CASSHQGPNTGELFF	TRBV3-1	TRBJ2-2
TGTGCCAGCAGCCAAAACAGGAGCACAGATACGCAGTATTTT	CASSQNRSTDTQYF	TRBV14	TRBJ2-3
TGCGCCAGCAGGGGACTAGCGGAAGAGACCCAGTACTTC	CASRGLAEETQYF	TRBV10-2	TRBJ2-5
TGTGCCAGCTCACCAGCGGGGTGGACTAGCGGGTGCGAGCAGTTCTTC	CASSPAGWTSGCEQFF	TRBV18	TRBJ2-1
TGTGCCAGCAGGACAGGGGACACTGAAGCTTTCTTT	CASRTGDTEAFF	TRBV27	TRBJ1-1
TGCGCCAGCAACCGGCCTGGGGAGGCCCAGCATTTT	CASNRPGEAQHF	TRBV10-1	TRBJ1-5
TGTGCCAGCAGTGACTCGGTGTGTCACAGGGACTACGAGCAGTACTTC	CASSDSVCHRDYEQYF	TRBV6-4	TRBJ2-7
TGTGCCTGGATGGGACGACTTTCCAACACTGAAGCTTTCTTT	CAWMGRLSNTEAFF	TRBV30	TRBJ1-1
TGTGCCAGCAGCTTGGGGACGTTCCCTGGAAACACCATATATTTT	CASSLGTFPGNTIYF	TRBV5-4	TRBJ1-3
TGTGCCAGCAGTGATCCGAGACAGGGAACCAGATACGAGCAGTACTTC	CASSDPRQGTRYEQYF	TRBV6-1	TRBJ2-7
TGCAGTGCTAGGGACAGGGAAGAGACCCAGTACTTC	CSARDREETQYF	TRBV20-1	TRBJ2-5
TGTGCCACCAGTGATCTAGTGGGGGGCCAGGAGGACACAGATACGCAGTATTTT	CATSDLVGGQEDTDTQYF	TRBV24-1	TRBJ2-3
TGCGCCAGCAGATGTGACAGGGAAACCTACGAGCAGTACTTC	CASRCDRETYEQYF	TRBV10-1	TRBJ2-7
TGTGCCAGCAGCTTCGGGACCCCTAGGGTCTCTGGAAACACCATATATTTT	CASSFGTPRVSGNTIYF	TRBV7-3	TRBJ1-3
TGTGCCACCAGTACCGCGGACCCTAGTGTACGGCTCTCCTACGAGCAGTACTTC	CATSTADPSVRLSYEQYF	TRBV24-1	TRBJ2-7
TGTGCCAGCAGCCCTGACAGGGATGGAAGCAATCAGCCCCAGCATTTT	CASSPDRDGSNQPQHF	TRBV13	TRBJ1-5
TGTGCCAGCAACAATCAGGGGGGATGGGGTAATGAAAAACTGTTTTTT	CASNNQGGWGNEKLFF	TRBV7-3	TRBJ1-4
TGTGCCACCTGGACAGAAAACTGGGGGTCCTTCGAGCAGTACTTC	CATWTENWGSFEQYF	TRBV15	TRBJ2-7
TGTGCCAGCAGTTTGTCGATGGAAAGACAAGATAGCGGGCCGTGCTCCTACAATGAGCAGTTCTTC	CASSLSMERQDSGPCSYNEQFF	TRBV27	TRBJ2-1
TGTGCCAGCAGCAGGGGGGGCACAGATACGCAGTATTTT	CASSRGGTDTQYF	TRBV5-4	TRBJ2-3
TGCAGTGCGCTCAGCTATGGCTACACCTTC	CSALSYGYTF	TRBV20-1	TRBJ1-2
TGTGCCAGCACCCGCAGGGAGCCCGCTCCCACCGGGGAGCTGTTTTTT	CASTRREPAPTGELFF	TRBV11-1	TRBJ2-2
TGTGCCAGCAGCTTAGTCGCGGGGTGGTATCAGCCCCAGCATTTT	CASSLVAGWYQPQHF	TRBV7-4	TRBJ1-5
TGTGCCAGCAGCCCCCCCGGGGGGGCAATAAATGAGCAGTTCTTC	CASSPPGGAINEQFF	TRBV3-1	TRBJ2-1
TGTGCCTGGATCAGGGGAATCGGCTATGGCTACACCTTC	CAWIRGIGYGYTF	TRBV30	TRBJ1-2
TGTGCCAGCAAATGGGACAGGCCGTTGGACCCGTTCCCAGCTTTCTTT	CASKWDRPLDPFPAFF	TRBV7-8	TRBJ1-1
TGCGCCAGCAGCCAAGTCAGGAGTAACTATGGCTACACCTTC	CASSQVRSNYGYTF	TRBV4-3	TRBJ1-2
TGTGCCAGCAGCCCAGACAGGGATGGCTACACCTTC	CASSPDRDGYTF	TRBV4-2	TRBJ1-2
TGCAGTGCCGTGTCATCTAGGACAGGGGGGCAAGAGACCCAGTACTTC	CSAVSSRTGGQETQYF	TRBV20-1	TRBJ2-5
TGTGCCAGCAGTTTATCGGCCATAAGCCGCCAAGAGACCCAGTACTTC	CASSLSAISRQETQYF	TRBV28	TRBJ2-5
TGTGCCAGCCCCAGACCGGAAACAGGGGAGCCCACTGAAGCTTTCTTT	CASPRPETGEPTEAFF	TRBV27	TRBJ1-1
TGTGCCAGCAGCCAAGATAAAAGCTTCGACGAAACGAAACAGCCCCAGCATTTT	CASSQDKSFDETKQPQHF	TRBV14	TRBJ1-5
TGCGCCAGCACCCAGGGGGCGCAGCCCCAGCATTTT	CASTQGAQPQHF	TRBV10-1	TRBJ1-5
TGTGCCAGCAGCCCGGGACAGGGGGCCTCCTACGAGCAGTACTTC	CASSPGQGASYEQYF	TRBV12-3	TRBJ2-7
TGTGCCAGCAGCTACCCGTCGCCAAACTTATATAGCAATCAGCCCCAGCATTTT	CASSYPSPNLYSNQPQHF	TRBV7-3	TRBJ1-5
TGCGCCAGCAGCCAACTGTGGGGGGATGAAAAACTGTTTTTT	CASSQLWGDEKLFF	TRBV4-1	TRBJ1-4
TGTGCCAGCAGCCCTAATTCCGGGACAGTGATTGGCTACGAGCAGTACTTC	CASSPNSGTVIGYEQYF	TRBV13	TRBJ2-7
TGTGCCAGGGGGTTGTCAGATACGCAGTATTTT	CARGLSDTQYF	TRBV6-4	TRBJ2-3
TGCGCCAGCAGCGGTGCGGGACTAGCGGGTCCCGAAAATGAGCAGTTCTTC	CASSGAGLAGPENEQFF	TRBV5-1	TRBJ2-1
TGTGCCACCCGGGAAAATAGCAATCAGCCCCAGCATTTT	CATRENSNQPQHF	TRBV6-2	TRBJ1-5
TGCAGTGCTGTCATACATGAAAAACTGTTTTTT	CSAVIHEKLFF	TRBV20-1	TRBJ1-4
TGTGCCAGCAGTTACCCCCCCCACGGGCTAGCCAAAAACATTCAGTACTTC	CASSYPPHGLAKNIQYF	TRBV6-5	TRBJ2-4
TGTGCCACCGCCCATTCAGGGAGCTCTGGAAACACCATATATTTT	CATAHSGSSGNTIYF	TRBV12-4	TRBJ1-3
TGTGCCAGCTCACCACGTGGCGGGTTAGCAGAAACTGAAGCTTTCTTT	CASSPRGGLAETEAFF	TRBV18	TRBJ1-1
TGTCAGGCGGGACAGGGGGATACACCCTACGAGCAGTACTTC	CQAGQGDTPYEQYF	TRBV10-3	TRBJ2-7
TGTGCCTGGTCTAGACAGGGCCCGGACCGTGAAAAACTGTTTTTT	CAWSRQGPDREKLFF	TRBV30	TRBJ1-4
TGTGCCAGCACCTACCAATGGGACAGAGATGAAGCTTTCTTT	CASTYQWDRDEAFF	TRBV2	TRBJ1-1
TGTGCCAGCAGCCGGACAGGGTTGCGGAGCAATCAGCCCCAGCATTTT	CASSRTGLRSNQPQHF	TRBV2	TRBJ1-5
TGCAGCGTTGCGGCTGGAGGGGGTTCCTACAATGAGCAGTTCTTC	CSVAAGGGSYNEQFF	TRBV29-1	TRBJ2-1
TGTGCCAGCAGGCACGCTCCTGAGACCCAGTACTTC	CASRHAPETQYF	TRBV12-4	TRBJ2-5
TGTGCCACCAGTGATTCTCGGCTAGCGGCCTACGAGCAGTACTTC	CATSDSRLAAYEQYF	TRBV24-1	TRBJ2-7
TGTGCCAGCAGTGCGGGACTAGCGGGAAATCTAAGGACCGGGGAGCTGTTTTTT	CASSAGLAGNLRTGELFF	TRBV27	TRBJ2-2
TGTGCCAGCAGTCCTAGGTCCAATGGACAGGGAATTCTGTCGGGGGCTTTCTTT	CASSPRSNGQGILSGAFF	TRBV6-5	TRBJ1-1
TGTGCCAGCAGAACACAGGGGGCCGAGCAGTACTTC	CASRTQGAEQYF	TRBV6-8	TRBJ2-7
TGTGCCAGCAGCTGTAAAGTGACTAGGGAAGATGAGCAGTTCTTC	CASSCKVTREDEQFF	TRBV5-4	TRBJ2-1
TGTGCCACCAGTGAAGGGGAAGGAAAGTGGGTTAGGCAGCCCCAGCATTTT	CATSEGEGKWVRQPQHF	TRBV24-1	TRBJ1-5
TGTGCCAGCAGCTTGGAAGGGGACAGGGGAGGCCCTAGCAATCAGCCCCAGCATTTT	CASSLEGDRGGPSNQPQHF	TRBV5-6	TRBJ1-5
TGTGCCACCAGTAGGGGATGGGGCAATCAGCCCCAGCATTTT	CATSRGWGNQPQHF	TRBV24-1	TRBJ1-5
TGTGCCAGCAGCGGTCGCAGGAATAGCAATCAGCCCCAGCATTTT	CASSGRRNSNQPQHF	TRBV13	TRBJ1-5
TGCGCCAGCAGCTTACCGTGGGTGTCCCCAGGAGCGGACACTGAAGCTTTCTTT	CASSLPWVSPGADTEAFF	TRBV5-1	TRBJ1-1
TGTGCCACCAGTGAGAGACAGGCCTACAATGAGCAGTTCTTC	CATSERQAYNEQFF	TRBV24-1	TRBJ2-1
TGTGCCAGCAGCTTGGTCAATACTCTTGGAAACACCATATATTTT	CASSLVNTLGNTIYF	TRBV5-4	TRBJ1-3
TGTGCCCCCGGGACAAGATACGAGCAGTACTTC	CAPGTRYEQYF	TRBV30	TRBJ2-7
TGTGCCAGCAGCCAGGACGACAAAGGACAGGGGGCAGGTAGAGCCTACGAGCAGTACTTC	CASSQDDKGQGAGRAYEQYF	TRBV14	TRBJ2-7
TGTGCCGGACAGGGGCAAAGCTCCTACGAGCAGTACTTC	CAGQGQSSYEQYF	TRBV9	TRBJ2-7
TGTGCCAGCAGCCGGGGGCCGGGCACTGAAGCTTTCTTT	CASSRGPGTEAFF	TRBV7-3	TRBJ1-1
TGTGCCAGCAAACAGGGAGCGGAGACCCAGTACTTC	CASKQGAETQYF	TRBV6-5	TRBJ2-5
TGTGCCAGCAGCTGCTGGACAGGGTCCTACAATGAGCAGTTCTTC	CASSCWTGSYNEQFF	TRBV11-2	TRBJ2-1
TGTGCCAGCGAGGGACCGTGGGGGGTAATGAACACTGAAGCTTTCTTT	CASEGPWGVMNTEAFF	TRBV6-6	TRBJ1-1
TGTGCCATCACCCTTGCCTTGGACAGGGGGTCTTTCACAGATACGCAGTATTTT	CAITLALDRGSFTDTQYF	TRBV10-3	TRBJ2-3
TGCAGCGTTGTTCGCTTTACCACCTACGAGCAGTACTTC	CSVVRFTTYEQYF	TRBV29-1	TRBJ2-7
TGTGCCAGCAGCCAGAAACCGAGTGGGAACACTGAAGCTTTCTTT	CASSQKPSGNTEAFF	TRBV3-1	TRBJ1-1
TGTGCCAGCAGCCCCGGGGCGAACACTGAAGCTTTCTTT	CASSPGANTEAFF	TRBV7-3	TRBJ1-1
TGTGCCAGCAGCTTAGGAGGAGGGTCGGACTTCACTGAAGCTTTCTTT	CASSLGGGSDFTEAFF	TRBV11-2	TRBJ1-1
TGTGCCAGCAGTGAAAAGTTACCTTGCTCCGGACTAAAGAACAATGAGCAGTTCTTC	CASSEKLPCSGLKNNEQFF	TRBV2	TRBJ2-1
TGTGCCAGCAGTGACTGCAGGAATAATTCACCCCTCCACTTT	CASSDCRNNSPLHF	TRBV6-4	TRBJ1-6
TGTGCCATCAGTTGGCTGGTGGGGGGGGGAATCACCGGGGAGCTGTTTTTT	CAISWLVGGGITGELFF	TRBV10-3	TRBJ2-2
TGCAAACAGCGGGAGGAGCAGTTCTTC	CKQREEQFF	TRBV20-1	TRBJ2-1
TGTGCCAGCATCGCCAGGACAGAGCCACCAGCATACAATGAGCAGTTCTTC	CASIARTEPPAYNEQFF	TRBV6-5	TRBJ2-1
TGTGCCTGGAGTGTAAGACCCGTCGACCTTTATGAGCAGTTCTTC	CAWSVRPVDLYEQFF	TRBV30	TRBJ2-1
TGTGCCAAATATAATAGCGGGAGGCGCACAGATACGCAGTATTTT	CAKYNSGRRTDTQYF	TRBV10-3	TRBJ2-3
TGTGCCAGCAGCGTAGAAAACAGGCAGTTAACGAACACCGGGGAGCTGTTTTTT	CASSVENRQLTNTGELFF	TRBV9	TRBJ2-2
TGTGCCAGCAGTTACGAGACAGGGGGCAACTATGGCTACACCTTC	CASSYETGGNYGYTF	TRBV6-2	TRBJ1-2
TGTGCCAGCAGAAACCTCCTGGGACTAGCGCAAGAGACCCAGTACTTC	CASRNLLGLAQETQYF	TRBV28	TRBJ2-5
TGTGCCAGCAGTGGGGGCTCCGGTCTCAATCAGCCCCAGCATTTT	CASSGGSGLNQPQHF	TRBV27	TRBJ1-5
TGTGCCAGCAGGGGGAAGTTGAACACCGGGGAGCTGTTTTTT	CASRGKLNTGELFF	TRBV28	TRBJ2-2
TGTGCCAGCAGCCAAAGGGAGGGCCGCCGCCTCCATTCACCCCTCCACTTT	CASSQREGRRLHSPLHF	TRBV7-8	TRBJ1-6
TGCGCCAGCACGGAGTATAGCAATCAGCCCCAGCATTTT	CASTEYSNQPQHF	TRBV5-1	TRBJ1-5
TGTGCCAGCAGTCATTCTGCGAGCGGGAGCAGGAACACTGAAGCTTTCTTT	CASSHSASGSRNTEAFF	TRBV28	TRBJ1-1
TGTGCCAGCAGCTTGGACTATAGCGGCCTCAACGAGCAGTACTTC	CASSLDYSGLNEQYF	TRBV5-4	TRBJ2-7
TGTGCCAGCATCAATGGGGCCTCGCGCTATGGCTACACCTTC	CASINGASRYGYTF	TRBV6-5	TRBJ1-2
TGCGAGGGACACGGGATCAATCAGCCCCAGCATTTT	CEGHGINQPQHF	TRBV5-1	TRBJ1-5
TGTGCCAGCAGCGGAGGTACTGCGGACAGGGTTGGCTACACCTTC	CASSGGTADRVGYTF	TRBV7-8	TRBJ1-2
TGTGCCAGCAGGATCCGACGGGGTGGCTACACCTTC	CASRIRRGGYTF	TRBV6-6	TRBJ1-2
TGTGCCAGCAGCTTAGAAAGCAGAGTGGAGACCCAGTACTTC	CASSLESRVETQYF	TRBV7-2	TRBJ2-5
TGCAGTGGCCGGATAACGGTAAGCTATGGCTACACCTTC	CSGRITVSYGYTF	TRBV20-1	TRBJ1-2
TGTGCCAGCAAACTAGCGGGGGACTACGAGCAGTACTTC	CASKLAGDYEQYF	TRBV3-1	TRBJ2-7
TGTGCCAGCAGACTTTCGAACCTATCTAGCTATAATTCACCCCTCCACTTT	CASRLSNLSSYNSPLHF	TRBV7-9	TRBJ1-6
TGTGCCAGAGGCCAATTTCAGCCCCAGCATTTT	CARGQFQPQHF	TRBV6-1	TRBJ1-5
TGTGCCAGCAGTCGGCGCCGACTAGCGAACACCGGGGAGCTGTTTTTT	CASSRRRLANTGELFF	TRBV6-5	TRBJ2-2
TGTGCCAGTAAAGACGGGGACAGTTTCTATAATTCACCCCTCCACTTT	CASKDGDSFYNSPLHF	TRBV27	TRBJ1-6
TGCAGTGCATTAGGGGACAGGGAATTCCAAAATTCACCCCTCCACTTT	CSALGDREFQNSPLHF	TRBV20-1	TRBJ1-6
TGTGCCAGCAGCTTCCCAGCCGCACATGCGGTGGAGTCCTACGAGCAGTACTTC	CASSFPAAHAVESYEQYF	TRBV7-2	TRBJ2-7
TGCGCCAGCAGTGAGTCTCTACGAGGCTACGAGCAGTACTTC	CASSESLRGYEQYF	TRBV10-1	TRBJ2-7
TGTGCCTGGATTGAGGGAATGGGCGAGCAGTACTTC	CAWIEGMGEQYF	TRBV30	TRBJ2-7
TGCGCCAGCAGCAAGGGTCACAGGGGGTCGGAAAAACTGTTTTTT	CASSKGHRGSEKLFF	TRBV5-1	TRBJ1-4
TGTGCCAGCAGTCCCCACGACAGGGATGAGTATACGCAGTATTTT	CASSPHDRDEYTQYF	TRBV12-4	TRBJ2-3
TGTGCCAGCAGCTTTTCGACAGGGCGATGGATGGTCGAAAAACTGTTTTTT	CASSFSTGRWMVEKLFF	TRBV7-2	TRBJ1-4
TGTGCCAGCACCGAGGGGGGCCCAGAGCCATATGGCTACACCTTC	CASTEGGPEPYGYTF	TRBV7-4	TRBJ1-2
TGTGCCAGCAGCTTACAGGGGGCGCTTCGGGGACCGCCGAGGGGTGGCAATCAGCCCCAGCATTTT	CASSLQGALRGPPRGGNQPQHF	TRBV7-6	TRBJ1-5
TGTGCCAGCAGCCCACCGGGGGTAGAATACGAGCAGTACTTC	CASSPPGVEYEQYF	TRBV11-1	TRBJ2-7
TGTCCCTGGGGGGGGGGACAGATCGCCACAGATACGCAGTATTTT	CPWGGGQIATDTQYF	TRBV30	TRBJ2-3
TGTGCCAGCAGCGTGGGACAGGGCTATGGCTACACCTTC	CASSVGQGYGYTF	TRBV13	TRBJ1-2
TGTGCCAGCAGCGTATCGGGCTCCTACGAGCAGTACTTC	CASSVSGSYEQYF	TRBV7-9	TRBJ2-7
TGTGCGAAGGTCGAGTTTCAGGATCGCAATCAGCCCCAGCATTTT	CAKVEFQDRNQPQHF	TRBV27	TRBJ1-5
TGCGCCAGCAGCTTTGAAGGGACACTCAGCAATCAGCCCCAGCATTTT	CASSFEGTLSNQPQHF	TRBV5-1	TRBJ1-5
TGCAGTGCTCCCCAATCCGGGACAGGGGAGGGGGGTGAAAAACTGTTTTTT	CSAPQSGTGEGGEKLFF	TRBV20-1	TRBJ1-4
TGTGCCAGCTCACCTTTGAGAGCGACCGGGGAGCTGTTTTTT	CASSPLRATGELFF	TRBV18	TRBJ2-2
TGCAGTGCTAGAGATGAGGTTTTCTACAATGAGCAGTTCTTC	CSARDEVFYNEQFF	TRBV20-1	TRBJ2-1
TGTGCCAGCTCACCACCTGCAGCTTTCTTT	CASSPPAAFF	TRBV18	TRBJ1-1
TGCACCGGAGAAGTAGACAGGGAAGCTTTCTTT	CTGEVDREAFF	TRBV20-1	TRBJ1-1
TGTGCCAGCTCCCGGACCACTGAAGCTTTCTTT	CASSRTTEAFF	TRBV18	TRBJ1-1
TGTGCCAGCAGCCCTGTCAGGGCCGCGTTACCCTACGAGCAGTACTTC	CASSPVRAALPYEQYF	TRBV7-4	TRBJ2-7
TGTGCCAGCAGCACCAGGACAGGCAAGGGAAGACGCAATCAGCCCCAGCATTTT	CASSTRTGKGRRNQPQHF	TRBV11-2	TRBJ1-5
TGCAGTGCTAGAGATTTAGGCGGGACGGGACGGCATTTT	CSARDLGGTGRHF	TRBV20-1	TRBJ1-5
TGTGCCAGCAAGGACCTGACTAGCGGGGGAGACAATGAGCAGTTCTTC	CASKDLTSGGDNEQFF	TRBV27	TRBJ2-1
TGTGCCAGCAGTTTATGTCAAGAGATGAACACAGATACGCAGTATTTT	CASSLCQEMNTDTQYF	TRBV28	TRBJ2-3
TGTGCCAGCAAGCCCAATCAGGGGGAGGTCTACGAGCAGTACTTC	CASKPNQGEVYEQYF	TRBV6-3	TRBJ2-7
TGCAGCGTTGAAGTCAAGCGTGGTCACTCCTACAATGAGCAGTTCTTC	CSVEVKRGHSYNEQFF	TRBV29-1	TRBJ2-1
TGTGCCAGCAGCCAACCCTCCCAGGGGGCGGACAGTTTCTACGAGCAGTACTTC	CASSQPSQGADSFYEQYF	TRBV4-2	TRBJ2-7
TGTGCCACCAGCAGGATGGCTGTCGGGACAGGGAGGGCCTATAATTCACCCCTCCACTTT	CATSRMAVGTGRAYNSPLHF	TRBV15	TRBJ1-6
TGTGCCACCAGGCCTAGGTGTAAGGGGAACTATGGCTACACCTTC	CATRPRCKGNYGYTF	TRBV24-1	TRBJ1-2
TGTGCCAGCAGCCCCGCTCCTCACCGGGAGGCTTCCAAAAACATTCAGTACTTC	CASSPAPHREASKNIQYF	TRBV6-5	TRBJ2-4
TGTGCCAGCAGCTTAGGACCTAGCACAGATACGCAGTATTTT	CASSLGPSTDTQYF	TRBV7-3	TRBJ2-3
TGTGCCAGCAGCCACCGCTCCTACGAGCAGTACTTC	CASSHRSYEQYF	TRBV5-6	TRBJ2-7
TGCGCCAACCAAACCCCAGGGCAACAGCCCCAGCATTTT	CANQTPGQQPQHF	TRBV10-1	TRBJ1-5
TGCAGTGCTAGAGACGGATGGGGGGCGAGCAGCGAGCAGTACTTC	CSARDGWGASSEQYF	TRBV20-1	TRBJ2-7
TGTGCCAGCAGCTGGACCTTCCCTGCCCCCTGCGAAAAACTGTTTTTT	CASSWTFPAPCEKLFF	TRBV5-4	TRBJ1-4
TGTGCCTGGAACCTAGCCGAGGACCCCAGGTCCGGGGAGCTGTTTTTT	CAWNLAEDPRSGELFF	TRBV30	TRBJ2-2
TGTGCCAGCAGAGAGGAGGGCACTGAAGCTTTCTTT	CASREEGTEAFF	TRBV6-4	TRBJ1-1
TGTGCCAGCAGTGAACCCAACCACAGGGGCTGGGAAAAACTGTTTTTT	CASSEPNHRGWEKLFF	TRBV6-1	TRBJ1-4
TGCGCCAGCAGCTTGGCAGAGGGGGCTAATTATTATAGCAATCAGCCCCAGCATTTT	CASSLAEGANYYSNQPQHF	TRBV5-1	TRBJ1-5
TGTGCCAGCAGATTCCGGGACAAACCAGGGGCTTTCTTT	CASRFRDKPGAFF	TRBV6-8	TRBJ1-1
TGTGCCAGCAGGGGGCGCGGCGGTTACGAGCAGTACTTC	CASRGRGGYEQYF	TRBV6-3	TRBJ2-7
TGTGCCAGCAGCACCCCGGGGGGGGCAGACTACGAGCAGTACTTC	CASSTPGGADYEQYF	TRBV7-3	TRBJ2-7
TGCGCCATGGCTAGCGATCCCGGGGAGCTGTTTTTT	CAMASDPGELFF	TRBV5-1	TRBJ2-2
TGTGCCAGCAGTGGGCAGGACGACTCTCAGCCCCAGCATTTT	CASSGQDDSQPQHF	TRBV6-1	TRBJ1-5
TGTGCCAGCAGCTTACGACCCCTCCTCGGACAGGGGGCTGGCTATAGCAATCAGCCCCAGCATTTT	CASSLRPLLGQGAGYSNQPQHF	TRBV7-9	TRBJ1-5
TGTGCCAGCTCCCATCGGGACAGAAGCCTACCTGAGACCCAGTACTTC	CASSHRDRSLPETQYF	TRBV27	TRBJ2-5
TGTGCCAGCAGTTATAAAAACAATGAGCAGTTCTTC	CASSYKNNEQFF	TRBV6-5	TRBJ2-1
TGTGCCAGCAGTGAATTATGGAGCTACGAGCAGTACTTC	CASSELWSYEQYF	TRBV25-1	TRBJ2-7
TGTGCTCAACCGGGACAGGGGGCACCTAATTCACCCCTCCACTTT	CAQPGQGAPNSPLHF	TRBV24-1	TRBJ1-6
TGTGCCAGCAGCTTAAAAGGCTTGTGCCCGACAGGGAAGGGCCCTGGCTACACCTTC	CASSLKGLCPTGKGPGYTF	TRBV7-3	TRBJ1-2
TGTGCCAGCAGCCTCTGGCGGGGGGCCGTAGAGACCCAGTACTTC	CASSLWRGAVETQYF	TRBV5-5	TRBJ2-5
TGTGCCAGCAGGAGGGTGGTGGACGAGCAGTACTTC	CASRRVVDEQYF	TRBV7-3	TRBJ2-7
TGTGCCAGCAGCCTGGGGGGTTTGCCGCGGAGCACTGAAGCTTTCTTT	CASSLGGLPRSTEAFF	TRBV13	TRBJ1-1
TGTGCCAGCAGCTTAGGCTCCTGCACAGATACGCAGTATTTT	CASSLGSCTDTQYF	TRBV7-7	TRBJ2-3
TGTGCCAGCAGTTTAAGGGGGAAGGACCACCGGGACAGGTTCTCCTACGAGCAGTACTTC	CASSLRGKDHRDRFSYEQYF	TRBV27	TRBJ2-7
TGTGCCAGCAGCCGGGTCGACAGGGCTAACACCATATATTTT	CASSRVDRANTIYF	TRBV11-3	TRBJ1-3
TGTGCCAGCAGCTTTCCAACGGGGGGCCTAAAGGAGCAGTTCTTC	CASSFPTGGLKEQFF	TRBV7-8	TRBJ2-1
TGTGCCAGCAGCGCCCAACTAGCGGGAGAAGGCAATGAGCAGTTCTTC	CASSAQLAGEGNEQFF	TRBV5-4	TRBJ2-1
TGTGCCAGCAGCCAAGCCGGGACAGGGTACTACGAGCAGTACTTC	CASSQAGTGYYEQYF	TRBV4-2	TRBJ2-7
TGTGCCAGCCTAGCGGTGCGTAATGAGCAGTTCTTC	CASLAVRNEQFF	TRBV19	TRBJ2-1
TGTGCCAGCAGTGATTCTTCGCACAGGGGTGAAGCTTTCTTT	CASSDSSHRGEAFF	TRBV27	TRBJ1-1
TGTGCCAGCAGTTTTATGAAGTGGACAGGGAATCAGCCCCAGCATTTT	CASSFMKWTGNQPQHF	TRBV12-3	TRBJ1-5
TGTGCCAGCAGTCAAGGGCTAGCGGGGATTGAGGCAGATACGCAGTATTTT	CASSQGLAGIEADTQYF	TRBV6-1	TRBJ2-3
TGTGCCAGCAGTGAAGAGGAAAGGAGTTGGAACACCGGGGAGCTGTTTTTT	CASSEEERSWNTGELFF	TRBV6-1	TRBJ2-2
TGTGCCAGCAGCTTAATCGACCGGGACAGGGGTTCCTACGAGCAGTACTTC	CASSLIDRDRGSYEQYF	TRBV7-6	TRBJ2-7
TGTGCCAGCAGCTTAGGGTTCAGTAGCTACGAGCAGTACTTC	CASSLGFSSYEQYF	TRBV7-8	TRBJ2-7
TGTGCCAGCAAACAGGGGCTTGATGAGCAGTTCTTC	CASKQGLDEQFF	TRBV9	TRBJ2-1
TGTGCCAGAGCGGTGATACAGTATCAGCCCCAGCATTTT	CARAVIQYQPQHF	TRBV28	TRBJ1-5
TGTGCCAGCAGTTACTCGTCACAGGGCAGAGATGGCTACGAGCAGTACTTC	CASSYSSQGRDGYEQYF	TRBV6-5	TRBJ2-7
TGCGCCATAAGGAAGCCCCGGGGGGGGACCACCTGGAGGCACAATGAGCAGTTCTTC	CAIRKPRGGTTWRHNEQFF	TRBV5-1	TRBJ2-1
TGTGCCAGCAGCGAACAGAACGAGACCCAGTACTTC	CASSEQNETQYF	TRBV9	TRBJ2-5
TGTGCCAGCACGAACAGCCCAGATTCACCCCTCCACTTT	CASTNSPDSPLHF	TRBV6-6	TRBJ1-6
TGTGCCAGCAGTGGCCCTGGGACTAGCGTTGCGTACGAGCAGTACTTC	CASSGPGTSVAYEQYF	TRBV12-3	TRBJ2-7
TGTGCCAGCAGAACAGGGCGCTACGAGCAGTACTTC	CASRTGRYEQYF	TRBV6-2	TRBJ2-7
TGTGCCAGCAGTGACCCAGGCCCCGGCACAGATACGCAGTATTTT	CASSDPGPGTDTQYF	TRBV2	TRBJ2-3
TGTGCCATCAGTGAGAGGGACAGCGGAAAACTGTTTTTT	CAISERDSGKLFF	TRBV10-3	TRBJ1-4
TGTGCAAACGGGACTTCCGCGGGCACAGATACGCAGTATTTT	CANGTSAGTDTQYF	TRBV7-2	TRBJ2-3
TGTGCCAGCAGCTTGTCCCGGGGCGGGGGAGACTCCTACGAGCAGTACTTC	CASSLSRGGGDSYEQYF	TRBV5-6	TRBJ2-7
TGTGCCAGCAGTTACGTGGACAGATGGGAGCTGTTTTTT	CASSYVDRWELFF	TRBV6-6	TRBJ2-2
TGTGCCAGCTCAGCGGGAGACGAGCAGTACTTC	CASSAGDEQYF	TRBV28	TRBJ2-7
TGCGCCAGCAGCCAAGTTTCGGGACAGAACACCGGGGAGCTGTTTTTT	CASSQVSGQNTGELFF	TRBV4-1	TRBJ2-2
TGTGCCACCAGCAGACCAGCCGACGGTAAGACCCAGTACTTC	CATSRPADGKTQYF	TRBV15	TRBJ2-5
TGTGCCAGCAGTGAGTTACAGAAAAACACCATATATTTT	CASSELQKNTIYF	TRBV6-1	TRBJ1-3
TGTGCCAGCAGTCCATCCGCCGGGGGGGCCTGCAACTCCTACGAGCAGTACTTC	CASSPSAGGACNSYEQYF	TRBV2	TRBJ2-7
TGTGCCAGCACGAAGAGGGTAGATAAAGAGACCCAGTACTTC	CASTKRVDKETQYF	TRBV6-5	TRBJ2-5
TGCGCCAGCAGGGTAATGTCGACTAGCGGGATCAGGTTTATTGAGACCCAGTACTTC	CASRVMSTSGIRFIETQYF	TRBV10-1	TRBJ2-5
TGCAGTGCTAGAGACGGCTCGGAGGGGGGCTCCTACGAGCAGTACTTC	CSARDGSEGGSYEQYF	TRBV20-1	TRBJ2-7
TGTGCCAGCAGTCCACCACTAGCGGGAGGGCGCACAGATACGCAGTATTTT	CASSPPLAGGRTDTQYF	TRBV12-3	TRBJ2-3
TGTGCCAGCAGCCAAGATAAGTCCGATTCCGGGACAGGGGGCACCGGGGAGCTGTTTTTT	CASSQDKSDSGTGGTGELFF	TRBV3-1	TRBJ2-2
TGTGCCAGCAGCGGACGACAGGGTCGAGGGGGGGAGCTGTTTTTT	CASSGRQGRGGELFF	TRBV7-3	TRBJ2-2
TGTGCCGGTCCGGGGGCCCACACAGATACGCAGTATTTT	CAGPGAHTDTQYF	TRBV25-1	TRBJ2-3
TGCGCCAGCAGCCAAGACAAGATACACAGTTGCAATGAGCAGTTCTTC	CASSQDKIHSCNEQFF	TRBV4-1	TRBJ2-1
TGTGCCAGCAGGAGGAACGGCGGACGGCGTACTGAAGCTTTCTTT	CASRRNGGRRTEAFF	TRBV6-5	TRBJ1-1
TGTGCCAGCAGCACCAGGGCCGTCGCCGATCAGCCCCAGCATTTT	CASSTRAVADQPQHF	TRBV27	TRBJ1-5
TGTGCCAGCAGCATCACTAGCGGGAGGGCGTTGAATCAGCCCCAGCATTTT	CASSITSGRALNQPQHF	TRBV7-6	TRBJ1-5
TGTGCCATGTCAAGATGGGACAGTGGCACTGAAGCTTTCTTT	CAMSRWDSGTEAFF	TRBV18	TRBJ1-1
TGTGCCAGCAGTTGGCCGGACAGGGAAAACTATGGCTACACCTTC	CASSWPDRENYGYTF	TRBV6-5	TRBJ1-2
TGTGCCAGCAGCTTGGTTTCCAGGGGCCAGTCACCCCTCCACTTT	CASSLVSRGQSPLHF	TRBV5-6	TRBJ1-6
TGTGCCAGAAGGGGGACCGGCCTGGGCTACACCTTC	CARRGTGLGYTF	TRBV28	TRBJ1-2
TGTGCCAGCAGCTTATCACGACGCGGGAGAAGATTCTACGAGCAGTACTTC	CASSLSRRGRRFYEQYF	TRBV7-8	TRBJ2-7
TGTGCCAGCAGCCAAGATGCACGGGGGGGCCGGGAGCAGTACTTC	CASSQDARGGREQYF	TRBV3-1	TRBJ2-7
TGCAGTGCGCCTCTAGCGGGGCGGGAGACCCAGTACTTC	CSAPLAGRETQYF	TRBV20-1	TRBJ2-5
TGTGCCAGCAGCGTAGCTAATATAAAGGAGGCCTACGAGCAGTACTTC	CASSVANIKEAYEQYF	TRBV9	TRBJ2-7
TGTGCCAGCAGCGTAGTTCCCAGGGATCATCAGCCCCAGCATTTT	CASSVVPRDHQPQHF	TRBV9	TRBJ1-5
TGTGCTAGTGGTTTGGTCAGGAGGCCTGAGTCCCGGGAAGCTTTCTTT	CASGLVRRPESREAFF	TRBV12-5	TRBJ1-1
TGTGCCAGCAGTTTTGACAGGGCGGGAACTGAAGCTTTCTTT	CASSFDRAGTEAFF	TRBV6-5	TRBJ1-1
TGTGCCAGCAGCAGGGGGGCGCAAAATCGTTATAGCAATCAGCCCCAGCATTTT	CASSRGAQNRYSNQPQHF	TRBV6-4	TRBJ1-5
TGTGCCAGCAGCCCAAGACTAGCGGGGCATCCCGGCTCCTACGAGCAGTACTTC	CASSPRLAGHPGSYEQYF	TRBV7-9	TRBJ2-7
TGTGCCAGCAGAGGGAGTCAGGGGACGGATTCCGGTAGCAATCAGCCCCAGCATTTT	CASRGSQGTDSGSNQPQHF	TRBV28	TRBJ1-5
TGTGCCAGCATGGCTAGCGGGGACTACGAGCAGTACTTC	CASMASGDYEQYF	TRBV7-4	TRBJ2-7
TGTGCCAGGGGGCCAAGGGAGGGACATGGACCCGGAAACACCATATATTTT	CARGPREGHGPGNTIYF	TRBV9	TRBJ1-3
TGTGCCAGCAGTCGCACGAACACTGAAGCTTTCTTT	CASSRTNTEAFF	TRBV6-1	TRBJ1-1
TGTGCCAGCAGCGCACACGAATCCAATGAGCAGTTCTTC	CASSAHESNEQFF	TRBV7-6	TRBJ2-1
TGTGCCAGCAGTATGTGGGAGTTTTTAGCCAAAAACATTCAGTACTTC	CASSMWEFLAKNIQYF	TRBV2	TRBJ2-4
TGCGCCAGCAGCCAAGAGCCCTTCGGGGATAATGAAAAACTGTTTTTT	CASSQEPFGDNEKLFF	TRBV4-1	TRBJ1-4
TGTGCCAGCAGAGCCGGACCTAATGGCTACACCTTC	CASRAGPNGYTF	TRBV28	TRBJ1-2
TGCGCCAGCAGCTTACGTAGAGGATATCACTGCTACGAGCAGTACTTC	CASSLRRGYHCYEQYF	TRBV5-1	TRBJ2-7
TGTGCCTGGAGTCCCACCGGGCCCGCTCCACTTGGCTACACTGAAGCTTTCTTT	CAWSPTGPAPLGYTEAFF	TRBV30	TRBJ1-1
TGTGCCAGCAGCTTACTCGGACAGCCGGATGGCTACACCTTC	CASSLLGQPDGYTF	TRBV7-9	TRBJ1-2
TGTGCCAGCCCACCAGGGTTCAACACTGAAGCTTTCTTT	CASPPGFNTEAFF	TRBV9	TRBJ1-1
TGTGCCAGCAGCGGGGGGGGGCATACGCAGTATTTT	CASSGGGHTQYF	TRBV13	TRBJ2-3
TGTGCCTGGGATACTACTGAGCAGTTCTTC	CAWDTTEQFF	TRBV30	TRBJ2-1
TGTGCCAGCAGCTTAGCGGGGAAGCAGTCAGAGCAGTTCTTC	CASSLAGKQSEQFF	TRBV7-2	TRBJ2-1
TGTGCCAGCAGCCGGTCAAGATCTCGGAACACTGAAGCTTTCTTT	CASSRSRSRNTEAFF	TRBV3-1	TRBJ1-1
TGTGCCAGCAGCAGGCTTGGGAGGCCCCCGTTCCCCTCGGGCACAGATACGCAGTATTTT	CASSRLGRPPFPSGTDTQYF	TRBV2	TRBJ2-3
TGTGCCAGCAGCTTACTAGGAAACTCCTACAATGAGCAGTTCTTC	CASSLLGNSYNEQFF	TRBV7-3	TRBJ2-1
TGTGCCAGTAGTATCTTGATCGAAGAGGGCTACACCTTC	CASSILIEEGYTF	TRBV19	TRBJ1-2
TGTGCCAGTAGTATAGCAGGGGGGGTAACACCGGGCTATGGCTACACCTTC	CASSIAGGVTPGYGYTF	TRBV19	TRBJ1-2
TGCGCCAGCAGCTTGGCAAAGTTTCCCGGGACTAGCGGGAGTCGCACAGATACGCAGTATTTT	CASSLAKFPGTSGSRTDTQYF	TRBV5-1	TRBJ2-3
TGCAGTGCCCTAAGGGACAGAGCTGAAGCTTTCTTT	CSALRDRAEAFF	TRBV20-1	TRBJ1-1
TGTGCCAGCAGCAGGACTTCCCTAGCGGGCCCAGTCGAGACCCAGTACTTC	CASSRTSLAGPVETQYF	TRBV7-2	TRBJ2-5
TGCGCCAGCAGTGACACTCGACGGGCAACAGATACGCAGTATTTT	CASSDTRRATDTQYF	TRBV10-1	TRBJ2-3
TGTGCCAGCAGTGACCTTCTCACGGGAGGGATTAGTCCGGCAGATACGCAGTATTTT	CASSDLLTGGISPADTQYF	TRBV6-4	TRBJ2-3
TGTGCCAGCAGCACCACTCCAGACTACGAGCAGTACTTC	CASSTTPDYEQYF	TRBV7-4	TRBJ2-7
TGCAGTGCTAGATTAAAGGGAGATAGTCAGTCCGGGGAGCTGTTTTTT	CSARLKGDSQSGELFF	TRBV20-1	TRBJ2-2
TGCGCCAGCAGTGAGTCGCAGGGGTTGACCTACGAGCAGTACTTC	CASSESQGLTYEQYF	TRBV10-1	TRBJ2-7
TGCAGCGTTGAGGGGGAGGACGAGCAGTACTTC	CSVEGEDEQYF	TRBV29-1	TRBJ2-7
TGCGCCAGCAGCCAAGAGGCCGGGACACGGTATAACGAGCAGTACTTC	CASSQEAGTRYNEQYF	TRBV4-1	TRBJ2-7
TGCGCCAATAGTGAGGAGGGCACAGATACGCAGTATTTT	CANSEEGTDTQYF	TRBV5-1	TRBJ2-3
TGTGCCAGCAGTTTTTCGGCCGGACAGGGGGCTGTGGCAACTAATGAAAAACTGTTTTTT	CASSFSAGQGAVATNEKLFF	TRBV12-3	TRBJ1-4
TGTGCCACCGAGCAAGGTCGGGACAGTCGGTGCGACGAGCAGTACTTC	CATEQGRDSRCDEQYF	TRBV24-1	TRBJ2-7
TGCAGTGCTAGAGAAAAGACAGATCCCTACGAGCAGTACTTC	CSAREKTDPYEQYF	TRBV20-1	TRBJ2-7
TGTGCCAGCAGCCATGGGTTTGTTGAGCAGTTCTTC	CASSHGFVEQFF	TRBV14	TRBJ2-1
TGTGCCAGTAGTAGAGAAGGGGGGAGGGAATACAATGAGCAGTTCTTC	CASSREGGREYNEQFF	TRBV19	TRBJ2-1
TGTGCCAGCACCAGGCCGGGCAATCAGCCCCAGCATTTT	CASTRPGNQPQHF	TRBV6-4	TRBJ1-5
TGTGCCAGCAGCTGGGGGCGGTCTTTCTTT	CASSWGRSFF	TRBV7-9	TRBJ1-1
TGCGCCAGACCGACAAGGGGCGCTCGGACGAGGGGGGGCGAGTTAACGACCACCTCCTACGAGCAGTACTTC	CARPTRGARTRGGELTTTSYEQYF	TRBV10-1	TRBJ2-7
TGTGCCAGCAGTGAATTAAGGTCTGACAGGGGGCGTACCTCCTACGAGCAGTACTTC	CASSELRSDRGRTSYEQYF	TRBV6-1	TRBJ2-7
TGTGCCAGCAGCTGGGGTTTTCGACCCTACGAGCAGTACTTC	CASSWGFRPYEQYF	TRBV11-3	TRBJ2-7
TGTGCCAGCAGCCCGACAGGGCGCACAGATACGCAGTATTTT	CASSPTGRTDTQYF	TRBV6-2	TRBJ2-3
TGTGCCAGCAGCTTAGCCGGGGACAGGTTGAACACTGAAGCTTTCTTT	CASSLAGDRLNTEAFF	TRBV7-2	TRBJ1-1
TGTGCCAGCAGCTGGGACAGGGGGCAGAGGGCCGGGGAGCTGTTTTTT	CASSWDRGQRAGELFF	TRBV7-4	TRBJ2-2
TGTGCCAGCGTGGGGCGGGTTTCCTACGAGCAGTACTTC	CASVGRVSYEQYF	TRBV27	TRBJ2-7
TGTGCCAGCAGCTTAGGACTTCCTGGAAACACCATATATTTT	CASSLGLPGNTIYF	TRBV11-2	TRBJ1-3
TGCGCCAGCTGGGTCAGGGGGAGGGGGTACGAGCAGTACTTC	CASWVRGRGYEQYF	TRBV5-1	TRBJ2-7
TGTGCCAGTAGTATCTGGGAATCCCATGGACAGGGGGGTTACGAGCAGTACTTC	CASSIWESHGQGGYEQYF	TRBV19	TRBJ2-7
TGTGCCAGCAGTTATTGTCCGAAATCTGGAAACACCATATATTTT	CASSYCPKSGNTIYF	TRBV6-4	TRBJ1-3
TGTGCCAGCAGCCTAGGGGCATTAAGTAATGAAAAACTGTTTTTT	CASSLGALSNEKLFF	TRBV7-9	TRBJ1-4
TGTGCCACTGGCCCCCCACAGGGGGGCGGGGAGCTGTTTTTT	CATGPPQGGGELFF	TRBV24-1	TRBJ2-2
TGTGCCAGCAGCCCCGAGGAACGTTGGAGAGAGACCCAGTACTTC	CASSPEERWRETQYF	TRBV5-6	TRBJ2-5
TGTGCCAGCAGCCGGGGGGGGAATTCACCCCTCCACTTT	CASSRGGNSPLHF	TRBV5-6	TRBJ1-6
TGTGCCAGCAGCATTTATGGCTCCTACGAGCAGTACTTC	CASSIYGSYEQYF	TRBV5-5	TRBJ2-7
TGTGCCAGCAGCCAGGAAGGTACTGAGGGTGGCTACACCTTC	CASSQEGTEGGYTF	TRBV13	TRBJ1-2
TGTGCCAGCAGCTCCCTAAGAAACGAGCAGTACTTC	CASSSLRNEQYF	TRBV7-3	TRBJ2-7
TGCGCCATAGTTTTGCAGGACAGGGAGTTTAACGAGCAGTACTTC	CAIVLQDREFNEQYF	TRBV5-1	TRBJ2-7
TGTGCCAGCAGCGGGGCTGGTAGCACAGATACGCAGTATTTT	CASSGAGSTDTQYF	TRBV9	TRBJ2-3
TGTGCCAGTAGTATGAGTGCTAGCGGGGGGGCCAGGTACAATGAGCAGTTCTTC	CASSMSASGGARYNEQFF	TRBV19	TRBJ2-1
TGTGCCAGCAGGTGGGGGTGTCTGAACACTGAAGCTTTCTTT	CASRWGCLNTEAFF	TRBV6-3	TRBJ1-1
TGCGCCAGCGCCGGTCGAGAGCGGGAGCTGAATTCACCCCTCCACTTT	CASAGRERELNSPLHF	TRBV5-1	TRBJ1-6
TGTGCCAGCAGCATGCGGGAGATTTTAGGGAATGAGCAGTTCTTC	CASSMREILGNEQFF	TRBV5-6	TRBJ2-1
TGCAGTGCTAGTCTGACTTACCGGGGCCCGAGAAACACCATATATTTT	CSASLTYRGPRNTIYF	TRBV20-1	TRBJ1-3
TGTGCCAGCAGCCTAATCTGTAGGGGAGGGCGAATTCACGAGCAGTACTTC	CASSLICRGGRIHEQYF	TRBV14	TRBJ2-7
TGTGCCAGCAGCCAAGAACAGGGGCTGTCCTACGAGCAGTACTTC	CASSQEQGLSYEQYF	TRBV14	TRBJ2-7
TGCAGTGCTAGAGCAGGCCCAGACAGGGCAATAGCCAAAAACATTCAGTACTTC	CSARAGPDRAIAKNIQYF	TRBV20-1	TRBJ2-4
TGTGCCAGCAGCCATGAAAGGACTAGCGGGAGGGCCTACGAGCAGTACTTC	CASSHERTSGRAYEQYF	TRBV5-6	TRBJ2-7
TGCAGTGCTAACAGGGGGAGAGAAGAGACCCAGTACTTC	CSANRGREETQYF	TRBV20-1	TRBJ2-5
TGCGCCAGGGCCATTCAAAGAGCAGGGACCCCATACGAGCAGTACTTC	CARAIQRAGTPYEQYF	TRBV10-1	TRBJ2-7
TGCAGTGCTAGAGTTGACGTCACTAGCACAGATACGCAGTATTTT	CSARVDVTSTDTQYF	TRBV20-1	TRBJ2-3
TGTGCCAGCAGCTTATTGGGGGGGCCTTACTCCTACGAGCAGTACTTC	CASSLLGGPYSYEQYF	TRBV5-4	TRBJ2-7
TGTGCCAGCAGCTTAAGGACAGGGGGAAATGGCTACACCTTC	CASSLRTGGNGYTF	TRBV7-7	TRBJ1-2
TGTGCCATCAGTGAGTCCAAACAGAAGCGCCCTCCTGGGGCCAACGTCCTGACTTTC	CAISESKQKRPPGANVLTF	TRBV10-3	TRBJ2-6
TGTGCCAGCAGCGGAAAGGGGGCTTGGTCGGAAGAGACCCAGTACTTC	CASSGKGAWSEETQYF	TRBV5-6	TRBJ2-5
TGTGCCAGCAGCGACCTAGAAACCTGCCTAGATACGCAGTATTTT	CASSDLETCLDTQYF	TRBV13	TRBJ2-3
TGTGCCAGCAGCCGGGGGGACGGGAGCTCCTACGAGCAGTACTTC	CASSRGDGSSYEQYF	TRBV13	TRBJ2-7
TGTGCCAGCGTAAGGGCAGAATCGAAGTACGAGCAGTACTTC	CASVRAESKYEQYF	TRBV27	TRBJ2-7
TGTGCTAGCAGCACCCTACCCCCGCGGGAGCTCTCTGAAGCTTTCTTT	CASSTLPPRELSEAFF	TRBV7-7	TRBJ1-1
TGTGCCAGCCTGGCTCCACAGTCGACAGATACGCAGTATTTT	CASLAPQSTDTQYF	TRBV5-8	TRBJ2-3
TGCGCCAGCAGCTCTTACGGGGCAAGTTACCAGAATGAAAAACTGTTTTTT	CASSSYGASYQNEKLFF	TRBV5-1	TRBJ1-4
TGCGCCAGCAGAACAGCGGGGACAGGGATGGGTAGAGGAGACTGTGAGCAGTTCTTC	CASRTAGTGMGRGDCEQFF	TRBV5-1	TRBJ2-1
TGCAGTGCCCCTAGCGGGATTACTGGCTACACCTTC	CSAPSGITGYTF	TRBV20-1	TRBJ1-2
TGTGCCAGCAGCTGGGGTTATGGGAACACCGGGGAGCTGTTTTTT	CASSWGYGNTGELFF	TRBV28	TRBJ2-2
TGTGCCAGCACCGAAGGACTAGCGGGGCCCGACCGATCCTACGAGCAGTACTTC	CASTEGLAGPDRSYEQYF	TRBV7-3	TRBJ2-7
TGTGCCACCAGCAGTCAGGGGGGGGAAGGCGAGCAGTACTTC	CATSSQGGEGEQYF	TRBV15	TRBJ2-7
TGTGCCAGTAGTAAAGACCTGCGACAGGGGCCTGAGACCCAGTACTTC	CASSKDLRQGPETQYF	TRBV19	TRBJ2-5
TGTGCCATCAGGACGAATCGGACAGGGGGCAACTTCTACAATGAGCAGTTCTTC	CAIRTNRTGGNFYNEQFF	TRBV10-3	TRBJ2-1
TGTGCCAGCAGCGCGCGGGATCCAGAGACCCAGTACTTC	CASSARDPETQYF	TRBV13	TRBJ2-5
TGTGCCAGCAAACAGGGGGCACTGGCCTACGAGCAGTACTTC	CASKQGALAYEQYF	TRBV6-5	TRBJ2-7
TGCAGTGCAACGAGGACTACTCACTCCTACAATGAGCAGTTCTTC	CSATRTTHSYNEQFF	TRBV20-1	TRBJ2-1
TGTGCCTGGACTCTGGGGGGGCCCCGAGGCTACGAGCAGTACTTC	CAWTLGGPRGYEQYF	TRBV30	TRBJ2-7
TGCAGTGCCCCTACCCAGGGCCCGGGGGACGAGCAGTACTTC	CSAPTQGPGDEQYF	TRBV20-1	TRBJ2-7
TGTGCAGACCAACGGGGACAGGGGTATCAGCCCCAGCATTTT	CADQRGQGYQPQHF	TRBV6-5	TRBJ1-5
TGTGCCAGCAGGGACGCCTACGAGCAGTACTTC	CASRDAYEQYF	TRBV6-2	TRBJ2-7
TGCGTGGGGAGGCAGGAGTTAACCCGCTCCTACGAGCAGTACTTC	CVGRQELTRSYEQYF	TRBV10-1	TRBJ2-7
TGTGCCAGCACGTGCTCCCCCGGGACTAGAGAGGGGACCGGGGAGCTGTTTTTT	CASTCSPGTREGTGELFF	TRBV27	TRBJ2-2
TGTGCCAGCAGCTTCTACAGGCGGGGGTACGAGCAGTACTTC	CASSFYRRGYEQYF	TRBV7-3	TRBJ2-7
TGCGCCAGCAGCCAAGATAAACCGCTGGTACGACAGGGAAAAAGCAATCAGCCCCAGCATTTT	CASSQDKPLVRQGKSNQPQHF	TRBV4-3	TRBJ1-5
TGTGCCACCAGTGATGGGGATGCGGGACACAATGAGCAGTTCTTC	CATSDGDAGHNEQFF	TRBV24-1	TRBJ2-1
TGTGCCAACCGGGACTTTTGCACTGAAGCTTTCTTT	CANRDFCTEAFF	TRBV27	TRBJ1-1
TGTGCCAGCATTTCCGGGACAGAGGGGGAAGGCTACTGTTGTAACTATGGCTACACCTTC	CASISGTEGEGYCCNYGYTF	TRBV6-3	TRBJ1-2
TGTGCCAGCAGAGGACAGGGAATGACCGGGGAGCTGTTTTTT	CASRGQGMTGELFF	TRBV5-4	TRBJ2-2
TGTGCCACCGCCTCCCCGGGCGGGAGGGCAACTAATGAAAAACTGTTTTTT	CATASPGGRATNEKLFF	TRBV24-1	TRBJ1-4
TGTGCCAGCAGTTGGGACCCCCGGAGCTCCTACGAGCAGTACTTC	CASSWDPRSSYEQYF	TRBV6-4	TRBJ2-7
TGCAGTGCTCCCGTGGGGGGCAACATTTTATCTGAGCAGTTCTTC	CSAPVGGNILSEQFF	TRBV20-1	TRBJ2-1
TGTGCCAGCAGCCAAGAAGCCTGGGCATCTGCAACTAATGAAAAACTGTTTTTT	CASSQEAWASATNEKLFF	TRBV3-1	TRBJ1-4
TGTGCCAGCAGCCAGACTAGCGTATGCTACGAGCAGTACTTC	CASSQTSVCYEQYF	TRBV7-4	TRBJ2-7
TGTGCCAGCCCGTTGACTAGCGGATTTTACAATGAGCAGTTCTTC	CASPLTSGFYNEQFF	TRBV13	TRBJ2-1
TGTGCCAGCAGTGATTTGGACCGGGGAGAGACCCAGTACTTC	CASSDLDRGETQYF	TRBV6-4	TRBJ2-5
TGTGCCAGCAGTTCGTTCTCTACGCGGGGAGCCACTGAAGCTTTCTTT	CASSSFSTRGATEAFF	TRBV27	TRBJ1-1
TGTGCCAGAGAGGGAGGGGAGGACCCTGGGGGCGCCTACGAGCAGTACTTC	CAREGGEDPGGAYEQYF	TRBV11-3	TRBJ2-7
TGTGCCAGCAGTGCCGGGACAGCGAATGAAAAACTGTTTTTT	CASSAGTANEKLFF	TRBV27	TRBJ1-4
TGTGCCAGCAGCCAACCCTGCAGTTTCCCGGGACTGGCGGACAATGAGCAGTTCTTC	CASSQPCSFPGLADNEQFF	TRBV14	TRBJ2-1
TGTGCCAGCAGCTTAGCCAGAGTGCTGGAAGACAGGGCCACTGAAGCTTTCTTT	CASSLARVLEDRATEAFF	TRBV7-8	TRBJ1-1
TGTGCCAGCAGCTTTGTCCGTACGACTCAATTAAGTGGCTACACCTTC	CASSFVRTTQLSGYTF	TRBV7-3	TRBJ1-2
TGCAGTGCGCCCCCTCTCTGGAGCCACGGTTTAGAAGAGACCCAGTACTTC	CSAPPLWSHGLEETQYF	TRBV20-1	TRBJ2-5
TGCGCCAGTTCCGGGACTAGCGGGAACATATGGCGGTACGAGCAGTACTTC	CASSGTSGNIWRYEQYF	TRBV5-1	TRBJ2-7
TGTGCCAGCTCACCCCCGGGAGAAGATGAGCAGTTCTTC	CASSPPGEDEQFF	TRBV18	TRBJ2-1
TGTGCCAGTAGTATAGGACTAGCGGGAGACGAGCAGTACTTC	CASSIGLAGDEQYF	TRBV19	TRBJ2-7
TGTGCCAGCAGTCAGACCAGGAATTCACCCCTCCACTTT	CASSQTRNSPLHF	TRBV27	TRBJ1-6
TGCGCCAGCACCGCCCAAGGGCCACGCCGGGACAGGGCCTACGAGCAGTACTTC	CASTAQGPRRDRAYEQYF	TRBV10-1	TRBJ2-7
TGTGCCAGCAGTTACTACGAGGGAGGGACAGGGTTCGTTAAAAACACCATATATTTT	CASSYYEGGTGFVKNTIYF	TRBV6-6	TRBJ1-3
TGTGCCAGCAGTCGCTGGTCAGCTGAAGAGACCCAGTACTTC	CASSRWSAEETQYF	TRBV6-5	TRBJ2-5
TGTGCCAGCAGTAAGGGACTAGCGCGGGAGACCCAGTACTTC	CASSKGLARETQYF	TRBV6-4	TRBJ2-5
TGTGCCAGCAGCGGGGGTTGCTCTGGGGCCAACGTCCTGACTTTC	CASSGGCSGANVLTF	TRBV5-5	TRBJ2-6
TGTGCCAGCAGCCGCCTAGCGGGCTTTGTCTCCTACGAGCAGTACTTC	CASSRLAGFVSYEQYF	TRBV9	TRBJ2-7
TGTGCCAGCAGCGGGTATCAACCTCCAGGCTCCCACGAGCAGTACTTC	CASSGYQPPGSHEQYF	TRBV7-3	TRBJ2-7
TGTGCCAGCAGTTCGGCGGGGGTCGACACTGAAGCTTTCTTT	CASSSAGVDTEAFF	TRBV12-4	TRBJ1-1
TGCGCCAGCAGCTTGCCCCCACCCGACAGGGGAAGTTACGAGCAGTACTTC	CASSLPPPDRGSYEQYF	TRBV5-1	TRBJ2-7
TGTGCCAGCAGCGAGTATCAGGGGGAACAGCATACGCAGTTCTTC	CASSEYQGEQHTQFF	TRBV9	TRBJ2-1
TGCAGTGCTAGCCTGTGGAACGACGAGCAGTACTTC	CSASLWNDEQYF	TRBV20-1	TRBJ2-7
TGTGCCAGTAGTATTCTGTATGAGCAGTTCTTC	CASSILYEQFF	TRBV19	TRBJ2-1
TGTGCCAGCAGCTTAACCGACCCTACCGCCCAGCGAGATTCACCCCTCCACTTT	CASSLTDPTAQRDSPLHF	TRBV7-9	TRBJ1-6
TGTGCCAGCAGCTTAAGGGGGCCCTACGAGCAGTACTTC	CASSLRGPYEQYF	TRBV7-9	TRBJ2-7
TGTGCCAGCAGTAGAGAGCCCTGGACCGGGGAGCTGTTTTTT	CASSREPWTGELFF	TRBV12-4	TRBJ2-2
TGTGCCAGCAGTTACGAATCAGGGCTTGACTACGAGCAGTACTTC	CASSYESGLDYEQYF	TRBV6-5	TRBJ2-7
TGTGCCAGCAGCCAAGATGAGAGGAAGGACGAGCAGTACTTC	CASSQDERKDEQYF	TRBV3-1	TRBJ2-7
TGCGCCAGCAGCCGGGACAGGGAGAAATCCTACAATGAGCAGTTCTTC	CASSRDREKSYNEQFF	TRBV5-1	TRBJ2-1
TGTGCCAGCAGTGCGACCGGGACAGGGCGGGGCTCCAATTCACCCCTCCACTTT	CASSATGTGRGSNSPLHF	TRBV6-3	TRBJ1-6
TGTGCCAGCAGTGTTCTGGCAGATACGCAGTATTTT	CASSVLADTQYF	TRBV6-5	TRBJ2-3
TGTGCCAGCAGTTACCGGGGGCTTGGGTACCAAGAGACCCAGTACTTC	CASSYRGLGYQETQYF	TRBV6-3	TRBJ2-5
TGTGCCAGCAGCTTCGCGGGAGTCATGAACACTGAAGCTTTCTTT	CASSFAGVMNTEAFF	TRBV5-5	TRBJ1-1
TGTGCCAGCAGCTTAGCGCCGGTTCACGTAGGGGCAGGGGGCTACACCTTC	CASSLAPVHVGAGGYTF	TRBV7-6	TRBJ1-2
TGTGCTAGTGCAGGGGACAGGGCTCAGACCAATCAGCCCCAGCATTTT	CASAGDRAQTNQPQHF	TRBV12-5	TRBJ1-5
TGTGCCAGCAGTAGTTTGACTAGCGGGGTAAGCTCCTACAATGAGCAGTTCTTC	CASSSLTSGVSSYNEQFF	TRBV28	TRBJ2-1
TGCGCCAGCAGCTACACAGGGCATGGCTACACCTTC	CASSYTGHGYTF	TRBV5-1	TRBJ1-2
TGTGCCAGCAGCTTGGGAGGGCAGGCTTTCTTT	CASSLGGQAFF	TRBV5-6	TRBJ1-1
TGTGCCAGCAGTGAATATATAGGGACAGGGTACGAGCAGTACTTC	CASSEYIGTGYEQYF	TRBV6-1	TRBJ2-7
TGCGCCAGCAGGGCGACAGGGGGGAGAGGAGGTAGCTCTGGAAACACCATATATTTT	CASRATGGRGGSSGNTIYF	TRBV10-2	TRBJ1-3
TGTGCCAGCAGCTTCACCCCGGGACAGGGGCCCTACGAGCAGTACTTC	CASSFTPGQGPYEQYF	TRBV7-9	TRBJ2-7
TGTGCCAGCAGCGAGGGGGGATACGAGCAGTACTTC	CASSEGGYEQYF	TRBV5-4	TRBJ2-7
TGCGCCAGCAGTGAGCAGGCTAGCAATCAGCCCCAGCATTTT	CASSEQASNQPQHF	TRBV10-1	TRBJ1-5
TGTGCCAGCAGCTTAGCTTCGGGGACAGGGAGCTCCTACAATGAGCAGTTCTTC	CASSLASGTGSSYNEQFF	TRBV7-6	TRBJ2-1
TGTGCCAGCAGCCAAGATGCGGCTAGCGGAGAGACCCAGTACTTC	CASSQDAASGETQYF	TRBV14	TRBJ2-5
TGTGCCAGCAGCTGCCTATCGACAGTCTACGAGCAGTACTTC	CASSCLSTVYEQYF	TRBV4-2	TRBJ2-7
TGTGCCAGCAGTACTCCGGGACAGGGGAGACACACTGAAGCTTTCTTT	CASSTPGQGRHTEAFF	TRBV27	TRBJ1-1
TGTGCCAGCAGTTTATGGCAGGGGTCCTATAGCAATCAGCCCCAGCATTTT	CASSLWQGSYSNQPQHF	TRBV28	TRBJ1-5
TGCAGCGTTGCAGGGTTTGATCACACTGAAGCTTTCTTT	CSVAGFDHTEAFF	TRBV29-1	TRBJ1-1
TGTGCCAGCAGTGAATCGGGGGGCCACTGGTTTCAGCCCCAGCATTTT	CASSESGGHWFQPQHF	TRBV25-1	TRBJ1-5
TGTGCCAGCAGTTACTTGGGGGGGGGTTTCAGGGAGGGCGAGACCCAGTACTTC	CASSYLGGGFREGETQYF	TRBV6-5	TRBJ2-5
TGTGCCAGCAGCAACAGGGAACGGTATGAAGGATCCACCCAGTACTTC	CASSNRERYEGSTQYF	TRBV9	TRBJ2-5
TGTGCCAGCAGTCTTGCGGCTAGCGGGAGAGCAGGGGCGAACACCGGGGAGCTGTTTTTT	CASSLAASGRAGANTGELFF	TRBV27	TRBJ2-2
TGTGCCAGCAGTGACTCGATACTCTGGGTAAAGATTTATAGCAATCAGCCCCAGCATTTT	CASSDSILWVKIYSNQPQHF	TRBV6-4	TRBJ1-5
TGTGCCAGCAGTGATGATGAACATGTGACAGGGGGGTCCACCGGGGAGCTGTTTTTT	CASSDDEHVTGGSTGELFF	TRBV6-1	TRBJ2-2
TGTGCCAGCAGCTTGGGTCCGGGACGGGACGAGCAGTACTTC	CASSLGPGRDEQYF	TRBV5-5	TRBJ2-7
TGTGCCAGTAGTTACCGCAGGGAGTCCTACGAGCAGTACTTC	CASSYRRESYEQYF	TRBV19	TRBJ2-7
TGTGCCAGCAGTTTAAGGGCCGGGGGATACTATGGCTACACCTTC	CASSLRAGGYYGYTF	TRBV6-6	TRBJ1-2
TGTGCCAGCAGCGGACAGGGATGTTGTCGAAGCAAGCAGTACTTC	CASSGQGCCRSKQYF	TRBV7-3	TRBJ2-7
TGTGCCAAACCGGACAGGTTAGGGAACATGAACACTGAAGCTTTCTTT	CAKPDRLGNMNTEAFF	TRBV24-1	TRBJ1-1
TGTGCCAGCAGCGTAGGAGTCCGAAGGGGACAGGGAATGGGACAGCCCCAGCATTTT	CASSVGVRRGQGMGQPQHF	TRBV9	TRBJ1-5
TGCGCCAGCAGTCTAGGGAGCACAGATACGCAGTATTTT	CASSLGSTDTQYF	TRBV10-1	TRBJ2-3
TGTGCCAGCAGCACCAAGGGGAGATTCTATGGCTACACCTTC	CASSTKGRFYGYTF	TRBV13	TRBJ1-2
TGTGCCAGCAGTTTGGCACGGGGAGGGCTGAACTATGGCTACACCTTC	CASSLARGGLNYGYTF	TRBV27	TRBJ1-2
TGTGCTAGCGTCCCCGGGGCTTGCACTGAAGCTTTCTTT	CASVPGACTEAFF	TRBV7-7	TRBJ1-1
TGTGCCAGCTCCACCGGGGGGGGCGAGCAGTTCTTC	CASSTGGGEQFF	TRBV6-1	TRBJ2-1
TGCAGTGCTAGAGATCTGTTTAGCGGGAGTAGTTCCTACGAGCAGTACTTC	CSARDLFSGSSSYEQYF	TRBV20-1	TRBJ2-7
TGTGCCAGCAGGAGTATCCGGCATGGAGTCCCCCAGCATTTT	CASRSIRHGVPQHF	TRBV5-4	TRBJ1-5
TGTGCCAGCTCGGGGGGAGCCGTTCAGACAAGTTCACCCCTCCACTTT	CASSGGAVQTSSPLHF	TRBV14	TRBJ1-6
TGCGCCAGCAGCCAACCTTGGGGACTAGCGGGTTCCTACGAGCAGTACTTC	CASSQPWGLAGSYEQYF	TRBV5-1	TRBJ2-7
TGCAGTGCTAGAGAGGATCGACTAGCGGGAGTGTATAGCAATCAGCCCCAGCATTTT	CSAREDRLAGVYSNQPQHF	TRBV20-1	TRBJ1-5
TGCAAACCTGTAAGCTCCTACGAGCAGTACTTC	CKPVSSYEQYF	TRBV20-1	TRBJ2-7
TGTGCCAGCAGCCCAGGACAGGGCCGGAACTATGGCTACACCTTC	CASSPGQGRNYGYTF	TRBV11-2	TRBJ1-2
TGCGCCAGCAGCCGGGGGGGACAGGGGACCGGGGAGCTGTTTTTT	CASSRGGQGTGELFF	TRBV5-1	TRBJ2-2
TGTGCCAGCAAATTGGCCCAACAGGGCGGTTTTTGTCTGAGTGAAGCTTTCTTT	CASKLAQQGGFCLSEAFF	TRBV13	TRBJ1-1
TGCAGCGTTGAAGTAGCCACGGGGGACAGGGGGAATGGAGGTGGGGACACTGAAGCTTTCTTT	CSVEVATGDRGNGGGDTEAFF	TRBV29-1	TRBJ1-1
TGTGCCAGCAGGATTCGGGACAGTAACTATGGCTACACCTTC	CASRIRDSNYGYTF	TRBV6-4	TRBJ1-2
TGTGCCAGCAGCCAAGATCGTTCTGGCGGCCAGGAAGAGACCCAGTACTTC	CASSQDRSGGQEETQYF	TRBV14	TRBJ2-5
TGCAGCGAACAGGGGAGGCCCTCCTACGAGCAGTACTTC	CSEQGRPSYEQYF	TRBV29-1	TRBJ2-7
TGCAGTGCTAGAGTGTTCCTTGCTATGGGGGGGAATGAGCAGTTCTTC	CSARVFLAMGGNEQFF	TRBV20-1	TRBJ2-1
TGTGCCAGGGGGGACTATGGCTACACCTTC	CARGDYGYTF	TRBV2	TRBJ1-2
TGTGCCAGCAGCTTGCCGGGTTCTGGGCCCATAGCTAACTATGGCTACACCTTC	CASSLPGSGPIANYGYTF	TRBV5-6	TRBJ1-2
TGCGCCAGCAGAAGTCGCAGGGGTAAGGGCACAGATACGCAGTATTTT	CASRSRRGKGTDTQYF	TRBV10-1	TRBJ2-3
TGTGCCAGCAGCACGGAGCGGGAGATACATGTCCGTGGTTCACCCCTCCACTTT	CASSTEREIHVRGSPLHF	TRBV27	TRBJ1-6
TGTGCCAGCAGCTTGGTTGCCGGGACAAGAGACACCGGGGAGCTGTTTTTT	CASSLVAGTRDTGELFF	TRBV5-4	TRBJ2-2
TGTGCCAGCAGCGTGAATCCGGGAGCGTACAATGAGCAGTTCTTC	CASSVNPGAYNEQFF	TRBV7-8	TRBJ2-1
TGTGCCATGCATGGGACAGGGTTAAACTACGAGCAGTACTTC	CAMHGTGLNYEQYF	TRBV10-3	TRBJ2-7
TGTGCCAGCAGCCGTGGGACAGGGGTCCCGAACACTGAAGCTTTCTTT	CASSRGTGVPNTEAFF	TRBV13	TRBJ1-1
TGTGCCAGCAGCTCCACGGGACAGGGGCGGTCCTACGAGCAGTACTTC	CASSSTGQGRSYEQYF	TRBV7-9	TRBJ2-7
TGCAGCATCAGGGGGGGAACTAATGAGCAGTTCTTC	CSIRGGTNEQFF	TRBV20-1	TRBJ2-1
TGTGCCAGCAGCTCGCTAGCCAACGAGCAGTACTTC	CASSSLANEQYF	TRBV7-9	TRBJ2-7
TGCAGTGCTTTCTGGACAGGGACCTACAATGAGCAGTTCTTC	CSAFWTGTYNEQFF	TRBV20-1	TRBJ2-1
TGCAGCGAGAAGGGAGGCCGGGGAATAGGGGTTATAGCTGGTGGTGGGAACACTGAAGCTTTCTTT	CSEKGGRGIGVIAGGGNTEAFF	TRBV29-1	TRBJ1-1
TGTGCCAGCCACTGCCCCTATAATTCACCCCTCCACTTT	CASHCPYNSPLHF	TRBV19	TRBJ1-6
TGTGCCAACCCAGGGACTCACTCCTACGAGCAGTACTTC	CANPGTHSYEQYF	TRBV15	TRBJ2-7
TGTGCCACCAGTTCTACAGGGGCGGAGAAGGGGTCATTCTACAATGAGCAGTTCTTC	CATSSTGAEKGSFYNEQFF	TRBV24-1	TRBJ2-1
TGTGCCAGCAGTGAAGGTAAACTAGCGGGAGGGCGGGAGACCCAGTACTTC	CASSEGKLAGGRETQYF	TRBV2	TRBJ2-5
TGTGCCAGCAGTTCTCAGGGCAATCAGCCCCAGCATTTT	CASSSQGNQPQHF	TRBV27	TRBJ1-5
TGTGCCAGCAGCCTGCCCCCGGGGGGCCCGTTCTACGAGCAGTACTTC	CASSLPPGGPFYEQYF	TRBV7-3	TRBJ2-7
TGCGCCACGTCGGGGACTGTGCCCTACAATGAGCAGTTCTTC	CATSGTVPYNEQFF	TRBV10-2	TRBJ2-1
TGTGCCAGCAGTTACTCACTAGCGGGGAGGGAAAGTCGGGAGGACCCGGGGAAGGACAATGAGCAGTTCTTC	CASSYSLAGRESREDPGKDNEQFF	TRBV6-2	TRBJ2-1
TGTGCCAGCAGCGCGGCCAGCGGCAGGACTAGCGGGAAAAGGGATACGCAGTATTTT	CASSAASGRTSGKRDTQYF	TRBV11-3	TRBJ2-3
TGCAGTGCTAGAGATCCCAGCTACGAGCAGTACTTC	CSARDPSYEQYF	TRBV20-1	TRBJ2-7
TGCGCCAGCACGGAGGGGGGCTCTCTTGACCAGCCAGATACGCAGTATTTT	CASTEGGSLDQPDTQYF	TRBV10-1	TRBJ2-3
TGTGCCAGCAGTGAGGGCAAAGTGAACACTGAAGCTTTCTTT	CASSEGKVNTEAFF	TRBV6-4	TRBJ1-1
TGTGCCAGCAGCTTACCAGTTCCCGGGCTGAGCTCCTACGAGCAGTACTTC	CASSLPVPGLSSYEQYF	TRBV7-4	TRBJ2-7
TGCGCCAGCAGCGGGATAGGACAGCCCCAGCATTTT	CASSGIGQPQHF	TRBV4-1	TRBJ1-5
TGTGCCAGCAGTTTTAGGGGTAAGAGCTCCTACGAGCAGTACTTC	CASSFRGKSSYEQYF	TRBV27	TRBJ2-7
TGCGCCAGCCGGTACCATTGCGGGAGAAGGGTGGACAATGAGCAGTTCTTC	CASRYHCGRRVDNEQFF	TRBV10-1	TRBJ2-1
TGTGCCAGCAGAGGGTCCTCGGGACAGAGGAATAATTCACCCCTCCACTTT	CASRGSSGQRNNSPLHF	TRBV27	TRBJ1-6
TGTGCCAGCAGCATCACAGGGACAGGCGAGACAGAGACCCAGTACTTC	CASSITGTGETETQYF	TRBV5-4	TRBJ2-5
TGTGCCAGCAGCGGCCGGGGAGAATACAATGAGCAGTTCTTC	CASSGRGEYNEQFF	TRBV7-4	TRBJ2-1
TGTGCCAGCAGTGTCCTGGGGGCAACGCCTCTGAACACTGAAGCTTTCTTT	CASSVLGATPLNTEAFF	TRBV2	TRBJ1-1
TGTGCCAGCAGCTCCAACGTTTCGGAGGGCACGGGTGAGCAGTTCTTC	CASSSNVSEGTGEQFF	TRBV7-2	TRBJ2-1
TGTGCCTGGAGTGTACTGACTAGCCAAGATGAGCAGTTCTTC	CAWSVLTSQDEQFF	TRBV30	TRBJ2-1
TGCGCCTTTGACTTTTCACGGAACACTGAAGCTTTCTTT	CAFDFSRNTEAFF	TRBV10-2	TRBJ1-1
TGTGCCACGGCCTCCAGGGGTACTAGAGCCAAAAACATTCAGTACTTC	CATASRGTRAKNIQYF	TRBV2	TRBJ2-4
TGTGCCAGCAGCGAACGGAGGGCAGATACGCAGTATTTT	CASSERRADTQYF	TRBV9	TRBJ2-3
TGTGCCAGCAGCAGACCGGGGGGGGACGAGCAGTTCTTC	CASSRPGGDEQFF	TRBV13	TRBJ2-1
TGTGCCAGCATACTCCGGACTAGCGGGCAAGGAAATGAGCAGTTCTTC	CASILRTSGQGNEQFF	TRBV14	TRBJ2-1
TGTGCCAGCAGCTTAGCCCTCAGACTAGCGGGGGAGGATACGCAGTATTTT	CASSLALRLAGEDTQYF	TRBV7-3	TRBJ2-3
TGCGCCAGCAGCCAAGACACACCTGAAAAACTGTTTTTT	CASSQDTPEKLFF	TRBV4-3	TRBJ1-4
TGTGCCAGCAGCAACGGGACTAGAGTATGCACCGGCTACAATGAGCAGTTCTTC	CASSNGTRVCTGYNEQFF	TRBV9	TRBJ2-1
TGTGCCAGCAGCCTGAACAGGGGAGGCTATGGCTACACCTTC	CASSLNRGGYGYTF	TRBV13	TRBJ1-2
TGTGCCACGAGACACAGGGGGCCAGATACGCAGTATTTT	CATRHRGPDTQYF	TRBV6-4	TRBJ2-3
TGCAGTGCCGAACTGGGACTAGAGCCCTCGGAGCAGTTCTTC	CSAELGLEPSEQFF	TRBV20-1	TRBJ2-1
TGTGCCAGCAGGCTAGTTGCGGGCACAGATACGCAGTATTTT	CASRLVAGTDTQYF	TRBV6-1	TRBJ2-3
TGTGCCAGCAGAGTCTTGGGGTGCGGTGAGAACACTGAAGCTTTCTTT	CASRVLGCGENTEAFF	TRBV6-5	TRBJ1-1
TGTGCCAGCAGCATTCTAGTTATAGGGAGCTCCTACGAGCAGTACTTC	CASSILVIGSSYEQYF	TRBV7-2	TRBJ2-7
TGTGCCAGTAGAGTCAGACTTGACCGAAGATACACTGAAGCTTTCTTT	CASRVRLDRRYTEAFF	TRBV19	TRBJ1-1
TGTGCTAGTGGCCTGACGGATGGCTACACCTTC	CASGLTDGYTF	TRBV12-5	TRBJ1-2
TGTGCCAGCAGTGCACCCGACCGGGACAGGGGACGCACAGATACGCAGTATTTT	CASSAPDRDRGRTDTQYF	TRBV6-4	TRBJ2-3
TGTGCCAGCAGGACGGGGATAGGTAATGAGCAGTTCTTC	CASRTGIGNEQFF	TRBV6-4	TRBJ2-1
TGTGCCAGCAGTTACGGCACAACGGGCAATCAGCCCCAGCATTTT	CASSYGTTGNQPQHF	TRBV6-5	TRBJ1-5
TGTGCCAGCTCACCGGGGGGGCCTGGGGAGCTGTTTTTT	CASSPGGPGELFF	TRBV18	TRBJ2-2
TGTGCCAGCAGCGGGAAAATAGAAAAACTGTTTTTT	CASSGKIEKLFF	TRBV5-4	TRBJ1-4
TGTGCCAGCAGCGTAGAACCGGACAGGGGAGACATGAACACTGAAGCTTTCTTT	CASSVEPDRGDMNTEAFF	TRBV9	TRBJ1-1
TGCAGCGTTGAAGATAACAGGGCTGGCTCTGGGGCCAACGTCCTGACTTTC	CSVEDNRAGSGANVLTF	TRBV29-1	TRBJ2-6
TGTGCCAGCAGCGGAGGGGGACTCCACTTT	CASSGGGLHF	TRBV13	TRBJ1-6
TGCAGTGCGTCCCATGACACAGGGGGCGATACCTATGGCTACACCTTC	CSASHDTGGDTYGYTF	TRBV20-1	TRBJ1-2
TGTGCCAGCAGCTTAGGCGGACGGAGGTATAGCAATCAGCCCCAGCATTTT	CASSLGGRRYSNQPQHF	TRBV7-9	TRBJ1-5
TGTGCCAGTAGTTCCGCCCGGACAGGGTGGTACAATGAGCAGTTCTTC	CASSSARTGWYNEQFF	TRBV19	TRBJ2-1
TGTGCCAGCAGCTTAGGCATCGGACAGAGACGTTTCACAGATACGCAGTATTTT	CASSLGIGQRRFTDTQYF	TRBV7-3	TRBJ2-3
TGTGCCAGCAGCCAACCGGGACAGGGCAATCAGCCCCAGCATTTT	CASSQPGQGNQPQHF	TRBV14	TRBJ1-5
TGTGCCAGCAGTTTAAAGGGGGACAGAGGCAATCAGCCCCAGCATTTT	CASSLKGDRGNQPQHF	TRBV12-4	TRBJ1-5
TGCAGCGTTGAGGCTGGCAATGAGCAGTTCTTC	CSVEAGNEQFF	TRBV29-1	TRBJ2-1
TGTGCCACCCGTACGGACGACGAGCAGTACTTC	CATRTDDEQYF	TRBV24-1	TRBJ2-7
TGTGCCAGCAGCAAGGCCTTAGTGTGGGGCTATGGCTACACCTTC	CASSKALVWGYGYTF	TRBV13	TRBJ1-2
TGTGCCAGCAGTGGGACCAAAACCTACGAGCAGTACTTC	CASSGTKTYEQYF	TRBV28	TRBJ2-7
TGTGCCAGCAGGGGGAGCAAGGGCACAGATACGCAGTATTTT	CASRGSKGTDTQYF	TRBV9	TRBJ2-3
TGTGCCAGCAGCGTCGGCACGCCCACCGGGGAGCTGTTTTTT	CASSVGTPTGELFF	TRBV5-6	TRBJ2-2
TGCGCCAGCATATTAACAGATACGCAGTATTTT	CASILTDTQYF	TRBV5-1	TRBJ2-3
TGTGCCAGCAGCTTGTTGGGACGGTACGAGCAGTACTTC	CASSLLGRYEQYF	TRBV5-6	TRBJ2-7
TGTGCCAGCAGTGAAGCTACTTCGGACGGTAACTATGGCTACACCTTC	CASSEATSDGNYGYTF	TRBV6-1	TRBJ1-2
TGTGCCAGTAGAAGGAGGGGATACACCGGGGAGCTGTTTTTT	CASRRRGYTGELFF	TRBV19	TRBJ2-2
TGTGCCAGCAGTGAATATGGGACCTCTGGGGCCAACGTCCTGACTTTC	CASSEYGTSGANVLTF	TRBV25-1	TRBJ2-6
TGTGCCACCAGTCCTCGACAGGAAGCGGAATCACCCCTCCACTTT	CATSPRQEAESPLHF	TRBV24-1	TRBJ1-6
TGTGCCAGCAGCTACAGGGACAGGGAAAACATTCAGTACTTC	CASSYRDRENIQYF	TRBV5-6	TRBJ2-4
TGCAGTCCCGGGACTAGCGGGAGGTTAGTCACAGATACGCAGTATTTT	CSPGTSGRLVTDTQYF	TRBV20-1	TRBJ2-3
TGTGCCAGCAGTGGACGACAGGATCGCCAGCCCCAGCATTTT	CASSGRQDRQPQHF	TRBV2	TRBJ1-5
TGCAGTGCTGAGGGGAAAGGACTAGCGGCGTCCTACGAGCAGTACTTC	CSAEGKGLAASYEQYF	TRBV20-1	TRBJ2-7
TGTGCCAGCAGTGACGGTTCGGGGGGCACCGTGGGTTACGAGCAGTACTTC	CASSDGSGGTVGYEQYF	TRBV6-4	TRBJ2-7
TGTGCCAGCAGCTTAGCAAGGCAAGAGGGGGTCCAGCAGTACTTC	CASSLARQEGVQQYF	TRBV11-3	TRBJ2-7
TGCAGTGCTAGCGGGGGTGCCTCCTACGAGCAGTACTTC	CSASGGASYEQYF	TRBV20-1	TRBJ2-7
TGTGCCAGCAGTGCGCGTTGTGGCTTACGCATAAGCACAGATACGCAGTATTTT	CASSARCGLRISTDTQYF	TRBV2	TRBJ2-3
TGCAGCGTCCCGGGAGGTACCTACGAGCAGTACTTC	CSVPGGTYEQYF	TRBV29-1	TRBJ2-7
TGCGCCAGCGCGACCTCGGGGGGGCCCTCCTACGAGCAGTACTTC	CASATSGGPSYEQYF	TRBV10-1	TRBJ2-7
TGTGCTAGTGGTTATCCCCGGGACGGAGCCTACGAGCAGTACTTC	CASGYPRDGAYEQYF	TRBV12-5	TRBJ2-7
TGTGCCTGGAGCCGCGGAGTCCTACCCCCTACTGAAGCTTTCTTT	CAWSRGVLPPTEAFF	TRBV30	TRBJ1-1
TGTGCCAGCAGTTACGTAACTATGGACAGGGTCGTCGGTTCTGGGGCCAACGTCCTGACTTTC	CASSYVTMDRVVGSGANVLTF	TRBV6-2	TRBJ2-6
TGTGCCAGCAGCGTTCCCCACAGGGGGGATTCACCCCTCCACTTT	CASSVPHRGDSPLHF	TRBV7-8	TRBJ1-6
TGTGCCAGCAGTAAGAACAGGGTGCTAATTAACTATGGCTACACCTTC	CASSKNRVLINYGYTF	TRBV28	TRBJ1-2
TGCGCCAGCAGCAAGGGGGGGAACGATCAGCCCCAGCATTTT	CASSKGGNDQPQHF	TRBV5-1	TRBJ1-5
TGTGCCACCTTGGAGGGCTACGAGCAGTACTTC	CATLEGYEQYF	TRBV15	TRBJ2-7
TGTGCCAGCAAACCGGTAACGGGGGGTTGTGCCAAAAACATTCAGTACTTC	CASKPVTGGCAKNIQYF	TRBV7-9	TRBJ2-4
TGTGCCAGCAGCTTAGCCTTAGCAGGGGTCTACGAGCAGTACTTC	CASSLALAGVYEQYF	TRBV7-6	TRBJ2-7
TGCGCCAGCACCCGCGGGGATTCTGGGGCCAACGTCCTGACTTTC	CASTRGDSGANVLTF	TRBV10-1	TRBJ2-6
TGTGCCAGCAGGGGAGACGGGCTGGGAGATACGCAGTATTTT	CASRGDGLGDTQYF	TRBV6-4	TRBJ2-3
TGTGCCAGTAGTCGTGAGTTAGGACAGCAGCCCCAGCATTTT	CASSRELGQQPQHF	TRBV19	TRBJ1-5
TGTGCCAGCAGCTTAATCCGTAAACTACAGGGCCCTCACCTAGCCAAAAACATTCAGTACTTC	CASSLIRKLQGPHLAKNIQYF	TRBV11-2	TRBJ2-4
TGCGCCAGCAGCCCGACTAGCGGGCACGGGATTTTCAATGAGCAGTTCTTC	CASSPTSGHGIFNEQFF	TRBV10-1	TRBJ2-1
TGTGCCAGCAGTAGGGGTTTCGAAAAACTGTTTTTT	CASSRGFEKLFF	TRBV6-5	TRBJ1-4
TGTGCCAGCAGCATTTCCGGGACAGGGGAGGTTACTCCAGATACGCAGTATTTT	CASSISGTGEVTPDTQYF	TRBV11-2	TRBJ2-3
TGTGCCAGCAGCGTACTATACAGACAGGATGAAGCTTTCTTT	CASSVLYRQDEAFF	TRBV9	TRBJ1-1
TGTGCCAGCAGCTTGGCCTCGAGCCGGCCCGGCTACACCTTC	CASSLASSRPGYTF	TRBV5-6	TRBJ1-2
TGTGCCTGGAGTAAAGCTAGTCGGAAACTCCACGAGCAGTACTTC	CAWSKASRKLHEQYF	TRBV30	TRBJ2-7
TGCGCCAGCAGTGAGGGTGGCAGGTACTCCTACAATGAGCAGTTCTTC	CASSEGGRYSYNEQFF	TRBV10-2	TRBJ2-1
TGTGCCAGCAGCAGGGTGAACACTGAAGCTTTCTTT	CASSRVNTEAFF	TRBV27	TRBJ1-1
TGCGCCAGCAGCTTCCGACCAAGGGGGCTGGGGCCGAATCAGCCCCAGCATTTT	CASSFRPRGLGPNQPQHF	TRBV5-1	TRBJ1-5
TGTGCCAGCAGTCCGGTAGACAGGGAGCCGAACACTGAAGCTTTCTTT	CASSPVDREPNTEAFF	TRBV28	TRBJ1-1
TGTGCCAGCAGCTTGGCCGCTAGAGGCGAATACAATGAGCAGTTCTTC	CASSLAARGEYNEQFF	TRBV5-6	TRBJ2-1
TGTGCTAGTGGACGGGACAGAGGTAAGTATGGCTACACCTTC	CASGRDRGKYGYTF	TRBV12-5	TRBJ1-2
TGTGCCAGCAGCTTAAGCCGACGCCAAGAGACCCAGTACTTC	CASSLSRRQETQYF	TRBV7-6	TRBJ2-5
TGTGCCAGGTACCTCACGGCGCTAGGAAGGAATAGGTCTGGAAACACCATATATTTT	CARYLTALGRNRSGNTIYF	TRBV11-3	TRBJ1-3
TGTGCCAGCAGCACCCCGATACCGGGCCGGGAAGCTTTCTTT	CASSTPIPGREAFF	TRBV6-1	TRBJ1-1
TGTGCCAGCAGCGGTCCGGACAGGGGGCAACCACAAGAGACCCAGTACTTC	CASSGPDRGQPQETQYF	TRBV11-3	TRBJ2-5
TGTGCCAGAGGGGCTTACGAGCAGTACTTC	CARGAYEQYF	TRBV6-1	TRBJ2-7
TGTGCCAGCAGTTTCCCGGGCCCGGATGAAGCTTTCTTT	CASSFPGPDEAFF	TRBV28	TRBJ1-1
TGTGCCAGCAGCCAAGGACGGCGCCAGGGGTCCTACAATGAGCAGTTCTTC	CASSQGRRQGSYNEQFF	TRBV14	TRBJ2-1
TGTGCCAGCAGCTCAAGAAGAGCTTTCTTT	CASSSRRAFF	TRBV7-4	TRBJ1-1
TGTGCCAGCAGTTTCGGACTAGCGGGTACCTACAATGAGCAGTTCTTC	CASSFGLAGTYNEQFF	TRBV28	TRBJ2-1
TGTGCCAGTAGTATCCACCCGGGACTAGCGGGAGGGGAGACCCAGTACTTC	CASSIHPGLAGGETQYF	TRBV19	TRBJ2-5
TGCAGTGCTAGATCCCGGGACAGGGGGCGCAAAAGAACGAACACCGGGGAGCTGTTTTTT	CSARSRDRGRKRTNTGELFF	TRBV20-1	TRBJ2-2
TGTGCCAGACCGAAGCCGAAAGACAGTGGACCCTATGGCTACACCTTC	CARPKPKDSGPYGYTF	TRBV27	TRBJ1-2
TGTGCCAGCAGCTCGGTCTCACCGAGCTCCCACTCCTATGGCTACACCTTC	CASSSVSPSSHSYGYTF	TRBV7-6	TRBJ1-2
TGTGCCAGCAGCCTAATCCACAGTAGCAATCAGCCCCAGCATTTT	CASSLIHSSNQPQHF	TRBV9	TRBJ1-5
TGTGCCAGCAGCTGTAAGGTAGGAGGACATCAGCCCCAGCATTTT	CASSCKVGGHQPQHF	TRBV7-3	TRBJ1-5
TGTGCCAGCAGCGCAGCAAAACGGCTAAACTCCTACGAGCAGTACTTC	CASSAAKRLNSYEQYF	TRBV7-4	TRBJ2-7
TGTGCCAGCAGCTTACGGAAGCGGGGACTTACGAACACCGGGGAGCTGTTTTTT	CASSLRKRGLTNTGELFF	TRBV7-9	TRBJ2-2
TGTGCCAGCGAACTAGGACAGGGGAGTCTAGCCAAAAACATTCAGTACTTC	CASELGQGSLAKNIQYF	TRBV7-3	TRBJ2-4
TGTGCCACCAGTATCCGGACGAAAGAGACCCAGTACTTC	CATSIRTKETQYF	TRBV24-1	TRBJ2-5
TGTGCCACCAGTGAACCCCCGACAGGGTTAGTGAGGAACACTGAAGCTTTCTTT	CATSEPPTGLVRNTEAFF	TRBV24-1	TRBJ1-1
TGTGCCAGCAGCTTTTGGGACCGGCGCTATGGCTACACCTTC	CASSFWDRRYGYTF	TRBV11-2	TRBJ1-2
TGCAGCTCCTACGGGTACGAGCAGTACTTC	CSSYGYEQYF	TRBV29-1	TRBJ2-7
TGCGCCAGCAGCTTGGAGGGAGGGCAAGCAGAGCAGTACTTC	CASSLEGGQAEQYF	TRBV5-1	TRBJ2-7
TGCGCCAGCAGCCTCTGTAGCGGGTTTGTAGATAATGAGCAGTTCTTC	CASSLCSGFVDNEQFF	TRBV4-1	TRBJ2-1
TGTGCCAGTAGTATCACCAGGGGGCATAGCAATCAGCCCCAGCATTTT	CASSITRGHSNQPQHF	TRBV19	TRBJ1-5
TGTGCCAGCAGCTTAGGGACAGGTTGGGGCTACACCTTC	CASSLGTGWGYTF	TRBV7-6	TRBJ1-2
TGTGCCAGCACCAACTTAGAGGAAGGAGGTGAGCAGTTCTTC	CASTNLEEGGEQFF	TRBV9	TRBJ2-1
TGTGCCAGTAGTAGGACCATGAACGAGCAGTACTTC	CASSRTMNEQYF	TRBV19	TRBJ2-7
TGTGCCAGCTCCGATTTTTCCTGGGGCATATATTTT	CASSDFSWGIYF	TRBV18	TRBJ1-3
TGTGCCAGCAGCTTAGATTTCACAGGGTCTGGGACCGAGCAGTACTTC	CASSLDFTGSGTEQYF	TRBV11-3	TRBJ2-7
TGTGCCAGCAGCTCTAGCGGGAAGGCCCGCCCTGTTAAGTACACTGAAGCTTTCTTT	CASSSSGKARPVKYTEAFF	TRBV7-2	TRBJ1-1
TGTGCCAGCAGCCAAGGGGGATACAATGAGCAGTTCTTC	CASSQGGYNEQFF	TRBV3-1	TRBJ2-1
TGTGCCAGCAGGGACAGGGATTCCCAGTACGAGCAGTACTTC	CASRDRDSQYEQYF	TRBV11-2	TRBJ2-7
