TGTGCCAGCTCACCCCCAACCCGGGACGGAATGGAGGTTCCGACTCCAAACTCTGGGGCCAACGTCCTGACTTTC	CASSPPTRDGMEVPTPNSGANVLTF	TRBV18	TRBJ2-6
TGCGCCAGCAGCCAAGCCCGCAGAGGGGGGAACAAGAGGGAAGAGACCCAGTACTTC	CASSQARRGGNKREETQYF	TRBV4-1	TRBJ2-5
TGCAGTGCTAGGGGCACAGAACTAGCGGATACGCAGTATTTT	CSARGTELADTQYF	TRBV20-1	TRBJ2-3
TGTGCCAGCAGCGCCGGGACAGGGAAGGATAGCAATCAGCCCCAGCATTTT	CASSAGTGKDSNQPQHF	TRBV6-5	TRBJ1-5
TGTGCCAGCAGCCCGGGGACAGAGGAAAGGTTTGGGGCCAACGTCCTGACTTTC	CASSPGTEERFGANVLTF	TRBV13	TRBJ2-6
TGCGCCAGCAGCCAAGAGGGGAGGGGGGCGGGAGAGTGTCAGCACACTGAAGCTTTCTTT	CASSQEGRGAGECQHTEAFF	TRBV4-1	TRBJ1-1
TGTGCCAGCAGCATGGCCCACCTACAGGGGGCGCCCTACGAGCAGTACTTC	CASSMAHLQGAPYEQYF	TRBV13	TRBJ2-7
TGTGCCAGCAGTGCGGACGTATATGGCTACACCTTC	CASSADVYGYTF	TRBV6-5	TRBJ1-2
TGTGCCAGCAGCGAGGGGACAGGAGTTCTTAAAGATACGCAGTATTTT	CASSEGTGVLKDTQYF	TRBV7-4	TRBJ2-3
TGTGCCAGCAGCTTAGCTACGCTCCCGGGACAGACCAGCTCCTATAATTCACCCCTCCACTTT	CASSLATLPGQTSSYNSPLHF	TRBV7-2	TRBJ1-6
TGTGCCTGGCGTCACAGTGCTCCTAATTCACCCCTCCACTTT	CAWRHSAPNSPLHF	TRBV30	TRBJ1-6
TGCGCCAGCAGCTTGCGGGGGGGCAGAGTTTGGACCAACTATGGCTACACCTTC	CASSLRGGRVWTNYGYTF	TRBV5-1	TRBJ1-2
TGTGCCAGCAGGAAGGCGCTTGAAGTTACGGCCGAAACTGAAGCTTTCTTT	CASRKALEVTAETEAFF	TRBV12-3	TRBJ1-1
TGTGCCAGCAGCGCTATGCCTCCGTCGACAGGGGATGCTAGCAATCAGCCCCAGCATTTT	CASSAMPPSTGDASNQPQHF	TRBV6-6	TRBJ1-5
TGTGCCAGCTCACCATGGGGGCGGACCCTCCACTTT	CASSPWGRTLHF	TRBV18	TRBJ1-6
TGTGCCAGTAAGCCAACTAATGAAACCGGACTCATAGAGACCCAGTACTTC	CASKPTNETGLIETQYF	TRBV19	TRBJ2-5
TGTGCCAGCAGTCGGACCGGACAGGGGACGGCTCGGGACGAGCAGTACTTC	CASSRTGQGTARDEQYF	TRBV6-4	TRBJ2-7
TGTGCCAGCAGCGCCCCAACCCAAGGCTACGAGCAGTACTTC	CASSAPTQGYEQYF	TRBV7-3	TRBJ2-7
TGTGCCACCAGCAGTACGACCCCGGACAGGGAAGTCATTCCTTTAGGCATGAACACTGAAGCTTTCTTT	CATSSTTPDREVIPLGMNTEAFF	TRBV15	TRBJ1-1
TGTGCCAGCAGTTTGCAACACGCCTTGGTTTTGAACACTGAAGCTTTCTTT	CASSLQHALVLNTEAFF	TRBV27	TRBJ1-1
TGTGCCAGCAGCAAAGCCCCGGGGGGGCGGGCGCAGTATTTT	CASSKAPGGRAQYF	TRBV7-3	TRBJ2-3
TGTGCCACCAGGGGGCGCAGGGAGCAGTACTTC	CATRGRREQYF	TRBV24-1	TRBJ2-7
TGCAGCGCAAGGAGGGCCGGCACTGGCTACACCTTC	CSARRAGTGYTF	TRBV29-1	TRBJ1-2
TGTGCCAGCAGCGCGAAGATTTCACCGACCCAGTACTTC	CASSAKISPTQYF	TRBV7-3	TRBJ2-5
TGTGCCAGCAGCCTCGGGGCCAGTTCGTTTTCACCCCTCCACTTT	CASSLGASSFSPLHF	TRBV7-3	TRBJ1-6
TGTGCCAGCAGCACAGGGGGCATACGAGAAGCTTTCTTT	CASSTGGIREAFF	TRBV5-8	TRBJ1-1
TGTGCCAGCAGTGACGGGGTAGGTGCGGCCACTGAAGCTTTCTTT	CASSDGVGAATEAFF	TRBV6-1	TRBJ1-1
TGTGCCAGCAGTTGGGACTGCTCCTACGAGCAGTACTTC	CASSWDCSYEQYF	TRBV27	TRBJ2-7
TGTGCCTGGAGTGTACTCTCAGGCAGGGGGCCTACGCACAATGAGCAGTTCTTC	CAWSVLSGRGPTHNEQFF	TRBV30	TRBJ2-1
TGTGCCAGCAGTTACCCGGAGAGTCAGGGGGAGAATGAGCAGTTCTTC	CASSYPESQGENEQFF	TRBV28	TRBJ2-1
TGCGCCAATAAGACAGCTTATAGCAATCAGCCCCAGCATTTT	CANKTAYSNQPQHF	TRBV5-1	TRBJ1-5
TGTGCCAGCAGGTACGAGCCCTCCTACGAGCAGTACTTC	CASRYEPSYEQYF	TRBV13	TRBJ2-7
TGTGCCAGCAGCTTGCGTTATCTCGAGGGTTCCAGCAATCAGCCCCAGCATTTT	CASSLRYLEGSSNQPQHF	TRBV5-6	TRBJ1-5
TGCAGTGCTCGGTACCAGGGGCCAGGTGAAAAACTGTTTTTT	CSARYQGPGEKLFF	TRBV20-1	TRBJ1-4
TGTGCCAGCAGTACCCCAGGGAACTCAGGGAGGATCTATGGCTACACCTTC	CASSTPGNSGRIYGYTF	TRBV2	TRBJ1-2
TGTGCCAGCAGCCCACTATATCGACCCCCCCAGGGGCGAGATACGCAGTATTTT	CASSPLYRPPQGRDTQYF	TRBV7-4	TRBJ2-3
TGTGCCAGCAGCAGCTCGGGGGCGTCAAAACTGTTTTTT	CASSSSGASKLFF	TRBV14	TRBJ1-4
TGTGCCACCAGTGAGGCCCCAGGGGAAAAACTGTTTTTT	CATSEAPGEKLFF	TRBV24-1	TRBJ1-4
TGCGCCAGCAGCTCCCCAGCTTGGGGGCTCCCTAATGAAAAACTGTTTTTT	CASSSPAWGLPNEKLFF	TRBV5-1	TRBJ1-4
TGTGCCAGCAGCTCCTCGACAGTCGGAAACACCATATATTTT	CASSSSTVGNTIYF	TRBV7-8	TRBJ1-3
TGTGCCAGCAGCCCAGGGTATTCACCCCTCCACTTT	CASSPGYSPLHF	TRBV13	TRBJ1-6
TGCGCCAGCAGCTTGGGCGGCAGGGGGCTAAGGGTCTATGGCTACACCTTC	CASSLGGRGLRVYGYTF	TRBV5-1	TRBJ1-2
TGCACAGCGACTAGCGGGGGGGTTGTAGCCAAAAACATTCAGTACTTC	CTATSGGVVAKNIQYF	TRBV29-1	TRBJ2-4
TGTGCCAGCAGTTGTAGGAACCGGGACATTATGAACACTGAAGCTTTCTTT	CASSCRNRDIMNTEAFF	TRBV28	TRBJ1-1
TGCGCCAGCAGTAACAGGGGGCTCGGGAGGCTGAGCACAGATACGCAGTATTTT	CASSNRGLGRLSTDTQYF	TRBV4-1	TRBJ2-3
TGTGCTAGTGGTTTGAGACAGGAGTACGAGCAGTACTTC	CASGLRQEYEQYF	TRBV12-5	TRBJ2-7
TGTGCCACCGGGGCCGAGCAGTACTTC	CATGAEQYF	TRBV24-1	TRBJ2-7
TGTGCCAGCAGCGTAATTGGGGGATTCTACGAGCAGTACTTC	CASSVIGGFYEQYF	TRBV9	TRBJ2-7
TGCGCCAGCAGCCCCTGCTCAGGTAGCTCCTACAATGAGCAGTTCTTC	CASSPCSGSSYNEQFF	TRBV4-1	TRBJ2-1
TGTGCCAGCTCACCAAAGGAATCCCAAAGACGAATCGACGAGCAGTACTTC	CASSPKESQRRIDEQYF	TRBV18	TRBJ2-7
TGTGCCAGCAGCAGTTCACCAAGGGGCAGTGATGGCTACACCTTC	CASSSSPRGSDGYTF	TRBV7-9	TRBJ1-2
TGTGCCAGCAGCCAAGAAACACAGGGGCCACCTGGGAGCAATCAGCCCCAGCATTTT	CASSQETQGPPGSNQPQHF	TRBV3-1	TRBJ1-5
TGTGCCACCAGCAGAGGTCGCCTACAGGGGGTGAAAAACATTCAGTACTTC	CATSRGRLQGVKNIQYF	TRBV15	TRBJ2-4
TGTGCCACCACCCAGCTAGCGGGGGCAAATACGCAGTATTTT	CATTQLAGANTQYF	TRBV27	TRBJ2-3
TGTGCCAGCAGCTTGGCCGCCAAGACAGGGTACAATGAGCAGTTCTTC	CASSLAAKTGYNEQFF	TRBV5-6	TRBJ2-1
TGTGCCAGCAGCAGGCGCGGTCGAGAAAAACTGTTTTTT	CASSRRGREKLFF	TRBV13	TRBJ1-4
TGTGCCAGTAGTAAAGACTGGGAGGTAAGGAGGAACACCGGGGAGCTGTTTTTT	CASSKDWEVRRNTGELFF	TRBV19	TRBJ2-2
TGTGCCTGGTGGGCGGCCTATGGCTACACCTTC	CAWWAAYGYTF	TRBV6-1	TRBJ1-2
TGCAGTGCTAGGACCAGTGCTCGCTACAATGAGCAGTTCTTC	CSARTSARYNEQFF	TRBV20-1	TRBJ2-1
TGCAGCGACCAGGCGGGGGAGTCCCTTCAAGGAAACACCATATATTTT	CSDQAGESLQGNTIYF	TRBV29-1	TRBJ1-3
TGTGCCAGCAGCTTAGGCTGGACCGGGACTCGCACAGATACGCAGTATTTT	CASSLGWTGTRTDTQYF	TRBV7-9	TRBJ2-3
TGTGCCAGCTGCACGGGACGAAAAGCTTTCTTT	CASCTGRKAFF	TRBV13	TRBJ1-1
TGTGCCAGCAGTGCGAACAAGGGGACAGGGGGCAACAGGGGGGGGTCGAACACTGAAGCTTTCTTT	CASSANKGTGGNRGGSNTEAFF	TRBV25-1	TRBJ1-1
TGCAGTGCTAGAGATAGGACAGGGGGCACGGCTCATGGGGCCAACGTCCTGACTTTC	CSARDRTGGTAHGANVLTF	TRBV20-1	TRBJ2-6
TGTGCCAGCAGTTACATACCTAGCAGGGGGGCTGAGACCCAGTACTTC	CASSYIPSRGAETQYF	TRBV6-3	TRBJ2-5
TGCAGTGCTAGAGCACTGACTGGCACAGATACGCAGTATTTT	CSARALTGTDTQYF	TRBV20-1	TRBJ2-3
TGTGCCACCACAACCTGTGCCGGGACACCTATAGGATCAGAAGCTGAAGCTTTCTTT	CATTTCAGTPIGSEAEAFF	TRBV24-1	TRBJ1-1
TGCAGTGCTGGGACCCTATTGTACGAGCAGTACTTC	CSAGTLLYEQYF	TRBV20-1	TRBJ2-7
TGTGCCAGCAGCAACCACCCAGGGTGTCCAACTGAAGCTTTCTTT	CASSNHPGCPTEAFF	TRBV13	TRBJ1-1
TGCGCCAGCAGTGAGTCTGGGGACAGGGCGACCTCCTACGAGCAGTACTTC	CASSESGDRATSYEQYF	TRBV10-1	TRBJ2-7
TGCAGCGTTGTACAAGGAGGCCCTCTCGGCAATCAGCCCCAGCATTTT	CSVVQGGPLGNQPQHF	TRBV29-1	TRBJ1-5
TGTGCCAGCAGCTTAGAAGTGGGAGGGCATGAGCAGTTCTTC	CASSLEVGGHEQFF	TRBV7-2	TRBJ2-1
TGTGCCAGACCCCAGGGGGACGAGCAGTACTTC	CARPQGDEQYF	TRBV27	TRBJ2-7
TGTGCCAGCAGCTTCCTCTCGGACAGGGCGGCGCAGCCCCAGCATTTT	CASSFLSDRAAQPQHF	TRBV11-3	TRBJ1-5
TGTGCCAGCACTGCAGACCCCACTAGGGGGTACAATGAGCAGTTCTTC	CASTADPTRGYNEQFF	TRBV6-2	TRBJ2-1
TGTGCCAGCTCACCAGTTCACCCGGCAGGGTCCTCTAACTATGGCTACACCTTC	CASSPVHPAGSSNYGYTF	TRBV18	TRBJ1-2
TGTGCCAGCAGTACGTGGATACGGGGCGGGGAGAGGACCTACGAGCAGTACTTC	CASSTWIRGGERTYEQYF	TRBV12-4	TRBJ2-7
TGCGCCAGCAGCTTGGCCGCGGAGAGAGCTGGGGCCAACGTCCTGACTTTC	CASSLAAERAGANVLTF	TRBV5-1	TRBJ2-6
TGTGCCACCAGTGATTGGACTGAAGACCGTTATAGCAATCAGCCCCAGCATTTT	CATSDWTEDRYSNQPQHF	TRBV24-1	TRBJ1-5
TGTGCCAGCAGGACAGCGGATCGCGAGCAGTACTTC	CASRTADREQYF	TRBV7-3	TRBJ2-7
TGTGCCTGGAGTAGAGGGGATTATGAGCAGTTCTTC	CAWSRGDYEQFF	TRBV30	TRBJ2-1
TGTGTGAGAGGGGCCAAAAACATTCAGTACTTC	CVRGAKNIQYF	TRBV4-2	TRBJ2-4
TGCGCCAGCATAGGGGTCTACGAGCAGTACTTC	CASIGVYEQYF	TRBV10-1	TRBJ2-7
TGTGCCAGCAGTGAATCACGAGAGGACAGGGGAACGGCGAACACTGAAGCTTTCTTT	CASSESREDRGTANTEAFF	TRBV25-1	TRBJ1-1
TGTGCCAGCTATCGACTAGCGGGAGGAAGCACTGAAGCTTTCTTT	CASYRLAGGSTEAFF	TRBV24-1	TRBJ1-1
TGTGCCAGCAGTTCCGAGACAGGCCGAGAATGCAATCAGCCCCAGCATTTT	CASSSETGRECNQPQHF	TRBV6-1	TRBJ1-5
TGTGCCAGCAGATGGGGGCAGGCCTACGAGCAGTACTTC	CASRWGQAYEQYF	TRBV6-1	TRBJ2-7
TGTGCCAGCAGCTCTTGGACAGAGACCCAGTACTTC	CASSSWTETQYF	TRBV9	TRBJ2-5
TGTGCCACCAGTCCCCGTAGAGTCGACACCGGGGAGCTGTTTTTT	CATSPRRVDTGELFF	TRBV24-1	TRBJ2-2
TGTGCCAGCAGTTACCCCCAGACAGGAAAAAATGAGCAGTTCTTC	CASSYPQTGKNEQFF	TRBV6-3	TRBJ2-1
TGCAGTGCTACTGGGGCGCACGCAGGCTACACCTTC	CSATGAHAGYTF	TRBV20-1	TRBJ1-2
TGTGCCAGCAGCCAAGAATCCTGGGGGACCGGGGAGCTGTTTTTT	CASSQESWGTGELFF	TRBV14	TRBJ2-2
TGTGCCACCAGTGATACCCCTTGGGACAGGAGAAACATTCAGTACTTC	CATSDTPWDRRNIQYF	TRBV24-1	TRBJ2-4
TGTGCCATCAGGATCCAGAGGAGCTCCTACGAGCAGTACTTC	CAIRIQRSSYEQYF	TRBV10-3	TRBJ2-7
TGTGCCAGCAGTTTCACCCTAAAACAGGTAAGAGAGACCCAGTACTTC	CASSFTLKQVRETQYF	TRBV27	TRBJ2-5
TGTGCCAGCAGTGACCCGCCCGGGACGACTGAAGCTTTCTTT	CASSDPPGTTEAFF	TRBV2	TRBJ1-1
TGTGCCAGCAGGGAACCAGCTAGCGGGACTGAGCAGTACTTC	CASREPASGTEQYF	TRBV2	TRBJ2-7
TGCGCCAGCAGCTTGGCTGAGGAGTCCTACAATGAGCAGTTCTTC	CASSLAEESYNEQFF	TRBV5-1	TRBJ2-1
TGCAGTGCTAGATCACAGGGCCCTTATCAGCCCCAGCATTTT	CSARSQGPYQPQHF	TRBV20-1	TRBJ1-5
TGCAGTGCTAGAGATGACCTCCGACTAGACCACAAGGACAATGAGCAGTTCTTC	CSARDDLRLDHKDNEQFF	TRBV20-1	TRBJ2-1
TGTGCCACCCAGGGGGACTATGGCTACACCTTC	CATQGDYGYTF	TRBV24-1	TRBJ1-2
TGTGCCAGCAGAGTCGACAGAGGGGTCTACGAGCAGTACTTC	CASRVDRGVYEQYF	TRBV27	TRBJ2-7
TGTGCCAGCAGTGAACGTTGGGAAAATTTACAAGAGACCCAGTACTTC	CASSERWENLQETQYF	TRBV6-1	TRBJ2-5
TGTGCCAGCAGCCCCGTCAATCAGCCCCAGCATTTT	CASSPVNQPQHF	TRBV3-1	TRBJ1-5
TGTGCCAGCAGTACTATCCGCACAGGGGGGTACACCATATATTTT	CASSTIRTGGYTIYF	TRBV6-6	TRBJ1-3
TGTGCCAGCAGCGTAGGTACGGGTGCAGCTGAAGCTTTCTTT	CASSVGTGAAEAFF	TRBV9	TRBJ1-1
TGTGCCAGCAGGAGCACCGCGCAGCCCCAGCATTTT	CASRSTAQPQHF	TRBV27	TRBJ1-5
TGTGCCAGCAGTTTGTGGACTGGGGTGGTAGAGACCCAGTACTTC	CASSLWTGVVETQYF	TRBV12-3	TRBJ2-5
TGCGCCAGCAGCTTCCCCCCCGGGACTAAAGGGGATTACGAGCAGTACTTC	CASSFPPGTKGDYEQYF	TRBV5-1	TRBJ2-7
TGTGCCAGCAGCTTCAGCAGACAGGGGCAGGGTTCAATCCGGGACACCGGGGAGCTGTTTTTT	CASSFSRQGQGSIRDTGELFF	TRBV11-1	TRBJ2-2
TGTGCCAGCAGCTTAACCGACGGGGTTCTGCTTAATGTGACCCAGTACTTC	CASSLTDGVLLNVTQYF	TRBV7-3	TRBJ2-5
TGTGCCAGCAGCCGCGTTAGGGACAGGGAGAGCTCCTACAATGAGCAGTTCTTC	CASSRVRDRESSYNEQFF	TRBV2	TRBJ2-1
TGTGCCAGTAGTACCGCGTTATGGGGCAGAGCCAAAAACATTCAGTACTTC	CASSTALWGRAKNIQYF	TRBV19	TRBJ2-4
TGCAGTGCTAGGATAGGGAGGATGGTCACAGATACGCAGTATTTT	CSARIGRMVTDTQYF	TRBV20-1	TRBJ2-3
TGTGCCAGCAGCTTGAACCTAGACGGGGGGGTGAACACTGAAGCTTTCTTT	CASSLNLDGGVNTEAFF	TRBV7-3	TRBJ1-1
TGTGCCAGCAGTCCGGGACTAGCGGGAGAGTACGAGCAGTACTTC	CASSPGLAGEYEQYF	TRBV6-4	TRBJ2-7
TGTGCCAGCAGTATGCCTAACAGGGGGCCCTACGAGCAGTACTTC	CASSMPNRGPYEQYF	TRBV6-3	TRBJ2-7
TGCGCCAGCAGCTCCCTGACCGGGACCGAGACCCAGTACTTC	CASSSLTGTETQYF	TRBV5-1	TRBJ2-5
TGTGCCAGCAGGGGGATTTCCGGCGGGGAGCTGTTTTTT	CASRGISGGELFF	TRBV6-8	TRBJ2-2
TGTGCCAGCAGCGTAAAGGTTGGGACTAGCGAGACCAAACAGTATTTT	CASSVKVGTSETKQYF	TRBV9	TRBJ2-3
TGTGCCAGCAGTCATCCCCAGGGGGGGGTGACGGAGACCCAGTACTTC	CASSHPQGGVTETQYF	TRBV27	TRBJ2-5
TGTGAGAAAAACGGATTCACTGAAGCTTTCTTT	CEKNGFTEAFF	TRBV25-1	TRBJ1-1
TGTGCCAGCAGCTGCTCGACAAACCCACGTGCAACTAATGAAAAACTGTTTTTT	CASSCSTNPRATNEKLFF	TRBV7-2	TRBJ1-4
TGTGCCAGCAGCCCGGGACAGGGGGGAGCTTTCTTT	CASSPGQGGAFF	TRBV5-5	TRBJ1-1
TGTGCCAGCAGTGAACTTAGGGGGGCTTTCTTCCCCTACGAGCAGTACTTC	CASSELRGAFFPYEQYF	TRBV6-1	TRBJ2-7
TGCGCCAGCAGGGAAGGAGGATACGAGCAGTACTTC	CASREGGYEQYF	TRBV10-1	TRBJ2-7
TGTGCCACCAAGGGCAGGGGGAGGGCCTACGAGCAGTACTTC	CATKGRGRAYEQYF	TRBV24-1	TRBJ2-7
TGTGCCAGCAGCTTGGACAGTTACACTGAAGCTTTCTTT	CASSLDSYTEAFF	TRBV5-4	TRBJ1-1
TGTGCCAGCAGCCTGGGCCGACTAGCGGAACCCCAAGAGACCCAGTACTTC	CASSLGRLAEPQETQYF	TRBV13	TRBJ2-5
TGCGCCAGCACTCGGGTAGATGTTAGGCTCTCTGGGGCCAACGTCCTGACTTTC	CASTRVDVRLSGANVLTF	TRBV4-1	TRBJ2-6
TGTGCCAGCAGCCAGTGGGGGGGGAGGACCTACGAGCAGTACTTC	CASSQWGGRTYEQYF	TRBV11-3	TRBJ2-7
TGTGCCAGCAGCTTAGCAGGGGATCCCCCCTACGAGCAGTACTTC	CASSLAGDPPYEQYF	TRBV7-9	TRBJ2-7
TGCGCCAGCAGCTTGGGTCTACCCCATATGGAGACCCAGTACTTC	CASSLGLPHMETQYF	TRBV5-1	TRBJ2-5
TGTGCCGTGACAGGGAGGCCTGGAAACACCATATATTTT	CAVTGRPGNTIYF	TRBV25-1	TRBJ1-3
TGTGCCAGCAGTTACAGAAAATCCTGGGGCCTTCTTAGCAATCAGCCCCAGCATTTT	CASSYRKSWGLLSNQPQHF	TRBV6-6	TRBJ1-5
TGTGCCAACCGAACAGGGCCCCTTATTGGGAGGACTGAAGCTTTCTTT	CANRTGPLIGRTEAFF	TRBV6-5	TRBJ1-1
TGTGCCAGCAGCAGGCGACAGGAGAAGTCCGCCTACGAGCAGTACTTC	CASSRRQEKSAYEQYF	TRBV13	TRBJ2-7
TGTGCCAGCAGCTGGACAGGGCCCCTCCAAGAGACCCAGTACTTC	CASSWTGPLQETQYF	TRBV7-3	TRBJ2-5
TGTGCCAGCAGACATAACACCATATATTTT	CASRHNTIYF	TRBV7-2	TRBJ1-3
TGTGCCAGCAGTTACGGACCGGGACTAGCGGGGGGGCACGGCTACGAGCAGTACTTC	CASSYGPGLAGGHGYEQYF	TRBV6-6	TRBJ2-7
TGCAGTGCTAGAGATGGCGGGACGTACAATGAGCAGTTCTTC	CSARDGGTYNEQFF	TRBV20-1	TRBJ2-1
TGCAGTGCTGAACAGGAGACAGGTTCCTATAATTCACCCCTCCACTTT	CSAEQETGSYNSPLHF	TRBV20-1	TRBJ1-6
TGCGCCAGCAGCTTCCCCCCCGGGGACAGGGTACAAGAGACCCAGTACTTC	CASSFPPGDRVQETQYF	TRBV5-1	TRBJ2-5
TGTGCTAGTGGTTTGGTAGAAGGGGGAAAGCTATTCTACGAGCAGTACTTC	CASGLVEGGKLFYEQYF	TRBV12-5	TRBJ2-7
TGTGCCAGCAGCGGGTTTGACAGTAGTTCACCCCTCCACTTT	CASSGFDSSSPLHF	TRBV9	TRBJ1-6
TGTGCCAGCAGTGACTGGACGAGGACAGGGTTTTCTTTGGGCAAAAACATTCAGTACTTC	CASSDWTRTGFSLGKNIQYF	TRBV6-4	TRBJ2-4
TGTGCCAGCAGCGTAGCCGGGGGCGCCCTCTATGGCTACACCTTC	CASSVAGGALYGYTF	TRBV9	TRBJ1-2
TGCGCCAGCAGCTGCCTCTCGCTAAACACTGAAGCTTTCTTT	CASSCLSLNTEAFF	TRBV5-1	TRBJ1-1
TGCAGCGGAACGCCAGGGGCTGAAGCTTTCTTT	CSGTPGAEAFF	TRBV29-1	TRBJ1-1
TGTGCCTGGAGACGGGATAGCAATCAGCCCCAGCATTTT	CAWRRDSNQPQHF	TRBV30	TRBJ1-5
TGCTCGGGGACAGAGGGGAACTATGGCTACACCTTC	CSGTEGNYGYTF	TRBV20-1	TRBJ1-2
TGTGCCAGCTCGACCGCACGATGGGACAGGGCCGCCCCCCGCTACGAGCAGTACTTC	CASSTARWDRAAPRYEQYF	TRBV18	TRBJ2-7
TGTGCCAGCAGTTACTCGCTCGCTGACTCTGGGGCCAACGTCCTGACTTTC	CASSYSLADSGANVLTF	TRBV6-6	TRBJ2-6
TGTGCCAGCTCAGGAGGACATTTCCAAGAGACCCAGTACTTC	CASSGGHFQETQYF	TRBV18	TRBJ2-5
TGTGCTAGTGGTTTGGTGACAGGGAGGGAAAAACTGTTTTTT	CASGLVTGREKLFF	TRBV12-5	TRBJ1-4
TGTGCCAGGGCCCCTGATAGCAATCAGCCCCAGCATTTT	CARAPDSNQPQHF	TRBV7-2	TRBJ1-5
TGTGCCAGCACCCGACTAGCCATGCAAGAGACCCAGTACTTC	CASTRLAMQETQYF	TRBV13	TRBJ2-5
TGTGCCAGCAGTTACTCTCCGGGAGGGGGATGCTCTGGAAACACCATATATTTT	CASSYSPGGGCSGNTIYF	TRBV6-9	TRBJ1-3
TGTGCCAGCAAGCAACAGTCATTTTTTGCCTTC	CASKQQSFFAF	TRBV27	TRBJ1-2
TGTGCCAGCAGCCTGTTGGACAGGCCGGGAGATTCACCCCTCCACTTT	CASSLLDRPGDSPLHF	TRBV7-9	TRBJ1-6
TGTGCCAGCAGCTCACCTAGCCCTAGCAATCAGCCCCAGCATTTT	CASSSPSPSNQPQHF	TRBV9	TRBJ1-5
TGTGCCAGCAGAAGAAGACGGAGGGGGACCCAGTACTTC	CASRRRRRGTQYF	TRBV6-4	TRBJ2-5
TGTGCCAGCATTAATACACTAGCGGGAGGTGGCCTCGGGGAGCTGTTTTTT	CASINTLAGGGLGELFF	TRBV27	TRBJ2-2
TGCGCCAGCAGCTTGAGCCGGGACAGTCCCTGCGAAGAGACCCAGTACTTC	CASSLSRDSPCEETQYF	TRBV5-1	TRBJ2-5
TGTGCCAGCAAGCCGGGACAGGGTTCCTATGGCTACACCTTC	CASKPGQGSYGYTF	TRBV11-3	TRBJ1-2
TGCGCCAGGTACAACCTTGGCTACACCTTC	CARYNLGYTF	TRBV5-1	TRBJ1-2
TGTGCCAGCAGTGAAGCTGAAGGGGGGGATACGCAGTATTTT	CASSEAEGGDTQYF	TRBV6-1	TRBJ2-3
TGTGCCACCCGGGGGACAGGACGAACTAATGAAAAACTGTTTTTT	CATRGTGRTNEKLFF	TRBV24-1	TRBJ1-4
TGTGCCAGCAGCACCCAAGGGGACAGCGTAGATACGCAGTATTTT	CASSTQGDSVDTQYF	TRBV7-3	TRBJ2-3
TGTGCCAGCAGTTTGGGGGGGTGGGGGAGGGTCTACGAGCAGTACTTC	CASSLGGWGRVYEQYF	TRBV6-8	TRBJ2-7
TGCGCCAGCAGCTTGTGTACATTAAGGGACCTCACTGAAGCTTTCTTT	CASSLCTLRDLTEAFF	TRBV5-1	TRBJ1-1
TGTGCCACCAGTCGTGCCGTGGGGGCGCGCGGACGCGCCGTCTACAATGAGCAGTTCTTC	CATSRAVGARGRAVYNEQFF	TRBV24-1	TRBJ2-1
TGTGCCAGCAGCCAAGATCTTAGTAAACCTAGACGATCCTACGAGCAGTACTTC	CASSQDLSKPRRSYEQYF	TRBV4-2	TRBJ2-7
TGCGCCAGCAGCCAGGACGACGACACTGAAGCTTTCTTT	CASSQDDDTEAFF	TRBV4-3	TRBJ1-1
TGTGCCAGCAACCACCGACAGGGGGCTCACCACCCTTTCTACGAGCAGTACTTC	CASNHRQGAHHPFYEQYF	TRBV25-1	TRBJ2-7
TGTGCCAGCAGCCAAGATTGCAAACTAGGGCAAGGCTACGAGCAGTACTTC	CASSQDCKLGQGYEQYF	TRBV4-2	TRBJ2-7
TGTGCCACCAGTGATCTTACGAAGGGGGTCACTTCCGGGGAGCTGTTTTTT	CATSDLTKGVTSGELFF	TRBV24-1	TRBJ2-2
TGTGCCAGCAGTGAATGTGCGGGACAGGGTGAAGACGTATACGAGCAGTACTTC	CASSECAGQGEDVYEQYF	TRBV25-1	TRBJ2-7
TGTGCCAGCAGCACGCGGGACAGAGAGACCCAGTACTTC	CASSTRDRETQYF	TRBV7-9	TRBJ2-5
TGTGCCAGCAGTGGCGTGGGGGTGTATGGCTACACCTTC	CASSGVGVYGYTF	TRBV25-1	TRBJ1-2
TGCAAAGTCCTCCATGAGCAGTTCTTC	CKVLHEQFF	TRBV29-1	TRBJ2-1
TGTGCCAGCATAAAAACCGGCGGACAGGGCTACAATGAGCAGTTCTTC	CASIKTGGQGYNEQFF	TRBV6-4	TRBJ2-1
TGTGTCGGCTCACCAAACGGTAATCAGCCCCAGCATTTT	CVGSPNGNQPQHF	TRBV5-4	TRBJ1-5
TGTGCCAGCAGCCAAGCGCAGAATGAGCAGTTCTTC	CASSQAQNEQFF	TRBV3-1	TRBJ2-1
TGTGCCAGCAGCATCCCCGACCCGGGCCGGTTATACGAGCAGTACTTC	CASSIPDPGRLYEQYF	TRBV9	TRBJ2-7
TGTGCCAGCAGTACCCCCGGGACGTTTGAAAAACTGTTTTTT	CASSTPGTFEKLFF	TRBV28	TRBJ1-4
TGTGCCAGCAGCTTGGGAAGGCATTTTGACAGAGGAAGTCCCACTGAAGCTTTCTTT	CASSLGRHFDRGSPTEAFF	TRBV5-6	TRBJ1-1
TGTGCCATCAGTCATAGCGGGTACTACGAGCAGTACTTC	CAISHSGYYEQYF	TRBV10-3	TRBJ2-7
TGTGCCGAAAGGCTAGCGGGGGGGGAGCTGTTTTTT	CAERLAGGELFF	TRBV24-1	TRBJ2-2
TGTGCCAGCAGCTCACATGTCTCTGGCTACACCTTC	CASSSHVSGYTF	TRBV6-8	TRBJ1-2
TGTGCCAGCAGCTTGTTGGGGTTTAATATGAACACTGAAGCTTTCTTT	CASSLLGFNMNTEAFF	TRBV7-8	TRBJ1-1
TGCGCCAGCAGTGACTACCAAGGGGTAAATGAGCAGTTCTTC	CASSDYQGVNEQFF	TRBV10-1	TRBJ2-1
TGCGCCAGCAGCTTGGAGGCCGGGGTCCGAGGGGAGCAGTACTTC	CASSLEAGVRGEQYF	TRBV5-1	TRBJ2-7
TGCGCCAGCAGCCAAGATCGAGTAGGGGGGGCCGATGAGCAGTTCTTC	CASSQDRVGGADEQFF	TRBV4-1	TRBJ2-1
TGCGCCAGCAGCCAAGGGACGGTTCGCTATAATTCACCCCTCCACTTT	CASSQGTVRYNSPLHF	TRBV10-1	TRBJ1-6
TGTGCCAGCTCACCAGGGACAGGACAGCCCCAGCATTTT	CASSPGTGQPQHF	TRBV18	TRBJ1-5
TGTGCCAGCAGCTTAGCCAGGGGACAGGGTTCTAATTCACCCCTCCACTTT	CASSLARGQGSNSPLHF	TRBV7-2	TRBJ1-6
TGTGCCAGCAGCAGTACAGGAGAGACCCAGTACTTC	CASSSTGETQYF	TRBV7-2	TRBJ2-5
TGTGCCAGCTCACCTCCGCTTACTCAAGGACAGGACGAGCAGTACTTC	CASSPPLTQGQDEQYF	TRBV18	TRBJ2-7
TGTCCCCGAAGGACGAACACTGAAGCTTTCTTT	CPRRTNTEAFF	TRBV6-6	TRBJ1-1
TGCAGCGTTGCCGTTGGGGGAAACACCATATATTTT	CSVAVGGNTIYF	TRBV29-1	TRBJ1-3
TGTGCCACCAGTTTTCGCCTCGGGGACCAGCGGGAGCTCCCGAACACTGAAGCTTTCTTT	CATSFRLGDQRELPNTEAFF	TRBV24-1	TRBJ1-1
TGTGCCAGCAGCGTAGAGGGGGGGGACAGGGTTACCTCTGGGGCCAACGTCCTGACTTTC	CASSVEGGDRVTSGANVLTF	TRBV9	TRBJ2-6
TGTGCCAGCAGTTCTTGGACAGGGGGGTGTCAGCCCCAGCATTTT	CASSSWTGGCQPQHF	TRBV6-6	TRBJ1-5
TGTGCCAGCCCCAGGGCTCCGTGCAATCAGCCCCAGCATTTT	CASPRAPCNQPQHF	TRBV7-3	TRBJ1-5
TGCAGTGCTCCGGCTAGTCGCGGGGAGCTGTTTTTT	CSAPASRGELFF	TRBV20-1	TRBJ2-2
TGTGCCAGCTCACCAAGTAATCCGAACCCGGGACAAAAAGCACAGAAAGAGACCCAGTACTTC	CASSPSNPNPGQKAQKETQYF	TRBV18	TRBJ2-5
TGCAGTGCTAGAGATCCCGAGCGGCAGGGCCTCTACAATGAGCAGTTCTTC	CSARDPERQGLYNEQFF	TRBV20-1	TRBJ2-1
TGTGCCAGCAGCCAAGATCAATCAGGGGGAATCTACGAGCAGTACTTC	CASSQDQSGGIYEQYF	TRBV14	TRBJ2-7
TGTGCCAGCAGCTTAATGGGGGGTGAGGGTCAAAACATTCAGTACTTC	CASSLMGGEGQNIQYF	TRBV11-2	TRBJ2-4
TGTGCCACCAGTACCCCCACAGGGGCTCGGGAGGCTTTCTTT	CATSTPTGAREAFF	TRBV24-1	TRBJ1-1
TGTGCCAGCAGCCAAGATAGGCTAGCGGTCTTC	CASSQDRLAVF	TRBV3-1	TRBJ2-1
TGTGCCAGCACAGTCGGGAAGCCGTCGGGAAATGAAAAACTGTTTTTT	CASTVGKPSGNEKLFF	TRBV6-2	TRBJ1-4
TGCAGTGCGGGCCGTGGGGTCTACCGGGCACCCCTCCACTTT	CSAGRGVYRAPLHF	TRBV20-1	TRBJ1-6
TGTGCCAGTAGTAAATGTCAGGGACTAGCGGAGAAGAGAACCAATGAGCAGTTCTTC	CASSKCQGLAEKRTNEQFF	TRBV19	TRBJ2-1
TGTGCCAGCAGCTTCGCGCGAGGATCCCCCCCTACCCCGGGACAGGGGGCAGACGAGCAGTACTTC	CASSFARGSPPTPGQGADEQYF	TRBV7-4	TRBJ2-7
TGTGAGATTCAGGCTTGCACAGATACGCAGTATTTT	CEIQACTDTQYF	TRBV6-4	TRBJ2-3
TGTGCCAGCAGCCCAAGAGCTGGGGGCAATCAGCCCCAGCATTTT	CASSPRAGGNQPQHF	TRBV3-1	TRBJ1-5
TGTGCCAGCAGCTACGGGACAGAACTCGAGCAGTACTTC	CASSYGTELEQYF	TRBV13	TRBJ2-7
TGTGCCAGCAGCCACAGGGGCAGGGATGAGCAGTTCTTC	CASSHRGRDEQFF	TRBV3-1	TRBJ2-1
TGTGCCAGCAGAGTGAAGGGGGTTAACACCGGGGAGCTGTTTTTT	CASRVKGVNTGELFF	TRBV6-4	TRBJ2-2
TGTGCTAGCAGTATGAAGAGGCCAGTATATAGCAATCAGCCCCAGCATTTT	CASSMKRPVYSNQPQHF	TRBV7-7	TRBJ1-5
TGTGCCAGCAGGAGGGGCTGGACGGTTAATTCACCCCTCCACTTT	CASRRGWTVNSPLHF	TRBV6-1	TRBJ1-6
TGTGCCAGCAGCATCCGGGTGGGGAGCTATGGCTACACCTTC	CASSIRVGSYGYTF	TRBV12-3	TRBJ1-2
TGTGCCAGCAGTGGAGGGGTCTATTTGGGGAGGGGCTACACCTTC	CASSGGVYLGRGYTF	TRBV7-2	TRBJ1-2
TGTGCCAGCTCAGGCCCGGCGGGAGGTTACGAGCAGTACTTC	CASSGPAGGYEQYF	TRBV18	TRBJ2-7
TGTGCCAGCAGCCCAATCTGGGACAGAGATTCGGCTGGGGCCAACGTCCTGACTTTC	CASSPIWDRDSAGANVLTF	TRBV2	TRBJ2-6
TGTGCCAGTAGCGGGGGCTTGAGGGACTCCTACGAGCAGTACTTC	CASSGGLRDSYEQYF	TRBV19	TRBJ2-7
TGTGCCAGCAGTTACGGGGGGACTAGCGGGGAGTACGAGCAGTACTTC	CASSYGGTSGEYEQYF	TRBV6-3	TRBJ2-7
TGTGCCAGCAGTTTTAGTTACAGGCTATGTGAGACCCAGTACTTC	CASSFSYRLCETQYF	TRBV27	TRBJ2-5
TGTGCTAGTGGTTTGGTAGGGAGCACTCATACTTGGAATTCACCCCTCCACTTT	CASGLVGSTHTWNSPLHF	TRBV12-5	TRBJ1-6
TGCGCCAGCAGCCAAGTATATAACAGGCGAACCTTTTATAGCAATCAGCCCCAGCATTTT	CASSQVYNRRTFYSNQPQHF	TRBV4-1	TRBJ1-5
TGTGCCAGCAGCCAAAATCTTAGCGGGTCGTCCTACGAGCAGTACTTC	CASSQNLSGSSYEQYF	TRBV3-1	TRBJ2-7
TGCGCCAGCAGCTTAGAGTGGGAGGGATTCCCCTACGAGCAGTACTTC	CASSLEWEGFPYEQYF	TRBV5-1	TRBJ2-7
TGTGCCACCAGTGATTACGGACAGGGTATCCATGGCTACACCTTC	CATSDYGQGIHGYTF	TRBV24-1	TRBJ1-2
TGTGCCAGCAGCATGACAGGGAGGAGGCAGAACACTGAAGCTTTCTTT	CASSMTGRRQNTEAFF	TRBV7-3	TRBJ1-1
TGCGCCAGCAGCTCCAGGGGACAGGCTGAGACCTACGAGCAGTACTTC	CASSSRGQAETYEQYF	TRBV5-1	TRBJ2-7
TGTGCCAGCAGCCTTCCCCTGAACGAGCTCTACGAGCAGTACTTC	CASSLPLNELYEQYF	TRBV13	TRBJ2-7
TGTGCCAGCACCTGGACAGGGGGTTATAGGGGCTATGGCTACACCTTC	CASTWTGGYRGYGYTF	TRBV7-9	TRBJ1-2
TGTGCCAGCAGCGGCATGACAGGGCCAGTCGAGCAGTACTTC	CASSGMTGPVEQYF	TRBV12-4	TRBJ2-7
TGTGCCAGCAGTTCGACGGTCCGACTGGAGTACAATGAGCAGTTCTTC	CASSSTVRLEYNEQFF	TRBV27	TRBJ2-1
TGTGCCAGCAGCGACAACCAGGGGGCCCATAAAGAAAAACTGTTTTTT	CASSDNQGAHKEKLFF	TRBV12-4	TRBJ1-4
TGTGCCAGCAGCCACCTGGACAGTGCCTACGAGCAGTACTTC	CASSHLDSAYEQYF	TRBV7-4	TRBJ2-7
TGTGCCAGCCCCGAAGGGGGGCCAAGAACAGCCAAAAACATTCAGTACTTC	CASPEGGPRTAKNIQYF	TRBV6-1	TRBJ2-4
TGCAGTGCTAGAGGGACTAGCGTAGACAATGAGCAGTTCTTC	CSARGTSVDNEQFF	TRBV20-1	TRBJ2-1
TGTGCCTGGAGGTTCGATGGGTTCGATCCAGTTCGCACTGAAGCTTTCTTT	CAWRFDGFDPVRTEAFF	TRBV30	TRBJ1-1
TGTGCCAGCAGTCGACGTAATGTGGACAATGAGCAGTTCTTC	CASSRRNVDNEQFF	TRBV6-1	TRBJ2-1
TGTGCCAGCAGCGTAGCCCAGGTGGGGTTCGACTCCTACGAGCAGTACTTC	CASSVAQVGFDSYEQYF	TRBV9	TRBJ2-7
TGCGCCAGCGAGGGTCTAACTGAAGCTTTCTTT	CASEGLTEAFF	TRBV10-1	TRBJ1-1
TGTGCCAGCAGCCACCCAGGGGGCAGCTCTGGAAACACCATATATTTT	CASSHPGGSSGNTIYF	TRBV14	TRBJ1-3
TGTGCCAGCAGCTTAGTGAACCGGGGGCGGGGGGACAACTATGGCTACACCTTC	CASSLVNRGRGDNYGYTF	TRBV7-2	TRBJ1-2
TGTGCCAGCTTGCGGGCGAAGCAAGAGACCCAGTACTTC	CASLRAKQETQYF	TRBV6-5	TRBJ2-5
TGCGCCAGCAGCCTGGGGGGCCCCTTTGAGCAGTTCTTC	CASSLGGPFEQFF	TRBV4-3	TRBJ2-1
TGTGCCAGCAGTTGCGTGCTTGGACAGGGAACGGGGGGGGTCTTC	CASSCVLGQGTGGVF	TRBV27	TRBJ2-1
TGTGCCAGCAGCTTAGTAAGACTCGGGACAGGGACGGAGGGGAGTCAGCCCCAGCATTTT	CASSLVRLGTGTEGSQPQHF	TRBV7-9	TRBJ1-5
TGTGCCACCAGCAGAGCGCGCAGGGGACAAGGAGGTACAAATCAGCCCCAGCATTTT	CATSRARRGQGGTNQPQHF	TRBV15	TRBJ1-5
TGTGCCAGCATAGCAGATACGCAGTATTTT	CASIADTQYF	TRBV6-5	TRBJ2-3
TGCAGCGTTGCGGAGGGTGAGAGGGACAGGAGACAAGAGACCCAGTACTTC	CSVAEGERDRRQETQYF	TRBV29-1	TRBJ2-5
TGTGCCAGCAGCCCGCGCGAGACCCAGTACTTC	CASSPRETQYF	TRBV7-3	TRBJ2-5
TGTGCCAGCAGCTTTAGGGGGGGCATGAGCTCCTACAATGAGCAGTTCTTC	CASSFRGGMSSYNEQFF	TRBV5-4	TRBJ2-1
TGTGCCAGCAGCCAAGATACCGGGGACTACGAGCAGTACTTC	CASSQDTGDYEQYF	TRBV14	TRBJ2-7
TGTGCCAGCAGCCTTACGACAGGGCAGAACAATGAGCAGTTCTTC	CASSLTTGQNNEQFF	TRBV13	TRBJ2-1
TGTGCCAGCAGCCAGCAGGTTGAAAAACTGTTTTTT	CASSQQVEKLFF	TRBV5-6	TRBJ1-4
TGTGCCAGCAGCGTAGCTAGCGGGCGGGACGGGGAGCTGTTTTTT	CASSVASGRDGELFF	TRBV9	TRBJ2-2
TGTGCCAGCACACCCTACACCGGGACAGGGAAGACCCAGTACTTC	CASTPYTGTGKTQYF	TRBV27	TRBJ2-5
TGTGCCAGGCCGGGACGATGGGGGCAAGAGACCCAGTACTTC	CARPGRWGQETQYF	TRBV7-7	TRBJ2-5
TGCGCCAAGGACAGGGCGATTCCCTACGAGCAGTACTTC	CAKDRAIPYEQYF	TRBV5-1	TRBJ2-7
TGCAGTGCTAGTAACGCGGGACGGGTGGAGCAGTACTTC	CSASNAGRVEQYF	TRBV20-1	TRBJ2-7
TGTGCCAGCAGCGTATCGTCAAAGCTGCGCACTAGCGGGAGCGGGGAGCTGTTTTTT	CASSVSSKLRTSGSGELFF	TRBV9	TRBJ2-2
TGTGCCAGCAGCGCCCTAGCGGGAGTAGTGCGCACAGATACGCAGTATTTT	CASSALAGVVRTDTQYF	TRBV9	TRBJ2-3
TGTGCCAGCACCCGGGGAGGGCAGGCCGAGCAGTACTTC	CASTRGGQAEQYF	TRBV28	TRBJ2-7
TGCAGTGCCGGCAGATATAGCAATCAGCCCCAGCATTTT	CSAGRYSNQPQHF	TRBV20-1	TRBJ1-5
TGTGCCAGCAGTGGGGGGGGTCTAGTCAGGGACAATGAGCAGTTCTTC	CASSGGGLVRDNEQFF	TRBV25-1	TRBJ2-1
TGTGCCAGCAGGAGCCGTTCACTAGCGGGAGCTAGGGGGGGGAACACTGAAGCTTTCTTT	CASRSRSLAGARGGNTEAFF	TRBV7-3	TRBJ1-1
TGCAGTGGCAACAGGACAGGGATGAACACTGAAGCTTTCTTT	CSGNRTGMNTEAFF	TRBV20-1	TRBJ1-1
TGTGCCAGCAGAATAGACAGGGACCCCCACACTGAAGCTTTCTTT	CASRIDRDPHTEAFF	TRBV27	TRBJ1-1
TGTGCTAGCAGCTTAGCCCGTCTAGCGGGTTGTTACAATGAGCAGTTCTTC	CASSLARLAGCYNEQFF	TRBV7-7	TRBJ2-1
TGTGCCAGCAGCATGCGCACCCAGAGCTCCTACAATGAGCAGTTCTTC	CASSMRTQSSYNEQFF	TRBV9	TRBJ2-1
TGTGCCAGTAGTATAGTCGACCGGGGCGAGAGCAATCAGCCCCAGCATTTT	CASSIVDRGESNQPQHF	TRBV19	TRBJ1-5
TGTGCCACCGCGGACATGGCCCAGTACTTC	CATADMAQYF	TRBV24-1	TRBJ2-5
TGCAGTCCCGACAGGGCAGCCCCCACAGATACGCAGTATTTT	CSPDRAAPTDTQYF	TRBV20-1	TRBJ2-3
TGTGCCAGCAGCTTAGGGAAATTCGGGGGGGCATATAAAGAGACCCAGTACTTC	CASSLGKFGGAYKETQYF	TRBV7-9	TRBJ2-5
TGTGCCAGGGTCGGGCCCGGCTACTCTGGGGCCAACGTCCTGACTTTC	CARVGPGYSGANVLTF	TRBV6-4	TRBJ2-6
TGTGCCACCAGTGATTTGCGGGCCCAGGGGGCTCAGCCCCAGCATTTT	CATSDLRAQGAQPQHF	TRBV24-1	TRBJ1-5
TGTGCCAGCAGTTACGAAACTAGCGGGAGAATCTTC	CASSYETSGRIF	TRBV6-5	TRBJ1-2
TGTGCCAGCAAACAGGGGAAAAAACTGTTTTTT	CASKQGKKLFF	TRBV27	TRBJ1-4
TGCGCCAGCAGCTTGCATCGTGACGAGACCCAGTACTTC	CASSLHRDETQYF	TRBV5-1	TRBJ2-5
TGTGCCTGGAGGGGAGCGGGATCCGCAGATACGCAGTATTTT	CAWRGAGSADTQYF	TRBV30	TRBJ2-3
TGTGCCATCAGTGGGACAGGCGGCTATGGCTACACCTTC	CAISGTGGYGYTF	TRBV10-3	TRBJ1-2
TGTGCCAGCAGTTACCCCTTTCGGGGCCTATCGTATAGCAATCAGCCCCAGCATTTT	CASSYPFRGLSYSNQPQHF	TRBV6-6	TRBJ1-5
TGTTTCCGAGACAGGGGTGAGACCCAGTACTTC	CFRDRGETQYF	TRBV6-5	TRBJ2-5
TGCGCCAGCAGCTGTCGGGACAGAGACTATGGCTACACCTTC	CASSCRDRDYGYTF	TRBV5-1	TRBJ1-2
TGCAGTGCTAGAGTAACTAGTCCCTTC	CSARVTSPF	TRBV20-1	TRBJ2-7
TGTGCCAGCAGTTTAGGGGGCAACTATAGCAATCAGCCCCAGCATTTT	CASSLGGNYSNQPQHF	TRBV12-4	TRBJ1-5
TGCGCCAGCAGTGAGTGGGAGGACAGAGATGGCTACACCTTC	CASSEWEDRDGYTF	TRBV10-1	TRBJ1-2
TGTGCCAGCAATTCGGACAGGGGGCATCAGCCCCAGCATTTT	CASNSDRGHQPQHF	TRBV7-9	TRBJ1-5
TGTGCCAGCAGCTTAGCTGAAGGGTCCGGCAATCAGCCCCAGCATTTT	CASSLAEGSGNQPQHF	TRBV11-2	TRBJ1-5
TGTGCCACCAGTGATAACCACAGGGGCGGATACGAGCAGTACTTC	CATSDNHRGGYEQYF	TRBV24-1	TRBJ2-7
TGTGCCACCAGTGGCAAAAAACTCGGGGAGCTGTTTTTT	CATSGKKLGELFF	TRBV24-1	TRBJ2-2
TGTGCCAGCAGCGTAGGATTAGGCTTACGCTCCTACGAGCAGTACTTC	CASSVGLGLRSYEQYF	TRBV9	TRBJ2-7
TGCAGTGCTCTGCCCCGAAAGAAGAGCAATCAGCCCCAGCATTTT	CSALPRKKSNQPQHF	TRBV20-1	TRBJ1-5
TGTGCCAGTTTCCAGGATAATTCACCCCTCCACTTT	CASFQDNSPLHF	TRBV5-6	TRBJ1-6
TGTGCCAGCAGCCATAAACGTCCTAGGCCTCTAAAAAACATTCAGTACTTC	CASSHKRPRPLKNIQYF	TRBV5-5	TRBJ2-4
TGTGCCAGCAGCTGGTCGGCAACAGGGGCTGAAGCTTTCTTT	CASSWSATGAEAFF	TRBV7-8	TRBJ1-1
TGTGCCAGCACTGTTAATTCACCCCTCCACTTT	CASTVNSPLHF	TRBV27	TRBJ1-6
TGTGCCAGCAGTTGTGGGACAGAGGTTGAAAAACTGTTTTTT	CASSCGTEVEKLFF	TRBV12-3	TRBJ1-4
TGTGCCAGCAGAGTCCCACCCCGGAGGGCGGCCTACAATGAGCAGTTCTTC	CASRVPPRRAAYNEQFF	TRBV6-5	TRBJ2-1
TGCGCCAGCAGCTTGGGCTTTGGGGGGGGGGCGTACGAGCAGTACTTC	CASSLGFGGGAYEQYF	TRBV5-1	TRBJ2-7
TGTGCCAGCAGCGTCGGGGGGGCGCCGGCAGATACGCAGTATTTT	CASSVGGAPADTQYF	TRBV11-2	TRBJ2-3
TGTGCCAGCAACCCAAGGGAGGGAGCCACTAACATTCAGTACTTC	CASNPREGATNIQYF	TRBV9	TRBJ2-4
TGTGCCAGCAGCAGGTTGGGGGGGGGAAGAGCGGCTAACATTCAGTACTTC	CASSRLGGGRAANIQYF	TRBV13	TRBJ2-4
TGTGCCAGCAGCCACCGGACAGGTAACAATGAGCAGTTCTTC	CASSHRTGNNEQFF	TRBV12-4	TRBJ2-1
TGCGCCAGCAGCTTGTCCGAAGGCGGGACAGGGGGCAGATCCGGGGAGCTGTTTTTT	CASSLSEGGTGGRSGELFF	TRBV5-1	TRBJ2-2
TGCGCCAGCGGCGCAACAGGGGGTAATGAAAAACTGTTTTTT	CASGATGGNEKLFF	TRBV10-1	TRBJ1-4
TGTGCCAGCAGCAAAAGGGGGGGAGGGGAGCTGTTTTTT	CASSKRGGGELFF	TRBV5-6	TRBJ2-2
TGTGCCAGTGGGACGCCGGACAGGGGGCGGCTAGCCAAAAACATTCAGTACTTC	CASGTPDRGRLAKNIQYF	TRBV19	TRBJ2-4
TGCGCCAGGTCCGTCCGGCATGAGCAGTTCTTC	CARSVRHEQFF	TRBV5-1	TRBJ2-1
TGTGCCAGCAGAATGAGCAATCAGCCCCAGCATTTT	CASRMSNQPQHF	TRBV6-1	TRBJ1-5
TGTGCCAGCAGTGAGACGGAGATACACATTCAGTACTTC	CASSETEIHIQYF	TRBV25-1	TRBJ2-4
TGTGCCAGCAGCAACCCGCAGGGATTTAACTATGGCTACACCTTC	CASSNPQGFNYGYTF	TRBV25-1	TRBJ1-2
TGTGCCAGCAGCTTATTAGCTCCCAGGGGTAGGGGTCAGCCCCAGCATTTT	CASSLLAPRGRGQPQHF	TRBV7-2	TRBJ1-5
TGTGCCACCAGTGATAGGGGGAATCAGCCCCAGCATTTT	CATSDRGNQPQHF	TRBV24-1	TRBJ1-5
TGTGCCAGCAGCTTACCGACTCGGTCCGGGGGGAGAGCTTTCTTT	CASSLPTRSGGRAFF	TRBV7-4	TRBJ1-1
TGTGCCAGCAGTTACAAGGGAGGGTTGAAGCTGACCTCCTACGAGCAGTACTTC	CASSYKGGLKLTSYEQYF	TRBV6-5	TRBJ2-7
TGTGCCAGCAGCTTAGCGTTTAGCAAGGGGGATAACTATGGCTACACCTTC	CASSLAFSKGDNYGYTF	TRBV7-9	TRBJ1-2
TGTGCCAGCAGCACAGTAGAACGGGATACGCAGTATTTT	CASSTVERDTQYF	TRBV9	TRBJ2-3
TGTGCCAGCAGCCAAGCCTACCCAGGACTAGCGGCACTCTCCTACGAGCAGTACTTC	CASSQAYPGLAALSYEQYF	TRBV4-2	TRBJ2-7
TGTGCCAGCAGCGTAGGTACGACTAGCGGGGGGAAAGCGAACACCGGGGAGCTGTTTTTT	CASSVGTTSGGKANTGELFF	TRBV9	TRBJ2-2
TGTGCCAGCAGCCCGGTAGAAAGGAACACCGGGGAGCTGTTTTTT	CASSPVERNTGELFF	TRBV11-3	TRBJ2-2
TGTGCCATCAGTGAGACTAGGAATGAAGCTTTCTTT	CAISETRNEAFF	TRBV10-3	TRBJ1-1
TGTGCCAGCAGGACGCAGGGGGCCAGGAACACTGAAGCTTTCTTT	CASRTQGARNTEAFF	TRBV13	TRBJ1-1
TGTGCCAGCAGTAAGAGACAAAATCAGCCCCAGCATTTT	CASSKRQNQPQHF	TRBV6-4	TRBJ1-5
TGTGCCAGCAGTTTAGTCCCTGAGCCGGGACACTATGGCTACACCTTC	CASSLVPEPGHYGYTF	TRBV12-3	TRBJ1-2
TGTGCCAGCAGTAGCCCGCGGGAGGTCGGCCATAGGTATGGCTACACCTTC	CASSSPREVGHRYGYTF	TRBV11-2	TRBJ1-2
TGTGCTAGTGGTGGGGAGTCCCCGAACAGGGGAAGCTCCTACGAGCAGTACTTC	CASGGESPNRGSSYEQYF	TRBV12-5	TRBJ2-7
TGCAAGGCGGACGAGCAGTACTTC	CKADEQYF	TRBV20-1	TRBJ2-7
TGCGCCAGCAGCTTCCAACCTGGACATTACGAGCAGTACTTC	CASSFQPGHYEQYF	TRBV5-1	TRBJ2-7
TGTGCCAGCAGATCCAAAGGGGGCCGGAACGAGACCCAGTACTTC	CASRSKGGRNETQYF	TRBV7-2	TRBJ2-5
TGTGCCAGTAGTATCCAGTCTTGTCCAGGTTCAGAGCAGTACTTC	CASSIQSCPGSEQYF	TRBV19	TRBJ2-7
TGTGCTAGTGGTTTGGACAGGGTTAATTCACCCCTCCACTTT	CASGLDRVNSPLHF	TRBV12-5	TRBJ1-6
TGTGGGAAGGACAGGGCAGATACGCAGTATTTT	CGKDRADTQYF	TRBV27	TRBJ2-3
TGTGCCAGCAGCTCTAGGAAACTAGCGGGAGTTGGAGATACGCAGTATTTT	CASSSRKLAGVGDTQYF	TRBV3-1	TRBJ2-3
TGTGCCAGCAGCTTTCCGGGAGGCATGAACACTGAAGCTTTCTTT	CASSFPGGMNTEAFF	TRBV7-6	TRBJ1-1
TGTGCCAGCAGCCGACTGGACAAGTTGGGGAATCAGCCCCAGCATTTT	CASSRLDKLGNQPQHF	TRBV13	TRBJ1-5
TGCGCCAGCCGCCGGACAGGCAAAGCTTTCTTT	CASRRTGKAFF	TRBV10-1	TRBJ1-1
TGTGCCAGCAGGGGCCGGGACAGGATGAACACTGAAGCTTTCTTT	CASRGRDRMNTEAFF	TRBV2	TRBJ1-1
TGTGCCAGCAGCTCTAGGGTTATTGGCTATGGCTACACCTTC	CASSSRVIGYGYTF	TRBV5-6	TRBJ1-2
TGTGCCAGCAGTTTGGACTTGTCCGTCGGCATGAACACTGAAGCTTTCTTT	CASSLDLSVGMNTEAFF	TRBV27	TRBJ1-1
TGCGCCAGCAGTCCATACGAGCAGTACTTC	CASSPYEQYF	TRBV10-2	TRBJ2-7
TGTGCCATCAGTGGCCGGCCGAAAAAACTGTTTTTT	CAISGRPKKLFF	TRBV10-3	TRBJ1-4
TGTGCCAGCAGTACCGACCGGGGGGCCCTGTACAATGAGCAGTTCTTC	CASSTDRGALYNEQFF	TRBV6-8	TRBJ2-1
TGCAGTGCCCGGGGGCACACTGAAGCTTTCTTT	CSARGHTEAFF	TRBV20-1	TRBJ1-1
TGTGCCAGCAGTGACTCGATAGGACAGGGTAGGGCGTCTGGGGCCAACGTCCTGACTTTC	CASSDSIGQGRASGANVLTF	TRBV6-4	TRBJ2-6
TGTGCCAGCAGCGTAGAAGGGGGGCTGCCAGATAGCAATCAGCCCCAGCATTTT	CASSVEGGLPDSNQPQHF	TRBV9	TRBJ1-5
TGTGCCAGCAGCTTCCTTGCCCGACGGGGGGAGCACTTCACCATATATTTT	CASSFLARRGEHFTIYF	TRBV13	TRBJ1-3
TGTGCCAGCAGTCCTAGAGCTATGCAGTTCTTC	CASSPRAMQFF	TRBV28	TRBJ2-1
TGTGCTAGTGGCTGGCAGTCATTCTCTGGAAACACCATATATTTT	CASGWQSFSGNTIYF	TRBV12-5	TRBJ1-3
TGTGCCAGCAGCTGGACGGGGGTTTCTCCTACGAACACCGGGGAGCTGTTTTTT	CASSWTGVSPTNTGELFF	TRBV7-9	TRBJ2-2
TGTGCCAGCAGTTGCCTCCTGCTTATAGGGACCTACGAGCAGTACTTC	CASSCLLLIGTYEQYF	TRBV27	TRBJ2-7
TGTGCCAGCAGCTCAAAACAGGGCAGCTCCTACAATGAGCAGTTCTTC	CASSSKQGSSYNEQFF	TRBV7-9	TRBJ2-1
TGTGCCAGCAGCGTAACCAGATTCAGGGTGAGTATAACAGATACGCAGTATTTT	CASSVTRFRVSITDTQYF	TRBV9	TRBJ2-3
TGTGCCAGCAGTAGAAGGGCATTATCGGAAGTCTCCTACGAGCAGTACTTC	CASSRRALSEVSYEQYF	TRBV28	TRBJ2-7
TGCAGTGCTAGACGGGAAAATGAGCAGTTCTTC	CSARRENEQFF	TRBV20-1	TRBJ2-1
TGTGCCAGCAGCGCTATAAATCGGTTGCAGTACTTC	CASSAINRLQYF	TRBV5-4	TRBJ2-7
TGTGCCAGCAGTTCTATACTAGCGGGAGGCCCTTGTAACGAGCAGTACTTC	CASSSILAGGPCNEQYF	TRBV6-2	TRBJ2-7
TGTGCCAGCCCGACGTGTGAAAAACTGTTTTTT	CASPTCEKLFF	TRBV9	TRBJ1-4
TGTGCCAGCAGCTGGCCAAGGGGACAGGGGTTAAGCATGAACACTGAAGCTTTCTTT	CASSWPRGQGLSMNTEAFF	TRBV7-2	TRBJ1-1
TGTGCCAGCAGCTTAGGGACTAGCGGGGGGGAGACAGATACGCAGTATTTT	CASSLGTSGGETDTQYF	TRBV7-9	TRBJ2-3
TGTGCCAGCACGTCGGGACAGGGGCCGACTGAAGCTTTCTTT	CASTSGQGPTEAFF	TRBV27	TRBJ1-1
TGTGCCAGCATATATTACAGGGTCCCTTGGACTGAAGCTTTCTTT	CASIYYRVPWTEAFF	TRBV11-3	TRBJ1-1
TGCAGTGCTAGGTCTGAGGGCCATACGCAGTATTTT	CSARSEGHTQYF	TRBV20-1	TRBJ2-3
TGTGCCAGCAGTTTTACAGGGGGGTACTATGGCTACACCTTC	CASSFTGGYYGYTF	TRBV6-5	TRBJ1-2
TGCAGTGCTAGAGGTCCAGGCACAGATACGCAGTATTTT	CSARGPGTDTQYF	TRBV20-1	TRBJ2-3
TGTGCCAGCAGCCTCATCCAGGGGGCAGGTAATCAGCCCCAGCATTTT	CASSLIQGAGNQPQHF	TRBV6-4	TRBJ1-5
TGTGCCACCACGAAAGACAGGGGAGGCTACGAGCAGTACTTC	CATTKDRGGYEQYF	TRBV24-1	TRBJ2-7
TGTGCCAGTACCGGGACAGGCAGCCGAGCTGAAGCTTTCTTT	CASTGTGSRAEAFF	TRBV19	TRBJ1-1
TGTGCCAGCAGCTGGACGGGGTGCTCATTCGAAAAACTGTTTTTT	CASSWTGCSFEKLFF	TRBV7-9	TRBJ1-4
TGTGCCAGCTCACCAAAACCATGGGGGCGGGGCACTGAAGCTTTCTTT	CASSPKPWGRGTEAFF	TRBV18	TRBJ1-1
TGCAGTGCTAGAGATCAGTCGGGACGAGGACAGAACAATGAGCAGTTCTTC	CSARDQSGRGQNNEQFF	TRBV20-1	TRBJ2-1
TGTGCCAGCAGTGAATATGGTTCAGTGGACGAAAAACTGTTTTTT	CASSEYGSVDEKLFF	TRBV25-1	TRBJ1-4
TGTGCCAGCCCTGCGGCAGGGGTCCTCCTGAATGAGACCCAGTACTTC	CASPAAGVLLNETQYF	TRBV2	TRBJ2-5
TGTGCCAGCAGCTTCATGATGCCACAAGCTAACTATGGCTACACCTTC	CASSFMMPQANYGYTF	TRBV5-4	TRBJ1-2
TGTGCCAGCAGTGGGAAAAGGACTAGCGGGACAGACGACAATGAGCAGTTCTTC	CASSGKRTSGTDDNEQFF	TRBV27	TRBJ2-1
TGTGCCAGCAGCGGACTTAACACTGAAGCTTTCTTT	CASSGLNTEAFF	TRBV2	TRBJ1-1
TGTGCCAGCAGAGGTCGGAATCAGCCCCAGCATTTT	CASRGRNQPQHF	TRBV28	TRBJ1-5
TGTGCCACCAGCAGAGATTTGCCAGAGGATGACAGGGCCCATCAGCCCCAGCATTTT	CATSRDLPEDDRAHQPQHF	TRBV15	TRBJ1-5
TGCAGTGCTAGTTTGCAGGGGGTTCAAAGATCCCCCACAGATACGCAGTATTTT	CSASLQGVQRSPTDTQYF	TRBV20-1	TRBJ2-3
TGTGCCTGGATACTAGCGGGGAATGGGGTTCAGTATTTT	CAWILAGNGVQYF	TRBV30	TRBJ2-3
TGCGCCAGCAGACTCGGGACAGTTGCTCAGCATTTT	CASRLGTVAQHF	TRBV10-1	TRBJ1-5
TGTGCTAGTGGTTTGGGTTACGAACAGGGGGCGGCGGGCTCTGAAGCTTTCTTT	CASGLGYEQGAAGSEAFF	TRBV12-5	TRBJ1-1
TGTGCCAGCTCACATCAGGGGGCGGTTCGGTATGGCTACACCTTC	CASSHQGAVRYGYTF	TRBV18	TRBJ1-2
TGTGCCACCAGTGACCCAGGGAGGGTTTATATACACTATGGCTACACCTTC	CATSDPGRVYIHYGYTF	TRBV24-1	TRBJ1-2
TGTGCCAGCAGCCTCAACTTGCCGAGATCCAAAAACATTCAGTACTTC	CASSLNLPRSKNIQYF	TRBV7-2	TRBJ2-4
TGCGCCAGCAGCAGCAGTGCGGGAGCCGGGGAGCTGTTTTTT	CASSSSAGAGELFF	TRBV5-1	TRBJ2-2
TGTGCCAGCAGTGGCAACCCTCCGCCCTACGAGCAGTACTTC	CASSGNPPPYEQYF	TRBV6-4	TRBJ2-7
TGTGGACACTCTCTAGCCAAAAACATTCAGTACTTC	CGHSLAKNIQYF	TRBV6-5	TRBJ2-4
TGCGCCAGCAGTGAGCTGGGGGGCGGCTATGGCTACACCTTC	CASSELGGGYGYTF	TRBV10-1	TRBJ1-2
TGCGCCAGCAAAGAGGGGACTAACGCCGGCTACGAGCAGTACTTC	CASKEGTNAGYEQYF	TRBV5-1	TRBJ2-7
TGTGCCAGCAGCTTAACCCCCCACAGGGGCGATCGAGAGACCCAGTACTTC	CASSLTPHRGDRETQYF	TRBV11-3	TRBJ2-5
TGTGCCAGCAGCAAACAGCGGAGGGGGGGCCCCAATGAGCAGTTCTTC	CASSKQRRGGPNEQFF	TRBV7-6	TRBJ2-1
TGTGCCAGACCGGGACAGGACGATGGCTACACCTTC	CARPGQDDGYTF	TRBV10-3	TRBJ1-2
TGTGCCAGCTCACCAAAATCGAACAGGGGGGGGGCCAACGTCCTGACTTTC	CASSPKSNRGGANVLTF	TRBV18	TRBJ2-6
TGCAGTGCTAGAACAGAAGGCGAGGAAACAGGTAATGAAAAACTGTTTTTT	CSARTEGEETGNEKLFF	TRBV20-1	TRBJ1-4
TGTGCCAGCAGTTTCAGCGGGAGTATGAGCTACGAGCAGTACTTC	CASSFSGSMSYEQYF	TRBV27	TRBJ2-7
TGTGCCAGCAGTGAACTACACCGGGAGGTTACCACGAAGAACACTGAAGCTTTCTTT	CASSELHREVTTKNTEAFF	TRBV6-1	TRBJ1-1
TGTGCCAGCAGCTTACCACTGCTCGCAACTAATGAAAAACTGTTTTTT	CASSLPLLATNEKLFF	TRBV7-3	TRBJ1-4
TGCGCCAGCAGCTTGGATCCAAGGACAAAACGGTACAATGAGCAGTTCTTC	CASSLDPRTKRYNEQFF	TRBV5-1	TRBJ2-1
TGTGCCAGCAGTTCATTAGAGGACAGCAATCAGCCCCAGCATTTT	CASSSLEDSNQPQHF	TRBV6-4	TRBJ1-5
TGTGCCAGCAGCTTTAAAGTCGTCGCTTTCTTT	CASSFKVVAFF	TRBV11-2	TRBJ1-1
TGTGCCAGCAGCCCCACAGGGACCACCGGGGAGCTGTTTTTT	CASSPTGTTGELFF	TRBV3-1	TRBJ2-2
TGTGCCAGCAGTTACCCGGGACCTGCGATGAACACTGAAGCTTTCTTT	CASSYPGPAMNTEAFF	TRBV6-5	TRBJ1-1
TGTGCCAGCAGCAGGGACAGGGTCCGCTGTCTGAACACTGAAGCTTTCTTT	CASSRDRVRCLNTEAFF	TRBV7-7	TRBJ1-1
TGTGCCAGCAGTTTAGGAGCGTCTGGAAACACCATATATTTT	CASSLGASGNTIYF	TRBV27	TRBJ1-3
TGCGCCAGCAGTGATCCTGACAGGGAAAGATGCTACGAGCAGTACTTC	CASSDPDRERCYEQYF	TRBV10-1	TRBJ2-7
TGCGCCAGCAGTGATGTCTACGGGCCGACAAGCTCCTACAATGAGCAGTTCTTC	CASSDVYGPTSSYNEQFF	TRBV10-1	TRBJ2-1
TGTGCCAGCAGTACCCACCGGTTCGATACGCAGTATTTT	CASSTHRFDTQYF	TRBV6-2	TRBJ2-3
TGTGCCAGCAAAACTTTCCGGGGCAATGAGCAGTTCTTC	CASKTFRGNEQFF	TRBV7-3	TRBJ2-1
TGTGCCAGCAGCCGGACGGTCAAATACAGCTACGAGCAGTACTTC	CASSRTVKYSYEQYF	TRBV14	TRBJ2-7
TGCAGTGCTAGAGATAAGGACCCCGGGACTAGCGGGAATGAGCAGTTCTTC	CSARDKDPGTSGNEQFF	TRBV20-1	TRBJ2-1
TGTGCCAGCAGCTCAGACCCTAGCTGTGGCACCGGGGAGCTGTTTTTT	CASSSDPSCGTGELFF	TRBV13	TRBJ2-2
TGTGCCAGCAGCTGGAACAGGATATATTGGTTCACAGATACGCAGTATTTT	CASSWNRIYWFTDTQYF	TRBV7-4	TRBJ2-3
TGTGCCAGCAGACACGTAGTCGGGACGAGAGACGAGCAGTACTTC	CASRHVVGTRDEQYF	TRBV14	TRBJ2-7
TGTGGATTAGGGGGGAGGGACTACGAGCAGTACTTC	CGLGGRDYEQYF	TRBV6-4	TRBJ2-7
TGTGCCATCAAAAGGTACAGGGGGCGCGAGAGTTACACTGAAGCTTTCTTT	CAIKRYRGRESYTEAFF	TRBV10-3	TRBJ1-1
TGTGCCAGTCGCCGGGACAGGGGAGGGGATAGCAATCAGCCCCAGCATTTT	CASRRDRGGDSNQPQHF	TRBV27	TRBJ1-5
TGCGCCAGCAGCTCTCGAGTAGCGTATGGCTACACCTTC	CASSSRVAYGYTF	TRBV5-1	TRBJ1-2
TGTGCCAGCAGCCAAGAGCACCACAGGGGCGGGGGCATTCAGTACTTC	CASSQEHHRGGGIQYF	TRBV14	TRBJ2-4
TGTGCCAGCAGCTTCCCTGGGGCCGGCACAGATACGCAGTATTTT	CASSFPGAGTDTQYF	TRBV11-2	TRBJ2-3
TGCGCCAGCAGCTTGGATCTAGCGATAACCAGTTTCCGCACAGATACGCAGTATTTT	CASSLDLAITSFRTDTQYF	TRBV5-1	TRBJ2-3
TGTGCCAGCAGCTTGCAGACTAACTACAATGAGCAGTTCTTC	CASSLQTNYNEQFF	TRBV5-4	TRBJ2-1
TGTGCCATCATTTCTAAAGGGGGCGCGAACACCGGGGAGCTGTTTTTT	CAIISKGGANTGELFF	TRBV19	TRBJ2-2
TGTGCCAGCAGTTACCCCAGGGCCAAAAACATTCAGTACTTC	CASSYPRAKNIQYF	TRBV6-5	TRBJ2-4
TGTGCCAGCAGTGACTCAACCCTAAAGGGGGACGTTTACTACAATGAGCAGTTCTTC	CASSDSTLKGDVYYNEQFF	TRBV6-4	TRBJ2-1
TGTGCCAGCAGCCCCACCGACTGTCGCACAGATACGCAGTATTTT	CASSPTDCRTDTQYF	TRBV7-3	TRBJ2-3
TGTGCCAGCAGCCAAGATATGGGACTAGCGGGGGGGCCCACAGATACGCAGTATTTT	CASSQDMGLAGGPTDTQYF	TRBV14	TRBJ2-3
TGTGCCAGCAGCGTTGGACAGGGCTACGAGCAGTACTTC	CASSVGQGYEQYF	TRBV5-5	TRBJ2-7
TGTGCTAGTGGTGTTCTCTCACTTAACGAGCAGTACTTC	CASGVLSLNEQYF	TRBV12-5	TRBJ2-7
TGCAGCGTTGAAGACCATTGTGACAGACTTTATGGCTACACCTTC	CSVEDHCDRLYGYTF	TRBV29-1	TRBJ1-2
TGTGCCACCAGCAGAGATGAGTTTAGGGGCTTCCTAGTTAGCCGCTACACCTTC	CATSRDEFRGFLVSRYTF	TRBV15	TRBJ1-2
TGTGCCAGCAGCCTGACTAGCGGGGGGGCCGAAGTCCAAGAGACCCAGTACTTC	CASSLTSGGAEVQETQYF	TRBV7-4	TRBJ2-5
TGTGCCAGCACCCACAGGGATGTGATAAGGTGCTACGAGCAGTACTTC	CASTHRDVIRCYEQYF	TRBV6-1	TRBJ2-7
TGTGCCAGCAGCACGGTTTTACGACTTGACACAGATACGCAGTATTTT	CASSTVLRLDTDTQYF	TRBV7-9	TRBJ2-3
TGTGCCAGCAGAAAAAAGGGATGGAGCACCGGGGAGCTGTTTTTT	CASRKKGWSTGELFF	TRBV12-3	TRBJ2-2
TGTGCCAGCAGCCGGCCCCTCGACAGAGGGGAAAAACTGTTTTTT	CASSRPLDRGEKLFF	TRBV7-3	TRBJ1-4
TGCAGTGCTAGGCGTGGAGACTGGATAAAGGAAGCTTTCTTT	CSARRGDWIKEAFF	TRBV20-1	TRBJ1-1
TGCGCCAGCAGCTTGGATCAGCTTGGGCTGATAGAGCAGTACTTC	CASSLDQLGLIEQYF	TRBV5-1	TRBJ2-7
TGTGCCAGCAGTGACTCGACTGTTATTAGGCCCGAACGAAGATCTGAAGCTTTCTTT	CASSDSTVIRPERRSEAFF	TRBV6-4	TRBJ1-1
TGTGCCTGGAGAGCTGGAGAGGTCTTC	CAWRAGEVF	TRBV30	TRBJ2-1
TGTGCCAGCAGTGACCGGCCGGGACGCTACGAGCAGTACTTC	CASSDRPGRYEQYF	TRBV6-4	TRBJ2-7
TGTGCCAGTACAAGCATCAGGGGCACTGAAGCTTTCTTT	CASTSIRGTEAFF	TRBV19	TRBJ1-1
TGCGCCAGCAGCTTGGCGGAGGCATATCAGCCCCAGCATTTT	CASSLAEAYQPQHF	TRBV5-1	TRBJ1-5
TGTGCCAGCAGCCGGTACGAAGGGATCCGATTCACTGAAGCTTTCTTT	CASSRYEGIRFTEAFF	TRBV5-8	TRBJ1-1
TGTGCCAGCAGTTTACCCACTGCCGGGACAGGGATGGACTATGGCTACACCTTC	CASSLPTAGTGMDYGYTF	TRBV27	TRBJ1-2
TGTGCCAGCAGGAGGGGCGACACCGGGGAGCTGTTTTTT	CASRRGDTGELFF	TRBV27	TRBJ2-2
TGTGATCAGAGCAATCAGCCCCAGCATTTT	CDQSNQPQHF	TRBV12-3	TRBJ1-5
TGTGCCAGCAGCCTTGACAGGGGCACCGGGGAGCTGTTTTTT	CASSLDRGTGELFF	TRBV7-9	TRBJ2-2
TGCGCCAGCAGCGGTCCGGGAAACAATGAGCAGTTCTTC	CASSGPGNNEQFF	TRBV5-1	TRBJ2-1
TGTGCCAGCAGCTCAGTTGCTTTGAACTTAATAGCGGGCTGTAGCCCCTACGAGCAGTACTTC	CASSSVALNLIAGCSPYEQYF	TRBV13	TRBJ2-7
TGTGCCAGCTCACCCTGGGACAGGGGCTCCGGCACTGAAGCTTTCTTT	CASSPWDRGSGTEAFF	TRBV18	TRBJ1-1
TGTGCCAGCAGTGGTTACCCCACTTGGAGGGACAGGGGGACAACCACACCTAGCAATCAGCCCCAGCATTTT	CASSGYPTWRDRGTTTPSNQPQHF	TRBV2	TRBJ1-5
TGTCAGGGGAACTCCTACGAGCAGTACTTC	CQGNSYEQYF	TRBV19	TRBJ2-7
TGTGCCAGCAGTCCGGGACAGGGCGGCTACACCTTC	CASSPGQGGYTF	TRBV28	TRBJ1-2
TGTGCCAGTATGTCCGGAGGACAGGATGAAAAACTGTTTTTT	CASMSGGQDEKLFF	TRBV19	TRBJ1-4
TGTGCCAGCCCGTGTAAAGAGACCCAGTACTTC	CASPCKETQYF	TRBV6-5	TRBJ2-5
TGTGCTTTTCCCGGAGCGTATGGCTACACCTTC	CAFPGAYGYTF	TRBV27	TRBJ1-2
TGTGCCAGCAGTATTCAGGAAGCTAACTATGGCTACACCTTC	CASSIQEANYGYTF	TRBV6-2	TRBJ1-2
TGTGCCAGCAGCTTGCATCCCAGACTAGCGGGCACAGATACGCAGTATTTT	CASSLHPRLAGTDTQYF	TRBV5-6	TRBJ2-3
TGTGCCACCTATCAAAGCACAGATACGCAGTATTTT	CATYQSTDTQYF	TRBV24-1	TRBJ2-3
TGTGCCAGCAGCAGTAAAGGGGCGTACAATGAGCAGTTCTTC	CASSSKGAYNEQFF	TRBV14	TRBJ2-1
TGTGCCAGACGGACAGGGGGAAATTCACCCCTCCACTTT	CARRTGGNSPLHF	TRBV9	TRBJ1-6
TGTGCCAGCAGCTACCGCAGGAGGGTGAACACTGAAGCTTTCTTT	CASSYRRRVNTEAFF	TRBV7-3	TRBJ1-1
TGTGCCAGCAGTTTCCGGGACTCGGTCACTAATGAAAAACTGTTTTTT	CASSFRDSVTNEKLFF	TRBV28	TRBJ1-4
TGCGCCAGCAGCTCGGACAGGGTGCAGTTCGCTGGGGCCAACGTCCTGACTTTC	CASSSDRVQFAGANVLTF	TRBV5-1	TRBJ2-6
TGTGCCATCAGTGACGTAGCGGGGGGTGACACCGGGGAGCTGTTTTTT	CAISDVAGGDTGELFF	TRBV10-3	TRBJ2-2
TGTGCCAGCAAAACGGGACAGGGTCGAGGCACTGAAGCTTTCTTT	CASKTGQGRGTEAFF	TRBV6-5	TRBJ1-1
TGCGCCAGCAGCTCGATGGAGGACGAGCAGTACTTC	CASSSMEDEQYF	TRBV4-3	TRBJ2-7
TGTGCCATTGGCGAAGCGGGGGTAGCTTTCTTT	CAIGEAGVAFF	TRBV10-3	TRBJ1-1
TGTGCCAGCAGTTCAAGAGGAAATGAGCAGTTCTTC	CASSSRGNEQFF	TRBV6-2	TRBJ2-1
TGTTTGAACCGAAGCGGGACCTACGAGCAGTACTTC	CLNRSGTYEQYF	TRBV19	TRBJ2-7
TGTGCCAGCAGCCTAGACGGTATGCAGTACTTC	CASSLDGMQYF	TRBV5-4	TRBJ2-7
TGTGCCAGCAGCGTAGGTTGGGACACAGATACGCAGTATTTT	CASSVGWDTDTQYF	TRBV9	TRBJ2-3
TGTGCCAGCTCACCACGATACGGGCAGGGAAATCAGCCCCAGCATTTT	CASSPRYGQGNQPQHF	TRBV18	TRBJ1-5
TGTGTGTGGACTAGCCAATCCTACAATGAGCAGTTCTTC	CVWTSQSYNEQFF	TRBV6-2	TRBJ2-1
TGTGCCAGCAGTCCCGGGCGTTGCGCTTTCTTT	CASSPGRCAFF	TRBV27	TRBJ1-1
TGTGCCAGCAGTTACTCGAAACAATTTGGCAGCGTAGCAACGATAGATAACACCGGGGAGCTGTTTTTT	CASSYSKQFGSVATIDNTGELFF	TRBV6-8	TRBJ2-2
TGTGCCAGAGGACAGCGTAACACTGAAGCTTTCTTT	CARGQRNTEAFF	TRBV6-1	TRBJ1-1
TGTGCCAGCAGCCGGGCGAACACTGAAGCTTTCTTT	CASSRANTEAFF	TRBV12-4	TRBJ1-1
TGCGCCAGCACCTGGACTAGCGGGAGTGGAGCCCAGTACTTC	CASTWTSGSGAQYF	TRBV4-3	TRBJ2-5
TGTGCCTGGAGTTCTTATCAGGGGGGTCCCGATGCGAACACTGAAGCTTTCTTT	CAWSSYQGGPDANTEAFF	TRBV30	TRBJ1-1
TGCAGTGCTAGAGATGCTTTGCCCGGCATCGGGCCCCAGCATTTT	CSARDALPGIGPQHF	TRBV20-1	TRBJ1-5
TGCGCCAGCAGTGACGCAGGATCATGGGACCATCAGCCCCAGCATTTT	CASSDAGSWDHQPQHF	TRBV10-1	TRBJ1-5
TGTGCCAGCAGCTTAATACAGGATGGCGTCTCCTACGAGCAGTACTTC	CASSLIQDGVSYEQYF	TRBV7-3	TRBJ2-7
TGTGCCAGCAGCTTCTACCCACAGGGCGAAGATATTGGCTACACCTTC	CASSFYPQGEDIGYTF	TRBV7-6	TRBJ1-2
TGTGCCAGCAGCTTGGGCCGCAAGAGGCCTGGGGCCAACGTCCTGACTTTC	CASSLGRKRPGANVLTF	TRBV7-9	TRBJ2-6
TGCGCCAGCAGTGATAGGTCGGACAGAGGCTACACCTTC	CASSDRSDRGYTF	TRBV10-1	TRBJ1-2
TGTGCCAGCAGCCAACCCCGTGGACAGGGCTACGAGCAGTACTTC	CASSQPRGQGYEQYF	TRBV9	TRBJ2-7
TGTGCCGAACAGAAATCCTATAATTCACCCCTCCACTTT	CAEQKSYNSPLHF	TRBV6-5	TRBJ1-6
TGTGCCAGCCGGGGAGAATGCTACGAGCAGTACTTC	CASRGECYEQYF	TRBV28	TRBJ2-7
TGTGCCACCAGCAGAGATGATGCAGGTCGCAGGAACACTGAAGCTTTCTTT	CATSRDDAGRRNTEAFF	TRBV15	TRBJ1-1
TGTGCCAGCAGCTTAGAGGGGCGGTTCTATGGCTACACCTTC	CASSLEGRFYGYTF	TRBV11-2	TRBJ1-2
TGTGCCAGCAGTTTCTGGTGGGGTTCCCGTGCCTACGAGCAGTACTTC	CASSFWWGSRAYEQYF	TRBV28	TRBJ2-7
TGTGCCAGCAGCATACACGGTAGGTTCTCCTACAATGAGCAGTTCTTC	CASSIHGRFSYNEQFF	TRBV7-9	TRBJ2-1
TGCGCCAGCAGTGGCTATAAGGGACAGCCGAGCACAGATACGCAGTATTTT	CASSGYKGQPSTDTQYF	TRBV10-1	TRBJ2-3
TGTGCCAGCAACCCGGGGGACCCGACTTTCTTT	CASNPGDPTFF	TRBV2	TRBJ1-1
TGCGCCAGCAGCGTCCGGGACAGGGCGCACACCGGGGAGCTGTTTTTT	CASSVRDRAHTGELFF	TRBV5-1	TRBJ2-2
TGTGCCAGCATCTCAAGGGGTACTAACTATGGCTACACCTTC	CASISRGTNYGYTF	TRBV6-4	TRBJ1-2
TGTGCCAGCAGCCCAGGACGGTATCGGAATGCTAACTATGGCTACACCTTC	CASSPGRYRNANYGYTF	TRBV7-9	TRBJ1-2
TGTGCCATACGTAGTTACAATGAGCAGTTCTTC	CAIRSYNEQFF	TRBV14	TRBJ2-1
TGTGCCAGCAGCCAAGATGAACAGGGAGGCCAAGAGACCCAGTACTTC	CASSQDEQGGQETQYF	TRBV3-1	TRBJ2-5
TGTGCCAGCAGCGTAGTGAAGGGCCATGAATCCAGGCGCATCCGGGCTTTCTTT	CASSVVKGHESRRIRAFF	TRBV9	TRBJ1-1
TGTGCCAGCAGTGACGGGGCGGATAGCAATCAGCCCCAGCATTTT	CASSDGADSNQPQHF	TRBV6-1	TRBJ1-5
TGTGCCAGTAGTATCTCAAAATATTCACCCCTCCACTTT	CASSISKYSPLHF	TRBV19	TRBJ1-6
TGTGCCAGCAGTTTAGGTAGGACTAGGGGTGATGAGCAGTTCTTC	CASSLGRTRGDEQFF	TRBV28	TRBJ2-1
TGTGCCAGCAGTGAATGTTTGTCCCTCCGGGGCACCCCAGTAACTGAAGCTTTCTTT	CASSECLSLRGTPVTEAFF	TRBV25-1	TRBJ1-1
TGTGCCAGCAGTTTAAAAAAGCAGGGAAATCAGCCCCAGCATTTT	CASSLKKQGNQPQHF	TRBV27	TRBJ1-5
TGTGCCAGCAGAGGGCAGACAGGGGGCTCGGGCTACACCTTC	CASRGQTGGSGYTF	TRBV27	TRBJ1-2
TGTGCCAGCAGAATGGGGGCCGGGGCACAGTTCTACGAGCAGTACTTC	CASRMGAGAQFYEQYF	TRBV7-9	TRBJ2-7
TGTGTCTCATTAAATTACACTGAAGCTTTCTTT	CVSLNYTEAFF	TRBV6-4	TRBJ1-1
TGTGCCAGCAGTCGCAGGCGAACCAGGGTGGGTAGCAATCAGCCCCAGCATTTT	CASSRRRTRVGSNQPQHF	TRBV27	TRBJ1-5
TGTGCCAGCAGCTTGTTATGGTGGGTTGGCTACACCTTC	CASSLLWWVGYTF	TRBV5-5	TRBJ1-2
TGTGCCAGCAGCCCACGAAGGGTCACAGGGGGCCCGGGGGGCACAGATACGCAGTATTTT	CASSPRRVTGGPGGTDTQYF	TRBV13	TRBJ2-3
TGTGCCAGCAGCGTTACTCTCGCTACAGATACGCAGTATTTT	CASSVTLATDTQYF	TRBV5-6	TRBJ2-3
TGTGCCAGCAGCGCATACCGACTGGAGGGTCAGCCCCAGCATTTT	CASSAYRLEGQPQHF	TRBV13	TRBJ1-5
TGTGCCAGCCGCCAACAGGGGGCACAGGTCCTTCCAAGGAGGATATATGGCTACACCTTC	CASRQQGAQVLPRRIYGYTF	TRBV6-3	TRBJ1-2
TGCGCCAGCAGCCAAGATGGGAGCCCCTCTCACGAGCAGTACTTC	CASSQDGSPSHEQYF	TRBV4-3	TRBJ2-7
TGTGCCAGCAGCCAGGGGCCCGCTGTTGAGCAGTACTTC	CASSQGPAVEQYF	TRBV7-3	TRBJ2-7
TGTGCCAGCAGCCAAGATTGGGACGTCGAGGTACATAGCAATCAGCCCCAGCATTTT	CASSQDWDVEVHSNQPQHF	TRBV14	TRBJ1-5
TGCAGTGGTGGGAGGGTGGGATTCGGCGCTGGGGCCAACGTCCTGACTTTC	CSGGRVGFGAGANVLTF	TRBV20-1	TRBJ2-6
TGTGCCAGCAGCGTACCGGGACTAGCGGGAGAAGGGGAGAATGAGCAGTTCTTC	CASSVPGLAGEGENEQFF	TRBV9	TRBJ2-1
TGTGCCACCAGTGATTTCCCTCGGTTAGAATCATACGAGCAGTACTTC	CATSDFPRLESYEQYF	TRBV24-1	TRBJ2-7
TGTGAAAGTGACCGCAATGAGCAGTTCTTC	CESDRNEQFF	TRBV9	TRBJ2-1
TGTGCCAGCAGCGCCACCGAAAGCCCAGTTGAGACCCAGTACTTC	CASSATESPVETQYF	TRBV13	TRBJ2-5
TGTGCCAGCAGCTTAGGGACAGGGGGCCGGGTCAAAAACATTCAGTACTTC	CASSLGTGGRVKNIQYF	TRBV5-4	TRBJ2-4
TGTGCCACCAGTGATCCGCACAGAGATGATCAGCCCCAGCATTTT	CATSDPHRDDQPQHF	TRBV24-1	TRBJ1-5
TGCAGCGCGAATGGGACAGGGCAAACGAATCAGCCCCAGCATTTT	CSANGTGQTNQPQHF	TRBV29-1	TRBJ1-5
TGTGCCAGCAGTGGGCCGACAGGGGGCAATTCACCCCTCCACTTT	CASSGPTGGNSPLHF	TRBV6-1	TRBJ1-6
TGTGCCAGCGCAGGGGGCTATAGCAATCAGCCCCAGCATTTT	CASAGGYSNQPQHF	TRBV7-6	TRBJ1-5
TGTGCCAGCAGATTGGGACATGGCTACACCTTC	CASRLGHGYTF	TRBV6-5	TRBJ1-2
TGTGCCAGCAGCTGGGGTGGCCTTGACCATACCTACGAGCAGTACTTC	CASSWGGLDHTYEQYF	TRBV7-9	TRBJ2-7
TGCGCCAGCAGCGGAGGGGCCTTACGGACCAATCAGCCCCAGCATTTT	CASSGGALRTNQPQHF	TRBV10-1	TRBJ1-5
TGTGCCAGCAGCTTAGGTAGGGACAGGGGGAGAATCGGCACAGATACGCAGTATTTT	CASSLGRDRGRIGTDTQYF	TRBV11-3	TRBJ2-3
TGCGCCTTACCCCGACTAGCGGGGGGGCCAATCTCCGGGGAGCTGTTTTTT	CALPRLAGGPISGELFF	TRBV10-1	TRBJ2-2
TGTGCCAGCAGCATGGCGGGAGCCAAAGCAGAGGGAGAGACCCAGTACTTC	CASSMAGAKAEGETQYF	TRBV13	TRBJ2-5
TGTGCCAGTAGTATAGTCGGGGGGGGGGTACCTCATGAGCAGTTCTTC	CASSIVGGGVPHEQFF	TRBV19	TRBJ2-1
TGCAGTGCTAGAGTACAGGATATGCTAGCGGGTTGCAATGAGCAGTTCTTC	CSARVQDMLAGCNEQFF	TRBV20-1	TRBJ2-1
TGTGCCAGCAGTTACCGGGGCCGAGGCTCGGCCAAAAACATTCAGTACTTC	CASSYRGRGSAKNIQYF	TRBV6-5	TRBJ2-4
TGCAGTGCTAGAGATACGGGCCTCGGCTCTGGGGCCAACGTCCTGACTTTC	CSARDTGLGSGANVLTF	TRBV20-1	TRBJ2-6
TGTGCCAGCAGCTTGGTAAGTCCATCTAGGCCTGAAGACGAGCAGTACTTC	CASSLVSPSRPEDEQYF	TRBV5-6	TRBJ2-7
TGTGCCTTGCCCCCCTCCACAGGGGGGGGCTACGAGCAGTACTTC	CALPPSTGGGYEQYF	TRBV30	TRBJ2-7
TGTGCCAGCAGCGCGTTGCCGGGACTCGGGGAGCTGTTTTTT	CASSALPGLGELFF	TRBV7-2	TRBJ2-2
TGTGCCAGCAGTAGGGAGAGCGGGAAATTGAACACTGAAGCTTTCTTT	CASSRESGKLNTEAFF	TRBV12-3	TRBJ1-1
TGTGCCACCAGCAGAGATGAGGGGGGTGGCTACACCTTC	CATSRDEGGGYTF	TRBV15	TRBJ1-2
TGTGCCAGCAGCCCGGGGCCATCTGGAAACACCATATATTTT	CASSPGPSGNTIYF	TRBV5-8	TRBJ1-3
TGCGCCAGCAGCGGGGAAGGCAATCAGCCCCAGCATTTT	CASSGEGNQPQHF	TRBV5-1	TRBJ1-5
TGTGCCAGCAGTGGGATGACATCCTGTCAGCCCCAGCATTTT	CASSGMTSCQPQHF	TRBV12-3	TRBJ1-5
TGTGCCAGCAGTTTTTCGGGGGCCAGGGCCACTGAAGCTTTCTTT	CASSFSGARATEAFF	TRBV27	TRBJ1-1
TGTGCCAGCAGTTTGAACGGGGGGGGCCGGGGGTACGAGCAGTACTTC	CASSLNGGGRGYEQYF	TRBV12-3	TRBJ2-7
TGTGCCAGCAGTTTACCCTTGAGCCCAACCGGGGGAAATGAGCAGTTCTTC	CASSLPLSPTGGNEQFF	TRBV28	TRBJ2-1
TGCAGCGTTCCCCAAACTAGCGGGAGGTTCTACGAGCAGTACTTC	CSVPQTSGRFYEQYF	TRBV29-1	TRBJ2-7
TGCGCCAGCAGCGTGTATGGGTCGGGCAATCAGCCCCAGCATTTT	CASSVYGSGNQPQHF	TRBV4-1	TRBJ1-5
TGTGCCAGCAGTTACGGAATTGGGGAAGGTTACAATGAGCAGTTCTTC	CASSYGIGEGYNEQFF	TRBV6-5	TRBJ2-1
TGCAGTGCTACCAAGGGGGGTACGCCCCAGCATTTT	CSATKGGTPQHF	TRBV20-1	TRBJ1-5
TGTGCCAGCGCCCTTCGGGTTAACCTAGCAACAGATACGCAGTATTTT	CASALRVNLATDTQYF	TRBV6-5	TRBJ2-3
TGTGCCAGCAAAGAGGGGGGCACCGGGGAGCTGTTTTTT	CASKEGGTGELFF	TRBV6-1	TRBJ2-2
TGCGCCAGCAGTGAGCCGAGGGATTTGGATAATGAAAAACTGTTTTTT	CASSEPRDLDNEKLFF	TRBV10-1	TRBJ1-4
TGTGCCAGCAGTTTAGGCAGGGGGGGGGACAGCAATCAGCCCCAGCATTTT	CASSLGRGGDSNQPQHF	TRBV12-3	TRBJ1-5
TGCGCCAGCAGCTTGCTGACAAGGTATAGCAATCAGCCCCAGCATTTT	CASSLLTRYSNQPQHF	TRBV5-1	TRBJ1-5
TGTGCCAGCGTGACAGGGCTCAACGAGCAGTACTTC	CASVTGLNEQYF	TRBV9	TRBJ2-7
TGTGCCAGCAGTAATGAACAGGCCGGGACCCAGGCAGCTTTCTTT	CASSNEQAGTQAAFF	TRBV12-4	TRBJ1-1
TGTGCCAGCAGTGAGTCGGGACTAGCGGGCTACGAGCAGTACTTC	CASSESGLAGYEQYF	TRBV6-1	TRBJ2-7
TGTGCCACCATGACAGGTTGCCTTAATGAAAAACTGTTTTTT	CATMTGCLNEKLFF	TRBV24-1	TRBJ1-4
TGTGCCAGCAGTTACCGAGATCCGGGGGCGCCGGAGACCCAGCATTTT	CASSYRDPGAPETQHF	TRBV6-5	TRBJ1-5
TGTGCCAGCAGTTATAACCCACTGCAGGGCGGGCATGAAAAACTGTTTTTT	CASSYNPLQGGHEKLFF	TRBV6-6	TRBJ1-4
TGTGCCAGTCCGGACAGGTTGAACACTGAAGCTTTCTTT	CASPDRLNTEAFF	TRBV27	TRBJ1-1
TGTGCCAGCAGCCAAGTGGGGACAGGGGCCCTTAAAAAAGCTTTCTTT	CASSQVGTGALKKAFF	TRBV14	TRBJ1-1
TGCAGTGCTCCCATGGGGGGGACTACCTTAAATGAGCAGTTCTTC	CSAPMGGTTLNEQFF	TRBV20-1	TRBJ2-1
TGTGCCAGCAGCCTGACTAGCGGGGATACGCAGTATTTT	CASSLTSGDTQYF	TRBV7-6	TRBJ2-3
TGCGCCAGCAGCTTGGGATGGACAGGGACTGTGGCCACAGATACGCAGTATTTT	CASSLGWTGTVATDTQYF	TRBV5-1	TRBJ2-3
TGTGCCAGCAGCCCAGAAGCGGGAATGCCCGGGGAGCTGTTTTTT	CASSPEAGMPGELFF	TRBV7-3	TRBJ2-2
TGCAGTCCTCCCGAGCAGGGGGCAATAGGAAACACCATATATTTT	CSPPEQGAIGNTIYF	TRBV20-1	TRBJ1-3
TGTGCCAGCAGCTTATCTTGCCGCCAGGGCCCGAACACTGAAGCTTTCTTT	CASSLSCRQGPNTEAFF	TRBV11-3	TRBJ1-1
TGTGCCACCACGACTAGGGATCGGGATGAGCAGTTCTTC	CATTTRDRDEQFF	TRBV24-1	TRBJ2-1
TGTGCCAGCAGCTCTGGAATCTCGGGGGGGGCTTACAATGAGCAGTTCTTC	CASSSGISGGAYNEQFF	TRBV13	TRBJ2-1
TGTGCCAGCAGCCGGAACAGGGGAAATGGCTACACCTTC	CASSRNRGNGYTF	TRBV14	TRBJ1-2
TGTGCCTCTGGGCGACGCCACGAGCAGTACTTC	CASGRRHEQYF	TRBV5-5	TRBJ2-7
TGTGCCAGCACGGATCTAGGCCGGGACATTAGAGCTCACTCTGGAAACACCATATATTTT	CASTDLGRDIRAHSGNTIYF	TRBV5-6	TRBJ1-3
TGTGCCAGCAGCACCGTAGAGGGGGACTCCTGCAGCTCTGGAAACACCATATATTTT	CASSTVEGDSCSSGNTIYF	TRBV7-2	TRBJ1-3
TGCAGTGCTCTGGGGGGACGAATTGAGACCCAGTACTTC	CSALGGRIETQYF	TRBV20-1	TRBJ2-5
TGCAGTGCTAGGGACGTGGATCCGAACACTGAAGCTTTCTTT	CSARDVDPNTEAFF	TRBV20-1	TRBJ1-1
TGTGGCGGGGGGCCTCCGAATCAGCCCCAGCATTTT	CGGGPPNQPQHF	TRBV5-4	TRBJ1-5
TGTGCCAGTGAGCGGGAGCCTGAGACCCAGTACTTC	CASEREPETQYF	TRBV10-3	TRBJ2-5
TGTGCCAGCAGCTTCCGACAGAGTTCTGAAGCTTTCTTT	CASSFRQSSEAFF	TRBV7-9	TRBJ1-1
TGCAGTGCTAGCAGGGCAGACAATGAAAAACTGTTTTTT	CSASRADNEKLFF	TRBV20-1	TRBJ1-4
TGCAGTGCTAGAGCTCGGGGGGGCGAAAACAATGAGCAGTTCTTC	CSARARGGENNEQFF	TRBV20-1	TRBJ2-1
TGTGCCAGCAGTAGGACAGGGCCCCTATCAGATACGCAGTATTTT	CASSRTGPLSDTQYF	TRBV6-5	TRBJ2-3
TGTGCCGTGCCCATCAGGGGTGAAATGAACACTGAAGCTTTCTTT	CAVPIRGEMNTEAFF	TRBV10-3	TRBJ1-1
TGTGCCAGCAGCTCTCCGCCCCCCCCGAGGTTACCTACGCAGTATTTT	CASSSPPPPRLPTQYF	TRBV13	TRBJ2-3
TGCAGTGCCCAGTGGAACACTGAAGCTTTCTTT	CSAQWNTEAFF	TRBV20-1	TRBJ1-1
TGTGCCAGCAGCCAGGGGGGCAATCAGCCCCAGCATTTT	CASSQGGNQPQHF	TRBV7-2	TRBJ1-5
TGTGCCAGCACAGGGGCTACCTACGAGCAGTACTTC	CASTGATYEQYF	TRBV7-8	TRBJ2-7
TGTGCCACCAGTGATTTGGGACAGTACCAAGAGACCCAGTACTTC	CATSDLGQYQETQYF	TRBV24-1	TRBJ2-5
TGTGCTAGTGGTTTGCGTCCGACAGGGCCCCTCGAGTGGGGCTACACCTTC	CASGLRPTGPLEWGYTF	TRBV12-5	TRBJ1-2
TGTGCCAGCAGCCCAAATAGCTCCCCAGAGACCCAGTACTTC	CASSPNSSPETQYF	TRBV13	TRBJ2-5
TGTGCCAGCAGCTTAGGACGGGCAGAAGACGAGCAGTACTTC	CASSLGRAEDEQYF	TRBV7-3	TRBJ2-7
TGTGCCAGCAGCCGGGACAGGCGGGGGAGCAATCAGCCCCAGCATTTT	CASSRDRRGSNQPQHF	TRBV7-3	TRBJ1-5
TGTGCCAGCAAATCACCTGGGGCCGTATCCCAAGAGACCCAGTACTTC	CASKSPGAVSQETQYF	TRBV5-4	TRBJ2-5
TGTGCCAGCAGTTTAGGTCCCTGGGGAGAGACCCAGTACTTC	CASSLGPWGETQYF	TRBV12-4	TRBJ2-5
TGTGCCAGCAGCTTGCGGCCTTGCTCCTACGAGCAGTACTTC	CASSLRPCSYEQYF	TRBV11-3	TRBJ2-7
TGTGCCAGCAGCTTAAACCAGGGGGCGGTGTATAGCAATCAGCCCCAGCATTTT	CASSLNQGAVYSNQPQHF	TRBV11-3	TRBJ1-5
TGTGCCAGCAGCCAAGCCCTTAGCGGGGACAGGGAGACCCAGTACTTC	CASSQALSGDRETQYF	TRBV3-1	TRBJ2-5
TGTGCCAGCAGCCAAGATGATAGTTTAGAACGGGGGACGGGGATGAACACTGAAGCTTTCTTT	CASSQDDSLERGTGMNTEAFF	TRBV14	TRBJ1-1
TGTGCCAGCAGCGCCACAGGGGGCCATGAGGAGACCCAGTACTTC	CASSATGGHEETQYF	TRBV6-3	TRBJ2-5
TGTGCCAGCAGTATGACTAGCGGGGGGGCGGATATCGACAATGAGCAGTTCTTC	CASSMTSGGADIDNEQFF	TRBV6-1	TRBJ2-1
TGTGCCAGCAGCCTGCAGGGGGGACGCCACACCATATATTTT	CASSLQGGRHTIYF	TRBV13	TRBJ1-3
TGTGCCAGCAGCGCTCAGGGGCCGGTCTACACTGAAGCTTTCTTT	CASSAQGPVYTEAFF	TRBV9	TRBJ1-1
TGTGCCAGCAGCCAAGAACGACAGGGAGAGGGCAATCAGCCCCAGCATTTT	CASSQERQGEGNQPQHF	TRBV3-1	TRBJ1-5
TGTGCCAGCAGGGGGACAGAAAATCAGCCCCAGCATTTT	CASRGTENQPQHF	TRBV6-2	TRBJ1-5
TGTGCCAGCAGCAAGGGGGGGCATTCACCCCTCCACTTT	CASSKGGHSPLHF	TRBV5-4	TRBJ1-6
TGTGCCAGCAGCTCCCCATCGGGGCTATACTACAATGAGCAGTTCTTC	CASSSPSGLYYNEQFF	TRBV7-4	TRBJ2-1
TGTGCCAGCAGCTTTAGGGGAATCGGGGACACTGAAGCTTTCTTT	CASSFRGIGDTEAFF	TRBV5-4	TRBJ1-1
TGTGCCAGTAGTGGGCTCCCGGGGACTAACAATGAGCAGTTCTTC	CASSGLPGTNNEQFF	TRBV19	TRBJ2-1
TGTGCCAGCACATCGTATAATGGACAGACCCCCACAAAACTGTTTTTT	CASTSYNGQTPTKLFF	TRBV6-5	TRBJ1-4
TGTGCCAGCAGATCCAGGGCCCGGTTGTGGGATACGCAGTATTTT	CASRSRARLWDTQYF	TRBV7-9	TRBJ2-3
TGTGCCAGCAGCTTAGAGATACAGGGTCGGAAGAGCTCCTATAATTCACCCCTCCACTTT	CASSLEIQGRKSSYNSPLHF	TRBV11-3	TRBJ1-6
TGTGCCACCGGAACTAGCGGGAAATACAATGAGCAGTTCTTC	CATGTSGKYNEQFF	TRBV24-1	TRBJ2-1
TGTGCCAGCACGGTCCGGGACTACAGCACAGATACGCAGTATTTT	CASTVRDYSTDTQYF	TRBV13	TRBJ2-3
TGCGCCAGCAGCTCCGGGGTGGTCAATCAGCCCCAGCATTTT	CASSSGVVNQPQHF	TRBV5-1	TRBJ1-5
TGTGCCAGCATTACCACTAGCGGGAGTAATCAGCCCCAGCATTTT	CASITTSGSNQPQHF	TRBV2	TRBJ1-5
TGTGCCAGCAGTTTCCCCGGGACAAGGAGTGGTCAGCCCCAGCATTTT	CASSFPGTRSGQPQHF	TRBV27	TRBJ1-5
TGTGGACGAGGGGAGGACGGCTACGAGCAGTACTTC	CGRGEDGYEQYF	TRBV2	TRBJ2-7
TGTGCCAGCAGCGTAGGGGGGACCCTAGGCCTGGGAGGCTACACCTTC	CASSVGGTLGLGGYTF	TRBV9	TRBJ1-2
TGTGCCAGCAGCGCCCCCGGGACAGGGGTTGGGTCGGGCTACACCTTC	CASSAPGTGVGSGYTF	TRBV13	TRBJ1-2
TGCGCCAGCAGCTTGACCGACGGGAATCCGGGTTCTGGAAACACCATATATTTT	CASSLTDGNPGSGNTIYF	TRBV5-1	TRBJ1-3
TGTGCCAGCAGCTTCCACAGGGGGAGCAATCAGCCCCAGCATTTT	CASSFHRGSNQPQHF	TRBV11-2	TRBJ1-5
TGTGCCACCAGGTTGGAACTAGCGGGAGCACCAGTCAATCAGCCCCAGCATTTT	CATRLELAGAPVNQPQHF	TRBV24-1	TRBJ1-5
TGTGCCAGCGTGACAGTTTCTCAGCCCCAGCATTTT	CASVTVSQPQHF	TRBV5-6	TRBJ1-5
TGTGCCAGCAGCCAAGCTATACCTCAGACAGGGTATGACACTGAAGCTTTCTTT	CASSQAIPQTGYDTEAFF	TRBV4-2	TRBJ1-1
TGCGCCAGCAGCTTGGGCGGACCAACCAGGACCTACGAGCAGTACTTC	CASSLGGPTRTYEQYF	TRBV5-1	TRBJ2-7
TGTGCCAGCAGCTTGGCCCCGGATAGAGGGGACGAGCAGTACTTC	CASSLAPDRGDEQYF	TRBV5-4	TRBJ2-7
TGCAGTGCTAGAGAAACCCTTCGGACAGGGGTTGGTGAGCTTGGCTACACCTTC	CSARETLRTGVGELGYTF	TRBV20-1	TRBJ1-2
TGTGCCAGCAAAACAGACTACGAGCAGTACTTC	CASKTDYEQYF	TRBV6-4	TRBJ2-7
TGTGCCAGCAGCGCAGGGCGGAATTCACCCCTCCACTTT	CASSAGRNSPLHF	TRBV7-3	TRBJ1-6
TGTGCCAGCAGCTCAAGTAGAGGGATACGAGATACGCAGTATTTT	CASSSSRGIRDTQYF	TRBV5-6	TRBJ2-3
TGTGCCAGCAGTGCGCGTAGTAACTATGGCTACACCTTC	CASSARSNYGYTF	TRBV27	TRBJ1-2
TGTGCCACCCGAGCAGCGACGGATCAGCCCCAGCATTTT	CATRAATDQPQHF	TRBV2	TRBJ1-5
TGCAGTGCTAGGCGAATCCATCGTCACAATCATGGGAATTCACCCCTCCACTTT	CSARRIHRHNHGNSPLHF	TRBV20-1	TRBJ1-6
TGTGCCAGCAGCTCGGGACTAGCGGGTTGGGAGACCCAGTACTTC	CASSSGLAGWETQYF	TRBV2	TRBJ2-5
TGTGCCAGCAGCTTGGCCGGGACAGGGGGAGATTACACTGAAGCTTTCTTT	CASSLAGTGGDYTEAFF	TRBV5-6	TRBJ1-1
TGTGCCAGCAGTTTATACACAACCCGAGCTAACTATGGCTACACCTTC	CASSLYTTRANYGYTF	TRBV28	TRBJ1-2
TGTGCCAGCAGCCAAGAAAAGGTCCAGGGGGGAAACACCATATATTTT	CASSQEKVQGGNTIYF	TRBV14	TRBJ1-3
TGTGCCACATGGGAAGGGGGGGGTGTCCACGAGCAGTACTTC	CATWEGGGVHEQYF	TRBV24-1	TRBJ2-7
TGTGCCAGCTCACCACGAGCGGGACGAGGCCTCTCCTACGAGCAGTACTTC	CASSPRAGRGLSYEQYF	TRBV18	TRBJ2-7
TGTGCCAGCAGTTCGGGGAGCTTTATGACCCAGTACTTC	CASSSGSFMTQYF	TRBV27	TRBJ2-5
TGTGCCAGCAACTTAAGAGGACAGGGATCGGGGGCGGAACAAGAGACCCAGTACTTC	CASNLRGQGSGAEQETQYF	TRBV25-1	TRBJ2-5
TGCGCCAGCAACCGGGACAGGGAAAAACTGTTTTTT	CASNRDREKLFF	TRBV10-2	TRBJ1-4
TGCAGTGCTAGAGATGAAAACGGACCCAATCAGCCCCAGCATTTT	CSARDENGPNQPQHF	TRBV20-1	TRBJ1-5
TGTGCCAGCAGTTACTCTAAGACTAGCGGGCCGGGGACCTACGAGCAGTACTTC	CASSYSKTSGPGTYEQYF	TRBV6-3	TRBJ2-7
TGTGCCACCAGTGCCGCCCGACAGGGGAGTGAAAAACTGTTTTTT	CATSAARQGSEKLFF	TRBV24-1	TRBJ1-4
TGTGCCAGCAGCCTACCGGACAGGGTAAACTACGAGCAGTACTTC	CASSLPDRVNYEQYF	TRBV5-6	TRBJ2-7
TGTGCCACCACCGGGGCCTATCAGCCCCAGCATTTT	CATTGAYQPQHF	TRBV24-1	TRBJ1-5
TGTGCCAGCAAGCACGGTCAGCCCCAGCATTTT	CASKHGQPQHF	TRBV6-4	TRBJ1-5
TGTGCCAGCAGCTGGGGGGCCCGGCCCAATAGGGGGCCTAGGAGCAATCAGCCCCAGCATTTT	CASSWGARPNRGPRSNQPQHF	TRBV9	TRBJ1-5
TGCGCCAGCAGCACCCCTTGGAGGCGGGACTCAGGGTACAATGAGCAGTTCTTC	CASSTPWRRDSGYNEQFF	TRBV5-1	TRBJ2-1
TGCGCCAGCAGCCAATCCGGGACAGGGGGCGCGAACTATGGCTACACCTTC	CASSQSGTGGANYGYTF	TRBV4-1	TRBJ1-2
TGTGCCGTGGGGACCGGACAGGGTCCCAATCAGCCCCAGCATTTT	CAVGTGQGPNQPQHF	TRBV19	TRBJ1-5
TGTGCCAGCAGCAGGGTAGGGGCCTCACTAGATACGCAGTATTTT	CASSRVGASLDTQYF	TRBV7-4	TRBJ2-3
TGCGCCAGCAGTCGCCGGGACAGGCATGAAAAACTGTTTTTT	CASSRRDRHEKLFF	TRBV10-2	TRBJ1-4
TGTGCCAGTAGTATAGTCACGGGCCCTCCTTCAGGAGGCGAAGAGACCCAGTACTTC	CASSIVTGPPSGGEETQYF	TRBV19	TRBJ2-5
TGTGCCATGTCCCCAACGGGGGGTGTCGAAGATGAAGCTTTCTTT	CAMSPTGGVEDEAFF	TRBV10-3	TRBJ1-1
TGTGCCAGGGGCCGGGACTACGCGCAGTTCTTC	CARGRDYAQFF	TRBV19	TRBJ2-1
TGTGCCAGCAGTGTTGCAGGGGGGAGCATGAACACTGAAGCTTTCTTT	CASSVAGGSMNTEAFF	TRBV2	TRBJ1-1
TGTGCCACCCGTGCCCGGACAATAGGAGGGACAGCTGGTCCACCTAATGAAAAACTGTTTTTT	CATRARTIGGTAGPPNEKLFF	TRBV6-5	TRBJ1-4
TGTGCCAGCAGTTGTACGTACGAGCAGTACTTC	CASSCTYEQYF	TRBV6-4	TRBJ2-7
TGTGCCAGCAGCCTCGGGGGGACTAGCACAGATACGCAGTATTTT	CASSLGGTSTDTQYF	TRBV7-3	TRBJ2-3
TGCGCCAGCACCCTGAAAACGGAGAAACACCGGGCCCGGGGGAATGCAACTAATGAAAAACTGTTTTTT	CASTLKTEKHRARGNATNEKLFF	TRBV10-1	TRBJ1-4
TGTGCCAGCAGCCCCAGGGGGACAGATACGCAGTATTTT	CASSPRGTDTQYF	TRBV13	TRBJ2-3
TGTGCCAGCAGCTTGCGCTTCGGAGGGGGTGTGGGAGCCATTCAGTACTTC	CASSLRFGGGVGAIQYF	TRBV5-4	TRBJ2-4
TGTGCCAGCAGTTACGCCCAGGTAGAGCTCAACAATCAGCCCCAGCATTTT	CASSYAQVELNNQPQHF	TRBV6-5	TRBJ1-5
TGCAGTGCTAGTCCGGGGGGAGACTATGGCTACACCTTC	CSASPGGDYGYTF	TRBV20-1	TRBJ1-2
TGTGCCAGCAGCCAATGTCCCGATCCCACGGACGAGCAGTACTTC	CASSQCPDPTDEQYF	TRBV3-1	TRBJ2-7
TGCGCCAGCAGGGCTCAGGGGGGGCCGGATTCACCCCTCCACTTT	CASRAQGGPDSPLHF	TRBV10-1	TRBJ1-6
TGTGCCAGCAGCTCGTACCCCGGCGTGGGACAGGGTGAAGCTTTCTTT	CASSSYPGVGQGEAFF	TRBV27	TRBJ1-1
TGCAGTGCTAGAGGCATGAAGAGACTAGCGGGAGGAGAGGCCTACAATGAGCAGTTCTTC	CSARGMKRLAGGEAYNEQFF	TRBV20-1	TRBJ2-1
TGCGCCAGCAGCTTGTTAACCATGGGGAAGACTCTCTCTACCGGGGAGCTGTTTTTT	CASSLLTMGKTLSTGELFF	TRBV5-1	TRBJ2-2
TGCAGTGCCCTCACAGGGGCCTATGGCTACACCTTC	CSALTGAYGYTF	TRBV20-1	TRBJ1-2
TGTGCCTGGATCAGTCACATGGAACTTGACAGTCGAGCTTTCTTT	CAWISHMELDSRAFF	TRBV30	TRBJ1-1
TGTGCCACCATCGGCACTACGGGCAATCAGCCCCAGCATTTT	CATIGTTGNQPQHF	TRBV24-1	TRBJ1-5
TGTGCCACGGCTAGCGGCTACGAGCAGTACTTC	CATASGYEQYF	TRBV24-1	TRBJ2-7
TGTGCCAGCAGCAGGGGGGGCCACTCTAGCAATCAGCCCCAGCATTTT	CASSRGGHSSNQPQHF	TRBV5-8	TRBJ1-5
TGTGCCAGCAGCTCAGGAAGACAGGGAAGGGTTGGCTACACCTTC	CASSSGRQGRVGYTF	TRBV7-2	TRBJ1-2
TGCGCCAGCAGCTTCGTCCGGGACCATGAGCAGTTCTTC	CASSFVRDHEQFF	TRBV5-1	TRBJ2-1
TGTGCCAGCAGCGGGACAGGTGGCTACACCTTC	CASSGTGGYTF	TRBV7-9	TRBJ1-2
TGTGCCAGCAGCTTAGCGGGGCTAGGGGAGAGATGTGAGCAGTTCTTC	CASSLAGLGERCEQFF	TRBV7-6	TRBJ2-1
TGTGCCAGCAAAGCCCAGCACTTAACAGATACGCAGTATTTT	CASKAQHLTDTQYF	TRBV6-2	TRBJ2-3
TGTGCCAGCAATTGCTGTACCGAAAGTGGCTACACCTTC	CASNCCTESGYTF	TRBV2	TRBJ1-2
TGTGCCATCAGTGAGTCGGGGCGCCTCGACTATGGCTACACCTTC	CAISESGRLDYGYTF	TRBV10-3	TRBJ1-2
TGTGCCAGCAGGAGACGACTAGCGGGGGGGGGGTGCAATGAGCAGTTCTTC	CASRRRLAGGGCNEQFF	TRBV28	TRBJ2-1
TGTGCCAGCAGCGTGGCGGCGGCGCTCAATCAGCCCCAGCATTTT	CASSVAAALNQPQHF	TRBV7-3	TRBJ1-5
TGTGCCAGCATCTGGACGATCAGCAATCAGCCCCAGCATTTT	CASIWTISNQPQHF	TRBV28	TRBJ1-5
TGTGCCAGCAGCATCTACCTCGACACCGGGGAGCTGTTTTTT	CASSIYLDTGELFF	TRBV9	TRBJ2-2
TGCAGTGCGGGAGCCAGCGGGACAGGATATGGCTACACCTTC	CSAGASGTGYGYTF	TRBV20-1	TRBJ1-2
TGCGCCAGCAGCGGGGTGTACACTGAAGCTTTCTTT	CASSGVYTEAFF	TRBV4-1	TRBJ1-1
TGCGCCAGCCTACCAGCGGGACCAGATACGCAGTATTTT	CASLPAGPDTQYF	TRBV5-1	TRBJ2-3
TGCAGTGCCGTCAGGGGGGAGGACGTCCTTCTCCGCCTGAACACTGAAGCTTTCTTT	CSAVRGEDVLLRLNTEAFF	TRBV20-1	TRBJ1-1
TGCGCCAGCAGTTCCGGGACAAGGTGGTACGAGCAGTACTTC	CASSSGTRWYEQYF	TRBV10-1	TRBJ2-7
TGTGCCAGCAGTAGGACGGCCGACAGGGCTAACAATGAGCAGTTCTTC	CASSRTADRANNEQFF	TRBV6-1	TRBJ2-1
TGTGCCAGCAGCTTACCGGACAGGGTGATGGATGGCTACACCTTC	CASSLPDRVMDGYTF	TRBV5-8	TRBJ1-2
TGTGCCAGCAGCTATACTCAGGGGGGAAATCAGCCCCAGCATTTT	CASSYTQGGNQPQHF	TRBV5-4	TRBJ1-5
TGCAGTGCTAGTATCGGGACAGCTTGCAGCTACGAGCAGTACTTC	CSASIGTACSYEQYF	TRBV20-1	TRBJ2-7
TGTGCCAGTCTAGGAGAGACCCAGTACTTC	CASLGETQYF	TRBV19	TRBJ2-5
TGTGCCAGCACTAGCTCCTACGAGCAGTACTTC	CASTSSYEQYF	TRBV6-2	TRBJ2-7
TGTGCCAGTAGTTCCAGTAGCCCAAGCTCCTACGAGCAGTACTTC	CASSSSSPSSYEQYF	TRBV19	TRBJ2-7
TGTGCCAGCAGTTATGGTTCCGGGGCTCGGAAGAACACTGAAGCTTTCTTT	CASSYGSGARKNTEAFF	TRBV12-3	TRBJ1-1
TGTGCCAGCAGCGGACGAGGATACGAGCAGTACTTC	CASSGRGYEQYF	TRBV9	TRBJ2-7
TGTGCCAGCAGGGGACTAGCGGGGGAAACCTGGAGGGACGAGCAGTACTTC	CASRGLAGETWRDEQYF	TRBV7-2	TRBJ2-7
TGCGCCAGCAGCTTGGCCGGACCTTTGAGCTCCTACAATGAGCAGTTCTTC	CASSLAGPLSSYNEQFF	TRBV5-1	TRBJ2-1
TGTGCCAGTACCGTCCCCGGGGACCTGAACACTGAAGCTTTCTTT	CASTVPGDLNTEAFF	TRBV19	TRBJ1-1
TGTGCCAGCAGCGTAGATTTACACAGGGCAGAGACTGAAGCTTTCTTT	CASSVDLHRAETEAFF	TRBV9	TRBJ1-1
TGTGCCAGCAGCCCAGCCTCAGGGGAGCATCAGCCCCAGCATTTT	CASSPASGEHQPQHF	TRBV13	TRBJ1-5
TGCAGTGCTGATCGACGCCCCTCACTAGCGGGAGACGAAAGAAATATCTGCTACGAGCAGTACTTC	CSADRRPSLAGDERNICYEQYF	TRBV20-1	TRBJ2-7
TGCGCCAGCAGCCAAAGTCCCAGGCTTAATACCCGTGAAAAACTGTTTTTT	CASSQSPRLNTREKLFF	TRBV4-1	TRBJ1-4
TGTGCCACCCCCAAAACCCGTAGGGGCTACAATGAGCAGTTCTTC	CATPKTRRGYNEQFF	TRBV15	TRBJ2-1
TGCGCCAGGTCGGGTGGGGTGGGACTAGCGGGCAATGAGCAGTTCTTC	CARSGGVGLAGNEQFF	TRBV10-1	TRBJ2-1
TGTGCCAGGCGCGGCAGAAACATTCAGTACTTC	CARRGRNIQYF	TRBV6-1	TRBJ2-4
TGTGCCAGTAGTATAGATTTAAGGACCCTTCTGAACGAGCAGTACTTC	CASSIDLRTLLNEQYF	TRBV19	TRBJ2-7
TGTGCCAGCACAGGGGGGGCTAACACTGAAGCTTTCTTT	CASTGGANTEAFF	TRBV6-1	TRBJ1-1
TGTGCCGGCGAGAGAACTTTCTTT	CAGERTFF	TRBV6-1	TRBJ1-1
TGTGCCAGCAGTTACTCGAATCCGCATGCGGGGGGGGGAGAGACCCAGTACTTC	CASSYSNPHAGGGETQYF	TRBV6-5	TRBJ2-5
TGTGCCAGCACCCAAGGGCAGCCCCAGCATTTT	CASTQGQPQHF	TRBV6-4	TRBJ1-5
TGTGCCAGCTCACCTGACGGGGGACGGGAGCAGTTCTTC	CASSPDGGREQFF	TRBV18	TRBJ2-1
TGTGCCAGATCCCTCAACGCACGGTCAGGAATCCCCGAAAAACTGTTTTTT	CARSLNARSGIPEKLFF	TRBV19	TRBJ1-4
TGTGCCAGCAACACCGTGCCCCCCCAAGAGACCCAGTACTTC	CASNTVPPQETQYF	TRBV6-1	TRBJ2-5
TGTGCCAGCAGCTCCCCGCTAGCGGGCAATGAGCAGTTCTTC	CASSSPLAGNEQFF	TRBV7-2	TRBJ2-1
TGCGCCAGAGTTAGCGGGGGAGGGGGCTACGAGCAGTACTTC	CARVSGGGGYEQYF	TRBV10-1	TRBJ2-7
TGTGCCAGCAGCTTCCCTTACCTAGCGGCCTGTGAGCAGTACTTC	CASSFPYLAACEQYF	TRBV7-3	TRBJ2-7
TGTGCCAGCAGCCAAGTCTATGAATCAAGCGGGGCTTGGTTAAAAAAGAGGGGTCGTCGAAACACTGAAGCTTTCTTT	CASSQVYESSGAWLKKRGRRNTEAFF	TRBV14	TRBJ1-1
TGTGCCAGCAGCTTAACAAGTCGGCTTTACAATGAGCAGTTCTTC	CASSLTSRLYNEQFF	TRBV13	TRBJ2-1
TGTGCCAGCAGCTGGAAAGGGGCGGGGCATGGCTACACCTTC	CASSWKGAGHGYTF	TRBV13	TRBJ1-2
TGTGCCAGCAGTTTGGGGGGGCGAGTCGAGCAGTACTTC	CASSLGGRVEQYF	TRBV27	TRBJ2-7
TGTGCTAGTGGTTTGGTCATGAGGCCGGGACAGGGGCTTTATCAGCCCCAGCATTTT	CASGLVMRPGQGLYQPQHF	TRBV12-5	TRBJ1-5
TGTGCCACCAGCAGACGGGAAGTGGACAGGGCACGTCAAGGCTACACCTTC	CATSRREVDRARQGYTF	TRBV15	TRBJ1-2
TGCAGTGCTAGAGGGGGGGGGGCCTTTGCCTCCTACGAGCAGTACTTC	CSARGGGAFASYEQYF	TRBV20-1	TRBJ2-7
TGTGCCAGCGGCGGTGTACCCTATGTTAGCGGCACAGATACGCAGTATTTT	CASGGVPYVSGTDTQYF	TRBV6-8	TRBJ2-3
TGTGCCAGCAGCCACCCGGGACTAGCGGGAGACCAATCCGATACGCAGTATTTT	CASSHPGLAGDQSDTQYF	TRBV7-3	TRBJ2-3
TGTGCCAGCAGCTTAGACAGAGCCATGCCCGGGGAGCTGTTTTTT	CASSLDRAMPGELFF	TRBV5-6	TRBJ2-2
TGTGCCAGCAGGAAGGGCGGAAAAAGCTCCTACGAGCAGTACTTC	CASRKGGKSSYEQYF	TRBV6-2	TRBJ2-7
TGTGCCAGCAGCTCCCTCAAAAAGTTTTCTGAGGGGAACACTGAAGCTTTCTTT	CASSSLKKFSEGNTEAFF	TRBV7-3	TRBJ1-1
TGTGCCAGCAGATATCCAGAGACATGTTGCTACGAGCAGTACTTC	CASRYPETCCYEQYF	TRBV28	TRBJ2-7
TGTGCCAGCAGGGGGACAGGGTATCAGCCCCAGCATTTT	CASRGTGYQPQHF	TRBV6-6	TRBJ1-5
TGTGCCACCGACCGGACTAGCGGGGGGGCCCCAGAGACCCAGTACTTC	CATDRTSGGAPETQYF	TRBV24-1	TRBJ2-5
TGTGCCAGCAGCCGGGACAGACTTTATGAAAAACTGTTTTTT	CASSRDRLYEKLFF	TRBV12-4	TRBJ1-4
TGTGCCAGCAGCCCCGTGAGCGTTGAGACCCAGTACTTC	CASSPVSVETQYF	TRBV9	TRBJ2-5
TGTGCCAGCAGTTCCCCTTGCACTGAAGCTTTCTTT	CASSSPCTEAFF	TRBV27	TRBJ1-1
TGTGCCAGCAGTGCCTCTACAGATACGCAGTATTTT	CASSASTDTQYF	TRBV25-1	TRBJ2-3
TGTGCCAGCAGCTTAAAACCGGGACAGGGGCCCTCTGGAAACACCATATATTTT	CASSLKPGQGPSGNTIYF	TRBV11-3	TRBJ1-3
TGCAGTGCTTGGACAGGTACAGCTGGAAACACCATATATTTT	CSAWTGTAGNTIYF	TRBV20-1	TRBJ1-3
TGCAGTGCTAGGGGCCGGGCGCGGAACTTC	CSARGRARNF	TRBV20-1	TRBJ2-7
TGTGCCAGCAGCCAAGCTCATATAGGGCCGACTGGAGCTTTCTTT	CASSQAHIGPTGAFF	TRBV3-1	TRBJ1-1
TGTGCCACCAGTGCGGACAAACCGCGGGAGACTCACGGGATGAAAGGCTACGAGCAGTACTTC	CATSADKPRETHGMKGYEQYF	TRBV24-1	TRBJ2-7
TGTGCCAGTAGGCCCGGACTAGCGGGGAACACCGGGGAGCTGTTTTTT	CASRPGLAGNTGELFF	TRBV19	TRBJ2-2
TGTGCCAGCAGTTTATCCACGGGTCCCCCTTCTGACACCGGGGAGCTGTTTTTT	CASSLSTGPPSDTGELFF	TRBV27	TRBJ2-2
TGTGCCAGAGGGCGGGCCGGGACTAGCGGGGGGGCTTCGCAGGCCTACCAGCGGACCTACGAGCAGTACTTC	CARGRAGTSGGASQAYQRTYEQYF	TRBV6-1	TRBJ2-7
TGTGCCATATTACCGGGGTTAGACGAGCAGTACTTC	CAILPGLDEQYF	TRBV7-9	TRBJ2-7
TGTGCCAGCACCGGGTCCAACTATGGCTACACCTTC	CASTGSNYGYTF	TRBV6-4	TRBJ1-2
TGTGCCAGCAGCGATGGGACCGGCGATAATCAGCCCCAGCATTTT	CASSDGTGDNQPQHF	TRBV11-3	TRBJ1-5
TGTGCCAGCAGTTGGGGGGTTGGGGAGCTGTTTTTT	CASSWGVGELFF	TRBV27	TRBJ2-2
TGTGCCAGCAGCCAAGTTAGGGGCACTGAAGCTTTCTTT	CASSQVRGTEAFF	TRBV3-1	TRBJ1-1
TGTGCCTGCCGGGGGGCCGCTGACGAGCAGTACTTC	CACRGAADEQYF	TRBV24-1	TRBJ2-7
TGCGCCAGCACGCGGGGCCCCGTGGCCTACAATGAGCAGTTCTTC	CASTRGPVAYNEQFF	TRBV10-1	TRBJ2-1
TGTGCCAGCAGTGAGGACAGGGCCCTGAGTGAAGCTTTCTTT	CASSEDRALSEAFF	TRBV6-8	TRBJ1-1
TGTGCCAGCAGTTACTCGGAGAGAGAAAAACTGTTTTTT	CASSYSEREKLFF	TRBV6-2	TRBJ1-4
TGTGCCAGCAGCAGAACTAGCGGGAGTGGTAACACTGAAGCTTTCTTT	CASSRTSGSGNTEAFF	TRBV28	TRBJ1-1
TGTGCCAAAACAGACAGGGGGCTGGGGTCAGCCAAAAACATTCAGTACTTC	CAKTDRGLGSAKNIQYF	TRBV24-1	TRBJ2-4
TGTGCCAGCAGCTGGACCCACTCCTACGAGCAGTACTTC	CASSWTHSYEQYF	TRBV11-2	TRBJ2-7
TGCGCCAGCAGTCTGGGGGCCGTGTGCTATGGCTACACCTTC	CASSLGAVCYGYTF	TRBV10-2	TRBJ1-2
TGTGCCAGCAGCGAAACCGGGACCTTTTACTACGAGCAGTACTTC	CASSETGTFYYEQYF	TRBV9	TRBJ2-7
TGTGCCAGCAGCTCCGGACTAGCGGGGGGTGGTGGAGGAGCCAAAAACATTCAGTACTTC	CASSSGLAGGGGGAKNIQYF	TRBV6-5	TRBJ2-4
TGCGCCAGCAGCTTGGACGGGAGCCACGAGCAGTACTTC	CASSLDGSHEQYF	TRBV5-1	TRBJ2-7
TGTGCCACCAGTGATTTGTCCCGGGGGGTGAAGGCCTACGAGCAGTACTTC	CATSDLSRGVKAYEQYF	TRBV24-1	TRBJ2-7
TGTGCCAGCAGCCGCGAGAGTCAGCCCCAGCATTTT	CASSRESQPQHF	TRBV13	TRBJ1-5
TGTGCCAGCAGCTTACCGGGGGGGACCGGTCTGCAGTACTTC	CASSLPGGTGLQYF	TRBV7-6	TRBJ2-7
TGTGCCAGCAGTGGGGGGGGGATCCCCTACGAGCAGTACTTC	CASSGGGIPYEQYF	TRBV6-1	TRBJ2-7
TGTGCCAGCAGCACACAGATAGAGACCCAGTACTTC	CASSTQIETQYF	TRBV14	TRBJ2-5
TGTGCCAGCAGCTTGATTACTTCGGGAAGCACTGAAGCTTTCTTT	CASSLITSGSTEAFF	TRBV7-2	TRBJ1-1
TGTGCCAGCAGCTATCCTGCCAAAACTACTGAAGCTTTCTTT	CASSYPAKTTEAFF	TRBV7-2	TRBJ1-1
TGTGCCAGCAGCGTACCCCCTCCAACAGGAGCCGGGGAGCTGTTTTTT	CASSVPPPTGAGELFF	TRBV9	TRBJ2-2
TGTGCCAGCAGGAAGTCGGGACAACGGGGAAACACCATATATTTT	CASRKSGQRGNTIYF	TRBV14	TRBJ1-3
TGTGCCAGCAGCAAATGGGGGGGCAGGGCACGCACAGATACGCAGTATTTT	CASSKWGGRARTDTQYF	TRBV13	TRBJ2-3
TGCAGTGCTAGAGGTCGGGGGTACTTC	CSARGRGYF	TRBV20-1	TRBJ2-4
TGTGCCACCAGTGAGCCGTCCTGGGGGACGGGGATGGGGGACACTGAAGCTTTCTTT	CATSEPSWGTGMGDTEAFF	TRBV24-1	TRBJ1-1
TGTGCCAGCGAGGCCAAGGATACGCAGTATTTT	CASEAKDTQYF	TRBV27	TRBJ2-3
TGCAGTGCTAGAGATCTCCGTAGGCGTGAAGAGACCCAGTACTTC	CSARDLRRREETQYF	TRBV20-1	TRBJ2-5
TGTGCCAGCAGTGACGGGACTAGCGGGGACACCGGGGAGCTGTTTTTT	CASSDGTSGDTGELFF	TRBV6-4	TRBJ2-2
TGTGCCACCAGTGATTCAATTACAGGGGGCACTGAAGCTTTCTTT	CATSDSITGGTEAFF	TRBV24-1	TRBJ1-1
TGTGCCAGCAGCCGTCCCTGGACAGGGGATGGGGGCGACTCCTACAATGAGCAGTTCTTC	CASSRPWTGDGGDSYNEQFF	TRBV5-5	TRBJ2-1
TGTGCCGGATTAGGGACAGGGGTGTCCAATCAGCCCCAGCATTTT	CAGLGTGVSNQPQHF	TRBV12-5	TRBJ1-5
TGCGCCAGCAGTTCGGAAGGAAGGAACACTGAAGCTTTCTTT	CASSSEGRNTEAFF	TRBV10-1	TRBJ1-1
TGTGCCAGCAGCTTAGCCTACGCGAACTATGGCTACACCTTC	CASSLAYANYGYTF	TRBV7-4	TRBJ1-2
TGTGCCACCAGTGGTAGAGGACCCAAGGAAAAACTGTTTTTT	CATSGRGPKEKLFF	TRBV24-1	TRBJ1-4
TGCAGTGCTAATCTCAGGGGAGGGGCTAATGAAAAACTGTTTTTT	CSANLRGGANEKLFF	TRBV20-1	TRBJ1-4
TGTGCCAGCAGTTCCACCCGCATCGGGGGACGGGGAACAGAGACCCAGTACTTC	CASSSTRIGGRGTETQYF	TRBV12-4	TRBJ2-5
TGTGCCAGCAGGTTTCCGGGACGCCGCGGAAACACCATATATTTT	CASRFPGRRGNTIYF	TRBV6-5	TRBJ1-3
TGTGCCACCAGCAGATCCACGTCAGCTACTCGGGGGGCCAACGTCCTGACTTTC	CATSRSTSATRGANVLTF	TRBV15	TRBJ2-6
TGTGCCACCATTCTGACTTCCTACGAGCAGTACTTC	CATILTSYEQYF	TRBV24-1	TRBJ2-7
TGTGCCAGCAGTTTATTCGACTCCAGGTGGAGGAACGATGGCTACACCTTC	CASSLFDSRWRNDGYTF	TRBV27	TRBJ1-2
TGTGCCAGCAGCTATACTAGGGACTCCTATAATTCACCCCTCCACTTT	CASSYTRDSYNSPLHF	TRBV7-9	TRBJ1-6
TGCAGTGCTATCTTGGAACCGGGTCCCTACGAGCAGTACTTC	CSAILEPGPYEQYF	TRBV20-1	TRBJ2-7
TGTGCCAGCAGTAAAAAGGACAATGAAAAACTGTTTTTT	CASSKKDNEKLFF	TRBV27	TRBJ1-4
TGTGCCAGCAGTTTAATTCCTAGTGCCAAAAACATTCAGTACTTC	CASSLIPSAKNIQYF	TRBV27	TRBJ2-4
TGTGCCAGCAGCACAGGGGGCGAGACCCAGTACTTC	CASSTGGETQYF	TRBV9	TRBJ2-5
TGTGCCAGCAGTGATCTGAGACAGCCGTACGAGCAGTACTTC	CASSDLRQPYEQYF	TRBV6-5	TRBJ2-7
TGCGCCAGCAGCCAAGCCAAGGGTTGGAGGGACTATAATTCACCCCTCCACTTT	CASSQAKGWRDYNSPLHF	TRBV4-1	TRBJ1-6
TGTGCCTGGAGTGTAATCGGGGGGGGCAATGAGCAGTTCTTC	CAWSVIGGGNEQFF	TRBV30	TRBJ2-1
TGTGCCAGCCGGGACAGGGGATTCTATGGCTACACCTTC	CASRDRGFYGYTF	TRBV19	TRBJ1-2
TGTGCCAGCAGGGCTAGCGGGAGATCCCCCGGGGAGCTGTTTTTT	CASRASGRSPGELFF	TRBV2	TRBJ2-2
TGTGCCAGCAGCTTATCCAACGGGAATAAGTTTAACTATGGCTACACCTTC	CASSLSNGNKFNYGYTF	TRBV5-4	TRBJ1-2
TGCGCCAGCAGTGATCCAACAGGGGGCCCAAACTCCTATAATTCACCCCTCCACTTT	CASSDPTGGPNSYNSPLHF	TRBV10-1	TRBJ1-6
TGTGCCAGCAGGGTTACCAGCGCAGTGATTAGCTCCTACGAGCAGTACTTC	CASRVTSAVISSYEQYF	TRBV6-4	TRBJ2-7
TGTGCCAGCAGTGACGGGAACAATGAGCAGTTCTTC	CASSDGNNEQFF	TRBV6-1	TRBJ2-1
TGCAGTGCTAGAGCCCCCCGGGACAGGGCCCGCCTCATGAACTACATGAACACTGAAGCTTTCTTT	CSARAPRDRARLMNYMNTEAFF	TRBV20-1	TRBJ1-1
TGTGCCAGCAGTGGGCTAGGCCACTATAATTCACCCCTCCACTTT	CASSGLGHYNSPLHF	TRBV6-4	TRBJ1-6
TGTGCCAGCAGCCCGGGACAGGGAGGGGCCAACGTCCTGACTTTC	CASSPGQGGANVLTF	TRBV7-3	TRBJ2-6
TGTGCCAGCAGTTTGGGGGCAGGCGGGCGTCCTAATGAAAAACTGTTTTTT	CASSLGAGGRPNEKLFF	TRBV27	TRBJ1-4
TGTGCCAGCAGCTTCCTAGCCGGGACTAGTTTTCTTGAGACCCAGTACTTC	CASSFLAGTSFLETQYF	TRBV7-8	TRBJ2-5
TGCAGTGCGGAGGGGGTGGGCTGGGTCTCCTACGAGCAGTACTTC	CSAEGVGWVSYEQYF	TRBV20-1	TRBJ2-7
TGTGCCAGCCAAACGAGGGGGGGACACCTAGCCAAAAACATTCAGTACTTC	CASQTRGGHLAKNIQYF	TRBV6-2	TRBJ2-4
TGTGCCAGCAGCCCCGGAGGGCGCAACACTGAAGCTTTCTTT	CASSPGGRNTEAFF	TRBV7-8	TRBJ1-1
TGTGCCAGCAGTGTGCCGGCGAAAACTGAAGCTTTCTTT	CASSVPAKTEAFF	TRBV6-1	TRBJ1-1
TGTGCCAGCAGCTTCGCCACTAGCGGGGAAGAGCAGTACTTC	CASSFATSGEEQYF	TRBV5-6	TRBJ2-7
TGTGCCAGCGTAGCCCCGGACCTAAACTATGGCTACACCTTC	CASVAPDLNYGYTF	TRBV14	TRBJ1-2
TGTGCCAGCAGGCGATACGAAACCCGTAGTAATGAGCAGTTCTTC	CASRRYETRSNEQFF	TRBV6-2	TRBJ2-1
TGTGCCCCGGTCGACTGGCGGACAGGGTTGCCGGGTGATTCCCCCACCGGGGAGCTGTTTTTT	CAPVDWRTGLPGDSPTGELFF	TRBV24-1	TRBJ2-2
TGTGCCAGCTCACCGGGGATAGCGGGCTACGAGCAGTACTTC	CASSPGIAGYEQYF	TRBV18	TRBJ2-7
TGCAGCGTTATTCCCCCCTGGACAGGGGGCGCCGAGCAGTACTTC	CSVIPPWTGGAEQYF	TRBV29-1	TRBJ2-7
TGTGCCAGCAGCCAAGATGCGCGGGAGTTCGGTAAAAACACTGAAGCTTTCTTT	CASSQDAREFGKNTEAFF	TRBV3-1	TRBJ1-1
TGTTGCTTAGCGGCGCACAATGAGCAGTTCTTC	CCLAAHNEQFF	TRBV30	TRBJ2-1
TGTGCCAGCAGTTGCGGGGGGGCCCAAGAGACCCAGTACTTC	CASSCGGAQETQYF	TRBV6-9	TRBJ2-5
TGCGCCAGCAGCCAAGCTGGCGGGACAGGGGCCACTGAAGCTTTCTTT	CASSQAGGTGATEAFF	TRBV4-1	TRBJ1-1
TGTGCCAGCAGCCCAGTTGAACGGACGCCCGAGTACTCCTACGAGCAGTACTTC	CASSPVERTPEYSYEQYF	TRBV3-1	TRBJ2-7
TGTGCTAGTGGCAATAACCGAGAAGGCCAGAAAGATACGCAGTATTTT	CASGNNREGQKDTQYF	TRBV12-5	TRBJ2-3
TGCGCCAGCAGCCAAGTAAAGGGACTTAGGAACTTC	CASSQVKGLRNF	TRBV4-1	TRBJ2-7
TGCGCCAGCAGCTTTGGTCCCCCCCAGCTAGTCCTGCAGTACTTC	CASSFGPPQLVLQYF	TRBV5-1	TRBJ2-7
TGCGCCAGCAGCTTTCCGTGCAACTACAGGGTAGATTGGGGCTACACCTTC	CASSFPCNYRVDWGYTF	TRBV5-1	TRBJ1-2
TGTGCCAGCAGTTCCTCGAAGCCAGCGGGACGGTCACCCCTCCACTTT	CASSSSKPAGRSPLHF	TRBV12-3	TRBJ1-6
TGTGCCAGTAGTATAGATCGCCGCCGAAACGAGTATTTT	CASSIDRRRNEYF	TRBV19	TRBJ2-3
TGTGCCAGCAGCGCCCCAGCGGAATACACAGATACGCAGTATTTT	CASSAPAEYTDTQYF	TRBV9	TRBJ2-3
TGCGCCAGCAGCCAAGACAGTCGGGACAGGGCGTCAGATACGCAGTATTTT	CASSQDSRDRASDTQYF	TRBV4-1	TRBJ2-3
TGTGCCATCCCTAGCCCCTATTACGAGCAGTACTTC	CAIPSPYYEQYF	TRBV11-1	TRBJ2-7
TGTGCCAGCAGCGTAGGGCGGGGGAGGCGGTACGAGCAGTACTTC	CASSVGRGRRYEQYF	TRBV9	TRBJ2-7
TGTGCCAGCAGCTTCCAAGACAGGGGCTACAATGAGCAGTTCTTC	CASSFQDRGYNEQFF	TRBV5-8	TRBJ2-1
TGTGCCAGCAGCCGGGACACCTACGAGCAGTACTTC	CASSRDTYEQYF	TRBV7-9	TRBJ2-7
TGTGCCAGCAGTTCCGGGACAGGGGGACAATCAGGTAGTCCCTACGAGCAGTACTTC	CASSSGTGGQSGSPYEQYF	TRBV11-3	TRBJ2-7
TGCGCCAGCGTCTGGGGGGTTACCTACGAGCAGTACTTC	CASVWGVTYEQYF	TRBV5-1	TRBJ2-7
TGCAGTGCTACCTTCCAAAGATCTGGAAACACCATATATTTT	CSATFQRSGNTIYF	TRBV20-1	TRBJ1-3
TGCAGTGCTCCGCAGCACACCGGGGAGCTGTTTTTT	CSAPQHTGELFF	TRBV20-1	TRBJ2-2
TGTGCCAGCAGCTTATCAACGGGGACAGTGACAGGGACTGGCTCTTTCGATAACACCATATATTTT	CASSLSTGTVTGTGSFDNTIYF	TRBV13	TRBJ1-3
TGCAGCGTGGCTAGGCCTGGAACAGGGTCCACAGATACGCAGTATTTT	CSVARPGTGSTDTQYF	TRBV29-1	TRBJ2-3
TGTGCCAGCAGCCCCATCCCCACTAGCGGGAGAAATTCGAAAGGAAAAGAGACCCAGTACTTC	CASSPIPTSGRNSKGKETQYF	TRBV13	TRBJ2-5
TGTGCCAGTCTGAAAACAGATACGCAGTATTTT	CASLKTDTQYF	TRBV19	TRBJ2-3
TGCAGTGCACTGGGAGAGGCAGGGGGCCTGTTTTTT	CSALGEAGGLFF	TRBV20-1	TRBJ1-4
TGTGCCAGCAGCCCCCCCGCTAGCGGCTACGAGCAGTACTTC	CASSPPASGYEQYF	TRBV13	TRBJ2-7
TGTGCCAGCAGCTTGAAGGAGGAGGATTACAGGCCTAAGTACTTC	CASSLKEEDYRPKYF	TRBV5-8	TRBJ2-4
TGTGCCAGCAGCAAGGAGTGCGATACGCAGTATTTT	CASSKECDTQYF	TRBV13	TRBJ2-3
TGTGCCAGCAGGCCGTCCATTACCCAGGGGGCACCAAACATTCAGTACTTC	CASRPSITQGAPNIQYF	TRBV27	TRBJ2-4
TGTGCCAGCAGTTACGGGACAGTTTCAGATACGCAGTATTTT	CASSYGTVSDTQYF	TRBV6-5	TRBJ2-3
TGCAGTGCTAGGCCGGGGGGGATCAACAATGAGCAGTTCTTC	CSARPGGINNEQFF	TRBV20-1	TRBJ2-1
TGTGCCAGCAGCTTAGCGTGCGAAAAGACAGGCGCTGCCTACGAGCAGTACTTC	CASSLACEKTGAAYEQYF	TRBV7-9	TRBJ2-7
TGTGCCAGCAGCTTAGGCTTGGGATTCAATGAGCAGTTCTTC	CASSLGLGFNEQFF	TRBV11-2	TRBJ2-1
TGTGCCAGCAGCACGGGACAGGGAAGAAATTCACCCCTCCACTTT	CASSTGQGRNSPLHF	TRBV9	TRBJ1-6
TGTGCCAGCAGCGGCAGGGATCAGCCCCAGCATTTT	CASSGRDQPQHF	TRBV13	TRBJ1-5
TGTGCCAGCAGGGGGGGGGGTGGGTACGAGCAGTACTTC	CASRGGGGYEQYF	TRBV7-2	TRBJ2-7
TGTGCCAGCAGCTTGTTCCTAGCGGGGGGGCCCCCTTCCTACGAGCAGTACTTC	CASSLFLAGGPPSYEQYF	TRBV5-6	TRBJ2-7
TGTGCCAGCAGCAAAATGGGAGGAACAGATACGCAGTATTTT	CASSKMGGTDTQYF	TRBV5-6	TRBJ2-3
TGCGCCAGCAGCCACGTAGCGGGGTGTCACGAGACCCAGTACTTC	CASSHVAGCHETQYF	TRBV4-3	TRBJ2-5
TGTGCCACCAGGGTCGATAGGACAGGCATTAATGAAAAACTGTTTTTT	CATRVDRTGINEKLFF	TRBV24-1	TRBJ1-4
TGTGCCAGCAGCTTCCCGGGACTAGCGGGACCTCCCTTAGCCAAAAACATTCAGTACTTC	CASSFPGLAGPPLAKNIQYF	TRBV5-6	TRBJ2-4
TGTGCCAGCAGTTGGCCGGGACAGCGGGTGAGCAATCAGCCCCAGCATTTT	CASSWPGQRVSNQPQHF	TRBV28	TRBJ1-5
TGTGCCAGCTCTTTCACCGACAGGGGGCAGGTTAACACTGAAGCTTTCTTT	CASSFTDRGQVNTEAFF	TRBV28	TRBJ1-1
TGTGCCAGCAGCCCTAGCGGGGCTTCTGCAGATACGCAGTATTTT	CASSPSGASADTQYF	TRBV2	TRBJ2-3
TGTGCCAGCAGTGAGCTAGCGGGCCCGTACGAGCAGTACTTC	CASSELAGPYEQYF	TRBV6-4	TRBJ2-7
TGTGCCAGCAGCCCCACAGAAGCTCAGCCCCAGCATTTT	CASSPTEAQPQHF	TRBV7-9	TRBJ1-5
TGTGCCAGCAGTGTCGTCCCGGAGGGGGCCGCTTTCTTT	CASSVVPEGAAFF	TRBV6-5	TRBJ1-1
TGTGCCAGCAGTTTAGGACATACTAACTATGGCTACACCTTC	CASSLGHTNYGYTF	TRBV28	TRBJ1-2
TGTGCCAGCACCAGGGGTTGCATCCGCTACGAGCAGTACTTC	CASTRGCIRYEQYF	TRBV14	TRBJ2-7
TGTGCCAGCAGTGTCAGCAGGGTGGCCCTAGCCAAAAACATTCAGTACTTC	CASSVSRVALAKNIQYF	TRBV6-5	TRBJ2-4
TGTGCCAGCAAATTCACGGGACAGGGGCTTTCTCGTCCCCAAGAGACCCAGTACTTC	CASKFTGQGLSRPQETQYF	TRBV28	TRBJ2-5
TGTGCCACCAGTGACAATGCAGGGATCGGCTCTTCCTACAATGAGCAGTTCTTC	CATSDNAGIGSSYNEQFF	TRBV24-1	TRBJ2-1
TGTGCCAGCAGCCAAGATGGAACAGTCGTCCCAAAGGGGGAGAACACCGGGGAGCTGTTTTTT	CASSQDGTVVPKGENTGELFF	TRBV14	TRBJ2-2
TGTGCCAGCAGGTTTCCGGGTGGTTTCCAAGAGACCCAGTACTTC	CASRFPGGFQETQYF	TRBV7-3	TRBJ2-5
TGTGCCAGCGAAAGGGACTCGGAGCAGTACTTC	CASERDSEQYF	TRBV7-9	TRBJ2-7
TGCGCCAGCAGCTTAGGGGTCCGGCGGGAGAGAAGGTTGGAGACCCAGTACTTC	CASSLGVRRERRLETQYF	TRBV5-1	TRBJ2-5
TGTGCCAGCAGCGTACAGTCCTGGCTCACAGATACGCAGTATTTT	CASSVQSWLTDTQYF	TRBV13	TRBJ2-3
TGTGCCAGCAGCCCCCTGGGGACGAAAAGCAATCAGCCCCAGCATTTT	CASSPLGTKSNQPQHF	TRBV9	TRBJ1-5
TGCGCCAGCAGTGAGTCCCCCTGGGACAGGGCCGAGACTGAAGCTTTCTTT	CASSESPWDRAETEAFF	TRBV10-1	TRBJ1-1
TGTGCCAGCACCCGCTCTATGAGCAGAGGAAACTCTGGGGCCAACGTCCTGACTTTC	CASTRSMSRGNSGANVLTF	TRBV28	TRBJ2-6
TGCGCCAGCACCAGGTGGGGGATAATGGGACGGGCCTCCTACGAGCAGTACTTC	CASTRWGIMGRASYEQYF	TRBV5-1	TRBJ2-7
TGTGCCTGGAGTGTATATTGGCACTATGGCTACACCTTC	CAWSVYWHYGYTF	TRBV30	TRBJ1-2
TGTGCCAGCAGCACCATGGACTACGAGCAGTACTTC	CASSTMDYEQYF	TRBV2	TRBJ2-7
TGCGCCAGCAGCCGCGGGAGGACAGGTACGACTGAAGCTTTCTTT	CASSRGRTGTTEAFF	TRBV10-1	TRBJ1-1
TGCAGTGCCGGGACTGGGGACGTCCAAGAGACCCAGTACTTC	CSAGTGDVQETQYF	TRBV20-1	TRBJ2-5
TGTGCCAGCAGCGAAAGCCCCGACAGGGCCACTGAAGCTTTCTTT	CASSESPDRATEAFF	TRBV9	TRBJ1-1
TGCGCCAGCAGCTTTGAACTAGCGGGAGGGCTGGGCCACAATGAGCAGTTCTTC	CASSFELAGGLGHNEQFF	TRBV5-1	TRBJ2-1
TGTGCCAGCAGCCTCCGCACTGCAGCGGGAGGGGCCTGCACAGATACGCAGTATTTT	CASSLRTAAGGACTDTQYF	TRBV7-3	TRBJ2-3
TGTGCCAGCAGCATTTCCCAGTTTCCAGTGGGGACTGAAGCTTTCTTT	CASSISQFPVGTEAFF	TRBV11-2	TRBJ1-1
TGCAGTGCTTCCGAGGGGGGGAGGGGTAGCCCCTACAATGAGCAGTTCTTC	CSASEGGRGSPYNEQFF	TRBV20-1	TRBJ2-1
TGTGCCAGCAGCCGAGGCGGGTTAGGGTGGAAGAACTATGGCTACACCTTC	CASSRGGLGWKNYGYTF	TRBV3-1	TRBJ1-2
TGTGCCAGCAGTGTCTTAATACCCGGGGCCGGGGTGAACACTGAAGCTTTCTTT	CASSVLIPGAGVNTEAFF	TRBV6-5	TRBJ1-1
TGTGCCATCAGTACCGGGTGCCTAGCCGGCACAGATACGCAGTATTTT	CAISTGCLAGTDTQYF	TRBV10-3	TRBJ2-3
TGTGCCAGCAGTTTAATTTACCAACCGGGACAGAGTTTCTACGAGCAGTACTTC	CASSLIYQPGQSFYEQYF	TRBV12-4	TRBJ2-7
TGTGCCAGCAGTTTATCTCCGGTTTCGCGTAGCGGGAGAGTATGCAAAAACATTCAGTACTTC	CASSLSPVSRSGRVCKNIQYF	TRBV28	TRBJ2-4
TGTGCCAGCAGCCAAGATTTCCCCGGGACAGGGAGCAATCAGCCCCAGCATTTT	CASSQDFPGTGSNQPQHF	TRBV3-1	TRBJ1-5
TGTGCCATCAGTCCGGATCCTGAAGCTTTCTTT	CAISPDPEAFF	TRBV10-3	TRBJ1-1
TGTGCCAGCAGCTCTAGGGAATTTTGCGAGCAGTACTTC	CASSSREFCEQYF	TRBV7-3	TRBJ2-7
TGTGCCACCGGCCAGTGGACAGGGCAGACTAACTATGGCTACACCTTC	CATGQWTGQTNYGYTF	TRBV24-1	TRBJ1-2
TGTGCCAGCAGTGATCCCCCAAAACCGGTGGACTTTAACTGGACCGGGGAGCTGTTTTTT	CASSDPPKPVDFNWTGELFF	TRBV6-4	TRBJ2-2
TGTGCCAGCAGCAAACAACCGGCGGAGACCCAGTACTTC	CASSKQPAETQYF	TRBV11-2	TRBJ2-5
TGTGCCAGCAGCACGGACGGGACTGAAGCTTTCTTT	CASSTDGTEAFF	TRBV9	TRBJ1-1
TGCAGCGTTGAAGATCCAGGGGGCGAAGCTTTCTTT	CSVEDPGGEAFF	TRBV29-1	TRBJ1-1
TGTGCCAGCAGTTATAAGGAAGCAGGGGCTTCTGAAGCTTTCTTT	CASSYKEAGASEAFF	TRBV6-5	TRBJ1-1
TGTGCCAGCCGACTAGCGGTTCCAAATGAGCAGTTCTTC	CASRLAVPNEQFF	TRBV2	TRBJ2-1
TGCGCCAGCAGTGAGCGAGCGGGAGTCCCAACCACCGGGGAGCTGTTTTTT	CASSERAGVPTTGELFF	TRBV10-2	TRBJ2-2
TGTGCCAGCTCAGGGGGGCATAGGGGCGGAAACACCATATATTTT	CASSGGHRGGNTIYF	TRBV18	TRBJ1-3
TGTGCCAGCAGCTTGGTCCCCTGGGCCTACACCGGGGAGCTGTTTTTT	CASSLVPWAYTGELFF	TRBV5-4	TRBJ2-2
TGTCTCCCCTTGATAAACACTGAAGCTTTCTTT	CLPLINTEAFF	TRBV6-1	TRBJ1-1
TGTGCCACCCCCCCATTTCCGGGACGGAGGAGCTCCTACAATGAGCAGTTCTTC	CATPPFPGRRSSYNEQFF	TRBV15	TRBJ2-1
TGTGCCAGCAGTTTGATACAGGGGCCGCTCAGGGAGACCCAGTACTTC	CASSLIQGPLRETQYF	TRBV28	TRBJ2-5
TGCAGTGCCCCCCCAGAAGCTGGGGTGAACACTGAAGCTTTCTTT	CSAPPEAGVNTEAFF	TRBV20-1	TRBJ1-1
TGTGCCAGCAGCCCAATCGACGGCGGAAACACCATATATTTT	CASSPIDGGNTIYF	TRBV5-6	TRBJ1-3
TGTGCCAGCAGCCCCCCCGGGACTATCAATGAGCAGTTCTTC	CASSPPGTINEQFF	TRBV5-6	TRBJ2-1
TGTGCCAGCAGCTTTGGGAGGCAGGCCCCTCACACTGAAGCTTTCTTT	CASSFGRQAPHTEAFF	TRBV13	TRBJ1-1
TGTGCCAGCAGCAGACAGCCACTCTCCTACGAGCAGTACTTC	CASSRQPLSYEQYF	TRBV11-2	TRBJ2-7
TGTGCCAGCAGCACAGGGACGACTGAAGCTTTCTTT	CASSTGTTEAFF	TRBV5-4	TRBJ1-1
TGTGCCAGCAGCTTAGTGGATTACGGACTAGCGGGTCCGTCCTACAATGAGCAGTTCTTC	CASSLVDYGLAGPSYNEQFF	TRBV7-6	TRBJ2-1
TGTGCCAGCAAGTCTGGGACAGGGTCTGTGGATACTGAAGCTTTCTTT	CASKSGTGSVDTEAFF	TRBV2	TRBJ1-1
TGTGCCAGCAGTGCGAGGGACTATAATTCACCCCTCCACTTT	CASSARDYNSPLHF	TRBV6-1	TRBJ1-6
TGTGCCAGGACAGGCCGCACTGAAGCTTTCTTT	CARTGRTEAFF	TRBV6-1	TRBJ1-1
TGTGCCAGCAGCTTAGATGGGGACAGGGGCGATGAAAAACTGTTTTTT	CASSLDGDRGDEKLFF	TRBV11-3	TRBJ1-4
TGTGCCAGCTCACCGAAAATCCGGACTGGGGCGCAAGAGACCCAGTACTTC	CASSPKIRTGAQETQYF	TRBV18	TRBJ2-5
TGTGCCAGCATAGCGGTGGGGGAGAACACTGAAGCTTTCTTT	CASIAVGENTEAFF	TRBV6-4	TRBJ1-1
TGCGCCAGCAGTGAGGGTCCGGGACTAGCGGGGGGGCGACGCGATGAGCAGTTCTTC	CASSEGPGLAGGRRDEQFF	TRBV10-1	TRBJ2-1
TGTGCCAGCAGTTACCCTCTAGCGGGGTTTATGAGCTCCTACGAGCAGTACTTC	CASSYPLAGFMSSYEQYF	TRBV6-5	TRBJ2-7
TGTGCCACCAAGGGGCGGGAGGTTCAAGAGACCCAGTACTTC	CATKGREVQETQYF	TRBV15	TRBJ2-5
TGTGCCAGCAGCCCCGAATTCCTAACTGAAGCTTTCTTT	CASSPEFLTEAFF	TRBV9	TRBJ1-1
TGTGCCAGCAGCAGACGGGACAGGGGAGGCAATAGCAATCAGCCCCAGCATTTT	CASSRRDRGGNSNQPQHF	TRBV13	TRBJ1-5
TGTGCCAGCAGCTTAGCACCGGGGGGTAGCCAAGAGACCCAGTACTTC	CASSLAPGGSQETQYF	TRBV7-9	TRBJ2-5
TGTGCCAGCAGCGTTCTGCAGTCAGGGACCTATGGCTACACCTTC	CASSVLQSGTYGYTF	TRBV11-3	TRBJ1-2
TGTGCCAGCAGTTTAGCCGGGAATTACCAAGAGACCCAGTACTTC	CASSLAGNYQETQYF	TRBV12-3	TRBJ2-5
TGTGCCAGCAGCACCCCGAAAGCGGGGGGATGTCCGTCCTACGAGCAGTACTTC	CASSTPKAGGCPSYEQYF	TRBV13	TRBJ2-7
TGTGCCAGCAGCAGAAGGTTCCAGGGGACGGGGTCCAGCTCCTACGAGCAGTACTTC	CASSRRFQGTGSSSYEQYF	TRBV7-6	TRBJ2-7
TGCAGTGCTGGGTGGGGGGAGGTAGATACGCAGTATTTT	CSAGWGEVDTQYF	TRBV20-1	TRBJ2-3
TGTGCCAGCAGTTTATCTTCAGTGACCCGGAGGCCTGAAGCTTTCTTT	CASSLSSVTRRPEAFF	TRBV27	TRBJ1-1
TGTGCCAGGGTGGACAGCAGCTCACCCCTCCACTTT	CARVDSSSPLHF	TRBV6-5	TRBJ1-6
TGCAGTGCTAGAGATCCGAACCATTTCAAAAACATTCAGTACTTC	CSARDPNHFKNIQYF	TRBV20-1	TRBJ2-4
TGTGCCAGCAGCGCGACAGGGTTCCAATACACCGGGGAGCTGTTTTTT	CASSATGFQYTGELFF	TRBV6-5	TRBJ2-2
TGTGCCAGCAGCCTTGGCGGCGGGGAGTGCACAGATACGCAGTATTTT	CASSLGGGECTDTQYF	TRBV14	TRBJ2-3
TGTGCCAGCAGCCAAGCTAGAAATTGCCGGGACAGTGGCCCCATGAAGTCACCCCTCCACTTT	CASSQARNCRDSGPMKSPLHF	TRBV3-1	TRBJ1-6
TGTGCCAGCAGCTTAATCCCGGACAGGATCTTCTACAATGAGCAGTTCTTC	CASSLIPDRIFYNEQFF	TRBV11-3	TRBJ2-1
TGTGCCAGCAGCCCGGGACAGGAAAGAGAGAAGGGGTGGAACACTGAAGCTTTCTTT	CASSPGQEREKGWNTEAFF	TRBV7-4	TRBJ1-1
TGCAGCGTTGCTTGGGCCAAAAACATTCAGTACTTC	CSVAWAKNIQYF	TRBV29-1	TRBJ2-4
TGTGCCAGCTTTCGGAAGGGGTGTCCTACTGAAGCTTTCTTT	CASFRKGCPTEAFF	TRBV6-8	TRBJ1-1
TGTGCCAGCAGCCCCTCCAGTACAAATCAGCCCCAGCATTTT	CASSPSSTNQPQHF	TRBV9	TRBJ1-5
TGTGCCACCAGTGGGACGGGACATGCTCAGCCCCAGCATTTT	CATSGTGHAQPQHF	TRBV24-1	TRBJ1-5
TGTGCCAGCAGCTTAATAGCCATCTACAGGGGGGTGTTTGATACGCAGTATTTT	CASSLIAIYRGVFDTQYF	TRBV7-4	TRBJ2-3
TGTGCCAGCAGCGTAGCAAACTCTATGGGGAATATGCGTTACTATGGCTACACCTTC	CASSVANSMGNMRYYGYTF	TRBV9	TRBJ1-2
TGTGCCAGCAGTGCCGAATTAGCCCCTAGCCTGGTGGAGCAGTACTTC	CASSAELAPSLVEQYF	TRBV2	TRBJ2-7
TGTGCCAGCAGGGTTTGTGGGCCTGGGGGGGCCCAGTCCCCCAATGAGCAGTTCTTC	CASRVCGPGGAQSPNEQFF	TRBV27	TRBJ2-1
TGTGCTAAGTTTCCGGGGCTTCGAGGCTACACCTTC	CAKFPGLRGYTF	TRBV12-5	TRBJ1-2
TGTGCCAGCAGAGGGGGCCTAGGACCAATCAAGAATCAGCCCCAGCATTTT	CASRGGLGPIKNQPQHF	TRBV7-9	TRBJ1-5
TGCGCCAGCAGTCGTTATTACACTGAAGCTTTCTTT	CASSRYYTEAFF	TRBV10-2	TRBJ1-1
TGTGCCAGCAGTTACCCCTTTTCTGGAAACACCATATATTTT	CASSYPFSGNTIYF	TRBV6-6	TRBJ1-3
TGTGCCAGCAGTTACTGCCCAAGGGGCCGTACCTACGAGCAGTACTTC	CASSYCPRGRTYEQYF	TRBV6-5	TRBJ2-7
TGTGCCAGCAGTGAGAGGGGAGAGACCCAGTACTTC	CASSERGETQYF	TRBV25-1	TRBJ2-5
TGTGCCAGCAGTGGGTCGGGTGAAGGCTACGAGCAGTACTTC	CASSGSGEGYEQYF	TRBV28	TRBJ2-7
TGTGCCAGCAGCGGGGAAACAGGGGTGGTATACTATGGCTACACCTTC	CASSGETGVVYYGYTF	TRBV11-2	TRBJ1-2
TGTGCCAGCAGCCGAGGCAGGGGCTATCAGCCCCAGCATTTT	CASSRGRGYQPQHF	TRBV14	TRBJ1-5
TGTGCCAGCAGTTCCACAGCCACCGGGGAGCTGTTTTTT	CASSSTATGELFF	TRBV12-3	TRBJ2-2
TGTGCCAGCAGTAGGAGGTCAAGACATGGAAACACCATATATTTT	CASSRRSRHGNTIYF	TRBV6-5	TRBJ1-3
TGTGCCAGCAGCTACCGGGCCCACATTCCCTACGAGCAGTACTTC	CASSYRAHIPYEQYF	TRBV7-4	TRBJ2-7
TGTGCTCATTCCGGACGAGTCGGGGCCAAAAACATTCAGTACTTC	CAHSGRVGAKNIQYF	TRBV12-5	TRBJ2-4
TGTGCCAGCAGCTTAGGCCACAGGGCCTACGAGCAGTACTTC	CASSLGHRAYEQYF	TRBV7-6	TRBJ2-7
TGTGCCAGCAGCTATCTGGACCAGCCGGTGTGGGCTAGCACAGATACGCAGTATTTT	CASSYLDQPVWASTDTQYF	TRBV5-8	TRBJ2-3
TGTGCCAGCAGCTTACCGCTCCGGGACAGGGTGGGAGGCTACACCTTC	CASSLPLRDRVGGYTF	TRBV7-9	TRBJ1-2
TGTGCCAGCAGCAGAAAATTTCAGGGGAACACTGAAGCTTTCTTT	CASSRKFQGNTEAFF	TRBV7-4	TRBJ1-1
TGTGCCAGCAACCGTTCAGAGAATCAGCCCCAGCATTTT	CASNRSENQPQHF	TRBV5-6	TRBJ1-5
TGTGCCACCAGTGATCCTTGGCAGGGCCCGCCGCCGGGAATGAACACTGAAGCTTTCTTT	CATSDPWQGPPPGMNTEAFF	TRBV24-1	TRBJ1-1
TGCAGCGCCATGGACAGGGGGGCGTTCCGCCAAGAGACCCAGTACTTC	CSAMDRGAFRQETQYF	TRBV29-1	TRBJ2-5
TGTGCCACCAGTGATGGGCAGACAGAGACCCAGTACTTC	CATSDGQTETQYF	TRBV24-1	TRBJ2-5
TGCGCCAGCAGCTTGGCGGGCCTACGGGACAAGGATCAGCCCCAGCATTTT	CASSLAGLRDKDQPQHF	TRBV5-1	TRBJ1-5
TGTGCCAGCAGCTACGGACAGCTACACAATGAAAAACTGTTTTTT	CASSYGQLHNEKLFF	TRBV7-9	TRBJ1-4
TGTGCCAGCTCACCACGGAGGTTATCGGACACTGAAGCTTTCTTT	CASSPRRLSDTEAFF	TRBV18	TRBJ1-1
TGCGCCAGCAAACCGGGACTTGGGTGGTGCAAAAACACCGGGGAGCTGTTTTTT	CASKPGLGWCKNTGELFF	TRBV10-1	TRBJ2-2
TGTGCCGAGCTAGGGGTCAGCCTAGGTTGTCACACTGAAGCTTTCTTT	CAELGVSLGCHTEAFF	TRBV27	TRBJ1-1
TGTGCCAGCAGCTCGGGGAAGAATGAGCAGTTCTTC	CASSSGKNEQFF	TRBV13	TRBJ2-1
TGTGCCAGCAGCGCCGACCGGGAGGGCTACACCTTC	CASSADREGYTF	TRBV7-3	TRBJ1-2
TGTGCCACCAGGGCGGGACACAAAACCTATGGCTACACCTTC	CATRAGHKTYGYTF	TRBV24-1	TRBJ1-2
TGCGCCAGCAGCCCGCGGGAGACAGATACGCAGTATTTT	CASSPRETDTQYF	TRBV5-1	TRBJ2-3
TGCACGGACAGGGTCTCCAGCTCCTACGAGCAGTACTTC	CTDRVSSSYEQYF	TRBV20-1	TRBJ2-7
TGCGCCAGCAGCTGGGTGCCGCGGGAGTCCAGGTATGAGCAGTTCTTC	CASSWVPRESRYEQFF	TRBV5-1	TRBJ2-1
TGTGCCAGCATTCCCCCGAGCTGTCGCTATGAGCAGTTCTTC	CASIPPSCRYEQFF	TRBV13	TRBJ2-1
TGTGCCAGCAGCCTCGGGTACGAGCAGTACTTC	CASSLGYEQYF	TRBV7-3	TRBJ2-7
