TGTGCCAGAACGAGGGACAGCTCCTACGAGCAGTACTTC	CARTRDSSYEQYF	TRBV6-5	TRBJ2-7
TGTGCCAGCAGCTTGGGTGACAGGGGAAGCTCTGGAAACACCATATATTTT	CASSLGDRGSSGNTIYF	TRBV5-4	TRBJ1-3
TGTGCCAGCAGTTTGAGGGACAGGGGAATCTACAATGAGCAGTTCTTC	CASSLRDRGIYNEQFF	TRBV27	TRBJ2-1
TGTGCCAGCAAGACCTGCACAGATACGCAGTATTTT	CASKTCTDTQYF	TRBV12-3	TRBJ2-3
TGCGCCAGCAGCTTAGGAGCTCGACTAGCGGGAGGGAGTCGAGAGACCCAGTACTTC	CASSLGARLAGGSRETQYF	TRBV5-1	TRBJ2-5
TGTGCCAGCAGCGAGTACGGGACAGGGGGCTACGAGCAGTACTTC	CASSEYGTGGYEQYF	TRBV7-4	TRBJ2-7
TGTGCCAGCAGCTGTCCGGGGGCCAGATCTAACTATGGCTACACCTTC	CASSCPGARSNYGYTF	TRBV28	TRBJ1-2
TGCGCCAGCACCGAGGAGCGGAGGGACAGTGAAAAACTGTTTTTT	CASTEERRDSEKLFF	TRBV10-1	TRBJ1-4
TGCGCCAGCAGTGAGTCGGTTCGAAAACGGGAAGATACGCAGTATTTT	CASSESVRKREDTQYF	TRBV10-1	TRBJ2-3
TGTGCCAGCAGCTACAGGGGGGGGACTGAAGCTTTCTTT	CASSYRGGTEAFF	TRBV7-3	TRBJ1-1
TGTGCTAGTGGTTTGGTACCACAGAGGGGTGCAACTAATGAAAAACTGTTTTTT	CASGLVPQRGATNEKLFF	TRBV12-5	TRBJ1-4
TGCAGTGCTGGATTCAATGAGCAGTTCTTC	CSAGFNEQFF	TRBV20-1	TRBJ2-1
TGTGCTAGTGGTAGAGATAATGGACTAGCGGGGCCTCCGAACTACGAGCAGTACTTC	CASGRDNGLAGPPNYEQYF	TRBV12-5	TRBJ2-7
TGTGCCAGCAGCTTATCTCATTACTTTCAGCCCCAGCATTTT	CASSLSHYFQPQHF	TRBV7-9	TRBJ1-5
TGTGCCAGCAGCTTGACGCTGACAGGGAGGTGTAACGAGCAGTACTTC	CASSLTLTGRCNEQYF	TRBV7-3	TRBJ2-7
TGCGCCAGCGAATGGGACAGTAATGAAAAACTGTTTTTT	CASEWDSNEKLFF	TRBV10-1	TRBJ1-4
TGCAGCGGCACAGGATTGCAAGAGACCCAGTACTTC	CSGTGLQETQYF	TRBV29-1	TRBJ2-5
TGTGCCAGCAGTGACCTCGGAAACAGGGAGGCTGGAAACACCATATATTTT	CASSDLGNREAGNTIYF	TRBV28	TRBJ1-3
TGTGCCAGCAGTGACAAACTGGGGGTTACCTACAATGAGCAGTTCTTC	CASSDKLGVTYNEQFF	TRBV6-4	TRBJ2-1
TGTGCCAGCAGCAAGCGGTGGAATCCGGGACTAGCGGGGTCCGGGGAGCTGTTTTTT	CASSKRWNPGLAGSGELFF	TRBV7-4	TRBJ2-2
TGTGCCAGCAGTGGGCGGGAGTGGGGTGATACGCAGTATTTT	CASSGREWGDTQYF	TRBV6-8	TRBJ2-3
TGCAGCGGGGAACAGGGTCAAGAGACCCAGTACTTC	CSGEQGQETQYF	TRBV29-1	TRBJ2-5
TGTGCCAGCAGTTTAACCTACGAGCAGTACTTC	CASSLTYEQYF	TRBV12-3	TRBJ2-7
TGTGCCAGCAGCCCCCCCCGGGCCTTAATGAACACTGAAGCTTTCTTT	CASSPPRALMNTEAFF	TRBV3-1	TRBJ1-1
TGTGCCAGCAGAAGGGGTAAGGGGAATGGCTACACCTTC	CASRRGKGNGYTF	TRBV6-5	TRBJ1-2
TGTGCCAGCAGCTTACAAAAAATCAATACACCCCTCCACTTT	CASSLQKINTPLHF	TRBV11-2	TRBJ1-6
TGTGCCAGCAGTTTAGGAGGAAACCACAGGGGGGCTGAAGCTTTCTTT	CASSLGGNHRGAEAFF	TRBV12-3	TRBJ1-1
TGTGCCAGCAGCGCGGGTAGCGCCTTGAAGTTAGGCGAGACCCAGTACTTC	CASSAGSALKLGETQYF	TRBV11-2	TRBJ2-5
TGTGCCAGCAGTGACGGACAGTTCCAAGAGACCCAGTACTTC	CASSDGQFQETQYF	TRBV25-1	TRBJ2-5
TGTGCCAGCAGTAAGGGACAGGGGACAGATACGCAGTATTTT	CASSKGQGTDTQYF	TRBV12-3	TRBJ2-3
TGTGCCAGCAGCCAAGAGCCGGGACAGGGGGGGAGTAACACCGGGGAGCTGTTTTTT	CASSQEPGQGGSNTGELFF	TRBV7-4	TRBJ2-2
TGCAGTGCTAGGCCACCGGGACTAGCGGGAGTGGAAAATTACGAGCAGTACTTC	CSARPPGLAGVENYEQYF	TRBV20-1	TRBJ2-7
TGTGCCAGCAGCAGGCACCAACGAGGGACAGTGGCCAAAAACATTCAGTACTTC	CASSRHQRGTVAKNIQYF	TRBV7-2	TRBJ2-4
TGTGCCAGCTCACCAGGGATGGGGGCGACAGGTAAGAGCAATCAGCCCCAGCATTTT	CASSPGMGATGKSNQPQHF	TRBV18	TRBJ1-5
TGTGCCAGTTCCCCCGGACAGGGGGCGCACTTGTACTTC	CASSPGQGAHLYF	TRBV19	TRBJ2-7
TGCAGTGCTGTAGAAAAGACAGGGGAGTTGAGTAATTCACCCCTCCACTTT	CSAVEKTGELSNSPLHF	TRBV20-1	TRBJ1-6
TGCGCCAGCAGCTACCGGGGCCTAGCCAAAAACATTCAGTACTTC	CASSYRGLAKNIQYF	TRBV4-1	TRBJ2-4
TGTGCCAGCAGCTTAGCGCAGGCGGGACAGGCAAGCGAGCAGTACTTC	CASSLAQAGQASEQYF	TRBV7-2	TRBJ2-7
TGTGCTAGTGGTCCCACAGCTAAGTCTGAAGCTTTCTTT	CASGPTAKSEAFF	TRBV12-5	TRBJ1-1
TGTGCCAGCAGCTTAGATCTAGCGGGGGCCGGCACAGATACGCAGTATTTT	CASSLDLAGAGTDTQYF	TRBV11-2	TRBJ2-3
TGTGCTAGCGGCACCGGGGAGCTGTTTTTT	CASGTGELFF	TRBV12-3	TRBJ2-2
TGTGCCAGCAGCAAGGGGGTCCTGGGCCAAGAGACCCAGTACTTC	CASSKGVLGQETQYF	TRBV13	TRBJ2-5
TGTGCCAGCTTGTTCTATGGGACCGCTACCTACGAGCAGTACTTC	CASLFYGTATYEQYF	TRBV27	TRBJ2-7
TGTGCCACGATAGGTGAGCGGACGAGGAACACTGAAGCTTTCTTT	CATIGERTRNTEAFF	TRBV19	TRBJ1-1
TGTGCCAGCAGCTTCGTCACCGGGCGACTTGAGCAGTTCTTC	CASSFVTGRLEQFF	TRBV7-4	TRBJ2-1
TGCGCCAGCAGCTTCAGAACAGGGCTGTCTTACAATCAGCCCCAGCATTTT	CASSFRTGLSYNQPQHF	TRBV5-1	TRBJ1-5
TGCGCCAGCAGCTTGGGTCGAAGTACAGGGGGCGCAGAGGGTGAGTTTGTGAACACTGAAGCTTTCTTT	CASSLGRSTGGAEGEFVNTEAFF	TRBV5-1	TRBJ1-1
TGTGCCAGCAGCTTATTCGTCCTTGCAACTAATGAAAAACTGTTTTTT	CASSLFVLATNEKLFF	TRBV7-2	TRBJ1-4
TGTGCCAGCAGCTTAATGACAGGGTCCGCTTTCTTT	CASSLMTGSAFF	TRBV11-2	TRBJ1-1
TGTGCCAGCAGTTTATCTAGCGGGTCGACAATTGGAGAGCAGTACTTC	CASSLSSGSTIGEQYF	TRBV28	TRBJ2-7
TGTGCCACCAGCAGTTTGGTAAGACCGGGCTACAATGAGCAGTTCTTC	CATSSLVRPGYNEQFF	TRBV15	TRBJ2-1
TGTGCCAGCAGCCAAAGGAGAGGCACAGATACGCAGTATTTT	CASSQRRGTDTQYF	TRBV3-1	TRBJ2-3
TGCGTAACCGGGGGCCGTAATCGAAGCTACGAGCAGTACTTC	CVTGGRNRSYEQYF	TRBV5-1	TRBJ2-7
TGTCGCCCAGCCCCCCTCCACTTT	CRPAPLHF	TRBV20-1	TRBJ1-6
TGTGCCAGCAGCAAAGTTTGGCGCTGGGGATCTGGGGCCAACGTCCTGACTTTC	CASSKVWRWGSGANVLTF	TRBV6-4	TRBJ2-6
TGTGCCAGCAGAAGGGTAGCGGCTGATGGGACCTACGAGCAGTACTTC	CASRRVAADGTYEQYF	TRBV6-1	TRBJ2-7
TGCAGTGCGAGGCCCACCCTAGCGGGGTGGGAAGATACGCAGTATTTT	CSARPTLAGWEDTQYF	TRBV20-1	TRBJ2-3
TGTGCCAGCAGTCAGGTTGGGGACAGGGGCGAGACCCAGTACTTC	CASSQVGDRGETQYF	TRBV6-8	TRBJ2-5
TGTGTGCAGTCTTCAAGAGGCACAGATACGCAGTATTTT	CVQSSRGTDTQYF	TRBV24-1	TRBJ2-3
TGTGCCAGCAGCGGGGGAGGGTCCTACAATGAGCAGTTCTTC	CASSGGGSYNEQFF	TRBV13	TRBJ2-1
TGCGCCAGCAGCCGGGCGGCTGGACTAGATACGCAGTATTTT	CASSRAAGLDTQYF	TRBV4-3	TRBJ2-3
TGTGCCAGCAGCGTCTCTCTAGCCAGCGAGCAGTACTTC	CASSVSLASEQYF	TRBV9	TRBJ2-7
TGTGCCAGCAGCAACCAGGGGGGCCTAACGAGCTCCTACGAGCAGTACTTC	CASSNQGGLTSSYEQYF	TRBV7-3	TRBJ2-7
TGTGCCAGCAGCCGTTGGGGCCGGGACCGATACAATGAGCAGTTCTTC	CASSRWGRDRYNEQFF	TRBV6-8	TRBJ2-1
TGCAGTGCTAGGGAAGGTAATTCACCCCTCCACTTT	CSAREGNSPLHF	TRBV20-1	TRBJ1-6
TGTGCCAGCAGCTTTCGTGCCCAGGCATATGGCTACACCTTC	CASSFRAQAYGYTF	TRBV5-4	TRBJ1-2
TGTGCCAGCTATAGGGGGAGAGGGAGCTCCTACAATGAGCAGTTCTTC	CASYRGRGSSYNEQFF	TRBV5-6	TRBJ2-1
TGTGCCAGCAGCTTAGAAGCCCCCCCCAGAGGGCTCCCTGGAAACACCATATATTTT	CASSLEAPPRGLPGNTIYF	TRBV11-2	TRBJ1-3
TGTGCCAGCAGCTGGGGACAGGGGGCGATGGGGGGCTATGGCTACACCTTC	CASSWGQGAMGGYGYTF	TRBV7-3	TRBJ1-2
TGTGCCAGCTCACCAGGAAGGGGCAAGTACAATGAGCAGTTCTTC	CASSPGRGKYNEQFF	TRBV18	TRBJ2-1
TGTGCCAGCAGAGGAGGCCGGGACGGGGGAACGGCTAGCACAGATACGCAGTATTTT	CASRGGRDGGTASTDTQYF	TRBV28	TRBJ2-3
TGTGCCACCAGTGATTTGCTAACCATACAGGGGTGTACAGATACGCAGTATTTT	CATSDLLTIQGCTDTQYF	TRBV24-1	TRBJ2-3
TGTGCCAGCAGCGGACGAAGAGCACCCCTCCACTTT	CASSGRRAPLHF	TRBV13	TRBJ1-6
TGTGCCAGCAGCCGGGGCGGCACCTTCTGTGCTTTCTTT	CASSRGGTFCAFF	TRBV7-9	TRBJ1-1
TGTGCCAGCAGCTTCAACAACACAGGGAGCACTGGGGCCAACGTCCTGACTTTC	CASSFNNTGSTGANVLTF	TRBV5-5	TRBJ2-6
TGTGCCAGCAGCATTAGAGCGGGACAGGTAGACGAGCAGTACTTC	CASSIRAGQVDEQYF	TRBV7-9	TRBJ2-7
TGTGCCACCAGTGATTTATCATTACAGGGGTATAAAGAGACCCAGTACTTC	CATSDLSLQGYKETQYF	TRBV24-1	TRBJ2-5
TGTGCCAGCAGCTTAGCAAGTACTGAAGCTTTCTTT	CASSLASTEAFF	TRBV11-2	TRBJ1-1
TGTGCCAGCAGCTTGCACGGGGAAGCTTTCTTT	CASSLHGEAFF	TRBV7-2	TRBJ1-1
TGTGCCAGCAGCTTTGGCCACAGGGACTTCACTGAAGCTTTCTTT	CASSFGHRDFTEAFF	TRBV7-4	TRBJ1-1
TGTGCCAGCAGAGATTTGATACCCTACGAGCAGTACTTC	CASRDLIPYEQYF	TRBV6-1	TRBJ2-7
TGTGCAAACGTGAATGAGCAGTTCTTC	CANVNEQFF	TRBV15	TRBJ2-1
TGCAGTGCAGGGGGGACAGAGGTGAAATACATGAACACTGAAGCTTTCTTT	CSAGGTEVKYMNTEAFF	TRBV20-1	TRBJ1-1
TGTGCCAGCAGTGACCCCCGGGACGGTAATCAGCCCCAGCATTTT	CASSDPRDGNQPQHF	TRBV6-4	TRBJ1-5
TGTGCCAGTAGTAATGGGGGAGGGCGGGTCTCAGGGCATGAAGCTTTCTTT	CASSNGGGRVSGHEAFF	TRBV19	TRBJ1-1
TGTGCCAGCAGCCTTTCTAGGGACTACACAGATACGCAGTATTTT	CASSLSRDYTDTQYF	TRBV7-2	TRBJ2-3
TGTGCCAGCAGGCGATCTCGTAGCAATCAGCCCCAGCATTTT	CASRRSRSNQPQHF	TRBV28	TRBJ1-5
TGTGCCAGCAAATCCGGGTTGCAGGGGGACACTGAAGCTTTCTTT	CASKSGLQGDTEAFF	TRBV7-3	TRBJ1-1
TGTGCCAGCAGGCTATCCCCCTTGGGAGCAGGAGGTCGGGAATCCCACGAGCAGTACTTC	CASRLSPLGAGGRESHEQYF	TRBV7-3	TRBJ2-7
TGTGCCATGGGGGGTTATGAGCAGTTCTTC	CAMGGYEQFF	TRBV7-8	TRBJ2-1
TGCGCCAGCTCTGAAAACAGGGTAGACTCCTACGAGCAGTACTTC	CASSENRVDSYEQYF	TRBV4-1	TRBJ2-7
TGCAGTGCTCCTAGCGGGGGCCCCGGGGAGCTGTTTTTT	CSAPSGGPGELFF	TRBV20-1	TRBJ2-2
TGTGCCAGCAGCTGCGGGGCCACTGAAGCTTTCTTT	CASSCGATEAFF	TRBV5-4	TRBJ1-1
TGTGCTAGCAGCTTCATTGACAGGGGGCGGGCCGGGGAGCTGTTTTTT	CASSFIDRGRAGELFF	TRBV7-7	TRBJ2-2
TGTGCCAGCAGCTTAGGCCTTCGGAGCCACTCGGCTGATACGCAGTATTTT	CASSLGLRSHSADTQYF	TRBV11-2	TRBJ2-3
TGTGCCAGCAGCAGGAGCCAGCCCTGGGCTGCAGATACGCAGTATTTT	CASSRSQPWAADTQYF	TRBV7-4	TRBJ2-3
TGTGCCAGCAGTGGGTGGCTTGGCTCCAACACCATATATTTT	CASSGWLGSNTIYF	TRBV6-6	TRBJ1-3
TGCAGTGCCGCCCCCCCCTGGAATTCGGAGACAAACGGAACTGAAGCTTTCTTT	CSAAPPWNSETNGTEAFF	TRBV20-1	TRBJ1-1
TGTGCCACCAGTACGCTAGCCTCCTACGAGCAGTACTTC	CATSTLASYEQYF	TRBV24-1	TRBJ2-7
TGTGCCAGCAGTGACGGACTGCCTAATAAAGAGACCCAGTACTTC	CASSDGLPNKETQYF	TRBV6-4	TRBJ2-5
TGTGCCAGCATGCGGTCTGTTTCAGATACGCAGTATTTT	CASMRSVSDTQYF	TRBV27	TRBJ2-3
TGTGCCAGCAGCCAGACTAGCGGGAGTGCAGCCTACGAGCAGTACTTC	CASSQTSGSAAYEQYF	TRBV7-3	TRBJ2-7
TGTGCCAGCAGCCGATGGCGGGAGAAAGACGAGCAGTACTTC	CASSRWREKDEQYF	TRBV7-4	TRBJ2-7
TGTGCCAGCAGTTACTCTATGGACAGGGAGCCCTCCTATAATTCACCCCTCCACTTT	CASSYSMDREPSYNSPLHF	TRBV6-2	TRBJ1-6
TGTGCCAGCAGGGACAGCAGGACGGAGACCCAGTACTTC	CASRDSRTETQYF	TRBV28	TRBJ2-5
TGCGCCAGCAGCTTGGGGGCAGGGGCATGGAACACTGAAGCTTTCTTT	CASSLGAGAWNTEAFF	TRBV5-1	TRBJ1-1
TGTGCCACCGGGTCCTCCCGGACTGGTCACTCTAATGAAAAACTGTTTTTT	CATGSSRTGHSNEKLFF	TRBV4-2	TRBJ1-4
TGTGCCACATCGAGTCAAAATCAGCCCCAGCATTTT	CATSSQNQPQHF	TRBV24-1	TRBJ1-5
TGTGCCAGCAGCGGAGAACACCCCCCGGACGGTTGGAGCTCCTACGAGCAGTACTTC	CASSGEHPPDGWSSYEQYF	TRBV5-6	TRBJ2-7
TGTGCCAGCAGTTACACCGTTAGACTAGTGGCGCCCTACAATGAGCAGTTCTTC	CASSYTVRLVAPYNEQFF	TRBV6-5	TRBJ2-1
TGTGCCAGCAGCGATACCAAGGGGACAGGGAAGAATAATTCACCCCTCCACTTT	CASSDTKGTGKNNSPLHF	TRBV5-6	TRBJ1-6
TGTGCCAGTAGTATGGGCTGGACCTCAAGAGAGACCCAGTACTTC	CASSMGWTSRETQYF	TRBV19	TRBJ2-5
TGTGCCAGCAGCCGACTAGGGGCCACCGGGGAGCTGTTTTTT	CASSRLGATGELFF	TRBV7-3	TRBJ2-2
TGTGCCAGCAGCAATTGCGGGAGCGAGCAGTACTTC	CASSNCGSEQYF	TRBV5-4	TRBJ2-7
TGCGCCAGCAGCCAAGATAAGGGACTAGCGGGCGACCAAGAGACCCAGTACTTC	CASSQDKGLAGDQETQYF	TRBV4-3	TRBJ2-5
TGTGCCACCAGTCCCTACAAAGACCAGGCATATGGCTACACCTTC	CATSPYKDQAYGYTF	TRBV24-1	TRBJ1-2
TGCGCCAGCAGCTGGAGCGGGACCGGGGGCGAGCAGTACTTC	CASSWSGTGGEQYF	TRBV5-1	TRBJ2-7
TGCGCCAAGTTCCAGGGGGATAGGAACTATGGCTACACCTTC	CAKFQGDRNYGYTF	TRBV4-3	TRBJ1-2
TGTGCCAGCCCCGTCCCAGGGGCGTCTATAGAGCAGTACTTC	CASPVPGASIEQYF	TRBV2	TRBJ2-7
TGTGCCAGCAGTGGCCAACCTAGGACGAAAATGTCAGATACGCAGTATTTT	CASSGQPRTKMSDTQYF	TRBV28	TRBJ2-3
TGCGCCAGCAGTGAGACTAGCGGGGGGACCTACGAGCAGTACTTC	CASSETSGGTYEQYF	TRBV10-1	TRBJ2-7
TGCAGCGCCCCCTATGAGCAGTTCTTC	CSAPYEQFF	TRBV29-1	TRBJ2-1
TGCGCCAGCAGCTTGCCCCTCCCCGGCAGGGTCAGCCCACGAGAGACCCAGTACTTC	CASSLPLPGRVSPRETQYF	TRBV5-1	TRBJ2-5
TGTGCCAGCAGGACCGGGACTAGCGGGCCAACCTCCGGGGAGCTGTTTTTT	CASRTGTSGPTSGELFF	TRBV6-4	TRBJ2-2
TGTGCCAGCAGGCCGGGGGGACACGCTGGAAACACCATATATTTT	CASRPGGHAGNTIYF	TRBV12-4	TRBJ1-3
TGTGCCAGCAGCGTTCGACAGGATAGGAACTATGGCTACACCTTC	CASSVRQDRNYGYTF	TRBV9	TRBJ1-2
TGTGCCAGCAGCCAATACCCGAAACAGGGCACTGAAGCTTTCTTT	CASSQYPKQGTEAFF	TRBV16	TRBJ1-1
TGTGCCAGTAGTTTCCGGATGATACTCTACGAGCAGTACTTC	CASSFRMILYEQYF	TRBV19	TRBJ2-7
TGTGCCAGCAGTTGGTCGAACAGGACAGCCGCTTGGAACACTGAAGCTTTCTTT	CASSWSNRTAAWNTEAFF	TRBV12-3	TRBJ1-1
TGTGCCAGTAAGACGGAAGCTTTCTTT	CASKTEAFF	TRBV19	TRBJ1-1
TGTGCCAGCAGCACCTCGTTGACAGGGAACCATAGCAATCAGCCCCAGCATTTT	CASSTSLTGNHSNQPQHF	TRBV5-6	TRBJ1-5
TGTGCCAGCAGTTCCCCCCCCCCTCAGATCGTTTTAACTCCACGGGACAGGGGGCTCTACACCTTC	CASSSPPPQIVLTPRDRGLYTF	TRBV6-5	TRBJ1-2
TGCGCCAGCACTGACAGGGCGGTTTTCGAGCAGTACTTC	CASTDRAVFEQYF	TRBV10-1	TRBJ2-7
TGTGCCACCTCGGGACTAGCCAACGTCCTGACTTTC	CATSGLANVLTF	TRBV7-2	TRBJ2-6
TGTGCCAGCATATTCGGAAAAGAGACCCAGTACTTC	CASIFGKETQYF	TRBV12-3	TRBJ2-5
TGTGCCAGCAGAGGCGCGGGCAACACCGGGGAGCTGTTTTTT	CASRGAGNTGELFF	TRBV6-5	TRBJ2-2
TGTGCCAGCAGTGACCTTCCGAAAAGCTACGAGCAGTACTTC	CASSDLPKSYEQYF	TRBV6-4	TRBJ2-7
TGTGCCAGCAGCTTAAAAACAGACAGGGGTATACCCCAGCATTTT	CASSLKTDRGIPQHF	TRBV7-9	TRBJ1-5
TGTGCCAGTATGAACACGCAGTCAGGCTATGGCTACACCTTC	CASMNTQSGYGYTF	TRBV19	TRBJ1-2
TGCAGCGTTGGACAGGGGGCGAAATATTATCAGCCCCAGCATTTT	CSVGQGAKYYQPQHF	TRBV29-1	TRBJ1-5
TGCAGTGCCGTAAAGGGTAAGGGGATTGGCACAGATACGCAGTATTTT	CSAVKGKGIGTDTQYF	TRBV20-1	TRBJ2-3
TGTGCCCTGACCAGGGGGAGCACAGATACGCAGTATTTT	CALTRGSTDTQYF	TRBV30	TRBJ2-3
TGTGCCAGCAGCCAAGAATCAGGACAGGGCGTTAATTCACCCCTCCACTTT	CASSQESGQGVNSPLHF	TRBV3-1	TRBJ1-6
TGTGCCAGCAGTGAATCGCCCTTGAGGGGGACGGCCTACGAGCAGTACTTC	CASSESPLRGTAYEQYF	TRBV25-1	TRBJ2-7
TGTGCCAGCAGTGAATCCCGTCAAGCAGAGGGCGGGGAGCAGTACTTC	CASSESRQAEGGEQYF	TRBV6-1	TRBJ2-7
TGCAGTGCTACACAGGGGGATTTGAGGTCCTACGAGCAGTACTTC	CSATQGDLRSYEQYF	TRBV20-1	TRBJ2-7
TGTGCCAGCAGCTCTGGGGCGGAATACGAGCAGTACTTC	CASSSGAEYEQYF	TRBV11-2	TRBJ2-7
TGTGCTAGTGGTTCCCGGGACAGGGAAGGAAACATTCAGTACTTC	CASGSRDREGNIQYF	TRBV12-5	TRBJ2-4
TGTGCCAGCAGCCCCCCACGGGGACAGGGTCAAGGCAATCAGCCCCAGCATTTT	CASSPPRGQGQGNQPQHF	TRBV7-3	TRBJ1-5
TGTGCCAGAGGGTTCTATGGCTACACCTTC	CARGFYGYTF	TRBV19	TRBJ1-2
TGTGCCAGCAGTTACGGGAAAGGGTCCCACGGGGAGCTGTTTTTT	CASSYGKGSHGELFF	TRBV6-3	TRBJ2-2
TGTGCCAGCAGCTTAGTCTGGCGGGACAGGGGCTATGGGGGCTCGCAGCCCCAGCATTTT	CASSLVWRDRGYGGSQPQHF	TRBV7-2	TRBJ1-5
TGTGCCAGCAGCGTGACAGGGGGGTATAATTCACCCCTCCACTTT	CASSVTGGYNSPLHF	TRBV13	TRBJ1-6
TGTGCCAGCAGCAGTGGGACAGGAGAAGCTTTCTTT	CASSSGTGEAFF	TRBV7-2	TRBJ1-1
TGTGCCAGCAACCGACAGGGGTCTTCCCACACTGAAGCTTTCTTT	CASNRQGSSHTEAFF	TRBV6-3	TRBJ1-1
TGTGCCAGCAACTGGGGGGGCGAGCAGTACTTC	CASNWGGEQYF	TRBV5-4	TRBJ2-7
TGTGCCAGCAGTGGGGTGGCCTTTAACCGCGTTTATGAAGAGACCCAGTACTTC	CASSGVAFNRVYEETQYF	TRBV6-4	TRBJ2-5
TGTGCCAGCAGCCATGCTAGCCGGGACGGAAGTGGCTACACCTTC	CASSHASRDGSGYTF	TRBV7-9	TRBJ1-2
TGTGCCAGCGTCGGCACGCAGTATTTT	CASVGTQYF	TRBV6-6	TRBJ2-3
TGCGCCAGCAGCCAAGATGAAGGACAGGGTTTCTTACTTAAAGAAGAGCAGTTCTTC	CASSQDEGQGFLLKEEQFF	TRBV4-1	TRBJ2-1
TGTGCCAGCCCGCGTTCTTCGCCGGACAATGAGCAGTTCTTC	CASPRSSPDNEQFF	TRBV2	TRBJ2-1
TGCATGAAGTATCCAGGGGGGGGAAACATTCAGTACTTC	CMKYPGGGNIQYF	TRBV20-1	TRBJ2-4
TGTGCCAGCAGTGCGGAAGGGACAGGGAGGGAGTCCTATAATTCACCCCTCCACTTT	CASSAEGTGRESYNSPLHF	TRBV6-4	TRBJ1-6
TGTGCCAGCAGTGAATTCCCCGGGACTAGTGTGAATGAGCAGTTCTTC	CASSEFPGTSVNEQFF	TRBV6-1	TRBJ2-1
TGCGCCAGCTCAAAGCATCTAAGGACAGAGGCCGGCCGCACTGAAGCTTTCTTT	CASSKHLRTEAGRTEAFF	TRBV5-1	TRBJ1-1
TGTGCCAGCAGTTTGCCAGGATCAAATGAAAAACTGTTTTTT	CASSLPGSNEKLFF	TRBV27	TRBJ1-4
TGTGCCAGCAGCGTTCCTGAGACAGGGGACACCATATATTTT	CASSVPETGDTIYF	TRBV7-9	TRBJ1-3
TGTGCCAGCAGTTACTCTGGGTATTTCACCGGGGAGCTGTTTTTT	CASSYSGYFTGELFF	TRBV27	TRBJ2-2
TGCGCCAGCAGCTTGGTCGAAGGGGAGCCCCAGCATTTT	CASSLVEGEPQHF	TRBV5-1	TRBJ1-5
TGTGCCAGCAGTGCAGGAGAGACCCAGTACTTC	CASSAGETQYF	TRBV27	TRBJ2-5
TGTGCCAGCAGCCCACCCACCCGGGTTAATAACTATGGCTACACCTTC	CASSPPTRVNNYGYTF	TRBV7-4	TRBJ1-2
TGTGCCAGCAGTATCCCAGCCGGGACAGGGAATCTCTACGAGCAGTACTTC	CASSIPAGTGNLYEQYF	TRBV6-2	TRBJ2-7
TGTGCTAGGATCAGACCGAGGGGCCCCACTGAAGCTTTCTTT	CARIRPRGPTEAFF	TRBV12-5	TRBJ1-1
TGTGCCAGCAGCGGGGGTACCTACGAGCAGTACTTC	CASSGGTYEQYF	TRBV7-7	TRBJ2-7
TGTGCCAGCAGCCCCGACAGGGGAAGCTCTGGAAACACCATATATTTT	CASSPDRGSSGNTIYF	TRBV7-3	TRBJ1-3
TGTGCCACCAGTGATTTAGGTGGCTACGAGCAGTACTTC	CATSDLGGYEQYF	TRBV24-1	TRBJ2-7
TGTGCCAGCAGCTTCGGAATGGGACTAGCGGGAGGGCCCGCGTACGAGCAGTACTTC	CASSFGMGLAGGPAYEQYF	TRBV3-1	TRBJ2-7
TGTGCCAGCAGCCAAGCCCAGGCGAGAAGAGCCGGGGAGCTGTTTTTT	CASSQAQARRAGELFF	TRBV3-1	TRBJ2-2
TGTGCCAGCAGTTACTCGTTTACTCTTCCGGGGCTAGCGGACGTTACAGATACGCAGTATTTT	CASSYSFTLPGLADVTDTQYF	TRBV6-5	TRBJ2-3
TGTGCCAGCATTCGGCGACAGGTGCGGCAGTTTCAGCCCCAGCATTTT	CASIRRQVRQFQPQHF	TRBV9	TRBJ1-5
TGTGCCAGCAGCTTAGGGCGTACGTGGGCAGTGTACAATGAGCAGTTCTTC	CASSLGRTWAVYNEQFF	TRBV13	TRBJ2-1
TGCGCCAGCAGCCAAGCCACCGGGTCTAACACCGGGGAGCTGTTTTTT	CASSQATGSNTGELFF	TRBV4-3	TRBJ2-2
TGCGCTCCGACCCCAGGGGAGGTAGTTGCTAACTATGGCTACACCTTC	CAPTPGEVVANYGYTF	TRBV10-1	TRBJ1-2
TGCAGTGCTAAAAAGGGGGCTAATTCACCCCTCCACTTT	CSAKKGANSPLHF	TRBV20-1	TRBJ1-6
TGCGCCAGCAGACTGTCTAGCGGGGCCTACGAGCAGTACTTC	CASRLSSGAYEQYF	TRBV10-1	TRBJ2-7
TGTGCCAGCAGCGTAGTCCTGGGGTCCAATCCGGGGGATGAGCAGTTCTTC	CASSVVLGSNPGDEQFF	TRBV9	TRBJ2-1
TGTGCCAGCAGCGTCCGTCGCAGGGTTTTCCACACTGAAGCTTTCTTT	CASSVRRRVFHTEAFF	TRBV9	TRBJ1-1
TGTGCCAGCACGGATTGGGGGTATTTCTCCTACGAGCAGTACTTC	CASTDWGYFSYEQYF	TRBV2	TRBJ2-7
TGTGCCAGCAGCCAAAAGGACAGGCCACCAGACGAGCAGTACTTC	CASSQKDRPPDEQYF	TRBV4-2	TRBJ2-7
TGTGCCAGCGAAGGGACAGGGCCTTGCCAAGAGACCCAGTACTTC	CASEGTGPCQETQYF	TRBV6-3	TRBJ2-5
TGTGCCAGCAGCGACCTTCATGGGGGGATAGATACGCAGTATTTT	CASSDLHGGIDTQYF	TRBV9	TRBJ2-3
TGCAGTGCTGGGGCCGGGACAGGGGTCTCTGGAAACACCATATATTTT	CSAGAGTGVSGNTIYF	TRBV20-1	TRBJ1-3
TGTGCCAGCAATTCGGGGGGGCAAATCAGGGAGACCCAGTACTTC	CASNSGGQIRETQYF	TRBV27	TRBJ2-5
TGTGCCAGCAGTGAATCCCAGCCCAGGGTCCCCTACGAGCAGTACTTC	CASSESQPRVPYEQYF	TRBV6-4	TRBJ2-7
TGTGCCAGCAGCCAAGATCGGGGAGACAAAGACACTGAAGCTTTCTTT	CASSQDRGDKDTEAFF	TRBV14	TRBJ1-1
TGTGCCAGCAGCCAATCCCCACGGGACGAGGGGGAAAAACTGTTTTTT	CASSQSPRDEGEKLFF	TRBV3-1	TRBJ1-4
TGTGCCATCAGTGAGGACAGGGAAAAAAGCTCCTACGAGCAGTACTTC	CAISEDREKSSYEQYF	TRBV10-3	TRBJ2-7
TGTGCCAGCAGCTTGGCCGAGGAGGACGAGCAGTACTTC	CASSLAEEDEQYF	TRBV5-6	TRBJ2-7
TGTGCCACGCCTCTCCCGGGACAGGGGGGCGCTGATAAACTCGGGGACCCAAACTATGGCTACACCTTC	CATPLPGQGGADKLGDPNYGYTF	TRBV2	TRBJ1-2
TGTGCCAGCAGTGGGGGACTAGAGAGCCAGTACTTC	CASSGGLESQYF	TRBV6-4	TRBJ2-5
TGTGCCAGCAGCTTAGGGGGAGATACGCAGTATTTT	CASSLGGDTQYF	TRBV11-2	TRBJ2-3
TGCGCCAGCGATAACTCCATAGGACGCACTGAAGCTTTCTTT	CASDNSIGRTEAFF	TRBV10-1	TRBJ1-1
TGTGCCAGCAGCAACCTGATTGTGAGGAAGGACGAGCAGTACTTC	CASSNLIVRKDEQYF	TRBV13	TRBJ2-7
TGTGCCAGCAGGGGGGGCTACGAGCAGTACTTC	CASRGGYEQYF	TRBV6-4	TRBJ2-7
TGTGCCACCTTAAGGCGAGTGGGGGGTACGTCTGAAGCTTTCTTT	CATLRRVGGTSEAFF	TRBV24-1	TRBJ1-1
TGTGCCAGCAGGACAGTCGGGACAGGGGGCGGGGTTCTTAGTTTAGGGACCTACGAGCAGTACTTC	CASRTVGTGGGVLSLGTYEQYF	TRBV6-5	TRBJ2-7
TGTGCCAGCAGCTGCACCGGGGGGGCTGGAGATACGCAGTATTTT	CASSCTGGAGDTQYF	TRBV7-9	TRBJ2-3
TGTGCCAGCTCACACCCAGGGTTCTATGGCTACACCTTC	CASSHPGFYGYTF	TRBV18	TRBJ1-2
TGTGCCACCAGCAGAAAAGCCGGGACAGGGTACTTCCTAGCTTTCTTT	CATSRKAGTGYFLAFF	TRBV15	TRBJ1-1
TGTGCCCAGGGGACAGGGGGCGGCTATGGCTACACCTTC	CAQGTGGGYGYTF	TRBV9	TRBJ1-2
TGTGCCAGCAGTTACCCGAGGGATGAGCAGTTCTTC	CASSYPRDEQFF	TRBV7-2	TRBJ2-1
TGCGCCAGCAGTGACCGCGGGGAGTTTGAAGCTTTCTTT	CASSDRGEFEAFF	TRBV5-1	TRBJ1-1
TGTGCCAGCAGCTTACTGGGGAGTTACGAGCAGTACTTC	CASSLLGSYEQYF	TRBV7-2	TRBJ2-7
TGTGCCACCACCGGGGGGCAAGGGTCCTACGAGCAGTACTTC	CATTGGQGSYEQYF	TRBV24-1	TRBJ2-7
TGTGCCAGCAGCTTAGTACGGGACAATCAGCCCCAGCATTTT	CASSLVRDNQPQHF	TRBV11-2	TRBJ1-5
TGTGCCACCAAGGACGAGCAGTACTTC	CATKDEQYF	TRBV3-1	TRBJ2-7
TGTGCCAGCAGCGCCGGGACTAAGGGCTACGAGCAGTACTTC	CASSAGTKGYEQYF	TRBV7-6	TRBJ2-7
TGTGCCAGCAGTGGAGAACGAGCTTTCTTT	CASSGERAFF	TRBV6-4	TRBJ1-1
TGTGCCAGCAACGGGACAGGGTCTGGAAACACCATATATTTT	CASNGTGSGNTIYF	TRBV9	TRBJ1-3
TGCGCCAGCAGCTCGGGATGGGGGGATGGGGCCGGAAACACCATATATTTT	CASSSGWGDGAGNTIYF	TRBV5-1	TRBJ1-3
TGTGCCAGCAGTTTGGGTCCATGGTGGCAGGGATCGGTGAACACTGAAGCTTTCTTT	CASSLGPWWQGSVNTEAFF	TRBV12-3	TRBJ1-1
TGTGCCACCAGCAGAAGAGGGGAAAGGACTTATAATTCACCCCTCCACTTT	CATSRRGERTYNSPLHF	TRBV15	TRBJ1-6
TGTGCCAGCAGCCCAACTGTGGAGGACGGCAATCAGCCCCAGCATTTT	CASSPTVEDGNQPQHF	TRBV16	TRBJ1-5
TGCAGCGTTGGTATTATAGGGTGCGACAGGTCCTACGAGCAGTACTTC	CSVGIIGCDRSYEQYF	TRBV29-1	TRBJ2-7
TGCAGTGCTCGTCGACGCATTATGAACACTGAAGCTTTCTTT	CSARRRIMNTEAFF	TRBV20-1	TRBJ1-1
TGTGCCAGCAGCTCAGCCAGGAGGGTCTGCCAAACTTACGTC	CASSSARRVCQTYV	TRBV11-2	TRBJ2-7
TGTGCCAGCAGCCTCCTCACTTTGGGGGATGAGCAGTTCTTC	CASSLLTLGDEQFF	TRBV7-3	TRBJ2-1
TGCGCCAGCAGCCAAGAGTGCGGGACAGGGACAAGACGGGCTGAAGCTTTCTTT	CASSQECGTGTRRAEAFF	TRBV4-1	TRBJ1-1
TGTGCCAGCAGCCCCGTGATAGGGGATACGCAGTATTTT	CASSPVIGDTQYF	TRBV7-3	TRBJ2-3
TGTGCCAGCAGCAGGGAATACACTGAAGCTTTCTTT	CASSREYTEAFF	TRBV12-3	TRBJ1-1
TGTGCCAGCAGGGTGGCCCAGTGTGCCTACGAGCAGTACTTC	CASRVAQCAYEQYF	TRBV6-4	TRBJ2-7
TGTGCCACCCCTAGCGGGCACACAGATACGCAGTATTTT	CATPSGHTDTQYF	TRBV12-3	TRBJ2-3
TGTGCCAGCAGTGACAGTCAGGACAGGCAGTATAGCAATCAGCCCCAGCATTTT	CASSDSQDRQYSNQPQHF	TRBV6-4	TRBJ1-5
TGTGCCAACGGTGGGACAGGGGTCACAGATACGCAGTATTTT	CANGGTGVTDTQYF	TRBV19	TRBJ2-3
TGTGCCAGGGGGAATCGGGACGGGGCCAATCAGCCCCAGCATTTT	CARGNRDGANQPQHF	TRBV28	TRBJ1-5
TGCGCCAGCAGCTTCGAAAGTGACACTGAAGCTTTCTTT	CASSFESDTEAFF	TRBV5-1	TRBJ1-1
TGCAGCGTTGAAGTTAAGGACAGTATAATAAATCAGCCCCAGCATTTT	CSVEVKDSIINQPQHF	TRBV29-1	TRBJ1-5
TGTGCCATCTTACCAGACTCCACAGATACGCAGTATTTT	CAILPDSTDTQYF	TRBV10-3	TRBJ2-3
TGTGCCACCAGTGACAACCGGGACATCTGCACAGATACGCAGTATTTT	CATSDNRDICTDTQYF	TRBV24-1	TRBJ2-3
TGCGCCAGCAGCTTGGCCGGCCAACCTACTAACTATGGCTACACCTTC	CASSLAGQPTNYGYTF	TRBV5-1	TRBJ1-2
TGCGCCAGCAACCGTTCGTGGGCGGGGTCCCTGACTCAGCATGAGCAGTTCTTC	CASNRSWAGSLTQHEQFF	TRBV10-1	TRBJ2-1
TGTGCCAGCAGCGGAGGCACCCTACGTGAGACGCGTGAGCAGTTCTTC	CASSGGTLRETREQFF	TRBV11-2	TRBJ2-1
TGTGCCAGCAGTCCCGCAGCTGAAAACGAGCAGTACTTC	CASSPAAENEQYF	TRBV28	TRBJ2-7
TGCAGTGCTAGCCCCCGGGTCTACGAGCAGTACTTC	CSASPRVYEQYF	TRBV20-1	TRBJ2-7
TGTGCCAGCAAAAGGGGACAGGGGGCGAACACTGAAGCTTTCTTT	CASKRGQGANTEAFF	TRBV7-9	TRBJ1-1
TGTGCCAGCAGTTTGTTACCTTCAGCCGGGGAGCTGTTTTTT	CASSLLPSAGELFF	TRBV27	TRBJ2-2
TGTGCCCTGGGACGACTTTACAATGAGCAGTTCTTC	CALGRLYNEQFF	TRBV5-6	TRBJ2-1
TGTGCCACCAGTGAATGTACTCCAGGCGAGGGCCGACACTACGAGCAGTACTTC	CATSECTPGEGRHYEQYF	TRBV24-1	TRBJ2-7
TGTGCCATTCAGGCTATCTATGAGACCCAGTACTTC	CAIQAIYETQYF	TRBV7-2	TRBJ2-5
TGTGCCAGCAGCTTGGCCCCATCTCTTTCCCGCGGGGGACAAGAGACCCAGTACTTC	CASSLAPSLSRGGQETQYF	TRBV5-4	TRBJ2-5
TGTGCCACCAGCAGAGATCCTACGACTAGCGGCCCTCGACGAACCCGGAGCACAGATACGCAGTATTTT	CATSRDPTTSGPRRTRSTDTQYF	TRBV15	TRBJ2-3
TGTGCTAGTGCCCTGACCGGGACAGGGCCGAGGAACCGAGCTTTCTTT	CASALTGTGPRNRAFF	TRBV12-5	TRBJ1-1
TGCAGTGCTCGTCTTGACGATGGCTACACCTTC	CSARLDDGYTF	TRBV20-1	TRBJ1-2
TGTGCCAGCAGTGAATCGAGACGGCCCTCCTACGAGCAGTACTTC	CASSESRRPSYEQYF	TRBV6-1	TRBJ2-7
TGCGCCACCTCTAGCGGGAACCGGGGACTAGCCAAAAACATTCAGTACTTC	CATSSGNRGLAKNIQYF	TRBV5-1	TRBJ2-4
TGTGCCAGCATTCCCACTGCGAATTATGGCTACACCTTC	CASIPTANYGYTF	TRBV12-3	TRBJ1-2
TGTGCATTAGAGACTAGCGGTGGGGGAGAGACCCAGTACTTC	CALETSGGGETQYF	TRBV6-5	TRBJ2-5
TGTGCCAGCAGCGGGACAGAAAACACTGAAGCTTTCTTT	CASSGTENTEAFF	TRBV13	TRBJ1-1
TGTGCCAGCAGTGACTCCCGTAACCCCGAGGGGACTTCTGGGCTGGGAAACACCATATATTTT	CASSDSRNPEGTSGLGNTIYF	TRBV6-4	TRBJ1-3
TGTGCCAGCAGCCAAGTAGCGGGTCACATTCAGTACTTC	CASSQVAGHIQYF	TRBV14	TRBJ2-4
TGTGCCACCGTAGATTTACTCCTATTCGGTGAGCAGTTCTTC	CATVDLLLFGEQFF	TRBV15	TRBJ2-1
TGTGCCAGCCTTTCCCCCCGACCTAAGTATAGCAATCAGCCCCAGCATTTT	CASLSPRPKYSNQPQHF	TRBV6-5	TRBJ1-5
TGTGCCACCACCTACAGGGCCCAAGGCTCTGGAAACACCATATATTTT	CATTYRAQGSGNTIYF	TRBV24-1	TRBJ1-3
TGCGCCAGCAGACGAAGGGGGGATGGTGGCTACGAGCAGTACTTC	CASRRRGDGGYEQYF	TRBV5-1	TRBJ2-7
TGTGCCAGCAGCTTGGCCGTTGCAGACCATCGGGATGCCCTCCACTTT	CASSLAVADHRDALHF	TRBV5-4	TRBJ1-6
TGTGCCAGCAGCCCTTTGCAGGGGCTCTTGCATAGCAATCAGCCCCAGCATTTT	CASSPLQGLLHSNQPQHF	TRBV14	TRBJ1-5
TGTGCCAGCAGCTTCACGAACGGGACAGGGATGAACACTGAAGCTTTCTTT	CASSFTNGTGMNTEAFF	TRBV27	TRBJ1-1
TGTGCCAGCAGCCAAACCTCTCATCCGGGACAGGGGGGGTATAGCAATCAGCCCCAGCATTTT	CASSQTSHPGQGGYSNQPQHF	TRBV3-1	TRBJ1-5
TGTGCCAACCCTATAGAGGGGGCTAGGGACTCCTACGAGCAGTACTTC	CANPIEGARDSYEQYF	TRBV28	TRBJ2-7
TGTGCCAGCAGCTTTCGACAGGGGAACACTGAAGCTTTCTTT	CASSFRQGNTEAFF	TRBV9	TRBJ1-1
TGCGCCAGCAGTGACTCCAATCAGCCCCAGCATTTT	CASSDSNQPQHF	TRBV10-1	TRBJ1-5
TGTGCCAGCAGTTCGAGGGAGTATTTT	CASSSREYF	TRBV6-5	TRBJ2-3
TGTGCCAGCAGCTTCACAGCTGGAAACACCATATATTTT	CASSFTAGNTIYF	TRBV13	TRBJ1-3
TGCAGTGCGTTCAGGACCCAGTATAGCAATCAGCCCCAGCATTTT	CSAFRTQYSNQPQHF	TRBV20-1	TRBJ1-5
TGTTGCCGACCCGCGGGACTTTTGAGTATAGGTAAAGGCGGCGAGCAGTACTTC	CCRPAGLLSIGKGGEQYF	TRBV6-5	TRBJ2-7
TGTGCCAGCTACTCAATGCTCCCTGAAAAACTGTTTTTT	CASYSMLPEKLFF	TRBV12-4	TRBJ1-4
TGTGCCAGCAGTTTCCTGTGTACTAAGGGGGGGAAGAACTACAATGAGCAGTTCTTC	CASSFLCTKGGKNYNEQFF	TRBV28	TRBJ2-1
TGTGCCAGCAGTGCGGGACAGCGTAGGACAACCCATACGCAGTATTTT	CASSAGQRRTTHTQYF	TRBV27	TRBJ2-3
TGCGCCAGCAGAGGGACAGGGACTCGGCCTGGCTACACCTTC	CASRGTGTRPGYTF	TRBV10-1	TRBJ1-2
TGTGCCAGCAGGATTCCGAACAGGAATGAAAAACTGTTTTTT	CASRIPNRNEKLFF	TRBV6-3	TRBJ1-4
TGTGCCAGCAGCTTAGCGGGACTAGCGGGTTCACTAGCCAAAAACATTCAGTACTTC	CASSLAGLAGSLAKNIQYF	TRBV7-9	TRBJ2-4
TGTGCCAGTAACCGCATTACTCGAGGGGGCGCTGAGCAGTACTTC	CASNRITRGGAEQYF	TRBV19	TRBJ2-7
TGTGCCAGCAGCCAATGGGACTACGAGCAGTACTTC	CASSQWDYEQYF	TRBV7-9	TRBJ2-7
TGTGCCAGCAGACCCCGGGTCGACAATGAGCAGTTCTTC	CASRPRVDNEQFF	TRBV7-9	TRBJ2-1
TGTGCCAGCAGCCAAAGACTACTCCCGACCGGGGAGCTGTTTTTT	CASSQRLLPTGELFF	TRBV16	TRBJ2-2
TGTGCCAGTAGTGCAATGACAGCAACTAATGAAAAACTGTTTTTT	CASSAMTATNEKLFF	TRBV19	TRBJ1-4
TGTGCCCTCCGCGGGAGAGAACACACCATATATTTT	CALRGREHTIYF	TRBV24-1	TRBJ1-3
TGCAGTGCTAGTAAATGGACAATTACAAGCAATCAGCCCCAGCATTTT	CSASKWTITSNQPQHF	TRBV20-1	TRBJ1-5
TGTGCCTGGAAAGCGGCTGGGCCGGCTCGCTCTGGAAACACCATATATTTT	CAWKAAGPARSGNTIYF	TRBV30	TRBJ1-3
TGCAGTGCGCCGCAGGGCCAGTTGGGGAGGGAGCCCCAGCATTTT	CSAPQGQLGREPQHF	TRBV20-1	TRBJ1-5
TGTGCCAGCAGGGACAAACACTACGAGCAGTACTTC	CASRDKHYEQYF	TRBV11-3	TRBJ2-7
TGTGCCAGCAGCGGACAGGAAAAACTGTTTTTT	CASSGQEKLFF	TRBV13	TRBJ1-4
TGTGCCAGCAGATCAGTGAGAGCCCGGGAAGCTTTCTTT	CASRSVRAREAFF	TRBV7-9	TRBJ1-1
TGTGCCAGCAGCTTAGACGTAGCGGGGGACGAGCAGTACTTC	CASSLDVAGDEQYF	TRBV7-8	TRBJ2-7
TGTGCCAGCAGGAATCGGCTACGGGGAAGGGGCTACGAGCAGTACTTC	CASRNRLRGRGYEQYF	TRBV28	TRBJ2-7
TGTGCCAGCAGTCGACGACAGGGGGAAGAGACCCAGTACTTC	CASSRRQGEETQYF	TRBV5-4	TRBJ2-5
TGTGCCAGCGCGGGAGGGGCCCAGTACTTC	CASAGGAQYF	TRBV2	TRBJ2-5
TGTGCCAGCAGTTTCCCCCTAAAGTATACTGAAGCTTTCTTT	CASSFPLKYTEAFF	TRBV6-5	TRBJ1-1
TGTGCCAGCAGCTTTGGAGGCCGGGACAGGGTTACGTACACTGAAGCTTTCTTT	CASSFGGRDRVTYTEAFF	TRBV7-8	TRBJ1-1
TGTGCCAGCAGTTTAGTCGGACAGGGTGAGCCAGAGACCCAGTACTTC	CASSLVGQGEPETQYF	TRBV27	TRBJ2-5
TGCGCCAGCAGCCCCCTTGCCACATACACTGAAGCTTTCTTT	CASSPLATYTEAFF	TRBV4-3	TRBJ1-1
TGTGCCACCAGTGATTACCCCGGTCCGCCCACGAATTCACCCCTCCACTTT	CATSDYPGPPTNSPLHF	TRBV24-1	TRBJ1-6
TGTGCCAGCAGCTTAGCGACCAATGAGCAGTTCTTC	CASSLATNEQFF	TRBV7-7	TRBJ2-1
TGTGCCAGCAGCGGTGGGGAGTTTGAGAATGAGCAGTTCTTC	CASSGGEFENEQFF	TRBV9	TRBJ2-1
TGTGCCTGGAGTGTATGGCCCCTGAGGGCGAACACTGAAGCTTTCTTT	CAWSVWPLRANTEAFF	TRBV30	TRBJ1-1
TGTGCCAGCTCACCGGGGGGTGGTAACACCTTC	CASSPGGGNTF	TRBV18	TRBJ1-2
TGTGCCAGCAGCGGCGACAGGGGGCGACCCTACGAGCAGTACTTC	CASSGDRGRPYEQYF	TRBV7-4	TRBJ2-7
TGTGCCAGCAGGAGGACACACACTGAAGCTTTCTTT	CASRRTHTEAFF	TRBV6-4	TRBJ1-1
TGTGCCAGCAGTGGACATAATGAAAAACTGTTTTTT	CASSGHNEKLFF	TRBV27	TRBJ1-4
TGTGCCAGCAGCCCTGGGGGGGCCAAGCTACCCTACAATGAGCAGTTCTTC	CASSPGGAKLPYNEQFF	TRBV6-6	TRBJ2-1
TGTGCCAGCAGCTTACATCGTCGCAGCCAACTTCACGAGCAGTACTTC	CASSLHRRSQLHEQYF	TRBV7-9	TRBJ2-7
TGTGCCAGCATGGACAGGGGGTGGAATTCACCCCTCCACTTT	CASMDRGWNSPLHF	TRBV27	TRBJ1-6
TGTGCTAGTGGTTTGATACGTACGACCATGAAAGAGCTGTTTTTT	CASGLIRTTMKELFF	TRBV12-5	TRBJ2-2
TGTGCCAGCAGCGAACACGGGGGGGGCGATGGCTACACCTTC	CASSEHGGGDGYTF	TRBV11-2	TRBJ1-2
TGTGCCTGGTCGGCGAACCTTGGAGGGACGAGCTATGGCTACACCTTC	CAWSANLGGTSYGYTF	TRBV30	TRBJ1-2
TGTGCCAGCAGCTTACCCCAGTGGCATTCCGGGACAGGGGGCTCGGGCACAGATACGCAGTATTTT	CASSLPQWHSGTGGSGTDTQYF	TRBV7-2	TRBJ2-3
TGCAGCGTGTGGGGGGGAGGTGGCGAGCAGTACTTC	CSVWGGGGEQYF	TRBV29-1	TRBJ2-7
TGTGCCAGCAGCCAGGGTCGGGACTACGAGCAGTACTTC	CASSQGRDYEQYF	TRBV4-2	TRBJ2-7
TGCGCCAGCAGCTTCCAGGACAGGGTGGACGAAAAACTGTTTTTT	CASSFQDRVDEKLFF	TRBV5-1	TRBJ1-4
TGTGCCTGGAGTGCGTGCCTTCCGGGACACCGTAATGAGCAGTTCTTC	CAWSACLPGHRNEQFF	TRBV30	TRBJ2-1
TGTGCCAGCAGTTTTCTTGATCGGGATGGCTACACCTTC	CASSFLDRDGYTF	TRBV12-4	TRBJ1-2
TGTGCCAGCAGCGTCACAGGGTTCTCCTACGAGCAGTACTTC	CASSVTGFSYEQYF	TRBV6-6	TRBJ2-7
TGTGCCACCAGTGATTTGCAACAGGGCACAATTGGGAGGGCGGGAGAAGCTTTCTTT	CATSDLQQGTIGRAGEAFF	TRBV24-1	TRBJ1-1
TGCGCCAGCAGCAAAAGTTTGACCCGTCGAGGGCGACAGAGGGAAACTGAAGCTTTCTTT	CASSKSLTRRGRQRETEAFF	TRBV5-1	TRBJ1-1
TGTGCCAGCAGTGAATGGAGTAACCCCGGGGGGAGCAATCAGCCCCAGCATTTT	CASSEWSNPGGSNQPQHF	TRBV25-1	TRBJ1-5
TGTGCCAGCAGGGTTCTAGCGGGGCTTCAAGAGACCCAGTACTTC	CASRVLAGLQETQYF	TRBV6-4	TRBJ2-5
TGTGCCACCAGCACAGGGTACGAGCAGTACTTC	CATSTGYEQYF	TRBV15	TRBJ2-7
TGTGCCAGCAGTTGCAACCCGTCCTTTCGGGCCGTTGGTAGCGAGCAGTACTTC	CASSCNPSFRAVGSEQYF	TRBV6-9	TRBJ2-7
TGTGCCAGCAGCGTTCGGGACAGGGGGGCTTTCTCCTCTGGAAACACCATATATTTT	CASSVRDRGAFSSGNTIYF	TRBV7-2	TRBJ1-3
TGCGCCAGCAGCTTCGCAGGGGACGCTAACTATGGCTACACCTTC	CASSFAGDANYGYTF	TRBV5-1	TRBJ1-2
TGCAGCGTAGGACAGGGGTCGGGTAATTCACCCCTCCACTTT	CSVGQGSGNSPLHF	TRBV29-1	TRBJ1-6
TGTGCCAGCAGTTATTCGAGGTACGGGAGTGAGCAGTTCTTC	CASSYSRYGSEQFF	TRBV6-2	TRBJ2-1
TGTGCCTGGAGCGGCGGGACCTCGTCCTACTCTGGAAACACCATATATTTT	CAWSGGTSSYSGNTIYF	TRBV30	TRBJ1-3
TGTGCCTGTATCGGGAGGGCGATCTACGAGCAGTACTTC	CACIGRAIYEQYF	TRBV30	TRBJ2-7
TGTGCCAGCAGTGCGGAATGCCCTGAGACCCAGTACTTC	CASSAECPETQYF	TRBV6-1	TRBJ2-5
TGTGCCAGCAGCCCCATCCCAGGGGCCAGTGCTGAAGCTTTCTTT	CASSPIPGASAEAFF	TRBV14	TRBJ1-1
TGTGCCAGCAGCACCTGGGAGGCTGTCGAGCAGTACTTC	CASSTWEAVEQYF	TRBV13	TRBJ2-7
TGTGCCAGCAGTTATATCGGCGCCCACACCTCGACAGAATCGAAGTGGGGGACTGAAGCTTTCTTT	CASSYIGAHTSTESKWGTEAFF	TRBV6-3	TRBJ1-1
TGTGCCAGCAGTACAGGGGGGTATTGCCCCAGCTATGGCTACACCTTC	CASSTGGYCPSYGYTF	TRBV27	TRBJ1-2
TGCGCCAGCAGCCAAGACCGGGGGGGCAATCAGCCCCAGCATTTT	CASSQDRGGNQPQHF	TRBV4-1	TRBJ1-5
TGCAGTGCTAGAGCCTACAGGGCGTCTATCCTGTATAGCAATCAGCCCCAGCATTTT	CSARAYRASILYSNQPQHF	TRBV20-1	TRBJ1-5
TGTGCCAGCAGCTTAGAAAACACGGGGCATAACGGCTACGAGCAGTACTTC	CASSLENTGHNGYEQYF	TRBV7-2	TRBJ2-7
TGTGCCAGCTTTTCCCGGGACAGTCCAAACATTCAGTACTTC	CASFSRDSPNIQYF	TRBV3-1	TRBJ2-4
TGTGCCAGCCCTGCGCGGGCTAACTATGGCTACACCTTC	CASPARANYGYTF	TRBV3-1	TRBJ1-2
TGTGCCAGCAGCTTAAACGGGGACAGGGAAGATACGCAGTATTTT	CASSLNGDREDTQYF	TRBV7-3	TRBJ2-3
TGCGCCAGCAGCTTGAGAGGGACAAGGGAGGCCAAAAACATTCAGTACTTC	CASSLRGTREAKNIQYF	TRBV5-1	TRBJ2-4
TGCGCCAGCAGCGGGGAGGGAGGAGTATCTGGGGCCAACGTCCTGACTTTC	CASSGEGGVSGANVLTF	TRBV10-1	TRBJ2-6
TGCGCCAGCACTAGCGGGGGGGTAGAGCAGTACTTC	CASTSGGVEQYF	TRBV5-1	TRBJ2-7
TGCGCCAGCAGCTTTCCGGGGGGCAATCAGCCCCAGCATTTT	CASSFPGGNQPQHF	TRBV5-1	TRBJ1-5
TGTGCCAGCAGCTTAAGGTCCTATAATTCACCCCTCCACTTT	CASSLRSYNSPLHF	TRBV7-9	TRBJ1-6
TGCAGCGCAAGCTATGGGACAGGTGCACCTCTCAATCAGCCCCAGCATTTT	CSASYGTGAPLNQPQHF	TRBV29-1	TRBJ1-5
TGTGCCTGGCTACAATTGCAGGGGCAAGAGACCCAGTACTTC	CAWLQLQGQETQYF	TRBV30	TRBJ2-5
TGTGCCAGCAGCCAAGACTCCGGGACAGCCATTGTCCCCTATGGCTACACCTTC	CASSQDSGTAIVPYGYTF	TRBV3-1	TRBJ1-2
TGTGCCAGCAGCCGGGGGGACGACAGCAATCAGCCCCAGCATTTT	CASSRGDDSNQPQHF	TRBV3-1	TRBJ1-5
TGCAGTGCTAGCGGGAGGGGGGGGGGGGGCAATCAGCCCCAGCATTTT	CSASGRGGGGNQPQHF	TRBV20-1	TRBJ1-5
TGCGCCAGCAGCCGGGGGGCGCACTCCCCAGCTAACTATGGCTACACCTTC	CASSRGAHSPANYGYTF	TRBV5-1	TRBJ1-2
TGCAGTGCTTCCAATATCGTTGGGAGGAATGAGCAGTTCTTC	CSASNIVGRNEQFF	TRBV20-1	TRBJ2-1
TGTGCAACCCCTAGCTACGAGCAGTACTTC	CATPSYEQYF	TRBV28	TRBJ2-7
TGTGCCACCAGTGGAGTTATCGAGGGGGCCGACGAGCAGTACTTC	CATSGVIEGADEQYF	TRBV24-1	TRBJ2-7
TGCAGTGCTAGAGAGGGAGAGACCCAGTACTTC	CSAREGETQYF	TRBV20-1	TRBJ2-5
TGTGCCAGCAGCCAAGACACTTCCGGGTCGACGGCGCAGTATTTT	CASSQDTSGSTAQYF	TRBV14	TRBJ2-3
TGTGCCAGTCCCGGACAACGTGAGACCCAGTACTTC	CASPGQRETQYF	TRBV9	TRBJ2-5
TGTGCCAGCAGCGAGACAGGCTACGAGCAGTACTTC	CASSETGYEQYF	TRBV13	TRBJ2-7
TGCGCCAGCAGATGTCTGGCAGATACGCAGTATTTT	CASRCLADTQYF	TRBV5-1	TRBJ2-3
TGCAGCGTTGCACGCGGTGGACCACAAAGGGCAGATACGCAGTATTTT	CSVARGGPQRADTQYF	TRBV29-1	TRBJ2-3
TGCGCCAGGGGGGGACCCTACAATGAGCAGTTCTTC	CARGGPYNEQFF	TRBV10-1	TRBJ2-1
TGTGCCACCAGAGCCTCAATCGGAGGAACAGCAGACGAGCAGTACTTC	CATRASIGGTADEQYF	TRBV24-1	TRBJ2-7
TGCGCCAGCAGCCAGACATATGGAATAAATCAGCCCCAGCATTTT	CASSQTYGINQPQHF	TRBV5-1	TRBJ1-5
TGTGCCAGCCCCGGTGAAAGAGACAATGAGCAGTTCTTC	CASPGERDNEQFF	TRBV9	TRBJ2-1
TGTGCCAGCAGTGACGGATCAGGGGACCGGCACTATGGCTACACCTTC	CASSDGSGDRHYGYTF	TRBV6-4	TRBJ1-2
TGTGCCAGCAGCCGTAAACGACGGGGCTCCTACGAGCAGTACTTC	CASSRKRRGSYEQYF	TRBV3-1	TRBJ2-7
TGCAGCGTTGAGGGAAGGACTAGCGGGAGGGTAGCCAAAAACATTCAGTACTTC	CSVEGRTSGRVAKNIQYF	TRBV29-1	TRBJ2-4
TGTGCCAGCAGCTTGGGCAGCCGACGGCAGCCCCAGCATTTT	CASSLGSRRQPQHF	TRBV5-4	TRBJ1-5
TGCAGTGCACCTCCGACAGGGGTTCCTGACACTGAAGCTTTCTTT	CSAPPTGVPDTEAFF	TRBV20-1	TRBJ1-1
TGTGCCTGGAGTGGAGATCAGCGCTACTACACCGGGGAGCTGTTTTTT	CAWSGDQRYYTGELFF	TRBV30	TRBJ2-2
TGTGCCAGCAGCGGGACAGGGAGGTATCAGCCCCAGCATTTT	CASSGTGRYQPQHF	TRBV25-1	TRBJ1-5
TGTGCCAGCTCACCTATAAGTTCTAGCCCCGCAGATACGCAGTATTTT	CASSPISSSPADTQYF	TRBV18	TRBJ2-3
TGCAGTGCCCTACTGATCATGAACACTGAAGCTTTCTTT	CSALLIMNTEAFF	TRBV20-1	TRBJ1-1
TGTGCCAGCAGCTTAGCGCTAGCCGGGGAGCTAGATGGCTACACCTTC	CASSLALAGELDGYTF	TRBV7-6	TRBJ1-2
TGCGCCAGCAGCCAGGCGGTAAGGGGCAATCCCAACACTGAAGCTTTCTTT	CASSQAVRGNPNTEAFF	TRBV4-1	TRBJ1-1
TGTGCCAGCAGTTTTTTCGGACAGGGGGCCTTGTCTGGGGCCAACGTCCTGACTTTC	CASSFFGQGALSGANVLTF	TRBV27	TRBJ2-6
TGTGCCAGCAGCCTACGACTACAGGGGGTCCCATATAGCAATCAGCCCCAGCATTTT	CASSLRLQGVPYSNQPQHF	TRBV11-3	TRBJ1-5
TGTGCCAGCATCCCGCACTGTCGGGGGCTGCGGCACACTGAAGCTTTCTTT	CASIPHCRGLRHTEAFF	TRBV12-3	TRBJ1-1
TGTGCCAGCAGCAAAAGCTACCCGGGACAGGGGACAACACTGTTTTTT	CASSKSYPGQGTTLFF	TRBV13	TRBJ1-4
TGTGCCAGCAGGTTGTCGGACTCTAGTTCACCCCTCCACTTT	CASRLSDSSSPLHF	TRBV28	TRBJ1-6
TGCAGCGGGGGGGTCGTGAACGTCCTGACTTTC	CSGGVVNVLTF	TRBV29-1	TRBJ2-6
TGTGCCAGTAGTACCAAATTGGTGGGGCTATTAGAAACTTATACCTACAATGAGCAGTTCTTC	CASSTKLVGLLETYTYNEQFF	TRBV19	TRBJ2-1
TGTGCCTGGAGTCCTGTTAAAACGGGACAGAAAAGCAAACCTCTCAATCAGCCCCAGCATTTT	CAWSPVKTGQKSKPLNQPQHF	TRBV30	TRBJ1-5
TGTGCCAGCAGTGATATATCGGGGGGGAAGAAAGAGACCCAGTACTTC	CASSDISGGKKETQYF	TRBV6-1	TRBJ2-5
TGTGCCAGCAGCTCACACAGGGAGGATGGCTACACCTTC	CASSSHREDGYTF	TRBV5-4	TRBJ1-2
TGTGCCATCTCCGAGCCGGGACTAGAGAGCGCGAACACCGGGGAGCTGTTTTTT	CAISEPGLESANTGELFF	TRBV10-3	TRBJ2-2
TGTGCCAGCAGCCCGTCTTCGGCGTACTCACCCCTCCACTTT	CASSPSSAYSPLHF	TRBV28	TRBJ1-6
TGTGCCAGCAGTTACTCGGGGTCCCCCGCCCGCAGGGGGCGTGCTTTCTTT	CASSYSGSPARRGRAFF	TRBV6-5	TRBJ1-1
TGTGCCAGCAGTGAATGGAACAGGGGAGGAACTAGCAATCAGCCCCAGCATTTT	CASSEWNRGGTSNQPQHF	TRBV2	TRBJ1-5
TGTGCCAGCAGCCAAGATTGGGAGTGGTTAAACCAAGAGACCCAGTACTTC	CASSQDWEWLNQETQYF	TRBV3-1	TRBJ2-5
TGTGCCAGCAGTTACAGGACGGAACGCGTGGGGCAGGACCAGCAGTACTTC	CASSYRTERVGQDQQYF	TRBV6-3	TRBJ2-7
TGCAGCGTTGTCCAGAGTCAGGGGGAGGAGCTGTTTTTT	CSVVQSQGEELFF	TRBV29-1	TRBJ2-2
TGTGCTAGTGGTAACGCTAGCGGGATAGAGTACTTC	CASGNASGIEYF	TRBV12-5	TRBJ2-7
TGTGCCATCAGTGATTTGCCCCAAATCCGGGGGCTCCCGCTAGCCAAAAACATTCAGTACTTC	CAISDLPQIRGLPLAKNIQYF	TRBV10-3	TRBJ2-4
TGCGCCAGCAGCCAAGATAAGTCCGGGGACACTGAAGCTTTCTTT	CASSQDKSGDTEAFF	TRBV4-3	TRBJ1-1
TGTGCCAGCAGCTTACAGGGGACACTAGCAAGCAATCAGCCCCAGCATTTT	CASSLQGTLASNQPQHF	TRBV7-6	TRBJ1-5
TGTGCTAGTGGTTTGGTGGACGGGACAGGGGCTGAAAAACTGTTTTTT	CASGLVDGTGAEKLFF	TRBV12-5	TRBJ1-4
TGTGCCTGGGGTCCACGACGCAATCAGCCCCAGCATTTT	CAWGPRRNQPQHF	TRBV11-3	TRBJ1-5
TGCGCCAGCAGCTCCATCCTAGCGGATTCTGCTGCCGGGGAGCTGTTTTTT	CASSSILADSAAGELFF	TRBV4-1	TRBJ2-2
TGTGCCAGCAGTCTTCGTCCGCAGATACAGGAAGTGACCGGATCCCAGTACTTC	CASSLRPQIQEVTGSQYF	TRBV6-1	TRBJ2-5
TGTGCCACCAGCAGAGCCCACCGAAATGAAAAACTGTTTTTT	CATSRAHRNEKLFF	TRBV15	TRBJ1-4
TGTGCCAGCAGCGGCACAGGGCGACCTGGAAACACCATATATTTT	CASSGTGRPGNTIYF	TRBV7-3	TRBJ1-3
TGTGCCAGCAGTGACCCTCTTATAGAAAAACTGTTTTTT	CASSDPLIEKLFF	TRBV6-4	TRBJ1-4
TGTGCCAGCAGTTTATCGCTGGGGGGGCGCACAGATACGCAGTATTTT	CASSLSLGGRTDTQYF	TRBV27	TRBJ2-3
TGTGCCAGTCGGACCGGGACAGGGCACTATGGCTACACCTTC	CASRTGTGHYGYTF	TRBV19	TRBJ1-2
TGTGCCAGCAGCTCAGATTTGGACGAGGGGGTCCACACTGAAGCTTTCTTT	CASSSDLDEGVHTEAFF	TRBV11-2	TRBJ1-1
TGTGCCAGCAGGTTGACAGGCGAAGAGACCCAGTACTTC	CASRLTGEETQYF	TRBV9	TRBJ2-5
TGTGCCAGCAGTTACCTCAGGGGGAGGGGCTACACCTTC	CASSYLRGRGYTF	TRBV12-3	TRBJ1-2
TGTGCCAGCAGCTATTTTTCATCGGCCCCCCGGACAACGCAGTCCTCGGAGACCCAGTACTTC	CASSYFSSAPRTTQSSETQYF	TRBV11-2	TRBJ2-5
TGTGCCAGCAGCATCAGAAGGGAGAATCAGCCCCAGCATTTT	CASSIRRENQPQHF	TRBV6-3	TRBJ1-5
TGTGCCAGCAGCTTTAGGGGCTATGGCTACACCTTC	CASSFRGYGYTF	TRBV27	TRBJ1-2
TGTGCCAGCAGCTCCGGGCCTGGAAACACCATATATTTT	CASSSGPGNTIYF	TRBV14	TRBJ1-3
TGTGCCAGCAGCTGGACTAGCGGGGGGCGTCCCTACGAGCAGTACTTC	CASSWTSGGRPYEQYF	TRBV7-3	TRBJ2-7
TGCAGTGCACAGCCCTCCTACAATGAGCAGTTCTTC	CSAQPSYNEQFF	TRBV20-1	TRBJ2-1
TGTGCCAGCCCCACAGGGGAAGAGACCCAGTACTTC	CASPTGEETQYF	TRBV10-3	TRBJ2-5
TGTGCCAGCCACGGGGTAGTCGGGGAGCTGTTTTTT	CASHGVVGELFF	TRBV6-2	TRBJ2-2
TGTGCCAGCACCTGGGGGGGCGGGAGGAACACTGAAGCTTTCTTT	CASTWGGGRNTEAFF	TRBV9	TRBJ1-1
TGTGCCACCAGTGTGCGCGCGGACGTGGGGCATTTT	CATSVRADVGHF	TRBV24-1	TRBJ1-5
TGTGCCAGCAGACTTAGACTAGCGGGGGGGGCGGGGTCAGTCAATGAGCAGTTCTTC	CASRLRLAGGAGSVNEQFF	TRBV6-4	TRBJ2-1
TGTGCCAGCGAGGCGGGTAGGATGTGTCACTATGGCTACACCTTC	CASEAGRMCHYGYTF	TRBV7-3	TRBJ1-2
TGTGCCACCAGCAGAGCAGGTTCGGACAGGGCAGATACGCAGTATTTT	CATSRAGSDRADTQYF	TRBV15	TRBJ2-3
TGTGCCAGCTCACCCCGCGGACAGGCTGAAGCTTTCTTT	CASSPRGQAEAFF	TRBV18	TRBJ1-1
TGCAGTGCTAGAGAGAGACAGGGGTGCGGATATGAGCAGTTCTTC	CSARERQGCGYEQFF	TRBV20-1	TRBJ2-1
TGTGCCAGCAGCTTGCGGGAGGACAACACCGGGGAGCTGTTTTTT	CASSLREDNTGELFF	TRBV7-4	TRBJ2-2
TGTGCCAGCAGCATCAACGGGACAGGTGAAAAACTGTTTTTT	CASSINGTGEKLFF	TRBV7-3	TRBJ1-4
TGTGCCACCGACAGGGGGTATGGCTACACCTTC	CATDRGYGYTF	TRBV7-9	TRBJ1-2
TGTGCCAGGCACCAGATGAGAGGCTACACCTTC	CARHQMRGYTF	TRBV5-6	TRBJ1-2
TGTGCCAGCAGTGAACCGCGGGAGAGTCATCAGCCCCAGCATTTT	CASSEPRESHQPQHF	TRBV2	TRBJ1-5
TGTGCCAGCAGTCTAGGCAGCACAGATACGCAGTATTTT	CASSLGSTDTQYF	TRBV6-2	TRBJ2-3
TGTGCCAGCAGTCGTAAGTTTGCAGGGCCTAATGAAAAACTGTTTTTT	CASSRKFAGPNEKLFF	TRBV13	TRBJ1-4
TGTGCCAGCAGTAACCGGGACAGGGGGATGAAGAATGAAAAACTGTTTTTT	CASSNRDRGMKNEKLFF	TRBV6-4	TRBJ1-4
TGTGCCAGCAGCGGTGTGGGAAGAGCGGGACAAATCTCCTACAATGAGCAGTTCTTC	CASSGVGRAGQISYNEQFF	TRBV9	TRBJ2-1
TGTGCCAGCAGCTTATCGGGACAGGGAAACACCATATATTTT	CASSLSGQGNTIYF	TRBV11-2	TRBJ1-3
TGTGCCAGCAGCACCCGCCTAGGGAAGGGCACTGAAGCTTTCTTT	CASSTRLGKGTEAFF	TRBV7-7	TRBJ1-1
TGTGCCAGCAGTTACGGGGTAGCGGGTCTCAGAGTTGGGGATCCTTATACGCAGTATTTT	CASSYGVAGLRVGDPYTQYF	TRBV6-2	TRBJ2-3
TGTGCCAGCAGCCAAGGAGCGGGAGGTGCCGAGACCCAGTACTTC	CASSQGAGGAETQYF	TRBV5-4	TRBJ2-5
TGTGCCACCAGTGATTTAGACAGGGTATCCAGTGAGACCCAGTACTTC	CATSDLDRVSSETQYF	TRBV24-1	TRBJ2-5
TGCGCCAGCAGGAGCCGGCGCGGGGGGGAAGAGACCCAGTACTTC	CASRSRRGGEETQYF	TRBV5-1	TRBJ2-5
TGTGCCAGCAGTAGGGGCTGGGTGCCCCAGCATTTT	CASSRGWVPQHF	TRBV6-5	TRBJ1-5
TGTGCCAGCAGCCCCTTGGGGGGGGACAATGAGCAGTTCTTC	CASSPLGGDNEQFF	TRBV7-2	TRBJ2-1
TGTGCCAGCAGGGCGGTGAACACCGGGGAGCTGTTTTTT	CASRAVNTGELFF	TRBV7-9	TRBJ2-2
TGTGCCAGCAGCTTAACCCAGCTCGGGGCCGGGGAGCTGTTTTTT	CASSLTQLGAGELFF	TRBV7-9	TRBJ2-2
TGTGCCAGCAGCCGGCTCTGGGACAGAGGTATCCCCTACGAGCAGTACTTC	CASSRLWDRGIPYEQYF	TRBV13	TRBJ2-7
TGCAGTGCTAGAGATACCAAGGGACAGGTCTACGAGCAGTACTTC	CSARDTKGQVYEQYF	TRBV20-1	TRBJ2-7
TGTGCCAGCGGAGCTACTACCGAGCAGTACTTC	CASGATTEQYF	TRBV2	TRBJ2-7
TGTGCCAGCAGCCCTCCCCTTCCAGGGGGTCCCGGGGCCAACGTCCTGACTTTC	CASSPPLPGGPGANVLTF	TRBV7-4	TRBJ2-6
TGTGCCCCTCGGCAATCCACAGATACGCAGTATTTT	CAPRQSTDTQYF	TRBV30	TRBJ2-3
TGCGCCAGCAGCTTGGTGCAGGGCACAGGGACAACAGATACGCAGTATTTT	CASSLVQGTGTTDTQYF	TRBV5-1	TRBJ2-3
TGTGTAATGATTGGATACAGGGGCTACAATGAGCAGTTCTTC	CVMIGYRGYNEQFF	TRBV12-3	TRBJ2-1
TGTGCCAGCAGCGCGGCGGACAGAGAAGATACGCAGTATTTT	CASSAADREDTQYF	TRBV7-3	TRBJ2-3
TGTGCCAGCAGTGAAAACAGAGAAGAAGAGACCCAGTACTTC	CASSENREEETQYF	TRBV6-1	TRBJ2-5
TGTGCCAGCAGTTATTGGCAGGGCACTGAAGCTTTCTTT	CASSYWQGTEAFF	TRBV6-3	TRBJ1-1
TGTGCCAGGATCGGCAGGGCCCGGCAGCCCCAGCATTTT	CARIGRARQPQHF	TRBV27	TRBJ1-5
TGCGCCAGCAGCTTGCTTCCGACTAGCGACTACGAGCAGTACTTC	CASSLLPTSDYEQYF	TRBV5-1	TRBJ2-7
TGTGCCATCAGTGAGGCGGCTGGGGCCAACGTCCTGACTTTC	CAISEAAGANVLTF	TRBV10-3	TRBJ2-6
TGCGCCAGCCGACCGGATTGCTCTGGGGCCAACGTCCTGACTTTC	CASRPDCSGANVLTF	TRBV10-1	TRBJ2-6
TGTGCCAGCAGTTTTAACAGGGGGTCCGAAAAACTGTTTTTT	CASSFNRGSEKLFF	TRBV27	TRBJ1-4
TGTGCCAGCAGTGGGGGTCGGGACAGGGGGAGCTCCTACGAGCAGTACTTC	CASSGGRDRGSSYEQYF	TRBV6-5	TRBJ2-7
TGCGCCAGCAGCCAACAAAGGACAGGGGCTAATGAAAAACTGTTTTTT	CASSQQRTGANEKLFF	TRBV4-1	TRBJ1-4
TGCAGTGCTAGAGGTCAATGGGGTTCGAAACCAGATACGCAGTATTTT	CSARGQWGSKPDTQYF	TRBV20-1	TRBJ2-3
TGCGCCAGCAGCTTTAAGGACGGGAACACTGAAGCTTTCTTT	CASSFKDGNTEAFF	TRBV5-1	TRBJ1-1
TGTGCCAGCAGCTTGGAGATCCGAGGGTACGAGCAGTACTTC	CASSLEIRGYEQYF	TRBV5-4	TRBJ2-7
TGCGCCAGCAGTGACAGGGGGGCGGGAAACACCATATATTTT	CASSDRGAGNTIYF	TRBV10-1	TRBJ1-3
TGTGCCAGCAGCCAAAGTCAGGGGCCTGCCTACGAGCAGTACTTC	CASSQSQGPAYEQYF	TRBV3-1	TRBJ2-7
TGTGCCAGCAGTTTATCCTCCCTATCGGGAACGGTCCCCGGGGAGCTGTTTTTT	CASSLSSLSGTVPGELFF	TRBV27	TRBJ2-2
TGTGCCAGCAGCCTGGAGCGTCAGTACGAGCAGTACTTC	CASSLERQYEQYF	TRBV9	TRBJ2-7
TGCAGTGCCCGAAAAGAGACCCAGTACTTC	CSARKETQYF	TRBV20-1	TRBJ2-5
TGCAGCGTTGAGGGCGTTAAAGTTGCAGGGCGGGAGGGGGTAAACCAAGAGACCCAGTACTTC	CSVEGVKVAGREGVNQETQYF	TRBV29-1	TRBJ2-5
TGTGCCAGCAGTTTATCCCAAAAGGGGATGGTCTACCAAGAGACCCAGTACTTC	CASSLSQKGMVYQETQYF	TRBV27	TRBJ2-5
TGTGCCACCAGTGATTTGGTGACTAGCGGGAGGTTATCCCATCAGCCCCAGCATTTT	CATSDLVTSGRLSHQPQHF	TRBV24-1	TRBJ1-5
TGTGCCAGCAGACCTTCGACTCAGAGGGTGGAGCAGTACTTC	CASRPSTQRVEQYF	TRBV2	TRBJ2-7
TGTGCCAGCATGGAAAGGACAAGGAGGGGCTCCACAGATACGCAGTATTTT	CASMERTRRGSTDTQYF	TRBV4-2	TRBJ2-3
TGTGCCAGCAGTTACTCGACCCTTAGGGGGAACACTGAAGCTTTCTTT	CASSYSTLRGNTEAFF	TRBV6-3	TRBJ1-1
TGCGCCTCCACAGGGGGGGAGACCCAGTACTTC	CASTGGETQYF	TRBV10-1	TRBJ2-5
TGCAGTGCTAGCCCTCACGGCGCTATCGCGACTGAAGCTTTCTTT	CSASPHGAIATEAFF	TRBV20-1	TRBJ1-1
TGTGCCAGCAGCCGCTTCGGGGGGGAGGGCACAGATACGCAGTATTTT	CASSRFGGEGTDTQYF	TRBV7-8	TRBJ2-3
TGCGCCAGCAGCTCGGGGCACGAGCAGTACTTC	CASSSGHEQYF	TRBV5-1	TRBJ2-7
TGTGCCAGCAGTCAATTCGGGACTTACGAGCAGTACTTC	CASSQFGTYEQYF	TRBV12-4	TRBJ2-7
TGTGCCAGCAGTCCACAGGACGAGCAGTACTTC	CASSPQDEQYF	TRBV6-8	TRBJ2-7
TGTGCCCCTACAGGGAGTAATGGCTACACCTTC	CAPTGSNGYTF	TRBV12-4	TRBJ1-2
TGTGCCAGCAGCTTGGCCCCGGGGTGCCATCACGAGCAGTACTTC	CASSLAPGCHHEQYF	TRBV5-6	TRBJ2-7
TGTGCCAGCAGGCGGGCGGGGAACTATGGCTACACCTTC	CASRRAGNYGYTF	TRBV7-3	TRBJ1-2
TGTGCCAGCAGTGGGGGATTTAGCGGGACGGAGAGCTCCTACAATGAGCAGTTCTTC	CASSGGFSGTESSYNEQFF	TRBV6-1	TRBJ2-1
TGCGCCAGCAGTCGTCGGACAGGGAATCAGCCCCAGCATTTT	CASSRRTGNQPQHF	TRBV10-2	TRBJ1-5
TGTGCCAGCAGTTACGATAGTGTCGGGACTAGCGGGGGGGCCGTGAGTGGAACCGATGAGCAGTTCTTC	CASSYDSVGTSGGAVSGTDEQFF	TRBV6-5	TRBJ2-1
TGTGCCAGCAGCCCTGAGAGGAACACTGAAGCTTTCTTT	CASSPERNTEAFF	TRBV7-9	TRBJ1-1
TGTGCCAGCAGGCGGGGTCGGGACCCACTCGAGCAGTACTTC	CASRRGRDPLEQYF	TRBV6-4	TRBJ2-7
TGTGCCAGCAGCTGGTTTTCAGGGAGCTCCTACGAGCAGTACTTC	CASSWFSGSSYEQYF	TRBV5-6	TRBJ2-7
TGTGCTCCCCCCGGAATAAGCTACACCTTC	CAPPGISYTF	TRBV2	TRBJ1-2
TGTGCCAGCAGGAGACGAAACACCGGGGAGCTGTTTTTT	CASRRRNTGELFF	TRBV6-5	TRBJ2-2
TGTGCCAGCAGAGATGGACTAGGGACTAGGCCCGGCGAGCAGTACTTC	CASRDGLGTRPGEQYF	TRBV27	TRBJ2-7
TGTGCCAGCAGAATTCGGCCCATGAACACTGAAGCTTTCTTT	CASRIRPMNTEAFF	TRBV28	TRBJ1-1
TGTGCCAGCAGTTCCTTGCGGGAAACCGGCTACAATGAGCAGTTCTTC	CASSSLRETGYNEQFF	TRBV6-1	TRBJ2-1
TGTGCCAGGAGCATCCGTCAAGGGGCCAACGTCCTGACTTTC	CARSIRQGANVLTF	TRBV5-4	TRBJ2-6
TGTGCCAGCAGCCAGGGACCTGGTAATACCAGCAATGAGCAGTTCTTC	CASSQGPGNTSNEQFF	TRBV7-9	TRBJ2-1
TGCGCCAGCAGCTTATTCGGGGATGGCTACACCTTC	CASSLFGDGYTF	TRBV5-1	TRBJ1-2
TGCGCCAGCAGCCATTATCGGGAACGGGAGCAGTACTTC	CASSHYREREQYF	TRBV4-1	TRBJ2-7
TGTGCCAGCAGTTTGATGTACGGACAGGCATATGGCTACACCTTC	CASSLMYGQAYGYTF	TRBV12-3	TRBJ1-2
TGCAGTGCTAGGTCAGTCTGGGGGAACACCGGGGAGCTGTTTTTT	CSARSVWGNTGELFF	TRBV20-1	TRBJ2-2
TGTGCCAGCAGCCAAGCCCTCTGCGGCACTGAAGCTTTCTTT	CASSQALCGTEAFF	TRBV3-1	TRBJ1-1
TGTGCCAGCAGCTTCCGCAGGGGGAGCAATCAGCCCCAGCATTTT	CASSFRRGSNQPQHF	TRBV5-6	TRBJ1-5
TGTGCCAGCAGCGGACCGACAGGGACATGCTTC	CASSGPTGTCF	TRBV13	TRBJ1-2
TGTGCCACCAGTGGATGGACAGGGGAAAGGTGGGTGGGCCCCTACGAGCAGTACTTC	CATSGWTGERWVGPYEQYF	TRBV24-1	TRBJ2-7
TGTGGGCCCGCTAGGTCGTTATACAATGAGCAGTTCTTC	CGPARSLYNEQFF	TRBV24-1	TRBJ2-1
TGTGCCACCAGTGATTTCGGGGGGACAGGAGACTCTGGGGCCAACGTCCTGACTTTC	CATSDFGGTGDSGANVLTF	TRBV24-1	TRBJ2-6
TGTGCCAGCAGCTTAGTTCCAACGAGGTATGGCTACACCTTC	CASSLVPTRYGYTF	TRBV11-2	TRBJ1-2
TGTGCCAGCAGCGAACAGGGTTTAACCGGGGAGCTGTTTTTT	CASSEQGLTGELFF	TRBV13	TRBJ2-2
TGTGCCAGCTCACGGAGAAGGGGGAGGGGCCAAGAGACCCAGTACTTC	CASSRRRGRGQETQYF	TRBV18	TRBJ2-5
TGTGCCAGCAGCCCGATCAGGAGTGGCTACACCTTC	CASSPIRSGYTF	TRBV11-3	TRBJ1-2
TGTGCTAGTGGTTTGGTACCGGCAGGCTACGAGCAGTACTTC	CASGLVPAGYEQYF	TRBV12-5	TRBJ2-7
TGTGCCACCAGTGCGACGACTGACAATGGTGAGCAGTTCTTC	CATSATTDNGEQFF	TRBV24-1	TRBJ2-1
TGTGCCAGCAGTTACCAGTGGGAGGGCCGACCCCAAGAGACCCAGTACTTC	CASSYQWEGRPQETQYF	TRBV6-5	TRBJ2-5
TGTGCCAGCAGCTTAGCGAAAAGCAGACTTGCGGAAGAGACCCAGTACTTC	CASSLAKSRLAEETQYF	TRBV11-3	TRBJ2-5
TGTGCCAGCAGCTTAGGAGAGGGCGATGGCTACGAGCAGTACTTC	CASSLGEGDGYEQYF	TRBV7-9	TRBJ2-7
TGTGCCATTGAGCAGGGCTACACCTTC	CAIEQGYTF	TRBV4-2	TRBJ1-2
TGTGCCAGCAGCCGGCCCCTCAACTCTGGGGCCAACGTCCTGACTTTC	CASSRPLNSGANVLTF	TRBV7-3	TRBJ2-6
TGTGCCAGCAGCATTCGGGGACAGGGGAGCACAGATACGCAGTATTTT	CASSIRGQGSTDTQYF	TRBV14	TRBJ2-3
TGCAGCGTTGATTTATCGGGAATTGAGCAGTTCTTC	CSVDLSGIEQFF	TRBV29-1	TRBJ2-1
TGTGCCAGCAGCTCCCTTAACCCACAGATCTCTACTAACTATGGCTACACCTTC	CASSSLNPQISTNYGYTF	TRBV13	TRBJ1-2
TGTGCCATTCTGACAGGGGTTTTCGGGTCAAGCTCCTACGAGCAGTACTTC	CAILTGVFGSSSYEQYF	TRBV7-8	TRBJ2-7
TGCGCCAGCAGCGGGGCCAGGGTACGCACAGATACGCAGTATTTT	CASSGARVRTDTQYF	TRBV5-1	TRBJ2-3
TGTGCCACCAGTGAGACTAGCGGGAGTACGCAGTATTTT	CATSETSGSTQYF	TRBV24-1	TRBJ2-3
TGTGCCAGCAGCAGTCGGACAGGGCGACCCGGCTACACCTTC	CASSSRTGRPGYTF	TRBV27	TRBJ1-2
TGCGCCTGGCATGGGCGGGGCGGCTACGAGCAGTACTTC	CAWHGRGGYEQYF	TRBV10-1	TRBJ2-7
TGTGCCTGGAGTGGCCCTAACAACACCGGGGAGCTGTTTTTT	CAWSGPNNTGELFF	TRBV30	TRBJ2-2
TGTGCCACCAGTGATTGGCACCCCGTGGAGGGGTTATACAATGAGCAGTTCTTC	CATSDWHPVEGLYNEQFF	TRBV24-1	TRBJ2-1
TGTGCCAGCAGCTCTAGCGGGTCGGTTCGCACAGATACGCAGTATTTT	CASSSSGSVRTDTQYF	TRBV9	TRBJ2-3
TGTGCCAGTAGTTCACCAGGTCGTAATCAGCCCCAGCATTTT	CASSSPGRNQPQHF	TRBV19	TRBJ1-5
TGCAGTGCCACATTTAGGAACACTGAAGCTTTCTTT	CSATFRNTEAFF	TRBV20-1	TRBJ1-1
TGCGCCAGCAGTGAGACACAGGGTCAGCCCCAGCATTTT	CASSETQGQPQHF	TRBV10-1	TRBJ1-5
TGTGCCAGCAGCTTAGTCCGGGGGGCAATACCTGAGCAGTTCTTC	CASSLVRGAIPEQFF	TRBV11-2	TRBJ2-1
TGTGCCAGCAGCTTCCTTCCCCCAGGGGGCCCGGGAAACACCATATATTTT	CASSFLPPGGPGNTIYF	TRBV11-3	TRBJ1-3
TGCGCCAGCAGCCAAGTGGCGAAAAAGCGCAGGGGCTCTGGGGCCAACGTCCTGACTTTC	CASSQVAKKRRGSGANVLTF	TRBV4-1	TRBJ2-6
TGTGCCAGCAGCTCTTATGCAAGGGGAGGTAAAGAAGACACTGAAGCTTTCTTT	CASSSYARGGKEDTEAFF	TRBV7-3	TRBJ1-1
TGTGCCAGCAGCATCTCTAGCGGTACCTACGAGCAGTACTTC	CASSISSGTYEQYF	TRBV11-2	TRBJ2-7
TGTGCCACCAGTGACGGGGAGGAGCAGTACTTC	CATSDGEEQYF	TRBV24-1	TRBJ2-7
TGCAGTGCTGAGAGACTAGCATTGGGACGGCGAGGAGAGACCCAGTACTTC	CSAERLALGRRGETQYF	TRBV20-1	TRBJ2-5
TGTGCCAGCAGCTATACAGCGGGCTACACCTTC	CASSYTAGYTF	TRBV7-9	TRBJ1-2
TGTGCCAGCAGCCAAGATAGGAGGTCTCGAGACACTGAAGCTTTCTTT	CASSQDRRSRDTEAFF	TRBV14	TRBJ1-1
TGTGCCTGGAGAGTCAGTAGTGACTACGAGCAGTACTTC	CAWRVSSDYEQYF	TRBV30	TRBJ2-7
TGTGCCAGCAGCCCTGGGGGGAATAACACTGAAGCTTTCTTT	CASSPGGNNTEAFF	TRBV13	TRBJ1-1
TGCAGTGCTAGACCCCGGAGAAAGCTAGCCAAAAACATTCAGTACTTC	CSARPRRKLAKNIQYF	TRBV20-1	TRBJ2-4
TGTGCCAGCGCGACGCAGGGCTCTGGGGCCAACGTCCTGACTTTC	CASATQGSGANVLTF	TRBV6-8	TRBJ2-6
TGTGCCAGCAGCTTATCTAAAAATAGTAGCTCCTACGAGCAGTACTTC	CASSLSKNSSSYEQYF	TRBV7-9	TRBJ2-7
TGTGCCAGCAGCCCGTCGGGGCGGGCCGAGCAGTACTTC	CASSPSGRAEQYF	TRBV7-9	TRBJ2-7
TGCGCCAGCAGCCAAGGGGCCCGAGGGAGTGATACGCAGTATTTT	CASSQGARGSDTQYF	TRBV4-1	TRBJ2-3
TGTGCCAGCAGCCGGTTCCGACAGGGCAGCAATCAGCCCCAGCATTTT	CASSRFRQGSNQPQHF	TRBV6-1	TRBJ1-5
TGTGCCAGCAGTGAAGGAGGGGGGGAAACTAATGAAAAACTGTTTTTT	CASSEGGGETNEKLFF	TRBV6-1	TRBJ1-4
TGTGCCTGGAGTATTACGGGGTCCTCAACTAATGAAAAACTGTTTTTT	CAWSITGSSTNEKLFF	TRBV30	TRBJ1-4
TGTGCTAGCAGCTTAGACGAAGGCGGGAGTAGTGAGCAGTTCTTC	CASSLDEGGSSEQFF	TRBV7-7	TRBJ2-1
TGTGCCAGCAGCTGTCCTAGAAATGAGCAGTTCTTC	CASSCPRNEQFF	TRBV13	TRBJ2-1
TGTGCCAGCAGCTTATCCGATAAGCAAGAGACCCAGTACTTC	CASSLSDKQETQYF	TRBV11-3	TRBJ2-5
TGTGCCAGCAGCTTCGGGTTGGAGGCTAACTATGGCTACACCTTC	CASSFGLEANYGYTF	TRBV5-4	TRBJ1-2
TGTGCCAGCAGCTGTGATTGCCAAGAGACCCAGTACTTC	CASSCDCQETQYF	TRBV11-2	TRBJ2-5
TGTGCCACCAGTGATTCGATTAGCAGAAGCTCCTACAATGAGCAGTTCTTC	CATSDSISRSSYNEQFF	TRBV24-1	TRBJ2-1
TGTGCCAGCAGTGAATCGAGCGGGAGGAATGGGAACACTGAAGCTTTCTTT	CASSESSGRNGNTEAFF	TRBV25-1	TRBJ1-1
TGTGCCACCAGTGGGGCCTGGCGCTACGAGCAGTACTTC	CATSGAWRYEQYF	TRBV24-1	TRBJ2-7
TGTGCCAGCACAGGGCTCCCTGACACCGGGGAGCTGTTTTTT	CASTGLPDTGELFF	TRBV7-3	TRBJ2-2
TGCAGTGCTAGACTGTACGGGACAGCTTCTGGGGCCAACGTCCTGACTTTC	CSARLYGTASGANVLTF	TRBV20-1	TRBJ2-6
TGTGCCAGCAGCTACAGGGTAAGAGGCAATCAGCCCCAGCATTTT	CASSYRVRGNQPQHF	TRBV7-2	TRBJ1-5
TGTGCCAGCAGCCACCCGCACCAAGTGGCAGGCACCGGGGAGCTGTTTTTT	CASSHPHQVAGTGELFF	TRBV5-4	TRBJ2-2
TGTGCCAGCAGCCGGACAGGGGGAAACACCATATATTTT	CASSRTGGNTIYF	TRBV27	TRBJ1-3
TGTGCCAGCAGTTATCTACCATACGAGCAGTACTTC	CASSYLPYEQYF	TRBV6-5	TRBJ2-7
TGTGCCAGGGGACAGGGCCACCGCAATCAGCCCCAGCATTTT	CARGQGHRNQPQHF	TRBV28	TRBJ1-5
TGTGCCAGCAGTTACAGGGGGTTGGCGAACACCGGGGAGCTGTTTTTT	CASSYRGLANTGELFF	TRBV6-9	TRBJ2-2
TGCAGTGCTAGCACGATCTGGGTTAACATTCAGTACTTC	CSASTIWVNIQYF	TRBV20-1	TRBJ2-4
TGTGCCAGCAGGGTTACGGGTGGGGAATTCTGGTACGAGCAGTACTTC	CASRVTGGEFWYEQYF	TRBV6-3	TRBJ2-7
TGCAGTGCTACCGGGACTCGACTAAGTATAGAGACCCAGTACTTC	CSATGTRLSIETQYF	TRBV20-1	TRBJ2-5
TGTGCCAGCAGTTTATGGGAGGGGGGTTCCAATCAGCCCCAGCATTTT	CASSLWEGGSNQPQHF	TRBV28	TRBJ1-5
TGCGCCACCCGGGACAGGGTTAGCTCCTACGAGCAGTACTTC	CATRDRVSSYEQYF	TRBV4-3	TRBJ2-7
TGTGCCAGCAGCTACAGGGGGCCATCTTCTTTAGACTCTGGAAACACCATATATTTT	CASSYRGPSSLDSGNTIYF	TRBV7-3	TRBJ1-3
TGTGCCAGCAGCCAAGTAGGGGGGACTAGCTACAATGAGCAGTTCTTC	CASSQVGGTSYNEQFF	TRBV4-2	TRBJ2-1
TGTGCCAAACGGGTGTCACAGGGGGACTATCAGCCCCAGCATTTT	CAKRVSQGDYQPQHF	TRBV9	TRBJ1-5
TGTGCCACCAGTCGCAGGGGATTAACGAACTATGGCTACACCTTC	CATSRRGLTNYGYTF	TRBV24-1	TRBJ1-2
TGCGCCAGCAGCCAAGACGGCGGGAACGAGACCCAGTACTTC	CASSQDGGNETQYF	TRBV4-1	TRBJ2-5
TGCAGTGCTAGAGAACCTACTCCCGACAGGACAAATGGCTACACCTTC	CSAREPTPDRTNGYTF	TRBV20-1	TRBJ1-2
TGTGCCTGGGACAGGGGGCCGCCGTCATGCAATCAGCCCCAGCATTTT	CAWDRGPPSCNQPQHF	TRBV10-3	TRBJ1-5
TGTGCCAGCAATCAACTAACAGGGGGTCATGAAGCTTTCTTT	CASNQLTGGHEAFF	TRBV6-4	TRBJ1-1
TGTGCCAGCGGGACCAGCTACGAGCAGTACTTC	CASGTSYEQYF	TRBV12-4	TRBJ2-7
TGTGCCAGCAGTTTACGGGGGCATAACAGTTTCTCGCCCTACGAGCAGTACTTC	CASSLRGHNSFSPYEQYF	TRBV27	TRBJ2-7
TGTGCCAGTAGTACTGCCCCGGGAGGGCCCTCTCGCACAGATACGCAGTATTTT	CASSTAPGGPSRTDTQYF	TRBV19	TRBJ2-3
TGCAGCGTGACTAGCGGGAGGGTGTGCAATGAGCAGTTCTTC	CSVTSGRVCNEQFF	TRBV29-1	TRBJ2-1
TGTGCCAGCAGAATCGAGGGACTAGGAGAGACCCAGTACTTC	CASRIEGLGETQYF	TRBV6-5	TRBJ2-5
TGTGCCAGCATCGACGAGGACGGTTCAGATACGCAGTATTTT	CASIDEDGSDTQYF	TRBV11-3	TRBJ2-3
TGTGCCAGCAGCCAAGACTCACGGGGAGATGAGCAGTTCTTC	CASSQDSRGDEQFF	TRBV3-1	TRBJ2-1
TGCAGTGCTAGAGCCAACAAAGCGGGAGACGGCACCGGGGAGCTGTTTTTT	CSARANKAGDGTGELFF	TRBV20-1	TRBJ2-2
TGCGCCAGCAGCTTGGTGTGCTTGAGGGATACAACTAATGAAAAACTGTTTTTT	CASSLVCLRDTTNEKLFF	TRBV5-1	TRBJ1-4
TGCAGTGCTTTGGGGTTACATTACGAGCAGTACTTC	CSALGLHYEQYF	TRBV20-1	TRBJ2-7
TGTGCCAACCCGGCTACTGAGCAGTTCTTC	CANPATEQFF	TRBV10-3	TRBJ2-1
TGTGCCAGCAGCGGCCCCTCGCACACCGGGGAGCTGTTTTTT	CASSGPSHTGELFF	TRBV13	TRBJ2-2
TGTGCCAGCAGCCAAGATAGCAGGACAGGGGATCAGCCCCAGCATTTT	CASSQDSRTGDQPQHF	TRBV3-1	TRBJ1-5
TGCGCCAGCAGCGCTACAGCCGTCAATCAGCCCCAGCATTTT	CASSATAVNQPQHF	TRBV5-1	TRBJ1-5
TGTGCCACCATGGGGGGAACTCCAAATTCACCCCTCCACTTT	CATMGGTPNSPLHF	TRBV24-1	TRBJ1-6
TGTGCCATCAGTGAGTCCCCCCCCGATAATGGACAGGGCTCTTCAGAGCAGTTCTTC	CAISESPPDNGQGSSEQFF	TRBV10-3	TRBJ2-1
TGCGCCAGCAGCTTGTCGCGTTCAGATCGGTACAGCAATCAGCCCCAGCATTTT	CASSLSRSDRYSNQPQHF	TRBV5-1	TRBJ1-5
TGTGCCAGCAGCCATCCAGGGGGGAAGTACGAGACCCAGTACTTC	CASSHPGGKYETQYF	TRBV7-9	TRBJ2-5
TGCGCCAGCAGCCAAGATTCGGGACAGGGGGCGAGGACAGATACGCAGTATTTT	CASSQDSGQGARTDTQYF	TRBV4-1	TRBJ2-3
TGTGCCAGCTTCGACAGAGGGCTGGGAGACTATGGCTACACCTTC	CASFDRGLGDYGYTF	TRBV2	TRBJ1-2
TGTGCCAGCAGTGACGGGGACGAGACCCAGTACTTC	CASSDGDETQYF	TRBV6-1	TRBJ2-5
TGTGCCAGCAGTTACCCGCCAGAACCATCGCCGGGAGATACGCAGTATTTT	CASSYPPEPSPGDTQYF	TRBV6-5	TRBJ2-3
TGTGCCAGCAGCGCTTTAGAGGGTTTTATTCATGAGCAGTTCTTC	CASSALEGFIHEQFF	TRBV28	TRBJ2-1
TGTGCCAGCAGCTCCTCTGAACAGGGGGGATTTGACACTGAAGCTTTCTTT	CASSSSEQGGFDTEAFF	TRBV7-9	TRBJ1-1
TGTGCCACCAGCCCAGCTAGTATCCGGACGCATGGGGAAAACATTCAGTACTTC	CATSPASIRTHGENIQYF	TRBV24-1	TRBJ2-4
TGTGCCAGGGGGCTAGCGGGGAAAATTGGGTACTTC	CARGLAGKIGYF	TRBV7-3	TRBJ2-7
TGTGCCAGCAGTGAAGCCGGGTGTAGGCCTATAAATGAGCAGTTCTTC	CASSEAGCRPINEQFF	TRBV6-1	TRBJ2-1
TGTGCCAGCAGCCGCCGCCCAGTAGCTTTCTTT	CASSRRPVAFF	TRBV7-9	TRBJ1-1
TGCGCCACCGGCAAGTTATGCAAAACCCAGTACTTC	CATGKLCKTQYF	TRBV10-1	TRBJ2-5
TGTGCCAGCAGCCAAGAGATTCGCGGGGGGCGGTACTTC	CASSQEIRGGRYF	TRBV14	TRBJ2-4
TGTGCCAGCAGCGTAGGAACAGGGGGATACTACGAGCAGTACTTC	CASSVGTGGYYEQYF	TRBV9	TRBJ2-7
TGTGCCAGCAGCCCGGACAGAAACACTGAAGCTTTCTTT	CASSPDRNTEAFF	TRBV14	TRBJ1-1
TGTGCCAGCTCACCACCCTGCAGGCCGTGCCAAACCTCTGGGGCCAACGTCCTGACTTTC	CASSPPCRPCQTSGANVLTF	TRBV18	TRBJ2-6
TGTGCCAGCAGGGGAGCCGTAGAAGGAAATCAGCCCCAGCATTTT	CASRGAVEGNQPQHF	TRBV6-2	TRBJ1-5
TGCGCCAGCAGCCAAGTAAGGGGAAACTCACCCCTCCACTTT	CASSQVRGNSPLHF	TRBV4-3	TRBJ1-6
TGTGCCAGCAGTTATGGGGGTATAAGCTCCTACGAGCAGTACTTC	CASSYGGISSYEQYF	TRBV9	TRBJ2-7
TGTGCCAGCAGCCGCCCGCGAACATCATACAATGAGCAGTTCTTC	CASSRPRTSYNEQFF	TRBV12-4	TRBJ2-1
TGTGCCAGCAGCTTGATTGGGTACGAGCAGTACTTC	CASSLIGYEQYF	TRBV5-5	TRBJ2-7
TGTGCCAGCAGCCTGATGCTATCTTACAATGAGCAGTTCTTC	CASSLMLSYNEQFF	TRBV14	TRBJ2-1
TGTGCCAGTCCTAGCGGGGGAAGCTCCTACAATGAGCAGTTCTTC	CASPSGGSSYNEQFF	TRBV6-1	TRBJ2-1
TGTGCCAGCAGCGGGGGGACAGGGGCCAACGTCCTGACTTTC	CASSGGTGANVLTF	TRBV5-4	TRBJ2-6
TGTGCCAGCAGCCCGAGACCGGGGCACAACGAGCAGTACTTC	CASSPRPGHNEQYF	TRBV7-3	TRBJ2-7
TGCGCCAGCAGTGACACTGACGACGCTACTGGCACAGATACGCAGTATTTT	CASSDTDDATGTDTQYF	TRBV10-1	TRBJ2-3
TGTGCCAGCAGCGGGATAAAGGGAGAAGATGGCTACACCTTC	CASSGIKGEDGYTF	TRBV7-3	TRBJ1-2
TGTGCCAGCACGGAAAACAAGAAGGGGTGGACAGGGGTGGCAGACGAGCAGTACTTC	CASTENKKGWTGVADEQYF	TRBV6-2	TRBJ2-7
TGTGCCAGCAGCCGGGGACGGCCCCAGCATTTT	CASSRGRPQHF	TRBV7-9	TRBJ1-5
TGTGCCAGCAGCGAAGGACAGGGTGAAGGGAATTCACCCCTCCACTTT	CASSEGQGEGNSPLHF	TRBV13	TRBJ1-6
TGTGTTCGGAGGGCGGTGAACACTGAAGCTTTCTTT	CVRRAVNTEAFF	TRBV7-9	TRBJ1-1
TGTGCCAGCAGCTTGGGGACCACAGGGTACGAGCAGTACTTC	CASSLGTTGYEQYF	TRBV5-4	TRBJ2-7
TGTGCCAGCAGTGTCCCCGGGACTAGGGCTATCTACGAGCAGTACTTC	CASSVPGTRAIYEQYF	TRBV27	TRBJ2-7
TGTGCCAGCAGTCGCGACAGGCCGTTGAACACTGAAGCTTTCTTT	CASSRDRPLNTEAFF	TRBV27	TRBJ1-1
TGTGCCAGCAGCCAAACGCAGGGGGCTCGATTTCGGTATCGGAACACTGAAGCTTTCTTT	CASSQTQGARFRYRNTEAFF	TRBV3-1	TRBJ1-1
TGTGCCAGCAGCTTAAGTAGGTATAGTAAAAACATTCAGTACTTC	CASSLSRYSKNIQYF	TRBV7-3	TRBJ2-4
TGTGCCAGCAGGCGTAGTGCTAGAGATACGCAGTATTTT	CASRRSARDTQYF	TRBV6-3	TRBJ2-3
TGTGCCAGCAGCGGTATGCCGGTAAGCAACATTCAGTACTTC	CASSGMPVSNIQYF	TRBV7-3	TRBJ2-4
TGTGCCAGTAGCGTAACCGCGGTGGGAGGGCACTTTGGCTACACCTTC	CASSVTAVGGHFGYTF	TRBV19	TRBJ1-2
TGTGCCAGCAGCCGGGGACTAGCGGGTAGAGATACGCAGTATTTT	CASSRGLAGRDTQYF	TRBV7-9	TRBJ2-3
TGTGCCAGCAAAATCGGGGACAGGGACGGGTGCTCCTACAATGAGCAGTTCTTC	CASKIGDRDGCSYNEQFF	TRBV2	TRBJ2-1
TGTGCCAGCAGCTCCGGGAGGGCAGATACGCAGTATTTT	CASSSGRADTQYF	TRBV5-5	TRBJ2-3
TGTGCCAGCACGGCTAGCGGGGGGAACTCCTACAATGAGCAGTTCTTC	CASTASGGNSYNEQFF	TRBV7-9	TRBJ2-1
TGCGCCAGCAGCGGGGGGGGGGCAGGACGCACAGATACGCAGTATTTT	CASSGGGAGRTDTQYF	TRBV5-1	TRBJ2-3
TGTGCCAGCAGCAACCCGGACGATGAGCAGTTCTTC	CASSNPDDEQFF	TRBV7-9	TRBJ2-1
TGTGCCACGCGGGTCCCACAGGGTGCAACTAATGAAAAACTGTTTTTT	CATRVPQGATNEKLFF	TRBV24-1	TRBJ1-4
TGTGTAAATGAGGGACAGTCCTACGAGCAGTACTTC	CVNEGQSYEQYF	TRBV12-3	TRBJ2-7
TGCAGCGTTGAAGACCGGCAAGAGACCCAGTACTTC	CSVEDRQETQYF	TRBV29-1	TRBJ2-5
TGCGCCAGCAGCGGTCAGTGGAGGAGGTGGAGAGGGAACACTGAAGCTTTCTTT	CASSGQWRRWRGNTEAFF	TRBV5-1	TRBJ1-1
TGTGCCAGCAGTTTTCTGCGAGGGGAGCTGTTTTTT	CASSFLRGELFF	TRBV28	TRBJ2-2
TGCGCCAGCAGCCCCTTAAAGTGCAATCAGCCCCAGCATTTT	CASSPLKCNQPQHF	TRBV4-1	TRBJ1-5
TGTGCCAGCAGCAAGAGAAGTTACGAGCAGTACTTC	CASSKRSYEQYF	TRBV5-6	TRBJ2-7
TGTGCCAGCAGTCGGGGCGGGAGCATGCAAGAGACCCAGTACTTC	CASSRGGSMQETQYF	TRBV6-5	TRBJ2-5
TGTGCCCCCGGGGGTTACACTGAAGCTTTCTTT	CAPGGYTEAFF	TRBV6-4	TRBJ1-1
TGTGCCAGCAGTTCGGGGAGTGTACACCCATATCAAGAGACCCAGTACTTC	CASSSGSVHPYQETQYF	TRBV6-5	TRBJ2-5
TGTGCCAGCACCACCGGAGACAGGGCATTCTTC	CASTTGDRAFF	TRBV7-9	TRBJ2-1
TGTGCCAGCAGCTTGGGCCTCTTCCCTGAAGCTTTCTTT	CASSLGLFPEAFF	TRBV7-8	TRBJ1-1
TGTGCCAGCACATTAGGGGCCGGAAGTTCTCACGAGCAGTACTTC	CASTLGAGSSHEQYF	TRBV6-4	TRBJ2-7
TGCGCCAGCAGCCGATCGCTGCGCGCCCGCAATCAGCCCCAGCATTTT	CASSRSLRARNQPQHF	TRBV4-1	TRBJ1-5
TGTGCCACCAGTGCTACAGAGGTAAGGGGGCCCCACTACGAGCAGTACTTC	CATSATEVRGPHYEQYF	TRBV24-1	TRBJ2-7
TGCGCCAGCAGATGGGGAGCGTATGGCTACACCTTC	CASRWGAYGYTF	TRBV10-1	TRBJ1-2
TGTGCCAGCAGTTCCGAATCTCAAGGGAGGATTAGGTTCTACGAGCAGTACTTC	CASSSESQGRIRFYEQYF	TRBV27	TRBJ2-7
TGTGCCAGCAGCTCCGGACTAGCGGCCACCGGGGAGCTGTTTTTT	CASSSGLAATGELFF	TRBV5-4	TRBJ2-2
TGTGCCAGCAGCTTAGTCCGGACGAATAGCAATCAGCCCCAGCATTTT	CASSLVRTNSNQPQHF	TRBV7-2	TRBJ1-5
TGCAGTGGGACTCCGGGACTCAAAAACATTCAGTACTTC	CSGTPGLKNIQYF	TRBV20-1	TRBJ2-4
TGTGCCAGCAGTGGGGGCTGTCAGCCCCAGCATTTT	CASSGGCQPQHF	TRBV6-1	TRBJ1-5
TGCGCCAGCAGCTTGACCGGCCGTGGCTACACCTTC	CASSLTGRGYTF	TRBV5-1	TRBJ1-2
TGTGCCACCGGCCGGGACAGGGAAGCAACTGGACCTCCGACTAATGAAAAACTGTTTTTT	CATGRDREATGPPTNEKLFF	TRBV6-1	TRBJ1-4
TGTGCCAGCAGCGTGGGGCGTAGGAGCTCCTACGAGCAGTACTTC	CASSVGRRSSYEQYF	TRBV7-2	TRBJ2-7
TGTGCCAGCAGCTCCACTTCCGACAGGGGCTCTGGAAACACCATATATTTT	CASSSTSDRGSGNTIYF	TRBV5-6	TRBJ1-3
TGCAGTGCTAGGTCCCTTCGGGGCGGCCGGGGAGGAGATGAAGCTTTCTTT	CSARSLRGGRGGDEAFF	TRBV20-1	TRBJ1-1
TGCGCCAGCAGCATACTAGCCGGGGAGCTGTTTTTT	CASSILAGELFF	TRBV5-1	TRBJ2-2
TGTGCCAGCAGACCAAGGGGGATAGGGGCCATGAACACTGAAGCTTTCTTT	CASRPRGIGAMNTEAFF	TRBV6-2	TRBJ1-1
TGTGCCGGCAGGGGGGACAATGAGCAGTTCTTC	CAGRGDNEQFF	TRBV11-2	TRBJ2-1
TGTGCCACCAGGGGAAGCTCCTATAATTCACCCCTCCACTTT	CATRGSSYNSPLHF	TRBV24-1	TRBJ1-6
TGTGCCAGCAGCGTACAATATGGGGGGGCCATACTCCGTACTGAGCAGTTCTTC	CASSVQYGGAILRTEQFF	TRBV9	TRBJ2-1
TGCAGTGCTAGACCCCATAAGAGGGCCAACTATGGCTACACCTTC	CSARPHKRANYGYTF	TRBV20-1	TRBJ1-2
TGTGCCAGCAGCGACCCAGAGGGCTACGAGCAGTACTTC	CASSDPEGYEQYF	TRBV9	TRBJ2-7
TGTGCCAGCAGCTTAAAGCCCGGGACAGGGGAGATCACCGGGGAGCTGTTTTTT	CASSLKPGTGEITGELFF	TRBV11-2	TRBJ2-2
TGTGCCAGCAAGGGGGAAACTGGAAACACCATATATTTT	CASKGETGNTIYF	TRBV11-3	TRBJ1-3
TGCGCCAGCTCAGGGAAATATAGCAATCAGCCCCAGCATTTT	CASSGKYSNQPQHF	TRBV10-1	TRBJ1-5
TGTGCCAGCAGCTTGAGGACTGACAATGAGCAGTTCTTC	CASSLRTDNEQFF	TRBV5-6	TRBJ2-1
TGCAGTGCTAGAGGCGGGGGCTACGAGCAGTACTTC	CSARGGGYEQYF	TRBV20-1	TRBJ2-7
TGTGCCAGCAGAATCGGACTAGCGGGGGGGCCGCACTACAATGAGCAGTTCTTC	CASRIGLAGGPHYNEQFF	TRBV3-1	TRBJ2-1
TGTGCCAGCAGTTACTGGGTGGCCCGAGGGCTCACAGATACGCAGTATTTT	CASSYWVARGLTDTQYF	TRBV6-3	TRBJ2-3
TGTGCCATCAGTGATCGACGGCTTCGAGATCCCGCACCCCTCCACTTT	CAISDRRLRDPAPLHF	TRBV10-3	TRBJ1-6
TGTGCCAGCAGCCAAGCGGATCCCCGGGACAGTTCCGGCCCGCCTAATGAAAAACTGTTTTTT	CASSQADPRDSSGPPNEKLFF	TRBV3-1	TRBJ1-4
TGTGCCAGCAGCTTGGCGGCCCCCTACGAGCAGTACTTC	CASSLAAPYEQYF	TRBV5-4	TRBJ2-7
TGTGCCACCGGTGACGGTCGGGGGGCATCGGCGTACGAGCAGTACTTC	CATGDGRGASAYEQYF	TRBV15	TRBJ2-7
TGCAGTGCTAGCCCGGGACAGGGAGGGGATGAGCAGTTCTTC	CSASPGQGGDEQFF	TRBV20-1	TRBJ2-1
TGCAGTGCTAGCAGGGAATGGGGGGTTCAGCCCCAGCATTTT	CSASREWGVQPQHF	TRBV20-1	TRBJ1-5
TGCAGTGAGGACAGGGATGGCTACACCTTC	CSEDRDGYTF	TRBV20-1	TRBJ1-2
TGTGCCAGCATCACAGTTAACACTGAAGCTTTCTTT	CASITVNTEAFF	TRBV2	TRBJ1-1
TGTGCCAGCAGTAGGGCGGGGCAGCCCCAGCATTTT	CASSRAGQPQHF	TRBV27	TRBJ1-5
TGTGCCAGCAGAATCCCAAGAGGACTAGCGGGAGCCACAGATACGCAGTATTTT	CASRIPRGLAGATDTQYF	TRBV11-3	TRBJ2-3
TGTGCCAGCAGCAATTCCGTAATCCCAGGGGGCTATCAGCCCCAGCATTTT	CASSNSVIPGGYQPQHF	TRBV28	TRBJ1-5
TGTGCCAGCAGTTACCCTTGTAAAGGGACAGGGATCAGGCAGCCCCAGCATTTT	CASSYPCKGTGIRQPQHF	TRBV6-5	TRBJ1-5
TGTGCCAGCAGCGGGGGCGCATCTAGCACAGATACGCAGTATTTT	CASSGGASSTDTQYF	TRBV13	TRBJ2-3
TGTGCCAGCAGCTCCCCCAGGGGTAGGGACAATCAGCCCCAGCATTTT	CASSSPRGRDNQPQHF	TRBV13	TRBJ1-5
TGTGCCAGCATAATGAAGGGACCCCGACGGGTTCAGCCCCAGCATTTT	CASIMKGPRRVQPQHF	TRBV6-5	TRBJ1-5
TGTGCCAGCGGGCGCGACAGAGAGTACGAGCAGTACTTC	CASGRDREYEQYF	TRBV27	TRBJ2-7
TGTGCCAGCAGTTGGGGGCGGTCCAGGCCCGAGCAGTACTTC	CASSWGRSRPEQYF	TRBV6-5	TRBJ2-7
TGTGCCAGCAGTTTAGGGGGGACAGGGGATGAGCAGTTCTTC	CASSLGGTGDEQFF	TRBV12-3	TRBJ2-1
TGTGCCAGCAGTTCCCCCCCTACTAAAGAAACAGGGACATTTCCGCAGCCCCAGCATTTT	CASSSPPTKETGTFPQPQHF	TRBV6-5	TRBJ1-5
TGTGCCAGCAGGGGGAGTCCCCAAGAGACCCAGTACTTC	CASRGSPQETQYF	TRBV6-5	TRBJ2-5
TGTGCCAGCAGTTACGGGCAATCATCCGGGACATACGAGCAGTACTTC	CASSYGQSSGTYEQYF	TRBV6-3	TRBJ2-7
TGTGCCAGCAGTGACGGACTATGGGGCCCACCTGAAGCTTTCTTT	CASSDGLWGPPEAFF	TRBV6-4	TRBJ1-1
TGTGCCAGCAGCCCCCACAGGTGGTGGGCTAGCAATCAGCCCCAGCATTTT	CASSPHRWWASNQPQHF	TRBV6-4	TRBJ1-5
TGTGCCACCAGCCCTCGAGGTGGGAGGAGCGCCCCAGATACGCAGTATTTT	CATSPRGGRSAPDTQYF	TRBV15	TRBJ2-3
TGCAGTGCTAGAGATGTCGGGGTTTACTCTGGAAACACCATATATTTT	CSARDVGVYSGNTIYF	TRBV20-1	TRBJ1-3
TGCAGTGCCACACCCAGGGTTGACTCGGGGGCCCATGAAGCTTTCTTT	CSATPRVDSGAHEAFF	TRBV20-1	TRBJ1-1
TGTGCCAGCAGTTGGCAGGGAGGCGAGCAGTACTTC	CASSWQGGEQYF	TRBV6-2	TRBJ2-7
TGTGCCAGCAGCGACAGGGACTCGGACACTGAAGCTTTCTTT	CASSDRDSDTEAFF	TRBV7-3	TRBJ1-1
TGTGCCAGCACCCGAGGGGGTAATACGCAGTATTTT	CASTRGGNTQYF	TRBV27	TRBJ2-3
TGTGCCAGCACGGAGGGCGTTCGCTACGAGCAGTACTTC	CASTEGVRYEQYF	TRBV6-4	TRBJ2-7
TGTGCCAGCTCACCTCGCCCGGACAGGGGGCGAAGTACTGAAGCTTTCTTT	CASSPRPDRGRSTEAFF	TRBV18	TRBJ1-1
TGTGCCAGCAGTTACTCAGGACCGGGACTAGAGTCCTGCGGGGAGCTGTTTTTT	CASSYSGPGLESCGELFF	TRBV6-5	TRBJ2-2
TGTGCCAGCTGGTGGGGAGGGTACTTC	CASWWGGYF	TRBV18	TRBJ2-7
TGTGCCAGCAGCTGGGGCGGCCAAGAGACCCAGTACTTC	CASSWGGQETQYF	TRBV7-9	TRBJ2-5
TGTGCCAGCAGGGTCCTGAGGGGCGGGGAGCTGTTTTTT	CASRVLRGGELFF	TRBV28	TRBJ2-2
TGTGCCAGCAGGACGCGCACCGGGGAGCTGTTTTTT	CASRTRTGELFF	TRBV9	TRBJ2-2
TGTGCCAGCAGCTTGGACGGGGGTCGGAGAGCTGGGGCCAACGTCCTGACTTTC	CASSLDGGRRAGANVLTF	TRBV5-5	TRBJ2-6
TGTGCCAGTAGACCTCTAGCGGGACTCGAGCAGTACTTC	CASRPLAGLEQYF	TRBV19	TRBJ2-7
TGTGCCAGCAGTTTCCTCGAGGGGGGGCGTTCCTTGGAAGAGACCCAGTACTTC	CASSFLEGGRSLEETQYF	TRBV12-4	TRBJ2-5
TGTGGACAGTGGACAGGGGTATTATTGGAGGAAAAACTGTTTTTT	CGQWTGVLLEEKLFF	TRBV5-4	TRBJ1-4
TGTGCCAGCAGCTTCTCGACAGGGAGAAGGGGTGGCTACACCTTC	CASSFSTGRRGGYTF	TRBV7-6	TRBJ1-2
TGTGCCAGCAGTTTAACAGGGGGCTGGTATAGCAATCAGCCCCAGCATTTT	CASSLTGGWYSNQPQHF	TRBV28	TRBJ1-5
TGTGCCAGCCCCAGGACAGGGCGTTTGGATCTTGAGAACACTGAAGCTTTCTTT	CASPRTGRLDLENTEAFF	TRBV28	TRBJ1-1
TGTGCCAGCAGCGACAGGGGTGATTCACCCCTCCACTTT	CASSDRGDSPLHF	TRBV13	TRBJ1-6
TGTGCCAGCAGCGTTCATCTGGCCTCGGTCACCACAGATACGCAGTATTTT	CASSVHLASVTTDTQYF	TRBV5-4	TRBJ2-3
TGCAGTGGCCCGCGGGAGCAGACCTACAATGAGCAGTTCTTC	CSGPREQTYNEQFF	TRBV20-1	TRBJ2-1
TGTGCCACACGACCGACAGCACCCTATGGCTACACCTTC	CATRPTAPYGYTF	TRBV24-1	TRBJ1-2
TGTGCCTGGAGTGTACCTCGAGGTTGCAACTCTGGGGCCAACGTCCTGACTTTC	CAWSVPRGCNSGANVLTF	TRBV30	TRBJ2-6
TGTGCCAGCAGTTTTTCCCAGGGTTATGGCTACACCTTC	CASSFSQGYGYTF	TRBV27	TRBJ1-2
TGCAGTGCCGGAGAGCAGTACTTC	CSAGEQYF	TRBV20-1	TRBJ2-7
TGTGCCAGCAGTGAAAAAAGGGGAAGACAGCCCCAGCATTTT	CASSEKRGRQPQHF	TRBV6-4	TRBJ1-5
TGTGCCAGCAGGGAGGGAAGATTGGGCTCTGGGGCCAACGTCCTGACTTTC	CASREGRLGSGANVLTF	TRBV6-5	TRBJ2-6
TGTGCCAGCAGTTGGTCGACAGGGGGGGTGCAGCCCCAGCATTTT	CASSWSTGGVQPQHF	TRBV28	TRBJ1-5
TGCGCCAGCAGCATCAGGACCCCGACAGGTCACGGGGCCTACGAGCAGTACTTC	CASSIRTPTGHGAYEQYF	TRBV5-1	TRBJ2-7
TGTGCCAGCAGTTACTCGATACCGACAGCGGTCGGCTACACCTTC	CASSYSIPTAVGYTF	TRBV6-5	TRBJ1-2
TGTGCCACCAGTGCCGAGGGCGGGGGGGCTGTAACCGGGGAGCTGTTTTTT	CATSAEGGGAVTGELFF	TRBV24-1	TRBJ2-2
TGTGCCAGCATAGCGGGACAGGAGACCCAGTACTTC	CASIAGQETQYF	TRBV7-3	TRBJ2-5
TGTGCCAGCAGTTTCCAGCGGGAGCGCGAGCAGTACTTC	CASSFQREREQYF	TRBV12-3	TRBJ2-7
TGCGCCAGCAGTGAAAGCTGCGAGGGGGCCCGGGTGGCTAGCACAGATACGCAGTATTTT	CASSESCEGARVASTDTQYF	TRBV10-1	TRBJ2-3
TGTGCCAGCAGCTTACCCGTTGACAGGAGGGGATATAGCAATCAGCCCCAGCATTTT	CASSLPVDRRGYSNQPQHF	TRBV11-3	TRBJ1-5
TGTGCCAGCAGCCAAGATTCAGAGATTGCTTTCTTT	CASSQDSEIAFF	TRBV14	TRBJ1-1
TGCGCCAGTGTAGGATTCCAGCCCCAGCATTTT	CASVGFQPQHF	TRBV10-1	TRBJ1-5
TGTGCCAGCAGCTTACGTATACACCGCTACGAGCAGTACTTC	CASSLRIHRYEQYF	TRBV7-2	TRBJ2-7
TGTGCCAGCAGAAGGACTAGCGGGGTTCCCCAAGAGACCCAGTACTTC	CASRRTSGVPQETQYF	TRBV28	TRBJ2-5
TGCGCCAGCAGCAAGACAGGGGTGGGGGCTAACTATGGCTACACCTTC	CASSKTGVGANYGYTF	TRBV5-1	TRBJ1-2
TGTGCCAGCAGCTTAGTCCGGGGGTACCCCGGCTACGAGCAGTACTTC	CASSLVRGYPGYEQYF	TRBV7-2	TRBJ2-7
TGTGCCAGCAGGATATACTTCCAGGGACGGTCCCGCTACGAGCAGTACTTC	CASRIYFQGRSRYEQYF	TRBV7-4	TRBJ2-7
TGTGCCAGCAGCTTCATTTGTTTGGTACGGTCCGATATGGAGCAGTTCTTC	CASSFICLVRSDMEQFF	TRBV7-4	TRBJ2-1
TGCGCCAGCAGCTCTTACCCGAGGAGGCTGTCGGCGGGTACAGATACGCAGTATTTT	CASSSYPRRLSAGTDTQYF	TRBV5-1	TRBJ2-3
TGCGCCAGCAGCATCGGACTGCCAGCCGGGGAGCTGTTTTTT	CASSIGLPAGELFF	TRBV5-1	TRBJ2-2
TGTGCCAGCAGCCACAGGGGCGAGAACTATGGCTACACCTTC	CASSHRGENYGYTF	TRBV14	TRBJ1-2
TGTGCCAGCAGCGCCCCGGCAACGGGCACAGATACGCAGTATTTT	CASSAPATGTDTQYF	TRBV7-9	TRBJ2-3
TGTGCCAGCAGTTTAGGCCACGGGGGGGCGACATGCACAGATACGCAGTATTTT	CASSLGHGGATCTDTQYF	TRBV27	TRBJ2-3
TGTGCCAGCAGTGACCCGGAGGGCGGCCTGGCGCAAGAGACCCAGTACTTC	CASSDPEGGLAQETQYF	TRBV6-4	TRBJ2-5
TGTGCCAGCAGTCTCTCCTGGAGTCCCTATTCACCCCTCCACTTT	CASSLSWSPYSPLHF	TRBV11-3	TRBJ1-6
TGTGCCAGTAGTATATTAAAAGACAGTCCCTACGAGCAGTACTTC	CASSILKDSPYEQYF	TRBV19	TRBJ2-7
TGTGCCAGCAGTTACACCTTTCCCGCGGGAGGACGGCGGGAGCAGTTCTTC	CASSYTFPAGGRREQFF	TRBV6-2	TRBJ2-1
TGTGCCAGCTCACCACAACGGAGACGGGAAAGGCAGCCCCAGCATTTT	CASSPQRRRERQPQHF	TRBV18	TRBJ1-5
TGTGCCAGCAGTGAATACCAAGAGATTTGGCTGGGGGGGGGAACTGAGCAGTTCTTC	CASSEYQEIWLGGGTEQFF	TRBV25-1	TRBJ2-1
TGCGCCAGCAGTGAGCACGAACGGACAGGGAACTATGGCTACACCTTC	CASSEHERTGNYGYTF	TRBV10-2	TRBJ1-2
TGTGCCAGTAGTATCAGGCTGGGGGCGGGGTACAATGAGCAGTTCTTC	CASSIRLGAGYNEQFF	TRBV19	TRBJ2-1
TGTGCCAGCAGAGGAGGGCCTTGGGCCCATGGCTACACCTTC	CASRGGPWAHGYTF	TRBV7-7	TRBJ1-2
TGTGCCAGCGGACCCGGAACCTGCCGGGACGGGCAGCCCCAGCATTTT	CASGPGTCRDGQPQHF	TRBV6-5	TRBJ1-5
TGCGCCAGCAGCCTCAAGAGTAAAACAGATACGCAGTATTTT	CASSLKSKTDTQYF	TRBV4-1	TRBJ2-3
TGCAGCGTTCGGGGGAACGATACGCAGTATTTT	CSVRGNDTQYF	TRBV29-1	TRBJ2-3
TGTGCCAGTAAGACAGGGTGTACCTACGAGCAGTACTTC	CASKTGCTYEQYF	TRBV19	TRBJ2-7
TGTGCCAGCAGTGCCAGCTCCCGCCCCAGGGGGACAGAACAGCCCCAGCATTTT	CASSASSRPRGTEQPQHF	TRBV6-2	TRBJ1-5
TGTGCCAGCAGCGGGGGTAATCAGCCCCAGCATTTT	CASSGGNQPQHF	TRBV7-3	TRBJ1-5
TGTGCCAGCAGAGGACAGACTGTTGCCAAAAACATTCAGTACTTC	CASRGQTVAKNIQYF	TRBV6-5	TRBJ2-4
TGTGCCAGCAGTCATTTGAGGGGGGGGTGGTCAGATACGCAGTATTTT	CASSHLRGGWSDTQYF	TRBV6-3	TRBJ2-3
TGTGCCAGCCAGGCCTACGAGCAGTACTTC	CASQAYEQYF	TRBV18	TRBJ2-7
TGTGCCAGCAGTTATGGACAGGGACTCGAGCAGTACTTC	CASSYGQGLEQYF	TRBV6-6	TRBJ2-7
TGCGCCAGCAGCCTTCCGGGGGGCACACTTCAGCCCCAGCATTTT	CASSLPGGTLQPQHF	TRBV10-1	TRBJ1-5
TGCAGTGCAAACGCGCCCGGGATCTCTGGGGCCAACGTCCTGACTTTC	CSANAPGISGANVLTF	TRBV20-1	TRBJ2-6
TGTGCCAGCAGCGTCCGGGGGTTCGAGCAGTACTTC	CASSVRGFEQYF	TRBV7-9	TRBJ2-7
TGTGCCAGCAGCAGAGCAGGGCGGTCTGAGTCCGGGGAGCTGTTTTTT	CASSRAGRSESGELFF	TRBV13	TRBJ2-2
TGCGCCAGCAGTACTCAGGGGAGCAATCAGCCCCAGCATTTT	CASSTQGSNQPQHF	TRBV10-1	TRBJ1-5
TGCGCCAGCAGCTTGGCGGACAGGGGGGAGACCCAGTACTTC	CASSLADRGETQYF	TRBV5-1	TRBJ2-5
TGTGCCACCAGTGATTGTCTGGGGGGGGCAGATACGCAGTATTTT	CATSDCLGGADTQYF	TRBV24-1	TRBJ2-3
TGTGCCAGCAGCCTACCCCCTGGCGACAGGGAACAAGAGACCCAGTACTTC	CASSLPPGDREQETQYF	TRBV7-2	TRBJ2-5
TGTGCCACCAGTGATTCTAGGGGGCAGGGGCGGGGCGGCTATGGCTACACCTTC	CATSDSRGQGRGGYGYTF	TRBV24-1	TRBJ1-2
TGTGCCAGCAGCTACCTAGCAGCGGGAACCGGGGCTTTCTTT	CASSYLAAGTGAFF	TRBV14	TRBJ1-1
TGTGCCAGCAGTTTAGAGAGGATCGGCGACGCCCTTGAAAAACTGTTTTTT	CASSLERIGDALEKLFF	TRBV27	TRBJ1-4
TGTGCCAGCACCCTTAACCGGGGTGGTTGCACAGATACGCAGTATTTT	CASTLNRGGCTDTQYF	TRBV14	TRBJ2-3
TGTGCCAGCAGTGGGCACCCTGGACAGGGCCATGAGGAGACCCAGTACTTC	CASSGHPGQGHEETQYF	TRBV6-1	TRBJ2-5
TGTGCCAGCAGCTTGGCCTCCCGGGACCTAAGCTCCTACGAGCAGTACTTC	CASSLASRDLSSYEQYF	TRBV5-6	TRBJ2-7
TGTGCTAGTGGTAGTAAACCCTTCAGCAATCAGCCCCAGCATTTT	CASGSKPFSNQPQHF	TRBV12-5	TRBJ1-5
TGTGCCAGCAGCGGGACACAGCAGCCCCAGCATTTT	CASSGTQQPQHF	TRBV7-3	TRBJ1-5
TGTGCCAGCAGGGGACAGGGAACTGGGGTCAACCAAGAGACCCAGTACTTC	CASRGQGTGVNQETQYF	TRBV6-5	TRBJ2-5
TGCAGCGACCAGTGGGGGCCCTACAATGAGCAGTTCTTC	CSDQWGPYNEQFF	TRBV29-1	TRBJ2-1
TGTGCCAGCAGCACTTTGAGACTGAATACCAAAAACATTCAGTACTTC	CASSTLRLNTKNIQYF	TRBV7-9	TRBJ2-4
TGTGCCAGCAGCCAAGAGTGGAGCTGGGAGCAGTTCTTC	CASSQEWSWEQFF	TRBV14	TRBJ2-1
TGTGCCAGCCTTCACCGGGACCTGACAGGAGCCAAAAACATTCAGTACTTC	CASLHRDLTGAKNIQYF	TRBV6-4	TRBJ2-4
TGCGCCAGCAGCTGGCTGCAGGGGGGGACCGGTGTGAGAGAGACCCAGTACTTC	CASSWLQGGTGVRETQYF	TRBV5-1	TRBJ2-5
TGTGCCAGGGGGCATCCGAACACCGGGGAGCTGTTTTTT	CARGHPNTGELFF	TRBV10-3	TRBJ2-2
TGTGCCAGCAGTTTATATAGATGGGGGGGAACCCAAGAGACCCAGTACTTC	CASSLYRWGGTQETQYF	TRBV27	TRBJ2-5
TGTGCCAGCAGCTTGTCACCTCCCGGGACAGGGGCTAGACATAGCAATCAGCCCCAGCATTTT	CASSLSPPGTGARHSNQPQHF	TRBV11-2	TRBJ1-5
TGTGCCTGGAGTGTACGAACGACAGGGCACACTGAAGCTTTCTTT	CAWSVRTTGHTEAFF	TRBV30	TRBJ1-1
TGTGCCAGCAGCGGGGGGGCCGCCTACGAGCAGTACTTC	CASSGGAAYEQYF	TRBV6-4	TRBJ2-7
TGTGCCAGCAACGCAGGGGGGGCTTCCTACGAGCAGTACTTC	CASNAGGASYEQYF	TRBV7-9	TRBJ2-7
TGCGCCAGCAGTGAGTCCATAAAAGCGCCGGGACAGGGAACTAATGAAAAACTGTTTTTT	CASSESIKAPGQGTNEKLFF	TRBV10-1	TRBJ1-4
TGTGCTAGTGGTTCGATTGGACAGGGTAACTATGGCTACACCTTC	CASGSIGQGNYGYTF	TRBV12-5	TRBJ1-2
TGTGCCAGCAGTTACCCTAGCGGGGCGGTCTACGAGCAGTACTTC	CASSYPSGAVYEQYF	TRBV6-5	TRBJ2-7
TGCGCCAGCAGGGGGGGATCCGTCCGCACAGATACGCAGTATTTT	CASRGGSVRTDTQYF	TRBV5-1	TRBJ2-3
TGCGCCAGCAGCTTGGTAATCCAGCGGGACTCCTACGAGCAGTACTTC	CASSLVIQRDSYEQYF	TRBV5-1	TRBJ2-7
TGTGCCAGCACCCGGGGGGGGGGCCCGGGGCATGAGCAGTTCTTC	CASTRGGGPGHEQFF	TRBV6-4	TRBJ2-1
TGTGCCAGCGGCTACACCGAAAACAGTGGGAGGGACACTGAAGCTTTCTTT	CASGYTENSGRDTEAFF	TRBV12-3	TRBJ1-1
TGTGCCAGCAGGGGGGGAGTGAACTATGGCTACACCTTC	CASRGGVNYGYTF	TRBV9	TRBJ1-2
TGTGCCAGCAGCTGTCTGGATGACCAAGAGACCCAGTACTTC	CASSCLDDQETQYF	TRBV11-1	TRBJ2-5
TGTGCCAGCAGCTTAGATACAGGACAGGGGTATGGCTACACCTTC	CASSLDTGQGYGYTF	TRBV11-3	TRBJ1-2
TGCGCCAGCAGCGGGGATCAGACCGATCAGCCCCAGCATTTT	CASSGDQTDQPQHF	TRBV5-1	TRBJ1-5
TGTGCCAGGGGAGGTAACAGGTCCTATAATTCACCCCTCCACTTT	CARGGNRSYNSPLHF	TRBV13	TRBJ1-6
TGTTTGGCCGGGACAGGGGCTTCAAAGAACGAGCAGTACTTC	CLAGTGASKNEQYF	TRBV6-5	TRBJ2-7
TGTGCCACCAGCAAAAAAGCGGGGACGAGGTTATCATACGAGCAGTACTTC	CATSKKAGTRLSYEQYF	TRBV15	TRBJ2-7
TGCAGTGCTAGAGATAAAACTAGAAACTCCTACAATGAGCAGTTCTTC	CSARDKTRNSYNEQFF	TRBV20-1	TRBJ2-1
TGTGCCCCCGTGAGAGGAGGGCAGTACTTC	CAPVRGGQYF	TRBV19	TRBJ2-7
TGTGCCAGCAGCTGTAGGACAGGGGTAAAGAGGGGTAATGAAAAACTGTTTTTT	CASSCRTGVKRGNEKLFF	TRBV13	TRBJ1-4
TGTGCCAGTAGCCCGACAGCTAATGACGATAGCAATCAGCCCCAGCATTTT	CASSPTANDDSNQPQHF	TRBV19	TRBJ1-5
TGTGCCGATGGCGTTTTCACAGATACGCAGTATTTT	CADGVFTDTQYF	TRBV5-6	TRBJ2-3
TGTGCCAGCAGCCAAGTGGCCAGCAGGAGTACAGATACGCAGTATTTT	CASSQVASRSTDTQYF	TRBV3-1	TRBJ2-3
TGCAGTGCACACCCCCCGAAGGACAGAATCTGCAATCAGCCCCAGCATTTT	CSAHPPKDRICNQPQHF	TRBV20-1	TRBJ1-5
TGTGCCAGCGGACAGGGGGCACGAGGGGGTTCCGAGCAGTACTTC	CASGQGARGGSEQYF	TRBV11-1	TRBJ2-7
TGTGCCAGCCCGTCCGATAACACTGAAGCTTTCTTT	CASPSDNTEAFF	TRBV6-6	TRBJ1-1
TGTGCCAGCAGTGATACGGGACAGGGGAGGAACACCGGGGAGCTGTTTTTT	CASSDTGQGRNTGELFF	TRBV6-4	TRBJ2-2
TGCGCCAGCGCCCTGACACCGCGTGAGCAGTTCTTC	CASALTPREQFF	TRBV4-1	TRBJ2-1
TGTGCCAGCAAAGGGTTTAGGGGAATCTTC	CASKGFRGIF	TRBV28	TRBJ2-1
TGTGCCAGTAGTATAGTACAGGGTAAGTATGAGCAGTTCTTC	CASSIVQGKYEQFF	TRBV19	TRBJ2-1
TGTGCCACCCCACTCTTTGGTAGTGAAGCTTTCTTT	CATPLFGSEAFF	TRBV10-3	TRBJ1-1
TGCAGCGTTGAGGGACAGATGGGTGAAAAACTGTTTTTT	CSVEGQMGEKLFF	TRBV29-1	TRBJ1-4
TGTGCCAGCAGTTCCCTAAGACCCCGGACCCTGTACTTC	CASSSLRPRTLYF	TRBV6-5	TRBJ2-5
TGCAGACGACAGCCGGGGAGGACCGGGGAGCTGTTTTTT	CRRQPGRTGELFF	TRBV20-1	TRBJ2-2
TGTGCCACCAGCAGAGATCACCCCCCCTCCCATAGCAATCAGCCCCAGCATTTT	CATSRDHPPSHSNQPQHF	TRBV15	TRBJ1-5
TGTGCCATCAGACACCGGGACAGGTCCATCGGCAATCAGCCCCAGCATTTT	CAIRHRDRSIGNQPQHF	TRBV10-3	TRBJ1-5
TGTGCCAGCAGCAAGCGGGAGCCGAGGGCCAATCAGCCCCAGCATTTT	CASSKREPRANQPQHF	TRBV13	TRBJ1-5
TGTGCCAGCAGCTTATCCCAACCAAGGAACGATAACAGGGGCCCTGCAACTAATGAAAAACTGTTTTTT	CASSLSQPRNDNRGPATNEKLFF	TRBV7-9	TRBJ1-4
TGTGCCACACAGGGCCAGCCGGCAGATACGCAGTATTTT	CATQGQPADTQYF	TRBV24-1	TRBJ2-3
TGTGCCAGCAGCCATCGAGGTAAGTCCTACAATGAGCAGTTCTTC	CASSHRGKSYNEQFF	TRBV4-2	TRBJ2-1
TGCGCCAGCATATGGACAGGGGGCGCAGCTTTCTTT	CASIWTGGAAFF	TRBV5-1	TRBJ1-1
TGCTACTTTGGAAGCGCCACCCCGAGAGCTCAGGGCGGACAGAACACTGAAGCTTTCTTT	CYFGSATPRAQGGQNTEAFF	TRBV20-1	TRBJ1-1
TGTGCCAGCAGCCAAGCAGTAAAGCGGCCCCAGCATTTT	CASSQAVKRPQHF	TRBV3-1	TRBJ1-5
TGCAGTGCTCAGGTAGTTAATGAAAAACTGTTTTTT	CSAQVVNEKLFF	TRBV20-1	TRBJ1-4
TGTGCCAGTAGTAACGAGATGACATGCAATCAGCCCCAGCATTTT	CASSNEMTCNQPQHF	TRBV19	TRBJ1-5
TGTGCCACCAGTGATGGAACTAGAACCTCCTACGAGCAGTACTTC	CATSDGTRTSYEQYF	TRBV24-1	TRBJ2-7
TGCAGTGCTATGTATCGACCTAATCAGCCCCAGCATTTT	CSAMYRPNQPQHF	TRBV20-1	TRBJ1-5
TGTGCCAGCAGTTTGCGGGCCAATGAGCAGTTCTTC	CASSLRANEQFF	TRBV27	TRBJ2-1
TGTGCCAGCAGCTTACGGACCGTACATAGCTCCTACAATGAGCAGTTCTTC	CASSLRTVHSSYNEQFF	TRBV7-8	TRBJ2-1
TGCATTGTCTGGGACTATCACACCGGGGAGCTGTTTTTT	CIVWDYHTGELFF	TRBV20-1	TRBJ2-2
TGCGCCAGCAGTGAGGACGACAGGGTCTCTCTTGGCTACACCTTC	CASSEDDRVSLGYTF	TRBV10-1	TRBJ1-2
TGCAGTGCTAGCAGACTAGCGGCTTTCATCGAGACCCAGTACTTC	CSASRLAAFIETQYF	TRBV20-1	TRBJ2-5
TGTGCCACCGGGAGGTTCTCGAGCACAGATACGCAGTATTTT	CATGRFSSTDTQYF	TRBV24-1	TRBJ2-3
TGTGCCAGCAGCGACAAGTTGGACAGGGTTGGCGATGGCTACACCTTC	CASSDKLDRVGDGYTF	TRBV11-2	TRBJ1-2
TGTGCCACCAGTGGCGACAGGATCGGAGGGCCTGAAAAACTGTTTTTT	CATSGDRIGGPEKLFF	TRBV24-1	TRBJ1-4
TGTGCCAGCATACCCATCAGCTACAACACTGAAGCTTTCTTT	CASIPISYNTEAFF	TRBV7-4	TRBJ1-1
TGCGCCAGCATGAGACAGTGGGCGGCCGGGGAGCTGTTTTTT	CASMRQWAAGELFF	TRBV10-1	TRBJ2-2
TGTGCCACCAGTGATGCGGGGGTTATTGAAGCTTTCTTT	CATSDAGVIEAFF	TRBV24-1	TRBJ1-1
TGTGCCTGGAGAGCGCCAGGGTACGAGCAGTACTTC	CAWRAPGYEQYF	TRBV30	TRBJ2-7
TGTGCCAGCAGCCAAGACGGGGACGGCAATCAGCCCCAGCATTTT	CASSQDGDGNQPQHF	TRBV3-1	TRBJ1-5
TGTGCCATCCGGGGACAGGGTTCCAACGAGCAGTACTTC	CAIRGQGSNEQYF	TRBV6-3	TRBJ2-7
TGCGCCAGCAGCTCGATTTCACTTCAGGGTGGCTACACCTTC	CASSSISLQGGYTF	TRBV5-1	TRBJ1-2
TGTGCCAGCAGTTCGGGACTGAGCATTTGGTGTGGCTACACCTTC	CASSSGLSIWCGYTF	TRBV9	TRBJ1-2
TGTGCCAGCAGTTGGTGGGGTATTCAGCCCCAGCATTTT	CASSWWGIQPQHF	TRBV28	TRBJ1-5
TGTGCCAGCAGCCCCCGGACAAAGGGACAGGGGCCTACGGGGCACAATCAGCCCCAGCATTTT	CASSPRTKGQGPTGHNQPQHF	TRBV28	TRBJ1-5
TGTGCCAGCATTAGACAGGTCCTAGAGCAGTACTTC	CASIRQVLEQYF	TRBV9	TRBJ2-7
TGCGCCAGCAGCCGAACACTTCACAGGGTCGCGAACACCGGGGAGCTGTTTTTT	CASSRTLHRVANTGELFF	TRBV4-3	TRBJ2-2
TGTGCCACCAGTGAGGCTAACTCTGGGGCCAACGTCCTGACTTTC	CATSEANSGANVLTF	TRBV24-1	TRBJ2-6
TGTGCCAGCAGTTTGGGCTGGAACACTGAAGCTTTCTTT	CASSLGWNTEAFF	TRBV12-3	TRBJ1-1
TGTGCCAGCAATGGTGACACAGGGAGCTCCTACGAGCAGTACTTC	CASNGDTGSSYEQYF	TRBV3-1	TRBJ2-7
TGTGAGGGGGTCGGGACGCTTAAGGGCTACACCTTC	CEGVGTLKGYTF	TRBV4-2	TRBJ1-2
TGTGCCAGCAGCTTACTGCTAGCGGGGGGGCCGGAAAACTACGAGCAGTACTTC	CASSLLLAGGPENYEQYF	TRBV7-9	TRBJ2-7
TGTGCCAGCGGGGGGCGGACAATAAATGAGCAGTTCTTC	CASGGRTINEQFF	TRBV18	TRBJ2-1
TGTGCCATGACACAGATATACACTGAAGCTTTCTTT	CAMTQIYTEAFF	TRBV10-3	TRBJ1-1
TGTGCCAGCAGCCAAGGAGGGACTAGCGAGAAACGGCAGTTCTTC	CASSQGGTSEKRQFF	TRBV14	TRBJ2-1
TGTGCCAGCAGGACGTGGAGTCAGCCCCAGCATTTT	CASRTWSQPQHF	TRBV6-5	TRBJ1-5
TGCGCCAGCAGCGGTCTACTAGCGCGAGATACGCAGTATTTT	CASSGLLARDTQYF	TRBV5-1	TRBJ2-3
TGTGCCAGCAGTGGGTCTAGCGGGAGGAGCTCCTACAATGAGCAGTTCTTC	CASSGSSGRSSYNEQFF	TRBV2	TRBJ2-1
TGCAGTGCTCACAGCAGTAATCAGCCCCAGCATTTT	CSAHSSNQPQHF	TRBV20-1	TRBJ1-5
TGTGCCAGCAGCAGTAATGGGACAGGGATGCCCTATGGCTACACCTTC	CASSSNGTGMPYGYTF	TRBV5-6	TRBJ1-2
TGTGCCAGCAGCTTCCACATTGGGTTACAGACCCAGTACTTC	CASSFHIGLQTQYF	TRBV7-9	TRBJ2-5
TGTGCCAGCCGGGGGGAGGGCCGCTATGGCTACACCTTC	CASRGEGRYGYTF	TRBV6-5	TRBJ1-2
TGTGCCAGCAGTGCAACCGTCGGGACAGGGCACCGGGAGTATGAAAAACTGTTTTTT	CASSATVGTGHREYEKLFF	TRBV27	TRBJ1-4
TGTGCCTGGCCAGACAGGCGTACTAATGAAAAACTGTTTTTT	CAWPDRRTNEKLFF	TRBV30	TRBJ1-4
TGTGCCAGCATGCAGCGGGATTGTTACAATGAGCAGTTCTTC	CASMQRDCYNEQFF	TRBV7-8	TRBJ2-1
TGTGCCAGCAGTGCGGCTGATTCGGATAGCAATCAGCCCCAGCATTTT	CASSAADSDSNQPQHF	TRBV6-5	TRBJ1-5
TGTGCCAGCAGCCGGGGGGTATCTTTCTCGGGGGCCTACAATGAGCAGTTCTTC	CASSRGVSFSGAYNEQFF	TRBV7-9	TRBJ2-1
TGTGCCAAGGTGACGGATCGGGACAGGGGGCGCAATCAGCCCCAGCATTTT	CAKVTDRDRGRNQPQHF	TRBV18	TRBJ1-5
TGCGCCAGCAGTCCCAAGGGACAGGGGGGAGCCGGCTACACCTTC	CASSPKGQGGAGYTF	TRBV5-1	TRBJ1-2
TGCAAACGGGTCGGGGTGATAGGGGCGCAGCCCCAGCATTTT	CKRVGVIGAQPQHF	TRBV20-1	TRBJ1-5
TGCGCCAGCACGGAGGAGGGAGCCTCCGACACCGGGGAGCTGTTTTTT	CASTEEGASDTGELFF	TRBV4-3	TRBJ2-2
TGTGCCAGCAGCCAAGATCTGCTCCCATCAGGTACGCAGTATTTT	CASSQDLLPSGTQYF	TRBV3-1	TRBJ2-3
TGTGCCTGGAGTCCCACTAGCGGGGGGGGGACTAGCTACGAGCAGTACTTC	CAWSPTSGGGTSYEQYF	TRBV30	TRBJ2-7
TGCGCCAGCAGCTCTTCCAGGATACCGGGGTTATCCTACGAGCAGTACTTC	CASSSSRIPGLSYEQYF	TRBV5-1	TRBJ2-7
TGTGCCAGCAGTTTACTCGAGAACGAGCAGTACTTC	CASSLLENEQYF	TRBV27	TRBJ2-7
TGTGCCAGCAGTCATAGGGGAAACTTCCACTACGAGCAGTACTTC	CASSHRGNFHYEQYF	TRBV27	TRBJ2-7
TGTGCCAGCAGCCAAGATGTGGTGGGGGGCCGAGATACGCAGTATTTT	CASSQDVVGGRDTQYF	TRBV14	TRBJ2-3
TGTGCCAGCAGCGGGTCGGGACTAGCGGGTGAGCTATACAATGAGCAGTTCTTC	CASSGSGLAGELYNEQFF	TRBV7-9	TRBJ2-1
TGCAGCGTACCCGGACTCGGTACATATGGCTACACCTTC	CSVPGLGTYGYTF	TRBV29-1	TRBJ1-2
TGTGCCAGCAGCTTATATGCCACATCCTTCAGGGGCTACACCTTC	CASSLYATSFRGYTF	TRBV7-9	TRBJ1-2
TGTGCCAGCAGCGGCTGGGGGGACTCGCCTGAGCAGTACTTC	CASSGWGDSPEQYF	TRBV5-8	TRBJ2-7
TGTGCCAGCAGTTTTCCCAGACACCAGCAAACCCATGCTTATGCCAAAAACATTCAGTACTTC	CASSFPRHQQTHAYAKNIQYF	TRBV12-3	TRBJ2-4
TGTGCCAGCAGTTTATCTACCGGGACAGGGGATGAGCAGTTCTTC	CASSLSTGTGDEQFF	TRBV27	TRBJ2-1
TGTGCCAGCAGCCGTCTACGGGGGCCGGGCACAGATACGCAGTATTTT	CASSRLRGPGTDTQYF	TRBV6-5	TRBJ2-3
TGTGCCAGCTCGGGGGGAAACTACGAGCAGTACTTC	CASSGGNYEQYF	TRBV13	TRBJ2-7
TGCAGTGCTAGAGATTCCGGACAGGACCGAATTCGACTGAACACTGAAGCTTTCTTT	CSARDSGQDRIRLNTEAFF	TRBV20-1	TRBJ1-1
TGTGCCAGGGCGCCTGTTAAAAATAGCAATCAGCCCCAGCATTTT	CARAPVKNSNQPQHF	TRBV28	TRBJ1-5
TGTGCCATCAGTGAGTCAGGCCGGGGGCGCGAATATGAAGCTTTCTTT	CAISESGRGREYEAFF	TRBV10-3	TRBJ1-1
TGTGCCAGCAGTTACTGTCGTAGTTCTAGCACAGATACGCAGTATTTT	CASSYCRSSSTDTQYF	TRBV6-6	TRBJ2-3
TGCGCCAGCAGAGCTGTCAGGGGGGGTGGGGGCCGAAGTGGCTACACCTTC	CASRAVRGGGGRSGYTF	TRBV10-1	TRBJ1-2
TGTGCCAGCAAGGGGCCCCACAAAAGAAATCAGCCCCAGCATTTT	CASKGPHKRNQPQHF	TRBV6-4	TRBJ1-5
TGTGCCAGCACCGACGCCTGGGGGACTGAAGCTTTCTTT	CASTDAWGTEAFF	TRBV6-5	TRBJ1-1
TGCGCCAGCAGCTGCCATTTAGGACAAGAGACCCAGTACTTC	CASSCHLGQETQYF	TRBV5-1	TRBJ2-5
TGTGCCAGCAGTGAAACGGGGACATACGAGCAGTACTTC	CASSETGTYEQYF	TRBV6-1	TRBJ2-7
TGCAGTGCTAGAGACCGCCAGGGGAGGGAGGGCCCCTACACCGGGGAGCTGTTTTTT	CSARDRQGREGPYTGELFF	TRBV20-1	TRBJ2-2
TGTGCCACCAGTGATTTGACACAGGGAACTAATGAAAAACTGTTTTTT	CATSDLTQGTNEKLFF	TRBV24-1	TRBJ1-4
TGCGCCAGCAGTGAGCGGGCCCTTGGACCATTGCATTTT	CASSERALGPLHF	TRBV10-2	TRBJ1-5
TGTGCCAGTAGTATAGATACAGGGGTGGAGTATGAGCAGTTCTTC	CASSIDTGVEYEQFF	TRBV19	TRBJ2-1
TGTGCCATCAGTGAGCCTATAAGGGGATATGAGCAGTTCTTC	CAISEPIRGYEQFF	TRBV10-3	TRBJ2-1
TGTGCCACCAGTGGGAATGAGCAGTTCTTC	CATSGNEQFF	TRBV24-1	TRBJ2-1
TGTGCCAGCAGCGTCGGGGGGGCCCGGGGTCAAAATGAGCAGTTCTTC	CASSVGGARGQNEQFF	TRBV11-3	TRBJ2-1
TGCAGTGCTAGGGGGACTCGGGAGTATGGCTACACCTTC	CSARGTREYGYTF	TRBV20-1	TRBJ1-2
TGTGCCAGCCCAATGTACGTACGTAGGGATACGCAGTATTTT	CASPMYVRRDTQYF	TRBV11-2	TRBJ2-3
TGTGCCAGCACAGGGACAGGGGCAAGGAGAAGCGGCTCCTACAATGAGCAGTTCTTC	CASTGTGARRSGSYNEQFF	TRBV7-9	TRBJ2-1
TGTGCCAGTTCCGGGAGGCCAGAGCAGTTCTTC	CASSGRPEQFF	TRBV7-9	TRBJ2-1
TGTGCCAGCAGTTACAGGGGGGCGGAGGATACGCAGTATTTT	CASSYRGAEDTQYF	TRBV6-5	TRBJ2-3
TGTGCCAGTAGTCGAGGGACAGCCAAACGCCAGCCCCAGCATTTT	CASSRGTAKRQPQHF	TRBV19	TRBJ1-5
TGTGCCAGCAGGCCAGCTGAGGTAGGGACCTATGGCTACACCTTC	CASRPAEVGTYGYTF	TRBV7-8	TRBJ1-2
TGTGCCAGCCGGGGGGCCGATCTCAATGAGCAGTTCTTC	CASRGADLNEQFF	TRBV5-8	TRBJ2-1
TGTGCCAGCAGAGACCTTAGGGGGGGCTACCACGAGCAGTACTTC	CASRDLRGGYHEQYF	TRBV28	TRBJ2-7
TGTGCCAGCAGCGAGCAAGGGGGGAACACTGAAGCTTTCTTT	CASSEQGGNTEAFF	TRBV9	TRBJ1-1
TGTGCCAGCAGTTTCGGGACAGGGGGAGACTATGGCTACACCTTC	CASSFGTGGDYGYTF	TRBV27	TRBJ1-2
TGTGCCAGCAGCTTCCCGAGACCGGGCCGAGAGACCCAGTACTTC	CASSFPRPGRETQYF	TRBV11-2	TRBJ2-5
TGCAGTGCTCATCGGACGTTCTCAACTAATGAAAAACTGTTTTTT	CSAHRTFSTNEKLFF	TRBV20-1	TRBJ1-4
TGTGCCAGCACCGCGCGACAGCAGTTTGGAGATACGCAGTATTTT	CASTARQQFGDTQYF	TRBV12-3	TRBJ2-3
TGTGCCATTAAACACCCGGGACAGGGGGCAAACTACGAGCAGTACTTC	CAIKHPGQGANYEQYF	TRBV28	TRBJ2-7
TGTGCCAGCAGCCGAAGACTAGCGGGGGATCATAACAATGAGCAGTTCTTC	CASSRRLAGDHNNEQFF	TRBV7-9	TRBJ2-1
TGCAGTGCGAGGGGGGGGCATACGCAGTATTTT	CSARGGHTQYF	TRBV20-1	TRBJ2-3
TGTGCCAGCAGCGGTACTATCCTTCGGAACACTGAAGCTTTCTTT	CASSGTILRNTEAFF	TRBV9	TRBJ1-1
TGCGCCAGCAGCTTGTTTTCAGGGCACCCTTCACCCCTCCACTTT	CASSLFSGHPSPLHF	TRBV5-1	TRBJ1-6
TGTGCCAGCAGCCACCACCAGGGAGCAATCCAAGAGACCCAGTACTTC	CASSHHQGAIQETQYF	TRBV13	TRBJ2-5
TGTGCCAGCAGTGGCAGGGTGACCAGGACCAATGAGCAGTTCTTC	CASSGRVTRTNEQFF	TRBV27	TRBJ2-1
TGTGCCAGCAGCTTAGTCCCCCCCCAAGGGGCCGGGACGATGTCTGGGGCCAACGTCCTGACTTTC	CASSLVPPQGAGTMSGANVLTF	TRBV11-3	TRBJ2-6
TGTGCCAGCAGCCAGTCTAGCGGTGTACCAGACAATGAGCAGTTCTTC	CASSQSSGVPDNEQFF	TRBV13	TRBJ2-1
TGCAAAAGGCGGGGGGGGGCACAAAGAGACACAGATACGCAGTATTTT	CKRRGGAQRDTDTQYF	TRBV20-1	TRBJ2-3
TGTGCCACCAGCCTGCAGCAGGGTTCCTACGAGCAGTACTTC	CATSLQQGSYEQYF	TRBV15	TRBJ2-7
TGTGCCACCAGCAGACTCGGGACAGGGAATACTGAAGCTTTCTTT	CATSRLGTGNTEAFF	TRBV15	TRBJ1-1
TGTGCCAGCAGCCAAGTCGTGACTCGGGAACGGTGCACAGATACGCAGTATTTT	CASSQVVTRERCTDTQYF	TRBV3-1	TRBJ2-3
TGTGCCAGCAGCTTATTCCCGTCACTCCTCTGTCACGAGCAGTACTTC	CASSLFPSLLCHEQYF	TRBV7-3	TRBJ2-7
TGTGCCAGCAGCGTAGCTGACTGGAGCACAGATACGCAGTATTTT	CASSVADWSTDTQYF	TRBV9	TRBJ2-3
TGTGCCAGCAGCACCGGTATGAACACTGAAGCTTTCTTT	CASSTGMNTEAFF	TRBV7-4	TRBJ1-1
TGTGCCAGCAGTGACTCCGCCCGGACAGGGTCTGGAAACACCATATATTTT	CASSDSARTGSGNTIYF	TRBV6-4	TRBJ1-3
TGTGCCTGGAGTGTCGCCTTCAGGGGGACTGAAGCTTTCTTT	CAWSVAFRGTEAFF	TRBV30	TRBJ1-1
TGTGCCAGCAGTTGCCGGACCGGGGAGAATGTAACCTACGAGCAGTACTTC	CASSCRTGENVTYEQYF	TRBV6-5	TRBJ2-7
TGCGCCAGCAGCTTGCCTCGTCAATCCCCAAGCAGGGACCAAAGGGCAAACACTGAAGCTTTCTTT	CASSLPRQSPSRDQRANTEAFF	TRBV5-1	TRBJ1-1
TGCAGTGAGAATCGGGACAGCCCTTTTGGCGAGCAGTACTTC	CSENRDSPFGEQYF	TRBV20-1	TRBJ2-7
TGCGCCAGCAGCCAAGATCCACGCTCCGCCTACGAGCAGTACTTC	CASSQDPRSAYEQYF	TRBV4-1	TRBJ2-7
TGCAGTGCTATGCCGCGGGAGTGTCGAAGCTCTGGGGCCAACGTCCTGACTTTC	CSAMPRECRSSGANVLTF	TRBV20-1	TRBJ2-6
TGCAGCGTGAACAGGGGGGAGCAAGAGACCCAGTACTTC	CSVNRGEQETQYF	TRBV29-1	TRBJ2-5
TGTGCCAGCAGCTTCTACCCCTTGATTAGCTCTGGAAACACCATATATTTT	CASSFYPLISSGNTIYF	TRBV7-9	TRBJ1-3
TGCGCCAGCAGCTTGGCACGGACAGGGGGATGGAACACTGAAGCTTTCTTT	CASSLARTGGWNTEAFF	TRBV5-1	TRBJ1-1
TGCGCCAGCAGCCAAGTTGGGCATGAGCAGTTCTTC	CASSQVGHEQFF	TRBV4-1	TRBJ2-1
TGTGCCAGCAGTTTCGAGATAATCCGGGACAGCACCGGGGAGCTGTTTTTT	CASSFEIIRDSTGELFF	TRBV27	TRBJ2-2
TGTGCCAGCTCACCTGTCTCGGACACTGAAGCTTTCTTT	CASSPVSDTEAFF	TRBV18	TRBJ1-1
TGCGCCAGCAGCCAAGCCCAGGACAGGGGACAGCCCCAGCATTTT	CASSQAQDRGQPQHF	TRBV4-1	TRBJ1-5
TGTGCCACCAAGAGGGGACTAGCGATCAATGAGCAGTTCTTC	CATKRGLAINEQFF	TRBV24-1	TRBJ2-1
TGTGCCAGCAGTGACTCGCGGGGGAGGGCCTACAATGAGCAGTTCTTC	CASSDSRGRAYNEQFF	TRBV6-4	TRBJ2-1
TGTGCCAGCAGGAGGGGCCGAGAAAAACTGTTTTTT	CASRRGREKLFF	TRBV6-3	TRBJ1-4
TGTGCCAGCAGCTTAGCCCCACAGGGGACCCGCAATCAGCCCCAGCATTTT	CASSLAPQGTRNQPQHF	TRBV11-2	TRBJ1-5
TGTGCCAGCAGCTCGGAGACAGATACGCAGTATTTT	CASSSETDTQYF	TRBV7-8	TRBJ2-3
TGTGCCAGCAGCTGGAAGGACCAAACTAGGCACGAGCAGTACTTC	CASSWKDQTRHEQYF	TRBV7-3	TRBJ2-7
TGTGCCAGCAGCTGCGGGGGACAGCAATCATCAGACGAGCAGTACTTC	CASSCGGQQSSDEQYF	TRBV7-2	TRBJ2-7
TGCAGTGCGACAGGGGCTGGCTACACCTTC	CSATGAGYTF	TRBV20-1	TRBJ1-2
TGCAGTGCTAGAGGGGGGGGCGCCCGGGAGACAGATACGCAGTATTTT	CSARGGGARETDTQYF	TRBV20-1	TRBJ2-3
TGTGCCAGCAGTCCGAGGACTAGCGGGAGGGCCTACAATGAGCAGTTCTTC	CASSPRTSGRAYNEQFF	TRBV6-5	TRBJ2-1
TGTGCTAGTGGTTTGGTACGATACCTCCGGGACAGGGTTCCGGGGAATAGCAATCAGCCCCAGCATTTT	CASGLVRYLRDRVPGNSNQPQHF	TRBV12-5	TRBJ1-5
TGTGCCAGCAGTTCCGCGGGAGGAGGAAACACCATATATTTT	CASSSAGGGNTIYF	TRBV6-2	TRBJ1-3
TGCAGTGCTAGTCCCCCCGTAGCGGGCACAGATACGCAGTATTTT	CSASPPVAGTDTQYF	TRBV20-1	TRBJ2-3
TGTGCCACAGGGTACACTAGCTCTGGAAACACCATATATTTT	CATGYTSSGNTIYF	TRBV10-3	TRBJ1-3
TGTGCCAGCAGCGATTGGATTCAGTTGGGGAACTATGGCTACACCTTC	CASSDWIQLGNYGYTF	TRBV13	TRBJ1-2
TGCGCCAGCAGGCGTGGGGGGGAGTCCGAGGATGAGCAGTTCTTC	CASRRGGESEDEQFF	TRBV10-1	TRBJ2-1
TGTGCTAGTGGGGCCAAACTCCTGCGACCGGAGGTCCGATGCAATCAGCCCCAGCATTTT	CASGAKLLRPEVRCNQPQHF	TRBV12-5	TRBJ1-5
TGTGCCAGCACCCTTAGGGAAAAAAGGGCCTACGAGCAGTACTTC	CASTLREKRAYEQYF	TRBV27	TRBJ2-7
TGTGCCAGCAGTGACCCGACGGGAGACTTGGGACGCTACGAGCAGTACTTC	CASSDPTGDLGRYEQYF	TRBV6-4	TRBJ2-7
TGTGCCAGCAGCCAAGATCCCCAGGGTAGGAGCAATCAGCCCCAGCATTTT	CASSQDPQGRSNQPQHF	TRBV14	TRBJ1-5
TGTGCCAGCAGTTTAGAGGCGGGACCTGAAGCTTTCTTT	CASSLEAGPEAFF	TRBV27	TRBJ1-1
TGTGCCAGCCGCGGGGGGCACGGATCCTACAATGAGCAGTTCTTC	CASRGGHGSYNEQFF	TRBV19	TRBJ2-1
TGTGCTAGTGGTTTGGTGTCTAGAACGGTCCAAGAGACCCAGTACTTC	CASGLVSRTVQETQYF	TRBV12-5	TRBJ2-5
TGCGCCAGCAGTGAGCCTCTAGAGAGCGAGCAGTACTTC	CASSEPLESEQYF	TRBV10-2	TRBJ2-7
TGTGCCAGCAGTAGGCGGGGCTGGGTGCTCAGCACAGATACGCAGTATTTT	CASSRRGWVLSTDTQYF	TRBV6-1	TRBJ2-3
TGTGCCAGCAGACTTCGTTCAGGGAAAGGAGGCACAGATACGCAGTATTTT	CASRLRSGKGGTDTQYF	TRBV14	TRBJ2-3
TGTGCCAGCAGCCAAGATTTCTGTGGGGACAGCTCTGGGGCCAACGTCCTGACTTTC	CASSQDFCGDSSGANVLTF	TRBV4-2	TRBJ2-6
TGTGCCATCAGTGAGCGCCGGGGACTAGCGTACAATGAGCAGTTCTTC	CAISERRGLAYNEQFF	TRBV10-3	TRBJ2-1
TGTGCCAGCAGTTCAACCCCTTCCCCGGGACAAGGTCGGTACACCTTC	CASSSTPSPGQGRYTF	TRBV6-9	TRBJ1-2
TGCAGTGCTAGAGGTCCCCGACAGGGAGTGGCCTATGGCTACACCTTC	CSARGPRQGVAYGYTF	TRBV20-1	TRBJ1-2
TGCGCCAGCGTATCCAACATTTCAGGGGTGAATCAGCCCCAGCATTTT	CASVSNISGVNQPQHF	TRBV5-1	TRBJ1-5
TGTGCCAGCAGCCGGGACAGGGACGGGCGGGGGAAGTACGAGCAGTACTTC	CASSRDRDGRGKYEQYF	TRBV11-2	TRBJ2-7
TGTGCCAGCAGCCCCCCCAAAGGGGGGGGGGGAGAGACCCAGTACTTC	CASSPPKGGGGETQYF	TRBV7-4	TRBJ2-5
