TGCGCCAGACTTAATCAGGCTGAAGCTTTCTTT	CARLNQAEAFF	TRBV10-1	TRBJ1-1
TGTGCCAGCTCGGGGTTGACCACAGATACGCAGTATTTT	CASSGLTTDTQYF	TRBV18	TRBJ2-3
TGTGCCAGCAGCAGGACAGGGCCCCAAGAGACCCAGTACTTC	CASSRTGPQETQYF	TRBV5-4	TRBJ2-5
TGTGCCAGCAGCCAAGTTCTCATGCGGAGCAATCAGCCCCAGCATTTT	CASSQVLMRSNQPQHF	TRBV4-2	TRBJ1-5
TGTGCCAGCAGCGTAGTAGGGACAGAAGGCAATCAGCCCCAGCATTTT	CASSVVGTEGNQPQHF	TRBV9	TRBJ1-5
TGTGCCAGCAGTGAAGAGGATCACCGGGACAGGGGCTTAAGGGATTATGGCTACACCTTC	CASSEEDHRDRGLRDYGYTF	TRBV6-4	TRBJ1-2
TGTGCCAGCAGTTTATGCCGTGGGACTAGCGGGGAGGGCCACTCCTACGAGCAGTACTTC	CASSLCRGTSGEGHSYEQYF	TRBV28	TRBJ2-7
TGTGCCATCAGAAGGACAGAAAGGGTGAACACTGAAGCTTTCTTT	CAIRRTERVNTEAFF	TRBV10-3	TRBJ1-1
TGTGCCAGCAGTGAAGTTCGTAGGGTGGTCACAGATACGCAGTATTTT	CASSEVRRVVTDTQYF	TRBV6-1	TRBJ2-3
TGTGCCAGCAATCTTCCAGGGGGCCAGGCCACAGATACGCAGTATTTT	CASNLPGGQATDTQYF	TRBV7-3	TRBJ2-3
TGTGCCAGCAGCTTACCTCGGAGGTCGCGGGGTGTGGGGGAGTTTGAAAAACTGTTTTTT	CASSLPRRSRGVGEFEKLFF	TRBV7-6	TRBJ1-4
TGTGCCAGCAGCTTGGGTAACTCCTACGAGCAGTACTTC	CASSLGNSYEQYF	TRBV7-9	TRBJ2-7
TGTGCCAGCAGCCTTATGGTGACCGGACAGCCCCAGCATTTT	CASSLMVTGQPQHF	TRBV7-3	TRBJ1-5
TGTGCCAGCAGCGTAGCGGAACTAGCGGGCGTCGAGCAGTACTTC	CASSVAELAGVEQYF	TRBV9	TRBJ2-7
TGCAGTGCTAGCTGGGGGCAGTTCCGGCATTTT	CSASWGQFRHF	TRBV20-1	TRBJ1-5
TGTGCCAGCAGCTTATTGGGACAGGGGGCTCGGCAAGAGACCCAGTACTTC	CASSLLGQGARQETQYF	TRBV7-9	TRBJ2-5
TGTGCAGGAGACGGCAATGAGCAGTTCTTC	CAGDGNEQFF	TRBV28	TRBJ2-1
TGTGCCAGCAGCCATCCGACTAGCGGGAGGTACGAGCAGTACTTC	CASSHPTSGRYEQYF	TRBV4-2	TRBJ2-7
TGCAGTGCTAGAATACCGGCCTCCTACGAGCAGTACTTC	CSARIPASYEQYF	TRBV20-1	TRBJ2-7
TGTGCCACCGGGGATTCGCACCCAAACTATGGCTACACCTTC	CATGDSHPNYGYTF	TRBV6-5	TRBJ1-2
TGTGCCAGCAGCTGCAGCCTAGCGGCGGGGCAAGAGACCCAGTACTTC	CASSCSLAAGQETQYF	TRBV7-9	TRBJ2-5
TGTGCCAGCATAGATTTACTAGGCGAGCAGTACTTC	CASIDLLGEQYF	TRBV12-3	TRBJ2-7
TGCAGTGCTCGTGGACGAGTAGGCTACGAGCAGTACTTC	CSARGRVGYEQYF	TRBV20-1	TRBJ2-7
TGTGCTAGTGGTTTATCAGAGGGTGAAAAACTGTTTTTT	CASGLSEGEKLFF	TRBV12-5	TRBJ1-4
TGTGCCAGTAGTTACTGGCGTTGCTACGAGCAGTACTTC	CASSYWRCYEQYF	TRBV19	TRBJ2-7
TGTGAGGTAGAGGGGGCAAATCAGCCCCAGCATTTT	CEVEGANQPQHF	TRBV7-9	TRBJ1-5
TGTGCCAGCAGCTTTAAGGTAGTTCGAGACAGGGCAACTAATGAAAAACTGTTTTTT	CASSFKVVRDRATNEKLFF	TRBV7-2	TRBJ1-4
TGTGCCAGCAGCGAAATGAACACTGAAGCTTTCTTT	CASSEMNTEAFF	TRBV5-4	TRBJ1-1
TGTGCCAGCAGCTTGGCCAGGGGGCGCCGGGCCCTGGATGGCTACACCTTC	CASSLARGRRALDGYTF	TRBV5-6	TRBJ1-2
TGTGCCAGCAGTTACTCTGGGGGCCGAAGCAATCAGCCCCAGCATTTT	CASSYSGGRSNQPQHF	TRBV6-5	TRBJ1-5
TGTGCCAGCAGTGAACCTAAGCGGGAGCCTAGCACAGATACGCAGTATTTT	CASSEPKREPSTDTQYF	TRBV6-1	TRBJ2-3
TGTGCCAGCAGTTACTCCGCCCGGCCCGGGTCTCGCCAGGAGAGCTACGAGCAGTACTTC	CASSYSARPGSRQESYEQYF	TRBV6-5	TRBJ2-7
TGCGCCAGCAGCTCCCCGAGAGATGGACATCAGCCCCAGCATTTT	CASSSPRDGHQPQHF	TRBV5-1	TRBJ1-5
TGTGCCAGCAGCTTAGGAGGGGTCGCGGCCACTGAAGCTTTCTTT	CASSLGGVAATEAFF	TRBV7-6	TRBJ1-1
TGTGCCAGCAGCCCCGGCAATTGGGATACGCAGTATTTT	CASSPGNWDTQYF	TRBV7-2	TRBJ2-3
TGTGCCAGCAGCGGGGCCGCGTACAAACAGCCCCAGCATTTT	CASSGAAYKQPQHF	TRBV7-3	TRBJ1-5
TGTGCCAGGACCACGGGGCCTAAGAGAACCTACGAGCAGTACTTC	CARTTGPKRTYEQYF	TRBV13	TRBJ2-7
TGCGCCAGCAGTGAGGACACAGGGCCCTACGAGCAGTACTTC	CASSEDTGPYEQYF	TRBV10-1	TRBJ2-7
TGTGCCAGCAGCGTAGTTGACAGGGGTACCACACCGATATATTTT	CASSVVDRGTTPIYF	TRBV9	TRBJ1-3
TGTGCCAGCAGCTTGCGGGGGCTCAGGAGACGTCAAGAGACCCAGTACTTC	CASSLRGLRRRQETQYF	TRBV7-3	TRBJ2-5
TGCGCCAGCAGTGGCACGGGAGGGTCTAATGAAAAACTGTTTTTT	CASSGTGGSNEKLFF	TRBV10-1	TRBJ1-4
TGTGCCAGCAGCTTTAGGGGACAGGGCGACAGGGAGTACTACGAGCAGTACTTC	CASSFRGQGDREYYEQYF	TRBV11-2	TRBJ2-7
TGTGCCAGCAGCAGAACCCCCCACCCCGGGAGCAATCAGCCCCAGCATTTT	CASSRTPHPGSNQPQHF	TRBV3-1	TRBJ1-5
TGCGCCAGCAGCTTGGCCATTGGGGGCGGCTGTAGAGAATTCGATACGCAGTATTTT	CASSLAIGGGCREFDTQYF	TRBV5-1	TRBJ2-3
TGCAGCGTGCCAGGGACCTCGGTCTTCTACGAGCAGTACTTC	CSVPGTSVFYEQYF	TRBV29-1	TRBJ2-7
TGTGCCAGCATGTGCCGACAGGAAGAGACCGAGCAGTACTTC	CASMCRQEETEQYF	TRBV28	TRBJ2-7
TGCAGTGCTAGAGATCGGCGACAGGAGAACACTGAAGCTTTCTTT	CSARDRRQENTEAFF	TRBV20-1	TRBJ1-1
TGCGCCAGCAGTCTCCCGCTCGGACAGGGGGCGCCCTACGAGCAGTACTTC	CASSLPLGQGAPYEQYF	TRBV10-1	TRBJ2-7
TGTGCCAGCAGCTTAGGAGAGAGAGGGATAGACTATGGCTACACCTTC	CASSLGERGIDYGYTF	TRBV11-2	TRBJ1-2
TGTGCCAGCAGCTTAGGGGCCGGGCTTAATCAGCCCCAGCATTTT	CASSLGAGLNQPQHF	TRBV7-2	TRBJ1-5
TGTGCCAGCAGTGGGGGCCCGGACACCGGGGAGCTGTTTTTT	CASSGGPDTGELFF	TRBV27	TRBJ2-2
TGTGCCAGCACAACCCTCGCTAGTACCTCAACAGATACGCAGTATTTT	CASTTLASTSTDTQYF	TRBV27	TRBJ2-3
TGTGCCAGCAGCGCCGTCGGGCGGGACAGGGGGCTTGGCTACACCTTC	CASSAVGRDRGLGYTF	TRBV9	TRBJ1-2
TGCGCCAGCAGCAGGGACAACAAAAACATTCAGTACTTC	CASSRDNKNIQYF	TRBV4-1	TRBJ2-4
TGTGCCAGCAGCCAGTCCATACAGCCCCAGCATTTT	CASSQSIQPQHF	TRBV7-3	TRBJ1-5
TGTGCCACTGAAAACACCGGGGAGCTGTTTTTT	CATENTGELFF	TRBV27	TRBJ2-2
TGTGCCAGCAAGTCTAACACAGATACGCAGTATTTT	CASKSNTDTQYF	TRBV27	TRBJ2-3
TGTGCCAGCAGCGCCGTGGGACAGGGCCGGAGAGAGCAGTACTTC	CASSAVGQGRREQYF	TRBV28	TRBJ2-7
TGTGCCAGCAGCATAGGGGGACTAGCGGGGACCACCGGGGAGCTGTTTTTT	CASSIGGLAGTTGELFF	TRBV7-8	TRBJ2-2
TGTGCCAGCAGCAAGCAAATGGGGGACGGATATGAAAAACTGTTTTTT	CASSKQMGDGYEKLFF	TRBV13	TRBJ1-4
TGCGCCAGCAGCTTGGCAGGTCCCACCGGGGAGCTGTTTTTT	CASSLAGPTGELFF	TRBV5-1	TRBJ2-2
TGTGCCAGCAGCCTGGGGGGGGCCGGGCTCGCTTGGGCCAAAAACATTCAGTACTTC	CASSLGGAGLAWAKNIQYF	TRBV11-3	TRBJ2-4
TGTCCTCCACAAGCCAGTTCTGGAAACACCATATATTTT	CPPQASSGNTIYF	TRBV14	TRBJ1-3
TGTGCCAGCAGCTTGGCTGGACGGGCCGGAGATGAGCAGTTCTTC	CASSLAGRAGDEQFF	TRBV5-6	TRBJ2-1
TGTGCCAGCAGCGTGGCCTCTGGGGCCCTGGGAGGGGCCAACGTCCTGACTTTC	CASSVASGALGGANVLTF	TRBV9	TRBJ2-6
TGCAGTGACCGGAGCACCATATATTTT	CSDRSTIYF	TRBV20-1	TRBJ1-3
TGTGCCAGCAGCACGTTCCCCGGGACAGGGAGAGAAGCTTTCTTT	CASSTFPGTGREAFF	TRBV13	TRBJ1-1
TGTGCCAGCAGCGTAGTACAGAGTCTTAGCTCCTACAATGAGCAGTTCTTC	CASSVVQSLSSYNEQFF	TRBV5-6	TRBJ2-1
TGTGCCGTTTGGACGGGGAACACCGGGGAGCTGTTTTTT	CAVWTGNTGELFF	TRBV6-5	TRBJ2-2
TGTGCCAGCAGCGTCCTCGAGTTAAATAATTCACCCCTCCACTTT	CASSVLELNNSPLHF	TRBV13	TRBJ1-6
TGCAGTGCAGGCGGGAGAAACACCGGGGAGCTGTTTTTT	CSAGGRNTGELFF	TRBV20-1	TRBJ2-2
TGTGCCAGCAGCTTAGATGCTCGACAGGGAGGGGGGGTTTACGAGCAGTACTTC	CASSLDARQGGGVYEQYF	TRBV11-2	TRBJ2-7
TGTGCCAGCAGTGAAGGCCATCAAAGCACAGCAAGGTACGAGCAGTACTTC	CASSEGHQSTARYEQYF	TRBV6-1	TRBJ2-7
TGTGCCAGCAGCGGAAGAACGCAGGGCGTGAAAGCTGGGGCCAACGTCCTGACTTTC	CASSGRTQGVKAGANVLTF	TRBV7-8	TRBJ2-6
TGTGCCAGCAGTTCCTGGCGGAACACTGAAGCTTTCTTT	CASSSWRNTEAFF	TRBV6-1	TRBJ1-1
TGCAGTGCTAGGTCAGGGAGACTTAATTCACCCCTCCACTTT	CSARSGRLNSPLHF	TRBV20-1	TRBJ1-6
TGTGCCAGCAGTTCGTCGCACGAGCAGTACTTC	CASSSSHEQYF	TRBV6-2	TRBJ2-7
TGTGCTAGTGGATCACCCAGGGGGATCGACTCTGGGGCCAACGTCCTGACTTTC	CASGSPRGIDSGANVLTF	TRBV12-5	TRBJ2-6
TGTGCCAGCAGTGAATCGGGGACAGGGAACAATCAGCCCCAGCATTTT	CASSESGTGNNQPQHF	TRBV6-1	TRBJ1-5
TGTGCCAGCAGTGAAGTTCTTCCCATTCAGTACTTC	CASSEVLPIQYF	TRBV6-1	TRBJ2-4
TGCGCCAGCCCTGAGCAGAACACTGAAGCTTTCTTT	CASPEQNTEAFF	TRBV5-1	TRBJ1-1
TGTGCCAGCAGTGGGCTAAAGGCCTCTTCTAACTATGGCTACACCTTC	CASSGLKASSNYGYTF	TRBV2	TRBJ1-2
TGTGCCAGCAGCCCCACTAGAGGACTCTACGAGCAGTACTTC	CASSPTRGLYEQYF	TRBV14	TRBJ2-7
TGTGCCAGCAGTTACAGGACAGGAGAGCAGTACTTC	CASSYRTGEQYF	TRBV6-5	TRBJ2-7
TGTGCCAGCAGCTTAGATGAAGTTGAGAAAGGTTTAGGGGTGGTGGAGTACTTGAGCTCCTACAATGAGCAGTTCTTC	CASSLDEVEKGLGVVEYLSSYNEQFF	TRBV11-2	TRBJ2-1
TGTGCCAGCAGCTTCCTCCTCTGTCCACTACCCGGGGGGCACTGGAAGGAGACCCAGTACTTC	CASSFLLCPLPGGHWKETQYF	TRBV11-3	TRBJ2-5
TGTGCCACCACGGGACAGGGGGACACCGGGGAGCTGTTTTTT	CATTGQGDTGELFF	TRBV24-1	TRBJ2-2
TGTGCCAGCAGCCCGGGACTTGATAATGAGCAGTTCTTC	CASSPGLDNEQFF	TRBV3-1	TRBJ2-1
TGTGCCTGGAGTGTACAAACCGACCCCGGGGGGATTAAAACATGGCAAGAGACCCAGTACTTC	CAWSVQTDPGGIKTWQETQYF	TRBV30	TRBJ2-5
TGCAGTGCTAAACTAGTGACTAGCGGGCGGAGCTACAATGAGCAGTTCTTC	CSAKLVTSGRSYNEQFF	TRBV20-1	TRBJ2-1
TGCGCCAGCAGTGAGGCCCTCCGGGACATAGGCAATCAGCCCCAGCATTTT	CASSEALRDIGNQPQHF	TRBV10-1	TRBJ1-5
TGTGCCAGCATCAGGGGGGTTCATGGCTACACCTTC	CASIRGVHGYTF	TRBV6-2	TRBJ1-2
TGTGCCAGCAGCCTACAGGGTGGAAACTATGGCTACACCTTC	CASSLQGGNYGYTF	TRBV2	TRBJ1-2
TGTGCCAGCAGTTTGGGGCCGGGACAGGAGCGAGAGCGAGAAAAACTGTTTTTT	CASSLGPGQEREREKLFF	TRBV28	TRBJ1-4
TGCGCCAGCAGCAGCGGGAGCAGTGCTGAAGCTTTCTTT	CASSSGSSAEAFF	TRBV10-1	TRBJ1-1
TGTGCTAGTGGTTTGGTACACGAAGAGGGGGCAGATACGCAGTATTTT	CASGLVHEEGADTQYF	TRBV12-5	TRBJ2-3
TGTGCCAGCAGGTACAGGGGTAATGAGCAGTTCTTC	CASRYRGNEQFF	TRBV2	TRBJ2-1
TGTGCCACCAGTGATATACATGGACAGGGCCGATGGGGCACAGATACGCAGTATTTT	CATSDIHGQGRWGTDTQYF	TRBV24-1	TRBJ2-3
TGTGCCAGCAGTTCGAAAATTAGCGGGACTTTCTTT	CASSSKISGTFF	TRBV6-1	TRBJ1-1
TGTGCCACCAGCAGAGGGATCTCAGGGGGAGCCTACGAGCAGTACTTC	CATSRGISGGAYEQYF	TRBV15	TRBJ2-7
TGCGCCAGCAGCCCTCGGGCCTTCCCTACTGGAAACACCATATATTTT	CASSPRAFPTGNTIYF	TRBV4-1	TRBJ1-3
TGTGCCAGCAGTCCCCTTTCAGACTTTGGGGGTGTAGGTTCGAAAGCGAACACCGGGGAGCTGTTTTTT	CASSPLSDFGGVGSKANTGELFF	TRBV25-1	TRBJ2-2
TGTGCCAGCAGCTTAAGGACAGGGGATGAGGATAGCAATCAGCCCCAGCATTTT	CASSLRTGDEDSNQPQHF	TRBV13	TRBJ1-5
TGTGCCAGCAGTTACTCGAGGGGTATTGACAGGGGAAGGATTGAAGCTTTCTTT	CASSYSRGIDRGRIEAFF	TRBV6-2	TRBJ1-1
TGTGCCAGTAGTACCCGGGACAGGGCTGGCGAGCAGTACTTC	CASSTRDRAGEQYF	TRBV19	TRBJ2-7
TGTGCCCACGCATTACTTCCTAGCAATCAGCCCCAGCATTTT	CAHALLPSNQPQHF	TRBV12-4	TRBJ1-5
TGCAGTGCTTCACCCTTGGGCGGGACAGGGGTTGAGAGCTATGGCTACACCTTC	CSASPLGGTGVESYGYTF	TRBV20-1	TRBJ1-2
TGTGCCACCAGTGATCGGGGGAGGGGAGAAAAACTGTTTTTT	CATSDRGRGEKLFF	TRBV24-1	TRBJ1-4
TGTGCCACCAGCTCCCACTTGGGAGTCTACGAGCAGTACTTC	CATSSHLGVYEQYF	TRBV24-1	TRBJ2-7
TGCAGTGCTAGAGGTCTAGACAGGGGAAGTCCCCAGCATTTT	CSARGLDRGSPQHF	TRBV20-1	TRBJ1-5
TGTGCCAGCAGCCGAGAACAGGGAGTACACTACGAGCAGTACTTC	CASSREQGVHYEQYF	TRBV13	TRBJ2-7
TGTGCCAGCAGCTTCAGGGAGGGGGGAGAAGCTGAGACCCAGTACTTC	CASSFREGGEAETQYF	TRBV9	TRBJ2-5
TGTGCCAGTAGTAGGGCAGGGAGCAATCAGCCCCAGCATTTT	CASSRAGSNQPQHF	TRBV19	TRBJ1-5
TGTGCCAGCAGTGAGCCGACAGGGGTCCAGCGAGGCTACACCTTC	CASSEPTGVQRGYTF	TRBV6-4	TRBJ1-2
TGTGCCAGCAGTGACGCAGACGGACAGGACAATGAGCAGTTCTTC	CASSDADGQDNEQFF	TRBV25-1	TRBJ2-1
TGTGCCAGCAGCTCCAGGACCTACGAGCAGTACTTC	CASSSRTYEQYF	TRBV11-3	TRBJ2-7
TGTGCCAGCAGCCAAGCCCCAGCTCTTCCAATGAACACTGAAGCTTTCTTT	CASSQAPALPMNTEAFF	TRBV3-1	TRBJ1-1
TGCAGTGCGACCCCCGGGACGTCGAACACTGAAGCTTTCTTT	CSATPGTSNTEAFF	TRBV20-1	TRBJ1-1
TGTGCCAGCAGTTACCTCCAGGGGAACTGGAACACTGAAGCTTTCTTT	CASSYLQGNWNTEAFF	TRBV6-5	TRBJ1-1
TGTGCCACCAGTGATTTGCTCAGTATTCCCGAGTGCACCGGGGAGCTGTTTTTT	CATSDLLSIPECTGELFF	TRBV24-1	TRBJ2-2
TGCAGTGCCGAAGGACATGTGAGGAAAGAGACCCAGTACTTC	CSAEGHVRKETQYF	TRBV20-1	TRBJ2-5
TGTGCCAGCAGCTTAGCCCCCGGGGACCTATTCTCACCCCTCCACTTT	CASSLAPGDLFSPLHF	TRBV11-2	TRBJ1-6
TGTGCCAGCAGCCGAGAGCAGGGGTTGGAGACCCAGTACTTC	CASSREQGLETQYF	TRBV7-2	TRBJ2-5
TGTGCCAGCAGCTTAGTCCGCCGGTATGGTAGTAAGGGTGACACCTTC	CASSLVRRYGSKGDTF	TRBV7-8	TRBJ1-2
TGTGCCAGCAGGGGTCTCCCCGCGGGAGGACCCTATAGCAATCAGCCCCAGCATTTT	CASRGLPAGGPYSNQPQHF	TRBV7-9	TRBJ1-5
TGTGCCAGCAAGAGGACAGGGGGTCCGAAAGCTTTCTTT	CASKRTGGPKAFF	TRBV12-3	TRBJ1-1
TGTGCCAGCAGCTCCAGGAGACTAGCGAATGAGCAGTTCTTC	CASSSRRLANEQFF	TRBV5-4	TRBJ2-1
TGTGCCAGCAGCTTATCATCTAGCGGGAGTTGCTACAATGAGCAGTTCTTC	CASSLSSSGSCYNEQFF	TRBV7-8	TRBJ2-1
TGCAGCGTTGGGGCTCGCTTTGAGACCCAGTACTTC	CSVGARFETQYF	TRBV29-1	TRBJ2-5
TGTGCCTGGCCTAGCGGGGGGGCCTACGAGCAGTACTTC	CAWPSGGAYEQYF	TRBV30	TRBJ2-7
TGCGCCAGCAGCCAAGGGCAGCCCTACGAGCAGTACTTC	CASSQGQPYEQYF	TRBV4-1	TRBJ2-7
TGTGCCAGCAGTGAAGCCCGGGTCACTGGGGCCAACGTCCTGACTTTC	CASSEARVTGANVLTF	TRBV2	TRBJ2-6
TGTGCCAGCAGCCCCAGGGACAGGGGTCCTCCTGATCAGCCCCAGCATTTT	CASSPRDRGPPDQPQHF	TRBV3-1	TRBJ1-5
TGTGCCAGCAGCGGCGGGGGGGGCTACGAGCAGTACTTC	CASSGGGGYEQYF	TRBV9	TRBJ2-7
TGCGCCAGCAGCACCCCGGGACAAGGTTCCGACTACGAGCAGTACTTC	CASSTPGQGSDYEQYF	TRBV5-1	TRBJ2-7
TGTGCCAGCAGCTATCATACGCATCAGCCCCAGCATTTT	CASSYHTHQPQHF	TRBV7-2	TRBJ1-5
TGTGCCACCAATACCTACGAGCAGTACTTC	CATNTYEQYF	TRBV6-4	TRBJ2-7
TGTGCCAGCAGTGGGGACCAGACTGAGCAGTTCTTC	CASSGDQTEQFF	TRBV2	TRBJ2-1
TGCGCCAGCCTCGGCACTAATAACACTGAAGCTTTCTTT	CASLGTNNTEAFF	TRBV10-1	TRBJ1-1
TGTGCCAGTGGGACCGGGGACGAGCAGTACTTC	CASGTGDEQYF	TRBV19	TRBJ2-7
TGTGCCAGCAGCAAATGGGGACAGGGCGAGACCTACGAGCAGTACTTC	CASSKWGQGETYEQYF	TRBV13	TRBJ2-7
TGTGCCAGCAGTGACTCTTTCGAAGACATTTCCAATCAGCCCCAGCATTTT	CASSDSFEDISNQPQHF	TRBV6-4	TRBJ1-5
TGTGCCAGCGGGACAGGCACTGAAGCTTTCTTT	CASGTGTEAFF	TRBV9	TRBJ1-1
TGCAGTGCTGGACTAGCGGGACCCTACGAGCAGTACTTC	CSAGLAGPYEQYF	TRBV20-1	TRBJ2-7
TGCAGTGCTAGAGATTACAGGGCGAGGACCGGGGAGCTGTTTTTT	CSARDYRARTGELFF	TRBV20-1	TRBJ2-2
TGTGCCAGCAGTGACGGAAGGTTCCATGGGGGGGACACTGAAGCTTTCTTT	CASSDGRFHGGDTEAFF	TRBV6-4	TRBJ1-1
TGTGCCAGCAGTTACCTACGGGTCGCGGGGAACGCTCCCCGAGATACGCAGTATTTT	CASSYLRVAGNAPRDTQYF	TRBV6-6	TRBJ2-3
TGTGCCCACCTTTTCGGGGGCAAAGAGACCCAGTACTTC	CAHLFGGKETQYF	TRBV7-2	TRBJ2-5
TGCAGTGACGGGACAGGGGGCAGGAGATACGAGCAGTACTTC	CSDGTGGRRYEQYF	TRBV20-1	TRBJ2-7
TGTGCCAGCGTGACGGATATAGAATACGAGCAGTACTTC	CASVTDIEYEQYF	TRBV25-1	TRBJ2-7
TGCAGTGCTAGTCTTAAGTTCCGCTACGAGCAGTACTTC	CSASLKFRYEQYF	TRBV20-1	TRBJ2-7
TGTGCCAGCAGTGCACCCAAACGGGACTACGAGCAGTACTTC	CASSAPKRDYEQYF	TRBV6-8	TRBJ2-7
TGTGCCTGGAGGGAAATAAAGATTGTTGACGAGCAGTACTTC	CAWREIKIVDEQYF	TRBV30	TRBJ2-7
TGTGCCAGCAGGAACCCAGGGGGAAATAAGGTGGCTGAAGCTTTCTTT	CASRNPGGNKVAEAFF	TRBV5-5	TRBJ1-1
TGTGCCAGCAGCTTGTTAGACGGTAGGACGGCCTACGAGCAGTACTTC	CASSLLDGRTAYEQYF	TRBV5-6	TRBJ2-7
TGTGCCACCAGTGGGGGTGACGGACAGGGCCTCTATGGCTACACCTTC	CATSGGDGQGLYGYTF	TRBV24-1	TRBJ1-2
TGTGCCACTAGCGGCGGGGAGCTGTTTTTT	CATSGGELFF	TRBV10-3	TRBJ2-2
TGTGCCAGCAAGCTCATAGACGACAGGGTAGAGGGTTACGAGCAGTACTTC	CASKLIDDRVEGYEQYF	TRBV7-9	TRBJ2-7
TGCGCCAGCAGCCAAGACCCCAAGTCAGGGGGACGTACGGGCACTGAAGCTTTCTTT	CASSQDPKSGGRTGTEAFF	TRBV4-3	TRBJ1-1
TGCGCCAGCAGTGATAACAGGGCCTGCTGCTCTGGAAACACCATATATTTT	CASSDNRACCSGNTIYF	TRBV10-1	TRBJ1-3
TGTGCCAGCAGCTCCCTGTCACGGAACACTGAAGCTTTCTTT	CASSSLSRNTEAFF	TRBV5-5	TRBJ1-1
TGTGCCACCATCCCCCCCGGGCCGGGACTAGGGGCCGGGCAAGAGACCCAGTACTTC	CATIPPGPGLGAGQETQYF	TRBV15	TRBJ2-5
TGTGCCAGCAGCTTAAAAAGGGGGCGGGGGGGGGAGTTCGAAAAACTGTTTTTT	CASSLKRGRGGEFEKLFF	TRBV7-3	TRBJ1-4
TGTGCCACCGCGGGGGCCTACGAGCAGTACTTC	CATAGAYEQYF	TRBV24-1	TRBJ2-7
TGTGCCAGCAGTACGGGCCCCAGGAGAAACACCATATATTTT	CASSTGPRRNTIYF	TRBV27	TRBJ1-3
TGTGCCGGGGACGTCTATGGCTACACCTTC	CAGDVYGYTF	TRBV11-3	TRBJ1-2
TGCGCCAGCAGCGCGGGGCAGCCCCAGCATTTT	CASSAGQPQHF	TRBV5-1	TRBJ1-5
TGCGCCAGCAGCGTGAGGGGGGTGAGGGGCGAGCAGTACTTC	CASSVRGVRGEQYF	TRBV5-1	TRBJ2-7
TGCGCCAGCAGCCCACCGGCGAGGTGCACCGGGGAGCTGTTTTTT	CASSPPARCTGELFF	TRBV5-1	TRBJ2-2
TGTGCCAGTAGCCCCCCGACGAATCAGCCCCAGCATTTT	CASSPPTNQPQHF	TRBV19	TRBJ1-5
TGTGAGCATCCGGTCGGGGAGCTAGCCAAAAACATTCAGTACTTC	CEHPVGELAKNIQYF	TRBV12-3	TRBJ2-4
TGTGCCAGCAGCAGCACAGGGGGAAGTCGGCCCTACGAGCAGTACTTC	CASSSTGGSRPYEQYF	TRBV11-2	TRBJ2-7
TGCGCCAGCAGCAGAGGACTCGGGAAGGAGGTCGGGGAGCTGTTTTTT	CASSRGLGKEVGELFF	TRBV5-1	TRBJ2-2
TGTGCCAGCAGTTTCCCGTCATGGGGGGCCGGAGAAAAACTGTTTTTT	CASSFPSWGAGEKLFF	TRBV12-3	TRBJ1-4
TGTGCCAGCAGCTTCAACAGGAGGCCGTGCAATCAGCCCCAGCATTTT	CASSFNRRPCNQPQHF	TRBV7-7	TRBJ1-5
TGTGCCAGCAGCTTAAGGGGGGGTTATAATAGCAATCAGCCCCAGCATTTT	CASSLRGGYNSNQPQHF	TRBV27	TRBJ1-5
TGCGCCAGCAGCACGCCGACTGACAGGGCCCCTCAGAATCAGCCCCAGCATTTT	CASSTPTDRAPQNQPQHF	TRBV5-1	TRBJ1-5
TGTGCCAGCAGTTGCGTGGGACAGGGGGCAGATACGCAGTATTTT	CASSCVGQGADTQYF	TRBV6-2	TRBJ2-3
TGCAGTGCTAGAGATGGAGACCCAGGGGCCCTGTCCTACGAGCAGTACTTC	CSARDGDPGALSYEQYF	TRBV20-1	TRBJ2-7
TGTGCCAGCAGAGTTGTATCGGGCCGGTCCCTCCACTTT	CASRVVSGRSLHF	TRBV6-4	TRBJ1-6
TGTGCCAGCAGCGGGGCGGGAAGGGAGTCCCCAACTAATGAAAAACTGTTTTTT	CASSGAGRESPTNEKLFF	TRBV5-6	TRBJ1-4
TGTGCCAGCAGCTTTGAATGTTGGGGGGGCCAGGGTCACAATGAGCAGTTCTTC	CASSFECWGGQGHNEQFF	TRBV5-4	TRBJ2-1
TGTGCCAGCAGTTTGCGGGGATCAAACTATGGCTACACCTTC	CASSLRGSNYGYTF	TRBV28	TRBJ1-2
TGTGCTAAGCGGGATCAGCCCCAGCATTTT	CAKRDQPQHF	TRBV7-3	TRBJ1-5
TGTGCCAGCAGACACCTAAGCTACACCTTC	CASRHLSYTF	TRBV28	TRBJ1-2
TGTGCCAGCAGTTTGCTGGACGATTATTGCTACGAGCAGTACTTC	CASSLLDDYCYEQYF	TRBV12-3	TRBJ2-7
TGCGCCAGCAGCAGACCCAGCGCCACTGAAGCTTTCTTT	CASSRPSATEAFF	TRBV4-3	TRBJ1-1
TGTGCCAGTAGTGCTCAACGGGGACTAGGTTCCTACGAGCAGTACTTC	CASSAQRGLGSYEQYF	TRBV19	TRBJ2-7
TGTGCCAGCAGTGGGACGCGGGACGGCTACAATGAGCAGTTCTTC	CASSGTRDGYNEQFF	TRBV7-9	TRBJ2-1
TGTGCCAGCAGTCCAGAGAACACTGAAGCTTTCTTT	CASSPENTEAFF	TRBV6-3	TRBJ1-1
TGTGCCACCAGTGCCGTCGCGGGACTAGCCAACAATGAGCAGTTCTTC	CATSAVAGLANNEQFF	TRBV24-1	TRBJ2-1
TGTGCCAGCAGCTTAGCCAGGGGGAGCAATCAGCCCCAGCATTTT	CASSLARGSNQPQHF	TRBV7-9	TRBJ1-5
TGCAGTGCTAGAGATCAACCCCAGGTACAGCCCCAGCATTTT	CSARDQPQVQPQHF	TRBV20-1	TRBJ1-5
TGTGCCAGCAGCTTCGATAGCGGGACAGCCTATCAGCCCCAGCATTTT	CASSFDSGTAYQPQHF	TRBV2	TRBJ1-5
TGTGCCAGCAGCCCAGAGGGGCGGTGTCGAGCTAACTATGGCTACACCTTC	CASSPEGRCRANYGYTF	TRBV14	TRBJ1-2
TGTGCCAGCCGGGACAGGGAGTCCGAGCAGTACTTC	CASRDRESEQYF	TRBV6-2	TRBJ2-7
TGTGCCAGCAGTTTGCTAGCGGGGGAGGCGGTGTGCTCCTACAATGAGCAGTTCTTC	CASSLLAGEAVCSYNEQFF	TRBV6-5	TRBJ2-1
TGTGCCAGCAGTACCGGGACAGCTTTCTTT	CASSTGTAFF	TRBV12-4	TRBJ1-1
TGTGCCAGTAGTATAGTAGACCACCAAGAGACCCAGTACTTC	CASSIVDHQETQYF	TRBV19	TRBJ2-5
TGTGCCAGCAACTACGAGGTGGGAAGAGGCAAAAACATTCAGTACTTC	CASNYEVGRGKNIQYF	TRBV25-1	TRBJ2-4
TGTGCCACCAGTGGCTCCGGGACAGGGGGGAGCTACGAGCAGTACTTC	CATSGSGTGGSYEQYF	TRBV24-1	TRBJ2-7
TGTGCCAGCAGCTACCTAGTTACCGGGGAGCTGTTTTTT	CASSYLVTGELFF	TRBV11-3	TRBJ2-2
TGTGCCAGCAGTTACTCAAAAGCCCGGGACAGGGATAGGGACATTCAGTACTTC	CASSYSKARDRDRDIQYF	TRBV6-2	TRBJ2-4
TGTGCCACCAGTGATTTTCCCGGGACTAGGAACAATGAGCAGTTCTTC	CATSDFPGTRNNEQFF	TRBV24-1	TRBJ2-1
TGTGCCAGTGCAGCGGGACAGACGGGCAATGAGCAGTTCTTC	CASAAGQTGNEQFF	TRBV25-1	TRBJ2-1
TGCGCCAGCAGCTTGCGTCAGGGCAAGATCGTTGCAACTAATGAAAAACTGTTTTTT	CASSLRQGKIVATNEKLFF	TRBV5-1	TRBJ1-4
TGCAGCGTTGAACGATGGGCTGAGACCCAGTACTTC	CSVERWAETQYF	TRBV29-1	TRBJ2-5
TGCGCCAGCAGCCGGGGAGGACACTATGGCTACACCTTC	CASSRGGHYGYTF	TRBV5-1	TRBJ1-2
TGTGCCAGCAGCCCCATCTGTGGTTTCAAAGAGACCCAGTACTTC	CASSPICGFKETQYF	TRBV7-4	TRBJ2-5
TGTGCCAGCAGCATGGGGAATGAAAAACTGTTTTTT	CASSMGNEKLFF	TRBV12-4	TRBJ1-4
TGTGCCAGCAGAGGACAGGGGGCCAATCAGCCCCAGCATTTT	CASRGQGANQPQHF	TRBV7-3	TRBJ1-5
TGTGCCAGTAGCGGAATGTACAGGGGTGGCTACACCTTC	CASSGMYRGGYTF	TRBV19	TRBJ1-2
TGTGCCAGCAGTGACTCGCAGGGGGGGCACGAGGTCCCGTCTAGCACAGATACGCAGTATTTT	CASSDSQGGHEVPSSTDTQYF	TRBV6-4	TRBJ2-3
TGTGCCAGCAGTGACTCTTCTCTTGGTACAGACGCTGAAAAACTGTTTTTT	CASSDSSLGTDAEKLFF	TRBV6-4	TRBJ1-4
TGTGCCAGCAGTGAACCTCGGGGGGGCATAGAGACCCAGTACTTC	CASSEPRGGIETQYF	TRBV25-1	TRBJ2-5
TGTGCCAGCAGCTTAATCGTATCGAGGAATCAGCCCCAGCATTTT	CASSLIVSRNQPQHF	TRBV7-3	TRBJ1-5
TGTGCCAGCAGCCCAGCGACGGGACAGGGTCGTTCCTACGAGCAGTACTTC	CASSPATGQGRSYEQYF	TRBV7-3	TRBJ2-7
TGTGCCAGCTCTATGGGACAGGGGTCTGGAAACACCATATATTTT	CASSMGQGSGNTIYF	TRBV18	TRBJ1-3
TGTGCCAGCAGGAAAGGCAACTACGAGCAGTACTTC	CASRKGNYEQYF	TRBV7-3	TRBJ2-7
TGTGCCAGCAGCTCCCCCCAGGAGAAAGACTACAATGAGCAGTTCTTC	CASSSPQEKDYNEQFF	TRBV11-3	TRBJ2-1
TGTGCCAGCAGCTTAGAGGGGGGGCCCCAGCATTTT	CASSLEGGPQHF	TRBV7-2	TRBJ1-5
TGTGCCAGCAGCAAGGTGGCGGGGACTCGACCGAACGAGCAGTACTTC	CASSKVAGTRPNEQYF	TRBV7-9	TRBJ2-7
TGTGCCAGCAGTGAATCGTTCCGGGGACAGGGCAGACCCACTGAAGCTTTCTTT	CASSESFRGQGRPTEAFF	TRBV25-1	TRBJ1-1
TGTGCCAGCAGCACACGGTCTGGCTCTGGAAACACCATATATTTT	CASSTRSGSGNTIYF	TRBV5-6	TRBJ1-3
TGCAGTGCTAGAGATATGGGGGAACCAATAGAGACCCAGTACTTC	CSARDMGEPIETQYF	TRBV20-1	TRBJ2-5
TGTGCCAGCAGCTTCCAGGGGGGGGGCCCTCCGGACACCCAGTACTTC	CASSFQGGGPPDTQYF	TRBV7-9	TRBJ2-5
TGTGCCACCAGCAGAGTCTTTGACAGCACAGATACGCAGTATTTT	CATSRVFDSTDTQYF	TRBV15	TRBJ2-3
TGCGCCAGCAGCCAAGATCCGAGCCACCCGGGCGACATTCAGTACTTC	CASSQDPSHPGDIQYF	TRBV4-3	TRBJ2-4
TGCAGTGCATATATTCTGGCAGATTGCTACGAGCAGTACTTC	CSAYILADCYEQYF	TRBV20-1	TRBJ2-7
TGTGCCACCAGTGAAAGACTCTATTCTAGTGAGCTCTCTGGGGCCAACGTCCTGACTTTC	CATSERLYSSELSGANVLTF	TRBV24-1	TRBJ2-6
TGTGCCAGCAGCTGGGGGACCCTAAGCACAGATACGCAGTATTTT	CASSWGTLSTDTQYF	TRBV11-3	TRBJ2-3
TGTGCCAGTAGTATAGCCGGGGGGAGATGTAGTCGGTCCTACAATGAGCAGTTCTTC	CASSIAGGRCSRSYNEQFF	TRBV19	TRBJ2-1
TGTGCCAGCAGCGCCCTAAGGGCCAACGTCCTGACTTTC	CASSALRANVLTF	TRBV9	TRBJ2-6
TGCAGCGTTGCCGGCCCCTACGGTGCTAGCACAGATACGCAGTATTTT	CSVAGPYGASTDTQYF	TRBV29-1	TRBJ2-3
TGTGCCACCAGCCCAAAGGGGGATGATGAGCAGTTCTTC	CATSPKGDDEQFF	TRBV15	TRBJ2-1
TGTGCCAGCAGTGGGGACAGGGGGTGGGGGTACGAGCAGTACTTC	CASSGDRGWGYEQYF	TRBV27	TRBJ2-7
TGTGCCAGCAGGGGACAGGGACATAGCAATCAGCCCCAGCATTTT	CASRGQGHSNQPQHF	TRBV28	TRBJ1-5
TGTGCCAGCCTTTGCGTACCAGGACAGCAGCGAGAGACCCAGTACTTC	CASLCVPGQQRETQYF	TRBV18	TRBJ2-5
TGTGCCAGCAGCGGTTCAAATGGGGCTCCTGAAGCTTTCTTT	CASSGSNGAPEAFF	TRBV13	TRBJ1-1
TGTGCCAGCAAGTTGTTGGTTCGGCCCGGCTACACCTTC	CASKLLVRPGYTF	TRBV5-4	TRBJ1-2
TGTGCCAGCAGTTTTCCCCATAGCGGGGGTAAGCATGCCAGGAATGAGCAGTTCTTC	CASSFPHSGGKHARNEQFF	TRBV28	TRBJ2-1
TGTGCTAGTGGTCGGCACCAGAGACTAGATACGCAGTATTTT	CASGRHQRLDTQYF	TRBV12-5	TRBJ2-3
TGTGCCACTAGACAGGGTACTGAAGCTTTCTTT	CATRQGTEAFF	TRBV27	TRBJ1-1
TGTGCCAGCAGCCACTACCTCGCAGTCGCAGTTGAGCAGTTCTTC	CASSHYLAVAVEQFF	TRBV14	TRBJ2-1
TGTGCCAGCAGGAAGCGGGAATGGGGAAACACCGGGGAGCTGTTTTTT	CASRKREWGNTGELFF	TRBV28	TRBJ2-2
TGTGCCACCACCACAACCCCGGACAGGGAAGGGTCCTACGAGCAGTACTTC	CATTTTPDREGSYEQYF	TRBV24-1	TRBJ2-7
TGTGCCAGCTCACCATACTGGCTGACTAGCGGGGTTGCTGAGCAGTTCTTC	CASSPYWLTSGVAEQFF	TRBV18	TRBJ2-1
TGTGCCAGCAGTTCACCTAGCTATGGCTACACCTTC	CASSSPSYGYTF	TRBV27	TRBJ1-2
TGTGCCAGCAGCCAAGCTGGGGGCTTTATGAACACTGAAGCTTTCTTT	CASSQAGGFMNTEAFF	TRBV14	TRBJ1-1
TGTGCCAGCAGCGTCACGGCCCCGCGGGCCCTCCACCAGACGGAGACCCAGTACTTC	CASSVTAPRALHQTETQYF	TRBV7-3	TRBJ2-5
TGTGCCAGCAGGTCTTGGGGGGGGACAGGGGAGGAGTACTTC	CASRSWGGTGEEYF	TRBV6-3	TRBJ2-7
TGTGCCAGCAGCGCAATGGGACCCTACGAGCAGTACTTC	CASSAMGPYEQYF	TRBV7-2	TRBJ2-7
TGTGCCAGTAGTAGGAGGCTAGCGGGTAAGCAGTACTTC	CASSRRLAGKQYF	TRBV19	TRBJ2-7
TGTGCCAGCAGCTTTCCCGATTTTGAAGCTTTCTTT	CASSFPDFEAFF	TRBV7-2	TRBJ1-1
TGTGCCAGCAGTTGGTTCACCGGGGAGCTGTTTTTT	CASSWFTGELFF	TRBV27	TRBJ2-2
TGCGCCAGCAGCTTGGGGGGCTCCTACAATGAGCAGTTCTTC	CASSLGGSYNEQFF	TRBV5-1	TRBJ2-1
TGTGCCAGCAGACTAGCGGGAGGGCCGGATGAGCAGTTCTTC	CASRLAGGPDEQFF	TRBV5-6	TRBJ2-1
TGTGCCAGCAGTAGAGGCGATGAGCAGTTCTTC	CASSRGDEQFF	TRBV6-2	TRBJ2-1
TGTGGTCCGGGACAGGGGACCTACGAGCAGTACTTC	CGPGQGTYEQYF	TRBV27	TRBJ2-7
TGCAGTGCTACTCGGAATACCCGTATACAGGGTCGTCACGAGCAGTACTTC	CSATRNTRIQGRHEQYF	TRBV20-1	TRBJ2-7
TGTGCCAGCAGCCTGGGCAATCAGCCCCAGCATTTT	CASSLGNQPQHF	TRBV9	TRBJ1-5
TGTGCCAGCAGCGCGAGTCCCCTAGGGAAAAGGCTGAACACTGAAGCTTTCTTT	CASSASPLGKRLNTEAFF	TRBV7-3	TRBJ1-1
TGTGCCTGGCATTCTTGGACTCATCAAGAGACCCAGTACTTC	CAWHSWTHQETQYF	TRBV30	TRBJ2-5
TGTGCCAGCAGCCTGCGGTTAAGCGGGAAGCGGTGGCGCACAGATACGCAGTATTTT	CASSLRLSGKRWRTDTQYF	TRBV3-1	TRBJ2-3
TGTGCCAGCAGTAGGGGTAATACTCCGGTTTTTTACTATGGCTACACCTTC	CASSRGNTPVFYYGYTF	TRBV14	TRBJ1-2
TGTGCCAGCAGCCTACTAGCGGGAGTCCTATATTCACCCCTCCACTTT	CASSLLAGVLYSPLHF	TRBV7-9	TRBJ1-6
TGCGCCACCCCCCGGAGGGATAATTCACCCCTCCACTTT	CATPRRDNSPLHF	TRBV10-1	TRBJ1-6
TGTGCCAGCAGCCGGAGGGGCACAGATACGCAGTATTTT	CASSRRGTDTQYF	TRBV7-4	TRBJ2-3
TGTGCCAGCAGTTTCGACAGGGAGGGCGAGACCCAGTACTTC	CASSFDREGETQYF	TRBV12-4	TRBJ2-5
TGCAGTGAACCCCGGGGGGCATATAGGGAGACCCAGTACTTC	CSEPRGAYRETQYF	TRBV20-1	TRBJ2-5
TGTGCCAGCAGTTCGATGGACAGGGAAAGCTACGAGCAGTACTTC	CASSSMDRESYEQYF	TRBV28	TRBJ2-7
TGTGCCAGCAGTGGGTGGGGGGGGGTCAATGAGCAGTTCTTC	CASSGWGGVNEQFF	TRBV6-5	TRBJ2-1
TGCGCCAGCAGCCAAGATGACGGTCGCGGCTACACCTTC	CASSQDDGRGYTF	TRBV4-3	TRBJ1-2
TGCGCCAGCAGCTTCCGGCAAGGGGGAAACGTTAGAGACTATGGCTACACCTTC	CASSFRQGGNVRDYGYTF	TRBV5-1	TRBJ1-2
TGTGCCAGCAGCTTAGTAGACAGGATAACTAATGAAAAACTGTTTTTT	CASSLVDRITNEKLFF	TRBV11-3	TRBJ1-4
TGTGCCAGCAGCCAAGACGTACTAGCGGGAGGTCGGGGGACAAATCAGCCCCAGCATTTT	CASSQDVLAGGRGTNQPQHF	TRBV3-1	TRBJ1-5
TGTGCTAGCAGCGTGTGGCGGGAGAAATGCAACATTCAGTACTTC	CASSVWREKCNIQYF	TRBV7-7	TRBJ2-4
TGTGCCAGTACTCAAAATGACGACAGGGAGCAGTACTTC	CASTQNDDREQYF	TRBV19	TRBJ2-7
TGTGCCAGCAGCCAGGTTAAGGGGGGTGGGTCACCCCTCCACTTT	CASSQVKGGGSPLHF	TRBV3-1	TRBJ1-6
TGCAACTCAGGACAGGGGGAAAACACCGGGGAGCTGTTTTTT	CNSGQGENTGELFF	TRBV20-1	TRBJ2-2
TGTGCCAGCCCCGGGGGCGACTATGGCTACACCTTC	CASPGGDYGYTF	TRBV11-3	TRBJ1-2
TGTGCCAGCAGCTTGGACAGGACTCATGGCTACACCTTC	CASSLDRTHGYTF	TRBV5-4	TRBJ1-2
TGTGCCAGCAGCTTACGTGGGGGGGGGGTTGACTACGAGCAGTACTTC	CASSLRGGGVDYEQYF	TRBV11-3	TRBJ2-7
TGTGCCAGCAGCTTAGCGAAAGGGGGCCAAGAGACCCAGTACTTC	CASSLAKGGQETQYF	TRBV7-9	TRBJ2-5
TGTGCCAGCAGTTTTTATCCGGAGAGGTGGCCACAGAGCGAGCAGTACTTC	CASSFYPERWPQSEQYF	TRBV27	TRBJ2-7
TGTGCCTGGAGGAACAGCCCCCGCTCAGGTACTGAAGCTTTCTTT	CAWRNSPRSGTEAFF	TRBV30	TRBJ1-1
TGTGCCAGCAGTCCGCTAGCGCGGGGGGAGACAACGTCCTACAATGAGCAGTTCTTC	CASSPLARGETTSYNEQFF	TRBV6-1	TRBJ2-1
TGCGCCAGCAGCTTGGCAGACTCCATGAACACTGAAGCTTTCTTT	CASSLADSMNTEAFF	TRBV5-1	TRBJ1-1
TGTGCCAGCAGTTGTTCAGTTGACAGGGGGCTCTTT	CASSCSVDRGLF	TRBV27	TRBJ1-1
TGTGCCACCAGCCGTAAGCGCCTAGCGGGGGAGGAGACCCAGTACTTC	CATSRKRLAGEETQYF	TRBV15	TRBJ2-5
TGTGCCAGCAGCCAAGATAAAGGGACTAGCGGGTTGAACACCGGGGAGCTGTTTTTT	CASSQDKGTSGLNTGELFF	TRBV4-2	TRBJ2-2
TGTGCCAGCAGCCGAGACAGGGGGAGGGGAGGGGCCAACGTCCTGACTTTC	CASSRDRGRGGANVLTF	TRBV2	TRBJ2-6
TGTGCCAGCAGCTTAGCAAAAAACACCATATATTTT	CASSLAKNTIYF	TRBV7-9	TRBJ1-3
TGTGCCAGCAGTATATACTGCGGCAATGAGCAGTTCTTC	CASSIYCGNEQFF	TRBV28	TRBJ2-1
TGTGCCTGGAGTGGGGGCAGTAAGGGAACCCGGAGCGGTTCCGGAAGCAATCAGCCCCAGCATTTT	CAWSGGSKGTRSGSGSNQPQHF	TRBV30	TRBJ1-5
TGTGCCAGCGGGCCCGGACTTGTGAACACTGAAGCTTTCTTT	CASGPGLVNTEAFF	TRBV6-5	TRBJ1-1
TGTGCCAGCAGCCCCGAGTCCTTAAGGGACAGGGTTGAGAACACTGAAGCTTTCTTT	CASSPESLRDRVENTEAFF	TRBV14	TRBJ1-1
TGTGCCAGCGACAATAGGTTGACGCAGTATTTT	CASDNRLTQYF	TRBV9	TRBJ2-3
TGCAGTGACCTGGGGGGGAGGTACTACGAGCAGTACTTC	CSDLGGRYYEQYF	TRBV20-1	TRBJ2-7
TGTGCCAGTAGTATAGATCGATCTAGCGGGGGGGCCGCCTACGAGCAGTACTTC	CASSIDRSSGGAAYEQYF	TRBV19	TRBJ2-7
TGCAGCGTTGTATCTAACTATGAGCAGTTCTTC	CSVVSNYEQFF	TRBV29-1	TRBJ2-1
TGTGCCAGCAGCCCAACGACGAGGCCTCACAATGAGCAGTTCTTC	CASSPTTRPHNEQFF	TRBV13	TRBJ2-1
TGCGCCAGCAGCCATAGCGGGGAGCTGTTTTTT	CASSHSGELFF	TRBV4-1	TRBJ2-2
TGTGCCAGCAGCAAGCACCCTACGCTAGCGGGAATAACCAAAAACATTCAGTACTTC	CASSKHPTLAGITKNIQYF	TRBV7-3	TRBJ2-4
TGTGCCAGCAGTTTTCAGCATACCTACGAGCAGTACTTC	CASSFQHTYEQYF	TRBV6-9	TRBJ2-7
TGTGCCAGCAGTACCCAGGTGCGGGGGAGCAGAACGCTTGGTCAGCCCCAGCATTTT	CASSTQVRGSRTLGQPQHF	TRBV6-3	TRBJ1-5
TGCGCCAGCAGCCAACAAGCCGGGACAGGGGGTACTGAAGCTTTCTTT	CASSQQAGTGGTEAFF	TRBV4-1	TRBJ1-1
TGTGCCAGCAGCTCCAGAATGTGTGGGGAGCTGTTTTTT	CASSSRMCGELFF	TRBV11-3	TRBJ2-2
TGTGCCAGTACGGGCCGGGGACACACCGGGGAGCTGTTTTTT	CASTGRGHTGELFF	TRBV19	TRBJ2-2
TGTGCCAGTAGTATTAGACAGATGGAGCAGTACTTC	CASSIRQMEQYF	TRBV19	TRBJ2-7
TGTGCCACCAAGGTAGCGGGGGAAGAGACCCAGTACTTC	CATKVAGEETQYF	TRBV24-1	TRBJ2-5
TGTGCCAGCAGCAGGGGGCGCTCTGGGGCCAACGTCCTGACTTTC	CASSRGRSGANVLTF	TRBV11-2	TRBJ2-6
TGTGCCAGCAGCCAAGCCCGGGCCTGGGGGGGGGCGGAGCAGTACTTC	CASSQARAWGGAEQYF	TRBV14	TRBJ2-7
TGTGCCAGCAGCGCTGAAACGGGACCGATTCGGAGCTACGAGCAGTACTTC	CASSAETGPIRSYEQYF	TRBV28	TRBJ2-7
TGTGCCAGCAGAAAACAAGGGACAGCATATTCGGAGACCCAGTACTTC	CASRKQGTAYSETQYF	TRBV2	TRBJ2-5
TGTGCCAGCAGTTTATCCGGAGCGGCTTTTATACTTGCAACTAATGAAAAACTGTTTTTT	CASSLSGAAFILATNEKLFF	TRBV27	TRBJ1-4
TGCGCCAGCAGCTTCTACAGGGGAACAGATACGCAGTATTTT	CASSFYRGTDTQYF	TRBV5-1	TRBJ2-3
TGTGCCAGCAGCCCCCTCGGGACAGCTTATGGCTACACCTTC	CASSPLGTAYGYTF	TRBV7-3	TRBJ1-2
TGTGCCAGCAGCTCCTGGGACCTTCCGCATGGGGGCTTACTGCGCGGTGGCTACACCTTC	CASSSWDLPHGGLLRGGYTF	TRBV13	TRBJ1-2
TGTGCCAGCAGTACGGAACAGAGCTCCTACAATGAGCAGTTCTTC	CASSTEQSSYNEQFF	TRBV6-6	TRBJ2-1
TGTGCCAGCAGCTCGGACGCTCTCAGCCAAGAAGCTTTCTTT	CASSSDALSQEAFF	TRBV7-6	TRBJ1-1
TGTGCCATCAGTGTGAGGGAGGGCGTCAATGAGCAGTTCTTC	CAISVREGVNEQFF	TRBV10-3	TRBJ2-1
TGTGCCAGCAGCGAAGAGCTAGCCCGAGATGGCTACACCTTC	CASSEELARDGYTF	TRBV9	TRBJ1-2
TGCAATTCGACAGGGGGGGTCGAGCAGTACTTC	CNSTGGVEQYF	TRBV29-1	TRBJ2-7
TGCAGTGCTAGAGACCGGCCGTACTGGACTAGCGAGGGCTACGAGCAGTACTTC	CSARDRPYWTSEGYEQYF	TRBV20-1	TRBJ2-7
TGCGCCAGCCAGGGGGGGCCCACGCAGTATTTT	CASQGGPTQYF	TRBV10-1	TRBJ2-3
TGTGCCAGCAGACGACTAGCGGGAGGGCGGTGCACAGATACGCAGTATTTT	CASRRLAGGRCTDTQYF	TRBV5-6	TRBJ2-3
TGTGCCAGCAGCTTGACAGGGGAATCCTACGAGCAGTACTTC	CASSLTGESYEQYF	TRBV7-3	TRBJ2-7
TGTGCCAGCTCACCAATAGGGGGCCCAGGATCGAGCTCCTACGAGCAGTACTTC	CASSPIGGPGSSSYEQYF	TRBV18	TRBJ2-7
TGTGCCAGCAGCTATGGACTAGCGGGGAAGGACGAGACCCAGTACTTC	CASSYGLAGKDETQYF	TRBV5-8	TRBJ2-5
TGCAGTGCTAGTCCCGGGACATTCAATCAGCCCCAGCATTTT	CSASPGTFNQPQHF	TRBV20-1	TRBJ1-5
TGCGCCAGCAGCTTCCCATCTGGGCACCAACTTGGCTACGAGCAGTACTTC	CASSFPSGHQLGYEQYF	TRBV5-1	TRBJ2-7
TGTGCCAGCAGCCAACGAGGTGGCGAGCAGTACTTC	CASSQRGGEQYF	TRBV7-9	TRBJ2-7
TGTGCCAGCAGTGACAGGGGGATCTACAATGAGCAGTTCTTC	CASSDRGIYNEQFF	TRBV6-3	TRBJ2-1
TGCGCCAGCAGCCGTGGCGTAGAGGGGCGCGCGGGAATCTATGGCTACACCTTC	CASSRGVEGRAGIYGYTF	TRBV4-1	TRBJ1-2
TGTGCCACCAGGGGCCGGGGCTATGGCTACACCTTC	CATRGRGYGYTF	TRBV24-1	TRBJ1-2
TGCGCCAGCAGCTCGGGCAGGGAAAAACTGTTTTTT	CASSSGREKLFF	TRBV5-1	TRBJ1-4
TGTGCCAGCTCACCAAGGACTGGTGATCAGCCCCAGCATTTT	CASSPRTGDQPQHF	TRBV18	TRBJ1-5
TGTGCCAGCAGTTCAGATCCGCGTGGGACTAGCGGGGGGGGTGCAGATACGCAGTATTTT	CASSSDPRGTSGGGADTQYF	TRBV12-4	TRBJ2-3
TGCAGTGCTAGAGACTTCACAGGGGGGGAAAAACTGTTTTTT	CSARDFTGGEKLFF	TRBV20-1	TRBJ1-4
TGTGCCAGCAGCGGGGCAAGCCACCGGAATCAGCCCCAGCATTTT	CASSGASHRNQPQHF	TRBV13	TRBJ1-5
TGTGCCAGCCCCGGGAGCTACGAGCAGTACTTC	CASPGSYEQYF	TRBV28	TRBJ2-7
TGTGCCCCATTATCCCGAGGGACCGGGAGACGAGAAAAGCAGTTCTTC	CAPLSRGTGRREKQFF	TRBV6-2	TRBJ2-1
TGTGCCAGCAAGTCGAAATGTAAGAGTACCTACGAGCAGTACTTC	CASKSKCKSTYEQYF	TRBV27	TRBJ2-7
TGTGCCAGCAGCTTTTCGGACAGGGGGCCATACTACGAGCAGTACTTC	CASSFSDRGPYYEQYF	TRBV7-3	TRBJ2-7
TGTGCCTGGAGGAGTCTGACTAGCGGGAGAAGGTACACTGAAGCTTTCTTT	CAWRSLTSGRRYTEAFF	TRBV30	TRBJ1-1
TGCGCCAGCAGCCAAGACTGGGACCACCTTACAGAGACCCAGTACTTC	CASSQDWDHLTETQYF	TRBV4-1	TRBJ2-5
TGTGCCAGCAGCCGATCCGGGACAGGTAACTATGGCTACACCTTC	CASSRSGTGNYGYTF	TRBV3-1	TRBJ1-2
TGTGCCAGCAGCGTGGACCCGGTATGTCAGCCCCAGCATTTT	CASSVDPVCQPQHF	TRBV9	TRBJ1-5
TGTGCCAATATTAAATTCGGGGACTGTAGGCACACTGAAGCTTTCTTT	CANIKFGDCRHTEAFF	TRBV3-1	TRBJ1-1
TGTGCCAGTTGCAGTGTCGCCAGCAATCAGCCCCAGCATTTT	CASCSVASNQPQHF	TRBV19	TRBJ1-5
TGTGCCAGCAGCTTAGCAAGGGGCCTGACAGGGGGCACTGATCAGCCCCAGCATTTT	CASSLARGLTGGTDQPQHF	TRBV7-6	TRBJ1-5
TGCGCCAGCAGCCAGCCGACATTCCAAGTCAATTCACCCCTCCACTTT	CASSQPTFQVNSPLHF	TRBV4-3	TRBJ1-6
TGTGCCAGCAGGGGGGGGAAAAGCACAGATACGCAGTATTTT	CASRGGKSTDTQYF	TRBV9	TRBJ2-3
TGTGCCATCAGTGTAGGGGGGGCTCCGAGAAGTCAGCCCCAGCATTTT	CAISVGGAPRSQPQHF	TRBV10-3	TRBJ1-5
TGTGCCATCAGTGACGAGGGGATCTCCTATAATTCACCCCTCCACTTT	CAISDEGISYNSPLHF	TRBV10-3	TRBJ1-6
TGCAGTGCTAGATTTTGCCACCGGACAGGCACTGAAGCTTTCTTT	CSARFCHRTGTEAFF	TRBV20-1	TRBJ1-1
TGTGCCAGCAGCGAAAGGCCCGCCCAGACGCGAGATACGCAGTATTTT	CASSERPAQTRDTQYF	TRBV9	TRBJ2-3
TGTGCCAGCAGGTCCGGGGTGGGTTACGAGCAGTACTTC	CASRSGVGYEQYF	TRBV6-6	TRBJ2-7
TGTGCCAGCAGCCTCCCCCGACAGGGAGTTCAGCCCCAGCATTTT	CASSLPRQGVQPQHF	TRBV12-3	TRBJ1-5
TGTGCCAGCAGCCCGATGCCCCGCCAGGGGGGAGCTGGAAACACCATATATTTT	CASSPMPRQGGAGNTIYF	TRBV11-2	TRBJ1-3
TGTGCCACCAGAAGATGGACAGGGCTTAGCTCGGGCGAAGACACTGAAGCTTTCTTT	CATRRWTGLSSGEDTEAFF	TRBV24-1	TRBJ1-1
TGTGCCAGCAAGACAAGCAATGAGCAGTTCTTC	CASKTSNEQFF	TRBV12-4	TRBJ2-1
TGTGCCAGCAGCTTAGTCCTAGTAAGGGAATACGAGCAGTACTTC	CASSLVLVREYEQYF	TRBV11-2	TRBJ2-7
TGCAGTGCTAGAGATAGACAGGCTCAGCCCCAGCATTTT	CSARDRQAQPQHF	TRBV20-1	TRBJ1-5
TGCGCCAGCAGGGGGTCTAATGAAAAACTGTTTTTT	CASRGSNEKLFF	TRBV5-1	TRBJ1-4
TGCAGCGTTGGGGTTACGGGTCCGGTTGACGAGCAGTACTTC	CSVGVTGPVDEQYF	TRBV29-1	TRBJ2-7
TGTGCCAGCAGTTATCCCGTCCGGGCAAGCGGAGGGGCTTTCTTT	CASSYPVRASGGAFF	TRBV6-2	TRBJ1-1
TGTGCCAGCACGGACAGGTATCAGCCCCAGCATTTT	CASTDRYQPQHF	TRBV6-1	TRBJ1-5
TGCGCCAGCAATTCGGGAGGAGATTTTGTGGAGACCCAGTACTTC	CASNSGGDFVETQYF	TRBV10-1	TRBJ2-5
TGTGCCATCAGTGAGGACAGGGGGGGCGAATTCCGCGGAAACACCATATATTTT	CAISEDRGGEFRGNTIYF	TRBV10-3	TRBJ1-3
TGTGCCAGCTCACGGTTTTCCAGGGCCTCCTACGAGCAGTACTTC	CASSRFSRASYEQYF	TRBV18	TRBJ2-7
TGCGCCAGCAGTGACCCTCGGGACATGACACCCCTCCACTTT	CASSDPRDMTPLHF	TRBV10-1	TRBJ1-6
TGTGCCAGCAGCTCCCGACAGGAATATTTCTACGAGCAGTACTTC	CASSSRQEYFYEQYF	TRBV11-1	TRBJ2-7
TGTGCCAGCAGTGGGGGGGGGCACCATGAGCAGTTCTTC	CASSGGGHHEQFF	TRBV6-4	TRBJ2-1
TGTGCCAGCATCTCCCGGGACAGGTTAAAGGTCGATGAGCAGTTCTTC	CASISRDRLKVDEQFF	TRBV3-1	TRBJ2-1
TGTGCCAGCAGCCGGTCTACGGGACAGGGCAATCAGCCCCAGCATTTT	CASSRSTGQGNQPQHF	TRBV13	TRBJ1-5
TGTGCCAGCTCACCAAGTGTCCGGGACACTGAAGCTTTCTTT	CASSPSVRDTEAFF	TRBV18	TRBJ1-1
TGTGCCAGCAGTGACATAACAGGGAACTATGGCTACACCTTC	CASSDITGNYGYTF	TRBV6-1	TRBJ1-2
TGTGCCAGCAGTTCCCCCAGGGGGGGTGCCCTCCACTTT	CASSSPRGGALHF	TRBV27	TRBJ1-6
TGTGCCAGCAGTTTACGCAGGGGAAGCTACAATGAGCAGTTCTTC	CASSLRRGSYNEQFF	TRBV12-4	TRBJ2-1
TGTGCCAGCAGCCCTCCCCCACGATACACAGGGGTACCCCTGAACACCGGGGAGCTGTTTTTT	CASSPPPRYTGVPLNTGELFF	TRBV7-6	TRBJ2-2
TGTGCCAGCAGCTACAGCGGGAGAGGTGGCTACACCTTC	CASSYSGRGGYTF	TRBV5-6	TRBJ1-2
TGTGCCAGCAGTTACTCGGCATCCAGCTCAACTAATGAAAAACTGTTTTTT	CASSYSASSSTNEKLFF	TRBV6-3	TRBJ1-4
TGCGCCAGCAGTGAGGTCGGGCCGGGTGGCCGCTTAAACACCGGGGAGCTGTTTTTT	CASSEVGPGGRLNTGELFF	TRBV10-1	TRBJ2-2
TGTGCCAGCACGTGGGGAGGGGATTACACTGAAGCTTTCTTT	CASTWGGDYTEAFF	TRBV4-2	TRBJ1-1
TGTGCCACCAGTGAGGGGGAGGACGACAACACCGGGGAGCTGTTTTTT	CATSEGEDDNTGELFF	TRBV24-1	TRBJ2-2
TGTGCCAGTCCAAGGGGGGATCGCCAGAGTGAAAAACTGTTTTTT	CASPRGDRQSEKLFF	TRBV19	TRBJ1-4
TGTGCCAGCAGTTACCCCGGGCTAGCCGGGACTACAGAGACCCAGTACTTC	CASSYPGLAGTTETQYF	TRBV6-3	TRBJ2-5
TGTGCCACCAGTGGTGTCTCGGCAGCGGGAGCCCTGGGGAATCAGCCCCAGCATTTT	CATSGVSAAGALGNQPQHF	TRBV24-1	TRBJ1-5
TGCAGTGCTCACCACTTAGTAAACTATGGCTACACCTTC	CSAHHLVNYGYTF	TRBV20-1	TRBJ1-2
TGTGCCAGCAGCGCCGGGACAGGGCTCTCCTACGAGCAGTACTTC	CASSAGTGLSYEQYF	TRBV5-5	TRBJ2-7
TGTGCCAGCAGTGAGGGACGGGTCAGCGAGCAGTACTTC	CASSEGRVSEQYF	TRBV6-4	TRBJ2-7
TGTGCCAGCTCACCACTAATAGGCCTTTGCGAGCAGTACTTC	CASSPLIGLCEQYF	TRBV18	TRBJ2-7
TGTGCTAGTGGTTTCACCCCTCCAGGTAATGAAAAACTGTTTTTT	CASGFTPPGNEKLFF	TRBV12-5	TRBJ1-4
TGTGCCAGCAGCTTGGATCGAGAGCGGGAATATTCACCCCTCCACTTT	CASSLDREREYSPLHF	TRBV7-6	TRBJ1-6
TGTGCCAGCAGCGGCCCCTCGACTAGCGGGGGGGCCTGGCCAGATACGCAGTATTTT	CASSGPSTSGGAWPDTQYF	TRBV7-4	TRBJ2-3
TGTGCCAGCATTGACAGGGGACAGGGGAGGAACACTGAAGCTTTCTTT	CASIDRGQGRNTEAFF	TRBV2	TRBJ1-1
TGTGCCAGTAGTATACCAGGGGGGAACACTGAAGCTTTCTTT	CASSIPGGNTEAFF	TRBV19	TRBJ1-1
TGTGCCAGCAATGCCACAGGGGGGTTTGAAAAACTGTTTTTT	CASNATGGFEKLFF	TRBV28	TRBJ1-4
TGTGCCAGCAGCAATGGGGGACTAGGTCGGAAGTTGCAGATGGACGAGCAGTACTTC	CASSNGGLGRKLQMDEQYF	TRBV5-5	TRBJ2-7
TGTGCCAGCAGGGGGGACAGGTTTGAATTTAGTCCTGAAGCTTTCTTT	CASRGDRFEFSPEAFF	TRBV27	TRBJ1-1
TGCAGTGCTAGTATGGGGGATGGAAACACCATATATTTT	CSASMGDGNTIYF	TRBV20-1	TRBJ1-3
TGTGCCAGCAGCCAAGATCCGGAGCGAGGGGTAGAGACCCAGTACTTC	CASSQDPERGVETQYF	TRBV3-1	TRBJ2-5
TGCAGTGCACTGGACAGGCAGGCCGGGGAGCTGTTTTTT	CSALDRQAGELFF	TRBV20-1	TRBJ2-2
TGTGCCAGCAGCTTCGACCGGGACTTC	CASSFDRDF	TRBV7-2	TRBJ2-5
TGTGCCAGCAAAAAGGGGATAGCTTTCTTT	CASKKGIAFF	TRBV19	TRBJ1-1
TGTGCCAGCAGTCTATCTAGACCTCCATACGAGCAGTACTTC	CASSLSRPPYEQYF	TRBV27	TRBJ2-7
TGTGCCAGCAGCTGTCCAGGGAGGTACGCCTACGAGCAGTACTTC	CASSCPGRYAYEQYF	TRBV7-9	TRBJ2-7
TGTGCCAGCAGTTTATGCTGGGGACAGGGGAAGCTCTACGAGCAGTACTTC	CASSLCWGQGKLYEQYF	TRBV27	TRBJ2-7
TGTGCCAGCAGCCGGAGTTTCAGTGGACAGGGGGAACCTAACTATGGCTACACCTTC	CASSRSFSGQGEPNYGYTF	TRBV13	TRBJ1-2
TGCAGTGCTAGTCCCCTCCCAGAGGGGAGGGGCTCTGAAAAACTGTTTTTT	CSASPLPEGRGSEKLFF	TRBV20-1	TRBJ1-4
TGTGCCAGCAGCTGGGCCTGGTTCTACTCCTACGAGCAGTACTTC	CASSWAWFYSYEQYF	TRBV7-3	TRBJ2-7
TGTGCCAGCAGCTTACCTCCAAATGAGCAGTTCTTC	CASSLPPNEQFF	TRBV7-3	TRBJ2-1
TGTGCCATAGGTCACGGGCTACATAGCAATCAGCCCCAGCATTTT	CAIGHGLHSNQPQHF	TRBV10-3	TRBJ1-5
TGCGCCAGCAGCCTGGAGACAGGGATCCCTGAAGCTTTCTTT	CASSLETGIPEAFF	TRBV5-1	TRBJ1-1
TGTGCCAGCAGTTTATCGACTCCTAGCCTTCGGGTCCTGGGGATCCGCTGCACAGATACGCAGTATTTT	CASSLSTPSLRVLGIRCTDTQYF	TRBV27	TRBJ2-3
TGTGCCAGCAGCTGGGGGGGGGAGGGGCCCTACGAGCAGTACTTC	CASSWGGEGPYEQYF	TRBV7-2	TRBJ2-7
TGCAGCGAGTCACGGCCCCCTGATGAAAAACTGTTTTTT	CSESRPPDEKLFF	TRBV29-1	TRBJ1-4
TGTGCCAGCAGCCACGGACAATTACTAGGGTATAGCTCTGGAAACACCATATATTTT	CASSHGQLLGYSSGNTIYF	TRBV3-1	TRBJ1-3
TGCAGTGCTAGTAAAGTAGACAGACCCCTCCACTTT	CSASKVDRPLHF	TRBV20-1	TRBJ1-6
TGCGCCAGCAGCGGGGGACCGGGACTAGCGGGGTGGCATGATACGCAGTATTTT	CASSGGPGLAGWHDTQYF	TRBV10-1	TRBJ2-3
TGTGCCAGCAGCTTAATCCCAAGGGGGCGGGACACCTACGAGCAGTACTTC	CASSLIPRGRDTYEQYF	TRBV11-3	TRBJ2-7
TGTGCCAGTAGTACTTACCTCCGGGACAGGGGTCTGGTAGATAGCAATCAGCCCCAGCATTTT	CASSTYLRDRGLVDSNQPQHF	TRBV19	TRBJ1-5
TGTGCCAGCAGCAAACCTTCTTCCAGGGATAGCTACAATGAGCAGTTCTTC	CASSKPSSRDSYNEQFF	TRBV7-3	TRBJ2-1
TGTGCCACCGTGACTAGCCGAGGCAATGAGCAGTTCTTC	CATVTSRGNEQFF	TRBV24-1	TRBJ2-1
TGTGCCACCACAGGGCCGCAGTACTTC	CATTGPQYF	TRBV24-1	TRBJ2-7
TGCAGTGCTAGTTACCCGCCCGGGACACGGGCCCAAGAGACCCAGTACTTC	CSASYPPGTRAQETQYF	TRBV20-1	TRBJ2-5
TGTGCCAGCAGCCTTACTAGCGGGACGGAGACCCAGTACTTC	CASSLTSGTETQYF	TRBV6-5	TRBJ2-5
TGTGCCAGCACCAATGTTGGGGGCGAGGGGTGGGGCAATCAGCCCCAGCATTTT	CASTNVGGEGWGNQPQHF	TRBV28	TRBJ1-5
TGTGCCAGCAGCCAGCAGGGGGTAGATGAGCAGTTCTTC	CASSQQGVDEQFF	TRBV11-2	TRBJ2-1
TGTGCCAGCAGCCAAGATCCCTGGTTTGACAGGCCTCAGATCGCTGGAAACACCATATATTTT	CASSQDPWFDRPQIAGNTIYF	TRBV3-1	TRBJ1-3
TGTGCCAGCAGCCGACCGGGACAGTTGCCCTATAGCAATCAGCCCCAGCATTTT	CASSRPGQLPYSNQPQHF	TRBV3-1	TRBJ1-5
TGTGCCAGCAGGCAGGGGGATTCACCCCTCCACTTT	CASRQGDSPLHF	TRBV6-5	TRBJ1-6
TGCGCCAGCAGCCAAGGGTCCCCCCCAAAATACGAGCAGTACTTC	CASSQGSPPKYEQYF	TRBV4-1	TRBJ2-7
TGTGCCAGCAGCTCTAGGGTGTACACCTTGGGGAGCGATAGCAATCAGCCCCAGCATTTT	CASSSRVYTLGSDSNQPQHF	TRBV13	TRBJ1-5
TGTGCCAGCAGCCACTTCGGACTGCAAGAGACCCAGTACTTC	CASSHFGLQETQYF	TRBV14	TRBJ2-5
TGTGCCAGTAGCCCCACTCAGATCCTTTCACCCCTCCACTTT	CASSPTQILSPLHF	TRBV19	TRBJ1-6
TGCAGTGCTAGAGATCCTACTAGCGGGAGGGCCCTTCACTTTTATTCACCCCTCCACTTT	CSARDPTSGRALHFYSPLHF	TRBV20-1	TRBJ1-6
TGCGCCAGCAGTGAGCGGGCCCTGGGACGCACTATACCCCTCCACTTT	CASSERALGRTIPLHF	TRBV10-1	TRBJ1-6
TGCAGCACTAGCGGGAGTGAGACCCAGTACTTC	CSTSGSETQYF	TRBV29-1	TRBJ2-5
TGTGTCGAACAGGGAAGGGAAAAACTGTTTTTT	CVEQGREKLFF	TRBV7-3	TRBJ1-4
TGTGCCAGCAGCCCAAAGGCAGGGCCCCCATTTCTTAGCAATCAGCCCCAGCATTTT	CASSPKAGPPFLSNQPQHF	TRBV3-1	TRBJ1-5
TGTGCCAGCAAAAGGGGGGACGAGCAGTACTTC	CASKRGDEQYF	TRBV28	TRBJ2-7
TGTGCCAGCAGCCAGCGGGAGGCCACCGGGGAGCTGTTTTTT	CASSQREATGELFF	TRBV13	TRBJ2-2
TGCAGTGCTAGGACACTGTACCAAGAGACCCAGTACTTC	CSARTLYQETQYF	TRBV20-1	TRBJ2-5
TGTGCCAGCAGCGGAAACACTGAAGCTTTCTTT	CASSGNTEAFF	TRBV13	TRBJ1-1
TGTGCCAGCAGTTACACTAACTGTGCCAGCTCCTACAATGAGCAGTTCTTC	CASSYTNCASSYNEQFF	TRBV27	TRBJ2-1
TGTGCCAGCAGCTCAGGGGGAGGCGCAATTACCCCCCAGCATTTT	CASSSGGGAITPQHF	TRBV11-2	TRBJ1-5
TGTGCCAGCAGTGAACCCCGGACATGGGGGACGGATAGCAATCAGCCCCAGCATTTT	CASSEPRTWGTDSNQPQHF	TRBV25-1	TRBJ1-5
TGTGCCATCAGTGAGCGACAGGGGCGCTACGAGCAGTACTTC	CAISERQGRYEQYF	TRBV10-3	TRBJ2-7
TGTGCCAGCAGTTTATTGGACTTGAACAGGAATCAGCCCCAGCATTTT	CASSLLDLNRNQPQHF	TRBV27	TRBJ1-5
TGTGCCAGCAGCGAAGAGGGGGGCTACGAGCAGTACTTC	CASSEEGGYEQYF	TRBV11-2	TRBJ2-7
TGTGCCAGCAGCCCCCAAAGTCGGGGACAGGACACTGAAGCTTTCTTT	CASSPQSRGQDTEAFF	TRBV7-3	TRBJ1-1
TGCAGCGCTGAATCAGGGAGATACGAGCAGTACTTC	CSAESGRYEQYF	TRBV29-1	TRBJ2-7
TGCGCCAGCAGCCAAGATCCAAGAGGAAGAGGTGTGAGGCCGGATTCACCCCTCCACTTT	CASSQDPRGRGVRPDSPLHF	TRBV4-1	TRBJ1-6
TGTGCCAGCAGCCACGCGGGACAGGGCGGCGCCTACGAGCAGTACTTC	CASSHAGQGGAYEQYF	TRBV14	TRBJ2-7
TGTGCCAGCTCCCTCGACAGGGCGGTCGGAGCCAAAAACATTCAGTACTTC	CASSLDRAVGAKNIQYF	TRBV6-4	TRBJ2-4
TGCGCCAGCAGCTTGGCCGGACAATTAAGGCCAGCTTTCTTT	CASSLAGQLRPAFF	TRBV5-1	TRBJ1-1
TGCAGCGTTGACCGGGGGCAAGAGACCCAGTACTTC	CSVDRGQETQYF	TRBV29-1	TRBJ2-5
TGCAGTGCTAGAGCGACAGGGGGCCTCTATGGCTACACCTTC	CSARATGGLYGYTF	TRBV20-1	TRBJ1-2
TGCAGTGCTGGGGGTGGTGAGACCCAGTACTTC	CSAGGGETQYF	TRBV20-1	TRBJ2-5
TGCGCCAGTCGGGACAGGGCACATCAGCCCCAGCATTTT	CASRDRAHQPQHF	TRBV10-1	TRBJ1-5
TGTGCCAGCAGCAGGACGAAGGTAAAACCTGGAAACACCATATATTTT	CASSRTKVKPGNTIYF	TRBV5-4	TRBJ1-3
TGTGCCAGCGGCAGGGTAGCCTACGAGCAGTACTTC	CASGRVAYEQYF	TRBV2	TRBJ2-7
TGCAGTGCTAGAGACAGGGTCGCAATATCCTATAATTCACCCCTCCACTTT	CSARDRVAISYNSPLHF	TRBV20-1	TRBJ1-6
TGTGCCAGCGGTCAGGGGGAAAACACCGGGGAGCTGTTTTTT	CASGQGENTGELFF	TRBV12-4	TRBJ2-2
TGTGCCAGTAGTATGACTAGCGATGGTTTGGAGCAGTACTTC	CASSMTSDGLEQYF	TRBV19	TRBJ2-7
TGCCAGGGGCAACAGGTCGGGGAGCTGTTTTTT	CQGQQVGELFF	TRBV5-1	TRBJ2-2
TGTGCCAGCATGGCGGCGCCATCCTATGGCTACACCTTC	CASMAAPSYGYTF	TRBV25-1	TRBJ1-2
TGTGCCAGTCGAGCGGAGAGCTCCTACAATGAGCAGTTCTTC	CASRAESSYNEQFF	TRBV19	TRBJ2-1
TGCAGTGCTAGACTTGGGGACGCGTCCCCACGAACCGAGCAGTACTTC	CSARLGDASPRTEQYF	TRBV20-1	TRBJ2-7
TGTGCTAGCAGCTTAAGAAATAAACTAGCGGGGGGGCCAGGATACAATGAGCAGTTCTTC	CASSLRNKLAGGPGYNEQFF	TRBV7-7	TRBJ2-1
TGTGCCAGCATGGTCTTCCAGGGGCGAGATGAAAAACTGTTTTTT	CASMVFQGRDEKLFF	TRBV14	TRBJ1-4
TGCAGCGTTGAAGACGGGGGGAACTACGAGCAGTACTTC	CSVEDGGNYEQYF	TRBV29-1	TRBJ2-7
TGCAGTGCTCGGGGGGGGGGCGTCACAGATACGCAGTATTTT	CSARGGGVTDTQYF	TRBV20-1	TRBJ2-3
TGTGCCAGCAGCTTTAGGGGGACTGGCTACGAGCAGTACTTC	CASSFRGTGYEQYF	TRBV7-8	TRBJ2-7
TGTGCCAGCAGTTACTCGACTCAACAGACGGGCTACACCTTC	CASSYSTQQTGYTF	TRBV6-5	TRBJ1-2
TGTGCCAGCAGTCTCACCCGGGACAGGGGGGACTACACTGAAGCTTTCTTT	CASSLTRDRGDYTEAFF	TRBV6-5	TRBJ1-1
TGTGCCTGGACTAGCGGGAACCGCACAGATACGCAGTATTTT	CAWTSGNRTDTQYF	TRBV30	TRBJ2-3
TGTGCCAGCAGCTTAAGTCCGGGGCTAGCGGGCATTGAGACCCAGTACTTC	CASSLSPGLAGIETQYF	TRBV11-2	TRBJ2-5
TGTGCCGTTGTCGGTTCAGGACGGAACATGGAGGGGTGTACACTGACCCAGTACTTC	CAVVGSGRNMEGCTLTQYF	TRBV7-8	TRBJ2-5
TGTGCCAGCTGGCGACTAGCGGGGTTACTCTTC	CASWRLAGLLF	TRBV6-4	TRBJ2-1
TGTGCCAGCAGCTGGGGGCATGGGAACTACGAGCAGTACTTC	CASSWGHGNYEQYF	TRBV13	TRBJ2-7
TGTGCCAGCAGCAGGGGGGGACAGGGGATAGATACGCAGTATTTT	CASSRGGQGIDTQYF	TRBV7-3	TRBJ2-3
TGTGCCAGCAGCAACACACTAGTCGAGACCCAGTACTTC	CASSNTLVETQYF	TRBV13	TRBJ2-5
TGTGCCAGCAGCTTAGGAATGGGACAGGCCCGCTACAATGAGCAGTTCTTC	CASSLGMGQARYNEQFF	TRBV7-9	TRBJ2-1
TGTGCCAGCAGCGGGCGACTAGCGTTACACGAGCAGTACTTC	CASSGRLALHEQYF	TRBV7-3	TRBJ2-7
TGTGCCAGCAGCTTACCCCGGGAGATCGCGACTGAAGCTTTCTTT	CASSLPREIATEAFF	TRBV11-2	TRBJ1-1
TGTGCCAGGAAACTAACGCATCAGCCCCAGCATTTT	CARKLTHQPQHF	TRBV6-4	TRBJ1-5
TGCAGTCCCGGGGGGCCTTTCTCCTACAATGAGCAGTTCTTC	CSPGGPFSYNEQFF	TRBV20-1	TRBJ2-1
TGTGCCAGCACGCCAGGGAACACTGAAGCTTTCTTT	CASTPGNTEAFF	TRBV12-3	TRBJ1-1
TGTGCCAGCAGTTATAGCGTGGGTTTCACAGATACGCAGTATTTT	CASSYSVGFTDTQYF	TRBV6-5	TRBJ2-3
TGTGCCAGCAGCTCCCGGGGGAACACTGAAGCTTTCTTT	CASSSRGNTEAFF	TRBV11-2	TRBJ1-1
TGTGCTAGTGGTTTGCGGACAGAACAGCCCCAGCATTTT	CASGLRTEQPQHF	TRBV12-5	TRBJ1-5
TGCGCCAGCAGCTTGAGGGCCGGGACTAGCGGGAGGACTTGGTACGAGCAGTACTTC	CASSLRAGTSGRTWYEQYF	TRBV5-1	TRBJ2-7
TGTGCCAGCAGCTTGGTGTTAGGGAGAGGCTCCTACGAGCAGTACTTC	CASSLVLGRGSYEQYF	TRBV5-4	TRBJ2-7
TGCGCCTCAGATCTGAGGGACAGGGCCTACAATCAGCCCCAGCATTTT	CASDLRDRAYNQPQHF	TRBV4-3	TRBJ1-5
TGTGCTAGTGGTTCGAAGCTCGGGGGACGGACTGAAGCTTTCTTT	CASGSKLGGRTEAFF	TRBV12-5	TRBJ1-1
TGTGCCAGCAGAGCGGAGGTGGACATTCAGTACTTC	CASRAEVDIQYF	TRBV2	TRBJ2-4
TGTGCCACCAGTGATTCGGATCAGGGGGGGGGAAACACCATATATTTT	CATSDSDQGGGNTIYF	TRBV24-1	TRBJ1-3
TGTGCCACACCAGGGTGGCGCTCCTACGAGCAGTACTTC	CATPGWRSYEQYF	TRBV24-1	TRBJ2-7
TGCAGTGCTAGAGACTCCCGGTTCCTAGCGGGAGGAAAGAACACTGAAGCTTTCTTT	CSARDSRFLAGGKNTEAFF	TRBV20-1	TRBJ1-1
TGTGCCAGCGCTAAGCGAGGGGGAAAGGGCCTTCATGGCTACACCTTC	CASAKRGGKGLHGYTF	TRBV9	TRBJ1-2
TGTGCCAGCAGTTTTTCGGAACCGGACAGGGCTGGAAACACCATATATTTT	CASSFSEPDRAGNTIYF	TRBV28	TRBJ1-3
TGTGCCAGCAGCCCTACAGGGGGCGAGACCCAGTACTTC	CASSPTGGETQYF	TRBV7-9	TRBJ2-5
TGTGCCAGCAGCTGGGGGAGTACAGCCAGCTACGAGCAGTACTTC	CASSWGSTASYEQYF	TRBV5-5	TRBJ2-7
TGCAGTGCCCAGTCTCCTGGCTACACCTTC	CSAQSPGYTF	TRBV20-1	TRBJ1-2
TGCGCCAGCAGCTTGGCCCACAGAACGGTAAATGAGCAGTTCTTC	CASSLAHRTVNEQFF	TRBV5-1	TRBJ2-1
TGTGCCAGCAGTGAGTGGCACAGGGGATTCTCCTCCTACGAGCAGTACTTC	CASSEWHRGFSSYEQYF	TRBV6-4	TRBJ2-7
TGTGCCAGCGGACAGGGTACTGAAGCTTTCTTT	CASGQGTEAFF	TRBV27	TRBJ1-1
TGTGCCAGCAGACTCCTAGCGGGTCTAGATACGCAGTATTTT	CASRLLAGLDTQYF	TRBV11-2	TRBJ2-3
TGTGCCAGCAGTCATAGGGGATGGGGGACCTATGGCTACACCTTC	CASSHRGWGTYGYTF	TRBV25-1	TRBJ1-2
TGTGCCAGCAGAGTCCCAGAGATACCAGAGATCATGTATGAAGCTTTCTTT	CASRVPEIPEIMYEAFF	TRBV6-1	TRBJ1-1
TGTGCCACCAGTGCAGACAGGATCTCCTACAATGAGCAGTTCTTC	CATSADRISYNEQFF	TRBV24-1	TRBJ2-1
TGTGCCAGCAGCTTAGAGGAGGGAACCAAAGAGACCCAGTACTTC	CASSLEEGTKETQYF	TRBV7-2	TRBJ2-5
TGTGCCAGCAGGCCCGCAGGGTTCACGGGGGACACATCTGAGACCCAGTACTTC	CASRPAGFTGDTSETQYF	TRBV2	TRBJ2-5
TGTGCCAGCAGTTTCGGGACAGGGGGCAACACCATATATTTT	CASSFGTGGNTIYF	TRBV28	TRBJ1-3
TGTGCCAGCAGTGAAGGGGCCGCTAACTATGGCTACACCTTC	CASSEGAANYGYTF	TRBV25-1	TRBJ1-2
TGTGCCAGCAGTGAAATTGGGGGGCCCCCGGACAGTTTAATTAGCTCCTACAATGAGCAGTTCTTC	CASSEIGGPPDSLISSYNEQFF	TRBV6-1	TRBJ2-1
TGTGCCAGCACGAGGTCCACAGATACGCAGTATTTT	CASTRSTDTQYF	TRBV6-1	TRBJ2-3
TGTGCCAGCAGCCCTAGGGATAGAAGGAGCGAGCAGTACTTC	CASSPRDRRSEQYF	TRBV5-6	TRBJ2-7
TGTGCCAGCAGTTTAGGGTATCCTAGCGGAAGTAATAGCACAGATACGCAGTATTTT	CASSLGYPSGSNSTDTQYF	TRBV27	TRBJ2-3
TGTGCCAGCAGTGCAGGACTAGCGGGCACAGATACGCAGTATTTT	CASSAGLAGTDTQYF	TRBV28	TRBJ2-3
TGTGCCAGCAGCCAAGATGGCGAGGGGAAGGCCAATGAGCAGTTCTTC	CASSQDGEGKANEQFF	TRBV3-1	TRBJ2-1
TGTGCCAGCAGCTTGAAGGGGACCACTGAAGCTTTCTTT	CASSLKGTTEAFF	TRBV11-2	TRBJ1-1
TGTGCCATCAGTGAGAAGTCACAAGGCACCCTCCCTAATGAAAAACTGTTTTTT	CAISEKSQGTLPNEKLFF	TRBV10-3	TRBJ1-4
TGTGCCCGGCATGGGAATCAGCCCCAGCATTTT	CARHGNQPQHF	TRBV19	TRBJ1-5
TGTGCCAGCAGCGGTTCCCCAGGGGGCAATCAGCCCCAGCATTTT	CASSGSPGGNQPQHF	TRBV11-3	TRBJ1-5
TGCAGTGCTGTTCATGACAGGGTTCGTAAGAACACTGAAGCTTTCTTT	CSAVHDRVRKNTEAFF	TRBV20-1	TRBJ1-1
TGTGCCAGCAGCCGACACGTGAAGAACGGACAAAACTATGGCTACACCTTC	CASSRHVKNGQNYGYTF	TRBV5-6	TRBJ1-2
TGTGCCAGAAACAGGGAGGCGATTGAAGCTTTCTTT	CARNREAIEAFF	TRBV14	TRBJ1-1
TGCGCCAGCAAGTTTAGGACATACTCCTACAATGAGCAGTTCTTC	CASKFRTYSYNEQFF	TRBV10-2	TRBJ2-1
TGCGCCAGCAGCGATGGCACGGGGCAGTATAGCAATCAGCCCCAGCATTTT	CASSDGTGQYSNQPQHF	TRBV10-1	TRBJ1-5
TGTGCCAGCAGCCCAGATCCCCGAAACACCATATATTTT	CASSPDPRNTIYF	TRBV7-3	TRBJ1-3
TGTGCCAGCAGCCCCAGGGGGGCTACTGGAAACACCATATATTTT	CASSPRGATGNTIYF	TRBV7-3	TRBJ1-3
TGCGCCAGCAGCCAAGATGGCCTCACTAGCGGGGAGACCCAGTACTTC	CASSQDGLTSGETQYF	TRBV4-3	TRBJ2-5
TGTGCCAGCAGTTTTTTCCTGCGGGAGGACGAGCAGTACTTC	CASSFFLREDEQYF	TRBV6-2	TRBJ2-7
TGCAGCGTTGGAGGCAACGAGACCCAGTACTTC	CSVGGNETQYF	TRBV29-1	TRBJ2-5
TGTGCCAAGGGGGGAGGAACGGGGCAGTTCTTC	CAKGGGTGQFF	TRBV5-8	TRBJ2-1
TGTGCCAGCAGCTTGGCCAGACGGAACACTGAAGCTTTCTTT	CASSLARRNTEAFF	TRBV5-6	TRBJ1-1
TGTGCCAGCAGCCTGAGGCGGGAGTGGAGACGGAGTTGCACAGATACGCAGTATTTT	CASSLRREWRRSCTDTQYF	TRBV7-3	TRBJ2-3
TGTGCCAGCAGCTTACACCGACAGGGATTAGGGGTAGAGACCCAGTACTTC	CASSLHRQGLGVETQYF	TRBV11-2	TRBJ2-5
TGTGCCAGCAGCCAACTCCCGGGAGGGCCAGGTCAACTCACAGATACGCAGTATTTT	CASSQLPGGPGQLTDTQYF	TRBV14	TRBJ2-3
TGTGCCAGCAGCTTGCCGGGCCCGTACATTCAGTACTTC	CASSLPGPYIQYF	TRBV5-6	TRBJ2-4
TGTGCCAGCTCACCCTACACTGATCAGCCCCAGCATTTT	CASSPYTDQPQHF	TRBV18	TRBJ1-5
TGTGCCAGCAGGAGGACAGGGGGGGTAGTGTCTGAAGCTTTCTTT	CASRRTGGVVSEAFF	TRBV6-4	TRBJ1-1
TGCGCCAGCAGCTTGGTTTCAGGGGCCTCCCACCAGCCCCAGCATTTT	CASSLVSGASHQPQHF	TRBV5-1	TRBJ1-5
TGTGCCAGCCCCAAGAGGACTAGCGGGGCAGTAAGCACAGATACGCAGTATTTT	CASPKRTSGAVSTDTQYF	TRBV27	TRBJ2-3
TGTGCCAGCAGAGTAAAAGCCCGACAGGGCCGATCCTACAATGAGCAGTTCTTC	CASRVKARQGRSYNEQFF	TRBV12-3	TRBJ2-1
TGTGCCAGTAGTATTCCCAATTTGAGGGTCTTCGAGCAGTACTTC	CASSIPNLRVFEQYF	TRBV19	TRBJ2-7
TGTGCCAGCAGTTTCGTGTTTCGACCCTGGGACAGCTATGGCTACACCTTC	CASSFVFRPWDSYGYTF	TRBV12-3	TRBJ1-2
TGTGCCAGCAGCCCAGGGTCTTACGAGCAGTACTTC	CASSPGSYEQYF	TRBV7-9	TRBJ2-7
TGTGCCAGCAGCCAAGGGCTTCCTCATACCTACAATGAGCAGTTCTTC	CASSQGLPHTYNEQFF	TRBV4-2	TRBJ2-1
TGTGCCAGCAGCGGACGCTACGAGCAGTACTTC	CASSGRYEQYF	TRBV3-1	TRBJ2-7
TGTGCCAGCAGCCCCCCAGCGGGAAACTATGGCTACACCTTC	CASSPPAGNYGYTF	TRBV3-1	TRBJ1-2
TGTGCCAGCAGTTTACTAGTCGGACAGGGCTCGAGGGTCTCTGAAGCTTTCTTT	CASSLLVGQGSRVSEAFF	TRBV27	TRBJ1-1
TGTGCCAGCAGCTTGGAACGACATGTCCGGACTAGCGGGGTCACTTATGAGCAGTTCTTC	CASSLERHVRTSGVTYEQFF	TRBV5-4	TRBJ2-1
TGCGCCAGCAGTGAGCCCAGCAGGGACTTCTGCCAAGAGACCCAGTACTTC	CASSEPSRDFCQETQYF	TRBV10-1	TRBJ2-5
TGTGCCAGCAGCTTAGGGAGGGGAAGGTCCAATGAGCAGTTCTTC	CASSLGRGRSNEQFF	TRBV7-9	TRBJ2-1
TGTGCCAGCAGCAGCGGGGCGGACGAGCAGTACTTC	CASSSGADEQYF	TRBV9	TRBJ2-7
TGTGCCAGCAGCTCGGGACTAGCAGGCCAAGAGACCCAGTACTTC	CASSSGLAGQETQYF	TRBV7-3	TRBJ2-5
TGTGCCCCCCGGGACGCCCGCGAAGCCTACGAGCAGTACTTC	CAPRDAREAYEQYF	TRBV30	TRBJ2-7
TGCAGTGCTAGAGTACATACGCAGTATTTT	CSARVHTQYF	TRBV20-1	TRBJ2-3
TGTGCCAGCAGTAATGGGTCTAAGGGGAATGGCTACACCTTC	CASSNGSKGNGYTF	TRBV12-3	TRBJ1-2
TGTGCCAGCAGCCAAGAGCCCCCGGGCTTTAGGACGCTAGCCAAAAACATTCAGTACTTC	CASSQEPPGFRTLAKNIQYF	TRBV14	TRBJ2-4
TGTGCCAGCAGCGGTCCTGGACAGGGGTGGCCTAGCACAGATACGCAGTATTTT	CASSGPGQGWPSTDTQYF	TRBV7-3	TRBJ2-3
TGTGCCAGCAGCAGACTAGCGGGGGTAACGTCCTACGAGCAGTACTTC	CASSRLAGVTSYEQYF	TRBV7-2	TRBJ2-7
TGTGCCAGCAGCCCCCCCCTCATAATAACTAATGGCTACACCTTC	CASSPPLIITNGYTF	TRBV7-3	TRBJ1-2
TGTGCCACCAGTTCCGGGATAGGAATCCGGTACGAGCAGTACTTC	CATSSGIGIRYEQYF	TRBV24-1	TRBJ2-7
TGTGCCAGCAGCGCCGGCGCCGGGGAACTACGACTAGCGGGAAGGCCGACCCAGTACTTC	CASSAGAGELRLAGRPTQYF	TRBV9	TRBJ2-5
TGTGCCAGCAGCGCGAGACTAGCGGGGGGATGCTACGAGCAGTACTTC	CASSARLAGGCYEQYF	TRBV13	TRBJ2-7
TGTGCCACCAGCAGAGATCCCCCAAAACTAGCGGGAGTCCCGGGGGAAGATACGCAGTATTTT	CATSRDPPKLAGVPGEDTQYF	TRBV15	TRBJ2-3
TGTGCCAGCAGCAGAAAAATACCGGGACGCCACAACGAGCAGTACTTC	CASSRKIPGRHNEQYF	TRBV7-7	TRBJ2-7
TGTGCCACCACCACGGCGTCCCAGCATTTT	CATTTASQHF	TRBV24-1	TRBJ1-5
TGTGCCAGCAGTTTACCCAGGGGAGGGCATGGCTACACCTTC	CASSLPRGGHGYTF	TRBV27	TRBJ1-2
TGTGCCAGCAGTCCCGCTGCGGGGGGTTTTGATGAGCAGTTCTTC	CASSPAAGGFDEQFF	TRBV28	TRBJ2-1
TGTGCCAGCAGCCAGGAGGCCGACAGGGGACCCAATCAGCCCCAGCATTTT	CASSQEADRGPNQPQHF	TRBV9	TRBJ1-5
TGTGCCAGCTCTTTAGGACTAGCGGGGGGGCCGCCGACTGAGACCCAGTACTTC	CASSLGLAGGPPTETQYF	TRBV5-8	TRBJ2-5
TGTGCCAGCAGTCCCCTGGTGGACAGGGCCCCCCCGGGCTCTGGGGCCAACGTCCTGACTTTC	CASSPLVDRAPPGSGANVLTF	TRBV2	TRBJ2-6
TGTGCCAGCAAAATCTCGAGGGACAGCTCGACCGGGGAGCTGTTTTTT	CASKISRDSSTGELFF	TRBV7-6	TRBJ2-2
TGTGCTAGTGGTTTGGTATCCCCTAGAGGATCCTACGAGCAGTACTTC	CASGLVSPRGSYEQYF	TRBV12-5	TRBJ2-7
TGTGCGGGGATCCGGGACAGGGCTAAAACAGATACGCAGTATTTT	CAGIRDRAKTDTQYF	TRBV28	TRBJ2-3
TGTGCCAGTAGTCGACCAGGGGGTGGGGGGCCCCAGCATTTT	CASSRPGGGGPQHF	TRBV19	TRBJ1-5
TGTGCCAGCAGCGCCCCCTGCCGGGACAGTGGGGAAGAGGGGACCAAACTGTTGAACACTGAAGCTTTCTTT	CASSAPCRDSGEEGTKLLNTEAFF	TRBV9	TRBJ1-1
TGTGCCTGGAGAAATAGGCATACAGGGAGGCATTTTGAAGCTTTCTTT	CAWRNRHTGRHFEAFF	TRBV30	TRBJ1-1
TGTGCCAGCAATCTGGCAGAGTGGAGAACCCAGTACTTC	CASNLAEWRTQYF	TRBV6-5	TRBJ2-5
TGTGCCAGCAGTGAATACACAACGGCGGGACAGGGCGCTTTTACCCAGCATTTT	CASSEYTTAGQGAFTQHF	TRBV25-1	TRBJ1-5
TGTGCCAGCAGTCAGGGGGGGGGGCGCGAGCAGTACTTC	CASSQGGGREQYF	TRBV27	TRBJ2-7
TGTGCCAGCCCGGCAGTTAAGTGCCAGCAAGAGACCCAGTACTTC	CASPAVKCQQETQYF	TRBV6-5	TRBJ2-5
TGTGCCAGCAGCCACGGGCTCCCTAGGGGGGATGAGCAGTTCTTC	CASSHGLPRGDEQFF	TRBV4-2	TRBJ2-1
TGTGCCAGAACCCTCCGGGACAATGGAAGGGGCTCTGGAAACACCATATATTTT	CARTLRDNGRGSGNTIYF	TRBV28	TRBJ1-3
TGTGCCAGTAGTAGAAGGGGCGGACAGGCCTACGAGCAGTACTTC	CASSRRGGQAYEQYF	TRBV19	TRBJ2-7
TGTGCCAGCACCGGGGGGGCCGCCCTCTCCTACGAGCAGTACTTC	CASTGGAALSYEQYF	TRBV25-1	TRBJ2-7
TGTGCCAGCAGTTTGGGGACAGGGGTTACTGAAGCTTTCTTT	CASSLGTGVTEAFF	TRBV28	TRBJ1-1
TGCGCCAGCGGGGCTTTCGAGCAGTACTTC	CASGAFEQYF	TRBV5-1	TRBJ2-7
TGCGCCAGCAGCCAAGGGGGGGGAGAGTACGGCTACACCTTC	CASSQGGGEYGYTF	TRBV4-1	TRBJ1-2
TGTGCCAGCAGCGATCGCGAGCCCCAGCATTTT	CASSDREPQHF	TRBV5-6	TRBJ1-5
TGTGCCAGCAGCGCCCCCCACTCCTCCTCCGGGGGACCTGAGACCCAGTACTTC	CASSAPHSSSGGPETQYF	TRBV11-1	TRBJ2-5
TGTGCCAGCAGCTTAGATCGAGCAGGTCCCTACTATGGCTACACCTTC	CASSLDRAGPYYGYTF	TRBV11-2	TRBJ1-2
TGTGCCAGCAGCGTGCGATTGAGGGGGGCCAAAAACATTCAGTACTTC	CASSVRLRGAKNIQYF	TRBV9	TRBJ2-4
TGTGCATATCCCCTGAGGCAGCCCCAGCATTTT	CAYPLRQPQHF	TRBV24-1	TRBJ1-5
TGTGCCAGCAGTTACCAGGGTGGAAACAATGAGCAGTTCTTC	CASSYQGGNNEQFF	TRBV6-5	TRBJ2-1
TGTGCCAGCAGCTTATCCGGGACATTAGCTGGAAACACCATATATTTT	CASSLSGTLAGNTIYF	TRBV7-6	TRBJ1-3
TGTGCCAGCACGTTCCTCCGGAAACCTAATGAAAAACTGTTTTTT	CASTFLRKPNEKLFF	TRBV27	TRBJ1-4
TGTGCCAGCAGTTCACATGAGGAAAGATCGCAGCCCCAGCATTTT	CASSSHEERSQPQHF	TRBV6-5	TRBJ1-5
TGTGCCAGCCTAGGCCCGGGACAGGGACCTAATTCACCCCTCCACTTT	CASLGPGQGPNSPLHF	TRBV5-6	TRBJ1-6
TGTGCCAGCAGCTTTCCCCCGGGGGGGGATGAGCAGTTCTTC	CASSFPPGGDEQFF	TRBV7-9	TRBJ2-1
TGTGCCAGCAGCCCTACGGTGGAGCAGTACTTC	CASSPTVEQYF	TRBV6-8	TRBJ2-7
TGTGCCAGCAGCGGCCCCAGCTCCTACGAGCAGTACTTC	CASSGPSSYEQYF	TRBV7-9	TRBJ2-7
TGTGCCACCAGTGATCTTTTCAGCCTGGGGCATCAGCCCCAGCATTTT	CATSDLFSLGHQPQHF	TRBV24-1	TRBJ1-5
TGCAGTGCTGGCTGTACTCACTGTCCAGACAATAGGGGAGCGCTCAATGAGCAGTTCTTC	CSAGCTHCPDNRGALNEQFF	TRBV20-1	TRBJ2-1
TGTGCCAGCAGTATAGAACACGGTGGCAATCAGCCCCAGCATTTT	CASSIEHGGNQPQHF	TRBV6-3	TRBJ1-5
TGTGCCAGCAGCCAAATAGGGCTGCAGCCCCAGCATTTT	CASSQIGLQPQHF	TRBV3-1	TRBJ1-5
TGCGCCAGCAGTGGTCCATACATCGAAACACCAGGGGCACCAATGGATCAGCCCCAGCATTTT	CASSGPYIETPGAPMDQPQHF	TRBV10-1	TRBJ1-5
TGTGCCAGTACTGGGACAGGGGGGGGCTACGAGCAGTACTTC	CASTGTGGGYEQYF	TRBV7-2	TRBJ2-7
TGTGCCAGCAGCTTAGGAGTCTCTGAGCAGTTCTTC	CASSLGVSEQFF	TRBV7-2	TRBJ2-1
TGTGCCAGCAGCGGCCGGGCGCCTTACAATGAGCAGTTCTTC	CASSGRAPYNEQFF	TRBV7-9	TRBJ2-1
TGCAGCGTTGATTCCACTGAGGTCTACGAGCAGTACTTC	CSVDSTEVYEQYF	TRBV29-1	TRBJ2-7
TGTGCTAGCAGCTCGGATAACACCGGGGAGCTGTTTTTT	CASSSDNTGELFF	TRBV7-7	TRBJ2-2
TGCGCCAGCAGCTTGAACGGGGGGGTCGACTACGAGCAGTACTTC	CASSLNGGVDYEQYF	TRBV5-1	TRBJ2-7
TGCAGTGCTTCATTGACTGACAGGGCGGGCCCGTTCCTGACTGAAGCTTTCTTT	CSASLTDRAGPFLTEAFF	TRBV20-1	TRBJ1-1
TGTGCTAGTGGTTTGGGGTCGGGGGCCGGGGCTAATGAAAAACTGTTTTTT	CASGLGSGAGANEKLFF	TRBV12-5	TRBJ1-4
TGTGCCAGCAAACAGGGACAGGGGTGTGATCAGCCCCAGCATTTT	CASKQGQGCDQPQHF	TRBV9	TRBJ1-5
TGTGCCTGGAGTGTGGCGGTGGGAGGGTTGGTTCCGGCCTACGAGCAGTACTTC	CAWSVAVGGLVPAYEQYF	TRBV30	TRBJ2-7
TGTGCCAGCAGTGTGCCGGGACAGCAGAACACTGAAGCTTTCTTT	CASSVPGQQNTEAFF	TRBV9	TRBJ1-1
TGTGCCAGCAGCTTAGGCCTAAGCGGATCCACCGGGGAGCTGTTTTTT	CASSLGLSGSTGELFF	TRBV13	TRBJ2-2
TGTGCCAGCTCGTGGAGGGGCGGAGTTACAACGAAAGGCTACACCTTC	CASSWRGGVTTKGYTF	TRBV18	TRBJ1-2
TGCAGCGTTGATGGGGGAACCGGGACAGTCTACGAGCAGTACTTC	CSVDGGTGTVYEQYF	TRBV29-1	TRBJ2-7
TGTGCCAGCAGACACCCCGGGACAGGTCAGCCCCAGCATTTT	CASRHPGTGQPQHF	TRBV12-3	TRBJ1-5
TGCGCCAGCAGCCAGTGTGGGGTGGATGAGACCCAGTACTTC	CASSQCGVDETQYF	TRBV4-1	TRBJ2-5
TGCAGTGCTAGAGATCGTAAAGGAGGACCGAATGTGTACCAAGAGACCCAGTACTTC	CSARDRKGGPNVYQETQYF	TRBV20-1	TRBJ2-5
TGCGCCAGCAGCTTCAGGGGGTGGTTTTGGAACACCGGGGAGCTGTTTTTT	CASSFRGWFWNTGELFF	TRBV5-1	TRBJ2-2
TGTGCCAGCAGAGGGCATGGGAGAGGTGAAAAACTGTTTTTT	CASRGHGRGEKLFF	TRBV11-2	TRBJ1-4
TGTGCCAGTAGTATACGTCTCTCGTACAATGAGCAGTTCTTC	CASSIRLSYNEQFF	TRBV19	TRBJ2-1
TGTGCCAGCAGCCAACCCGAGGGGGCTTCGGGAAATGAGCAGTTCTTC	CASSQPEGASGNEQFF	TRBV4-2	TRBJ2-1
TGTGCCAGCAGAGTGAGACGGAACTATGGCTACACCTTC	CASRVRRNYGYTF	TRBV6-1	TRBJ1-2
TGTGCCAGCAGCTTCTACCGGCGGGAGGGGAAGTACGAGCAGTACTTC	CASSFYRREGKYEQYF	TRBV7-4	TRBJ2-7
TGCGCCAGCAGCTTGGGTGGGGACAGCGATCAGCCCCAGCATTTT	CASSLGGDSDQPQHF	TRBV5-1	TRBJ1-5
TGTGCCAGCAGTTATGGACAGGGAGGCACTGAAGCTTTCTTT	CASSYGQGGTEAFF	TRBV6-5	TRBJ1-1
TGTGCCAGCAGCTTGGAGGGACTAGCGGTGTTGACTTATGAGCAGTTCTTC	CASSLEGLAVLTYEQFF	TRBV11-2	TRBJ2-1
TGTGCCAGCAGCTTGCCAGGGACTGAAGCTTTCTTT	CASSLPGTEAFF	TRBV5-5	TRBJ1-1
TGCGCCAGCGGGGGGCGTGGGACGACCGAGCAGTACTTC	CASGGRGTTEQYF	TRBV5-1	TRBJ2-7
TGTGCCAGCAGCCCCGTAGACAGGGGTTCCCGGGAGCAGTACTTC	CASSPVDRGSREQYF	TRBV5-4	TRBJ2-7
TGTGCCAGCAGTGGACAGGTAAACGAGCAGTACTTC	CASSGQVNEQYF	TRBV6-5	TRBJ2-7
TGTGCCAGCGAAGGCGGCACTGAAGCTTTCTTT	CASEGGTEAFF	TRBV6-5	TRBJ1-1
TGCAGTGCTAGACCTAGGGGCTCCTTCGATACGCAGTATTTT	CSARPRGSFDTQYF	TRBV20-1	TRBJ2-3
TGTGCCTGGAGGTCCGGGGGGGCCAATTCACCCCTCCACTTT	CAWRSGGANSPLHF	TRBV30	TRBJ1-6
TGTGCCAGCACCAAAGAGTTAACCAGGGGATCATTTGGAGACACCGGGGAGCTGTTTTTT	CASTKELTRGSFGDTGELFF	TRBV6-1	TRBJ2-2
TGTGCCAGCAGTTTACCCAGGGGTTACATTCAGTACTTC	CASSLPRGYIQYF	TRBV28	TRBJ2-4
TGTGCCTGGACGGGACTAGCGGGATTTAGGTCCTACAATGAGCAGTTCTTC	CAWTGLAGFRSYNEQFF	TRBV30	TRBJ2-1
TGTGCCTGGAGCGGGAGGGGGCATGAGCAGTTCTTC	CAWSGRGHEQFF	TRBV30	TRBJ2-1
TGTGCCAGCAGTTACGCTCGGACAGGCCGAACCGAGCAGTACTTC	CASSYARTGRTEQYF	TRBV6-5	TRBJ2-7
TGTGCCAGCAGCTTAGGACAGGGTGGAAACACCATATATTTT	CASSLGQGGNTIYF	TRBV7-8	TRBJ1-3
TGTGCCTCGTGGACAAGCTCTGGAAACACCATATATTTT	CASWTSSGNTIYF	TRBV30	TRBJ1-3
TGCAGTGCTAGACTCGAGGGCATGACCCGGGCAGATACGCAGTATTTT	CSARLEGMTRADTQYF	TRBV20-1	TRBJ2-3
TGTGAAACAGTACGCGACACCATATATTTT	CETVRDTIYF	TRBV6-1	TRBJ1-3
TGTGCCAGCAGTTTACACCGCAGCCTGAATAACTATGGCTACACCTTC	CASSLHRSLNNYGYTF	TRBV27	TRBJ1-2
TGTGCCATCAGAGGACAGTATAATTCACCCCTCCACTTT	CAIRGQYNSPLHF	TRBV10-3	TRBJ1-6
TGTGCCACCAGACGGACAGGCGATACGCAGTATTTT	CATRRTGDTQYF	TRBV24-1	TRBJ2-3
TGTGCCAGCAGCCCGGGACCCCGGGACAGGAGCTACGAGCAGTACTTC	CASSPGPRDRSYEQYF	TRBV7-2	TRBJ2-7
TGTGCCAGCTCACATCCTAGGGACTACGTCGCCTACGAGCAGTACTTC	CASSHPRDYVAYEQYF	TRBV18	TRBJ2-7
TGCGCCAGCAACCCGTTCGAACTTGACCTCAATCAGCCCCAGCATTTT	CASNPFELDLNQPQHF	TRBV5-1	TRBJ1-5
TGTGCCAAACGATCAGGACGGAAGAACACTGAAGCTTTCTTT	CAKRSGRKNTEAFF	TRBV27	TRBJ1-1
TGTGCCAGCAGCAACAGACTGGGGACGACAAGCTCTGGAAACACCATATATTTT	CASSNRLGTTSSGNTIYF	TRBV11-1	TRBJ1-3
TGTGCCAGCAGGGCGAAAAGCAATCAGCCCCAGCATTTT	CASRAKSNQPQHF	TRBV5-8	TRBJ1-5
TGTGCCAGCAGCCCGGGACAGGCCTGGTCTTTCGACACTGAAGCTTTCTTT	CASSPGQAWSFDTEAFF	TRBV7-4	TRBJ1-1
TGTGCCAGCAGTTCAACCTCGACAGGGCCGAAAATATCCTACGAGCAGTACTTC	CASSSTSTGPKISYEQYF	TRBV28	TRBJ2-7
TGTGCCACCAGTGTCAATTCTAGCGGAAAGTTATTGTACAATGAGCAGTTCTTC	CATSVNSSGKLLYNEQFF	TRBV24-1	TRBJ2-1
TGTGCCAGCAGTGACACCGGGGGTCACACCTTC	CASSDTGGHTF	TRBV6-4	TRBJ1-2
TGTGCCAGCAGTGGCGGGACAGGGGGGGAGACAGTCGAATACGAGCAGTACTTC	CASSGGTGGETVEYEQYF	TRBV6-1	TRBJ2-7
TGTGCCAGCGTACACAGGGTTCCTTACTACGAGCAGTACTTC	CASVHRVPYYEQYF	TRBV5-6	TRBJ2-7
TGTGCCAGCAGCCAAGTAAGGGGAACAGGGTCGCTCGAGCAGTACTTC	CASSQVRGTGSLEQYF	TRBV4-2	TRBJ2-7
TGCGCCAGCAGCGGGACAGGGGGTAACTATGGCTACACCTTC	CASSGTGGNYGYTF	TRBV5-1	TRBJ1-2
TGCGCCAGCAGCCAAGAAGGAGGGTCCAGCAATCAGCCCCAGCATTTT	CASSQEGGSSNQPQHF	TRBV4-1	TRBJ1-5
TGTGCTAGCAGCTTACCTTCGACGGGGGTTACCGGGGAGCTGTTTTTT	CASSLPSTGVTGELFF	TRBV7-7	TRBJ2-2
TGTGCCAGCTCACTACTGGGGCTTCCTAGCGGGGGCACAGATACGCAGTATTTT	CASSLLGLPSGGTDTQYF	TRBV18	TRBJ2-3
TGTGCCAGCAGTTACGGGGGGACAGGGGGCCGCAATGAGCAGTTCTTC	CASSYGGTGGRNEQFF	TRBV6-3	TRBJ2-1
TGTGCCAGCAGCTTGGGGGGACTGGGCCTAGGGGAGCAGTACTTC	CASSLGGLGLGEQYF	TRBV5-4	TRBJ2-7
TGTGCCACCAGTGATTTGCCGGGACATTTGGTGAACACTGAAGCTTTCTTT	CATSDLPGHLVNTEAFF	TRBV24-1	TRBJ1-1
TGCAGTGCTTTCTCCCCTTATAACCCCCAGGGATGTGAAGGCACTGAAGCTTTCTTT	CSAFSPYNPQGCEGTEAFF	TRBV20-1	TRBJ1-1
TGTGCCAGCAGCTTTTCCCTTAAGGGACTGGGGGCGGGTAACTATGGCTACACCTTC	CASSFSLKGLGAGNYGYTF	TRBV7-3	TRBJ1-2
TGTGCCATTGGGGTAGGGGGATACGAGCAGTACTTC	CAIGVGGYEQYF	TRBV10-3	TRBJ2-7
TGTGACAGGGGGGGAACAGATACGCAGTATTTT	CDRGGTDTQYF	TRBV30	TRBJ2-3
TGTGCCAGAAGAAGACGCAAACCCAGGGATCAGCCCCAGCATTTT	CARRRRKPRDQPQHF	TRBV25-1	TRBJ1-5
TGTGCCATCAGTCCCCTTCCACAGGGACTCTCTGGGGCCAACGTCCTGACTTTC	CAISPLPQGLSGANVLTF	TRBV10-3	TRBJ2-6
TGTGCCTGGAGGCCCTCCAAGGGAAAGAGCAATCAGCCCCAGCATTTT	CAWRPSKGKSNQPQHF	TRBV30	TRBJ1-5
TGTGCCAGGCCTGAGGACAGGGGCTGCGGACATCAGCCCCAGCATTTT	CARPEDRGCGHQPQHF	TRBV27	TRBJ1-5
TGTGCCAGCAGCTTTTACAGGGCCCTCAATGAGCAGTTCTTC	CASSFYRALNEQFF	TRBV5-4	TRBJ2-1
TGTGCCAGCAGTTTTAGCATTTGGGGTGGAGAGACCCAGTACTTC	CASSFSIWGGETQYF	TRBV7-9	TRBJ2-5
TGTGCCAGCAGACGCCGGGACTCCATTGAAGAGACCCAGTACTTC	CASRRRDSIEETQYF	TRBV11-3	TRBJ2-5
TGTGCCAGCAGTGAGGAGGGGTGTCTGACGAACACCGGGGAGCTGTTTTTT	CASSEEGCLTNTGELFF	TRBV6-1	TRBJ2-2
TGTGCCAGTAGTATAGATCGGCGCGCGCCGGGACAGGGAGGAGGGCCCTCTGGAAACACCATATATTTT	CASSIDRRAPGQGGGPSGNTIYF	TRBV19	TRBJ1-3
TGTGCCAGCAGTTCGGCGGTCGAGCAGTACTTC	CASSSAVEQYF	TRBV6-6	TRBJ2-7
TGTGCGGGTGGCCTCACTTCACCCCTCCACTTT	CAGGLTSPLHF	TRBV6-5	TRBJ1-6
TGTGCCAGCTCCGGACAGTGCACTGAAGCTTTCTTT	CASSGQCTEAFF	TRBV18	TRBJ1-1
TGTGCCACCAGTGAGAGCAGCGCCAGAGGCGAGAAAGCTTTCTTT	CATSESSARGEKAFF	TRBV24-1	TRBJ1-1
TGTGCCAACTCCGAGACCACAGATACGCAGTATTTT	CANSETTDTQYF	TRBV5-5	TRBJ2-3
TGCGCCAGCAGGCTAGGGGGTCAAGAGACCCAGTACTTC	CASRLGGQETQYF	TRBV4-1	TRBJ2-5
TGTGCCAGGTTACAGGGGCAGTCCGGGGAGCTGTTTTTT	CARLQGQSGELFF	TRBV19	TRBJ2-2
TGTGCTAGTGGCAGATCCGGGTTCTTT	CASGRSGFF	TRBV12-5	TRBJ1-1
TGTGCCAGCAGTCGACTACAGGGGGAGCTCGGGGCCAACGTCCTGACTTTC	CASSRLQGELGANVLTF	TRBV27	TRBJ2-6
TGTGCCAGCAGCTTGGCCAATAGGGGAGGGACTAGCGGGGGGGGCTACGAGCAGTACTTC	CASSLANRGGTSGGGYEQYF	TRBV5-6	TRBJ2-7
TGTGCCAGCAGCTCCGGCTGGGACAATGAGCAGTTCTTC	CASSSGWDNEQFF	TRBV6-1	TRBJ2-1
TGTGCCTGGAGTGTACCGTTGCCCCAGGCTTGGTATAATTCACCCCTCCACTTT	CAWSVPLPQAWYNSPLHF	TRBV30	TRBJ1-6
TGTGCCAGCAGTCTATGGGGCGTGGTGGCCAATCAGCCCCAGCATTTT	CASSLWGVVANQPQHF	TRBV12-3	TRBJ1-5
TGTGCCAGCAGCCATTCCGGGACGGACGATCAGCCCCAGCATTTT	CASSHSGTDDQPQHF	TRBV13	TRBJ1-5
TGTGCCAGCAGTTACTCGATTCCGACTAGCGGGCCCGACTCCTACGAGCAGTACTTC	CASSYSIPTSGPDSYEQYF	TRBV6-3	TRBJ2-7
TGTGCCAGCAGCTTACCTAGCGGGGGAACCGGGGAGCTGTTTTTT	CASSLPSGGTGELFF	TRBV13	TRBJ2-2
TGCGCCAGCAGCTTACCCCGGGACAGGGCTTTCTTT	CASSLPRDRAFF	TRBV5-1	TRBJ1-1
TGTGCCAGCAGTTCGGAGGGGACAGATACGCAGTATTTT	CASSSEGTDTQYF	TRBV27	TRBJ2-3
TGTGCCAGCAGTGAAGCGGAACTCCGGAAGATCACTGAAGCTTTCTTT	CASSEAELRKITEAFF	TRBV2	TRBJ1-1
TGTGCCAGCTCAGGAGGACAGGGAAGAGTAACCGGGGAGCTGTTTTTT	CASSGGQGRVTGELFF	TRBV18	TRBJ2-2
TGTGCCAGCAGCACGTGGACGTCACACACCGGGGAGCTGTTTTTT	CASSTWTSHTGELFF	TRBV7-4	TRBJ2-2
TGTGCCACTATATCGGGCTACACCTTC	CATISGYTF	TRBV24-1	TRBJ1-2
TGTGCCAGCAGTGAACGGAGTCAGGGTACCCGGACCGGGGAGCTGTTTTTT	CASSERSQGTRTGELFF	TRBV2	TRBJ2-2
TGTGCCAGCGTAGGGGGAGAAGCTTTCTTT	CASVGGEAFF	TRBV6-4	TRBJ1-1
TGTGCCTGGAGTCACTGGGCAAGGCATGGCTACACCTTC	CAWSHWARHGYTF	TRBV30	TRBJ1-2
TGCGCCAGCAGCTTGGCGAAGACCGGCCAGCTACAAGAGACCCAGTACTTC	CASSLAKTGQLQETQYF	TRBV5-1	TRBJ2-5
TGTGCCAGCAGCAGGGCGTGTGGACAAGAAAATCAGCCCCAGCATTTT	CASSRACGQENQPQHF	TRBV7-3	TRBJ1-5
TGCAGTGCTAGACTACAGTACAACTTACTAGCGGGAGTGAACACTGAAGCTTTCTTT	CSARLQYNLLAGVNTEAFF	TRBV20-1	TRBJ1-1
TGCGCCAGCAGCTTGGTCCGGCCATGGACAGAGAGCTCCGGCTCCTACGAGCAGTACTTC	CASSLVRPWTESSGSYEQYF	TRBV5-1	TRBJ2-7
TGTGCCAGTTCCGGTACGGGCAGCCACGAGCAGTACTTC	CASSGTGSHEQYF	TRBV19	TRBJ2-7
TGCAGTGCTAGAGATGACTTCACCCAGGCCTACGAGCAGTACTTC	CSARDDFTQAYEQYF	TRBV20-1	TRBJ2-7
TGTGCCAGCAGCGTAGCCTCCTCAGGGCCTTCGGGGGAGCAGTTCTTC	CASSVASSGPSGEQFF	TRBV9	TRBJ2-1
TGTGCCAGCGGGCTGTTAGCGGGCAGCTACGAGCAGTACTTC	CASGLLAGSYEQYF	TRBV6-5	TRBJ2-7
TGCAGTGCTAGAGGAGGGGGGGGCATGCCCTACGAGCAGTACTTC	CSARGGGGMPYEQYF	TRBV20-1	TRBJ2-7
TGTGCCAGCAGAGTCCCAAGACAGGGGGTGACTTACGAGCAGTACTTC	CASRVPRQGVTYEQYF	TRBV6-5	TRBJ2-7
TGCGCCAGCAGCCAAGAGACATACAGGGTACGAGTCCTGGGCAATCAGCCCCAGCATTTT	CASSQETYRVRVLGNQPQHF	TRBV4-1	TRBJ1-5
TGTGCTAGTGGTTTGGCACGGTATACAGATACGCAGTATTTT	CASGLARYTDTQYF	TRBV12-5	TRBJ2-3
TGTGCCAGCAGCCTTGGGCGGGGCGGGTCACCCCTCCACTTT	CASSLGRGGSPLHF	TRBV7-2	TRBJ1-6
TGTGCCAGCAGCGCCGAGCATAAAGAAAAACTGTTTTTT	CASSAEHKEKLFF	TRBV7-9	TRBJ1-4
TGTGCCAGCAGCGTAGGGAGCTGCTGGTACAATGAGCAGTTCTTC	CASSVGSCWYNEQFF	TRBV9	TRBJ2-1
TGTGCCAGCCCTAGAGCGGGAGGTATCTACAATGAGCAGTTCTTC	CASPRAGGIYNEQFF	TRBV6-5	TRBJ2-1
TGTGCCAGCAGTTCGGGCCCTGAGCAGTTCTTC	CASSSGPEQFF	TRBV12-4	TRBJ2-1
TGTGCCAGCAGTGAACCTCAGGGGATGGGGCAAGAGACCCAGTACTTC	CASSEPQGMGQETQYF	TRBV6-1	TRBJ2-5
TGCAGCCCCATTCCAGCGGGGGAACAAGACCTTATAGAGCAGTTCTTC	CSPIPAGEQDLIEQFF	TRBV29-1	TRBJ2-1
TGTGCCAGCAGATGGAGCGCGGGGGGGGGTTCGGGCTATAGCAATCAGCCCCAGCATTTT	CASRWSAGGGSGYSNQPQHF	TRBV12-3	TRBJ1-5
TGTGCCAGCAGCCAAAATGGGTTACTGAACACTGAAGCTTTCTTT	CASSQNGLLNTEAFF	TRBV14	TRBJ1-1
TGTGCCAGCAGTGAAGGGCCGGGGACTTTCTTT	CASSEGPGTFF	TRBV2	TRBJ1-1
TGCAGTGCTCAAGGAAGGGACAGGCCTGATACGCAGTATTTT	CSAQGRDRPDTQYF	TRBV20-1	TRBJ2-3
TGTGCCAGCAGCCCGTGCCTCGCAACCCCTCTCAGGGCCAAAAACATTCAGTACTTC	CASSPCLATPLRAKNIQYF	TRBV13	TRBJ2-4
TGTGCCAGCAGCTTTCCGGGACTAGCGGGAGCGGGTACGAACACCGGGGAGCTGTTTTTT	CASSFPGLAGAGTNTGELFF	TRBV7-6	TRBJ2-2
TGTGCTAGTGGTTTGGTTCGCGGGGGGGGGCTAAATTGCTACGAGCAGTACTTC	CASGLVRGGGLNCYEQYF	TRBV12-5	TRBJ2-7
TGTGGTCACCCAGGGGACTACGAGCAGTACTTC	CGHPGDYEQYF	TRBV24-1	TRBJ2-7
TGCGCCAGCAGCCGGAGCCGACGGGGGCCCAACAATGAGCAGTTCTTC	CASSRSRRGPNNEQFF	TRBV5-1	TRBJ2-1
TGTGCCATCAGTGAGTATGGGCCATTTGGCTACACCTTC	CAISEYGPFGYTF	TRBV10-3	TRBJ1-2
TGTGCCAGCAGCTTAGTAAGGGGTTGGAACAATGAGCAGTTCTTC	CASSLVRGWNNEQFF	TRBV7-2	TRBJ2-1
TGTGCCAGCAAGGGCAATCAAGCTTTCTTT	CASKGNQAFF	TRBV25-1	TRBJ1-1
TGCGCCAGCAGAGGTCGTCCGGGACAGCACAATACGCAGTATTTT	CASRGRPGQHNTQYF	TRBV10-1	TRBJ2-3
TGCGCCAGCAGCCCCGGGAGTAGGGAGAGCTCCTACGAGCAGTACTTC	CASSPGSRESSYEQYF	TRBV5-1	TRBJ2-7
TGTGCCAGCAGTTACTCAGGTTTGGTTCAGGCAAAAGATCAGCCCCAGCATTTT	CASSYSGLVQAKDQPQHF	TRBV6-5	TRBJ1-5
TGTGCCAGCAGCGGGTATCTAGCGGGAGTCACCGGGGAGCTGTTTTTT	CASSGYLAGVTGELFF	TRBV27	TRBJ2-2
TGCGCCAGCCACGGACTAGCGGGTCTGTGCCACAATGAGCAGTTCTTC	CASHGLAGLCHNEQFF	TRBV5-1	TRBJ2-1
TGTGCCAGCAGTTTGGGTGAGAGTGAGGACACAGATACGCAGTATTTT	CASSLGESEDTDTQYF	TRBV27	TRBJ2-3
TGTGCCAGCAGTCGGACCCCCGTCGACGTTTTAGATACGCAGTATTTT	CASSRTPVDVLDTQYF	TRBV6-4	TRBJ2-3
TGCGCCAGCAGCACTTTAGGCCCAGTTGGGCAGACCCAGTACTTC	CASSTLGPVGQTQYF	TRBV5-1	TRBJ2-5
TGTGCCAGCAGCCGGGGCCTAGACCCCGAGCAGTACTTC	CASSRGLDPEQYF	TRBV7-9	TRBJ2-7
TGTGCCAGCTCTCTGGGTTACTATGGCTACACCTTC	CASSLGYYGYTF	TRBV18	TRBJ1-2
TGTGCCAGCAGCTATTCCGGGTCAGGGCCCATATATTTT	CASSYSGSGPIYF	TRBV7-9	TRBJ1-3
TGTGCCAGCAGCTTAGGGGGGAGGGAAGACGAGCAGTACTTC	CASSLGGREDEQYF	TRBV11-2	TRBJ2-7
TGTGCCAGCAGTGACTCGCCGACTAGCGGGTCTGGAGTTTACAATGAGCAGTTCTTC	CASSDSPTSGSGVYNEQFF	TRBV6-4	TRBJ2-1
TGTGCCAGCAGTCTACCCTCACCACGCTATGGCTACACCTTC	CASSLPSPRYGYTF	TRBV12-3	TRBJ1-2
TGTGCCAGCAGCTCGTCACAGAAGTCCTATAATTCACCCCTCCACTTT	CASSSSQKSYNSPLHF	TRBV7-2	TRBJ1-6
TGCGCCAGCAGCTTGTGTTGCACTAGCGACACCGGGGAGCTGTTTTTT	CASSLCCTSDTGELFF	TRBV5-1	TRBJ2-2
TGCGCCAGCAGCTTGGTCAGGGTTCAGCCCCAGCATTTT	CASSLVRVQPQHF	TRBV5-1	TRBJ1-5
TGCGCCAGCGCTGCAGACTATGGCTACACCTTC	CASAADYGYTF	TRBV5-1	TRBJ1-2
TGTGCCAGTAGTCCAAAAGAAGGGACAGGGGACTATGGCTACACCTTC	CASSPKEGTGDYGYTF	TRBV19	TRBJ1-2
TGTGCCAGCAGCTTGTGGGACCGGGACGATAACACCGGGGAGCTGTTTTTT	CASSLWDRDDNTGELFF	TRBV5-4	TRBJ2-2
TGCGCCAGCAGCTTGGGGACAGGTGAGGAAGAGACCCAGTACTTC	CASSLGTGEEETQYF	TRBV5-1	TRBJ2-5
TGTGCCAGCAGCGCTACTCCCGCGGGCCGGGACAGGGTTAGAGGAGCTTTCTTT	CASSATPAGRDRVRGAFF	TRBV5-6	TRBJ1-1
TGCGCCAGCAGCCAAATGGCCTTAAAAACTGAGCAGTTCTTC	CASSQMALKTEQFF	TRBV4-3	TRBJ2-1
TGTGCCAGCAGGGGCCGGGACAGGGGACATATAGTATGGGAAAAACTGTTTTTT	CASRGRDRGHIVWEKLFF	TRBV6-5	TRBJ1-4
TGTGCCAGCACCCCCCTGACTGAAGCTTTCTTT	CASTPLTEAFF	TRBV4-2	TRBJ1-1
TGCGCCATCAGGGGGCGAACGGGTGAGACCCAGTACTTC	CAIRGRTGETQYF	TRBV4-1	TRBJ2-5
TGTGCCAGCTCGAGTCCTAGGCAGAACAGGCCTAACTATGGCTACACCTTC	CASSSPRQNRPNYGYTF	TRBV2	TRBJ1-2
TGTGCCAGCAGCAGGGACAATGAGCAGTTCTTC	CASSRDNEQFF	TRBV5-4	TRBJ2-1
TGTGCCAGCAGAAAAGTAAGGGGAGGGGCCTACGAGCAGTACTTC	CASRKVRGGAYEQYF	TRBV7-2	TRBJ2-7
TGTGCCAGCAGTGGTCGCGGGAGGTCGGGACGCTACGAGCAGTACTTC	CASSGRGRSGRYEQYF	TRBV7-2	TRBJ2-7
TGTGCCACCGGGACAGGGTGGGAGACCCAGTACTTC	CATGTGWETQYF	TRBV7-9	TRBJ2-5
TGTGCCAGCAGCTTAGAATCAAGGGACAGGGCAGATGGCTACACCTTC	CASSLESRDRADGYTF	TRBV11-3	TRBJ1-2
TGCAGTGCTAGGTTGGACAACCGCTCAGGGTTTTACGTCGAGCAGTACTTC	CSARLDNRSGFYVEQYF	TRBV20-1	TRBJ2-7
TGCGCCAGCGTTAAAGACGAGCAGTACTTC	CASVKDEQYF	TRBV10-1	TRBJ2-7
TGTGCTTCCAGACAGGGCCGCCCCACTGAAGCTTTCTTT	CASRQGRPTEAFF	TRBV6-4	TRBJ1-1
TGTGCCAGCTCACCCTACCAGCATCGGCCAAACACCGGGGAGCTGTTTTTT	CASSPYQHRPNTGELFF	TRBV18	TRBJ2-2
TGTGCCATCAGTGCGACCCCACGCATTTTAAATCAGCCCCAGCATTTT	CAISATPRILNQPQHF	TRBV10-3	TRBJ1-5
TGTGCCAGCAGTTTGGGTCCTTCAAGGGGCTCCTACAATGAGCAGTTCTTC	CASSLGPSRGSYNEQFF	TRBV28	TRBJ2-1
TGCGCCAATGGGACAGGACGGGCCTACAATGAGCAGTTCTTC	CANGTGRAYNEQFF	TRBV10-2	TRBJ2-1
TGTGCCAGCAGCGCAAGGGAGGGAATGAACGAGCAGTACTTC	CASSAREGMNEQYF	TRBV7-9	TRBJ2-7
TGCAGTGCTGATGGGGGGACAGGCAGGACGGTCTCCTCTGGGGCCAACGTCCTGACTTTC	CSADGGTGRTVSSGANVLTF	TRBV20-1	TRBJ2-6
TGTGCCAGCAGCCAAGATTGGGGCGAAGAGACCCAGTACTTC	CASSQDWGEETQYF	TRBV3-1	TRBJ2-5
TGTCCAAAGTTCAGGACAGTCACCTCTGGGGCCAACGTCCTGACTTTC	CPKFRTVTSGANVLTF	TRBV29-1	TRBJ2-6
TGTGCCAGCAGTTTATTTTGGCCGCGGGAGACCGGGGAGCTGTTTTTT	CASSLFWPRETGELFF	TRBV5-4	TRBJ2-2
TGTGCCAGCAGCTTTGTCCCGGGACAGGGGGGGAGTAACTATGGCTACACCTTC	CASSFVPGQGGSNYGYTF	TRBV5-6	TRBJ1-2
TGCGCCAGAGAGTCAGGCCCCTACAATGAGCAGTTCTTC	CARESGPYNEQFF	TRBV5-1	TRBJ2-1
TGTGCCAGCAGCTGGACTAGCGGGGGGAATGAGCAGTTCTTC	CASSWTSGGNEQFF	TRBV7-8	TRBJ2-1
TGCAGTGCTAGAAACTTCGGGACTCAAACACAGCCCCAGCATTTT	CSARNFGTQTQPQHF	TRBV20-1	TRBJ1-5
TGCAGCGTGGAGAGCGGGAAAATCTACGAGCAGTACTTC	CSVESGKIYEQYF	TRBV29-1	TRBJ2-7
TGCGCCAGCCCTCCGACCGGGACAGGGTACGAGCAGTACTTC	CASPPTGTGYEQYF	TRBV10-2	TRBJ2-7
TGTGCCAGCAGCACGGACCCGGTTAATGAGCAGTTCTTC	CASSTDPVNEQFF	TRBV11-2	TRBJ2-1
TGCAGTGCTAGAGTGGACCTAAAGACAGGCAATCAGCCCCAGCATTTT	CSARVDLKTGNQPQHF	TRBV20-1	TRBJ1-5
TGCGCCAGCAGCCAAGGTTGGGGGGCCCAGAAGTTTCTTGGCTACACCTTC	CASSQGWGAQKFLGYTF	TRBV4-1	TRBJ1-2
TGTGCAGGTACGGGACAAAACGGAACTAATGAAAAACTGTTTTTT	CAGTGQNGTNEKLFF	TRBV9	TRBJ1-4
TGTGCCACCAGCCCACCGCTAATTGCGCGACTAAGCTATGGCTACACCTTC	CATSPPLIARLSYGYTF	TRBV24-1	TRBJ1-2
TGTGCCAGCAGCTTTCTGACTAGGAACTACGAGCAGTACTTC	CASSFLTRNYEQYF	TRBV5-4	TRBJ2-7
TGTGCCAGCAGCTTAGATATTGGGGTGGGGGCCAACGTCCTGACTTTC	CASSLDIGVGANVLTF	TRBV11-2	TRBJ2-6
TGTGCCAGCAAGCGGGAGTACAATGAGCAGTTCTTC	CASKREYNEQFF	TRBV27	TRBJ2-1
TGCGCCAGTTCGGACAGGGGGGACGAGCAGTACTTC	CASSDRGDEQYF	TRBV5-1	TRBJ2-7
TGTGCCAGCAGCCCGCATCGGGGGTGTCCAGAGACCCAGTACTTC	CASSPHRGCPETQYF	TRBV7-2	TRBJ2-5
TGTGCCAGCAGTCCCAGGGAAGAGACCCAGTACTTC	CASSPREETQYF	TRBV28	TRBJ2-5
TGCAGTGCCGCAGGTATATACGAGCAGTACTTC	CSAAGIYEQYF	TRBV20-1	TRBJ2-7
TGTGCCAGTACGGAGAGTTCACCCCTCCACTTT	CASTESSPLHF	TRBV19	TRBJ1-6
TGTGCCAGCACTCTCCAAGGGGAGCGCTATGGCTACACCTTC	CASTLQGERYGYTF	TRBV2	TRBJ1-2
TGTGCCAGCACGAGCCCGGGACAGGGATCGGGAGGCTACACCTTC	CASTSPGQGSGGYTF	TRBV6-5	TRBJ1-2
TGTGCCAGCAGCTCCGCCGGTAGCTCCTACGAGCAGTACTTC	CASSSAGSSYEQYF	TRBV7-3	TRBJ2-7
TGCAGTGCTAGAAAGGTAATGACTGCTAGCAATCAGCCCCAGCATTTT	CSARKVMTASNQPQHF	TRBV20-1	TRBJ1-5
TGTGCCAGCAAACCATATGGGAGTCGGGTCCAACGAAGACTAGCGGGCACAGATACGCAGTATTTT	CASKPYGSRVQRRLAGTDTQYF	TRBV6-2	TRBJ2-3
TGTGCCAGCTCCCGCGCTAGAGGTCGAGTTAACTATGAGCAGTTCTTC	CASSRARGRVNYEQFF	TRBV7-9	TRBJ2-1
TGTGCCACGGTACGTCCCTCCTACGAGCAGTACTTC	CATVRPSYEQYF	TRBV24-1	TRBJ2-7
TGCAGCATGGACAGGCCTCGGGACGGCCCCAACTATGGCTACACCTTC	CSMDRPRDGPNYGYTF	TRBV29-1	TRBJ1-2
TGCGCCAGCCGGACATGGACAGGGGACCCTGGCTACACCTTC	CASRTWTGDPGYTF	TRBV5-1	TRBJ1-2
TGTGCCATTCCGGACACTGAAGCTTTCTTT	CAIPDTEAFF	TRBV2	TRBJ1-1
TGCGCCAGCAGCTTGTATGACGAGCAGTACTTC	CASSLYDEQYF	TRBV5-1	TRBJ2-7
TGTGCCAGCAGCTTTAAAGGGCTTCCACGCACTGAAGCTTTCTTT	CASSFKGLPRTEAFF	TRBV11-2	TRBJ1-1
TGTGCCAGCAGCTTAGCTCCCGGACAGGAGTCCCAGGCCGGGGAGCTGTTTTTT	CASSLAPGQESQAGELFF	TRBV7-4	TRBJ2-2
TGTGCCAGGCAGGCCGGGACAGGTCGGCTAGCCAAAAACATTCAGTACTTC	CARQAGTGRLAKNIQYF	TRBV7-3	TRBJ2-4
TGCAGGCATGACGACAGAGGCGAGACCCAGTACTTC	CRHDDRGETQYF	TRBV20-1	TRBJ2-5
TGCGCCAGCAGGCCGGGGTCCTCACCCCTCCACTTT	CASRPGSSPLHF	TRBV10-1	TRBJ1-6
TGTGCCAGTTATCACCGGGACGCGGTTTACTATGGCTACACCTTC	CASYHRDAVYYGYTF	TRBV3-1	TRBJ1-2
TGTGCCAGCGTGGAGGTCTATGGCTACACCTTC	CASVEVYGYTF	TRBV6-2	TRBJ1-2
TGTGCCAGCAGCCATGGTCAGCGGGACAGGAACACTGAAGCTTTCTTT	CASSHGQRDRNTEAFF	TRBV7-6	TRBJ1-1
TGTGCCAGGAGAAGGACAGTATCTCGCGAGCAGTACTTC	CARRRTVSREQYF	TRBV27	TRBJ2-7
TGTGCCAGCAGGGGGGGTTGGGGGATTCGGTCCCCGACCCAGTACTTC	CASRGGWGIRSPTQYF	TRBV6-2	TRBJ2-5
TGTGCCAGCAGTTCCCGACAGGGGGGAGAGACCCAGTACTTC	CASSSRQGGETQYF	TRBV27	TRBJ2-5
TGTGCCAGCAGCCACGGACTCTACGAGCAGTACTTC	CASSHGLYEQYF	TRBV9	TRBJ2-7
TGTGCCTGGAGTGTACGTGGGACGGGAGGCTGGAATGGCTACACCTTC	CAWSVRGTGGWNGYTF	TRBV30	TRBJ1-2
TGTGCCAGCAGTTACTCGATTCTTACACGGGGGGGTCGGATCTGCGAGCAGTACTTC	CASSYSILTRGGRICEQYF	TRBV6-6	TRBJ2-7
TGTGCCAGCAGCCCTACTCGGGGTGACACCGGGGAGCTGTTTTTT	CASSPTRGDTGELFF	TRBV7-9	TRBJ2-2
TGCGCCATCCCCTCTAAGACGTACGAGCAGTACTTC	CAIPSKTYEQYF	TRBV10-1	TRBJ2-7
TGTGCCAGCAGGACAGCTGGCTATAATTCACCCCTCCACTTT	CASRTAGYNSPLHF	TRBV6-1	TRBJ1-6
TGTGCCAACGGGCTCCTAGATGAGTCCGCAGATACGCAGTATTTT	CANGLLDESADTQYF	TRBV25-1	TRBJ2-3
TGTGCCACCCTAGGCCGTTTAAGCGAGCAGTACTTC	CATLGRLSEQYF	TRBV6-4	TRBJ2-7
TGTGCCAGCAGCCAAGCCCCCCGGGGACAATCCTACAATGAGCAGTTCTTC	CASSQAPRGQSYNEQFF	TRBV14	TRBJ2-1
TGCGCCAGCCCTCCAGACAGGGGGCTTCGTCATGACAATGAGCAGTTCTTC	CASPPDRGLRHDNEQFF	TRBV10-1	TRBJ2-1
TGTGCCAGCAGCCAAGTCTCTCGGGACAGGGGCCTACGCTATGGCTACACCTTC	CASSQVSRDRGLRYGYTF	TRBV14	TRBJ1-2
TGTGCCAGTAGTATCGCCAGGGGGGGCCCATACAATGAGCAGTTCTTC	CASSIARGGPYNEQFF	TRBV19	TRBJ2-1
TGTGCTAGTGTGACAGGGGTAGGACTAAGCTCCTACGAGCAGTACTTC	CASVTGVGLSSYEQYF	TRBV12-5	TRBJ2-7
TGTGCCAGCAGTTTAGAAGGCGATGAAGCTTTCTTT	CASSLEGDEAFF	TRBV12-4	TRBJ1-1
TGTGCCAGCAGCCTCAGGGGCTTAGATTATCAGCCCCAGCATTTT	CASSLRGLDYQPQHF	TRBV13	TRBJ1-5
TGTGCCAGCATGTGGACAGGGCAGGAGGCCCTCTATGGCTACACCTTC	CASMWTGQEALYGYTF	TRBV27	TRBJ1-2
TGCAGCGCGTACCAGGGGAGAGCTTTCTTT	CSAYQGRAFF	TRBV29-1	TRBJ1-1
TGTGCCAGCAGCCAACCTCCAGGGCCCAATGAGCAGTTCTTC	CASSQPPGPNEQFF	TRBV3-1	TRBJ2-1
TGTGCCAGCATTCTCTCCGGGACTAGGGGGTACGAGCAGTACTTC	CASILSGTRGYEQYF	TRBV6-3	TRBJ2-7
TGCAGTGCTAGAGATCGATGTGTTGTTGAGCAGTACTTC	CSARDRCVVEQYF	TRBV20-1	TRBJ2-7
TGTGCCAGCAGTGAATCCCGGGACAGGGGCTTATGGTCTGCATCCGAATCCTACGAGCAGTACTTC	CASSESRDRGLWSASESYEQYF	TRBV2	TRBJ2-7
TGTGCCAGCGGGGTTGGGGGCCGTGAGAATCAGCCCCAGCATTTT	CASGVGGRENQPQHF	TRBV5-6	TRBJ1-5
TGCGCCAGCAGCTTGGGGACTAGCGGGAGGGTTGACACTGAAGCTTTCTTT	CASSLGTSGRVDTEAFF	TRBV5-1	TRBJ1-1
TGTGCCAGCAGCCAAGATGTCCTTTCGAGGAGTGAGCAGTTCTTC	CASSQDVLSRSEQFF	TRBV3-1	TRBJ2-1
TGCGCCAGCAGACAGGAGAGCAATCAGCCCCAGCATTTT	CASRQESNQPQHF	TRBV10-1	TRBJ1-5
TGTGCCAGCAGCTTCCCGGACAGGGGAGCTTTCTTT	CASSFPDRGAFF	TRBV7-8	TRBJ1-1
TGTGCCAGCAGCCGGCTGGGGGGGTCCTTAGATTACGAGCAGTACTTC	CASSRLGGSLDYEQYF	TRBV13	TRBJ2-7
TGTGCCAGCAGTGTCCCGGGACAGGGCAATCAGCCCCAGCATTTT	CASSVPGQGNQPQHF	TRBV27	TRBJ1-5
TGTGCCAGCAGAAGTCCTCTGAAGGGCGAAAAACTGTTTTTT	CASRSPLKGEKLFF	TRBV28	TRBJ1-4
TGTGCCAGCAGTCTGACTAGCGGGAGGGCCCACAGGAACGTTGCAACTAATGAAAAACTGTTTTTT	CASSLTSGRAHRNVATNEKLFF	TRBV27	TRBJ1-4
TGCGCCAGCAGCCCCAAGAACCAAGGAGACACTGAAGCTTTCTTT	CASSPKNQGDTEAFF	TRBV10-1	TRBJ1-1
TGCGCCAGCAACAGGAACACTGAAGCTTTCTTT	CASNRNTEAFF	TRBV10-1	TRBJ1-1
TGTGCCAGCAGTTTGACCCGAGGGGGGTACGAGCAGTACTTC	CASSLTRGGYEQYF	TRBV28	TRBJ2-7
TGCGCCAGCAGCCTCCCACTCGGTGGACAGGGGCCTCGAGCCTACGAGCAGTACTTC	CASSLPLGGQGPRAYEQYF	TRBV5-1	TRBJ2-7
TGTGCCTGTTACGCCAACGGGACGGCCTACGAGCAGTACTTC	CACYANGTAYEQYF	TRBV19	TRBJ2-7
TGTGCCAGCAGTTTAGTGTCAGCCCTGAGGGAATTAGAGACCCAGTACTTC	CASSLVSALRELETQYF	TRBV12-3	TRBJ2-5
TGTGCCAGCAGCGCAGAACTACGAGTCTACGAGCAGTACTTC	CASSAELRVYEQYF	TRBV5-8	TRBJ2-7
TGCGCCAGCAGCTTGAAACAGGCACGGGCCAAAAACATTCAGTACTTC	CASSLKQARAKNIQYF	TRBV5-1	TRBJ2-4
TGCAGTGCCCTGACGTATAGGACGGGGTTCTACGGCGCTTTCTTT	CSALTYRTGFYGAFF	TRBV20-1	TRBJ1-1
TGCAGTGCGACTAGCCGAAAGGGCCCTACCGGGGAGCTGTTTTTT	CSATSRKGPTGELFF	TRBV20-1	TRBJ2-2
TGTGCCAGCAGTTCTGTACCAACTCCCTCTGGAAACACCATATATTTT	CASSSVPTPSGNTIYF	TRBV28	TRBJ1-3
TGCGCCATATGGGCGTCGCGGGATGAGCAGTACTTC	CAIWASRDEQYF	TRBV5-1	TRBJ2-7
TGTGCCAGCAGCTGGCCGGCGCCGCTAGCCAAAAACATTCAGTACTTC	CASSWPAPLAKNIQYF	TRBV9	TRBJ2-4
TGTGCCAGCAGCGTAGCGCGAGGGGGGGACTTAGGCAATCAGCCCCAGCATTTT	CASSVARGGDLGNQPQHF	TRBV9	TRBJ1-5
TGTGCCAGCAGCAGCGGGGGCCGTTCCCAAGAGACCCAGTACTTC	CASSSGGRSQETQYF	TRBV7-2	TRBJ2-5
TGTGCCAGCAGTCTAAGGAAGTCCGGGGAGCTGTTTTTT	CASSLRKSGELFF	TRBV28	TRBJ2-2
TGTGCCAGCAGTTTTGCAGGGGGGAGCAATCAGCCCCAGCATTTT	CASSFAGGSNQPQHF	TRBV27	TRBJ1-5
TGTGCCAGCACCGGCGTGGAGTACGAGCAGTACTTC	CASTGVEYEQYF	TRBV6-3	TRBJ2-7
TGTGCCACCAGTGCACTGGGACGGACGGGGCCTTTCACTAACTATGGCTACACCTTC	CATSALGRTGPFTNYGYTF	TRBV24-1	TRBJ1-2
TGTGCCAGCAGCTTGGTTCACACTCACTGGACAGTGTTCGAGCAGTACTTC	CASSLVHTHWTVFEQYF	TRBV5-4	TRBJ2-7
TGTGCCACCAGTTGCGACAGGGGAGGGAATCAGCCCCAGCATTTT	CATSCDRGGNQPQHF	TRBV24-1	TRBJ1-5
TGCAGTGCTAGAGAGAGCAGGGGACGGAATTCACCCCTCCACTTT	CSARESRGRNSPLHF	TRBV20-1	TRBJ1-6
TGTGCCACCAGTGATTTGCGGATTCGTGGGGGGTTTCCTAATGAAAAACTGTTTTTT	CATSDLRIRGGFPNEKLFF	TRBV24-1	TRBJ1-4
TGTGCCACCAGTGGTCGGACAGGCTACGAGCAGTACTTC	CATSGRTGYEQYF	TRBV24-1	TRBJ2-7
TGTGCCAGCAGGGTCGGGCGAGCCTACGAGCAGTACTTC	CASRVGRAYEQYF	TRBV27	TRBJ2-7
TGCGCCAACATGTACAGTGTAAGCAATCAGCCCCAGCATTTT	CANMYSVSNQPQHF	TRBV10-1	TRBJ1-5
TGTGCCAGTAGTATAGGACCGTACAGGGGGCACTGGGGGAACACTGAAGCTTTCTTT	CASSIGPYRGHWGNTEAFF	TRBV19	TRBJ1-1
TGTGCCAGCAGCCATGCTCACCCGCCAGAGCAGTACTTC	CASSHAHPPEQYF	TRBV14	TRBJ2-7
TGTGCCAGCAGCAACGTCGACAGGGGATACGGAAACACCATATATTTT	CASSNVDRGYGNTIYF	TRBV13	TRBJ1-3
TGTGCCAGCAGGTGGGGGCGTGGGCCTGAAGCTTTCTTT	CASRWGRGPEAFF	TRBV7-3	TRBJ1-1
TGCAGTGCTAGTGAAACGTCCTACAATGAGCAGTTCTTC	CSASETSYNEQFF	TRBV20-1	TRBJ2-1
TGTGCCAGTAGTTATGGGGGGCCAGTAGAGACCCAGTACTTC	CASSYGGPVETQYF	TRBV19	TRBJ2-5
TGTGCCAGCAGCTCAGGGGAGGGGCTCGAGCAGTACTTC	CASSSGEGLEQYF	TRBV7-2	TRBJ2-7
TGCAGTGCGCTCGGGGGGACGGGCGAGCAGTACTTC	CSALGGTGEQYF	TRBV20-1	TRBJ2-7
TGTGCCAGCTATAGGCCGAATTCCCAAGAGACCCAGTACTTC	CASYRPNSQETQYF	TRBV6-4	TRBJ2-5
TGCGCCAGCAGTTGCGGGAGGAACACTGAAGCTTTCTTT	CASSCGRNTEAFF	TRBV5-1	TRBJ1-1
TGCAGTGCTAGAGTTCGCTCTTCCTACAATGAGCAGTTCTTC	CSARVRSSYNEQFF	TRBV20-1	TRBJ2-1
TGTGCCACCAGTGAGACAGTCACCGGGGAGCTGTTTTTT	CATSETVTGELFF	TRBV24-1	TRBJ2-2
TGCGCCAGCAGCTTATCGGGGGGAGGTAGCAATCAGCCCCAGCATTTT	CASSLSGGGSNQPQHF	TRBV5-1	TRBJ1-5
TGTGCCAGCAGCTTGGGATCTAATCTCTACGAGCAGTACTTC	CASSLGSNLYEQYF	TRBV5-4	TRBJ2-7
TGTGCCAGCAGCTCATACGGACTGGGACTAAATGAGCAGTTCTTC	CASSSYGLGLNEQFF	TRBV13	TRBJ2-1
TGTGCCAGCGGGAGGTTGGAACATGGCTACACCTTC	CASGRLEHGYTF	TRBV3-1	TRBJ1-2
TGTGCCAGCACGAGCCGGGGGCGCGGGTATCAGCCCCAGCATTTT	CASTSRGRGYQPQHF	TRBV7-3	TRBJ1-5
TGTGCCAGCAGAAAAGCCCCAGGGGGCAGGGAGTACTTC	CASRKAPGGREYF	TRBV6-4	TRBJ2-5
TGTGCCATCAAGGGGACCGGGACTAGGGTTGAGCAGTTCTTC	CAIKGTGTRVEQFF	TRBV10-3	TRBJ2-1
TGTGCCAGCAGCCGGGGGGACTTAGTCTACGAGCAGTACTTC	CASSRGDLVYEQYF	TRBV11-2	TRBJ2-7
TGTGCCATCAGTGCTGGGGGAGGTAACTATGGCTACACCTTC	CAISAGGGNYGYTF	TRBV10-3	TRBJ1-2
TGTGCCAGCAGCGTGGGCTTCTCGCAGTACTTC	CASSVGFSQYF	TRBV9	TRBJ2-7
TGTCAAAAATGGACAGGGGGTCGGACTGAAGCTTTCTTT	CQKWTGGRTEAFF	TRBV19	TRBJ1-1
TGTGCCAGCAGTTTCCCACTAGCTTGCACAGATACGCAGTATTTT	CASSFPLACTDTQYF	TRBV27	TRBJ2-3
TGTGCCTGGAGCGGGACAGAGATCTATGGCTACACCTTC	CAWSGTEIYGYTF	TRBV30	TRBJ1-2
TGTGCCAGCAGTGCTGGACGGGACGAGCAGTACTTC	CASSAGRDEQYF	TRBV12-4	TRBJ2-7
TGTGCAGGGGACAGGAGGAGGAATGAGCAGTTCTTC	CAGDRRRNEQFF	TRBV15	TRBJ2-1
TGTGCCAGCAGCTTTGTCCGGGGCTCAGAGACCCAGTACTTC	CASSFVRGSETQYF	TRBV7-9	TRBJ2-5
TGTGCCAGCAGCTTAAGCAACAGACAGAGAAACACTGAAGCTTTCTTT	CASSLSNRQRNTEAFF	TRBV7-3	TRBJ1-1
TGTGCCAGCAGGCCTCTACCGGAGACCCAGTACTTC	CASRPLPETQYF	TRBV12-3	TRBJ2-5
TGTGCCAGCAGCTTGTTCAATTCCGCGGGGATCTCCTATAATTCACCCCTCCACTTT	CASSLFNSAGISYNSPLHF	TRBV5-6	TRBJ1-6
TGTGCCAGCAGCTGTCCACCCGGGGTGACCTACAATGAGCAGTTCTTC	CASSCPPGVTYNEQFF	TRBV7-9	TRBJ2-1
TGTGCCAGCAGCCCAGGAAATGGCTACACCTTC	CASSPGNGYTF	TRBV11-3	TRBJ1-2
TGTGCCAGCAGTGAGGGTATGACTCAGATCACCGGGGAGCTGTTTTTT	CASSEGMTQITGELFF	TRBV6-1	TRBJ2-2
TGTGCCAGCAGCCCCCAGTACGGTGAGGGGTACGAGCAGTACTTC	CASSPQYGEGYEQYF	TRBV7-2	TRBJ2-7
TGTGCTAGCAGCTTACCGGGACAGGGGAAGGACGAGCAGTACTTC	CASSLPGQGKDEQYF	TRBV7-7	TRBJ2-7
TGCGCCAGCAGCTGGACAGGGGATGCTGTTGAGCAGTTCTTC	CASSWTGDAVEQFF	TRBV5-1	TRBJ2-1
TGTGCCAGCAGGACAGGGTTATCCTACGAGCAGTACTTC	CASRTGLSYEQYF	TRBV6-4	TRBJ2-7
TGTGCCAGCAGTTTGTCAGATTCTCCTACCGGGGAGCTGTTTTTT	CASSLSDSPTGELFF	TRBV27	TRBJ2-2
TGTGCCAGCAGTTACTCGGGGCCGACTAGCGGGATCTTC	CASSYSGPTSGIF	TRBV6-5	TRBJ2-1
TGTGCCAGCAGCCGAGGCGGGAGATCTGGGGCCAACGTCCTGACTTTC	CASSRGGRSGANVLTF	TRBV7-4	TRBJ2-6
TGTGCCAGCAGGGCGCGTAAAGTCTATGGCTACACCTTC	CASRARKVYGYTF	TRBV28	TRBJ1-2
TGTGCCAGCAGCCAAGGGTGTCGCGGGAGCTTTGAAAAACTGTTTTTT	CASSQGCRGSFEKLFF	TRBV14	TRBJ1-4
TGTGCCAGCCGGCACTTTTGGGGAGTGCTAGCCAAAAACATTCAGTACTTC	CASRHFWGVLAKNIQYF	TRBV6-2	TRBJ2-4
TGTGCCCTCAGGGGGCGACCCTACGAGCAGTACTTC	CALRGRPYEQYF	TRBV10-3	TRBJ2-7
TGCAGTGCCCCACAGGGGTGCTATGGCTACACCTTC	CSAPQGCYGYTF	TRBV20-1	TRBJ1-2
TGTGCCAGCAGCCGGGAGGGTGGGGGCAACTATGGCTACACCTTC	CASSREGGGNYGYTF	TRBV6-4	TRBJ1-2
TGCAGTGCTAGAGATCCAAGGGACAGGGGGCAAGAGACCCAGTACTTC	CSARDPRDRGQETQYF	TRBV20-1	TRBJ2-5
TGTGCCAGCAGCTGCCGCATATTGGGCCGGAACACTGAAGCTTTCTTT	CASSCRILGRNTEAFF	TRBV7-3	TRBJ1-1
TGTGCCAGTACGTGCCCCCTGGGGGGCGACTACGAGCAGTACTTC	CASTCPLGGDYEQYF	TRBV19	TRBJ2-7
TGCAGTGCTCGGGAGGACAGCACGCGCCCCACAGATACGCAGTATTTT	CSAREDSTRPTDTQYF	TRBV20-1	TRBJ2-3
TGTGCCAGCAGCTCACGGTCCCGGGACAGGTGGTATAGGCCCCAGCATTTT	CASSSRSRDRWYRPQHF	TRBV5-4	TRBJ1-5
TGTGCCAGCAGTTACTCCCCTAGCGGGAAATTAGATACGCAGTATTTT	CASSYSPSGKLDTQYF	TRBV6-3	TRBJ2-3
TGTGCCAGTTCAGTTACCGGGACAGGGTGCAGATGCTATGGCTACACCTTC	CASSVTGTGCRCYGYTF	TRBV19	TRBJ1-2
TGCGCCAGCAGCAAACAGGGGACCGCCTGCACTGAAGCTTTCTTT	CASSKQGTACTEAFF	TRBV4-1	TRBJ1-1
TGTGCCAGCAGAAGGGACTCCACCCGCAATCAGCCCCAGCATTTT	CASRRDSTRNQPQHF	TRBV2	TRBJ1-5
TGTGCCAGCAGAAGGGAGCTCACTGAAGCTTTCTTT	CASRRELTEAFF	TRBV6-4	TRBJ1-1
TGTGCCAGCAGTGCGAAAAAGGGTTTAGCTTTAGAGACAGATACGCAGTATTTT	CASSAKKGLALETDTQYF	TRBV6-4	TRBJ2-3
TGTGCCAGCAGTTACCCGTTTAGCGGGGGCGGGGAGCTGTTTTTT	CASSYPFSGGGELFF	TRBV6-2	TRBJ2-2
TGCAGTGCAGGTCGCAGGGAAGGCGAGCAGTACTTC	CSAGRREGEQYF	TRBV20-1	TRBJ2-7
TGTGCCAGCAGCCCCGGGGGCTTTTGTATCGGAAGTGGCAATCAGCCCCAGCATTTT	CASSPGGFCIGSGNQPQHF	TRBV7-9	TRBJ1-5
TGCGCCAGCAGGGCAGGGGGCTCCTACGAGCAGTACTTC	CASRAGGSYEQYF	TRBV10-2	TRBJ2-7
TGTGCCAGCAGCCCGGGGGGCGTGGACAATGAGCAGTTCTTC	CASSPGGVDNEQFF	TRBV3-1	TRBJ2-1
TGTGCCAGCAGTCTCCCTAAGGGGACATATGGGGACGAGCAGTACTTC	CASSLPKGTYGDEQYF	TRBV6-2	TRBJ2-7
TGTGCCAGCAGCCTAAGGGTCAGGGGGGCCCCATCGACGCAGTATTTT	CASSLRVRGAPSTQYF	TRBV5-5	TRBJ2-3
TGTGCCCCCCCTCGCCCAGGGTGGGGGAACACTGAAGCTTTCTTT	CAPPRPGWGNTEAFF	TRBV7-7	TRBJ1-1
TGCAGTGCTAGAGATCGACTAACCGGGGGATCTTTAGGTGAAAAACTGTTTTTT	CSARDRLTGGSLGEKLFF	TRBV20-1	TRBJ1-4
TGTGCCAGCAGCTTAGGTGTGAAAAGGGGACAGGGTGAAGCTTTCTTT	CASSLGVKRGQGEAFF	TRBV7-6	TRBJ1-1
TGTGCCAGCAGTGATCGGGGGCGAGTTGGCTACACCTTC	CASSDRGRVGYTF	TRBV6-4	TRBJ1-2
TGCAGTGCAGGGTTCGGGGGCTCGCGTCAGCCCCAGCATTTT	CSAGFGGSRQPQHF	TRBV20-1	TRBJ1-5
TGTGCCAGCCGTACTAGCGGGAGCTTCGAAGCCTACGAGCAGTACTTC	CASRTSGSFEAYEQYF	TRBV27	TRBJ2-7
TGTGCCAGCTCACCATCACCCAGACTAGAGACCCAGTACTTC	CASSPSPRLETQYF	TRBV18	TRBJ2-5
TGCAGTGACCCATCAGGGGTCTACGAGCAGTACTTC	CSDPSGVYEQYF	TRBV20-1	TRBJ2-7
TGTGCCAGCAGTGTGGAGCTTACCTTCGTGGGCTATGGCTACACCTTC	CASSVELTFVGYGYTF	TRBV27	TRBJ1-2
TGTGCCAGCAGCGTTCAGGGGATATACACTGAGCCTGCAACTAATGAAAAACTGTTTTTT	CASSVQGIYTEPATNEKLFF	TRBV9	TRBJ1-4
TGCGCCAGCAGCCAAGATTCCGGGGGACCAGAGCAGTACTTC	CASSQDSGGPEQYF	TRBV4-1	TRBJ2-7
TGTGCCAGCAGCCGGAGGGTATCCTACGAGCAGTACTTC	CASSRRVSYEQYF	TRBV13	TRBJ2-7
TGTGCCAGCAGCCACCACCGGCGAACCAGAACCAATCAGCCCCAGCATTTT	CASSHHRRTRTNQPQHF	TRBV3-1	TRBJ1-5
TGTGCCACCAGTAAGCCGACAGGGCCAATCTACGAGCAGTACTTC	CATSKPTGPIYEQYF	TRBV24-1	TRBJ2-7
TGTGCCAGCAGTTTAGTACCTCGGCAGGGGAGGATTAGTCCCTCCTACAATGAGCAGTTCTTC	CASSLVPRQGRISPSYNEQFF	TRBV27	TRBJ2-1
TGTGCCAGCAGTGTTAGACCTAACGAGCAGTACTTC	CASSVRPNEQYF	TRBV6-4	TRBJ2-7
TGTGCCAGCAGTGCAGAGCATCCCACCGGGGAGCTGTTTTTT	CASSAEHPTGELFF	TRBV27	TRBJ2-2
TGTGCCAGCAGCTGTAGATCCTACGAGCAGTACTTC	CASSCRSYEQYF	TRBV28	TRBJ2-7
TGTGCCAGCAGCCTGGGGACTAGGGCCTACGAGCAGTACTTC	CASSLGTRAYEQYF	TRBV7-3	TRBJ2-7
TGTGCCAGTAGTATCTCCGGGGACTCGTCAGCTACGCAGTATTTT	CASSISGDSSATQYF	TRBV19	TRBJ2-3
TGTGCCAGTCCTCGCGACAGCCTGGCTGAAGCTTTCTTT	CASPRDSLAEAFF	TRBV19	TRBJ1-1
TGTGCCGCTCTCGCCCCGCGGGAGGACAACACCGGGGAGCTGTTTTTT	CAALAPREDNTGELFF	TRBV9	TRBJ2-2
TGTGCCAGCAGCGATCGCCGGGAGGTAGTAAATGGCTACACCTTC	CASSDRREVVNGYTF	TRBV7-3	TRBJ1-2
TGTGCCAGCAGCCAAGAGGTTAAGAGGGACGGACTCTTAGTTGAAGCTTTCTTT	CASSQEVKRDGLLVEAFF	TRBV14	TRBJ1-1
TGTGCCAGCAGTCGAGCAGATACGCAGTATTTT	CASSRADTQYF	TRBV6-8	TRBJ2-3
TGTGCCAGCACCAGTCTTGATAGCCAACTCACCTACGAGCAGTACTTC	CASTSLDSQLTYEQYF	TRBV6-4	TRBJ2-7
TGTGCCAGCAGCAACCTCCCCGACAGCCGTTATGGCTACACCTTC	CASSNLPDSRYGYTF	TRBV7-3	TRBJ1-2
TGCGCCAGCAGCCGCCTAGCGGGGGACACCGGGGAGCTGTTTTTT	CASSRLAGDTGELFF	TRBV5-1	TRBJ2-2
TGTGCCTGGAGTGTAGGAAGAATGTCCGGGACAGGGGACAATTCACCCCTCCACTTT	CAWSVGRMSGTGDNSPLHF	TRBV30	TRBJ1-6
TGTGCCAGCAGCCAAGCGGGACCTAGCAATCAGCCCCAGCATTTT	CASSQAGPSNQPQHF	TRBV14	TRBJ1-5
TGTGCCTGGAGTCCAGGGGCGGTGAGACGGGGACTAGCCAAAAACATTCAGTACTTC	CAWSPGAVRRGLAKNIQYF	TRBV30	TRBJ2-4
TGTGCCAGCAGTGAGTCCCGCGGGAGTGGCTACACCTTC	CASSESRGSGYTF	TRBV25-1	TRBJ1-2
TGTGCCAGCAGCCAAGGACAGGGACAACGTGGCTACACCTTC	CASSQGQGQRGYTF	TRBV14	TRBJ1-2
TGTGCCAGCAGTTTAATTGAGGATCGAGCCTACGAGCAGTACTTC	CASSLIEDRAYEQYF	TRBV12-4	TRBJ2-7
TGTGCCAGCAGCGATAGCGGGGTTTCCAATGAGCAGTTCTTC	CASSDSGVSNEQFF	TRBV13	TRBJ2-1
TGCAGCGGGAACATCATGCAAGAGACCCAGTACTTC	CSGNIMQETQYF	TRBV29-1	TRBJ2-5
TGTGCCAGCAGCTGGGACAGTGGGAGCTCTGGAAACACCATATATTTT	CASSWDSGSSGNTIYF	TRBV11-2	TRBJ1-3
TGCAGGGGCTTAAACATTCAGTACTTC	CRGLNIQYF	TRBV20-1	TRBJ2-4
TGTGCCAGCAAAGATAGCGGGAATGAGCAGTTCTTC	CASKDSGNEQFF	TRBV6-4	TRBJ2-1
TGTGCCAGCAGCAGGGGCGGGAGAGGGGAGACCCAGTACTTC	CASSRGGRGETQYF	TRBV6-5	TRBJ2-5
TGTGCCAGCACCCCCACAGGGGAGAACACTGAAGCTTTCTTT	CASTPTGENTEAFF	TRBV11-3	TRBJ1-1
TGCAGTGCTAGAGATGGGACAGGGTCTTGCGGCTACACCTTC	CSARDGTGSCGYTF	TRBV20-1	TRBJ1-2
TGTGCCAGCGGGAAGGCCCCCCCCCGGGACAATTCCTACGAGCAGTACTTC	CASGKAPPRDNSYEQYF	TRBV13	TRBJ2-7
TGCGCCACCTGCCGGCCTGGGGGAAACACCATATATTTT	CATCRPGGNTIYF	TRBV10-1	TRBJ1-3
TGTGCCAGCAGTGACTCGCCCCAGACAAGCAATCAGCCCCAGCATTTT	CASSDSPQTSNQPQHF	TRBV6-4	TRBJ1-5
