TGTGCCAGCAGTTTACAGGCGCTGACACTGGCTCACACTGAAGCTTTCTTT	CASSLQALTLAHTEAFF	TRBV12-3	TRBJ1-1
TGTGCCACCAGTGATTCATCCGGGACTAGGTACAATGAGCAGTTCTTC	CATSDSSGTRYNEQFF	TRBV24-1	TRBJ2-1
TGTGCCAGTAGTATAGATCCCTACTCTTACAATGAGCAGTTCTTC	CASSIDPYSYNEQFF	TRBV19	TRBJ2-1
TGTGCCAGCAGTTACGGCGCAGGGGTTTCAACTGAGCAGTACTTC	CASSYGAGVSTEQYF	TRBV6-5	TRBJ2-7
TGTGCCAGCAGCTCCAGCAATCAGCCCCAGCATTTT	CASSSSNQPQHF	TRBV11-3	TRBJ1-5
TGCGCCAGCAGCTTGGTTGTTAAGATCTTC	CASSLVVKIF	TRBV5-1	TRBJ2-1
TGTGCCAGCAGCGGGGGGGCGGCGACTAATGAAAAACTGTTTTTT	CASSGGAATNEKLFF	TRBV11-3	TRBJ1-4
TGCAGCGTTCGAGGTTATCTCGCCTACGAGCAGTACTTC	CSVRGYLAYEQYF	TRBV29-1	TRBJ2-7
TGTGCCAGCAGTGAATTGAAAGGGGGCGATCGTGACTATGGCTACACCTTC	CASSELKGGDRDYGYTF	TRBV25-1	TRBJ1-2
TGCAGTGCTAGTAGGGTTGGCTACACCTTC	CSASRVGYTF	TRBV20-1	TRBJ1-2
TGTGCCAGCAGGCTCGCACTTGGCCCTGCCCGGGACAGGGGTCATGACGATGAGCAGTTCTTC	CASRLALGPARDRGHDDEQFF	TRBV12-3	TRBJ2-1
TGCAGTGCTGGTAGCTTAGCCTACAATGAGCAGTTCTTC	CSAGSLAYNEQFF	TRBV20-1	TRBJ2-1
TGTGCCATCAGGACACTTAGCACAGATACGCAGTATTTT	CAIRTLSTDTQYF	TRBV10-3	TRBJ2-3
TGCGCCAGCAGCCAGCAGTGCCCAACTAATGAAAAACTGTTTTTT	CASSQQCPTNEKLFF	TRBV5-1	TRBJ1-4
TGTGCCAGGGGGTTTAGAGTCGCTAGAGAGACCCAGTACTTC	CARGFRVARETQYF	TRBV27	TRBJ2-5
TGTGCCTGGAGTCCGAAAGCTCCAAACATTCAGTACTTC	CAWSPKAPNIQYF	TRBV30	TRBJ2-4
TGCGCCAGCAGCCAAGCATTGTCGTGTTACGAGCAGTACTTC	CASSQALSCYEQYF	TRBV4-1	TRBJ2-7
TGTGCCAGCAGCGGGGACGAAAAGAAAGACTCCTACGAGCAGTACTTC	CASSGDEKKDSYEQYF	TRBV7-3	TRBJ2-7
TGTGCCTGGAGTGTAGCGGGAGGGGAGGTGAACACTGAAGCTTTCTTT	CAWSVAGGEVNTEAFF	TRBV30	TRBJ1-1
TGTGCCAGCAGTTTCTATGAGAGTACCGAAGAGACCCAGTACTTC	CASSFYESTEETQYF	TRBV28	TRBJ2-5
TGTGCCACCAGTGAGAGGGGGACAGGGAATCAGCCCCAGCATTTT	CATSERGTGNQPQHF	TRBV24-1	TRBJ1-5
TGTGCCAGTAGTGGACAGGGGAGTAACACTGAAGCTTTCTTT	CASSGQGSNTEAFF	TRBV19	TRBJ1-1
TGTGCCAGCAGCCATGACAGGAACCCCTACGAGCAGTACTTC	CASSHDRNPYEQYF	TRBV3-1	TRBJ2-7
TGTGCCAGCTCACTCTCGGGAGGGGTACCTAGCACAGATACGCAGTATTTT	CASSLSGGVPSTDTQYF	TRBV18	TRBJ2-3
TGCAGTGCTAGATTCTCGGAACGGACCCCTTGCCGGATGCTCATTTGCAATCAGCCCCAGCATTTT	CSARFSERTPCRMLICNQPQHF	TRBV20-1	TRBJ1-5
TGTGCCAGTAGGGGTCTCAGACACTCAGATACGCAGTATTTT	CASRGLRHSDTQYF	TRBV19	TRBJ2-3
TGTGCCTCGGGGCCGGGACAGGGGATAAACATTCAGTACTTC	CASGPGQGINIQYF	TRBV30	TRBJ2-4
TGTGCCAGCAGTTCCGTGGGACAGATGGTGGGTAATGAAAAACTGTTTTTT	CASSSVGQMVGNEKLFF	TRBV12-3	TRBJ1-4
TGCAGTGCTAGAGATGGGACTAGCGGGATAAGCAACACCGGGGAGCTGTTTTTT	CSARDGTSGISNTGELFF	TRBV20-1	TRBJ2-2
TGTGCCAGCAGCCCGCTAGATTCGCACACAGATACGCAGTATTTT	CASSPLDSHTDTQYF	TRBV9	TRBJ2-3
TGTGCCAGCAGCCTAACTGTGAGATCCTACGAGCAGTACTTC	CASSLTVRSYEQYF	TRBV9	TRBJ2-7
TGTGCCAGCAGCTTAGGGGACGAGGGGGCATGCTATGGCTACACCTTC	CASSLGDEGACYGYTF	TRBV11-3	TRBJ1-2
TGCGCCAGCAGCTCCCGGGCCGGCGGGATAAGCCGGGGTTGCCAGCCCCAGCATTTT	CASSSRAGGISRGCQPQHF	TRBV4-1	TRBJ1-5
TGTGCCAGCAGCGGGCCCATAGAGACCCAGTACTTC	CASSGPIETQYF	TRBV7-2	TRBJ2-5
TGTGCCAGCAGTGGGGACAGGGCATACGAGCAGTACTTC	CASSGDRAYEQYF	TRBV6-3	TRBJ2-7
TGCAGTGCTAGCCCAGGGGGTGAACCGGGCTACACCTTC	CSASPGGEPGYTF	TRBV20-1	TRBJ1-2
TGTGCCAGCAAAGTAGGAGAGGAAAGGCCTGAAGCTTTCTTT	CASKVGEERPEAFF	TRBV6-1	TRBJ1-1
TGTGCCAGCAGTGACAGCGGTGATACGCAGTATTTT	CASSDSGDTQYF	TRBV6-4	TRBJ2-3
TGTGCCAGCAGCCAAGATACGTGTCCCTCGGGGAGGGAGTACGAGCAGTACTTC	CASSQDTCPSGREYEQYF	TRBV3-1	TRBJ2-7
TGTGCCAACGCGGTCTCGGGACAGGAGGTGAACACTGAAGCTTTCTTT	CANAVSGQEVNTEAFF	TRBV12-3	TRBJ1-1
TGTGCCAGCAGCGTTTTGACATTTACTTATAGCTCCTATAATTCACCCCTCCACTTT	CASSVLTFTYSSYNSPLHF	TRBV9	TRBJ1-6
TGTGCCAGTAGTTTTCTAGGGACTGGCAATCAGCCCCAGCATTTT	CASSFLGTGNQPQHF	TRBV19	TRBJ1-5
TGCGCCAGCAGGAAACTGACAACGGAAAAACTGTTTTTT	CASRKLTTEKLFF	TRBV10-1	TRBJ1-4
TGCGCCAGCAGCTTGGGAACAGGACGCAATCAGCCCCAGCATTTT	CASSLGTGRNQPQHF	TRBV5-1	TRBJ1-5
TGCGCCAGCAGCCAATGGGGATACTACAGGGGTGTCGGGTCTGGAAACACCATATATTTT	CASSQWGYYRGVGSGNTIYF	TRBV4-1	TRBJ1-3
TGTGCCACCAGCAGAGGGTTAGGCCAGGGGGGTTTTCGCTACGAGCAGTACTTC	CATSRGLGQGGFRYEQYF	TRBV15	TRBJ2-7
TGCGCCAGCAGTGAGTCTATACTAGTCCACTCCTACGAGCAGTACTTC	CASSESILVHSYEQYF	TRBV10-1	TRBJ2-7
TGTGCCAGCAAAAAGGGGTACAATGAGCAGTTCTTC	CASKKGYNEQFF	TRBV6-1	TRBJ2-1
TGTGCCAGCAACCGTACAAACGCCTCCTATAATTCACCCCTCCACTTT	CASNRTNASYNSPLHF	TRBV6-2	TRBJ1-6
TGCGCCAGCAGCTTAGCAGGTTTTGAGGCCAACGTCCTGACTTTC	CASSLAGFEANVLTF	TRBV5-1	TRBJ2-6
TGTGCCATCAGTGAGGGGGGGGGTGCAGATACGCAGTATTTT	CAISEGGGADTQYF	TRBV10-3	TRBJ2-3
TGTGCCAGCAGCGGCTCAAATTGCCCGGGACAGGCCCTACTACGCACAGATACGCAGTATTTT	CASSGSNCPGQALLRTDTQYF	TRBV13	TRBJ2-3
TGTGCCAGCATGGGGAAGAGCGTCGGGACTAGCTTGAACGAGCAGTACTTC	CASMGKSVGTSLNEQYF	TRBV9	TRBJ2-7
TGTGCCACCAGTGCAACATGTAAGGGGGATACGCAGTATTTT	CATSATCKGDTQYF	TRBV24-1	TRBJ2-3
TGTGCCAGCAGCAACGGAGACCGTCCCACATACACCGGGGAGCTGTTTTTT	CASSNGDRPTYTGELFF	TRBV13	TRBJ2-2
TGTGCCACCAGCAGCCTGTTACGGGAGGGACGGTCCTACGAGCAGTACTTC	CATSSLLREGRSYEQYF	TRBV15	TRBJ2-7
TGTGCCAGCAGCCAAGATCCACAGGGGGAAAGGTGGGGAAGCAATCAGCCCCAGCATTTT	CASSQDPQGERWGSNQPQHF	TRBV14	TRBJ1-5
TGCGCCAGCAGCAGGGAAGAAGGGGATGGCTACACCTTC	CASSREEGDGYTF	TRBV5-1	TRBJ1-2
TGCGCCCACCACTCCGACTATGGCTACACCTTC	CAHHSDYGYTF	TRBV10-1	TRBJ1-2
TGTGCCAGCAGCGGTGACCGGACAGGGGAGCGCATGAACACTGAAGCTTTCTTT	CASSGDRTGERMNTEAFF	TRBV7-9	TRBJ1-1
TGTGCCAGCGAGCGGGGAGCGAACACCGGGGAGCTGTTTTTT	CASERGANTGELFF	TRBV6-4	TRBJ2-2
TGTGCCAGCAGCTTAGACCTTGGGACAGATACAGGCTACAATGAAAAACTGTTTTTT	CASSLDLGTDTGYNEKLFF	TRBV11-2	TRBJ1-4
TGTGCCAGCAGCAACCGAAGAGCCAATGAAAAACTGTTTTTT	CASSNRRANEKLFF	TRBV7-4	TRBJ1-4
TGTGCCAGCAGCTTCAAGGGGTGGTACAATGAGCAGTTCTTC	CASSFKGWYNEQFF	TRBV7-9	TRBJ2-1
TGTGCCAGCAGCGGAAGCCCGGCTAACGAGCAGTACTTC	CASSGSPANEQYF	TRBV9	TRBJ2-7
TGTGCCAGCAGCTTCCCTGGGGGCATGAACACTGAAGCTTTCTTT	CASSFPGGMNTEAFF	TRBV7-3	TRBJ1-1
TGTGCCAGCAGCTTAGGACAGGGTAGGAGCTATGGCTACACCTTC	CASSLGQGRSYGYTF	TRBV7-7	TRBJ1-2
TGCAGTGCCAGGGGGACTGGGGGGCATGGCTACACCTTC	CSARGTGGHGYTF	TRBV20-1	TRBJ1-2
TGTGCCAGCAGCTTCGGCCCGGACGGGGCCAACGTCCTGACTTTC	CASSFGPDGANVLTF	TRBV6-4	TRBJ2-6
TGTGCCAGCAGCCAACCCGGTTACAAAAAGGACTCTGGGGCCAACGTCCTGACTTTC	CASSQPGYKKDSGANVLTF	TRBV3-1	TRBJ2-6
TGTGCCAGCAGTTACCCCGATAGGGGGGCGGTCGAGCAGTACTTC	CASSYPDRGAVEQYF	TRBV6-2	TRBJ2-7
TGTGCCAGCAGCAGTCGGACAGGGCTACAGCCCCAGCATTTT	CASSSRTGLQPQHF	TRBV5-4	TRBJ1-5
TGTGCCAGTAGAAAAGGGCAACCGGGACAGAGAGGTTGCACAGATACGCAGTATTTT	CASRKGQPGQRGCTDTQYF	TRBV19	TRBJ2-3
TGTGCCAGCAGCGTTCTCTTAGGGGGCACAGATACGCAGTATTTT	CASSVLLGGTDTQYF	TRBV9	TRBJ2-3
TGTGCCAGCAGCGTAGGTCAAGCGCCCTGGCGTCCACAGGGGCGCTACGAGCAGTACTTC	CASSVGQAPWRPQGRYEQYF	TRBV9	TRBJ2-7
TGTGCCAGCAGGGGCAGGACAGGGCTCCAAGACTATGGCTACACCTTC	CASRGRTGLQDYGYTF	TRBV2	TRBJ1-2
TGTGCCAGCAGGCTCCCTAGCGGGGGGGCCCCAAAAACGCAGTATTTT	CASRLPSGGAPKTQYF	TRBV5-4	TRBJ2-3
TGTGCCACCAGTGATTTTAGAAAAGAAGCTTTCTTT	CATSDFRKEAFF	TRBV24-1	TRBJ1-1
TGTGCCAGCAGCTTAAGCGGGATACGAGTCTCCTACGAGCAGTACTTC	CASSLSGIRVSYEQYF	TRBV7-3	TRBJ2-7
TGTGCCAGCAGATCGGGGGAACAGGGAAAGGAGGGCTATGGCTACACCTTC	CASRSGEQGKEGYGYTF	TRBV7-2	TRBJ1-2
TGTGCCAGCAGCATGAGCGGGATCTACGAGCAGTACTTC	CASSMSGIYEQYF	TRBV9	TRBJ2-7
TGTGCCACCTCTCCTTATGGCTACACCTTC	CATSPYGYTF	TRBV24-1	TRBJ1-2
TGTGCCAGCAGAAAAGGGGTTCGGAGAGCCGCCGGGGAGCTGTTTTTT	CASRKGVRRAAGELFF	TRBV6-2	TRBJ2-2
TGCAGTGGAGAGACTAGCACAGATACGCAGTATTTT	CSGETSTDTQYF	TRBV20-1	TRBJ2-3
TGTGCCAGCAGTTACAGGGTTTATAATTCACCCCTCCACTTT	CASSYRVYNSPLHF	TRBV6-5	TRBJ1-6
TGTGCCAGTAGTTTCCCCACGCAGGACAGACGAGCTAACTATGGCTACACCTTC	CASSFPTQDRRANYGYTF	TRBV19	TRBJ1-2
TGTGCCAGCAGCCAGGTCAGCTACGAGCAGTACTTC	CASSQVSYEQYF	TRBV7-9	TRBJ2-7
TGTGCCTGGAGTGGCCCCTCAGGGGGCCTTCATGAAAAACTGTTTTTT	CAWSGPSGGLHEKLFF	TRBV30	TRBJ1-4
TGTGCCAGCAGCTCGGGCCCGAGCGGGAATGGCTACGAGCAGTACTTC	CASSSGPSGNGYEQYF	TRBV7-3	TRBJ2-7
TGCAGCGTGGAGGGGTTGGCCGGGGAGCTGTTTTTT	CSVEGLAGELFF	TRBV29-1	TRBJ2-2
TGCGCCAGCAGCTTGGCCGCTCCGGGACTAGCGGGGAATCTGCGTGGTCTTCCCTACAATGAGCAGTTCTTC	CASSLAAPGLAGNLRGLPYNEQFF	TRBV5-1	TRBJ2-1
TGTGCCAGCAGCACGTCGTACGAGCAGTACTTC	CASSTSYEQYF	TRBV11-3	TRBJ2-7
TGCGCCAGCAGCCAAGAAAAACAGGGGCATTCTAGATTAAGGTCCTACAATGAGCAGTTCTTC	CASSQEKQGHSRLRSYNEQFF	TRBV4-1	TRBJ2-1
TGTGCCAGCAGTTCCAGACTAGCGGGAGAAAAGGGACCAGGCACCGGGGAGCTGTTTTTT	CASSSRLAGEKGPGTGELFF	TRBV6-2	TRBJ2-2
TGCGCCAGCAGCCCACCCTACGAGCAGTACTTC	CASSPPYEQYF	TRBV4-3	TRBJ2-7
TGCAGCATCAAAGGGGGACAGGGAAACACCGGGGAGCTGTTTTTT	CSIKGGQGNTGELFF	TRBV29-1	TRBJ2-2
TGTGCCAGCAGTCACGGACGCTGGAATGAGCAGTTCTTC	CASSHGRWNEQFF	TRBV6-4	TRBJ2-1
TGCAGTGCTGGGACTAGCGGGGGGGCGACACATGAGCAGTTCTTC	CSAGTSGGATHEQFF	TRBV20-1	TRBJ2-1
TGTGCCAGCAGTGGTTCAGACAGGGTCGGGCTCACTGAAGCTTTCTTT	CASSGSDRVGLTEAFF	TRBV2	TRBJ1-1
TGTGCCATCAGCGGGAACTACTATGGCTACACCTTC	CAISGNYYGYTF	TRBV10-3	TRBJ1-2
TGTGCCAGCGAACTAGCGACAGCCTACGAGCAGTACTTC	CASELATAYEQYF	TRBV28	TRBJ2-7
TGTGCCAGCAGAACCCCGGAGGGTTGTAGCACAGATACGCAGTATTTT	CASRTPEGCSTDTQYF	TRBV6-1	TRBJ2-3
TGTGCCAGGAGGGGGGCGGAAGAGACCCAGTACTTC	CARRGAEETQYF	TRBV5-4	TRBJ2-5
TGCGCCAGCAGCGGACCGTTCGACGAGCAGTACTTC	CASSGPFDEQYF	TRBV5-1	TRBJ2-7
TGTGCCAGCAGCGTAGAAGGGCTCCGGGACAGCACCGATGGCTACACCTTC	CASSVEGLRDSTDGYTF	TRBV9	TRBJ1-2
TGTGCCAGCGATCTAACCGTCTCCTACAATGAGCAGTTCTTC	CASDLTVSYNEQFF	TRBV6-2	TRBJ2-1
TGCGCCAGCAGCCAAGACTATGGCAGCTCCTACAATGAGCAGTTCTTC	CASSQDYGSSYNEQFF	TRBV4-1	TRBJ2-1
TGCAGTGCTAGAGAGGCGTCACCCCTCCACTTT	CSAREASPLHF	TRBV20-1	TRBJ1-6
TGTGCCAATCATAATGACAGGGAAGGGGGGGGGAACACTGAAGCTTTCTTT	CANHNDREGGGNTEAFF	TRBV27	TRBJ1-1
TGCGCCAAAAGTGGAGACAGGGGGCTGCGGGGAAGCAATCAGCCCCAGCATTTT	CAKSGDRGLRGSNQPQHF	TRBV10-1	TRBJ1-5
TGTGCCATCCCCCGGGACACCACATATAGCAATCAGCCCCAGCATTTT	CAIPRDTTYSNQPQHF	TRBV2	TRBJ1-5
TGTGCCAGCAGTGTGACAGGGTCCGAATACGCTGAAGCTTTCTTT	CASSVTGSEYAEAFF	TRBV6-5	TRBJ1-1
TGTGCCAGCAGTTACCCAGGTGAGAGCTCCTATAATTCACCCCTCCACTTT	CASSYPGESSYNSPLHF	TRBV6-5	TRBJ1-6
TGCGCCAGCAGTGAGAGCCCTGGGGGGGTAGAGCAGTACTTC	CASSESPGGVEQYF	TRBV10-2	TRBJ2-7
TGTGCCAGCAGCGATTGGGAGGGTAGCCATAATTCACCCCTCCACTTT	CASSDWEGSHNSPLHF	TRBV5-4	TRBJ1-6
TGTGCCAGCAGCCGACTTCCGGGACATAGTCTCTTC	CASSRLPGHSLF	TRBV11-3	TRBJ2-1
TGTGCCACCTGGGTAGCCAGCCGGGGGAATCGTGAAGCTTTCTTT	CATWVASRGNREAFF	TRBV24-1	TRBJ1-1
TGTGCCAGCAGTTCGCCTGAGGCTCCTAACTATGGCTACACCTTC	CASSSPEAPNYGYTF	TRBV27	TRBJ1-2
TGCAATGAGTCTACCGGGGAGCTGTTTTTT	CNESTGELFF	TRBV20-1	TRBJ2-2
TGTGCCAGCCACAGGGTTAACTATGGCTACACCTTC	CASHRVNYGYTF	TRBV6-5	TRBJ1-2
TGTGCCAGCACCCGGGGGCCTTTTTACGAGCAGTACTTC	CASTRGPFYEQYF	TRBV28	TRBJ2-7
TGTGCCAGCAGTTGCGCCCGGGGCAATCAGGGGGGGCCCTACGAGCAGTACTTC	CASSCARGNQGGPYEQYF	TRBV27	TRBJ2-7
TGTGCCATCAGCAACAGGCATCAGCCCCAGCATTTT	CAISNRHQPQHF	TRBV10-3	TRBJ1-5
TGTGCCAGCAGCCATGCGATGGACAGGGTTCAGCCCCAGCATTTT	CASSHAMDRVQPQHF	TRBV14	TRBJ1-5
TGTGCCAGCAGTGGCTTGTATAAAACTGGCTACACCTTC	CASSGLYKTGYTF	TRBV6-6	TRBJ1-2
TGTGCCAGCAGTTACGGACAGGGTAGGAGAGAAGAGACCCAGTACTTC	CASSYGQGRREETQYF	TRBV6-2	TRBJ2-5
TGTGCCAGCAACCGGGGAGGAAAACTGTTTTTT	CASNRGGKLFF	TRBV2	TRBJ1-4
TGTGCCTGGAGTGGGAGCTACGAGCAGTACTTC	CAWSGSYEQYF	TRBV30	TRBJ2-7
TGCAGTGCTAGAGATTCTTTAAGGACAGGGTGTGGGTACAATGAGCAGTTCTTC	CSARDSLRTGCGYNEQFF	TRBV20-1	TRBJ2-1
TGCGCCACCAAGGTACCGACAGGCGAGACCCAGTACTTC	CATKVPTGETQYF	TRBV10-1	TRBJ2-5
TGCGCCAGCAGCTTAGCAGTCAGGAACACTGAAGCTTTCTTT	CASSLAVRNTEAFF	TRBV5-1	TRBJ1-1
TGTGCCAGCAGCTTGGGGACAGGGGTTAATTACGAGCAGTACTTC	CASSLGTGVNYEQYF	TRBV7-6	TRBJ2-7
TGCGCCAGCACTGGACTAGCGGTGCAAGAGACCCAGTACTTC	CASTGLAVQETQYF	TRBV10-1	TRBJ2-5
TGCGCCAGCAGCCAAGATAGTCCAGACAGGGAGTCTAATCAGCCCCAGCATTTT	CASSQDSPDRESNQPQHF	TRBV4-1	TRBJ1-5
TGTGCCAGCAGTATGCCCGCAGGGAGGACTGACTATGGCTACACCTTC	CASSMPAGRTDYGYTF	TRBV12-4	TRBJ1-2
TGTGCCAGCTCACCACCCCGACCGGTGCGTGGGGTCCGCGGGGCCAAAAACATTCAGTACTTC	CASSPPRPVRGVRGAKNIQYF	TRBV18	TRBJ2-4
TGCGCCAGCAGCTTGCCAAATCAGGGGCCCTATAATTCACCCCTCCACTTT	CASSLPNQGPYNSPLHF	TRBV5-1	TRBJ1-6
TGCGCCAGCAGCTTGATTACAGGGGGCCGAAACACCGGGGAGCTGTTTTTT	CASSLITGGRNTGELFF	TRBV5-1	TRBJ2-2
TGTGCCAGCAGTCTGCGGAATGCCTACAATGAGCAGTTCTTC	CASSLRNAYNEQFF	TRBV6-4	TRBJ2-1
TGTGCCAGCAGCCAAGAAGTGGAGACGGGGACTAGTCGGAATGAAAAACTGTTTTTT	CASSQEVETGTSRNEKLFF	TRBV3-1	TRBJ1-4
TGCGCCAGCAGCATCAGCGGGGGCTCTGGGGCCAACGTCCTGACTTTC	CASSISGGSGANVLTF	TRBV5-1	TRBJ2-6
TGTGCCAGCAGCGTCCAAATCTGGGGAGAGGTCATGAACACTGAAGCTTTCTTT	CASSVQIWGEVMNTEAFF	TRBV7-7	TRBJ1-1
TGTGCCAGCAGTTACTCGAAACTAGCGGGGAATGAGCAGTTCTTC	CASSYSKLAGNEQFF	TRBV6-5	TRBJ2-1
TGCGCCAGCAGCATCCGCGTGTTCGCGGGGGGGGCAGGCACAGATACGCAGTATTTT	CASSIRVFAGGAGTDTQYF	TRBV5-1	TRBJ2-3
TGTGCCAGCAGTATCTTGCGCCTGCCTGACGGGACTAGCGGGCAAGAGACCCAGTACTTC	CASSILRLPDGTSGQETQYF	TRBV12-4	TRBJ2-5
TGTGCCAGCAGCATCGGAACGCCGGGGAGCTACGAGCAGTACTTC	CASSIGTPGSYEQYF	TRBV5-8	TRBJ2-7
TGTGCCGTTCAACCCTACGAGCAGTACTTC	CAVQPYEQYF	TRBV28	TRBJ2-7
TGTGCCAGCAGTTCTCAAAGGAGGGGGCACCCCTACGAGCAGTACTTC	CASSSQRRGHPYEQYF	TRBV6-3	TRBJ2-7
TGTGCCAGCAAGCCAGGGACCTCTAACTATGGCTACACCTTC	CASKPGTSNYGYTF	TRBV3-1	TRBJ1-2
TGCGCCAGCAGAAGACAGGCCAAAGGGGACTATGGCTACACCTTC	CASRRQAKGDYGYTF	TRBV5-1	TRBJ1-2
TGTGCCAGCAGTTACGCCAACAGGGTCTGCTATGGCTACACCTTC	CASSYANRVCYGYTF	TRBV6-5	TRBJ1-2
TGTGCCAGCAGCGGGGTTCACACTGAAGCTTTCTTT	CASSGVHTEAFF	TRBV6-1	TRBJ1-1
TGCGCCAGCAGCGGCGGTGTTCGAGGTGGATCGCCGGGGGGCTCCTCTGGGGCCAACGTCCTGACTTTC	CASSGGVRGGSPGGSSGANVLTF	TRBV5-1	TRBJ2-6
TGTGCCATCTTGCCGGAGCCCTTTATAACTTTGACCCAGTACTTC	CAILPEPFITLTQYF	TRBV5-4	TRBJ2-5
TGTGCCAGCAGCATCTATGAGCAGTTCTTC	CASSIYEQFF	TRBV7-3	TRBJ2-1
TGTGCCAGCAGCTTCTCAGGATCCAGCAATCAGCCCCAGCATTTT	CASSFSGSSNQPQHF	TRBV7-8	TRBJ1-5
TGTGCCAGCAGTGTCCGGCCAGGGTGGGCGAATCAGCCCCAGCATTTT	CASSVRPGWANQPQHF	TRBV6-1	TRBJ1-5
TGTGCCAGCAGGGGAGTGGGGGACCAATCACCCCTCCACTTT	CASRGVGDQSPLHF	TRBV6-5	TRBJ1-6
TGTGCCAGCAGCTTGAGAAAAAGGACTGGAGCCGTGAACACTGAAGCTTTCTTT	CASSLRKRTGAVNTEAFF	TRBV5-6	TRBJ1-1
TGTGCCAGCAGTGAATACCGGGACAGGTACGAGCAGTACTTC	CASSEYRDRYEQYF	TRBV25-1	TRBJ2-7
TGCGCCAGCCCGGGACTAGCGGGACAGAACACCGGGGAGCTGTTTTTT	CASPGLAGQNTGELFF	TRBV10-1	TRBJ2-2
TGTGCCACCAGTACGACAGGGGTTCCGTGGATCTCTGGGGCCAACGTCCTGACTTTC	CATSTTGVPWISGANVLTF	TRBV24-1	TRBJ2-6
TGTGCCAGGGAGGGTATCTCTAATGAAAAACTGTTTTTT	CAREGISNEKLFF	TRBV19	TRBJ1-4
TGTGCCAGCAGCTGCCAGGCCACCGGGACAGGCGTCAATGGCTACACCTTC	CASSCQATGTGVNGYTF	TRBV3-1	TRBJ1-2
TGTGCCATCAGTGAGAATCAGGGGGGCACTGAAGCTTTCTTT	CAISENQGGTEAFF	TRBV10-3	TRBJ1-1
TGTGCCAGCAGCCCGGAGGTGTACGAGCAGTACTTC	CASSPEVYEQYF	TRBV7-2	TRBJ2-7
TGTGCCAGCAGCCCTTTAATGGACAGGGACACTGAAGCTTTCTTT	CASSPLMDRDTEAFF	TRBV7-9	TRBJ1-1
TGTGCCAGCAGAACCTTAGTTAAGGAGACCCAGTACTTC	CASRTLVKETQYF	TRBV27	TRBJ2-5
TGCAGTGCTAGTCCAGGACAGGGAGCCAAAGGGGTGCACACCATATATTTT	CSASPGQGAKGVHTIYF	TRBV20-1	TRBJ1-3
TGTGCCAGCAGTTGGTACCCCCGGGACAGCAGCTCCTACGAGCAGTACTTC	CASSWYPRDSSSYEQYF	TRBV27	TRBJ2-7
TGTGCCATCGACGGGGGACTCAAGTACGAGCAGTACTTC	CAIDGGLKYEQYF	TRBV10-3	TRBJ2-7
TGTGCCAGCAGTGTAATAGGGGGTCGTTCTGGAGATACGCAGTATTTT	CASSVIGGRSGDTQYF	TRBV2	TRBJ2-3
TGTGCCACCAGTGATTACCGCGGGACAGGGGGAAAGTGCAATCAGCCCCAGCATTTT	CATSDYRGTGGKCNQPQHF	TRBV24-1	TRBJ1-5
TGTGACGTTAGCGGGACGGGAGCCACAGATACGCAGTATTTT	CDVSGTGATDTQYF	TRBV7-9	TRBJ2-3
TGCGCCAGCAGTGATCGGGACAGGTTTACCCAGCCCCAGCATTTT	CASSDRDRFTQPQHF	TRBV10-1	TRBJ1-5
TGTGCCAGCAGAAGGACGACACACGAGCAGTACTTC	CASRRTTHEQYF	TRBV6-3	TRBJ2-7
TGTGCCAGCAGTGAATGCCTATTAGAGGGACTAGCGGGATGGTCTTGGTACTCCTACGAGCAGTACTTC	CASSECLLEGLAGWSWYSYEQYF	TRBV25-1	TRBJ2-7
TGTGCCAGCAGCCCCCGTGGGACGCACGAAAGCTCCTACGAGCAGTACTTC	CASSPRGTHESSYEQYF	TRBV5-6	TRBJ2-7
TGTGCCACACGGGGGGCCTATGAGCAGTACTTC	CATRGAYEQYF	TRBV28	TRBJ2-7
TGTGCCAGCAGACCGAGGACAGGCGGATACGAGCAGTACTTC	CASRPRTGGYEQYF	TRBV6-2	TRBJ2-7
TGTGCCAGCAGCCGAGAAGAAGGGTGGGATGATCTGAACACTGAAGCTTTCTTT	CASSREEGWDDLNTEAFF	TRBV14	TRBJ1-1
TGTGCCAGCAGCGTAGTGTGCACATTGACAGACGCTGAAGCTTTCTTT	CASSVVCTLTDAEAFF	TRBV9	TRBJ1-1
TGCAGTGCATTTCCCGGGACAGGGGGGGGTATAGAGACCCAGTACTTC	CSAFPGTGGGIETQYF	TRBV20-1	TRBJ2-5
TGTGCCAGCACCCCTTCGAGGGACAGGGGAGGAGCTGGGGCCAACGTCCTGACTTTC	CASTPSRDRGGAGANVLTF	TRBV6-4	TRBJ2-6
TGCGCCAGCAGCCCTGAGACTCCGAAAGAGACCCAGTACTTC	CASSPETPKETQYF	TRBV5-1	TRBJ2-5
TGCGCCAGCAGCTTGGCCAACGGGGACAAAATGACCCTGTATGGCTACACCTTC	CASSLANGDKMTLYGYTF	TRBV5-1	TRBJ1-2
TGCAGTGCTAGAGCGTCCAATGGGGGGGCGGGGGAGCGTCACGAGCAGTACTTC	CSARASNGGAGERHEQYF	TRBV20-1	TRBJ2-7
TGTGCCAGCAGCTCTCTAGCGGACAGGTCGGGACAAGAGACCCAGTACTTC	CASSSLADRSGQETQYF	TRBV7-3	TRBJ2-5
TGTGCCAGCAGCTTGGCGGGGGCCGACTTC	CASSLAGADF	TRBV5-6	TRBJ2-7
TGTGCCAGCAGTCCAGGGGCTGGGACTAGACAAGAGACCCAGTACTTC	CASSPGAGTRQETQYF	TRBV5-6	TRBJ2-5
TGTGCCACCATTCGGGGGGGTGGCTACACCTTC	CATIRGGGYTF	TRBV24-1	TRBJ1-2
TGTGCCAGTAGGTGCACCGGGGAGCTGTTTTTT	CASRCTGELFF	TRBV6-2	TRBJ2-2
TGTGCCAGCAGCTTACCAAACAGGGGCGACCTCTACGAGCAGTACTTC	CASSLPNRGDLYEQYF	TRBV7-3	TRBJ2-7
TGTGCCAGCAGTGCAGTTGGGGGCATAAGTTGTGATGAGCAGTTCTTC	CASSAVGGISCDEQFF	TRBV25-1	TRBJ2-1
TGTGCCAGCAGCTTACACCCGGTGGGGGTCAGGGGTTATGAGCAGTACTTC	CASSLHPVGVRGYEQYF	TRBV11-3	TRBJ2-7
TGTGCCAGCAGCTTAGACGTCGCGGAGGCCTCCATGAACACTGAAGCTTTCTTT	CASSLDVAEASMNTEAFF	TRBV11-3	TRBJ1-1
TGTGCCAGCCAGACTAGCGGGAGCACAGATACGCAGTATTTT	CASQTSGSTDTQYF	TRBV28	TRBJ2-3
TGTGCCAGCAGGTGGGGAAGGAGTTCGCCCTACGAGCAGTACTTC	CASRWGRSSPYEQYF	TRBV11-3	TRBJ2-7
TGTGCCAGCAGTGGAAGAAAAGATACGCAGTATTTT	CASSGRKDTQYF	TRBV6-1	TRBJ2-3
TGTGCCAGCAGCTTAGGACTCTCGCGGTGGTTGAATGAGCAGTTCTTC	CASSLGLSRWLNEQFF	TRBV11-2	TRBJ2-1
TGTGCCAGCAGCTTTAGCACCCCTGGCTACACCTTC	CASSFSTPGYTF	TRBV7-9	TRBJ1-2
TGTGCCAGCAGCGTGCATGGAATTGCGGGAGAGGCGCGGAATGAAAAACTGTTTTTT	CASSVHGIAGEARNEKLFF	TRBV9	TRBJ1-4
TGTGCCAGCAGCCGATCGAGGGGGCACTCCTACGAGCAGTACTTC	CASSRSRGHSYEQYF	TRBV14	TRBJ2-7
TGCGCCAGCAGCTTGTCACTGGGGCTTTCCACCGGGGAGCTGTTTTTT	CASSLSLGLSTGELFF	TRBV5-1	TRBJ2-2
TGTGCCAGCAGCTTGGGTAGCCTGGCGTGGGCCTATAATTCACCCCTCCACTTT	CASSLGSLAWAYNSPLHF	TRBV5-6	TRBJ1-6
TGTGCCAGGGGGGCCTTAGAGCCTAGCACAGATACGCAGTATTTT	CARGALEPSTDTQYF	TRBV12-3	TRBJ2-3
TGTGCCAGCTCACGAGATCCTGGGGTGCCCAGCGTACCGAACACCGGGGAGCTGTTTTTT	CASSRDPGVPSVPNTGELFF	TRBV18	TRBJ2-2
TGTGCCAGCAGCTTAGATCAAGGTAGCAGGGGAGCTTTCTTT	CASSLDQGSRGAFF	TRBV11-2	TRBJ1-1
TGTGCCAGCAGCCCTCCCGTGGGCGGACGCTACACCTTC	CASSPPVGGRYTF	TRBV7-3	TRBJ1-2
TGTGCCAGTAGTAGTGGTGATTCACCCCTCCACTTT	CASSSGDSPLHF	TRBV19	TRBJ1-6
TGTGCCAGCAGTGAAAGAACGACTAGCGGTTTAAGGGATACGCAGTATTTT	CASSERTTSGLRDTQYF	TRBV2	TRBJ2-3
TGTGCCTGGAGCCGAAACTTCGCAGGGGAGCAGTACTTC	CAWSRNFAGEQYF	TRBV30	TRBJ2-7
TGCGCCAGCAGCTTGAGGCGGAGACTTGGTATTGAGACCCAGTACTTC	CASSLRRRLGIETQYF	TRBV5-1	TRBJ2-5
TGCGCCAGCAGCTCTCGGGAAAGAAACATTCAGTACTTC	CASSSRERNIQYF	TRBV4-1	TRBJ2-4
TGTGCCAGCAGCCAAGTCTTCGCCTGGTACAATGAGCAGTTCTTC	CASSQVFAWYNEQFF	TRBV14	TRBJ2-1
TGTGCCAGCAGTCAGAGGAGGGGAGAGCAGTTCTTC	CASSQRRGEQFF	TRBV6-5	TRBJ2-1
TGTGCCACGCACGAGAGTCTTGGCTCCTATAATTCACCCCTCCACTTT	CATHESLGSYNSPLHF	TRBV24-1	TRBJ1-6
TGTGCCAGCAACCGTAGGGGTGACCAGTACTTC	CASNRRGDQYF	TRBV7-9	TRBJ2-5
TGTGCCAGCAGGGGGGTCCGTCCCCCCCAAGAGACCCAGTACTTC	CASRGVRPPQETQYF	TRBV28	TRBJ2-5
TGTGCCCCGGGACAGGGCGAAAATCAGCCCCAGCATTTT	CAPGQGENQPQHF	TRBV7-6	TRBJ1-5
TGTGCCAGCAGTGACTGGGGTTCGGGACTGAATGAGCAGTTCTTC	CASSDWGSGLNEQFF	TRBV6-4	TRBJ2-1
TGTGCCAGCAGCCTAGAAGGGGGTGATCAGCCCCAGCATTTT	CASSLEGGDQPQHF	TRBV14	TRBJ1-5
TGTGCCAGCAGCTTAGGAGGACAGGGGGCGTGCACTAATGAAAAACTGTTTTTT	CASSLGGQGACTNEKLFF	TRBV11-3	TRBJ1-4
TGTGCCAGCACAGTTGGCGGGCAAGAGACCCAGTACTTC	CASTVGGQETQYF	TRBV25-1	TRBJ2-5
TGTGCCAGCAGAAATAGGGGATTGTACGAGCAGTACTTC	CASRNRGLYEQYF	TRBV28	TRBJ2-7
TGCGCCAGCAGCCAAGGGGCATGTTACGAGCAGTACTTC	CASSQGACYEQYF	TRBV4-3	TRBJ2-7
TGTGCCAGCAGCAAACCTCCGGGTTCAGGAGAAAGCTCCTACGAGCAGTACTTC	CASSKPPGSGESSYEQYF	TRBV13	TRBJ2-7
TGTGCCAGCAGCCATCTCGCGCTAGCGGACTTAAGGCCGCCCTACAATGAGCAGTTCTTC	CASSHLALADLRPPYNEQFF	TRBV14	TRBJ2-1
TGTGCCAGCAGGCATAGCTTCGTTCTAGAGCAGTACTTC	CASRHSFVLEQYF	TRBV27	TRBJ2-7
TGTGCCACCAGTGTCGAAGCCGGGACAGCTTACTACGAGCAGTACTTC	CATSVEAGTAYYEQYF	TRBV24-1	TRBJ2-7
TGTGCCAGCAGCTTAGCGTTACCCAACAGGCCTGGGTCCAGCTACGAGCAGTACTTC	CASSLALPNRPGSSYEQYF	TRBV7-9	TRBJ2-7
TGTGCCAGTAGTATACAGGGGGACCCGGGGCCGACTGAAGCTTTCTTT	CASSIQGDPGPTEAFF	TRBV19	TRBJ1-1
TGTGCCAGCAGTTATAGTGGACCAGGGTATGGCTACACCTTC	CASSYSGPGYGYTF	TRBV6-3	TRBJ1-2
TGTGCCAGCAGCTTAAAAACGCGCGGGACCTACACTGAAGCTTTCTTT	CASSLKTRGTYTEAFF	TRBV7-3	TRBJ1-1
TGTGCCACCAGCAACAGACAGGACTACGAGCAGTACTTC	CATSNRQDYEQYF	TRBV24-1	TRBJ2-7
TGTGCCAGCAGATCCCCGGGATGGGCCTCCTACGAGCAGTACTTC	CASRSPGWASYEQYF	TRBV28	TRBJ2-7
TGCGCCAGCAGGGTCTATCACGGTGGGGGTTCAAACACCATATATTTT	CASRVYHGGGSNTIYF	TRBV10-1	TRBJ1-3
TGTGCCATCAACAGGGCAATGAACACTGAAGCTTTCTTT	CAINRAMNTEAFF	TRBV10-3	TRBJ1-1
TGTGCCAGCAGCGTCCTCTGGACCCTAGCGGTTCGGGGACCGAACACCGGGGAGCTGTTTTTT	CASSVLWTLAVRGPNTGELFF	TRBV9	TRBJ2-2
TGCGCCAGCAGTGAGAGACTAGGTAGCTGGACATACGAGCAGTACTTC	CASSERLGSWTYEQYF	TRBV10-1	TRBJ2-7
TGTGGGGCGGAACAGGGCGGAGGCAATCAGCCCCAGCATTTT	CGAEQGGGNQPQHF	TRBV9	TRBJ1-5
TGTGCCAGCAGGGGGACAATCACTGAAGCTTTCTTT	CASRGTITEAFF	TRBV7-4	TRBJ1-1
TGTGCCAGCAGCTTGCATACCCTTCAGGGACAGGGGGGGGAGCATCAGCCCCAGCATTTT	CASSLHTLQGQGGEHQPQHF	TRBV5-4	TRBJ1-5
TGCGCCAGCAGCTTGGCGGTGTCCCACATCAATTCACCCCTCCACTTT	CASSLAVSHINSPLHF	TRBV5-1	TRBJ1-6
TGTGCCAGCAGCTTTAAGGGGGAGAGATGCAATCAGCCCCAGCATTTT	CASSFKGERCNQPQHF	TRBV5-8	TRBJ1-5
TGTGCCAGCAGCTTAGATGCGATGGGGGCTGGCAATCAGCCCCAGCATTTT	CASSLDAMGAGNQPQHF	TRBV7-2	TRBJ1-5
TGTGCCAGCAGTTTGCCAGTGGCGGGGGGGGCCTATGGCTACACCTTC	CASSLPVAGGAYGYTF	TRBV12-3	TRBJ1-2
TGTGCCAGCAGCTTAGGTCACGACAGTTTAGACACTGAAGCTTTCTTT	CASSLGHDSLDTEAFF	TRBV7-4	TRBJ1-1
TGTGCCAGTACCGCATACTATGAGACCCAGTACTTC	CASTAYYETQYF	TRBV19	TRBJ2-5
TGTGCCAGCAGCCTGGGCGGGGCGACTGAAGCTTTCTTT	CASSLGGATEAFF	TRBV9	TRBJ1-1
TGTGCCAGCAGACGGGACAGGGAGGCAATAGCTAACTATGGCTACACCTTC	CASRRDREAIANYGYTF	TRBV6-5	TRBJ1-2
TGTGCCTGGAGTCAGGACAGGGACCCTTCGGACGCGCAGTACTTC	CAWSQDRDPSDAQYF	TRBV30	TRBJ2-7
TGTGCCAGCTCTGTCGAAGGGGACAGGGGGCTGCCCTACGAGCAGTACTTC	CASSVEGDRGLPYEQYF	TRBV18	TRBJ2-7
TGTGCCAGCAGTGACTCAAGCGGGAATACTACTGAAGCTTTCTTT	CASSDSSGNTTEAFF	TRBV6-4	TRBJ1-1
TGTGCCAGTAGTGGCCTAGCGGGGATCTTC	CASSGLAGIF	TRBV19	TRBJ2-1
TGTGCCAGCAGTTTATCGAGTCCGACTAGAGATGAGCAGTTCTTC	CASSLSSPTRDEQFF	TRBV27	TRBJ2-1
TGTGCTAGTGGTTCTTGGGCTGCGTTACGGGAGCTGTTTTTT	CASGSWAALRELFF	TRBV12-5	TRBJ2-2
TGTGCCAGCAGCTTAGACTCCTATAATTCACCCCTCCACTTT	CASSLDSYNSPLHF	TRBV7-4	TRBJ1-6
TGTGCCAGCAGCGCAACGGCTGAAAATGAAAAACTGTTTTTT	CASSATAENEKLFF	TRBV13	TRBJ1-4
TGTGCCAGCACTGCATTCTATGGCTACACCTTC	CASTAFYGYTF	TRBV7-3	TRBJ1-2
TGTGCCAGCAGCCAAGGGGGGAGGGCCTACAATGAGCAGTTCTTC	CASSQGGRAYNEQFF	TRBV4-2	TRBJ2-1
TGTGCCGGGGGAAGACAGATCGGAGAATCACCCCTCCACTTT	CAGGRQIGESPLHF	TRBV2	TRBJ1-6
TGCGCCAGCAGCTTGGGCCCTCCTACCTGGGGTGCAACTAATGAAAAACTGTTTTTT	CASSLGPPTWGATNEKLFF	TRBV5-1	TRBJ1-4
TGTGCCAGCAGCCAAGCGCCCCTGGGGGGGGTTCACTATGGCTACACCTTC	CASSQAPLGGVHYGYTF	TRBV4-2	TRBJ1-2
TGTGCCAGCAGTTACGGAGTTAGCGGGCCATGCACAGATACGCAGTATTTT	CASSYGVSGPCTDTQYF	TRBV12-3	TRBJ2-3
TGTGCCTGGATTCCGGGGGGGCTAACGCATACTCAAGAGACCCAGTACTTC	CAWIPGGLTHTQETQYF	TRBV30	TRBJ2-5
TGTGCCAGCAGGGGCGGACAGGGTTCGGAAAAACTGTTTTTT	CASRGGQGSEKLFF	TRBV6-1	TRBJ1-4
TGTGCCAGCAGTTCCGGGGGGCAGTACTTC	CASSSGGQYF	TRBV27	TRBJ2-7
TGTGCCACCAGTGATTTGCGGGCAGGGGGCTTTGCGCCACCCCTCCACTTT	CATSDLRAGGFAPPLHF	TRBV24-1	TRBJ1-6
TGTGCCAGCAGCCGACAGGGGGAGCCCCAGCATTTT	CASSRQGEPQHF	TRBV13	TRBJ1-5
TGTGCCAGCAGTGGCTCCTCGGGGTCTTACGGATCAGCTTTCTTT	CASSGSSGSYGSAFF	TRBV6-4	TRBJ1-1
TGTGCCAGCAGCGGCTCCTTATTGTCAACTAATGAAAAACTGTTTTTT	CASSGSLLSTNEKLFF	TRBV12-3	TRBJ1-4
TGTGCCAGCAGCCTACCCATTAAGCCTGATGACAATGAGCAGTTCTTC	CASSLPIKPDDNEQFF	TRBV7-3	TRBJ2-1
TGTGCCAGCAGAACCGCGGACACCTACGAGCAGTACTTC	CASRTADTYEQYF	TRBV12-3	TRBJ2-7
TGTGCCAGCAGTGGGGGGGCTTATGGCTACACCTTC	CASSGGAYGYTF	TRBV6-1	TRBJ1-2
TGCAGTACGAGGGGGTGGGGGAGGAACACCGGGGAGCTGTTTTTT	CSTRGWGRNTGELFF	TRBV20-1	TRBJ2-2
TGTGCCAGCAGCTTAAGGGCTCAGCCCCAGCATTTT	CASSLRAQPQHF	TRBV7-3	TRBJ1-5
TGCAGTGCTAAGGACGGGGAGACCCAGTACTTC	CSAKDGETQYF	TRBV20-1	TRBJ2-5
TGTGCCACCAGAGCCCTCGGGGCCGACTATGGCTACACCTTC	CATRALGADYGYTF	TRBV24-1	TRBJ1-2
TGTGCCAGCAGCCCATGGACAGAGTCCGGCTCCAAAAACATTCAGTACTTC	CASSPWTESGSKNIQYF	TRBV5-6	TRBJ2-4
TGTGCCAGCAGCTTAGGCGGGGTGACTGAAGCTTTCTTT	CASSLGGVTEAFF	TRBV7-9	TRBJ1-1
TGTGCCAGCAGTAACAGGGACAGCGGTAACTATGGCTACACCTTC	CASSNRDSGNYGYTF	TRBV6-1	TRBJ1-2
TGTGCCAGCAGCGGCAAAGGGGACAGGGGGGGGGTAGGGTTCTACGAGCAGTACTTC	CASSGKGDRGGVGFYEQYF	TRBV7-3	TRBJ2-7
TGTGCCAGCAGCTTAAACAGTAACACCATATATTTT	CASSLNSNTIYF	TRBV7-3	TRBJ1-3
TGTGCCAGCATCCCGAGCGGGGACGAGATTCGCAATCAGCCCCAGCATTTT	CASIPSGDEIRNQPQHF	TRBV9	TRBJ1-5
TGTGCCAGCAGTTACTTAGGTTCAAAGGGCCGACAGAAACAGTTTCCGGATACGCAGTATTTT	CASSYLGSKGRQKQFPDTQYF	TRBV6-5	TRBJ2-3
TGTGCCAGCAGCTTAGCCCGGACTACTTGCTACGAGCAGTACTTC	CASSLARTTCYEQYF	TRBV11-2	TRBJ2-7
TGTGCCAGCAGCTTAGAATTTAGCGGGCCCCAAAGCCAAGAGACCCAGTACTTC	CASSLEFSGPQSQETQYF	TRBV11-3	TRBJ2-5
TGTGCCAGCAGTGTTGAGGGAAGGCAAGAGACCCAGTACTTC	CASSVEGRQETQYF	TRBV28	TRBJ2-5
TGTGCCAGCAGTTGCCGGGAGACCCAGTACTTC	CASSCRETQYF	TRBV6-5	TRBJ2-5
TGCGCCAGCAGCTTGGTTATCTATTCGGGAGGGCAAGATACGCAGTATTTT	CASSLVIYSGGQDTQYF	TRBV5-1	TRBJ2-3
TGTGCCAGCAGACCAGGGCGGTCCTACGAGCAGTACTTC	CASRPGRSYEQYF	TRBV27	TRBJ2-7
TGTGCCAGCAGTTTATGCCCCAGAAGCACTGAAGCTTTCTTT	CASSLCPRSTEAFF	TRBV28	TRBJ1-1
TGTGCCAGCAGCTGGGGTTTATCGGGCCGGGCGTCCTACGAGCAGTACTTC	CASSWGLSGRASYEQYF	TRBV11-2	TRBJ2-7
TGTGCCAGCAGCCCGGGGCGAGAGGGCTACACCTTC	CASSPGREGYTF	TRBV13	TRBJ1-2
TGTGCCAGATTCAATCCAAATTCTGGAAACACCATATATTTT	CARFNPNSGNTIYF	TRBV6-1	TRBJ1-3
TGTGCCAGCAGTTACAGGGGGCACTTC	CASSYRGHF	TRBV6-8	TRBJ2-5
TGTGCCACGTCATTTCCCCCGGGGGGGAGGCCAGACACTGAAGCTTTCTTT	CATSFPPGGRPDTEAFF	TRBV24-1	TRBJ1-1
TGTGCCAGCAGCTCAGGCATCCGGCAGCGGAGCCATCAGCCCCAGCATTTT	CASSSGIRQRSHQPQHF	TRBV5-6	TRBJ1-5
TGCAGTGCGTTAACAGTCGCCGGCAAAAACATTCAGTACTTC	CSALTVAGKNIQYF	TRBV20-1	TRBJ2-4
TGTGCCAGCAGCGGGATCCATCTAAAGAGGGGGTGCTACGAGCAGTACTTC	CASSGIHLKRGCYEQYF	TRBV9	TRBJ2-7
TGTGCCAGCAGCGTTGGGTCTTCAGTTCGCTCTAACTATGGCTACACCTTC	CASSVGSSVRSNYGYTF	TRBV7-9	TRBJ1-2
TGTGCCAGCAGACAAGCGGCCCGGATGGTCCGTGAGACCCAGTACTTC	CASRQAARMVRETQYF	TRBV27	TRBJ2-5
TGCGCCAGTGTGGAGGACCGGAACACTGAAGCTTTCTTT	CASVEDRNTEAFF	TRBV4-1	TRBJ1-1
TGTGCCAGCAGTGAGAGGGGAAACTATAGCAATCAGCCCCAGCATTTT	CASSERGNYSNQPQHF	TRBV27	TRBJ1-5
TGTGCCTGGAGGCCGATCAGGAGAGAGACCCAGTACTTC	CAWRPIRRETQYF	TRBV30	TRBJ2-5
TGTGCCAGCAGACCCGGAATTGATAATTCACCCCTCCACTTT	CASRPGIDNSPLHF	TRBV28	TRBJ1-6
TGCAGCGTCTCCATACCGCCCTGGTCAGGCCCTGGAACCTTC	CSVSIPPWSGPGTF	TRBV29-1	TRBJ1-2
TGTGCCAGCAGCTTGGACTCAGGGGGGGTGAACACTGAAGCTTTCTTT	CASSLDSGGVNTEAFF	TRBV11-3	TRBJ1-1
TGTGCCGTTGCGGGCAACACTGAAGCTTTCTTT	CAVAGNTEAFF	TRBV12-3	TRBJ1-1
TGTGCCACCAGTGACAGGGCAGGAAACACCATATATTTT	CATSDRAGNTIYF	TRBV24-1	TRBJ1-3
TGTGCCAGCATTTGGAGGAGTACTGAAGCTTTCTTT	CASIWRSTEAFF	TRBV3-1	TRBJ1-1
TGTGCCAGCAGCTCCCGGGACAGGATAACCTACAATGAGCAGTTCTTC	CASSSRDRITYNEQFF	TRBV5-5	TRBJ2-1
TGTGCCAGCAGCTCCTATGACAGGGGGCCCCGCTCTGGAAACACCATATATTTT	CASSSYDRGPRSGNTIYF	TRBV13	TRBJ1-3
TGCGCCAGCAGTAGACCCGATAATCAGCCCCAGCATTTT	CASSRPDNQPQHF	TRBV10-1	TRBJ1-5
TGCGCCAGCAGCTTATCTACAGGGGGCCGAGGGAACTATGGCTACACCTTC	CASSLSTGGRGNYGYTF	TRBV5-1	TRBJ1-2
TGTGCCAGCAGCCAGGGGGAGGCGAATCAGCCCCAGCATTTT	CASSQGEANQPQHF	TRBV11-2	TRBJ1-5
TGTGCCAGCAGTTTAGAGGGACAGAGCAATCAGCCCCAGCATTTT	CASSLEGQSNQPQHF	TRBV28	TRBJ1-5
TGTGCCAGCAGCCACAGGGTCCAAGAGACCCAGTACTTC	CASSHRVQETQYF	TRBV13	TRBJ2-5
TGTGCCAGCAGCTTAAGAGTTGGACTAGCGGGGGGGCCTGAAGAGGAAGAGACCCAGTACTTC	CASSLRVGLAGGPEEEETQYF	TRBV7-2	TRBJ2-5
TGTGCCAGCAGTACCTCCAAGCAGGGGGACTATGGCTACACCTTC	CASSTSKQGDYGYTF	TRBV2	TRBJ1-2
TGTGCCAGCAGTTACCCCGGAGTGGTAGCGGGTGTGGCCCAAGAGACCCAGTACTTC	CASSYPGVVAGVAQETQYF	TRBV6-2	TRBJ2-5
TGCGCCAGCAGTGAGGGTGCCAGCCGGGCTACCTCTGGAAACACCATATATTTT	CASSEGASRATSGNTIYF	TRBV10-1	TRBJ1-3
TGTGCCAGCACTCGGGTTAGCGGGAGCCTCAATCCTTTCAATGACACTGAAGCTTTCTTT	CASTRVSGSLNPFNDTEAFF	TRBV6-5	TRBJ1-1
TGTGCCAGCAGTTTCCAACTGGGACAGGGGGATCACACTGAAGCTTTCTTT	CASSFQLGQGDHTEAFF	TRBV27	TRBJ1-1
TGCGCCAGCACAGGTCAGCATCAGCCCCAGCATTTT	CASTGQHQPQHF	TRBV4-1	TRBJ1-5
TGTGCCAGCAGTTACGGACTAGCGGGAGGCTTTAGGGCCGGGGAGCTGTTTTTT	CASSYGLAGGFRAGELFF	TRBV6-5	TRBJ2-2
TGTGCCATGCCGGAGGGGAACACTGAAGCTTTCTTT	CAMPEGNTEAFF	TRBV19	TRBJ1-1
TGCGCCAGCAGCTCCGACAGGACCAAGACTGAGCAGTTCTTC	CASSSDRTKTEQFF	TRBV4-1	TRBJ2-1
TGCGCCAGCAGTGACCGCGACTTTCGGGCTAGCACAGATACGCAGTATTTT	CASSDRDFRASTDTQYF	TRBV10-1	TRBJ2-3
TGTGCCAGCCTCGTGGAGGACGAGAGGGCGAACACCGGGGAGCTGTTTTTT	CASLVEDERANTGELFF	TRBV12-4	TRBJ2-2
TGTGCCGAGGTCCCTGCTGTTTCGGACGAGCAGTACTTC	CAEVPAVSDEQYF	TRBV10-3	TRBJ2-7
TGTGCCAGTAGTTTGCCAGGCCAAGGCTCCTACAATGAGCAGTTCTTC	CASSLPGQGSYNEQFF	TRBV19	TRBJ2-1
TGTGCCAGCAGCGAACTCGGGTGCTCCGAGCAGTACTTC	CASSELGCSEQYF	TRBV13	TRBJ2-7
TGTGCCTTCCCCGGGACAGGGGGTGCCCAGCATTTT	CAFPGTGGAQHF	TRBV30	TRBJ1-5
TGTGCCAGCAGCGCCCGGGGGGAACAAAAACTGTTTTTT	CASSARGEQKLFF	TRBV9	TRBJ1-4
TGTGCCAGTAGTCACCGGGACGGAGAGACCCAGTACTTC	CASSHRDGETQYF	TRBV19	TRBJ2-5
TGTGCCAGCAGTGAAGAGGACAGACCCGGGGTGGCAGCCCTCCACTTT	CASSEEDRPGVAALHF	TRBV25-1	TRBJ1-6
TGTGCCAGCAGTTATCCTCATCGGGCGTCTGAAAAACTGTTTTTT	CASSYPHRASEKLFF	TRBV6-8	TRBJ1-4
TGTGCCACTGGACAGTCCTCTGGAAACACCATATATTTT	CATGQSSGNTIYF	TRBV6-3	TRBJ1-3
TGTGCCAGCAGCTTACCCAAGGGGGGGCACTATTCACCCCTCCACTTT	CASSLPKGGHYSPLHF	TRBV11-1	TRBJ1-6
TGTGCCACCAGTGATTCATCGACTAGCGGAGCAGAGACCCAGTACTTC	CATSDSSTSGAETQYF	TRBV24-1	TRBJ2-5
TGTGCCAGCAGTTACTTCCCCACCATTAGGAGACTTTCACCCCTCCACTTT	CASSYFPTIRRLSPLHF	TRBV6-6	TRBJ1-6
TGTGCCAGCAGGCGTATACAGGGGTCGACCTCTGGGGCCAACGTCCTGACTTTC	CASRRIQGSTSGANVLTF	TRBV6-4	TRBJ2-6
TGTGCCAGCAGCTTCCGTCCGGGACTAGCGGGACGCGGCTACACCTTC	CASSFRPGLAGRGYTF	TRBV5-6	TRBJ1-2
TGTGCCAGCAGCACTTATATGGGTCAGTGGGGGGGAGGTCAGTACTTC	CASSTYMGQWGGGQYF	TRBV7-3	TRBJ2-5
TGCAGCGAAGAGGCGACAGGGGGCGAAGTAGCCTACGAGCAGTACTTC	CSEEATGGEVAYEQYF	TRBV29-1	TRBJ2-7
TGTGCCAGCAGCCAAGCCACCCCGGGACAGGGCACTGAAGCTTTCTTT	CASSQATPGQGTEAFF	TRBV3-1	TRBJ1-1
TGTGCCAGTCGGAACAGGCTATTGAACACTGAAGCTTTCTTT	CASRNRLLNTEAFF	TRBV6-4	TRBJ1-1
TGCAGTGCTAGAGATCTCATGGACGAGGCAACTGGAAACACCATATATTTT	CSARDLMDEATGNTIYF	TRBV20-1	TRBJ1-3
TGTGCCAGCAGAACTAGCGGGCGGGACGAGCAGTACTTC	CASRTSGRDEQYF	TRBV27	TRBJ2-7
TGTGCCACTACCAGGTGTCCGGTGGAGACCCAGTACTTC	CATTRCPVETQYF	TRBV6-5	TRBJ2-5
TGCAGTGCTAGCGGGGGGCCTAGCGGGACGAGGGATGGCACAGATACGCAGTATTTT	CSASGGPSGTRDGTDTQYF	TRBV20-1	TRBJ2-3
TGTGCTAGTGGTTTATTCAAGGGACGTGGCTACACCTTC	CASGLFKGRGYTF	TRBV12-5	TRBJ1-2
TGTGCCAGCAGCTTAAGGGAGGACGGGCTAGAAGCCGGAGGTACGCAGTATTTT	CASSLREDGLEAGGTQYF	TRBV7-9	TRBJ2-3
TGTGCTAGCAGCTTAGCGGCGGAGGGAAAGACCTACGAGCAGTACTTC	CASSLAAEGKTYEQYF	TRBV7-7	TRBJ2-7
TGTGCCAGCAGCTTAAGAAGATCGGGGGAGGGATCTGGGGCCAACGTCCTGACTTTC	CASSLRRSGEGSGANVLTF	TRBV11-3	TRBJ2-6
TGTGCCAGTAGCGAACTAGCGGGAGCCTACGAGCAGTACTTC	CASSELAGAYEQYF	TRBV6-5	TRBJ2-7
TGCGCCAGCAGTACTCTCACAATAACACACGGAACGGTGGGGTACGAGCAGTACTTC	CASSTLTITHGTVGYEQYF	TRBV5-1	TRBJ2-7
TGTGCCAGCAGCACCCTAGCGGTAGTTGCGTTAACCGGGGAGCTGTTTTTT	CASSTLAVVALTGELFF	TRBV11-3	TRBJ2-2
TGTGCCAGCAGTTTACCGGGGGGAGAGACCCAGTACTTC	CASSLPGGETQYF	TRBV12-3	TRBJ2-5
TGTGCCACCAGTGCGTCGGGTTCCTTCTACAATGAGCAGTTCTTC	CATSASGSFYNEQFF	TRBV24-1	TRBJ2-1
TGTGCCAGCAGCGTGTTTAAGACTAGCGGTACTAACGGGTACAATGAGCAGTTCTTC	CASSVFKTSGTNGYNEQFF	TRBV9	TRBJ2-1
TGTGCCACCAGTGATTACCATGAGGGCCAGCCAGAGACCCAGTACTTC	CATSDYHEGQPETQYF	TRBV24-1	TRBJ2-5
TGTGCCAGCAGTTACGGGGAACGGGGTCAGCCCCAGCATTTT	CASSYGERGQPQHF	TRBV6-5	TRBJ1-5
TGTGCCAGCAGCCAAAGCGGACGTTCCTACGAGCAGTACTTC	CASSQSGRSYEQYF	TRBV13	TRBJ2-7
TGTGCCAGCAGCTTCCCTCCCCCCTACGAGCAGTACTTC	CASSFPPPYEQYF	TRBV7-9	TRBJ2-7
TGTGCCTGGAGTAGAAGCGGGACAGATACGCAGTATTTT	CAWSRSGTDTQYF	TRBV30	TRBJ2-3
TGTGCCAGCAGGGGGCATGATACGCAGTATTTT	CASRGHDTQYF	TRBV6-5	TRBJ2-3
TGCGCCAGCAGCCAGAATGCACGGGGGGAGGTGGGCACAGATACGCAGTATTTT	CASSQNARGEVGTDTQYF	TRBV4-1	TRBJ2-3
TGCGCCAGCAGCCGGGACAGTGGAGAAGAGACCCAGTACTTC	CASSRDSGEETQYF	TRBV4-3	TRBJ2-5
TGTGCCAGCAGTGAGTTCCGAGGACTAGCGGGGCCCACCGGGGAGCTGTTTTTT	CASSEFRGLAGPTGELFF	TRBV12-3	TRBJ2-2
TGTGCCAGCAGCCCCCCTAAATACGAGCAGTACTTC	CASSPPKYEQYF	TRBV7-9	TRBJ2-7
TGTGCCAGTAGTGACTGGCAAGAGACCCAGTACTTC	CASSDWQETQYF	TRBV19	TRBJ2-5
TGCGCCAGCAGCTTGTCCGGACAGGGGGCAAAGCGCTACGAGCAGTACTTC	CASSLSGQGAKRYEQYF	TRBV4-1	TRBJ2-7
TGCGCCAGCACCCCGGGACCTTTCTTT	CASTPGPFF	TRBV5-1	TRBJ1-1
TGTGCCAGCAGCCCCGGAACAGGACCCTACGAGCAGTACTTC	CASSPGTGPYEQYF	TRBV7-3	TRBJ2-7
TGTGCCTGGATTGGACGGGACTATCAGCCCCAGCATTTT	CAWIGRDYQPQHF	TRBV30	TRBJ1-5
TGCGCCAGCAGTGACAACCTTGGAAACCCCGGGCCCCTAGAGACCCAGTACTTC	CASSDNLGNPGPLETQYF	TRBV10-1	TRBJ2-5
TGTGCCAGCAGACAGGGCCGACTCCGCTACAATGAGCAGTTCTTC	CASRQGRLRYNEQFF	TRBV6-5	TRBJ2-1
TGTGCCAGCAGTTACCCAGGGCTCACTGAAGCTTTCTTT	CASSYPGLTEAFF	TRBV28	TRBJ1-1
TGTGCCAGTAGGTGGGGGGGCCCGCGTTCCTGCTACGAGCAGTACTTC	CASRWGGPRSCYEQYF	TRBV19	TRBJ2-7
TGTGCCAGCAGCCAAGTCGGGGTCTGGGGGTATGGCTACACCTTC	CASSQVGVWGYGYTF	TRBV4-2	TRBJ1-2
TGTGCCTGTTCCGGACAGGGTCATAGCAATCAGCCCCAGCATTTT	CACSGQGHSNQPQHF	TRBV11-2	TRBJ1-5
TGCGCCAGCCCCACGCTTTGGGCACCCCTTAGGCAAGAGACCCAGTACTTC	CASPTLWAPLRQETQYF	TRBV5-1	TRBJ2-5
TGTGCCAGCAGAAGAGCCAGGGCTCGTGAGACCCAGTACTTC	CASRRARARETQYF	TRBV11-3	TRBJ2-5
TGTGCCAGCGGTTCAACAGGGGGCAGGGGGAGCGGGGAGCTGTTTTTT	CASGSTGGRGSGELFF	TRBV6-4	TRBJ2-2
TGTGCCAGCAGTTACAACCAGGGGTTAGCTTTCTTT	CASSYNQGLAFF	TRBV6-3	TRBJ1-1
TGTGCTAGTGGTTTGGTACGGGTGCTAGCGGGGGTAAATGAGCAGTTCTTC	CASGLVRVLAGVNEQFF	TRBV12-5	TRBJ2-1
TGTGCCAGCAGCTTGGCCCCACAGGGGGCCACCGGGGAGCTGTTTTTT	CASSLAPQGATGELFF	TRBV5-6	TRBJ2-2
TGCAGTGCTAGAAAAGAAAGGATAAATCAGCCCCAGCATTTT	CSARKERINQPQHF	TRBV20-1	TRBJ1-5
TGTGCCAGCAGCCCGGGGGGACTAGCGGGACGCTCCTACGAGCAGTACTTC	CASSPGGLAGRSYEQYF	TRBV11-3	TRBJ2-7
TGTGCCAGCAGACCGGGCACTAGCGGGAGTGAGCAGTTCTTC	CASRPGTSGSEQFF	TRBV6-2	TRBJ2-1
TGCAGTGCTTACCAGGGCTCCTACGAGCAGTACTTC	CSAYQGSYEQYF	TRBV20-1	TRBJ2-7
TGTGCCAGCAGCTTCGAACCAGGGGGCTCAGATACGCAGTATTTT	CASSFEPGGSDTQYF	TRBV5-5	TRBJ2-3
TGTGCCAGCAGTTCGGCAAGCGGGAGGCCCGCTGGAAACACCATATATTTT	CASSSASGRPAGNTIYF	TRBV11-1	TRBJ1-3
TGTGCCAGCAGCTCGAATGGGGAACGTTCCGGGGAGCTGTTTTTT	CASSSNGERSGELFF	TRBV6-5	TRBJ2-2
TGTGCCAGCAGCAGCAGGGAGAGGAGGGAGACCCAGTACTTC	CASSSRERRETQYF	TRBV13	TRBJ2-5
TGTGCCAAAGGGCGCAATCAGCCCCAGCATTTT	CAKGRNQPQHF	TRBV6-1	TRBJ1-5
TGTGCCAGCAGTTACGGGATAGCCGCACCTGGAAACACCATATATTTT	CASSYGIAAPGNTIYF	TRBV6-3	TRBJ1-3
TGTGCTAGCAGCTTTTTCGGGACAGGGTTGAAGTATAGCAATCAGCCCCAGCATTTT	CASSFFGTGLKYSNQPQHF	TRBV7-7	TRBJ1-5
TGTGGGGACAGTCCCGTAACCTCCCCTGGAAACACCATATATTTT	CGDSPVTSPGNTIYF	TRBV25-1	TRBJ1-3
TGTGCCAGCAGCCATGAAGGCAATCAGCCCCAGCATTTT	CASSHEGNQPQHF	TRBV7-4	TRBJ1-5
TGTGCCAGGCAGAATAGAGGATGCTCCTACGAGCAGTACTTC	CARQNRGCSYEQYF	TRBV24-1	TRBJ2-7
TGTGCCACCAGTGATTGGACAGGGCAAAAGTCCTACGAGCAGTACTTC	CATSDWTGQKSYEQYF	TRBV24-1	TRBJ2-7
TGCGCCAGCAGTGCCGGACGACTAGGGGCTGGGGCCAACGTCCTGACTTTC	CASSAGRLGAGANVLTF	TRBV10-1	TRBJ2-6
TGTGCCAGCAGTGGGTCCTCGGGACAGGGGCCTAATTATGAGCAGTTCTTC	CASSGSSGQGPNYEQFF	TRBV6-1	TRBJ2-1
TGTGCCAGTACGGGGGAGAAGGAAGAGACCCAGTACTTC	CASTGEKEETQYF	TRBV19	TRBJ2-5
TGTGCCACCAGTGATGTTATCCCTCGCCGGGGACGGGGCTGGGACTATGGCTACACCTTC	CATSDVIPRRGRGWDYGYTF	TRBV24-1	TRBJ1-2
TGTGCCAGCAGCAACTTAGGGTCTGAAGCTTTCTTT	CASSNLGSEAFF	TRBV13	TRBJ1-1
TGTGCCAGCAGCTTAAAATCGAACTTGGGACAGGAATCCTACGAGCAGTACTTC	CASSLKSNLGQESYEQYF	TRBV13	TRBJ2-7
TGTGCCAGCAGCCTTACCAAGTGTGATTGTTTTGGCTACACCTTC	CASSLTKCDCFGYTF	TRBV4-2	TRBJ1-2
TGTGCCATCAGTTCAGTCAACAGGGGGCGCACCATATATTTT	CAISSVNRGRTIYF	TRBV10-3	TRBJ1-3
TGTGCCAGCAGCCCCCGGGGGGACAGGGGTAACTATGGCTACACCTTC	CASSPRGDRGNYGYTF	TRBV5-6	TRBJ1-2
TGTGCTAGTGGTTTGGTAAGGAGGGGCGTGCAAGAGACCCAGTACTTC	CASGLVRRGVQETQYF	TRBV12-5	TRBJ2-5
TGTGCCAGCAGGAGCCTCGGAACCGTAGGAGATACGCAGTATTTT	CASRSLGTVGDTQYF	TRBV2	TRBJ2-3
TGTGCCAGCAGCCAAGCTAAATGGGGGACAGGGCCCAATTCACCCCTCCACTTT	CASSQAKWGTGPNSPLHF	TRBV4-2	TRBJ1-6
TGTGCCAGCAGTGACTCGAGGGAGGACACTGAAGCTTTCTTT	CASSDSREDTEAFF	TRBV6-4	TRBJ1-1
TGTGCCACCAGTGAATCCCCAACAGGAAACACCATATATTTT	CATSESPTGNTIYF	TRBV24-1	TRBJ1-3
TGTGCCAGCAGATCTAAGGCCGGGAAAACCGAGCAGTACTTC	CASRSKAGKTEQYF	TRBV7-3	TRBJ2-7
TGTGCCAGCAGTTACAGGTCCCATCAGCCCCAGCATTTT	CASSYRSHQPQHF	TRBV6-5	TRBJ1-5
TGCGCCAGCAGCGGTCTTGCGGGACAGGATGTCAACGAGCAGTACTTC	CASSGLAGQDVNEQYF	TRBV5-1	TRBJ2-7
TGCAGTGCTAGAAAAAGTGGGGATGGCTACACCTTC	CSARKSGDGYTF	TRBV20-1	TRBJ1-2
TGTGCCAGCTCTGACGAAGTAGGTAGGGACACCATATATTTT	CASSDEVGRDTIYF	TRBV28	TRBJ1-3
TGTGCCAGCAGCCAGGGACTAGCGGGGAGCTCCTACAATGAGCAGTTCTTC	CASSQGLAGSSYNEQFF	TRBV13	TRBJ2-1
TGTGCCAGCAGCTTCCCCCGGGACAGGGAGGGCGAACGCTCTGGAAACACCATATATTTT	CASSFPRDREGERSGNTIYF	TRBV7-4	TRBJ1-3
TGTGCCAGCAGCCAACGACGAGAGACCCAGTACTTC	CASSQRRETQYF	TRBV3-1	TRBJ2-5
TGTGCCAGCAGTAGGATCCAACTTGGCGGACAGGGGCTGAACACTGAAGCTTTCTTT	CASSRIQLGGQGLNTEAFF	TRBV12-3	TRBJ1-1
TGTGCCAGCAGCCAAGGACCTGGGAGGGATTGCACTGAAGCTTTCTTT	CASSQGPGRDCTEAFF	TRBV3-1	TRBJ1-1
TGTGCCAGCAGTGAACCTCCGGGACACCCAGGGGGCACAGATACGCAGTATTTT	CASSEPPGHPGGTDTQYF	TRBV2	TRBJ2-3
TGTGCCAGCAGCTTGACAGGGGGGTGGGGAACTTCCTATGGCTACACCTTC	CASSLTGGWGTSYGYTF	TRBV7-9	TRBJ1-2
TGCAGCGTTGAAGGCCCCAAGGGTTACCGGCAGTACTTC	CSVEGPKGYRQYF	TRBV29-1	TRBJ2-7
TGTGCCAGCAGTTTGGGACTTGGTGAAGAGACCCAGTACTTC	CASSLGLGEETQYF	TRBV12-3	TRBJ2-5
TGTGCCAGCAGCTATGGTATGGAGTGGGGGGCGAAGGAGATGAACACTGAAGCTTTCTTT	CASSYGMEWGAKEMNTEAFF	TRBV5-6	TRBJ1-1
TGTGCCAGCAGCGGGGACAGGGGGGCCTACGAGCAGTACTTC	CASSGDRGAYEQYF	TRBV13	TRBJ2-7
TGTGCCAGCAGCCGTCGCGATGTCCACGGGGACAGGGGGCAAGGTGATACAGATACGCAGTATTTT	CASSRRDVHGDRGQGDTDTQYF	TRBV3-1	TRBJ2-3
TGCGCCAGCACGGGAGGGAGCTCCTACAATGAGCAGTTCTTC	CASTGGSSYNEQFF	TRBV10-1	TRBJ2-1
TGTGCCAGCAGAACCCCCAACCGGACGGAGCAGTACTTC	CASRTPNRTEQYF	TRBV6-1	TRBJ2-7
TGTGCCAGCAGCTGGAGTGGGGGGGGTACAGATACGCAGTATTTT	CASSWSGGGTDTQYF	TRBV5-5	TRBJ2-3
TGTGCCAGCAGTTTTTCGGAGGGGGCGAGTTACGAGCAGTACTTC	CASSFSEGASYEQYF	TRBV27	TRBJ2-7
TGCAGTGCCGTAGACATCAACTCACCCCTCCACTTT	CSAVDINSPLHF	TRBV20-1	TRBJ1-6
TGTGCCAGCAGTGAAAATTCTTGTCTCACCTATGGCTACACCTTC	CASSENSCLTYGYTF	TRBV25-1	TRBJ1-2
TGTGCCAGCAGCTTACAACGCCGGGACACCTACGAGCAGTACTTC	CASSLQRRDTYEQYF	TRBV7-3	TRBJ2-7
TGTGCCCCTGCCGAGACACATGGGGCCAACGTCCTGACTTTC	CAPAETHGANVLTF	TRBV12-4	TRBJ2-6
TGTGCCAACCCCGGGACAGGGCTGCCGTACGAGCAGTACTTC	CANPGTGLPYEQYF	TRBV28	TRBJ2-7
TGTGCCTGGAGTTGGGTGGACAGGGGAAGAAGGGTTGAAGCTTTCTTT	CAWSWVDRGRRVEAFF	TRBV30	TRBJ1-1
TGTGCCAGCAGGTGGGCGACCCAGTACTTC	CASRWATQYF	TRBV7-8	TRBJ2-5
TGTGCCACCAGGGCCCAGGGGAAGCCCCAGCATTTT	CATRAQGKPQHF	TRBV24-1	TRBJ1-5
TGCGCCAGCAGCTTGGCAACCAAGAGTGCAACACAGGGGGCGTGTAACTATGGCTACACCTTC	CASSLATKSATQGACNYGYTF	TRBV5-1	TRBJ1-2
TGTGCCGGCCTACCTAGGGGTTACGAGACCCAGTACTTC	CAGLPRGYETQYF	TRBV10-3	TRBJ2-5
TGTGCCAGTAGTTCTGACAGGGCTGGGTTTACTGAAGCTTTCTTT	CASSSDRAGFTEAFF	TRBV19	TRBJ1-1
TGTGCCACCAGCGTTTCTAGCGGGTTTAAACAAGAGACCCAGTACTTC	CATSVSSGFKQETQYF	TRBV15	TRBJ2-5
TGTGCCAGCAGCCAAGCTAAGTCCAACAGGGGAGGATGTCGCACAGATACGCAGTATTTT	CASSQAKSNRGGCRTDTQYF	TRBV3-1	TRBJ2-3
TGTGCCAGCAGCTTAGATGGACGGGATGTCTCCTACGAGCAGTACTTC	CASSLDGRDVSYEQYF	TRBV11-3	TRBJ2-7
TGTGCCAGCAGTTACGAGGTGAGGGATTCGCCGAGGGTCACCGGGGAGCTGTTTTTT	CASSYEVRDSPRVTGELFF	TRBV6-5	TRBJ2-2
TGCACCCGTGGGACTAGCGGGAGAGATACGCAGTATTTT	CTRGTSGRDTQYF	TRBV20-1	TRBJ2-3
TGCAGTGCTAGCTCGACTAGCGGCGGGATTGCATACGAGCAGTACTTC	CSASSTSGGIAYEQYF	TRBV20-1	TRBJ2-7
TGTGCCAGCAGCTTAGTTCGAACGGGGGTCTCACCCCTCCACTTT	CASSLVRTGVSPLHF	TRBV11-2	TRBJ1-6
TGTGCCAGCATTCCCCCCAGCGGGATCACGCATGGGGGAAGAGAGACCCAGTACTTC	CASIPPSGITHGGRETQYF	TRBV6-2	TRBJ2-5
TGTGCCACCAGCAGCGATCTAACTAGCGGGAGTTTTTGGGGCTCTGGGGCCAACGTCCTGACTTTC	CATSSDLTSGSFWGSGANVLTF	TRBV15	TRBJ2-6
TGTGCCAGCAGCAGGGACAGGGAAGATGGCTACACCTTC	CASSRDREDGYTF	TRBV13	TRBJ1-2
TGCGCCAGCAGTGCCCCGTGCGGACTAGCGGCATCCGGATTGCAGTTCTTC	CASSAPCGLAASGLQFF	TRBV10-1	TRBJ2-1
TGTGCCAGCTCCAAATCGGATTATGACACCGGGGAGCTGTTTTTT	CASSKSDYDTGELFF	TRBV18	TRBJ2-2
TGCGCCAGCAGCTCAGGCGGACTAGCGGTCGACAGCCGGGGGTTTGCCTACGAGCAGTACTTC	CASSSGGLAVDSRGFAYEQYF	TRBV5-1	TRBJ2-7
TGTGCCAGCAGTTCCGGGACAGGGGGTCTTCGGACACCCTATAATTCACCCCTCCACTTT	CASSSGTGGLRTPYNSPLHF	TRBV12-3	TRBJ1-6
TGTGCCAGCTCACCCTCGGGGCCCGATACGCAGTATTTT	CASSPSGPDTQYF	TRBV18	TRBJ2-3
TGTGCCAGCAGCGTAGAAACCGGACTAGCGGGCCTTCCCCAGTACTTC	CASSVETGLAGLPQYF	TRBV9	TRBJ2-5
TGCAGCGTTTTAAGGTCCTACAATGAGCAGTTCTTC	CSVLRSYNEQFF	TRBV29-1	TRBJ2-1
TGTGCCAGCAGTGATAAGACAAACGAGCAGTACTTC	CASSDKTNEQYF	TRBV25-1	TRBJ2-7
TGTGCCATCCCGATCGACGATCGGGACAATGAGCAGTTCTTC	CAIPIDDRDNEQFF	TRBV10-3	TRBJ2-1
TGTGCCAGCAGTTTGCTAGCGGGTCAAGAGATCTCCTACGAGCAGTACTTC	CASSLLAGQEISYEQYF	TRBV12-4	TRBJ2-7
TGTGCCAGCAGCTCACCGGCAGGGGGGCTGCCGATGAACACTGAAGCTTTCTTT	CASSSPAGGLPMNTEAFF	TRBV13	TRBJ1-1
TGTGCCAGCAGCTTAAGCCCTGGACCCGATCAGCCCCAGCATTTT	CASSLSPGPDQPQHF	TRBV7-3	TRBJ1-5
TGCGCCAGCAGTGAGTCGCGCTTTCGGGGGCCGAGGTCCTACGAGCAGTACTTC	CASSESRFRGPRSYEQYF	TRBV10-1	TRBJ2-7
TGTGCCTGGGAAAAGACTAGCGGCTGGAGGTATACGCAGTATTTT	CAWEKTSGWRYTQYF	TRBV30	TRBJ2-3
TGCACTCAGCCGGGACAGGGGGACACCATATATTTT	CTQPGQGDTIYF	TRBV20-1	TRBJ1-3
TGTGCCAGCAGCGGGGGTTCGGAGTACACAGCGACGACGTACGAGCAGTACTTC	CASSGGSEYTATTYEQYF	TRBV7-3	TRBJ2-7
TGTGCCAGCAGCTTATTGGACAGCGGCTTTGCCATGAACACTGAAGCTTTCTTT	CASSLLDSGFAMNTEAFF	TRBV11-2	TRBJ1-1
TGTGCCAGCAGCTTCCGCCTCCCCCCGCAGGGGGCACTTTACGAGCAGTACTTC	CASSFRLPPQGALYEQYF	TRBV7-4	TRBJ2-7
TGTGCCAGCAGACATGACAGGGTTACATACGAGCAGTACTTC	CASRHDRVTYEQYF	TRBV6-5	TRBJ2-7
TGTGCCAGCAGCCTCCCTTGGGGACAGATCCATCAGCCCCAGCATTTT	CASSLPWGQIHQPQHF	TRBV14	TRBJ1-5
TGTGCCAGCAGCTTCCAAGAGGCGGTGGTAAAGTACGAGCAGTACTTC	CASSFQEAVVKYEQYF	TRBV7-8	TRBJ2-7
TGTGCCAGCAGCCCACTGGATGCGGGCTCCTACAATGAGCAGTTCTTC	CASSPLDAGSYNEQFF	TRBV7-8	TRBJ2-1
TGCGCCAGCAGCCAAGATAGGCAGTACTTC	CASSQDRQYF	TRBV4-3	TRBJ2-7
TGTGCCACCAGTGATTTGGATGGGGGGGGTGCACCCGCCGGATACGAGCAGTACTTC	CATSDLDGGGAPAGYEQYF	TRBV24-1	TRBJ2-7
TGTGCCAGCAGCCGGGACACAGGAAATCAGCCCCAGCATTTT	CASSRDTGNQPQHF	TRBV7-2	TRBJ1-5
TGTGCCAGCAGCTTAGGGGGGTACCCACGTAATGAAAAACTGTTTTTT	CASSLGGYPRNEKLFF	TRBV7-6	TRBJ1-4
TGTGCCAGCAGCGGACAGAGCTCCTATAATTCACCCCTCCACTTT	CASSGQSSYNSPLHF	TRBV7-9	TRBJ1-6
TGTGCCAGCAGCACTCAACCTCCAGAGAATCAGCCCCAGCATTTT	CASSTQPPENQPQHF	TRBV13	TRBJ1-5
TGTGCCAGCAGCAAGACGACTAGCGGGGTAGAGCAGTTCTTC	CASSKTTSGVEQFF	TRBV14	TRBJ2-1
TGTGCCTGGAGTCCCAGGGTTGAAAAACTGTTTTTT	CAWSPRVEKLFF	TRBV30	TRBJ1-4
TGTCCCTTGGGGGGGGGGGAGCAGTACTTC	CPLGGGEQYF	TRBV14	TRBJ2-7
TGTGCCAGCAGCTGCGACAGCAGGGGAGGGCCCCAGCATTTT	CASSCDSRGGPQHF	TRBV27	TRBJ1-5
TGTGCCAGCTCAAGCCACGTCGGAACAGGGGTATTGAACACCGGGGAGCTGTTTTTT	CASSSHVGTGVLNTGELFF	TRBV18	TRBJ2-2
TGTGCCAACCGTATAGCTTACGAGCAGTACTTC	CANRIAYEQYF	TRBV27	TRBJ2-7
TGTGCCACCAGCATCACAGGGTCTAGCTCCTACGAGCAGTACTTC	CATSITGSSSYEQYF	TRBV24-1	TRBJ2-7
TGTGCCAGCAGTACCGGACGTGTCACTGAAGCTTTCTTT	CASSTGRVTEAFF	TRBV6-6	TRBJ1-1
TGTGCCAGCAGTGGTCAGTCGATATGCACAGATACGCAGTATTTT	CASSGQSICTDTQYF	TRBV27	TRBJ2-3
TGTGCCAGCAGCTTACGACAGGGGGGGACTAATGAAAAACTGTTTTTT	CASSLRQGGTNEKLFF	TRBV7-9	TRBJ1-4
TGTGCCAGCAGCCGTGGACAGGGTTTTGATACGCAGTATTTT	CASSRGQGFDTQYF	TRBV9	TRBJ2-3
TGTGCCAGCAGCAAGGGACTTTCCTACGAGCAGTACTTC	CASSKGLSYEQYF	TRBV13	TRBJ2-7
TGTGCCAGCAGCCGGCTCTGGCTAGCGGGTCCCTTTTGCACAGATACGCAGTATTTT	CASSRLWLAGPFCTDTQYF	TRBV5-4	TRBJ2-3
TGTGCCAGCAGGGTGGGGCGCTCACCCCTCCACTTT	CASRVGRSPLHF	TRBV12-4	TRBJ1-6
TGTGCCAGCAGTGAAACTTGGGGAGAAGAGCAGTACTTC	CASSETWGEEQYF	TRBV6-1	TRBJ2-7
TGTGCCAGCTCACCATGCCATGAGAATCGAACAGAGACCCAGTACTTC	CASSPCHENRTETQYF	TRBV18	TRBJ2-5
TGTGCCAGCGGTGCTCGTACAGATACGCAGTATTTT	CASGARTDTQYF	TRBV6-1	TRBJ2-3
TGCAGTGCTAGATTAAAACAGGGCGTTTACGAGCAGTACTTC	CSARLKQGVYEQYF	TRBV20-1	TRBJ2-7
TGTGCCAGCAGCCGTAGACAGGTAGTGGAGACCCAGTACTTC	CASSRRQVVETQYF	TRBV13	TRBJ2-5
TGTGCCAGCAGCCAAGAGCTAAATAAGGGACAGGGCGGGGGAGGGACTGAAGCTTTCTTT	CASSQELNKGQGGGGTEAFF	TRBV3-1	TRBJ1-1
TGTGCCAGCAGCTTAGTGAGACAGGGCCGGGGGACCCAGTACTTC	CASSLVRQGRGTQYF	TRBV7-9	TRBJ2-5
TGTGCCAGCAGCTCTCCCTGGACAGCGGACACTGAAGCTTTCTTT	CASSSPWTADTEAFF	TRBV13	TRBJ1-1
TGTGCCAGCAGTTACCAACGACAGGGAGGGTACGAGCAGTACTTC	CASSYQRQGGYEQYF	TRBV6-2	TRBJ2-7
TGTGGCGGAAAGCGACATCCCAATGAAAAACTGTTTTTT	CGGKRHPNEKLFF	TRBV12-3	TRBJ1-4
TGCAGCGTTCCCCCCTGCCGGGGGGGGCGGGGCTCTGGGGCCAACGTCCTGACTTTC	CSVPPCRGGRGSGANVLTF	TRBV29-1	TRBJ2-6
TGTGCCAGCAGCTTAGCGATGACAGGCAATCTAGAGACCCAGTACTTC	CASSLAMTGNLETQYF	TRBV7-9	TRBJ2-5
TGTGCCAGCAGCCGAATCCCGGCTCGCTACGAGCAGTACTTC	CASSRIPARYEQYF	TRBV6-8	TRBJ2-7
TGCGCCAGCAGTGAGGGGGCACGGGACTTTTACAATGAGCAGTTCTTC	CASSEGARDFYNEQFF	TRBV10-1	TRBJ2-1
TGTGCCAGCAGTGACCCGGGGCAGAACACTGAAGCTTTCTTT	CASSDPGQNTEAFF	TRBV6-4	TRBJ1-1
TGCACCAAGGTCCGAACGATGAACACTGAAGCTTTCTTT	CTKVRTMNTEAFF	TRBV20-1	TRBJ1-1
TGCGCCAGCGTGTTGGGGACAGGGGGCCCTGAAGCTTTCTTT	CASVLGTGGPEAFF	TRBV10-1	TRBJ1-1
TGTGCCAGTAGTCCAAGGACAGGTTACAATGAGCAGTTCTTC	CASSPRTGYNEQFF	TRBV19	TRBJ2-1
TGTGCCAGCAGCCCCGTAGGGGGGCCCCGTTCCAATGAGCAGTTCTTC	CASSPVGGPRSNEQFF	TRBV13	TRBJ2-1
TGTGCCAGCAGCGGACTAGCGGAATACAATGAGCAGTTCTTC	CASSGLAEYNEQFF	TRBV9	TRBJ2-1
TGTGCCAGCACCGCACTAGCGGGGCCCCCGGGGGGGAAAAGCGAGACCCAGTACTTC	CASTALAGPPGGKSETQYF	TRBV4-2	TRBJ2-5
TGTGCCAGCAGCTCCTTCTTAACAAGGGAATGCTATGGCTACACCTTC	CASSSFLTRECYGYTF	TRBV11-2	TRBJ1-2
TGTGCCAGCTCCGGCGGGAGACGGTACAATGAGCAGTTCTTC	CASSGGRRYNEQFF	TRBV7-3	TRBJ2-1
TGTGCCAGCAGCTTAACACAGGGAGTGAACACTGAAGCTTTCTTT	CASSLTQGVNTEAFF	TRBV7-2	TRBJ1-1
TGTGCCAGCAGCGGGAGACAAGGAACCGGGGAGCTGTTTTTT	CASSGRQGTGELFF	TRBV11-2	TRBJ2-2
TGTGCCAGCAGTGATTTAGGGACAGGGATCCATAACCAAGAGACCCAGTACTTC	CASSDLGTGIHNQETQYF	TRBV6-5	TRBJ2-5
TGCAGCGTTGCGCCAGGTTTAGGGGACACCGGGGAGCTGTTTTTT	CSVAPGLGDTGELFF	TRBV29-1	TRBJ2-2
TGCACCTGGACAGATCTCAATCAGCCCCAGCATTTT	CTWTDLNQPQHF	TRBV20-1	TRBJ1-5
TGTGCCAGCAGCATACATAAGGTCTACGAGCAGTACTTC	CASSIHKVYEQYF	TRBV9	TRBJ2-7
TGTGCCAGCAGGCGGCTTCGCCCCTCTTTCTTT	CASRRLRPSFF	TRBV6-1	TRBJ1-1
TGCAGCGTTGAAGATCTTGGAGGGGGGGCGGAGACCCAGTACTTC	CSVEDLGGGAETQYF	TRBV29-1	TRBJ2-5
TGTGCCAGCAGCGGACAGGGCAACAATGAGCAGTTCTTC	CASSGQGNNEQFF	TRBV12-3	TRBJ2-1
TGTGCCAGTAGCGGGGCTGACCTCCACTTT	CASSGADLHF	TRBV19	TRBJ1-6
TGTGCCAGCAGCAGATCGGGGGACAGCAATCAGCCCCAGCATTTT	CASSRSGDSNQPQHF	TRBV13	TRBJ1-5
TGCGCCAGCAGTGAGCATGGGCACAGGCACGACGAGCAGTACTTC	CASSEHGHRHDEQYF	TRBV10-1	TRBJ2-7
TGTGCCAGCAGAGAGGAGGCGTCCTACGAGCAGTACTTC	CASREEASYEQYF	TRBV11-3	TRBJ2-7
TGTGCCAGCAGCCTAGATAAAGAGACCCAGTACTTC	CASSLDKETQYF	TRBV6-5	TRBJ2-5
TGTGCCATCAGCCTAGACAGGTTTTCCTCTGGAAACACCATATATTTT	CAISLDRFSSGNTIYF	TRBV10-3	TRBJ1-3
TGCGCCAGCAGCGCCTCGAACGGTGGGGACAGGGGGCCCTTACCAGCTTTCTTT	CASSASNGGDRGPLPAFF	TRBV5-1	TRBJ1-1
TGCGCCAGCAGCCCCCCTATCTCCTACGAGCAGTACTTC	CASSPPISYEQYF	TRBV4-3	TRBJ2-7
TGTGCCAGCAGCTTAGCTAGCGGGCGGCGCACAGATACGCAGTATTTT	CASSLASGRRTDTQYF	TRBV7-2	TRBJ2-3
TGTGCCAGCAGCCAAGGGACTAACACAGATACGCAGTATTTT	CASSQGTNTDTQYF	TRBV14	TRBJ2-3
TGTGCCAGCAGTTCAGCTAGCGGGGGGGGGACCTGGTACGAGCAGTACTTC	CASSSASGGGTWYEQYF	TRBV27	TRBJ2-7
TGTGCCAGCAGCGTCGCCTACGAGCAGTACTTC	CASSVAYEQYF	TRBV13	TRBJ2-7
TGCAGTGCGGGAGGGCGAGCTGAAGCTTTCTTT	CSAGGRAEAFF	TRBV20-1	TRBJ1-1
TGTGCTGACCCGACAGGCCCCTACGAGCAGTACTTC	CADPTGPYEQYF	TRBV12-5	TRBJ2-7
TGCGCCAGCAGGGGAACCCGACAGGACAAGCGCACTGAAGCTTTCTTT	CASRGTRQDKRTEAFF	TRBV5-1	TRBJ1-1
TGTGCCAGCAGTCGGAGTACTCTCAGGCGCCAGGGTAGCAATCAGCCCCAGCATTTT	CASSRSTLRRQGSNQPQHF	TRBV27	TRBJ1-5
TGTGCCAGCACCTGCCCAGCCAGGGCCAACGTCCTGACTTTC	CASTCPARANVLTF	TRBV6-6	TRBJ2-6
TGTGCCAGCAGTTACAAGGGCTGTGGAGACACCGGGGAGCTGTTTTTT	CASSYKGCGDTGELFF	TRBV6-2	TRBJ2-2
TGTGCCAGCAGCTTATCCCTGTCAGGGGCCCCCGCAGAGACCCAGTACTTC	CASSLSLSGAPAETQYF	TRBV5-4	TRBJ2-5
TGCACGAGGGAAAGGATAGGTAAATGCCAAGAGACCCAGTACTTC	CTRERIGKCQETQYF	TRBV20-1	TRBJ2-5
TGTGCCTGGAAGGGGGGAAACACCATATATTTT	CAWKGGNTIYF	TRBV30	TRBJ1-3
TGCAGCGTTATGCGCGTACAGAAAGGCTCTGGGGCCAACGTCCTGACTTTC	CSVMRVQKGSGANVLTF	TRBV29-1	TRBJ2-6
TGTGCCAGCAGCCCCCGAGGCGGGGTTGAAAAACTGTTTTTT	CASSPRGGVEKLFF	TRBV13	TRBJ1-4
TGCAGTGCTAGAGATCAAAATAGACTAGCCGGGGAGCTGTTTTTT	CSARDQNRLAGELFF	TRBV20-1	TRBJ2-2
TGTGCCAGCAGTCAGCACAACACTGAAGCTTTCTTT	CASSQHNTEAFF	TRBV6-2	TRBJ1-1
TGTGCCACCACCCCACGGGGTGTCCGAAACAGTAATGAAAAACTGTTTTTT	CATTPRGVRNSNEKLFF	TRBV24-1	TRBJ1-4
TGCAGTGCGCCTCTCGTGGGTCTCACCGGGGAGCTGTTTTTT	CSAPLVGLTGELFF	TRBV20-1	TRBJ2-2
TGTGCCAGCAGCCCTCCCGGGACAGGTCACTATGGCTACACCTTC	CASSPPGTGHYGYTF	TRBV5-4	TRBJ1-2
TGTGCCAGCATTACAGTGACGCTGGTCAAATACGAGCAGTACTTC	CASITVTLVKYEQYF	TRBV9	TRBJ2-7
TGCGCCAGCAGGTGTCAGGGACAGGGGGTTGATGAAGCTTTCTTT	CASRCQGQGVDEAFF	TRBV10-1	TRBJ1-1
TGCGCCAGCAGACAACGGGGGGACTCTGGAAACACCATATATTTT	CASRQRGDSGNTIYF	TRBV10-2	TRBJ1-3
TGTGCCAGCAGCGTGGTCCGGGGGCCGGAAAACATTCAGTACTTC	CASSVVRGPENIQYF	TRBV9	TRBJ2-4
TGTGCCAGCTCGTTCCGGGACAGACGACGACTTAATGGCTACACCTTC	CASSFRDRRRLNGYTF	TRBV18	TRBJ1-2
TGCGCCAGCAGCCAAGCAAAGACAGGGAGCTCAAGCGGGGAGCTGTTTTTT	CASSQAKTGSSSGELFF	TRBV4-1	TRBJ2-2
TGTGCCAGCAGTATTTCTACGGGAGGAGGGGTGGCAGATACGCAGTATTTT	CASSISTGGGVADTQYF	TRBV6-1	TRBJ2-3
TGCAGCGTTGCCGGGCACCACACTGAAGCTTTCTTT	CSVAGHHTEAFF	TRBV29-1	TRBJ1-1
TGTGCCAGTGAACTAAATGGAGAGCAGTTCTTC	CASELNGEQFF	TRBV19	TRBJ2-1
TGTGCCAGCAGCCAGGGTAATAGGGAGACCCAGTACTTC	CASSQGNRETQYF	TRBV7-7	TRBJ2-5
TGTGCCAGCAGTACAGCCTTTGAAAAACTGTTTTTT	CASSTAFEKLFF	TRBV2	TRBJ1-4
TGTGCCAGCAGCATTTCTCACAGGGGTGGCTACACCTTC	CASSISHRGGYTF	TRBV11-3	TRBJ1-2
TGTGCCAGCAGCAGGGACAGGGGGCATGTCAAACTGTTTTTT	CASSRDRGHVKLFF	TRBV6-5	TRBJ1-4
TGCGCCAGCAGCCCGGGGGTTTGGCTTAACTATGGCTACACCTTC	CASSPGVWLNYGYTF	TRBV10-1	TRBJ1-2
TGTGCCAGCAGTTACTCGAATTTAGGGAACACCGGGAGGGGAACAGAAAATCAGCCCCAGCATTTT	CASSYSNLGNTGRGTENQPQHF	TRBV6-5	TRBJ1-5
TGTGCCAGCAGCGGTCCTGGGGGGAGGTATGGCTACACCTTC	CASSGPGGRYGYTF	TRBV9	TRBJ1-2
TGTGCCAGCAGCTTAGCGGGGGGCTACGAGCAGTACTTC	CASSLAGGYEQYF	TRBV7-2	TRBJ2-7
TGTGCCAGTACAAGGGACAGGGAGGACACAGATACGCAGTATTTT	CASTRDREDTDTQYF	TRBV19	TRBJ2-3
TGTGCCAGCAGCCAAGAAGTCCGGGGGGACACTGAAGCTTTCTTT	CASSQEVRGDTEAFF	TRBV14	TRBJ1-1
TGCAGTGCTAGACAGGGTTGGCCTAGTACCTATAATTCACCCCTCCACTTT	CSARQGWPSTYNSPLHF	TRBV20-1	TRBJ1-6
TGCGCCAGCAGTGATAGAACCAGGCATGGCTACACCTTC	CASSDRTRHGYTF	TRBV10-1	TRBJ1-2
TGTGATCCGGTGCCACAGTATGGCTACACCTTC	CDPVPQYGYTF	TRBV30	TRBJ1-2
TGTGCCAGCGAGTGGGACAGGGTACGGTATGCAACTAATGAAAAACTGTTTTTT	CASEWDRVRYATNEKLFF	TRBV6-4	TRBJ1-4
TGCAGTGCTGGTGAGGGCTACGAGCAGTACTTC	CSAGEGYEQYF	TRBV20-1	TRBJ2-7
TGCGCCAGCAGCCAAGAGGAAGGGAGGACAACAGATACGCAGTATTTT	CASSQEEGRTTDTQYF	TRBV4-3	TRBJ2-3
TGCACAGGGGGGCCCGGCACCGGGGAGCTGTTTTTT	CTGGPGTGELFF	TRBV20-1	TRBJ2-2
TGCAGTGCTAGAGGGTGCAGATTGTTGGCTAATGAAAAACTGTTTTTT	CSARGCRLLANEKLFF	TRBV20-1	TRBJ1-4
TGTGCCAGCACGCTTCAGGGGTGTGAAGCTTTCTTT	CASTLQGCEAFF	TRBV6-3	TRBJ1-1
TGTGCCAAAATCGGCAACCAAGGGGCCTGGCGCAATCAGCCCCAGCATTTT	CAKIGNQGAWRNQPQHF	TRBV6-3	TRBJ1-5
TGTGCCAGCAGCGGATACTCCCGGGAGTCGAGAGGGGAGACCCAGTACTTC	CASSGYSRESRGETQYF	TRBV11-2	TRBJ2-5
TGTGCCAGCAGCAGGGGACAGGGGAACGACCCGAACACTGAAGCTTTCTTT	CASSRGQGNDPNTEAFF	TRBV13	TRBJ1-1
TGTGCCAGCAGTTTGGGGTGCAGCGGGAGGCCCCAGCATTTT	CASSLGCSGRPQHF	TRBV28	TRBJ1-5
TGTGCCAGCACAGGGGTTCGTTCACCCCTCCACTTT	CASTGVRSPLHF	TRBV5-6	TRBJ1-6
TGTGCCAGCAGCTTCCGGGGGCGCTACAATGAGCAGTTCTTC	CASSFRGRYNEQFF	TRBV9	TRBJ2-1
TGTGCCAGCAGTGATCCCCCCGGGGGAAACACCATATATTTT	CASSDPPGGNTIYF	TRBV6-4	TRBJ1-3
TGTGCCAGCAGTTTAACGGGGGGGGCGGGCGATAACACCGGGGAGCTGTTTTTT	CASSLTGGAGDNTGELFF	TRBV27	TRBJ2-2
TGTGCCAGCAGCTTAGAAAGGACAGGGGGGTGTTTGCGATCCAATCAGCCCCAGCATTTT	CASSLERTGGCLRSNQPQHF	TRBV7-7	TRBJ1-5
TGTGCCAGCAGTTTGATCCAGGGGATAATTGCAACTAATGAAAAACTGTTTTTT	CASSLIQGIIATNEKLFF	TRBV12-3	TRBJ1-4
TGCAGGAGAGGGGACGAGCAGTACTTC	CRRGDEQYF	TRBV20-1	TRBJ2-7
TGTGCCAGCAGTTTAGGGCCCATTTACGAGCAGTACTTC	CASSLGPIYEQYF	TRBV12-3	TRBJ2-7
TGCGCCAGCAGCAGGGTCTGTGGTCCGGGACAGGGGGGCCGGGAGGCCAAAAACATTCAGTACTTC	CASSRVCGPGQGGREAKNIQYF	TRBV5-1	TRBJ2-4
TGTGCCACCAGTGATTCGGGGGGCGCTGAGAGCAGCTCCTATAATTCACCCCTCCACTTT	CATSDSGGAESSSYNSPLHF	TRBV24-1	TRBJ1-6
TGCAGTGCCCTCCTACACTTTGCGACTAGCGGGAGAGCCTACGAGCAGTACTTC	CSALLHFATSGRAYEQYF	TRBV20-1	TRBJ2-7
TGTGCCACCAGCAGACCGGTCGACAGGAGGAAAAGCCATAAGAGCAATCAGCCCCAGCATTTT	CATSRPVDRRKSHKSNQPQHF	TRBV15	TRBJ1-5
TGTGCCAGCAGCGGAGGGACACTTTCACCCCTCCACTTT	CASSGGTLSPLHF	TRBV5-6	TRBJ1-6
TGCGCCAGCAGCCCTCCTCTAGCGGGGAATTATCAAGAGACCCAGTACTTC	CASSPPLAGNYQETQYF	TRBV4-1	TRBJ2-5
TGTGCCAGCAGAGGAAGGGGCTCCTACGAGCAGTACTTC	CASRGRGSYEQYF	TRBV6-4	TRBJ2-7
TGCGCCAGCAGCCAAGTATTAAGGCAATGCACAGATACGCAGTATTTT	CASSQVLRQCTDTQYF	TRBV4-3	TRBJ2-3
TGTGCCAGCAGTTTATGTGGACTAGCGGGGTCACCAGCAGATACGCAGTATTTT	CASSLCGLAGSPADTQYF	TRBV12-4	TRBJ2-3
TGTGCCAGCAAGTTCCCAGCCGGGAATAATGAGCAGTTCTTC	CASKFPAGNNEQFF	TRBV3-1	TRBJ2-1
TGTGCCAGCAGAGGACAGCCGGGACTTAACTATGGCTACACCTTC	CASRGQPGLNYGYTF	TRBV6-2	TRBJ1-2
TGCGCCAGCAGTTTCGGGGCGTTTGGCTACACCTTC	CASSFGAFGYTF	TRBV10-1	TRBJ1-2
TGCAGTGCATCACCTAGTTCCTACAATGAGCAGTTCTTC	CSASPSSYNEQFF	TRBV20-1	TRBJ2-1
TGTGCCAGCAGCCGGACAGCTCCTAATGAAAAACTGTTTTTT	CASSRTAPNEKLFF	TRBV6-5	TRBJ1-4
TGTGCCAGCAGTGAAGATCGTTGCAGCGGCGCTACCAGGGGGGCTGCCGGGGAGCTGTTTTTT	CASSEDRCSGATRGAAGELFF	TRBV6-1	TRBJ2-2
TGTGCCAGCAGCTACAGGGGCCGCTATGGCTACACCTTC	CASSYRGRYGYTF	TRBV5-6	TRBJ1-2
TGTGCCAGCAGTTTGAGGGGGAGGCCCCAGCATTTT	CASSLRGRPQHF	TRBV27	TRBJ1-5
TGCAGTGCTAGAACCGGGACAGGGACGGACATGAACACTGAAGCTTTCTTT	CSARTGTGTDMNTEAFF	TRBV20-1	TRBJ1-1
TGTGCCAAGCGGGGGGCACCGGGCTACACCTTC	CAKRGAPGYTF	TRBV6-1	TRBJ1-2
TGCGCCAGCAGAGTCCTCCGACTAGCGGGAGGATACAATGAGCAGTTCTTC	CASRVLRLAGGYNEQFF	TRBV5-1	TRBJ2-1
TGCGCCAGCAGTGAGTCGCCGGGACAGGGTTATGGCTACACCTTC	CASSESPGQGYGYTF	TRBV10-1	TRBJ1-2
TGTGCCAGCTCACTTACCCGGGACAGTATCAACTATGGCTACACCTTC	CASSLTRDSINYGYTF	TRBV18	TRBJ1-2
TGTGCCAGCAGTTTAACACCGGGGGATCAGCCCCAGCATTTT	CASSLTPGDQPQHF	TRBV28	TRBJ1-5
TGTGCCAGCAGTCGGGGACAGGGGGCTGATCAGCCCCAGCATTTT	CASSRGQGADQPQHF	TRBV12-3	TRBJ1-5
TGTGCCAGCAGCTCGGGGACCGGGACTAGGAAGAATGAGCAGTTCTTC	CASSSGTGTRKNEQFF	TRBV7-7	TRBJ2-1
TGTGCCAGTTCCGGACAGCCCGGCTACACCTTC	CASSGQPGYTF	TRBV6-3	TRBJ1-2
TGTGCCAGCAGCCAAGATAGAACAGGGGACACCGGGGAGCTGTTTTTT	CASSQDRTGDTGELFF	TRBV3-1	TRBJ2-2
TGTGCCAGCAGCTTGAAGGGGCGTGTTTGGTACTTC	CASSLKGRVWYF	TRBV5-6	TRBJ2-5
TGTGCCAGCAGGCACGGGCCCGGGTGGGTGGGGACAAGGCTCGAGACCCAGTACTTC	CASRHGPGWVGTRLETQYF	TRBV7-9	TRBJ2-5
TGTGCCAGCAGCCAGGCCCTAGCGGGAGAGACCCAGTACTTC	CASSQALAGETQYF	TRBV3-1	TRBJ2-5
TGTGCCAGCAGCCAGGCGGGACAGGTTTCTGCCTATAATTCACCCCTCCACTTT	CASSQAGQVSAYNSPLHF	TRBV3-1	TRBJ1-6
TGTGCCAGCAGGACTAGCGGGAAGAATGAGCAGTTCTTC	CASRTSGKNEQFF	TRBV6-5	TRBJ2-1
TGTGCCAGCAGTTATTGGTGGGAGTTTGCAACTAATGAAAAACTGTTTTTT	CASSYWWEFATNEKLFF	TRBV6-3	TRBJ1-4
TGTGCCAGCAGTTTGGCCCAGGGCGGGGGCTACGAGCAGTACTTC	CASSLAQGGGYEQYF	TRBV27	TRBJ2-7
TGTGCCACCAGTGACTCAGGGATTTACGAGCAGTACTTC	CATSDSGIYEQYF	TRBV24-1	TRBJ2-7
TGTGCCAGCAGCGGACCCCCGGGACAGGGGGGAAATGAAAAACTGTTTTTT	CASSGPPGQGGNEKLFF	TRBV7-9	TRBJ1-4
TGCGCCAGCAGTGAGCCGACGATTGGAGGCTATGGCTACACCTTC	CASSEPTIGGYGYTF	TRBV10-1	TRBJ1-2
TGTGCCAGCAGCTTAGATCCCGAGGTGACAGGGAGTGCTTATGGCTACACCTTC	CASSLDPEVTGSAYGYTF	TRBV7-4	TRBJ1-2
TGTGCCAGCAGTCACCCCACTATCGGGAGGACCGGGGAGCTGTTTTTT	CASSHPTIGRTGELFF	TRBV6-2	TRBJ2-2
TGTGCCAGCAGCTACCGCTCGGATGACAGGGGTAAGGAGGGGACTGAAGCTTTCTTT	CASSYRSDDRGKEGTEAFF	TRBV11-2	TRBJ1-1
TGCAGCGTTGCAATCGGCTACACCTTC	CSVAIGYTF	TRBV29-1	TRBJ1-2
TGCAGTGCCCGGGCCGGGACAGGGACTAACTATGGCTACACCTTC	CSARAGTGTNYGYTF	TRBV20-1	TRBJ1-2
TGTGCCAGCAGCGCTTCGATACGGGACAGTTCTAGGATTAACTATGGCTACACCTTC	CASSASIRDSSRINYGYTF	TRBV7-3	TRBJ1-2
TGTGCCAGCAGCCAAACAGGGGAAGGCACTGAAGCTTTCTTT	CASSQTGEGTEAFF	TRBV3-1	TRBJ1-1
TGTGCCACCCTTTCAGGGGAGCTCACCGGGGAGCTGTTTTTT	CATLSGELTGELFF	TRBV24-1	TRBJ2-2
TGTGCCAGCAGTCGGACAGGGGAAGACGAGCAGTACTTC	CASSRTGEDEQYF	TRBV6-5	TRBJ2-7
TGTGCCACCAGTGATTTATCCAGACAGGTCTTGAACACTGAAGCTTTCTTT	CATSDLSRQVLNTEAFF	TRBV24-1	TRBJ1-1
TGTGCCAGCAGCTTTCTCCTTTTTTCCTCTGGAAACACCATATATTTT	CASSFLLFSSGNTIYF	TRBV7-9	TRBJ1-3
TGTGCCAGCAGTTTCCGGGAAGGGGAAAAACTGTTTTTT	CASSFREGEKLFF	TRBV12-3	TRBJ1-4
TGTGCCCGCGGGGAGGGTCAAAACATTCAGTACTTC	CARGEGQNIQYF	TRBV7-8	TRBJ2-4
TGTGCCAGCAGCCTTGGTTTGGGAGGAGTAAAGCCGTGTCCAGATACGCAGTATTTT	CASSLGLGGVKPCPDTQYF	TRBV11-3	TRBJ2-3
TGTGCCAGCAGCTTCCCATCAGACAGGGGTTCAAACATTCAGTACTTC	CASSFPSDRGSNIQYF	TRBV5-6	TRBJ2-4
TGTGCCAGCTCACGACCTGGCGTGGGGACTAGCGGGGGCCTCAATGAGCAGTTCTTC	CASSRPGVGTSGGLNEQFF	TRBV18	TRBJ2-1
TGTGCCAGCAGTCCCAGACAGGGCCGGGAGCAGTACTTC	CASSPRQGREQYF	TRBV6-1	TRBJ2-7
TGTGCCACCAGCGGAGGGGGGGGTGACTGCTATGGCTACACCTTC	CATSGGGGDCYGYTF	TRBV15	TRBJ1-2
TGTGCCAGTAGACTGGGCCTCCCAAGCTATGGCTACACCTTC	CASRLGLPSYGYTF	TRBV19	TRBJ1-2
TGTGCCAGCAGCGAGGGGGGGTCAACTGCGTTTTATAGCAATCAGCCCCAGCATTTT	CASSEGGSTAFYSNQPQHF	TRBV6-6	TRBJ1-5
TGTGCCAGCAGTTCCCCAGGGGAGGCCATGAACACTGAAGCTTTCTTT	CASSSPGEAMNTEAFF	TRBV27	TRBJ1-1
TGTGCCAGCAGTTTATCGCGACAGGTCGGGGAGCTGTTTTTT	CASSLSRQVGELFF	TRBV27	TRBJ2-2
TGTGCCAGCAGCGGACAGGGGGCGAGTGAGGAAGGAAACACCATATATTTT	CASSGQGASEEGNTIYF	TRBV9	TRBJ1-3
TGTGCCAGCAGTAAACCCAGAAGCTACGAGCAGTACTTC	CASSKPRSYEQYF	TRBV27	TRBJ2-7
TGTGCCAGCAGCCTATCTACCGGGGTTGGGATGGGCAATCAGCCCCAGCATTTT	CASSLSTGVGMGNQPQHF	TRBV14	TRBJ1-5
TGCGCCTCCAGGTCCTACGAGCAGTACTTC	CASRSYEQYF	TRBV10-1	TRBJ2-7
TGTGCCAGCACCCAGAAGCGGACTAGCGGGTGGGATGCCAAAAACATTCAGTACTTC	CASTQKRTSGWDAKNIQYF	TRBV6-1	TRBJ2-4
TGTGCCACCACGGGGTGGGGGGCCAAGTGGTCACCCCTCCACTTT	CATTGWGAKWSPLHF	TRBV24-1	TRBJ1-6
TGCGCCAGCAGGGGACCTAGCACAGATACGCAGTATTTT	CASRGPSTDTQYF	TRBV5-1	TRBJ2-3
TGTGCCAGCTTCGGGGCTAGGGGGCGAGGGACCAACACCGGGGAGCTGTTTTTT	CASFGARGRGTNTGELFF	TRBV7-9	TRBJ2-2
TGTGCCAGTAGTATAACGGACAGGGAGAAGGGGGAAGCTTTCTTT	CASSITDREKGEAFF	TRBV19	TRBJ1-1
TGTGCCAGCAGCCGGAAGAGTTGGAATGAGCAGTTCTTC	CASSRKSWNEQFF	TRBV13	TRBJ2-1
TGTGCCACCAGTGATAACTGTAACGGCTACGAGCAGTACTTC	CATSDNCNGYEQYF	TRBV24-1	TRBJ2-7
TGCAGTCCCGCTGCATCGTCAGGGAACACTGAAGCTTTCTTT	CSPAASSGNTEAFF	TRBV20-1	TRBJ1-1
TGTGCCAGCAGTGCTCCCACAGGGGAACAAGAGACCCAGTACTTC	CASSAPTGEQETQYF	TRBV6-1	TRBJ2-5
TGTGCCAGCAGTTATCCTAGCGGGGGATGGAGCTCCTACAATGAGCAGTTCTTC	CASSYPSGGWSSYNEQFF	TRBV27	TRBJ2-1
TGTGCCAGCGTCCGCCAGACTAGCGGGCCCTACGAGCAGTACTTC	CASVRQTSGPYEQYF	TRBV7-9	TRBJ2-7
TGTGCCAGCAGACATTGGGAGAAGGGGAGCTCTGGAAACACCATATATTTT	CASRHWEKGSSGNTIYF	TRBV6-2	TRBJ1-3
TGTGCCAGCAGTTTGGGGGACAGAGCATCAGATACGCAGTATTTT	CASSLGDRASDTQYF	TRBV12-3	TRBJ2-3
TGTGCCAGCACTTCCCGGGACAGTGATGGCTACACCTTC	CASTSRDSDGYTF	TRBV6-5	TRBJ1-2
TGTGCCAGCAAGAGGCTTGACATTCAGTACTTC	CASKRLDIQYF	TRBV5-4	TRBJ2-4
TGCAGTGCTAGAGTGGACTCCTCTGGAAACACCATATATTTT	CSARVDSSGNTIYF	TRBV20-1	TRBJ1-3
TGTGCCAGCAGCTTAGGGCCTCGGCGGGAAAAACTGTTTTTT	CASSLGPRREKLFF	TRBV11-2	TRBJ1-4
TGTGCCAGCAGCTTAGTAGACTTGGGTAGCGGTGGGGGGGCCGGTGGTATTGGAGGCGAGCAGTACTTC	CASSLVDLGSGGGAGGIGGEQYF	TRBV7-2	TRBJ2-7
TGTGCCAGCAGCGCCTCAAGCAATCAGCCCCAGCATTTT	CASSASSNQPQHF	TRBV11-1	TRBJ1-5
TGTGCCAGCAGTTACTCGGATTCAGACAGGGGCTCTGGAAACACCATATATTTT	CASSYSDSDRGSGNTIYF	TRBV6-5	TRBJ1-3
TGTGCCAGCAGCGGAAAAATTCCGGGACTAGCGGGAGCACGGGAGACCCAGTACTTC	CASSGKIPGLAGARETQYF	TRBV11-1	TRBJ2-5
TGTGCCAGCAGCTGGGGGGGATGGGCTTCCTACGAGCAGTACTTC	CASSWGGWASYEQYF	TRBV5-4	TRBJ2-7
TGTGCCTGGGAAAGGGGTACCGGGGAGCTGTTTTTT	CAWERGTGELFF	TRBV30	TRBJ2-2
TGCGCCAGCACTGGGGGGAACGGAATCACTTACGAGCAGTACTTC	CASTGGNGITYEQYF	TRBV10-2	TRBJ2-7
TGTGCCAGCAGTTACTCGAGAGGGACATGTTTAGAGACCCAGTACTTC	CASSYSRGTCLETQYF	TRBV6-6	TRBJ2-5
TGTGCCAGCAGCTTCAACCGAACCCGGGGGGAACCGAAGAACACCGGGGAGCTGTTTTTT	CASSFNRTRGEPKNTGELFF	TRBV7-6	TRBJ2-2
TGTGCCAGCAGGTACTTAAGGGGTTGGATCCAGCCCCAGCATTTT	CASRYLRGWIQPQHF	TRBV25-1	TRBJ1-5
TGCAGTGCTAGAGACCCTAACGGGGGGTCGAACACTGAAGCTTTCTTT	CSARDPNGGSNTEAFF	TRBV20-1	TRBJ1-1
TGTGCCAGCAGCTCACGCACAAGGGGAGGCGCGAACACTGAAGCTTTCTTT	CASSSRTRGGANTEAFF	TRBV5-5	TRBJ1-1
TGTGCCAGCAGGGACAGGGCCGGGAATTCACCCCTCCACTTT	CASRDRAGNSPLHF	TRBV27	TRBJ1-6
TGTGCCAGCAGTTTATGCGGGCGGACTAGCGGGGTTCCGCTGTTTTTT	CASSLCGRTSGVPLFF	TRBV27	TRBJ2-2
TGTGCCTGGAGTGTAGGGGACTGCTCTGGGGCCAACGTCCTGACTTTC	CAWSVGDCSGANVLTF	TRBV30	TRBJ2-6
TGCGCCAGCAGTCTGGGACCCAGCCAAGAGACCCAGTACTTC	CASSLGPSQETQYF	TRBV10-1	TRBJ2-5
TGTGCCAGCAGTTTGTTCCGTAGCACAGATACGCAGTATTTT	CASSLFRSTDTQYF	TRBV27	TRBJ2-3
TGTGCCAGCAGCTTGGCAGGAGCCTTGAAGGGGACAGGGGGCGGACAGCCCCAGCATTTT	CASSLAGALKGTGGGQPQHF	TRBV5-6	TRBJ1-5
TGTGCCAGCAGTTGGACAGGAGAAGAGACCCAGTACTTC	CASSWTGEETQYF	TRBV6-2	TRBJ2-5
TGCGCCAGCAGCCAAGAGACAGGGGAAGCCTACGAGCAGTACTTC	CASSQETGEAYEQYF	TRBV4-1	TRBJ2-7
TGTGCCAGCAGCCATCGGACAGGGGGTAATCAGCCCCAGCATTTT	CASSHRTGGNQPQHF	TRBV3-1	TRBJ1-5
TGCAGTGCTAGAGATAAGGCGGACAGGGGGCATACCTACGAGCAGTACTTC	CSARDKADRGHTYEQYF	TRBV20-1	TRBJ2-7
TGCGCCAGCAGCTCCGACGGGCTTGATCAGCCCCAGCATTTT	CASSSDGLDQPQHF	TRBV5-1	TRBJ1-5
TGTGCCAGCAGTCCACCGGGGAGAAATGAGCAGTTCTTC	CASSPPGRNEQFF	TRBV2	TRBJ2-1
TGTGCCAGCAGTTCCGCCCGGGACCATTACCGCAATCAGCCCCAGCATTTT	CASSSARDHYRNQPQHF	TRBV6-5	TRBJ1-5
TGTGCCAGCAGCTTACCTCTTGATCACGAGCAGTACTTC	CASSLPLDHEQYF	TRBV11-3	TRBJ2-7
TGCAGTGCCTTTTCCACAGGGACCCAGTACTTC	CSAFSTGTQYF	TRBV20-1	TRBJ2-5
TGTGCCAGCAGTCCGAGGCGGGGGGGGCGGTCAAATGAGCAGTTCTTC	CASSPRRGGRSNEQFF	TRBV12-3	TRBJ2-1
TGTGCCACCAGTGATTTACGACAGGGAGAGATAGAACGTAACTATGGCTACACCTTC	CATSDLRQGEIERNYGYTF	TRBV24-1	TRBJ1-2
TGCGCCAGCAGTGACGCGTGGTCCAGGCAGACCCGAGGGGGCTACACCTTC	CASSDAWSRQTRGGYTF	TRBV10-2	TRBJ1-2
TGTGCCAGCAGCCCGCGGCCCGACTATAGAATCTACAATGAGCAGTTCTTC	CASSPRPDYRIYNEQFF	TRBV9	TRBJ2-1
TGTGCCAGCAGCTCTCAAGATGGAAACACCATATATTTT	CASSSQDGNTIYF	TRBV9	TRBJ1-3
TGTGCCAGCAGCCAAGATCTTCCCGTAGCGGGATCATCCGGATACCCGTTTTACAATGAGCAGTTCTTC	CASSQDLPVAGSSGYPFYNEQFF	TRBV3-1	TRBJ2-1
TGCGCCAGCACCCATATAGGCTCCTACAATGAGCAGTTCTTC	CASTHIGSYNEQFF	TRBV5-1	TRBJ2-1
TGTGCCGGGGGGACCCCGGGACTAGGGGGGAGCTCCTACGAGCAGTACTTC	CAGGTPGLGGSSYEQYF	TRBV7-3	TRBJ2-7
TGTGCCAGGAGTCGGGACCCGGCCTTC	CARSRDPAF	TRBV7-4	TRBJ1-2
TGTGCCAGCAGCTTAGTCGCATGCACCGGTGGGACGGTAAGCTCCTACGAGCAGTACTTC	CASSLVACTGGTVSSYEQYF	TRBV11-2	TRBJ2-7
TGTGCCAGCAGCAGACAGGGTCAAGAGCAGTACTTC	CASSRQGQEQYF	TRBV9	TRBJ2-7
TGTGCCAGCGAGGGATTAGCGGGAGTTGACAATGAGCAGTTCTTC	CASEGLAGVDNEQFF	TRBV11-3	TRBJ2-1
TGTGCCAGCAGCTTGCAGGGCGAGCTGCAGTACTTC	CASSLQGELQYF	TRBV5-4	TRBJ2-7
TGTGCCAGCAGCCAGGATCCCGGGACAGCAGGAACCGGGGAGCTGTTTTTT	CASSQDPGTAGTGELFF	TRBV7-9	TRBJ2-2
TGTGCCAGCAGCCAAGAAGCCCTAGATTTTTACAATGAGCAGTTCTTC	CASSQEALDFYNEQFF	TRBV14	TRBJ2-1
TGTGCTAGCAGTACCCGTCGGATTCGCGGGAGTTGCGAGCAGTACTTC	CASSTRRIRGSCEQYF	TRBV7-7	TRBJ2-7
TGCAGTGCCTCGAGGGATACTGAAGAGACCCAGTACTTC	CSASRDTEETQYF	TRBV20-1	TRBJ2-5
TGTGCCAGCTCGCCCCGAGTACAGGGTGAGCAGTACTTC	CASSPRVQGEQYF	TRBV18	TRBJ2-7
TGTGCCAGCAGCTTAGCCCCCGTCTATTCGGTAGCCAAAAACATTCAGTACTTC	CASSLAPVYSVAKNIQYF	TRBV7-6	TRBJ2-4
TGTGCCAGCAGCTACCCCCAGACAGGGGGCTCCCGGCCCACAGATACGCAGTATTTT	CASSYPQTGGSRPTDTQYF	TRBV5-4	TRBJ2-3
TGTGCCAGCAGCTTGAAACCACGAATGGGAGACTCCTACAATGAGCAGTTCTTC	CASSLKPRMGDSYNEQFF	TRBV7-9	TRBJ2-1
TGTGCCAGCAGCTTGCCTGTAGACAGGGGTCACGAGCAGTACTTC	CASSLPVDRGHEQYF	TRBV5-4	TRBJ2-7
TGCAGCGTTGAGGGGGGCTATCAGCCCCAGCATTTT	CSVEGGYQPQHF	TRBV29-1	TRBJ1-5
TGCAGTGCTAATGGACCCGACAACACAGATACGCAGTATTTT	CSANGPDNTDTQYF	TRBV20-1	TRBJ2-3
TGTGCTAGCAGCTCCAACAGGGGCAAAGAGACCCAGTACTTC	CASSSNRGKETQYF	TRBV7-7	TRBJ2-5
TGCAGTGCTGGTAGACAGGGGGAATCGACAGATACGCAGTATTTT	CSAGRQGESTDTQYF	TRBV20-1	TRBJ2-3
TGCGCCAGCAGATACAGGGTTGTGACCCCTCAGCCCCAGCATTTT	CASRYRVVTPQPQHF	TRBV10-2	TRBJ1-5
TGTGCCAGCAGCTCGTTTGGGGGCTCTAACTATGGCTACACCTTC	CASSSFGGSNYGYTF	TRBV9	TRBJ1-2
TGCGCCAGCATGACAAATCTTGGAAACACCATATATTTT	CASMTNLGNTIYF	TRBV5-1	TRBJ1-3
TGTGCCACCGGGCCCGGGACTAGCGGGGAGGACACAGATACGCAGTATTTT	CATGPGTSGEDTDTQYF	TRBV15	TRBJ2-3
TGTGCCAGCCCCCGGGGGCGCTTCACTGAAGCTTTCTTT	CASPRGRFTEAFF	TRBV27	TRBJ1-1
TGTGCCAGCGGGACAGGCTACCAAGAGACCCAGTACTTC	CASGTGYQETQYF	TRBV7-2	TRBJ2-5
TGCAGTGCAGTAGGTCTTGGGGACTGGATGAACACTGAAGCTTTCTTT	CSAVGLGDWMNTEAFF	TRBV20-1	TRBJ1-1
TGTGCCAGCAGGGAGCCCGCTGACAGGGGCTATGGCTACGAGCAGTACTTC	CASREPADRGYGYEQYF	TRBV7-6	TRBJ2-7
TGTGCCAGCCAAAGTCCGGTCACGGAGACCCAGTACTTC	CASQSPVTETQYF	TRBV5-5	TRBJ2-5
TGTGCCAGCAGCTTATGGGTGTTCTCGCTGGTCTACAATGAGCAGTTCTTC	CASSLWVFSLVYNEQFF	TRBV7-4	TRBJ2-1
TGTGCCAGCAGCCGCTGCGGGAGGGACGCCGCCGAGACCCAGTACTTC	CASSRCGRDAAETQYF	TRBV14	TRBJ2-5
TGTGCCAGCAGCTTGGCTGTCAATGAGCAGTTCTTC	CASSLAVNEQFF	TRBV7-9	TRBJ2-1
TGCGCCAGCAGCCTCAAGTGGGCTCCGGAAAAACTGTTTTTT	CASSLKWAPEKLFF	TRBV4-3	TRBJ1-4
TGTGCCAGCAGTTTATGCTCAGCGGGAGCCCCCTACAATGAGCAGTTCTTC	CASSLCSAGAPYNEQFF	TRBV28	TRBJ2-1
TGTGCCAGCAGCTTGGCCCCGGGACTTCTGCAGTACTTC	CASSLAPGLLQYF	TRBV5-6	TRBJ2-7
TGTGCCAGCAGGAGTGTTAGAGGGGAGCTGTTTTTT	CASRSVRGELFF	TRBV7-2	TRBJ2-2
TGTGCCAGCAGTGAAAGCGGACAGGAGTACTTC	CASSESGQEYF	TRBV25-1	TRBJ2-5
TGTGCCAGCACTTTCGTGGGACAGGGATACACTGAAGCTTTCTTT	CASTFVGQGYTEAFF	TRBV2	TRBJ1-1
TGTGCCACCATACCAGAGACCCAGTACTTC	CATIPETQYF	TRBV24-1	TRBJ2-5
TGCAGTGCCAAGACAGGGAAGGGATTATATCAGCCCCAGCATTTT	CSAKTGKGLYQPQHF	TRBV20-1	TRBJ1-5
TGTGCCTGGAGTGCGAAAGGGGGGGAAGACAGGACCGGGGAGCTGTTTTTT	CAWSAKGGEDRTGELFF	TRBV30	TRBJ2-2
TGCAGTGCGAGGGGACGCTCCGGGGGGGCGGACTATGGCTACACCTTC	CSARGRSGGADYGYTF	TRBV20-1	TRBJ1-2
TGTGCCAGCAGCTTAACCACTAGCGGGAGTCTAAGGGATACGCAGTATTTT	CASSLTTSGSLRDTQYF	TRBV11-2	TRBJ2-3
TGTGCCAGCAGGACTACCACAGGGGGCTCGAGGACGGGAGAATATGGCTACACCTTC	CASRTTTGGSRTGEYGYTF	TRBV6-4	TRBJ1-2
TGCAGTGCTTCCAGGGTAATACCCTATAATTCACCCCTCCACTTT	CSASRVIPYNSPLHF	TRBV20-1	TRBJ1-6
TGCGCCAGCAGCTTACAGGGACCGACAGCTTTCTTT	CASSLQGPTAFF	TRBV5-1	TRBJ1-1
TGCGCCAGCAGGTACAGCACTTACTATGGCTACACCTTC	CASRYSTYYGYTF	TRBV10-1	TRBJ1-2
TGTGCCAGCAGCACTGGGGACAGCCGCTACGACACTGAAGCTTTCTTT	CASSTGDSRYDTEAFF	TRBV7-6	TRBJ1-1
TGTGCCAGCAGCAGGGTGGGGGGCGATCCTGATGAGCAGTTCTTC	CASSRVGGDPDEQFF	TRBV7-3	TRBJ2-1
TGTGCCGGCTACCCAGGGTCCTCCTGCGACGACGAGTACTTC	CAGYPGSSCDDEYF	TRBV27	TRBJ2-7
TGTGCCAGCAGTGGGAGTTTCCCGGAGACCCTTATTGTTACCGGGGAGCTGTTTTTT	CASSGSFPETLIVTGELFF	TRBV6-5	TRBJ2-2
TGTGCCTGGAGTGTCAAAATGGGGGGAAGGCAGCCCCAGCATTTT	CAWSVKMGGRQPQHF	TRBV30	TRBJ1-5
TGTGCCAGCAGCTTAGGCGAGCGGGACTTTACGCAGTATTTT	CASSLGERDFTQYF	TRBV7-9	TRBJ2-3
TGTGCCAGCAGCATGCGGGAGGTTAGCGAGCCTAGCACAGATACGCAGTATTTT	CASSMREVSEPSTDTQYF	TRBV5-6	TRBJ2-3
TGTGCCAGCAGGGCCGGGACTAGCGGCAATGAGCAGTTCTTC	CASRAGTSGNEQFF	TRBV27	TRBJ2-1
TGTGCCAGCAGCCGGCTGTCCTACGGGGGGGGCCGTAATGAGCAGTTCTTC	CASSRLSYGGGRNEQFF	TRBV28	TRBJ2-1
TGTGCCAGCAGCCGTTCCCCGGGGGTTATCTGGCGGGACGCTGGGGCCAACGTCCTGACTTTC	CASSRSPGVIWRDAGANVLTF	TRBV7-3	TRBJ2-6
TGTGCCAGCAGCTTAGCGGGGGGTGCTAGCGGGGTTTCGCAAAGGGATACGCAGTATTTT	CASSLAGGASGVSQRDTQYF	TRBV7-6	TRBJ2-3
TGTGCCAGCAGGGTTGGGGTCCCCTTACTCAGCTCCTACAATGAGCAGTTCTTC	CASRVGVPLLSSYNEQFF	TRBV6-5	TRBJ2-1
TGCAGTGCCACGGGAGGCGCTCTAACCTACGAGCAGTACTTC	CSATGGALTYEQYF	TRBV20-1	TRBJ2-7
TGTGCCAGCAGCTTAACCGGGACAGGGTGCAAAGCTTTCTTT	CASSLTGTGCKAFF	TRBV5-8	TRBJ1-1
TGCGCCAGCAGCGTCGGACAGCCCCAGCATTTT	CASSVGQPQHF	TRBV5-1	TRBJ1-5
TGTGCCAGCAGCTTGACTAGCGAGGAGACCCAGTACTTC	CASSLTSEETQYF	TRBV7-8	TRBJ2-5
TGTGCCAGCGGAGGGACAGCCGATGAGCAGTTCTTC	CASGGTADEQFF	TRBV25-1	TRBJ2-1
TGTGCCAGCAGTTACCGGGAACGCACAGATACGCAGTATTTT	CASSYRERTDTQYF	TRBV6-5	TRBJ2-3
TGTGCCAGCAGCCTATCCGGGACACCTAAAAACATTCAGTACTTC	CASSLSGTPKNIQYF	TRBV13	TRBJ2-4
TGTGCCAAAGGGGGGGTCCCCACCTACGAGCAGTACTTC	CAKGGVPTYEQYF	TRBV27	TRBJ2-7
TGCGCCAGCAGTGACTCGGTAGAGAATGGGACAGGGCTTAACTATGGCTACACCTTC	CASSDSVENGTGLNYGYTF	TRBV10-2	TRBJ1-2
TGCGCCAGCAGTGATCAGACGGGCTATAATTCACCCCTCCACTTT	CASSDQTGYNSPLHF	TRBV10-1	TRBJ1-6
TGTGCCAGCAGTTCGACCGGAACTAATGAAAAACTGTTTTTT	CASSSTGTNEKLFF	TRBV28	TRBJ1-4
TGTGCCAGCAGCTGGAAAGCTCCGACAGGTTGGTTTCAAGAGACCCAGTACTTC	CASSWKAPTGWFQETQYF	TRBV7-9	TRBJ2-5
TGTGCCAGCAGTCTACTAGCGGGAGGGCAATACGAGGCCTCTGGAAACACCATATATTTT	CASSLLAGGQYEASGNTIYF	TRBV27	TRBJ1-3
TGTGCCAGCAGTTACGATCGACAAGTAACCCAGTACTTC	CASSYDRQVTQYF	TRBV6-3	TRBJ2-7
TGTGCCACCAGTGATTTGCGGGGGGGGGTGCATCAGCCCCAGCATTTT	CATSDLRGGVHQPQHF	TRBV24-1	TRBJ1-5
TGCGCCAGCAGACACGGGGGGGACAATGAGCAGTTCTTC	CASRHGGDNEQFF	TRBV10-1	TRBJ2-1
TGTGCCAGCAGTGACGGTTCTGGGCTCGTGGAGGGTCGGGCTTACGAGCAGTACTTC	CASSDGSGLVEGRAYEQYF	TRBV6-4	TRBJ2-7
TGCAGTGCTAGAGATCGGTCTTTCGAGGGGAGACGAGCGAACACCGGGGAGCTGTTTTTT	CSARDRSFEGRRANTGELFF	TRBV20-1	TRBJ2-2
TGTGCCACGTGTGAAAGGAGGGGTCACCAAGAGACCCAGTACTTC	CATCERRGHQETQYF	TRBV19	TRBJ2-5
TGCGCCATCCGTGGCGGGGGGGACAATGAGCAGTTCTTC	CAIRGGGDNEQFF	TRBV4-1	TRBJ2-1
TGTGCCAGCAGTGAACCTGAGGGTCTGAAGGGACATCTCGAGCAGTACTTC	CASSEPEGLKGHLEQYF	TRBV2	TRBJ2-7
TGTGCCAGCAGTGGCCCGCGGGAGTTCGATGGCTACACCTTC	CASSGPREFDGYTF	TRBV7-9	TRBJ1-2
TGTGCCAGCAGCTTTTATGGGGGCGAGAGAGCCAAAAACATTCAGTACTTC	CASSFYGGERAKNIQYF	TRBV11-2	TRBJ2-4
TGTGCCAGCAGCTTAGTGAGGGACAGGGGGGGGGGAAACTATGGCTACACCTTC	CASSLVRDRGGGNYGYTF	TRBV7-6	TRBJ1-2
TGTGCCAGCAGTTACTCTACGGTGAATGAGCAGTTCTTC	CASSYSTVNEQFF	TRBV6-5	TRBJ2-1
TGCGCCAGCAGTGAGGAGAAGGGGGCTAACCAAAGGTGGCCCGGGAACTATGGCTACACCTTC	CASSEEKGANQRWPGNYGYTF	TRBV10-1	TRBJ1-2
TGTGCCAGCTGGACAGGTAGCAATCAGCCCCAGCATTTT	CASWTGSNQPQHF	TRBV7-3	TRBJ1-5
TGTGCCAGCAGCTCTCTACTAACCCGACAGGGGGCTAACTATGGCTACACCTTC	CASSSLLTRQGANYGYTF	TRBV9	TRBJ1-2
TGCAGTGCTAGCCGGTCTAGGGAATACTTC	CSASRSREYF	TRBV20-1	TRBJ2-5
TGTGCCAGCAGCGGACCTTTTCGAATACCAATGTATGGCTACACCTTC	CASSGPFRIPMYGYTF	TRBV13	TRBJ1-2
TGTGCTAGTGGTTTGCAGCTGACGCCCCAGCATTTT	CASGLQLTPQHF	TRBV12-5	TRBJ1-5
TGTGCCAGCAGCCAAGGGACAGATGTCACCGGGGAGCTGTTTTTT	CASSQGTDVTGELFF	TRBV4-2	TRBJ2-2
TGCAGTGCACGACCTTCTGGTCCCAGGACGAAGGGACAGGGAAACTTAAGGACCGGGGAGCTGTTTTTT	CSARPSGPRTKGQGNLRTGELFF	TRBV20-1	TRBJ2-2
TGTGCCAGCAGTTCCCGAATGTTGGCCACTTACAATGAGCAGTTCTTC	CASSSRMLATYNEQFF	TRBV27	TRBJ2-1
TGTGCCAGCAGCCGGGACAAGTATAGCAATCAGCCCCAGCATTTT	CASSRDKYSNQPQHF	TRBV6-5	TRBJ1-5
TGTGCCAGCAGCCCCGACAGGGCTCCCTTCTACGAGCAGTACTTC	CASSPDRAPFYEQYF	TRBV9	TRBJ2-7
TGTGCCAGCAGTTTCGGGGGGCAGATGAACACTGAAGCTTTCTTT	CASSFGGQMNTEAFF	TRBV28	TRBJ1-1
TGTGCCAGCAGCTTATTCCCCTCGGGTACTGACGGGAATCAGCCCCAGCATTTT	CASSLFPSGTDGNQPQHF	TRBV11-2	TRBJ1-5
TGTGCCAGCAGCAGTCCGTTCCTGTTTTTT	CASSSPFLFF	TRBV7-2	TRBJ1-4
TGTGCCAGCAGCAGGGTTTTGGGCCTTCACGAGCAGTACTTC	CASSRVLGLHEQYF	TRBV7-9	TRBJ2-7
TGTGCCAGCAGCCCCGGTCTAATCAGGGGATTTAATGAAAAACTGTTTTTT	CASSPGLIRGFNEKLFF	TRBV13	TRBJ1-4
TGTGCCAGCAGCCAAGAGCGACACGAACCTAACTATGGCTACACCTTC	CASSQERHEPNYGYTF	TRBV4-2	TRBJ1-2
TGTGCCACCAGTGATTTGGCTGCCCCCCGGGACAGCGGGGAGCTGTTTTTT	CATSDLAAPRDSGELFF	TRBV24-1	TRBJ2-2
TGTGCCAGCAGTCCAGGGGGGGGCCGGAGCTCCGCCTCCTACAATGAGCAGTTCTTC	CASSPGGGRSSASYNEQFF	TRBV6-5	TRBJ2-1
TGTGCCAGCAGTTCCAGGCAGGGGTCTTACGAGCAGTACTTC	CASSSRQGSYEQYF	TRBV6-5	TRBJ2-7
TGTGCCAGCAGCTTAGCGCGTTCGGGGGAACAGCCCCAGCATTTT	CASSLARSGEQPQHF	TRBV7-7	TRBJ1-5
TGCGCCAGCAGCCCCTGGACAGGGCCCCCTATGGGGCAAGAGACCCAGTACTTC	CASSPWTGPPMGQETQYF	TRBV5-1	TRBJ2-5
TGTGCCAGCAGTAAACAGGGGTGGAGGAATCAGCCCCAGCATTTT	CASSKQGWRNQPQHF	TRBV6-8	TRBJ1-5
TGTGCCAGCAGCCACTTCGGACACAGTCTGAACACTGAAGCTTTCTTT	CASSHFGHSLNTEAFF	TRBV3-1	TRBJ1-1
TGTGCCAGCAGGTGTAGCCACAGATTATCCGAGTATGGCTACACCTTC	CASRCSHRLSEYGYTF	TRBV7-8	TRBJ1-2
TGCGCCAGCAGCTTGGCCACCTCCCCAGGAGCGGGAAAGAAGGGAGCAGGCTACGAGCAGTACTTC	CASSLATSPGAGKKGAGYEQYF	TRBV5-1	TRBJ2-7
TGCAGCAAACTCTGGGACAGGGGGCAGACCGGGGAGCTGTTTTTT	CSKLWDRGQTGELFF	TRBV29-1	TRBJ2-2
TGTGCCAGCAGCCAAGTTGCCCCGCAGGGGTGTATTTTCAATCAGCCCCAGCATTTT	CASSQVAPQGCIFNQPQHF	TRBV3-1	TRBJ1-5
TGTGCCAGCAGCCCTCCAGGACTAGGCTACGAGCAGTACTTC	CASSPPGLGYEQYF	TRBV6-1	TRBJ2-7
TGTGCCAGTAGTATTAAACGTAGGCATCGGTACCAAGAGACCCAGTACTTC	CASSIKRRHRYQETQYF	TRBV19	TRBJ2-5
TGCGCCAGCAGCTTGGGGGTAAAGAACACTGAAGCTTTCTTT	CASSLGVKNTEAFF	TRBV5-1	TRBJ1-1
TGCAGTGCTAGAGATGAGGTAAAGTCCGGGACTAGCGGTCGCCGGTGGCAAGAGACCCAGTACTTC	CSARDEVKSGTSGRRWQETQYF	TRBV20-1	TRBJ2-5
TGTGCCAGCAGCGACCATAACTGGGCCTACGAGCAGTACTTC	CASSDHNWAYEQYF	TRBV7-2	TRBJ2-7
TGTGCCAGCAGCTTAGAAGCCTTTAGATCTAGCACAGATACGCAGTATTTT	CASSLEAFRSSTDTQYF	TRBV7-4	TRBJ2-3
TGTGCCAGCAGCCAAGTCGGGGGCATACAGGGGCACGAGCAGTACTTC	CASSQVGGIQGHEQYF	TRBV14	TRBJ2-7
TGCGCCAGCAGCTTGGGTAGGGGGGTTCAGCCCCAGCATTTT	CASSLGRGVQPQHF	TRBV5-1	TRBJ1-5
TGTGCCAGCAGTTGGCCGCCCGGGTACGAAAGTGAAAAACTGTTTTTT	CASSWPPGYESEKLFF	TRBV6-3	TRBJ1-4
TGTGCCAGCGCTGTCCGTATCAGGGGGGGCTACGAGCAGTACTTC	CASAVRIRGGYEQYF	TRBV27	TRBJ2-7
TGTGCCAGCAGCGGCCGCGATATACCCGTCTACGGCTCTGGGGCCAACGTCCTGACTTTC	CASSGRDIPVYGSGANVLTF	TRBV7-9	TRBJ2-6
TGTGCCAGCAGTGACTCATTAATAAGGGGTTCTACTGAAGCTTTCTTT	CASSDSLIRGSTEAFF	TRBV6-4	TRBJ1-1
TGTGCCACCAGTGATCTGGGCAGGGTGGACAAAAACATTCAGTACTTC	CATSDLGRVDKNIQYF	TRBV24-1	TRBJ2-4
TGTGCCAGCAGCTTACCTGAGGGTGCTGAGACCCAGTACTTC	CASSLPEGAETQYF	TRBV11-2	TRBJ2-5
TGTGCCAGCAGCGTAGACCCCCGGGTCCGGAGAGATACGCAGTATTTT	CASSVDPRVRRDTQYF	TRBV9	TRBJ2-3
TGTGCCAGCAGTCCCCAGGGGGACGACGAGCAGTACTTC	CASSPQGDDEQYF	TRBV12-4	TRBJ2-7
TGTGCCAGAGGTAACTCGCGGGAGGACGGAGAGGAGTGCCGCTATGGCTACACCTTC	CARGNSREDGEECRYGYTF	TRBV11-2	TRBJ1-2
TGTGCCAGCAGCCACTCCTGCCCTGCCCATGGGGAAGAGACCCAGTACTTC	CASSHSCPAHGEETQYF	TRBV5-8	TRBJ2-5
TGTGCCAGCAGTTTATCCTCAGGCGAAGCCCAGCATTTT	CASSLSSGEAQHF	TRBV27	TRBJ1-5
TGTGCCTGGAGAGACCCCGGACAGGGGCCGTGCACTGAAGCTTTCTTT	CAWRDPGQGPCTEAFF	TRBV30	TRBJ1-1
TGCGCCAGCAGCCCCGATGCGCGGGAGGAGCAGTACTTC	CASSPDAREEQYF	TRBV5-1	TRBJ2-7
TGTGCCAGCAGCCCGGACAGGGGGCGACGCAATCAGCCCCAGCATTTT	CASSPDRGRRNQPQHF	TRBV7-3	TRBJ1-5
TGCGCCAGCAGTGAGTCGGCGAGGGGCCACTCCTATAATTCACCCCTCCACTTT	CASSESARGHSYNSPLHF	TRBV10-2	TRBJ1-6
TGCGCCAGCAGCCAAGACCCCACCACCCCCTACGAGCAGTACTTC	CASSQDPTTPYEQYF	TRBV4-1	TRBJ2-7
TGTGCCAGCAGCCGGACGCAGGACATACGGGGTTATGGCTACACCTTC	CASSRTQDIRGYGYTF	TRBV7-3	TRBJ1-2
TGTGCCAGCAGCGCCCAGGGAACGTATGGCTACACCTTC	CASSAQGTYGYTF	TRBV13	TRBJ1-2
TGCAGCGTTGCCAGGGGGCCACTGTTGAAATTGTTAAGAAACACCATATATTTT	CSVARGPLLKLLRNTIYF	TRBV29-1	TRBJ1-3
TGTGCCACGGGATTTCGGGGCTCTGGGGCCAACGTCCTGACTTTC	CATGFRGSGANVLTF	TRBV7-9	TRBJ2-6
TGTGCCAGCAGCTTAAAGCAGGGTTGGATGTACGAGCAGTACTTC	CASSLKQGWMYEQYF	TRBV11-2	TRBJ2-7
TGTGCCAGCAGTGCGTGGCAGACCGAGCAGTACTTC	CASSAWQTEQYF	TRBV6-1	TRBJ2-7
TGTGCCAGTAGTAGTCTCCGACAGGTCGCAGATACGCAGTATTTT	CASSSLRQVADTQYF	TRBV19	TRBJ2-3
TGTGCCAGCAGCAATACCCCAGTCCTTAGCAGGACAGGAGATAATGAAAAACTGTTTTTT	CASSNTPVLSRTGDNEKLFF	TRBV13	TRBJ1-4
TGTGCCAGCAGTTCCTCCATCCCTTACGAGCAGTACTTC	CASSSSIPYEQYF	TRBV6-1	TRBJ2-7
TGTGCCAGCAGTGACTGTTCAGCCCCTCACCGGGACACTGTACACACCATATATTTT	CASSDCSAPHRDTVHTIYF	TRBV6-4	TRBJ1-3
TGTGCCAGCAGTGCGACCGGGACTAGCGGGAGATGGGCTGGGCAAGAGACCCAGTACTTC	CASSATGTSGRWAGQETQYF	TRBV25-1	TRBJ2-5
TGTGCCAGCAGCTCCATTTGGGCGGTTAAGTATGGCTACACCTTC	CASSSIWAVKYGYTF	TRBV4-2	TRBJ1-2
TGCGCCAGCAGGAAAAAATCAGTCACTAGCGGGAGTGGGCGGCCCCAGCATTTT	CASRKKSVTSGSGRPQHF	TRBV5-1	TRBJ1-5
TGTGCCAGCAGTTTAAAGCCGGGACAGGGTGATGAGCAGTTCTTC	CASSLKPGQGDEQFF	TRBV28	TRBJ2-1
TGTGCCAGCTCACTCAACAGCTCCTATAATTCACCCCTCCACTTT	CASSLNSSYNSPLHF	TRBV18	TRBJ1-6
TGTGCCAGCAGGTTTCTAGAGCAGTTCTTC	CASRFLEQFF	TRBV7-2	TRBJ2-1
TGCGCCAGCAGTCCATCCGCGTGTATCCGGGACAGGGCTCTCTATGGCTACACCTTC	CASSPSACIRDRALYGYTF	TRBV10-2	TRBJ1-2
TGTGCCAGCGATCGTCGGAGTGGTTCCTACGAGCAGTACTTC	CASDRRSGSYEQYF	TRBV7-4	TRBJ2-7
TGTGCCAGCAGCGGACTAGGGGACAATGAGCAGTTCTTC	CASSGLGDNEQFF	TRBV7-4	TRBJ2-1
TGTGCCAGCAGTTACGGGAGCGGGAGAGGCTACGAGCAGTACTTC	CASSYGSGRGYEQYF	TRBV6-5	TRBJ2-7
TGTGCCAGCAGTGAAGCCGGATGCGACCAAAACATTCAGTACTTC	CASSEAGCDQNIQYF	TRBV2	TRBJ2-4
TGTGCCAGCAGTTATCGAAGGACCCAACAAGAGACCCAGTACTTC	CASSYRRTQQETQYF	TRBV6-5	TRBJ2-5
TGTGCCAGCAGTTGGGGAGACCTAGCGGGCAGTGAGCAGTTCTTC	CASSWGDLAGSEQFF	TRBV6-4	TRBJ2-1
TGCGCCAGCAGCTGGGGCCTATTAAGACAGGGCGGGGGTGGTGACTATGGCTACACCTTC	CASSWGLLRQGGGGDYGYTF	TRBV5-1	TRBJ1-2
TGTGCCAGCAGCCCCATAACCCTTGAGCAGTACTTC	CASSPITLEQYF	TRBV13	TRBJ2-7
TGTGCCAGCAGCTTGACCCCCGACCACCAGGGCGCCTACGAGCAGTACTTC	CASSLTPDHQGAYEQYF	TRBV11-3	TRBJ2-7
TGCAGCGTAATCTCTGCTGGTACAAACCCGGGGGGGACAGACAGGGCGAACACCGGGGAGCTGTTTTTT	CSVISAGTNPGGTDRANTGELFF	TRBV29-1	TRBJ2-2
TGTGCCAGCAGTGGCCCCGGGACTAGCGTTCACAATGAGCAGTTCTTC	CASSGPGTSVHNEQFF	TRBV27	TRBJ2-1
TGCGCCAGCAGCCAGCCGGGCGGGACAGTTAGGAACACTGAAGCTTTCTTT	CASSQPGGTVRNTEAFF	TRBV4-1	TRBJ1-1
TGCAGCGTTGAAGGTCGGGGGGTACCCACAGATACGCAGTATTTT	CSVEGRGVPTDTQYF	TRBV29-1	TRBJ2-3
TGTGCCAGCAGTCCTCCCGGATGGCGGCCAACTTCCTACGAGCAGTACTTC	CASSPPGWRPTSYEQYF	TRBV6-5	TRBJ2-7
TGCGCCAGCAGCTTCCCAGAAGAGACCCAGTACTTC	CASSFPEETQYF	TRBV5-1	TRBJ2-5
TGTGCCACCAGTGATAGGGGGGGGCCCGGCTCCTACAATGAGCAGTTCTTC	CATSDRGGPGSYNEQFF	TRBV24-1	TRBJ2-1
TGTGCCAGCAGCGGAACACTGGGACTAGCGGGAGGCCTTCACTACGAGCAGTACTTC	CASSGTLGLAGGLHYEQYF	TRBV13	TRBJ2-7
TGTGCCAGCAGCGTACCGCGGGAGCGACCCCGCACAGATACGCAGTATTTT	CASSVPRERPRTDTQYF	TRBV9	TRBJ2-3
TGTGCCAGCACCGGCTATGGCGGCAACACTGAAGCTTTCTTT	CASTGYGGNTEAFF	TRBV5-4	TRBJ1-1
TGTGCCAGTCCCGCACGCACTGAAGCTTTCTTT	CASPARTEAFF	TRBV11-2	TRBJ1-1
TGTGCCATCAGTGGGTCTAACTTAGCGGGATTCGGCTACAATGAGCAGTTCTTC	CAISGSNLAGFGYNEQFF	TRBV10-3	TRBJ2-1
TGTGCCAGCAGCCCCGGGCATCTGGGCTACACCTTC	CASSPGHLGYTF	TRBV13	TRBJ1-2
TGCGCCAGCAGCTTGGTGTCGGAGACCCAGTACTTC	CASSLVSETQYF	TRBV5-1	TRBJ2-5
TGTGCCAGCAGCCAGGGGCCGGGACAGGGGTGGTATAATTCACCCCTCCACTTT	CASSQGPGQGWYNSPLHF	TRBV13	TRBJ1-6
TGTGCCAGCAGCTTAGGTTGTCAGGGACTAGCGGGGGGGCAGGCATCTTGTGACAATGAGCAGTTCTTC	CASSLGCQGLAGGQASCDNEQFF	TRBV11-3	TRBJ2-1
TGTGCCAGCAGCCTGGATGAAGGGACACGACCGGACAATTCACCCCTCCACTTT	CASSLDEGTRPDNSPLHF	TRBV14	TRBJ1-6
TGTGCCAGTAGTATGTTAAAAAGGGGGCAGCATTACGAGCAGTACTTC	CASSMLKRGQHYEQYF	TRBV19	TRBJ2-7
TGTGCCAGCTCAGGGGGGATTGGACGACACGAGCAGTACTTC	CASSGGIGRHEQYF	TRBV18	TRBJ2-7
TGTGCCAGCAGCAGACAGGGGGGCACTGAAGCTTTCTTT	CASSRQGGTEAFF	TRBV7-3	TRBJ1-1
TGTGCCACCAGTGATGGGCCCTACGAGCAGTACTTC	CATSDGPYEQYF	TRBV24-1	TRBJ2-7
TGTGCCAGTAGTATAGATCCCCCCCGGCGCGCCGACTCTGGAAACACCATATATTTT	CASSIDPPRRADSGNTIYF	TRBV19	TRBJ1-3
TGTGCCATCGTCAGGGGGCTACGCACTGAAGCTTTCTTT	CAIVRGLRTEAFF	TRBV10-3	TRBJ1-1
TGTGCCATTCCACAGGGTGGTAACTATGGCTACACCTTC	CAIPQGGNYGYTF	TRBV10-3	TRBJ1-2
TGTGCCAGCAAGCGCCGACTTGATTGCTATGAGCAGTTCTTC	CASKRRLDCYEQFF	TRBV6-8	TRBJ2-1
TGTGCCAGCAGTTACACCTTTTGGACAGGTCGGAATCCCTACGAGCAGTACTTC	CASSYTFWTGRNPYEQYF	TRBV6-5	TRBJ2-7
TGTGCCAGCAGCTACGTCGGACAGCCATGGCACGAGCAGTACTTC	CASSYVGQPWHEQYF	TRBV11-2	TRBJ2-7
TGTGCCAGCACCCCGGACAGGGGGTATCAGCCCCAGCATTTT	CASTPDRGYQPQHF	TRBV27	TRBJ1-5
TGCGCCAGCAGCGTAAGGGCCAACGGGGAGCTGTTTTTT	CASSVRANGELFF	TRBV5-1	TRBJ2-2
TGTGCCAGCAGGTCACCCGAGAAGGGTAATACGCAGTATTTT	CASRSPEKGNTQYF	TRBV9	TRBJ2-3
TGTGCCAGCAGGCTAGCGGGCGTCTACGAGCAGTACTTC	CASRLAGVYEQYF	TRBV6-6	TRBJ2-7
TGCGCCAGCAGCTTGGAGATCACTAGCGGGAGTAGAGACACCGGGGAGCTGTTTTTT	CASSLEITSGSRDTGELFF	TRBV5-1	TRBJ2-2
TGTGCCAGCATTAGGGACCAGGGACAGGGCGGTGGCTACGAGCAGTACTTC	CASIRDQGQGGGYEQYF	TRBV28	TRBJ2-7
TGTGCCAGCAGTTTATCGATAACTCCCGGGACTAGCGGGAGGGTTTCTCCGGAAGAGACCCAGTACTTC	CASSLSITPGTSGRVSPEETQYF	TRBV28	TRBJ2-5
TGTGCCAGCAGCCAGGGGGTTTCGACGTCTGGAAACACCATATATTTT	CASSQGVSTSGNTIYF	TRBV5-6	TRBJ1-3
TGCAGCGGTACTCTAGCGGGGGAGCAGTACTTC	CSGTLAGEQYF	TRBV29-1	TRBJ2-7
TGTGCCAGCAGCCCGCTGTTCCACCCGCCAGCTACATCAGCTTTCTTT	CASSPLFHPPATSAFF	TRBV5-6	TRBJ1-1
TGTGCCAGCAGCGTAGATGGGCTAACCTACGAGCAGTACTTC	CASSVDGLTYEQYF	TRBV9	TRBJ2-7
TGCAGTGCCCGGACCCTAGCGGGACTGGACATTCAGTACTTC	CSARTLAGLDIQYF	TRBV20-1	TRBJ2-4
TGTGCCAGCAGCCCCACCTCCGGACGGGAATCGCGTGAGCAGTTCTTC	CASSPTSGRESREQFF	TRBV7-4	TRBJ2-1
TGTGCCTATTACCGGGTCCCCAGGACCGGGGAGCTGTTTTTT	CAYYRVPRTGELFF	TRBV6-1	TRBJ2-2
TGTGCCAGCAGTGAAGAGAAGGAGGACCAGCCCCAGCATTTT	CASSEEKEDQPQHF	TRBV2	TRBJ1-5
TGCGCCAGCAGTTTCGGGGGGGGGTACGAGCAGTACTTC	CASSFGGGYEQYF	TRBV10-2	TRBJ2-7
TGTGCCAGCAGCGGCCAGGGATTAAGAGAGACCCAGTACTTC	CASSGQGLRETQYF	TRBV5-5	TRBJ2-5
TGTGCCAGCAGTGACTCCCGTGACAAATACTCTGGAAACACCATATATTTT	CASSDSRDKYSGNTIYF	TRBV6-4	TRBJ1-3
TGTGCCAGCAGAGTCCGACAGGATGAGCAGTTCTTC	CASRVRQDEQFF	TRBV28	TRBJ2-1
TGTGCCAGCAGCGGAAAAATCCACACTGAAGCTTTCTTT	CASSGKIHTEAFF	TRBV7-3	TRBJ1-1
TGCAGGGTCCAGTTAATCCTATACGACAGCTCCGACGAGCAGTACTTC	CRVQLILYDSSDEQYF	TRBV29-1	TRBJ2-7
TGTGCCAGCAGCGTGAGAACGGCTTCTAGGAATCATCAGCCCCAGCATTTT	CASSVRTASRNHQPQHF	TRBV9	TRBJ1-5
TGCGCCAGCAGCCAAACGAACGGGTCGGGGTTTGAGACCCAGTACTTC	CASSQTNGSGFETQYF	TRBV5-1	TRBJ2-5
TGTGCCAGCAGCCGCTCGCCTTTGGAGGCAGCCTACGAGCAGTACTTC	CASSRSPLEAAYEQYF	TRBV9	TRBJ2-7
TGTGCCAGCAGCACAGGTTCCTGGTCCTACAATGAGCAGTTCTTC	CASSTGSWSYNEQFF	TRBV9	TRBJ2-1
TGTGCCATCAGTGCGAGAGCGGGGGGTAGCTCCTACAATGAGCAGTTCTTC	CAISARAGGSSYNEQFF	TRBV10-3	TRBJ2-1
TGTGCCAGCAGCTTACTAGGACAGGTTGTGAACACCGGGGAGCTGTTTTTT	CASSLLGQVVNTGELFF	TRBV7-8	TRBJ2-2
TGTGCCAGCAGTTTTGTCAGGACTAGCGCTGAACACAATGAGCAGTTCTTC	CASSFVRTSAEHNEQFF	TRBV12-4	TRBJ2-1
TGTGCCAGCAGCGATATAAAGGGGACAGGGGCTGACACTGAAGCTTTCTTT	CASSDIKGTGADTEAFF	TRBV11-3	TRBJ1-1
TGTGCCAGCAGCCAACCCCTGGAAAGGACAGGGACCATTCCCAATGAGCAGTTCTTC	CASSQPLERTGTIPNEQFF	TRBV3-1	TRBJ2-1
TGTGCCAGCAGTTTATATACTCCTGACACCTACGAGCAGTACTTC	CASSLYTPDTYEQYF	TRBV27	TRBJ2-7
TGTGCCACCAGTGAACCGGGGGGAGAAAATTCACCCCTCCACTTT	CATSEPGGENSPLHF	TRBV24-1	TRBJ1-6
TGCAGTGCTAGAGATCCGACATCCTACAATGAGCAGTTCTTC	CSARDPTSYNEQFF	TRBV20-1	TRBJ2-1
TGTGCCAGCATATCCCGGGACAGGGGGCCCGCGTGGCGCTTTTACTATGGCTACACCTTC	CASISRDRGPAWRFYYGYTF	TRBV7-9	TRBJ1-2
TGTGCCAGCAGCCTCCTTAACCGGACAGGCGTCTACGAGCAGTACTTC	CASSLLNRTGVYEQYF	TRBV5-6	TRBJ2-7
TGTGCCAGCATCATTAGAGGGGGCCCCCCCTCCACCGGGGAGCTGTTTTTT	CASIIRGGPPSTGELFF	TRBV6-3	TRBJ2-2
TGCGCCAGCAGCTTGGACGAGGGTTCGGGACAGGGAGAGGGAACAGATACGCAGTATTTT	CASSLDEGSGQGEGTDTQYF	TRBV5-1	TRBJ2-3
TGTGCCAGCAGCCTATTTCGGCAGGGCGCGATTGACTACGAGCAGTACTTC	CASSLFRQGAIDYEQYF	TRBV9	TRBJ2-7
TGTGCCCTCGGCCTTAATCAGCCCCAGCATTTT	CALGLNQPQHF	TRBV6-2	TRBJ1-5
TGTGCCAGCAGCCAAGATCAAAGGGCCAATATACCGTTCGGGCACAATGAGCAGTTCTTC	CASSQDQRANIPFGHNEQFF	TRBV14	TRBJ2-1
TGCAGTGCCGCTGAGCAGTTCTTC	CSAAEQFF	TRBV20-1	TRBJ2-1
TGTGCCAGCCCCCCCGACAGTCGCACAGATACGCAGTATTTT	CASPPDSRTDTQYF	TRBV6-3	TRBJ2-3
TGTGCCAGCAGCCAACAGAATGACAGTGGGTGGAACACTGAAGCTTTCTTT	CASSQQNDSGWNTEAFF	TRBV3-1	TRBJ1-1
TGTGCCTGGAGGAGGGCAACGGCGGACAGGGACCATGGTGGGGAGACCCAGTACTTC	CAWRRATADRDHGGETQYF	TRBV30	TRBJ2-5
TGTGCCAGCAGCTTAGCGAACCCGCCAGGGCGCTACGAGCAGTACTTC	CASSLANPPGRYEQYF	TRBV11-3	TRBJ2-7
TGCAGTGCTAGCCGGACAGGGGTGGGGAGGATTGAAAAACTGTTTTTT	CSASRTGVGRIEKLFF	TRBV20-1	TRBJ1-4
TGCGCCAGCAGTGTGGGTCCGGGTCGGGGGAACACTGAAGCTTTCTTT	CASSVGPGRGNTEAFF	TRBV10-1	TRBJ1-1
TGTGCCAGCAGCCAAGCCAGACTAGATGAGCAGTTCTTC	CASSQARLDEQFF	TRBV14	TRBJ2-1
TGCAGTGCTAGTGATCCAAGCTCTGGGGCCAACGTCCTGACTTTC	CSASDPSSGANVLTF	TRBV20-1	TRBJ2-6
TGTGCCAGCAGCCGACTAGCGGGTTGGTACTACGAGCAGTACTTC	CASSRLAGWYYEQYF	TRBV14	TRBJ2-7
TGTGCCAGCAGAATGGGACAGGGCATTTGCACAGATACGCAGTATTTT	CASRMGQGICTDTQYF	TRBV6-2	TRBJ2-3
TGTGCCAGTATGCCCACAGACGTAGAGAATCGTACCTACGAGCAGTACTTC	CASMPTDVENRTYEQYF	TRBV19	TRBJ2-7
TGTGCCAGCAGCCAAGACCACAGGGGGCAGTACGAGCAGTACTTC	CASSQDHRGQYEQYF	TRBV3-1	TRBJ2-7
TGCAGTGCCCTTCTGCGGGAGGGTGGGGGTTCTGGAAACACCATATATTTT	CSALLREGGGSGNTIYF	TRBV20-1	TRBJ1-3
TGCGCCAGCAGTGAGAGGCTAGCGGGGCTAACGACAGATACGCAGTATTTT	CASSERLAGLTTDTQYF	TRBV10-1	TRBJ2-3
TGTGCCAGCAACCCCGGGACTAGCGCAACCTACGAGCAGTACTTC	CASNPGTSATYEQYF	TRBV7-9	TRBJ2-7
TGTGCCAGGCCGGGACAGGGCTATGGCTACACCTTC	CARPGQGYGYTF	TRBV19	TRBJ1-2
TGTGCCAGCACGGGCTGCATTCAGTACTTC	CASTGCIQYF	TRBV5-6	TRBJ2-4
TGTGCCAGCAGTGATGGGTCTGGAAACACCATATATTTT	CASSDGSGNTIYF	TRBV9	TRBJ1-3
TGTGCCAGCTTTAGCACAGATACGCAGTATTTT	CASFSTDTQYF	TRBV27	TRBJ2-3
TGTGCCAGCAGCGGACAGAACAGCAATCAGCCCCAGCATTTT	CASSGQNSNQPQHF	TRBV11-3	TRBJ1-5
TGCGCCAGCATTCACATGGAAGGGGGGGGCGGTGATACGCAGTATTTT	CASIHMEGGGGDTQYF	TRBV10-2	TRBJ2-3
TGTGCCAGCAGCAGTGGGTCAGGTCAGCCCCAGCATTTT	CASSSGSGQPQHF	TRBV13	TRBJ1-5
TGTGCGGGGCCCCGGGGCGGCTATGGCTACACCTTC	CAGPRGGYGYTF	TRBV2	TRBJ1-2
TGTGCCAGCAGCGTCTACACTCAGGCTAATTCACCCCTCCACTTT	CASSVYTQANSPLHF	TRBV9	TRBJ1-6
TGTGCCAGCAGTTACGACCCGGGGGAGGGGAAGTATGGCTACACCTTC	CASSYDPGEGKYGYTF	TRBV12-4	TRBJ1-2
TGTGCCAGCAGCTTACATCCGAGGGGAGCTACAGAGACCCAGTACTTC	CASSLHPRGATETQYF	TRBV7-9	TRBJ2-5
TGTGCCAGCAGCTTCTTTTGTGACTGGGGGGGGCGAGATACGCAGTATTTT	CASSFFCDWGGRDTQYF	TRBV7-3	TRBJ2-3
TGTGCCAGCAGTGAGGGGCGCGAGACCCAGTACTTC	CASSEGRETQYF	TRBV2	TRBJ2-5
TGTGCCAGCAGAAAGGTTAAAAACACCTTC	CASRKVKNTF	TRBV7-2	TRBJ1-2
TGTGCCAGCAGCTTGGAGGCCACGACTGAAGCTTTCTTT	CASSLEATTEAFF	TRBV5-6	TRBJ1-1
TGCGCCAGCAGCCGACCGGGACAGGTAATCTTTAACTATGGCTACACCTTC	CASSRPGQVIFNYGYTF	TRBV4-1	TRBJ1-2
TGCAGTGCTAGAGTCAGGAGGGGAAACACCATATATTTT	CSARVRRGNTIYF	TRBV20-1	TRBJ1-3
TGTGCCATCAGTGTCGGGCTTGGCTACACCTTC	CAISVGLGYTF	TRBV10-3	TRBJ1-2
TGCGCCAGCAGTGAGAGGGGGTCTTCACCCCTCCACTTT	CASSERGSSPLHF	TRBV10-1	TRBJ1-6
TGTGCCAGCAGTTTACGGGGGGACAGGTCCTATGGCTACACCTTC	CASSLRGDRSYGYTF	TRBV12-3	TRBJ1-2
TGTGCCAGCAGCTTGAGGGCTTCGGGAGTGGAAATAGAAAATGGAAACACCATATATTTT	CASSLRASGVEIENGNTIYF	TRBV11-3	TRBJ1-3
TGCAGTGTGAAGACGGTGGGGGCTGCTAGCACAGATACGCAGTATTTT	CSVKTVGAASTDTQYF	TRBV20-1	TRBJ2-3
TGCGCCAGCAGCTTGGCTTCCGGGACAGGTGGGACTGGGGCCAACGTCCTGACTTTC	CASSLASGTGGTGANVLTF	TRBV5-1	TRBJ2-6
TGTGCCAGCGTAAAATGGGGCCTGGACAGAGAGACCCAGTACTTC	CASVKWGLDRETQYF	TRBV27	TRBJ2-5
TGTGCCAGCAGGAGAATAGGTACAGGGGTGATGGGCTACACCTTC	CASRRIGTGVMGYTF	TRBV13	TRBJ1-2
TGTGCCAGCAGCCCACCCTGGACAGTCGGGGAACTGTTTTTT	CASSPPWTVGELFF	TRBV7-9	TRBJ1-4
TGTGCCAGCAGGGGGGGTAACTATGGCTACACCTTC	CASRGGNYGYTF	TRBV6-4	TRBJ1-2
TGTGCCAGCCACTACACACCTGGAAACACCATATATTTT	CASHYTPGNTIYF	TRBV6-1	TRBJ1-3
TGTGCCAGCAGCGGCCACGGCAATCAGCCCCAGCATTTT	CASSGHGNQPQHF	TRBV7-9	TRBJ1-5
TGTGCTAGTGGCCGCGGGGCCCTTCTCATGAACACTGAAGCTTTCTTT	CASGRGALLMNTEAFF	TRBV12-5	TRBJ1-1
TGTGCCAGCAGTTACTCGGACGGTCGCATGGGACAGGGGGGAAAGTTCGAGCAGTACTTC	CASSYSDGRMGQGGKFEQYF	TRBV6-5	TRBJ2-7
TGTGCCAGCAGTGCGACCCGGGACAGGGGCAATCAGCCCCAGCATTTT	CASSATRDRGNQPQHF	TRBV12-3	TRBJ1-5
TGTGCCAGCAGTTTACTCTCCCGGGTTGCCAAAAACATTCAGTACTTC	CASSLLSRVAKNIQYF	TRBV27	TRBJ2-4
TGTGCCAGCAGCCCCCTTCGACGAGAGCAGTACTTC	CASSPLRREQYF	TRBV7-4	TRBJ2-7
TGTGCCAGCAGCCCGAACTGTAGGGGGGCAGGCTACAATGAGCAGTTCTTC	CASSPNCRGAGYNEQFF	TRBV13	TRBJ2-1
TGTGCCAGCGACAGACCTGAAGCTTTCTTT	CASDRPEAFF	TRBV6-1	TRBJ1-1
TGTGCCAGCAGCTCCAAAGGGGGGACAGAAGAGAAGGTAGGGGCCAACGTCCTGACTTTC	CASSSKGGTEEKVGANVLTF	TRBV7-3	TRBJ2-6
TGCGCCAGCTTCGCAGAGTTCCCTCTTGAAGCTTTCTTT	CASFAEFPLEAFF	TRBV10-1	TRBJ1-1
TGTGCCATCAGTGTCCAATACGCCCCAGGGACAGGCTACGAGCAGTACTTC	CAISVQYAPGTGYEQYF	TRBV10-3	TRBJ2-7
