TGTGCCAGCAGCTTAGTCCCCCCAGGTTCCTACGAGCAGTACTTC	CASSLVPPGSYEQYF	TRBV7-4	TRBJ2-7
TGTGCCAGCGGGGGACAGGGGGGCGGGGAGCTGTTTTTT	CASGGQGGGELFF	TRBV28	TRBJ2-2
TGTGCCAGCAGCGTAGCCCGTCACAGGGGCCCGGTTAGCGAGCAGTACTTC	CASSVARHRGPVSEQYF	TRBV9	TRBJ2-7
TGTGCCACCAAGTCGGAGGGACCCGGGGAGCTGTTTTTT	CATKSEGPGELFF	TRBV24-1	TRBJ2-2
TGTGCCACCAGTTCGGGGGAGGGCGTCCACACTGAAGCTTTCTTT	CATSSGEGVHTEAFF	TRBV24-1	TRBJ1-1
TGTGCCAGTAGTATCGCTCCCTACTTTCCGGGACAGGGGGCCAACTACGAGCAGTACTTC	CASSIAPYFPGQGANYEQYF	TRBV19	TRBJ2-7
TGTGCCCCACACTTTACTGGACTAGCGAATGAGCAGTTCTTC	CAPHFTGLANEQFF	TRBV7-3	TRBJ2-1
TGTGCCAGCAGCTTAAGAAAGGGGACCTCTGGAAACACCATATATTTT	CASSLRKGTSGNTIYF	TRBV7-9	TRBJ1-3
TGCAGTGCTAGAGTTCACAATCTGGGGTTGAACACTGAAGCTTTCTTT	CSARVHNLGLNTEAFF	TRBV20-1	TRBJ1-1
TGTGCCAGTCCTTGTGGTGGGGGTCACTCTGGGGCCAACGTCCTGACTTTC	CASPCGGGHSGANVLTF	TRBV19	TRBJ2-6
TGTGCCAGCAGCCAACATCCCTTGCTCGACGGTCCCTATAATTCACCCCTCCACTTT	CASSQHPLLDGPYNSPLHF	TRBV3-1	TRBJ1-6
TGTGCCAGCAGCTCACAAACAGGGGAAGAGGCCTCCTACGAGCAGTACTTC	CASSSQTGEEASYEQYF	TRBV7-4	TRBJ2-7
TGTGCCAGCAGCGGAGAACGTTTCAATGAGCAGTTCTTC	CASSGERFNEQFF	TRBV14	TRBJ2-1
TGTGCCATCAGCCCCACAGAGCTCGGCCTGCCAAACTATGGCTACACCTTC	CAISPTELGLPNYGYTF	TRBV10-3	TRBJ1-2
TGTGCCAGCAGCTTCGTACAGGGCCCCCTGCATTTT	CASSFVQGPLHF	TRBV5-6	TRBJ1-5
TGTGCCAGCAGCTCCCGATACGGGACCACCTCTGAAGCTTTCTTT	CASSSRYGTTSEAFF	TRBV7-9	TRBJ1-1
TGTGCCATGGGGACTCAGAACACTGAAGCTTTCTTT	CAMGTQNTEAFF	TRBV6-1	TRBJ1-1
TGTGCCGTCCGGGACAGGGGGGACTATGGCTACACCTTC	CAVRDRGDYGYTF	TRBV19	TRBJ1-2
TGCGCCAGCAGCTTGTATACGGGCACTGAAGCTTTCTTT	CASSLYTGTEAFF	TRBV5-1	TRBJ1-1
TGTGCCAGTAGGAGCGGCCGGACTAGCGGGCGATACAATGAGCAGTTCTTC	CASRSGRTSGRYNEQFF	TRBV19	TRBJ2-1
TGTGCCAGCAGTGAAGAGAGGGCCCTTGGTCTTAGCTCCTACGAGCAGTACTTC	CASSEERALGLSSYEQYF	TRBV6-1	TRBJ2-7
TGTGCCAGCAGTTACTCCGGAGGGGAAAATAATGAAAAACTGTTTTTT	CASSYSGGENNEKLFF	TRBV6-3	TRBJ1-4
TGTGCCAGCAGCCAAATCTCCGGGGGGGGCTACGAGCAGTACTTC	CASSQISGGGYEQYF	TRBV28	TRBJ2-7
TGTGCCAGCAGTTACGAAGGAAAAACCTTTCAGGGGATCAGTGAAGCTTTCTTT	CASSYEGKTFQGISEAFF	TRBV6-6	TRBJ1-1
TGTGCCAGCAGCCGAGCCCTGACGGACACTGAAGCTTTCTTT	CASSRALTDTEAFF	TRBV6-1	TRBJ1-1
TGTGCTAGTGGTTTGGAAGGGGGAAGGCGAAGGAACACTGAAGCTTTCTTT	CASGLEGGRRRNTEAFF	TRBV12-5	TRBJ1-1
TGTGCCAGCAGTTACTCAATGGGGTCGGCGGGGACGCCCCAGCATTTT	CASSYSMGSAGTPQHF	TRBV6-5	TRBJ1-5
TGTGCCAGCAGTTTAAGGGGGGTCTCCACTGAAGCTTTCTTT	CASSLRGVSTEAFF	TRBV12-4	TRBJ1-1
TGTGCCAGCAGTTACCCAGCGGGAGAGGCCAGGGGGGCCAACGTCCTGACTTTC	CASSYPAGEARGANVLTF	TRBV6-5	TRBJ2-6
TGTGCCACCAGTGAGCTTCTAGAGTCGACTAGCGGGGGGTCCTACGAGCAGTACTTC	CATSELLESTSGGSYEQYF	TRBV24-1	TRBJ2-7
TGTGCCAGCAGCCAAGCCGTGGGCCCGAAGGGGACTGAAGCTTTCTTT	CASSQAVGPKGTEAFF	TRBV4-2	TRBJ1-1
TGCGCCAGCAGCAACGACAGGGGATGGTATGGCTACACCTTC	CASSNDRGWYGYTF	TRBV5-1	TRBJ1-2
TGTGCCAGCAGACGGGACAGTTCTAATGAAAAACTGTTTTTT	CASRRDSSNEKLFF	TRBV27	TRBJ1-4
TGTGCCAGCGGGAGGGGGGGGCCCGAGGAGACCCAGTACTTC	CASGRGGPEETQYF	TRBV25-1	TRBJ2-5
TGTGCCAGCAGGAAAAGCGGGAGCAGCGGGGAGCTGTTTTTT	CASRKSGSSGELFF	TRBV6-1	TRBJ2-2
TGTGCCAGCAGTGTACACAGCTCGTCTAAAGAGACCCAGTACTTC	CASSVHSSSKETQYF	TRBV27	TRBJ2-5
TGTGCTAGTGGTTGTAACGACAGGTGGGGGTCCTACGAGCAGTACTTC	CASGCNDRWGSYEQYF	TRBV12-5	TRBJ2-7
TGTGCCAGCAGCGATACCCCGGGGGGGCGGTGGTCGCAGTACTTC	CASSDTPGGRWSQYF	TRBV9	TRBJ2-7
TGTGCCAGCTCGGGGGTTAGCTATGGCTACACCTTC	CASSGVSYGYTF	TRBV27	TRBJ1-2
TGCAGTGCTAGAGACTCGGGGAGCGGGAGGGGGTGGTACGAGCAGTACTTC	CSARDSGSGRGWYEQYF	TRBV20-1	TRBJ2-7
TGTGCCAGCAGCTTAGTCAGGGCCTACGAGCAGTACTTC	CASSLVRAYEQYF	TRBV11-2	TRBJ2-7
TGCGCCAGCAGCCAAGACGATGAGGGGGGGGACCGGGCGTGCTACGAGCAGTACTTC	CASSQDDEGGDRACYEQYF	TRBV4-1	TRBJ2-7
TGTGCCAGCGTAACAGAGGACTACGAGCAGTACTTC	CASVTEDYEQYF	TRBV11-2	TRBJ2-7
TGTGCCAGCAGCTTGGGCCCCCCCGGGACAGGGGGGCCCTCTGGGGCCAACGTCCTGACTTTC	CASSLGPPGTGGPSGANVLTF	TRBV5-8	TRBJ2-6
TGTGCCCTTCCTGGTTGCGGGACCTACGAGCAGTACTTC	CALPGCGTYEQYF	TRBV9	TRBJ2-7
TGTGCCACCAACTTCACTAGCGGGTACGAGCAGTACTTC	CATNFTSGYEQYF	TRBV24-1	TRBJ2-7
TGTGCCAGTAGGGGCGGGGGGGCACAGAACGGAGTCTACAATGAGCAGTTCTTC	CASRGGGAQNGVYNEQFF	TRBV19	TRBJ2-1
TGTGCCAGACAGGTAGAAGAGCAGTACTTC	CARQVEEQYF	TRBV6-4	TRBJ2-7
TGTGCCACCAGTGCATGCACCGGGGAGCTGTTTTTT	CATSACTGELFF	TRBV24-1	TRBJ2-2
TGTGCCAGCAGCCAGCGACAGTTGTGGTACGAGCAGTACTTC	CASSQRQLWYEQYF	TRBV11-3	TRBJ2-7
TGCGCCAGCAGACTTCTGCTAGCGGGGACCACCGAGACCCAGTACTTC	CASRLLLAGTTETQYF	TRBV10-1	TRBJ2-5
TGTGCCAGCAGCTGGACTAGCGGGTACAATGAGCAGTTCTTC	CASSWTSGYNEQFF	TRBV11-2	TRBJ2-1
TGCAGCGTTAGGGGCCAAAAGAATGAGCAGTTCTTC	CSVRGQKNEQFF	TRBV29-1	TRBJ2-1
TGTGCCAGTAGTATAGCAGCCAATGTAGGGGTTGGTGAAGAGACCCAGTACTTC	CASSIAANVGVGEETQYF	TRBV19	TRBJ2-5
TGTGCCAGCAGTGACGCCCCCGGCCACGGGACTAGCGGGGGGGCCCGGTACAATGAGCAGTTCTTC	CASSDAPGHGTSGGARYNEQFF	TRBV2	TRBJ2-1
TGTGCTAGTGGTTTGCGCCGCCGACAGGGGGCCGTTCAGCCCCAGCATTTT	CASGLRRRQGAVQPQHF	TRBV12-5	TRBJ1-5
TGCGCCAGCAGCTTGGAGCACCAGGGCGGGGAGCTGTTTTTT	CASSLEHQGGELFF	TRBV5-1	TRBJ2-2
TGTGCCAGCAGGGTCCCTTTGAGCAGGGTGATTGATCGGGGAAACTATGGCTACACCTTC	CASRVPLSRVIDRGNYGYTF	TRBV6-1	TRBJ1-2
TGTGCTAGTGGCCTGACAGTTTATGGCTACACCTTC	CASGLTVYGYTF	TRBV12-5	TRBJ1-2
TGTGCCAGCAGCTTAAGGGTTCCTTGTCAGGTCCTGACTAACTATGGCTACACCTTC	CASSLRVPCQVLTNYGYTF	TRBV7-3	TRBJ1-2
TGTGCCAGCTCAGTAAACCTGGGACAGGGGTATGAAAAACTGTTTTTT	CASSVNLGQGYEKLFF	TRBV18	TRBJ1-4
TGCAGTGCTGGTGAAGGAGGAATGAACACTGAAGCTTTCTTT	CSAGEGGMNTEAFF	TRBV20-1	TRBJ1-1
TGTGCCACCAGTGAAGTAACTGAAGCTTTCTTT	CATSEVTEAFF	TRBV24-1	TRBJ1-1
TGTGCCAGCTCGGGACAGGGTTGCGACACTGAAGCTTTCTTT	CASSGQGCDTEAFF	TRBV6-4	TRBJ1-1
TGTGCCAGCAAAAGGACAGGCCATTGCAATCAGCCCCAGCATTTT	CASKRTGHCNQPQHF	TRBV6-4	TRBJ1-5
TGTGCCAGCAAGCCACGGACGCCCGGAGGGGCCAACGTCCTGACTTTC	CASKPRTPGGANVLTF	TRBV27	TRBJ2-6
TGTGCCAGCAGTTACCGGGGAGCGGGTTCCAATGAGCAGTTCTTC	CASSYRGAGSNEQFF	TRBV6-3	TRBJ2-1
TGTGCCAGCTCAATTCCGGGGGGACTAGCGGGGGGAGAGACCCAGTACTTC	CASSIPGGLAGGETQYF	TRBV18	TRBJ2-5
TGTGCCAGCTTCCCAGCTTCTGGAAACACCATATATTTT	CASFPASGNTIYF	TRBV28	TRBJ1-3
TGTGCCAGCAGCGTCGATGGACTTAGGTCTAGCAATCAGCCCCAGCATTTT	CASSVDGLRSSNQPQHF	TRBV9	TRBJ1-5
TGTGCCAGCAGGATCAGGCGCTGGTACGAGCAGTACTTC	CASRIRRWYEQYF	TRBV28	TRBJ2-7
TGTGCCAGAGTAGGAAATCAGCCCCAGCATTTT	CARVGNQPQHF	TRBV7-3	TRBJ1-5
TGCAGCGTTGGGTTCCCAGAGGCCTACGAGCAGTACTTC	CSVGFPEAYEQYF	TRBV29-1	TRBJ2-7
TGTGCCAGCAGGCGGCAGGGGTCCAATCAGCCCCAGCATTTT	CASRRQGSNQPQHF	TRBV7-9	TRBJ1-5
TGTGGGGGGGGGCTAGGCGAGCAGTACTTC	CGGGLGEQYF	TRBV6-5	TRBJ2-7
TGTGCCACCAGTGATTTGCAGGTGCGGGAGTATACCGGGGAGCTGTTTTTT	CATSDLQVREYTGELFF	TRBV24-1	TRBJ2-2
TGCGCCAGCAGCTTCAGGGACTGGCAGAACACTGAAGCTTTCTTT	CASSFRDWQNTEAFF	TRBV5-1	TRBJ1-1
TGTGCCAGCAGTACTGGGGGCAGACTATTCAATCAGCCCCAGCATTTT	CASSTGGRLFNQPQHF	TRBV27	TRBJ1-5
TGTGCACCCCCGGGGAGAGAGACCCAGTACTTC	CAPPGRETQYF	TRBV6-5	TRBJ2-5
TGTGCCAGCAGTTACCCCGGACTAGCGGGCCCCAACACCGGGGAGCTGTTTTTT	CASSYPGLAGPNTGELFF	TRBV6-5	TRBJ2-2
TGTGCCAGCAGCGCCCCAAAACTCGGGGATGTCCCCACTTTGCCCGGGCGGGGCTATGGCTACACCTTC	CASSAPKLGDVPTLPGRGYGYTF	TRBV9	TRBJ1-2
TGTGCCAGCAGTGAAGCCACAGGCACTGAAGCTTTCTTT	CASSEATGTEAFF	TRBV6-1	TRBJ1-1
TGTGCCAGCAGGATTAAACCGGGACAGAGGTACGAGCAGTACTTC	CASRIKPGQRYEQYF	TRBV11-1	TRBJ2-7
TGTGCCAGCAGCTTTCCCCACACGACAGGGAGCAACAATCAGCCCCAGCATTTT	CASSFPHTTGSNNQPQHF	TRBV5-6	TRBJ1-5
TGTGCCAGCTCACCATTAGGACAGGGGGCTCAGAGTAACTATGGCTACACCTTC	CASSPLGQGAQSNYGYTF	TRBV18	TRBJ1-2
TGTGCCAGCAGCCGAACAGGGTGGTCTGGAAACACCATATATTTT	CASSRTGWSGNTIYF	TRBV14	TRBJ1-3
TGTGCCAGCAGCCCCGGGGCTTATTTTGGGTCCTACGAGCAGTACTTC	CASSPGAYFGSYEQYF	TRBV7-3	TRBJ2-7
TGTGCCAGCAGTTGCGGTGGATTCCTAGCAATTGATACGCAGTATTTT	CASSCGGFLAIDTQYF	TRBV12-3	TRBJ2-3
TGTGCCAGCGGGGAGGGTTTTGACACCGGGGAGCTGTTTTTT	CASGEGFDTGELFF	TRBV6-4	TRBJ2-2
TGTGCCAGCAGTTGTTCTCGACAGGGGCAAGAGACCCAGTACTTC	CASSCSRQGQETQYF	TRBV27	TRBJ2-5
TGTGCCAGCACAGAACCCACGGGACTAGCGGTTTACAATGAGCAGTTCTTC	CASTEPTGLAVYNEQFF	TRBV7-9	TRBJ2-1
TGTGCCTGGAGTTGTGTAGTGGTGGTGGACAATGAGCAGTTCTTC	CAWSCVVVVDNEQFF	TRBV30	TRBJ2-1
TGTGCCAGCAGTGGGCCCGGGACAGGGGATTTCTCCTACGAGCAGTACTTC	CASSGPGTGDFSYEQYF	TRBV12-3	TRBJ2-7
TGTGCCAGCAGAGCGGGAGAGCAGTACTTC	CASRAGEQYF	TRBV27	TRBJ2-7
TGTGCCAGCAAGAGGGACGAGCAGTACTTC	CASKRDEQYF	TRBV12-3	TRBJ2-7
TGTGCCAGCAGCCCTAGCGGGGGCGAGCAGTACTTC	CASSPSGGEQYF	TRBV7-9	TRBJ2-7
TGTGCCAGCAGTTGGCTTGGATACCAAGAGACCCAGTACTTC	CASSWLGYQETQYF	TRBV12-3	TRBJ2-5
TGTGCCGTTTTAACAAGGTCCTACGAGCAGTACTTC	CAVLTRSYEQYF	TRBV7-8	TRBJ2-7
TGCGCCAGCAGGGGGGGGCCCTCCTACGAGCAGTACTTC	CASRGGPSYEQYF	TRBV10-1	TRBJ2-7
TGTGCCAGCAATCCGGGACAGGGGTCGGGGGGCTATGGCTACACCTTC	CASNPGQGSGGYGYTF	TRBV25-1	TRBJ1-2
TGTGCCAGCAGCTTGCCGGAGTTTTGGACCTACGAGCAGTACTTC	CASSLPEFWTYEQYF	TRBV5-6	TRBJ2-7
TGCGCCATCCCGGGATCCGGACGAGATGGCTACACCTTC	CAIPGSGRDGYTF	TRBV5-1	TRBJ1-2
TGTGCCACTCCCGACAGCGTGAACTATGGCTACACCTTC	CATPDSVNYGYTF	TRBV24-1	TRBJ1-2
TGTGCCAGCATTAGTACCCTAGGGGAAGAAGCTTTCTTT	CASISTLGEEAFF	TRBV27	TRBJ1-1
TGTGCCAGCACCGCTAAGGGGACCGGGGAGCTGTTTTTT	CASTAKGTGELFF	TRBV7-3	TRBJ2-2
TGTGCCAGCTTCCGGGGGGGGGCGAGCCGGGAGACCCAGTACTTC	CASFRGGASRETQYF	TRBV6-5	TRBJ2-5
TGTGCCAGCAGTTACTTCCTGTCGACAGGGGCACCCTGGACCTCCTACGAGCAGTACTTC	CASSYFLSTGAPWTSYEQYF	TRBV6-5	TRBJ2-7
TGTGCCAGCAGCCCCGCCACTGAAGCTTTCTTT	CASSPATEAFF	TRBV3-1	TRBJ1-1
TGTGCCAGCAGCTTATTCTCTGGGACAGGGGGGATTAGCAATCAGCCCCAGCATTTT	CASSLFSGTGGISNQPQHF	TRBV7-9	TRBJ1-5
TGTGCCAGTAGTGACCAAGGAGAAGGTTTTTTCTCCTACAATGAGCAGTTCTTC	CASSDQGEGFFSYNEQFF	TRBV19	TRBJ2-1
TGTGCCACCACTCGGGGGTTCTGCACAGATACGCAGTATTTT	CATTRGFCTDTQYF	TRBV24-1	TRBJ2-3
TGTGCCAGCAGCCGAGTTATTGGGGGGGAAGAATCCAAAAACATTCAGTACTTC	CASSRVIGGEESKNIQYF	TRBV7-3	TRBJ2-4
TGTGCCAGCAGTTACGCCCGTTCGAGGGTTTACTCCTACAATGAGCAGTTCTTC	CASSYARSRVYSYNEQFF	TRBV6-5	TRBJ2-1
TGTGCCAGCAGTACAATATCAACAGGGCATTACAATTCCCATAGCACAGATACGCAGTATTTT	CASSTISTGHYNSHSTDTQYF	TRBV27	TRBJ2-3
TGTGCCAGCAGCGGTCCTGGGACTAATCGGTCAGATACGCAGTATTTT	CASSGPGTNRSDTQYF	TRBV5-4	TRBJ2-3
TGTGCCAGTATGCAGGGCCGGCTTAGCTCCTATAATTCACCCCTCCACTTT	CASMQGRLSSYNSPLHF	TRBV19	TRBJ1-6
TGTGCCAGCGGACAGGGTAGTCAGCCCCAGCATTTT	CASGQGSQPQHF	TRBV6-5	TRBJ1-5
TGTGCCAGCAGCTTAGTCCCGGGACAGGGGGCGCGGAATTCACCCCTCCACTTT	CASSLVPGQGARNSPLHF	TRBV7-6	TRBJ1-6
TGTGCCAGCAGGTCGTACAATGAGCAGTTCTTC	CASRSYNEQFF	TRBV6-2	TRBJ2-1
TGTGCCAGCAGTAGCTCTCGGCACGGGACAGACGACTATGGCTACACCTTC	CASSSSRHGTDDYGYTF	TRBV27	TRBJ1-2
TGTGCCAGCAGCCTCCGGGACAGAGATGGCTACACCTTC	CASSLRDRDGYTF	TRBV5-6	TRBJ1-2
TGTGCCAGCAGTTCCGCTACAACTAATGAAAAACTGTTTTTT	CASSSATTNEKLFF	TRBV27	TRBJ1-4
TGTGCCACCACGGAGGGGGGCTTTCCGAACACTGAAGCTTTCTTT	CATTEGGFPNTEAFF	TRBV24-1	TRBJ1-1
TGTGCCACCAGCAGAGATCCCCCGAGGGGATTCGGTGGCTACACCTTC	CATSRDPPRGFGGYTF	TRBV15	TRBJ1-2
TGTGCCAGCAGTGCCGGACAGGTCTACAATGAGCAGTTCTTC	CASSAGQVYNEQFF	TRBV27	TRBJ2-1
TGTGCCACCAGTGATTTGACCCCCGGGGGGCCGGGGGTCGAGCAGTACTTC	CATSDLTPGGPGVEQYF	TRBV24-1	TRBJ2-7
TGTGCCAGCAGCTTAGCACTGAAGGGGGCCGGCGGTGCGGGACCCTACGAGCAGTACTTC	CASSLALKGAGGAGPYEQYF	TRBV7-4	TRBJ2-7
TGTGCCAACTACAATGAGCAGTTCTTC	CANYNEQFF	TRBV19	TRBJ2-1
TGTGCCAGCAGTTACTCTCACTCGGGGGGGCCTCCGGGCTTGTACGAGCAGTACTTC	CASSYSHSGGPPGLYEQYF	TRBV6-5	TRBJ2-7
TGCAGTGCGACCGGACTAGCGGATGAGCAGTTCTTC	CSATGLADEQFF	TRBV20-1	TRBJ2-1
TGCGCCAGCACCCGAAAGACTGAAGCTTTCTTT	CASTRKTEAFF	TRBV10-1	TRBJ1-1
TGTGCCAGCAGCGTTTTGGTAGTCCTGGACAGGCGTTCACCCCTCCACTTT	CASSVLVVLDRRSPLHF	TRBV13	TRBJ1-6
TGTGCCAGCAGTGAGTGGGGTGCCTACGAGCAGTACTTC	CASSEWGAYEQYF	TRBV12-4	TRBJ2-7
TGTGCCACCAGCAGAGATGTCCGGGGTAGCAATCAGCCCCAGCATTTT	CATSRDVRGSNQPQHF	TRBV15	TRBJ1-5
TGTGCCAGCTCCGACCAAGAGACCCAGTACTTC	CASSDQETQYF	TRBV18	TRBJ2-5
TGTGCCAGTTCCACAGGGGCAGAGTATAGCAATCAGCCCCAGCATTTT	CASSTGAEYSNQPQHF	TRBV2	TRBJ1-5
TGTGCCAGTAGTATAGTCAAATCGAGGCTTCCAGATACGCAGTATTTT	CASSIVKSRLPDTQYF	TRBV19	TRBJ2-3
TGTGCCAGTAGTTACCGTATCAGGAAACAAGCCTACGAGCAGTACTTC	CASSYRIRKQAYEQYF	TRBV19	TRBJ2-7
TGTGCCTGGAGTGTAAAGCAAGACTTAAGGGGACAGGAAATCAACATTCAGTACTTC	CAWSVKQDLRGQEINIQYF	TRBV30	TRBJ2-4
TGTGCCACCAGTGATTTGCGGATAGCGGGTAACTGTAGCTCCTACGAGCAGTACTTC	CATSDLRIAGNCSSYEQYF	TRBV24-1	TRBJ2-7
TGTGCCAGCAGGCTGAGGCAGCCCCAGCATTTT	CASRLRQPQHF	TRBV6-6	TRBJ1-5
TGTGCCATCAGTGAGCTCGGACGAAGATATTACGAAGGCTACGAGCAGTACTTC	CAISELGRRYYEGYEQYF	TRBV10-3	TRBJ2-7
TGTGCCAGCAGCGGGTACACGAGGGTACGCGAGCAGTACTTC	CASSGYTRVREQYF	TRBV7-3	TRBJ2-7
TGTGCCAGCTCACTCTCCCGGGACCAGCAGTACTTC	CASSLSRDQQYF	TRBV18	TRBJ2-7
TGTGCCAGCAGGGGGCACACTGAAGCTTTCTTT	CASRGHTEAFF	TRBV11-3	TRBJ1-1
TGCCGGGACAGGGGGAGCAATCAGCCCCAGCATTTT	CRDRGSNQPQHF	TRBV20-1	TRBJ1-5
TGTGCCAGCAGCTTAACTACCGGACAGGGTGTATATTATAACACTGAAGCTTTCTTT	CASSLTTGQGVYYNTEAFF	TRBV7-2	TRBJ1-1
TGTGCCAGCAGCTTAGCATCCTTTCTCCGAGGGGGCACCGGGGAGCTGTTTTTT	CASSLASFLRGGTGELFF	TRBV7-2	TRBJ2-2
TGTGCCAGCAGCTTGACGAATAGCGGCGGGGCCAAAAACATTCAGTACTTC	CASSLTNSGGAKNIQYF	TRBV5-4	TRBJ2-4
TGTGCCAGTAGTATAGTCAGGCAAGGCTACGAAAAAGCCTGGTACGAGCAGTACTTC	CASSIVRQGYEKAWYEQYF	TRBV19	TRBJ2-7
TGCGCCAGCAGAACGGAATCCTATGGCTACACCTTC	CASRTESYGYTF	TRBV10-1	TRBJ1-2
TGTGCCAGCCTCTCAGGGGACGGTCGTACCACTTTAGCAACTAATGAAAAACTGTTTTTT	CASLSGDGRTTLATNEKLFF	TRBV2	TRBJ1-4
TGTGCCAGCAGCTTGGTAAGACTAGCGGGCTTTGCCTACGAGCAGTACTTC	CASSLVRLAGFAYEQYF	TRBV5-6	TRBJ2-7
TGTGCCAGCAGTTACTCTAGCGGGGGGGATTCGGGGGAGCTGTTTTTT	CASSYSSGGDSGELFF	TRBV6-2	TRBJ2-2
TGCGCCAGCAGCATTATCGACAATCAGCCCCAGCATTTT	CASSIIDNQPQHF	TRBV5-1	TRBJ1-5
TGTGCCAGCAGCCGGGGGACAGTTGAGACCCAGTACTTC	CASSRGTVETQYF	TRBV7-8	TRBJ2-5
TGTGCCAGCAGCTTGGAGGGGGGGCCGGGTAGGGGAACTAATGAAAAACTGTTTTTT	CASSLEGGPGRGTNEKLFF	TRBV5-4	TRBJ1-4
TGTGCCAGCAGTGACACGGGACAGGGGGCTACCTACGAGCAGTACTTC	CASSDTGQGATYEQYF	TRBV25-1	TRBJ2-7
TGTGCCAGCAGTCCCCACCCCGGGGCTAGGTCCTACGAGCAGTACTTC	CASSPHPGARSYEQYF	TRBV27	TRBJ2-7
TGTGCCAGCAGTTACAGTGTGACGTGCAGGCCGGTACACTATGGCTACACCTTC	CASSYSVTCRPVHYGYTF	TRBV6-2	TRBJ1-2
TGTGCCAGCCATCCTACAGGGGGTGTTCCCCAAGAGACCCAGTACTTC	CASHPTGGVPQETQYF	TRBV5-8	TRBJ2-5
TGTGCCAGCAGCTCAAGGGCAAATTCACCCCTCCACTTT	CASSSRANSPLHF	TRBV14	TRBJ1-6
TGTGCCAGCAGCACCAACACAGAGAACCGGTACACTGAAGCTTTCTTT	CASSTNTENRYTEAFF	TRBV7-4	TRBJ1-1
TGTGCCCCCGGACATTCACCCCTCCACTTT	CAPGHSPLHF	TRBV2	TRBJ1-6
TGTGCCACCAGTGATCTTTTAGGCAACGCTTTCTTT	CATSDLLGNAFF	TRBV24-1	TRBJ1-1
TGCGCCAGCAGCAACAGTAATGAAAAACTGTTTTTT	CASSNSNEKLFF	TRBV5-1	TRBJ1-4
TGTGCCAGCGTGAGTAGGAACTATGGCTACACCTTC	CASVSRNYGYTF	TRBV28	TRBJ1-2
TGCGCCAGCAGGCGGGAGCCTGGAAACACCATATATTTT	CASRREPGNTIYF	TRBV10-1	TRBJ1-3
TGTGCCAGCAGCTGGAGGGACAGACACACTGAAGCTTTCTTT	CASSWRDRHTEAFF	TRBV11-1	TRBJ1-1
TGTGCCAGCAGCCTGATCGTCATGGGCTACACCTTC	CASSLIVMGYTF	TRBV3-1	TRBJ1-2
TGTGCCAGCAGCCACGTCGCCGGACAGGGTGGCAATGAGCAGTTCTTC	CASSHVAGQGGNEQFF	TRBV7-3	TRBJ2-1
TGTGCCAGCAGCACAGGGGAGAGGGACAGTCGGTTCTTGACTGAAGCTTTCTTT	CASSTGERDSRFLTEAFF	TRBV9	TRBJ1-1
TGTGCCAGCAGCGCTACGGGTAAGAATGAGCAGTTCTTC	CASSATGKNEQFF	TRBV7-3	TRBJ2-1
TGTGCCAGCAGTGACCGGGACAGCTATGAGCAGTTCTTC	CASSDRDSYEQFF	TRBV6-4	TRBJ2-1
TGCAGTGCTGAGGGACTAGCGGGGAGCTCCTACGAGCAGTACTTC	CSAEGLAGSSYEQYF	TRBV20-1	TRBJ2-7
TGCGCCAGCAGTGAGAATGCCCATAACAGGTTATTGGGGTTCACCTTC	CASSENAHNRLLGFTF	TRBV10-2	TRBJ1-2
TGTGCCAGCATACCGGAGGTGGACTGCTATAGCTCCTACGAGCAGTACTTC	CASIPEVDCYSSYEQYF	TRBV11-3	TRBJ2-7
TGTGCCAGCAGCGCTGGATCGCGAGTAGGTCCCTACGAGCAGTACTTC	CASSAGSRVGPYEQYF	TRBV11-3	TRBJ2-7
TGTGCCAGCAGTGAAATAGGGGGCAAGGGCTCCTACGAGCAGTACTTC	CASSEIGGKGSYEQYF	TRBV6-4	TRBJ2-7
TGTGCCTGGAAGCAGGGGCCTGAGCAGTTCTTC	CAWKQGPEQFF	TRBV30	TRBJ2-1
TGCAGTGCTGTGAGGACAGGGAGCCCCTACGAGCAGTACTTC	CSAVRTGSPYEQYF	TRBV20-1	TRBJ2-7
TGCAGCGTTGCACTAGCGGGAGGGCATAATTCACCCCTCCACTTT	CSVALAGGHNSPLHF	TRBV29-1	TRBJ1-6
TGCGCCAGCAGCTTTCCGGGGGGCCGGTATCAGCCCCAGCATTTT	CASSFPGGRYQPQHF	TRBV5-1	TRBJ1-5
TGCAGCGGATATCACAGGGGCTTAAACACTGAAGCTTTCTTT	CSGYHRGLNTEAFF	TRBV29-1	TRBJ1-1
TGCGCCAGCAGGGTAAGAACCGGTGAGGCCTACAATGAGCAGTTCTTC	CASRVRTGEAYNEQFF	TRBV4-1	TRBJ2-1
TGCGCCAGCAGCTTGGCCTCCGGGACAGACAGTTATTATGGCTACACCTTC	CASSLASGTDSYYGYTF	TRBV5-1	TRBJ1-2
TGTGCCAGCAGCCAGAAGCCCGGGATGGGGGATACGCAGTATTTT	CASSQKPGMGDTQYF	TRBV3-1	TRBJ2-3
TGTGCCAGCAGTTTATGCCCCGGGACAGGCCCCCGCGAGCAGTACTTC	CASSLCPGTGPREQYF	TRBV28	TRBJ2-7
TGTGCCAGCAGCTTCGCAGGGGGAAACCCCAATTCACCCCTCCACTTT	CASSFAGGNPNSPLHF	TRBV7-3	TRBJ1-6
TGTGCCAGCAGTTACTCGTTACGCGTAGGGGCGAACACCTTC	CASSYSLRVGANTF	TRBV6-3	TRBJ1-2
TGTGCCAGCAGTTTTGGGCCACGCACAGATACGCAGTATTTT	CASSFGPRTDTQYF	TRBV27	TRBJ2-3
TGCGCCAGCAGCCAAGATAAGGCCCAAGACGAAGATCCTGGCTACACCTTC	CASSQDKAQDEDPGYTF	TRBV4-3	TRBJ1-2
TGTGCCAGCAGTTATCACCGCGGCCTCACAGATACGCAGTATTTT	CASSYHRGLTDTQYF	TRBV28	TRBJ2-3
TGTGCCAGCAGCGTAACTAGCGGGGCCAATGAGCAGTTCTTC	CASSVTSGANEQFF	TRBV7-3	TRBJ2-1
TGCGCCAGCAGCCGGCCAGGGTCTTTCCAGCCCCAGCATTTT	CASSRPGSFQPQHF	TRBV5-1	TRBJ1-5
TGTGCTAGCAGCGGACATAATAGGCATGAGCAGTTCTTC	CASSGHNRHEQFF	TRBV7-7	TRBJ2-1
TGTGCCAGCAGACCCAGGGGGAACTATGGCTACACCTTC	CASRPRGNYGYTF	TRBV7-3	TRBJ1-2
TGTGCCAGCAGAGCAATTATAACTGAAGCTTTCTTT	CASRAIITEAFF	TRBV5-5	TRBJ1-1
TGTGCCAGCAGCCGAGGGGATGGTCAGTACTTC	CASSRGDGQYF	TRBV7-4	TRBJ2-4
TGTGCCAGCTCTCCAGGAACCAAAAGGGGGCGGGCACACACTGAAGCTTTCTTT	CASSPGTKRGRAHTEAFF	TRBV6-8	TRBJ1-1
TGCGGGAGTGGACGGGAGGGAGTGCACGAGACCCAGTACTTC	CGSGREGVHETQYF	TRBV20-1	TRBJ2-5
TGCGCCAGCAGCTCCAGGGTGGAAGTTAACTATGGCTACACCTTC	CASSSRVEVNYGYTF	TRBV5-1	TRBJ1-2
TGTGCCAGCAGTGAGGAAGGGCACTATAGCAATCAGCCCCAGCATTTT	CASSEEGHYSNQPQHF	TRBV6-4	TRBJ1-5
TGTGCCAGCAGTTTTAGGGACCCCTACGAGCAGTACTTC	CASSFRDPYEQYF	TRBV27	TRBJ2-7
TGTGCCAGCAGGGGTCCCCTGCTCACGGGACAGGGGAGGGGAAGAGATACGCAGTATTTT	CASRGPLLTGQGRGRDTQYF	TRBV6-1	TRBJ2-3
TGTGCCAGCAGCCAAGGGCCTAGGACTGTAGACAATGAGCAGTTCTTC	CASSQGPRTVDNEQFF	TRBV4-2	TRBJ2-1
TGTGCTAATGGGAGTTCCGGGACGTCACCCCTCCACTTT	CANGSSGTSPLHF	TRBV12-5	TRBJ1-6
TGTGCCAGCAAGAGTAGGACGGCCAAAAACATTCAGTACTTC	CASKSRTAKNIQYF	TRBV5-6	TRBJ2-4
TGTGCCAGCAGGCGGGGAAGACGAACTGAAGCTTTCTTT	CASRRGRRTEAFF	TRBV27	TRBJ1-1
TGTGCCAGCAGCGTAGTCCTTTCGGTCTCCTACGAGCAGTACTTC	CASSVVLSVSYEQYF	TRBV9	TRBJ2-7
TGTGCCAGCAGCTATCTTTTACCGGGACAGCGCACTGAAGCTTTCTTT	CASSYLLPGQRTEAFF	TRBV7-3	TRBJ1-1
TGTGCCAGCTCCGCGACTAGCGGGAGGGCTGGTAAGGAGACCCAGTACTTC	CASSATSGRAGKETQYF	TRBV7-9	TRBJ2-5
TGCAGTGCTAGCCCAGACAGTCACTCCTACAATGAGCAGTTCTTC	CSASPDSHSYNEQFF	TRBV20-1	TRBJ2-1
TGTGCCAGCAGCCAAGACCCCTTCTTCTCAGGCTCTGGGGCCAACGTCCTGACTTTC	CASSQDPFFSGSGANVLTF	TRBV3-1	TRBJ2-6
TGTGCCAGCAGTTTATCGCGAACAGATACGCAGTATTTT	CASSLSRTDTQYF	TRBV27	TRBJ2-3
TGTGCCACCAGTGGGCCGGGGACTAGCGGGCAGAAGAGCAATGAGCAGTTCTTC	CATSGPGTSGQKSNEQFF	TRBV24-1	TRBJ2-1
TGTGCCAGCAGTTTCTCGTATAGGACCCGGAGGAAAAACATTCAGTACTTC	CASSFSYRTRRKNIQYF	TRBV28	TRBJ2-4
TGCGCCAGCAGCATCCTTTTCAGGGTTTATACTAATAACACTGAAGCTTTCTTT	CASSILFRVYTNNTEAFF	TRBV5-1	TRBJ1-1
TGTGCCAGCAGTGACGCTACGGGACAAACGTACAATGAGCAGTTCTTC	CASSDATGQTYNEQFF	TRBV6-4	TRBJ2-1
TGTGCCTGGAGTGTACGTACCCGGACAGGGGGCTATGGCTACACCTTC	CAWSVRTRTGGYGYTF	TRBV30	TRBJ1-2
TGTGCCAGCTCACCGCCCTTCTCCCCGGGATCGCACGAGCAGTACTTC	CASSPPFSPGSHEQYF	TRBV18	TRBJ2-7
TGCAGTGCTAGATGGTTCCCGGGACATGAGCAGTTCTTC	CSARWFPGHEQFF	TRBV20-1	TRBJ2-1
TGTGCCAGCAGTTTGACTAGACTGAACACCGGGGAGCTGTTTTTT	CASSLTRLNTGELFF	TRBV27	TRBJ2-2
TGTGCCAGCAGCACAGACGACGGACAGAAGGATGAAAAACTGTTTTTT	CASSTDDGQKDEKLFF	TRBV7-2	TRBJ1-4
TGCACCACCCTAAGATCAGACAGAAAACTGTTTTTT	CTTLRSDRKLFF	TRBV29-1	TRBJ1-4
TGCAGCGTTGAAGATCTTTTTCGAGGGGGCAGCTCCTATAATTCACCCCTCCACTTT	CSVEDLFRGGSSYNSPLHF	TRBV29-1	TRBJ1-6
TGTGCCACTTTTGGTTCCCGAACCAATCAGCCCCAGCATTTT	CATFGSRTNQPQHF	TRBV12-4	TRBJ1-5
TGTGCCAGCTCCTGTCCGGCGACAGGGGAGCAGTACTTC	CASSCPATGEQYF	TRBV13	TRBJ2-7
TGCGGTTCCGCCCATCTCCGGGGACAGGGCGACCAAGAGACCCAGTACTTC	CGSAHLRGQGDQETQYF	TRBV5-1	TRBJ2-5
TGTGCCAGCAGCTTATTTTGCTGGAACACTGAAGCTTTCTTT	CASSLFCWNTEAFF	TRBV7-2	TRBJ1-1
TGTGCCAGGTGGGCCCTACCGCCGCAGTTCTTC	CARWALPPQFF	TRBV6-2	TRBJ2-1
TGTGCCACCAGTGCCAGGGCTCACACTGAAGCTTTCTTT	CATSARAHTEAFF	TRBV24-1	TRBJ1-1
TGTGCCAGCAGCTTAGGCAATTCTAAAGAGACCCAGTACTTC	CASSLGNSKETQYF	TRBV7-6	TRBJ2-5
TGCGCCAGCAGCCAATTCGGGGTCATCTACGAGCAGTACTTC	CASSQFGVIYEQYF	TRBV4-1	TRBJ2-7
TGTGCCAGCAGCCCGTTCGACAGGGCCTACGAGCAGTACTTC	CASSPFDRAYEQYF	TRBV9	TRBJ2-7
TGTGCCAGCAGCGGGCGTCTGCAGTACTTC	CASSGRLQYF	TRBV27	TRBJ2-7
TGCAGTGCTAGAGATACGTTGTTTAGCTGGGACAGTAAGCACTCTGGAAACACCATATATTTT	CSARDTLFSWDSKHSGNTIYF	TRBV20-1	TRBJ1-3
TGTGCCAGCAGAATGGGGGTAGAAAGCACAGATACGCAGTATTTT	CASRMGVESTDTQYF	TRBV5-6	TRBJ2-3
TGTGCCAGCAGCTGGGGGAGATGCGAGCAGTTCTTC	CASSWGRCEQFF	TRBV5-6	TRBJ2-1
TGTGCCACCAGTGAATTACGCAGGGTGAAAGCTTTCTTT	CATSELRRVKAFF	TRBV24-1	TRBJ1-1
TGTGCTAGTGGCTCCCGGGACAGAGAAATGAACACTGAAGCTTTCTTT	CASGSRDREMNTEAFF	TRBV12-5	TRBJ1-1
TGTGCCAGCAGTTACTCTTGGCTGAACGAGCAGTACTTC	CASSYSWLNEQYF	TRBV6-2	TRBJ2-7
TGTGCCACGGTGGGACAGGGTAGCACAGATACGCAGTATTTT	CATVGQGSTDTQYF	TRBV6-4	TRBJ2-3
TGTGCCAGCAGCTTAGAAAAGACTAGCGGGAGCGCCTTGAATTCACCCCTCCACTTT	CASSLEKTSGSALNSPLHF	TRBV11-3	TRBJ1-6
TGTGCCAGCAGCCCGGACCAGGACTCTAGCTCCTACAATGAGCAGTTCTTC	CASSPDQDSSSYNEQFF	TRBV2	TRBJ2-1
TGCCTGGGGATTGCGGGGGACAATCAGCCCCAGCATTTT	CLGIAGDNQPQHF	TRBV20-1	TRBJ1-5
TGTGCCAGCAGCTTGGACGACGAGTCTGAGACCCAGTACTTC	CASSLDDESETQYF	TRBV5-6	TRBJ2-5
TGCGCCAGCAGCCCCCCCACTCGACGGACAACCTGCTACAATGAGCAGTTCTTC	CASSPPTRRTTCYNEQFF	TRBV4-1	TRBJ2-1
TGTGCCACCAGCAGCACAGGGCTGCCCACTGAAGCTTTCTTT	CATSSTGLPTEAFF	TRBV15	TRBJ1-1
TGTGCCAGCAGTGACTGGGAGTGGGTGGATAGCAATCAGCCCCAGCATTTT	CASSDWEWVDSNQPQHF	TRBV6-4	TRBJ1-5
TGTGCCAGCAGTTACTCTCCCGGGGGGCGGGAGAGGGGGCAGTACTTC	CASSYSPGGRERGQYF	TRBV6-5	TRBJ2-7
TGTGCCATCAGACCTACGACCACTGGCTACACCTTC	CAIRPTTTGYTF	TRBV10-3	TRBJ1-2
TGCGCCAGCAGTGTGAGAAAGCCGGGGGACGCAGATACGCAGTATTTT	CASSVRKPGDADTQYF	TRBV10-1	TRBJ2-3
TGCGCCAGCAGTGAGTTCGGTCCGGGGGGCTTCTACGAGCAGTACTTC	CASSEFGPGGFYEQYF	TRBV10-1	TRBJ2-7
TGTGCCAGCAGAGAAGGGGGGCTCAATGAGCAGTTCTTC	CASREGGLNEQFF	TRBV11-3	TRBJ2-1
TGTGCCAGCACGTTAACGAAGGCCCCAGATGAGCAGTTCTTC	CASTLTKAPDEQFF	TRBV6-2	TRBJ2-1
TGTGCCAGCAGTGAATGCCAACGCTACTATACAGATACGCAGTATTTT	CASSECQRYYTDTQYF	TRBV25-1	TRBJ2-3
TGCAGTGCTCCTACGATGGATAGCGGGTGTGGCAATGAGCAGTTCTTC	CSAPTMDSGCGNEQFF	TRBV20-1	TRBJ2-1
TGTGCCAGCAGAGGGTCTTGCGGGAGTAAGTACAGAAACACCATATATTTT	CASRGSCGSKYRNTIYF	TRBV13	TRBJ1-3
TGTGCCAGCAGTTTCCCAGGGTCAGAGGCCTATGGCTACACCTTC	CASSFPGSEAYGYTF	TRBV27	TRBJ1-2
TGCAGCGTTGAAAGGTCCGGAGGGGGACTAGTTGATGAGCAGTTCTTC	CSVERSGGGLVDEQFF	TRBV29-1	TRBJ2-1
TGTGCCAGCAGTTGGGGGCCGGCCTACGAGCAGTACTTC	CASSWGPAYEQYF	TRBV7-9	TRBJ2-7
TGTGCCAGCAGTCTGGGGACAGCGCCCTACGAGCAGTACTTC	CASSLGTAPYEQYF	TRBV27	TRBJ2-7
TGCGCCAGCGTGGACAGAGGCTACACCTTC	CASVDRGYTF	TRBV5-1	TRBJ1-2
TGTGCCAGCGGCCCCCCCAAGAAGAAGGGGAACACTGAAGCTTTCTTT	CASGPPKKKGNTEAFF	TRBV6-2	TRBJ1-1
TGCAGTGCGCTTATGGACCTACAAGAGACCCAGTACTTC	CSALMDLQETQYF	TRBV20-1	TRBJ2-5
TGTGCCAGCAGCGGCGTACAGACAGTTGATACGCAGTATTTT	CASSGVQTVDTQYF	TRBV7-3	TRBJ2-3
TGTGCCAGCACCCCCGGCACCGGGACTAGCGGGAGAGGCGGTCCCCAGCATTTT	CASTPGTGTSGRGGPQHF	TRBV27	TRBJ1-5
TGTGCCAGCAGCTCAACCAGACCGGACAGGGGGCAATTTTATGGCTACACCTTC	CASSSTRPDRGQFYGYTF	TRBV11-3	TRBJ1-2
TGTGCCAAAATGACAGACCGTTTGGATAGCTACGAGCAGTACTTC	CAKMTDRLDSYEQYF	TRBV6-2	TRBJ2-7
TGCGCCAGCAGTGGACGTAAACTCTGTCCCTTCAATGAGCAGTTCTTC	CASSGRKLCPFNEQFF	TRBV10-1	TRBJ2-1
TGCGCCAGCAGTGGTATCCTTCTGGGGGAAGACAGCTCCTACGAGCAGTACTTC	CASSGILLGEDSSYEQYF	TRBV10-1	TRBJ2-7
TGTGCCAGCAGCTTGTGCGGTAGGAGATATCAGCCCCAGCATTTT	CASSLCGRRYQPQHF	TRBV7-2	TRBJ1-5
TGTGCCAGCAGCTTAGTTAAGGACAGGGCGGGGAACACTGAAGCTTTCTTT	CASSLVKDRAGNTEAFF	TRBV7-9	TRBJ1-1
TGTGCCAGCAGCGGCCAACCCATCCGGAGGGCGGCAGCTTTCTTT	CASSGQPIRRAAAFF	TRBV13	TRBJ1-1
TGTGCCACCAGTGAGAAGCGTCCGGGACAGTGGACCTATAATTCACCCCTCCACTTT	CATSEKRPGQWTYNSPLHF	TRBV24-1	TRBJ1-6
TGTGCCAGTAGTAGGGGGAACGGGCCCGAAAAACTGTTTTTT	CASSRGNGPEKLFF	TRBV19	TRBJ1-4
TGTGCCAGCAGCGTGCGTCTAGCGGGAGAGGACAATGAGCAGTTCTTC	CASSVRLAGEDNEQFF	TRBV9	TRBJ2-1
TGTGCCAGCAGCTTCCGGGACAAAAAAGATTGGAGGACTAATGAAAAACTGTTTTTT	CASSFRDKKDWRTNEKLFF	TRBV7-2	TRBJ1-4
TGTGCCAGCAGTCTCCCGACAGGGGGCCGTAGCAATCAGCCCCAGCATTTT	CASSLPTGGRSNQPQHF	TRBV27	TRBJ1-5
TGTGCCAGCAGCAGGCGGTTACGAGGCTCTGGAAACACCATATATTTT	CASSRRLRGSGNTIYF	TRBV14	TRBJ1-3
TGTGCCAGCAACCTAGACGAGCAGTACTTC	CASNLDEQYF	TRBV9	TRBJ2-7
TGCACTACTCATCAGCCCCAGCATTTT	CTTHQPQHF	TRBV29-1	TRBJ1-5
TGCAGTGCTAGAGATCTCAGGGTAAGCGGCTACACCTTC	CSARDLRVSGYTF	TRBV20-1	TRBJ1-2
TGTGCCAGCAGCTTCAACGACATCCACACAGATACGCAGTATTTT	CASSFNDIHTDTQYF	TRBV5-5	TRBJ2-3
TGTGCCAGCAGCCGGGGACAACGCACAGATACGCAGTATTTT	CASSRGQRTDTQYF	TRBV27	TRBJ2-3
TGCGCCAGCAGTGAGTCCCGGTTCATACTCTCTGGAAACACCATATATTTT	CASSESRFILSGNTIYF	TRBV10-1	TRBJ1-3
TGCAGCGTTGATCTAGCCCCGAGCTCCTACAATGAGCAGTTCTTC	CSVDLAPSSYNEQFF	TRBV29-1	TRBJ2-1
TGTGCCACCAGGAATGCGGGAGTAAAATCACGAACTGAAGCTTTCTTT	CATRNAGVKSRTEAFF	TRBV24-1	TRBJ1-1
TGTGCCAGCTCCTTATTACTCCAGACTGAAGCTTTCTTT	CASSLLLQTEAFF	TRBV27	TRBJ1-1
TGCGCCAGCAGCCGAAAGGGAGACGGACCCGAGCAGTACTTC	CASSRKGDGPEQYF	TRBV5-1	TRBJ2-7
TGTGCCAGCAGCTTAGTAGCGGGAGCTCCCTTGTACGAGCAGTACTTC	CASSLVAGAPLYEQYF	TRBV7-9	TRBJ2-7
TGTGCCAGCACGATCGGGAACTGTGAGCAGTTCTTC	CASTIGNCEQFF	TRBV14	TRBJ2-1
TGTGCCAGCCGGACGTCTACTGAAGCTTTCTTT	CASRTSTEAFF	TRBV6-5	TRBJ1-1
TGTGCCAGCAGCCATCATACTAGCGGGTCATGCAATGAGCAGTTCTTC	CASSHHTSGSCNEQFF	TRBV6-6	TRBJ2-1
TGTGCCAGCAGCCACGGTTCTGGGGGCCCGGGGACTGAAGCTTTCTTT	CASSHGSGGPGTEAFF	TRBV14	TRBJ1-1
TGTGCCAGTACCTCACTGGCCCATTCACCCCTCCACTTT	CASTSLAHSPLHF	TRBV19	TRBJ1-6
TGTGCCAGTAGTATGATCAAACTAGCGGGAGATTCACCCCTCCACTTT	CASSMIKLAGDSPLHF	TRBV19	TRBJ1-6
TGTGCCAGCAGTTTAGGCCGACAGGGAACGAACACCGGGGAGCTGTTTTTT	CASSLGRQGTNTGELFF	TRBV12-4	TRBJ2-2
TGTGCCAGCAGCTTAAACAGGGGCACTGAAGCTTTCTTT	CASSLNRGTEAFF	TRBV7-4	TRBJ1-1
TGTGCCAGCACAAGTGTGACAGACGAGCCGGGTGAAGGGCGGGACTATAATTCACCCCTCCACTTT	CASTSVTDEPGEGRDYNSPLHF	TRBV12-4	TRBJ1-6
TGTGCCAGCCTGCCACCGAGAACCTACGAGCAGTACTTC	CASLPPRTYEQYF	TRBV2	TRBJ2-7
TGTACTCACAGGGGACCCTGGAATGGCTACACCTTC	CTHRGPWNGYTF	TRBV30	TRBJ1-2
TGTGCCAGCAGTTTATGCTTCGACAGGGGTGGCAATGAGCAGTTCTTC	CASSLCFDRGGNEQFF	TRBV27	TRBJ2-1
TGTGCCAGCAGCCTTGGCCTCCCTAATTCCTGGGACAGGGAGAAGAGCTACGAGCAGTACTTC	CASSLGLPNSWDREKSYEQYF	TRBV3-1	TRBJ2-7
TGTGCCACAGCACCGGGACAGGCCTATGGCTACACCTTC	CATAPGQAYGYTF	TRBV6-4	TRBJ1-2
TGTGCCAGCAGCGGGCTACGGGACAGGGCATATCGAGCCAAGGGGCGGAACGGGGAGCTGTTTTTT	CASSGLRDRAYRAKGRNGELFF	TRBV5-5	TRBJ2-2
TGTGCCAGCAGCAGATTGCCTAGGGCGGGGGTCTTCTTC	CASSRLPRAGVFF	TRBV11-2	TRBJ2-1
TGTGCCAGCAGTGACCGGACAAGGGTCAAAAACATTCAGTACTTC	CASSDRTRVKNIQYF	TRBV6-4	TRBJ2-4
TGTGCCAGCAGTCCCCGAGCAGGGAAGGTAGAGGCCTACGAGCAGTACTTC	CASSPRAGKVEAYEQYF	TRBV28	TRBJ2-7
TGCAGTGCTAGAGCGGGGACTAGCGGGACCCCGGTCACAGATACGCAGTATTTT	CSARAGTSGTPVTDTQYF	TRBV20-1	TRBJ2-3
TGCGCCAGCAGCTTCCGACAGGTCTACGAGCAGTACTTC	CASSFRQVYEQYF	TRBV5-1	TRBJ2-7
TGTGCCAGCGAAGGGGGACTAGCGGGGGGTATCTCCTACGAGCAGTACTTC	CASEGGLAGGISYEQYF	TRBV4-2	TRBJ2-7
TGTGCCTGGAGTCCAGGACAGGGTCAGACGGGGCCTAAGGAGTACTTC	CAWSPGQGQTGPKEYF	TRBV30	TRBJ2-5
TGTGCCAGCAGTTTGAAGGGGGGGGAGGAGCAGTACTTC	CASSLKGGEEQYF	TRBV12-4	TRBJ2-7
TGCGCCAGCAGCTTGCAAAAGGACGTTGGTGCGAGGGGAGCCAAAAACATTCAGTACTTC	CASSLQKDVGARGAKNIQYF	TRBV5-1	TRBJ2-4
TGTGCCAACAGAATCCTACGGTATGAAAAACTGTTTTTT	CANRILRYEKLFF	TRBV6-1	TRBJ1-4
TGTGCCAGCAGCTGCGTACAGTGCCGGGACAGGGCGGCGAGGATCTACGAGCAGTACTTC	CASSCVQCRDRAARIYEQYF	TRBV11-1	TRBJ2-7
TGTGCCAGTAGTATAGCAACCGATAGGAAAGAACTGTTTTTT	CASSIATDRKELFF	TRBV19	TRBJ1-4
TGCGCCAGCAGCTCTGTGGGGGGGCCGAACACTGAAGCTTTCTTT	CASSSVGGPNTEAFF	TRBV4-3	TRBJ1-1
TGTGCCAGCAGTTACTCGAGGGGGGGACCTCACACTGAAGCTTTCTTT	CASSYSRGGPHTEAFF	TRBV6-5	TRBJ1-1
TGTGCCAGCAGCCCGGGACAGAGACTCTCCTATAATTCACCCCTCCACTTT	CASSPGQRLSYNSPLHF	TRBV13	TRBJ1-6
TGTGCCAGTAAGGAATTCCCCTTGGGACTAGGTCAAGAGACCCAGTACTTC	CASKEFPLGLGQETQYF	TRBV19	TRBJ2-5
TGTGCCAGTAGTCGAAATCGCTCGCCGAAGTACACCGGGGAGCTGTTTTTT	CASSRNRSPKYTGELFF	TRBV19	TRBJ2-2
TGTGCCAGCAGCCAAGAGGGGCACCAGCATTTT	CASSQEGHQHF	TRBV3-1	TRBJ1-5
TGTGCCAGCAGCCCCGGAGGGCATCAGCCCCAGCATTTT	CASSPGGHQPQHF	TRBV13	TRBJ1-5
TGTGCCAGCAGCTCGAGATGGAGTCCAAAAAACTATGGCTACACCTTC	CASSSRWSPKNYGYTF	TRBV5-6	TRBJ1-2
TGTGCCAGCAGTGACCTTCCAGGGGGTATTTCACCCCTCCACTTT	CASSDLPGGISPLHF	TRBV6-4	TRBJ1-6
TGTGCCAGCAGTTACTCCCATAGCGGGTGGTCCTACAATGAGCAGTTCTTC	CASSYSHSGWSYNEQFF	TRBV6-5	TRBJ2-1
TGTGCCAGCAGTTTAGGCTATCCCGGCCGACAGGGGAGAGCTTTCTTT	CASSLGYPGRQGRAFF	TRBV12-4	TRBJ1-1
TGTGCCAGCAGCTTTCAGTTGACCTACGAGCAGTACTTC	CASSFQLTYEQYF	TRBV7-3	TRBJ2-7
TGTGCCAGCAGCCAAGAGCGGAGGCGCACTGAAGCTTTCTTT	CASSQERRRTEAFF	TRBV14	TRBJ1-1
TGCAGTGCTACCAGCAGGCTAGCAAGGGGCTCCTACAATGAGCAGTTCTTC	CSATSRLARGSYNEQFF	TRBV20-1	TRBJ2-1
TGTGCCAGCAGCCAAGTACCAAAACACATGGGGGGCCTATCCTACGAGCAGTACTTC	CASSQVPKHMGGLSYEQYF	TRBV3-1	TRBJ2-7
TGTGCCGGGGGGTCCTACGAGCAGTACTTC	CAGGSYEQYF	TRBV6-4	TRBJ2-7
TGTGCCATGGCTGTTCAGGGAACGTACAATGAGCAGTTCTTC	CAMAVQGTYNEQFF	TRBV10-3	TRBJ2-1
TGCGCCAGCAGCCTCCTAGCGGTCCACAATGAGCAGTTCTTC	CASSLLAVHNEQFF	TRBV5-1	TRBJ2-1
TGTGGCTACCCAGGGCTCTCCGTCTACGAGCAGTACTTC	CGYPGLSVYEQYF	TRBV28	TRBJ2-7
TGTGCCAGCAGTTACCCACAGTATATGGCTAATGAAAAACTGTTTTTT	CASSYPQYMANEKLFF	TRBV6-5	TRBJ1-4
TGCGGTAACGGGGGGTCAGATACGCAGTATTTT	CGNGGSDTQYF	TRBV5-1	TRBJ2-3
TGTGCCAGCAGCGGACAGGGAGAGACCCAGTACTTC	CASSGQGETQYF	TRBV6-5	TRBJ2-5
TGTGCCAGCAGTTACGAAGTTGGACGGGATCAGCCCCAGCATTTT	CASSYEVGRDQPQHF	TRBV6-5	TRBJ1-5
TGTGCCAGCAGCTTAGCGCGCGGGGGCGCCGGGGGGGACACAGATACGCAGTATTTT	CASSLARGGAGGDTDTQYF	TRBV11-3	TRBJ2-3
TGTGCCAGCAGTTACTCGTGTCAGGGACGGTGCGCCTGCGAGCAGTACTTC	CASSYSCQGRCACEQYF	TRBV6-3	TRBJ2-7
TGTGCTAGCAGCTTAATTCCGGACGCAGGCAATGAGCAGTTCTTC	CASSLIPDAGNEQFF	TRBV7-7	TRBJ2-1
TGTGCCACACCCCAGTTCTCCTACGAGCAGTACTTC	CATPQFSYEQYF	TRBV24-1	TRBJ2-7
TGTGCCAGCAGCGGGGTACCGGTAGATAGCTCCTACGAGCAGTACTTC	CASSGVPVDSSYEQYF	TRBV3-1	TRBJ2-7
TGTGCCACCAGTGATAAGGGAATATCGGCACCCTACGAGCAGTACTTC	CATSDKGISAPYEQYF	TRBV24-1	TRBJ2-7
TGTGCCAGCAGCCATACGGGGTGGCCTATAGCCTGCACAGATACGCAGTATTTT	CASSHTGWPIACTDTQYF	TRBV14	TRBJ2-3
TGTGCCAGCAGCTTTTATTCACCGTCGGAGGCCGACGAGCAGTACTTC	CASSFYSPSEADEQYF	TRBV5-4	TRBJ2-7
TGCAGTGCCCCCCTAGTAGACCGGGACAGGGAACATGAAGCTTTCTTT	CSAPLVDRDREHEAFF	TRBV20-1	TRBJ1-1
TGCGCCAGCAGCATACAGGGGGCTAGAATGGCCAACTATGGCTACACCTTC	CASSIQGARMANYGYTF	TRBV4-1	TRBJ1-2
TGTGCCAGCAGCTTGAACAACAGCTTAGCAAGCAGCTCCTACGAGCAGTACTTC	CASSLNNSLASSSYEQYF	TRBV5-5	TRBJ2-7
TGTGCCAGCAGTCTCCCGGAAGGGGGGGCCCACTCCTACGAGCAGTACTTC	CASSLPEGGAHSYEQYF	TRBV6-5	TRBJ2-7
TGTGCCAGCAAGACTAGCGGGGACGACTTC	CASKTSGDDF	TRBV28	TRBJ2-7
TGTGCCAGCAGTAGTCACAGGGACTACAATGAGCAGTTCTTC	CASSSHRDYNEQFF	TRBV28	TRBJ2-1
TGTGCCAGCAGCTGCGAAGGGGGCCTAGAGGGCACCGGGGAGCTGTTTTTT	CASSCEGGLEGTGELFF	TRBV13	TRBJ2-2
TGTCACCCCGGGACTAGCGGGAGAGGAAATTCACCCCTCCACTTT	CHPGTSGRGNSPLHF	TRBV19	TRBJ1-6
TGCGCCAGCAGCAAGGACAGGGGGTCAGATACGCAGTATTTT	CASSKDRGSDTQYF	TRBV5-1	TRBJ2-3
TGTGCCAGCAGTGAATCAATACGTCATCCTGTCTACGAGCAGTACTTC	CASSESIRHPVYEQYF	TRBV25-1	TRBJ2-7
TGCGCCAGCATAGGCGGGGGAAAATACGAGCAGTACTTC	CASIGGGKYEQYF	TRBV10-1	TRBJ2-7
TGTGCCCTCGGGACAGGGGCCAAACATAGCAATCAGCCCCAGCATTTT	CALGTGAKHSNQPQHF	TRBV6-1	TRBJ1-5
TGTGCCAGCAGCCAAACACACAGGGGGCGAGGACCGGGCTACACCTTC	CASSQTHRGRGPGYTF	TRBV14	TRBJ1-2
TGCGCCACCCATCGACAGTGTAATGAAAAACTGTTTTTT	CATHRQCNEKLFF	TRBV10-1	TRBJ1-4
TGTGCCAGCAGCCGGCCCAATCCCCTGGGGACTAGCGGTTGGTACGAGCAGTACTTC	CASSRPNPLGTSGWYEQYF	TRBV7-3	TRBJ2-7
TGTGCCAGCAGTTTATTTAATTCTGACAGGCGCTATGGCTACACCTTC	CASSLFNSDRRYGYTF	TRBV27	TRBJ1-2
TGCAGCGTTCCAGGGCACAAATCGAACACCGGGGAGCTGTTTTTT	CSVPGHKSNTGELFF	TRBV29-1	TRBJ2-2
TGTGCCAGCAGAAGCAGGACGGATCAGCCCCAGCATTTT	CASRSRTDQPQHF	TRBV11-3	TRBJ1-5
TGCGCCAGCAGCTTCTGCAAGACAGGTAATGAAAAACTGTTTTTT	CASSFCKTGNEKLFF	TRBV5-1	TRBJ1-4
TGTGCCAGCAGCTTGTGGGACAGGGCGGTACTCTGTGAAGCTTTCTTT	CASSLWDRAVLCEAFF	TRBV7-8	TRBJ1-1
TGTGCCAGCAGTTACTTCAAATGGGACAGGGTCTGCACGCAAGAGACCCAGTACTTC	CASSYFKWDRVCTQETQYF	TRBV6-9	TRBJ2-5
TGTGCCAGCAGCCAAGACACAGGAGGGAATCAGCCCCAGCATTTT	CASSQDTGGNQPQHF	TRBV3-1	TRBJ1-5
TGTGCCAGCAGTCCCGGGGACTCTGGAAACACCATATATTTT	CASSPGDSGNTIYF	TRBV12-3	TRBJ1-3
TGTGCCAGTAGTATTGGGCGGGGGGCTCCCGCTAGCACAGATACGCAGTATTTT	CASSIGRGAPASTDTQYF	TRBV19	TRBJ2-3
TGTGCCACCAGTGACAGGGACTCTGGAAACACCATATATTTT	CATSDRDSGNTIYF	TRBV24-1	TRBJ1-3
TGTGCCAGCAGCTTAATCCAAAAACATAGCAATCAGCCCCAGCATTTT	CASSLIQKHSNQPQHF	TRBV7-3	TRBJ1-5
TGTGCCAGCACGACTAGCGGGAGGGCCCGAGGGGGCACCGGGGAGCTGTTTTTT	CASTTSGRARGGTGELFF	TRBV9	TRBJ2-2
TGTGCCAGCAGCCAAGGCGGCCTTTGCAATCAGCCCCAGCATTTT	CASSQGGLCNQPQHF	TRBV7-3	TRBJ1-5
TGTGCTAGTGGTACACAGACAGATACGCAGTATTTT	CASGTQTDTQYF	TRBV12-5	TRBJ2-3
TGCGTGACAGCCGTTATTGAGGCAGCCACTGGTGAAGCTTTCTTT	CVTAVIEAATGEAFF	TRBV10-1	TRBJ1-1
TGTGCCAGCAGGGAACGAAGGGCTAACTATGGCTACACCTTC	CASRERRANYGYTF	TRBV5-6	TRBJ1-2
TGTGCCAGCAGTGAAAAGGGGGCGCACTATGGCTACACCTTC	CASSEKGAHYGYTF	TRBV6-4	TRBJ1-2
TGTGCCACCAGTGATTTGCAAATTAGGGCTGGGTGGGACACTGAAGCTTTCTTT	CATSDLQIRAGWDTEAFF	TRBV24-1	TRBJ1-1
TGCGCCATTCGAACAATTAGGGGGCGTGAAAAACTGTTTTTT	CAIRTIRGREKLFF	TRBV10-2	TRBJ1-4
TGTGCCAGCAGCTTAGCGTCCCTAGCGGGACGGGCGAACACCGGGGAGCTGTTTTTT	CASSLASLAGRANTGELFF	TRBV11-3	TRBJ2-2
TGTGCCAGCAGCGACCTCTTAACTACTGAAGCTTTCTTT	CASSDLLTTEAFF	TRBV14	TRBJ1-1
TGTGCCAAAACGCCGACCCCCAGGGGCCGCTACGAGCAGTACTTC	CAKTPTPRGRYEQYF	TRBV7-9	TRBJ2-7
TGCAGTGCTAGAGAAATCAGCGGGGGGGCCACAGATACGCAGTATTTT	CSAREISGGATDTQYF	TRBV20-1	TRBJ2-3
TGTGCCAGCAGTGAAGCGGTGGGGGGGCCCGAAGGGCAGTACTTC	CASSEAVGGPEGQYF	TRBV2	TRBJ2-7
TGTGCCACCAGTGATTTGCAGGGAACCCGGGGCAGAGGTAATTCACCCCTCCACTTT	CATSDLQGTRGRGNSPLHF	TRBV24-1	TRBJ1-6
TGTGCCAGCAGCTTGGTACCTACCGGCACTGAAGCTTTCTTT	CASSLVPTGTEAFF	TRBV5-4	TRBJ1-1
TGTGCCAGCAGCTTGGCAGTCTTGGTATACACCGGGGAGCTGTTTTTT	CASSLAVLVYTGELFF	TRBV5-6	TRBJ2-2
TGTGCCAGCAGCTTAAACCCCTCTAGACTTTTAGAGACCCAGTACTTC	CASSLNPSRLLETQYF	TRBV7-3	TRBJ2-5
TGTGCCAGCAGTGACTCGTCAAATAGGCCACTCACAGACGGGGAGCTGTTTTTT	CASSDSSNRPLTDGELFF	TRBV6-4	TRBJ2-2
TGTGCCAGCAGCCCCCAACCGCCAGGCACAGATACGCAGTATTTT	CASSPQPPGTDTQYF	TRBV6-4	TRBJ2-3
TGTGCCAGCAGCCAAGCCAGTATAGACATTATGGAGACCCAGTACTTC	CASSQASIDIMETQYF	TRBV4-2	TRBJ2-5
TGTGCCAGCAGCTTGGCTCGGGACCAGGGGGGCCTATACTACGAGCAGTACTTC	CASSLARDQGGLYYEQYF	TRBV5-4	TRBJ2-7
TGTGCCAGCCCCGTCGGGAATCTACTGAATGAGCAGTTCTTC	CASPVGNLLNEQFF	TRBV7-6	TRBJ2-1
TGCGCCAGCAGCCAAGGGCGGGGGGGCCACTTC	CASSQGRGGHF	TRBV4-1	TRBJ2-7
TGTGCCAGCAGTTACCATGGACGAATCACTGAAGCTTTCTTT	CASSYHGRITEAFF	TRBV6-5	TRBJ1-1
TGCGCCAGCAGCCCCGTAGCGGGCCAAAGATATGCCTACGAGCAGTACTTC	CASSPVAGQRYAYEQYF	TRBV5-1	TRBJ2-7
TGTGCCAGCAGGAGGCCCGGGGGGCGCTACGAGCAGTACTTC	CASRRPGGRYEQYF	TRBV6-4	TRBJ2-7
TGTGCCAGCAGTGACTCGATAGGGACCCCAGGGGGGTACTTC	CASSDSIGTPGGYF	TRBV6-4	TRBJ2-5
TGTGCCAGCAGCGCCACATGGTTTGGCGATACGCAGTATTTT	CASSATWFGDTQYF	TRBV9	TRBJ2-3
TGTGCCAGCAGCGAGGAACACGCAAAGAACACTGAAGCTTTCTTT	CASSEEHAKNTEAFF	TRBV13	TRBJ1-1
TGTGCCTGGAGTGTACCACGAACCGTCGACACAGGGAGCTACGGGAACGAGCAGTACTTC	CAWSVPRTVDTGSYGNEQYF	TRBV30	TRBJ2-7
TGTGCCAGCAGCACCAGGGACCAGCCCCAGCATTTT	CASSTRDQPQHF	TRBV7-9	TRBJ1-5
TGTGCCAGCAGCCTTAGGACTAGCGGGTCGGGCTCCTACGAGCAGTACTTC	CASSLRTSGSGSYEQYF	TRBV7-3	TRBJ2-7
TGTGCCAGCAGTTACCCGGCCCGGAGTTTTAGGTCCTACGAGCAGTACTTC	CASSYPARSFRSYEQYF	TRBV6-6	TRBJ2-7
TGTGCCAGTAGTATACTCTCGAATGAAAAACTGTTTTTT	CASSILSNEKLFF	TRBV19	TRBJ1-4
TGTGCCAGCAGCCGGAACGACTCTTGGTCGGGACTGAACACTGAAGCTTTCTTT	CASSRNDSWSGLNTEAFF	TRBV27	TRBJ1-1
TGTGCCTGGAGTATGGGGGGGCGGGCCTACGAGCAGTACTTC	CAWSMGGRAYEQYF	TRBV30	TRBJ2-7
TGTGCCAGCAGTTACCCCTCAAGGACAGGGGGCGGATGGGCTAACTATGGCTACACCTTC	CASSYPSRTGGGWANYGYTF	TRBV6-5	TRBJ1-2
TGTGCCTGGAGACAGGGGGCCGCCAATCAGCCCCAGCATTTT	CAWRQGAANQPQHF	TRBV30	TRBJ1-5
TGTGCCACCAGCAGAGGGTGTCGGCCTTGGGGAGACACAAACGAGCAGTACTTC	CATSRGCRPWGDTNEQYF	TRBV15	TRBJ2-7
TGTGCCAGCAGCTTCCCCCAAGGCCAAGAGACCACTGAAGCTTTCTTT	CASSFPQGQETTEAFF	TRBV5-4	TRBJ1-1
TGTGCCCCATCCCACAGGCTTTCACCAGGGGGCGGGTGCAATCAGCCCCAGCATTTT	CAPSHRLSPGGGCNQPQHF	TRBV28	TRBJ1-5
TGTGCCAGCAGTGAGCCTAGACAGGGGAGGGCCAAAAACATTCAGTACTTC	CASSEPRQGRAKNIQYF	TRBV6-3	TRBJ2-4
TGTGCCAGCAGCTTAGGGGGGGACCTTGAGCAGTTCTTC	CASSLGGDLEQFF	TRBV11-3	TRBJ2-1
TGTGCCAGCAGCTCGCCTAGCGGTGGTCCTGAGCAGTTCTTC	CASSSPSGGPEQFF	TRBV7-9	TRBJ2-1
TGTGCCAGCAGTGAGATGGGGAGTTCCTACGAGCAGTACTTC	CASSEMGSSYEQYF	TRBV2	TRBJ2-7
TGTGCCAGCACTAGCGGCCCCGGGGAGCTGTTTTTT	CASTSGPGELFF	TRBV7-6	TRBJ2-2
TGCGCCAGCAGTGAGCGGCGGGAGGCCACAGATACGCAGTATTTT	CASSERREATDTQYF	TRBV10-2	TRBJ2-3
TGCGCCACCCTCGGGGCTTTCTCCTACGAGCAGTACTTC	CATLGAFSYEQYF	TRBV4-3	TRBJ2-7
TGCGCCAGCAGCCAAGAGGGGACAGACTCTCACACCGGGGAGCTGTTTTTT	CASSQEGTDSHTGELFF	TRBV4-1	TRBJ2-2
TGTGCCAGCAGTTCCGAGGGGACTAGCGGGAGGGCCGGAACGACCGGGGAGCTGTTTTTT	CASSSEGTSGRAGTTGELFF	TRBV28	TRBJ2-2
TGTGCCAGCAGCTTAGTATCATACAGAGGGCCCAACTATGGCTACACCTTC	CASSLVSYRGPNYGYTF	TRBV7-9	TRBJ1-2
TGTGCCAGCAGCTCCTGTAGCGATACGCAGTATTTT	CASSSCSDTQYF	TRBV7-8	TRBJ2-3
TGTGCCAGCAGTGATACTTACCAGATACGCCCCTACAATGAGCAGTTCTTC	CASSDTYQIRPYNEQFF	TRBV12-4	TRBJ2-1
TGTGCCAGCAGTGTAAACAGGGGCTATGGCTACACCTTC	CASSVNRGYGYTF	TRBV27	TRBJ1-2
TGTGCCAGCAGCCAAGGACAGGGGGAAAAACTGTTTTTT	CASSQGQGEKLFF	TRBV3-1	TRBJ1-4
TGTGCCAGCAGCTTGTTTCCCTGCGGGAGGTGGCGCTCCTACGAGCAGTACTTC	CASSLFPCGRWRSYEQYF	TRBV5-6	TRBJ2-7
TGTGCCAGCAGCTTGTCCGGGACAGGGGCGGGACACTCTGGGGCCAACGTCCTGACTTTC	CASSLSGTGAGHSGANVLTF	TRBV5-5	TRBJ2-6
TGTGCCAGCAGCTTAGCGGGTAGGAACACTGAAGCTTTCTTT	CASSLAGRNTEAFF	TRBV7-2	TRBJ1-1
TGTGCCAGCAGCGGGTCCTGTAGTGCCAAAAACATTCAGTACTTC	CASSGSCSAKNIQYF	TRBV9	TRBJ2-4
TGTGCCAGCAATCGAGCGGGAGGGCCCTATAGAGACTTTGAGCAGTTCTTC	CASNRAGGPYRDFEQFF	TRBV6-1	TRBJ2-1
TGTGCCAGCAGTTACTCACACCAGGGGGCTGGGGGTGAAGCTTTCTTT	CASSYSHQGAGGEAFF	TRBV6-6	TRBJ1-1
TGCGCCAGCAGCTTGGGACCGGGACCGAATCAGCCCCAGCATTTT	CASSLGPGPNQPQHF	TRBV5-1	TRBJ1-5
TGCGCCAGCAGCCAAGACCGGTGTCGGTCCCGGGGAGCGAGTGCTAATCAGCCCCAGCATTTT	CASSQDRCRSRGASANQPQHF	TRBV4-1	TRBJ1-5
TGTGCCAGCAGCCGGAGGGCCCACTTCCGCCGAGGGAGGCGCTCCTACAATGAGCAGTTCTTC	CASSRRAHFRRGRRSYNEQFF	TRBV14	TRBJ2-1
TGTGCCAGCAGTCTAGCGGGAAGAAACAATGAGCAGTTCTTC	CASSLAGRNNEQFF	TRBV6-2	TRBJ2-1
TGCAGCGCAAGTTCAGTGGTACCGTCGAACACTGAAGCTTTCTTT	CSASSVVPSNTEAFF	TRBV29-1	TRBJ1-1
TGTGCCAGCAGTCTGAAAGGGGCCTCAGTTGAGGCCTCCTACGAGCAGTACTTC	CASSLKGASVEASYEQYF	TRBV6-1	TRBJ2-7
TGTGCCAGCAGCTTAACCCTTACGCAGTATTTT	CASSLTLTQYF	TRBV7-9	TRBJ2-3
TGTGCCAGCAGCATAAAGACAGGGGAGCCCCAGCATTTT	CASSIKTGEPQHF	TRBV5-4	TRBJ1-5
TGTGCCACCAGGCGGCCTAGCATTGGGGCAGATACGCAGTATTTT	CATRRPSIGADTQYF	TRBV24-1	TRBJ2-3
TGTGCCAGCAGGGCGACGTCCGAGCAGTACTTC	CASRATSEQYF	TRBV7-3	TRBJ2-7
TGTGCCAGCAGCCTCACAGAGCTATATGGCTACACCTTC	CASSLTELYGYTF	TRBV5-6	TRBJ1-2
TGTGCCAGCAGCCAAGATTTGCGGGACAGTGGAGCGAGTAGCAATCAGCCCCAGCATTTT	CASSQDLRDSGASSNQPQHF	TRBV3-1	TRBJ1-5
TGTGCCAGCTTCGGGGCAGGTCAATATGGCTACACCTTC	CASFGAGQYGYTF	TRBV27	TRBJ1-2
TGCGCCAGCAGTGAGTCCCCGACAGGGAAAAACATTCAGTACTTC	CASSESPTGKNIQYF	TRBV10-1	TRBJ2-4
TGCAGTGCTAGGCCGGGACAGGGCTACCCCGAGCAGTACTTC	CSARPGQGYPEQYF	TRBV20-1	TRBJ2-7
TGTGCCAGCAGTACTCAGGGTAACCAAGAGACCCAGTACTTC	CASSTQGNQETQYF	TRBV27	TRBJ2-5
TGCAGCGTTGAAGCGGGGTTAGGCTATGGCTACACCTTC	CSVEAGLGYGYTF	TRBV29-1	TRBJ1-2
TGTGCCAGCAGCTTAGTAACGACAGCGGCACGGGAGCAGTACTTC	CASSLVTTAAREQYF	TRBV11-2	TRBJ2-7
TGTGCCAGCAGCTTATCGGGACCCAAAAACATTCAGTACTTC	CASSLSGPKNIQYF	TRBV11-3	TRBJ2-4
TGTGCCATCAGGGTATTGTCCCGGACTACCTACAATGAGCAGTTCTTC	CAIRVLSRTTYNEQFF	TRBV10-3	TRBJ2-1
TGTGCCAGCAACCGGGCTTCAGCTTATGGCTACACCTTC	CASNRASAYGYTF	TRBV9	TRBJ1-2
TGCAGTGCTCACTTATCGGGGAGTAGATTAAACATTCAGTACTTC	CSAHLSGSRLNIQYF	TRBV20-1	TRBJ2-4
TGTGCCAGCAGCCTCCGGGTGGGGAACACAGATACGCAGTATTTT	CASSLRVGNTDTQYF	TRBV12-4	TRBJ2-3
TGTGCCAGCAGCAACCCGGGACCGAACACCGGGGAGCTGTTTTTT	CASSNPGPNTGELFF	TRBV3-1	TRBJ2-2
TGTGCCAGCAGTTTACCCCTGTTTGACAGGGGATTAGAGACCCAGTACTTC	CASSLPLFDRGLETQYF	TRBV27	TRBJ2-5
TGTGCCAGCTCACTACGGGCTCGCGAGCAGTACTTC	CASSLRAREQYF	TRBV18	TRBJ2-7
TGTGCCAGCAGTTTAGAATTGGGGGGCGGCTACGAGCAGTACTTC	CASSLELGGGYEQYF	TRBV28	TRBJ2-7
TGTGCCAGCAGTGAGGACAGGGGACCGCCCCAGCATTTT	CASSEDRGPPQHF	TRBV6-4	TRBJ1-5
TGCAGTCGGCGGACTAGCGGGGGAGCGGTGACCCAGTACTTC	CSRRTSGGAVTQYF	TRBV20-1	TRBJ2-5
TGTGCCAGCAGATACGAGGGAGGGAAGGGTCCTCAGTATAGCAATCAGCCCCAGCATTTT	CASRYEGGKGPQYSNQPQHF	TRBV13	TRBJ1-5
TGTGCCAGCAGTTACTCCCGGGACTCCAAGCTCGAGACCCAGTACTTC	CASSYSRDSKLETQYF	TRBV6-8	TRBJ2-5
TGTGCTAGCAGCCAACCAGGGACGATAAACTATGGCTACACCTTC	CASSQPGTINYGYTF	TRBV7-7	TRBJ1-2
TGTGCCAGCAGCCAAGCCAGGGCTTTATACTATGGCTACACCTTC	CASSQARALYYGYTF	TRBV14	TRBJ1-2
TGCAGTGCTAGGCCGGGACAGGGCGGAGACGAGCAGTACTTC	CSARPGQGGDEQYF	TRBV20-1	TRBJ2-7
TGCAGTGCTAGAATCCCGGCGGACGGCGGGGAGCTGTTTTTT	CSARIPADGGELFF	TRBV20-1	TRBJ2-2
TGTGCCAGCAGTGCTGGGGCCACAAACAGATATGGCTACACCTTC	CASSAGATNRYGYTF	TRBV6-4	TRBJ1-2
TGTGCCAGCAGCCGAGGACGGGGCGCTCAGAACACTGAAGCTTTCTTT	CASSRGRGAQNTEAFF	TRBV5-5	TRBJ1-1
TGTGCCAGCAGCAGAGGGGCACCGCCCACTGAAGCTTTCTTT	CASSRGAPPTEAFF	TRBV7-2	TRBJ1-1
TGTGCCAGCAGCACGCCGGGGGGCATATCCTACGAGCAGTACTTC	CASSTPGGISYEQYF	TRBV7-3	TRBJ2-7
TGTGCCACCAGTAATGGGACTGATAACACAGATACGCAGTATTTT	CATSNGTDNTDTQYF	TRBV24-1	TRBJ2-3
TGTGCCAGCAGCAGGATGTCTTTCGGAGCGTCCTACGAGCAGTACTTC	CASSRMSFGASYEQYF	TRBV9	TRBJ2-7
TGTGCCAGCAGCCAGCCTGACAGGGAAGTATACAATACTGATCCCACTGAAGCTTTCTTT	CASSQPDREVYNTDPTEAFF	TRBV3-1	TRBJ1-1
TGTGCCACCAAGTGGGGTGGGGGCAACTCCTACAATGAGCAGTTCTTC	CATKWGGGNSYNEQFF	TRBV24-1	TRBJ2-1
TGTGCCAGCAGCTTAGTCGTCAGTACTAACTATGGCTACACCTTC	CASSLVVSTNYGYTF	TRBV7-8	TRBJ1-2
TGTGCCAGCATCGAGAGACCCATGAACACTGAAGCTTTCTTT	CASIERPMNTEAFF	TRBV6-5	TRBJ1-1
TGTGCCAGCAGGACGCAGGCTGGAAACACCATATATTTT	CASRTQAGNTIYF	TRBV6-4	TRBJ1-3
TGTGCCAGCAGTGGGTCCCGAGGGACAGGGATATACGAGCAGTACTTC	CASSGSRGTGIYEQYF	TRBV6-4	TRBJ2-7
TGTGCCAGCAGCTTGTCAGTATCAGATACGCAGTATTTT	CASSLSVSDTQYF	TRBV5-6	TRBJ2-3
TGCGCCAGCAGCTTGGAATTTCCCCGCCGATCGTTTATCACAGATACGCAGTATTTT	CASSLEFPRRSFITDTQYF	TRBV5-1	TRBJ2-3
TGCAGTGCGCGTCGGGACAGTAATGAAAAACTGTTTTTT	CSARRDSNEKLFF	TRBV20-1	TRBJ1-4
TGTGCCAGTAGATTAGGGACTAGCGGGAGTGAGCAGTTCTTC	CASRLGTSGSEQFF	TRBV19	TRBJ2-1
TGCAGTGCTAGTGTGGACTTTATGTCACAGGGTGGAGACTCCGGGGAGCTGTTTTTT	CSASVDFMSQGGDSGELFF	TRBV20-1	TRBJ2-2
TGTGCCACCAGTGCTCAAACCGGGGAGCTGTTTTTT	CATSAQTGELFF	TRBV24-1	TRBJ2-2
TGTGCCAGCAGCTTCGCGCGGTTTAACACAGATACGCAGTATTTT	CASSFARFNTDTQYF	TRBV7-9	TRBJ2-3
TGTGCCAGCAGCTTTGGGGGGGAACAGGGGGGGGATACGCAGTATTTT	CASSFGGEQGGDTQYF	TRBV7-9	TRBJ2-3
TGCGCCAGCAAGGCGCGGGAGAGAAACGAGCAGTACTTC	CASKARERNEQYF	TRBV4-3	TRBJ2-7
TGTGCCATCAGACGTAAAGTAGACAGGGGCTATGGCTACACCTTC	CAIRRKVDRGYGYTF	TRBV10-3	TRBJ1-2
TGCAGCGTTCACCCTCCGGGACTAGCGGGAGCTGGGTTTGGAAACACCATATATTTT	CSVHPPGLAGAGFGNTIYF	TRBV29-1	TRBJ1-3
TGTGCCAGCAGCAAAAGGGGAGAGACCCAGTACTTC	CASSKRGETQYF	TRBV7-3	TRBJ2-5
TGCAGTGCTAGGTTTCCTAATCAGCCCCAGCATTTT	CSARFPNQPQHF	TRBV20-1	TRBJ1-5
TGTGCCACCATTCGACAGGGAGGGGCTTGCGATCAGCCCCAGCATTTT	CATIRQGGACDQPQHF	TRBV24-1	TRBJ1-5
TGTGCCAGCAGTTCAGGGACAGGGAGTCCCACTGAAGCTTTCTTT	CASSSGTGSPTEAFF	TRBV25-1	TRBJ1-1
TGTGCCAGTATGAAGCCAGGCACAGATACGCAGTATTTT	CASMKPGTDTQYF	TRBV19	TRBJ2-3
TGTGCCAGCAAGGTTCAGGGACTGAATGAGCAGTTCTTC	CASKVQGLNEQFF	TRBV6-5	TRBJ2-1
TGTGCCAGCAGCGGGGGCAGAGCTTTCTTT	CASSGGRAFF	TRBV4-2	TRBJ1-1
TGCGCCAGCAGCTTAAGTCTAGACAGGCCAGGGACGGTGAACACTGAAGCTTTCTTT	CASSLSLDRPGTVNTEAFF	TRBV5-1	TRBJ1-1
TGTGCCAGCAGCTTAGTCTACAAAGACAGCATGTACGAGCAGTACTTC	CASSLVYKDSMYEQYF	TRBV7-3	TRBJ2-7
TGTGCCAGCAGCCTCCTGTCCCAGGGGACGAGACCCTACGAGCAGTACTTC	CASSLLSQGTRPYEQYF	TRBV11-2	TRBJ2-7
TGCAGTGCTCCGCGTCGTATACAAGAGACCCAGTACTTC	CSAPRRIQETQYF	TRBV20-1	TRBJ2-5
TGTGCCAGCAGCTTAGTCCGATCGGCGGCGGGGGGGGGCAATGAGCAGTTCTTC	CASSLVRSAAGGGNEQFF	TRBV7-8	TRBJ2-1
TGTGCCAGCAGCTTAGGGGGACAGGGCTACAATGAGCAGTTCTTC	CASSLGGQGYNEQFF	TRBV7-9	TRBJ2-1
TGCGCCAGCAGCTTGTCAGGTACAGGGGCCTTCGGGGTTTTATATCAGCCCCAGCATTTT	CASSLSGTGAFGVLYQPQHF	TRBV5-1	TRBJ1-5
TGCGCCAGCGGGGGACAGGGACAAGCCTATAATTCACCCCTCCACTTT	CASGGQGQAYNSPLHF	TRBV4-1	TRBJ1-6
TGTGCCAGCAGCCCACCAGGGAATGGCTACACCTTC	CASSPPGNGYTF	TRBV13	TRBJ1-2
TGTGCTAGTGGTTTACCTACCCCGTGGCCCCGGGACAGGGTTGGCTACGAGCAGTACTTC	CASGLPTPWPRDRVGYEQYF	TRBV12-5	TRBJ2-7
TGCGCCAGGACCGCCTTGTCCGGGACAGGGCAATACAATGAGCAGTTCTTC	CARTALSGTGQYNEQFF	TRBV10-1	TRBJ2-1
TGTGCCACCAGCGGGTCAGGGGAGTACTACGAGCAGTACTTC	CATSGSGEYYEQYF	TRBV24-1	TRBJ2-7
TGTGCCAGCAGCTTATTTCAGGGGGCCAAAAATCAGCCCCAGCATTTT	CASSLFQGAKNQPQHF	TRBV11-3	TRBJ1-5
TGTGCCAGCAGCTTGGGGGCTAGGGTTGGCTACACCTTC	CASSLGARVGYTF	TRBV7-8	TRBJ1-2
TGTGCCAGCAGCACCCAACGGGATGAAGTTAGCTCCTACAATGAGCAGTTCTTC	CASSTQRDEVSSYNEQFF	TRBV13	TRBJ2-1
TGTGCCAGCAGCCAGGGGCTAGATCAGCCCCAGCATTTT	CASSQGLDQPQHF	TRBV5-6	TRBJ1-5
TGTGCCAGCAGTGATGACAGGGCGTATTCACCCCTCCACTTT	CASSDDRAYSPLHF	TRBV27	TRBJ1-6
TGTGCCAGCAGTGACTGGCGGGGGTGGTTGAACACTGAAGCTTTCTTT	CASSDWRGWLNTEAFF	TRBV6-4	TRBJ1-1
TGCAGTGCTAGGGACCGAAACACTGAAGCTTTCTTT	CSARDRNTEAFF	TRBV20-1	TRBJ1-1
TGTGCCAGCAGTTACCCAACTAGCGGGAGAAGGAACCCCCCCTACAATGAGCAGTTCTTC	CASSYPTSGRRNPPYNEQFF	TRBV6-5	TRBJ2-1
TGTGCCAGCAGCCTAGAAGACGAGCAGTACTTC	CASSLEDEQYF	TRBV7-9	TRBJ2-7
TGTGCCAGCAGCTCCTGGGTGTTCCCCCAGTACTTC	CASSSWVFPQYF	TRBV14	TRBJ2-5
TGTGCCAGCAAGCGCCTGGGGGACAGGGGGAAGGGGGGAAACACCATATATTTT	CASKRLGDRGKGGNTIYF	TRBV6-6	TRBJ1-3
TGTGCCAGCAGCGTGGGACACGAGCAGTACTTC	CASSVGHEQYF	TRBV7-2	TRBJ2-7
TGCGCCAGCAGCCAATCACACTATCGAGGGTGTAGCAATCAGCCCCAGCATTTT	CASSQSHYRGCSNQPQHF	TRBV4-1	TRBJ1-5
TGTGCCAGCAGAGGCCAGTTCGGTTCACCCCTCCACTTT	CASRGQFGSPLHF	TRBV25-1	TRBJ1-6
TGTGCCAGCAGCTCTCCCAGACCGGGACGAAGCTCCTATAATTCACCCCTCCACTTT	CASSSPRPGRSSYNSPLHF	TRBV11-2	TRBJ1-6
TGCGCCAGCAGCCAAGGCGCGACGCTTGAGACCCAGTACTTC	CASSQGATLETQYF	TRBV4-3	TRBJ2-5
TGTGCCAGTAGTATGTTAAGTAGCACTGAAGCTTTCTTT	CASSMLSSTEAFF	TRBV19	TRBJ1-1
TGTGCCAGCAGTGGGACGGATGGCGCCCGGGGCGGGGAGCTGTTTTTT	CASSGTDGARGGELFF	TRBV6-1	TRBJ2-2
TGTGCCAGCAGCGTAGGACAATCCGGGTTAGAGACCCAGTACTTC	CASSVGQSGLETQYF	TRBV9	TRBJ2-5
TGTGCCAGTAGCAGCGGGACAGGGGTGCAGTTCTTC	CASSSGTGVQFF	TRBV19	TRBJ2-1
TGTGCCTTCAGACAGGACCAAGAGACCCAGTACTTC	CAFRQDQETQYF	TRBV30	TRBJ2-5
TGTGCCAGCAGCGAGTTCTACTGGCCCTACAATGAGCAGTTCTTC	CASSEFYWPYNEQFF	TRBV7-2	TRBJ2-1
TGTGCCACCAGTGATTGGCGGGGGACTGAAGCTTTCTTT	CATSDWRGTEAFF	TRBV24-1	TRBJ1-1
TGTGCCCCGAGGTTCAACACCGGGGAGCTGTTTTTT	CAPRFNTGELFF	TRBV6-4	TRBJ2-2
TGTGCCAGCGAAGGGGGCCACCCCCGTGGCTACACCTTC	CASEGGHPRGYTF	TRBV9	TRBJ1-2
TGTGCCAGCAGCCCCCCAAGGGGTGGCTCTGGGGCCAACGTCCTGACTTTC	CASSPPRGGSGANVLTF	TRBV7-4	TRBJ2-6
TGTGCCAGCAGCTGGGTACGGGGTAGCGAAGCTTTCTTT	CASSWVRGSEAFF	TRBV7-9	TRBJ1-1
TGTGCTAGTGGTTTGATGAGTGGACAGGGGTGCTCGGAGGGTTTCGTGGACAAGGTTTCCTACGAGCAGTACTTC	CASGLMSGQGCSEGFVDKVSYEQYF	TRBV12-5	TRBJ2-7
TGTGCCAGCGTCCCTAGAAACGCCTTTCACTCCTACAATGAGCAGTTCTTC	CASVPRNAFHSYNEQFF	TRBV27	TRBJ2-1
TGTGCCAGCGGGAGTAACAGGGTGGATAGGTCTCCCTACGAGCAGTACTTC	CASGSNRVDRSPYEQYF	TRBV6-5	TRBJ2-7
TGCGCCAGCAGCCTCGAAAGGCCGAAGGACAATGAGCAGTTCTTC	CASSLERPKDNEQFF	TRBV4-1	TRBJ2-1
TGTGCCAGCAGTCCCGTTTACGGGACAGGGAGCGTGGGTTCCTATAATTCACCCCTCCACTTT	CASSPVYGTGSVGSYNSPLHF	TRBV28	TRBJ1-6
TGCAGTGCTAGAGGTCCCGGGACAGGGGAAGCTGAAGCTTTCTTT	CSARGPGTGEAEAFF	TRBV20-1	TRBJ1-1
TGTGCCAGCAGCCAAGCGAAGCTTTACAATGAGCAGTTCTTC	CASSQAKLYNEQFF	TRBV5-5	TRBJ2-1
TGTGCCAGCAGCCAAGAAGGGACGGGGGGCACTGAAGCTTTCTTT	CASSQEGTGGTEAFF	TRBV14	TRBJ1-1
TGCAGTGCGAAAGGCAGGAGTTGTTACGAGCAGTACTTC	CSAKGRSCYEQYF	TRBV20-1	TRBJ2-7
TGTGCCAGCAGGGACAGGGGTGAATTAGCCAAAAACATTCAGTACTTC	CASRDRGELAKNIQYF	TRBV6-1	TRBJ2-4
TGTGCCAGCAGTCAGCAGGGGGACAGGGGGTCGAACACTGAAGCTTTCTTT	CASSQQGDRGSNTEAFF	TRBV6-6	TRBJ1-1
TGTGCCATCAGTGAGTTCCGCCCACCTAGCGGGGACCTTCTCGAGACCCAGTACTTC	CAISEFRPPSGDLLETQYF	TRBV10-3	TRBJ2-5
TGCAGTGCTAGACCCATAGAATATGAGCAGTTCTTC	CSARPIEYEQFF	TRBV20-1	TRBJ2-1
TGTGCGATGAGGGCAGAGACCCAGTACTTC	CAMRAETQYF	TRBV24-1	TRBJ2-5
TGTGCCAGCCCAGGAAAGTCAAGGGGTGAGGTGAAGCCCTACGAGCAGTACTTC	CASPGKSRGEVKPYEQYF	TRBV7-9	TRBJ2-7
TGTGCCAGCAGTTATGGAGGCGGGAGAGAATCTGCCCAGGAAAAACTGTTTTTT	CASSYGGGRESAQEKLFF	TRBV6-5	TRBJ1-4
TGTGCCGGGGGGGGGGGGGAAGAGACCCAGTACTTC	CAGGGGEETQYF	TRBV28	TRBJ2-5
TGCGCCAGCAGCGAAGGGGGCTATGGCTACACCTTC	CASSEGGYGYTF	TRBV5-1	TRBJ1-2
TGTGCCAGCAGTAAGCTGAATCAGGGGGAACCGGGTAGCACAGATACGCAGTATTTT	CASSKLNQGEPGSTDTQYF	TRBV6-1	TRBJ2-3
TGTGCCAGCAGCCAAGATGCGACAGGGACAGGGTTGGTCAATTCACCCCTCCACTTT	CASSQDATGTGLVNSPLHF	TRBV4-2	TRBJ1-6
TGTGCCAGCAGCAAGGTCGGGGGAGAAAAACTGTTTTTT	CASSKVGGEKLFF	TRBV9	TRBJ1-4
TGTGCCTGGAGGAGAGTCAGCGGGACCTACGAGCAGTACTTC	CAWRRVSGTYEQYF	TRBV30	TRBJ2-7
TGTGCCAGCAGTTTAGGGAGTAACATCCACCGGAGATCCTACAATGAGCAGTTCTTC	CASSLGSNIHRRSYNEQFF	TRBV27	TRBJ2-1
TGTGCCAGCAGTTTCATCCGGGACAGGGGGCCTCAAGAGACCCAGTACTTC	CASSFIRDRGPQETQYF	TRBV12-3	TRBJ2-5
TGCAGTGCTCCACCGGGCCCGAGGTGCAATCAGCCCCAGCATTTT	CSAPPGPRCNQPQHF	TRBV20-1	TRBJ1-5
TGTGCTAGTGGATGCTCTCTGCGGAGGGGGAAAAGTCAGAGGTACCAAGAGACCCAGTACTTC	CASGCSLRRGKSQRYQETQYF	TRBV12-5	TRBJ2-5
TGTGCCAGTAGCAGGACAGGTAATTCACCCCTCCACTTT	CASSRTGNSPLHF	TRBV19	TRBJ1-6
TGTGCCAGCAAGGCCAGGGGCAGTGGTAGGTATTTT	CASKARGSGRYF	TRBV2	TRBJ2-3
TGTGCCAGCAGTTGTAATGGGACCCCATCGGGGGCGCGGTATATCGAGACCCAGTACTTC	CASSCNGTPSGARYIETQYF	TRBV27	TRBJ2-5
TGTGCCAGCAGCTTAAACCCCGGGACAGGGTACACCGGGGAGCTGTTTTTT	CASSLNPGTGYTGELFF	TRBV7-3	TRBJ2-2
TGTGCCAGCAGCACCATTCTCCCCGGGACAGGGTTTTGGATCTTC	CASSTILPGTGFWIF	TRBV13	TRBJ2-1
TGTGCCATCGCTGGTCCGGGGGGGTTCACAGATACGCAGTATTTT	CAIAGPGGFTDTQYF	TRBV10-3	TRBJ2-3
TGTGCCAGCAGCCTATGGGGTCCTGGTCGCAATCAGCCCCAGCATTTT	CASSLWGPGRNQPQHF	TRBV7-9	TRBJ1-5
TGTGCCAGCGCTAGCGGAAGAATTGAGACCCAGTACTTC	CASASGRIETQYF	TRBV18	TRBJ2-5
TGTGCCAGCAGCCCCTTCCGGGACATGGAGTATGGCTACACCTTC	CASSPFRDMEYGYTF	TRBV14	TRBJ1-2
TGTGCCAGCCCCCCTAGGGGGGAAGCTTTCTTT	CASPPRGEAFF	TRBV6-6	TRBJ1-1
TGTGCCAGCAGTCTTCAGGGAACCAACGTCCTGACTTTC	CASSLQGTNVLTF	TRBV6-5	TRBJ2-6
TGTGCCAGCAGCTGGCCGGACAGGAGGAGAATCTCCTACAATGAGCAGTTCTTC	CASSWPDRRRISYNEQFF	TRBV7-9	TRBJ2-1
TGCAGTGCTAGATCACCCGGGCCCCTAGGGATGAACACTGAAGCTTTCTTT	CSARSPGPLGMNTEAFF	TRBV20-1	TRBJ1-1
TGTGCCAGCAGTTTGCAGATAGGGTGCCGGTACGAGCAGTACTTC	CASSLQIGCRYEQYF	TRBV12-3	TRBJ2-7
TGTGCCAGCAGCGTTGCACTAGCGGGCTGCTACAATGAGCAGTTCTTC	CASSVALAGCYNEQFF	TRBV9	TRBJ2-1
TGTGCTAGTGGTGCAGCGGACAGGTCGTGCACTGAAGCTTTCTTT	CASGAADRSCTEAFF	TRBV12-5	TRBJ1-1
TGTGCCAGCAGCGGCCCAGTTGTGGGACGGAACGAGCAGTACTTC	CASSGPVVGRNEQYF	TRBV9	TRBJ2-7
TGTGCCAGCAGGGGGGAAATCAATGCGGTGGAAGCTTTCTTT	CASRGEINAVEAFF	TRBV6-2	TRBJ1-1
TGTGCCACCAGCATACACCACCAGGAGTGCGGGGACACCGGGGAGCTGTTTTTT	CATSIHHQECGDTGELFF	TRBV15	TRBJ2-2
TGTGCCACGATGGGGAGGACGACCTACGAGCAGTACTTC	CATMGRTTYEQYF	TRBV15	TRBJ2-7
TGCAGTGCTAGAGGACCTGGGGCCTACACTGAAGCTTTCTTT	CSARGPGAYTEAFF	TRBV20-1	TRBJ1-1
TGCGCCAGCAGCCTAACAGGGGGGCGAGCCGGCACTGAAGCTTTCTTT	CASSLTGGRAGTEAFF	TRBV4-1	TRBJ1-1
TGTGCCACCAGCTTCGACAGGGTCAATATAGACCAAGAGACCCAGTACTTC	CATSFDRVNIDQETQYF	TRBV15	TRBJ2-5
TGTGCCAGCAGCCAAGATACGCCTCACTTGGACAGGGGCAATCAGCCCCAGCATTTT	CASSQDTPHLDRGNQPQHF	TRBV3-1	TRBJ1-5
TGTGCCAGCAGGGAGGATACGGGCCAAGGCCGGAGGGACTACGAGCAGTACTTC	CASREDTGQGRRDYEQYF	TRBV27	TRBJ2-7
TGCAGCGTTGACCTGAGGAGGAACGAGCAGTACTTC	CSVDLRRNEQYF	TRBV29-1	TRBJ2-7
TGTGCCAGCGACCCCAGGCGGTCTTTCTTT	CASDPRRSFF	TRBV2	TRBJ1-1
TGTGCCAGCAGCCCCCACTCCGGATCCGGACGGTACTTC	CASSPHSGSGRYF	TRBV3-1	TRBJ2-7
TGTGCCAGCAGCAACGACAGCGGATACAATGAGCAGTTCTTC	CASSNDSGYNEQFF	TRBV11-3	TRBJ2-1
TGTGCCACACCCCGTTACCCCTGGACTAGCGGGACCGGGGAGCTGTTTTTT	CATPRYPWTSGTGELFF	TRBV19	TRBJ2-2
TGTGCCAGTCCCTTGGGGAGGTTCTACGAGCAGTACTTC	CASPLGRFYEQYF	TRBV6-2	TRBJ2-7
TGTGCCAGCAGCAAAGATCGGCCCCGGGACAGTGCCCTCCACTTT	CASSKDRPRDSALHF	TRBV11-3	TRBJ1-6
TGTGCCTGGGAGGGACAGGGCCTCCACTTT	CAWEGQGLHF	TRBV30	TRBJ1-6
TGCAGCGTTGCCTTCAGCGGAAACACCATATATTTT	CSVAFSGNTIYF	TRBV29-1	TRBJ1-3
TGCGCCAGCGAGACTAGCGGAAGCACAGATACGCAGTATTTT	CASETSGSTDTQYF	TRBV5-1	TRBJ2-3
TGTGCCACCCCGGGACTACGTTCTGGGGCCAACGTCCTGACTTTC	CATPGLRSGANVLTF	TRBV27	TRBJ2-6
TGTGCCAGCTGGGGACTAGCCAAAAACATTCAGTACTTC	CASWGLAKNIQYF	TRBV6-1	TRBJ2-4
TGTGCCAGCAGCTTTACTCGCGAACTGAACACTGAAGCTTTCTTT	CASSFTRELNTEAFF	TRBV7-3	TRBJ1-1
TGTGCCAGCAGCCGAGGACAGGACAGAGACTATGGCTACACCTTC	CASSRGQDRDYGYTF	TRBV14	TRBJ1-2
TGTGCCAGCAGTTTTCGGACAGAGACCTATTCACCCCTCCACTTT	CASSFRTETYSPLHF	TRBV28	TRBJ1-6
TGCGCCAGCCACCTGGGACGCCTCTACTATGGCTACACCTTC	CASHLGRLYYGYTF	TRBV5-1	TRBJ1-2
TGTGCCAGCACACGGGAGGAACAGGCCGGGGAGCTGTTTTTT	CASTREEQAGELFF	TRBV6-1	TRBJ2-2
TGTGCCAGCCCCCACCAGCCCCAGCATTTT	CASPHQPQHF	TRBV6-1	TRBJ1-5
TGTGCCAGTAGTACTCACGGGAGGCGTGGGAGTCTGGATAGCAATCAGCCCCAGCATTTT	CASSTHGRRGSLDSNQPQHF	TRBV19	TRBJ1-5
TGTGCCAGCAGTGCCAGAGGCGATGAAAAACTGTTTTTT	CASSARGDEKLFF	TRBV6-4	TRBJ1-4
TGCGCCAGCAGCCAGGACAGGGGCCGGGACAGGGTTGAGACCCAGTACTTC	CASSQDRGRDRVETQYF	TRBV4-1	TRBJ2-5
TGCAGCGTTGGGGGTACCGCGAACACCGGGGAGCTGTTTTTT	CSVGGTANTGELFF	TRBV29-1	TRBJ2-2
TGTGCCACCAGCTGGGCGGGACAGGGGAGAGATCAGCCCCAGCATTTT	CATSWAGQGRDQPQHF	TRBV15	TRBJ1-5
TGTGCTAGCAGCTTCTTATGGGACGGACGTCAAGAGACCCAGTACTTC	CASSFLWDGRQETQYF	TRBV7-7	TRBJ2-5
TGCGCCAGCAGCCAAGTTGTGGTGGGGGATCAGCCCCAGCATTTT	CASSQVVVGDQPQHF	TRBV4-1	TRBJ1-5
TGCGCCAGCAGTGAGCCCGCGGACAGGGCAGGGCCATACGAGCAGTACTTC	CASSEPADRAGPYEQYF	TRBV10-1	TRBJ2-7
TGCGCCAGCAGCTTCTGGCGTCAAACAGGGTTGGACTTCAGGAACGAAAGCAATCAGCCCCAGCATTTT	CASSFWRQTGLDFRNESNQPQHF	TRBV5-1	TRBJ1-5
TGTGCCAGTAACAATCGGCCCCAGCATTTT	CASNNRPQHF	TRBV19	TRBJ1-5
TGTGCCAGCAGCGTAGATCTCACAGGGGCTGTAAGGGTTAACTATGGCTACACCTTC	CASSVDLTGAVRVNYGYTF	TRBV9	TRBJ1-2
TGCAGGATGACTGAGCAGTACTTC	CRMTEQYF	TRBV29-1	TRBJ2-7
TGTGCCAGCAGTTTATCCCGCACCAGGGTCGTAACGGCTTTCTTT	CASSLSRTRVVTAFF	TRBV27	TRBJ1-1
TGCAGCGTGCTTGCGAGGGGACACGATAGTTGTTCGAATTCACCCCTCCACTTT	CSVLARGHDSCSNSPLHF	TRBV29-1	TRBJ1-6
TGTGCCAGCCCAGGGCCCCGGCGCTTC	CASPGPRRF	TRBV7-9	TRBJ2-5
TGTGCCAGCAGCGGCGGCCACACTGAAGCTTTCTTT	CASSGGHTEAFF	TRBV9	TRBJ1-1
TGCAGTGCTAACTCCGCTTTACAGCCCCAGCATTTT	CSANSALQPQHF	TRBV20-1	TRBJ1-5
TGCGCCAGCAGGGGAAACCTAGTCTGGCAGTTCTTC	CASRGNLVWQFF	TRBV10-2	TRBJ2-1
TGTGCCAGCAGCGGGGTCCAGATAAGCGAGCAGTACTTC	CASSGVQISEQYF	TRBV11-2	TRBJ2-7
TGCAGTGCAGGGAACAGGGAGGACACTGAAGCTTTCTTT	CSAGNREDTEAFF	TRBV20-1	TRBJ1-1
TGTGCCAGCAGTGAGCTTTCCGAGTACTTC	CASSELSEYF	TRBV6-1	TRBJ2-4
TGCAGCGTTGAAAAGCTAATCCGTGGGAATGACACTGAAGCTTTCTTT	CSVEKLIRGNDTEAFF	TRBV29-1	TRBJ1-1
TGTGCCAGCAGCTTAGCTGACCCACTAGCGGGAGCTTGCACAGATACGCAGTATTTT	CASSLADPLAGACTDTQYF	TRBV7-9	TRBJ2-3
TGTGCCAGCAGTGCCGACGAGACCTACGAGCAGTACTTC	CASSADETYEQYF	TRBV12-3	TRBJ2-7
TGTGCCAGCAGTTTGACACCGGGATCTGGAAACACCATATATTTT	CASSLTPGSGNTIYF	TRBV28	TRBJ1-3
TGTGCCAGCAGCAGGGCAGTGAAGGACTATCAACACGCCGGGGAGCTGTTTTTT	CASSRAVKDYQHAGELFF	TRBV13	TRBJ2-2
TGTGCCAGCAGCTTAATGGGGGGCGGGGTAGGATACGAGCAGTACTTC	CASSLMGGGVGYEQYF	TRBV5-4	TRBJ2-7
TGTGCCAGCAGCTTACTGTCGGGGGGCAATGACGAGCAGTTCTTC	CASSLLSGGNDEQFF	TRBV7-9	TRBJ2-1
TGTGCCAGCAGCTTGGCCGAATTGAGGGCCCGAATTAACTATGGCTACACCTTC	CASSLAELRARINYGYTF	TRBV5-4	TRBJ1-2
TGTGCCAGTAGTGGCGGCAATCAGCCCCAGCATTTT	CASSGGNQPQHF	TRBV19	TRBJ1-5
TGTGCCAGCAGCTTATTGGGCGGGGCCTGGGACTATGGCTACACCTTC	CASSLLGGAWDYGYTF	TRBV7-2	TRBJ1-2
TGCGCCAGCGCCGGGGCCCAGGGCGATACGCAGTATTTT	CASAGAQGDTQYF	TRBV10-1	TRBJ2-3
TGTGCCAGCGGGACAACAGATGGCTACACCTTC	CASGTTDGYTF	TRBV19	TRBJ1-2
TGTGCCAGCAGCTTACCGTGCGGGGGCCGGTCCAATCAGCCCCAGCATTTT	CASSLPCGGRSNQPQHF	TRBV7-4	TRBJ1-5
TGCGCCAGCAGCCTTAGTGACCCAGAGCCCGGGGAGCTGTTTTTT	CASSLSDPEPGELFF	TRBV4-3	TRBJ2-2
TGTGCCAGCAGTTTATCGTTAATAACTAGCATCCCGGGACAGGGGAATTACAATGAGCAGTTCTTC	CASSLSLITSIPGQGNYNEQFF	TRBV27	TRBJ2-1
TGTGCCAGCAGCGTCCCTAGGGGGATTCCAGATACGCAGTATTTT	CASSVPRGIPDTQYF	TRBV9	TRBJ2-3
TGTGCCAGCAGCTTAGATCCCCCGGGACAGCGAGATCAGCCCCAGCATTTT	CASSLDPPGQRDQPQHF	TRBV11-3	TRBJ1-5
TGCAGTGCCAGTCCCGGGACTAGCTCCACACCCATTCAGTACTTC	CSASPGTSSTPIQYF	TRBV20-1	TRBJ2-4
TGCAGTGCTAGCCGCAGGGTCTCATTCATCAATGAGCAGTTCTTC	CSASRRVSFINEQFF	TRBV20-1	TRBJ2-1
TGTGCCAGCAGCCAATACCCAATGGGGAGGTCCTCTGGGGCCAACGTCCTGACTTTC	CASSQYPMGRSSGANVLTF	TRBV3-1	TRBJ2-6
TGCGCCAGCAGCTTGGAAGGGGACTGGGGGTATTTT	CASSLEGDWGYF	TRBV5-1	TRBJ2-3
TGTGCCTGGAGTCCCCTAGCGGGTTTAGAGACCCAGTACTTC	CAWSPLAGLETQYF	TRBV30	TRBJ2-5
TGCAGTGCTAGAGATCTACAGCGACTCGACTCCTACGAGCAGTACTTC	CSARDLQRLDSYEQYF	TRBV20-1	TRBJ2-7
TGCGCCAGCAGCTTACCCCCAGGGGGGGCCTTAAGAGACGAGCAGTACTTC	CASSLPPGGALRDEQYF	TRBV5-1	TRBJ2-7
TGTGCCAGCAGTTTAACGGCGTTAGATGAGCAGTTCTTC	CASSLTALDEQFF	TRBV27	TRBJ2-1
TGTGCCAGCAGTGGACAGGGGATAGTTCCCTCCTACGAGCAGTACTTC	CASSGQGIVPSYEQYF	TRBV6-5	TRBJ2-7
TGCGCCAGCAGCTTAATTGCCGGGACTGATACCTACGAGCAGTACTTC	CASSLIAGTDTYEQYF	TRBV5-1	TRBJ2-7
TGTGCCAGCAGTGAACTCCCCCAGCCGAACACTGAAGCTTTCTTT	CASSELPQPNTEAFF	TRBV6-1	TRBJ1-1
TGCGCCAGCAGCAGGAGGGGGACCCAGCCCCAGCATTTT	CASSRRGTQPQHF	TRBV5-1	TRBJ1-5
TGTGCCAGCATACGGGGGAAGGGGGCAGCTTTCTTT	CASIRGKGAAFF	TRBV6-3	TRBJ1-1
TGTGCCAGCAGTGATCCCGCCGGGACAGCGATAGCCGCCTACGAGCAGTACTTC	CASSDPAGTAIAAYEQYF	TRBV6-1	TRBJ2-7
TGTGCCAGCAGTTGTAGTAGCAATCAGCCCCAGCATTTT	CASSCSSNQPQHF	TRBV12-3	TRBJ1-5
TGTGCCAGCAGAACTTCTAGCGGGGCTTACGAGCAGTACTTC	CASRTSSGAYEQYF	TRBV4-2	TRBJ2-7
TGTGCCAGCAGTGACTGGAAAACTAGCGGGGAGAACTACAATGAGCAGTTCTTC	CASSDWKTSGENYNEQFF	TRBV6-4	TRBJ2-1
TGTGCCATCAGTGAGTCAAAGGTGGACAGCTGGGAAGCCTACGAGCAGTACTTC	CAISESKVDSWEAYEQYF	TRBV10-3	TRBJ2-7
TGTGCTAGTGGTTTTGGGAACTCCACAGATACGCAGTATTTT	CASGFGNSTDTQYF	TRBV12-5	TRBJ2-3
TGTGCCAGCAGCTTGGAGGGGGGACACGATACGCAGTATTTT	CASSLEGGHDTQYF	TRBV5-8	TRBJ2-3
TGTGCCAGCAGCGTAACGGACAGGGAAGAGACCCAGTACTTC	CASSVTDREETQYF	TRBV9	TRBJ2-5
TGTGCCAGCAGTTGGGAAAAGTTCGCCCTAGCGGAGAATGAGCAGTTCTTC	CASSWEKFALAENEQFF	TRBV12-4	TRBJ2-1
TGTGCCAGCAGCTTAGTTCTTGGAGGAAAGCTGGATGAAAAACTGTTTTTT	CASSLVLGGKLDEKLFF	TRBV7-6	TRBJ1-4
TGCGCCAGCAGACCAGGGTACAAGAGCTCCTACGAGCAGTACTTC	CASRPGYKSSYEQYF	TRBV10-1	TRBJ2-7
TGTGCCAGCAGTTCAGTTATGCTAGTTTCCTCCTACGAGCAGTACTTC	CASSSVMLVSSYEQYF	TRBV27	TRBJ2-7
TGTGCCAGCAGTGACACCTCATGGGTCAAGATAGCGAGCAATCAGCCCCAGCATTTT	CASSDTSWVKIASNQPQHF	TRBV6-4	TRBJ1-5
TGCGCCAGCAGTGCGGTGAGGGAGAGCGAGCAGTACTTC	CASSAVRESEQYF	TRBV10-1	TRBJ2-7
TGTGCCAGCAGTTACTGGACTAGGGAAGGTGTCAATGAGCAGTTCTTC	CASSYWTREGVNEQFF	TRBV6-5	TRBJ2-1
TGTGCCAGCAGCTTACTGGGGGCATCCTACGAGCAGTACTTC	CASSLLGASYEQYF	TRBV11-2	TRBJ2-7
TGCAGCGTTGCCCGAAGTGCAGGGGGTGCAGATACGCAGTATTTT	CSVARSAGGADTQYF	TRBV29-1	TRBJ2-3
TGTGCCAGCAGTTATGAATGGGACAGGGGCACTGAAGCTTTCTTT	CASSYEWDRGTEAFF	TRBV6-1	TRBJ1-1
TGTGCCAGCAGCTTCCCGGACAGGATAGAAAAACTGTTTTTT	CASSFPDRIEKLFF	TRBV7-9	TRBJ1-4
TGTGCCAGCGAGACTAGCGGGGCGGGTGATGCCCCCCACCAAGAGACCCAGTACTTC	CASETSGAGDAPHQETQYF	TRBV9	TRBJ2-5
TGTGCCAGCAGTCTTCCCGGAAATTCAAAATCGCGGGGCGGTAATGAGCAGTTCTTC	CASSLPGNSKSRGGNEQFF	TRBV6-1	TRBJ2-1
TGTGCCAGCAGTTACTTGGAAATAGGGACTTTCCACTACGAGCAGTACTTC	CASSYLEIGTFHYEQYF	TRBV6-2	TRBJ2-7
TGTGCCAGCAGCCAAGTCCTGTGTCCTAGAGCCAAAAACATTCAGTACTTC	CASSQVLCPRAKNIQYF	TRBV14	TRBJ2-4
TGTGCCAGCAGTAGCCGGGACAGAGAAGCTTTCTTT	CASSSRDREAFF	TRBV3-1	TRBJ1-1
TGCGCCAGCAGCTTGCCTGGACTAGCGGGGGGCAATGAGCAGTTCTTC	CASSLPGLAGGNEQFF	TRBV5-1	TRBJ2-1
TGTGCCTGGAACCCCTCACTAGCGGGAGTAGATCCCTACAATGAGCAGTTCTTC	CAWNPSLAGVDPYNEQFF	TRBV30	TRBJ2-1
TGTGCCAGCAGCGGACCTCCTGAGTGTGGAAACACCATATATTTT	CASSGPPECGNTIYF	TRBV11-2	TRBJ1-3
TGTGCCAGCAGCCGGGACAGCTACGAGCAGTACTTC	CASSRDSYEQYF	TRBV6-4	TRBJ2-7
TGTGCCAGCAGAAACCTCATTGGGGGCCCGGCAAATTACAATGAGCAGTTCTTC	CASRNLIGGPANYNEQFF	TRBV6-5	TRBJ2-1
TGTGCCAGCAGCTCGACAGGGACGTGGGAGCAGTACTTC	CASSSTGTWEQYF	TRBV13	TRBJ2-7
TGTGCCAGCCCGGGGGGCGCGCAGTATTTT	CASPGGAQYF	TRBV6-4	TRBJ2-3
TGTGCCAGCAGTCATTTTAGCGGTACTGGCTACGAGCAGTACTTC	CASSHFSGTGYEQYF	TRBV12-3	TRBJ2-7
TGTGCCAGCAGCGTAGTGATGTCCAGTGAAGCTTTCTTT	CASSVVMSSEAFF	TRBV9	TRBJ1-1
TGTGCCAGCAGCTTAGGCGTCCCACTAGCGGGGGGTGGGAGCTCCTACAATGAGCAGTTCTTC	CASSLGVPLAGGGSSYNEQFF	TRBV11-2	TRBJ2-1
TGTGCCAGCAGCGATCTGGGGGCCCTACTCGAGACCCAGTACTTC	CASSDLGALLETQYF	TRBV13	TRBJ2-5
TGTGCCAGTAGTACCGGGACAGCTACTGAAGCTTTCTTT	CASSTGTATEAFF	TRBV19	TRBJ1-1
TGTGCCAGCAGCGATGGGACAGGGGGCTCTGGGGCCAACGTCCTGACTTTC	CASSDGTGGSGANVLTF	TRBV7-2	TRBJ2-6
TGTGCCAGCAGCCAAGATGTCTTGGGACAGGGTGGACAAGCCATACACACTGAAGCTTTCTTT	CASSQDVLGQGGQAIHTEAFF	TRBV14	TRBJ1-1
TGTGCCAGCAGCTCCAGGACAGGCCCGCTAGCCAAAAACATTCAGTACTTC	CASSSRTGPLAKNIQYF	TRBV7-9	TRBJ2-4
TGCAGTGCTAGGGTGCTCGAGTTTGAAAAACTGTTTTTT	CSARVLEFEKLFF	TRBV20-1	TRBJ1-4
TGTGCCAGCAGTGAAGGTGGAGGGGAAAAACTGTTTTTT	CASSEGGGEKLFF	TRBV2	TRBJ1-4
TGCAGTGCTAGAGGGGCCGGGACTAGCACAGATACGCAGTATTTT	CSARGAGTSTDTQYF	TRBV20-1	TRBJ2-3
TGTGCCAGCAGTAAGGCTCGACGCTCCTACGAGCAGTACTTC	CASSKARRSYEQYF	TRBV6-1	TRBJ2-7
TGTGCCAGCAGCCTTCCGGGACAGTCAAACTATGGCTACACCTTC	CASSLPGQSNYGYTF	TRBV4-2	TRBJ1-2
TGTGCCAGCAGCTTACAGAGGGAGTTTTCTGACAATGAGCAGTTCTTC	CASSLQREFSDNEQFF	TRBV7-9	TRBJ2-1
TGTGCCAGCAGCCGGGTAGGTGCAACTAATGAAAAACTGTTTTTT	CASSRVGATNEKLFF	TRBV14	TRBJ1-4
TGTGCCAGCAGCTACCGTAGGGGGGCCCTATTCAAAAGGGAGCAGCCCCAGCATTTT	CASSYRRGALFKREQPQHF	TRBV7-7	TRBJ1-5
TGTGCCAGCAGTTTTGGACAGGGGGCAACTAATGAAAAACTGTTTTTT	CASSFGQGATNEKLFF	TRBV27	TRBJ1-4
TGTGCCAGCAGCAGTCAGGGACTAGTTGCAGAGACCCAGTACTTC	CASSSQGLVAETQYF	TRBV7-3	TRBJ2-5
TGTGCCAGCATACCTAAACTAGCGGATTGGGGAAGCCCAGATACGCAGTATTTT	CASIPKLADWGSPDTQYF	TRBV12-4	TRBJ2-3
TGTGCCAGCTTTGGAGGGTCACCCCTCCACTTT	CASFGGSPLHF	TRBV7-9	TRBJ1-6
TGCAGTGCTAGAGGCATTAGCGGGGGCCTCCAGGCCTATAGTGAGCAGTTCTTC	CSARGISGGLQAYSEQFF	TRBV20-1	TRBJ2-1
TGTGCCAGCAGTTACGGAGCGGGTGAAGGGAACAATGAGCAGTTCTTC	CASSYGAGEGNNEQFF	TRBV6-3	TRBJ2-1
TGTGCCAGCAGCTTACAAGGGGGACAGGAGAATGAAAAACTGTTTTTT	CASSLQGGQENEKLFF	TRBV7-6	TRBJ1-4
TGCGCCAGCAGCTTGTCCCTCAGGGACAACTATGGCTACACCTTC	CASSLSLRDNYGYTF	TRBV5-1	TRBJ1-2
TGCGCCAGCAGTGAGTCTGCGGGAGAGACCCAGTACTTC	CASSESAGETQYF	TRBV10-1	TRBJ2-5
TGCAGTGCTAGCGTAGCGGGAGCCAATGAGCAGTTCTTC	CSASVAGANEQFF	TRBV20-1	TRBJ2-1
TGTGCCAGCAGTGATTTTGAGCCTGGAAGGTTGGATGGCTACACCTTC	CASSDFEPGRLDGYTF	TRBV6-4	TRBJ1-2
TGTGCCAGCAGCAATAGGGCGGTGGGCTACGAGCAGTACTTC	CASSNRAVGYEQYF	TRBV5-4	TRBJ2-7
TGCAGTGCCCGGACCCGACTAGCGAGGGTAAACGAGCAGTACTTC	CSARTRLARVNEQYF	TRBV20-1	TRBJ2-7
TGTGCCAGACGCGGGAACACTGAAGCTTTCTTT	CARRGNTEAFF	TRBV10-3	TRBJ1-1
TGTGCCACCAGCGAGGCCAGGAGGGGGAATGAGCAGTTCTTC	CATSEARRGNEQFF	TRBV15	TRBJ2-1
TGTGCCAGCAGCTTGGCAGACAGGGCGGTGAACACTGAAGCTTTCTTT	CASSLADRAVNTEAFF	TRBV5-6	TRBJ1-1
TGTGCCAGCAGCCTAGTGGCTCTCAGCTACGAGCAGTACTTC	CASSLVALSYEQYF	TRBV11-3	TRBJ2-7
TGTGCCAGCACTCCCCGGGGGGGGAACACTGAAGCTTTCTTT	CASTPRGGNTEAFF	TRBV6-2	TRBJ1-1
TGTGCCAGCAGTCCATACACACCCTGTTTAGACTCCTACAATGAGCAGTTCTTC	CASSPYTPCLDSYNEQFF	TRBV27	TRBJ2-1
TGCGCCACAAACTCGTTGTGGGGTGCTAACACCGGGGAGCTGTTTTTT	CATNSLWGANTGELFF	TRBV10-1	TRBJ2-2
TGTGCCAGTAGTCGATTGCAGCGACTAGGGTATGAGCAGTTCTTC	CASSRLQRLGYEQFF	TRBV19	TRBJ2-1
TGCGCCAGCAGCCCGTCAGGCGGGAGAATGGGGGAGCAGTACTTC	CASSPSGGRMGEQYF	TRBV10-1	TRBJ2-7
TGTGCTAGTGCCCTGATGGGGACCCGATTAGAGACCCAGTACTTC	CASALMGTRLETQYF	TRBV12-5	TRBJ2-5
TGTGCCAGCAGTGAATCTCCCCACACAGATACGCAGTATTTT	CASSESPHTDTQYF	TRBV6-1	TRBJ2-3
TGTGCCAGCAGCATTGACAGGGCTCCACTGAATGAAAAACTGTTTTTT	CASSIDRAPLNEKLFF	TRBV13	TRBJ1-4
TGTGCCAGACTTCCGGCCAAGGGGAATCAGCCCCAGCATTTT	CARLPAKGNQPQHF	TRBV6-4	TRBJ1-5
TGTGCCAGCAGCCCGATCCGGGACTCGAGTGAGTACAATGAGCAGTTCTTC	CASSPIRDSSEYNEQFF	TRBV13	TRBJ2-1
TGCAGTCATCCTGAAGAGCGGGAGAGGAGGATTAGAGAGACCCAGTACTTC	CSHPEERERRIRETQYF	TRBV20-1	TRBJ2-5
TGTGCCACATCTCGGGACGTCGATGGCTACACCTTC	CATSRDVDGYTF	TRBV24-1	TRBJ1-2
TGTGCCGGAGGGGGGTCAGTTACGCAGTATTTT	CAGGGSVTQYF	TRBV28	TRBJ2-3
TGTGCCAGCAGTGAAGCGCCAGACCCGGGATACAGGGGGTATGTCATTGTAGCTTTCTTT	CASSEAPDPGYRGYVIVAFF	TRBV6-1	TRBJ1-1
TGTGCCAGCAGCTCCCCGACTAGCGGAAGGGAGACCCAGTACTTC	CASSSPTSGRETQYF	TRBV5-5	TRBJ2-5
TGCAGTGCTAGAGACGACGGGCAGGATCAGCCCCAGCATTTT	CSARDDGQDQPQHF	TRBV20-1	TRBJ1-5
TGCGCCAGCAGCTTGGTACGAAGCGGGAGATGCACAGATACGCAGTATTTT	CASSLVRSGRCTDTQYF	TRBV5-1	TRBJ2-3
TGTGCCACCAGCGGCGGTCGGGACAGGGGAATAGACTTC	CATSGGRDRGIDF	TRBV15	TRBJ2-7
TGTGCCACGGGACTAACCACTGAAGCTTTCTTT	CATGLTTEAFF	TRBV6-1	TRBJ1-1
TGTGCCAGCAGTCACGACCCCGGGACAGGGGCGCAGGGGTACGAGCAGTACTTC	CASSHDPGTGAQGYEQYF	TRBV6-4	TRBJ2-7
TGTGCCAGCAGCTTGTCGGATCAGAATTATGATTCTGGCCATAATGAGCAGTTCTTC	CASSLSDQNYDSGHNEQFF	TRBV5-6	TRBJ2-1
TGTGCCAGCAGCGGCCGAAAAACAGGTAGTACTGAAGCTTTCTTT	CASSGRKTGSTEAFF	TRBV13	TRBJ1-1
TGTGCCAGCAGTGGGTTGCCGGGGACCTATGGCTACACCTTC	CASSGLPGTYGYTF	TRBV2	TRBJ1-2
TGCGCCAGCAGCAGGGGGCCCTACGAGCAGTACTTC	CASSRGPYEQYF	TRBV5-1	TRBJ2-7
TGTGCCAGCAGCCAAGATAAGTGGACGAGACAGGGGGTACCGGACACAGATACGCAGTATTTT	CASSQDKWTRQGVPDTDTQYF	TRBV14	TRBJ2-3
TGTGCCAGCAGTTTATCGGATTATAAATGGGACAGTGAAAAACTGTTTTTT	CASSLSDYKWDSEKLFF	TRBV27	TRBJ1-4
TGCGCCAGCAGCTACTTGAGTAAGGCGGACCATTCACCCCTCCACTTT	CASSYLSKADHSPLHF	TRBV5-1	TRBJ1-6
TGTGCCAGCAGCCAAGATCGCATCGGGGGGGCTTTCTACGAGCAGTACTTC	CASSQDRIGGAFYEQYF	TRBV4-2	TRBJ2-7
TGTGCCAGCAGCCGGGACGACAGGGGAACCGGGGAGCTGTTTTTT	CASSRDDRGTGELFF	TRBV7-4	TRBJ2-2
TGCAGTGCTAGAGCCCTTGCAGGGGCCGCAACTAATGAAAAACTGTTTTTT	CSARALAGAATNEKLFF	TRBV20-1	TRBJ1-4
TGTGCCAGTAGTATAGTTCGGGGTTTTTTCTACGAGCAGTACTTC	CASSIVRGFFYEQYF	TRBV19	TRBJ2-7
TGTGCCAGTACAGGGACAGGGGGCGAGCCCGAAAACACTGAAGCTTTCTTT	CASTGTGGEPENTEAFF	TRBV19	TRBJ1-1
TGTGCCAGCAGTAGGGGGTCTAACATTCAGTACTTC	CASSRGSNIQYF	TRBV6-3	TRBJ2-4
TGTGCCAGCAGAAGCAGGCAGAGGAGCACAGATACGCAGTATTTT	CASRSRQRSTDTQYF	TRBV9	TRBJ2-3
TGTGCCAGCAGCCCTCGAACAGGGGGGGCCACTGAAGCTTTCTTT	CASSPRTGGATEAFF	TRBV11-2	TRBJ1-1
TGCGCCAGCAGCCAAGAGGCAGGGGGGAGAGAGCAGTACTTC	CASSQEAGGREQYF	TRBV4-1	TRBJ2-7
TGCAGCGGGTGCCCCTGGGGAAGGGCTTTCTTT	CSGCPWGRAFF	TRBV29-1	TRBJ1-1
TGTGCCAGCAGTTGGGGGGGGGCCTACAATGAGCAGTTCTTC	CASSWGGAYNEQFF	TRBV6-3	TRBJ2-1
TGTGCCAGCAGCTACGGACTAGCTAGACACACAGATACGCAGTATTTT	CASSYGLARHTDTQYF	TRBV27	TRBJ2-3
TGTGCCTCTATTCGACAGGGGGGCGAGCAGTACTTC	CASIRQGGEQYF	TRBV30	TRBJ2-7
TGTGCCAGCTCACGGGACAGGCCAAAAAGATCCTACTCCTACGAGCAGTACTTC	CASSRDRPKRSYSYEQYF	TRBV18	TRBJ2-7
TGCAGCGTTGAGAAGGGGGGGTCATCCTACGAGCAGTACTTC	CSVEKGGSSYEQYF	TRBV29-1	TRBJ2-7
TGCGCCAGCAGAAAGGACAGGGTATGGTGCACTGAAGCTTTCTTT	CASRKDRVWCTEAFF	TRBV5-1	TRBJ1-1
TGTGCCAGCAGCTGGAAGACTAGCGGGGGGTCCTACAATGAGCAGTTCTTC	CASSWKTSGGSYNEQFF	TRBV13	TRBJ2-1
TGTGCCAGCATCGGACAATCCGGGACCTACGAGCAGTACTTC	CASIGQSGTYEQYF	TRBV7-2	TRBJ2-7
TGCGCCAGCAGCAGTGTGGTGACTGTGGGCTCGAGCAACGTCCTGACTTTC	CASSSVVTVGSSNVLTF	TRBV4-3	TRBJ2-6
TGTGCCAGCAGTTACCAATACAGGGGGGGCCTCAGGTCCTACGAGCAGTACTTC	CASSYQYRGGLRSYEQYF	TRBV6-3	TRBJ2-7
TGTGCCAGCAGCCGTCGACACGGACAGTACGGGGAGCTGTTTTTT	CASSRRHGQYGELFF	TRBV3-1	TRBJ2-2
TGTGCCAGCAGTGGGACAGGGGGGGCGAACACCGGGGAGCTGTTTTTT	CASSGTGGANTGELFF	TRBV12-4	TRBJ2-2
TGTGCCAGCAGCACTTATGGAAGTAGCAATCAGCCCCAGCATTTT	CASSTYGSSNQPQHF	TRBV13	TRBJ1-5
TGTGCCAGCAGTTTAGCAGGGTGGAATGAGCAGTTCTTC	CASSLAGWNEQFF	TRBV12-4	TRBJ2-1
TGTGCCAGAACGGTTGAGAATTCACCCCTCCACTTT	CARTVENSPLHF	TRBV13	TRBJ1-6
TGTGCCACCAGTGATGACCTGGGGGGGGAGCAGTACTTC	CATSDDLGGEQYF	TRBV24-1	TRBJ2-7
TGTGCCAGCAGTGTGTGGCGCGGTATGAATAATTCACCCCTCCACTTT	CASSVWRGMNNSPLHF	TRBV6-1	TRBJ1-6
TGTGCCAGCAGCAATTTAGCGTCCGAGCAGTACTTC	CASSNLASEQYF	TRBV13	TRBJ2-7
TGTGCCACGACATGGGTCGCAGGAGAAGCCTACGAGCAGTACTTC	CATTWVAGEAYEQYF	TRBV6-5	TRBJ2-7
TGTGCCACCAGTGATTTAGTCCAGGGATTCCGACCCATCCAGAACACTGAAGCTTTCTTT	CATSDLVQGFRPIQNTEAFF	TRBV24-1	TRBJ1-1
TGTGCCACCAGTGATTTATGTCAACGCCGGGACCAAGAGACCCAGTACTTC	CATSDLCQRRDQETQYF	TRBV24-1	TRBJ2-5
TGTGCCAGCTCACCACCGTCCATAGACAGGAATGTCCGGGCGGACCCCTCTGGAAACACCATATATTTT	CASSPPSIDRNVRADPSGNTIYF	TRBV18	TRBJ1-3
TGTGCCTGGAGTGTATTCCTTGGAGTTAGGAACTATGGCTACACCTTC	CAWSVFLGVRNYGYTF	TRBV30	TRBJ1-2
TGTGCCAGCAGTAGATACAACGGGAGGGTAGAGACCCAGTACTTC	CASSRYNGRVETQYF	TRBV27	TRBJ2-5
TGTGCCAGCATCTCAGCCTTCGGATACAATGAGCAGTTCTTC	CASISAFGYNEQFF	TRBV28	TRBJ2-1
TGTGCCAGCCCGGGGCAGGGGGATCAGCCCCAGCATTTT	CASPGQGDQPQHF	TRBV6-1	TRBJ1-5
TGTGCTAGCAGCACAACACGAAATCAGCCCCAGCATTTT	CASSTTRNQPQHF	TRBV7-7	TRBJ1-5
TGTGCCACCAGTGATCAGGAGGGAGCCTACGAGCAGTACTTC	CATSDQEGAYEQYF	TRBV24-1	TRBJ2-7
TGCGCCAGCACCCCGGACAGTTACGAAAAACTGTTTTTT	CASTPDSYEKLFF	TRBV5-1	TRBJ1-4
TGTGCCAGCAGCCGCGTTTCTAACAAGGGCCGGGACTACGAGCAGTACTTC	CASSRVSNKGRDYEQYF	TRBV3-1	TRBJ2-7
TGCTTGGTCCCGGGACAGGCTCCGTACCAAGAGACCCAGTACTTC	CLVPGQAPYQETQYF	TRBV20-1	TRBJ2-5
TGTGCCAGCAGCAAAGGGGACTTCTACTCTGGGGCCAACGTCCTGACTTTC	CASSKGDFYSGANVLTF	TRBV7-2	TRBJ2-6
TGTGCCAGCAGCTATCATCCGGGACTAGCGGGGGACACCGGGGAGCTGTTTTTT	CASSYHPGLAGDTGELFF	TRBV11-3	TRBJ2-2
TGTGCCAGCAGCTCAATGGCGGGAGGGGTGAAGTGCCATGCCGCTTTCTTT	CASSSMAGGVKCHAAFF	TRBV7-9	TRBJ1-1
TGTGCCAGCAGAACGAGGGGGCTGGGGGGCACTGAAGCTTTCTTT	CASRTRGLGGTEAFF	TRBV7-3	TRBJ1-1
TGTGCCAGCAGCGCACCCCTCGGGAGCGGAGCCTACGAGCAGTACTTC	CASSAPLGSGAYEQYF	TRBV27	TRBJ2-7
TGTGCCACCAGCGGGGGGGGGGAGCTGTTTTTT	CATSGGGELFF	TRBV15	TRBJ2-2
TGTGCCAGCACCCGGGACAGGGCCTACGAGCAGTACTTC	CASTRDRAYEQYF	TRBV27	TRBJ2-7
TGCGCCAGCAGCCAAGCGGCCCGGGGGAGTAATGAAGCTTTCTTT	CASSQAARGSNEAFF	TRBV4-1	TRBJ1-1
TGTGCCACCAGTGAGGGCGAGTCGGGGAGGAATGAGCAGTTCTTC	CATSEGESGRNEQFF	TRBV24-1	TRBJ2-1
TGTGCCAGCAGCTTGGGACAGGCCTACGAGCAGTACTTC	CASSLGQAYEQYF	TRBV11-3	TRBJ2-7
TGTGCCAGCAGTTTATGCGCCGGCGGGTACCGCGGCTACACCTTC	CASSLCAGGYRGYTF	TRBV27	TRBJ1-2
TGTGCCAGCAGCTGGGCAGACAGGGGGGGGGAGGGGGTTCCTGAAGCTTTCTTT	CASSWADRGGEGVPEAFF	TRBV5-6	TRBJ1-1
TGTGCCAGCATTACCTGCCGGGACAGGGGGAAAACGGTAAGCTCCTACGAGCAGTACTTC	CASITCRDRGKTVSSYEQYF	TRBV6-1	TRBJ2-7
TGTGCCAGCAGTTCGGGACTAGCAGGACGCCTTACTACCGGGGAGCTGTTTTTT	CASSSGLAGRLTTGELFF	TRBV28	TRBJ2-2
TGCAGTGCCTCAGTGGGGGGCTATGAGCAGTTCTTC	CSASVGGYEQFF	TRBV20-1	TRBJ2-1
TGTGCCAGTAGTATTTTCGGGGCTAATTCACCCCTCCACTTT	CASSIFGANSPLHF	TRBV19	TRBJ1-6
TGTGCCAGCAGTGTAAGTGAGGGGGGGGGCCGGCCGACTGAAGCTTTCTTT	CASSVSEGGGRPTEAFF	TRBV27	TRBJ1-1
TGCGCCAGCAGCCAGGGGGGGGGGGTTAGCACAGATACGCAGTATTTT	CASSQGGGVSTDTQYF	TRBV5-1	TRBJ2-3
TGTGCCAGCAGAGCGGGACATGGAAACACCATATATTTT	CASRAGHGNTIYF	TRBV27	TRBJ1-3
TGTGCCAGCAGCGGCGACCCGGGGCATGGGGGCTACGAGCAGTACTTC	CASSGDPGHGGYEQYF	TRBV13	TRBJ2-7
TGTGCCAGCAGTTATCGGGGGGGGGACAATCGAGCCCTGACTCGAGAGATATACGAGCAGTACTTC	CASSYRGGDNRALTREIYEQYF	TRBV6-5	TRBJ2-7
TGTGCCATCCGGGGGGGGGTCACAGATACGCAGTATTTT	CAIRGGVTDTQYF	TRBV10-3	TRBJ2-3
TGTGCCACCAGTGGATACCGGGACAGAAGGGGCAACATTCAGTACTTC	CATSGYRDRRGNIQYF	TRBV24-1	TRBJ2-4
TGTGCCAGCAGTTACTTCGAGAACATTAGCAATCAGCCCCAGCATTTT	CASSYFENISNQPQHF	TRBV6-5	TRBJ1-5
TGCAGTGCTAGGCCCCCAACAAACTATAGCAATCAGCCCCAGCATTTT	CSARPPTNYSNQPQHF	TRBV20-1	TRBJ1-5
TGTGCCAGCAGCTTGCGCTCTTGTGGACAGGGTTTGTACTACGAGCAGTACTTC	CASSLRSCGQGLYYEQYF	TRBV7-3	TRBJ2-7
TGTGCCACCAGTGTTCGCGGTAATAATGAGCAGTTCTTC	CATSVRGNNEQFF	TRBV24-1	TRBJ2-1
TGTGCCAGCAGCTTCTTTCTAGCGGGCGACACGCCTCGGGAAGGCCTTGAGCAGTTCTTC	CASSFFLAGDTPREGLEQFF	TRBV9	TRBJ2-1
TGTCGACAAAATCTGGGGGAAGCTTTCTTT	CRQNLGEAFF	TRBV29-1	TRBJ1-1
TGCAGTGCTAGAGCGGGGGTGGTTAATGAAAAACTGTTTTTT	CSARAGVVNEKLFF	TRBV20-1	TRBJ1-4
TGCGCCAGCAGCTTGGGCACAATCGGGGGGACTAGCGGGGGAACCAATGAGCAGTTCTTC	CASSLGTIGGTSGGTNEQFF	TRBV5-1	TRBJ2-1
TGTGCCAGCAGCTTAGGGGGGGAACCTTTCAGGCAGTACTTC	CASSLGGEPFRQYF	TRBV7-2	TRBJ2-7
TGCAGTGCTAACGCTGGACCCGATGGCTACACCTTC	CSANAGPDGYTF	TRBV20-1	TRBJ1-2
TGTGCCAGCAGCCAACGGCCAGGGGATTCACCCCTCCACTTT	CASSQRPGDSPLHF	TRBV3-1	TRBJ1-6
TGTGCCAGCAGCGGGACTAGCGGCCCGGACTCCTACGAGCAGTACTTC	CASSGTSGPDSYEQYF	TRBV7-9	TRBJ2-7
TGTGCCAGCAGTGGGGACAGGGGAGAGACCCAGTACTTC	CASSGDRGETQYF	TRBV2	TRBJ2-5
TGTGCCAGCCTACCACAGGGGAAAAGATCCTACGAGCAGTACTTC	CASLPQGKRSYEQYF	TRBV12-4	TRBJ2-7
TGTGCCATCAGTGGTGAGCAGGATGGCTACACCTTC	CAISGEQDGYTF	TRBV10-3	TRBJ1-2
TGTGCCAGCAGCTTATTTATTCCCCAGGGGGAAGCTTTCTTT	CASSLFIPQGEAFF	TRBV11-3	TRBJ1-1
TGTGCCAGCAGTGGGGCTCATAACTATGGCTACACCTTC	CASSGAHNYGYTF	TRBV7-4	TRBJ1-2
TGTGCCAGTAGTATCCATGGGGGCGACTCCAACACCGGGGAGCTGTTTTTT	CASSIHGGDSNTGELFF	TRBV19	TRBJ2-2
TGTGCCAGCAGGGGGGGGCCTCACTCCTACGAGCAGTACTTC	CASRGGPHSYEQYF	TRBV12-3	TRBJ2-7
TGTGCCCATCCCGTGACGGCTGGCTACACCTTC	CAHPVTAGYTF	TRBV7-4	TRBJ1-2
TGTGCCAGCAGTGACGGACCATTGCATGAGACCCAGTACTTC	CASSDGPLHETQYF	TRBV6-4	TRBJ2-5
TGTGCCAGCAGTAGGAGGACAGGGTCGGACCCATATGAAGCTTTCTTT	CASSRRTGSDPYEAFF	TRBV6-1	TRBJ1-1
TGTGCCTGTGGACTAGCGGGGGGCTTGCCGCAGTTCTTC	CACGLAGGLPQFF	TRBV30	TRBJ2-1
TGTGCCAGCAGTTACACAGGGGGCACAGATACGCAGTATTTT	CASSYTGGTDTQYF	TRBV6-5	TRBJ2-3
TGTGCCAGCACCAGGGACAGGGGGCCATCAACTAATGAAAAACTGTTTTTT	CASTRDRGPSTNEKLFF	TRBV6-4	TRBJ1-4
TGCGCCAGCAGCCAAGTTACCAGGAGCCTGAACACTGAAGCTTTCTTT	CASSQVTRSLNTEAFF	TRBV4-1	TRBJ1-1
TGTGCCAGCAGTTTTCCTCTGACAGGGGGAGGAAATTCACCCCTCCACTTT	CASSFPLTGGGNSPLHF	TRBV27	TRBJ1-6
TGCGCCAGCAGCCCTTGGGGCCCAAACGTAACCGGGGAGCTGTTTTTT	CASSPWGPNVTGELFF	TRBV10-1	TRBJ2-2
TGCGCCAGCACCCCAGGGGAAGGGCATGGCTACACCTTC	CASTPGEGHGYTF	TRBV10-1	TRBJ1-2
TGTGCCAGCAGCTTAGAAGGCGTCAGGGATGAAAAACTGTTTTTT	CASSLEGVRDEKLFF	TRBV7-4	TRBJ1-4
TGCGCCAGCAGCGTGGAAACAGGGAATTGCTATGGCTACACCTTC	CASSVETGNCYGYTF	TRBV5-1	TRBJ1-2
TGTGCCAGCAGTGACTCGTTGCGGAGGTCGGGGGGGAGCGCTGGGGCCAACGTCCTGACTTTC	CASSDSLRRSGGSAGANVLTF	TRBV6-4	TRBJ2-6
TGCAGTGCTAGAGATAACGTACCTCTGGCGACCCAGTACTTC	CSARDNVPLATQYF	TRBV20-1	TRBJ2-5
TGTGCCAGCAGAAAGGGGGGGACCATAGATACGCAGTATTTT	CASRKGGTIDTQYF	TRBV6-1	TRBJ2-3
TGTGCCACTCTAACCGGGACCAGGATTAGGAGCGCTGAGACCCAGTACTTC	CATLTGTRIRSAETQYF	TRBV24-1	TRBJ2-5
TGCAGTGCTAGCATGAAAGGGGGCTTGGAAGGAAACCCCTACGAGCAGTACTTC	CSASMKGGLEGNPYEQYF	TRBV20-1	TRBJ2-7
TGTGCCAGCAGTAGGGGCGGGGGGCTGGTGGATAGCAATCAGCCCCAGCATTTT	CASSRGGGLVDSNQPQHF	TRBV27	TRBJ1-5
TGCGCCAGCAGCTTGGTGGACCGCATATTGGACAGGGACATGAATGAGCAGTTCTTC	CASSLVDRILDRDMNEQFF	TRBV5-1	TRBJ2-1
TGTGCCAGCTCACCACCGGTACCCCGTCTGGGGGGGCGACCCCAAGAGACCCAGTACTTC	CASSPPVPRLGGRPQETQYF	TRBV18	TRBJ2-5
TGTGCCAGCAGTTGCTGCCTCTACAAACCCAACACCGGGGAGCTGTTTTTT	CASSCCLYKPNTGELFF	TRBV6-2	TRBJ2-2
TGTGCCAGCCGACAGGGGAATCAGCCCCAGCATTTT	CASRQGNQPQHF	TRBV7-2	TRBJ1-5
TGTGCCAGCAGTTTACCATCCGGACAGGGGGCGGCGCCGACCCAGTACTTC	CASSLPSGQGAAPTQYF	TRBV6-9	TRBJ2-5
TGCAGTGCTAGAGCAAGGCAGCGGGATCAGTCCTGTAATTCACCCCTCCACTTT	CSARARQRDQSCNSPLHF	TRBV20-1	TRBJ1-6
TGTGCCAGCAGTTCCCGGGAGGGAAATGAATACGAGCAGTACTTC	CASSSREGNEYEQYF	TRBV6-3	TRBJ2-7
TGTGCCAGCAGCCGCAGCAGTCGCTACGAGCAGTACTTC	CASSRSSRYEQYF	TRBV9	TRBJ2-7
TGTGCCAGCAGTTACTCACAGGGAGATGGCAATCAGCCCCAGCATTTT	CASSYSQGDGNQPQHF	TRBV6-6	TRBJ1-5
TGTGCCAGCAGTGACCAAAGAAGGGACAGGGGCTTTGCCGGGGAGCTGTTTTTT	CASSDQRRDRGFAGELFF	TRBV6-4	TRBJ2-2
TGTGCCAGCAGCCAAGCGGAATCGCGGGCTCAGCCCCAGCATTTT	CASSQAESRAQPQHF	TRBV14	TRBJ1-5
TGTGCCAGCAGTCCACTAGGGACTAATGAAAAACTGTTTTTT	CASSPLGTNEKLFF	TRBV6-1	TRBJ1-4
TGTGCCATCAGTGTAAATCTAGCGGGGGGCACAGATACGCAGTATTTT	CAISVNLAGGTDTQYF	TRBV10-3	TRBJ2-3
TGTGCCACTAAGAAAAGGACTAGCGGGGGAACTGATACGCAGTATTTT	CATKKRTSGGTDTQYF	TRBV24-1	TRBJ2-3
TGCGCCAGCAGCCAAGACTCCGGGGGGCCCAATGAGCAGTTCTTC	CASSQDSGGPNEQFF	TRBV4-1	TRBJ2-1
TGTGCCAGCAAAAGCAGGGGGGCGACTTGCTCCTACAATGAGCAGTTCTTC	CASKSRGATCSYNEQFF	TRBV7-3	TRBJ2-1
TGTGCCACCAGTGATTTGCAGGTAGGCAACCGGAGCTCCTACGAGCAGTACTTC	CATSDLQVGNRSSYEQYF	TRBV24-1	TRBJ2-7
TGTGCCAGCAGAAAACTACGGGACAGGGGTTTGAACACTGAAGCTTTCTTT	CASRKLRDRGLNTEAFF	TRBV7-7	TRBJ1-1
TGTGCCAGCAGTTTAGTCACGGCTCAGAGTGAAGCTTTCTTT	CASSLVTAQSEAFF	TRBV12-4	TRBJ1-1
TGTGCCAGCAGCGTAGCCACAGGGCCAGGGCGGGGCCCCTATAGCAATCAGCCCCAGCATTTT	CASSVATGPGRGPYSNQPQHF	TRBV9	TRBJ1-5
TGTGCCAGCACAGATCCCGGACGTGGTTACTACGAGCAGTACTTC	CASTDPGRGYYEQYF	TRBV6-1	TRBJ2-7
TGTGCCAGCAGCCAAGCCCCGGGACAGGGACACACAGATACGCAGTATTTT	CASSQAPGQGHTDTQYF	TRBV3-1	TRBJ2-3
TGTGCTAGTGATGAAGGGGGCAAGAAGTCCCCCCAGTACTTC	CASDEGGKKSPQYF	TRBV12-5	TRBJ2-5
TGTGCCACCAGCTCCGGGGGGGCGAAGGGGGGGAATCAGCCCCAGCATTTT	CATSSGGAKGGNQPQHF	TRBV15	TRBJ1-5
TGTGCCAGCAGCCCCAGGGTTCATAGCAATCAGCCCCAGCATTTT	CASSPRVHSNQPQHF	TRBV5-8	TRBJ1-5
TGTGCCAGCAGGCCGGGCGGGAGCGGCAGATCGACCACAGATACGCAGTATTTT	CASRPGGSGRSTTDTQYF	TRBV12-4	TRBJ2-3
TGTGCCAGCAGCATCGACTGGCAGGCTGAAGCTTTCTTT	CASSIDWQAEAFF	TRBV7-4	TRBJ1-1
TGTGCCAGCAGTGGAGAGAACGGGGGGGCCTTCTCCTACAATGAGCAGTTCTTC	CASSGENGGAFSYNEQFF	TRBV6-4	TRBJ2-1
TGTGCCAGCCCCGGGACAGTTAACACTGAAGCTTTCTTT	CASPGTVNTEAFF	TRBV7-9	TRBJ1-1
TGTGCCAGCCTTGGGACTAGCGGGAGCTCCTACAATGAGCAGTTCTTC	CASLGTSGSSYNEQFF	TRBV7-6	TRBJ2-1
TGTGCCAGCAGCCAAGAGAACAGCGTACCTAGCAATCAGCCCCAGCATTTT	CASSQENSVPSNQPQHF	TRBV14	TRBJ1-5
TGTGCCAGCAGCCCGGGACAGGGCTATATCGTTCCCGAGCAGTACTTC	CASSPGQGYIVPEQYF	TRBV7-3	TRBJ2-7
TGTGCCAGCAGCGACGGACAGAACTTT	CASSDGQNF	TRBV9	TRBJ1-1
TGTGCCAGCAGCCAGAGAAGTCAGGTTTCTCCCTACGAGCAGTACTTC	CASSQRSQVSPYEQYF	TRBV13	TRBJ2-7
TGCAGTGCCCAGGTAGCGGAGCAAGAGACCCAGTACTTC	CSAQVAEQETQYF	TRBV20-1	TRBJ2-5
TGTGCCAGCAGCCAGGAGGACAGGGGGCCGAGACTGGGAAACACCATATATTTT	CASSQEDRGPRLGNTIYF	TRBV11-2	TRBJ1-3
TGCAGTGCTCCTATGGACCCCGAGCAGTACTTC	CSAPMDPEQYF	TRBV20-1	TRBJ2-7
TGTGCCAAGGCCAGGTCCGTAGATGACCGGGACAGGGACACTGAAGCTTTCTTT	CAKARSVDDRDRDTEAFF	TRBV28	TRBJ1-1
TGTGCCAGCAGCCAAGCGGCAGCAAGGTACGAGCAGTACTTC	CASSQAAARYEQYF	TRBV3-1	TRBJ2-7
TGCAGTGCTAGAGATCTGAGGCATTACGTGGACGAGCAGTACTTC	CSARDLRHYVDEQYF	TRBV20-1	TRBJ2-7
TGTGCCAGTAGTATTTTGACAGGGTCTTTGGTTCGCAATCAGCCCCAGCATTTT	CASSILTGSLVRNQPQHF	TRBV19	TRBJ1-5
TGCAGTGCTAGACACTGGGCTTTCTTT	CSARHWAFF	TRBV20-1	TRBJ1-1
TGTGCCAGCACTAGCGAAGGGGCCAAAAACATTCAGTACTTC	CASTSEGAKNIQYF	TRBV6-2	TRBJ2-4
TGCAGTGCTCAGGGTAGGAAGTTCCAAGAGACCCAGTACTTC	CSAQGRKFQETQYF	TRBV20-1	TRBJ2-5
TGCGCCAGCAGCTTGAAACGGGCCGGGAGGCCTGAAGCTTTCTTT	CASSLKRAGRPEAFF	TRBV5-1	TRBJ1-1
TGTGCCAGCAGCGACAGGGAAAGTTTTGAAGCTTTCTTT	CASSDRESFEAFF	TRBV5-6	TRBJ1-1
TGCAGTGCTAGAGCCCGCCTTCGGGGGGGCATCCGTCCCTACAATGAGCAGTTCTTC	CSARARLRGGIRPYNEQFF	TRBV20-1	TRBJ2-1
TGTGCCACCCCGGGGGGGCTGTGGGAGCAGTACTTC	CATPGGLWEQYF	TRBV28	TRBJ2-7
TGCGCCAGCACAAGGACAGGGGGACGGATACAGCCCCAGCATTTT	CASTRTGGRIQPQHF	TRBV10-1	TRBJ1-5
TGTGCCACCAGCAGAGTGACAGGTAACACTGAAGCTTTCTTT	CATSRVTGNTEAFF	TRBV15	TRBJ1-1
TGTGCCAGCAGGCCCCGTGGGACTGGCCCTGAGCAGTTCTTC	CASRPRGTGPEQFF	TRBV6-6	TRBJ2-1
TGCAGTGCTAGAGAATTAGGGACTAGCGGTGTTCATTACAATGAGCAGTTCTTC	CSARELGTSGVHYNEQFF	TRBV20-1	TRBJ2-1
TGTGCCAGCAGCACCGGGGACCCGATAGCCAAAAACATTCAGTACTTC	CASSTGDPIAKNIQYF	TRBV7-8	TRBJ2-4
TGTGCCAGCAGCTATCCGGCCTATGGCTACACCTTC	CASSYPAYGYTF	TRBV7-9	TRBJ1-2
TGTGCCAGCAGCGTAGCCCAGGGCGCTTATGGCTACACCTTC	CASSVAQGAYGYTF	TRBV9	TRBJ1-2
TGTGCCAGCAGCCCCACTCCGGCAGCCTCAAAACTGTTTTTT	CASSPTPAASKLFF	TRBV6-6	TRBJ1-4
TGTGCCAGCATGGTGACTAGCTTGAACACCGGGGAGCTGTTTTTT	CASMVTSLNTGELFF	TRBV2	TRBJ2-2
TGCAGTGCGGAGTCCGACCCGGGCCGGACGAACACCGGGGAGCTGTTTTTT	CSAESDPGRTNTGELFF	TRBV20-1	TRBJ2-2
TGTGCCAGATATAGTACGGGACAGAAGGACGAGCAGTACTTC	CARYSTGQKDEQYF	TRBV19	TRBJ2-7
TGCAGTGCTAGAGAGCCGAAGAGGGACAGGCAATACGAGCAGTACTTC	CSAREPKRDRQYEQYF	TRBV20-1	TRBJ2-7
TGTGCCTGGAGAAAGGGGACTATCGCAACTAATGAAAAACTGTTTTTT	CAWRKGTIATNEKLFF	TRBV30	TRBJ1-4
TGCAGTGCTAGCAGGGATCGTGGCTACACCTTC	CSASRDRGYTF	TRBV20-1	TRBJ1-2
TGCAGTGAGACCGGGGGACTAGCGGCAAGCCCGGGTACGGCCGAAAACATTCAGTACTTC	CSETGGLAASPGTAENIQYF	TRBV20-1	TRBJ2-4
TGTGCCACAGCGTTTAGTAGCAATCAGCCCCAGCATTTT	CATAFSSNQPQHF	TRBV27	TRBJ1-5
TGTGCCAGCAAGATCTGGACGGAGCTGTTTTTT	CASKIWTELFF	TRBV5-6	TRBJ2-2
TGTGCCAGCAGCCCCCGTACAGTCCAGCCCCAGCATTTT	CASSPRTVQPQHF	TRBV7-9	TRBJ1-5
TGCAGTGCGTCCTTCGACAGGGCCGGGGCCTATGGCTACACCTTC	CSASFDRAGAYGYTF	TRBV20-1	TRBJ1-2
TGTGCCAGCAGCTTAGTTAGGGACAGGGCTTGGGGGAACACTGAAGCTTTCTTT	CASSLVRDRAWGNTEAFF	TRBV11-3	TRBJ1-1
TGCAGTGCTAGGACGACTAATGAGCAGTTCTTC	CSARTTNEQFF	TRBV20-1	TRBJ2-1
TGTGCCAGCAGTGACTCAAGAAGCTGGGACTTATCCTACAATGAGCAGTTCTTC	CASSDSRSWDLSYNEQFF	TRBV6-4	TRBJ2-1
TGCAGCGTCAGCCGGACTAACTTCTATACCTACAATGAGCAGTTCTTC	CSVSRTNFYTYNEQFF	TRBV29-1	TRBJ2-1
TGTGCCAGCAGCGGCCCACCCGGGCGAAGCGAGCAGTACTTC	CASSGPPGRSEQYF	TRBV9	TRBJ2-7
TGCAGTGCTAGCCCGGTCTTACGGGGAAGCTCCTACGAGCAGTACTTC	CSASPVLRGSSYEQYF	TRBV20-1	TRBJ2-7
TGTGCCAGCAGTCCTGGGAAGCAAGGTAACGGGGAGCTGTTTTTT	CASSPGKQGNGELFF	TRBV6-1	TRBJ2-2
TGTGCCAGCAGCTTAGAATTCAGAGCCTGGTGGGGATTCAGCTCCTACAATGAGCAGTTCTTC	CASSLEFRAWWGFSSYNEQFF	TRBV7-8	TRBJ2-1
TGTGCCAGTAGTTGTAATTGGGGCAGCTTAGGCTATGGCTACACCTTC	CASSCNWGSLGYGYTF	TRBV19	TRBJ1-2
TGTGCCAGCAGGTCGGGGGCATGCTCAGCCTACGAGCAGTACTTC	CASRSGACSAYEQYF	TRBV6-1	TRBJ2-7
TGTGCCAGCAGCCATTTCTCCCAATACACCTTC	CASSHFSQYTF	TRBV12-3	TRBJ1-2
TGTGCCTGGAGTGTGGTGAGCCAGAACACTGAAGCTTTCTTT	CAWSVVSQNTEAFF	TRBV30	TRBJ1-1
TGTGCCAGCAGTGAAGCGCTTCAGTTAGCCAAAAACATTCAGTACTTC	CASSEALQLAKNIQYF	TRBV2	TRBJ2-4
TGTGCCAGCAGCTTCCCCGGGCGGTGTAGGCACGGTGAAGGCACCGGGGAGCTGTTTTTT	CASSFPGRCRHGEGTGELFF	TRBV7-9	TRBJ2-2
TGTGCCACCAGTGAGTCTCTCACTAGCGGGTCTGAGCAGTTCTTC	CATSESLTSGSEQFF	TRBV24-1	TRBJ2-1
TGTGCCAGCAGGGATTTCTCCGAGGGGGACACCATATATTTT	CASRDFSEGDTIYF	TRBV7-3	TRBJ1-3
TGTGCCAGCAGCAGGGGCCCGAGCGGCAATCAGCCCCAGCATTTT	CASSRGPSGNQPQHF	TRBV5-4	TRBJ1-5
TGCGCCACGGGGCGTATTTTAGAGACCCAGTACTTC	CATGRILETQYF	TRBV5-1	TRBJ2-5
TGCAGTGCTAGTGGACAGGGAAACCAAAGCGGGGAGCTGTTTTTT	CSASGQGNQSGELFF	TRBV20-1	TRBJ2-2
TGCGCCAGCAGCCAAGATAAGGACAGGGATATCAAACCCTCTGGAAACACCATATATTTT	CASSQDKDRDIKPSGNTIYF	TRBV4-1	TRBJ1-3
TGTGCTAGTGGTACTCCGATCATATACGAGCAGTACTTC	CASGTPIIYEQYF	TRBV12-5	TRBJ2-7
TGTGCCAGCTCACGGGGTTCGGGATTTGGCTACACCTTC	CASSRGSGFGYTF	TRBV18	TRBJ1-2
TGTGCCAGCAGCTGTAGGGGAGGAAAAGGGGGAGGGTTAAGCCTGAGAAACACCATATATTTT	CASSCRGGKGGGLSLRNTIYF	TRBV13	TRBJ1-3
TGTGCCAGCAGCAAGACGGGTAATACCGGGGAGCTGTTTTTT	CASSKTGNTGELFF	TRBV7-3	TRBJ2-2
TGTGCCAGCAGCCTGGGACGCAATCAGCCCCAGCATTTT	CASSLGRNQPQHF	TRBV9	TRBJ1-5
TGTGCCAGCACGGGGTGCAGGGAGGATCAGCCCCAGCATTTT	CASTGCREDQPQHF	TRBV28	TRBJ1-5
TGTGCCACCGGCCCGGACAGGGGGTTTGAAGCTTTCTTT	CATGPDRGFEAFF	TRBV2	TRBJ1-1
TGTGCCAGCAGTTCGAATCAGGCCGTCGGCACAGATACGCAGTATTTT	CASSSNQAVGTDTQYF	TRBV6-1	TRBJ2-3
TGTGCCAGCAGGGAAGACAGGGGCTATGGCTACACCTTC	CASREDRGYGYTF	TRBV6-4	TRBJ1-2
TGTGCCAGCACCTACAGGGGGCGGTATAGCAATCAGCCCCAGCATTTT	CASTYRGRYSNQPQHF	TRBV2	TRBJ1-5
TGTGCCAGCAGTGAATTATGGACTAGCGGGGGTACCTACGAGCAGTACTTC	CASSELWTSGGTYEQYF	TRBV2	TRBJ2-7
TGTGCCAGCAGAAACTGTACCCCACTAGCGGGAGCTAAAACGACCCAGTACTTC	CASRNCTPLAGAKTTQYF	TRBV6-1	TRBJ2-5
TGTGCCAGCAGCCGCGAGGACAGGTGGGAAGAGACCCAGTACTTC	CASSREDRWEETQYF	TRBV13	TRBJ2-5
TGTGCCAGCAGTTCCCGGGCCGACAGGGAGCAGTACTTC	CASSSRADREQYF	TRBV6-3	TRBJ2-7
TGTGCTAGTGGTTTAGTCGGGGACTATGGCTACACCTTC	CASGLVGDYGYTF	TRBV12-5	TRBJ1-2
TGTGCCAGCAGCCCCCGGGGGACAGGGGACCAGCTAGAGACCCAGTACTTC	CASSPRGTGDQLETQYF	TRBV7-4	TRBJ2-5
TGCAGTGCTAGAGATGTTAATCCCCAGACTAGCGGGGACGAGCAGTACTTC	CSARDVNPQTSGDEQYF	TRBV20-1	TRBJ2-7
TGTGCCAGCAAGGCAGTTAACCCGGGCTACACCTTC	CASKAVNPGYTF	TRBV28	TRBJ1-2
TGTGCCAGCAGTTTTAGCGGGAGTCAGTACGAGCAGTACTTC	CASSFSGSQYEQYF	TRBV27	TRBJ2-7
TGTGCCAGCAGTTTCCGAGCGGGGTTCGGGGGTAATTACAATGAGCAGTTCTTC	CASSFRAGFGGNYNEQFF	TRBV28	TRBJ2-1
TGTGCCAGCAGCCCAGGGCCCGCTAACTATGGCTACACCTTC	CASSPGPANYGYTF	TRBV14	TRBJ1-2
TGTGCCAGTCCGGGACAGGGGGCAGCGAATGAGCAGTTCTTC	CASPGQGAANEQFF	TRBV7-7	TRBJ2-1
TGTGCCAGCAGCTTGCAAAGACAGGACCCTGACGAGCAGTACTTC	CASSLQRQDPDEQYF	TRBV5-6	TRBJ2-7
TGTGCCAGCAGCTTAACGATAGGGTACATTCAGTACTTC	CASSLTIGYIQYF	TRBV7-3	TRBJ2-4
TGTGCCAGCAGTGAGTCAAAGCGGGAGGGCCCAGATACGCAGTATTTT	CASSESKREGPDTQYF	TRBV6-4	TRBJ2-3
TGTGCCAGCAGCATTTCGGACCCGGGACTAGCGGGCTCGCAGTATTTT	CASSISDPGLAGSQYF	TRBV13	TRBJ2-3
TGTGCCAGCAGCATGACAGGGGAGCACGGCATCTCCTACAATGAGCAGTTCTTC	CASSMTGEHGISYNEQFF	TRBV7-3	TRBJ2-1
TGTGCCAGTAGTATTTGTCGTCGAGACGGCTACGAGCAGTACTTC	CASSICRRDGYEQYF	TRBV19	TRBJ2-7
TGTGCCAGCAGCCAAGGGTCTTTGATAACTAGCAATCAGCCCCAGCATTTT	CASSQGSLITSNQPQHF	TRBV4-2	TRBJ1-5
TGTGCCAGCAGCGTCGTCAGCGGGAGGGGCTCTGGAAACACCATATATTTT	CASSVVSGRGSGNTIYF	TRBV7-3	TRBJ1-3
TGTGCCAGCAGCTTCTGGGATACGCAGTATTTT	CASSFWDTQYF	TRBV7-4	TRBJ2-3
TGTGCCAGCAGCTGGGTTCGAGTGGGACTAGGGGAGGTGGGTGAGAACACCGGGGAGCTGTTTTTT	CASSWVRVGLGEVGENTGELFF	TRBV7-9	TRBJ2-2
TGTGCCTGGTGTATGGCGTCAGCCTACGAGCAGTACTTC	CAWCMASAYEQYF	TRBV30	TRBJ2-7
TGTGCCAGCAGTGGCCCCCCGGACAGGGCTTGCAATCAGCCCCAGCATTTT	CASSGPPDRACNQPQHF	TRBV6-1	TRBJ1-5
TGCAGTGCTAGGAAGAGGCTCGGGGCGGGGGAAGCTTTCTTT	CSARKRLGAGEAFF	TRBV20-1	TRBJ1-1
TGTGCCAGCAGCAAATCTACCGGGACAGGGGAGGTCCCCGAGCAGTACTTC	CASSKSTGTGEVPEQYF	TRBV7-3	TRBJ2-7
TGTGCCAGCAGTTTACCAGGGGGAGTGGAGACCTACGAGCAGTACTTC	CASSLPGGVETYEQYF	TRBV28	TRBJ2-7
TGTGCCAGCAGCTACCCTCGACAGGGGGCGGTCAACTCTGGGGCCAACGTCCTGACTTTC	CASSYPRQGAVNSGANVLTF	TRBV11-2	TRBJ2-6
TGTGCCAGCAGTCGGCTTTTTGCGGGAGGGCGAAACATTCAGTACTTC	CASSRLFAGGRNIQYF	TRBV6-3	TRBJ2-4
TGCAGTGCTAGAAGCTGGACGGGGAAAAGTGTAAATCAGCCCCAGCATTTT	CSARSWTGKSVNQPQHF	TRBV20-1	TRBJ1-5
TGTGCCAGCTCACCGATGCGGCGCTACGAGCAGTACTTC	CASSPMRRYEQYF	TRBV18	TRBJ2-7
TGTGCCAGCAGTGTCGAGGTCCCAGGGGGCACCGGGGAGCTGTTTTTT	CASSVEVPGGTGELFF	TRBV25-1	TRBJ2-2
TGTGCCAGCAGCCAAGAAGTAACCGGGACTAGCGGGTTGGTGTCGAACACCGGGGAGCTGTTTTTT	CASSQEVTGTSGLVSNTGELFF	TRBV14	TRBJ2-2
TGTGCTAGCAGCCGAGAGCGGACAGGGGGGGCCAGCACAGATACGCAGTATTTT	CASSRERTGGASTDTQYF	TRBV7-7	TRBJ2-3
TGTGCCAGCAGCTGTCCCGTACAGGGACGTTACAATGAGCAGTTCTTC	CASSCPVQGRYNEQFF	TRBV5-6	TRBJ2-1
TGTGCCAGCAGCTCCGGGACAGTGAGGGACTACAATGAGCAGTTCTTC	CASSSGTVRDYNEQFF	TRBV5-6	TRBJ2-1
TGTGCCAGCAGCTGGACTAGCGGAGTCTACGAGCAGTACTTC	CASSWTSGVYEQYF	TRBV5-6	TRBJ2-7
TGTGCCAGCAGTTACAATCGGGGGGTGACAGAGACCCAGTACTTC	CASSYNRGVTETQYF	TRBV6-6	TRBJ2-5
TGTGCCAGCAGCCGAGACCCGCTAACTAGCACAGATACGCAGTATTTT	CASSRDPLTSTDTQYF	TRBV7-3	TRBJ2-3
TGTGCCAGCAGCCAAGAGTTAGGAAGTCAGCCCCAGCATTTT	CASSQELGSQPQHF	TRBV3-1	TRBJ1-5
TGTGCCAGCAGCTTAGAAGATTCCTCCAACGATCACCAGGGGGCAACTGAAGCTTTCTTT	CASSLEDSSNDHQGATEAFF	TRBV7-9	TRBJ1-1
TGTGCCAGCAGCTTATTGCAGGGGGTTGACTTC	CASSLLQGVDF	TRBV5-4	TRBJ2-7
TGTGCCAGTAGTAGGCTAACTGCAGGGGGATCCTACGAGCAGTACTTC	CASSRLTAGGSYEQYF	TRBV19	TRBJ2-7
TGTGCCAGCAGCCTTTTTTACTCCCAGAGAAACGGAATAGCCCCTTATGAGCAGTTCTTC	CASSLFYSQRNGIAPYEQFF	TRBV7-2	TRBJ2-1
TGTGCCAGGTGGAATCCGGGGGTTTCCTACGAGCAGTACTTC	CARWNPGVSYEQYF	TRBV25-1	TRBJ2-7
TGTGCCAGCAGTTTAGCCTCGGAGGGGGAACTAAAACGCTACGAGCAGTACTTC	CASSLASEGELKRYEQYF	TRBV12-3	TRBJ2-7
TGTGCCAGCAGCTCATTTCAGATAGTTATATGCACTGAAGCTTTCTTT	CASSSFQIVICTEAFF	TRBV5-6	TRBJ1-1
TGTGCCAGCAGTGACTCGGAGAGAGGATACACTGAAGCTTTCTTT	CASSDSERGYTEAFF	TRBV6-4	TRBJ1-1
TGTGCCAGCTCACCTCCAGAAGGACAGGGGGACTCTGGAAACACCATATATTTT	CASSPPEGQGDSGNTIYF	TRBV18	TRBJ1-3
TGTGCCTGGAGGCCGGCTTATCACTCACCCCTCCACTTT	CAWRPAYHSPLHF	TRBV30	TRBJ1-6
