TGTGCCAGCAGCGGATGGTCCCGGGGGCCCCAGACCGGGGAGCTGTTTTTT	CASSGWSRGPQTGELFF	TRBV11-2	TRBJ2-2
TGTGCCAGCAGTTACTACAAGGAGGGACAGGGGGTTGAAAAACTGTTTTTT	CASSYYKEGQGVEKLFF	TRBV6-5	TRBJ1-4
TGTGCCAGCAGTTTCTCCCCTTGTAGCGGGAAGTTCACAGATACGCAGTATTTT	CASSFSPCSGKFTDTQYF	TRBV27	TRBJ2-3
TGTGCCAGCAGTCTGTCCGAGAGGTTAGGGAATGAAAAACTGTTTTTT	CASSLSERLGNEKLFF	TRBV6-5	TRBJ1-4
TGTGCCAGCAGCTTACGCGTCAGGGGGGGCTACACCTTC	CASSLRVRGGYTF	TRBV7-8	TRBJ1-2
TGTGCCAGCAGCTTGCGGGACAGGGGTCGGAATCAGCCCCAGCATTTT	CASSLRDRGRNQPQHF	TRBV5-6	TRBJ1-5
TGTGCCAGCAGCTCGGAGGCGCCGGGTGGCTACACCTTC	CASSSEAPGGYTF	TRBV5-4	TRBJ1-2
TGTGCCAGCAGTGGACATGGGGTTGGGGGCGCTAATGAAAAACTGTTTTTT	CASSGHGVGGANEKLFF	TRBV6-5	TRBJ1-4
TGTGCCAGCAGCGACCGACGCTACGTCTTGGACACTGAAGCTTTCTTT	CASSDRRYVLDTEAFF	TRBV5-6	TRBJ1-1
TGTGCCAGCAGCTCCTCAACCGCGGGAGGACTGACCCAGTACTTC	CASSSSTAGGLTQYF	TRBV11-2	TRBJ2-5
TGTGCCAGCAGCACTCCGGGGTACGGAAACACCATATATTTT	CASSTPGYGNTIYF	TRBV13	TRBJ1-3
TGTGCCATCAGTGCTAGCGGAACAGATACGCAGTATTTT	CAISASGTDTQYF	TRBV10-3	TRBJ2-3
TGTGCCAGCAGCCCTAGACTAGCGGGGACGGAAATCTACAATGAGCAGTTCTTC	CASSPRLAGTEIYNEQFF	TRBV14	TRBJ2-1
TGTGCCACCAGTGATTTTAACCTAGCGGGTTCCTACAATGAGCAGTTCTTC	CATSDFNLAGSYNEQFF	TRBV24-1	TRBJ2-1
TGTGCCAGCAGCCTAGGGGGCTGTGGAAACACCATATATTTT	CASSLGGCGNTIYF	TRBV13	TRBJ1-3
TGTGCCAGTCCGAGGGGCCCGGCCTGGACGAACACTGAAGCTTTCTTT	CASPRGPAWTNTEAFF	TRBV19	TRBJ1-1
TGTGCCATGGGGGACAGGGTCGGCCGGAACACTGAAGCTTTCTTT	CAMGDRVGRNTEAFF	TRBV19	TRBJ1-1
TGTGCCAGACGGCCTAGAGCTTTCTTT	CARRPRAFF	TRBV7-9	TRBJ1-1
TGTGCCCTATCGGACGCCGATGGCTACACCTTC	CALSDADGYTF	TRBV19	TRBJ1-2
TGTGCCAGCAGCGAGGGGGCGGGTATCTACACTGAAGCTTTCTTT	CASSEGAGIYTEAFF	TRBV7-4	TRBJ1-1
TGTGCCAGCAGTAGAGGGGGCCAGAGTCAGGCGAATCAGCCCCAGCATTTT	CASSRGGQSQANQPQHF	TRBV27	TRBJ1-5
TGCAGTGCTAGAGCCGTGAGGGGGGGGGCACCCGAGACCCAGTACTTC	CSARAVRGGAPETQYF	TRBV20-1	TRBJ2-5
TGTGCCAGCAGCCCGTCCACCCGGGGTAATAACTCCTACGAGCAGTACTTC	CASSPSTRGNNSYEQYF	TRBV27	TRBJ2-7
TGTGCCAGCAGCTTCGAAGCCCCCTGGTGCACCGGGGAGCTGTTTTTT	CASSFEAPWCTGELFF	TRBV11-3	TRBJ2-2
TGCGCCAGCAGCTTGCGGTTTCTCAAGCAATGCTACGAGCAGTACTTC	CASSLRFLKQCYEQYF	TRBV5-1	TRBJ2-7
TGCGGATCACCAAGCACAGATACGCAGTATTTT	CGSPSTDTQYF	TRBV20-1	TRBJ2-3
TGTGCCAGCAGCTTTGGGGGGGGCCAAGAGACCCAGTACTTC	CASSFGGGQETQYF	TRBV7-9	TRBJ2-5
TGTGCCAGCAGTTTCGATATAAATGACTATGGCTACACCTTC	CASSFDINDYGYTF	TRBV27	TRBJ1-2
TGTGCCAGCAGCCAGAGTGGCCGCCATAAGGCGAACCGACTTTATGGCTACACCTTC	CASSQSGRHKANRLYGYTF	TRBV14	TRBJ1-2
TGCGCCAGCGAGGACCTTAATTCACCCCTCCACTTT	CASEDLNSPLHF	TRBV4-3	TRBJ1-6
TGTGCCAGCAGCTCCCCGGGGGGGGGTATCTACAATGAGCAGTTCTTC	CASSSPGGGIYNEQFF	TRBV11-2	TRBJ2-1
TGCAGTGCTAGACACTCGAGGGGCATGAACACTGAAGCTTTCTTT	CSARHSRGMNTEAFF	TRBV20-1	TRBJ1-1
TGTGCCAGCAGCGATGGGGTCCGGGAGGCTGGGGCCAACGTCCTGACTTTC	CASSDGVREAGANVLTF	TRBV13	TRBJ2-6
TGTGCCAGCAGACCTTTCCGCCAACCGGAGGGTGAGAGCTCCTACAATGAGCAGTTCTTC	CASRPFRQPEGESSYNEQFF	TRBV27	TRBJ2-1
TGCGCCAGCAGCTGGTGTATACCGGGGGGGTTCCAAGAGACCCAGTACTTC	CASSWCIPGGFQETQYF	TRBV5-1	TRBJ2-5
TGTGCCAGCAGCTTACCGGGACATGGAGAGACCCAGTACTTC	CASSLPGHGETQYF	TRBV28	TRBJ2-5
TGCGCCAGCAGCCTAGCGGGTTACGAGCAGTACTTC	CASSLAGYEQYF	TRBV5-1	TRBJ2-7
TGTGCCAGCAGCTGGGTCTCCCTCGGGGAGCTGTTTTTT	CASSWVSLGELFF	TRBV7-9	TRBJ2-2
TGTGCCAGCAGCCCGCCCCGGGTTAGCTACGAGCAGTACTTC	CASSPPRVSYEQYF	TRBV5-6	TRBJ2-7
TGTGCCAGAGATTTGGACAGGGGTGCACAGTCAGATACGCAGTATTTT	CARDLDRGAQSDTQYF	TRBV3-1	TRBJ2-3
TGTGCCAGCAGCCAAGGTCAGGGGGGGGAGACCCAGTACTTC	CASSQGQGGETQYF	TRBV4-2	TRBJ2-5
TGTGCCAGCAGTGACAATATAACTAGCAATGAGCAGTTCTTC	CASSDNITSNEQFF	TRBV6-4	TRBJ2-1
TGTGCCAGCAGAAACAGGGCTAGGGACAATGAGCAGTTCTTC	CASRNRARDNEQFF	TRBV2	TRBJ2-1
TGTGCCAGCAGCTTGCGGTCGTGGCCGGGACGGGGCTGCAATCAGCCCCAGCATTTT	CASSLRSWPGRGCNQPQHF	TRBV5-4	TRBJ1-5
TGTGCCAGCAGACTAGCGGCTGATACGCAGTATTTT	CASRLAADTQYF	TRBV6-1	TRBJ2-3
TGTGCCAGTCCCTATCCAGTCTCTGGGGCCAACGTCCTGACTTTC	CASPYPVSGANVLTF	TRBV19	TRBJ2-6
TGCAGAAGCAGTAGGGCCAAGACCTACGAGCAGTACTTC	CRSSRAKTYEQYF	TRBV20-1	TRBJ2-7
TGTGCTAGTGGTTTGCGTAGAACACCGGAGTTAGCTTTCTTT	CASGLRRTPELAFF	TRBV12-5	TRBJ1-1
TGTGCCAGCAGTGTACTTCTCGTCTACGAGCAGTACTTC	CASSVLLVYEQYF	TRBV27	TRBJ2-7
TGTGCCAGCAGCGTCTGGGGGCGGAGGGTCGGGGGAGAAAAACTGTTTTTT	CASSVWGRRVGGEKLFF	TRBV9	TRBJ1-4
TGTGCCAGCAGTTTTCCGGCGGAGGGGGCCAACGTCCTGACTTTC	CASSFPAEGANVLTF	TRBV28	TRBJ2-6
TGTGCCACCAGCCTCCCGGGACTAGCGGGAGTGAGGCAAGAGACCCAGTACTTC	CATSLPGLAGVRQETQYF	TRBV15	TRBJ2-5
TGTGCTAGAAAAGAGGGACGGGCGGAGACCCAGTACTTC	CARKEGRAETQYF	TRBV12-5	TRBJ2-5
TGTGCCATGGTCCATTGTAGGGCGGACCCGAAATGGGAGCTGTTTTTT	CAMVHCRADPKWELFF	TRBV10-3	TRBJ2-2
TGTGCCAGCAGCCTTGGGGGCCGGCGGACTGAAGCTTTCTTT	CASSLGGRRTEAFF	TRBV11-2	TRBJ1-1
TGTGCTAGTGGGGGGACAGGGGTGAACACTGAAGCTTTCTTT	CASGGTGVNTEAFF	TRBV12-5	TRBJ1-1
TGTGCCAGCAGCCAAGACGTGAGGTTTAAGACCGGGGAGCTGTTTTTT	CASSQDVRFKTGELFF	TRBV9	TRBJ2-2
TGTGCCAGCAGCTTTGTTTTATTCTCCACTGAAGCTTTCTTT	CASSFVLFSTEAFF	TRBV11-2	TRBJ1-1
TGCGCCAGCAGCTGGGGGACTAACACCGGGGAGCTGTTTTTT	CASSWGTNTGELFF	TRBV5-1	TRBJ2-2
TGCAGTGCGGAGGGGGGGCGACCCCAAGAGACCCAGTACTTC	CSAEGGRPQETQYF	TRBV20-1	TRBJ2-5
TGCGCCATCTCCCAGACAGGGTGTTTTCAGCCCCAGCATTTT	CAISQTGCFQPQHF	TRBV10-1	TRBJ1-5
TGTGCCAGCAGTGCCTTTCTAGCGGGGAAAGATGAAGAAAACAATGAGCAGTTCTTC	CASSAFLAGKDEENNEQFF	TRBV6-5	TRBJ2-1
TGTGCCAGCAGCGGATTTAGGGCCGAGATGTACAATGAGCAGTTCTTC	CASSGFRAEMYNEQFF	TRBV13	TRBJ2-1
TGTGCCAGCAGGGACGGGGGAACTAGGTCCTACGAGCAGTACTTC	CASRDGGTRSYEQYF	TRBV6-8	TRBJ2-7
TGTGCCAGCAGAATGGGACTAGCGGGCAAAGAGACCCAGTACTTC	CASRMGLAGKETQYF	TRBV12-3	TRBJ2-5
TGCCCCCGTCGGGACGATCCTGTGTTAACGCCTCGACAGCCCCAGCATTTT	CPRRDDPVLTPRQPQHF	TRBV20-1	TRBJ1-5
TGTGCCAGCAGTTTAGCTGGAAAAACGGGGGCTTTTTTGAACACTGAAGCTTTCTTT	CASSLAGKTGAFLNTEAFF	TRBV28	TRBJ1-1
TGTGCCAGCAGATTCGGAGGGCAGGTGGGTGACTACGAGCAGTACTTC	CASRFGGQVGDYEQYF	TRBV6-5	TRBJ2-7
TGTGCCAGCAGTTATGGACCGGTCGACGGCTGGTATGGCTACACCTTC	CASSYGPVDGWYGYTF	TRBV6-6	TRBJ1-2
TGCGCCAGACCTATTGAGGGGGAAAGCACTGAAGCTTTCTTT	CARPIEGESTEAFF	TRBV10-1	TRBJ1-1
TGTGCCAGCAGCTACGTTTCTCCGGGACAGGGGGTTACGACCCCTGGCTACACCTTC	CASSYVSPGQGVTTPGYTF	TRBV7-9	TRBJ1-2
TGTGCCAGTATGGGGCTTGGGACCCAGTACTTC	CASMGLGTQYF	TRBV19	TRBJ2-5
TGCGCCAGCAGCCAAGCGGGAGGCTCTGGGGCCAACGTCCTGACTTTC	CASSQAGGSGANVLTF	TRBV4-1	TRBJ2-6
TGTGCCAGCAGTTTAGGAGAGCCGGGGACAGGGGGCTGGGGGGGGAACACTGAAGCTTTCTTT	CASSLGEPGTGGWGGNTEAFF	TRBV12-4	TRBJ1-1
TGTGCCACCTTTGGGACAGTTCCACTCACGGCGGACACCGGGGAGCTGTTTTTT	CATFGTVPLTADTGELFF	TRBV24-1	TRBJ2-2
TGTGCCCCGAACAGGGGGCAGGGCAATGAAAAACTGTTTTTT	CAPNRGQGNEKLFF	TRBV30	TRBJ1-4
TGTGCCAGCAGTTTTTTGAGGACTAATCAGCCCCAGCATTTT	CASSFLRTNQPQHF	TRBV28	TRBJ1-5
TGTGCCAGCAGTTCCCCGGAACTAGACTACGAGCAGTACTTC	CASSSPELDYEQYF	TRBV27	TRBJ2-7
TGTGCCAGCAGCCGGACGGGACAGGGGTCCTCTGAAGCTTTCTTT	CASSRTGQGSSEAFF	TRBV13	TRBJ1-1
TGTGCCAGCAGTTACTCACCCAGGGTTCCTGAAGCTTTCTTT	CASSYSPRVPEAFF	TRBV6-5	TRBJ1-1
TGTGCCAGCAGTTGCCAGAGGGTAGGCTACACCTTC	CASSCQRVGYTF	TRBV6-3	TRBJ1-2
TGTGCCAGCAGGACGGAATCCTACGAGCAGTACTTC	CASRTESYEQYF	TRBV2	TRBJ2-7
TGTGCCTGGAGTTCGGGTTCAAAACAGGACACTGAAGCTTTCTTT	CAWSSGSKQDTEAFF	TRBV30	TRBJ1-1
TGTGCCACCGAATCGAGCCAAGACAGGCTCGGGGCGACTAACTATGGCTACACCTTC	CATESSQDRLGATNYGYTF	TRBV15	TRBJ1-2
TGCGCCAGCAGGGACGACACAACTGAAGCTTTCTTT	CASRDDTTEAFF	TRBV10-2	TRBJ1-1
TGCGCCAGCAGCCAAGATTTGGGACAGGGGCGGAACACCATATATTTT	CASSQDLGQGRNTIYF	TRBV4-1	TRBJ1-3
TGCGCCAGCAGCCAAGCCTTGTTACCGGGACAGGGAGAGACCCAGTACTTC	CASSQALLPGQGETQYF	TRBV4-1	TRBJ2-5
TGTGCCAGCAGTGTCCTCCTCCCCAGGAGGGAGCATCAGCCCCAGCATTTT	CASSVLLPRREHQPQHF	TRBV27	TRBJ1-5
TGTGCCAGCAGTCCCTACAGAGAGGGGACACGGGGCTACGAGCAGTACTTC	CASSPYREGTRGYEQYF	TRBV25-1	TRBJ2-7
TGTGCCAGCAGTGGAGTTACGGACAGCCTGGATTGCCAAGAGACCCAGTACTTC	CASSGVTDSLDCQETQYF	TRBV6-1	TRBJ2-5
TGTGCCAGTAGTATAGGACGGGGTGACTACGAGCAGTACTTC	CASSIGRGDYEQYF	TRBV19	TRBJ2-7
TGCGCCAGCAAGGGCGGGAGTCGCCCCCGTATGAACACTGAAGCTTTCTTT	CASKGGSRPRMNTEAFF	TRBV10-1	TRBJ1-1
TGTGCCACTCTACACTCCGAAAAACTGTTTTTT	CATLHSEKLFF	TRBV13	TRBJ1-4
TGTGCCAGCAGCGGCGGACAGCCCCATGAGCAGTTCTTC	CASSGGQPHEQFF	TRBV9	TRBJ2-1
TGTGCCACCTTCATAGGCACCCAAAATTCACCCCTCCACTTT	CATFIGTQNSPLHF	TRBV24-1	TRBJ1-6
TGTGCCAGCAGTCCGCTAGCGGGAGCCTACAATGAGCAGTTCTTC	CASSPLAGAYNEQFF	TRBV6-1	TRBJ2-1
TGTGCCAGCGCAGACCCCGACATCCTGAACACTGAAGCTTTCTTT	CASADPDILNTEAFF	TRBV25-1	TRBJ1-1
TGTGCCAGCAGCTTAGTTTACCAGGGGGCTCAGCCCCAGCATTTT	CASSLVYQGAQPQHF	TRBV7-2	TRBJ1-5
TGCAGTGCTCGGACATCCTACGAGCAGTACTTC	CSARTSYEQYF	TRBV20-1	TRBJ2-7
TGTGCCAGCAGTTACCAATTGCTGCGAAACGTCCTGACTTTC	CASSYQLLRNVLTF	TRBV6-5	TRBJ2-6
TGTGCCAGCAGCCAGAGTCAGCATAGCGAGCAGTACTTC	CASSQSQHSEQYF	TRBV7-3	TRBJ2-7
TGTGCCATCAGTGAAGACCATAGCGGGGGTTTCTACGAGCAGTACTTC	CAISEDHSGGFYEQYF	TRBV10-3	TRBJ2-7
TGTGCCAGCAGCCAAGAGGAGTCGGAGCAGTACTTC	CASSQEESEQYF	TRBV14	TRBJ2-7
TGTGCCAGCAGTGAACCTGGACAAGAGACCCAGTACTTC	CASSEPGQETQYF	TRBV25-1	TRBJ2-5
TGTGCCAGTAGGGGGCTGAACACTGAAGCTTTCTTT	CASRGLNTEAFF	TRBV19	TRBJ1-1
TGTGCCAGCAAACCGGGACCAGAGAGCACAGATACGCAGTATTTT	CASKPGPESTDTQYF	TRBV7-9	TRBJ2-3
TGTGCCAGCAGCAAGGATACTAGCGGGAGCAGGAATCAGCCCCAGCATTTT	CASSKDTSGSRNQPQHF	TRBV13	TRBJ1-5
TGTGCCAGCAGTTGGGGGCCAGATTACGTTGAAAAACTGTTTTTT	CASSWGPDYVEKLFF	TRBV28	TRBJ1-4
TGCAGCGTTATGGACTGTAGGGATGGCTACACCTTC	CSVMDCRDGYTF	TRBV29-1	TRBJ1-2
TGTGCCAGCAGCCTAAATGGGCCCGAAAAACTGTTTTTT	CASSLNGPEKLFF	TRBV5-5	TRBJ1-4
TGTGACCCTGGGGGGGCCAATGAGCAGTTCTTC	CDPGGANEQFF	TRBV24-1	TRBJ2-1
TGTGCCAGCAGCTTTCGTCTCCCAACCGGGTGTATATCTAGCACAGATACGCAGTATTTT	CASSFRLPTGCISSTDTQYF	TRBV5-8	TRBJ2-3
TGTGCCATCAGTGAGTCAAGCCAGGATGGGGCTTTCTTT	CAISESSQDGAFF	TRBV10-3	TRBJ1-1
TGTGCCGAGGTCGCGGTCAATGAGCAGTTCTTC	CAEVAVNEQFF	TRBV14	TRBJ2-1
TGTGCCAGCAGCGGGGGTAGGGAGCAGTACTTC	CASSGGREQYF	TRBV6-5	TRBJ2-7
TGTGCCAGCAGTTACTCTAGCGGGGGAATCGGGACAGATACGCAGTATTTT	CASSYSSGGIGTDTQYF	TRBV6-5	TRBJ2-3
TGTGCCTCGGGACGCTGCTACGAGCAGTACTTC	CASGRCYEQYF	TRBV27	TRBJ2-7
TGTGCCAGCAGTGATTCCGTTCAGGGTGTTCTGTCCGGGGAGCTGTTTTTT	CASSDSVQGVLSGELFF	TRBV6-1	TRBJ2-2
TGTGCCAGCAGCTCCCCCGGAGGGCAGGCTTCTCATACGCAGTATTTT	CASSSPGGQASHTQYF	TRBV5-4	TRBJ2-3
TGTGCCAGCAGCGTCGGACAGGGGGAAGCCTGTGGCTACACCTTC	CASSVGQGEACGYTF	TRBV7-9	TRBJ1-2
TGTGCTACCGATTGCCCTGGGGCCAACGTCCTGACTTTC	CATDCPGANVLTF	TRBV12-5	TRBJ2-6
TGTGCCAGCAGCGCAGGGGTTTTGGCCTTGACAGGAGGCTCACCCCTCCACTTT	CASSAGVLALTGGSPLHF	TRBV9	TRBJ1-6
TGTGCCAGCAGTAGGCCGGAACCTCGAACAGATACGCAGTATTTT	CASSRPEPRTDTQYF	TRBV6-6	TRBJ2-3
TGTGCCAGCAGCCCCGGGACAGGACAGGGCTTCCGATGCTATGGCTACACCTTC	CASSPGTGQGFRCYGYTF	TRBV7-3	TRBJ1-2
TGTGCCAGCAGCAAGTTACTTGGGTCAAGTTCCTACGAGCAGTACTTC	CASSKLLGSSSYEQYF	TRBV5-5	TRBJ2-7
TGTGCCAGCAGAGCCCCAGGTCTGGGACGACTCTACGAGCAGTACTTC	CASRAPGLGRLYEQYF	TRBV6-4	TRBJ2-7
TGTGCCAGCAGCCCGGGACTTTCAATTCACACCGGGGAGCTGTTTTTT	CASSPGLSIHTGELFF	TRBV14	TRBJ2-2
TGTGCCAGCAGTTACTCGAGGGGGACCCACGAGCAGTACTTC	CASSYSRGTHEQYF	TRBV6-5	TRBJ2-7
TGTGCCAGTATAGGGACAGGAAGGGGCAATCAGCCCCAGCATTTT	CASIGTGRGNQPQHF	TRBV19	TRBJ1-5
TGTGCCTGGATGGACACTTGCAACACCGGGGAGCTGTTTTTT	CAWMDTCNTGELFF	TRBV30	TRBJ2-2
TGTGCCATCAGTGCCACGACAACGGAGCTGTTTTTT	CAISATTTELFF	TRBV10-3	TRBJ2-2
TGTGCCAGCAGCGTAGGGAGGCCCCCGGTGGCTGAAGCCGGGTCCTCTAACTATGGCTACACCTTC	CASSVGRPPVAEAGSSNYGYTF	TRBV9	TRBJ1-2
TGTGCCAGCAGCCAAGGAGGGGCGTTCACCTTC	CASSQGGAFTF	TRBV3-1	TRBJ1-2
TGTGCCCCGACCGGACAGCAGGAAAAACTGTTTTTT	CAPTGQQEKLFF	TRBV25-1	TRBJ1-4
TGCGCCAGCAGTCAAGGGACAGGGCGAAGGCGAACTGAAGCTTTCTTT	CASSQGTGRRRTEAFF	TRBV10-1	TRBJ1-1
TGTGCCAGCAGTTACTCGGGATGGGGCGGGGGGGAATTAGCGAACACCGGGGAGCTGTTTTTT	CASSYSGWGGGELANTGELFF	TRBV6-3	TRBJ2-2
TGTGCCAGCAGCGCGAGGACAGCCGGGGAGCTGTTTTTT	CASSARTAGELFF	TRBV7-6	TRBJ2-2
TGTGCCAGCTCACCCAGGGGGGGCACAGATACGCAGTATTTT	CASSPRGGTDTQYF	TRBV18	TRBJ2-3
TGTGCCAGAAAGTCGGAGGGGGGGGTCAGCAATCAGCCCCAGCATTTT	CARKSEGGVSNQPQHF	TRBV27	TRBJ1-5
TGTGCCGGGTGGCGGACAGGGTCGCAGCCCCAGCATTTT	CAGWRTGSQPQHF	TRBV19	TRBJ1-5
TGCGCCAGCAGATACCTGCCGGGACAGGGGAGGCAGTACTTC	CASRYLPGQGRQYF	TRBV4-1	TRBJ2-5
TGTGCCAGCAGTTACGGCAGGGGGCCGGCCCAGTACTTC	CASSYGRGPAQYF	TRBV6-5	TRBJ2-5
TGTGCCAGCAGCCAAGGGAAAGAGACCCAGTACTTC	CASSQGKETQYF	TRBV14	TRBJ2-5
TGTGCCAGCAATTGCAGAAACAGGGCACTTAACTCTGGAAACACCATATATTTT	CASNCRNRALNSGNTIYF	TRBV6-2	TRBJ1-3
TGTGCCAGCAGCACCCACGGAGCGGCCGTCTACGAGCAGTACTTC	CASSTHGAAVYEQYF	TRBV13	TRBJ2-7
TGCGCCAGCAGCCAAGATCTACGAAATAGGACAGGCCGGTTCTACGAGCAGTACTTC	CASSQDLRNRTGRFYEQYF	TRBV4-1	TRBJ2-7
TGTGCCAGCAGCGTAGCAGGGACTAGCGGGCACAAGTACGAGCAGTACTTC	CASSVAGTSGHKYEQYF	TRBV9	TRBJ2-7
TGTGCCAGGACGGGGGGGCCGCCCTACGAGCAGTACTTC	CARTGGPPYEQYF	TRBV27	TRBJ2-7
TGTCCCCCGGGCCCGGCGTACTTC	CPPGPAYF	TRBV6-5	TRBJ2-4
TGCAGCGTTGACGGGCCGGGCTATGGCTACACCTTC	CSVDGPGYGYTF	TRBV29-1	TRBJ1-2
TGTGCCAGCAGCTCGACTAGCGGGGGGGCATCCACCGGGGAGCTGTTTTTT	CASSSTSGGASTGELFF	TRBV5-5	TRBJ2-2
TGTGCCACCAGTGATTACCCAGGGGGTCAGCCCCAGCATTTT	CATSDYPGGQPQHF	TRBV24-1	TRBJ1-5
TGTGCCAGCAGTTTAGGTGTTAAGGCCTACGAGCAGTACTTC	CASSLGVKAYEQYF	TRBV12-4	TRBJ2-7
TGCGCCAGCAGCCATCACCCAGGGGGGGAGACCCAGTACTTC	CASSHHPGGETQYF	TRBV4-1	TRBJ2-5
TGTGACCGTCCGTCTGGCAATCAGCCCCAGCATTTT	CDRPSGNQPQHF	TRBV28	TRBJ1-5
TGTGCCAGCAGCTCAGAGGTCGGGACAGGGTTAGCAGTGGAGTATGGCTACACCTTC	CASSSEVGTGLAVEYGYTF	TRBV7-9	TRBJ1-2
TGTGCCACCAGCAGAGCTTCTTTGGGACATGGCTACACCTTC	CATSRASLGHGYTF	TRBV15	TRBJ1-2
TGTGCCAGCAGCGTAGGACGTTGTGGCTACGAGCAGTACTTC	CASSVGRCGYEQYF	TRBV9	TRBJ2-7
TGTGCCAGCAGTTCCACGGGGGGGTGCACAGATACGCAGTATTTT	CASSSTGGCTDTQYF	TRBV7-7	TRBJ2-3
TGTGCCAGCAGCGGGGTTCCGGGACAGGGGCCCTACGAGCAGTACTTC	CASSGVPGQGPYEQYF	TRBV11-2	TRBJ2-7
TGTGCCAGCACGGTTTCCCAGGTTCAGCCCCAGCATTTT	CASTVSQVQPQHF	TRBV6-4	TRBJ1-5
TGTGCGCCTCCTCGGATCTTCTCCGCCGATTCACCCCTCCACTTT	CAPPRIFSADSPLHF	TRBV24-1	TRBJ1-6
TGCGCCAGCAGCTTGGGGTTTGGGGGGCTCAATACGCAGTATTTT	CASSLGFGGLNTQYF	TRBV5-1	TRBJ2-3
TGTGCCTGGATCCAGGGGAACGAGCAGTACTTC	CAWIQGNEQYF	TRBV30	TRBJ2-7
TGCAGTGCGTGGCAGAAGTTTAACTATGGCTACACCTTC	CSAWQKFNYGYTF	TRBV20-1	TRBJ1-2
TGTGCCAGCAGCCCGGGGGACTACCGTGGCTACACCTTC	CASSPGDYRGYTF	TRBV7-9	TRBJ1-2
TGTGCCAGCAGTGAAATACGACTAGCGGTAAGTAAATCGAGCACAGATACGCAGTATTTT	CASSEIRLAVSKSSTDTQYF	TRBV6-1	TRBJ2-3
TGCAGTGCTAGTAAGGGGGACGAAGAAAAACTGTTTTTT	CSASKGDEEKLFF	TRBV20-1	TRBJ1-4
TGTGCCAGCAGCCAAGACATAAGGGGACGCAATCAGCCCCAGCATTTT	CASSQDIRGRNQPQHF	TRBV3-1	TRBJ1-5
TGCGCCAGCAGCCAGAGCCGCGGAATGTCAGATACGCAGTATTTT	CASSQSRGMSDTQYF	TRBV4-1	TRBJ2-3
TGTGCCAGCAGCGGTGGAGACACTGGGCGAGAGACCCAGTACTTC	CASSGGDTGRETQYF	TRBV7-4	TRBJ2-5
TGTGCCAGCAGCTTACCTCAGCTGACAGATACGCAGTATTTT	CASSLPQLTDTQYF	TRBV7-9	TRBJ2-3
TGTGCCAGCAGCATCGACCCGGGACAGGGTACAGATACGCAGTATTTT	CASSIDPGQGTDTQYF	TRBV12-3	TRBJ2-3
TGCAGTGCTAGGATCCAGGACAGGGATGGGGTCTCCTACGAGCAGTACTTC	CSARIQDRDGVSYEQYF	TRBV20-1	TRBJ2-7
TGTGCCAGCAGCCCGACGAAGAGAACACTAGCGGGAGGGCCCTACGAGCAGTACTTC	CASSPTKRTLAGGPYEQYF	TRBV7-4	TRBJ2-7
TGTGCCAGCAGCGGCCGTCCCAGGGTCGATACGCAGTATTTT	CASSGRPRVDTQYF	TRBV9	TRBJ2-3
TGTGCCAGCAGCAGACAATCACCCCTCCACTTT	CASSRQSPLHF	TRBV28	TRBJ1-6
TGTGCCAGCAGCCCACCCACCAGGGACAGGGGGCCGCGAGAGCAAGAGACCCAGTACTTC	CASSPPTRDRGPREQETQYF	TRBV7-3	TRBJ2-5
TGTGCCATCGTTTTAGACTGGGGACATGGACAACGCTGTGAGCAGTTCTTC	CAIVLDWGHGQRCEQFF	TRBV10-3	TRBJ2-1
TGTGCCAGCAGCGGGGGGGGGGGCGAGACCCAGTACTTC	CASSGGGGETQYF	TRBV7-3	TRBJ2-5
TGTGCCAGTAGTATATCACCGAGGGACAGGGGGCATTCACCCCTCCACTTT	CASSISPRDRGHSPLHF	TRBV19	TRBJ1-6
TGTGCCAGCAGCCGCCTGGGCAATGAGCAGTTCTTC	CASSRLGNEQFF	TRBV7-9	TRBJ2-1
TGTGCCAGCAGGGAGAGACGAGAAAAACTGTTTTTT	CASRERREKLFF	TRBV6-8	TRBJ1-4
TGTGCCAGCAGCCAGCGGACAGGCCCCTACGAGCAGTACTTC	CASSQRTGPYEQYF	TRBV3-1	TRBJ2-7
TGCGCCAGCAGTGCCCTAGGGAGGGGGCCAGCCAAAAACATTCAGTACTTC	CASSALGRGPAKNIQYF	TRBV10-1	TRBJ2-4
TGCGCCAGCAGTTTTCCGCGACTAGCGGGGGGTAGGTCCGGGGAGCTGTTTTTT	CASSFPRLAGGRSGELFF	TRBV10-1	TRBJ2-2
TGCGCCAGCACCCGGGGTCAGCCCCAGCATTTT	CASTRGQPQHF	TRBV10-1	TRBJ1-5
TGTGCCAGCAGCCCGGCAGTCCGGGGGTACGAGCAGTACTTC	CASSPAVRGYEQYF	TRBV4-2	TRBJ2-7
TGTGCCAGCACGTTGGCCCCGTACCAAGAGACCCAGTACTTC	CASTLAPYQETQYF	TRBV27	TRBJ2-5
TGTGCCAGCAGCTTACCGCCTGTCCCCGGACTAGCGGGGAACCGGCGCCCCTACGAGCAGTACTTC	CASSLPPVPGLAGNRRPYEQYF	TRBV7-2	TRBJ2-7
TGTGCCTGGAGACCCCCCGGGACAGGGGACCGAAACGGTTATGGCTACACCTTC	CAWRPPGTGDRNGYGYTF	TRBV30	TRBJ1-2
TGCGCCAGCAGCTTGGCCCCCAAACGGGTAGACGAGCAGTACTTC	CASSLAPKRVDEQYF	TRBV5-1	TRBJ2-7
TGTGCCACCAGCAGAGATTCGGGGGCGGGCCCGCTCGAGCAGTACTTC	CATSRDSGAGPLEQYF	TRBV15	TRBJ2-7
TGTGCCAGCAGTTACTCGATTCCGCAGTCTCGAAAGGGGGGGGGTCACGAGCAGTACTTC	CASSYSIPQSRKGGGHEQYF	TRBV6-5	TRBJ2-7
TGTGCCAGCTCACCTGGGGGACAGGGGGCAGAATATTTTAGCTCCTACGAGCAGTACTTC	CASSPGGQGAEYFSSYEQYF	TRBV18	TRBJ2-7
TGCAGTGCTAGCGCGGCTGAAACAGGGGCAACTAATGAAAAACTGTTTTTT	CSASAAETGATNEKLFF	TRBV20-1	TRBJ1-4
TGTGCCAGCAGTGAAAACATGACGGACGGAGAGACCCAGTACTTC	CASSENMTDGETQYF	TRBV2	TRBJ2-5
TGCGCCAGCAGCTTGCTAGCACGGGCCCGGGCCGGGGAGCTGTTTTTT	CASSLLARARAGELFF	TRBV5-1	TRBJ2-2
TGTGCCAGCAGCCAAGATCGGCATAGGACAGGGGGCGCCAGCTACGAGCAGTACTTC	CASSQDRHRTGGASYEQYF	TRBV4-2	TRBJ2-7
TGTGCCCAGGGGAACACTGAAGCTTTCTTT	CAQGNTEAFF	TRBV28	TRBJ1-1
TGTGCCAGCAGTAGCTCCTACGAGCAGTACTTC	CASSSSYEQYF	TRBV7-2	TRBJ2-7
TGCAGTACATCAGGGAAGCCCGCGAACACCGGGGAGCTGTTTTTT	CSTSGKPANTGELFF	TRBV20-1	TRBJ2-2
TGCAGCGTTGAAGTGGGGGGGGGCGAGCAGTACTTC	CSVEVGGGEQYF	TRBV29-1	TRBJ2-7
TGTGCCAGCAGCTTTATCGGGGGATACAATGAGCAGTTCTTC	CASSFIGGYNEQFF	TRBV5-6	TRBJ2-1
TGTGCCAGCAGCCGAGGACAGCAGCCCCAGCATTTT	CASSRGQQPQHF	TRBV13	TRBJ1-5
TGCAGCGTTGTGGGACAGGGACAAGACACTGAAGCTTTCTTT	CSVVGQGQDTEAFF	TRBV29-1	TRBJ1-1
TGTGCCAGCAGTTCCGCCGGGACTAGGTCTCTCGGGGAGCTGTTTTTT	CASSSAGTRSLGELFF	TRBV6-1	TRBJ2-2
TGTGCCAGCAGCGAGAATCCCTACAGGGCTTTGACCTACGAGCAGTACTTC	CASSENPYRALTYEQYF	TRBV9	TRBJ2-7
TGTGCCATACGCGGAAGCTATGGCTACACCTTC	CAIRGSYGYTF	TRBV10-3	TRBJ1-2
TGTGCCAGCAGCAGGAACGGGACCCATAATCAGCCCCAGCATTTT	CASSRNGTHNQPQHF	TRBV13	TRBJ1-5
TGTGCCAGCAAGGAACCCCTGGAACGACCTTCACCCCTCCACTTT	CASKEPLERPSPLHF	TRBV7-2	TRBJ1-6
TGTGCCAGCAGGGGGGGTACAGGGGGCGACTCGGGAATTGAAAAACTGTTTTTT	CASRGGTGGDSGIEKLFF	TRBV6-2	TRBJ1-4
TGCGCCAGCAGCCAAGATACCGCGGGAGGGGGGGGCCTCTCCTACGAGCAGTACTTC	CASSQDTAGGGGLSYEQYF	TRBV4-1	TRBJ2-7
TGTGCCAGGATCTGGGGGGGAACTAATGAAAAACTGTTTTTT	CARIWGGTNEKLFF	TRBV6-1	TRBJ1-4
TGTGCCAGCAGTGAAGGACCGAAGTCTTTTCGCAATAGCGGGGGGTTCAATGAGCAGTTCTTC	CASSEGPKSFRNSGGFNEQFF	TRBV25-1	TRBJ2-1
TGTGCCAGTAGTGAGGGGAGGAAACCCGGGGAGCTGTTTTTT	CASSEGRKPGELFF	TRBV19	TRBJ2-2
TGCGCCAGCAGCAGGGTCCGGGACAGTTCCGAAACTAATGAAAAACTGTTTTTT	CASSRVRDSSETNEKLFF	TRBV5-1	TRBJ1-4
TGTGCCAGCAGCAGGACACGCACAGATACGCAGTATTTT	CASSRTRTDTQYF	TRBV7-3	TRBJ2-3
TGTGCCAGCAGCTCAGGACAGGGGGCGCTGACTTACGTTGAGTACTTC	CASSSGQGALTYVEYF	TRBV7-2	TRBJ2-4
TGTGCCAGCAGCTTGAGGGCAACACAGGGCTTCCAAGACTCTGGGGCCAACGTCCTGACTTTC	CASSLRATQGFQDSGANVLTF	TRBV5-6	TRBJ2-6
TGTGCCAGCAGCGCCAGGGGATTATATGGCTACACCTTC	CASSARGLYGYTF	TRBV7-2	TRBJ1-2
TGTGCCAGCAGGCCCCAACAGGGCAGTCAGCCCCAGCATTTT	CASRPQQGSQPQHF	TRBV3-1	TRBJ1-5
TGTGCCAGCAGTTGGGTTGCAGTAGGACAGGACGTGACACTTCCTGGCTACACCTTC	CASSWVAVGQDVTLPGYTF	TRBV6-5	TRBJ1-2
TGTAGACGGACCTCAAAAACGGAGGAAGGCTGGGTCTACGAGCAGTACTTC	CRRTSKTEEGWVYEQYF	TRBV11-1	TRBJ2-7
TGTGCCATCGGGGGGGGGGGCCCTAATGAAAAACTGTTTTTT	CAIGGGGPNEKLFF	TRBV12-4	TRBJ1-4
TGCAGTGCTCTCCCCCCGAGGAAGAACACTGAAGCTTTCTTT	CSALPPRKNTEAFF	TRBV20-1	TRBJ1-1
TGTGCCAGCAGTAAGCGGGAGACCCAGTACTTC	CASSKRETQYF	TRBV6-1	TRBJ2-5
TGTGCCACCAGGCGGAGGGGGGGTAGCTTCCGCACAGATACGCAGTATTTT	CATRRRGGSFRTDTQYF	TRBV15	TRBJ2-3
TGCGCCAGCAGCCTAGGCTCCTACGAGCAGTACTTC	CASSLGSYEQYF	TRBV4-1	TRBJ2-7
TGTGCCAGCAGCATCTCAAGTTCCTATAATTCACCCCTCCACTTT	CASSISSSYNSPLHF	TRBV13	TRBJ1-6
TGTGCCAGCAGCTTGGGGACAGGACCCGGAAACACCATATATTTT	CASSLGTGPGNTIYF	TRBV11-2	TRBJ1-3
TGTGCCAGCAGCCGGGCGGGACAGGGGAACTCTGGGGCCAACGTCCTGACTTTC	CASSRAGQGNSGANVLTF	TRBV13	TRBJ2-6
TGTGCCAGCAGCTTAGTTTCAGGGACTAACTATGGCTACACCTTC	CASSLVSGTNYGYTF	TRBV7-8	TRBJ1-2
TGTGCCAGCAGCGGGCCCAGCTCCTACGAGCAGTACTTC	CASSGPSSYEQYF	TRBV11-1	TRBJ2-7
TGTGCCAGCAGTGACCCAGACAGGGGAAGGGTCTCCTACGAGCAGTACTTC	CASSDPDRGRVSYEQYF	TRBV6-4	TRBJ2-7
TGTGCCAGCAGCGAGTGGGACAGGGGGCCCGGGGAGCTGTTTTTT	CASSEWDRGPGELFF	TRBV3-1	TRBJ2-2
TGTGCCAGCAGCCCTTATACCCGGACGGTCTATGAAAAACTGTTTTTT	CASSPYTRTVYEKLFF	TRBV13	TRBJ1-4
TGCAGTGCCTCGTCAAGGGACAGCAATCAGCCCCAGCATTTT	CSASSRDSNQPQHF	TRBV20-1	TRBJ1-5
TGTGCCAGCAGCCGGCGCCGGGGCCCTAGTTCCGGGGAGCTGTTTTTT	CASSRRRGPSSGELFF	TRBV7-3	TRBJ2-2
TGTGCCAGCAGTTCTGGGACAGGGTCCTTC	CASSSGTGSF	TRBV27	TRBJ1-2
TGTGAGAAAGCGGACTTAGACACTGAAGCTTTCTTT	CEKADLDTEAFF	TRBV24-1	TRBJ1-1
TGTGCCACCAGCAGAGCCCGGGACAGGGGGGTTGAACAGCCCCAGCATTTT	CATSRARDRGVEQPQHF	TRBV15	TRBJ1-5
TGCGCCAGCAGTGAACCCCACCGCAAGAAGGAATCGGTGAACACTGAAGCTTTCTTT	CASSEPHRKKESVNTEAFF	TRBV10-1	TRBJ1-1
TGCAGTGTCCTCCGGACAGGGGACGCGAACACCGGGGAGCTGTTTTTT	CSVLRTGDANTGELFF	TRBV20-1	TRBJ2-2
TGTGCCAGCAGTTCGTCCGGGAGGCGGGAAAAACTGTTTTTT	CASSSSGRREKLFF	TRBV12-3	TRBJ1-4
TGTGCCAGCAGTTACTCGGGGTGGGGCTTTGTCACAGATACGCAGTATTTT	CASSYSGWGFVTDTQYF	TRBV6-8	TRBJ2-3
TGTGCCAGCAGTGACTCGACGTTAGCGTCTGATGGGGGGAGGCATGATGAGCAGTTCTTC	CASSDSTLASDGGRHDEQFF	TRBV6-4	TRBJ2-1
TGTGCCTGGAGTAAGGACAGGGGGCGGAGCAATCAGCCCCAGCATTTT	CAWSKDRGRSNQPQHF	TRBV30	TRBJ1-5
TGCGCCAGCAGAAAAAACGGGATTGACTATGGCTACACCTTC	CASRKNGIDYGYTF	TRBV10-1	TRBJ1-2
TGTGCCAGTAGTATGAGTTTCCTCCACCCGTCAACGGTAGTCTACAATGAGCAGTTCTTC	CASSMSFLHPSTVVYNEQFF	TRBV19	TRBJ2-1
TGTGCCAGCAGTTACTCGGATCTGGGCTACGAGCAGTACTTC	CASSYSDLGYEQYF	TRBV6-8	TRBJ2-7
TGTGCCAGCATCTCGAAAATTACCGGGGAGCTGTTTTTT	CASISKITGELFF	TRBV28	TRBJ2-2
TGTGCCAGCAGCGACAGGGTGGATGGCTACACCTTC	CASSDRVDGYTF	TRBV13	TRBJ1-2
TGTGCCACCAGTGATTCCTTAGCAGACTCTGGGGCCAACGTCCTGACTTTC	CATSDSLADSGANVLTF	TRBV24-1	TRBJ2-6
TGCGCCACAGGGGATCAGCCCCAGCATTTT	CATGDQPQHF	TRBV10-1	TRBJ1-5
TGTGCCAGCAGCCCTCAGGCCGGGACAGGGTGCTCACCCCTCCACTTT	CASSPQAGTGCSPLHF	TRBV7-9	TRBJ1-6
TGTGCCAGCAGCAGAATAGAACAGGATGAAAAACTGTTTTTT	CASSRIEQDEKLFF	TRBV13	TRBJ1-4
TGTGCCAGCAGCAAACAATTTAATAGACGACGGCACTACGAGCAGTACTTC	CASSKQFNRRRHYEQYF	TRBV11-3	TRBJ2-7
TGTGCCAGCAGTTACCCCACAGGGGGCAGGGACCTCTACGAGCAGTACTTC	CASSYPTGGRDLYEQYF	TRBV6-5	TRBJ2-7
TGTGCCAGCAGCCAAGTCTGCGGGAGGATCTACAATGAGCAGTTCTTC	CASSQVCGRIYNEQFF	TRBV3-1	TRBJ2-1
TGTGCCAGCAGACTGGGGGTGCAAGCTTTCTTT	CASRLGVQAFF	TRBV6-3	TRBJ1-1
TGTGCCAGCAGCTGGCTTGTGGGACAGGGGGTAAGTGAAAAACTGTTTTTT	CASSWLVGQGVSEKLFF	TRBV5-6	TRBJ1-4
TGCAGTGCAGAACGGGACAATGAGCAGTTCTTC	CSAERDNEQFF	TRBV20-1	TRBJ2-1
TGTGCCAGCAGCAGAACAGGGCAGAGCAATGAGCAGTTCTTC	CASSRTGQSNEQFF	TRBV14	TRBJ2-1
TGTGCCAGCAGCCCCTTGGGGCAACCGGAGACTGAAGCTTTCTTT	CASSPLGQPETEAFF	TRBV7-3	TRBJ1-1
TGCGCCAGCAGCGACGGGGGGGGGGGCGACGACGAGCAGTACTTC	CASSDGGGGDDEQYF	TRBV4-1	TRBJ2-7
TGTGCCATCACCAAAGTTTGGACCAGCCCCGGCGAAAAACTGTTTTTT	CAITKVWTSPGEKLFF	TRBV10-3	TRBJ1-4
TGTGCCACCAGTGATCTTGACACGCTGGGGGGCCCCGGGTCACAAGAGACCCAGTACTTC	CATSDLDTLGGPGSQETQYF	TRBV24-1	TRBJ2-5
TGTGCCAGCTCCCGACGTATTGTGACCCACACTGAAGCTTTCTTT	CASSRRIVTHTEAFF	TRBV6-1	TRBJ1-1
TGTGCCAGCAGCTTTCGGCAGCCCCAGCATTTT	CASSFRQPQHF	TRBV5-6	TRBJ1-5
TGTGCCAGCAGTAACGAGGGTAAATCTGGCTACACCTTC	CASSNEGKSGYTF	TRBV27	TRBJ1-2
TGTGCCAGCACCTTTGCACGGATAAGGGGAAACTACAATGAGCAGTTCTTC	CASTFARIRGNYNEQFF	TRBV28	TRBJ2-1
TGTGCCAGCAGACTTGAGGCCGTTGACAGGGTAAGGCGGGGTACCGAGACCCAGTACTTC	CASRLEAVDRVRRGTETQYF	TRBV3-1	TRBJ2-5
TGCGCCAGCAGCCAAGGATGGGCCCGGTACTTTTTACTTGCCTACGAGCAGTACTTC	CASSQGWARYFLLAYEQYF	TRBV4-1	TRBJ2-7
TGTGCCAGCAACCGAAGAATGGGGGGGGAGTTTGGCTACACCTTC	CASNRRMGGEFGYTF	TRBV7-3	TRBJ1-2
TGTGCCAGCAGCCAAGGATCGGGGACAGGGCCTGGAAACACCATATATTTT	CASSQGSGTGPGNTIYF	TRBV4-2	TRBJ1-3
TGTGCCACCAGTGGGACATGGTTCGAGCAGTACTTC	CATSGTWFEQYF	TRBV24-1	TRBJ2-7
TGCGCCAGCAGTAAGTCACCAAGCCACAATGAGCAGTTCTTC	CASSKSPSHNEQFF	TRBV10-1	TRBJ2-1
TGTGCCAGCAGCCAAGCCGGTAGCCCCTCCTACGAGCAGTACTTC	CASSQAGSPSYEQYF	TRBV3-1	TRBJ2-7
TGTGCTAGTGAGTTTAAGCGGACCGGCACCGGGGAGCTGTTTTTT	CASEFKRTGTGELFF	TRBV12-5	TRBJ2-2
TGTGCCAGCAGCGAATACGGGGTATATGGCTACACCTTC	CASSEYGVYGYTF	TRBV7-9	TRBJ1-2
TGTGCCACCAGTGACCGTCTGAACAATGAGCAGTTCTTC	CATSDRLNNEQFF	TRBV24-1	TRBJ2-1
TGTGCCAGCAGACCGGGACAGTACCACGAGTACTTC	CASRPGQYHEYF	TRBV12-3	TRBJ2-4
TGTGCCAGCAGCCAAGGGACAGGGCGATTTAGCAATCAGCCCCAGCATTTT	CASSQGTGRFSNQPQHF	TRBV3-1	TRBJ1-5
TGTGCCAGCATACGGGGCTCTGGAAACACCATATATTTT	CASIRGSGNTIYF	TRBV28	TRBJ1-3
TGTGCCAGCAGCGGAGGGACAGGGCGTATTTTTAAGGGGTCACCCCTCCACTTT	CASSGGTGRIFKGSPLHF	TRBV7-3	TRBJ1-6
TGTGCCAGCAGCGTAGTAGATAACAATGAGCAGTTCTTC	CASSVVDNNEQFF	TRBV9	TRBJ2-1
TGTGCCAGCAGCATATACGAAAGCAACACAGATACGCAGTATTTT	CASSIYESNTDTQYF	TRBV7-4	TRBJ2-3
TGTGCCACCAGTGATCCGATGGCGACAGCCCCGTCACCCCTCCACTTT	CATSDPMATAPSPLHF	TRBV24-1	TRBJ1-6
TGTGCCAGTAGTTTGCTGGGGGTCTGCTACGAGCAGTACTTC	CASSLLGVCYEQYF	TRBV19	TRBJ2-7
TGTGCCAGCAGTTTATGCTACACAGGAAGTTACAGGGAGTTCTTT	CASSLCYTGSYREFF	TRBV28	TRBJ1-1
TGTGCCAGCAAATTCCTCGGAGGACAGGGAGGAGCTTTCTTT	CASKFLGGQGGAFF	TRBV12-4	TRBJ1-1
TGTGCCAGCAGCTCAGGGAAAAGCAACACTGAAGCTTTCTTT	CASSSGKSNTEAFF	TRBV11-2	TRBJ1-1
TGTGCCAGCAGGAGACAGGGGAGCTGGGGAAATGAGCAGTTCTTC	CASRRQGSWGNEQFF	TRBV6-4	TRBJ2-1
TGCACCTCGACGGGGAGGGCCGACAATGAGCAGTTCTTC	CTSTGRADNEQFF	TRBV20-1	TRBJ2-1
TGTGCCAGCAGAGAAAGGGACGAGCTCTACATTCAGTACTTC	CASRERDELYIQYF	TRBV28	TRBJ2-4
TGTGCCCGACCTAGCGGGCTTCACAAAAACATTCAGTACTTC	CARPSGLHKNIQYF	TRBV15	TRBJ2-4
TGTGCCACCGGGAGCAGCGGGTCAAGGCCTGAAGCTTTCTTT	CATGSSGSRPEAFF	TRBV7-9	TRBJ1-1
TGTGCCAGCAGCCAAGTCGGATTGAGCGGGACGGGGGGTCAGCTGCAGTTCTTC	CASSQVGLSGTGGQLQFF	TRBV14	TRBJ2-1
TGTGCCAGCAGCGGGGGGGCGGGCAATGAGCAGTTCTTC	CASSGGAGNEQFF	TRBV5-4	TRBJ2-1
TGTGCCAGCAGCTCCCGATGGACTAGCGGGGGCTTTAATGAGCAGTTCTTC	CASSSRWTSGGFNEQFF	TRBV5-4	TRBJ2-1
TGTGCCAGCAGCGTATACAGCCGGAGCTCCTACGAGCAGTACTTC	CASSVYSRSSYEQYF	TRBV13	TRBJ2-7
TGTGCCAGCAGCACCCTGAACAGGGGGGTCTATGGCTACACCTTC	CASSTLNRGVYGYTF	TRBV7-9	TRBJ1-2
TGCGCCAGCAACCGTAGCGGGGTCGATTACGAGCAGTACTTC	CASNRSGVDYEQYF	TRBV10-1	TRBJ2-7
TGTGCCAGCAGCCAAGGGGTTAGCGGGACCGGGGAGCTGTTTTTT	CASSQGVSGTGELFF	TRBV3-1	TRBJ2-2
TGTGCCGGGGAGAGGGCATATGAGCAGTTCTTC	CAGERAYEQFF	TRBV19	TRBJ2-1
TGTGCCAGCAGTTATTCCAGCTCCTCCCGGGACAGGGGGCCTTTTCAGCCCCAGCATTTT	CASSYSSSSRDRGPFQPQHF	TRBV6-5	TRBJ1-5
TGTGCCAGGTTGGGCCCGACTAGCGGAAATGAGCAGTTCTTC	CARLGPTSGNEQFF	TRBV5-4	TRBJ2-1
TGTGCCAGCAGCTGCGACGACAGCATGAACACTGAAGCTTTCTTT	CASSCDDSMNTEAFF	TRBV5-6	TRBJ1-1
TGTGCCAGCAGCCAACGAGGGGATATGAACACTGAAGCTTTCTTT	CASSQRGDMNTEAFF	TRBV14	TRBJ1-1
TGTGCCAGCATCAGAGCCGACAGAGATAGGTTTGAAGCTTTCTTT	CASIRADRDRFEAFF	TRBV6-4	TRBJ1-1
TGTGCCAGCAGTGAAGGGGGAACCGAGCAGTACTTC	CASSEGGTEQYF	TRBV12-3	TRBJ2-7
TGTGCCAGCAGTGCCAATTCCCGGTTCGACAAATACGAGCAGTACTTC	CASSANSRFDKYEQYF	TRBV2	TRBJ2-7
TGTGCCAGTAGTATAGAAAACCTCCGGGGGCGGTGTAACTATGGCTACACCTTC	CASSIENLRGRCNYGYTF	TRBV19	TRBJ1-2
TGTGCCAGCAGCCAAGATCCGGGCGAAGGCTGGTGCAATCAGCCCCAGCATTTT	CASSQDPGEGWCNQPQHF	TRBV14	TRBJ1-5
TGTGCCAGCAGGGAGCGTACGGAGGACTCCTACAATGAGCAGTTCTTC	CASRERTEDSYNEQFF	TRBV12-3	TRBJ2-1
TGTGCCAGCAGTTACGTTGTTATGTACAATGAGCAGTTCTTC	CASSYVVMYNEQFF	TRBV6-3	TRBJ2-1
TGTGCCAAACAGGGGGTGGAATACGGAAGAAACACTGAAGCTTTCTTT	CAKQGVEYGRNTEAFF	TRBV6-3	TRBJ1-1
TGTGCCACCAGTGATGGCGAGTGGCTGGCCTACGAGCAGTACTTC	CATSDGEWLAYEQYF	TRBV24-1	TRBJ2-7
TGTGCCACGGAGTTTCAGGGGTCACCCTATGAGCAGTTCTTC	CATEFQGSPYEQFF	TRBV24-1	TRBJ2-1
TGTGCCAGCTCACCCAGACAGGGGGAGCAGTACTTC	CASSPRQGEQYF	TRBV18	TRBJ2-7
TGTGCCAGCAGCTGCTGGCAAGCTTTCTTT	CASSCWQAFF	TRBV7-4	TRBJ1-1
TGTGCCAGCAGTTACGGGGAACGTACTAATGAAAAACTGTTTTTT	CASSYGERTNEKLFF	TRBV6-5	TRBJ1-4
TGTGCCAGCAGCGTAGGATTCAAACTAGGGACACGGAGTGAAAAACTGTTTTTT	CASSVGFKLGTRSEKLFF	TRBV9	TRBJ1-4
TGCAGGTTCCCACAGGGGGAAGGGGGCAATCAGCCCCAGCATTTT	CRFPQGEGGNQPQHF	TRBV20-1	TRBJ1-5
TGTGCCAGCTCACAAGAACCTTCTAAGGGGGAGTTAGATACGCAGTATTTT	CASSQEPSKGELDTQYF	TRBV18	TRBJ2-3
TGTGCCAGCAGTATGACTTGGGGACAGGGGGGTGTTTACGAGCAGTACTTC	CASSMTWGQGGVYEQYF	TRBV9	TRBJ2-7
TGTGCCAGCAGTGATCGGCAGGGGGCCTACAATGAGCAGTTCTTC	CASSDRQGAYNEQFF	TRBV6-4	TRBJ2-1
TGTGCCAGCAGCCTGATACCTCGGGCCCGCCTTGAAAACTATGGCTACACCTTC	CASSLIPRARLENYGYTF	TRBV13	TRBJ1-2
TGTGCCAGCAGCCCGACTAGCGGTGGGCCGAACACCGGGGAGCTGTTTTTT	CASSPTSGGPNTGELFF	TRBV5-6	TRBJ2-2
TGTGCTAGTGGTTTCTTCGCGACAGGTGATTTCGAGACCCAGTACTTC	CASGFFATGDFETQYF	TRBV12-5	TRBJ2-5
TGCAGCGATAGATGGGACAGAGGCTCTGGGGCCAACGTCCTGACTTTC	CSDRWDRGSGANVLTF	TRBV29-1	TRBJ2-6
TGTGCCAGCAGCTTAGATGAACAGGATCAGCCCCAGCATTTT	CASSLDEQDQPQHF	TRBV11-3	TRBJ1-5
TGTGCCAGCATCCCGGTTTGCCCTTCAGGGAACACTGAAGCTTTCTTT	CASIPVCPSGNTEAFF	TRBV25-1	TRBJ1-1
TGTGCCAGCAGTTCTAGCGGCGGCGATACCGGGGAGCTGTTTTTT	CASSSSGGDTGELFF	TRBV28	TRBJ2-2
TGTGCCACCAGTTCCCGGCCGGGACTAGCGGGAAGAAACGAGCAGTACTTC	CATSSRPGLAGRNEQYF	TRBV24-1	TRBJ2-7
TGTGCCAGCAAAGGTAGGGGGCAGGAGGTGGGCTACAATGAGCAGTTCTTC	CASKGRGQEVGYNEQFF	TRBV6-5	TRBJ2-1
TGCGCCAGCAGCTTGTCCACCCCGGGACAGGTACCTGGGGCCAACGTCCTGACTTTC	CASSLSTPGQVPGANVLTF	TRBV5-1	TRBJ2-6
TGTGCCAGCATAACCATACAGGACAGGGGGCAGCAGGAGCACTCTGGAAACACCATATATTTT	CASITIQDRGQQEHSGNTIYF	TRBV27	TRBJ1-3
TGTGCCAGTAGTATCACCCTGAACAATGAGCAGTTCTTC	CASSITLNNEQFF	TRBV19	TRBJ2-1
TGTGCCACCAGGGAGTCGAGGACAGGAGAGGCCTACGAGCAGTACTTC	CATRESRTGEAYEQYF	TRBV24-1	TRBJ2-7
TGTGCCAGCAGTGAAGTGCAGGGGAGCAATTCTGCTAATGAAAAACTGTTTTTT	CASSEVQGSNSANEKLFF	TRBV25-1	TRBJ1-4
TGTGCCAGCAGTGTCCTAAACCGCCGTGCTTTCCTAGGCTACGAGCAGTACTTC	CASSVLNRRAFLGYEQYF	TRBV25-1	TRBJ2-7
TGTGCCAGCCCCCTTAAGAAGTTAGATTCACCCCTCCACTTT	CASPLKKLDSPLHF	TRBV6-3	TRBJ1-6
TGTGCCAGTAGTCTGGGGGGCTACACCTTC	CASSLGGYTF	TRBV19	TRBJ1-2
TGTGCCATCATAAGGGGAGGTGGGCAGCCCCAGCATTTT	CAIIRGGGQPQHF	TRBV10-3	TRBJ1-5
TGTGCCAGCGTGACAGGGGGGGTAGACACTGAAGCTTTCTTT	CASVTGGVDTEAFF	TRBV7-9	TRBJ1-1
TGTGCCAGCAGCTTGACCGAAATCGGGGAGCTGTTTTTT	CASSLTEIGELFF	TRBV7-2	TRBJ2-2
TGTGCCAGCAGCCTTCGACAGGGTCGGCGGAGCACAGATACGCAGTATTTT	CASSLRQGRRSTDTQYF	TRBV14	TRBJ2-3
TGCAGTGCTACTCTGTTTAGGGACAGCTCTGGAAACACCATATATTTT	CSATLFRDSSGNTIYF	TRBV20-1	TRBJ1-3
TGTGCCAGTCACCTCTCGGTCCGGCACTACGAGCAGTACTTC	CASHLSVRHYEQYF	TRBV5-4	TRBJ2-7
TGTGCCAGCAGCATGCGGGAGGTCGGGTACGAGCAGTACTTC	CASSMREVGYEQYF	TRBV4-2	TRBJ2-7
TGTGCCAGCAGTTCAGGTACCACGGACAGGTGCCGGCGCGTTGGCTACGAGCAGTACTTC	CASSSGTTDRCRRVGYEQYF	TRBV6-5	TRBJ2-7
TGTGCCAGCAGCCAGATGCGTAAGGACAGGGCCGAAAAACTGTTTTTT	CASSQMRKDRAEKLFF	TRBV6-5	TRBJ1-4
TGCAGTGCTAGAACGACAGGGGGAGTAACCTATAATTCACCCCTCCACTTT	CSARTTGGVTYNSPLHF	TRBV20-1	TRBJ1-6
TGTGCCAAAACGATGGTCCGGGACAGGCAGTACTTC	CAKTMVRDRQYF	TRBV10-3	TRBJ2-7
TGTGCCAGCAACGTCGCCCGGCCATCCGGGCGATCGGGCTACACCTTC	CASNVARPSGRSGYTF	TRBV4-2	TRBJ1-2
TGTGCCAGCGGAGTACTTAAGGACAGGTCGAATGAAAAACTGTTTTTT	CASGVLKDRSNEKLFF	TRBV6-2	TRBJ1-4
TGTGCCAGCAGTGGTTTCCTGGCAGTGACAGATACGCAGTATTTT	CASSGFLAVTDTQYF	TRBV6-4	TRBJ2-3
TGTGCCAGCAGCCATGAATTCCGATACGGCTATGGCTACACCTTC	CASSHEFRYGYGYTF	TRBV9	TRBJ1-2
TGCAGTGCTAGCATAGTGGACAGGGAAGGAAACACCATATATTTT	CSASIVDREGNTIYF	TRBV20-1	TRBJ1-3
TGTGCCAGCAGTAGCTGGTCCCATGAGCAGTTCTTC	CASSSWSHEQFF	TRBV12-3	TRBJ2-1
TGTGCCACCAGTGAGTCGTTAGAAGGACTCAGCTACACCTTC	CATSESLEGLSYTF	TRBV24-1	TRBJ1-2
TGTGCCAGCAGCTTAGTAGCACAGGCGAACTCTGGGGCCAACGTCCTGACTTTC	CASSLVAQANSGANVLTF	TRBV7-8	TRBJ2-6
TGTGCCAGCAAGGGGGGACCGAGCCTCGGCTCTGGAAACACCATATATTTT	CASKGGPSLGSGNTIYF	TRBV5-6	TRBJ1-3
TGTGCCAGCAGTCGCGGCGCCTACAATGAGCAGTTCTTC	CASSRGAYNEQFF	TRBV28	TRBJ2-1
TGTGCCAGCAGCGGACGGGACCAGAATAGCTCTGGGGCCAACGTCCTGACTTTC	CASSGRDQNSSGANVLTF	TRBV9	TRBJ2-6
TGTGCCAGCAGCTTTCGCCCGCAGGACCCTGAAAAACTGTTTTTT	CASSFRPQDPEKLFF	TRBV5-8	TRBJ1-4
TGTGCCAGCAGCTTAGGAAAAGGGACAGGTATTGAGCAGTTCTTC	CASSLGKGTGIEQFF	TRBV11-2	TRBJ2-1
TGTGCCAGCAGGGATACAGGGTTCGAGCAGTACTTC	CASRDTGFEQYF	TRBV11-2	TRBJ2-7
TGTGCCAGCAGCTTATCCGTTAGGGTGGGGAAGAACACTGAAGCTTTCTTT	CASSLSVRVGKNTEAFF	TRBV7-8	TRBJ1-1
TGTGCCAGCAGTCCCCCACGGGACAGGGGAATGAACACCGGGGAGCTGTTTTTT	CASSPPRDRGMNTGELFF	TRBV6-1	TRBJ2-2
TGCAGCGTTGAAGATCTGGGGAATGGGACAAACAGCAATCAGCCCCAGCATTTT	CSVEDLGNGTNSNQPQHF	TRBV29-1	TRBJ1-5
TGTGCCAGCAGAGAAGGGGGGTGGCAGCCCCAGCATTTT	CASREGGWQPQHF	TRBV14	TRBJ1-5
TGTGCCAGCAGTCTTCGTGGGGGGATCGATGAGCAGTTCTTC	CASSLRGGIDEQFF	TRBV6-1	TRBJ2-1
TGTGCCAGCAGTAGGCCGGGGGACACTGAAGCTTTCTTT	CASSRPGDTEAFF	TRBV28	TRBJ1-1
TGTGCCAGTACCGGGGGGCACGGGGAGCTGTTTTTT	CASTGGHGELFF	TRBV19	TRBJ2-2
TGTGCCAGCAGCTTCCCCCCACAGCACATCTCCTATAATTCACCCCTCCACTTT	CASSFPPQHISYNSPLHF	TRBV11-3	TRBJ1-6
TGTGCCAGCTTCAGGTGTGAAAAACTGTTTTTT	CASFRCEKLFF	TRBV27	TRBJ1-4
TGTGCCAGCAGTGGAAAGTCGCGGGGATTTGGGACCTACGAGCAGTACTTC	CASSGKSRGFGTYEQYF	TRBV6-4	TRBJ2-7
TGTGCCATCACGAGGGGAGAGAATGAGCAGTTCTTC	CAITRGENEQFF	TRBV2	TRBJ2-1
TGTGCCAGCAGCACCGGACCCCAGCCCCAGCATTTT	CASSTGPQPQHF	TRBV5-4	TRBJ1-5
TGTGCCAGCTCACTGCCGGGACAGGGATCCTACGAGCAGTACTTC	CASSLPGQGSYEQYF	TRBV18	TRBJ2-7
TGCAGTGCTAGAGATCCCGGGGCGCGTTCCCGTAGCAATCAGCCCCAGCATTTT	CSARDPGARSRSNQPQHF	TRBV20-1	TRBJ1-5
TGTGCCAGCAGTACAGACAGGGACCGGACTGAAGCTTTCTTT	CASSTDRDRTEAFF	TRBV6-5	TRBJ1-1
TGCGCCAGCAGCAGTAGTAGCTACGAGCAGTACTTC	CASSSSSYEQYF	TRBV5-1	TRBJ2-7
TGTGCCAGCAGCTTAGTTATACGTAACAGGGGGCCCTTCTCCTATAATTCACCCCTCCACTTT	CASSLVIRNRGPFSYNSPLHF	TRBV11-3	TRBJ1-6
TGCGCCGCCCTAGGGGCCTTTTATGGCTACACCTTC	CAALGAFYGYTF	TRBV10-1	TRBJ1-2
TGTGCCAGCAGCTTAAAAGCCGTCGGGGATGAGCAGTTCTTC	CASSLKAVGDEQFF	TRBV7-2	TRBJ2-1
TGCGCCAGCAGCCAAGCCGTAAACAAGACAGCTGGTTGCAATCAGCCCCAGCATTTT	CASSQAVNKTAGCNQPQHF	TRBV4-3	TRBJ1-5
TGTGCCAGCAGTCGGGGAGGGCACAGGACTGAAGCTTTCTTT	CASSRGGHRTEAFF	TRBV27	TRBJ1-1
TGTGCCAGCAGCCACGGGTTAACTTTGAACACTGAAGCTTTCTTT	CASSHGLTLNTEAFF	TRBV5-4	TRBJ1-1
TGTGCCAGTAACCTTGACAGGGGGACCTACGAGCAGTACTTC	CASNLDRGTYEQYF	TRBV5-6	TRBJ2-7
TGTGCCAGCAGCGTAGACAGGTACTGTAACTATGGCTACACCTTC	CASSVDRYCNYGYTF	TRBV9	TRBJ1-2
TGTGCCAGCAGCCACGGACTAGCGGGGGGGCCTGCCGGAGAGACCCAGTACTTC	CASSHGLAGGPAGETQYF	TRBV2	TRBJ2-5
TGTGCCAGCAGCTCAGGGACAGGGGACGGGAGCAATCAGCCCCAGCATTTT	CASSSGTGDGSNQPQHF	TRBV5-4	TRBJ1-5
TGTGCCAGCAGCTTAGGCCGGGGACACTATGGCTACACCTTC	CASSLGRGHYGYTF	TRBV7-9	TRBJ1-2
TGTGCCAGCAGCGGGAAAGACAGGGGGGCCCAAGACACTGAAGCTTTCTTT	CASSGKDRGAQDTEAFF	TRBV11-2	TRBJ1-1
TGTGCCAGCAGCAAAGGACAAAGGAACACCGGGGAGCTGTTTTTT	CASSKGQRNTGELFF	TRBV13	TRBJ2-2
TGTGCCAGCAGTTGCGAATGGTTCTCCTACGAGCAGTACTTC	CASSCEWFSYEQYF	TRBV12-3	TRBJ2-7
TGTGCCAGCAGTGACTCAAGGCGAGCCCAGAGGGATGCTAGCAATCAGCCCCAGCATTTT	CASSDSRRAQRDASNQPQHF	TRBV6-4	TRBJ1-5
TGTGCCAGCAGCTGGATGGGACAGGGCTACGAGCAGTACTTC	CASSWMGQGYEQYF	TRBV11-2	TRBJ2-7
TGTGCCAGCAGCTCGTGGGGCTATCGCACTGAAGCTTTCTTT	CASSSWGYRTEAFF	TRBV5-4	TRBJ1-1
TGTGCCAGCAGTTTATTAACCAGCGAATATGGCTACACCTTC	CASSLLTSEYGYTF	TRBV27	TRBJ1-2
TGTGCCAGCAGCGGGGACAGGGTTTCACCCCTCCACTTT	CASSGDRVSPLHF	TRBV5-6	TRBJ1-6
TGTGCCAGCAGCAGGGCCGGACAGGGGGGGAACACTGAAGCTTTCTTT	CASSRAGQGGNTEAFF	TRBV13	TRBJ1-1
TGTGCCAGCCCGGGGACTAGCGGGAGCTCCTACGAGCAGTACTTC	CASPGTSGSSYEQYF	TRBV13	TRBJ2-7
TGTGCCTGGAGTGATGAGTCAGGGGGTAATGAAGCTTTCTTT	CAWSDESGGNEAFF	TRBV30	TRBJ1-1
TGTGCCAGCAGCCAAGCCGATGGGGTTAACATTCAGTACTTC	CASSQADGVNIQYF	TRBV14	TRBJ2-4
TGTGCCAGCAGTTTCGGATACCGCAATCAGCCCCAGCATTTT	CASSFGYRNQPQHF	TRBV28	TRBJ1-5
TGTGCCAGCAGTACGGCTTCAATTGAGCAGTTCTTC	CASSTASIEQFF	TRBV6-4	TRBJ2-1
TGTGCCAGCAGCCTTTTGCAGGGGGTTAAAGACTCCTACGAGCAGTACTTC	CASSLLQGVKDSYEQYF	TRBV3-1	TRBJ2-7
TGTGCCAGCAGCCGGCCCTGGCTAAAAATGAACACTGAAGCTTTCTTT	CASSRPWLKMNTEAFF	TRBV3-1	TRBJ1-1
TGTGCCAGCAGCGGGGGGGTCTACGAGCAGTACTTC	CASSGGVYEQYF	TRBV11-3	TRBJ2-7
TGTGCCACCAGCCTCGGAACACGCCCGGGACTAGCGTGTTCCAACACAGATACGCAGTATTTT	CATSLGTRPGLACSNTDTQYF	TRBV15	TRBJ2-3
TGTGCTAGTGGTTTCTCGGCAAAGGGGAAATACGAGCAGTACTTC	CASGFSAKGKYEQYF	TRBV12-5	TRBJ2-7
TGCAGCGTTGTAAAAGGGGGGCGGGCTAGCACAGATACGCAGTATTTT	CSVVKGGRASTDTQYF	TRBV29-1	TRBJ2-3
TGTGCCAGCAGCGTAGGGTATGGGCACAATTCACCCCTCCACTTT	CASSVGYGHNSPLHF	TRBV9	TRBJ1-6
TGTGCCAGCAGTTTAGAGGAGCAGGGGATGAATGAGCAGTTCTTC	CASSLEEQGMNEQFF	TRBV28	TRBJ2-1
TGTGCCAGACCGTCGGAGTGGGACAGCACAGATACGCAGTATTTT	CARPSEWDSTDTQYF	TRBV7-8	TRBJ2-3
TGTGCCAGTTTCAACAGGGAGGACACCTTC	CASFNREDTF	TRBV19	TRBJ1-2
TGTGCCAGCAGCCCGGACAGGCACTACGAGCAGTACTTC	CASSPDRHYEQYF	TRBV3-1	TRBJ2-7
TGTGCCAGCAGCGGGACAATGAACACTGAAGCTTTCTTT	CASSGTMNTEAFF	TRBV27	TRBJ1-1
TGTGCCAGCATCGACAGGGGTTGGGAGACCGGGGAGCTGTTTTTT	CASIDRGWETGELFF	TRBV4-2	TRBJ2-2
TGTGCCAGCTCACCGGGGGGCCTGTTCCGATATAATTCACCCCTCCACTTT	CASSPGGLFRYNSPLHF	TRBV18	TRBJ1-6
TGCGCCAGCAGCTATTCCCGGGACAAAACGTGTGGCTACGAGCAGTACTTC	CASSYSRDKTCGYEQYF	TRBV5-1	TRBJ2-7
TGCGCCAGCAGTAGGAGCGGAGCCAAAAACATTCAGTACTTC	CASSRSGAKNIQYF	TRBV5-1	TRBJ2-4
TGTGCCAGCAGTTCGGATATTCACAATGAGCAGTTCTTC	CASSSDIHNEQFF	TRBV6-6	TRBJ2-1
TGTGCCAGCAGCAGTAGTCGACAGGTTGAGACCCAGTACTTC	CASSSSRQVETQYF	TRBV13	TRBJ2-5
TGTGCCAGCAGCCAAGTCTCGTGCTCCGGGACAGGGACTTCCCGCACTGAAGCTTTCTTT	CASSQVSCSGTGTSRTEAFF	TRBV4-2	TRBJ1-1
TGTGCCAGTAGTATCAAGTACCAGGGAGAAACGTATTTAGCTTTCTTT	CASSIKYQGETYLAFF	TRBV19	TRBJ1-1
TGTGCCAGCAGTTTAGACAGGGAGTACGAGCAGTACTTC	CASSLDREYEQYF	TRBV27	TRBJ2-7
TGCAGTGCTAGGGAGCCGACGGCGGACGGCTATGGCTACACCTTC	CSAREPTADGYGYTF	TRBV20-1	TRBJ1-2
TGCGCCAGCAGGGACGGGAGGGTAACAGTCAATCAGCCCCAGCATTTT	CASRDGRVTVNQPQHF	TRBV5-1	TRBJ1-5
TGTGCCAGCTCACCATCCAGGAAGGTTACCGGGACTAGCGCCTACTACAATGAGCAGTTCTTC	CASSPSRKVTGTSAYYNEQFF	TRBV18	TRBJ2-1
TGTGCCAGCAGTTTAAATCGGGGTCCCAAAAACATTCAGTACTTC	CASSLNRGPKNIQYF	TRBV12-4	TRBJ2-4
TGTGCCACCAGTGATTATTTTGAAGAGGAAGATACGCAGTATTTT	CATSDYFEEEDTQYF	TRBV24-1	TRBJ2-3
TGTGCCGGACGGGGGGGTTTCTCCACCTTTCCAGATACGCAGTATTTT	CAGRGGFSTFPDTQYF	TRBV2	TRBJ2-3
TGTGCCAGCAGCTTAGCGGGACAGGGGCCAAGCTATGGCTACACCTTC	CASSLAGQGPSYGYTF	TRBV11-3	TRBJ1-2
TGTGCCAGCAGTGACTCCCCGGGGGGGACACTCCACTATGGCTACACCTTC	CASSDSPGGTLHYGYTF	TRBV6-4	TRBJ1-2
TGTGCCAGCAGTGTCCCCAGGGAGCCCTCTGGAAACACCATATATTTT	CASSVPREPSGNTIYF	TRBV6-4	TRBJ1-3
TGTGCCAGCACTCTGAAACCCGGGACTAGCGGGCCGAGCTCCTACGAGCAGTACTTC	CASTLKPGTSGPSSYEQYF	TRBV7-3	TRBJ2-7
TGTGCCAGCAGCTTAGCGGGCCACTCTGGGGCCAACGTCCTGACTTTC	CASSLAGHSGANVLTF	TRBV7-9	TRBJ2-6
TGTGCCAGCAGCTTAGTCGCTAGCGGGCCAAGGTCAGCCCCCAGTGAGCAGTTCTTC	CASSLVASGPRSAPSEQFF	TRBV7-2	TRBJ2-1
TGTGCCAGCAGTTACTCCTTGACAGGACCAACCTACAATGAGCAGTTCTTC	CASSYSLTGPTYNEQFF	TRBV6-6	TRBJ2-1
TGTGCCACCAGTGATTTCGACAGGGAGAAGCCCTGCAATCAGCCCCAGCATTTT	CATSDFDREKPCNQPQHF	TRBV24-1	TRBJ1-5
TGTGCCACCAATCCCGGCGTAACTATAAGCTCCTACGAGCAGTACTTC	CATNPGVTISSYEQYF	TRBV24-1	TRBJ2-7
TGTGCCAGCTCACTTCGGGTCCGCGGCAATCAGCCCCAGCATTTT	CASSLRVRGNQPQHF	TRBV18	TRBJ1-5
TGTGCCAGCAGCTGGGGGGGGTCCTCTGGGGCCAACGTCCTGACTTTC	CASSWGGSSGANVLTF	TRBV5-6	TRBJ2-6
TGTGCCAGCAGCGGAACTCGGGTGGGCACCGGGGAGCTGTTTTTT	CASSGTRVGTGELFF	TRBV7-2	TRBJ2-2
TGTGCCAGCAGCAAAGGCGGGGACTATGGCTACACCTTC	CASSKGGDYGYTF	TRBV9	TRBJ1-2
TGTGCCAGCACAGACAGGGTACCCTCTGGAAACACCATATATTTT	CASTDRVPSGNTIYF	TRBV6-4	TRBJ1-3
TGCGCCAGCAGCTATGGGGGGAGGGGAACTGCGGAGCAGCCCCAGCATTTT	CASSYGGRGTAEQPQHF	TRBV5-1	TRBJ1-5
TGTGCCTGGATGGGATTGATCTTTGTGCAGAAAGAGACCCAGTACTTC	CAWMGLIFVQKETQYF	TRBV30	TRBJ2-5
TGTGCCAGTAGGTTTGCCTGGCGGGGTGGAAACACCATATATTTT	CASRFAWRGGNTIYF	TRBV19	TRBJ1-3
TGTGCCAGCACCGCCGGACTCCGCACAGATACGCAGTATTTT	CASTAGLRTDTQYF	TRBV6-4	TRBJ2-3
TGTGCTCCTCCGTCAGACAGGGGGGAAAGAGATACGCAGTATTTT	CAPPSDRGERDTQYF	TRBV27	TRBJ2-3
TGTGCCAGCAGTTACTCAATAATACGGCCGAATCAGCCCCAGCATTTT	CASSYSIIRPNQPQHF	TRBV6-2	TRBJ1-5
TGTGCTAGTGGTTCGGCCAAATCCAGGGCATGGATGGGGAACACTGAAGCTTTCTTT	CASGSAKSRAWMGNTEAFF	TRBV12-5	TRBJ1-1
TGTGTTAGGGCAGCGGCGGGGTTTAACAATGAGCAGTTCTTC	CVRAAAGFNNEQFF	TRBV27	TRBJ2-1
TGTGCCAGCAGTTTAGAATGGGGAGGTAGCGAGCAGTACTTC	CASSLEWGGSEQYF	TRBV12-3	TRBJ2-7
TGTGCCAGCCCGTGGCGTACAGGGCCCGTAAATCAGCCCCAGCATTTT	CASPWRTGPVNQPQHF	TRBV6-5	TRBJ1-5
TGTGCTAGTGGTTTGGAAAGACACGAGAATAGCAATCAGCCCCAGCATTTT	CASGLERHENSNQPQHF	TRBV12-5	TRBJ1-5
TGTGCCTGGAGTGGGGTTATAAGCGGGATTTTCTCTGGAAACACCATATATTTT	CAWSGVISGIFSGNTIYF	TRBV30	TRBJ1-3
TGTGCCAGCAGCGCGACGGCTAGGGTAGGGAACACCGGGGAGCTGTTTTTT	CASSATARVGNTGELFF	TRBV9	TRBJ2-2
TGTGCCAGCAGCTTTTCTTCCGGACAGGGATACTACGAGCAGTACTTC	CASSFSSGQGYYEQYF	TRBV7-4	TRBJ2-7
TGTGCCATCGGGGGGGGACCTTACGAGCAGTACTTC	CAIGGGPYEQYF	TRBV10-3	TRBJ2-7
TGCGCCAGTGGGACAGAAAACACTGAAGCTTTCTTT	CASGTENTEAFF	TRBV5-1	TRBJ1-1
TGTGCCAGCAGCTTACACCCGTGTCAGCGGGGGGAGACCCAGTACTTC	CASSLHPCQRGETQYF	TRBV5-8	TRBJ2-5
TGTGCCAGCAGCCGACAAGGCGAGACCCAGTACTTC	CASSRQGETQYF	TRBV13	TRBJ2-5
TGTGCCAGCAGGGGGGGGGGTACGAACACCGGGGAGCTGTTTTTT	CASRGGGTNTGELFF	TRBV7-3	TRBJ2-2
TGTGCCAGCAGCTTGGACAGGAAATTTGGCTACACCTTC	CASSLDRKFGYTF	TRBV13	TRBJ1-2
TGTGCCACCAGTGATCTGAAGGGGTCTGGAAACACCATATATTTT	CATSDLKGSGNTIYF	TRBV24-1	TRBJ1-3
TGTGCCAGCAGCCCAACGGGACTAGCGGGGGGGCCCGAGGAGGTGCATTACGAGCAGTACTTC	CASSPTGLAGGPEEVHYEQYF	TRBV7-2	TRBJ2-7
TGTGCCTGGAGTGAAACAGGTCTCGTCCGTAGGCAAGAGACCCAGTACTTC	CAWSETGLVRRQETQYF	TRBV30	TRBJ2-5
TGTGCCAGCAGCTTGGGATATGTAGGGAATGAGCAGTTCTTC	CASSLGYVGNEQFF	TRBV5-6	TRBJ2-1
TGTGCCAGCAGCAAATTCGACAAGGTCTGCGACGCCTACAATGAGCAGTTCTTC	CASSKFDKVCDAYNEQFF	TRBV13	TRBJ2-1
TGTGCCATCGACAGAAATGAAAAACTGTTTTTT	CAIDRNEKLFF	TRBV6-3	TRBJ1-4
TGTGCCAGCAAATTCGACCTATCCAGAAGCATGGCTGAAGCTTTCTTT	CASKFDLSRSMAEAFF	TRBV6-1	TRBJ1-1
TGTGCCAGCAGGGGGGGGGGGCGGACCACTGAAGCTTTCTTT	CASRGGGRTTEAFF	TRBV6-3	TRBJ1-1
TGTAGAGAGGGGGCCGGGGAGCTGTTTTTT	CREGAGELFF	TRBV10-3	TRBJ2-2
TGTGCCAGAGGGCTTCCCAATCAGCCCCAGCATTTT	CARGLPNQPQHF	TRBV28	TRBJ1-5
TGTGCCAGCAGCCACCGGGGCGAGGATGAGACCCAGTACTTC	CASSHRGEDETQYF	TRBV3-1	TRBJ2-5
TGTGCCAGCAGCCTCGAACAGGTGGGCTACGAGCAGTACTTC	CASSLEQVGYEQYF	TRBV13	TRBJ2-7
TGTGCCAGCAGCTTAGCCGGAGATCAGCCCCAGCATTTT	CASSLAGDQPQHF	TRBV7-9	TRBJ1-5
TGTGCCAGCAGCCACCCGGGCCGGCCTGGTACCTTT	CASSHPGRPGTF	TRBV7-3	TRBJ1-1
TGTGCCAGCAGCGCCGGACTTCTGGAGCAGTACTTC	CASSAGLLEQYF	TRBV9	TRBJ2-7
TGCGCCAGCAGTGGAGGGTACAGGGGATTCGGCTACACCTTC	CASSGGYRGFGYTF	TRBV10-1	TRBJ1-2
TGTGCCAGCAGCTGGACAGGTCAGGCAGAGACCCAGTACTTC	CASSWTGQAETQYF	TRBV11-2	TRBJ2-5
TGTGCCAGCAGTAGGGGGGCTAGCTCCTACGAGCAGTACTTC	CASSRGASSYEQYF	TRBV27	TRBJ2-7
TGTGCCAGCAGCTGTCGGGGGGAGAACACTGAAGCTTTCTTT	CASSCRGENTEAFF	TRBV11-3	TRBJ1-1
TGTGCCAGCAGTTTATCGCGATCGGGGGGGGGCACGGGCGAGCAGTACTTC	CASSLSRSGGGTGEQYF	TRBV27	TRBJ2-7
TGTGCCAGCAGTTTTGGACGTTATACGCCGAGAGACGGGGAGCTGTTTTTT	CASSFGRYTPRDGELFF	TRBV28	TRBJ2-2
TGTGCCAGCAGTTTTGTCGTATCCTCAGGGGGGGTAGCTTTCTTT	CASSFVVSSGGVAFF	TRBV27	TRBJ1-1
TGCAGTGCCCACTTTAATGGGACAGGGTCCTACGAGCAGTACTTC	CSAHFNGTGSYEQYF	TRBV20-1	TRBJ2-7
TGTGCCACCAGTCCACAATACTATAGCAATCAGCCCCAGCATTTT	CATSPQYYSNQPQHF	TRBV24-1	TRBJ1-5
TGTGCCAGCAGTGGGCATGGGGGCGGCAATGAGCAGTTCTTC	CASSGHGGGNEQFF	TRBV6-4	TRBJ2-1
TGTGCCAGCAGAAGGGTCTTGCGTGACGAGCAGTACTTC	CASRRVLRDEQYF	TRBV3-1	TRBJ2-7
TGTGCCAGCAGCTCCGGGGAAGGACAGGGCCAAGAGACCCAGTACTTC	CASSSGEGQGQETQYF	TRBV11-3	TRBJ2-5
TGTGCCATCAGTGCTGTCGCTGACAATTTCTGCAATCAGCCCCAGCATTTT	CAISAVADNFCNQPQHF	TRBV10-3	TRBJ1-5
TGCAGCGTTGATCAGGGCTCCTACAATGAGCAGTTCTTC	CSVDQGSYNEQFF	TRBV29-1	TRBJ2-1
TGTGCCAGCAGCGCGTCCCGATGGACAGATACGCAGTATTTT	CASSASRWTDTQYF	TRBV7-8	TRBJ2-3
TGTGCCTGGACCCTACCGGCGGGGAGCTCCTACAATGAGCAGTTCTTC	CAWTLPAGSSYNEQFF	TRBV30	TRBJ2-1
TGTGCCATCAGGGGGACAGAGACAGATACGCAGTATTTT	CAIRGTETDTQYF	TRBV10-3	TRBJ2-3
TGTGCCAGCAGGCGGGAGCGTCCTACAGATACGCAGTATTTT	CASRRERPTDTQYF	TRBV5-6	TRBJ2-3
TGTGCCAGCAGCAGGGGTAGGAGTACCAAGAGATACGAGCAGTACTTC	CASSRGRSTKRYEQYF	TRBV13	TRBJ2-7
TGCGCCAGCAGCCAGGGACGACAGGGAGCTGATTCTAGCACAGATACGCAGTATTTT	CASSQGRQGADSSTDTQYF	TRBV4-1	TRBJ2-3
TGTGCCAGCAGCCAAGCACGGGGGGGCGAGCAGTACTTC	CASSQARGGEQYF	TRBV14	TRBJ2-7
TGTGCCAGCAGCTTCTTTACAGATAGATTCGGATACGAGCAGTACTTC	CASSFFTDRFGYEQYF	TRBV7-9	TRBJ2-7
TGTGCCAGCAGCGGCAGAGTTCTTAGCTCCTACAATGAGCAGTTCTTC	CASSGRVLSSYNEQFF	TRBV13	TRBJ2-1
TGTGCCAGCAGTTTAAGGGACGGTTCAACTAATGAAAAACTGTTTTTT	CASSLRDGSTNEKLFF	TRBV12-3	TRBJ1-4
TGTGCCAGCAGTTACTCGAGGTGTCCTTGGGACGAGAACACTGAAGCTTTCTTT	CASSYSRCPWDENTEAFF	TRBV6-5	TRBJ1-1
TGCAGTGCTGGTCCGGGACATTTCGCACACGAGCAGTACTTC	CSAGPGHFAHEQYF	TRBV20-1	TRBJ2-7
TGTGCCAGCAGCTTGGGCGCAGTAACCCCAGATACGCAGTATTTT	CASSLGAVTPDTQYF	TRBV5-6	TRBJ2-3
TGTGCCAGCAGTTACCCCAGGGTCCCTGAAGCTTTCTTT	CASSYPRVPEAFF	TRBV6-5	TRBJ1-1
TGTGCCACCAGTGGTAGTTTCCAGGAAGCCTACGAGCAGTACTTC	CATSGSFQEAYEQYF	TRBV24-1	TRBJ2-7
TGCGCCAGCAGGCTTGGGGGACTAGCGGACGAGCAGTACTTC	CASRLGGLADEQYF	TRBV10-1	TRBJ2-7
TGTGCCAGCAGCTTGAAGCCGACTGAAGCTTTCTTT	CASSLKPTEAFF	TRBV5-8	TRBJ1-1
TGTGCCAGCAGCTTGGTAAGACAGGGTGTTTTCTACGAGCAGTACTTC	CASSLVRQGVFYEQYF	TRBV5-4	TRBJ2-7
TGTGCCAGTAGTATAGATTGCCGTCGCAATAGGGCTTTCTTT	CASSIDCRRNRAFF	TRBV19	TRBJ1-1
TGTGCCAGCAGCCTCCCCGGGACAGAGTTGGCCCTCCACTTT	CASSLPGTELALHF	TRBV7-3	TRBJ1-6
TGTGCCAGCAGCGCGATAAAAACGGCAGGGAAGATTTCACCCCTCCACTTT	CASSAIKTAGKISPLHF	TRBV7-9	TRBJ1-6
TGTGCCAGCAGTTCGGGACAGGGTGGCTACACCTTC	CASSSGQGGYTF	TRBV27	TRBJ1-2
TGTGCCAGCAGCGTAGATTGCGGAAACGAGCAGTACTTC	CASSVDCGNEQYF	TRBV9	TRBJ2-7
TGCAGCGTTGAAGCTGAAACTAGCGGGAGGCCTAATGAAAAACTGTTTTTT	CSVEAETSGRPNEKLFF	TRBV29-1	TRBJ1-4
TGCGCCAGCAGCCAAGATCCTAACAGGGGTCCTAGCACAGATACGCAGTATTTT	CASSQDPNRGPSTDTQYF	TRBV4-1	TRBJ2-3
TGTGCCAGCAGCCGGGAACTGGCTTTTGCCTATAATTCACCCCTCCACTTT	CASSRELAFAYNSPLHF	TRBV7-3	TRBJ1-6
TGTCCAGTGTCCCGAAAAAAAATCTACGAGCAGTACTTC	CPVSRKKIYEQYF	TRBV7-9	TRBJ2-7
TGTGCCAGCAGAACCGGGACAGGGAACGCGAACACCGGGGAGCTGTTTTTT	CASRTGTGNANTGELFF	TRBV12-3	TRBJ2-2
TGTGCCAGCAGCTTGTCGACAGGGTCGTTGGGCCAGGGCTACACCTTC	CASSLSTGSLGQGYTF	TRBV5-8	TRBJ1-2
TGTGCCAGCAGCTCCCGCAGGGCCTATGGCTACACCTTC	CASSSRRAYGYTF	TRBV7-2	TRBJ1-2
TGCGCCAGCAGCCCTAAGACAGGGGGGACCTATAGCAATCAGCCCCAGCATTTT	CASSPKTGGTYSNQPQHF	TRBV5-1	TRBJ1-5
TGTGCCAGCAGCTGCATGAGGGGCATGAACACTGAAGCTTTCTTT	CASSCMRGMNTEAFF	TRBV7-9	TRBJ1-1
TGTGCCACCTTCACGGGACTAGCGCTAGATGAGCAGTTCTTC	CATFTGLALDEQFF	TRBV24-1	TRBJ2-1
TGTGCCTTTCTTGACAGGGATCGCACTAGCACAGATACGCAGTATTTT	CAFLDRDRTSTDTQYF	TRBV30	TRBJ2-3
TGTGCCACCAGTGATACACAAGATGGAAACACCATATATTTT	CATSDTQDGNTIYF	TRBV24-1	TRBJ1-3
TGTGCCAGCAGGACCCCTCTCGAGCAGTACTTC	CASRTPLEQYF	TRBV5-6	TRBJ2-7
TGTGCCAGCACCGGCCGGGACACCCGCACTGAAGCTTTCTTT	CASTGRDTRTEAFF	TRBV27	TRBJ1-1
TGTGCCAGCAGTTACGTCTGGCGTATAGACGGACATGAGCAGTTCTTC	CASSYVWRIDGHEQFF	TRBV6-3	TRBJ2-1
TGTGCCAGCAGGGCGCAAGGGTTAGGGGATACAAGTAATGAAAAACTGTTTTTT	CASRAQGLGDTSNEKLFF	TRBV2	TRBJ1-4
TGTGCCAGCAGCTTGGCCCTCCCCGGGACCGGATACACTGAAGCTTTCTTT	CASSLALPGTGYTEAFF	TRBV5-6	TRBJ1-1
TGTGCCACGCCGGGACAGGGGGGGATCTCACCCCTCCACTTT	CATPGQGGISPLHF	TRBV6-1	TRBJ1-6
TGTGCCACCAGTGATTGGGTGCCCCAGACCCCTCGGATGACAGGGGCGGGGGACTTC	CATSDWVPQTPRMTGAGDF	TRBV24-1	TRBJ2-7
TGTGCCAGCAGCTCCAACCCTCGACAGGAGTACTGGGACGAGCAGTACTTC	CASSSNPRQEYWDEQYF	TRBV11-3	TRBJ2-7
TGCGCCAGCAGCTTAAAGGGACCCAAAAACTATGGCTACACCTTC	CASSLKGPKNYGYTF	TRBV10-2	TRBJ1-2
TGTGCCAGCCTCCGGGGCCTAATCTACGAGCAGTACTTC	CASLRGLIYEQYF	TRBV2	TRBJ2-7
TGTGCCAGCAGTCCCGAGGGGGGACATGCCAATCAGCCCCAGCATTTT	CASSPEGGHANQPQHF	TRBV27	TRBJ1-5
TGTGCCAGCAGCCAAGAGCACAGGGGGCGGTCAATTACCGGTAATGAGCAGTTCTTC	CASSQEHRGRSITGNEQFF	TRBV4-2	TRBJ2-1
TGTGCCTGGAGTGCCACGAGGACAGACTACGAGCAGTACTTC	CAWSATRTDYEQYF	TRBV30	TRBJ2-7
TGTGCCAGCAGATTCCTAGGACAGGACGGAGGACAGAATCACGAGCAGTACTTC	CASRFLGQDGGQNHEQYF	TRBV27	TRBJ2-7
TGTGCCAGCAGAATGGACAGAGCTTTCTTT	CASRMDRAFF	TRBV25-1	TRBJ1-1
TGTGCCAGCAGCGCCACCCCAGGTACCAACTATGGCTACACCTTC	CASSATPGTNYGYTF	TRBV7-6	TRBJ1-2
TGTGCCAGCAGGGGACATCAGCCCCAGCATTTT	CASRGHQPQHF	TRBV27	TRBJ1-5
TGTGCCAGTAGTCCGCTAGCGGGTCGGTGGGAGCTGTTTTTT	CASSPLAGRWELFF	TRBV19	TRBJ2-2
TGCGCCAGCAGCGCGGAAAAAGGTGACAGGGATTACGAGCAGTACTTC	CASSAEKGDRDYEQYF	TRBV5-1	TRBJ2-7
TGTGCCAGCAGTGACTCGGGGGATGCAACCTACGAGCAGTACTTC	CASSDSGDATYEQYF	TRBV6-4	TRBJ2-7
TGTGCCACCAGTGCTCCAGGAAGTGGGCTCTACGAGCAGTACTTC	CATSAPGSGLYEQYF	TRBV24-1	TRBJ2-7
TGTGCCATCCTAGCCACTGACAGGGTAGACGGGGTGAACACTGAAGCTTTCTTT	CAILATDRVDGVNTEAFF	TRBV6-1	TRBJ1-1
TGTGCCAGCACGGGGGGCGGATCTGGAAACACCATATATTTT	CASTGGGSGNTIYF	TRBV6-3	TRBJ1-3
TGTGCCAGCAGTGCATTTACGAAGTCCAATGAGCAGTTCTTC	CASSAFTKSNEQFF	TRBV2	TRBJ2-1
TGTGCCAGCAGCTCAGATCCTTTGAACACTGAAGCTTTCTTT	CASSSDPLNTEAFF	TRBV27	TRBJ1-1
TGTGCCAGCAGCTTGCCCCCGGGACCATATCCCGGTTCCTACGAGCAGTACTTC	CASSLPPGPYPGSYEQYF	TRBV5-6	TRBJ2-7
TGTGCCAGCAGCGACCGGGCAAAACTAGCAATGCCCTACGAGCAGTACTTC	CASSDRAKLAMPYEQYF	TRBV9	TRBJ2-7
TGTGCCAGCAGCTTAGTTAAAGCCGGGACAGGGAGGCCCCAGCATTTT	CASSLVKAGTGRPQHF	TRBV7-6	TRBJ1-5
TGTGCCAGCAGCGTAGATCCCCAAGGTGGAACTGAAGCTTTCTTT	CASSVDPQGGTEAFF	TRBV9	TRBJ1-1
TGTGCCAGCAGCTTAAACTGGCCGGGACAAGCGAATAGCAATCAGCCCCAGCATTTT	CASSLNWPGQANSNQPQHF	TRBV7-2	TRBJ1-5
TGTGCCAGCAGCACAGAGACACGTGATAAGTACCAAGAGACCCAGTACTTC	CASSTETRDKYQETQYF	TRBV5-6	TRBJ2-5
TGTGCCAGCAGCCGAACCGGGACAGGGTTAGCGAATTCACCCCTCCACTTT	CASSRTGTGLANSPLHF	TRBV2	TRBJ1-6
TGCGCCAGCAGCTTCCGAGGGTTTTACGAGCAGTACTTC	CASSFRGFYEQYF	TRBV5-1	TRBJ2-7
TGCGCCAGCAGTGAGTCGTATATAAATGAGCAGTTCTTC	CASSESYINEQFF	TRBV10-1	TRBJ2-1
TGCGCCAGCAGCTTGAAAAGGACTAGCGGGGGGGTTGCCAGCTCTGGGGCCAACGTCCTGACTTTC	CASSLKRTSGGVASSGANVLTF	TRBV5-1	TRBJ2-6
TGTGCCACCGGTCCGACACTGGAGGAGCAGTTCTTC	CATGPTLEEQFF	TRBV5-5	TRBJ2-1
TGTGCCCCAGCTACTCAGGGTCAACCCTACGAGCAGTACTTC	CAPATQGQPYEQYF	TRBV27	TRBJ2-7
TGTGCCAGCAGCCACTTCTACGAGCAGTACTTC	CASSHFYEQYF	TRBV7-2	TRBJ2-7
TGTGCCAGCAGCGTCGGGACAGGGGGCCGTCGGATCTTCTCTGGAAACACCATATATTTT	CASSVGTGGRRIFSGNTIYF	TRBV7-3	TRBJ1-3
TGTGCCAGCAGCCGGGTATTGAGGGGCTCCTACGAGCAGTACTTC	CASSRVLRGSYEQYF	TRBV3-1	TRBJ2-7
TGTGCCAGCAGCTCCCGGCGAATTCAGCCCCAGCATTTT	CASSSRRIQPQHF	TRBV7-3	TRBJ1-5
TGTGCCAGCAGCGATTTAGCGGGATGCTTC	CASSDLAGCF	TRBV9	TRBJ2-5
TGTGCCAGCAGTTCCTTGGGCCAGGGTCTTCGCTACAATGAGCAGTTCTTC	CASSSLGQGLRYNEQFF	TRBV28	TRBJ2-1
TGTGCCAGCAGCTTGTTGGAAGGGGGGGGGGGAATAGTAGGCAATCAGCCCCAGCATTTT	CASSLLEGGGGIVGNQPQHF	TRBV5-4	TRBJ1-5
TGCGCCAGCAGTGAGGTGGGCCGCGGAAAAAGAGAAGAGACCCAGTACTTC	CASSEVGRGKREETQYF	TRBV10-1	TRBJ2-5
TGCAGTGCTGCCCAAAGTCCTAGGTCAAGCGGGGGATATGGCTACACCTTC	CSAAQSPRSSGGYGYTF	TRBV20-1	TRBJ1-2
TGCAGCGTTCGGGGACTAGCGGGCGGACATTGCACAGATACGCAGTATTTT	CSVRGLAGGHCTDTQYF	TRBV29-1	TRBJ2-3
TGCAATGACAGAACAAATGGCTACACCTTC	CNDRTNGYTF	TRBV29-1	TRBJ1-2
TGTGCCAGCAGCATTACAGGCGAAGGGGCCCTCCACTTT	CASSITGEGALHF	TRBV7-9	TRBJ1-6
TGTGCCTGGAGTGAGGTAACAGATACGCAGTATTTT	CAWSEVTDTQYF	TRBV30	TRBJ2-3
TGTGCCACCAGCAGAGATCGGCCACTTCCTAACTATGGCTACACCTTC	CATSRDRPLPNYGYTF	TRBV15	TRBJ1-2
TGTGCCAGCAGCCAGAGCAGGGGCCATGGCTACACCTTC	CASSQSRGHGYTF	TRBV7-4	TRBJ1-2
TGTGCCAGCAGCCAAACTAGGAGGAAGCCCGAGACCCAGTACTTC	CASSQTRRKPETQYF	TRBV14	TRBJ2-5
TGTGCCAGCAGCTCGACAGGGTGCACGAACACCGGGGAGCTGTTTTTT	CASSSTGCTNTGELFF	TRBV13	TRBJ2-2
TGTGCCAGCAGCTCCCCCCACGGCTACACCTTC	CASSSPHGYTF	TRBV13	TRBJ1-2
TGTGCCTGGAGGGGCAGGGTAACCTACGAGCAGTACTTC	CAWRGRVTYEQYF	TRBV30	TRBJ2-7
TGTGCCAGGGACAGGGGCTACGAGCAGTACTTC	CARDRGYEQYF	TRBV6-6	TRBJ2-7
TGTGCCAGCAGGGATTCGGGACACAGGGAAAAACTGTTTTTT	CASRDSGHREKLFF	TRBV7-9	TRBJ1-4
TGTGCCAGCAGCCTCCGCTCAAACATTCAGTACTTC	CASSLRSNIQYF	TRBV14	TRBJ2-4
TGTGCCAGCAGTTCTAGGAGGGGCAAGGGTTACACTGAAGCTTTCTTT	CASSSRRGKGYTEAFF	TRBV3-1	TRBJ1-1
TGTGCCACAAAGTCGAAATGGCCCGCTCGAGCCCGCGAGCAGTACTTC	CATKSKWPARAREQYF	TRBV19	TRBJ2-7
TGTGCCAGCAGCCGCGGACTAGCGGGTACCAGCTCCTACAATGAGCAGTTCTTC	CASSRGLAGTSSYNEQFF	TRBV13	TRBJ2-1
TGTGCCAGCAGCATCGCGACCCTGACAGATACGCAGTATTTT	CASSIATLTDTQYF	TRBV28	TRBJ2-3
TGCGCCAGCAGCCAAGCCGGCAGGGAGGAGACCCAGTACTTC	CASSQAGREETQYF	TRBV4-3	TRBJ2-5
TGCAGTGCTAGACAGGACCCTCCTAACTATGGCTACACCTTC	CSARQDPPNYGYTF	TRBV20-1	TRBJ1-2
TGTGCCAGTGGGGGACAGAATCCGGTTCTTAAGACTAGGGAGCAGTACTTC	CASGGQNPVLKTREQYF	TRBV19	TRBJ2-7
TGTGCCAGCAGCGACAAACTAGGCTTCTCGTACAATGAGCAGTTCTTC	CASSDKLGFSYNEQFF	TRBV7-2	TRBJ2-1
TGTGCCACCAGTGGAAGACTAGGCACAGATACGCAGTATTTT	CATSGRLGTDTQYF	TRBV24-1	TRBJ2-3
TGTGCCAGTAGTCACGGAAACTATGGCTACACCTTC	CASSHGNYGYTF	TRBV19	TRBJ1-2
TGCAGTGCTAGCAATACACTAGGGGATCCTAGGATAGAGGCTGCTGGCTACACCTTC	CSASNTLGDPRIEAAGYTF	TRBV20-1	TRBJ1-2
TGTGCCAGCAGCCCTCCGGGACAGGGCCATTATGGCTACACCTTC	CASSPPGQGHYGYTF	TRBV14	TRBJ1-2
TGCGCCAGCAGCTTGGCCCCAGGGGCGGGAGTGACTGGAAACACCATATATTTT	CASSLAPGAGVTGNTIYF	TRBV5-1	TRBJ1-3
TGTGCCAGCTCACCAAAGCAGTGCGCGGATAACGAGCAGTACTTC	CASSPKQCADNEQYF	TRBV18	TRBJ2-7
TGTGCCAGCAGAAGGGACAGGGGTAACTATGGCTACACCTTC	CASRRDRGNYGYTF	TRBV6-4	TRBJ1-2
TGTGCCAGCAGCTTAGCACGGGACCTGTCCTACGAGCAGTACTTC	CASSLARDLSYEQYF	TRBV7-2	TRBJ2-7
TGTGCCAGTAGTAGGGATAACACTGAAGCTTTCTTT	CASSRDNTEAFF	TRBV19	TRBJ1-1
TGTGCCAGCAGCCCTCTCTCTTTAGACAACTACGAGCAGTACTTC	CASSPLSLDNYEQYF	TRBV5-6	TRBJ2-7
TGCAGTGCTAGCTTTCCTGGGGGGGAGCAGTTCTTC	CSASFPGGEQFF	TRBV20-1	TRBJ2-1
TGCGCCAGCAGCACGCCTCCCGGGACGTGGCTTGTGGACGAGCAGTACTTC	CASSTPPGTWLVDEQYF	TRBV4-3	TRBJ2-7
TGTGCCAGCACTAGCAGGGCAAGATATGAAAAACTGTTTTTT	CASTSRARYEKLFF	TRBV6-4	TRBJ1-4
TGTGCCACCAGTGAGAAGGACGGAACTGAAGCTTTCTTT	CATSEKDGTEAFF	TRBV24-1	TRBJ1-1
TGTGCTAGCAGCTTAGACAGGCCCCAGCATTTT	CASSLDRPQHF	TRBV7-7	TRBJ1-5
TGTGCCAGCAGCCACCATGGATTGATTGGGGTTTCCACCAGCTCCTACGAGCAGTACTTC	CASSHHGLIGVSTSSYEQYF	TRBV7-2	TRBJ2-7
TGTGCCAGCAGCGCGGGAGTCTCTGGAAACACCATATATTTT	CASSAGVSGNTIYF	TRBV7-3	TRBJ1-3
TGTGCCAGCAGTGGTCCCGGGACTAGCGGGACCACCTACGAGCAGTACTTC	CASSGPGTSGTTYEQYF	TRBV6-4	TRBJ2-7
TGTGCCAGCAGCTTCCCCGGGACACACCAGCCCCAGCATTTT	CASSFPGTHQPQHF	TRBV13	TRBJ1-5
TGTGCCAGCAGATGGGGGGTGGAATACGAGCAGTACTTC	CASRWGVEYEQYF	TRBV7-8	TRBJ2-7
TGTGCCAGCAGCCAGGTAATGCCCACAGATACGCAGTATTTT	CASSQVMPTDTQYF	TRBV5-4	TRBJ2-3
TGCGCCAGCAGGGGACAGTGGGGCGGAGGGAACACTGAAGCTTTCTTT	CASRGQWGGGNTEAFF	TRBV10-1	TRBJ1-1
TGTGCCTGGAGTCAAGTGGACAGGGCGTTAAGGGCCTTCAATCAGCCCCAGCATTTT	CAWSQVDRALRAFNQPQHF	TRBV30	TRBJ1-5
TGTGCCAGCAGCCTTGTTCAGGTCAGGGTCCGGGAAAGCTCCTACGAGCAGTACTTC	CASSLVQVRVRESSYEQYF	TRBV3-1	TRBJ2-7
TGCGCCAGCAGTGAGGTAGCGGGCACAGATACGCAGTATTTT	CASSEVAGTDTQYF	TRBV10-1	TRBJ2-3
TGTGCCAGCAGTGTTCAAGGGGGGGGCTCTGGGGCCAACGTCCTGACTTTC	CASSVQGGGSGANVLTF	TRBV2	TRBJ2-6
TGTGCCAGCAGTTACGGGCAGGCTTTTGGGGACGGGGACGAGCAGTACTTC	CASSYGQAFGDGDEQYF	TRBV6-3	TRBJ2-7
TGCGCCAGCTTCGGGGGGGGCCATGAGCAGTTCTTC	CASFGGGHEQFF	TRBV10-2	TRBJ2-1
TGTGCAGCCCGGACAGGACTCGGCCCCTACGAGCAGTACTTC	CAARTGLGPYEQYF	TRBV12-5	TRBJ2-7
TGTGCCAGCAGTTCTAAACGACAGGGGGGCTCCTACAATGAGCAGTTCTTC	CASSSKRQGGSYNEQFF	TRBV25-1	TRBJ2-1
TGTGCCAGCAGTCCCGGGACCTCCCTCGACAGGGGCTCTGGAAACACCATATATTTT	CASSPGTSLDRGSGNTIYF	TRBV6-3	TRBJ1-3
TGTGCCAGCAGCTTCATGGGGGGAAGGTACGGGAACACTGAAGCTTTCTTT	CASSFMGGRYGNTEAFF	TRBV5-6	TRBJ1-1
TGTGCCAGCAGCTTTAAGACAGCGGAGTACTACGAGCAGTACTTC	CASSFKTAEYYEQYF	TRBV13	TRBJ2-7
TGCGCCAGCAGCTTGGGTACGGCAGGGGGCGTAACAGAAAATGAGCAGTTCTTC	CASSLGTAGGVTENEQFF	TRBV5-1	TRBJ2-1
TGCAGTGCGCCCAACACAGCGGACACCATATATTTT	CSAPNTADTIYF	TRBV20-1	TRBJ1-3
TGTGCCAGCAGCTTGCTCGACCCGGGACAGGGAGAGGTAAACACCATATATTTT	CASSLLDPGQGEVNTIYF	TRBV5-4	TRBJ1-3
TGCAGTGCTAGATCATTATGGCAGAAATGGGGGGGCGATCATGGCTACACCTTC	CSARSLWQKWGGDHGYTF	TRBV20-1	TRBJ1-2
TGTGCCAGCAGCTCCCGCCGGGAGAAGGCTGGAAACACCATATATTTT	CASSSRREKAGNTIYF	TRBV11-3	TRBJ1-3
TGCAGCGTTGCTGTATGCGCGACAGGGTTGGGCTACGAGCAGTACTTC	CSVAVCATGLGYEQYF	TRBV29-1	TRBJ2-7
TGTGCCAGCAGTTACTCGACTGAGGGGACCTACGAGCAGTACTTC	CASSYSTEGTYEQYF	TRBV6-5	TRBJ2-7
TGTGCCACCAGTGACCGGACAGGGGGCGGGCGTAATGAAAAACTGTTTTTT	CATSDRTGGGRNEKLFF	TRBV24-1	TRBJ1-4
TGTGCCAGCAGTTACAACAGGGGACAGGGGAACACTGAAGCTTTCTTT	CASSYNRGQGNTEAFF	TRBV6-2	TRBJ1-1
TGTGCCAGCAGGGGACTGCCAACCGAGCAGTACTTC	CASRGLPTEQYF	TRBV27	TRBJ2-7
TGTGCCACCAGCTGGGTGGCAGTATCTGAAGCTTTCTTT	CATSWVAVSEAFF	TRBV15	TRBJ1-1
TGTGCCAGCAGCTCGGGGGGGGGTTATGCGCAGAGCTCCTACAATGAGCAGTTCTTC	CASSSGGGYAQSSYNEQFF	TRBV11-3	TRBJ2-1
TGTGCCTGGAGTGCCTTAGTGGACAGGGGACCGATGCAAGAGACCCAGTACTTC	CAWSALVDRGPMQETQYF	TRBV30	TRBJ2-5
TGCGCCAGCAGCTTGCTAATTAAAAATTCACCCCTCCACTTT	CASSLLIKNSPLHF	TRBV5-1	TRBJ1-6
TGTGCCTTATCATGGGGACCGGTTAACGAGCAGTACTTC	CALSWGPVNEQYF	TRBV25-1	TRBJ2-7
TGTGCCAGCAGTGCATTCGGGGGGCCGGGGAAAGAGCAGTACTTC	CASSAFGGPGKEQYF	TRBV6-4	TRBJ2-7
TGTGCCATCAGGCAGCGGGTTCGGGATACGCAGTATTTT	CAIRQRVRDTQYF	TRBV10-3	TRBJ2-3
TGTGCCAGCAGTTATCGGAGGGATCCCGAATCCTACAATGAGCAGTTCTTC	CASSYRRDPESYNEQFF	TRBV6-5	TRBJ2-1
TGTGCCAGCTCACCACAAAGGGGGAAACCTGTAGAGCAGTACTTC	CASSPQRGKPVEQYF	TRBV18	TRBJ2-7
TGCGCCAGCAGCTGTACAGGGGCTGGAGCCAAAAACATTCAGTACTTC	CASSCTGAGAKNIQYF	TRBV5-1	TRBJ2-4
TGTGCCACCAGTGAAACGTCAAGCATGAAGAACACTGAAGCTTTCTTT	CATSETSSMKNTEAFF	TRBV24-1	TRBJ1-1
TGTGCCTCAGTATCGTACGAGCAGTACTTC	CASVSYEQYF	TRBV6-1	TRBJ2-7
TGTGCCAGCAGCTGTAGACCAGAGGGGTCGTCCGAGTCGGCCTACGAGCAGTACTTC	CASSCRPEGSSESAYEQYF	TRBV5-4	TRBJ2-7
TGTGCCAGCACCCTGCGGGAGGACGAGCAGTACTTC	CASTLREDEQYF	TRBV25-1	TRBJ2-7
TGTGCCACCAGTGGCGGGGGGGCGGGTGAAATGAACACTGAAGCTTTCTTT	CATSGGGAGEMNTEAFF	TRBV24-1	TRBJ1-1
TGTGCCAGCAGCTTCGCAGAGGGTTTAGGCGAGCAGTACTTC	CASSFAEGLGEQYF	TRBV7-2	TRBJ2-7
TGTGCCAGCAGCTGGGTCAGCTCCTTTCCTGGGGCCAACGTCCTGACTTTC	CASSWVSSFPGANVLTF	TRBV11-1	TRBJ2-6
TGTGCCACCAGCACTCAATACATCCGGGAGAGGGACAATGAGCAGTTCTTC	CATSTQYIRERDNEQFF	TRBV15	TRBJ2-1
TGTGCCAGCAGTTTACCCTGGGGCCGGGACACTCCCTCCTACGAGCAGTACTTC	CASSLPWGRDTPSYEQYF	TRBV12-3	TRBJ2-7
TGCGCCAGCAGCTTGGGGGTGTCCCGCCCCGGATTCTCTGGAAACACCATATATTTT	CASSLGVSRPGFSGNTIYF	TRBV5-1	TRBJ1-3
TGCGCCAGCACAAGTCGGGGCTTC	CASTSRGF	TRBV4-1	TRBJ1-2
TGCGCCAGCAAGCAGGGGGGTGCAACTAATGAAAAACTGTTTTTT	CASKQGGATNEKLFF	TRBV10-1	TRBJ1-4
TGTGCCAGCAGCTTGGGGGGGCTAGAGCAGTACTTC	CASSLGGLEQYF	TRBV7-3	TRBJ2-7
TGTGCCAGCAGCTCAGGTCTAGCTTTCTTT	CASSSGLAFF	TRBV13	TRBJ1-1
TGCAGTGCTAGCCCGGGGGATTCTCTGGGATATGGCTACACCTTC	CSASPGDSLGYGYTF	TRBV20-1	TRBJ1-2
TGTGCCAGCAGCTTAGTCCGACCCCTATTTAATCAGCCCCAGCATTTT	CASSLVRPLFNQPQHF	TRBV11-2	TRBJ1-5
TGTGCCAGCAGCGAATCGGGACTAGCGGGGGGGAAAAATAATGCCGGGGAGCTGTTTTTT	CASSESGLAGGKNNAGELFF	TRBV7-3	TRBJ2-2
TGTGCCAGCAGCGCCTCGGGTAGGGGGTCCTACGAGCAGTACTTC	CASSASGRGSYEQYF	TRBV2	TRBJ2-7
TGTGCCAGCAGGACGCCGGGACAGGGTTACTACGAGCAGTACTTC	CASRTPGQGYYEQYF	TRBV6-5	TRBJ2-7
TGTGCCAGCAGCTGGGGGGCCTGGAATTCACCCCTCCACTTT	CASSWGAWNSPLHF	TRBV5-8	TRBJ1-6
TGTGCCAGCTGGGAGGGGTGGAGTCCTGAGCAGTTCTTC	CASWEGWSPEQFF	TRBV18	TRBJ2-1
TGTGCCAGCAGACAGAACGATGAGCAGTTCTTC	CASRQNDEQFF	TRBV12-4	TRBJ2-1
TGTGCCAGCAATGTATGGACCCCCGGCAATGAGCAGTTCTTC	CASNVWTPGNEQFF	TRBV6-6	TRBJ2-1
TGTGCCAGCAGCCAAGACGGGACAGGGGAAGCTTTCTTT	CASSQDGTGEAFF	TRBV3-1	TRBJ1-1
TGTGCCAGCAGCCCCTTCTCCTCTGGGGCCAACGTCCTGACTTTC	CASSPFSSGANVLTF	TRBV13	TRBJ2-6
TGTGCCAGCAGTGAAGCGCTTCTTAACACAATTTCCGAGACTGAAAAACTGTTTTTT	CASSEALLNTISETEKLFF	TRBV2	TRBJ1-4
TGTGCCAGTGGTAACTCAGTCTTC	CASGNSVF	TRBV19	TRBJ2-1
TGTGCCACCTTCCGACCGGAGGGGACGGAGCAGTACTTC	CATFRPEGTEQYF	TRBV6-1	TRBJ2-7
TGTGCCAGCAGTAGACTCGAGCAGTACTTC	CASSRLEQYF	TRBV11-2	TRBJ2-7
TGTGCCAGCAATAGCAACGATGGCTACACCTTC	CASNSNDGYTF	TRBV6-1	TRBJ1-2
TGCAGTGCTATGGGACACCGAGGAAACACCATATATTTT	CSAMGHRGNTIYF	TRBV20-1	TRBJ1-3
TGTGCCAGCAGCCCCCTGGTAAGGGGGGCGTTGATTAACTATGGCTACACCTTC	CASSPLVRGALINYGYTF	TRBV5-5	TRBJ1-2
TGCGCCAGCAGTAGGGGGCGGTGCGGAAATGAGCAGTTCTTC	CASSRGRCGNEQFF	TRBV5-1	TRBJ2-1
TGTGCCAGCAGCTTAGCACGGGGGGACATCCACATAAATAGCAATCAGCCCCAGCATTTT	CASSLARGDIHINSNQPQHF	TRBV7-9	TRBJ1-5
TGTGCCAGCAGCTCGGAGGGACAGGACGAGCAGTACTTC	CASSSEGQDEQYF	TRBV7-2	TRBJ2-7
TGTGCCAGCAGCGGACTAGCGGGTGGCACAGATACGCAGTATTTT	CASSGLAGGTDTQYF	TRBV6-2	TRBJ2-3
TGCGCCAGCAGCGGGGGTAGGGAAGAGACCCAGTACTTC	CASSGGREETQYF	TRBV5-1	TRBJ2-5
TGTGCCAGCAGTTTGTCCCGGGACAGGGAGTTTGTTCCATCCTACAATGAGCAGTTCTTC	CASSLSRDREFVPSYNEQFF	TRBV6-3	TRBJ2-1
TGTGCCAGTAGTATGGACGCCCCCTACGAGCAGTACTTC	CASSMDAPYEQYF	TRBV19	TRBJ2-7
TGCGCCAGCAGCACTCGGGGAAGCGGTTACGGCAATCAGCCCCAGCATTTT	CASSTRGSGYGNQPQHF	TRBV5-1	TRBJ1-5
TGCGCCAGCAGCTATCAGGAGACGAACACCGGGGAGCTGTTTTTT	CASSYQETNTGELFF	TRBV5-1	TRBJ2-2
TGTGCCATACTTACTAATGGGGAGCTGTTTTTT	CAILTNGELFF	TRBV12-3	TRBJ2-2
TGCAGTGCTATGAAGTATGGAAGTGATGCAACTAATGAAAAACTGTTTTTT	CSAMKYGSDATNEKLFF	TRBV20-1	TRBJ1-4
TGTGCCAGCAGTTACCTTTTATCGGGACAACGTAATGAAAAACTGTTTTTT	CASSYLLSGQRNEKLFF	TRBV6-6	TRBJ1-4
TGTGCCAGCAGTTCCTCTCCGGGACAGGGTAGCGTGCCCCAGCATTTT	CASSSSPGQGSVPQHF	TRBV27	TRBJ1-5
TGTGCCATCAGTGAGAACCGGGACAGGGGGCGCCCTCAGCCCCAGCATTTT	CAISENRDRGRPQPQHF	TRBV10-3	TRBJ1-5
TGTGCCAGCAGCGGGAGTTGGCGAGGTTTTAATCAGCCCCAGCATTTT	CASSGSWRGFNQPQHF	TRBV11-3	TRBJ1-5
TGTGCCAGCAGCTTGGCGGACCGGAGGGCCACCGGGGAGCTGTTTTTT	CASSLADRRATGELFF	TRBV5-6	TRBJ2-2
TGTGCCAGCATCCCAGCGGGGGACAGTCAGCCCCAGCATTTT	CASIPAGDSQPQHF	TRBV27	TRBJ1-5
TGTGCCAGCAGTTTATCGAGAGGTTGGGGCAATCAGCCCCAGCATTTT	CASSLSRGWGNQPQHF	TRBV27	TRBJ1-5
TGTGCCAAGAGGTTACCCCGTGACTACGAGCAGTACTTC	CAKRLPRDYEQYF	TRBV6-5	TRBJ2-7
TGTGCCAGCAGTTGGACAGGGCTGATAGGGCTGGGCACTGAAGCTTTCTTT	CASSWTGLIGLGTEAFF	TRBV6-9	TRBJ1-1
TGTGCCAGCAGCCCAGGGACAGGGGGCTACGAGCAGTACTTC	CASSPGTGGYEQYF	TRBV11-3	TRBJ2-7
TGTGCCAGCAAACCTGATACAGGGGGGTCGGGAAACACCATATATTTT	CASKPDTGGSGNTIYF	TRBV27	TRBJ1-3
TGTGCCAGTCGGACTAGCGGGCACGCCTACAATGAGCAGTTCTTC	CASRTSGHAYNEQFF	TRBV19	TRBJ2-1
TGTGCCAGCAGTGACTTCTACAGGGCCTCCTACGAGCAGTACTTC	CASSDFYRASYEQYF	TRBV2	TRBJ2-7
TGCGCCAGCAGCTTAGCGCTTCACCAAGAGACCCAGTACTTC	CASSLALHQETQYF	TRBV5-1	TRBJ2-5
TGTGCCAGCAGCCTCCGGGAGCAGTACTTC	CASSLREQYF	TRBV6-1	TRBJ2-7
TGTGCCAGCAGTATGAACAGGCGTTGGACTAGCGGGGGGCAATGGTACCAAGAGACCCAGTACTTC	CASSMNRRWTSGGQWYQETQYF	TRBV6-5	TRBJ2-5
TGTGCCAGCAGCTCCGGGGGGGGATGCTCTGGGGCCAACGTCCTGACTTTC	CASSSGGGCSGANVLTF	TRBV7-9	TRBJ2-6
TGCAGTGCTAGGCGGGAGCGGCTCAATGAGCAGTTCTTC	CSARRERLNEQFF	TRBV20-1	TRBJ2-1
TGTGCCAGCAGCCAAGATCGACAGGGTTGTGGCTACACCTTC	CASSQDRQGCGYTF	TRBV3-1	TRBJ1-2
TGCGCCAGCAGCTGTAATCCCAGGGAAGTGGGGGGCCGAGCGGACGAGCAGTACTTC	CASSCNPREVGGRADEQYF	TRBV5-1	TRBJ2-7
TGTGCCAGCCAAGGGACAGGGGCTCCACGTCTGAGCAGCAATCAGCCCCAGCATTTT	CASQGTGAPRLSSNQPQHF	TRBV6-5	TRBJ1-5
TGTGCCAGCAGCTTACTCCCCGTGGACAGGCCGGTTACCGGGGAGCTGTTTTTT	CASSLLPVDRPVTGELFF	TRBV11-3	TRBJ2-2
TGTGCCAGCAGCCCCCGGGTGGATAGCAATCAGCCCCAGCATTTT	CASSPRVDSNQPQHF	TRBV3-1	TRBJ1-5
TGTGCCAGCAGCAGATGCAGCGTTAGAAGCTACCATCAAGAACTGTTTTTT	CASSRCSVRSYHQELFF	TRBV11-2	TRBJ1-4
TGTGCCAGCAGTTGGAAACTAGCGGGAGGGCAGAGGGATGAGCAGTTCTTC	CASSWKLAGGQRDEQFF	TRBV6-5	TRBJ2-1
TGTGCCAGTAGTATCGGGGGAGAGTACGAGCAGTACTTC	CASSIGGEYEQYF	TRBV19	TRBJ2-7
TGCGCCAGCGGCCACGACGAGCAGTACTTC	CASGHDEQYF	TRBV10-2	TRBJ2-7
TGCAGTGCTAGAGATTGGGGGGTTGGCTACACCTTC	CSARDWGVGYTF	TRBV20-1	TRBJ1-2
TGTGCCACCAGTGATACCGAGGTCGACACCGGGGAGCTGTTTTTT	CATSDTEVDTGELFF	TRBV24-1	TRBJ2-2
TGCGCCAGCAGCTTGAGGTTGTCCCCCGGACTAGCGGGCAGGAATGAGCAGTTCTTC	CASSLRLSPGLAGRNEQFF	TRBV5-1	TRBJ2-1
TGTGCCAGCAGGCCGGTAAGCTACGAGCAGTACTTC	CASRPVSYEQYF	TRBV28	TRBJ2-7
TGCGCCAGCAGTGAGACCCTCCTCTCTAGAGAGCAGTACGAGCAGTACTTC	CASSETLLSREQYEQYF	TRBV10-1	TRBJ2-7
TGTTCGGGGCCAGGTGGCTACACCTTC	CSGPGGYTF	TRBV7-9	TRBJ1-2
TGCGCCAGCAGCCAAGACCCTAATTGGGACGAAGGGGGAGCTAATGAAAAACTGTTTTTT	CASSQDPNWDEGGANEKLFF	TRBV4-3	TRBJ1-4
TGTGCCAGCAGCTTAGCGCTCCGGGAGGGGAGGGAGTCCTACAATGAGCAGTTCTTC	CASSLALREGRESYNEQFF	TRBV7-9	TRBJ2-1
TGTGCCAGCAGCTTCTGTCAGCTACAGGGGGCAAAAGGACAGCCCCAGCATTTT	CASSFCQLQGAKGQPQHF	TRBV7-6	TRBJ1-5
TGTGCCAGCAGTTACCCTGAGTGTGGGGGAGGAAGCAATGAGCAGTTCTTC	CASSYPECGGGSNEQFF	TRBV6-5	TRBJ2-1
TGTGCCAGCAGGCGGGGGGCCTGGTACAATGAGCAGTTCTTC	CASRRGAWYNEQFF	TRBV6-5	TRBJ2-1
TGTGCTAGTGGTTTGGTACCTGGACAGGGGGCTCACATAGGCATGAACACTGAAGCTTTCTTT	CASGLVPGQGAHIGMNTEAFF	TRBV12-5	TRBJ1-1
TGTGCCAGCAGACGCCACACTAACTACGAGCAGTACTTC	CASRRHTNYEQYF	TRBV7-2	TRBJ2-7
TGTGCCAGCGGGGGAGGGGGTGAGCAGTTCTTC	CASGGGGEQFF	TRBV7-9	TRBJ2-1
TGTGCCAGCAGTTATAATCGACATGTTATAAATGAAAAACTGTTTTTT	CASSYNRHVINEKLFF	TRBV6-9	TRBJ1-4
TGCGCCAGCAGCCAAGATGGAGGGATTCTTCAGCCCCAGCATTTT	CASSQDGGILQPQHF	TRBV4-1	TRBJ1-5
TGCGCCAGCAGCCAAGTAGCAGGGGGAACCGGCTATGGCTACACCTTC	CASSQVAGGTGYGYTF	TRBV4-1	TRBJ1-2
TGTGCCAGCCAGCGAGGGACAGGTCTCTCTGGAAACACCATATATTTT	CASQRGTGLSGNTIYF	TRBV2	TRBJ1-3
TGCGCCAGCAGCTTGGGTCCCAGACTGAACACAGATACGCAGTATTTT	CASSLGPRLNTDTQYF	TRBV5-1	TRBJ2-3
TGTGCCAGCAGGCAAACGTCCTACGAGCAGTACTTC	CASRQTSYEQYF	TRBV6-3	TRBJ2-7
TGTGCCACCAGCAGAGATGGTAAGGACAGGGCGAACACTGAAGCTTTCTTT	CATSRDGKDRANTEAFF	TRBV15	TRBJ1-1
TGTGCCTGGGTCCAGAACCCCTACAATGAGCAGTTCTTC	CAWVQNPYNEQFF	TRBV30	TRBJ2-1
TGCGCCAGCAGCCTCGGGGGGGCCCCCGTTACAGATACGCAGTATTTT	CASSLGGAPVTDTQYF	TRBV5-1	TRBJ2-3
TGTGCCAGCAGCCCAGGGGGGCTAGAGACCCAGTACTTC	CASSPGGLETQYF	TRBV4-2	TRBJ2-5
TGTGCCACCAGTGAGGGGGGGAAGGACACCGGGGAGCTGTTTTTT	CATSEGGKDTGELFF	TRBV24-1	TRBJ2-2
TGCAGTGCTGATAGATACGAGCAGTACTTC	CSADRYEQYF	TRBV20-1	TRBJ2-7
TGTGCCAGCAGTGGTCTTCAATACCCGGGACAGGGGCAGTACTTC	CASSGLQYPGQGQYF	TRBV6-1	TRBJ2-7
TGCAGTGCGGCAGCTGACTACAATGAGCAGTTCTTC	CSAAADYNEQFF	TRBV20-1	TRBJ2-1
TGCGCCAGCAGTGAGGGTTTAGTCGGGACACTCACCGGGGAGCTGTTTTTT	CASSEGLVGTLTGELFF	TRBV10-2	TRBJ2-2
TGTGCCAGCGTAGGAGGGGGGCTGGGAGACAATGAGCAGTTCTTC	CASVGGGLGDNEQFF	TRBV6-1	TRBJ2-1
TGTGCCAGCAGCCAGCAGGGCGTAATGGATCAGCCCCAGCATTTT	CASSQQGVMDQPQHF	TRBV14	TRBJ1-5
TGTGCCAGCAGTTTATCGACGATTCAGGGGAGTGGTCCCTACAATGAGCAGTTCTTC	CASSLSTIQGSGPYNEQFF	TRBV28	TRBJ2-1
TGCGCCAGCAGTGAGAGGGGGGAGGGAAATGAGCAGTTCTTC	CASSERGEGNEQFF	TRBV10-2	TRBJ2-1
TGTGCCAGCAGTTACAGGGGCCAGGGGGAGGGGCAAGAGACCCAGTACTTC	CASSYRGQGEGQETQYF	TRBV6-6	TRBJ2-5
TGTGCCAGCAGTGAAGCGCTTTACAGGGCTTCGGGGGAAAAACTGTTTTTT	CASSEALYRASGEKLFF	TRBV2	TRBJ1-4
TGTGCCAGCAGCGAGGCGACAGGGAGCTCCTACGAGCAGTACTTC	CASSEATGSSYEQYF	TRBV7-3	TRBJ2-7
TGTGCCAGCAGTATAGACAGGTACCGCTCTGGAAACACCATATATTTT	CASSIDRYRSGNTIYF	TRBV27	TRBJ1-3
TGTGCCACCAGCACCCCTGGGGCCGGGACTAGGGGGGAGCTGTTTTTT	CATSTPGAGTRGELFF	TRBV15	TRBJ2-2
TGTGCCAGCAGCCGAGGGAATGAGCAGTTCTTC	CASSRGNEQFF	TRBV13	TRBJ2-1
TGTGCCAGCAGCCCCTCCGGGACAGGGAGTCGGTTCTCCTACGAGCAGTACTTC	CASSPSGTGSRFSYEQYF	TRBV4-2	TRBJ2-7
TGTGCCAGCAACCGAAGAAGCAATCAGCCCCAGCATTTT	CASNRRSNQPQHF	TRBV27	TRBJ1-5
TGCGCCAGCAGCTTGGCCGGGACTAGCGGGAGGTGTGATACCTCCTACGAGCAGTACTTC	CASSLAGTSGRCDTSYEQYF	TRBV5-1	TRBJ2-7
TGTGCCAGCAGCAGAGGCAAAAAAAGGAACTACGAGCAGTACTTC	CASSRGKKRNYEQYF	TRBV7-2	TRBJ2-7
TGTGCCAGCAGGGACCCACTACGCAATCAGCCCCAGCATTTT	CASRDPLRNQPQHF	TRBV2	TRBJ1-5
TGTGCCATTGGGGGGGACCGGCACAATGAGCAGTTCTTC	CAIGGDRHNEQFF	TRBV24-1	TRBJ2-1
TGTGCCAGCAGCCAATGGAGGGACACGAACTATGGCTACACCTTC	CASSQWRDTNYGYTF	TRBV16	TRBJ1-2
TGCAGTGCTCTTCCACAGGGATGGGGGAATGAAAAACTGTTTTTT	CSALPQGWGNEKLFF	TRBV20-1	TRBJ1-4
TGTGCCAGCAGGACAGGGGTCAACACCGGGGAGCTGTTTTTT	CASRTGVNTGELFF	TRBV6-1	TRBJ2-2
TGCGCCAGCAGCCAAGACTCGGGACACTCGAACACCGGGGAGCTGTTTTTT	CASSQDSGHSNTGELFF	TRBV4-3	TRBJ2-2
TGTGCCAGCAGGCAAGACAGGGACACTGAAGCTTTCTTT	CASRQDRDTEAFF	TRBV7-9	TRBJ1-1
TGTGCCTGGAGGGAAGTCGGTACATCACCCCTCCACTTT	CAWREVGTSPLHF	TRBV30	TRBJ1-6
TGCAGTGCAGCCTTTTGCCGGCGGGAGTCGGGTCAGCCCCAGCATTTT	CSAAFCRRESGQPQHF	TRBV20-1	TRBJ1-5
TGTGCCAGCAGCACTGGGGTCAGCTCCTACAATGAGCAGTTCTTC	CASSTGVSSYNEQFF	TRBV7-6	TRBJ2-1
TGTGCCAGCACAGAATGCTCTGGAAACACCATATATTTT	CASTECSGNTIYF	TRBV6-4	TRBJ1-3
TGTGCCAGCAGTTACGAGGACTACAATGAGCAGTTCTTC	CASSYEDYNEQFF	TRBV6-6	TRBJ2-1
TGTGCCAGCAGCTTACAAAGGGACAGGAACACTGAAGCTTTCTTT	CASSLQRDRNTEAFF	TRBV11-3	TRBJ1-1
TGTGCCATCAGACGGGGGGGAAGGGCCAATGAGCAGTTCTTC	CAIRRGGRANEQFF	TRBV10-3	TRBJ2-1
TGCGCCAGCAGTGCCCGGCCCAGGAAAACGGCGAGGGGAGGAAACACCATATATTTT	CASSARPRKTARGGNTIYF	TRBV10-1	TRBJ1-3
TGTGCCACCAGCAGAACTCTGGGGGGGTACACCGGGGAGCTGTTTTTT	CATSRTLGGYTGELFF	TRBV15	TRBJ2-2
TGTGCCAGCAGCAGGGGGAGGGTAGTGGTGATTTATGGCTACACCTTC	CASSRGRVVVIYGYTF	TRBV7-2	TRBJ1-2
TGTGCCAGGGGGGTGGATGGCTACACCTTC	CARGVDGYTF	TRBV7-8	TRBJ1-2
TGTGCCAGCAGTCAGTCCCCCTGGCAAACTGGGGCCAACGTCCTGACTTTC	CASSQSPWQTGANVLTF	TRBV12-4	TRBJ2-6
TGTGCCAGCTCACCGGGGGGAGAGGTGCTAGCGGGGAGGAGATACTCCTACAATGAGCAGTTCTTC	CASSPGGEVLAGRRYSYNEQFF	TRBV18	TRBJ2-1
TGTGCCAGCAGCCCCCCCCGGGGCAGTTACTATGGCTACACCTTC	CASSPPRGSYYGYTF	TRBV7-9	TRBJ1-2
TGTGCCAGCAGTGAAGCGGGCGGAAATGAAGCTTTCTTT	CASSEAGGNEAFF	TRBV6-1	TRBJ1-1
TGTGCCACCAGTGAACCCCCTACTCGGGGGATCTATGGCTACACCTTC	CATSEPPTRGIYGYTF	TRBV24-1	TRBJ1-2
TGTGCCAGCAGTGAATCGAAGGGACAGGGGCTAGAGACCCAGTACTTC	CASSESKGQGLETQYF	TRBV25-1	TRBJ2-5
TGTGCCAGCAGCTTAGGGACTAGGATAGGAAATGCTGAGCAGTTCTTC	CASSLGTRIGNAEQFF	TRBV7-6	TRBJ2-1
TGTGCCAGCAGCCGGGACTCAGGCTATGGCTACACCTTC	CASSRDSGYGYTF	TRBV13	TRBJ1-2
TGTGCCAGCAGCGGGTATTCTACAGATACGCAGTATTTT	CASSGYSTDTQYF	TRBV7-7	TRBJ2-3
TGTGCCAGCAGTTCTGGGCTGGCCTATGATACGCAGTATTTT	CASSSGLAYDTQYF	TRBV6-8	TRBJ2-3
TGTGCCAGCAGCTTCGGTCCAAAAATTCGGGACACGGGGACTAGCGGGAAGAACACCGGGGAGCTGTTTTTT	CASSFGPKIRDTGTSGKNTGELFF	TRBV7-4	TRBJ2-2
TGTGCCAGCAGTTACTCGAGCTCGGGGGGGGCTGGCTACACCTTC	CASSYSSSGGAGYTF	TRBV6-5	TRBJ1-2
TGTGCCAGCAGTTGTCCGACGGACCCGGGGGGAGTAGCCAAAAACATTCAGTACTTC	CASSCPTDPGGVAKNIQYF	TRBV27	TRBJ2-4
TGTGCCAGCAGAGTGTTGTTTACACTAGCGGGAAGGGCAGATGAGCAGTTCTTC	CASRVLFTLAGRADEQFF	TRBV6-4	TRBJ2-1
TGTGCCAGCTCACCCCCCCGTAGGCCGGGGTATGTCGAGCAGTACTTC	CASSPPRRPGYVEQYF	TRBV18	TRBJ2-7
TGTGCCAGCAGCTCTCCACTTCTACAAGAGACCCAGTACTTC	CASSSPLLQETQYF	TRBV5-6	TRBJ2-5
TGTGCCAGCAGGTCAAATTTCCCTACACGTAATGAGCAGTTCTTC	CASRSNFPTRNEQFF	TRBV6-5	TRBJ2-1
TGTGCCACGACTTTTCAGACTAGGTCCTACGAGCAGTACTTC	CATTFQTRSYEQYF	TRBV6-5	TRBJ2-7
TGTGCCAGCAGCTGGGACAGGGGCACAGATACGCAGTATTTT	CASSWDRGTDTQYF	TRBV5-6	TRBJ2-3
TGTGCCAGCAGCCCTAACGAAGTGGCGAACACCGGGGAGCTGTTTTTT	CASSPNEVANTGELFF	TRBV12-3	TRBJ2-2
TGTGCCAGCAGCACCCGCCCGGTAAATGAGCAGTTCTTC	CASSTRPVNEQFF	TRBV13	TRBJ2-1
TGTGCCAGCAGTGAAGTGTCGAGATGGCAGTACTTC	CASSEVSRWQYF	TRBV6-1	TRBJ2-7
TGTGCCAGCAGTGAACGACTAGCGGACTTCCCGGGCTACGAGCAGTACTTC	CASSERLADFPGYEQYF	TRBV6-1	TRBJ2-7
TGTGCCAGCAGCGCTTACGTGACAGCTTTCTTT	CASSAYVTAFF	TRBV9	TRBJ1-1
TGTGCCAGCAGGCGGGCGAACTCTGGGGCCAACGTCCTGACTTTC	CASRRANSGANVLTF	TRBV6-6	TRBJ2-6
TGCGCCAGCAGAGTTCCAAACAGGAGCAACTATGGCTACACCTTC	CASRVPNRSNYGYTF	TRBV10-1	TRBJ1-2
TGTGCCAGCAGTGAAGAAGCGGGACAGGTGGCCGGGGAGCTGTTTTTT	CASSEEAGQVAGELFF	TRBV2	TRBJ2-2
TGCAGTTATAGCTATTCCGAGCAGTACTTC	CSYSYSEQYF	TRBV20-1	TRBJ2-7
TGTGCCAGCAGTTATCCCGTGGGAAACACCATATATTTT	CASSYPVGNTIYF	TRBV6-2	TRBJ1-3
TGTGCCAGCAGGGTTTGCTCCGGGACAGGGGGCCTGGGGTATGGCTACACCTTC	CASRVCSGTGGLGYGYTF	TRBV6-4	TRBJ1-2
TGTGCCAGCAGTCGGCTCCTAACTCGGGGGCCCCAGCCCCAGCATTTT	CASSRLLTRGPQPQHF	TRBV27	TRBJ1-5
TGCGCCAGCAGTGAGGCGGGGGGGACAGGGAGGCAGTTCTTC	CASSEAGGTGRQFF	TRBV10-1	TRBJ2-1
TGTGCCAGCAGCGGGATTATATCGGGGTATGAGCAGTTCTTC	CASSGIISGYEQFF	TRBV7-3	TRBJ2-1
TGTGCCACCAGTGATTTGTCCGGGCCGACTACTCCGGCAGATACGCAGTATTTT	CATSDLSGPTTPADTQYF	TRBV24-1	TRBJ2-3
TGTGCCAGCAGCCCGGGACAGGGGAGCACAGATACGCAGTATTTT	CASSPGQGSTDTQYF	TRBV5-5	TRBJ2-3
TGTGCCAGCAAGGAGCAGTTCTTC	CASKEQFF	TRBV6-6	TRBJ2-1
TGCAGTGCAAGGGGGGAGGGGTATGAGCAGTTCTTC	CSARGEGYEQFF	TRBV20-1	TRBJ2-1
TGTGCCATGGGACAGGGAAATAATTCACCCCTCCACTTT	CAMGQGNNSPLHF	TRBV7-7	TRBJ1-6
TGCAGTGGGGGAAACAGGCCCTACGAGCAGTACTTC	CSGGNRPYEQYF	TRBV20-1	TRBJ2-7
TGTGCCAGCAGCCGCAGGTTAAGCTCCTATAATTCACCCCTCCACTTT	CASSRRLSSYNSPLHF	TRBV13	TRBJ1-6
TGTGCCAGCAGCTCCAGGGGGCTAGCCTACGAGCAGTACTTC	CASSSRGLAYEQYF	TRBV7-2	TRBJ2-7
TGTGCCAGCAGGTCCTGCCAAGAGACCCAGTACTTC	CASRSCQETQYF	TRBV2	TRBJ2-5
TGTGCCAGCAGCTTAGGCCTGGGGGAGCAGTACTTC	CASSLGLGEQYF	TRBV13	TRBJ2-7
TGCAGTGCTAGAGCCGACAGGTCCGCTGAAGCTTTCTTT	CSARADRSAEAFF	TRBV20-1	TRBJ1-1
TGTCCGGGACTAGCGGGGAACTACGAGCAGTACTTC	CPGLAGNYEQYF	TRBV10-3	TRBJ2-7
TGTGCCACCGTTTTCCTCTTCGGCCCAGGGGGTGGGCACACTGAAGCTTTCTTT	CATVFLFGPGGGHTEAFF	TRBV24-1	TRBJ1-1
TGTGCCAGCAGGGAAGAGGTTGATATTAATCAGCCCCAGCATTTT	CASREEVDINQPQHF	TRBV6-1	TRBJ1-5
TGTGCCAGCAGCTTAACGGACAGCCTTTGTCGCAATTCACCCCTCCACTTT	CASSLTDSLCRNSPLHF	TRBV7-3	TRBJ1-6
TGTGCCAGCAGCCACCCGAACAATGAGCAGTTCTTC	CASSHPNNEQFF	TRBV7-2	TRBJ2-1
TGCGCCAGCAGTGGTAAGTCGGGACAGGGGGGTACAACTTATGGCTACACCTTC	CASSGKSGQGGTTYGYTF	TRBV10-1	TRBJ1-2
TGTGCCAGCATTTCGCAGGGGAGCCCAAACTCTGGGGCCAACGTCCTGACTTTC	CASISQGSPNSGANVLTF	TRBV6-4	TRBJ2-6
TGTGCCAGCCTTGGGACATGGGCAACTAATGAAAAACTGTTTTTT	CASLGTWATNEKLFF	TRBV7-3	TRBJ1-4
TGTGCCAGCAGTCCCGGACGGACAGGTAATTCACCCCTCCACTTT	CASSPGRTGNSPLHF	TRBV12-4	TRBJ1-6
TGTGCCAGCAGCTCCGGTCGACAGGGTGTAGCCTACGAGCAGTACTTC	CASSSGRQGVAYEQYF	TRBV7-9	TRBJ2-7
TGTGCCAGCAGCAGGAGGAGGGGGGGGATGCGTCAACACAATGAGCAGTTCTTC	CASSRRRGGMRQHNEQFF	TRBV5-5	TRBJ2-1
TGCGCCAGCAGCTTGGGGGGAGGGTTGTACTTC	CASSLGGGLYF	TRBV5-1	TRBJ2-4
TGTGCTAGTGGTTTGGGGGGTTTGGGGGCTTACTATGGCTACACCTTC	CASGLGGLGAYYGYTF	TRBV12-5	TRBJ1-2
TGTGCCACCCAACAGCGGGTATACAATGAGCAGTTCTTC	CATQQRVYNEQFF	TRBV24-1	TRBJ2-1
TGTGCCAGCAGTTGTCCTCGGCAGAGCTATGGCTACACCTTC	CASSCPRQSYGYTF	TRBV6-5	TRBJ1-2
TGCAGTGCTGGGAGGCGCACCTACGAGCAGTACTTC	CSAGRRTYEQYF	TRBV20-1	TRBJ2-7
TGTGCCAGCAGTGACGAACTGGGCTATGGCTACACCTTC	CASSDELGYGYTF	TRBV6-4	TRBJ1-2
TGTGCCAGCAGTTGGGGACAGGACTATGGCTACACCTTC	CASSWGQDYGYTF	TRBV6-4	TRBJ1-2
TGTGCCAGCAGCCGGAAGGGAAATTGGTATGGCTACACCTTC	CASSRKGNWYGYTF	TRBV14	TRBJ1-2
TGTGCCACACCCGACAGGGGATGCTATGGCTACACCTTC	CATPDRGCYGYTF	TRBV27	TRBJ1-2
TGCAGTGCTAGAGGACAGGGGGAAGGCATTCAGTACTTC	CSARGQGEGIQYF	TRBV20-1	TRBJ2-4
TGTGCCAGCAGCTTAGCGAAGTCAGACCAGGACTACGAGCAGTACTTC	CASSLAKSDQDYEQYF	TRBV7-9	TRBJ2-7
TGTGCCAGCAGCTTAGAAAAGAGGGACAGGGGGCTAAATTCACCCCTCCACTTT	CASSLEKRDRGLNSPLHF	TRBV7-9	TRBJ1-6
TGTGCCAGCAGTAAGAGGGACAGATGGAACAATGAGCAGTTCTTC	CASSKRDRWNNEQFF	TRBV27	TRBJ2-1
TGTGCCAGCAGTTACCCTTCGGAAAGACTCGAGAAGTACAATGAGCAGTTCTTC	CASSYPSERLEKYNEQFF	TRBV6-9	TRBJ2-1
TGCGCCAGCAGCCACCAAGACAGGGTGGAAAAACTGTTTTTT	CASSHQDRVEKLFF	TRBV4-3	TRBJ1-4
TGTGCCAGCAGTGAAGGCATCGTCAGAGGAGAGACCCAGTACTTC	CASSEGIVRGETQYF	TRBV6-1	TRBJ2-5
TGCAGTGCAGCGGGACGGGGGGGAGAGACCCAGTACTTC	CSAAGRGGETQYF	TRBV20-1	TRBJ2-5
TGTGCCAGCAGCCAAAAGACCCCCTACGGACGTTACGAGCAGTACTTC	CASSQKTPYGRYEQYF	TRBV3-1	TRBJ2-7
TGCAGCGTTGGACAACCCGGGGTTGGGCTTAATGGCTACACCTTC	CSVGQPGVGLNGYTF	TRBV29-1	TRBJ1-2
TGCAGTGCTATACAGGGCGACAATGAGCAGTTCTTC	CSAIQGDNEQFF	TRBV20-1	TRBJ2-1
TGTGCCACCACTGGGGGGGACATTTATGGCTACACCTTC	CATTGGDIYGYTF	TRBV24-1	TRBJ1-2
TGCAGCGTTGAAGGCAGGGCGTCGGGGAGAGGGGCCAACGTCCTGACTTTC	CSVEGRASGRGANVLTF	TRBV29-1	TRBJ2-6
TGTGCCAGCAGCTTGGCTAGCCGTTCCGGGGCCCACCCCTACGAGCAGTACTTC	CASSLASRSGAHPYEQYF	TRBV5-4	TRBJ2-7
TGTGCCAGCCCCTCCGGGACAGGGGGCTCGGACTACGAGCAGTACTTC	CASPSGTGGSDYEQYF	TRBV28	TRBJ2-7
TGTGCCAGCAGCTTGGACACGGAGGAAAAACTGTTTTTT	CASSLDTEEKLFF	TRBV11-1	TRBJ1-4
TGTGCCAGCAGTTTCTACTCAGTTTACGGGGAGCTGTTTTTT	CASSFYSVYGELFF	TRBV6-2	TRBJ2-2
TGTGCCAGCAGCGACTATGGACAGGGTGATCAGCCCCAGCATTTT	CASSDYGQGDQPQHF	TRBV5-4	TRBJ1-5
TGTGCCAGTAGTCGGGGACTTTCCTACGAGCAGTACTTC	CASSRGLSYEQYF	TRBV19	TRBJ2-7
TGCGCCAGCAGCCAAGACGACGGTGCACAGGGGGCTCTTGATAGCAATCAGCCCCAGCATTTT	CASSQDDGAQGALDSNQPQHF	TRBV4-1	TRBJ1-5
TGTGCCAGCAGCTTGGCTCAGTCGTGCCCCTCTGGGGCCAACGTCCTGACTTTC	CASSLAQSCPSGANVLTF	TRBV5-8	TRBJ2-6
TGCAGTGCTAGATACTCTGGAAGCTATGGCTACACCTTC	CSARYSGSYGYTF	TRBV20-1	TRBJ1-2
TGTGCCTGCGGACTAGTCAAAAACATTCAGTACTTC	CACGLVKNIQYF	TRBV30	TRBJ2-4
TGTGCCAGCAGAACGCCAGGGGCTTCTGAAGCTTTCTTT	CASRTPGASEAFF	TRBV6-2	TRBJ1-1
TGTGCCAGCAGCGATCAGGGAGGATTAGCTTCCTACGAGCAGTACTTC	CASSDQGGLASYEQYF	TRBV7-9	TRBJ2-7
TGTGCCAGCTCGCTAGTATACGAGCAGTACTTC	CASSLVYEQYF	TRBV7-3	TRBJ2-7
TGCGCCAGCAGCTTCCACTTCCAGCCCCAGCATTTT	CASSFHFQPQHF	TRBV10-1	TRBJ1-5
TGTGCCAGCATTCAACTAGCGGGAGACTATGGCTACACCTTC	CASIQLAGDYGYTF	TRBV7-9	TRBJ1-2
TGTGCCAGCAGTGAATTCCCGGTAACCCAGCGGACAGGAAGGGGGAATTCACCCCTCCACTTT	CASSEFPVTQRTGRGNSPLHF	TRBV25-1	TRBJ1-6
TGTGCCAGCAGCGGGGGGGTAGGCTACACCTTC	CASSGGVGYTF	TRBV9	TRBJ1-2
TGCGCCCGGGGGGTCGGTAGGAACACTGAAGCTTTCTTT	CARGVGRNTEAFF	TRBV10-1	TRBJ1-1
TGTGCCACCAGTGATTGGGACAGGAGCTCTGGAAACACCATATATTTT	CATSDWDRSSGNTIYF	TRBV24-1	TRBJ1-3
TGTGCCAGAAACCCCCCGGGACTAGCGGGAGGAGGGGGAGGCACTGAAGCTTTCTTT	CARNPPGLAGGGGGTEAFF	TRBV2	TRBJ1-1
TGCGCCAGCAGCTATGAGGGATGTAATCAGCCCCAGCATTTT	CASSYEGCNQPQHF	TRBV5-1	TRBJ1-5
TGTGCCAGCAGCTTGTTCTACAGGGGGCCAGATGGAAACACCATATATTTT	CASSLFYRGPDGNTIYF	TRBV5-6	TRBJ1-3
TGCGCCAGCAGCTGTACACTTGGGAATGAAAAACTGTTTTTT	CASSCTLGNEKLFF	TRBV5-1	TRBJ1-4
TGCGCCAGCCCGAAGGGGGGGCGCTTGTACGAGCAGTACTTC	CASPKGGRLYEQYF	TRBV10-1	TRBJ2-7
TGTGCCTTGATTACAGGTGGGGGGGTTCTCGGGTTAGATACGCAGTATTTT	CALITGGGVLGLDTQYF	TRBV7-8	TRBJ2-3
TGTGCCAGCAGTTGGACTAGCGGGGTGAATGAGCAGTTCTTC	CASSWTSGVNEQFF	TRBV28	TRBJ2-1
TGTGCCACCTCCAAGTTGAGGGGTACGGCTAGCTCCTATAATTCACCCCTCCACTTT	CATSKLRGTASSYNSPLHF	TRBV24-1	TRBJ1-6
TGCGCCAGCAGCCTTACAGGGGGCCTCAAGCCGGTCGGCACAGATACGCAGTATTTT	CASSLTGGLKPVGTDTQYF	TRBV10-1	TRBJ2-3
TGTGCCAGCAGACGCCCTAGGACGGCAGGTGAAGCTTTCTTT	CASRRPRTAGEAFF	TRBV6-5	TRBJ1-1
TGTGCCAATCATCGGCGACAGAGAATCTTGAATGAGCAGTTCTTC	CANHRRQRILNEQFF	TRBV24-1	TRBJ2-1
TGTGCCAGCCCCCGGCGGCCAGGCTTTTGGGGGAGCTCCTACAATGAGCAGTTCTTC	CASPRRPGFWGSSYNEQFF	TRBV7-3	TRBJ2-1
TGTGCCAGCAGCTCGGCCACTAGGGACAGCGGTCCCGAGCAGTACTTC	CASSSATRDSGPEQYF	TRBV11-3	TRBJ2-7
TGTGCCAGCAGCGCCCGGGGCCGAGAAGCCCCCACTGAAGCTTTCTTT	CASSARGREAPTEAFF	TRBV5-8	TRBJ1-1
TGTGCCAGCTCAGGATATGCTTTCTTT	CASSGYAFF	TRBV6-1	TRBJ1-1
TGTGCCAGGTTTACAGTGACCCAGTACTTC	CARFTVTQYF	TRBV6-5	TRBJ2-5
TGTGCCACCAGCAGAGACTTCCGGGTAACAAGCCAGAGCTCCTACAATGAGCAGTTCTTC	CATSRDFRVTSQSSYNEQFF	TRBV15	TRBJ2-1
TGTGCCAGTAGTGCGAGCGGGATAACCCCCTACGAGCAGTACTTC	CASSASGITPYEQYF	TRBV19	TRBJ2-7
TGCAGTGCTAGAGAGCCATGTACGGGACAGACCGGGGAGCTGTTTTTT	CSAREPCTGQTGELFF	TRBV20-1	TRBJ2-2
TGTGCCAGCAGCTGGATCGGATTATACGAGCAGTACTTC	CASSWIGLYEQYF	TRBV5-6	TRBJ2-7
TGTGCCAGCAGCGGGGACAGGGGGTATCAGCCCCAGCATTTT	CASSGDRGYQPQHF	TRBV19	TRBJ1-5
TGCGCCAGCAGTAGGGGCTACGAGCAGTACTTC	CASSRGYEQYF	TRBV5-1	TRBJ2-7
TGTGCCAGCAGTTCACTAGCGGTTGGGGATGAGCAGTTCTTC	CASSSLAVGDEQFF	TRBV6-5	TRBJ2-1
TGTGCCAGCAGTCGTCCGGGACAGGGGCCCAACTACGAGCAGTACTTC	CASSRPGQGPNYEQYF	TRBV2	TRBJ2-7
TGTGCCAGTAGGACTAGCGGGGGACGCTGGTCGTACCAAGAGACCCAGTACTTC	CASRTSGGRWSYQETQYF	TRBV19	TRBJ2-5
TGTGCCAGCTCACCAGGACGGGTAGATAGCTCCTATAATTCACCCCTCCACTTT	CASSPGRVDSSYNSPLHF	TRBV18	TRBJ1-6
TGTGCCAGCTACCGGGACAGGGGAGTAAGGCGACATGAAAAACTGTTTTTT	CASYRDRGVRRHEKLFF	TRBV6-5	TRBJ1-4
TGTGCCAGCAAACAGGGGGCCGTATTAAATGAAAAACTGTTTTTT	CASKQGAVLNEKLFF	TRBV25-1	TRBJ1-4
TGTGCCAGCAGTTTTCTTCCCATGGACAGGGTATGGGTGCACTATGGCTACACCTTC	CASSFLPMDRVWVHYGYTF	TRBV28	TRBJ1-2
TGTGCCAGCAGCGGGACAGGCCAAGAGACCCAGTACTTC	CASSGTGQETQYF	TRBV6-5	TRBJ2-5
TGTGCCACCAGTGTGGTGAGAGGTGGGGCCAACGTCCTGACTTTC	CATSVVRGGANVLTF	TRBV24-1	TRBJ2-6
TGTGCTAGTGGTTTGGCTGAAAGTAGGACAGGGGAGAGGTTATGGGGGTACAACACTGAAGCTTTCTTT	CASGLAESRTGERLWGYNTEAFF	TRBV12-5	TRBJ1-1
TGTGCCAGCAGTGGGCAGCCTCTTCAAGAGACCCAGTACTTC	CASSGQPLQETQYF	TRBV2	TRBJ2-5
TGTGCCAGCAGAGATAGGGGCGAGCAGTACTTC	CASRDRGEQYF	TRBV28	TRBJ2-7
TGTGCCAGCAGTTTCACAGGGTTTAGCACAGATACGCAGTATTTT	CASSFTGFSTDTQYF	TRBV27	TRBJ2-3
TGTGCCACTCAAATCGACGACAGGGACCCTGCTTTCTTT	CATQIDDRDPAFF	TRBV13	TRBJ1-1
TGCAGTGCTAGCCAAACTAGCGGGGGGGCAAATCGTACCCAGTACTTC	CSASQTSGGANRTQYF	TRBV20-1	TRBJ2-5
TGCAGTGCTAGACCGGGGAAAGACAGGGATGACTATGGCTACACCTTC	CSARPGKDRDDYGYTF	TRBV20-1	TRBJ1-2
TGTGCCAGCACAGGGCCCCCGGGGGGAAGGAATGAGCAGTTCTTC	CASTGPPGGRNEQFF	TRBV6-4	TRBJ2-1
TGTGCCACCAGTGATGCCTCGGGGGGGGGAGTTAGGAGATGCAGCTCCTACGAGCAGTACTTC	CATSDASGGGVRRCSSYEQYF	TRBV24-1	TRBJ2-7
TGTGCCATTTTAGAACGGAGCGGGAGCGAGACCCAGTACTTC	CAILERSGSETQYF	TRBV10-3	TRBJ2-5
TGCGCCAGCAGCCTTCGGGAGGTGAACACCGGGGAGCTGTTTTTT	CASSLREVNTGELFF	TRBV5-1	TRBJ2-2
TGCATTCCCGACAGGGCCAAGTTGACCCAGTACTTC	CIPDRAKLTQYF	TRBV20-1	TRBJ2-5
TGCAGCGTGCGGGGTCTAGCTAACTATGGCTACACCTTC	CSVRGLANYGYTF	TRBV29-1	TRBJ1-2
TGTGCCAGCAGTGGGAACAGGGCGGGGCTACGTTCTGAAAAACTGTTTTTT	CASSGNRAGLRSEKLFF	TRBV6-4	TRBJ1-4
TGTGCCAGCAGTTTACCCAGGGACGAGGCGACCTCTGGAAACACCATATATTTT	CASSLPRDEATSGNTIYF	TRBV28	TRBJ1-3
TGTGCCAGCAGTGGGTTACCAGACAGGGAAGCTTTCTTT	CASSGLPDREAFF	TRBV6-4	TRBJ1-1
TGTGCCACCATTCACCTTATCCAATACAATGGAGGGGTCTACGAGCAGTACTTC	CATIHLIQYNGGVYEQYF	TRBV24-1	TRBJ2-7
TGTGCCCCCCGTAGATCCGGGACTCGGTTTACCTACGAGCAGTACTTC	CAPRRSGTRFTYEQYF	TRBV5-6	TRBJ2-7
TGTGCCAGCAGCCCCCAAAGGACAGCGCCTTCACCCCTCCACTTT	CASSPQRTAPSPLHF	TRBV7-4	TRBJ1-6
TGTGCCAGCAGCTGCCAGCGGGGGAGAAACGAGCAGTACTTC	CASSCQRGRNEQYF	TRBV11-3	TRBJ2-7
TGTGCCAGCAGTTTATTTATGGGACAGGGCCATAGAGAGACCCAGTACTTC	CASSLFMGQGHRETQYF	TRBV28	TRBJ2-5
TGTGCCACCAGTGATTTGCCGACAGGGTCTAACACTGAAGCTTTCTTT	CATSDLPTGSNTEAFF	TRBV24-1	TRBJ1-1
TGTGCCAGCTCACCACATGAGAACAATGAGCAGTTCTTC	CASSPHENNEQFF	TRBV18	TRBJ2-1
TGTGCCAGCAGCTTGGTACGGCGCCTCTCCTACGAGCAGTACTTC	CASSLVRRLSYEQYF	TRBV5-8	TRBJ2-7
TGTGCTAGCAGCTTAGCGTCCATGCCGGGACAGGGGCCGACTAGCAATCAGCCCCAGCATTTT	CASSLASMPGQGPTSNQPQHF	TRBV7-7	TRBJ1-5
TGTGCCAGCAGTGAACAGGGGGTTGAAAAACTGTTTTTT	CASSEQGVEKLFF	TRBV25-1	TRBJ1-4
TGTGCCTGGACACGGGACTCAACTGGCAGCAATCAGCCCCAGCATTTT	CAWTRDSTGSNQPQHF	TRBV30	TRBJ1-5
TGTGCCAGCAGTCAGCCGTTCGTTCGACAGGGGTGCTCCTACGAGCAGTACTTC	CASSQPFVRQGCSYEQYF	TRBV27	TRBJ2-7
TGTGCCAGCAGTTGGGGGGCCGGGGGGGGCCGGAAGAGTTTGAGCTCCTACAATGAGCAGTTCTTC	CASSWGAGGGRKSLSSYNEQFF	TRBV28	TRBJ2-1
TGTGCTAGTGGTCCCGGGACAGGGGGCGCAAAGAAGAGCTACACCTTC	CASGPGTGGAKKSYTF	TRBV12-5	TRBJ1-2
TGCGCCAGCAGCCAAGATGCGAGGGTGATCTCTGGAAACACCATATATTTT	CASSQDARVISGNTIYF	TRBV4-1	TRBJ1-3
TGTGCCAGCCTATACACTAGAGCAGGCTACAATGAGCAGTTCTTC	CASLYTRAGYNEQFF	TRBV7-7	TRBJ2-1
TGTGCCAGCAGTGAACGTCCTCCCCCTAGCGGGACGTTAAACAATGAGCAGTTCTTC	CASSERPPPSGTLNNEQFF	TRBV12-4	TRBJ2-1
TGTGCCTGCGTACCGGGACAGGGTCCGACTAGGAACAACAATCAGCCCCAGCATTTT	CACVPGQGPTRNNNQPQHF	TRBV30	TRBJ1-5
TGTGCCAGCAGTTACCGAAGCTTCTGGACAGGGATTCCCGGGAGAGAGACCCAGTACTTC	CASSYRSFWTGIPGRETQYF	TRBV6-5	TRBJ2-5
TGTGCCAGCAGGCATCCCATTCTGGGGGGGTTATTCGATGCCTACGAGCAGTACTTC	CASRHPILGGLFDAYEQYF	TRBV28	TRBJ2-7
TGTGCCAGCAGCTTGGCCGCGGTTCTACTTATTTATTCGCCTAACCGAGATCAGCCCCAGCATTTT	CASSLAAVLLIYSPNRDQPQHF	TRBV14	TRBJ1-5
TGTGCCACCAGCACCTTCTTCCCGGACAGGGAACAAGAGACCCAGTACTTC	CATSTFFPDREQETQYF	TRBV15	TRBJ2-5
TGCGCCAGCACTGATTCACCCCTCCACTTT	CASTDSPLHF	TRBV10-1	TRBJ1-6
TGTGCCAGCACAAAAGGTCGGAATTCAAGCCGGGGCCGCTATAGCAATCAGCCCCAGCATTTT	CASTKGRNSSRGRYSNQPQHF	TRBV14	TRBJ1-5
TGTGCCAGCACGGGGACGGCTGGGGCCAACGTCCTGACTTTC	CASTGTAGANVLTF	TRBV6-2	TRBJ2-6
TGTGCCAGCAGCTTGAAACCTGGTAGGAAACCCGAGCAGTACTTC	CASSLKPGRKPEQYF	TRBV5-4	TRBJ2-7
TGTGCCAGCACGTGGGTCCAAACACATGTTTACACCGGGGAGCTGTTTTTT	CASTWVQTHVYTGELFF	TRBV6-1	TRBJ2-2
TGTGCCAGCAGAATCAGGAATGAGCAGTTCTTC	CASRIRNEQFF	TRBV12-3	TRBJ2-1
TGTGCCAGCAGCTCTCGAGGGGGCGATTACGGTTTAAAACTGTTTTTT	CASSSRGGDYGLKLFF	TRBV7-9	TRBJ1-4
TGTGCCAGCATTTACGGGGGGACAGGGTTCTGCTACGAGCAGTACTTC	CASIYGGTGFCYEQYF	TRBV27	TRBJ2-7
TGTGCCAGCAGTTACGGACTAGCGGGCACCGACCAAGAGACCCAGTACTTC	CASSYGLAGTDQETQYF	TRBV6-5	TRBJ2-5
TGTGCCAGCAGCCCCCTGGGGAACACTGAAGCTTTCTTT	CASSPLGNTEAFF	TRBV3-1	TRBJ1-1
TGTGCCAGCACCCCCAGCCGGACCCTCCAGCCTCCGAGCTACGAGCAGTACTTC	CASTPSRTLQPPSYEQYF	TRBV27	TRBJ2-7
TGTGCCAGCAGCCCCGACACAGGCTTAGACAGTTACAATCAGCCCCAGCATTTT	CASSPDTGLDSYNQPQHF	TRBV3-1	TRBJ1-5
TGTGCCTGGAGTGTACAGCGTAGTAGTGCCTACGAGCAGTACTTC	CAWSVQRSSAYEQYF	TRBV30	TRBJ2-7
TGTGCCAGCAGTTACTCGTGCACAGGGGGGACCGAAGGAAGCGAGCAGTACTTC	CASSYSCTGGTEGSEQYF	TRBV6-6	TRBJ2-7
TGCAGCGGAGGCAGGGAAGAGACCCAGTACTTC	CSGGREETQYF	TRBV29-1	TRBJ2-5
TGTGCGCGCGACAGGGGTTCCTACGAGCAGTACTTC	CARDRGSYEQYF	TRBV6-2	TRBJ2-7
TGTGCCAGCAGCCGGGACTGGAGCTCCTACAATGAGCAGTTCTTC	CASSRDWSSYNEQFF	TRBV27	TRBJ2-1
TGTGCTAGTGGTTTAGCTTTCTTT	CASGLAFF	TRBV12-5	TRBJ1-1
TGCAGTGCTAGCCGGATCGGACAGCACACTGAAGCTTTCTTT	CSASRIGQHTEAFF	TRBV20-1	TRBJ1-1
TGTGCCAGCCGACTCATCCGAAGTAGGGACGTGGGCACCGGGGAGCTGTTTTTT	CASRLIRSRDVGTGELFF	TRBV25-1	TRBJ2-2
TGTGCCAGACATGCCTACGAGCAGTACTTC	CARHAYEQYF	TRBV6-5	TRBJ2-7
TGCGCCAGCAGTGAGGGAAACGCTAGCGGAATAGCCAAAAACATTCAGTACTTC	CASSEGNASGIAKNIQYF	TRBV10-1	TRBJ2-4
TGTGCCAGCAGTGATTCAGCGTACGAATCACTCTCTGGAAACACCATATATTTT	CASSDSAYESLSGNTIYF	TRBV6-1	TRBJ1-3
TGTGCCAGCAGCTTCTCCGAGGAGTCCGAGACCCAGTACTTC	CASSFSEESETQYF	TRBV7-9	TRBJ2-5
TGTGCCAGCAGTGCCGCAGGGACAGCCGTACCCTACGAGCAGTACTTC	CASSAAGTAVPYEQYF	TRBV6-1	TRBJ2-7
TGTGCCAGCAGCGGCTTTCGGGGCCCCAGTGGGACCTACAATGAGCAGTTCTTC	CASSGFRGPSGTYNEQFF	TRBV27	TRBJ2-1
TGTGCCAGACGTGTCCGGGGACACTATGGCTACACCTTC	CARRVRGHYGYTF	TRBV27	TRBJ1-2
TGTGCCAGCAGCTTAGTCCAGGTCTTGAACACTGAAGCTTTCTTT	CASSLVQVLNTEAFF	TRBV7-9	TRBJ1-1
TGTGCCACCGGATTTGCAGGGGATGCAAACATTCAGTACTTC	CATGFAGDANIQYF	TRBV7-9	TRBJ2-4
TGTGCCACCAGTGATGTCAGCCGGGTGAACACTGAAGCTTTCTTT	CATSDVSRVNTEAFF	TRBV24-1	TRBJ1-1
TGTGCGCGAGTTAACAGTAACACTCAGCCCCAGCATTTT	CARVNSNTQPQHF	TRBV2	TRBJ1-5
TGTGCCAGCACCCCCAGGACAGGGGAGGTAAGACCCTCCTACAATGAGCAGTTCTTC	CASTPRTGEVRPSYNEQFF	TRBV28	TRBJ2-1
TGTGCCAGCAGCTTAGATGATCCGCGGGAGCATCAGCCCCAGCATTTT	CASSLDDPREHQPQHF	TRBV11-3	TRBJ1-5
TGTGCCAGCAGCGGAACAGGGCGGACGTGGATCTTGGAGGAGTACACTGAAGCTTTCTTT	CASSGTGRTWILEEYTEAFF	TRBV7-3	TRBJ1-1
TGCGCCAGCAGCCAAGGGCAATACAGGGCTGGAGTGCCCGAGCAGTACTTC	CASSQGQYRAGVPEQYF	TRBV4-1	TRBJ2-7
TGTGCCAGCAGCTTAACTCATATAAAGTCTGGGAAGAGCAATCAGCCCCAGCATTTT	CASSLTHIKSGKSNQPQHF	TRBV7-9	TRBJ1-5
TGTGCTAGGTTGTCGGCCTACGAGCAGTACTTC	CARLSAYEQYF	TRBV24-1	TRBJ2-7
TGTGCCAGCAGCTTGTCGGGGGGTTCCTACAATGAGCAGTTCTTC	CASSLSGGSYNEQFF	TRBV7-2	TRBJ2-1
TGTGCCTGGACTCTAGACGAGACCCAGTACTTC	CAWTLDETQYF	TRBV30	TRBJ2-5
TGTGCCAGCAGCGCTCAAGCGGTTTTCATGATTCTAGCCAAAAACATTCAGTACTTC	CASSAQAVFMILAKNIQYF	TRBV7-9	TRBJ2-4
TGTGCCAGCAGCTTAACCCACAGGCCTGGGGCCAACGTCCTGACTTTC	CASSLTHRPGANVLTF	TRBV7-3	TRBJ2-6
TGTGCCAGCAGTGAGAGCGGGAGGACTGAGCAGTTCTTC	CASSESGRTEQFF	TRBV6-4	TRBJ2-1
TGTGCCAGCGGTCGCCCGGAGGTGTACAATGAGCAGTTCTTC	CASGRPEVYNEQFF	TRBV27	TRBJ2-1
TGTGCCAGCAGCCGGGAAGGTGGAGGAAGGTACTCCTACGAGCAGTACTTC	CASSREGGGRYSYEQYF	TRBV14	TRBJ2-7
TGTGCCAGCACTTACAGCCCCGGAAACACCATATATTTT	CASTYSPGNTIYF	TRBV6-1	TRBJ1-3
TGCGCCAGCAGTGAGCCGCCCCAATATTTCGATTCCTACGAGCAGTACTTC	CASSEPPQYFDSYEQYF	TRBV10-2	TRBJ2-7
TGCAGTGCTAGAAGGGGAGCGATAGCGCAGCCCCAGCATTTT	CSARRGAIAQPQHF	TRBV20-1	TRBJ1-5
TGCAGCGTTGATTGTAAGAGTAATGAGCAGTTCTTC	CSVDCKSNEQFF	TRBV29-1	TRBJ2-1
