TGCAGTGCTAGAGGCGCGGGGATAAAACTGTTTTTT	CSARGAGIKLFF	TRBV20-1	TRBJ1-4
TGTGCCAGCAGCCCGGCAGGGGGTAATGAAAAACTGTTTTTT	CASSPAGGNEKLFF	TRBV7-9	TRBJ1-4
TGTGCCAGCAGCATATTCGGGACTAGCGGGGGGTACAATGAGCAGTTCTTC	CASSIFGTSGGYNEQFF	TRBV9	TRBJ2-1
TGTGCCAGCAGCTTGACCCAGGGCCCCTGGGGCAGCAATCAGCCCCAGCATTTT	CASSLTQGPWGSNQPQHF	TRBV7-3	TRBJ1-5
TGCGCCAGCAGCTTGGAGACGCAGAGGGACGGTAGCTCCTACAATGAGCAGTTCTTC	CASSLETQRDGSSYNEQFF	TRBV5-1	TRBJ2-1
TGTGCCAGCAGCTCTCGGCGGGACCCCCACACCGGGGAGCTGTTTTTT	CASSSRRDPHTGELFF	TRBV7-4	TRBJ2-2
TGCAGTGCTAGAGATTTATCAAAAATCATAGCAGATACGCAGTATTTT	CSARDLSKIIADTQYF	TRBV20-1	TRBJ2-3
TGTGCCAGCAGCCCGCCGGTGAGATCCTACGAGCAGTACTTC	CASSPPVRSYEQYF	TRBV9	TRBJ2-7
TGTGCCAGCAGCGGGGGGAACACTGAAGCTTTCTTT	CASSGGNTEAFF	TRBV6-5	TRBJ1-1
TGTGCCAGCAGCTTCCGTCAGGGGACTAGCGGGGCCTACGAGCAGTACTTC	CASSFRQGTSGAYEQYF	TRBV7-3	TRBJ2-7
TGTGCCATCACCCAGAACCCACACACCGGGGAGCTGTTTTTT	CAITQNPHTGELFF	TRBV10-3	TRBJ2-2
TGTGCCATCAGTGAGTCGGGACAGGGCGTGAGAGGTGCAGGTAACGCTAACACTGAAGCTTTCTTT	CAISESGQGVRGAGNANTEAFF	TRBV10-3	TRBJ1-1
TGCTCAGCGGGAATCTACGAGCAGTACTTC	CSAGIYEQYF	TRBV5-1	TRBJ2-7
TGTGCCAGCAGCTTTCAGTCTGGAATAGCGGGAGTCGGCATTCAGTACTTC	CASSFQSGIAGVGIQYF	TRBV7-9	TRBJ2-4
TGTGCCAGCAGCAAAAGGGAACCATACGAGCAGTACTTC	CASSKREPYEQYF	TRBV2	TRBJ2-7
TGTGCCAGCAGGGAACAGGGTTCTAGCACAGATACGCAGTATTTT	CASREQGSSTDTQYF	TRBV6-4	TRBJ2-3
TGTGCCAGTAGGGGCGGGACAGGGTTGAACACTGAAGCTTTCTTT	CASRGGTGLNTEAFF	TRBV19	TRBJ1-1
TGTGCCAGGGATCAACGGGGACCCCCCTACGAGCAGTACTTC	CARDQRGPPYEQYF	TRBV28	TRBJ2-7
TGTGCCATCACCCCGAATGGGGAAGAGCCAAACACTGAAGCTTTCTTT	CAITPNGEEPNTEAFF	TRBV10-3	TRBJ1-1
TGTGCCAGTAGTAGGGGCGTCGGGGGGCCTCAGGGATACGAGCAGTACTTC	CASSRGVGGPQGYEQYF	TRBV19	TRBJ2-7
TGTGCCACCAGTGAAGTTCCGGGGGAGGAACAGGGAAACACCATATATTTT	CATSEVPGEEQGNTIYF	TRBV24-1	TRBJ1-3
TGTGCCAGCAGCGGGGTGCGGGGCGGAGACTATGGCTACACCTTC	CASSGVRGGDYGYTF	TRBV9	TRBJ1-2
TGTGCCAGCAGCTACGTCGGGGGGGGACAGCAAGAGACCCAGTACTTC	CASSYVGGGQQETQYF	TRBV7-9	TRBJ2-5
TGTGCCAGCAGCCCAACTGGTTTGCTCTATGGCTACACCTTC	CASSPTGLLYGYTF	TRBV13	TRBJ1-2
TGTGCCAGCAGCTCGCTCGGGGGCTCCTACGAGCAGTACTTC	CASSSLGGSYEQYF	TRBV5-8	TRBJ2-7
TGTGCCAGCAGTTACTTCACAGGGGTACAGCCCCAGCATTTT	CASSYFTGVQPQHF	TRBV12-4	TRBJ1-5
TGTGCCAGAGGAGGGTACCTAACTGAAGCTTTCTTT	CARGGYLTEAFF	TRBV19	TRBJ1-1
TGTGCCTGGAGTTCTCGGGGCGGGACGGGCAATCAGCCCCAGCATTTT	CAWSSRGGTGNQPQHF	TRBV30	TRBJ1-5
TGTGAAAAGACAGGGCAGCGGGACTATGGCTACACCTTC	CEKTGQRDYGYTF	TRBV25-1	TRBJ1-2
TGCAGTGCTAGCCGGAGACAGGGCTCGAGCTCTGGAAACACCATATATTTT	CSASRRQGSSSGNTIYF	TRBV20-1	TRBJ1-3
TGTGCCTGGAGTGTACTTGAGGGGGGACATTTCACTGAAGCTTTCTTT	CAWSVLEGGHFTEAFF	TRBV30	TRBJ1-1
TGTGCCAGCAGTGACAGGGTCCTCAGGTATCAGCCCCAGCATTTT	CASSDRVLRYQPQHF	TRBV27	TRBJ1-5
TGTGCTAGTGGTTTGCCAGGGACAGGGGTAGGGGTTGCAACTAATGAAAAACTGTTTTTT	CASGLPGTGVGVATNEKLFF	TRBV12-5	TRBJ1-4
TGTGCCAGCAGTGGGGTGTCGGCGAAACTAGCGGGAGCCTGCTACGAGCAGTACTTC	CASSGVSAKLAGACYEQYF	TRBV6-4	TRBJ2-7
TGTGCCAGCAGCTTGGGGGAAACTGCTTCTAGCACAGATACGCAGTATTTT	CASSLGETASSTDTQYF	TRBV7-8	TRBJ2-3
TGCAGCGTTGTGGTTAAACCCGCTGGGGCCAACGTCCTGACTTTC	CSVVVKPAGANVLTF	TRBV29-1	TRBJ2-6
TGTGCCAGCAGCGGACTAGTTTGTCTAGATACGCAGTATTTT	CASSGLVCLDTQYF	TRBV13	TRBJ2-3
TGTGCCAGCAGCCAAGAAGTTCCGGGACAGGGCTATAATTCACCCCTCCACTTT	CASSQEVPGQGYNSPLHF	TRBV14	TRBJ1-6
TGTGCCAGCAGTTACACGCTGAAGTTAAAGACTAGCGGGGAGCCGAACACCGGGGAGCTGTTTTTT	CASSYTLKLKTSGEPNTGELFF	TRBV6-3	TRBJ2-2
TGTGCCAGCAGCGCCCGGACAGTTTTAAAGCCCCAGCATTTT	CASSARTVLKPQHF	TRBV7-3	TRBJ1-5
TGTGCCAGCAGCTTAGGGCGAGCTTACTATGGCTACACCTTC	CASSLGRAYYGYTF	TRBV7-4	TRBJ1-2
TGTGCCAGCACCGTGGGAGAGAATCAGCCCCAGCATTTT	CASTVGENQPQHF	TRBV6-5	TRBJ1-5
TGTGCCACCAGTGATGTGACAGGGTCCACAGATACGCAGTATTTT	CATSDVTGSTDTQYF	TRBV24-1	TRBJ2-3
TGTGCCAGCAAACCGCCCAGTCTGGGAAGCACCGGGGAGCTGTTTTTT	CASKPPSLGSTGELFF	TRBV6-1	TRBJ2-2
TGTGCCAGCTCGGACAGGGTTGATCAGCCCCAGCATTTT	CASSDRVDQPQHF	TRBV7-3	TRBJ1-5
TGTGCCAGCAGCCAAACCTTGGCTGACAGGGGCCCGGGAGGGCTGCCCCAGCATTTT	CASSQTLADRGPGGLPQHF	TRBV3-1	TRBJ1-5
TGCGCCAGCAACGGGCCGGCGCAAGAGACCCAGTACTTC	CASNGPAQETQYF	TRBV5-1	TRBJ2-5
TGTGCCAGCCGAGGAGAGGGGGTGAACACTGAAGCTTTCTTT	CASRGEGVNTEAFF	TRBV6-2	TRBJ1-1
TGTGCCAGCAGCCTGGGACAGGGGCCCCCAGAGACCCAGTACTTC	CASSLGQGPPETQYF	TRBV3-1	TRBJ2-5
TGTGCCAGCAGCGTTTCCACTAGCGGGCGAGAACGGATAAAAGAGACCCAGTACTTC	CASSVSTSGRERIKETQYF	TRBV11-2	TRBJ2-5
TGTGCCAGCAGCCCCGGGACAGGTAATAGGGGCTCCTATAATTCACCCCTCCACTTT	CASSPGTGNRGSYNSPLHF	TRBV7-3	TRBJ1-6
TGTGCCAGCAGTGTACCACCGAGGCACTATGGCTACACCTTC	CASSVPPRHYGYTF	TRBV6-4	TRBJ1-2
TGTGCTAGTGGTTTGGTACGGACAGACCTTTTTACCTATGGCTACACCTTC	CASGLVRTDLFTYGYTF	TRBV12-5	TRBJ1-2
TGTGCCAGCAGCTCCGAGAGTTCGGGAGATACGGGTAGGAAAGATACGCAGTATTTT	CASSSESSGDTGRKDTQYF	TRBV7-2	TRBJ2-3
TGTGCCAGCGTCCATACCCGGGACAGGGCCTCCTATAATTCACCCCTCCACTTT	CASVHTRDRASYNSPLHF	TRBV5-4	TRBJ1-6
TGTGCCAGCAGCTTCGGAGGAGCGGGGGAAAAAGTTGAGACCCAGTACTTC	CASSFGGAGEKVETQYF	TRBV11-3	TRBJ2-5
TGTGCCAGCAGCTTAAGAAGGGTAAGGGGGCAAGAGACCCAGTACTTC	CASSLRRVRGQETQYF	TRBV7-3	TRBJ2-5
TGCGCCAGAACCCTCTCAGGGCGATACGAGCAGTACTTC	CARTLSGRYEQYF	TRBV10-1	TRBJ2-7
TGCGCCAGCAGCTTTCATATGACTAGCGGGGGGGGAGAGACCCAGTACTTC	CASSFHMTSGGGETQYF	TRBV5-1	TRBJ2-5
TGTGCCAGCCCCACGGCGGACAGGTCAGCCTACGAGCAGTACTTC	CASPTADRSAYEQYF	TRBV6-1	TRBJ2-7
TGTGCCAGCAGTTTTCGGACAGGGGACACTGAAGCTTTCTTT	CASSFRTGDTEAFF	TRBV11-3	TRBJ1-1
TGTGCCAGCAGCACCCAGCGGAGCACAGATACGCAGTATTTT	CASSTQRSTDTQYF	TRBV13	TRBJ2-3
TGTGCCAGTAAGCCTAGGGCGATTTGGGAAAAACTGTTTTTT	CASKPRAIWEKLFF	TRBV10-3	TRBJ1-4
TGTGCCAGCAGAGGAAACCCTAACGCAACTAATGAAAAACTGTTTTTT	CASRGNPNATNEKLFF	TRBV28	TRBJ1-4
TGTGCCAGCAGTTTATCGATCTACTCGGCAGAAGAGACCCAGTACTTC	CASSLSIYSAEETQYF	TRBV27	TRBJ2-5
TGCAGTGCTCAACCGTGGGGGGAGGGAAGGGATGAAAAACTGTTTTTT	CSAQPWGEGRDEKLFF	TRBV20-1	TRBJ1-4
TGTGCCAGCAGCCAAGCCGGGACTAGCGGGGGGAGAGAGACCCAGTACTTC	CASSQAGTSGGRETQYF	TRBV3-1	TRBJ2-5
TGTGCCAGCAGCTTAGTGGGCCCGGGGGATACGCAGTATTTT	CASSLVGPGDTQYF	TRBV7-4	TRBJ2-3
TGTGCCAGCAGCTCCGCGGGACAGGCTGAAAAACTGTTTTTT	CASSSAGQAEKLFF	TRBV7-2	TRBJ1-4
TGTGCCAGCAGGGGGGGGCAGCCCCAGCATTTT	CASRGGQPQHF	TRBV11-3	TRBJ1-5
TGTGCCAGCAGTTACCGGATCACTGAGACCCAGTACTTC	CASSYRITETQYF	TRBV6-2	TRBJ2-5
TGTGCCAGCAGCGAGAGTGGGCCTTATTATCAGCCCCAGCATTTT	CASSESGPYYQPQHF	TRBV9	TRBJ1-5
TGCGCCAGCAAACACAGGGGAAGGGTTCTGACTGGAAACACCATATATTTT	CASKHRGRVLTGNTIYF	TRBV5-1	TRBJ1-3
TGTGCCAGCAGCTTAATGGGCTACGAGCAGTACTTC	CASSLMGYEQYF	TRBV7-2	TRBJ2-7
TGTGCCAGCAGTACAAAGCAGGACAGGGGAAGTACAGATACGCAGTATTTT	CASSTKQDRGSTDTQYF	TRBV28	TRBJ2-3
TGTGCCAGCAGCGGGGGAAAAGATGGCCGTAGGACTGAAGCTTTCTTT	CASSGGKDGRRTEAFF	TRBV11-2	TRBJ1-1
TGCAGTGCGGGGGGCTACGAGCAGTACTTC	CSAGGYEQYF	TRBV20-1	TRBJ2-7
TGCGCCAGCAGTACCTCATCTGGACAGGGGGTCTTAAACTACGAGCAGTACTTC	CASSTSSGQGVLNYEQYF	TRBV10-1	TRBJ2-7
TGCGCCAGCAGGAGATATTTATCCTACAATGAGCAGTTCTTC	CASRRYLSYNEQFF	TRBV10-1	TRBJ2-1
TGTGCCAGCAGTTTATCGGGACAGGGGCCTAATGAAAAACTGTTTTTT	CASSLSGQGPNEKLFF	TRBV27	TRBJ1-4
TGTGCCAGCAGGTCCCGGGAGGGGTATGAAAAACTGTTTTTT	CASRSREGYEKLFF	TRBV6-1	TRBJ1-4
TGTGCCAGCAGCAGGGGGCAACTAACTGAAGCTTTCTTT	CASSRGQLTEAFF	TRBV13	TRBJ1-1
TGTGCCAGCAGGGGGCGTGACAATGAGCAGTTCTTC	CASRGRDNEQFF	TRBV7-2	TRBJ2-1
TGTGCCAGCAGCTTCGGGACTAGCGGGGGAGATACGCAGTATTTT	CASSFGTSGGDTQYF	TRBV11-2	TRBJ2-3
TGTGCCAGCTGGGCCCCACTAGCGGGGGAGTACAATGAGCAGTTCTTC	CASWAPLAGEYNEQFF	TRBV7-9	TRBJ2-1
TGTGCCAGCAGCTTAGCTATGTTCACATGGCGATCGGGACAGGGGGCTGGGACCTCCTACAATGAGCAGTTCTTC	CASSLAMFTWRSGQGAGTSYNEQFF	TRBV7-6	TRBJ2-1
TGTGCCAGCAGCTTCCGCGGGAGAGCCCTAGAGACCCAGTACTTC	CASSFRGRALETQYF	TRBV7-6	TRBJ2-5
TGCAGTGCTAGAGGTGATCCCTCGTGGGACGGCTACACCTTC	CSARGDPSWDGYTF	TRBV20-1	TRBJ1-2
TGTGCCAGCAGTTTGCTAGGGGGGACTACAACAGATACGCAGTATTTT	CASSLLGGTTTDTQYF	TRBV27	TRBJ2-3
TGTGCCAGCAGTGGCCTTATGGGCCACGAGCAGTACTTC	CASSGLMGHEQYF	TRBV27	TRBJ2-7
TGTGCCAGCAGCTTGGCCGGGTTCGGGCCCCCAGATGAGCAGTTCTTC	CASSLAGFGPPDEQFF	TRBV5-5	TRBJ2-1
TGCGCCAGCAAAAGACAGGACAGGGCAGACTATGGCTACACCTTC	CASKRQDRADYGYTF	TRBV5-1	TRBJ1-2
TGTGCCAGCAGCTTAGAGGGGGGCGCAGCCTACGAGCAGTACTTC	CASSLEGGAAYEQYF	TRBV7-9	TRBJ2-7
TGTGCCAGCAGCTTCACAGGGAACACTGAAGCTTTCTTT	CASSFTGNTEAFF	TRBV11-3	TRBJ1-1
TGTGCCAGCAGTTTAGGGGAGCGGCGGGTCCCCTACGAGCAGTACTTC	CASSLGERRVPYEQYF	TRBV28	TRBJ2-7
TGTGCCAGTAGTAGCGTTTCGGGGATAGGCTCCTACGAGCAGTACTTC	CASSSVSGIGSYEQYF	TRBV19	TRBJ2-7
TGTGCCAGCAGCACCTGGCGGCACACCGAGGAATATGGCTACACCTTC	CASSTWRHTEEYGYTF	TRBV9	TRBJ1-2
TGTGCCAGCTCAGGTCAGGACCAGGCAGGAGGCTACACCTTC	CASSGQDQAGGYTF	TRBV18	TRBJ1-2
TGTGCCAGCAGCCTACCAGAGGCAGCTTTCTTT	CASSLPEAAFF	TRBV6-3	TRBJ1-1
TGTGCGCCTAGACAAACGTACGAGCAGTACTTC	CAPRQTYEQYF	TRBV9	TRBJ2-7
TGTGCCAGCAAACGAGATACGCAGTATTTT	CASKRDTQYF	TRBV6-3	TRBJ2-3
TGTGCCAGCAACGCCAGAAGGGGGGAAAGCTCCTACGAGCAGTACTTC	CASNARRGESSYEQYF	TRBV4-2	TRBJ2-7
TGTGCCAGCAGCTTTTCCAAGAACACTGAAGCTTTCTTT	CASSFSKNTEAFF	TRBV11-3	TRBJ1-1
TGTGCCAGCAGCTTAGCGGGGGCTGGAGCTTTCTTT	CASSLAGAGAFF	TRBV11-2	TRBJ1-1
TGCAGCGTTCCGGGGTCCTACGAGCAGTACTTC	CSVPGSYEQYF	TRBV29-1	TRBJ2-7
TGCGCCAGCCGACAGAGAGGGGCCTACGAGCAGTACTTC	CASRQRGAYEQYF	TRBV4-1	TRBJ2-7
TGTGCCAGCAGCTCCGGACAGGGAACCACCGGGGAGCTGTTTTTT	CASSSGQGTTGELFF	TRBV6-4	TRBJ2-2
TGTGCCAGCAGTGACTCCTTTTCGACTAGCGGAGATACGCAGTATTTT	CASSDSFSTSGDTQYF	TRBV6-4	TRBJ2-3
TGTGCCAGCAGCGAACCCGGGACAGGGGGCGATTTCACTGAAGCTTTCTTT	CASSEPGTGGDFTEAFF	TRBV7-3	TRBJ1-1
TGCGCCAGCAGCAAACCTAGCGGGACCCGGTGGTGGAAACTGGGGGGCAATGAGCAGTTCTTC	CASSKPSGTRWWKLGGNEQFF	TRBV5-1	TRBJ2-1
TGCAGTGCTAGAGTCTCGGACAGGGAGGCCTACGAGCAGTACTTC	CSARVSDREAYEQYF	TRBV20-1	TRBJ2-7
TGCGCCAGCAGCTATCAGGAGGAAGGGGGCGGGGGGGAAAACACTGAAGCTTTCTTT	CASSYQEEGGGGENTEAFF	TRBV5-1	TRBJ1-1
TGTGCCAGCAGCCGAACAGGGATGATGAACACCGGGGAGCTGTTTTTT	CASSRTGMMNTGELFF	TRBV6-4	TRBJ2-2
TGTGCCAGCAGCCCGGGGGAGCAGCCCCAGCATTTT	CASSPGEQPQHF	TRBV7-3	TRBJ1-5
TGCGCCAGCAGCTTCTGGGGTTCCGTCGGGGGCGAGCAGTACTTC	CASSFWGSVGGEQYF	TRBV10-1	TRBJ2-7
TGTGCCAGACAGTTCAGCAATCAGCCCCAGCATTTT	CARQFSNQPQHF	TRBV5-4	TRBJ1-5
TGCGCCAGCATCTCATCAGACAGGGGGCCGGACACAGATACGCAGTATTTT	CASISSDRGPDTDTQYF	TRBV10-1	TRBJ2-3
TGTGCCAGCAGCGGTCTGACAGATACGCAGTATTTT	CASSGLTDTQYF	TRBV13	TRBJ2-3
TGTGCCAGCAGTAAACCACAGGGGGCGGGGAACACTGAAGCTTTCTTT	CASSKPQGAGNTEAFF	TRBV12-4	TRBJ1-1
TGCGCCCCCGGGGGGGCGGAGCAGTTCTTC	CAPGGAEQFF	TRBV10-1	TRBJ2-1
TGTGCCAGCAGCGGGGGGGATCAGCCCCAGCATTTT	CASSGGDQPQHF	TRBV7-4	TRBJ1-5
TGTGCCAGCAGCCCAGCTTTGCGGGAGGGATGGACCGAGCAGTACTTC	CASSPALREGWTEQYF	TRBV5-6	TRBJ2-7
TGTGCCAGCAGCCCGGGACAGTCTGGCTACACCTTC	CASSPGQSGYTF	TRBV7-3	TRBJ1-2
TGCAGTGCTAGAGAGGGGCTCAACTATGGCTACACCTTC	CSAREGLNYGYTF	TRBV20-1	TRBJ1-2
TGTGCCAGCATGGAGAAGGGGGGCCCAAACACCATATATTTT	CASMEKGGPNTIYF	TRBV6-4	TRBJ1-3
TGCGCCAGCCGGGGACTGGCCACTGAAGCTTTCTTT	CASRGLATEAFF	TRBV5-1	TRBJ1-1
TGTGCCAGCAGTTACCAGAGTTCAATCCGGGACAGTGAAGCTTTCTTT	CASSYQSSIRDSEAFF	TRBV6-5	TRBJ1-1
TGCAGCGTTGACAAACGGGACGGTCATTGGGAGGAAAAACTGTTTTTT	CSVDKRDGHWEEKLFF	TRBV29-1	TRBJ1-4
TGTGCCAGGATCGTCTCGGGGTTCGAGACCCAGTACTTC	CARIVSGFETQYF	TRBV11-3	TRBJ2-5
TGTGCCACCAGTGATACATCCTTGCCAGGGAAGGCCTACAATGAGCAGTTCTTC	CATSDTSLPGKAYNEQFF	TRBV24-1	TRBJ2-1
TGTGCCAGACTAGCGGGAGGGCGTTCACCCCTCCACTTT	CARLAGGRSPLHF	TRBV14	TRBJ1-6
TGTGCCAGCAGCTTATGGCGCCGGGGCCAAGAGACCCAGTACTTC	CASSLWRRGQETQYF	TRBV6-3	TRBJ2-5
TGCGCCAGCAGCTTGGATAATTCCGGGACCTATGAGCAGTTCTTC	CASSLDNSGTYEQFF	TRBV5-1	TRBJ2-1
TGCAGCGTTCGACGGAGGACTAGCTCCATAGATACGCAGTATTTT	CSVRRRTSSIDTQYF	TRBV29-1	TRBJ2-3
TGTGCCAGCAGCCAGCGGGAGAGGCAAGAGACCCAGTACTTC	CASSQRERQETQYF	TRBV13	TRBJ2-5
TGTGCCAGCAGCACGATTGGGCCATCTCAGGATAGCAATCAGCCCCAGCATTTT	CASSTIGPSQDSNQPQHF	TRBV9	TRBJ1-5
TGCAGTTTAAGACTAGCGGGATTCACAGATACGCAGTATTTT	CSLRLAGFTDTQYF	TRBV20-1	TRBJ2-3
TGTGCCAGTAGTATAGTCAGGGATGGAAACACCATATATTTT	CASSIVRDGNTIYF	TRBV19	TRBJ1-3
TGTGCCAGCATTCCGGGGAGAGACAGGGGGGGGAAGGCTTTCTTT	CASIPGRDRGGKAFF	TRBV27	TRBJ1-1
TGTGCCAGCAGCGTCCGGCTGGGCATCAGGTACTTC	CASSVRLGIRYF	TRBV13	TRBJ2-7
TGTGCCAGCGGGGGGACCAATCAGCCCCAGCATTTT	CASGGTNQPQHF	TRBV6-1	TRBJ1-5
TGTGCCAGCAGCCCGAAGACAGGGCGTGCAGATACGCAGTATTTT	CASSPKTGRADTQYF	TRBV9	TRBJ2-3
TGTGCCAGCAGTTCCCGGGTGGGACTAGATAACGCCTCGGACGAGCAGTACTTC	CASSSRVGLDNASDEQYF	TRBV6-3	TRBJ2-7
TGTGCCAGCAGAGGGAGGGACGTCTCCTACGAGCAGTACTTC	CASRGRDVSYEQYF	TRBV12-3	TRBJ2-7
TGTGCCAGCAGCATCCCTGGCACCGAGCAGTACTTC	CASSIPGTEQYF	TRBV5-4	TRBJ2-7
TGTGCCAGCAGTGGGGGCTCTGGAAACACCATATATTTT	CASSGGSGNTIYF	TRBV2	TRBJ1-3
TGTGCCAGCAGTCCCCCGGTCGGGGAGTACAATGAGCAGTTCTTC	CASSPPVGEYNEQFF	TRBV6-3	TRBJ2-1
TGCGCCAGCAGCGCGGACCCCCTAGCGGGACCCTACGAGCAGTACTTC	CASSADPLAGPYEQYF	TRBV4-1	TRBJ2-7
TGTGCCAGCTCACCACCGGGCATCCGGGGGGTCCGAGGGGCCAACGTCCTGACTTTC	CASSPPGIRGVRGANVLTF	TRBV18	TRBJ2-6
TGCGCCAGCAGCCAAGTCGGGACTAGCGGGGGGGCGAGAGGAGCTCCTCGAGATACGCAGTATTTT	CASSQVGTSGGARGAPRDTQYF	TRBV4-1	TRBJ2-3
TGTGCCAGCAATCTCCGACTAGCCGGGGCAGAGGACACCTACGAGCAGTACTTC	CASNLRLAGAEDTYEQYF	TRBV28	TRBJ2-7
TGTGCCAGCAGTTTCCCAGGGGCGAGTCAGCCCCAGCATTTT	CASSFPGASQPQHF	TRBV6-1	TRBJ1-5
TGTGCCAGCAGTGGGGACGGGGGGGTAGATACGCAGTATTTT	CASSGDGGVDTQYF	TRBV2	TRBJ2-3
TGTGCCAGCAGCGGATGGGAGCTATACAATGAGCAGTTCTTC	CASSGWELYNEQFF	TRBV7-3	TRBJ2-1
TGTGCCAGCATGGAAAAAGGGACCGGAAACTATGGCTACACCTTC	CASMEKGTGNYGYTF	TRBV12-3	TRBJ1-2
TGTGCCAGCAGCCAGGTCTCGAGCGAGCAGTTCTTC	CASSQVSSEQFF	TRBV7-9	TRBJ2-1
TGTGCTAGTTGGGACACTGAGACCCAGTACTTC	CASWDTETQYF	TRBV12-5	TRBJ2-5
TGTGCCACCAGTGGACAAACTAATGAAAAACTGTTTTTT	CATSGQTNEKLFF	TRBV24-1	TRBJ1-4
TGCAGTGCTAGAGATCAAAAACCGGAGGGCGGGACTTCGGGAGAAGGGTACTTC	CSARDQKPEGGTSGEGYF	TRBV20-1	TRBJ2-7
TGTGCCAGCAGCAGTGATCGTGTCCCGGGACTTAACTATGGCTACACCTTC	CASSSDRVPGLNYGYTF	TRBV5-4	TRBJ1-2
TGTGCCTGGACCGGGTACAGGGACTATGGCTACACCTTC	CAWTGYRDYGYTF	TRBV30	TRBJ1-2
TGTGCCAGCAGCCCCGCTAACAAGATTAGGTTCCGGGAAAACCGAGATACGCAGTATTTT	CASSPANKIRFRENRDTQYF	TRBV9	TRBJ2-3
TGTGCCAGCAGCTTAAGGGTGGGGACAGCGAACACCGGGGAGCTGTTTTTT	CASSLRVGTANTGELFF	TRBV5-4	TRBJ2-2
TGCGCCAGCAGATGCCCCCCAGGGGGGGTCTCCTACGAGCAGTACTTC	CASRCPPGGVSYEQYF	TRBV5-1	TRBJ2-7
TGTGCCAGCAGCTTAGGAGGACTAGCGGGGGGGGGGCCCAACATAAAAAACATTCAGTACTTC	CASSLGGLAGGGPNIKNIQYF	TRBV11-3	TRBJ2-4
TGTGCCACCAGCAGAGGAGGCCAACTCTCTGGGGCCAACGTCCTGACTTTC	CATSRGGQLSGANVLTF	TRBV15	TRBJ2-6
TGTGCCAGCAGTTTATCCAAAAATGCGTCCAACACAGATACGCAGTATTTT	CASSLSKNASNTDTQYF	TRBV28	TRBJ2-3
TGTGCCAGCAGCTCGGTCAGGGTTCTCAGGCGGACAGATACGCAGTATTTT	CASSSVRVLRRTDTQYF	TRBV11-2	TRBJ2-3
TGTGCCTGGAGCGTCGCTAGGAGCCGGGACAGGGGGCACCACTACGAGCAGTACTTC	CAWSVARSRDRGHHYEQYF	TRBV30	TRBJ2-7
TGTGCCAGCAGCGGGGGACATTTCACTGAAGCTTTCTTT	CASSGGHFTEAFF	TRBV11-2	TRBJ1-1
TGTGCCAGCAGCCGTGACAGGAACGCTAATGGCTACACCTTC	CASSRDRNANGYTF	TRBV7-3	TRBJ1-2
TGTGCCAGCAGCGGACATCAGAGTGGTCTCACTGAAGCTTTCTTT	CASSGHQSGLTEAFF	TRBV7-3	TRBJ1-1
TGTGCCAGCAGCTTAGCATTAACGCTAACGGGAAGGGAAGAGACCCAGTACTTC	CASSLALTLTGREETQYF	TRBV7-6	TRBJ2-5
TGTGCCAGCAGTGGGCCGGGGGCGACGAACACCGGGGAGCTGTTTTTT	CASSGPGATNTGELFF	TRBV5-5	TRBJ2-2
TGTGCCGGGGGGGGGACGGAGAGAAAAGAGACCCAGTACTTC	CAGGGTERKETQYF	TRBV7-9	TRBJ2-5
TGTGCTAGTGGTCTGGACTCGGCCGGGCCCGGGGAGCTGTTTTTT	CASGLDSAGPGELFF	TRBV12-5	TRBJ2-2
TGTGCCAGCAGCCAAGGTGACAGGTTTAGGGTAGAGACCCAGTACTTC	CASSQGDRFRVETQYF	TRBV14	TRBJ2-5
TGTGCCAGCAGCCAGGACAGGGAGGCCGAGCAGTTCTTC	CASSQDREAEQFF	TRBV7-4	TRBJ2-1
TGCGCCAGCAGTGGGCTTAAGGGGCGCACTGAAGCTTTCTTT	CASSGLKGRTEAFF	TRBV10-1	TRBJ1-1
TGTGCCAGCAGCTTGGATCCTAGAGGACAGGTAGCGTGGGGTAACTATGGCTACACCTTC	CASSLDPRGQVAWGNYGYTF	TRBV5-4	TRBJ1-2
TGTGCCATCAGTGAGTCAAAGTGCGGGGGTCACGAGCAGTACTTC	CAISESKCGGHEQYF	TRBV10-3	TRBJ2-7
TGTGCCAGCAGGAATGGTCCAAGGGTCCAGACGGCTGAAGCTTTCTTT	CASRNGPRVQTAEAFF	TRBV2	TRBJ1-1
TGTGCCAGCAGCTTAGCCGGGGGGGAGCGAGAGGCAGATACGCAGTATTTT	CASSLAGGEREADTQYF	TRBV7-9	TRBJ2-3
TGTGCCAGCAGCGTAGTCTTCCGGGACAAGAACTACGAGCAGTACTTC	CASSVVFRDKNYEQYF	TRBV5-6	TRBJ2-7
TGTGCCTGGCGGTTCTCAGCACCATTAGAAAGTAGGAGTGGCTACACCTTC	CAWRFSAPLESRSGYTF	TRBV30	TRBJ1-2
TGTGCCAGCAGTGCGGGGGGGCGGGCCTACAATGAGCAGTTCTTC	CASSAGGRAYNEQFF	TRBV12-4	TRBJ2-1
TGCAGTGCTAGATTACCGGGACAGTATTATAGCAATCAGCCCCAGCATTTT	CSARLPGQYYSNQPQHF	TRBV20-1	TRBJ1-5
TGTGCCAGCAGTTACGGGACAGGGTGGGGAGCTAACTATGGCTACACCTTC	CASSYGTGWGANYGYTF	TRBV6-5	TRBJ1-2
TGTGCCACCAGGACCGGGACATGGGTGGTGGATTCACCCCTCCACTTT	CATRTGTWVVDSPLHF	TRBV24-1	TRBJ1-6
TGCGCCAGCAGCTTGGTTCCCGGGACAGGGAATTCACCCCTCCACTTT	CASSLVPGTGNSPLHF	TRBV5-1	TRBJ1-6
TGTGCCAGCAGCTGCGTCCCCCCCCACCTCAGGGTGAACACTGAAGCTTTCTTT	CASSCVPPHLRVNTEAFF	TRBV5-4	TRBJ1-1
TGTGATACACTAAAACAGCGGGGGGAAGGGGGGGAAAATGAGCAGTTCTTC	CDTLKQRGEGGENEQFF	TRBV24-1	TRBJ2-1
TGTGCCAGCAGTGAAGGGCGGGTGGAGCAGTACTTC	CASSEGRVEQYF	TRBV6-5	TRBJ2-7
TGCAGTGCTAGAGATCTACGAGACTGGGCCACTTCAATATCTAGGTACTTC	CSARDLRDWATSISRYF	TRBV20-1	TRBJ2-4
TGTGCCAGAGGTTACGGAGGGTACTCCTACAATGAGCAGTTCTTC	CARGYGGYSYNEQFF	TRBV2	TRBJ2-1
TGTGCCAGCAGGGGCACCGCTTTCTTT	CASRGTAFF	TRBV6-1	TRBJ1-1
TGTGCCAGCAGTTCGAAGCGTGAAGGGAATGAGCAGTTCTTC	CASSSKREGNEQFF	TRBV12-3	TRBJ2-1
TGTGCCAGCAGTTGGGGGGATGGCTACACCTTC	CASSWGDGYTF	TRBV12-3	TRBJ1-2
TGCGCCACTAGCGGTAGCACCCTTTTCAATGAGCAGTTCTTC	CATSGSTLFNEQFF	TRBV4-1	TRBJ2-1
TGTGCCAGCAGCTGCCCTGGGCACTACCAACAAGAGACCCAGTACTTC	CASSCPGHYQQETQYF	TRBV27	TRBJ2-5
TGCGCCAGCAGCGAGGCGGGAGAAGGGATAAAAACCTACGAGCAGTACTTC	CASSEAGEGIKTYEQYF	TRBV5-1	TRBJ2-7
TGCAGTGCTAGCGCGGACAGGGGGGCTCAGCCCCAGCATTTT	CSASADRGAQPQHF	TRBV20-1	TRBJ1-5
TGCAGTGCTCGTGGGCAGAGGTACAGCGAGCAGTACTTC	CSARGQRYSEQYF	TRBV20-1	TRBJ2-7
TGTGCCAGCAGCCGAACCGGGACAGGGCCGGATGAGCAGTTCTTC	CASSRTGTGPDEQFF	TRBV14	TRBJ2-1
TGTGCCAGCAGTTCACAGCTGGACAGGGGGTGCACAGATACGCAGTATTTT	CASSSQLDRGCTDTQYF	TRBV27	TRBJ2-3
TGTGCCAGCAGCTACCTGAGGGACAGGAAATCCGGGGAGCTGTTTTTT	CASSYLRDRKSGELFF	TRBV7-9	TRBJ2-2
TGTGCCAGCAGCCAAGATCCCGACAGGGGGCGCAGAGAGGCTTTCTTT	CASSQDPDRGRREAFF	TRBV14	TRBJ1-1
TGTGCCAGCAGCTTTAGGGGTCTGGTGGGTGGCTACACCTTC	CASSFRGLVGGYTF	TRBV11-3	TRBJ1-2
TGCGCCAGCAGCCAAGATGTTGGACAGGTGTATGGCTACACCTTC	CASSQDVGQVYGYTF	TRBV4-3	TRBJ1-2
TGTGCCAGCGGGAGAAGCCGGGGGGGTGGATCGAATCAGCCCCAGCATTTT	CASGRSRGGGSNQPQHF	TRBV5-6	TRBJ1-5
TGTGCCAGCTCTAAAGCCGGGACAGGCAACAATCAGCCCCAGCATTTT	CASSKAGTGNNQPQHF	TRBV6-4	TRBJ1-5
TGTGCCAGCAGATCCGTGTCAGGGGGCGTAGCTTTCTTT	CASRSVSGGVAFF	TRBV28	TRBJ1-1
TGCAGTGCTGGCCGTGAGCAGTTCTTC	CSAGREQFF	TRBV20-1	TRBJ2-1
TGTGCCACCAGCAGGGGGACTGACACTGAAGCTTTCTTT	CATSRGTDTEAFF	TRBV15	TRBJ1-1
TGTGCCAGCAGCGTAGCAGACAGCTGGAGGTACGAGCAGTACTTC	CASSVADSWRYEQYF	TRBV9	TRBJ2-7
TGCAGCGTTGAAGTCGGAGGAACTAGCGGGAGGGCTTCTGGGGCCAACGTCCTGACTTTC	CSVEVGGTSGRASGANVLTF	TRBV29-1	TRBJ2-6
TGTGCCAGCAGACGAGGGAGCTCCTATAATTCACCCCTCCACTTT	CASRRGSSYNSPLHF	TRBV5-5	TRBJ1-6
TGTGCCAGTAGTACGGACAGCCTGTATGGCTACACCTTC	CASSTDSLYGYTF	TRBV19	TRBJ1-2
TGCGCCAGCAGCTTGTGCGGGAGTAATAGCCGGAACACCGGGGAGCTGTTTTTT	CASSLCGSNSRNTGELFF	TRBV5-1	TRBJ2-2
TGTGCCAGCAGCCAAGACCAGGGGACTAGCGGCTACAATGAGCAGTTCTTC	CASSQDQGTSGYNEQFF	TRBV4-2	TRBJ2-1
TGTGCCAGCAGTCTGGGGAAGGTCTCTGGAAACACCATATATTTT	CASSLGKVSGNTIYF	TRBV6-2	TRBJ1-3
TGTGCCAGCAGTGTAGGGGCCCAGTACTTC	CASSVGAQYF	TRBV6-1	TRBJ2-5
TGTGCCAGCAGCGACAACCGAGGGGACAGGAACACTGAAGCTTTCTTT	CASSDNRGDRNTEAFF	TRBV9	TRBJ1-1
TGCGCCAGCAGCTTGACACAGGGCTTTACCGGGGGGAAAGAGACCCAGTACTTC	CASSLTQGFTGGKETQYF	TRBV5-1	TRBJ2-5
TGTGCCAGCACGACAGGGGAGGGGTATAGCAATCAGCCCCAGCATTTT	CASTTGEGYSNQPQHF	TRBV6-1	TRBJ1-5
TGTGCCAGCAGTCCCTTGGCAGCGGTTTACGGGAACTCTGGGGCCAACGTCCTGACTTTC	CASSPLAAVYGNSGANVLTF	TRBV28	TRBJ2-6
TGTGCCAGCAGCTGCAATGGGACCTCTGGCTACACCTTC	CASSCNGTSGYTF	TRBV12-4	TRBJ1-2
TGCAGCGTTCTCACAACAGGGGATCGTGCTAATGAAAAACTGTTTTTT	CSVLTTGDRANEKLFF	TRBV29-1	TRBJ1-4
TGTGCCAGCAGTTACCAATTTAGGGGGGAAGCTTTCTTT	CASSYQFRGEAFF	TRBV6-5	TRBJ1-1
TGCAGTGCTAGAGGGGGGCCATCGGTACACACCGGGGAGCTGTTTTTT	CSARGGPSVHTGELFF	TRBV20-1	TRBJ2-2
TGTGCCAGTAGTTCTCAAGGTATGACAGGTCGAGGACTGTTTTTT	CASSSQGMTGRGLFF	TRBV19	TRBJ1-4
TGTGCCAGCAGCCTGGGAACGGTGACAGGGGGAAACCGGAACACTGAAGCTTTCTTT	CASSLGTVTGGNRNTEAFF	TRBV7-3	TRBJ1-1
TGCGCCAGCAGCTACCGACTAGCGGGAGGAGGCTTTTCGTACGAGCAGTACTTC	CASSYRLAGGGFSYEQYF	TRBV5-1	TRBJ2-7
TGTGCCAGCACGCTGTGGCAGATTTCAGATACGCAGTATTTT	CASTLWQISDTQYF	TRBV9	TRBJ2-3
TGTGCTAGTGGTTTGGTACACCCCCGCCGGGGCTACACCTTC	CASGLVHPRRGYTF	TRBV12-5	TRBJ1-2
TGTGCTAGTGGTTTGCACCTCAGGGTTGAAGCTTTCTTT	CASGLHLRVEAFF	TRBV12-5	TRBJ1-1
TGTGCCTGCCCCCCAAGGTCACACCGACAGAAGTACGAGCAGTACTTC	CACPPRSHRQKYEQYF	TRBV30	TRBJ2-7
TGCGCCAGCACGGGCACCGGGGAGCTGTTTTTT	CASTGTGELFF	TRBV10-1	TRBJ2-2
TGCAGTGCTAGAGATCGTTCCGGGACCGGGGAGCTGTTTTTT	CSARDRSGTGELFF	TRBV20-1	TRBJ2-2
TGTGCCATCACCCGGGGAGGGTCCGGGAGCTCCTATAATTCACCCCTCCACTTT	CAITRGGSGSSYNSPLHF	TRBV10-3	TRBJ1-6
TGTGCCAGCCCGGCGGCCCCGCCTTTAAAACCCTCCCGCGAACACCACGAGCAGTACTTC	CASPAAPPLKPSREHHEQYF	TRBV28	TRBJ2-7
TGTGCCAGCAGTTTGCGTGTACCTGGAATCAGGGGGTGCTCCTACGAGCAGTACTTC	CASSLRVPGIRGCSYEQYF	TRBV12-3	TRBJ2-7
TGCGCCAGCAGCTTGGAGTTACTCCCCGGGTGGGGTGGCTACACCTTC	CASSLELLPGWGGYTF	TRBV5-1	TRBJ1-2
TGCGCCAGCCCCTGGCTCTTCTTC	CASPWLFF	TRBV10-1	TRBJ2-1
TGTGCCAGCAGTTACTCAGGGAGACTCAGCACCACCGGGGAGCTGTTTTTT	CASSYSGRLSTTGELFF	TRBV6-2	TRBJ2-2
TGTGCCAGCAGCTTAGATAAGCGACTAGGGCCCTACGAGCAGTACTTC	CASSLDKRLGPYEQYF	TRBV11-3	TRBJ2-7
TGTGCCAGCAGCTTGGCAGACAGGGTGAACACTGAAGCTTTCTTT	CASSLADRVNTEAFF	TRBV5-6	TRBJ1-1
TGTGCCAGCACGTATGGCTACACCTTC	CASTYGYTF	TRBV6-5	TRBJ1-2
TGTGCCAGCAGCGGGCAGGGCAGGTCTAACTATGGCTACACCTTC	CASSGQGRSNYGYTF	TRBV9	TRBJ1-2
TGCGCCAGCAGTGAGCGGCCCGGGGACGAGCAGTACTTC	CASSERPGDEQYF	TRBV10-1	TRBJ2-7
TGTGCCAGCAGCCACAAGCAGTACTTC	CASSHKQYF	TRBV6-4	TRBJ2-7
TGCAGTGCTAAGGACAGGGAGCAAAGCTCCTACAATGAGCAGTTCTTC	CSAKDREQSSYNEQFF	TRBV20-1	TRBJ2-1
TGTGCCAGAATAGATAAAGCGGGACGCTCCTACGAGCAGTACTTC	CARIDKAGRSYEQYF	TRBV5-6	TRBJ2-7
TGTGCCAGCAGCTTAAATAGGGGAAACGCCAAAAACATTCAGTACTTC	CASSLNRGNAKNIQYF	TRBV11-2	TRBJ2-4
TGCGCCAGCAGCCTCGGGCCGGGGACCCGGAACACTGAAGCTTTCTTT	CASSLGPGTRNTEAFF	TRBV5-1	TRBJ1-1
TGTGCCAGCAGTGACTCCTTTCCAGGTTTCCTTATGCGACAGGTAGCCAAAAACATTCAGTACTTC	CASSDSFPGFLMRQVAKNIQYF	TRBV6-4	TRBJ2-4
TGTGCCACGGGGACCAGAACTGAAGCTTTCTTT	CATGTRTEAFF	TRBV24-1	TRBJ1-1
TGTGCCAGCAGCCCGGGACAGGGGCTGAACAATGAGCAGTTCTTC	CASSPGQGLNNEQFF	TRBV6-5	TRBJ2-1
TGTGCCAGGACTAGCGGGAGGATAGGCTCTGGGGCCAACGTCCTGACTTTC	CARTSGRIGSGANVLTF	TRBV27	TRBJ2-6
TGTGCCAGTAGTAGGCCGGGACTAAATCAGCCCCAGCATTTT	CASSRPGLNQPQHF	TRBV19	TRBJ1-5
TGCAGCGTTGAAGATCCCTTCCAGGGGGCGAAGACATCCTACGAGCAGTACTTC	CSVEDPFQGAKTSYEQYF	TRBV29-1	TRBJ2-7
TGTGCCACCAGCAGACCTCTGGAGAGGGGGTATGGCTACACCTTC	CATSRPLERGYGYTF	TRBV15	TRBJ1-2
TGTGCCAGCAGTTGTCCCAAGGGGAGAATCGACACTGAAGCTTTCTTT	CASSCPKGRIDTEAFF	TRBV6-2	TRBJ1-1
TGTGCCAGCACCTCCGCAAACTCTGGGGCCAACGTCCTGACTTTC	CASTSANSGANVLTF	TRBV25-1	TRBJ2-6
TGTGCCAGCAGTGAAGGGGCCCTGGGACAGGGTCCTCCTACTAGCACAGATACGCAGTATTTT	CASSEGALGQGPPTSTDTQYF	TRBV6-1	TRBJ2-3
TGTGCCAGCAGCCGACCGGGGCGCGGCTACGAGCAGTACTTC	CASSRPGRGYEQYF	TRBV13	TRBJ2-7
TGTGCCAGCAGTTGGACGCCCTCGCCTGAAAAACTGTTTTTT	CASSWTPSPEKLFF	TRBV6-2	TRBJ1-4
TGTGCCAGCTCACAACTGTACCCCACAGATACGCAGTATTTT	CASSQLYPTDTQYF	TRBV18	TRBJ2-3
TGCGCCAGCAGCGCAGGGGACAATCAGCCCCAGCATTTT	CASSAGDNQPQHF	TRBV5-1	TRBJ1-5
TGTGCCAGCAGCTTAGATCCCCTAGGAAACTACGAGCAGTACTTC	CASSLDPLGNYEQYF	TRBV7-9	TRBJ2-7
TGTGCCAGCAGCACGCTAGTCTACGAGCAGTACTTC	CASSTLVYEQYF	TRBV5-6	TRBJ2-7
TGTGCCTTATTTCGCACACGGGCAAAGACCGGGGAGCTGTTTTTT	CALFRTRAKTGELFF	TRBV12-3	TRBJ2-2
TGCAGTGCAACGGCGAACACCGGGGAGCTGTTTTTT	CSATANTGELFF	TRBV20-1	TRBJ2-2
TGTGCCAGCACATTGACTAGCGGTTTCCTGGCGGGCAATCGCTCCTACGAGCAGTACTTC	CASTLTSGFLAGNRSYEQYF	TRBV27	TRBJ2-7
TGTGCCAGCAGTTCTGGGGGCCACTACGAGCAGTACTTC	CASSSGGHYEQYF	TRBV28	TRBJ2-7
TGTGCCAGCAAGGTGCCTCGGGGGTGGACCTACGAGCAGTACTTC	CASKVPRGWTYEQYF	TRBV6-4	TRBJ2-7
TGTGCCAGCAGCACGACTAGCGGGAGGGCGCTCTACGAGCAGTACTTC	CASSTTSGRALYEQYF	TRBV5-4	TRBJ2-7
TGTGCCAGCAGCTTGGGGGAGGGGGGTTCCAATGAGCAGTTCTTC	CASSLGEGGSNEQFF	TRBV5-6	TRBJ2-1
TGTGCCAGCAGCCTAGCGACGCCGGTCTATGGCTACACCTTC	CASSLATPVYGYTF	TRBV7-6	TRBJ1-2
TGTGCCAGCAGCTGGAGAAGACGCGACACCGGGGAGCTGTTTTTT	CASSWRRRDTGELFF	TRBV7-3	TRBJ2-2
TGTGCCACCAGTCCTTGGACAGGGGGCCGTCCCTACGAGCAGTACTTC	CATSPWTGGRPYEQYF	TRBV24-1	TRBJ2-7
TGTGCCACCAGTGAGGGTGGCCCGGGGAGCCGGGACAGGGTTAATGAGTATCAGCCCCAGCATTTT	CATSEGGPGSRDRVNEYQPQHF	TRBV24-1	TRBJ1-5
TGTGCCAGTATGTATAAGAGGGCCGGGGAGCTGTTTTTT	CASMYKRAGELFF	TRBV11-2	TRBJ2-2
TGCGCCAGCAGCCTCGGACTAAACACTAATGAAAAACTGTTTTTT	CASSLGLNTNEKLFF	TRBV4-3	TRBJ1-4
TGTGCCAGCAGCCCCAACCGGGACAGTTTAGACACTGAAGCTTTCTTT	CASSPNRDSLDTEAFF	TRBV11-2	TRBJ1-1
TGTGCCAGCAGAATGGACAGGGAGTTTTACGAGCAGTACTTC	CASRMDREFYEQYF	TRBV6-5	TRBJ2-7
TGTGCCAGCAGCTTAGACAAGGGGCCTGCGGACGAGCAGTACTTC	CASSLDKGPADEQYF	TRBV11-3	TRBJ2-7
TGTGCCAGCTCACCACCGGTTTGCCCCCTACAGGGAAGGGGAACTCAGCCCCAGCATTTT	CASSPPVCPLQGRGTQPQHF	TRBV18	TRBJ1-5
TGCAGTGCTAGGGGCTGGATCGTAAACACCATATATTTT	CSARGWIVNTIYF	TRBV20-1	TRBJ1-3
TGCAGTGCTAGCAGAACTCCGGGGCCGGGACTAGCGGGGGTTTATGCCCCAGGCACCGGGGAGCTGTTTTTT	CSASRTPGPGLAGVYAPGTGELFF	TRBV20-1	TRBJ2-2
TGTGCCAGCAGTGTGCGGGACAGGGCTAAGAGCACAGATACGCAGTATTTT	CASSVRDRAKSTDTQYF	TRBV6-1	TRBJ2-3
TGTGCCAGCGGGGTGTGGCCAGCTCAGCCCCGCCCGTACGAGCAGTACTTC	CASGVWPAQPRPYEQYF	TRBV27	TRBJ2-7
TGTGCCAGCAGTTTCTTCGCGCAGGTTGTGGGGTTCACACTAGATACGCAGTATTTT	CASSFFAQVVGFTLDTQYF	TRBV27	TRBJ2-3
TGTGCCAGCAGTTACTCGCCTGACCCACAGGGGCACAATGAGCAGTTCTTC	CASSYSPDPQGHNEQFF	TRBV6-2	TRBJ2-1
TGTGCCAGCAGCCCGGGGGCCCAGTACTTC	CASSPGAQYF	TRBV6-5	TRBJ2-5
TGTGCCAGCAGCGTACAGGGACAGGGGAGAACTGAAGCTTTCTTT	CASSVQGQGRTEAFF	TRBV9	TRBJ1-1
TGCTCCGGGGGGAAAGCCAAAAACATTCAGTACTTC	CSGGKAKNIQYF	TRBV10-1	TRBJ2-4
TGTGCCAGCAGCTTATCAGGTCCAGGGGGCGGGCCCTACAATGAGCAGTTCTTC	CASSLSGPGGGPYNEQFF	TRBV7-2	TRBJ2-1
TGTGCCAGCAGTCGAACGCACCGGGACAGCACAGATACGCAGTATTTT	CASSRTHRDSTDTQYF	TRBV27	TRBJ2-3
TGTGCCAGCATCAGGTATTCCCCCCCCTACGAGCAGTACTTC	CASIRYSPPYEQYF	TRBV27	TRBJ2-7
TGTGCCACCAGCAGAGATCCACAGGACGGCTACACCTTC	CATSRDPQDGYTF	TRBV15	TRBJ1-2
TGTGCCAGCAGCTTGGAGGGGACAGGGGGCACAGATACGCAGTATTTT	CASSLEGTGGTDTQYF	TRBV5-8	TRBJ2-3
TGTGCCAGCAGTGCCGGGGCCTACGAGCAGTACTTC	CASSAGAYEQYF	TRBV6-1	TRBJ2-7
TGTGCCAGCAGTTACTCGCCTATAAAGGCTAACTATGGCTACACCTTC	CASSYSPIKANYGYTF	TRBV6-8	TRBJ1-2
TGTGCCAGCAGCGCGGGGATAGGGGGCGCAGATGAAGAGACCCAGTACTTC	CASSAGIGGADEETQYF	TRBV9	TRBJ2-5
TGTGCCAGCAGTCATTACAGGGGTGCCTACGAGCAGTACTTC	CASSHYRGAYEQYF	TRBV6-5	TRBJ2-7
TGTGCCAGTAGTCGGTTAGGGGTCACTGAAGCTTTCTTT	CASSRLGVTEAFF	TRBV19	TRBJ1-1
TGTGCCAGCAATGCACTAGCGGGGGGGCTTGCACAAGAGACCCAGTACTTC	CASNALAGGLAQETQYF	TRBV6-5	TRBJ2-5
TGTGCCAGCAGCTTATTCCAGGGAAAGGGGGGGGTGAAAGGGCAGTATTTT	CASSLFQGKGGVKGQYF	TRBV7-3	TRBJ2-3
TGTGCCAGCAGCGTTGTCCAGTTGGGGGGTATGAACACCGGGGAGCTGTTTTTT	CASSVVQLGGMNTGELFF	TRBV5-6	TRBJ2-2
TGTGCCAGCAGAGGGGTCAACGGGGAGCTGTTTTTT	CASRGVNGELFF	TRBV25-1	TRBJ2-2
TGTGCCAGCAGCTTAGGGGGGAGGGGGACAGGCCTGGGGAACACTGAAGCTTTCTTT	CASSLGGRGTGLGNTEAFF	TRBV7-9	TRBJ1-1
TGTGCCAGCAGCGACCCGAATCCGGTATATGGCTACACCTTC	CASSDPNPVYGYTF	TRBV5-8	TRBJ1-2
TGCGCCAGCAGCCAACTCCATAGGTCTTCCAATCAGCCCCAGCATTTT	CASSQLHRSSNQPQHF	TRBV4-1	TRBJ1-5
TGTGCCAGCAGCGGACTTGTGACAGATACGCAGTATTTT	CASSGLVTDTQYF	TRBV6-3	TRBJ2-3
TGTGCCAGCTCACTCCAGCCTAGCGGGCTACGGGGCGAGCAGTACTTC	CASSLQPSGLRGEQYF	TRBV18	TRBJ2-7
TGTGCCACAAGGCACCCGGGACTAGCGGGACACACCGGGGAGCTGTTTTTT	CATRHPGLAGHTGELFF	TRBV7-2	TRBJ2-2
TGTGCCAGCAGCAAAGTTTGGGGGGGTATCGACGACACCGGGGAGCTGTTTTTT	CASSKVWGGIDDTGELFF	TRBV13	TRBJ2-2
TGTGCCAGCAGGACACCAGGGGGAGAAGGCTACACCTTC	CASRTPGGEGYTF	TRBV12-4	TRBJ1-2
TGTGCCTGGAGTGATCCGCCGTCCGGGGAGGTTGCTTATCAGCCCCAGCATTTT	CAWSDPPSGEVAYQPQHF	TRBV30	TRBJ1-5
TGCAGTGCTAGTGGCCAGGGCGATTGGGGGGGCTACGAGCAGTACTTC	CSASGQGDWGGYEQYF	TRBV20-1	TRBJ2-7
TGTGCCAGCCGGGGGGCGGACGAGACCCAGTACTTC	CASRGADETQYF	TRBV27	TRBJ2-5
TGCGCCAGCAGCTTGGTCCCCACTCCGACAGGGGGAATTCACGAGACCTATAATTCACCCCTCCACTTT	CASSLVPTPTGGIHETYNSPLHF	TRBV5-1	TRBJ1-6
TGTGCCAGCAGCGGGAACGGGGGGGGGGTCGTCGACAATGAGCAGTTCTTC	CASSGNGGGVVDNEQFF	TRBV7-9	TRBJ2-1
TGTGCCACCAGCAGAAATTCGACAGGGCTTGTCTCCTACGAGCAGTACTTC	CATSRNSTGLVSYEQYF	TRBV15	TRBJ2-7
TGTGCCAGCAGCTCTCCGGGTCAGACCCAGTACTTC	CASSSPGQTQYF	TRBV7-9	TRBJ2-5
TGTGCCAGTAGCGATTCTCAGGGGGAGAATGTTCAAGAGACCCAGTACTTC	CASSDSQGENVQETQYF	TRBV19	TRBJ2-5
TGTGCCAGCAGGATAGCGGCCAGGGAGGGTTACGAGCAGTACTTC	CASRIAAREGYEQYF	TRBV27	TRBJ2-7
TGTGCCAGCAGCCGGGTTGAGCGGGCCATAGCCAGCATAGCGGGGTTTTACGAGCAGTACTTC	CASSRVERAIASIAGFYEQYF	TRBV7-3	TRBJ2-7
TGTGCCAGCTTCCTAAGGGCCGACGAGACCCAGTACTTC	CASFLRADETQYF	TRBV27	TRBJ2-5
TGTGCCTGGAGTGTAGACGGAGGGGAGACCCAGTACTTC	CAWSVDGGETQYF	TRBV30	TRBJ2-5
TGTGCCAGCAGCTTGGCCATCTTTTGGGAGCAGTTCTTC	CASSLAIFWEQFF	TRBV5-5	TRBJ2-1
TGTGCTAGTGGTTTGGGGCTGACTAGCGGGAGGGCACGTGAGCAGTTCTTC	CASGLGLTSGRAREQFF	TRBV12-5	TRBJ2-1
TGTGCCACTGTGGGGAAAGAAGCTTTCTTT	CATVGKEAFF	TRBV27	TRBJ1-1
TGTGCCTGGAGGGCCTGGGGAAACGAAGCTTTCTTT	CAWRAWGNEAFF	TRBV30	TRBJ1-1
TGTGCCACCAGTGATTTGCATACTAGCGGGAGGGCGGAGCTAAAGTACTTC	CATSDLHTSGRAELKYF	TRBV24-1	TRBJ2-7
TGTGCCAGCAGCCCCCCCAAGGAGACTTATGGCTACACCTTC	CASSPPKETYGYTF	TRBV2	TRBJ1-2
TGTGCCAGCAGCTTCGGAGCGTACCAAGAGACCCAGTACTTC	CASSFGAYQETQYF	TRBV6-2	TRBJ2-5
TGTGCCAGCAGTCCCTCCAGACACAGGGGAGAGACCCAGTACTTC	CASSPSRHRGETQYF	TRBV6-2	TRBJ2-5
TGTGCCAGCTGGACGCCCACTGAAGCTTTCTTT	CASWTPTEAFF	TRBV6-1	TRBJ1-1
TGTGCCAGCAGCGTAGGCCCATCCGAGGGGAGTATTGCTAGCTCCTACAATGAGCAGTTCTTC	CASSVGPSEGSIASSYNEQFF	TRBV9	TRBJ2-1
TGTGCCAGCAGCGTAGCCTGTGCGACAGGGGGCGTGAACACTGAAGCTTTCTTT	CASSVACATGGVNTEAFF	TRBV9	TRBJ1-1
TGTGCCAGCAGCGTGAGGTGTAGGGGCCCGTGCCACACCATATATTTT	CASSVRCRGPCHTIYF	TRBV7-9	TRBJ1-3
TGTGCCAGCAGTTGGGAGGGAGACTATGGCTACACCTTC	CASSWEGDYGYTF	TRBV12-3	TRBJ1-2
TGCGCCAACCTGGAGGGGAACACAGATACGCAGTATTTT	CANLEGNTDTQYF	TRBV10-1	TRBJ2-3
TGTGCCCGGACGCGGAAAGCTAGCTCCTACAATGAGCAGTTCTTC	CARTRKASSYNEQFF	TRBV28	TRBJ2-1
TGCGCCAGCAGCCAGTGCGATGAGCAGTTCTTC	CASSQCDEQFF	TRBV4-3	TRBJ2-1
TGCGCCAGCAGCTTCCTGTCGGGCGCCCAGGACACTGAAGCTTTCTTT	CASSFLSGAQDTEAFF	TRBV5-1	TRBJ1-1
TGTGCCAGCAGCCCCCGACAGGGGTCCACCTATGGCTACACCTTC	CASSPRQGSTYGYTF	TRBV6-1	TRBJ1-2
TGTGCCCCCAGGACTAGCGGCCCGAACACCGGGGAGCTGTTTTTT	CAPRTSGPNTGELFF	TRBV19	TRBJ2-2
TGCGCCAGCAGCTTGGCGGAGGGGGGGCCCTTGGGGGAGGATGAGCAGTTCTTC	CASSLAEGGPLGEDEQFF	TRBV5-1	TRBJ2-1
TGTGCCAGCAGTTTCAAAGCAGACGGCGAGCAGTACTTC	CASSFKADGEQYF	TRBV28	TRBJ2-7
TGTGCCAGCAGCCAGAGCGCAGGGCCCTTTGGGAGCAATCAGCCCCAGCATTTT	CASSQSAGPFGSNQPQHF	TRBV13	TRBJ1-5
TGTGCCAGCAGTTTTCGGGACCTACCTAACTATGGCTACACCTTC	CASSFRDLPNYGYTF	TRBV27	TRBJ1-2
TGTGCCAGCAGGCTGGGGGGCTGGCCCCAGCATTTT	CASRLGGWPQHF	TRBV9	TRBJ1-5
TGCAGTGCTAGCCCCCCCAGGCAAGAGACCCAGTACTTC	CSASPPRQETQYF	TRBV20-1	TRBJ2-5
TGTGCCAGCAGTTTATCGCGACTAGCGGGGAGTGGGTTTGAGACCCAGTACTTC	CASSLSRLAGSGFETQYF	TRBV27	TRBJ2-5
TGTGCCAGCTCCCTTAGCGGGACTCGCATTCAGTACTTC	CASSLSGTRIQYF	TRBV18	TRBJ2-4
TGTGCCAGCAGTTACGAGATAAAGCGTAGTCAGGGGGATGGCTACACCTTC	CASSYEIKRSQGDGYTF	TRBV6-2	TRBJ1-2
TGTGCCAGCAGCGTAGAGCAGGACAGTAATGAAAAACTGTTTTTT	CASSVEQDSNEKLFF	TRBV9	TRBJ1-4
TGTGCCAGCAGAACAGGGAGCAATCAGCCCCAGCATTTT	CASRTGSNQPQHF	TRBV3-1	TRBJ1-5
TGTGCCAGCTCAGCTAAACTAGCGGGGTGTCTGGGCTCCTACGAGCAGTACTTC	CASSAKLAGCLGSYEQYF	TRBV18	TRBJ2-7
TGTGCCAGCAGCACGGGATGTTGGTACTTC	CASSTGCWYF	TRBV9	TRBJ2-5
TGTGCCTGGAGTGTATTGGGAGCAGAGTATTTT	CAWSVLGAEYF	TRBV30	TRBJ2-3
TGCGCCAGCAGCCAAGATTCCATGGGGGACGAGACCCAGTACTTC	CASSQDSMGDETQYF	TRBV4-1	TRBJ2-5
TGTGCCAGCAGCTTGGTTTCGATCTCCTACAATGAGCAGTTCTTC	CASSLVSISYNEQFF	TRBV9	TRBJ2-1
TGTGCCAGCAGCTGCGCCGGGACAGGTTACTTC	CASSCAGTGYF	TRBV7-3	TRBJ2-7
TGTGCCAGCAGTTATGTGTCCCAGGGCAGATATACGCAGTATTTT	CASSYVSQGRYTQYF	TRBV28	TRBJ2-3
TGTGCCAGCATATTCGGGGTGGGCTCTGGAAACACCATATATTTT	CASIFGVGSGNTIYF	TRBV6-5	TRBJ1-3
TGTGCCAGCAGCTTAGAGTTTCCGGGGCCGGCCTGCTCTGGAAACACCATATATTTT	CASSLEFPGPACSGNTIYF	TRBV11-1	TRBJ1-3
TGTGCCAGCAGCCTTGCAAATCGGAGGGGCGCGAACACTGAAGCTTTCTTT	CASSLANRRGANTEAFF	TRBV14	TRBJ1-1
TGTGCCAGCAGCTTGGTTAGAGAGGGCAATCAGCCCCAGCATTTT	CASSLVREGNQPQHF	TRBV5-6	TRBJ1-5
TGTGCCAGCAGTTTCCCGGGGAGGCAGCCCCAGCATTTT	CASSFPGRQPQHF	TRBV28	TRBJ1-5
TGTGCCAGCAGTGACGTCAAAAAACTGTTTTTT	CASSDVKKLFF	TRBV28	TRBJ1-4
TGCGCCAGCAGCCGTACCTGTGGTCCAGATACGCAGTATTTT	CASSRTCGPDTQYF	TRBV4-3	TRBJ2-3
TGTGCCAGCCTACGACAGGGGGCACACTCTGGGGCCAACGTCCTGACTTTC	CASLRQGAHSGANVLTF	TRBV19	TRBJ2-6
TGTGCCAGCAGTGATACACGGGGTACATATGGCTACACCTTC	CASSDTRGTYGYTF	TRBV25-1	TRBJ1-2
TGTGCCAGCAGCCCGAGACTAGCGGGTAGGTACGAGCAGTACTTC	CASSPRLAGRYEQYF	TRBV6-2	TRBJ2-7
TGTGCTAGCAGCTTAAACCCCCGGGACAGGGGGCGGGGCATTCAGTACTTC	CASSLNPRDRGRGIQYF	TRBV7-7	TRBJ2-4
TGTGCCAGCAGCGACCCGTGTAGCCACCAGGAGTCCTACGAGCAGTACTTC	CASSDPCSHQESYEQYF	TRBV3-1	TRBJ2-7
TGTGCCAGCAGTTTAATTCGGCATGGGTATGGCTACACCTTC	CASSLIRHGYGYTF	TRBV27	TRBJ1-2
TGTGCCAGTAGTAACCAACGGACAGATTGGACGACGGAAGCTTTCTTT	CASSNQRTDWTTEAFF	TRBV19	TRBJ1-1
TGCGCCAGCAGCATGGACAGTCGCTTTGGCTACACCTTC	CASSMDSRFGYTF	TRBV5-1	TRBJ1-2
TGTGCCAGCAGTGAGAGGTCAGTACATGGCTACACCTTC	CASSERSVHGYTF	TRBV25-1	TRBJ1-2
TGTCCTCCGAGGAAAGAGACCCAGTACTTC	CPPRKETQYF	TRBV7-9	TRBJ2-5
TGTGCCAGCAGGTGGGGCAGAGGGAATGAGCAGTTCTTC	CASRWGRGNEQFF	TRBV6-5	TRBJ2-1
TGTGCCAGCAGCCGACAGACAGACGAGCAGTACTTC	CASSRQTDEQYF	TRBV6-1	TRBJ2-7
TGTGCCTGGTTCCTCCGACGGAGCTACGAGCAGTACTTC	CAWFLRRSYEQYF	TRBV30	TRBJ2-7
TGTGCCACCGGGAGGGGTTCACCCCTCCACTTT	CATGRGSPLHF	TRBV12-3	TRBJ1-6
TGTGCCAGCAGTGCCCTACTAGCGGGAGGTATAGAGACCCAGTACTTC	CASSALLAGGIETQYF	TRBV27	TRBJ2-5
TGTGCCAGCAGCTTCAGACTGGATAATTCACCCCTCCACTTT	CASSFRLDNSPLHF	TRBV13	TRBJ1-6
TGTGCCAGCAGCCCTGTAAGGCGGAACTACAATGAGCAGTTCTTC	CASSPVRRNYNEQFF	TRBV13	TRBJ2-1
TGTGCCAGCAGCGGCCAGGGTCATAGTAACTATGGCTACACCTTC	CASSGQGHSNYGYTF	TRBV13	TRBJ1-2
TGTGCCAGCAGTGTGAACGGGGCAGATACGCAGTATTTT	CASSVNGADTQYF	TRBV6-4	TRBJ2-3
TGTGCCAGCAGCGGCGGGGACTATGGCTACACCTTC	CASSGGDYGYTF	TRBV5-5	TRBJ1-2
TGTGCCACCCCGCGGGAGGGTCGGGTCTTC	CATPREGRVF	TRBV24-1	TRBJ2-1
TGTGCCCCGTATTTAACAGGGGATACACGGAACTTC	CAPYLTGDTRNF	TRBV27	TRBJ2-7
TGTGCCATGGGGAGCATGTCCCCGACCTATGGCTACACCTTC	CAMGSMSPTYGYTF	TRBV6-5	TRBJ1-2
TGTGCCAGCAGTTTGTTTACCGGGGGACAGAAGGATACGCAGTATTTT	CASSLFTGGQKDTQYF	TRBV27	TRBJ2-3
TGTGCCAGCAGCCAAGATGGAAAGAGCTACGAGCAGTACTTC	CASSQDGKSYEQYF	TRBV3-1	TRBJ2-7
TGTGCCAGCAGTGGGGGGCTAAGGATGGGCCCCTACGAGCAGTACTTC	CASSGGLRMGPYEQYF	TRBV6-1	TRBJ2-7
TGCGCCAGCATTCGGCAAAATGACAGGCTTCAGCCCCAGCATTTT	CASIRQNDRLQPQHF	TRBV5-1	TRBJ1-5
TGTGCCTGGGCCTACCGACAGGAGTGTGTCGGGGAGCTGTTTTTT	CAWAYRQECVGELFF	TRBV30	TRBJ2-2
TGTGCCATCACCCCCACTAGGCAGGCCTACGAGCAGTACTTC	CAITPTRQAYEQYF	TRBV10-3	TRBJ2-7
TGTGCCAGCACCTTGTATTACAGCTCCTACAATGAGCAGTTCTTC	CASTLYYSSYNEQFF	TRBV4-2	TRBJ2-1
TGTGCCAGTAGTCCCCCTGGGCCTGGGGTTTCTGACACCGGGGAGCTGTTTTTT	CASSPPGPGVSDTGELFF	TRBV19	TRBJ2-2
TGTGCCAAACGGGCACGGGGCTCTGGGGCCAACGTCCTGACTTTC	CAKRARGSGANVLTF	TRBV9	TRBJ2-6
TGCGCCAGCGAAAGGGACAGGCCAACGGCATCACCCCTCCACTTT	CASERDRPTASPLHF	TRBV10-1	TRBJ1-6
TGTGCCAGCAGCCTCCCGGGACAGGGCGGAGAAAAACTGTTTTTT	CASSLPGQGGEKLFF	TRBV11-3	TRBJ1-4
TGTGCCAACTCTGGGTACACTAGCGGGAGCCCGAGATATGAGCAGTTCTTC	CANSGYTSGSPRYEQFF	TRBV6-4	TRBJ2-1
TGTGCCAGCAGTGCCAGGGACAGTCGCTCCTACAATGAGCAGTTCTTC	CASSARDSRSYNEQFF	TRBV2	TRBJ2-1
TGTGCCAGTAGTATCCCAGGGCCCCACGAGCAGTACTTC	CASSIPGPHEQYF	TRBV19	TRBJ2-7
TGTGCCAGCACCATCTTTTGTCGACAGGGGTACTATGGCTACACCTTC	CASTIFCRQGYYGYTF	TRBV7-3	TRBJ1-2
TGTGCCAGCAGTTTCCGAAAAGTACGGGGAGGGGTGGAGAGTGCAACTAATGAAAAACTGTTTTTT	CASSFRKVRGGVESATNEKLFF	TRBV28	TRBJ1-4
TGTGCCTGGAGTGTAGTGAGGACAGCCAATCAGCCCCAGCATTTT	CAWSVVRTANQPQHF	TRBV30	TRBJ1-5
TGTGCCAGCAGCCCTAGCGCCAAAAACATTCAGTACTTC	CASSPSAKNIQYF	TRBV11-3	TRBJ2-4
TGTGCCAGCAGGAACAGTAACTATGGCTACACCTTC	CASRNSNYGYTF	TRBV6-1	TRBJ1-2
TGCGCCAGCAGCTTTACCCTCAGGGGCTGCTGGGGTTCACCCCTCCACTTT	CASSFTLRGCWGSPLHF	TRBV5-1	TRBJ1-6
TGCGCCAGCAGCGTGGGGGCGTGGTGCTACAATGAGCAGTTCTTC	CASSVGAWCYNEQFF	TRBV5-1	TRBJ2-1
TGTGCCAGCAGCCAGGAGGGGCGTCACATGAACACTGAAGCTTTCTTT	CASSQEGRHMNTEAFF	TRBV7-3	TRBJ1-1
TGTGCCAGCAGCCAAGTCCGGGGGACAGGGGTATCAAAACTGTTTTTT	CASSQVRGTGVSKLFF	TRBV3-1	TRBJ1-4
TGTGCCAGCAGCTTGGGGTACCAGCCCCAGCATTTT	CASSLGYQPQHF	TRBV5-5	TRBJ1-5
TGTGCCAGCAGCAGGTCCGCCCAGCAGACGAACACTGAAGCTTTCTTT	CASSRSAQQTNTEAFF	TRBV13	TRBJ1-1
TGTGCCAGCAGTGCCAAGGTTAGCCCTTCCTACGAGCAGTACTTC	CASSAKVSPSYEQYF	TRBV27	TRBJ2-7
TGCGCCAGCAGCTTGGGGACAGGACCGGGCTCCTACAATGAGCAGTTCTTC	CASSLGTGPGSYNEQFF	TRBV5-1	TRBJ2-1
TGTGCCAGCAGTTTCAATAATCCAGCCTTGACCACCGGGGAGCTGTTTTTT	CASSFNNPALTTGELFF	TRBV28	TRBJ2-2
TGTGCTAGTGGTTTATGTCAGGGCTCCTACGAGCAGTACTTC	CASGLCQGSYEQYF	TRBV12-5	TRBJ2-7
TGTGCCAGCAGCTGCGCTAGGTGCCCGACGTGGAGCACAGATACGCAGTATTTT	CASSCARCPTWSTDTQYF	TRBV7-9	TRBJ2-3
TGTGCCAGCAGCTGGTACCAGGGGGCGCGGCACAATGAGCAGTTCTTC	CASSWYQGARHNEQFF	TRBV5-4	TRBJ2-1
TGTGCCAGCACCCGCAGTAATTTGTCAATGAACACTGAAGCTTTCTTT	CASTRSNLSMNTEAFF	TRBV6-6	TRBJ1-1
TGCGCCATACAGCTCAGGGACAGGGACGAAAAACTGTTTTTT	CAIQLRDRDEKLFF	TRBV5-1	TRBJ1-4
TGTGCCAGCAGCCCGGGACAGGGGGCGCGGGGTTTTGGAAACACCATATATTTT	CASSPGQGARGFGNTIYF	TRBV7-2	TRBJ1-3
TGCAGTACGGGGGCAGATACGCAGTATTTT	CSTGADTQYF	TRBV20-1	TRBJ2-3
TGCAGTGCTAGCCGGCCCGACCGCCAGACACACGAGCAGTACTTC	CSASRPDRQTHEQYF	TRBV20-1	TRBJ2-7
TGCAGCGCCCTATACCGGGGGTTTTTAGTAAAGGACTATGGCTACACCTTC	CSALYRGFLVKDYGYTF	TRBV29-1	TRBJ1-2
TGCAGTGCTAGGACGGTAAACTATGGCTACACCTTC	CSARTVNYGYTF	TRBV20-1	TRBJ1-2
TGTGCCAGCCCCGGTTCAAGGATGGCGAAGTGCTACGAGCAGTACTTC	CASPGSRMAKCYEQYF	TRBV7-3	TRBJ2-7
TGTGCCAGCAGTTACTCGGGTCTCTTGAACAATGAGCAGTTCTTC	CASSYSGLLNNEQFF	TRBV6-6	TRBJ2-1
TGCAGTGCTAGATTTTGGGGGCGGCCCCCCTACGAGCAGTACTTC	CSARFWGRPPYEQYF	TRBV20-1	TRBJ2-7
TGTGCCAGCAGCGCTGGGGGCAAAAACATTCAGTACTTC	CASSAGGKNIQYF	TRBV9	TRBJ2-4
TGTGCCAGCAGTATCCACAGGGTACGTGGAAACACCATATATTTT	CASSIHRVRGNTIYF	TRBV2	TRBJ1-3
TGTGCCAGCAGCTTAGGAGGGACCTGTGACGGGACTGAAGCTTTCTTT	CASSLGGTCDGTEAFF	TRBV11-2	TRBJ1-1
TGTGCCAATGGGGGGAGGTCGTACGAGCAGTACTTC	CANGGRSYEQYF	TRBV10-3	TRBJ2-7
TGCAGCGTTGAAGGGGGGGAAGGAGAGCAGTACTTC	CSVEGGEGEQYF	TRBV29-1	TRBJ2-7
TGTGCCAGCAGCATTGAGGGCTATGGCTACACCTTC	CASSIEGYGYTF	TRBV13	TRBJ1-2
TGCAGCGTTCGTCTTCACGGGGGGCCAGGGCCAGGGGACTCCTACAATGAGCAGTTCTTC	CSVRLHGGPGPGDSYNEQFF	TRBV29-1	TRBJ2-1
TGTGCCAGCAGTTTATGGGACAGGGTTGTTCAGCCCCAGCATTTT	CASSLWDRVVQPQHF	TRBV28	TRBJ1-5
TGTGCCAGCAGGGGGACTAGTGAGACCCAGTACTTC	CASRGTSETQYF	TRBV7-2	TRBJ2-5
TGTGCCATCTCGATAGCGGGAAGAGCCTACGAGCAGTACTTC	CAISIAGRAYEQYF	TRBV10-3	TRBJ2-7
TGTGCCAGCAGCGGCGAGACGACCGGGGAGCTGTTTTTT	CASSGETTGELFF	TRBV13	TRBJ2-2
TGTGCCTGGAGTGTGCCATCGGGGCGGGAGCAGTACTTC	CAWSVPSGREQYF	TRBV30	TRBJ2-7
TGTGCCAGCAAATTAGGGTACGAGCAGTACTTC	CASKLGYEQYF	TRBV9	TRBJ2-7
TGTGCCAGCAGTGCGGGGCGGGGAGAAAGTAACTCCTACGAGCAGTACTTC	CASSAGRGESNSYEQYF	TRBV2	TRBJ2-7
TGTGCCAGCAGCGGCGTTCGTGGTTACGAGCAGTACTTC	CASSGVRGYEQYF	TRBV13	TRBJ2-7
TGTGCCAGCAGCTTAGATCCAATCGGGGATGACGGCACTGAAGCTTTCTTT	CASSLDPIGDDGTEAFF	TRBV11-3	TRBJ1-1
TGTGCCATCAGCCAACGGACTAGCCCGCGGTCACGGGTCACCGGGGAGCTGTTTTTT	CAISQRTSPRSRVTGELFF	TRBV10-3	TRBJ2-2
TGTGCCAGCAGCCTTAAACAATACAGGAACACTGAAGCTTTCTTT	CASSLKQYRNTEAFF	TRBV14	TRBJ1-1
TGCAGTGCGGACTCCGTCCCCTATATGGACAGGGCCTACTCTGGGGCCAACGTCCTGACTTTC	CSADSVPYMDRAYSGANVLTF	TRBV20-1	TRBJ2-6
TGTGCCAGCACTCTAGACAGGAATGGGCTAGAAAAACTGTTTTTT	CASTLDRNGLEKLFF	TRBV12-3	TRBJ1-4
TGTGCCAGCAGCTCGACTGGTAGCTACGAGCAGTACTTC	CASSSTGSYEQYF	TRBV11-3	TRBJ2-7
TGTGCCAGCAGGTTCCTAGGGAGGGGAGATACGCAGTATTTT	CASRFLGRGDTQYF	TRBV5-6	TRBJ2-3
TGTGCCAGCAGGGTTCAAGTCTGGAATGGGGCGGTTGAAGCTTTCTTT	CASRVQVWNGAVEAFF	TRBV27	TRBJ1-1
TGTGCCAGCAGTTACGATCGTAACCTGGGACTAGCGGGGAACTCCTACGAGCAGTACTTC	CASSYDRNLGLAGNSYEQYF	TRBV6-5	TRBJ2-7
TGTGCCAGCAGCCAGGCTAGCACGGACGAGCAGTACTTC	CASSQASTDEQYF	TRBV3-1	TRBJ2-7
TGTGCCAGCAGTGAAGTTGGAGGGGGCAGCCATCAGCCCCAGCATTTT	CASSEVGGGSHQPQHF	TRBV6-4	TRBJ1-5
TGCAGTGCATTTCATAAGCCGGGACAGGGGGGAGAGCAGTACTTC	CSAFHKPGQGGEQYF	TRBV20-1	TRBJ2-7
TGTGCCAGCAGCTTTGGCGTCAGAATCCCAAGGGGGACGCAGTATTTT	CASSFGVRIPRGTQYF	TRBV11-3	TRBJ2-3
TGTGCCAGCAAGGAAATTAGTTGGGGCCTTGGGGGCACAGATACGCAGTATTTT	CASKEISWGLGGTDTQYF	TRBV3-1	TRBJ2-3
TGTGCCAGCACTCTTTTAATCAACAGGGTCGGGGTTGAAAAACTGTTTTTT	CASTLLINRVGVEKLFF	TRBV6-3	TRBJ1-4
TGCGCCAGCAGCCTCGGACAGTGGGGCTCCTCCTACGAGCAGTACTTC	CASSLGQWGSSYEQYF	TRBV5-1	TRBJ2-7
TGTGCCACCCGGTTGGGTACCCGCTCCTACGAGCAGTACTTC	CATRLGTRSYEQYF	TRBV15	TRBJ2-7
TGTGCCAGCAGCTTAGCAGGGCGGAACACTGAAGCTTTCTTT	CASSLAGRNTEAFF	TRBV7-2	TRBJ1-1
TGTGCCAGCAGATGGGGACGACCGTTTGAAAAACTGTTTTTT	CASRWGRPFEKLFF	TRBV2	TRBJ1-4
TGTGCCAGCAGTTTCCCCATTTCTCGGGATCAGCCCCAGCATTTT	CASSFPISRDQPQHF	TRBV27	TRBJ1-5
TGTGCCAGCAGCGTAGCATCCGGTTCAACAGGGGACACTGAAGCTTTCTTT	CASSVASGSTGDTEAFF	TRBV9	TRBJ1-1
TGTGCCACCAGCCAAGAAAATGCGCCGGGACAGGGGGACAACTATGGCTACACCTTC	CATSQENAPGQGDNYGYTF	TRBV15	TRBJ1-2
TGCAGCGGCTTGAACACTGAAGCTTTCTTT	CSGLNTEAFF	TRBV20-1	TRBJ1-1
TGTGCCATCAGTGGAGTGGGGGCAGGGGGAACCGGGGAGCTGTTTTTT	CAISGVGAGGTGELFF	TRBV10-3	TRBJ2-2
TGTGCCAGCACACTAGCGGGTCCGACCTACGAGCAGTACTTC	CASTLAGPTYEQYF	TRBV6-2	TRBJ2-7
TGTGAGAAGTCCATAGGGTTCACAGATACGCAGTATTTT	CEKSIGFTDTQYF	TRBV28	TRBJ2-3
TGTGCCAGCAGCCAAACGGGGACAGGGGGCGATACGCAGTATTTT	CASSQTGTGGDTQYF	TRBV13	TRBJ2-3
TGTGCCAGCAGCCGTCGGGCCGAGACCGGGGAGCTGTTTTTT	CASSRRAETGELFF	TRBV9	TRBJ2-2
TGTGCCAGCAACGGACTAGGCTCCTACGAGCAGTACTTC	CASNGLGSYEQYF	TRBV6-4	TRBJ2-7
TGTGCCAGCAGCCCAAGAGATCACCCGGGACAGTTTGACACCATATATTTT	CASSPRDHPGQFDTIYF	TRBV5-6	TRBJ1-3
TGTGCCAGCAGCTCTCAGGTTTTGAACACTGAAGCTTTCTTT	CASSSQVLNTEAFF	TRBV12-3	TRBJ1-1
TGTGCCAGCAGCCAAGTACCCTCCTACGAGCAGTACTTC	CASSQVPSYEQYF	TRBV11-3	TRBJ2-7
TGTGCCAGACGTGGGGGGCCTGCGGATGAGCAGTTCTTC	CARRGGPADEQFF	TRBV6-6	TRBJ2-1
TGTGCCAGTAGTAGGGCAGTAAAGGGGGCCGGCTATGGCTACACCTTC	CASSRAVKGAGYGYTF	TRBV19	TRBJ1-2
TGCAGTGCTAGGTCGACTAGCGGGGGTAAATGGGTCGCCTACGAGCAGTACTTC	CSARSTSGGKWVAYEQYF	TRBV20-1	TRBJ2-7
TGTGCCATGACTCCGGGACTAGTTGGAGATACGCAGTATTTT	CAMTPGLVGDTQYF	TRBV7-8	TRBJ2-3
TGTGCCAGCAGTGACGCCTTCTGGACTAGCGGACACAATGAGCAGTTCTTC	CASSDAFWTSGHNEQFF	TRBV2	TRBJ2-1
TGTGCCAGCCCTAACAGGGGCGGTGAGCAGTTCTTC	CASPNRGGEQFF	TRBV9	TRBJ2-1
TGTGCCAGTAGTATCTTCAGGGGCCATGAGGGGGGAAACATTCAGTACTTC	CASSIFRGHEGGNIQYF	TRBV19	TRBJ2-4
TGCAGTGCGGGGTGGGTAGCTAACTATGGCTACACCTTC	CSAGWVANYGYTF	TRBV20-1	TRBJ1-2
TGTGCCAGCAGCGGCGGGGGACAGGGGCAGCCCCAGCATTTT	CASSGGGQGQPQHF	TRBV13	TRBJ1-5
TGTGCCAGTTGGGAGAGGGCCGAAGCTTTCTTT	CASWERAEAFF	TRBV19	TRBJ1-1
TGTGCCACCGGCGAGGGGGATCAGCCCCAGCATTTT	CATGEGDQPQHF	TRBV24-1	TRBJ1-5
TGCAGTGCGCACAGAGATAACGACGCGAACACCGGGGAGCTGTTTTTT	CSAHRDNDANTGELFF	TRBV20-1	TRBJ2-2
TGTGCCAGCAGTTACGTCAGGGAGGGGGGAGATACGCAGTATTTT	CASSYVREGGDTQYF	TRBV6-3	TRBJ2-3
TGTGCCTGGAGTCGGGGGTTGACCCAGTACTTC	CAWSRGLTQYF	TRBV30	TRBJ2-5
TGTGCCAGCAGTGAGGGCTTAAACACAGATACGCAGTATTTT	CASSEGLNTDTQYF	TRBV25-1	TRBJ2-3
TGTGCCAGCAGTGAAATTAGGTCCTACACCGGGGAGCTGTTTTTT	CASSEIRSYTGELFF	TRBV6-1	TRBJ2-2
TGTGCCAACATCTCGCAGGGTAGGGTGAAGAACTATGGCTACACCTTC	CANISQGRVKNYGYTF	TRBV19	TRBJ1-2
TGTGCCAGCAGCGTAGGCACAGATAGCTCCTACGAGCAGTACTTC	CASSVGTDSSYEQYF	TRBV9	TRBJ2-7
TGCGCCAGCCGCGGGGGGGGGGGCACAGATACGCAGTATTTT	CASRGGGGTDTQYF	TRBV10-1	TRBJ2-3
TGTGCCAGCAGTTTATGGCCGAGGGGTTACCGACCTGCCAATCAGCCCCAGCATTTT	CASSLWPRGYRPANQPQHF	TRBV27	TRBJ1-5
TGTGCCAGCAGTTTCCCCCGGGGGGAAGGTGAAGCTTTCTTT	CASSFPRGEGEAFF	TRBV12-4	TRBJ1-1
TGTGCCAGCAGCTGGGGGGGGGGAGGGTACGAGCAGTACTTC	CASSWGGGGYEQYF	TRBV7-2	TRBJ2-7
TGTGCCAGCAGTTTGTTAGGGAGGGAGCTCAGGTCTGGCAATCAGCCCCAGCATTTT	CASSLLGRELRSGNQPQHF	TRBV28	TRBJ1-5
TGCGCCAGCAGCAAAGGGCCTAATGAAAAACTGTTTTTT	CASSKGPNEKLFF	TRBV5-1	TRBJ1-4
TGTGCCAGTAGACTGCTTGACAGGGCCTATGGCACTGAAGCTTTCTTT	CASRLLDRAYGTEAFF	TRBV19	TRBJ1-1
TGTGCCAGCTCACAGGCAAGGGGCCAAGAGACCCAGTACTTC	CASSQARGQETQYF	TRBV18	TRBJ2-5
TGCGCCAGCAGCATTGTCGCCTACAGGGAATACGAGCAGTACTTC	CASSIVAYREYEQYF	TRBV5-1	TRBJ2-7
TGCAGTGCTAGCTTGATAGCAGGGGGTTTGGATAGCAATCAGCCCCAGCATTTT	CSASLIAGGLDSNQPQHF	TRBV20-1	TRBJ1-5
TGTGCCAGCAGCCGGCCGGGACAGGGGTGGCCGGATGAGCAGTTCTTC	CASSRPGQGWPDEQFF	TRBV14	TRBJ2-1
TGTGCCAGCAGGGGGGACGTACCTAAGAACACTGAAGCTTTCTTT	CASRGDVPKNTEAFF	TRBV6-2	TRBJ1-1
TGTGCCAGCAGTGACCAGACGGGGTTGGGTGGACCGGGGGGCTACGAGCAGTACTTC	CASSDQTGLGGPGGYEQYF	TRBV6-4	TRBJ2-7
TGCAGCGTTCATAGGGGGGGAGGACGGATCTACGAGCAGTACTTC	CSVHRGGGRIYEQYF	TRBV29-1	TRBJ2-7
TGTGCCAGCAGCCTCGGCAGTGGCTACACCTTC	CASSLGSGYTF	TRBV3-1	TRBJ1-2
TGTGCCAGCGTCTCCCTCGAGTACGGCTACACCTTC	CASVSLEYGYTF	TRBV12-3	TRBJ1-2
TGCAGTGGTTCTCAGCGGAACACTGAAGCTTTCTTT	CSGSQRNTEAFF	TRBV20-1	TRBJ1-1
TGTGCCAGCAGTTGGCAGACTTCTATGAACACTGAAGCTTTCTTT	CASSWQTSMNTEAFF	TRBV6-8	TRBJ1-1
TGTGCCAGCAGCTCCGGGACAGGGCCCTATAGCAATCAGCCCCAGCATTTT	CASSSGTGPYSNQPQHF	TRBV7-8	TRBJ1-5
TGCGCCGGGGCGAACCTTCTCGCTAGAAAGGTCGAGACCCAGTACTTC	CAGANLLARKVETQYF	TRBV4-1	TRBJ2-5
TGTGCCAGTAATGCCGGGACAGGGAACGGAAACGAGCAGTACTTC	CASNAGTGNGNEQYF	TRBV14	TRBJ2-7
TGTGCCAGCAGCTTAGTTTCACCGGGACAGGCCGGACATGGCTACACCTTC	CASSLVSPGQAGHGYTF	TRBV11-2	TRBJ1-2
TGTGCCAGTAGTAGATTATGCCCCGAGGGGGTGTACTTC	CASSRLCPEGVYF	TRBV19	TRBJ2-7
TGTGCCAGCAGCCCCACGACAGGGGGCGCCTTCGGGGAGCTGTTTTTT	CASSPTTGGAFGELFF	TRBV5-6	TRBJ2-2
TGTGCCAGCAGCGGGGGTCAGGGGTACGGCAGGAGCCAAGAGACCCAGTACTTC	CASSGGQGYGRSQETQYF	TRBV9	TRBJ2-5
TGTGCCAGCAGCCTCAGGAACCAGGACAGCTCCTACAATGAGCAGTTCTTC	CASSLRNQDSSYNEQFF	TRBV13	TRBJ2-1
TGTGCCAGCAGCGCCCGGACAGGGGGGGACGAGCAGTACTTC	CASSARTGGDEQYF	TRBV9	TRBJ2-7
TGCGCCAGCAGCCAAGATCCTGTCTTTCTACAAGATACGCAGTATTTT	CASSQDPVFLQDTQYF	TRBV4-1	TRBJ2-3
TGCGCCAGCAGCTTTGCCCGGGGAGCTAACTATGGCTACACCTTC	CASSFARGANYGYTF	TRBV5-1	TRBJ1-2
TGTGCCAGCAAGGGACTAGCGGGAAATGAGCAGTTCTTC	CASKGLAGNEQFF	TRBV6-4	TRBJ2-1
TGTGCCAGCATGGGGACCAGGGGAGGATGGGTCTGGGATCAGCCCCAGCATTTT	CASMGTRGGWVWDQPQHF	TRBV6-2	TRBJ1-5
TGTGCCAGTTATTTGAATGCCCACGGTCACGAGCAGTACTTC	CASYLNAHGHEQYF	TRBV6-5	TRBJ2-7
TGTGCCCTTAAGGGGGGGTGCACAGATACGCAGTATTTT	CALKGGCTDTQYF	TRBV7-2	TRBJ2-3
TGTGCCAGCAGTTCCCGGGACAGGGACTCCGGAAGTCCAACTAATGAAAAACTGTTTTTT	CASSSRDRDSGSPTNEKLFF	TRBV6-3	TRBJ1-4
TGTGCCAGCAGCCAAGATGTGGAGAGGGGGGAGGATAATTCACCCCTCCACTTT	CASSQDVERGEDNSPLHF	TRBV14	TRBJ1-6
TGCGGCTCCTGGGGGGAATGCAATGAGCAGTTCTTC	CGSWGECNEQFF	TRBV10-1	TRBJ2-1
TGCAGTGCGTATAGCGGGTACGAGCAGTACTTC	CSAYSGYEQYF	TRBV20-1	TRBJ2-7
TGTGCCAGCAGTCCAGAAAGCAACGAGCAGTACTTC	CASSPESNEQYF	TRBV27	TRBJ2-7
TGTGCCAGCAGGCTAGGGGGCCTGGCAAACCTAGGAGGTCTGCCCCAGCATTTT	CASRLGGLANLGGLPQHF	TRBV12-3	TRBJ1-5
TGTGCCAGCAGAGTTGAGTGGGAACAGCCCCAGCATTTT	CASRVEWEQPQHF	TRBV6-4	TRBJ1-5
TGCGCCAGCAGCGTGGGGGAGATCTCTGGAAACACCATATATTTT	CASSVGEISGNTIYF	TRBV5-1	TRBJ1-3
TGTGCCAGCAGTTACTTCGCGTACGAGCAGTACTTC	CASSYFAYEQYF	TRBV6-3	TRBJ2-7
TGTGCCAGCATCAGAAGATTAGCGGGCTACGAGCAGTACTTC	CASIRRLAGYEQYF	TRBV27	TRBJ2-7
TGCAGTGCTAGAGCCACCAGAAGTCCCAGGCAAGAGACCCAGTACTTC	CSARATRSPRQETQYF	TRBV20-1	TRBJ2-5
TGCAGTGCTCGCGGGAGCAGTCACACCGGGGAGCTGTTTTTT	CSARGSSHTGELFF	TRBV20-1	TRBJ2-2
TGTGCCAGCAGCTTAGCGCAGCTAGCGGGCTCGACTTCCTACGAGCAGTACTTC	CASSLAQLAGSTSYEQYF	TRBV7-9	TRBJ2-7
TGTGCCAGCAATATGGAAGGGGGGGGACTGTATTTT	CASNMEGGGLYF	TRBV27	TRBJ2-3
TGTGCCAGCAGGACAGGGAATGAGACCCAGTACTTC	CASRTGNETQYF	TRBV12-4	TRBJ2-5
TGCACAATCGACAGGGGCCCTTGCACAGATACGCAGTATTTT	CTIDRGPCTDTQYF	TRBV20-1	TRBJ2-3
TGTGCGGTCCCGGGGCATAGCAATCAGCCCCAGCATTTT	CAVPGHSNQPQHF	TRBV12-5	TRBJ1-5
TGTGCCAGCAGTTACCGGGACAGGGGACCCTCCTACAATGAGCAGTTCTTC	CASSYRDRGPSYNEQFF	TRBV6-3	TRBJ2-1
TGTGCCACCAGTGACGGACAGGGACAGAGCGGGGGGTACAATCAGCCCCAGCATTTT	CATSDGQGQSGGYNQPQHF	TRBV24-1	TRBJ1-5
TGTGCTAGTGGTTTGGTACTCATATGGATTAATGAAAAACTGTTTTTT	CASGLVLIWINEKLFF	TRBV12-5	TRBJ1-4
TGTGCCAAGGACAGGGCATACGAGCAGTACTTC	CAKDRAYEQYF	TRBV14	TRBJ2-7
TGTGCCAGCAGTGGTTGGAGCGGACAAGATACGCAGTATTTT	CASSGWSGQDTQYF	TRBV6-3	TRBJ2-3
TGTGCCACCAGTGACTTAGGCTCTCTGAACTATGGCTACACCTTC	CATSDLGSLNYGYTF	TRBV24-1	TRBJ1-2
TGCAGCTATTCCAGCAGGGACAAGCATCAGCCCCAGCATTTT	CSYSSRDKHQPQHF	TRBV29-1	TRBJ1-5
TGTGCCAGCAGCTTACAAGGGGGGAACACTGAAGCTTTCTTT	CASSLQGGNTEAFF	TRBV5-4	TRBJ1-1
TGCGCCAGCAGCCAAGCTAGCGGATGCGCTTATGAGCAGTTCTTC	CASSQASGCAYEQFF	TRBV4-3	TRBJ2-1
TGTGCCAGCCGGGTACAGGGGAGTGAGCAGTTCTTC	CASRVQGSEQFF	TRBV6-5	TRBJ2-1
TGTGCCAGCTCACCACCCCAGGTCGGGCATACGACCCAGTACTTC	CASSPPQVGHTTQYF	TRBV18	TRBJ2-5
TGCGCCAGCAGCTACCCAGCAGGGGGCTCTGGGGCCAACGTCCTGACTTTC	CASSYPAGGSGANVLTF	TRBV5-1	TRBJ2-6
TGCGCCAGCAGTGAGGGTATCGGGCTAGCGCATTCCTACGAGCAGTACTTC	CASSEGIGLAHSYEQYF	TRBV10-1	TRBJ2-7
TGTGCCAGCAGCAGCAGGGGACCTGATACGCAGTATTTT	CASSSRGPDTQYF	TRBV7-4	TRBJ2-3
TGTGCCAGCAGTTTTGGACGACAGGGCTTCCAAGAGACCCAGTACTTC	CASSFGRQGFQETQYF	TRBV12-4	TRBJ2-5
TGTGCCAGCAGTTTAACCCCCCCTGGGGCGTACGAGCAGTACTTC	CASSLTPPGAYEQYF	TRBV28	TRBJ2-7
TGTGCCAGCAGCTTTGGGGGACAGCTGGGGGACGAGCAGTACTTC	CASSFGGQLGDEQYF	TRBV7-3	TRBJ2-7
TGTGCCAGCAGCTCGCTGGGACTAGCGGGCTACGAGTACGAGCAGTACTTC	CASSSLGLAGYEYEQYF	TRBV5-4	TRBJ2-7
TGTGCTAGTGGTCTAGGGAAGGGCTACACCTTC	CASGLGKGYTF	TRBV12-5	TRBJ1-2
TGTGCCACCAGTTCGTTCCGGGACAGGGGGGGCAATCAGCCCCAGCATTTT	CATSSFRDRGGNQPQHF	TRBV24-1	TRBJ1-5
TGTGCCAGCAGCAGTCTAGCGGGAGAGACCCAGTACTTC	CASSSLAGETQYF	TRBV7-9	TRBJ2-5
TGTGCCAGCCATAGGGCCAAAAACATTCAGTACTTC	CASHRAKNIQYF	TRBV27	TRBJ2-4
TGTGCCAGCAGTTTATTTCCGAAATACTATGGCTACACCTTC	CASSLFPKYYGYTF	TRBV27	TRBJ1-2
TGTGCCAGCAGCTTTACCGGCGGACAGGGGGAGGGCTATAGCAATCAGCCCCAGCATTTT	CASSFTGGQGEGYSNQPQHF	TRBV27	TRBJ1-5
TGTGCCAGAGCAGACGGGACGAAAGGCAATCAGCCCCAGCATTTT	CARADGTKGNQPQHF	TRBV6-4	TRBJ1-5
TGCGCCAGCAGCCAAGAGGGGATAGCATCATATAGCAATCAGCCCCAGCATTTT	CASSQEGIASYSNQPQHF	TRBV4-1	TRBJ1-5
TGTGCCAGCAGTCGGAGTGCCGAGCAGTACTTC	CASSRSAEQYF	TRBV9	TRBJ2-7
TGTGCCAGCAGCGCGACTAGGAGAGAGACCCAGTACTTC	CASSATRRETQYF	TRBV7-3	TRBJ2-5
TGCAGTGCTAGGGGACTAGCGGGGGGCATGGAGAGATTTAGGGGGCAAGAGACCCAGTACTTC	CSARGLAGGMERFRGQETQYF	TRBV20-1	TRBJ2-5
TGCGCCAGCAGACGACAGGGGAGTAAGGAAAAACTGTTTTTT	CASRRQGSKEKLFF	TRBV10-1	TRBJ1-4
TGTGCCAGCAGCCTCAGGGACCCATATGGCTACACCTTC	CASSLRDPYGYTF	TRBV13	TRBJ1-2
TGTGCCAGCAGCGCCGGGACAGGGATTGCCCAGCATTTT	CASSAGTGIAQHF	TRBV13	TRBJ1-5
TGTGCCACCAGGAGGTTTTACTACAGGGGCACCGGGGAGCTGTTTTTT	CATRRFYYRGTGELFF	TRBV24-1	TRBJ2-2
TGCGCCAGCAGCCAAGATCAGGGGGGGGGAGCTCCGACAGATACGCAGTATTTT	CASSQDQGGGAPTDTQYF	TRBV4-1	TRBJ2-3
TGTGCCAGCAGCACCGCCCGAGGACAGGGCGGGCACTATGGCTACACCTTC	CASSTARGQGGHYGYTF	TRBV13	TRBJ1-2
TGTGCCAGCAAAACACGAACCAGGATAACTGAAGCTTTCTTT	CASKTRTRITEAFF	TRBV9	TRBJ1-1
TGTGCCACCAGTGATTCCCCTACGACTAGCGGTAGCTCTGGGGCCAACGTCCTGACTTTC	CATSDSPTTSGSSGANVLTF	TRBV24-1	TRBJ2-6
TGTGCCAGCCTGACAGGGGTCTGGAATCAGCCCCAGCATTTT	CASLTGVWNQPQHF	TRBV13	TRBJ1-5
TGTGCCAGCGACCAGAGCAAAAACATTCAGTACTTC	CASDQSKNIQYF	TRBV7-9	TRBJ2-4
TGTGCCAGCAGCTTAGGAGGGGGGCTACCAAGTGGGTATAATTCACCCCTCCACTTT	CASSLGGGLPSGYNSPLHF	TRBV11-2	TRBJ1-6
TGCGCCAGCAGCAGACACCCCAGGGAGGACCTTACGGACACTGAAGCTTTCTTT	CASSRHPREDLTDTEAFF	TRBV10-1	TRBJ1-1
TGTGCCAGCAGCTTTACTAGCATATACACCGGGGAGCTGTTTTTT	CASSFTSIYTGELFF	TRBV11-3	TRBJ2-2
TGCGCCAGCAGCCGATCCTCGGGGGACAGGGGGAGCTCCTACGAGCAGTACTTC	CASSRSSGDRGSSYEQYF	TRBV4-1	TRBJ2-7
TGCGCCAGCAAAACCTGGGCATGGGGCTATGGCTACACCTTC	CASKTWAWGYGYTF	TRBV10-2	TRBJ1-2
TGCGCCAGCAGTGTGACAGGGCCCTACGAGCAGTACTTC	CASSVTGPYEQYF	TRBV10-1	TRBJ2-7
TGCAGTGCTAGAGCAGGCCGGGACAGAAACTACGCCCGAGGCTACACCTTC	CSARAGRDRNYARGYTF	TRBV20-1	TRBJ1-2
TGTGCCAGCACAGGGGGGCCCAGATACTCCTACGAGCAGTACTTC	CASTGGPRYSYEQYF	TRBV27	TRBJ2-7
TGTGCCAGCTATAAGCGGGACAGGGCGAGCTCCTACAATGAGCAGTTCTTC	CASYKRDRASSYNEQFF	TRBV9	TRBJ2-1
TGTGCCAGCAGTTACACGAAAAAAGGGGACCTTAACGAGCAGTACTTC	CASSYTKKGDLNEQYF	TRBV6-5	TRBJ2-7
TGTGCCAGCAGTGACTCCATCGGGGGGTGCTGGAATCAGCCCCAGCATTTT	CASSDSIGGCWNQPQHF	TRBV6-4	TRBJ1-5
TGTGCCAGCAGCCATCCTACGACAGGGTCCAGCTCTGGAAACACCATATATTTT	CASSHPTTGSSSGNTIYF	TRBV14	TRBJ1-3
TGTGCCAGCAGGGGTGAAGCCAAAAACATTCAGTACTTC	CASRGEAKNIQYF	TRBV6-8	TRBJ2-4
TGTGCCAGCAGCTCCTCAGGACGGGGGGCTTTCTTT	CASSSSGRGAFF	TRBV7-9	TRBJ1-1
TGTGCCAGCAGTGACTCAAATGGGAAACAGTATATAGCCAAAAACATTCAGTACTTC	CASSDSNGKQYIAKNIQYF	TRBV6-4	TRBJ2-4
TGTGCCAGCAGCGAACACCAAGAGACCCAGTACTTC	CASSEHQETQYF	TRBV7-3	TRBJ2-5
TGCAGTGCTAGAGTTCGAGGGGTGGGAAACTATGGCTACACCTTC	CSARVRGVGNYGYTF	TRBV20-1	TRBJ1-2
TGTGCCAGCAGCCCCGGGGATGAGCAGTTCTTC	CASSPGDEQFF	TRBV9	TRBJ2-1
TGTGCCAGCAGCGTCCCGAGGATCGAGACCCAGTACTTC	CASSVPRIETQYF	TRBV9	TRBJ2-5
TGTGCCAGCAGAACCGGCAGGGGCGACACTGAAGCTTTCTTT	CASRTGRGDTEAFF	TRBV12-4	TRBJ1-1
TGTGCCAGCAGCCCTAGGCCTACCATACCAGATACGCAGTATTTT	CASSPRPTIPDTQYF	TRBV7-8	TRBJ2-3
TGTGCCAGCAGCCCCTCTCTGACTAGACGGGCCTACAATGAGCAGTTCTTC	CASSPSLTRRAYNEQFF	TRBV7-9	TRBJ2-1
TGTGCCAGTAGGGAACGCCACGAGCAGTACTTC	CASRERHEQYF	TRBV12-3	TRBJ2-7
TGTGCCAGCAGCCAAGTTGGGACTAGCGGGAAAGAGACCCAGTACTTC	CASSQVGTSGKETQYF	TRBV4-2	TRBJ2-5
TGTGCCAGCAGGACCGTCGAGAATGAGCAGTTCTTC	CASRTVENEQFF	TRBV6-4	TRBJ2-1
TGTGCCAGCAGTGCACCTCAAACAGGGGGCCATGGGGGGCCAATGGATAGCAATCAGCCCCAGCATTTT	CASSAPQTGGHGGPMDSNQPQHF	TRBV6-4	TRBJ1-5
TGTGCCAGCAGTTTAGAAGGGACTAGCGGGGGGCGGGGCTACAATGAGCAGTTCTTC	CASSLEGTSGGRGYNEQFF	TRBV12-3	TRBJ2-1
TGTGCCAGCAGTGTTTGGGGCAAGGGGAAGTTCAATCAGCCCCAGCATTTT	CASSVWGKGKFNQPQHF	TRBV6-4	TRBJ1-5
TGTGCCAGCAGCTTAGCGTTCCCCGGGACAACTTTCGAAAAACTGTTTTTT	CASSLAFPGTTFEKLFF	TRBV11-2	TRBJ1-4
TGTGCCAGCAGCGTAGGTAGCCGCCCGGGACTAGCGGGCCCCGGGAAGCAGTACTTC	CASSVGSRPGLAGPGKQYF	TRBV9	TRBJ2-7
TGTGCCAGCAGCTTAAATCACAGGGGGAACACCGGGGAGCTGTTTTTT	CASSLNHRGNTGELFF	TRBV11-1	TRBJ2-2
TGTGCCAGCAGCGTTCGAGGGCTGCCCTACGAGCAGTACTTC	CASSVRGLPYEQYF	TRBV7-9	TRBJ2-7
TGTGCCAGCAGGGGGACGCTTCGAGACAGGGATTGGATGAGTCAGCCCCAGCATTTT	CASRGTLRDRDWMSQPQHF	TRBV6-6	TRBJ1-5
TGTGCCATGCCTACCGGGACGCGGACCTACGAGCAGTACTTC	CAMPTGTRTYEQYF	TRBV10-3	TRBJ2-7
TGTGCCAGCAGCTTGGGCGGAGGGGAGTCTTGGTACGAGCAGTACTTC	CASSLGGGESWYEQYF	TRBV7-3	TRBJ2-7
TGTGCCAGTAGTATAGACCCTTATCCCGCGGGGCTCATAGATACGCAGTATTTT	CASSIDPYPAGLIDTQYF	TRBV19	TRBJ2-3
TGTGCTAGTGGTTTTCAGGGGGGCCAGAACGAGCAGTACTTC	CASGFQGGQNEQYF	TRBV12-5	TRBJ2-7
TGTGCCAGCAGCTTGAACGACAGGGTCTCGCATCAAGAGACCCAGTACTTC	CASSLNDRVSHQETQYF	TRBV5-6	TRBJ2-5
TGTGGATTGGGACAGGGCCAGAGCAAGTACAATTCACCCCTCCACTTT	CGLGQGQSKYNSPLHF	TRBV2	TRBJ1-6
TGTGCCAGCAGCATGGCAACCGCAGGGAAGAGCACAGATACGCAGTATTTT	CASSMATAGKSTDTQYF	TRBV7-3	TRBJ2-3
TGCAGTGCTAGAGATCCTGTCGGGGGAAACACAGATACGCAGTATTTT	CSARDPVGGNTDTQYF	TRBV20-1	TRBJ2-3
TGTGCCAGCTCACCAAAGAGAGGGACGGAGGTGGAAAAACTGTTTTTT	CASSPKRGTEVEKLFF	TRBV18	TRBJ1-4
TGTGCCAGACCTCAGCGTGGGAATTGGGAGCAGTACTTC	CARPQRGNWEQYF	TRBV7-4	TRBJ2-7
TGCGCCAGCAGCCACGCGCGGGGGACCAAGAGCCAGCCGACAGATACGCAGTATTTT	CASSHARGTKSQPTDTQYF	TRBV4-1	TRBJ2-3
TGTGCCAGCAGCACACGAAAAGGGATCCTTCGGTGGGTTCCCTGCACAGATACGCAGTATTTT	CASSTRKGILRWVPCTDTQYF	TRBV28	TRBJ2-3
TGTGCCAGCAGCTTCTGGTGGGGCACCGGGGAGCTGTTTTTT	CASSFWWGTGELFF	TRBV7-9	TRBJ2-2
TGTGCCAGCAGCTTAGCGGGGTCCTACGAGCAGTACTTC	CASSLAGSYEQYF	TRBV7-4	TRBJ2-7
TGTGCCAGCAGCGGGACAGGGTTCGACAATGAGCAGTTCTTC	CASSGTGFDNEQFF	TRBV7-9	TRBJ2-1
TGTGCCACCAGTGAGCCGGGACAGGGGAAGTATAATTCACCCCTCCACTTT	CATSEPGQGKYNSPLHF	TRBV24-1	TRBJ1-6
TGTGCCAGCACCCTACTAGTAGGCAATCAGCCCCAGCATTTT	CASTLLVGNQPQHF	TRBV11-2	TRBJ1-5
TGTGCCAGCAGTTTACCACTAGATACGGGGCCTACGACAGATACGCAGTATTTT	CASSLPLDTGPTTDTQYF	TRBV27	TRBJ2-3
TGTGCCAGCAGCGGGAGACAGGGGGCTCAGGGAAGTGAAAAACTGTTTTTT	CASSGRQGAQGSEKLFF	TRBV9	TRBJ1-4
TGTGCCAGCAGCCGTCACACGACCCCGGGACCCACATTCTTT	CASSRHTTPGPTFF	TRBV9	TRBJ1-1
TGTGCCAGCAGTGAAGCCGAGGGGGGCGGGGAGTATGGCTACACCTTC	CASSEAEGGGEYGYTF	TRBV6-1	TRBJ1-2
TGTGCCAGCAGTCCCGGGGGCACAGATACGCAGTATTTT	CASSPGGTDTQYF	TRBV6-1	TRBJ2-3
TGTGCCACTCGCGGGAGGTCTCTAAGCTCTGGGGCCAACGTCCTGACTTTC	CATRGRSLSSGANVLTF	TRBV24-1	TRBJ2-6
TGTGCCAGCAGCATCCGGCAGGCCTCTTGTCCAGCCTACGAGCAGTACTTC	CASSIRQASCPAYEQYF	TRBV5-8	TRBJ2-7
TGTGCCAGCAGTAGCGGGGCCAACGTCCTGACTTTC	CASSSGANVLTF	TRBV27	TRBJ2-6
TGTGCCTCGAATCCCGACAGGGTCAGTCTCGGTAATGAAAAACTGTTTTTT	CASNPDRVSLGNEKLFF	TRBV19	TRBJ1-4
TGTGCCGGGGTGGGGGAAATGGGCGGGCCCCAGCATTTT	CAGVGEMGGPQHF	TRBV10-3	TRBJ1-5
TGTGCCAGCAGTGCATTGCTGGGGCAAGGTCAGCCCCAGCATTTT	CASSALLGQGQPQHF	TRBV6-4	TRBJ1-5
TGTGCTAGTGGTTTGGTCGAACTAGCGGGGGCGGAGAGCAATGAGCAGTTCTTC	CASGLVELAGAESNEQFF	TRBV12-5	TRBJ2-1
TGCAGCGCACTAGCGGGAGTACGGTCTGGGGCCAACGTCCTGACTTTC	CSALAGVRSGANVLTF	TRBV29-1	TRBJ2-6
TGTGCCAGCAGTTTGACACCAGACAGGGGCCTGGGACCCTCGGGCAATCAGCCCCAGCATTTT	CASSLTPDRGLGPSGNQPQHF	TRBV12-3	TRBJ1-5
TGTGCCAGCAACCCGACTAGACACAATGAGCAGTTCTTC	CASNPTRHNEQFF	TRBV12-3	TRBJ2-1
TGTGCCAGCAGCCAGATTCTAGGGGAGAAGGAGCAGTACTTC	CASSQILGEKEQYF	TRBV7-9	TRBJ2-7
TGCAGTGCTCGGACTAGCGGGGATCATGAGCAGTTCTTC	CSARTSGDHEQFF	TRBV20-1	TRBJ2-1
TGTGCCAGTAGGGTGGCGGGACAGTACGAGCAGTACTTC	CASRVAGQYEQYF	TRBV19	TRBJ2-7
TGTGCCAGCAGCCCCAGCTACGAGCAGTACTTC	CASSPSYEQYF	TRBV5-5	TRBJ2-7
TGTGCCACGGGACGACTGGGACCGGAGAAGAGCTCCTACGAGCAGTACTTC	CATGRLGPEKSSYEQYF	TRBV12-4	TRBJ2-7
TGTGCCAGTAGTATATGGACAGGGGTGGGGTATGGCTACACCTTC	CASSIWTGVGYGYTF	TRBV19	TRBJ1-2
TGTGCCAGCAGCAGGTTGGACAGGTCCTACGAGCAGTACTTC	CASSRLDRSYEQYF	TRBV13	TRBJ2-7
TGCGCCAGCAGTGAGTCAAAAAAACTCCGGGACGGGCCCCGGTCTGAAGCTTTCTTT	CASSESKKLRDGPRSEAFF	TRBV10-1	TRBJ1-1
TGTGCCACCATTCCAAACTTGGAGGGCGAGCAGTACTTC	CATIPNLEGEQYF	TRBV6-1	TRBJ2-7
TGTGCCAGCAGCGAAGCGGGGACCGACTCCTACGAGCAGTACTTC	CASSEAGTDSYEQYF	TRBV9	TRBJ2-7
TGCGCCAGCCCCAGGACAGGGTCGAGGCCCCAGCATTTT	CASPRTGSRPQHF	TRBV5-1	TRBJ1-5
TGTGCCAGCAGTCAGAATGTAACCGGACACCTGGGGGTGACCTATAGGAGGGGCAATCAGCCCCAGCATTTT	CASSQNVTGHLGVTYRRGNQPQHF	TRBV12-3	TRBJ1-5
TGCGCCAGCAGTGAGTCGACCAGAGACGGGGAGCTGTTTTTT	CASSESTRDGELFF	TRBV10-2	TRBJ2-2
TGTGCCAGCCAGGGGGGTAGCAATCAGCCCCAGCATTTT	CASQGGSNQPQHF	TRBV14	TRBJ1-5
TGTGCCAGCAGTTTCCGGGAGCGGAAGGGTTACAATGAGCAGTTCTTC	CASSFRERKGYNEQFF	TRBV12-4	TRBJ2-1
TGCAGTGCTAGGGGGGACTGGGGGGCCCCCTACGAGCAGTACTTC	CSARGDWGAPYEQYF	TRBV20-1	TRBJ2-7
TGCAGTGCTAGAGAGGACAGGGCGGTCTATCAGCCCCAGCATTTT	CSAREDRAVYQPQHF	TRBV20-1	TRBJ1-5
TGTGCCAAATTTGACAGGGACGAGCAGTACTTC	CAKFDRDEQYF	TRBV27	TRBJ2-7
TGTGCCAGCTCCTTCCGAGACAGGCCCCTGAGCAATCAGCCCCAGCATTTT	CASSFRDRPLSNQPQHF	TRBV5-8	TRBJ1-5
TGTGCCAGCAGCAGGAGGGAGGTCCCCTACGAGCAGTACTTC	CASSRREVPYEQYF	TRBV13	TRBJ2-7
TGTGCTGAGGATTGGCGGGAGCCTCTCAGCACAGATACGCAGTATTTT	CAEDWREPLSTDTQYF	TRBV28	TRBJ2-3
TGTGCCAGCAGTTTCCCATCTAGGACCGAGCAGTACTTC	CASSFPSRTEQYF	TRBV28	TRBJ2-7
TGTGCCAGCAGCTTAGGGGGGGAGGGGGAGAACACTGAAGCTTTCTTT	CASSLGGEGENTEAFF	TRBV11-3	TRBJ1-1
TGTGCCACCAGCAGGAGGAGTTACAATGAGCAGTTCTTC	CATSRRSYNEQFF	TRBV15	TRBJ2-1
TGTGCCAGCAGCTTCAGACAGGGAAGGAATCAGCCCCAGCATTTT	CASSFRQGRNQPQHF	TRBV5-4	TRBJ1-5
TGTGCCAGCAGTTTACCCCCTGGGAAGGACACTGAAGCTTTCTTT	CASSLPPGKDTEAFF	TRBV27	TRBJ1-1
TGTGCCAGGGGGCCCTCACCCCTCCACTTT	CARGPSPLHF	TRBV10-3	TRBJ1-6
TGTGCCAGCAGAATTGGGGACAGGGAGGGCTACGAGCAGTACTTC	CASRIGDREGYEQYF	TRBV5-6	TRBJ2-7
TGTGCCAGCAGCCGGGGGGAGGGATCGGAGGGCAATACCTACAATGAGCAGTTCTTC	CASSRGEGSEGNTYNEQFF	TRBV7-2	TRBJ2-1
TGTGCCAGCAGGACAACGGGGGGGGGGTCTTTCTGGGCCCACGAGCAGTACTTC	CASRTTGGGSFWAHEQYF	TRBV7-2	TRBJ2-7
TGTGCCACCATTCGGACAGGGGGGGAATCGCGTTCACCCCTCCACTTT	CATIRTGGESRSPLHF	TRBV24-1	TRBJ1-6
TGTGCCAGCAGAAGGGGCGGGTCTGATCTGTATGAAGCTTTCTTT	CASRRGGSDLYEAFF	TRBV6-1	TRBJ1-1
TGTGCCAACGTTAAATGGGACGACACCGGGGAGCTGTTTTTT	CANVKWDDTGELFF	TRBV6-5	TRBJ2-2
TGTGCCAGCAGCTTATATCCGGGACAGGGGAGCACGGGCTACGAGCAGTACTTC	CASSLYPGQGSTGYEQYF	TRBV7-8	TRBJ2-7
TGCAGCGTTGAAGGCGGGACAGGGGCCGGGAAAGAGACCCAGTACTTC	CSVEGGTGAGKETQYF	TRBV29-1	TRBJ2-5
TGTGCCAGCAGTTTATGTCCGCCAAGTATGACTAGCGGGTACAATGAGCAGTTCTTC	CASSLCPPSMTSGYNEQFF	TRBV28	TRBJ2-1
TGTGCCAGCAGCTTGGTACTACCACCGGCTGGAAACACCATATATTTT	CASSLVLPPAGNTIYF	TRBV5-5	TRBJ1-3
TGTGCCATCAGTGAGTCGACGATAGGGCGCAATGAGCAGTTCTTC	CAISESTIGRNEQFF	TRBV10-3	TRBJ2-1
TGTGCCAGCAGCACAAGGCCCCCCCAGGAGGTAGAGGGAGGGGCATTTCAATTGCGTGATTTCGCTGAGCAGTTCTTC	CASSTRPPQEVEGGAFQLRDFAEQFF	TRBV12-3	TRBJ2-1
TGTGCCAGCTCACTCAGCCGGGACATGAGGCCCCAGCATTTT	CASSLSRDMRPQHF	TRBV18	TRBJ1-5
TGCAGTGCTCTACCCCCAACCTACGAGCAGTACTTC	CSALPPTYEQYF	TRBV20-1	TRBJ2-7
TGTGCCAGCAGTTTTCCCCAGCCATGGGGGACGAGTAATGGCTACACCTTC	CASSFPQPWGTSNGYTF	TRBV12-4	TRBJ1-2
TGTGCCAGCAGCGAAACAATGAAACTAGCGGGGGGGCCCCCCACCGGGGAGCTGTTTTTT	CASSETMKLAGGPPTGELFF	TRBV7-9	TRBJ2-2
TGCGCCAGCTGGTCTCGGGACAGGGGGAACTATGGCTACACCTTC	CASWSRDRGNYGYTF	TRBV10-1	TRBJ1-2
TGTGCCACCAGTGAACACTCCGCCCTCTGGGTGACATACGAGCAGTACTTC	CATSEHSALWVTYEQYF	TRBV24-1	TRBJ2-7
TGTGCCAGCAGCTTTCCGCGGGACAGGGGGCGATGGCTCTACGAGCAGTACTTC	CASSFPRDRGRWLYEQYF	TRBV28	TRBJ2-7
TGCAGCGTTAATGGGACAGGGGGAAGCTCCTACGAGCAGTACTTC	CSVNGTGGSSYEQYF	TRBV29-1	TRBJ2-7
TGTGCCAGCATCTACCAGGCAGGGATAGCTGAAGCTTTCTTT	CASIYQAGIAEAFF	TRBV6-4	TRBJ1-1
TGCGCCAGCAGCCAAAAGGTAAGGGACACCGGGGAGCTGTTTTTT	CASSQKVRDTGELFF	TRBV4-3	TRBJ2-2
TGTGCCAGCTCACCACCTCCTATTGTACTAGCGGGTGAGCAGTTCTTC	CASSPPPIVLAGEQFF	TRBV18	TRBJ2-1
TGCGCCAGCATTTGGGCAGGGGTTGGCTATGGCTACACCTTC	CASIWAGVGYGYTF	TRBV10-2	TRBJ1-2
TGTGCCAGCAGTGACAACCGGGACTCGTACTTC	CASSDNRDSYF	TRBV6-4	TRBJ2-7
TGTGCCAGCAGTATCATCCGACAGGGGGACTCTGGAAACACCATATATTTT	CASSIIRQGDSGNTIYF	TRBV27	TRBJ1-3
TGTGCCAGCAGCCAAAGGGGACAGAACACTGAAGCTTTCTTT	CASSQRGQNTEAFF	TRBV13	TRBJ1-1
TGTGCCAGCAGCTTTCAAACAGCCAGGACTGAAGCTTTCTTT	CASSFQTARTEAFF	TRBV7-9	TRBJ1-1
TGTGCCAGCAGGGACAGGGGCAGCAATCAGCCCCAGCATTTT	CASRDRGSNQPQHF	TRBV27	TRBJ1-5
TGTGCCAGCAGCCCAGGGAGAGATAGCAATCAGCCCCAGCATTTT	CASSPGRDSNQPQHF	TRBV5-5	TRBJ1-5
TGTGCCAGCAGCTCTATACTGGGACTAGCGGCCTACGAGCAGTACTTC	CASSSILGLAAYEQYF	TRBV7-9	TRBJ2-7
TGTGCCAGCAGTTGGCCTCTCCCAACCGGAGGATCGGGACAGGGGGGAAAGGGTAGCAATCAGCCCCAGCATTTT	CASSWPLPTGGSGQGGKGSNQPQHF	TRBV28	TRBJ1-5
TGTGCCAGCAGTGAAGGGCGGATGGCTATAGAAAAACTGTTTTTT	CASSEGRMAIEKLFF	TRBV6-4	TRBJ1-4
TGTGCCAGCAACCGTGGCAGTAGCAATCAGCCCCAGCATTTT	CASNRGSSNQPQHF	TRBV27	TRBJ1-5
TGTGCCAGCAGAGCACGGACTAGAGACCAGGTACCCTACGAGCAGTACTTC	CASRARTRDQVPYEQYF	TRBV6-2	TRBJ2-7
TGTGCCAGCAGTGAATGGGCCCTTATCTTC	CASSEWALIF	TRBV6-1	TRBJ2-5
TGTGCCACCAGCACGGTGTCCGGACAGGGTACCCCCAAGGGGTTCTCTGGAAACACCATATATTTT	CATSTVSGQGTPKGFSGNTIYF	TRBV15	TRBJ1-3
TGTGCCAGGGGACAGCTCTACGAGCAGTACTTC	CARGQLYEQYF	TRBV28	TRBJ2-7
TGCGCCAGCACCTCGGGACAGGGAGCTGACACTGAAGCTTTCTTT	CASTSGQGADTEAFF	TRBV10-1	TRBJ1-1
TGTGCCAGCTCACCACCTCAGTGTGGGACAGGGGGTGGGGACAATGAGCAGTTCTTC	CASSPPQCGTGGGDNEQFF	TRBV18	TRBJ2-1
TGCAGTGGGGTTTCCTCGCGACTCGGGAGCTCCTACGAGCAGTACTTC	CSGVSSRLGSSYEQYF	TRBV20-1	TRBJ2-7
TGTGCCATCAGGGGAGGACAGGGCTCCGGGGAGCTGTTTTTT	CAIRGGQGSGELFF	TRBV10-3	TRBJ2-2
TGTGCCACCAGCAGTTTAGAGGGGGGCCCCTCAGGTTCAAGAAGGTACGAGCAGTACTTC	CATSSLEGGPSGSRRYEQYF	TRBV15	TRBJ2-7
TGTGCCAGCAGTTACATGAGGGTAGGTTCACCCCTCCACTTT	CASSYMRVGSPLHF	TRBV6-6	TRBJ1-6
TGTGCCAGCAGTTTAAGCAGGGGGGGGGGGAGCGGAGCTGAAGCTTTCTTT	CASSLSRGGGSGAEAFF	TRBV28	TRBJ1-1
TGTGCCAGCAGCCAAGAAACCGCGTATCCCGAAATCAATGAGCAGTTCTTC	CASSQETAYPEINEQFF	TRBV4-2	TRBJ2-1
TGTGCCAGCAGCGGAAGTGTAGCGGGGTATGCCAAAAACATTCAGTACTTC	CASSGSVAGYAKNIQYF	TRBV6-5	TRBJ2-4
TGTGCCAGCAGCGGGACATACAATGAGCAGTTCTTC	CASSGTYNEQFF	TRBV7-6	TRBJ2-1
TGTGCCAGACGGGGGGACGAGCAGTACTTC	CARRGDEQYF	TRBV7-9	TRBJ2-7
TGTGCCAGCAGCTTTGGAGGCACAGATACGCAGTATTTT	CASSFGGTDTQYF	TRBV5-6	TRBJ2-3
TGCAGTGCTAGAGACCCTAGCCCAGATACGCAGTATTTT	CSARDPSPDTQYF	TRBV20-1	TRBJ2-3
TGTGCCAGCAGCCCTAGCGGGACCGGGGAGCTGTTTTTT	CASSPSGTGELFF	TRBV13	TRBJ2-2
TGTGCCAGCAGTGAACAGGGGACCTGGTCCTACGAGCAGTACTTC	CASSEQGTWSYEQYF	TRBV6-1	TRBJ2-7
TGTGCCAGCAGTTACTCGGGCCGGACAGGTTACAATGAGCAGTTCTTC	CASSYSGRTGYNEQFF	TRBV6-5	TRBJ2-1
TGTGCCAGCAGCCCCCCCCGGGACAGGGGAGAAGGTTCTTTCTTT	CASSPPRDRGEGSFF	TRBV13	TRBJ1-1
TGTGCCAGCAACCGGAGATCAACCGGGGAGCTGTTTTTT	CASNRRSTGELFF	TRBV25-1	TRBJ2-2
TGCAGCGTAGAGCTGGCGAGATATCTACTCGAGACCCAGTACTTC	CSVELARYLLETQYF	TRBV29-1	TRBJ2-5
TGCGCCAGCAGCTTGGACGGGGGGGGTAATGAAAAACTGTTTTTT	CASSLDGGGNEKLFF	TRBV5-1	TRBJ1-4
TGCCAGGCCGATCCGGGACAGGGGGCGGTTTTTGACTCTGGAAACACCATATATTTT	CQADPGQGAVFDSGNTIYF	TRBV18	TRBJ1-3
TGTGCCAGCAGCGGGTTGCCGAGACAAGAGACCCAGTACTTC	CASSGLPRQETQYF	TRBV11-2	TRBJ2-5
TGTGCCACCAGCAGAGAAGGGCACGTTTCAGTTGAGACCCAGTACTTC	CATSREGHVSVETQYF	TRBV15	TRBJ2-5
TGTGCCAGCAGTGAAGTTGGGGGGGCGGGCAATCAGCCCCAGCATTTT	CASSEVGGAGNQPQHF	TRBV6-4	TRBJ1-5
TGTGCCAGCAGTTACTCGAAATCGGGGGCCGAGCAGTACTTC	CASSYSKSGAEQYF	TRBV6-5	TRBJ2-7
TGTGCCATCAGTGCCCGGACAGGAAACGAGCAGTACTTC	CAISARTGNEQYF	TRBV10-3	TRBJ2-7
TGTGCCAGCAGCCTACTTCAGTTATATAGCAATCAGCCCCAGCATTTT	CASSLLQLYSNQPQHF	TRBV9	TRBJ1-5
TGTGCCAGCAACTCACTGAGGGGGAATCAGCCCCAGCATTTT	CASNSLRGNQPQHF	TRBV6-1	TRBJ1-5
TGTGCCAGCAGTTCTCTGGCCCCCGGGACAGAGAGCTCTGGAAACACCATATATTTT	CASSSLAPGTESSGNTIYF	TRBV6-5	TRBJ1-3
TGTGCCAGCAGCCCGCGCCGGGGGGCAGATACGCAGTATTTT	CASSPRRGADTQYF	TRBV5-4	TRBJ2-3
TGTGCCAGCAGATCCGGGGGCCTCTTTAGCTCCTACGAGCAGTACTTC	CASRSGGLFSSYEQYF	TRBV6-2	TRBJ2-7
TGTGCCAGCAAGATTTCGAACAACCAGCCTATGTGGGGGTTTAGAAACACCATATATTTT	CASKISNNQPMWGFRNTIYF	TRBV5-6	TRBJ1-3
TGTGCCAGGGGGTCCACCTACGAGCAGTACTTC	CARGSTYEQYF	TRBV6-4	TRBJ2-7
TGTGCCAGCAGTTGTGGTCTAGACAGTCACGAGCAGTACTTC	CASSCGLDSHEQYF	TRBV6-5	TRBJ2-7
TGCGCCAGCAGCGTTGGGACCTACGAGCAGTACTTC	CASSVGTYEQYF	TRBV5-1	TRBJ2-7
TGCAGTGGAAGGCGACAGGGCTATCAGCCCCAGCATTTT	CSGRRQGYQPQHF	TRBV20-1	TRBJ1-5
TGTGCCAGCTCACCATGTAGGGGACAGATAACAAGTGGCTACACCTTC	CASSPCRGQITSGYTF	TRBV18	TRBJ1-2
TGTGCCAGCAGCAGCGGCAGGGAATTCACTGAAGCTTTCTTT	CASSSGREFTEAFF	TRBV13	TRBJ1-1
TGTGCCAGCAGTGGAAGGGCCTACAATGAGCAGTTCTTC	CASSGRAYNEQFF	TRBV6-1	TRBJ2-1
TGTGCCAGCAGCTTGAGAGACCATTTGAGGCTGGAGCAGTACTTC	CASSLRDHLRLEQYF	TRBV5-5	TRBJ2-7
TGTGCCTGGAGTGTAGCGGGAGAGTCCAGCTCCTACAATGAGCAGTTCTTC	CAWSVAGESSSYNEQFF	TRBV30	TRBJ2-1
TGTGCCACCGGTTCCCCACCGAAGTGGGGGGGGAGCACGTGGTTCTACAATGAGCAGTTCTTC	CATGSPPKWGGSTWFYNEQFF	TRBV24-1	TRBJ2-1
TGTGCCAGCAGCTGTAGCAGGACAGATACGCAGTATTTT	CASSCSRTDTQYF	TRBV7-9	TRBJ2-3
TGTGCCAGCAGCATAAACGCAGATACGCAGTATTTT	CASSINADTQYF	TRBV3-1	TRBJ2-3
TGTGCCAGATCAACGAGGTGCCGCTACGAGCAGTACTTC	CARSTRCRYEQYF	TRBV7-3	TRBJ2-7
TGTGCCAGCAGCCCAGGCTACGAGCAGTACTTC	CASSPGYEQYF	TRBV9	TRBJ2-7
TGCGCCAGCAGCCAAGATGGAGACAGGGACAGCGCCGGGGAGCTGTTTTTT	CASSQDGDRDSAGELFF	TRBV4-3	TRBJ2-2
TGTGCCAGCAGCTTAGTTAGCGGGGGAGAGCAGTACTTC	CASSLVSGGEQYF	TRBV7-6	TRBJ2-7
TGTGCCAGCAGTTGCGTTTATTCGGGGGCATGTGGAAGCAATCAGCCCCAGCATTTT	CASSCVYSGACGSNQPQHF	TRBV6-4	TRBJ1-5
TGTGCCATCAGTGAGTCGAGTCCCCCTCCACTATACAGGGGGCCCCATTGGCAGCCCCAGCATTTT	CAISESSPPPLYRGPHWQPQHF	TRBV10-3	TRBJ1-5
TGTGCCACCAGTGATTTGCATGCGGACAGGGGGGCTGAGTCCGATTCACCCCTCCACTTT	CATSDLHADRGAESDSPLHF	TRBV24-1	TRBJ1-6
TGTGCCAGCAGCCGTGGACAAGGCGGGGGTTTTGAGCAGTACTTC	CASSRGQGGGFEQYF	TRBV12-3	TRBJ2-7
TGTGCCAGCAGCGGGGGCGACAACACTGAAGCTTTCTTT	CASSGGDNTEAFF	TRBV2	TRBJ1-1
TGTGCCAGCACTGAAGTCCCGACAGGGGGGCTTGAAGCTTTCTTT	CASTEVPTGGLEAFF	TRBV13	TRBJ1-1
TGTGCCAGCAGTTTGGAAAGAGTACCCATCTCCTACGAGCAGTACTTC	CASSLERVPISYEQYF	TRBV12-3	TRBJ2-7
TGTGCCAGCATGGACCCCACACACACTGAAGCTTTCTTT	CASMDPTHTEAFF	TRBV9	TRBJ1-1
TGTGCCAGCAGCTTAGTTGCAGGGGGGACTGAAGCTTTCTTT	CASSLVAGGTEAFF	TRBV7-9	TRBJ1-1
TGTGCCAGCAGCTTCCTGGGACAGGGGCCAACTGGGGCCAACGTCCTGACTTTC	CASSFLGQGPTGANVLTF	TRBV7-7	TRBJ2-6
TGTGCCAGCAAACTTTCCCCCCGGGGTGGGTTCAATCAGCCCCAGCATTTT	CASKLSPRGGFNQPQHF	TRBV2	TRBJ1-5
TGTGCCAGCAGCAGGAACGGGGGCCCGACAGGGGGGGGGACAAGCAATCAGCCCCAGCATTTT	CASSRNGGPTGGGTSNQPQHF	TRBV13	TRBJ1-5
TGTGCTAGTGGTAAGCGACAGACAGGGTACGAGCAGTACTTC	CASGKRQTGYEQYF	TRBV12-5	TRBJ2-7
TGCGCCAGCAGTGGGGACAGGACTAATGAAAAACTGTTTTTT	CASSGDRTNEKLFF	TRBV10-1	TRBJ1-4
TGTGCCAGCAGTACCGGACTAGCGGGAGTGCATACGCAGTATTTT	CASSTGLAGVHTQYF	TRBV6-1	TRBJ2-3
TGCGCCAGCAGCTTTAAAGGCGGAAAGATTCGACACAATCAGCCCCAGCATTTT	CASSFKGGKIRHNQPQHF	TRBV5-1	TRBJ1-5
TGTGCCAGCAGCTTAGCCGAGAGGGGTAACAATGAGCAGTTCTTC	CASSLAERGNNEQFF	TRBV7-6	TRBJ2-1
TGTGCCAGCAGCGCGGTTTACGAGCAGTACTTC	CASSAVYEQYF	TRBV11-1	TRBJ2-7
TGTGCCAGCAGTGGCGGTGGGGGACAGGGCTCCTACGAGCAGTACTTC	CASSGGGGQGSYEQYF	TRBV6-1	TRBJ2-7
TGTGCCAGCAGAAATAAGAACGGGACAGGGGTCTGTTTAGAGACCCAGTACTTC	CASRNKNGTGVCLETQYF	TRBV12-4	TRBJ2-5
TGTGCCAGCAGCGTATTCCTGAAAGAGACCCAGTACTTC	CASSVFLKETQYF	TRBV13	TRBJ2-5
TGTGCCAGCAGCGTAGGGGGGGATAATTCACCCCTCCACTTT	CASSVGGDNSPLHF	TRBV9	TRBJ1-6
TGCGCCAGCCTCCCCAGGTTGCCACCCACTGAAGCTTTCTTT	CASLPRLPPTEAFF	TRBV10-2	TRBJ1-1
TGTGCCAGCAGACCACTTTCTGGAAACACCATATATTTT	CASRPLSGNTIYF	TRBV27	TRBJ1-3
TGTGCCAGCAGTGAGTTACGGGCTAATACCCCAGGGTCTGGGGCCAACGTCCTGACTTTC	CASSELRANTPGSGANVLTF	TRBV6-4	TRBJ2-6
TGTGCCAGCAGCGGGGCAGCGGACGAGCAGTACTTC	CASSGAADEQYF	TRBV9	TRBJ2-7
TGTGCCGAAGAAGGGATCAAAAACATTCAGTACTTC	CAEEGIKNIQYF	TRBV10-3	TRBJ2-4
TGCAGTGCCGAGGGGCAGTACTTC	CSAEGQYF	TRBV20-1	TRBJ2-7
TGTGCCAGCAGTGAACCCCTCCCTCTTGGGCCGATGGGTCGTGACAATGAGCAGTTCTTC	CASSEPLPLGPMGRDNEQFF	TRBV6-1	TRBJ2-1
TGTGCCAGCAGCACGGACGTCTCCTATAATTCACCCCTCCACTTT	CASSTDVSYNSPLHF	TRBV6-1	TRBJ1-6
TGTGCCAGCAGTAGGTGCCCGGGAGGAGGCACTGAAGCTTTCTTT	CASSRCPGGGTEAFF	TRBV28	TRBJ1-1
TGTGCCAGCTCACCTGAGATACGCGGGAGTCGGAACACTGAAGCTTTCTTT	CASSPEIRGSRNTEAFF	TRBV18	TRBJ1-1
TGTGCCAGCAGCAGTAGGACAGGCTCTGGAAACACCATATATTTT	CASSSRTGSGNTIYF	TRBV7-3	TRBJ1-3
TGTGCCAGCAGCTTCCTTGGACAGGGAGAGGCAGCCAAAAACATTCAGTACTTC	CASSFLGQGEAAKNIQYF	TRBV5-6	TRBJ2-4
TGCAGTGCTCCTTTTCCTAGGGGGGTCTACGAGCAGTACTTC	CSAPFPRGVYEQYF	TRBV20-1	TRBJ2-7
TGTGCCAGCAGCTGGCCGGGACAGGGCTACGAGCAGTACTTC	CASSWPGQGYEQYF	TRBV7-3	TRBJ2-7
TGTGCCAGCAGCCGCAGGGGGGGGCACACCGGGGAGCTGTTTTTT	CASSRRGGHTGELFF	TRBV4-2	TRBJ2-2
TGTGCCAGCAGCGTAGGGGGGGGTTTCAGCTCCTACAATGAGCAGTTCTTC	CASSVGGGFSSYNEQFF	TRBV9	TRBJ2-1
TGTGCCAGCAGTAATCCCCCCCCAGGCACCGAAGGCTCCTACGAGCAGTACTTC	CASSNPPPGTEGSYEQYF	TRBV27	TRBJ2-7
TGTGCCAGCAGCACCCGACCCGACGGGCCATACAATGAGCAGTTCTTC	CASSTRPDGPYNEQFF	TRBV11-3	TRBJ2-1
TGTGCCAGCAGCCAAAACGACTATGGCTACACCTTC	CASSQNDYGYTF	TRBV3-1	TRBJ1-2
TGTGCCAGCAGCAAAGCGGGCTCCTACAATGAGCAGTTCTTC	CASSKAGSYNEQFF	TRBV7-8	TRBJ2-1
TGTGCCAGCAGAACGAGGGGGGCCGAAAGGAATGAGCAGTTCTTC	CASRTRGAERNEQFF	TRBV5-4	TRBJ2-1
TGTGCCAGCAGTGGCGACAGGGCGGGGTCTAGCAATCAGCCCCAGCATTTT	CASSGDRAGSSNQPQHF	TRBV2	TRBJ1-5
TGTGCCAGTAGTATGGGTGGGGGGCAAGAGACCCAGTACTTC	CASSMGGGQETQYF	TRBV19	TRBJ2-5
TGTGCCAGCAGGGCGGGAGCAGTCGGGGAGAGGGGCGATGAGCAGTTCTTC	CASRAGAVGERGDEQFF	TRBV6-1	TRBJ2-1
TGCGCCAGCAGCTTGGCCCTTAAGGATACGCAGTATTTT	CASSLALKDTQYF	TRBV5-1	TRBJ2-3
TGCGCCAGCAGCTTGGTCTGGGCCCCCACCAGCTCCTACAATGAGCAGTTCTTC	CASSLVWAPTSSYNEQFF	TRBV5-1	TRBJ2-1
TGTGCCAGCAGCTTAGGCCCGGAAGACACCATATATTTT	CASSLGPEDTIYF	TRBV11-3	TRBJ1-3
TGTGCCTGGAGTCGGTGGACAGGGGGGGTCGCCAAAAACATTCAGTACTTC	CAWSRWTGGVAKNIQYF	TRBV30	TRBJ2-4
TGTGCCAGCCTCTGGTCGACAGGGCCCTATGGCTACACCTTC	CASLWSTGPYGYTF	TRBV2	TRBJ1-2
TGTGCCAGCAGCTCCCGGGGCTCTGGAAACACCATATATTTT	CASSSRGSGNTIYF	TRBV2	TRBJ1-3
TGTGCCAGTAGTATGTCGATCCCGACAGGTTATGGCTACACCTTC	CASSMSIPTGYGYTF	TRBV19	TRBJ1-2
TGTGCTAGTGGTTACGGGACAGGGCTCCCGGGCTCCTACGAGCAGTACTTC	CASGYGTGLPGSYEQYF	TRBV12-5	TRBJ2-7
TGTGCCGGGGTCGGAGACTACGAGCAGTACTTC	CAGVGDYEQYF	TRBV9	TRBJ2-7
TGCGCCAGCAGCCAAGACAAATGGGGACTAGCGGCGAACACCGGGGAGCTGTTTTTT	CASSQDKWGLAANTGELFF	TRBV4-1	TRBJ2-2
TGTGCCAGCAGCCAAGAGGGACCAGGCTACGAGCAGTACTTC	CASSQEGPGYEQYF	TRBV3-1	TRBJ2-7
TGTGCCAGCAGCTTAGTAACAGGGGGTACCCAGTACTTC	CASSLVTGGTQYF	TRBV7-3	TRBJ2-5
TGTGCCAGCAGTTTACCGCGGGAGCGGGCTGAAGCTTTCTTT	CASSLPRERAEAFF	TRBV6-1	TRBJ1-1
TGCGCCAGCAACAGGGAACCCGCCGGCCCCCGGGACTACGAGCAGTACTTC	CASNREPAGPRDYEQYF	TRBV5-1	TRBJ2-7
TGTGCCAGCAGCAGCGCAAGCTATGGCTACACCTTC	CASSSASYGYTF	TRBV7-9	TRBJ1-2
TGCGCCAGCAGCCAAGATAGGGGAGGGGGCTACACCTTC	CASSQDRGGGYTF	TRBV4-3	TRBJ1-2
TGTGCCAGCAGTGAAAACGGGCCGGGTTGCAATGAGCAGTTCTTC	CASSENGPGCNEQFF	TRBV25-1	TRBJ2-1
TGCAGTGCTGTCGACAGGACAAATGAGCAGTTCTTC	CSAVDRTNEQFF	TRBV20-1	TRBJ2-1
TGCAGCGGGCAGCGGACATATGATACGCAGTATTTT	CSGQRTYDTQYF	TRBV29-1	TRBJ2-3
TGCAGTGCTAGCCCGGGCCTAGTTGAAAAACTGTTTTTT	CSASPGLVEKLFF	TRBV20-1	TRBJ1-4
TGTGCCAGCAGCACTTTAGGGGCGGCAGATACGCAGTATTTT	CASSTLGAADTQYF	TRBV7-2	TRBJ2-3
TGTGCCGAAACCCGGGACGAACGCAAGGCCAATGAGCAGTTCTTC	CAETRDERKANEQFF	TRBV24-1	TRBJ2-1
TGTGCCAGCAGAGATCTGCCCCAAGGGAGGACAGGGGGAAATCAGCCCCAGCATTTT	CASRDLPQGRTGGNQPQHF	TRBV11-3	TRBJ1-5
TGTGCCAGCAGCCCCAATTGGTTTGGGTCCCGACTTTTCGCTAGCACAGATACGCAGTATTTT	CASSPNWFGSRLFASTDTQYF	TRBV7-3	TRBJ2-3
TGTGCCAGCAGTCTATCTGTAATGGGTGGAAACACCATATATTTT	CASSLSVMGGNTIYF	TRBV27	TRBJ1-3
TGTGCCAGCCCCTCCCCAATCCACAGGGGGAATCAGCCCCAGCATTTT	CASPSPIHRGNQPQHF	TRBV5-6	TRBJ1-5
TGCAGTGCTAGAGCTCCAGGGAAGAACACTGAAGCTTTCTTT	CSARAPGKNTEAFF	TRBV20-1	TRBJ1-1
TGCAGCGTTGAACCCCGGAGCATTCTCCAAGAGACCCAGTACTTC	CSVEPRSILQETQYF	TRBV29-1	TRBJ2-5
TGTGCCAGCAGCGTCCTAGAAACTAGCACAGATACGCAGTATTTT	CASSVLETSTDTQYF	TRBV11-3	TRBJ2-3
TGTGCCAGCAGCGCGGGACAGGGGCAGCCCCAGCATTTT	CASSAGQGQPQHF	TRBV6-4	TRBJ1-5
TGCAGTGCATTCCACGAGACCCAGTACTTC	CSAFHETQYF	TRBV20-1	TRBJ2-5
TGTGCCAGCAGCCCGGGCCAGTTAGCGATAAGCTCCTACGAGCAGTACTTC	CASSPGQLAISSYEQYF	TRBV7-6	TRBJ2-7
TGCAATGACAGTAGGGAGGAGCCCCAGCATTTT	CNDSREEPQHF	TRBV29-1	TRBJ1-5
TGTGCTAGTGGTCCCATGGAGGGGGAGGGGATGAATCAGCCCCAGCATTTT	CASGPMEGEGMNQPQHF	TRBV12-5	TRBJ1-5
TGCAGTGCTAGAGATTTCCCCAATAGGGGGGGGACCATTCAGTACTTC	CSARDFPNRGGTIQYF	TRBV20-1	TRBJ2-4
TGTGCCAGCAGTTTCCCAGGGGGGTATGGCTACACCTTC	CASSFPGGYGYTF	TRBV6-5	TRBJ1-2
TGTGCCAGCAGCGGCAAGGGGGCGCAAAGAGCCGACACTGAAGCTTTCTTT	CASSGKGAQRADTEAFF	TRBV6-2	TRBJ1-1
TGTGCCAGCAGTTGGGTTTCAGAATTCGACAGGAGCTTTTATGGCTACACCTTC	CASSWVSEFDRSFYGYTF	TRBV6-2	TRBJ1-2
TGCGCCAGCAGTTCGAAGCGAGAGACCCAGTACTTC	CASSSKRETQYF	TRBV5-1	TRBJ2-5
TGTGCCAGCAGACGGCTGCCGGACAGGAGTTATAGCAATCAGCCCCAGCATTTT	CASRRLPDRSYSNQPQHF	TRBV6-4	TRBJ1-5
TGTGCCTGGATTCCCGGGGGCGCAGGAAAGCCCCAGCATTTT	CAWIPGGAGKPQHF	TRBV30	TRBJ1-5
TGTGCCAGCAGTGAAATAACAGGGAAGACGGGGAACACTGAAGCTTTCTTT	CASSEITGKTGNTEAFF	TRBV6-1	TRBJ1-1
TGTGCCAGCAGCCGCGATAACCGGGACAGTTACCTCGAGCAGTACTTC	CASSRDNRDSYLEQYF	TRBV7-9	TRBJ2-7
TGCGCCAGCTCACGGGTAAAGGAGGAAGCTTTCTTT	CASSRVKEEAFF	TRBV4-3	TRBJ1-1
TGTGTTTCCCGTTTCCCCGAAGACAGGTTTGATACGCAGTATTTT	CVSRFPEDRFDTQYF	TRBV4-2	TRBJ2-3
TGCGCCAGCAGCATCCCAGGGGGAAATGAGCAGTTCTTC	CASSIPGGNEQFF	TRBV5-1	TRBJ2-1
TGTGCCAGCAGCTTGGACATTGGGACAGCGACTTATAGCAATCAGCCCCAGCATTTT	CASSLDIGTATYSNQPQHF	TRBV5-6	TRBJ1-5
TGTGCTAGCAGCTTATATGTCCCGGATGAGGGCGTACCCCGTAGGGATACGCAGTATTTT	CASSLYVPDEGVPRRDTQYF	TRBV7-7	TRBJ2-3
TGTGCCATCAGTGAGTCATCAGTCACGGGGGGGACCCCCACTAATGAAAAACTGTTTTTT	CAISESSVTGGTPTNEKLFF	TRBV10-3	TRBJ1-4
TGTGCCAACCAGGGGCCTCACACTGAAGCTTTCTTT	CANQGPHTEAFF	TRBV6-4	TRBJ1-1
TGTGCCATCAGTATCCCCGCAGATACGCAGTATTTT	CAISIPADTQYF	TRBV10-3	TRBJ2-3
TGTGCCAAGGATAACCTCCCGAACACCGGGGAGCTGTTTTTT	CAKDNLPNTGELFF	TRBV28	TRBJ2-2
TGCGCCAGCAGTGTGATAAAAGGGCTCTCCTACGAGCAGTACTTC	CASSVIKGLSYEQYF	TRBV10-1	TRBJ2-7
TGTGCCACCAGTGAGACCGGGAGGAACACTGAAGCTTTCTTT	CATSETGRNTEAFF	TRBV24-1	TRBJ1-1
TGTGCCAGCAGCTTAAGAGGACTAGCGGGGGAAGAGACCCAGTACTTC	CASSLRGLAGEETQYF	TRBV7-2	TRBJ2-5
TGTGCCATAGACACCTCCCCCGACAGGGGTTGCATGAACACTGAAGCTTTCTTT	CAIDTSPDRGCMNTEAFF	TRBV10-3	TRBJ1-1
TGTGCCTGGAGTGTAAAGGGCAGGACAGGGTTTTCGACTGAAGCTTTCTTT	CAWSVKGRTGFSTEAFF	TRBV30	TRBJ1-1
TGTGCCAGCAGCGCCAGCGGGGACTCTGGGGCCAACGTCCTGACTTTC	CASSASGDSGANVLTF	TRBV7-3	TRBJ2-6
TGTGCCAGCAGCCTAAAGACAGGGGGCTTGTACGAGCAGTACTTC	CASSLKTGGLYEQYF	TRBV7-9	TRBJ2-7
TGTGCCACCGCCCTTATCCGGAACTATGGCTACACCTTC	CATALIRNYGYTF	TRBV24-1	TRBJ1-2
TGCAGCGGATCTGACAGGTTGGCCTACGAGCAGTACTTC	CSGSDRLAYEQYF	TRBV29-1	TRBJ2-7
TGTGCCAGCAGTAGCCGTACCGGGGAGCTGTTTTTT	CASSSRTGELFF	TRBV6-1	TRBJ2-2
TGTGCCAGCAGTTACCGGGTCAGTACCCCCAGGTACGAGCAGTACTTC	CASSYRVSTPRYEQYF	TRBV6-5	TRBJ2-7
TGTGCCAGCAGCCAAGACCCAACCGGGGGGGGCTCCTACGAGCAGTACTTC	CASSQDPTGGGSYEQYF	TRBV14	TRBJ2-7
TGCGCCAGCAGCTTGCTAGGGCAAGATGAGCAGTTCTTC	CASSLLGQDEQFF	TRBV5-1	TRBJ2-1
TGTGCCAGCAGCGGCGGGTCGGGACAGCAAATATATTTT	CASSGGSGQQIYF	TRBV9	TRBJ1-3
TGTGCCAGTAGTATAACACAGTGGGAGACCCAGTACTTC	CASSITQWETQYF	TRBV19	TRBJ2-5
TGTGCCAGCAGTGAACTAGACGAGCAGTACTTC	CASSELDEQYF	TRBV12-3	TRBJ2-7
TGTGCCAGCTCACCGCTGACAGGGGCATACGAGCAGTACTTC	CASSPLTGAYEQYF	TRBV18	TRBJ2-7
TGTGCCAGCTCACCGAACATGGGGACATGGGGGACCCAGTACTTC	CASSPNMGTWGTQYF	TRBV18	TRBJ2-5
TGTGCCAGCTCACCGTCCGGGACAGGCTCCTACGAGCAGTACTTC	CASSPSGTGSYEQYF	TRBV18	TRBJ2-7
TGTGCCAGCACTGTTTGGGACAGGGCCGGAAACACCATATATTTT	CASTVWDRAGNTIYF	TRBV6-4	TRBJ1-3
TGTGCCAGCAGTTACACCGGGGCTAGCTACGAGCAGTACTTC	CASSYTGASYEQYF	TRBV6-5	TRBJ2-7
TGTGCCAGCAGCTTAGGAAACAGGGGACTCGAGCAGTACTTC	CASSLGNRGLEQYF	TRBV11-2	TRBJ2-7
TGTGCCACCAGCAGATCGCGAGGGTCTGGAAACACCATATATTTT	CATSRSRGSGNTIYF	TRBV15	TRBJ1-3
TGTGCCAGCAGCTTTCTTTGGGGTGACAGGGGGCCGGGGTATGAGCAGTTCTTC	CASSFLWGDRGPGYEQFF	TRBV11-2	TRBJ2-1
TGTGCCAGCAGCTTACTGAGGCCAGGGCGAGAAGCTTTCTTT	CASSLLRPGREAFF	TRBV7-8	TRBJ1-1
TGTGCCAGCAGAGCCCCACGACAGGGGGCGGGCAATCAGCCCCAGCATTTT	CASRAPRQGAGNQPQHF	TRBV27	TRBJ1-5
TGCAGTGCAACGGAGGCCTATAGGGGGAGCTATGGCTACACCTTC	CSATEAYRGSYGYTF	TRBV20-1	TRBJ1-2
TGTGCCAGCAGTGAGGGACAGGGGAGCAATCAGCCCCAGCATTTT	CASSEGQGSNQPQHF	TRBV6-4	TRBJ1-5
TGCAGTGCTAGGGGAGGCGTTGAGCAGTACTTC	CSARGGVEQYF	TRBV20-1	TRBJ2-7
TGTGCCAGCAGCCTGCGCATTGGAGTCTCTGGAAACACCATATATTTT	CASSLRIGVSGNTIYF	TRBV7-9	TRBJ1-3
TGTGCCAGCAGCACGGGTGCTGGGGATGTAGGCTCCTACGAGCAGTACTTC	CASSTGAGDVGSYEQYF	TRBV7-4	TRBJ2-7
TGTGCCACCAGTGAAGTACTCAGGGAAACTAACTATGGCTACACCTTC	CATSEVLRETNYGYTF	TRBV24-1	TRBJ1-2
TGTGCCACCAGTGATTCCCCAACTCCAACCTGGAGGAACATTCAGTACTTC	CATSDSPTPTWRNIQYF	TRBV24-1	TRBJ2-4
TGTGCCAGCAGCGTATCCAGGGGAGTAGAGCACGAGCAGTACTTC	CASSVSRGVEHEQYF	TRBV9	TRBJ2-7
TGTGCCAGCAGCGAACATCCTAGCGGTGCTAACACCGGGGAGCTGTTTTTT	CASSEHPSGANTGELFF	TRBV7-9	TRBJ2-2
TGTGCCAGCAGCCAAGCCGGGGATGCAACTAATGAAAAACTGTTTTTT	CASSQAGDATNEKLFF	TRBV14	TRBJ1-4
TGTGCCAGCAGCTTACAACCCCAGGGAACCTACGAGCAGTACTTC	CASSLQPQGTYEQYF	TRBV7-3	TRBJ2-7
TGTGCCAGCAGTTTATACTCCATAGGCACAGATACGCAGTATTTT	CASSLYSIGTDTQYF	TRBV27	TRBJ2-3
TGTGCCAGCAGCTGGCTTGCCGGGGAGCTGTTTTTT	CASSWLAGELFF	TRBV27	TRBJ2-2
TGCAGCGTTGTACGGCGGAGGGGTTGCTATGGCTACACCTTC	CSVVRRRGCYGYTF	TRBV29-1	TRBJ1-2
TGTGCCAGTAGTATTAGGACAGGGGCTTTCTTT	CASSIRTGAFF	TRBV19	TRBJ1-1
TGCAGTGCCATAGAAGAGACCCAGTACTTC	CSAIEETQYF	TRBV20-1	TRBJ2-5
TGTGCCAGCAGCTTACCTATGGTCGATACTGTACGGGGATTAACCGGGGAGCTGTTTTTT	CASSLPMVDTVRGLTGELFF	TRBV7-7	TRBJ2-2
TGTGCCAGCAGACCGGCGTGTTCGTTCACTGAAGCTTTCTTT	CASRPACSFTEAFF	TRBV6-5	TRBJ1-1
TGTGCCAGTCCTAGCGGGGTGCAAGAGACCCAGTACTTC	CASPSGVQETQYF	TRBV19	TRBJ2-5
TGCGCCAGCAGCTTGGGACCTAGATTGATTTGGTACAATGAGCAGTTCTTC	CASSLGPRLIWYNEQFF	TRBV5-1	TRBJ2-1
TGTGCCAGCGTTTCCTCGCCGGGACAGGGTGGGTGGTTTTCCTACGAGCAGTACTTC	CASVSSPGQGGWFSYEQYF	TRBV6-5	TRBJ2-7
TGTGCCAGCAGCCAAGAGCCGACAGGGTGGGATCAGCCCCAGCATTTT	CASSQEPTGWDQPQHF	TRBV14	TRBJ1-5
TGTGCCAGCAGTGATTCCGGACAGGCCGGACAAGAGACCCAGTACTTC	CASSDSGQAGQETQYF	TRBV6-4	TRBJ2-5
TGTGCCAGCAGCCAAGTCGACAGGGTCAGAAGCAATCAGCCCCAGCATTTT	CASSQVDRVRSNQPQHF	TRBV4-2	TRBJ1-5
TGTGCCAGTACTGCGGACCCATCAGATACGCAGTATTTT	CASTADPSDTQYF	TRBV19	TRBJ2-3
TGTGCCTGCAGCGACCGCTCCTACGAGCAGTACTTC	CACSDRSYEQYF	TRBV6-4	TRBJ2-7
TGTGCCAGCAGCGGACCTCGAATGCAGGGTTGCAATTCACCCCTCCACTTT	CASSGPRMQGCNSPLHF	TRBV9	TRBJ1-6
TGTGCCAGCAGCGGTACTGAGCAGTTCTTC	CASSGTEQFF	TRBV14	TRBJ2-1
TGTGCCAGCGTAAGGGGGTGCATCCAAGAGACCCAGTACTTC	CASVRGCIQETQYF	TRBV6-5	TRBJ2-5
TGTGCCAGCAGCCAAGTCATCGAAATCCATGATGGGACCCAAAGCACAGATACGCAGTATTTT	CASSQVIEIHDGTQSTDTQYF	TRBV3-1	TRBJ2-3
TGTGCCAGCAGCTTAGCCCAGGGACCTAACACCGGGGAGCTGTTTTTT	CASSLAQGPNTGELFF	TRBV11-3	TRBJ2-2
TGCGCCAGCAGCTTGGCCGGCATCTACAATGAGCAGTTCTTC	CASSLAGIYNEQFF	TRBV5-1	TRBJ2-1
TGTGCCAGCAGCAATTCATCGCCCGGCACAGATACGCAGTATTTT	CASSNSSPGTDTQYF	TRBV5-4	TRBJ2-3
TGCGCCAGCAGGAGGACAGGGAACAATCAGCCCCAGCATTTT	CASRRTGNNQPQHF	TRBV5-1	TRBJ1-5
TGCAGTGGACCACTTACCAATGAGCAGTTCTTC	CSGPLTNEQFF	TRBV20-1	TRBJ2-1
TGTGCCAGCACGAGCGGGGATAGAAACACTGAAGCTTTCTTT	CASTSGDRNTEAFF	TRBV6-1	TRBJ1-1
TGCGCCAGCAGCCAAGGCTGGACAGGATACAGCAATCAGCCCCAGCATTTT	CASSQGWTGYSNQPQHF	TRBV4-1	TRBJ1-5
TGTGCCAGCATGCAGGGGGCGAATAAGTTGCCCCAGCATTTT	CASMQGANKLPQHF	TRBV9	TRBJ1-5
TGTGCCAGCAGCGTAGTTCAGGAATACGAGCAGTACTTC	CASSVVQEYEQYF	TRBV9	TRBJ2-7
TGCAGTGCTTTTATGGGGGGGTGTAGCTCCTACAATGAGCAGTTCTTC	CSAFMGGCSSYNEQFF	TRBV20-1	TRBJ2-1
TGTGCCACCAGTCCCCTGGGGGCGACAGAGACCCAGTACTTC	CATSPLGATETQYF	TRBV24-1	TRBJ2-5
TGTGCCAGCAGTGGCACCCCCTACGAGCAGTACTTC	CASSGTPYEQYF	TRBV12-3	TRBJ2-7
TGTGCCAGCAGTTTAGGGGGAGCAGATCAGCCCCAGCATTTT	CASSLGGADQPQHF	TRBV27	TRBJ1-5
TGTGCCAGCATCAGGACAGGAGTGGGGAACACTGAAGCTTTCTTT	CASIRTGVGNTEAFF	TRBV7-3	TRBJ1-1
TGCGCCAGAGACTGGACAGGGGGCTTGAAAGTCTACGAGCAGTACTTC	CARDWTGGLKVYEQYF	TRBV10-1	TRBJ2-7
TGTGCCGGGACTAGAGGGGCCTACGAGCAGTACTTC	CAGTRGAYEQYF	TRBV19	TRBJ2-7
TGCGCCAGCAGCTTGGAACGAGCCAGAGACAGGTTCTTCCAAGAGACCCAGTACTTC	CASSLERARDRFFQETQYF	TRBV5-1	TRBJ2-5
TGTGCCAGTAGTAGCCCTTCCGTAGGACAGGGTAGGTGGAGCGAGCAGTACTTC	CASSSPSVGQGRWSEQYF	TRBV19	TRBJ2-7
TGTGCCAGCAGTGAACTTGGGACAGGCTCTGGAAACACCATATATTTT	CASSELGTGSGNTIYF	TRBV2	TRBJ1-3
TGTGCCAGCAGCTTAGCTCCCTTAAGACAGGGTGAAGCTTTCTTT	CASSLAPLRQGEAFF	TRBV11-2	TRBJ1-1
TGTGCCACCATTAAAGGGTACGAGCAGTACTTC	CATIKGYEQYF	TRBV24-1	TRBJ2-7
TGTGCCAGCAGCATCCTGGGGCGCAAAGCAACTAATGAAAAACTGTTTTTT	CASSILGRKATNEKLFF	TRBV9	TRBJ1-4
TGTGCCAGCTCACCACCGTGGGGCCAGCCCCAGCATTTT	CASSPPWGQPQHF	TRBV18	TRBJ1-5
TGTGCCAGCAGCTCAAACAGCGAATCGGGCTACACCTTC	CASSSNSESGYTF	TRBV7-8	TRBJ1-2
TGCGCCAGCAGCCAAGATTTGACAGGGGGGTCCGCCAAAAACATTCAGTACTTC	CASSQDLTGGSAKNIQYF	TRBV4-1	TRBJ2-4
TGTGCCAGCTGTAGCATCTCTTCTTACGAGCAGTACTTC	CASCSISSYEQYF	TRBV12-4	TRBJ2-7
TGTGCCAGCAGTTACGACAAAGCGGACAGGAGAAACTCTAGCTCCTACGAGCAGTACTTC	CASSYDKADRRNSSSYEQYF	TRBV6-2	TRBJ2-7
TGCGCCAGCCGAGGACAGGTTGGAAACACCATATATTTT	CASRGQVGNTIYF	TRBV10-1	TRBJ1-3
TGTGCCAGCAGCACAGGGGGGGGGTTACAGCCCCAGCATTTT	CASSTGGGLQPQHF	TRBV9	TRBJ1-5
TGTGCCAGCAACCGCGGCGGCAACGAGCAGTACTTC	CASNRGGNEQYF	TRBV11-1	TRBJ2-7
TGTGCCAGCAGTTTCCTACAACGCGGGGAGGTCGATGAAAAACTGTTTTTT	CASSFLQRGEVDEKLFF	TRBV28	TRBJ1-4
TGTGCCAGCCCGGACAGGCCCGACGAGCAGTACTTC	CASPDRPDEQYF	TRBV3-1	TRBJ2-7
TGTGCCAGTAGTATAGATTTCCTCCTGCCCGGGACAGGCGAGCAGTACTTC	CASSIDFLLPGTGEQYF	TRBV19	TRBJ2-7
TGTGCCACCAGTGCTCAAAACACCGAGCCACGCTCGCAATCCTACGAGCAGTACTTC	CATSAQNTEPRSQSYEQYF	TRBV24-1	TRBJ2-7
TGTGCCTCGGGCGTCCGGACAAACAATCAGCCCCAGCATTTT	CASGVRTNNQPQHF	TRBV2	TRBJ1-5
TGCAGTGCTAGTCAGGTTGAGGGGGGGTATAGCAATCAGCCCCAGCATTTT	CSASQVEGGYSNQPQHF	TRBV20-1	TRBJ1-5
TGTGCCACCAGTGATTTAGTAAGACAGGCCGGGGAGCTGTTTTTT	CATSDLVRQAGELFF	TRBV24-1	TRBJ2-2
TGTGCCAGCCGGGGCGATGGCTACACCTTC	CASRGDGYTF	TRBV28	TRBJ1-2
TGTGCCAGCAGCGTAGGCGGTTGTTCCTACGAGCAGTACTTC	CASSVGGCSYEQYF	TRBV9	TRBJ2-7
TGTGCCAGCAGTGACGGGGCAAACACCATATATTTT	CASSDGANTIYF	TRBV6-2	TRBJ1-3
TGTGCCAGCACGAAGTCTATTACACGAACATCTGAAAAACTGTTTTTT	CASTKSITRTSEKLFF	TRBV28	TRBJ1-4
TGTGCCAGCCCGGGACTCACTAGCACAGATACGCAGTATTTT	CASPGLTSTDTQYF	TRBV6-4	TRBJ2-3
TGCGCCAGCAGCACTAGCGGGGGGGCCCGCACCGGGGAGCTGTTTTTT	CASSTSGGARTGELFF	TRBV5-1	TRBJ2-2
TGCAGTGCTAGAGCACGTCTCCCCGGGACTGTCATTGATGAGCAGTTCTTC	CSARARLPGTVIDEQFF	TRBV20-1	TRBJ2-1
TGTGCCAGGGGTAGGAGGGGAGGTGGCCACTCTGGGGCCAACGTCCTGACTTTC	CARGRRGGGHSGANVLTF	TRBV6-4	TRBJ2-6
TGTGCCAGCAGTTTATCCTTTCCTCTTCCGACAGAGACTTATGAAAAACTGTTTTTT	CASSLSFPLPTETYEKLFF	TRBV27	TRBJ1-4
TGCAGTGCTAGAGACAGCCTCCTTGGATGCAATCAGCCCCAGCATTTT	CSARDSLLGCNQPQHF	TRBV20-1	TRBJ1-5
TGTGCCAGCAGCATACCTCCCGGGACTAGGGAGGAACTCAACACCGGGGAGCTGTTTTTT	CASSIPPGTREELNTGELFF	TRBV7-4	TRBJ2-2
TGTGCCAGCAGTTTAGATATACCAAGGACAGGGGGCAAGTTTCTTAACAACTACTCCTACGAGCAGTACTTC	CASSLDIPRTGGKFLNNYSYEQYF	TRBV12-3	TRBJ2-7
TGTGCCAGCAGTTTGCGTTTGGGGACAGAAAGAGAGGCCAAAAACATTCAGTACTTC	CASSLRLGTEREAKNIQYF	TRBV27	TRBJ2-4
TGTGCCAGCAGCTCCGGGCCCGGCCGGACCTACGAGCAGTACTTC	CASSSGPGRTYEQYF	TRBV7-2	TRBJ2-7
TGCAACGCGACATTTTGCTCCTACGAGCAGTACTTC	CNATFCSYEQYF	TRBV20-1	TRBJ2-7
TGCAGTGCGGACACCAGCTACAATGAGCAGTTCTTC	CSADTSYNEQFF	TRBV20-1	TRBJ2-1
TGTGCCACCAGTGATTTCAGATTTTCCTACGAGCAGTACTTC	CATSDFRFSYEQYF	TRBV24-1	TRBJ2-7
TGTGCCAGCAGTACCGGGGGCAGGCAGCCCCAGCATTTT	CASSTGGRQPQHF	TRBV6-6	TRBJ1-5
TGTGCCAGTAGTAAAAGCGGGACAGGGATCTCTGGGGCCAACGTCCTGACTTTC	CASSKSGTGISGANVLTF	TRBV19	TRBJ2-6
TGTGCCAGCAGCCAAGGACCCGACAGGGAGTGGTACTTC	CASSQGPDREWYF	TRBV3-1	TRBJ2-7
TGTGCCAGCTCAGAACGACTAGCTGAAGAGTACTTC	CASSERLAEEYF	TRBV18	TRBJ2-7
TGTGCCAGCAGCGGTCAGGGGGCGAGGGGGTACCAAGAGACCCAGTACTTC	CASSGQGARGYQETQYF	TRBV7-3	TRBJ2-5
TGTGCCAGCAGCAGGGGGGGCGAGCAGTACTTC	CASSRGGEQYF	TRBV7-3	TRBJ2-7
TGTGCCAGCAGCTTACGGGATATTAGGGAAGCCCAGCATTTT	CASSLRDIREAQHF	TRBV5-6	TRBJ1-5
TGTGCCAGCAGGGCCGGGACTCATGGAAACACCATATATTTT	CASRAGTHGNTIYF	TRBV28	TRBJ1-3
TGTGCCAGCAGTTCTACCGGGACTAGCGGGAGAGGGGGAGAGACCCAGTACTTC	CASSSTGTSGRGGETQYF	TRBV27	TRBJ2-5
TGTGCCAGCATAGTGGGGGGACAGTTGAGTTCCTACGAGCAGTACTTC	CASIVGGQLSSYEQYF	TRBV6-8	TRBJ2-7
TGTGCCAGCAGCTTAATGGGGGGGCCGGGGTTGGAAGATACGCAGTATTTT	CASSLMGGPGLEDTQYF	TRBV7-2	TRBJ2-3
TGTGCCAGCAGTGAAGAAGCAGGGATTAGGACCAAAAACATTCAGTACTTC	CASSEEAGIRTKNIQYF	TRBV2	TRBJ2-4
TGTGCCTGGAGTGTACCAAAGTTCCGGGACAGGGGGTATGGCTACACCTTC	CAWSVPKFRDRGYGYTF	TRBV30	TRBJ1-2
TGTGCCAGCAGATCCGGGACAGAGTCGGAGACCCAGTACTTC	CASRSGTESETQYF	TRBV6-2	TRBJ2-5
TGTGCCAGCAGCCAATACCTTTTTGACAGGGCCTATGGCTACACCTTC	CASSQYLFDRAYGYTF	TRBV3-1	TRBJ1-2
TGTGACAACCTAGCCTCCTACGAGCAGTACTTC	CDNLASYEQYF	TRBV12-3	TRBJ2-7
TGTGCCAGCAGCGTCAGGGGACGGAAGTACTTC	CASSVRGRKYF	TRBV13	TRBJ2-7
TGTGCCAGCAGTTTTGCTGGGGTGGACAATGAGCAGTTCTTC	CASSFAGVDNEQFF	TRBV27	TRBJ2-1
TGCAGTGCTAGACACAGCTACGAGCAGTACTTC	CSARHSYEQYF	TRBV20-1	TRBJ2-7
TGCGCCCAGGGCTACTACAATGAGCAGTTCTTC	CAQGYYNEQFF	TRBV10-1	TRBJ2-1
TGTGCCAGCAGCCCCCCGGGAGGGCCCTACGAGCAGTACTTC	CASSPPGGPYEQYF	TRBV6-1	TRBJ2-7
