TGTGCCAGCAGTCCGGGGTACTACGAGCAGTACTTC	CASSPGYYEQYF	TRBV6-5	TRBJ2-7
TGCGCCAGCAGTGAAGGAGGGGGGGATGGCTACACCTTC	CASSEGGGDGYTF	TRBV10-1	TRBJ1-2
TGTGCCTGCCCAGTTGGGTACTACGAGCAGTACTTC	CACPVGYYEQYF	TRBV30	TRBJ2-7
TGTGCCAGGGTACCGACAGTATCCAATGAGCAGTTCTTC	CARVPTVSNEQFF	TRBV5-6	TRBJ2-1
TGTGCCAGCAGCTTGGACTGCGAGGGGTCCGATGAGCAGTTCTTC	CASSLDCEGSDEQFF	TRBV5-6	TRBJ2-1
TGTGCCAGCAGTGCCCGACAGGGATTCTATGGCTACACCTTC	CASSARQGFYGYTF	TRBV6-4	TRBJ1-2
TGTGCCAGCAGTGCTCGGAGGGGGGATGGCTACACCTTC	CASSARRGDGYTF	TRBV12-3	TRBJ1-2
TGTGCCAGCTCGGGGGGGTCAGGAAGCACCGGGGAGCTGTTTTTT	CASSGGSGSTGELFF	TRBV7-9	TRBJ2-2
TGTGCCAGCAGCCAAGTCCGCGTGGGGAACACCGGGGAGCTGTTTTTT	CASSQVRVGNTGELFF	TRBV14	TRBJ2-2
TGCAGCGTTGAGGGGGGGACCAATGTAGCTTTCTTT	CSVEGGTNVAFF	TRBV29-1	TRBJ1-1
TGTGCCAGCAGCCGGGACAGGGGGGCGGCAGCTTTCTTT	CASSRDRGAAAFF	TRBV14	TRBJ1-1
TGTGCCAGCAGCGATATGGGGAAAATTGAAGGCTACACCTTC	CASSDMGKIEGYTF	TRBV7-4	TRBJ1-2
TGTGCCTGGATAGCTGGGATCACCGGGGAGCTGTTTTTT	CAWIAGITGELFF	TRBV30	TRBJ2-2
TGTGCCAGCAGCTTAGCTTGGGACAGGGGCGGAGGAGGAGGAAACACCATATATTTT	CASSLAWDRGGGGGNTIYF	TRBV7-9	TRBJ1-3
TGCGCCAGCAGTGAGCCTTCTAGAGCCAAAAACATTCAGTACTTC	CASSEPSRAKNIQYF	TRBV10-2	TRBJ2-4
TGCGCCAGCAGCTTTTTGGACAGTGACACTGAAGCTTTCTTT	CASSFLDSDTEAFF	TRBV5-1	TRBJ1-1
TGTGCCAGCAGTGGGGTAGCGACAGGAGGCGAGCAGTACTTC	CASSGVATGGEQYF	TRBV27	TRBJ2-7
TGTGCCAGCAGTGGGACAGGGCAAGAGACCCAGTACTTC	CASSGTGQETQYF	TRBV6-1	TRBJ2-5
TGCGCCAGCCCCAGTAACGGGGGCGCCTACGAGCAGTACTTC	CASPSNGGAYEQYF	TRBV10-1	TRBJ2-7
TGTGCCAGCCGGACAGGGGAGACCCAGTACTTC	CASRTGETQYF	TRBV6-3	TRBJ2-5
TGTGCCAGCAGCCCCCGGAGGCGGGGTGCGGATCAGCCCCAGCATTTT	CASSPRRRGADQPQHF	TRBV11-2	TRBJ1-5
TGTGCCAGCAGTGAGAAGTTGAATCAGGGGGCGGTTGTATGGCCCTCTGGGGCCAACGTCCTGACTTTC	CASSEKLNQGAVVWPSGANVLTF	TRBV6-1	TRBJ2-6
TGTGCCAGCAAGAGCAAGGGGTTCGATGGCAAAGAGACCCAGTACTTC	CASKSKGFDGKETQYF	TRBV6-1	TRBJ2-5
TGTGCCAGTAGTGCCCACGGGTACGAGCAGTACTTC	CASSAHGYEQYF	TRBV19	TRBJ2-7
TGTGCCACCAGTGATTCCGGCGTAGCGGGGGAAGAGACCCAGTACTTC	CATSDSGVAGEETQYF	TRBV24-1	TRBJ2-5
TGTGCCAGCAGCCAAAACAGGCTCCGAGATGAGCAGTTCTTC	CASSQNRLRDEQFF	TRBV14	TRBJ2-1
TGTGCCAGCAGCCCCAGGGGTAAAGAAAAACTGTTTTTT	CASSPRGKEKLFF	TRBV14	TRBJ1-4
TGTGCCAGCAGTGGGACAACAGACACAGATACGCAGTATTTT	CASSGTTDTDTQYF	TRBV27	TRBJ2-3
TGCAGCGTTGAAGATCAAGTTGGCGTACTTTTGAACACTGAAGCTTTCTTT	CSVEDQVGVLLNTEAFF	TRBV29-1	TRBJ1-1
TGTGCCAGCAGTTCGATTTGTAATGGGACCGAGAGCTACGAGCAGTACTTC	CASSSICNGTESYEQYF	TRBV6-8	TRBJ2-7
TGTGCCAGCAGTTTCCTAGCGGGAGTTACAGAGACCCAGTACTTC	CASSFLAGVTETQYF	TRBV28	TRBJ2-5
TGTGCCAGCAGTGGAGGGGGGGGCGTTCGTTTCTACGAGCAGTACTTC	CASSGGGGVRFYEQYF	TRBV12-3	TRBJ2-7
TGTGCCAGCAGTTTGACAGGGCCTAGCAATCAGCCCCAGCATTTT	CASSLTGPSNQPQHF	TRBV28	TRBJ1-5
TGTGCCGGACTAGCGGGACTACTCAGGGAGCAGTACTTC	CAGLAGLLREQYF	TRBV7-3	TRBJ2-7
TGTGCCAGCAGTTTAGAGGGCAAGCCCGACAGGGGATATGGCTACACCTTC	CASSLEGKPDRGYGYTF	TRBV28	TRBJ1-2
TGTGCCAGCAGCAGAAAGGGGATTGAGCAGTACTTC	CASSRKGIEQYF	TRBV13	TRBJ2-7
TGCGCCAGCAGCCTAATCCAGGGGAGTGCGAACACCGGGGAGCTGTTTTTT	CASSLIQGSANTGELFF	TRBV5-1	TRBJ2-2
TGTGCCAGCAGCCGGCTTCACAATGAGCAGTTCTTC	CASSRLHNEQFF	TRBV6-4	TRBJ2-1
TGTGCCAGCAGCCAAGCGGGGAGGAGGAGTGAAAAACTGTTTTTT	CASSQAGRRSEKLFF	TRBV3-1	TRBJ1-4
TGTGCCAGTAGGCAGAGGACAGCTTACACTGAAGCTTTCTTT	CASRQRTAYTEAFF	TRBV19	TRBJ1-1
TGTGCCAGCAGCCCCACGCTAGCGGGGAAGCAGTTCTTC	CASSPTLAGKQFF	TRBV3-1	TRBJ2-1
TGTGCCAGCGTCCTGGAGTTAAATGAGCAGTTCTTC	CASVLELNEQFF	TRBV7-8	TRBJ2-1
TGTGCCAGCAGTGAAGAAATGACAGCCGACCGGCACTATGGCTACACCTTC	CASSEEMTADRHYGYTF	TRBV6-1	TRBJ1-2
TGTGCCAGCAGCTTACAGGAGCGGGAGTTGGGGATTGGCTACACCTTC	CASSLQERELGIGYTF	TRBV7-9	TRBJ1-2
TGCGCCAGCAGCTTCCCTTGGGAAGAGTGTTATGACCAAGAGACCCAGTACTTC	CASSFPWEECYDQETQYF	TRBV5-1	TRBJ2-5
TGTGCCAGTTTCGCCTACCTTCCTAATCAGCCCCAGCATTTT	CASFAYLPNQPQHF	TRBV27	TRBJ1-5
TGTGCCAGCAGGCCCAAGACTAGGACAGTCGGGTACGAGACCCAGTACTTC	CASRPKTRTVGYETQYF	TRBV7-9	TRBJ2-5
TGTGCCACCAGTAGGGGGACTAGTTCAGCTGAGCAGTTCTTC	CATSRGTSSAEQFF	TRBV24-1	TRBJ2-1
TGTGCCACCAGTGATTGGGTTACAGGTCCGATAAACACTGAAGCTTTCTTT	CATSDWVTGPINTEAFF	TRBV24-1	TRBJ1-1
TGCAGTGCTAGAGTCTCCGAGCTAAGTCCGCCGGGGCTGTACACCGGGGAGCTGTTTTTT	CSARVSELSPPGLYTGELFF	TRBV20-1	TRBJ2-2
TGTGCCAGCAGCCATCAGACTAGCGGGAGGGGATACGAGCAGTACTTC	CASSHQTSGRGYEQYF	TRBV3-1	TRBJ2-7
TGCGCCAGCAGCTTGGCCGGACTACGACTTCCCTACGAGCAGTACTTC	CASSLAGLRLPYEQYF	TRBV5-1	TRBJ2-7
TGTGCCAGCACCGGGGCGGGGGGCAGGTACAATGAGCAGTTCTTC	CASTGAGGRYNEQFF	TRBV27	TRBJ2-1
TGTGCCAGCAGCTTGGCCCCATTACCGGGACAGGGAAGACTAACTGAAGCTTTCTTT	CASSLAPLPGQGRLTEAFF	TRBV5-8	TRBJ1-1
TGTGCCAGCAGTTTAAGGCACAGCCGTAGTGAAGCTTTCTTT	CASSLRHSRSEAFF	TRBV6-5	TRBJ1-1
TGTGCCAGCAGAGGGGGACAGATGAGCCCTGAGCCCGGGGAGCTGTTTTTT	CASRGGQMSPEPGELFF	TRBV5-6	TRBJ2-2
TGTGCCAGCAGCCAATTACGGGGGGGCCGACTCAAGGATGAGCAGTTCTTC	CASSQLRGGRLKDEQFF	TRBV4-2	TRBJ2-1
TGTGCCAGCAGCCGTCACACGATCCGGTACGAGCAGTACTTC	CASSRHTIRYEQYF	TRBV13	TRBJ2-7
TGTGCCAGCAGCTTCGACGTCCGAGGAGCGGGGACGAGCGACACTGAAGCTTTCTTT	CASSFDVRGAGTSDTEAFF	TRBV7-4	TRBJ1-1
TGTGCCAGCAGTGAAACCTACCCGACGCCCTCTGGCTACACCTTC	CASSETYPTPSGYTF	TRBV2	TRBJ1-2
TGCGCCAGCAGCTTGGCCGGCCGGGACAGCGGGTCCTATGGCTACACCTTC	CASSLAGRDSGSYGYTF	TRBV5-1	TRBJ1-2
TGTGCCAGCAGTGACTGGATTCCTACTAGAGGATACCAGAGGCGCAAAACAACAGATACGCAGTATTTT	CASSDWIPTRGYQRRKTTDTQYF	TRBV25-1	TRBJ2-3
TGTGCCAGCAGCCAAGTAGGGCGTACTTCTGAAGCTTTCTTT	CASSQVGRTSEAFF	TRBV14	TRBJ1-1
TGTGCCAGCAGCTTAGATCGACGAGATACGCAGTATTTT	CASSLDRRDTQYF	TRBV7-2	TRBJ2-3
TGCAGTGCGAAAGGGGGGGGGTGGAAAAATCAGCCCCAGCATTTT	CSAKGGGWKNQPQHF	TRBV20-1	TRBJ1-5
TGTGCCAGCAGTGACGTGCTAGCGGGGGGGCCGTACGAGCAGTACTTC	CASSDVLAGGPYEQYF	TRBV6-1	TRBJ2-7
TGCGCCAGCAGCTTGGCCCAAGGGGGATTGTCACCCCTCCACTTT	CASSLAQGGLSPLHF	TRBV5-1	TRBJ1-6
TGTGCCACCAGGACAGGGGGCGGAACTAATGAAAAACTGTTTTTT	CATRTGGGTNEKLFF	TRBV6-1	TRBJ1-4
TGTGCCAGCAGCCCGCCGTCTAATGAAAAACTGTTTTTT	CASSPPSNEKLFF	TRBV6-3	TRBJ1-4
TGTGCCAGCAGTCAGCAAGCAGCTAGTGCTAACTATGGCTACACCTTC	CASSQQAASANYGYTF	TRBV6-3	TRBJ1-2
TGCGCCAGCACCAAGGGGGGGGCTTTTAATGGCTACACCTTC	CASTKGGAFNGYTF	TRBV4-3	TRBJ1-2
TGTGCCAGCAGCTCACCTCCGGGACTACTCGAGCAGTACTTC	CASSSPPGLLEQYF	TRBV3-1	TRBJ2-7
TGTGCCAGCAGTTACCCCCCCCACAGGGGCTTTGAAGCTTTCTTT	CASSYPPHRGFEAFF	TRBV6-2	TRBJ1-1
TGCAGTGGGGGGGGACAGGGCCACGGCAATCAGCCCCAGCATTTT	CSGGGQGHGNQPQHF	TRBV20-1	TRBJ1-5
TGTGCCACCAGAGCTGTTACCGAGAACAGGGGTAGCTCCTACGAGCAGTACTTC	CATRAVTENRGSSYEQYF	TRBV24-1	TRBJ2-7
TGTGCCAGCAGCCTGGGGTATCCGCCCCAGCATTTT	CASSLGYPPQHF	TRBV6-4	TRBJ1-5
TGTGCCACCAGTGCCCAGTCAGAAAAACTGTTTTTT	CATSAQSEKLFF	TRBV24-1	TRBJ1-4
TGTGCCAGCAGTTTAGTCGGGTACAATGAGCAGTTCTTC	CASSLVGYNEQFF	TRBV6-2	TRBJ2-1
TGCGCCAGCAGCTTGGCCAATCAGGGGTTTTCCGAGCAGTACTTC	CASSLANQGFSEQYF	TRBV5-1	TRBJ2-7
TGTGCCAGCACCCTACGGCCCAGGGGGAATTCACCCCTCCACTTT	CASTLRPRGNSPLHF	TRBV6-4	TRBJ1-6
TGCGCCAGCGCGCAAGCCGGGACTAGCGGGGATAATTCACCCCTCCACTTT	CASAQAGTSGDNSPLHF	TRBV5-1	TRBJ1-6
TGTGCCAGCACACACAAGTGCTCCCGGGACAGGGATGTGCGTAGGGAGACCCAGTACTTC	CASTHKCSRDRDVRRETQYF	TRBV2	TRBJ2-5
TGTGCCTGGGATCTGACTAGCGGGAGAAACTACGAGCAGTACTTC	CAWDLTSGRNYEQYF	TRBV19	TRBJ2-7
TGTGCCAGCAGTCCCTTATCCCGACCCTACGAGCAGTACTTC	CASSPLSRPYEQYF	TRBV6-1	TRBJ2-7
TGTGCCAGCAGGCAAAAGCGGGATTTGGGTATCTCCTATAATTCACCCCTCCACTTT	CASRQKRDLGISYNSPLHF	TRBV6-4	TRBJ1-6
TGTGCCAGCACGGGGGCGCTTACGGAGCAGTACTTC	CASTGALTEQYF	TRBV7-9	TRBJ2-7
TGTGCCAGCAGTCCCCCCGCGGGGGGGATAGACTTCAGCCAAGAGACCCAGTACTTC	CASSPPAGGIDFSQETQYF	TRBV6-5	TRBJ2-5
TGTGCCAGCAGCGGACAGGCCAACACCGGGGAGCTGTTTTTT	CASSGQANTGELFF	TRBV13	TRBJ2-2
TGTGCCAGCAGCAGACAGGTACAGAAAGAGACCCAGTACTTC	CASSRQVQKETQYF	TRBV3-1	TRBJ2-5
TGTGCCAGCAGTTACTCCATACCGGCCTACGAGCAGTACTTC	CASSYSIPAYEQYF	TRBV6-3	TRBJ2-7
TGTGCCAGCAGCCAAGCTCGGGGATTGGCCCGATACTTCCCGAATGAGCAGTTCTTC	CASSQARGLARYFPNEQFF	TRBV3-1	TRBJ2-1
TGTGCCAGCAGCAACACCTCTGGGGCCAACGTCCTGACTTTC	CASSNTSGANVLTF	TRBV7-8	TRBJ2-6
TGTGCCAGCAGCTTTACATCGGACTCTGTTGACAATGAGCAGTTCTTC	CASSFTSDSVDNEQFF	TRBV5-6	TRBJ2-1
TGTGCCAGCAGCTGGTTGGGGGCGCGGTTGTCCTACGAGCAGTACTTC	CASSWLGARLSYEQYF	TRBV7-2	TRBJ2-7
TGTGCTAGTGCAGGGCTACTAGCGGTCGAGACCCAGTACTTC	CASAGLLAVETQYF	TRBV12-5	TRBJ2-5
TGTGCCAGCAGTGCGAAAACTGGGGCAGGAAACACCATATATTTT	CASSAKTGAGNTIYF	TRBV2	TRBJ1-3
TGTGCCTGGACACTCGCCTCGGCACTGAACACTGAAGCTTTCTTT	CAWTLASALNTEAFF	TRBV30	TRBJ1-1
TGTGCCAGCAGTAGTTCCAGGCAAGCCAAAGAGCAGTTCTTC	CASSSSRQAKEQFF	TRBV28	TRBJ2-1
TGCGCCAGCAGCTTTCCCCCCGGGACAGCGACTGAAGCTTTCTTT	CASSFPPGTATEAFF	TRBV5-1	TRBJ1-1
TGTGCCACCAGTTCCTCCGATCGCGGACAGGGGGCTCCCCCTGGAAACACCATATATTTT	CATSSSDRGQGAPPGNTIYF	TRBV24-1	TRBJ1-3
TGTGCTAGCAGCTTAGTGGGGGGGACAGAGACCCAGTACTTC	CASSLVGGTETQYF	TRBV7-7	TRBJ2-5
TGTGCCAGCAGCCTCTGGGACAGGGAAGGATCCTCCTATAATTCACCCCTCCACTTT	CASSLWDREGSSYNSPLHF	TRBV7-2	TRBJ1-6
TGTGCCAGCAGTTGGACCTTCCCGCGGGAGCAGTACTTC	CASSWTFPREQYF	TRBV6-3	TRBJ2-7
TGTGCCAGCAACGCCGGGGGGGCCGGGGAGCTGTTTTTT	CASNAGGAGELFF	TRBV6-6	TRBJ2-2
TGTGCCAGCACTCCCGGAGGGAACGAGACCCAGTACTTC	CASTPGGNETQYF	TRBV27	TRBJ2-5
TGTGCCAGCAGCCGAAGACGTTTAAGCAATCAGCCCCAGCATTTT	CASSRRRLSNQPQHF	TRBV3-1	TRBJ1-5
TGCAGTGCTAGAGAAAAGGGGGCCCTCCAGTGCACTGAAGCTTTCTTT	CSAREKGALQCTEAFF	TRBV20-1	TRBJ1-1
TGTGCCAGCAGCTTGGTTGACAGGGAGGACTATGGCTACACCTTC	CASSLVDREDYGYTF	TRBV5-6	TRBJ1-2
TGTGCCAGCAGTTCAGCCGACAGGGGACCTAATCAGCCCCAGCATTTT	CASSSADRGPNQPQHF	TRBV27	TRBJ1-5
TGCGCCAGCAGCTTGTTCCAGGGGGGCTATGGCTACACCTTC	CASSLFQGGYGYTF	TRBV5-1	TRBJ1-2
TGTGCCACCAGTGCCCCCTCGGGACTAGCGAGGGAAGCGGGCACAGATACGCAGTATTTT	CATSAPSGLAREAGTDTQYF	TRBV24-1	TRBJ2-3
TGTGCCAGCAGCTGTAGCCCCGGGGGGGCCTTATACGAGCAGTACTTC	CASSCSPGGALYEQYF	TRBV13	TRBJ2-7
TGTGCCACTGGGGTGGACCCGACCTACGAGCAGTACTTC	CATGVDPTYEQYF	TRBV6-5	TRBJ2-7
TGTGCCAGCAGCTTATGGGTCTTCATCGGCCTCCACTTT	CASSLWVFIGLHF	TRBV7-3	TRBJ1-6
TGTGCCAGCAGGTTAACGAAGAACACCGGGGAGCTGTTTTTT	CASRLTKNTGELFF	TRBV14	TRBJ2-2
TGCGCCAGCACGCGGGACAGGGTGGAAAAACTGTTTTTT	CASTRDRVEKLFF	TRBV10-2	TRBJ1-4
TGTGCCAGCAGTCGAGGGGGGCGCGGCTTCCCCTACGAGCAGTACTTC	CASSRGGRGFPYEQYF	TRBV27	TRBJ2-7
TGCAGCGGCCCCCGAGTTTGCTATGGCTACACCTTC	CSGPRVCYGYTF	TRBV29-1	TRBJ1-2
TGCGCCAGCAGCCAAGCATTTTCGGGGGCCAACGTCCTGACTTTC	CASSQAFSGANVLTF	TRBV4-3	TRBJ2-6
TGTGCCAGCAGTTTTAATGGTCAGGGGGCCATTGGCTACAATGAGCAGTTCTTC	CASSFNGQGAIGYNEQFF	TRBV6-5	TRBJ2-1
TGCAGTGCACTTGGGGCTGAAAAACTGTTTTTT	CSALGAEKLFF	TRBV20-1	TRBJ1-4
TGTGCCAGCAGGCCCGGGCAGAGCACTGAAGCTTTCTTT	CASRPGQSTEAFF	TRBV6-5	TRBJ1-1
TGCAGTGCTAGCCAGGCTATCCCGGGGGGGCGGGGGTCGTTAGCCAAAAACATTCAGTACTTC	CSASQAIPGGRGSLAKNIQYF	TRBV20-1	TRBJ2-4
TGTGCCAGCAGTGAAGCTGGACTGGGAGGGGCCCAGGATACGCAGTATTTT	CASSEAGLGGAQDTQYF	TRBV2	TRBJ2-3
TGCGCCAGCGGGCCGCTAAAACACTACAATGAGCAGTTCTTC	CASGPLKHYNEQFF	TRBV5-1	TRBJ2-1
TGTGCCAGCAGTCCTAGCGGGCATTGCAATGAGCAGTTCTTC	CASSPSGHCNEQFF	TRBV27	TRBJ2-1
TGTGCCAGCAGCTTAATTACAGGGGGCCGGGTACAAGCTTTCTTT	CASSLITGGRVQAFF	TRBV11-3	TRBJ1-1
TGTGCCAGTAGCCGACTAGCGGGGGATGAGCAGTTCTTC	CASSRLAGDEQFF	TRBV19	TRBJ2-1
TGTGCCACCAGTGAAAGGTGGGGGGGAGCGATCCCCTCCTACAATGAGCAGTTCTTC	CATSERWGGAIPSYNEQFF	TRBV24-1	TRBJ2-1
TGTGCCAGCAGTTTATCATCTATTTACCGTAGCGGGAATGAGCAGTTCTTC	CASSLSSIYRSGNEQFF	TRBV27	TRBJ2-1
TGTGCCAGCAGCTCGACCGCTAGCGGGGGACCCTACGAGCAGTACTTC	CASSSTASGGPYEQYF	TRBV5-4	TRBJ2-7
TGTGCCAGCAGACGAGAATACACTGAAGCTTTCTTT	CASRREYTEAFF	TRBV12-4	TRBJ1-1
TGTGCCAGCTCACCACCGAGACAGGGGGACGAGTGTCAAGAGACCCAGTACTTC	CASSPPRQGDECQETQYF	TRBV18	TRBJ2-5
TGTGCCAGCAGCCGACAGGGTAACGCCAAAAACATTCAGTACTTC	CASSRQGNAKNIQYF	TRBV25-1	TRBJ2-4
TGTGCCAGCAGTGACCTAGAGGACAGGGTGGGTGATACTGAAGCTTTCTTT	CASSDLEDRVGDTEAFF	TRBV6-4	TRBJ1-1
TGTGCCAGCAGCTTGTTGAGGGGGGAGGAATACAATGAGCAGTTCTTC	CASSLLRGEEYNEQFF	TRBV5-6	TRBJ2-1
TGCAGTGCTAGACTAGCGGGAGGGGGGTCCAATGAAAAACTGTTTTTT	CSARLAGGGSNEKLFF	TRBV20-1	TRBJ1-4
TGTGCCTGGAGTAAAGGGCTGTACACTGAAGCTTTCTTT	CAWSKGLYTEAFF	TRBV30	TRBJ1-1
TGTGCCAGCAGTTACGGGACAGGGGGATTCCTAGCTTTCTTT	CASSYGTGGFLAFF	TRBV6-5	TRBJ1-1
TGTGCCGAGGTGACAGGGTGTTACAATGAGCAGTTCTTC	CAEVTGCYNEQFF	TRBV27	TRBJ2-1
TGTGCCAGCAGCTCATGGGACATGGGAAACACCGGGGAGCTGTTTTTT	CASSSWDMGNTGELFF	TRBV9	TRBJ2-2
TGTGCCAGCAGCCACCTTTGGGCTGGAAACACCATATATTTT	CASSHLWAGNTIYF	TRBV13	TRBJ1-3
TGTGCCAGCAAATACGTAGACAGTCGTGAGACCCAGTACTTC	CASKYVDSRETQYF	TRBV6-4	TRBJ2-5
TGTGCCTGGAGTGTGGGAGGGAATTCACCCCTCCACTTT	CAWSVGGNSPLHF	TRBV30	TRBJ1-6
TGTGCCCCCCGGGGTCGGGATGGTATAGACTATGGCTACACCTTC	CAPRGRDGIDYGYTF	TRBV24-1	TRBJ1-2
TGTGCCAGCAGCTTCGGACAGGACTCCTACGAGCAGTACTTC	CASSFGQDSYEQYF	TRBV5-6	TRBJ2-7
TGTGCCAGCAGGAGCAGGGGCTATGGCTACACCTTC	CASRSRGYGYTF	TRBV3-1	TRBJ1-2
TGTGCCAGCAGACGCGGGAGTTATGAGCAGTTCTTC	CASRRGSYEQFF	TRBV27	TRBJ2-1
TGTGCCAGCACCGGGGGCTCGGAGACCCAGTACTTC	CASTGGSETQYF	TRBV6-8	TRBJ2-5
TGTGCCAGCAGTGACTGGGGGGGGACCGAGCAGTACTTC	CASSDWGGTEQYF	TRBV6-4	TRBJ2-7
TGTGCCAGCAGCGGCCCGCAGAAGAGTAGCAATCAGCCCCAGCATTTT	CASSGPQKSSNQPQHF	TRBV7-3	TRBJ1-5
TGTGCCAGCAGTGGGACAGGGGGCATCAAAGCCGATCAGCCCCAGCATTTT	CASSGTGGIKADQPQHF	TRBV12-3	TRBJ1-5
TGTGCCAGCAGCTTAGGGAACCGGGACAGGGGGGATCACTACGAGCAGTACTTC	CASSLGNRDRGDHYEQYF	TRBV11-2	TRBJ2-7
TGTGCCAGCAGCTCCGGGACTCCCCGGACCCGACAGGAAAGGTCACCCCTCCACTTT	CASSSGTPRTRQERSPLHF	TRBV11-1	TRBJ1-6
TGTGCCAGCAGTTGGAGCGGCTCCTACGAGCAGTACTTC	CASSWSGSYEQYF	TRBV6-1	TRBJ2-7
TGTGCCAGCAGCTTGGAAAAGCGGTCTGGGACCCAGTACTTC	CASSLEKRSGTQYF	TRBV5-6	TRBJ2-5
TGTGCCAGCAGCTTAGCAACGGGGGACGGGCCTTGTCTGTTTTTT	CASSLATGDGPCLFF	TRBV11-2	TRBJ1-4
TGTGCCAGCAGCTTAACCAAGCGGGAGGGGCCCTCTGGAAACACCATATATTTT	CASSLTKREGPSGNTIYF	TRBV7-3	TRBJ1-3
TGCAGTGCTACTGCAGCCACAGATACGCAGTATTTT	CSATAATDTQYF	TRBV20-1	TRBJ2-3
TGTGCCTGGAGGCCTGGGGGGGGCCTAGAGCAGTTCTTC	CAWRPGGGLEQFF	TRBV30	TRBJ2-1
TGTGCCTGGACCCCTCCCGGGAGGGGGAGGCAAGAGACCCAGTACTTC	CAWTPPGRGRQETQYF	TRBV30	TRBJ2-5
TGTGCCAGCAGTTTCTTCGGCCCGGGACTAGCCGGTGAGCAGTTCTTC	CASSFFGPGLAGEQFF	TRBV12-3	TRBJ2-1
TGTGCCAGCAGCTTAAGGAACGCACAGGGTGAAAGAAATGAGCAGTTCTTC	CASSLRNAQGERNEQFF	TRBV13	TRBJ2-1
TGTGCCTGGAGTGTAGACTGGACTGAAGCTTTCTTT	CAWSVDWTEAFF	TRBV30	TRBJ1-1
TGTGCCAGCAGCTTGAGAAGGGAATGGGCGAACACTGAAGCTTTCTTT	CASSLRREWANTEAFF	TRBV5-6	TRBJ1-1
TGTGCCAGCAGCTACCCCACCGACACCAGGAATAATTCACCCCTCCACTTT	CASSYPTDTRNNSPLHF	TRBV5-5	TRBJ1-6
TGTGCCACTAGACGGCAGGGGTCCTACGAGCAGTACTTC	CATRRQGSYEQYF	TRBV27	TRBJ2-7
TGTGCCAGCAGCCAAGGCGCCGGGACTAGGCCGGGGAACACCGGGGAGCTGTTTTTT	CASSQGAGTRPGNTGELFF	TRBV14	TRBJ2-2
TGTGCCAGCAGCTTCACATCCACAGATACGCAGTATTTT	CASSFTSTDTQYF	TRBV13	TRBJ2-3
TGTGCCAGCAGCCAAGGCAATGCGACTAGCGCAGCTAGCACAGATACGCAGTATTTT	CASSQGNATSAASTDTQYF	TRBV14	TRBJ2-3
TGTGCCAGTCATAATTGGGACAGGGGGCTCAATCAGCCCCAGCATTTT	CASHNWDRGLNQPQHF	TRBV19	TRBJ1-5
TGCAGCGTGTTGAGGGAGGGGGATACGCAGTATTTT	CSVLREGDTQYF	TRBV29-1	TRBJ2-3
TGTGCCTGGCACGGGCCACCTAACTATGGCTACACCTTC	CAWHGPPNYGYTF	TRBV27	TRBJ1-2
TGTGCCAGCAGTGAGAGCTATGAGGGAGTCACCTACGAGCAGTACTTC	CASSESYEGVTYEQYF	TRBV25-1	TRBJ2-7
TGTGCCACCCCCGAGCGTCCCGGCGGACTAGGGGATTCGAGATCCTCAGATACGCAGTATTTT	CATPERPGGLGDSRSSDTQYF	TRBV24-1	TRBJ2-3
TGTGCCAGCAGTGATCGGGTTCTCTACGAGCAGTACTTC	CASSDRVLYEQYF	TRBV6-4	TRBJ2-7
TGCGCCAGCGGTACAGGGGCGATGTTTGTGAACACTGAAGCTTTCTTT	CASGTGAMFVNTEAFF	TRBV5-1	TRBJ1-1
TGCGCCAGCAGCCGGAGCTCCTACGAGCAGTACTTC	CASSRSSYEQYF	TRBV5-1	TRBJ2-7
TGCGCCAGCAGTGAAGGGGAGGAGGGCTATGGCTACACCTTC	CASSEGEEGYGYTF	TRBV10-1	TRBJ1-2
TGTGCCAGCAGCTTACTCAGCCGCTCCTACGAGCAGTACTTC	CASSLLSRSYEQYF	TRBV7-2	TRBJ2-7
TGTGCCAGCAGTTTCAGTCCCCGGGACAGTGGTACTGAAGCTTTCTTT	CASSFSPRDSGTEAFF	TRBV27	TRBJ1-1
TGTGCCAGCAGCTTAGCGACATCACCCAGCTCCTACGAGCAGTACTTC	CASSLATSPSSYEQYF	TRBV11-3	TRBJ2-7
TGTGCCAGCAGCTCTAAGGACCTCCGTCCCTCCTACGAGCAGTACTTC	CASSSKDLRPSYEQYF	TRBV11-3	TRBJ2-7
TGCGCCAGCAGGCACGGGAATAAAAGCTCCTACGAGCAGTACTTC	CASRHGNKSSYEQYF	TRBV4-3	TRBJ2-7
TGTGCCAGCAGCGTGGGCGGGGGGGGGTACTTAGAGACCCAGTACTTC	CASSVGGGGYLETQYF	TRBV9	TRBJ2-5
TGTCCCCTCCTGGGGGCAAGGCACACTGAAGCTTTCTTT	CPLLGARHTEAFF	TRBV19	TRBJ1-1
TGTGCCAGCAGCCAAGTGGGGACTAGCGGCAACTACGAGCAGTACTTC	CASSQVGTSGNYEQYF	TRBV3-1	TRBJ2-7
TGCGCCAGCAGCGATCTAGCGGGATGGGAGCAGTTCTTC	CASSDLAGWEQFF	TRBV5-1	TRBJ2-1
TGCGCCAGCAGCCCAGGCGCGAAAGGACCTAATGAAAAACTGTTTTTT	CASSPGAKGPNEKLFF	TRBV5-1	TRBJ1-4
TGTGCCAGCAGCTTACCCTTGCCCGAAGAGGGGGGCACCGCGAAGGGGAACACTGAAGCTTTCTTT	CASSLPLPEEGGTAKGNTEAFF	TRBV7-4	TRBJ1-1
TGTGCCAGCAGTTTAATGGGACTAGACAATGAGCAGTTCTTC	CASSLMGLDNEQFF	TRBV27	TRBJ2-1
TGTGCCAGCGGAGACGAGGATGGCTACACCTTC	CASGDEDGYTF	TRBV6-3	TRBJ1-2
TGTGCCCGGGACGGAAATGGCTACACCTTC	CARDGNGYTF	TRBV9	TRBJ1-2
TGTGCCAGCAGCGAGACTAGCGGATCAGATACGCAGTATTTT	CASSETSGSDTQYF	TRBV9	TRBJ2-3
TGTGCCAGTAGTATCGGGAGGACCCCGACACCCTATGGCTACACCTTC	CASSIGRTPTPYGYTF	TRBV19	TRBJ1-2
TGTGCCAGCAGCCCACATAAGAGAGATACGCAGTATTTT	CASSPHKRDTQYF	TRBV11-2	TRBJ2-3
TGTGCCAGCATCGCTAGCGGGGAGCAGTACTTC	CASIASGEQYF	TRBV25-1	TRBJ2-7
TGTGCCAGCAGCCACCCCGACAGGGGGAGGCTCAGCTCCTATAATTCACCCCTCCACTTT	CASSHPDRGRLSSYNSPLHF	TRBV4-2	TRBJ1-6
TGTGCCAGCAGTACAGCCCCAAGGACGCGCGGTGGGGAGCAGTACTTC	CASSTAPRTRGGEQYF	TRBV27	TRBJ2-7
TGCGCCAGCAGCGGATCCCCGGGACAGGGTGGAGGTAGGCCTAGCTACACCTTC	CASSGSPGQGGGRPSYTF	TRBV5-1	TRBJ1-2
TGTGCCAGCAGCAGAAAGGTATTAATAATCAGCTCTGGAAACACCATATATTTT	CASSRKVLIISSGNTIYF	TRBV7-3	TRBJ1-3
TGTGCCTGGAGATGGGGGGGCGGGCGCACAGATACGCAGTATTTT	CAWRWGGGRTDTQYF	TRBV30	TRBJ2-3
TGTGCCAGCTCACCCACCATAACGGGCTATGGCTACACCTTC	CASSPTITGYGYTF	TRBV18	TRBJ1-2
TGTGCTAGTGGTTCGCCGGGTTACGAGCAGTACTTC	CASGSPGYEQYF	TRBV12-5	TRBJ2-7
TGTGCCAGCAGCCAAGATAACCCTGCCCCACTCTCAGGGTCTGTTGAAAAACTGTTTTTT	CASSQDNPAPLSGSVEKLFF	TRBV14	TRBJ1-4
TGCGCCAGCAGCCAAGATCCCCCCCAGACCCTTTATTATGGCTACACCTTC	CASSQDPPQTLYYGYTF	TRBV4-1	TRBJ1-2
TGTGCCAGCAGCTTATGCAGGGAACCCCAGCATTTT	CASSLCREPQHF	TRBV7-9	TRBJ1-5
TGTGCCAGCAGTTTATGTAGGGGAGGCGGGGGCACAGATACGCAGTATTTT	CASSLCRGGGGTDTQYF	TRBV27	TRBJ2-3
TGTGCCAGCAGTTCCCCGTGGCAGCTGGGAGCCAATCAGCCCCAGCATTTT	CASSSPWQLGANQPQHF	TRBV7-3	TRBJ1-5
TGTGCCAGCAGCGCCGGGACAGGGCCCCAAGAGACCCAGTACTTC	CASSAGTGPQETQYF	TRBV7-4	TRBJ2-5
TGTGCCAGCAGCCGGGCATCAGGGGGCAGAAGAGAGCAGTACTTC	CASSRASGGRREQYF	TRBV9	TRBJ2-7
TGTGCCAGCAGCGTAGTAGTCGGACAGGGCGAGCAGTACTTC	CASSVVVGQGEQYF	TRBV9	TRBJ2-7
TGTGCCAGCAGTGACACAGGGCTCATCTACGAGCAGTACTTC	CASSDTGLIYEQYF	TRBV6-4	TRBJ2-7
TGCAGTGCTAGCCCTTACCGCAATCAGCCCCAGCATTTT	CSASPYRNQPQHF	TRBV20-1	TRBJ1-5
TGTGCCACCAGCAACTGGGATAGCGGCAGGTCTAATGAGCAGTTCTTC	CATSNWDSGRSNEQFF	TRBV15	TRBJ2-1
TGTGCCAGCAGCCCTCAGGGGAGCTATGGCTACACCTTC	CASSPQGSYGYTF	TRBV13	TRBJ1-2
TGTGCCAGCAGTGGGGGAAATCGATCTACGGAGCAGTACTTC	CASSGGNRSTEQYF	TRBV6-5	TRBJ2-7
TGTGCCAGCAGCTTTAACAGGGGCCGAACTAATGAAAAACTGTTTTTT	CASSFNRGRTNEKLFF	TRBV5-4	TRBJ1-4
TGTGCCAGCTCAGAGCAGGGCCATGGCTACACCTTC	CASSEQGHGYTF	TRBV18	TRBJ1-2
TGTGCCACCAGGGGGCACACTGAAGCTTTCTTT	CATRGHTEAFF	TRBV24-1	TRBJ1-1
TGCAGCGTCATCCAGGGTGTCTGTGAAGGTGAGCAGTTCTTC	CSVIQGVCEGEQFF	TRBV29-1	TRBJ2-1
TGTGCCAGCAGCTTATGTCTCTCAGTGAGGAACACTGAAGCTTTCTTT	CASSLCLSVRNTEAFF	TRBV11-2	TRBJ1-1
TGCAGTGCTAACGGGACAGGTAGGCGGGGAAACACCATATATTTT	CSANGTGRRGNTIYF	TRBV20-1	TRBJ1-3
TGTGCCAGCAGCACGACGGGGAGCCGGGGGCGAGCCAAAAACATTCAGTACTTC	CASSTTGSRGRAKNIQYF	TRBV13	TRBJ2-4
TGTGCCAGCAGCCAAGATACGACAGGGGGCCAGCACCAAGGACCTAGCAATCAGCCCCAGCATTTT	CASSQDTTGGQHQGPSNQPQHF	TRBV4-2	TRBJ1-5
TGTGCCAGCAGTGATTCAGACAGGTACGGGGACTACGAGCAGTACTTC	CASSDSDRYGDYEQYF	TRBV25-1	TRBJ2-7
TGTGCCACCAGTGATTTGATAGCGGGAGGAGTTTTGGAGACCCAGTACTTC	CATSDLIAGGVLETQYF	TRBV24-1	TRBJ2-5
TGTGCCACCAGCCCCAGGGGTACCTACACTGAAGCTTTCTTT	CATSPRGTYTEAFF	TRBV24-1	TRBJ1-1
TGCAGTGCTAGAGATCTCCGCACAGGGGGCTTTACAAGATGTCAAAGTAATGAAAAACTGTTTTTT	CSARDLRTGGFTRCQSNEKLFF	TRBV20-1	TRBJ1-4
TGTGCCAGCAGTTACTCGATTATGAGGGTGGCCGTAATGCGTGTTGAAAAACTGTTTTTT	CASSYSIMRVAVMRVEKLFF	TRBV6-6	TRBJ1-4
TGTGCCAGCAGTTACTCGAGAACGGGACAGGGTCCTTGCAATCAGCCCCAGCATTTT	CASSYSRTGQGPCNQPQHF	TRBV6-3	TRBJ1-5
TGTGCCAGCAGCCAAGGCAAGTATAAACCGAACACAGATACGCAGTATTTT	CASSQGKYKPNTDTQYF	TRBV14	TRBJ2-3
TGTGCCAGCAGCCCGGGGGACGGCAATCGGAACACTGAAGCTTTCTTT	CASSPGDGNRNTEAFF	TRBV9	TRBJ1-1
TGTGCCAGAGTGGTAGTTTCATACAATGAGCAGTTCTTC	CARVVVSYNEQFF	TRBV12-4	TRBJ2-1
TGTGCCAGCATGCGGACGACCGACCAAGAGACCCAGTACTTC	CASMRTTDQETQYF	TRBV6-1	TRBJ2-5
TGCAGCGCCCAAAGGGGCATCCATAACTTT	CSAQRGIHNF	TRBV29-1	TRBJ1-1
TGCGCCAGCAGCAAAGACAGGGAAGTTACGAACACTGAAGCTTTCTTT	CASSKDREVTNTEAFF	TRBV5-1	TRBJ1-1
TGTGCCAGCAGCTATAAGGTAGGGGCAGATACGCAGTATTTT	CASSYKVGADTQYF	TRBV7-6	TRBJ2-3
TGTGCCAGCAGCTTAGTTCTTATAGTCCCCCGCACAGATACGCAGTATTTT	CASSLVLIVPRTDTQYF	TRBV11-2	TRBJ2-3
TGTGCCAGCAGCCGTGAATCCCCGACTACTAACTATGGCTACACCTTC	CASSRESPTTNYGYTF	TRBV6-4	TRBJ1-2
TGTGCCAGTAGTCTCAGGGAATATACTAATCAGCCCCAGCATTTT	CASSLREYTNQPQHF	TRBV19	TRBJ1-5
TGTGCCAGCAGATTCGAGCTGATTTCCTCGGCTTTCTTT	CASRFELISSAFF	TRBV9	TRBJ1-1
TGTGCCAGCAGCCTGGGGGACAGGATTACTGAAGCTTTCTTT	CASSLGDRITEAFF	TRBV7-3	TRBJ1-1
TGTGCCAGCAGTACTCCTGGGGGGGCCTACAATGAGCAGTTCTTC	CASSTPGGAYNEQFF	TRBV11-3	TRBJ2-1
TGTGCCAGCAGCTGTTCTGCCAGCCGGACAGGGGAAGACTCCGGGGAGCTGTTTTTT	CASSCSASRTGEDSGELFF	TRBV5-6	TRBJ2-2
TGTGCCAGCAGCCCCAAAATTCCGGGCAGGGGGCTTTCTAACTATGGCTACACCTTC	CASSPKIPGRGLSNYGYTF	TRBV4-2	TRBJ1-2
TGTGCCAGTAGTCGACCCAACTGTATGAGCTCCTACGAGCAGTACTTC	CASSRPNCMSSYEQYF	TRBV19	TRBJ2-7
TGCAGTGCTAGAGCGAGGGCACAAGAGACCCAGTACTTC	CSARARAQETQYF	TRBV20-1	TRBJ2-5
TGTGCCAGCAGCTTACAGATGCACTCTGGAAACACCATATATTTT	CASSLQMHSGNTIYF	TRBV7-9	TRBJ1-3
TGTGCCACCAGTGGGCTAGCTTACAATGAGCAGTTCTTC	CATSGLAYNEQFF	TRBV24-1	TRBJ2-1
TGTGCCAGCAGCCCCAATGACCGGGTCTCCTACAATGAGCAGTTCTTC	CASSPNDRVSYNEQFF	TRBV7-3	TRBJ2-1
TGCAGCGTAGTAAGTACTCTAGCGGGTTTCAATGAGCAGTTCTTC	CSVVSTLAGFNEQFF	TRBV29-1	TRBJ2-1
TGTGCCAGCAGCTCAGGAGGGGGAAGTAGGTACGAGCAGTACTTC	CASSSGGGSRYEQYF	TRBV13	TRBJ2-7
TGTGCCAGCAGTGGCGAGGATGGTAGAAACACCATATATTTT	CASSGEDGRNTIYF	TRBV6-4	TRBJ1-3
TGTGCCAGCACCCAAGGGGTGACTGAAGCTTTCTTT	CASTQGVTEAFF	TRBV2	TRBJ1-1
TGTGCCAGCTCGGGGCGGGTCAATGAGCAGTTCTTC	CASSGRVNEQFF	TRBV6-1	TRBJ2-1
TGTGCCAGCAGCTCGGGGGCGGACAGGGAGGATGGCTACACCTTC	CASSSGADREDGYTF	TRBV11-2	TRBJ1-2
TGCAGTGCTCTGTCCCTTATGATGTCCGACTATGGCTACACCTTC	CSALSLMMSDYGYTF	TRBV20-1	TRBJ1-2
TGTGCCAGCAGCTTAGGGAACCGGGACAGGGTCTCCCACGAGCAGTACTTC	CASSLGNRDRVSHEQYF	TRBV13	TRBJ2-7
TGTGCCAGCAGTTTCGAGGACTTTGTAAACGGATTGAGCTCCTACAATGAGCAGTTCTTC	CASSFEDFVNGLSSYNEQFF	TRBV12-4	TRBJ2-1
TGTGCCAGCAGCTTGAAAGGGGGGGGCACAGATACGCAGTATTTT	CASSLKGGGTDTQYF	TRBV5-4	TRBJ2-3
TGTGCCAGCAGTGGGAGGGGGCGGTATAGCAATCAGCCCCAGCATTTT	CASSGRGRYSNQPQHF	TRBV12-4	TRBJ1-5
TGTGCCAGACCGGACAGGACTATCTATGGCTACACCTTC	CARPDRTIYGYTF	TRBV19	TRBJ1-2
TGCAAACGGACTCCTCCAGATACGCAGTATTTT	CKRTPPDTQYF	TRBV20-1	TRBJ2-3
TGTGCCAGCAGCCCCTTCGCGGCCACCGGGGAGCTGTTTTTT	CASSPFAATGELFF	TRBV13	TRBJ2-2
TGTGCCAGCAGCCAAGATCGGGAGCCACCCCTCAGCACAGATACGCAGTATTTT	CASSQDREPPLSTDTQYF	TRBV14	TRBJ2-3
TGCGCCAGCAGCTCATATGACAGCGGAAACACCATATATTTT	CASSSYDSGNTIYF	TRBV5-1	TRBJ1-3
TGTGCCAGCAGTTACCTGACGGAGGGCTCTAACTATGGCTACACCTTC	CASSYLTEGSNYGYTF	TRBV6-5	TRBJ1-2
TGCAGTGCTAGAACTAGCGGTAAGCAGTACTTC	CSARTSGKQYF	TRBV20-1	TRBJ2-7
TGTGCCAGCAGTTTAGAGAGACAGTGGCCCTACGAGCAGTACTTC	CASSLERQWPYEQYF	TRBV12-3	TRBJ2-7
TGTGCCATCAGTGGGTCTAGGGGAAACACCATATATTTT	CAISGSRGNTIYF	TRBV10-3	TRBJ1-3
TGTGCCAGCAGCTTAGTGCTGGATGGCTACACCTTC	CASSLVLDGYTF	TRBV11-1	TRBJ1-2
TGTGCCAGCAGTCGGCAGGAAAATGGCTACACCTTC	CASSRQENGYTF	TRBV27	TRBJ1-2
TGTGCCACCATTGGACAGAGGACTAATGAAAAACTGTTTTTT	CATIGQRTNEKLFF	TRBV24-1	TRBJ1-4
TGCGCCAGCAGTGAATCGCCGGGACCCCCTGACACTGAAGCTTTCTTT	CASSESPGPPDTEAFF	TRBV10-1	TRBJ1-1
TGTGCCAGCAGCTTATCCCCAAGCTTATTAGCCTACAATGAGCAGTTCTTC	CASSLSPSLLAYNEQFF	TRBV7-3	TRBJ2-1
TGTGCCAGCAGCCAACCGAAGGAGGGCAATCAGCCCCAGCATTTT	CASSQPKEGNQPQHF	TRBV3-1	TRBJ1-5
TGTGCCAGCAGCCTTCCCCAGATTGACACAGATACGCAGTATTTT	CASSLPQIDTDTQYF	TRBV13	TRBJ2-3
TGTGCCAGCAGCGGGACCGTAGCAGGACGCAATGAGCAGTTCTTC	CASSGTVAGRNEQFF	TRBV7-8	TRBJ2-1
TGCAGCGCCACAAGGGGCCATGGCTACACCTTC	CSATRGHGYTF	TRBV29-1	TRBJ1-2
TGTGCCAGCAGCTTAGCCGGGGGGGGGGGGTCACCCCTCCACTTT	CASSLAGGGGSPLHF	TRBV7-8	TRBJ1-6
TGCAGGTTCCGGACAGGGGTGGATCAGCCCCAGCATTTT	CRFRTGVDQPQHF	TRBV29-1	TRBJ1-5
TGCGCCAGCAGCCAAGCCGGCAAGGGACCGTATGGCTACACCTTC	CASSQAGKGPYGYTF	TRBV4-1	TRBJ1-2
TGTGCCAGCAGACCCGGGGGGGGGCCCGGGGAGCTGTTTTTT	CASRPGGGPGELFF	TRBV27	TRBJ2-2
TGTGCCAGCAGCTTAAACCAGGAGTGTCGCTACGAGCAGTACTTC	CASSLNQECRYEQYF	TRBV7-9	TRBJ2-7
TGTGCCAGCAGCGGGGGAATGAGGGGTCGTGCTGAAGCTTTCTTT	CASSGGMRGRAEAFF	TRBV7-4	TRBJ1-1
TGTGCCAGCAGCCTGCTGGGGACAGTACGGGAAAAACTGTTTTTT	CASSLLGTVREKLFF	TRBV14	TRBJ1-4
TGTGCCAGCGTCACATTAGGGGGGCCAGGCTACACCTTC	CASVTLGGPGYTF	TRBV2	TRBJ1-2
TGCGCCTCCGGGACCATAGCCTCCAACTCTGGGGCCAACGTCCTGACTTTC	CASGTIASNSGANVLTF	TRBV10-1	TRBJ2-6
TGTGCCACCAGGGACCGTAACGAGCAGTACTTC	CATRDRNEQYF	TRBV10-3	TRBJ2-7
TGTGCCAGCAGTTACTCGGCCCTACATTATGGCTACACCTTC	CASSYSALHYGYTF	TRBV6-8	TRBJ1-2
TGTGCCAGCAGCGTACCAAGGGACTTTGATACGCAGTATTTT	CASSVPRDFDTQYF	TRBV7-4	TRBJ2-3
TGTGCCAGCAGCCTAGCGGGGGCTGGGGCCAATGAGCAGTTCTTC	CASSLAGAGANEQFF	TRBV13	TRBJ2-1
TGTGCCAGCAGAGTAGCGGGGAAAGCCTACGAGCAGTACTTC	CASRVAGKAYEQYF	TRBV6-3	TRBJ2-7
TGTGCCAGCAGCTTGGGACCAGGGAGTAACTATGGCTACACCTTC	CASSLGPGSNYGYTF	TRBV5-6	TRBJ1-2
TGTGCCAGCACTCCGAGCGGGAGGAATGAGCAGTTCTTC	CASTPSGRNEQFF	TRBV2	TRBJ2-1
TGTGCCAGCACTAACACCCCCTTACACGCCTACGAGCAGTACTTC	CASTNTPLHAYEQYF	TRBV5-6	TRBJ2-7
TGTGCCAGCACCCCAGGGATATATGGCTACACCTTC	CASTPGIYGYTF	TRBV11-3	TRBJ1-2
TGTGCCAGCAGTTACCGGGGGGGGGGGGCCCAGGATACGCAGTATTTT	CASSYRGGGAQDTQYF	TRBV27	TRBJ2-3
TGTGCCAGCACATCAAGGGCTGGGGCCAACGTCCTGACTTTC	CASTSRAGANVLTF	TRBV27	TRBJ2-6
TGTGCCAGCAGCGTAGTGGGAACAGGGACTAGCGGGGGGACACCGGCGAACACCGGGGAGCTGTTTTTT	CASSVVGTGTSGGTPANTGELFF	TRBV9	TRBJ2-2
TGTGCTAGTGGTTGTTGGGCCGCTGGCAATCAGCCCCAGCATTTT	CASGCWAAGNQPQHF	TRBV12-5	TRBJ1-5
TGTGCCAGCAGCCCTGTAAGGGGGAGGGAGACCCAGTACTTC	CASSPVRGRETQYF	TRBV5-4	TRBJ2-5
TGTGCCAGCAGCTCCGCCGGGCGCGCGGTCAATCAGCCCCAGCATTTT	CASSSAGRAVNQPQHF	TRBV7-8	TRBJ1-5
TGTGCCAGCCCTAGGGAGAACCTGAACACCGGGGAGCTGTTTTTT	CASPRENLNTGELFF	TRBV25-1	TRBJ2-2
TGTGCCAGCACTAGCGTAAGCTCCTACAATGAGCAGTTCTTC	CASTSVSSYNEQFF	TRBV27	TRBJ2-1
TGTGCCAGCTTACAGGGGTCCTATAATTCACCCCTCCACTTT	CASLQGSYNSPLHF	TRBV12-3	TRBJ1-6
TGCAGCGTCCTCCCCCCTAGCGGGCGGGGTTACGAGCAGTACTTC	CSVLPPSGRGYEQYF	TRBV29-1	TRBJ2-7
TGTGCCAGCAGCCCCGGAACGGGGGGTGGCTACGAGCAGTACTTC	CASSPGTGGGYEQYF	TRBV6-4	TRBJ2-7
TGTGCCATCATCAAGGGACTAGCGGGAATTAACAATGAGCAGTTCTTC	CAIIKGLAGINNEQFF	TRBV10-3	TRBJ2-1
TGTGCCAGCAGCAAGTCGGTCCATAGTTACACTGAAGCTTTCTTT	CASSKSVHSYTEAFF	TRBV13	TRBJ1-1
TGTGCCAGCAGCACACGGACCGCGACGGGCGTTAACTATGGCTACACCTTC	CASSTRTATGVNYGYTF	TRBV13	TRBJ1-2
TGTGCCAGCAGCCCTACCACAGCCTATTTGGGCAGCTCCTACAATGAGCAGTTCTTC	CASSPTTAYLGSSYNEQFF	TRBV7-8	TRBJ2-1
TGTGCCTGGTATCGGGCAGGGCAGAGAGATACGCAGTATTTT	CAWYRAGQRDTQYF	TRBV30	TRBJ2-3
TGCGCCAGCAAACTCCGAGGGGGGGACAATGAGCAGTTCTTC	CASKLRGGDNEQFF	TRBV10-1	TRBJ2-1
TGTGCCAGCAGAGGGGCGGAGCCCTACGAGCAGTACTTC	CASRGAEPYEQYF	TRBV28	TRBJ2-7
TGTGCCAGCAGACAGGTAAATGCGCAAGAGACCCAGTACTTC	CASRQVNAQETQYF	TRBV3-1	TRBJ2-5
TGTGCCACCTCTAGTGAACAAGAGACCCAGTACTTC	CATSSEQETQYF	TRBV28	TRBJ2-5
TGTGCCAGCAGCGAAGGGACAGGGTATAATTCACCCCTCCACTTT	CASSEGTGYNSPLHF	TRBV11-3	TRBJ1-6
TGTGCCAGCAGCTTCACCCCCTGCAGGGGGCCCGAGCAGTACTTC	CASSFTPCRGPEQYF	TRBV7-9	TRBJ2-7
TGTGCCACCAGTGAGAAACTATCTGAAGCTTTCTTT	CATSEKLSEAFF	TRBV24-1	TRBJ1-1
TGCGCCAGCAGCTTGGCGGAAGGGACCCGGCAGTACTTC	CASSLAEGTRQYF	TRBV5-1	TRBJ2-7
TGTGCCAGCAGCTTAGCTAGCGGGGGGTGCGCCTCCTACGAGCAGTACTTC	CASSLASGGCASYEQYF	TRBV7-9	TRBJ2-7
TGTGCCAGCAGCTTAGCAGGACTAGGTGACGAGCAGTACTTC	CASSLAGLGDEQYF	TRBV7-4	TRBJ2-7
TGTGCCAGCAGCTTAGCAGTCAGAAACACCATATATTTT	CASSLAVRNTIYF	TRBV7-9	TRBJ1-3
TGTGCCAGCAGTGAATACCTAGCGACTACCTACAATGAGCAGTTCTTC	CASSEYLATTYNEQFF	TRBV25-1	TRBJ2-1
TGTGCCAGCAGCTTTCTTCAGCCCCAGCATTTT	CASSFLQPQHF	TRBV4-2	TRBJ1-5
TGTGCCAGCAGCTTGTGTTGCACGGGGAAAGAGACCCAGTACTTC	CASSLCCTGKETQYF	TRBV5-5	TRBJ2-5
TGCGCCAGCAGCTTGGGGACCGATGAAGCTTTCTTT	CASSLGTDEAFF	TRBV5-1	TRBJ1-1
TGTGCCAGCAGCTCACAGGAGCAAGAGACCCAGTACTTC	CASSSQEQETQYF	TRBV7-3	TRBJ2-5
TGTGCCAGCAGCCAAGATCGCCACGCTGTATATGAAGAGACCCAGTACTTC	CASSQDRHAVYEETQYF	TRBV4-2	TRBJ2-5
TGTGCCAGCACCCTAGACTTGCAGTACTTC	CASTLDLQYF	TRBV28	TRBJ2-7
TGTGCCAGCAGCTTACGCGGTAGCCACGAGCAGTACTTC	CASSLRGSHEQYF	TRBV11-2	TRBJ2-7
TGTGCTAAGGGGACAAATGAGCAGTTCTTC	CAKGTNEQFF	TRBV6-2	TRBJ2-1
TGCAGTGCTGTAACCCCAGGGGCAAACAATCAGCCCCAGCATTTT	CSAVTPGANNQPQHF	TRBV20-1	TRBJ1-5
TGCGCCAGCAGCCAAGATCATCACAGCAATGGCCGCAATCAGCCCCAGCATTTT	CASSQDHHSNGRNQPQHF	TRBV4-3	TRBJ1-5
TGTGCCAGCAGCTTAGGTACCTCGAGGCAGGCTGAAGCTTTCTTT	CASSLGTSRQAEAFF	TRBV7-8	TRBJ1-1
TGTGCCAGCAGCGTAGGGACAGGGGATCAGCCTGGAAACACCATATATTTT	CASSVGTGDQPGNTIYF	TRBV9	TRBJ1-3
TGTGCCAGCAGCCAAGTGAGACATCCTCGGGATCAGCCCCAGCATTTT	CASSQVRHPRDQPQHF	TRBV3-1	TRBJ1-5
TGTGCCAGCAGCTTAGAGCGGCCGGGTTTTCCGCATGAGCAGTTCTTC	CASSLERPGFPHEQFF	TRBV7-2	TRBJ2-1
TGTGCCAGCAGCATCGGGACAGGCTCCACCTACAATGAGCAGTTCTTC	CASSIGTGSTYNEQFF	TRBV9	TRBJ2-1
TGCAGTGCTAGAGGGGGACTCTATGGCTACACCTTC	CSARGGLYGYTF	TRBV20-1	TRBJ1-2
TGCGCCAGCAGCTACTCTTGGGGTTGGATCACTAATGAAAAACTGTTTTTT	CASSYSWGWITNEKLFF	TRBV5-1	TRBJ1-4
TGTGCCAGCAGCCAGGCGGTACCGGGACAGGCGTCCGGGGAGCTGTTTTTT	CASSQAVPGQASGELFF	TRBV7-2	TRBJ2-2
TGTGCCAGCAGTGGGAATGAGACAGGGCTCAGCTCCTACGAGCAGTACTTC	CASSGNETGLSSYEQYF	TRBV6-1	TRBJ2-7
TGTGCCACCAGCAGCCGGGGCATATCCCAGCATTTT	CATSSRGISQHF	TRBV15	TRBJ1-5
TGCAGTGCTAGACGGACGAGTAACTATGGCTACACCTTC	CSARRTSNYGYTF	TRBV20-1	TRBJ1-2
TGTGCCAGCAGCGGGCCGGGACAGTGCTACACCTTC	CASSGPGQCYTF	TRBV11-3	TRBJ1-2
TGTGCCAGCAGCCTGGGGCCAGATAACTATGGCTACACCTTC	CASSLGPDNYGYTF	TRBV7-2	TRBJ1-2
TGTGCCAGCAGCAAGGCCGTAAGGCCCATCTCTGGAAACACCATATATTTT	CASSKAVRPISGNTIYF	TRBV7-3	TRBJ1-3
TGCGCCAGCAGCCCACAGGGGGAAACCAATGAAAAACTGTTTTTT	CASSPQGETNEKLFF	TRBV5-1	TRBJ1-4
TGTGCCAGTAGTCCATCAGTAGAAGCTTTCTTT	CASSPSVEAFF	TRBV19	TRBJ1-1
TGCAGTAGTGGGGACAGGCTACGGCAGCCCCAGCATTTT	CSSGDRLRQPQHF	TRBV20-1	TRBJ1-5
TGTGCCAGCAGCTCTTCGATAGCGGGGAACAACTTC	CASSSSIAGNNF	TRBV7-2	TRBJ2-5
TGCGCCAGCGATGGGTTCTCCCCCCTCGGGGGGGGCTACGAGCAGTACTTC	CASDGFSPLGGGYEQYF	TRBV4-1	TRBJ2-7
TGCGCCAGCAGCTCCTGCCTGATGGCCTACAATGAGCAGTTCTTC	CASSSCLMAYNEQFF	TRBV5-1	TRBJ2-1
TGTGCCAGCAGTTATTTACATCCAGGGAATGAAAAACTGTTTTTT	CASSYLHPGNEKLFF	TRBV6-5	TRBJ1-4
TGTGCCAGCAGTTTCCCTAGGTCACCCCTCCACTTT	CASSFPRSPLHF	TRBV12-3	TRBJ1-6
TGTGCCAGCAGCCTTTCGGACATGTATGAGCAGTTCTTC	CASSLSDMYEQFF	TRBV13	TRBJ2-1
TGTGCCAGCAGTGAGGATTGGGGGGAAGTAGCTGGAAACACCATATATTTT	CASSEDWGEVAGNTIYF	TRBV6-1	TRBJ1-3
TGCAGCGTTGAGGCCGGGACTAGTCCCTACGAGCAGTACTTC	CSVEAGTSPYEQYF	TRBV29-1	TRBJ2-7
TGTGCCAGCAGCTTTGAAAGAACCAAGCGCACAGATACGCAGTATTTT	CASSFERTKRTDTQYF	TRBV7-9	TRBJ2-3
TGCGCCAGCAGCCAAGGGGACAGGGTCGAGCAGTACTTC	CASSQGDRVEQYF	TRBV4-1	TRBJ2-7
TGTGCCAGCAGCGCCCAGCCGACAGGGGTGAAGCTTTGGTACGAGCAGTACTTC	CASSAQPTGVKLWYEQYF	TRBV7-2	TRBJ2-7
TGTGCCAGCAGTTACAGCAGGGGAACTGAAGCTTTCTTT	CASSYSRGTEAFF	TRBV6-2	TRBJ1-1
TGTGCCAGCAGCGCGGACTCCCACACTGAAGCTTTCTTT	CASSADSHTEAFF	TRBV7-4	TRBJ1-1
TGTGCCATCAGGATCCGGGTTCGCCCCCTCTACGAGCAGTACTTC	CAIRIRVRPLYEQYF	TRBV10-3	TRBJ2-7
TGTGCCAGCAGCGCACACGAGTATGGCTACACCTTC	CASSAHEYGYTF	TRBV7-9	TRBJ1-2
TGTGCCGGCCCCTGGGGGGTCCACAATGAGCAGTTCTTC	CAGPWGVHNEQFF	TRBV27	TRBJ2-1
TGTGCCAGCAGTTACGCAGAAGATAGAAATGAAAAACTGTTTTTT	CASSYAEDRNEKLFF	TRBV6-5	TRBJ1-4
TGTGCCAGCAAGCTGCAGGGGGGGAGTTATCAGCCCCAGCATTTT	CASKLQGGSYQPQHF	TRBV9	TRBJ1-5
TGCGCCAGCAGGAAGGGTGGAGATACGCAGTATTTT	CASRKGGDTQYF	TRBV10-1	TRBJ2-3
TGTGCCAGGGGGGAGGGAGGAGATACGCAGTATTTT	CARGEGGDTQYF	TRBV28	TRBJ2-3
TGTGCCAGCAGTTTCCGACGGAACGAGCAGTACTTC	CASSFRRNEQYF	TRBV12-3	TRBJ2-7
TGTGCCAGCAGCTCCTACTCCACAGATACGCAGTATTTT	CASSSYSTDTQYF	TRBV7-9	TRBJ2-3
TGTGCCAGCAGCGTGGCCCCGAGGGGGGCAAGATATAGCAATCAGCCCCAGCATTTT	CASSVAPRGARYSNQPQHF	TRBV9	TRBJ1-5
TGTGCCAGCAGCTTCAGGCAGGGAGCGGAGACCCAGTACTTC	CASSFRQGAETQYF	TRBV13	TRBJ2-5
TGTGCCAGCAGCTTACATCGACAGGCGGGCACCTCTGGGGCCAACGTCCTGACTTTC	CASSLHRQAGTSGANVLTF	TRBV7-9	TRBJ2-6
TGTGCCAGCAGTTACACAAGTGAGCAGGAGTCGGACAATCAGCCCCAGCATTTT	CASSYTSEQESDNQPQHF	TRBV6-3	TRBJ1-5
TGTGCCAGCAGCTTGGTTCTCTTCGGATATGAGCAGTTCTTC	CASSLVLFGYEQFF	TRBV5-4	TRBJ2-1
TGTGCCTCCCTCCTGGGACAGAGACGTAACTATGGCTACACCTTC	CASLLGQRRNYGYTF	TRBV30	TRBJ1-2
TGTGCTTCAAGGGCCCGGAATGAGCAGTTCTTC	CASRARNEQFF	TRBV28	TRBJ2-1
TGCAGCGTGTCTTTCGGGACTACCGGGGAGCTGTTTTTT	CSVSFGTTGELFF	TRBV29-1	TRBJ2-2
TGCAGTGCCCGAGGGGACAGGGAACCAGAGACCCAGTACTTC	CSARGDREPETQYF	TRBV20-1	TRBJ2-5
TGTGCCAGCACAAGGGTCCGGGAGTGCACTGAAGCTTTCTTT	CASTRVRECTEAFF	TRBV2	TRBJ1-1
TGCGCCAGCAGCCAAGTAGCCGGGACAGGGGAAAGGAGCTCCTATAATTCACCCCTCCACTTT	CASSQVAGTGERSSYNSPLHF	TRBV4-1	TRBJ1-6
TGTGCCAGTAGTATGTATAGGACAGGGTTGATTTACGAGCAGTACTTC	CASSMYRTGLIYEQYF	TRBV19	TRBJ2-7
TGTGCCAGCAGTGGGAGGGGTCCCGAATATGGCTACACCTTC	CASSGRGPEYGYTF	TRBV28	TRBJ1-2
TGTGCCAGCAGTTTGTCTAGCGGGTTAAAAAATGAGCAGTTCTTC	CASSLSSGLKNEQFF	TRBV6-3	TRBJ2-1
TGTGCCAGCAGCGACAGTGGCGGGGAGCTGTTTTTT	CASSDSGGELFF	TRBV7-3	TRBJ2-2
TGTGCCAGCAGGAGCTCTCCCCGCACAGATACGCAGTATTTT	CASRSSPRTDTQYF	TRBV9	TRBJ2-3
TGTGCCATCAGGACCCCTAGCGGGAAAGGCACAGATACGCAGTATTTT	CAIRTPSGKGTDTQYF	TRBV10-3	TRBJ2-3
TGCGCCAGCAGTATCAGGGGGTTAACAGATACGCAGTATTTT	CASSIRGLTDTQYF	TRBV4-3	TRBJ2-3
TGCGCCAGCAGCTTGGTGATAAGGGTAAACACCATATATTTT	CASSLVIRVNTIYF	TRBV5-1	TRBJ1-3
TGTGCCAGCAGCTGGACGGCGAGTGAGCAGTACTTC	CASSWTASEQYF	TRBV7-2	TRBJ2-7
TGCAGTGCACAGGGGAAACCCTCCTACAATGAGCAGTTCTTC	CSAQGKPSYNEQFF	TRBV20-1	TRBJ2-1
TGTGCCAGCAGTTACTTGCGGCGGGGGCGGGGCTACGAGCAGTACTTC	CASSYLRRGRGYEQYF	TRBV6-5	TRBJ2-7
TGTGCCAGCAGTCCAGACGGGAGCAATCAGCCCCAGCATTTT	CASSPDGSNQPQHF	TRBV6-3	TRBJ1-5
TGTGCCAGCAGTCCAGGCGGGGAGCCCACTGAAGCTTTCTTT	CASSPGGEPTEAFF	TRBV6-3	TRBJ1-1
TGCGCCAGCAGCCAAGATCCGCCAGATTTTCCTCAGCCCCAGCATTTT	CASSQDPPDFPQPQHF	TRBV4-3	TRBJ1-5
TGTGCCAGCTCACCAAAACGGACAGGGGCTGCCAGCTCCTACGAGCAGTACTTC	CASSPKRTGAASSYEQYF	TRBV18	TRBJ2-7
TGTGCCAGCAGCAAAGATGACAGGGGTCCGTCGACAAAGGTAGAGACCCAGTACTTC	CASSKDDRGPSTKVETQYF	TRBV13	TRBJ2-5
TGCGCCAGCAGGAGCGGGACAGATACGCAGTATTTT	CASRSGTDTQYF	TRBV5-1	TRBJ2-3
TGTGCCAGCAGTGAGAGGGGGAACACTGAAGCTTTCTTT	CASSERGNTEAFF	TRBV6-4	TRBJ1-1
TGCGCCAGCAGCTGGGGCATGGTCATGAACACTGAAGCTTTCTTT	CASSWGMVMNTEAFF	TRBV5-1	TRBJ1-1
TGCAGTGCTAGGGAAGGGGACAGCGTCGCGAACACCGGGGAGCTGTTTTTT	CSAREGDSVANTGELFF	TRBV20-1	TRBJ2-2
TGTGCCAGCAGCAAGCCATTGCAGGGCAACACTGAAGCTTTCTTT	CASSKPLQGNTEAFF	TRBV5-4	TRBJ1-1
TGTGCCACCGGCAGCTTTGGGTTGGACAGGTTGTACTCTGGAAACACCATATATTTT	CATGSFGLDRLYSGNTIYF	TRBV24-1	TRBJ1-3
TGTGCCAGCAGGTGGACAGGGAAAGTGAACACTGAAGCTTTCTTT	CASRWTGKVNTEAFF	TRBV6-5	TRBJ1-1
TGCAGTGCTAGACGGAGCGGGGAGCTGTTTTTT	CSARRSGELFF	TRBV20-1	TRBJ2-2
TGTGCCAGCAGTGGAATCACAGGGGATTCCCAAGAGACCCAGTACTTC	CASSGITGDSQETQYF	TRBV6-1	TRBJ2-5
TGTGCCAGCAGTTGGAAGACAGGGGGAGGATGTGAAGGGAACACCGGGGAGCTGTTTTTT	CASSWKTGGGCEGNTGELFF	TRBV6-5	TRBJ2-2
TGTGCCAGCAGTTGCGGGGCACTGTACTTC	CASSCGALYF	TRBV6-5	TRBJ2-5
TGTGCCAGCAGGGGGACTACAGGAGGGCAGCGTTACGAGCAGTACTTC	CASRGTTGGQRYEQYF	TRBV6-1	TRBJ2-7
TGTGCCAGCAGTTACCAACGAATTACTAGCGGGAGGAACACCGGGGAGCTGTTTTTT	CASSYQRITSGRNTGELFF	TRBV6-3	TRBJ2-2
TGTGCCAGCAGTGAACTGTGCCCGGGGCGCAACAGGAACACTGAAGCTTTCTTT	CASSELCPGRNRNTEAFF	TRBV2	TRBJ1-1
TGTGCCAGCAGCCAAGCCCCAGGGATAACTAATGAAAAACTGTTTTTT	CASSQAPGITNEKLFF	TRBV3-1	TRBJ1-4
TGTGCCAGCTGTCGCCGGGACACGGACGAGCAGTACTTC	CASCRRDTDEQYF	TRBV5-6	TRBJ2-7
TGTGCCAGCAGCCCCGACAGGACGGTTCGGGGAGAGACCCAGTACTTC	CASSPDRTVRGETQYF	TRBV3-1	TRBJ2-5
TGTGCCAGCAGTGACTACAGGAATGAAAAACTGTTTTTT	CASSDYRNEKLFF	TRBV6-1	TRBJ1-4
TGCGCCAGCAGCCGTACCCCTCGACTAGCGCGGGGGGGGTACTTC	CASSRTPRLARGGYF	TRBV4-1	TRBJ2-7
TGTGTATCGGCCCAGGGAGAATACGAGCAGTACTTC	CVSAQGEYEQYF	TRBV10-3	TRBJ2-7
TGTGCCAGCAGCCGGTGGGGACAGGACTACGAGCAGTACTTC	CASSRWGQDYEQYF	TRBV9	TRBJ2-7
TGTGCTAGTGGTTTACGGGGGCACGGATTGGCAACTAATGAAAAACTGTTTTTT	CASGLRGHGLATNEKLFF	TRBV12-5	TRBJ1-4
TGTGCCAGCGGTAGAGGGGGCTACACCTTC	CASGRGGYTF	TRBV2	TRBJ1-2
TGTGCCGGAAAGCAGCAGTTTAGGCCCCAGCATTTT	CAGKQQFRPQHF	TRBV27	TRBJ1-5
TGTGCCTGGATCCGGCGGAATCAGCCCCAGCATTTT	CAWIRRNQPQHF	TRBV30	TRBJ1-5
TGTGCCAGCAGTGTATTATTGACAGAACTCCGGTATCAGCCCCAGCATTTT	CASSVLLTELRYQPQHF	TRBV2	TRBJ1-5
TGTGCCAGAGCAGGGTTCGAAATGACCTACGAGCAGTACTTC	CARAGFEMTYEQYF	TRBV19	TRBJ2-7
TGTGCCAGCAGTTCCACGCTTAATCAGCCCCAGCATTTT	CASSSTLNQPQHF	TRBV28	TRBJ1-5
TGTGCCAGCAGCATGGGGGGGTTTGAAAAACTGTTTTTT	CASSMGGFEKLFF	TRBV5-4	TRBJ1-4
TGCGCCAGCAGGGGCTTAACCTACGAGCAGTACTTC	CASRGLTYEQYF	TRBV10-1	TRBJ2-7
TGTGCCAGCAGTGAAAGAGGAATCCAAGACCGGGACAGGGATCGGCAAGAACAGCCCCAGCATTTT	CASSERGIQDRDRDRQEQPQHF	TRBV6-4	TRBJ1-5
TGTGCCAGCAGTCCAGGAGGGTTGGGTCACAATGAGCAGTTCTTC	CASSPGGLGHNEQFF	TRBV6-5	TRBJ2-1
TGCGCCAGCAGCAAGGACCTGTTTACTAATGAAAAACTGTTTTTT	CASSKDLFTNEKLFF	TRBV5-1	TRBJ1-4
TGCGCCAGCAGTTGGACAGGTTTGAACGAGCAGTACTTC	CASSWTGLNEQYF	TRBV10-1	TRBJ2-7
TGTGCCAGCAGCCTTTCCCTTATCCCAAAAGAGACTAGCGGGGGGTACAAATGTGAGCAGTTCTTC	CASSLSLIPKETSGGYKCEQFF	TRBV13	TRBJ2-1
TGTGCCAGCAGTGACGTCCGGAACACCGGGGAGCTGTTTTTT	CASSDVRNTGELFF	TRBV6-4	TRBJ2-2
TGTGCCAGCAGAACTCACGGCCTGTTCCAAGAGACCCAGTACTTC	CASRTHGLFQETQYF	TRBV12-4	TRBJ2-5
TGTGCCAGCAGCTTAGGGGAGCGGTTGGATGAGCAGTTCTTC	CASSLGERLDEQFF	TRBV11-2	TRBJ2-1
TGTGCCAGCAGCTCCCCGGACAGGTTCCTGAACACTGAAGCTTTCTTT	CASSSPDRFLNTEAFF	TRBV13	TRBJ1-1
TGTGCCAGCGACAGGGGTTATAGCAATCAGCCCCAGCATTTT	CASDRGYSNQPQHF	TRBV25-1	TRBJ1-5
TGTGCCAGCAGCCACAGGGGGCGGGCCAACACTGAAGCTTTCTTT	CASSHRGRANTEAFF	TRBV7-3	TRBJ1-1
TGCAGTGCTAGTTTGAGGGGCACCCAGTACTTC	CSASLRGTQYF	TRBV20-1	TRBJ2-5
TGCGCCAGCAGTGAGAATATACGCGCCTACGAGCAGTACTTC	CASSENIRAYEQYF	TRBV10-1	TRBJ2-7
TGCGCCAGCAGCACGGGCTACACCTTC	CASSTGYTF	TRBV5-1	TRBJ1-2
TGTGCCAGCAGCGAAAACCGTCTAGCGGGGGGGCCGGGGGCCTACAATGAGCAGTTCTTC	CASSENRLAGGPGAYNEQFF	TRBV9	TRBJ2-1
TGTGCCAGCAGTCGGGATAGGTACCGGCAAGAGACCCAGTACTTC	CASSRDRYRQETQYF	TRBV12-3	TRBJ2-5
TGTGCCAGCAGCTTAGACCGAGGGGTCTCCGAGCAGTACTTC	CASSLDRGVSEQYF	TRBV11-2	TRBJ2-7
TGTGCCAGCAGCGTAGCTAGGGTCTCCGTCAATCAGCCCCAGCATTTT	CASSVARVSVNQPQHF	TRBV9	TRBJ1-5
TGTGCCAGCAGTTACACCACTATTCGCGGAAAGACCCAGTACTTC	CASSYTTIRGKTQYF	TRBV6-5	TRBJ2-5
TGTGTAGGACGATCCTACGAGCAGTACTTC	CVGRSYEQYF	TRBV11-3	TRBJ2-7
TGTGCCAGCAGGCGGCGAGGCCCGAACACCGGGGAGCTGTTTTTT	CASRRRGPNTGELFF	TRBV6-1	TRBJ2-2
TGTGCCAGCAGCGGGACTAGCGGGTTAAGGAGCTCCTACAATGAGCAGTTCTTC	CASSGTSGLRSSYNEQFF	TRBV7-3	TRBJ2-1
TGCGCCAGCAGCGTTACTCGCGGGAGGAACACCGGGGAGCTGTTTTTT	CASSVTRGRNTGELFF	TRBV5-1	TRBJ2-2
TGCGCCAGCAGCCTCCCGCGTCGGGCCTCTGGGGCCAACGTCCTGACTTTC	CASSLPRRASGANVLTF	TRBV4-3	TRBJ2-6
TGCGCCAGCAGCCGCGGGGCTGAAGCTTTCTTT	CASSRGAEAFF	TRBV5-1	TRBJ1-1
TGTGCCAGCATCGAGAGGTGGACTAGCCGTAAGGGCCTCTACGAGCAGTACTTC	CASIERWTSRKGLYEQYF	TRBV7-2	TRBJ2-7
TGTGCCAGCAGTTTAGGGGTGGAGGACAGGCAAGAATATGGCTACACCTTC	CASSLGVEDRQEYGYTF	TRBV12-3	TRBJ1-2
TGTGCCAGCAGTTTAGCGCGGGCCTACGAGCAGTACTTC	CASSLARAYEQYF	TRBV12-4	TRBJ2-7
TGCGCCAGCAGCTCGAACCGGGACGGTGTTGAAAAACTGTTTTTT	CASSSNRDGVEKLFF	TRBV5-1	TRBJ1-4
TGTGCCAGCAGAGCCCTGGGGGCGCCGGTCAAAAACATTCAGTACTTC	CASRALGAPVKNIQYF	TRBV5-5	TRBJ2-4
TGTGCCTTTGTGGGGAAACACAGGAATAGCAACATTCAGTACTTC	CAFVGKHRNSNIQYF	TRBV7-9	TRBJ2-4
TGTGCCAGTAGTATGCCGGAGGGCAATCAGCCCCAGCATTTT	CASSMPEGNQPQHF	TRBV19	TRBJ1-5
TGTGCCATCACATCGACGGCAGAATCAGATCAGCCCCAGCATTTT	CAITSTAESDQPQHF	TRBV10-3	TRBJ1-5
TGTGCCAGCAGACATCTAGGGGAGCAGTTCTTC	CASRHLGEQFF	TRBV12-4	TRBJ2-1
TGTGCCAGCAGCCGCATAACAGGCAGGCACAACAATGAGCAGTTCTTC	CASSRITGRHNNEQFF	TRBV3-1	TRBJ2-1
TGTGCCAGCAGTTCTGCTTTTAGCCGGGACAGGGATGGCTACACCTTC	CASSSAFSRDRDGYTF	TRBV6-5	TRBJ1-2
TGCAGTGCTAGGGGCACTGAAAAACTGTTTTTT	CSARGTEKLFF	TRBV20-1	TRBJ1-4
TGTGCCAGCAGCTTGGGACAGGGAGGACCTGAAGCTTTCTTT	CASSLGQGGPEAFF	TRBV4-2	TRBJ1-1
TGTGCCAGCAGTTTACGGTTGGGGTGCAATCAGCCCCAGCATTTT	CASSLRLGCNQPQHF	TRBV27	TRBJ1-5
TGCGCCAGCCCAGGGATGGCCTATGGCTACACCTTC	CASPGMAYGYTF	TRBV10-1	TRBJ1-2
TGTGCCAGCAGTGACCCCTGGGGGGCGAATCAGCCCCAGCATTTT	CASSDPWGANQPQHF	TRBV6-4	TRBJ1-5
TGTGCCAGCAGCCAAGACGTTCATGAGGGACTGGCGGGTGGGGATGAGCAGTTCTTC	CASSQDVHEGLAGGDEQFF	TRBV3-1	TRBJ2-1
TGTGCCAGCAGTGCTTACAGGGTAAGCTCTGGAAACACCATATATTTT	CASSAYRVSSGNTIYF	TRBV6-4	TRBJ1-3
TGTGCCAGCAGTCTAAATAGGGCCGATCGCTCTAATGAAAAACTGTTTTTT	CASSLNRADRSNEKLFF	TRBV12-3	TRBJ1-4
TGCGAGGGACTAGCAGATACGCAGTATTTT	CEGLADTQYF	TRBV20-1	TRBJ2-3
TGTGCCAGCAGTTACCAAGATAGCACTGAAGCTTTCTTT	CASSYQDSTEAFF	TRBV6-2	TRBJ1-1
TGTGCCAGCAGGAATCCCGGGGGAGGCCTGGGATACAATGAGCAGTTCTTC	CASRNPGGGLGYNEQFF	TRBV6-2	TRBJ2-1
TGCAGTGCTAAGCGGGCGCCGAGCTCCTACAATGAGCAGTTCTTC	CSAKRAPSSYNEQFF	TRBV20-1	TRBJ2-1
TGTGCCAGCAGCTGGGCCCTGGTAGATACGCAGTATTTT	CASSWALVDTQYF	TRBV7-7	TRBJ2-3
TGTGCCAGCAGTGAAGACAGGGGGGGGGTGAACACTGAAGCTTTCTTT	CASSEDRGGVNTEAFF	TRBV25-1	TRBJ1-1
TGTGCCAGCAGCTTAGGGGGGGGACACTACGAGCAGTACTTC	CASSLGGGHYEQYF	TRBV11-2	TRBJ2-7
TGTGCCAGCAGCTTCCTACTCCAAAGGGGAATTGAAGCTTTCTTT	CASSFLLQRGIEAFF	TRBV5-6	TRBJ1-1
TGTGCCAGCAGCGCTAGCGGGTTTGGGGTCTCCTTAAGCACAGATACGCAGTATTTT	CASSASGFGVSLSTDTQYF	TRBV6-1	TRBJ2-3
TGTGCCAGCAGTCCCAGTAAACTCCAGCATTTT	CASSPSKLQHF	TRBV7-9	TRBJ1-5
TGTGCCAGCTCACTCGTAATAAAGCCCGGGGGGGCCGATCTGAATGAGCAGTTCTTC	CASSLVIKPGGADLNEQFF	TRBV18	TRBJ2-1
TGTGCGACGACAGGGGATAAAGAGACCCAGTACTTC	CATTGDKETQYF	TRBV27	TRBJ2-5
TGCAGCGTTGGAACCTACAATGAGCAGTTCTTC	CSVGTYNEQFF	TRBV29-1	TRBJ2-1
TGCGCCAGCAGCTTGGATGGAGGAAATGAGCAGTTCTTC	CASSLDGGNEQFF	TRBV5-1	TRBJ2-1
TGTGCCAGTAGTATAGACAGGGGACAGTCGGAGAATCAGCCCCAGCATTTT	CASSIDRGQSENQPQHF	TRBV19	TRBJ1-5
TGTGCCAGCAGCGGGACAGCGGGTATGAATCAGCCCCAGCATTTT	CASSGTAGMNQPQHF	TRBV11-3	TRBJ1-5
TGTGCCAGTAGTACTGGGGGGAGCTCAGGCTACACCTTC	CASSTGGSSGYTF	TRBV19	TRBJ1-2
TGTGCCAGCGGGGGGGATAAAACTCATGAGCAGTTCTTC	CASGGDKTHEQFF	TRBV11-3	TRBJ2-1
TGTGCCAGCAGTCCGGGGGACATTTGGTACGAGCAGTACTTC	CASSPGDIWYEQYF	TRBV12-3	TRBJ2-7
TGTGCCAGCAGCCATTACTCAGGTCCTCAGCCCCAGCATTTT	CASSHYSGPQPQHF	TRBV4-2	TRBJ1-5
TGTGCCAGCACACCCGGGACAGGGAAAGTATATAGCAATCAGCCCCAGCATTTT	CASTPGTGKVYSNQPQHF	TRBV7-4	TRBJ1-5
TGTGCCAGCAGCGTCAGGGACAGGGGTCCTAACTATGGCTACACCTTC	CASSVRDRGPNYGYTF	TRBV6-4	TRBJ1-2
TGCGCCAGTTGGACAGCTTTTAACTATGGCTACACCTTC	CASWTAFNYGYTF	TRBV4-1	TRBJ1-2
TGTGCCAGCAGTTTGGTAGGGACAGTCTACGAGCAGTACTTC	CASSLVGTVYEQYF	TRBV12-3	TRBJ2-7
TGCGCCAGCAGCTTGGCAGTTCGGGTGAACACTGAAGCTTTCTTT	CASSLAVRVNTEAFF	TRBV5-1	TRBJ1-1
TGTGCCAGCAAGACTCTCTACGAACGGTGCCGGTGCTACACTGAAGCTTTCTTT	CASKTLYERCRCYTEAFF	TRBV9	TRBJ1-1
TGCGCCAGCAGCTACAGGGACGGCTATGGCTACACCTTC	CASSYRDGYGYTF	TRBV5-1	TRBJ1-2
TGTGCCAGCAGCCAAGATGTCCTAGCGGGGATTACGACCCAAGAGACCCAGTACTTC	CASSQDVLAGITTQETQYF	TRBV3-1	TRBJ2-5
TGTGCCATCAGGGGACTAAAGGACAGGGAGGGCTCTGGGGCCAACGTCCTGACTTTC	CAIRGLKDREGSGANVLTF	TRBV10-3	TRBJ2-6
TGCGCCAGCAGCTTGAATCGGGGGCAAGTCTGCAATCAGCCCCAGCATTTT	CASSLNRGQVCNQPQHF	TRBV5-1	TRBJ1-5
TGTGCCAGCAGCGGCACGAGCGGGAAAGAGACCCAGTACTTC	CASSGTSGKETQYF	TRBV4-2	TRBJ2-5
TGTGCCAGCAGGCCGCCCCGGCCCCAGGAAATTGAAAAACTGTTTTTT	CASRPPRPQEIEKLFF	TRBV5-5	TRBJ1-4
TGTGCCAGCAGTTACTCGATAAATGCAGGGACGCCAGATACGCAGTATTTT	CASSYSINAGTPDTQYF	TRBV6-5	TRBJ2-3
TGTGCCAGCACGCTGCGGGCGGGGGAGCAGTACTTC	CASTLRAGEQYF	TRBV6-6	TRBJ2-7
TGTGCCAGCAGCTTGACGACACTACTGGCTGAAGCTTTCTTT	CASSLTTLLAEAFF	TRBV13	TRBJ1-1
TGCGCCAGCAGTCTGACAGGGTGTAAATGGGCGGCCACAGATACGCAGTATTTT	CASSLTGCKWAATDTQYF	TRBV10-1	TRBJ2-3
TGTGCCAGCAGCGTAGGTCGTCCGGGACTAGGAACTCAAGAGACCCAGTACTTC	CASSVGRPGLGTQETQYF	TRBV9	TRBJ2-5
TGTGCCACCAGTGATCCAGGAGATTCCTACGAGCAGTACTTC	CATSDPGDSYEQYF	TRBV24-1	TRBJ2-7
TGTGCCAGCAGCACTGGGGATGTGAACACTGAAGCTTTCTTT	CASSTGDVNTEAFF	TRBV13	TRBJ1-1
TGTGCCAGCAGTGAATGCCCGGGATCCAATGAGCAGTTCTTC	CASSECPGSNEQFF	TRBV6-1	TRBJ2-1
TGTGCCAGCAGTTACTCTCACAGGGGGAACACTGAAGCTTTCTTT	CASSYSHRGNTEAFF	TRBV6-2	TRBJ1-1
TGTGCCTGGAGTGGCCCCTCAACCGTGGTCAGGACAGGTGTCTCCTACGAGCAGTACTTC	CAWSGPSTVVRTGVSYEQYF	TRBV30	TRBJ2-7
TGTGCCAGCAGCAACACGGTGACAGGGGGGGTGAACACTGAAGCTTTCTTT	CASSNTVTGGVNTEAFF	TRBV13	TRBJ1-1
TGTGCCAGCAGTCCCCCCCGGAGGAGGACGAACACTGAAGCTTTCTTT	CASSPPRRRTNTEAFF	TRBV6-2	TRBJ1-1
TGTGCCAGCAGCTTAAGATCCTACAATGAGCAGTTCTTC	CASSLRSYNEQFF	TRBV11-2	TRBJ2-1
TGCGCCAGCAGCTCCTCTAGGGGGGAGGCCCTAGCCAAAAACATTCAGTACTTC	CASSSSRGEALAKNIQYF	TRBV5-1	TRBJ2-4
TGTGCCAGCGATCGTGTGGGGGGACCGGATCAGGAGACCCAGTACTTC	CASDRVGGPDQETQYF	TRBV2	TRBJ2-5
TGCAGTGCTCCTCAGGGGACCTACGAGCAGTACTTC	CSAPQGTYEQYF	TRBV20-1	TRBJ2-7
TGTGCCTGGAGTGATAGGGAAGTGAATCAGCCCCAGCATTTT	CAWSDREVNQPQHF	TRBV30	TRBJ1-5
TGTGCCAGCAGCTTAGCCCAGGGGGGCCGGACTAATGAAAAACTGTTTTTT	CASSLAQGGRTNEKLFF	TRBV7-2	TRBJ1-4
TGTGCCAGCAGTACCCGTGGTAGTCCCCTCTACGAGCAGTACTTC	CASSTRGSPLYEQYF	TRBV27	TRBJ2-7
TGTGCCACCAGCTCCCAGGGGGAGCGGGGGGGAGGAGAGACCCAGTACTTC	CATSSQGERGGGETQYF	TRBV24-1	TRBJ2-5
TGTGCCAGCAGACAGGCTACAGCCTACGAGCAGTACTTC	CASRQATAYEQYF	TRBV6-5	TRBJ2-7
TGTGCCAGCAGCCAAGATAGGGAGGCCCAGTATTTT	CASSQDREAQYF	TRBV3-1	TRBJ2-3
TGTGCCAGCAAAAGGACAGGGTCTAACTATGGCTACACCTTC	CASKRTGSNYGYTF	TRBV27	TRBJ1-2
TGTGCCAGCAGTGGTCGGTGGGACTACAATGAGCAGTTCTTC	CASSGRWDYNEQFF	TRBV27	TRBJ2-1
TGTGCCAGCAGCGTCCCGGGGAAAAAAACTAATGAAAAACTGTTTTTT	CASSVPGKKTNEKLFF	TRBV9	TRBJ1-4
TGTGCCAGCCATCCTGGACTAGCGGCAGAGAACACCGGGGAGCTGTTTTTT	CASHPGLAAENTGELFF	TRBV9	TRBJ2-2
TGTGCTAGTGGTTCACCAGGGAAGCCGGCGCAAGAGACCCAGTACTTC	CASGSPGKPAQETQYF	TRBV12-5	TRBJ2-5
TGTGCCAGCAGCTTTCTTGACAGGCAGTATTTT	CASSFLDRQYF	TRBV5-4	TRBJ2-3
TGCAGTGCGAAGAGCGCAGGGGACAATCAGCCCCAGCATTTT	CSAKSAGDNQPQHF	TRBV20-1	TRBJ1-5
TGTGCCAGCAGCCAAGAGAAGGGGGGATTGCAGTACTTC	CASSQEKGGLQYF	TRBV14	TRBJ2-7
TGCGCCAGGACAGTCAACACTGAAGCTTTCTTT	CARTVNTEAFF	TRBV5-1	TRBJ1-1
TGTGCCTCGAATATCGCGGGAGCGTGGAACACTGAAGCTTTCTTT	CASNIAGAWNTEAFF	TRBV24-1	TRBJ1-1
TGTGCCAGCAGCCAAGAGGGGGGGATCCTCCACACAGATACGCAGTATTTT	CASSQEGGILHTDTQYF	TRBV14	TRBJ2-3
TGTGCCAGCACTAGCGGGCGAGATACGCAGTATTTT	CASTSGRDTQYF	TRBV9	TRBJ2-3
TGTGCCAGTAGTCTCGGGACAGGGTATCAGCCCCAGCATTTT	CASSLGTGYQPQHF	TRBV19	TRBJ1-5
TGTGCCAGCAGCGCACTCACAGGGTGCGTTTCACCCCTCCACTTT	CASSALTGCVSPLHF	TRBV9	TRBJ1-6
TGTGCCAGCAGAGACACAGGGGGTCCTGAAAAACTGTTTTTT	CASRDTGGPEKLFF	TRBV6-5	TRBJ1-4
TGTGCCAGCACGGGGCTTAGGACAGTCAGTGACTCCTACGAGCAGTACTTC	CASTGLRTVSDSYEQYF	TRBV4-2	TRBJ2-7
TGCACGGGGGCTCAACACTACGAGCAGTACTTC	CTGAQHYEQYF	TRBV20-1	TRBJ2-7
TGTGCCAGCAGGGGGGACCAAGGCACAGATACGCAGTATTTT	CASRGDQGTDTQYF	TRBV25-1	TRBJ2-3
TGTGCCAGCAGTTATTGCGGGGGGCTAGACGGGGAGCTGTTTTTT	CASSYCGGLDGELFF	TRBV6-5	TRBJ2-2
TGTGCCAGCAGCCACCCCCACAGGGCCTATAATGAAAAACTGTTTTTT	CASSHPHRAYNEKLFF	TRBV3-1	TRBJ1-4
TGTGCCAGCAGCCTAAAGACCTTATGGGGCTACACCTTC	CASSLKTLWGYTF	TRBV5-6	TRBJ1-2
TGTGCCAGCAGCGGGGTAAACACCGGGGAGCTGTTTTTT	CASSGVNTGELFF	TRBV7-3	TRBJ2-2
TGTGCCAGCAGTGAACCGGGACATAACAAAAACATTCAGTACTTC	CASSEPGHNKNIQYF	TRBV6-1	TRBJ2-4
TGTGCCACCAGTGAGACAAAGACTAGCGGGGGTTGGGAGCGCTACGAGCAGTACTTC	CATSETKTSGGWERYEQYF	TRBV24-1	TRBJ2-7
TGTGCCAGCAGGCCGGTAGCGGCCTGTATCCCGAACACCGGGGAGCTGTTTTTT	CASRPVAACIPNTGELFF	TRBV27	TRBJ2-2
TGTGCCAGCAGTGAAGTACCCGCCGAGCAGTACTTC	CASSEVPAEQYF	TRBV2	TRBJ2-7
TGTGCCAGCAGACAGGACGAGGCCACTGAAGCTTTCTTT	CASRQDEATEAFF	TRBV7-9	TRBJ1-1
TGTGCCAGCAGTTTTCCAACCGGGCGGGCCTACGAGCAGTACTTC	CASSFPTGRAYEQYF	TRBV12-3	TRBJ2-7
TGTGCCAGCAGCCGGGCACCAACAGCCGACAGGGTTCGCCACGAGCAGTACTTC	CASSRAPTADRVRHEQYF	TRBV11-3	TRBJ2-7
TGTGCCAGCAGCTTATTACGACAGAGGGTCAATCAGCCCCAGCATTTT	CASSLLRQRVNQPQHF	TRBV5-5	TRBJ1-5
TGTGCCAGCAGCTTCCCTAATAGGGGCACTGAAGCTTTCTTT	CASSFPNRGTEAFF	TRBV5-4	TRBJ1-1
TGTGCCAGCAGCTTGGTAGAGGGTGGATACAATGAGCAGTTCTTC	CASSLVEGGYNEQFF	TRBV5-4	TRBJ2-1
TGTGCCAGCAGTGGGGACGCAACAGGGGGCTGGAGTGGCTACACCTTC	CASSGDATGGWSGYTF	TRBV28	TRBJ1-2
TGCAGCGTCTGGGACAGGGGGGGATGCAATCAGCCCCAGCATTTT	CSVWDRGGCNQPQHF	TRBV29-1	TRBJ1-5
TGCGCCAGCAGCCAACAGCATGGCTACACCTTC	CASSQQHGYTF	TRBV4-3	TRBJ1-2
TGCAGTGCTAGAGAGAGCGCGACGGTGCACGAGCAGTACTTC	CSARESATVHEQYF	TRBV20-1	TRBJ2-7
TGCAGTGCTAGAGATAGAGGGCAGTACTTC	CSARDRGQYF	TRBV20-1	TRBJ2-7
TGTGCCAGCAGTTCCCAGGGTCCCGGGACTAGCGGCTTGGGCTCCTACGAGCAGTACTTC	CASSSQGPGTSGLGSYEQYF	TRBV6-9	TRBJ2-7
TGCGCCAGTGGGACAGTAACGCAGTTCTTC	CASGTVTQFF	TRBV5-1	TRBJ2-1
TGCAGTGCTAGAGAGCCCCGGCGGGACATCAATCAGCCCCAGCATTTT	CSAREPRRDINQPQHF	TRBV20-1	TRBJ1-5
TGTGCCACCAGTGGGGGGGGAGTGATATACGAGCAGTACTTC	CATSGGGVIYEQYF	TRBV24-1	TRBJ2-7
TGTGCCAGGGGGGGCAACACTGAAGCTTTCTTT	CARGGNTEAFF	TRBV28	TRBJ1-1
TGCAGTGCAAAGGGGGGGTCTCTAGCCAAAAACATTCAGTACTTC	CSAKGGSLAKNIQYF	TRBV20-1	TRBJ2-4
TGTGCCACGAGGGGGTTAGATGAGCAGTTCTTC	CATRGLDEQFF	TRBV7-9	TRBJ2-1
TGTGCCAGCAGGGTCCTCACTTTGACAGGGGAGCGTTGTAATGAAAAACTGTTTTTT	CASRVLTLTGERCNEKLFF	TRBV6-4	TRBJ1-4
TGTGCCAGCTACCGCTACGAGCAGTACTTC	CASYRYEQYF	TRBV5-6	TRBJ2-7
TGTGCCAGCAGCCCAGGGGGGCACGAGCAGTACTTC	CASSPGGHEQYF	TRBV13	TRBJ2-7
TGTGCCATCAGTGAGTCGGGACAGGATCATAGCAATCAGCCCCAGCATTTT	CAISESGQDHSNQPQHF	TRBV10-3	TRBJ1-5
TGTGCCACTTCCGGGCTAGATAACAGGGTCTACGAGCAGTACTTC	CATSGLDNRVYEQYF	TRBV24-1	TRBJ2-7
TGTGCCACCAGTGATTTGCGAAAGAGTTGTATGAACACTGAAGCTTTCTTT	CATSDLRKSCMNTEAFF	TRBV24-1	TRBJ1-1
TGTGCCAGCAGCTTAGCGCTTAGGACTAGCGGGAGATCGGCCGGGGAGCTGTTTTTT	CASSLALRTSGRSAGELFF	TRBV7-2	TRBJ2-2
TGTGCCAGCAGCACTTGCCGGACAGGGAGTTTGAACACTGAAGCTTTCTTT	CASSTCRTGSLNTEAFF	TRBV7-3	TRBJ1-1
TGTGCCAGCAGCCAAGGAGCCCCCGGACTAGCTGAAACCGAGCAGTACTTC	CASSQGAPGLAETEQYF	TRBV14	TRBJ2-7
TGTGCCACCAGTTCCAGGGAGAATGAAAAACTGTTTTTT	CATSSRENEKLFF	TRBV24-1	TRBJ1-4
TGCGCCAGCGGCAGGTTTTCCAATCAGCCCCAGCATTTT	CASGRFSNQPQHF	TRBV5-1	TRBJ1-5
TGTGCCAGCAGAGAGTACAGGGGCATCGATGGCTACACCTTC	CASREYRGIDGYTF	TRBV27	TRBJ1-2
TGTGCCAGCAGTGGACTAGCGGGAGGGCGGCCTGAGACCCAGTACTTC	CASSGLAGGRPETQYF	TRBV6-4	TRBJ2-5
TGCGCCAGCAGCTCTACTAGTTATGGCTACACCTTC	CASSSTSYGYTF	TRBV10-1	TRBJ1-2
TGTGCCAGCAGCATACTGTCCTACAATGAGCAGTTCTTC	CASSILSYNEQFF	TRBV5-6	TRBJ2-1
TGTGCCAGCAGCTTAAAAAACGAAGGGGGGGACCAAGAGACCCAGTACTTC	CASSLKNEGGDQETQYF	TRBV11-2	TRBJ2-5
TGCGCCAGCAGCTTGGGGACGGGACGGCGGATGCCTAGCACAGATACGCAGTATTTT	CASSLGTGRRMPSTDTQYF	TRBV5-1	TRBJ2-3
TGTGCCAGCAGCGTAGTCGGGCGGGAGGAGACCCAGTACTTC	CASSVVGREETQYF	TRBV9	TRBJ2-5
TGTGCCAGCATTGGGTGGGATTCTGCAACTAATGAAAAACTGTTTTTT	CASIGWDSATNEKLFF	TRBV9	TRBJ1-4
TGTGCCAGTAGTATATTCCTACGGACAGGGGGTCCCACTGAAGCTTTCTTT	CASSIFLRTGGPTEAFF	TRBV19	TRBJ1-1
TGTGCCAGCAGCCCCGGTTATCGGCACGAGCAGTACTTC	CASSPGYRHEQYF	TRBV6-5	TRBJ2-7
TGTGCCAGCAGTCACTTTAACACTGAAGCTTTCTTT	CASSHFNTEAFF	TRBV12-3	TRBJ1-1
TGTGCCAGCAGCGGTACAGGCCTGACATTGGGTATCCGTGCTGGCCGCTCTGGGGCCAACGTCCTGACTTTC	CASSGTGLTLGIRAGRSGANVLTF	TRBV7-8	TRBJ2-6
TGTGCCAGCAGTCCCAAGAGGAGGCCCTACACCTTC	CASSPKRRPYTF	TRBV6-6	TRBJ1-2
TGTGCCAGCCTGACAGGGGAGGTAGGGGATTTCATGAACACTGAAGCTTTCTTT	CASLTGEVGDFMNTEAFF	TRBV7-4	TRBJ1-1
TGCGCCAGCAGCCAAGTGGGGGGAATGGCCTACGAGCAGTACTTC	CASSQVGGMAYEQYF	TRBV4-3	TRBJ2-7
TGCGCCAGCAGCCAAGTTGTGGGACAGTCCGAGCAGTACTTC	CASSQVVGQSEQYF	TRBV4-3	TRBJ2-7
TGTGCCACCAGCACGGTGAGCGCAACTAATGAAAAACTGTTTTTT	CATSTVSATNEKLFF	TRBV24-1	TRBJ1-4
TGTGCCAGCAGCCAAGCGGGGGACAATCAGCCCCAGCATTTT	CASSQAGDNQPQHF	TRBV3-1	TRBJ1-5
TGTGCCAGCAGTTTAAGGGACAATCAGCCCCAGCATTTT	CASSLRDNQPQHF	TRBV12-4	TRBJ1-5
TGTGCCACCAGTGCGGGGGACTCAGGGGGTACCTACGAGCAGTACTTC	CATSAGDSGGTYEQYF	TRBV24-1	TRBJ2-7
TGTGCCAGCAGTGTTTCGGGGGGGGCCGGGGCTGGACGGTGTGAGCCTAACTATGGCTACACCTTC	CASSVSGGAGAGRCEPNYGYTF	TRBV27	TRBJ1-2
TGTGCCAGCACCCTAAACAGAAACAACACCGGGGAGCTGTTTTTT	CASTLNRNNTGELFF	TRBV27	TRBJ2-2
TGTGCCAGCAGCGAACCTGCCCGGGGGAAGACAACTAATGAAAAACTGTTTTTT	CASSEPARGKTTNEKLFF	TRBV11-1	TRBJ1-4
TGTGCCAGCAGTTACTCCTTCCGGCTGGGTGGTCCCACAGATACGCAGTATTTT	CASSYSFRLGGPTDTQYF	TRBV6-2	TRBJ2-3
TGTGCCAGCAGTCCCCCCACCAGGGGCCGGAGCTCCTACGAGCAGTACTTC	CASSPPTRGRSSYEQYF	TRBV28	TRBJ2-7
TGTGCCAGCACCCGCGGGGGGGGGGCGTTCTACAATGAGCAGTTCTTC	CASTRGGGAFYNEQFF	TRBV28	TRBJ2-1
TGCGCCATCAAGGGCTTACTAGGGAACACTGAAGCTTTCTTT	CAIKGLLGNTEAFF	TRBV10-1	TRBJ1-1
TGTGCCAGCAGCGTAATTAGGGGAGGCGGATACGAGCAGTACTTC	CASSVIRGGGYEQYF	TRBV9	TRBJ2-7
TGTGCCAGCAGCACCCTCACCCTCAGGGAGGAGACCCAGTACTTC	CASSTLTLREETQYF	TRBV6-2	TRBJ2-5
TGTGCCTGGAGTTGGGCGAACGCGTTGAACAATGAGCAGTTCTTC	CAWSWANALNNEQFF	TRBV30	TRBJ2-1
TGTGCCAGCAGCCCATGCGGGAGGTTCGTACATAGCAATCAGCCCCAGCATTTT	CASSPCGRFVHSNQPQHF	TRBV7-9	TRBJ1-5
TGCGCCAGCAGCTCGGGGAGAGAGACCCAGTACTTC	CASSSGRETQYF	TRBV5-1	TRBJ2-5
TGTGCCAGCAACGAACCCAGGGAGATAGGCAATTCACCCCTCCACTTT	CASNEPREIGNSPLHF	TRBV6-1	TRBJ1-6
TGCAGTGCTGGAGGGGGCCTCTATGGCTACACCTTC	CSAGGGLYGYTF	TRBV20-1	TRBJ1-2
TGTGCCAGCAGTTCAACGACAGGGTCCAATCAGCCCCAGCATTTT	CASSSTTGSNQPQHF	TRBV28	TRBJ1-5
TGTGCCAGCAGCCAGGGTCTCCCAGCGGGAAGGGATGAGACCCAGTACTTC	CASSQGLPAGRDETQYF	TRBV3-1	TRBJ2-5
TGTGCCAGCAGCTTATTCCCAGAATCGGATACTCCAATGAACACTGAAGCTTTCTTT	CASSLFPESDTPMNTEAFF	TRBV7-6	TRBJ1-1
TGTGCCATCAGCGCGAGGGGGGGAAGCAATCAGCCCCAGCATTTT	CAISARGGSNQPQHF	TRBV10-3	TRBJ1-5
TGCGCCAGGTTCCCCTATCCCCGACAGGGCTCTGAAAGCTATAGCAATCAGCCCCAGCATTTT	CARFPYPRQGSESYSNQPQHF	TRBV10-1	TRBJ1-5
TGTGCCAGCAGCATGTGGACAGGGAGCACTGAAGCTTTCTTT	CASSMWTGSTEAFF	TRBV13	TRBJ1-1
TGTGCCATCAGTGAGAACGGGACTAGCGGGGCAGGTAGCTCCTACAATGAGCAGTTCTTC	CAISENGTSGAGSSYNEQFF	TRBV10-3	TRBJ2-1
TGTGCCAGCAGCTTTCCTGGGACAGTTAGTCAGCCCCAGCATTTT	CASSFPGTVSQPQHF	TRBV7-9	TRBJ1-5
TGTGCCATCAGTGAGTCGAACTCGAAGGACAGGGCACTATTCTTT	CAISESNSKDRALFF	TRBV10-3	TRBJ1-1
TGTGCCAGCAGCTTAGTGGAGATCAACACCGGGGAGCTGTTTTTT	CASSLVEINTGELFF	TRBV11-1	TRBJ2-2
TGTGCCAGCCAACCCCGGGGTGGGGCCGGGGAGCTGTTTTTT	CASQPRGGAGELFF	TRBV6-6	TRBJ2-2
TGCAGTGCTAGGTTCAGGACTAACTCCAGCTCCTACAATGAGCAGTTCTTC	CSARFRTNSSSYNEQFF	TRBV20-1	TRBJ2-1
TGTGCCAGCAGCAAGGTTTCAGACTCCATCAGGGGGCCAGTGCTGGGAGATACGCAGTATTTT	CASSKVSDSIRGPVLGDTQYF	TRBV11-3	TRBJ2-3
TGTGCCAGCAGCGTACTTAATGGATTTGAAAAACTGTTTTTT	CASSVLNGFEKLFF	TRBV5-4	TRBJ1-4
TGTGCCAGCAGCTTAGCTAGAGGGGATAGGGGACTAGACCCGACCGGGGAGCTGTTTTTT	CASSLARGDRGLDPTGELFF	TRBV7-8	TRBJ2-2
TGTGCCAGCAGCAACCAGGTAGGTGAAGCTTTCTTT	CASSNQVGEAFF	TRBV11-2	TRBJ1-1
TGCGCCAGCAGTCGGAGGAGCTACAATGAGCAGTTCTTC	CASSRRSYNEQFF	TRBV5-1	TRBJ2-1
TGTGCCAGCGTACAGGAGGATTTAGGGTATAATGGCTACACCTTC	CASVQEDLGYNGYTF	TRBV5-6	TRBJ1-2
TGCAGTGCAAAAGGGGTCGGGTACGAGCAGTACTTC	CSAKGVGYEQYF	TRBV20-1	TRBJ2-7
TGTGCCAGCAGTGATCAGGCGAACAATGAGCAGTTCTTC	CASSDQANNEQFF	TRBV25-1	TRBJ2-1
TGTGCCTGGAGTTTAGGTCGGCGGAGGGCAGGCGGGGCTTTCTTT	CAWSLGRRRAGGAFF	TRBV30	TRBJ1-1
TGCGCCAGCAGTCGGTCCCCAATGCGCGGGAGGGGGGACGGGGAGACCCAGTACTTC	CASSRSPMRGRGDGETQYF	TRBV10-1	TRBJ2-5
TGTGCCAGCAGCTTGTTGCTTGGGCTCGGGGGGATGGCCACCGGGGAGCTGTTTTTT	CASSLLLGLGGMATGELFF	TRBV5-4	TRBJ2-2
TGTGCCAGCAGCGGGGACAGGGTCGGATGGATATACGAGCAGTACTTC	CASSGDRVGWIYEQYF	TRBV7-3	TRBJ2-7
TGTGCCAGCATTCCACCGGAAACCAAGCCCATTCTTTCCTACGAGCAGTACTTC	CASIPPETKPILSYEQYF	TRBV6-6	TRBJ2-7
TGCGCCAGCAGGGCCTGTCAGGGGGGGGGGCAAGAGACCCAGTACTTC	CASRACQGGGQETQYF	TRBV10-1	TRBJ2-5
TGTGCCAGCTCACCCTACAACGATGGCTACACCTTC	CASSPYNDGYTF	TRBV18	TRBJ1-2
TGCGCCAGCAGCTTGGTTGAGAACGGGCAACCGAACTATGGCTACACCTTC	CASSLVENGQPNYGYTF	TRBV5-1	TRBJ1-2
TGTGCCAGCCCCAGGGGGCGGATTGGACTTCGAGGACCCCTCCACTTT	CASPRGRIGLRGPLHF	TRBV6-4	TRBJ1-6
TGCGCCAGCAGTCAGCCCCCCAGGCAGTTCTTC	CASSQPPRQFF	TRBV4-1	TRBJ2-1
TGTGCCAGCAGCCAAGCGCGTCAGGGGTCAACTTTAGCCAAAAACATTCAGTACTTC	CASSQARQGSTLAKNIQYF	TRBV4-2	TRBJ2-4
TGTGCCGACGGGCGGCGGGGAATTAATGAAAAACTGTTTTTT	CADGRRGINEKLFF	TRBV6-2	TRBJ1-4
TGTGCCAGCAGCTCGCAGGGAAGCCATCAGCCCCAGCATTTT	CASSSQGSHQPQHF	TRBV5-5	TRBJ1-5
TGTGCCAGCAGATCCTGGGACAGGGGGGAATTGAGCAATCAGCCCCAGCATTTT	CASRSWDRGELSNQPQHF	TRBV9	TRBJ1-5
TGTGCCATCACAGGACAGGGGGTTGGAAACACCATATATTTT	CAITGQGVGNTIYF	TRBV10-3	TRBJ1-3
TGTGCCAGCAGACAGGCCGGGACAGTGGACACTGAAGCTTTCTTT	CASRQAGTVDTEAFF	TRBV2	TRBJ1-1
TGTGCCAGCGAGGGAATGCGGAACTACGAGCAGTACTTC	CASEGMRNYEQYF	TRBV28	TRBJ2-7
TGCAGTGCTAGAGGGCTTATAGGGGGGGGCAGCTCCTACAATGAGCAGTTCTTC	CSARGLIGGGSSYNEQFF	TRBV20-1	TRBJ2-1
TGCGCCAGCAGCTTGGTGAGGGGGGGGCTAGGCTCCTACAATGAGCAGTTCTTC	CASSLVRGGLGSYNEQFF	TRBV5-1	TRBJ2-1
TGTGCCAGCAGCTACTTGACAGGGGGCGGAGTTGTCAGCAATCAGCCCCAGCATTTT	CASSYLTGGGVVSNQPQHF	TRBV5-6	TRBJ1-5
TGTGCCAGCAGTGAAGGGACAGGGGACCCTACAGATACGCAGTATTTT	CASSEGTGDPTDTQYF	TRBV6-4	TRBJ2-3
TGTGCCATCAGAATCGGGGGGACCTCCTACGAGCAGTACTTC	CAIRIGGTSYEQYF	TRBV10-3	TRBJ2-7
TGTGCCAGCGGTTACAGGGAGTCCAGCAATCAGCCCCAGCATTTT	CASGYRESSNQPQHF	TRBV6-2	TRBJ1-5
TGTGCCACGATCCGGGGACACACCGGGGAGCTGTTTTTT	CATIRGHTGELFF	TRBV27	TRBJ2-2
TGTGCCAGCAGTTGGGTACAGGGACAGGGGGTTCGGTACGAGCAGTACTTC	CASSWVQGQGVRYEQYF	TRBV27	TRBJ2-7
TGCGCCAGCCGAGAATTACCGAACATTCAGTACTTC	CASRELPNIQYF	TRBV5-1	TRBJ2-4
TGTGCCAGCAGTGAAGGGACCCGGGACGGGACTAATGAAAAACTGTTTTTT	CASSEGTRDGTNEKLFF	TRBV6-1	TRBJ1-4
TGTGCCAGCAGTTACTCTCCCCCAGACAGGGGAGGGAACTATGGCTACACCTTC	CASSYSPPDRGGNYGYTF	TRBV6-2	TRBJ1-2
TGCAGTGCTAGAGGGTTCCAGAGCTACGAGCAGTACTTC	CSARGFQSYEQYF	TRBV20-1	TRBJ2-7
TGTGCCAGCAGTCGGCAAGAGACCCAGTACTTC	CASSRQETQYF	TRBV2	TRBJ2-5
TGTGCCAGCAGCGGCACAGTCCCCTCTTCAGGAACCGAGAATGAAAAACTGTTTTTT	CASSGTVPSSGTENEKLFF	TRBV2	TRBJ1-4
TGTGCCAGCAGTCTCGAAGTCTACCAAGAGACCCAGTACTTC	CASSLEVYQETQYF	TRBV6-1	TRBJ2-5
TGTGCTAGTGGTTTCCTTGCCCGACAGGAGGCGGGTTGCTATGGCTACACCTTC	CASGFLARQEAGCYGYTF	TRBV12-5	TRBJ1-2
TGCGCCAGCACGTGGGGGGGGCCAGGATATGGCTACACCTTC	CASTWGGPGYGYTF	TRBV10-1	TRBJ1-2
TGTGCCAGCAGCGATCGGGACGGTTCTGGAAACACCATATATTTT	CASSDRDGSGNTIYF	TRBV13	TRBJ1-3
TGTGCCAGCAGCCTTTCTTTGCCCGTTGGCGGGGAGCTGTTTTTT	CASSLSLPVGGELFF	TRBV11-2	TRBJ2-2
TGCGCCAGCAGCCAGACAGGATTATATAGCAATCAGCCCCAGCATTTT	CASSQTGLYSNQPQHF	TRBV4-1	TRBJ1-5
TGTGCCAGCAGTTTTCCCAGTTGGGGCCACACTGAAGCTTTCTTT	CASSFPSWGHTEAFF	TRBV27	TRBJ1-1
TGCGCCCGAAGGCCGAAAAATGAGCAGTTCTTC	CARRPKNEQFF	TRBV4-1	TRBJ2-1
TGTGCCAGCAGCCGAGGTTATATTCTTTGCTATGGCTACACCTTC	CASSRGYILCYGYTF	TRBV3-1	TRBJ1-2
TGTGCCAGCAGCGAAAATGCAGGGGGAGTTAACTATGGCTACACCTTC	CASSENAGGVNYGYTF	TRBV7-3	TRBJ1-2
TGTGCCAGCTCACCACGACACGACAGGGATGAGCAGTTCTTC	CASSPRHDRDEQFF	TRBV18	TRBJ2-1
TGTGCCAGCAGTGAACGGGCCCAGGGGAATCAGCCCCAGCATTTT	CASSERAQGNQPQHF	TRBV2	TRBJ1-5
TGCAGCGTTAAAGCCAGGGGAGGACAGCCCCAGCATTTT	CSVKARGGQPQHF	TRBV29-1	TRBJ1-5
TGCGCCAGCAGCTTGAGGACAGAGTATAGCAATCAGCCCCAGCATTTT	CASSLRTEYSNQPQHF	TRBV5-1	TRBJ1-5
TGTGCCACCAGCAGAAGGACCTTAGGAGGGTTCTTC	CATSRRTLGGFF	TRBV15	TRBJ2-1
TGTGCCAGCAGTTATTTCCTGGAACGAGGGGGCGCGCTTGAAGAGACCCAGTACTTC	CASSYFLERGGALEETQYF	TRBV6-9	TRBJ2-5
TGTGCCAGCAGGCACCTTCAGGGTACCAGCAATCAGCCCCAGCATTTT	CASRHLQGTSNQPQHF	TRBV6-4	TRBJ1-5
TGTGCCAGCAGCGTTGTGTTCCCCAGGGGGCGCTGTCAGCCCCAGCATTTT	CASSVVFPRGRCQPQHF	TRBV5-5	TRBJ1-5
TGTGCCAGCAGCCCCGACAGGACAGCTTTCTTT	CASSPDRTAFF	TRBV7-9	TRBJ1-1
TGCGCCAGCAGGTTACAGGGTCGTTACCTCTTGCAAGAGACCCAGTACTTC	CASRLQGRYLLQETQYF	TRBV10-2	TRBJ2-5
TGCATACAGGAGGCCCGAAATCAGCCCCAGCATTTT	CIQEARNQPQHF	TRBV20-1	TRBJ1-5
TGTGCCATCTATCCACGGGGCCTTAGAGGAAACACCATATATTTT	CAIYPRGLRGNTIYF	TRBV10-3	TRBJ1-3
TGTGCCAGCAGTTTGGGGGGGGTATATGGGGGCTCCTACGAGCAGTACTTC	CASSLGGVYGGSYEQYF	TRBV12-4	TRBJ2-7
TGTGCCAGCAGCGATAGGGCTCGTATCGAGCAGTACTTC	CASSDRARIEQYF	TRBV9	TRBJ2-7
TGTGCCAGCAGCGGGGATTCAGGGATATTGGGGTCCTACGAGCAGTACTTC	CASSGDSGILGSYEQYF	TRBV11-3	TRBJ2-7
TGTGCCAGCAGCGTATACACAGATACGCAGTATTTT	CASSVYTDTQYF	TRBV9	TRBJ2-3
TGTGCCAGCAGCTTAGTTGGGGGACAGACGGTACAGAACACTGAAGCTTTCTTT	CASSLVGGQTVQNTEAFF	TRBV7-2	TRBJ1-1
TGTGCCAGCAGTTTCCAGGCCCCAGAGACAGAGAATCAGCCCCAGCATTTT	CASSFQAPETENQPQHF	TRBV27	TRBJ1-5
TGCGACGGGGGGACAGGAGGTTCCACAGATACGCAGTATTTT	CDGGTGGSTDTQYF	TRBV20-1	TRBJ2-3
TGTGCCAGCAGTGACCTCCCACTGTGCCGGGACAGGGTCTACGAGCAGTACTTC	CASSDLPLCRDRVYEQYF	TRBV6-4	TRBJ2-7
TGTGCCAGCAGCCAAAGGGGCCGAAGCACCATATATTTT	CASSQRGRSTIYF	TRBV14	TRBJ1-3
TGTGCCAGCTCACCAGGACTAGCGGCCTACGAGCAGTACTTC	CASSPGLAAYEQYF	TRBV18	TRBJ2-7
TGTGCCAGCAGCTTAAAGGGCCAACAGAAGCAGTACTTC	CASSLKGQQKQYF	TRBV7-3	TRBJ2-7
TGTGCCAGCAGCCATAGAGTGGGGGTCCCCCAGCCCCAGCATTTT	CASSHRVGVPQPQHF	TRBV14	TRBJ1-5
TGTGCCAGCAGTTTCTGGAGGAACACTGAAGCTTTCTTT	CASSFWRNTEAFF	TRBV12-3	TRBJ1-1
TGTGCCAGCAGCTCGACAGGGGCTCAGCCCCAGCATTTT	CASSSTGAQPQHF	TRBV3-1	TRBJ1-5
TGTGCTAGTGGTTTGGTACGTGGGGCGGGTTGCTATGGCTACACCTTC	CASGLVRGAGCYGYTF	TRBV12-5	TRBJ1-2
TGTGCCAGCAGCTTACCTAGGCTCACCTCTGGGGCCAACGTCCTGACTTTC	CASSLPRLTSGANVLTF	TRBV11-3	TRBJ2-6
TGCGCCAGCAGCGCCGGGAGAGGCTACACCTTC	CASSAGRGYTF	TRBV5-1	TRBJ1-2
TGTGCCAGCAGCCAAGATCGCAGGGGACCTGGAAGGGACGAGCAGTACTTC	CASSQDRRGPGRDEQYF	TRBV4-2	TRBJ2-7
TGTGCCAGCAGGGGACAAGGACCTGAAGCTTTCTTT	CASRGQGPEAFF	TRBV5-8	TRBJ1-1
TGTGCCAGCAGGGTACCAGGCGACTATGGCTACACCTTC	CASRVPGDYGYTF	TRBV6-2	TRBJ1-2
TGTGCCAGCAGCGATGGGGAGGCTGAAAAACTGTTTTTT	CASSDGEAEKLFF	TRBV9	TRBJ1-4
TGCAGTGCTAGCCAGGGACAGGGAAGTATAAAAAACATTCAGTACTTC	CSASQGQGSIKNIQYF	TRBV20-1	TRBJ2-4
TGTGCCAGCATTGGGGGCCCTAGCGGGGGGGCCGCCTCGGTTGGGGCCAACGTCCTGACTTTC	CASIGGPSGGAASVGANVLTF	TRBV12-3	TRBJ2-6
TGTGCCAGCAGCCCCCCGACAGGGATTGACGAGCAGTACTTC	CASSPPTGIDEQYF	TRBV5-4	TRBJ2-7
TGTGCCACCAAACAGGGGGCTCAGCCCCAGCATTTT	CATKQGAQPQHF	TRBV24-1	TRBJ1-5
TGTGCCAGCAACCCCGGGACAGGTGAAGAGACCCAGTACTTC	CASNPGTGEETQYF	TRBV2	TRBJ2-5
TGCAGTGCTAGAGTAGCGGGGATCTATGGCTACACCTTC	CSARVAGIYGYTF	TRBV20-1	TRBJ1-2
TGTGCCAGCAGTTCCAGGGGGGATGCTTTCTTT	CASSSRGDAFF	TRBV27	TRBJ1-1
TGTGCCAGCAGAATCCCCGGGGATCCTGGAAACACCATATATTTT	CASRIPGDPGNTIYF	TRBV25-1	TRBJ1-3
TGTGCCAGCAGCTCCCCCCGACCCTACGAGCAGTACTTC	CASSSPRPYEQYF	TRBV7-3	TRBJ2-7
TGTGCCAGCAGTTTAAGCCCGGGGGGGGCTGAAGCTTTCTTT	CASSLSPGGAEAFF	TRBV12-3	TRBJ1-1
TGTGCCAGCAGCCAGTCGAACACTGAAGCTTTCTTT	CASSQSNTEAFF	TRBV7-9	TRBJ1-1
TGTGCCAGCAGTTTAGGACAGGGAGCAACTAATGAAAAACTGTTTTTT	CASSLGQGATNEKLFF	TRBV12-4	TRBJ1-4
TGTGCCAGCAGCTATGCTGAGACGGCCCTCCACTTT	CASSYAETALHF	TRBV11-2	TRBJ1-6
TGTGCCATGTCCTGGCCGGTCAGCATGAACACTGAAGCTTTCTTT	CAMSWPVSMNTEAFF	TRBV28	TRBJ1-1
TGTGCCAGCAGCTTACAAGTACGGGGATGCGACATTCAGTACTTC	CASSLQVRGCDIQYF	TRBV7-3	TRBJ2-4
TGTGCCACGGGGGGGTCACCCTATGGCTACACCTTC	CATGGSPYGYTF	TRBV27	TRBJ1-2
TGCGCCAGCAGTGAGGGCGACAGGGTGGACGAGCAGTACTTC	CASSEGDRVDEQYF	TRBV10-2	TRBJ2-7
TGCAGCGTTGAAGATCGCACCCGGGACAGTAGGAACACTGAAGCTTTCTTT	CSVEDRTRDSRNTEAFF	TRBV29-1	TRBJ1-1
TGTGCCAGCAGCTTAGAAACCTTTAGCCGGGACAGGGTTGGTAGAGTGCAGGTTAGCAATCAGCCCCAGCATTTT	CASSLETFSRDRVGRVQVSNQPQHF	TRBV11-3	TRBJ1-5
TGTGCCAGCAGCTTAGATGAAGGACAGGGGGAGGTAGCCAAAAACATTCAGTACTTC	CASSLDEGQGEVAKNIQYF	TRBV7-3	TRBJ2-4
TGTGCCAGCAGCGGACAGGGGACCGGGGAGCTGTTTTTT	CASSGQGTGELFF	TRBV7-4	TRBJ2-2
TGTGCCAGCAGCGTAGCAGGGACAGGGGGCACTAACTATGGCTACACCTTC	CASSVAGTGGTNYGYTF	TRBV9	TRBJ1-2
TGTGCCAGCAGCCCTGCCTCCTACGAGCAGTACTTC	CASSPASYEQYF	TRBV6-1	TRBJ2-7
TGCGCCAGCAGCTGTCCTGGGGCTCCCTACGAGCAGTACTTC	CASSCPGAPYEQYF	TRBV5-1	TRBJ2-7
TGTGCCATCAGTGAGCATGGGGGGCGAGATGAGCAGTTCTTC	CAISEHGGRDEQFF	TRBV10-3	TRBJ2-1
TGTGCCAGCAGTTTGGGTTCCGGGACTAGCGGGAGAGGCAATGAGCAGTTCTTC	CASSLGSGTSGRGNEQFF	TRBV27	TRBJ2-1
TGTGCCAGCAGTCCAGCCGGGTCCTACGAGCAGTACTTC	CASSPAGSYEQYF	TRBV6-5	TRBJ2-7
TGTGCCAACAGTTGGGATGGCTACACCTTC	CANSWDGYTF	TRBV12-3	TRBJ1-2
TGTGCCAGCATGGGCCGGAGCACAGATACGCAGTATTTT	CASMGRSTDTQYF	TRBV6-5	TRBJ2-3
TGTGCCAGCAGTGAGGACAGGGATTACCACTATGGCTACACCTTC	CASSEDRDYHYGYTF	TRBV6-1	TRBJ1-2
TGTGCCAGCAGCCATCCCCACCGCGGGCGACAGGGCAGATCTCAGGAGCAGTACTTC	CASSHPHRGRQGRSQEQYF	TRBV3-1	TRBJ2-7
TGCGCCAGCAGCGCCCATACACAGGGGGTATGTGGAAACACCATATATTTT	CASSAHTQGVCGNTIYF	TRBV5-1	TRBJ1-3
TGTGCCTGGAGTGGAACGGGGAGAGCCACCGGGGAGCTGTTTTTT	CAWSGTGRATGELFF	TRBV30	TRBJ2-2
TGTGCCAGCAGCCAGTTACGACAGGGGAGGGTAGGCTACACCTTC	CASSQLRQGRVGYTF	TRBV11-3	TRBJ1-2
TGCGCCAGCAGCTTGTGGGCCTCCAAGGTCTCTGGAAACACCATATATTTT	CASSLWASKVSGNTIYF	TRBV5-1	TRBJ1-3
TGTGCCAGTAGTATGAGAGAATGGACAGCTAACTATGGCTACACCTTC	CASSMREWTANYGYTF	TRBV19	TRBJ1-2
TGTGCCAGCAGCCTCCAGCTGGCGTACTTAGACTACGACACTGAAGCTTTCTTT	CASSLQLAYLDYDTEAFF	TRBV5-8	TRBJ1-1
TGTGCCAGCAGTTTGGGACAGCGAGGCTACGAGCAGTACTTC	CASSLGQRGYEQYF	TRBV27	TRBJ2-7
TGTGCCAGCAGTGACTCGAGAATTGGGACTGGGTCAACCGGGGAGCTGTTTTTT	CASSDSRIGTGSTGELFF	TRBV6-4	TRBJ2-2
TGTGCCAGCAGTGAGGGTAGACAGGGGAACTATGGCTACACCTTC	CASSEGRQGNYGYTF	TRBV6-4	TRBJ1-2
TGTGCCAGCAGCTCCTTAGGGGAACCGGACCGGTTAAAACTGTTTTTT	CASSSLGEPDRLKLFF	TRBV5-4	TRBJ1-4
TGTGCCAGCAGCTTGGTAAGGACGGTCGAGAACACTGAAGCTTTCTTT	CASSLVRTVENTEAFF	TRBV5-4	TRBJ1-1
TGCAGTGCTAGAGGAGTACGGATGCCCCAGCATTTT	CSARGVRMPQHF	TRBV20-1	TRBJ1-5
TGCAGTGCTAGGACAGGGGGTCACCGCAATCAGCCCCAGCATTTT	CSARTGGHRNQPQHF	TRBV20-1	TRBJ1-5
TGTGCCAGCAGCTTAAGAATAGGTAGGACTGGGGCCAACGTCCTGACTTTC	CASSLRIGRTGANVLTF	TRBV7-3	TRBJ2-6
TGCGCCAGCAGCTTGGGCGATTCAGGGACCTACGAGCAGTACTTC	CASSLGDSGTYEQYF	TRBV5-1	TRBJ2-7
TGTGCCAGCAGCCAAGATTCAAACGAATACGGAGAATACGAGCAGTACTTC	CASSQDSNEYGEYEQYF	TRBV14	TRBJ2-7
TGTGCCAGCAGCAAACGGGAGGGGACTAGCGGGTGCCGCTACGAGCAGTACTTC	CASSKREGTSGCRYEQYF	TRBV7-3	TRBJ2-7
TGTGCCAGCAATATGTGGACAGGTACCGGGGAGCTGTTTTTT	CASNMWTGTGELFF	TRBV6-3	TRBJ2-2
TGTGCCAGCAGGGACAGGCATCTAACTGAAGCTTTCTTT	CASRDRHLTEAFF	TRBV6-1	TRBJ1-1
TGTGCCAGTAGTCCTAGACAGGGCGGCGGACTACCCTCCTATAATTCACCCCTCCACTTT	CASSPRQGGGLPSYNSPLHF	TRBV19	TRBJ1-6
TGTGCCAGCAGCGGGAGCCGGACTAGCGGGGAGCAGTTCTTC	CASSGSRTSGEQFF	TRBV7-4	TRBJ2-1
TGTGCCAGCAGTGAAAATCCGGGGACTAGCGGGAGGGCCCATCAGGAGGAGGGTAACACCGGGGAGCTGTTTTTT	CASSENPGTSGRAHQEEGNTGELFF	TRBV6-1	TRBJ2-2
TGTGCCAGCACCCAGGAAATAAAGTTGGATCCCTACGAGCAGTACTTC	CASTQEIKLDPYEQYF	TRBV14	TRBJ2-7
TGTGCCAGCAGCCAAGATTTGGGGCTCACAGATACGCAGTATTTT	CASSQDLGLTDTQYF	TRBV14	TRBJ2-3
TGTGCCAGCAGCTATAGATTGCCGGCGGGAGAGGAGAACTCCTACGAGCAGTACTTC	CASSYRLPAGEENSYEQYF	TRBV7-2	TRBJ2-7
TGCGCCAGCACGGGGGGGGGTGAGACCCAGTACTTC	CASTGGGETQYF	TRBV10-1	TRBJ2-5
TGTGCCACCAGCGGACTTGGGAACACTGAAGCTTTCTTT	CATSGLGNTEAFF	TRBV15	TRBJ1-1
TGTGCCAGCCATGAGGCCGAGGGCTACAATGAGCAGTTCTTC	CASHEAEGYNEQFF	TRBV7-9	TRBJ2-1
TGTGCCAGCAGCCCGGGGAGCCTGTTTTTT	CASSPGSLFF	TRBV13	TRBJ1-4
TGCGCCAGCAGCCAAGATGCCAGGGGGGGCTTAGGCAATCAGCCCCAGCATTTT	CASSQDARGGLGNQPQHF	TRBV4-1	TRBJ1-5
TGCAGTGCTAGAGATCCACTAGCGGGAGCCAGGAGGGCCTACGAGCAGTACTTC	CSARDPLAGARRAYEQYF	TRBV20-1	TRBJ2-7
TGTGCCAGCAGTGGAAACGGGGGGCGATTCTACGAGCAGTACTTC	CASSGNGGRFYEQYF	TRBV6-4	TRBJ2-7
TGTGCCAGCAGCAGGACGCCCTTAGAAAAACTGTTTTTT	CASSRTPLEKLFF	TRBV11-2	TRBJ1-4
TGTGCCAGCAGCTTGGTCGGTGGGGAGGGGCTGGGCTACACCTTC	CASSLVGGEGLGYTF	TRBV5-5	TRBJ1-2
TGTGCCAGCTCAGACGTTGGGAACACCATATATTTT	CASSDVGNTIYF	TRBV18	TRBJ1-3
TGTGCCAGCAGCGGGGGGGAGCAGTTCTTC	CASSGGEQFF	TRBV9	TRBJ2-1
TGTGCCTGGAAGACCAGGGAGACCCAGTACTTC	CAWKTRETQYF	TRBV30	TRBJ2-5
TGCAGTGCTAGTGGAGTAGGGGGGGAATGGGGGACCGGGGAGCTGTTTTTT	CSASGVGGEWGTGELFF	TRBV20-1	TRBJ2-2
TGTGCCAGCAGGCCACGGTATGCCGAGACCCAGTACTTC	CASRPRYAETQYF	TRBV6-4	TRBJ2-5
TGTGCCAGTGGGGGCACCGGGGAGCTGTTTTTT	CASGGTGELFF	TRBV6-1	TRBJ2-2
TGTGCCAGCAGTCACCCGGGACAAAATTCAAATCAGCCCCAGCATTTT	CASSHPGQNSNQPQHF	TRBV12-4	TRBJ1-5
TGTGCCAGCAGCCAAGAAGACGACAGGGGGCACCATTCCTACGAGCAGTACTTC	CASSQEDDRGHHSYEQYF	TRBV14	TRBJ2-7
TGCGCCAGCAGTGACCCGCGAGTACCTGGTGGGGACCGCATCCCTGGAAACACCATATATTTT	CASSDPRVPGGDRIPGNTIYF	TRBV10-1	TRBJ1-3
TGTGCCAGCAGCTCCAGGATGTACAATGAGCAGTTCTTC	CASSSRMYNEQFF	TRBV9	TRBJ2-1
TGTGCCAGCAGCGGGACTAGGGCAAGAAACATTCAGTACTTC	CASSGTRARNIQYF	TRBV13	TRBJ2-4
TGTGCTAGTGGGATACCGCAGGGCGATCAGCCCCAGCATTTT	CASGIPQGDQPQHF	TRBV12-5	TRBJ1-5
TGTGCCAGCAGCCTAGGAGTAGGGACCGTATATAGCTCCTACGAGCAGTACTTC	CASSLGVGTVYSSYEQYF	TRBV3-1	TRBJ2-7
TGTGCCACCAGTGATTTGAAGCAGGGGACAGTGGGTTATGGCTACACCTTC	CATSDLKQGTVGYGYTF	TRBV24-1	TRBJ1-2
TGTGCCAGCAGCTGGACAGGCGAAAAACTGTTTTTT	CASSWTGEKLFF	TRBV28	TRBJ1-4
TGTGCCAGCAGTTTTAGCATTAGCGGGGAGCTGTTTTTT	CASSFSISGELFF	TRBV6-9	TRBJ2-2
TGTGCCAGCAGTGAACTGGACAGAAATGAGCAGTACTTC	CASSELDRNEQYF	TRBV2	TRBJ2-7
TGCAGTGCCCCCGCCACAGGTTCACCCCTCCACTTT	CSAPATGSPLHF	TRBV20-1	TRBJ1-6
TGCAGCGTTGTGTGCCGGGTTAGGGTTGATCGGGCTGGAAACACCATATATTTT	CSVVCRVRVDRAGNTIYF	TRBV29-1	TRBJ1-3
TGCAGACTAGCGGGAGGGCACTACAATGAGCAGTTCTTC	CRLAGGHYNEQFF	TRBV20-1	TRBJ2-1
TGTGCCAGCAGTACGGGCCCAGCTTCGTGGGAGCAGTACTTC	CASSTGPASWEQYF	TRBV6-1	TRBJ2-7
TGTGCCAGCAGTGTGCTAGCTGGAAATGAGCAGTTCTTC	CASSVLAGNEQFF	TRBV27	TRBJ2-1
TGCGCCAGCAGCCAAGCTCTTCCCGGACTATACACCTACGAGCAGTACTTC	CASSQALPGLYTYEQYF	TRBV4-1	TRBJ2-7
TGTGCCAGCCCTTGGGACGAGCCGGGGGGGGATGGCTACACCTTC	CASPWDEPGGDGYTF	TRBV6-3	TRBJ1-2
TGTGCCAGCAGTGGATGTCACAGGGGACCTGAAGCTTTCTTT	CASSGCHRGPEAFF	TRBV28	TRBJ1-1
TGTGCCAGCAGCCAAGTGGACTACGAGCAGTACTTC	CASSQVDYEQYF	TRBV3-1	TRBJ2-7
TGCGCCAGCGAGACAGCTAGGGTTTACACTGAAGCTTTCTTT	CASETARVYTEAFF	TRBV4-1	TRBJ1-1
TGCAGTGCAATAATCCCCTCAGGGGCCGACAATCAGCCCCAGCATTTT	CSAIIPSGADNQPQHF	TRBV20-1	TRBJ1-5
TGTGCCAGCAGCTTAGAGTCACTCAACAGGCTCCCTCACACTGAAGCTTTCTTT	CASSLESLNRLPHTEAFF	TRBV11-2	TRBJ1-1
TGTGCCATCAGCCGAAGCCAACAGGGAAAGCAGTACTTC	CAISRSQQGKQYF	TRBV10-3	TRBJ2-7
TGTGCCAGCAGGTCGAGGGATGAAAAACTGTTTTTT	CASRSRDEKLFF	TRBV12-4	TRBJ1-4
TGTGCCACCAGTGTCCCTCTATACACCGGGGAGCTGTTTTTT	CATSVPLYTGELFF	TRBV24-1	TRBJ2-2
TGTGCCAGTAGTATAGGCCGGGATCCCCAAGAGACCCAGTACTTC	CASSIGRDPQETQYF	TRBV19	TRBJ2-5
TGTGCCAGCAGCTTAATGGGACAGGGACTGAGAGAGCAGTTCTTC	CASSLMGQGLREQFF	TRBV11-2	TRBJ2-1
TGTGCCAGCAGTGACGGTAGGGTTGAGACCCAGTACTTC	CASSDGRVETQYF	TRBV25-1	TRBJ2-5
TGTGCCAGCCAAACGACAGGGCTTTACTTC	CASQTTGLYF	TRBV19	TRBJ2-4
TGTGCCAGTAGTTTCCCTAGCGGGAAACACTACGAGCAGTACTTC	CASSFPSGKHYEQYF	TRBV19	TRBJ2-7
TGTGCCAGCAGCTTCCCCCTGGGGGGAGGCCAGACCCAGTACTTC	CASSFPLGGGQTQYF	TRBV14	TRBJ2-5
TGCGCCAGCAACCTTGGGACAGGGGCTGGATATAGCAATCAGCCCCAGCATTTT	CASNLGTGAGYSNQPQHF	TRBV10-1	TRBJ1-5
TGTGCCATCAGTGATTCAAAGGGGACTTCCAATCAGCCCCAGCATTTT	CAISDSKGTSNQPQHF	TRBV10-3	TRBJ1-5
TGTGGAACAGTTGGGACTAGCGGGCTAAAGCCAACACCCAATGAGCAGTTCTTC	CGTVGTSGLKPTPNEQFF	TRBV25-1	TRBJ2-1
TGTGCCAGCAGCCACCGACCCTCGCGGACACCGGTTAGCATGGGGGAGGTGTACGAGCAGTACTTC	CASSHRPSRTPVSMGEVYEQYF	TRBV14	TRBJ2-7
TGTGCCAGTAGTGAAGCGACAGGGCCTGAGAAAAATGAAAAACTGTTTTTT	CASSEATGPEKNEKLFF	TRBV19	TRBJ1-4
TGTGCCAGCAGCGGAGGGGAGTACAGGGGGAAAGAGACCCAGTACTTC	CASSGGEYRGKETQYF	TRBV7-3	TRBJ2-5
TGTGCCGGGACTAGCGGGGGGGCGAACACCGGGGAGCTGTTTTTT	CAGTSGGANTGELFF	TRBV6-4	TRBJ2-2
TGTGCAGGGCCGAGGGCCTACGAGCAGTACTTC	CAGPRAYEQYF	TRBV30	TRBJ2-7
TGTGCCAGCAGTGCTAAGACTCAGGGACGGAACATTCAGTACTTC	CASSAKTQGRNIQYF	TRBV6-1	TRBJ2-4
TGCAGTGCTAGACCCGAAAGGTATGGTGTTTCCGGAATGAACACTGAAGCTTTCTTT	CSARPERYGVSGMNTEAFF	TRBV20-1	TRBJ1-1
TGTGCCACCAGGAGGGGCACTTCCTACGAGCAGTACTTC	CATRRGTSYEQYF	TRBV24-1	TRBJ2-7
TGTGCCAGCAGCTTGGCCAAACTCGCATCCCCTAATGAGCAGTTCTTC	CASSLAKLASPNEQFF	TRBV5-5	TRBJ2-1
TGTGCCAGCAAGCGCTCAGGGGGGTGGTACGAGCAGTACTTC	CASKRSGGWYEQYF	TRBV6-6	TRBJ2-7
TGTTTTATGGGACGGGATACGCAGTATTTT	CFMGRDTQYF	TRBV10-3	TRBJ2-3
TGTGCCAGCAGCGTCAGGAACTCTGGAAACACCATATATTTT	CASSVRNSGNTIYF	TRBV9	TRBJ1-3
TGTGCCAGCAGTTGGGGACTAGCGGGAAAAAACATTCAGTACTTC	CASSWGLAGKNIQYF	TRBV27	TRBJ2-4
TGCGCCAGCAGCTTGTTTCCCGGGACAGGGGTTATAGCCAAAAACATTCAGTACTTC	CASSLFPGTGVIAKNIQYF	TRBV5-1	TRBJ2-4
TGTGCCAGCAGAAATCCGCCAGGACAGGGTGTGCAGTACTTC	CASRNPPGQGVQYF	TRBV7-3	TRBJ2-7
TGTGCCAACGGGGGAGGCTACGAGCAGTACTTC	CANGGGYEQYF	TRBV25-1	TRBJ2-7
TGTGCCAGCAGTTTCCCCCGGTACGGGGCCGGCACTGAAGCTTTCTTT	CASSFPRYGAGTEAFF	TRBV12-4	TRBJ1-1
TGCGCCAGCAGGGGGGACGACAATGAGCAGTTCTTC	CASRGDDNEQFF	TRBV10-2	TRBJ2-1
TGTGCCAGCAGGGGACAGGGGGCACAAAACGGCTACACCTTC	CASRGQGAQNGYTF	TRBV5-6	TRBJ1-2
TGTGCCAGCAGTCCGGGGATACGGGGGCGGGTCCCCGAGGGCTATGGCTACACCTTC	CASSPGIRGRVPEGYGYTF	TRBV6-5	TRBJ1-2
TGCAGCCGAGGACTAGCGGGGGGAGATACGCAGTATTTT	CSRGLAGGDTQYF	TRBV29-1	TRBJ2-3
TGTGCCAGCAGAGCCAACTATGGCTACACCTTC	CASRANYGYTF	TRBV6-3	TRBJ1-2
TGTGCCAGCACTATGACTAAGTACGAGCAGTACTTC	CASTMTKYEQYF	TRBV7-2	TRBJ2-7
TGCGCCAGCAGTGAGTCTTGTCCGACTAGCGGGCACAATGAGCAGTTCTTC	CASSESCPTSGHNEQFF	TRBV10-1	TRBJ2-1
TGTGCCAGCAGCATTCCCCGCTCCCGCCGGGGGGTAGCGAACACCGGGGAGCTGTTTTTT	CASSIPRSRRGVANTGELFF	TRBV7-9	TRBJ2-2
TGTGCCAGCAAACGGGACAGGGGACCTGAGCAGTACTTC	CASKRDRGPEQYF	TRBV27	TRBJ2-7
TGTGCCAGCAGTTACTTCTCTGCGAACACCGGGGAGCTGTTTTTT	CASSYFSANTGELFF	TRBV6-3	TRBJ2-2
TGTGCCAGCAGCCGACCCAGGGGATCCTACGAGCAGTACTTC	CASSRPRGSYEQYF	TRBV9	TRBJ2-7
TGTGCCTGGAAAGGGGACAGGAATAGGAACACTGAAGCTTTCTTT	CAWKGDRNRNTEAFF	TRBV30	TRBJ1-1
TGTGCCAGTCCCATCTCGGGACAGGGCTCCTACGAGCAGTACTTC	CASPISGQGSYEQYF	TRBV19	TRBJ2-7
TGCGCCAGCACCCGGTCCGGGACAGGGAAGACGCATCAGCCCCAGCATTTT	CASTRSGTGKTHQPQHF	TRBV10-1	TRBJ1-5
TGCGCCAGCAGTTTTCTAACTGACGACAATGAGCAGTTCTTC	CASSFLTDDNEQFF	TRBV4-1	TRBJ2-1
TGTGCCAGCATCGGGACCATCGGGGGCACTGAAGCTTTCTTT	CASIGTIGGTEAFF	TRBV6-4	TRBJ1-1
TGTGCCAGCAGCATCACAATCTACGAGCAGTACTTC	CASSITIYEQYF	TRBV7-4	TRBJ2-7
TGTGCCAGCAGTGCCGCCCCGAAACAGGGGGTAGACTACGAGCAGTACTTC	CASSAAPKQGVDYEQYF	TRBV6-4	TRBJ2-7
TGTGCCAGCAGCGGTAGGCGGGAGAGAGGCCCCTACGAGCAGTACTTC	CASSGRRERGPYEQYF	TRBV13	TRBJ2-7
TGTGCCAGCAAGTGGGGGGGAAGCGGGTATGGCTACACCTTC	CASKWGGSGYGYTF	TRBV28	TRBJ1-2
TGTGCCAGCAGATGGACAGAGCTAGAGACCCAGTACTTC	CASRWTELETQYF	TRBV6-5	TRBJ2-5
TGTGCCAGCCGAAGACGGAATGAGCAGTTCTTC	CASRRRNEQFF	TRBV7-3	TRBJ2-1
TGTGCCAGCACCACAGGGAGCCGCAATCAGCCCCAGCATTTT	CASTTGSRNQPQHF	TRBV6-2	TRBJ1-5
TGTGCCAGCAGTGTCACCCAGCCGGGACAGGGTTCTTCGTTCTATGGCTACACCTTC	CASSVTQPGQGSSFYGYTF	TRBV28	TRBJ1-2
TGTGCCAGCAGCGTAGACCTTCCGCGACTAGCGGCGGCGGGCTCCTACGAGCAGTACTTC	CASSVDLPRLAAAGSYEQYF	TRBV9	TRBJ2-7
TGTGCCAGCAGTCCTCGGGTGTACACTGAAGCTTTCTTT	CASSPRVYTEAFF	TRBV27	TRBJ1-1
TGTGCCAGCTCCGGTACTAGCGGGGCAAAGAACACCGGGGAGCTGTTTTTT	CASSGTSGAKNTGELFF	TRBV25-1	TRBJ2-2
TGTGCCAGCAGCTGGGACAGGTGGGGGTCTGGCTACACCTTC	CASSWDRWGSGYTF	TRBV7-8	TRBJ1-2
TGCGCCAGCAGCTTGTACAAGGGTTACTATGGCTACACCTTC	CASSLYKGYYGYTF	TRBV5-1	TRBJ1-2
TGTGCCACCGAGGCCGCCTACGAGCAGTACTTC	CATEAAYEQYF	TRBV24-1	TRBJ2-7
TGTGCCAGCAGTTCCCTCGACAGGGTTACCTACGAGCAGTACTTC	CASSSLDRVTYEQYF	TRBV27	TRBJ2-7
TGTGCCAGCAGTTTGCAGGCCATGGCTGAAGCTTTCTTT	CASSLQAMAEAFF	TRBV28	TRBJ1-1
TGTGCCAGCAGCCAATCTTCATTTGACACTGAAGCTTTCTTT	CASSQSSFDTEAFF	TRBV3-1	TRBJ1-1
TGTGCCACCAGTGATTCGATACCTAGGAGCTCCTATAATTCACCCCTCCACTTT	CATSDSIPRSSYNSPLHF	TRBV24-1	TRBJ1-6
TGTGCCAGCAGCTTGTCATATCCGACAGCCCAGCATTTT	CASSLSYPTAQHF	TRBV5-6	TRBJ1-5
TGTGCCAGCAGCTCGACGCTTTCAGAGAGGCCGGGTAATTCACCCCTCCACTTT	CASSSTLSERPGNSPLHF	TRBV7-6	TRBJ1-6
TGTGCCAGCAGCATCCCGGGACAGGGTCCTAATGAAAAACTGTTTTTT	CASSIPGQGPNEKLFF	TRBV2	TRBJ1-4
TGCAGTGCCAGACAGAATTCACCCCTCCACTTT	CSARQNSPLHF	TRBV20-1	TRBJ1-6
TGTGCCAGCAGCTTAAGGAGGGGGGGTGAGCAGTTCTTC	CASSLRRGGEQFF	TRBV5-4	TRBJ2-1
TGTGCCAGCAGTGACGGATTTCAGCAGTCAGATACGCAGTATTTT	CASSDGFQQSDTQYF	TRBV6-4	TRBJ2-3
TGTGCCAGCAGCCACTCCCCCCGGGACAGAAAGTGCCTCGGTTCCGGGTATGGCTACACCTTC	CASSHSPRDRKCLGSGYGYTF	TRBV3-1	TRBJ1-2
TGTGCCAGCAGCCCTCAGGGGGCTCTTTGGGGATGGGAAGGCTACACCTTC	CASSPQGALWGWEGYTF	TRBV14	TRBJ1-2
TGTGCCATCTTACACAGGGGGGCTAGCACAGATACGCAGTATTTT	CAILHRGASTDTQYF	TRBV10-3	TRBJ2-3
TGTGCCAGCGCATTAGCGGGCTACGAGCAGTACTTC	CASALAGYEQYF	TRBV7-6	TRBJ2-7
TGCGCCAGCAGCCAAGATCGGGACAGGGGACGCGATCAGCCCCAGCATTTT	CASSQDRDRGRDQPQHF	TRBV4-3	TRBJ1-5
TGTGCCAGCAGCGATCCAGCCATTCAGCCCCAGCATTTT	CASSDPAIQPQHF	TRBV9	TRBJ1-5
TGTGCCAGCAGCTTAGCAAGGACCGTAAAGGGGTACGAGCAGTACTTC	CASSLARTVKGYEQYF	TRBV7-4	TRBJ2-7
TGTGCCAGCAGGTCCCCAGTTGGGAAAGTCCATAGCAATCAGCCCCAGCATTTT	CASRSPVGKVHSNQPQHF	TRBV5-8	TRBJ1-5
TGCAGCGCGGGAGACGAGCAGTACTTC	CSAGDEQYF	TRBV29-1	TRBJ2-7
TGTGCCAGGCAGCAGGCACCTGGCCCAGGCACAGATACGCAGTATTTT	CARQQAPGPGTDTQYF	TRBV19	TRBJ2-3
TGTGCCAGCAGCTTAAGGTGGCGTTCGGCATCTAACTATGGCTACACCTTC	CASSLRWRSASNYGYTF	TRBV11-3	TRBJ1-2
TGCGCCAGCAGCCAAGATACTAGCGGGAGAACTGGGGAGCAGTACTTC	CASSQDTSGRTGEQYF	TRBV4-1	TRBJ2-7
TGTGCCAGCACCCGGGGGAATGAGCAGTTCTTC	CASTRGNEQFF	TRBV6-6	TRBJ2-1
TGTGCCAGCAGCCATTCCTCACGGGGTGAGTATGGCTACACCTTC	CASSHSSRGEYGYTF	TRBV14	TRBJ1-2
TGTGCCAGCAGCGTAGCCCAGGTACCCGCGGCGGGTACAGAGACCCAGTACTTC	CASSVAQVPAAGTETQYF	TRBV9	TRBJ2-5
TGTGCCAGCAGTGAGCCGATTCCCAGGGGAAAACTGTTTTTT	CASSEPIPRGKLFF	TRBV6-1	TRBJ1-4
TGTGCCAGACGTGGCGGGACTAGCCGGAACACCGGGGAGCTGTTTTTT	CARRGGTSRNTGELFF	TRBV25-1	TRBJ2-2
TGCGCCAGCCGAAGCCAGGGGAGTAGCCGAAACACCATATATTTT	CASRSQGSSRNTIYF	TRBV5-1	TRBJ1-3
TGTGCCTTACAGGGAGAGAGTTCCTACGAGCAGTACTTC	CALQGESSYEQYF	TRBV30	TRBJ2-7
TGTGCCAGCAGAAGCTACGAGCAGTACTTC	CASRSYEQYF	TRBV6-5	TRBJ2-7
TGTGCCAGCAGCCAGGGGGCCTCCACTGAAGCTTTCTTT	CASSQGASTEAFF	TRBV7-9	TRBJ1-1
TGTGCCAGCAGCATTCGGGGAGGGAGAAACACCATATATTTT	CASSIRGGRNTIYF	TRBV3-1	TRBJ1-3
TGTGCCTGGAGTAATTATCCGGGGGGATATGGCTACACCTTC	CAWSNYPGGYGYTF	TRBV30	TRBJ1-2
TGTGCCAGCACTCTGACAGGGAATGGAAACACCATATATTTT	CASTLTGNGNTIYF	TRBV6-4	TRBJ1-3
TGTGCCAGCAGTTACCACCCCCATACCAACTATGGCTACACCTTC	CASSYHPHTNYGYTF	TRBV6-8	TRBJ1-2
TGTGCCAGCAGTTACGTCCGCGGGACAGACGAGCAGTACTTC	CASSYVRGTDEQYF	TRBV6-5	TRBJ2-7
TGTGCTAGTGCCCTATCCGGGACAGTTGCCGAGAATGAAAAACTGTTTTTT	CASALSGTVAENEKLFF	TRBV12-5	TRBJ1-4
TGTGCCTGGAGTGTACCGTGCGTAGGGGAGGATGAAGCTTTCTTT	CAWSVPCVGEDEAFF	TRBV30	TRBJ1-1
TGCAGTGCGAGGGACAGGGAGCAAGAGACCCAGTACTTC	CSARDREQETQYF	TRBV20-1	TRBJ2-5
TGCAGTGCATTATACAGGGCCATGGAGGGCTACGAGCAGTACTTC	CSALYRAMEGYEQYF	TRBV20-1	TRBJ2-7
TGCGCCAGCAGCCATCGCGAGTGCCACGACCCGCCTTCAAGGAAACCGTACTTC	CASSHRECHDPPSRKPYF	TRBV4-1	TRBJ2-5
TGTGCCAGCAGCTTAGTCGGGGAGAACACTGAAGCTTTCTTT	CASSLVGENTEAFF	TRBV11-2	TRBJ1-1
TGTGCCAGCAGCAGACAGGGACGTGATGTCTATGGCTACACCTTC	CASSRQGRDVYGYTF	TRBV7-3	TRBJ1-2
TGTGCTAGTGGTTTGGAATGGACAGGGCCCCCCTATGGCTACACCTTC	CASGLEWTGPPYGYTF	TRBV12-5	TRBJ1-2
TGTGCCAGCAGCGAGGTATACATCACCAGAAGAATGAACACTGAAGCTTTCTTT	CASSEVYITRRMNTEAFF	TRBV7-7	TRBJ1-1
TGTGCCAGCAGCGGGACAGGGACCCCGAACGGATCAAACAATCAGCCCCAGCATTTT	CASSGTGTPNGSNNQPQHF	TRBV6-5	TRBJ1-5
TGTGCCAGCAGTGAGACTAGCGTTCAGCAGTACTTC	CASSETSVQQYF	TRBV6-4	TRBJ2-7
TGTGCCATCAGGGCATGCGAGTCCGCCAAAAACATTCAGTACTTC	CAIRACESAKNIQYF	TRBV10-3	TRBJ2-4
TGTGCCAGCAAGTTCTGGGACGCCACAGATACGCAGTATTTT	CASKFWDATDTQYF	TRBV7-9	TRBJ2-3
TGCGCCAGCAGCCAAGGGGGGAAGTCCTATGGCTACACCTTC	CASSQGGKSYGYTF	TRBV4-3	TRBJ1-2
TGTGCCAGCAGTTACTCGAGGGTCGAATTCCGGGACAAGAGCGTATCGACCCAGTACTTC	CASSYSRVEFRDKSVSTQYF	TRBV6-6	TRBJ2-5
TGCGCCAGCAGCCAAGCGTGCCCCCGTGCCCAGGGAGCTTGGGGCACCGGGGAGCTGTTTTTT	CASSQACPRAQGAWGTGELFF	TRBV4-1	TRBJ2-2
TGTGCCAGCAGCTTAGTCCAGGCCCGGGGCTGCTACAATGAGCAGTTCTTC	CASSLVQARGCYNEQFF	TRBV11-2	TRBJ2-1
TGTGCCAGCAGCAAGGGGGGCCCCCAGGGTGTCCTTGAAAAACTGTTTTTT	CASSKGGPQGVLEKLFF	TRBV3-1	TRBJ1-4
TGTGCCAGTGGTTTACCGGGACTAGCGCTCCAGGGCGAGCAGTACTTC	CASGLPGLALQGEQYF	TRBV6-2	TRBJ2-7
TGTGCCAGCAGCTTATCTGGGGGGACCACAGATACGCAGTATTTT	CASSLSGGTTDTQYF	TRBV7-3	TRBJ2-3
TGTGCCAGCAGTGAATTATATACTAGCGGCTTAGAGAGATTCCTCTACGAGCAGTACTTC	CASSELYTSGLERFLYEQYF	TRBV25-1	TRBJ2-7
TGTGCCAGCAGCCAAGGCAGGGCCCAAGAGCAGTTCTTC	CASSQGRAQEQFF	TRBV3-1	TRBJ2-1
TGCAGTGCTAGGGCCCCAGGGCCGAACACCGGGGAGCTGTTTTTT	CSARAPGPNTGELFF	TRBV20-1	TRBJ2-2
TGCGCCAGCAGCTTGACGAACACTAGCGGGAGTGGCGCCAAAAACATTCAGTACTTC	CASSLTNTSGSGAKNIQYF	TRBV5-1	TRBJ2-4
TGTGCCAGCAGCTTCATGGGGGGCACAGATACGCAGTATTTT	CASSFMGGTDTQYF	TRBV5-5	TRBJ2-3
TGTGCCAGCACCCGGACAGCTACAGCTAACTATGGCTACACCTTC	CASTRTATANYGYTF	TRBV6-8	TRBJ1-2
TGCAGTGCTAGAACCCTGATCCCAACTGTTTCAGGCGCTTGGCAGCCCCAGCATTTT	CSARTLIPTVSGAWQPQHF	TRBV20-1	TRBJ1-5
TGTGCCACCAGTTCACCCCAGTTGCCTAAGGACAGAGTCCTAGCCAAAAACATTCAGTACTTC	CATSSPQLPKDRVLAKNIQYF	TRBV24-1	TRBJ2-4
TGTGCCAGCAGCCAAGAACGTCGACAGATGGGTTCCAGCAATCAGCCCCAGCATTTT	CASSQERRQMGSSNQPQHF	TRBV4-2	TRBJ1-5
TGTGCCAGTAAATTGGGGGGGTGTCCCAATGAGCAGTTCTTC	CASKLGGCPNEQFF	TRBV19	TRBJ2-1
TGTGCCAGCAGTTATCCTTACTCCCGGGACGACTTTGAAGAGACCCAGTACTTC	CASSYPYSRDDFEETQYF	TRBV6-5	TRBJ2-5
TGTGCCAGCCACGCGGGGAACACTGAAGCTTTCTTT	CASHAGNTEAFF	TRBV7-6	TRBJ1-1
TGTGCCAGCAGCTTAGGATCTATAGACCACCCAGAGACCCAGTACTTC	CASSLGSIDHPETQYF	TRBV11-2	TRBJ2-5
TGTGCCAGCAGCAGAACAGGTACTCAAGAGTTTGACACCGGGGAGCTGTTTTTT	CASSRTGTQEFDTGELFF	TRBV11-3	TRBJ2-2
TGTGCCAGCACGTGCCGAGATAGCTCCTACAATGAGCAGTTCTTC	CASTCRDSSYNEQFF	TRBV2	TRBJ2-1
TGTGCCAGCATAGGAGCCTCCGAGGGGGGGTCGGGGAATGAGCAGTTCTTC	CASIGASEGGSGNEQFF	TRBV9	TRBJ2-1
TGCGCCAGCAGCCAAGATGAGGAGACTAGGAATAACCGCACAGATACGCAGTATTTT	CASSQDEETRNNRTDTQYF	TRBV4-1	TRBJ2-3
TGTGCCAGCAGTTTATCCGGGACGCACAATCAGCCCCAGCATTTT	CASSLSGTHNQPQHF	TRBV27	TRBJ1-5
TGTGCCACCAGCGACAAGAAATATAGGGACAGACGCACTGAAGCTTTCTTT	CATSDKKYRDRRTEAFF	TRBV15	TRBJ1-1
TGTGCCAGCAGCCAAGCCCCGGGGGTCTCTTACAATGAGCAGTTCTTC	CASSQAPGVSYNEQFF	TRBV3-1	TRBJ2-1
TGTGCCAGCAGCAGGGTTCCCTGGGACAGGGATTTGGCGAACACCGGGGAGCTGTTTTTT	CASSRVPWDRDLANTGELFF	TRBV7-9	TRBJ2-2
TGTGCCAGCAGTTTGGAAAGTCCGGGACTAGGGGACTCCTACGAGCAGTACTTC	CASSLESPGLGDSYEQYF	TRBV28	TRBJ2-7
TGTGCCAGCAGTTTATTCGAGACCTACGAGCAGTACTTC	CASSLFETYEQYF	TRBV28	TRBJ2-7
TGTGCCATCAGTGAGACAGGGAGGAGCTCCTACAATGAGCAGTTCTTC	CAISETGRSSYNEQFF	TRBV10-3	TRBJ2-1
TGTGCCAGCAGCTCGTTAAAGTTCAAACGGAGGAAGAGGGAGTCCCTCTCCTACGAGCAGTACTTC	CASSSLKFKRRKRESLSYEQYF	TRBV11-2	TRBJ2-7
TGTGCCAGCAGTAGCAACGGGGATGGTAGCTCTGGGGCCAACGTCCTGACTTTC	CASSSNGDGSSGANVLTF	TRBV6-4	TRBJ2-6
TGTGCCAGCAGTTCGGAGGCTAATCAGCCCCAGCATTTT	CASSSEANQPQHF	TRBV2	TRBJ1-5
TGTGCCAGCAGCCAAGAATGGGGGACTGAATCCTATGGCTACACCTTC	CASSQEWGTESYGYTF	TRBV3-1	TRBJ1-2
TGTGCCAGCAGCCCTCAGGCGGAAGTCTCCTACAATGAGCAGTTCTTC	CASSPQAEVSYNEQFF	TRBV28	TRBJ2-1
TGTGCCATCAGTGAGTCCCCGGATGCTCCCTACAATGAGCAGTTCTTC	CAISESPDAPYNEQFF	TRBV10-3	TRBJ2-1
TGTGCCAGCAGTACACCCCCCGGGACTGAAGTGGTTTACAATGAGCAGTTCTTC	CASSTPPGTEVVYNEQFF	TRBV6-4	TRBJ2-1
TGCGCCAGCAGCTTTCCCCCGTCCCCGGGGGGAGGGTACCAAGAGACCCAGTACTTC	CASSFPPSPGGGYQETQYF	TRBV5-1	TRBJ2-5
TGTGCCAGCAGTTTCCCACCACAGGGGGCATATGGCTACACCTTC	CASSFPPQGAYGYTF	TRBV12-4	TRBJ1-2
TGTGCCAGCAGTTGGCCTCGTCTAGTCTACGAGCAGTACTTC	CASSWPRLVYEQYF	TRBV5-4	TRBJ2-7
TGTGCCAGAATTGGGGTTGATAACAATGAGCAGTTCTTC	CARIGVDNNEQFF	TRBV6-5	TRBJ2-1
TGCGCCAGCAGCCCTCAGCAGGTACGGACCGGGGAGCTGTTTTTT	CASSPQQVRTGELFF	TRBV5-1	TRBJ2-2
TGCGCCAGCAGCTTGTGGGGCGCTTCCGGTCCCAATAATGAGCAGTTCTTC	CASSLWGASGPNNEQFF	TRBV5-1	TRBJ2-1
TGTGCCACCAGTGAACAGGGGAGTCACTATGGCTACACCTTC	CATSEQGSHYGYTF	TRBV24-1	TRBJ1-2
TGTGCCAGCGGCAGGAATCCCCAAGTCGACAGGGGAACCGCTTTCTTT	CASGRNPQVDRGTAFF	TRBV9	TRBJ1-1
TGTGCCAGCTCACGTAGCGAGGACAGGGTGATGAACACTGAAGCTTTCTTT	CASSRSEDRVMNTEAFF	TRBV18	TRBJ1-1
TGTGCCAGCAGCTGGCCGGTGGTATCTTACCAAGAGACCCAGTACTTC	CASSWPVVSYQETQYF	TRBV13	TRBJ2-5
TGTGCCAGTAGTATCCTGGACTTGACAGCCTACGAGCAGTACTTC	CASSILDLTAYEQYF	TRBV19	TRBJ2-7
TGTGCCAGCAGCTTGAGGGTGGGAAGCAATCAGCCCCAGCATTTT	CASSLRVGSNQPQHF	TRBV5-6	TRBJ1-5
TGTGCCAGCAGGGGGGGGGGTTTTCTCACAGATACGCAGTATTTT	CASRGGGFLTDTQYF	TRBV27	TRBJ2-3
TGTGCCAGATTCCTGCAGGGGGCTATGGGCTATGGCTACACCTTC	CARFLQGAMGYGYTF	TRBV27	TRBJ1-2
TGTGCCAGCAGCACTCCGATGCCCCGGGAGACCCAGTACTTC	CASSTPMPRETQYF	TRBV13	TRBJ2-5
TGTGCCAGACCCGGGACAGGGGTGGGGGGTAATTCACCCCTCCACTTT	CARPGTGVGGNSPLHF	TRBV6-1	TRBJ1-6
TGTGCCAGCAGTTTGAAGGGGGCCGGTCCTTCAGGATACGAGCAGTACTTC	CASSLKGAGPSGYEQYF	TRBV27	TRBJ2-7
TGCAGTGCTAGAGGACCCACCGGCGGAAGGGGGGATGGCTACACCTTC	CSARGPTGGRGDGYTF	TRBV20-1	TRBJ1-2
TGTGCCAGCAGTCCTCCGGTGAGGAGGGGTCATCAGCCCCAGCATTTT	CASSPPVRRGHQPQHF	TRBV28	TRBJ1-5
TGCAGCGGAACCTCCGGGACTCCCTCCTACGAGCAGTACTTC	CSGTSGTPSYEQYF	TRBV29-1	TRBJ2-7
TGTGCCAGCAGTCTACGGAGGTACGAGCAGTACTTC	CASSLRRYEQYF	TRBV6-5	TRBJ2-7
TGTGCCACCAGTGATTTGTCTCGGACGGAAAGGTATAGCAATCAGCCCCAGCATTTT	CATSDLSRTERYSNQPQHF	TRBV24-1	TRBJ1-5
TGTGCCAGCAGCAGCCCTGGACAGGGGACAGACAATGAGCAGTTCTTC	CASSSPGQGTDNEQFF	TRBV7-3	TRBJ2-1
TGTGCTAGTGGTGAGGGCGTACAAGCAGGGTACGAGCAGTACTTC	CASGEGVQAGYEQYF	TRBV12-5	TRBJ2-7
TGCGCCAGCAGCTCGTCACAAGTTGAGCAGTTCTTC	CASSSSQVEQFF	TRBV5-1	TRBJ2-1
TGTGCCAGCAGCTTAAACGGTAATCACACTGAAGCTTTCTTT	CASSLNGNHTEAFF	TRBV7-3	TRBJ1-1
TGTGCTAGTCGGGGGCCGGGGCGGGTTGAAAAACTGTTTTTT	CASRGPGRVEKLFF	TRBV12-5	TRBJ1-4
TGTGCCAGCAACGGACACGAGCAGTACTTC	CASNGHEQYF	TRBV6-1	TRBJ2-7
TGTGCCAGCAGTGCCTGCTTCCAGGGGTCGAGGAACACTGAAGCTTTCTTT	CASSACFQGSRNTEAFF	TRBV6-4	TRBJ1-1
TGTGCCCCACGAATCTTGCTGGGGCCCGATAAAGGGGTTGAGCAGTACTTC	CAPRILLGPDKGVEQYF	TRBV2	TRBJ2-7
TGTGCCAGCAGTAGGTGGGGTCCCCCCGACTATGGCTACACCTTC	CASSRWGPPDYGYTF	TRBV6-4	TRBJ1-2
TGTGCCAGCACGGACAGAAAGCACTCCTACGAGCAGTACTTC	CASTDRKHSYEQYF	TRBV14	TRBJ2-7
TGTGCCAGCAGCCCCTCCGAGCGGGACAGGGCCTACGAGCAGTACTTC	CASSPSERDRAYEQYF	TRBV6-4	TRBJ2-7
TGTGCCAGCAGTGGTATTACAGGGTTTTGCTATGGCTACACCTTC	CASSGITGFCYGYTF	TRBV2	TRBJ1-2
TGTGCCAGTCCAGCTGGGGAGCAGCCCCAGCATTTT	CASPAGEQPQHF	TRBV19	TRBJ1-5
TGTGCCAGCAGCTTTTTAGTACACCCGGAAGCCGGCAGCTACGAGCAGTACTTC	CASSFLVHPEAGSYEQYF	TRBV7-9	TRBJ2-7
TGTGCCAGCAGTGACTCGAACCCTTTCAGGGGGGCCATCTCCTACGAGCAGTACTTC	CASSDSNPFRGAISYEQYF	TRBV6-4	TRBJ2-7
TGCGCCAGCAGCTACAGGGACACCGGGGAGCTGTTTTTT	CASSYRDTGELFF	TRBV5-1	TRBJ2-2
TGTGCCAGCAGCGCAGCCCCCACAGGGCAGGGGGGTAACTATGGCTACACCTTC	CASSAAPTGQGGNYGYTF	TRBV7-9	TRBJ1-2
TGTGCCAGCAGCGTCCCGGACACGGACTATGGCTACACCTTC	CASSVPDTDYGYTF	TRBV7-2	TRBJ1-2
TGTGCCAGCAGCGCGCTAGCTGGCAGGGGACCGGCTGGAAACACCATATATTTT	CASSALAGRGPAGNTIYF	TRBV7-3	TRBJ1-3
TGTGCCAGCGACGGGACGCAAAGCAATCAGCCCCAGCATTTT	CASDGTQSNQPQHF	TRBV5-4	TRBJ1-5
TGTGCCTGGAGTGTAGCCCGAAGACTAAGGGTGGCAACTAATGAAAAACTGTTTTTT	CAWSVARRLRVATNEKLFF	TRBV30	TRBJ1-4
TGCAGTGCTAGAGATCAAGCGACCAGGTTAGGGATTTCCCGGCGCAATCAGCCCCAGCATTTT	CSARDQATRLGISRRNQPQHF	TRBV20-1	TRBJ1-5
TGTGCCAGCAGCACGCCTTCAGGGGGGGGCCTGGTCTCCTACAATGAGCAGTTCTTC	CASSTPSGGGLVSYNEQFF	TRBV7-3	TRBJ2-1
TGTGCCAGCAGCTTGTCACAGGGTAGCACTGAAGCTTTCTTT	CASSLSQGSTEAFF	TRBV5-4	TRBJ1-1
TGCAGCGTTGGGACAGGGTTTAATGAAAAACTGTTTTTT	CSVGTGFNEKLFF	TRBV29-1	TRBJ1-4
