TGTGCCAGCATCTACGACACAGATACGCAGTATTTT	CASIYDTDTQYF	TRBV14	TRBJ2-3
TGTGCCAGCAGCGATAAACAAGGGGAGACCCAGTACTTC	CASSDKQGETQYF	TRBV13	TRBJ2-5
TGTGCCAGCAGGGTATCAGGGGGTATCTTGGACTACGAGCAGTACTTC	CASRVSGGILDYEQYF	TRBV6-5	TRBJ2-7
TGTGCCAGCAGTGGGTCAGGGGGCACAGATACGCAGTATTTT	CASSGSGGTDTQYF	TRBV12-3	TRBJ2-3
TGTGCCAGCAGCCCGAGGACAGGGAGCCCCTCACCCCTCCACTTT	CASSPRTGSPSPLHF	TRBV14	TRBJ1-6
TGTGCCTGGAGTATAGGGGGCTACGAGCAGTACTTC	CAWSIGGYEQYF	TRBV30	TRBJ2-7
TGCAGCGTTGAAGAAATGCGGGAGGGGAGCTCCTACGAGCAGTACTTC	CSVEEMREGSSYEQYF	TRBV29-1	TRBJ2-7
TGTGCCAGCAGTGGGGGGCAGGGAACTGAAAAACTGTTTTTT	CASSGGQGTEKLFF	TRBV6-1	TRBJ1-4
TGTGCGGTAACGGGGGATGGTACCTACGAGCAGTACTTC	CAVTGDGTYEQYF	TRBV6-4	TRBJ2-7
TGTGCCAGCAAATCGCCCGAGGTGGTCGGGGAGGGCTCTGGGGCCAACGTCCTGACTTTC	CASKSPEVVGEGSGANVLTF	TRBV2	TRBJ2-6
TGCGCCAGCAGCATCAGGGAGCCCGGGTACGAGCAGTACTTC	CASSIREPGYEQYF	TRBV5-1	TRBJ2-7
TGTGCCAGCAGTTACGGGGTGCGGGACAATTTGGACACCGGGGAGCTGTTTTTT	CASSYGVRDNLDTGELFF	TRBV6-5	TRBJ2-2
TGTGCCAGCAGCATGACTAGCGGGGTTAGAAGCCTACCATACAATGAGCAGTTCTTC	CASSMTSGVRSLPYNEQFF	TRBV14	TRBJ2-1
TGTGCCAGGTCGTCCAGCACTAGCGGGAGGAGGGATGGCTACACCTTC	CARSSSTSGRRDGYTF	TRBV25-1	TRBJ1-2
TGTGCCAGCAGCTTCAACGGACAGGGTCAAGACACCATATATTTT	CASSFNGQGQDTIYF	TRBV7-3	TRBJ1-3
TGTGCCTGGAGCAGGTTTTCGGCTGAAGCTTTCTTT	CAWSRFSAEAFF	TRBV30	TRBJ1-1
TGTGCCAGCAGTGACAGGGGGTACTATGGCTACACCTTC	CASSDRGYYGYTF	TRBV6-4	TRBJ1-2
TGTGCCAGCAGCCAAGATTCTGAAATCATGCAGCCCCAGCATTTT	CASSQDSEIMQPQHF	TRBV3-1	TRBJ1-5
TGTGCCACCTTCTGGACAGGGGACGGTGGGTATGGCTACACCTTC	CATFWTGDGGYGYTF	TRBV6-4	TRBJ1-2
TGTGCTAGTGGTTTGCCAACGGGGGGAAGGTACGAGCAGTACTTC	CASGLPTGGRYEQYF	TRBV12-5	TRBJ2-7
TGTGCCACCGGTTGGGCGGGAGGAGGCCCCGATACGCAGTATTTT	CATGWAGGGPDTQYF	TRBV15	TRBJ2-3
TGTGCCAGCAGTGACACCCTCCGGGACAGGGCACAAGAGACCCAGTACTTC	CASSDTLRDRAQETQYF	TRBV6-4	TRBJ2-5
TGTGCCAGCAGCTTAGGGCAAGGGGGGCGGTGGTGCGAGCAGTACTTC	CASSLGQGGRWCEQYF	TRBV11-2	TRBJ2-7
TGTGCCAGCAGCTCAAGGGCGCATCAGCCCCAGCATTTT	CASSSRAHQPQHF	TRBV11-3	TRBJ1-5
TGTGCCAGCAGCTTAGATCCCCCAGGGGGCGCACAAAGGAACACTGAAGCTTTCTTT	CASSLDPPGGAQRNTEAFF	TRBV7-7	TRBJ1-1
TGTGCCAGCAGCAAGACCCAATGCAATCAGCCCCAGCATTTT	CASSKTQCNQPQHF	TRBV7-9	TRBJ1-5
TGTGCCAGCAGCCAAGGCGGCGAGGGAAGAGACTATGGCTACACCTTC	CASSQGGEGRDYGYTF	TRBV3-1	TRBJ1-2
TGTGCCAGCAGTTACCTGCGGGAGGCCCGCTATGGCTACACCTTC	CASSYLREARYGYTF	TRBV6-2	TRBJ1-2
TGTGCCAGCAGCTTAGTCCGGGGGGGCTCAATCCTCATTCAGTACTTC	CASSLVRGGSILIQYF	TRBV7-8	TRBJ2-4
TGCGCCAGCAGCCAAGCCTTTGTGAGCGGGAGGGGTTACTATGGCTACACCTTC	CASSQAFVSGRGYYGYTF	TRBV4-1	TRBJ1-2
TGTGCCAGCAGCTTAAATCTAGCGGGGGGGCCGAACAATGAGCAGTTCTTC	CASSLNLAGGPNNEQFF	TRBV7-3	TRBJ2-1
TGTGCCAGCAGTCCCCGCTCGGACAGGGAGCGAACTGGTAGAGCTTTCTTT	CASSPRSDRERTGRAFF	TRBV12-3	TRBJ1-1
TGTGCCAGCAGCCAAGACCTACAGTCGACTTACACTGAAGCTTTCTTT	CASSQDLQSTYTEAFF	TRBV14	TRBJ1-1
TGCAGTGCTAAAGCCGGGAACGGGACAGGGCATTCACCCCTCCACTTT	CSAKAGNGTGHSPLHF	TRBV20-1	TRBJ1-6
TGTGCCAGCAGTCGCGGACAGGGCAGGAATCAGCCCCAGCATTTT	CASSRGQGRNQPQHF	TRBV27	TRBJ1-5
TGTGCCAGAATACCGGGACAGATTTCCTATAATTCACCCCTCCACTTT	CARIPGQISYNSPLHF	TRBV6-4	TRBJ1-6
TGTGCCAGCAGCGGTTCGGACAGTGAGACCCAGTACTTC	CASSGSDSETQYF	TRBV13	TRBJ2-5
TGTGCCAGCAGCTTATTATCAGGGAAGAACACTGAAGCTTTCTTT	CASSLLSGKNTEAFF	TRBV11-1	TRBJ1-1
TGTGCCAGCAGTTTATACCCGATAGAATGTCAAAGCGCCGAGCAGTACTTC	CASSLYPIECQSAEQYF	TRBV27	TRBJ2-7
TGTGCCACCGTCCACTGCTTTTGTGCTCCCTTTGAGGGGGGGATCTACGAGCAGTACTTC	CATVHCFCAPFEGGIYEQYF	TRBV15	TRBJ2-7
TGTGCCAGCAGTAAGCCAGAGGGACCCTACGAGCAGTACTTC	CASSKPEGPYEQYF	TRBV27	TRBJ2-7
TGTGCCAGCAGCATACAAGAATCTCCCTCGGAGCCGTCCTACGAGCAGTACTTC	CASSIQESPSEPSYEQYF	TRBV13	TRBJ2-7
TGTGCCAGCAATCCTAGGGAGGGGGACGCTTTCTTT	CASNPREGDAFF	TRBV6-6	TRBJ1-1
TGTGCCAGCAGTGACTCGATAACGGTCCGGGACAGCTTACGGCACACCGGGGAGCTGTTTTTT	CASSDSITVRDSLRHTGELFF	TRBV6-4	TRBJ2-2
TGCAGCGTTGAAGTGCCTACAGCTACATTGGGGACCAACTATGGCTACACCTTC	CSVEVPTATLGTNYGYTF	TRBV29-1	TRBJ1-2
TGTGCCAGCAGTATTCGGTCCAGGGGACAGGGAAACTATAATTCACCCCTCCACTTT	CASSIRSRGQGNYNSPLHF	TRBV6-1	TRBJ1-6
TGTGCCAGCAGTGCTGGGACAGACGAGCAGTACTTC	CASSAGTDEQYF	TRBV6-1	TRBJ2-7
TGTGCCAGCAGTGACAGTTCCCTGAGGTGTTCCGGAGGGGTTTACAATGAGCAGTTCTTC	CASSDSSLRCSGGVYNEQFF	TRBV6-4	TRBJ2-1
TGCGCCAGCAGCCAAGTAGATAGGTTAGCCTACGAGCAGTACTTC	CASSQVDRLAYEQYF	TRBV4-1	TRBJ2-7
TGCAGCGTTCCGTTAGCGGGGCCCAATGAGCAGTTCTTC	CSVPLAGPNEQFF	TRBV29-1	TRBJ2-1
TGTGCCAGTAGTGAGGGGGGGGAAATTCTGGCCGACACCGGGGAGCTGTTTTTT	CASSEGGEILADTGELFF	TRBV19	TRBJ2-2
TGTGCCAGCAGCCAAGATAAAAAGGATAGCAATCAGCCCCAGCATTTT	CASSQDKKDSNQPQHF	TRBV3-1	TRBJ1-5
TGTGCCAGCAGCTGGTATCCTGGAGAAAGTTGGACGACGGGTAACTCTGGAAACACCATATATTTT	CASSWYPGESWTTGNSGNTIYF	TRBV13	TRBJ1-3
TGTGCCAGCAGCCCGGGGACAGTTTTCCAAGAGACCCAGTACTTC	CASSPGTVFQETQYF	TRBV9	TRBJ2-5
TGTGCCAGCAGCTTAGCCCGGAGGCGGACAGGGGGCAACTCAAAACTGTTTTTT	CASSLARRRTGGNSKLFF	TRBV11-2	TRBJ1-4
TGTGCCAGCAGCGAGGGGACGGGCTCTGGAAACACCATATATTTT	CASSEGTGSGNTIYF	TRBV7-9	TRBJ1-3
TGTGCCAGTGGGAGAGGCAATCAGCCCCAGCATTTT	CASGRGNQPQHF	TRBV19	TRBJ1-5
TGTGCCAGTAGTAATGGGGGGCGGTACACCGGGGAGCTGTTTTTT	CASSNGGRYTGELFF	TRBV19	TRBJ2-2
TGCAGTGCTAGAGGGGCAGGGTGGGAGTCTTATCAGCCCCAGCATTTT	CSARGAGWESYQPQHF	TRBV20-1	TRBJ1-5
TGTGCCTGGGGCGTAGGGACTCGAATGCAAGAGACCCAGTACTTC	CAWGVGTRMQETQYF	TRBV14	TRBJ2-5
TGTGCCAGCAGCGGAAGGGGGCTAAAAGAAGAGACCCAGTACTTC	CASSGRGLKEETQYF	TRBV5-4	TRBJ2-5
TGTGCCAGCAGCGCCTATGAGCAGTTCTTC	CASSAYEQFF	TRBV6-3	TRBJ2-1
TGTGCCAGCAGCTTAAAGGACGAGGGACTAACCGAGACGTGGACCTACGAGCAGTACTTC	CASSLKDEGLTETWTYEQYF	TRBV7-3	TRBJ2-7
TGTGCCAGCAGTACTTGGACAGTACTAGGTGGCTACACCTTC	CASSTWTVLGGYTF	TRBV27	TRBJ1-2
TGTGGATCACCCCTCCACTTT	CGSPLHF	TRBV6-2	TRBJ1-6
TGTGCCAGCAGCGTAGGGGGAAGAGTCGTGAACACTGAAGCTTTCTTT	CASSVGGRVVNTEAFF	TRBV9	TRBJ1-1
TGTGCCAGCAGCTTGGCCCATACGGACCGGGGGCCGGATGGCTACACCTTC	CASSLAHTDRGPDGYTF	TRBV11-2	TRBJ1-2
TGTGCCAGCAGTTTAAGGGACTATGGCTACACCTTC	CASSLRDYGYTF	TRBV9	TRBJ1-2
TGTGCCAGCAGCCAAGAAACTCTCGGGATGGAGACCCAGTACTTC	CASSQETLGMETQYF	TRBV14	TRBJ2-5
TGTGCCAGCAGTCCGGGACAGGGGGACGGTCATAGCAATCAGCCCCAGCATTTT	CASSPGQGDGHSNQPQHF	TRBV6-6	TRBJ1-5
TGTGCCAGCAGCCACAGACTAGCGTACAATGAGCAGTTCTTC	CASSHRLAYNEQFF	TRBV11-3	TRBJ2-1
TGTGCCAGCAGCACCCGGGAACCCGCTAGTAACTGGTACAATGAGCAGTTCTTC	CASSTREPASNWYNEQFF	TRBV11-3	TRBJ2-1
TGCAGTGCTAGGACAGGGGAGGGTCAGCCCCAGCATTTT	CSARTGEGQPQHF	TRBV20-1	TRBJ1-5
TGTGCCAGCAGCGTAGGGGACAGGGGATCGCCGAATGAAAAACTGTTTTTT	CASSVGDRGSPNEKLFF	TRBV9	TRBJ1-4
TGTGCCAGCAGTTCCGCTGAGGGGGGACCTTGGGACGAGCAGTACTTC	CASSSAEGGPWDEQYF	TRBV28	TRBJ2-7
TGTGCCAGCAGCGAGGCGGGCTCTGGAAACACCATATATTTT	CASSEAGSGNTIYF	TRBV9	TRBJ1-3
TGTGCCAGCATGTGCGGGGGAGTTATCCCATTCTCCTACGAGCAGTACTTC	CASMCGGVIPFSYEQYF	TRBV11-2	TRBJ2-7
TGCAGCGTTGTTACAGGGGTATTGAACACTGAAGCTTTCTTT	CSVVTGVLNTEAFF	TRBV29-1	TRBJ1-1
TGTGCCAGCAGCGTAGGGGGGGACAGGGATGGGTTTTCCAAAAACATTCAGTACTTC	CASSVGGDRDGFSKNIQYF	TRBV9	TRBJ2-4
TGCGCCAGCAGTGAGTCGGCTTCATGGGACAGTACAGATACGCAGTATTTT	CASSESASWDSTDTQYF	TRBV10-1	TRBJ2-3
TGTGCCAGCGAACTAGCGAGAACCTCCTTTCCTGGGGCCAACGTCCTGACTTTC	CASELARTSFPGANVLTF	TRBV6-4	TRBJ2-6
TGTGCCACCAGCAGTGAGGGGGGGGGCGTACGGATCTACAATGAGCAGTTCTTC	CATSSEGGGVRIYNEQFF	TRBV15	TRBJ2-1
TGTGCCAGCAGCTTAGGACAGCGCACTGAAGCTTTCTTT	CASSLGQRTEAFF	TRBV11-2	TRBJ1-1
TGCAGCGCCTCGTGGACAGCTGAAGCTTTCTTT	CSASWTAEAFF	TRBV29-1	TRBJ1-1
TGTGCCAGCAGCGTAGACGGGAGGGCAGACAATGAGCAGTTCTTC	CASSVDGRADNEQFF	TRBV9	TRBJ2-1
TGTGCCAGCAGTAACCGAGAAACTAGCTGGGTGGGATCCTACGAGCAGTACTTC	CASSNRETSWVGSYEQYF	TRBV6-5	TRBJ2-7
TGTGCCAGCAGCTTAAGTGGAGACGCGCGCGAGACCCAGTACTTC	CASSLSGDARETQYF	TRBV5-6	TRBJ2-5
TGTGCCAGCAGTTACAGCCACAATCAGCCCCAGCATTTT	CASSYSHNQPQHF	TRBV6-1	TRBJ1-5
TGTGCCAGCAGTCGGGACAGGGACACTGAAGCTTTCTTT	CASSRDRDTEAFF	TRBV28	TRBJ1-1
TGTGCCAGCAGCTTAACCTTCAGGGATTTCCCCTACAATGAGCAGTTCTTC	CASSLTFRDFPYNEQFF	TRBV7-3	TRBJ2-1
TGTGCCACCAGTGACTCCAGGGTTGGGGGTGAAGCTTTCTTT	CATSDSRVGGEAFF	TRBV24-1	TRBJ1-1
TGTGCCAGCAGCGAGGACGCAACTAATGAAAAACTGTTTTTT	CASSEDATNEKLFF	TRBV5-6	TRBJ1-4
TGCGCCAGCAGCTTAGACAGGGAAAGATCCTATAATTCACCCCTCCACTTT	CASSLDRERSYNSPLHF	TRBV5-1	TRBJ1-6
TGCGCCAGCAGCTTGCAAAGGGGTAGGACTCGGGACCTCGAGATGAACACTGAAGCTTTCTTT	CASSLQRGRTRDLEMNTEAFF	TRBV5-1	TRBJ1-1
TGTGCCAGCAGCAAATGCCAAGTATCACTAGCGGGAGTAGCGGGGACCGAGCAGTACTTC	CASSKCQVSLAGVAGTEQYF	TRBV28	TRBJ2-7
TGTGCCAGCAGCTACCCCCGCGGGTATCAGCCCCAGCATTTT	CASSYPRGYQPQHF	TRBV7-3	TRBJ1-5
TGTGCCACCAGTGACAGTTCCTCGGGGGTTCTAGGTTTGCAGTACTTC	CATSDSSSGVLGLQYF	TRBV24-1	TRBJ2-7
TGCAGTGCTAGAGTCCCAATGTCTGAGGGGGGGTGGTACAATGAGCAGTTCTTC	CSARVPMSEGGWYNEQFF	TRBV20-1	TRBJ2-1
TGTGCCACCAGTGAAACAGGGTGCTACACTGAAGCTTTCTTT	CATSETGCYTEAFF	TRBV24-1	TRBJ1-1
TGTGCCAGCAGCTCGTGGCGGCTCTACGAGCAGTACTTC	CASSSWRLYEQYF	TRBV11-3	TRBJ2-7
TGTGCCAGCAGTGAAGCGCTTTATGTTTTATACGAGCAGTACTTC	CASSEALYVLYEQYF	TRBV2	TRBJ2-7
TGTGCCAGCAGCTTGGGAGACTCATATGGCTACACCTTC	CASSLGDSYGYTF	TRBV7-7	TRBJ1-2
TGTGCCAGCAGCTTAGCTCACGACAGGGAATCACCCCTCCACTTT	CASSLAHDRESPLHF	TRBV7-2	TRBJ1-6
TGTGCCAGCAGGTCCGGGAGTACCTACGAGCAGTACTTC	CASRSGSTYEQYF	TRBV27	TRBJ2-7
TGTGCCAGCAGCTTAGAAATCAAGGACACAACTAATGAAAAACTGTTTTTT	CASSLEIKDTTNEKLFF	TRBV7-3	TRBJ1-4
TGTGCCAGCAGTCCGAGGGGCGTAAACACCGGGGAGCTGTTTTTT	CASSPRGVNTGELFF	TRBV12-3	TRBJ2-2
TGTGCCAGCAGCTTGAGGCCGAACACCGGGGAGCTGTTTTTT	CASSLRPNTGELFF	TRBV5-4	TRBJ2-2
TGTGCCAGCAGTTACCATGGCCTCCGGGACAGACTAGAGACCCAGTACTTC	CASSYHGLRDRLETQYF	TRBV6-5	TRBJ2-5
TGCAGTGCTAGAGATCTCCCCGAATTACCGGGACAGGGTGGTAGCAATCAGCCCCAGCATTTT	CSARDLPELPGQGGSNQPQHF	TRBV20-1	TRBJ1-5
TGCGCCAGCAGCCAAGACGGACCATCCTCTGGGGCCAACGTCCTGACTTTC	CASSQDGPSSGANVLTF	TRBV4-1	TRBJ2-6
TGTGCCAGCAGCCCCGAAGCAGGGGATAACTATGGCTACACCTTC	CASSPEAGDNYGYTF	TRBV7-2	TRBJ1-2
TGTGCCAGCAGTGGAACCGGGCAGGGACACTATGGCTACACCTTC	CASSGTGQGHYGYTF	TRBV14	TRBJ1-2
TGTGCCAGCAGCTTAGACGACTTGGGGCCCCAGCATTTT	CASSLDDLGPQHF	TRBV7-2	TRBJ1-5
TGTGCCAGCAGTTTCGACAGCGAGCAGTACTTC	CASSFDSEQYF	TRBV27	TRBJ2-7
TGTGCCACCAGTGGACTCCGGCAGGACGAATCGTACGAGCAGTACTTC	CATSGLRQDESYEQYF	TRBV24-1	TRBJ2-7
TGTGCGTGCTTAAGGACAGGGGAAAAACTGTTTTTT	CACLRTGEKLFF	TRBV12-5	TRBJ1-4
TGTGCCAGCAGCTTAAAACAGGGAGATTACGAGCAGTACTTC	CASSLKQGDYEQYF	TRBV7-9	TRBJ2-7
TGTGCCAGCAGTGTTGGGAGGGGCTTCATGAACACTGAAGCTTTCTTT	CASSVGRGFMNTEAFF	TRBV2	TRBJ1-1
TGTGCCTTGGCTGAAAACATTCAGTACTTC	CALAENIQYF	TRBV11-3	TRBJ2-4
TGTGCCAGCAGCTTCGGGGGGCCGGACCAAGAGACCCAGTACTTC	CASSFGGPDQETQYF	TRBV6-5	TRBJ2-5
TGTGCCAGCCAAGGGACAGGGGGCCATTCGGAATCCGGTGTCAATCAGCCCCAGCATTTT	CASQGTGGHSESGVNQPQHF	TRBV19	TRBJ1-5
TGTGCCACCAGTGAAAAAAGGCGAAGAGGTACAGAGACCCAGTACTTC	CATSEKRRRGTETQYF	TRBV24-1	TRBJ2-5
TGTGCCAGCAGCTTGCGGCCCTTAGCGAACACCGGGGAGCTGTTTTTT	CASSLRPLANTGELFF	TRBV5-4	TRBJ2-2
TGTGCCACCAGTGATTTGAGGGGGGCCTACGAGCAGTACTTC	CATSDLRGAYEQYF	TRBV24-1	TRBJ2-7
TGTGCCAGCAACCCCATTCCTGACAGGGCCGATAACGAGCAGTACTTC	CASNPIPDRADNEQYF	TRBV6-8	TRBJ2-7
TGTGCGTGGGGGGGACCCTTCTACGAGCAGTACTTC	CAWGGPFYEQYF	TRBV25-1	TRBJ2-7
TGCGCCAGCAAGGGGGGAGGCGGAAGCACAGATACGCAGTATTTT	CASKGGGGSTDTQYF	TRBV10-2	TRBJ2-3
TGTGCCAGTTCGCAGAAGCCTCCCAACTATGGCTACACCTTC	CASSQKPPNYGYTF	TRBV19	TRBJ1-2
TGTGCCAGCAGCCGGCAGGGGACAAGAGTCGAGCAGTACTTC	CASSRQGTRVEQYF	TRBV9	TRBJ2-7
TGTGCCAGCAGGGGAGCTGCGGGAGTCCAAGAGACCCAGTACTTC	CASRGAAGVQETQYF	TRBV6-1	TRBJ2-5
TGTGCCAGCAGCTTGATCATCCGTCTGACAGGGGGGACGGAGAATGAAAAACTGTTTTTT	CASSLIIRLTGGTENEKLFF	TRBV5-4	TRBJ1-4
TGTGCCAGCAGTTACGGGTTCGGGAGTCAGCCCCAGCATTTT	CASSYGFGSQPQHF	TRBV6-3	TRBJ1-5
TGTGCATTAGGGCCAGAGACCCAGTACTTC	CALGPETQYF	TRBV28	TRBJ2-5
TGCGCCAGCAGCCATCGTGACCGCGAGCAGTACTTC	CASSHRDREQYF	TRBV4-1	TRBJ2-7
TGTGCCAGCAGGGAGACTAGCGTGTTTGAAAGGTACGTC	CASRETSVFERYV	TRBV9	TRBJ2-7
TGTGCCAGAAGGACAGACAGGGATGGGACCCAGTACTTC	CARRTDRDGTQYF	TRBV27	TRBJ2-5
TGTGCCAGCAGCGTGGACAGGGGGCGGGGATACGAGCAGTACTTC	CASSVDRGRGYEQYF	TRBV5-4	TRBJ2-7
TGTGCCAGCAGGTTTCAGATGGGTGGCACTGTGAGCTACGAGCAGTACTTC	CASRFQMGGTVSYEQYF	TRBV2	TRBJ2-7
TGTGCCAGCAGCAGACAGGTCAGGACCCCTAATCGGGCTAACTATGGCTACACCTTC	CASSRQVRTPNRANYGYTF	TRBV7-2	TRBJ1-2
TGTGCCAGCAGCGATGGCCTAAGGAACACTGAAGCTTTCTTT	CASSDGLRNTEAFF	TRBV6-5	TRBJ1-1
TGTGCCAGCTCACTTGCTCGGCGAGATAGCAATCAGCCCCAGCATTTT	CASSLARRDSNQPQHF	TRBV18	TRBJ1-5
TGTGCCAGCAGCGTAGCCCGACAGGGCCGTAGGAACACTGAAGCTTTCTTT	CASSVARQGRRNTEAFF	TRBV9	TRBJ1-1
TGTGCCAGCAGTTTGGGGACAGGGGTACTCAATCAGCCCCAGCATTTT	CASSLGTGVLNQPQHF	TRBV6-9	TRBJ1-5
TGTGCCAGCAGCCAGGAAAGTACGGGACAGGGGGACGACACCGGGGAGCTGTTTTTT	CASSQESTGQGDDTGELFF	TRBV11-2	TRBJ2-2
TGTGCCAGCAGACCCAAGGACGGCAACGAGCAGTACTTC	CASRPKDGNEQYF	TRBV27	TRBJ2-7
TGTGCCAGCAGCCGGACAAAGAGCTCTGGAAACACCATATATTTT	CASSRTKSSGNTIYF	TRBV11-3	TRBJ1-3
TGTGCCGAGATGGACTCCTACAATGAGCAGTTCTTC	CAEMDSYNEQFF	TRBV19	TRBJ2-1
TGTGCCAGCAGCTTAGCGGTTCCAGGGGTGCTAATGAACACTGAAGCTTTCTTT	CASSLAVPGVLMNTEAFF	TRBV7-2	TRBJ1-1
TGCGCCAGCAGCCAAGATCAAGCCCCAGGGGCAAACACCGGGGAGCTGTTTTTT	CASSQDQAPGANTGELFF	TRBV4-1	TRBJ2-2
TGTGCCAGCGTAGACAGGGGGCGCGAAACGAGGTTCACTGAAGCTTTCTTT	CASVDRGRETRFTEAFF	TRBV7-3	TRBJ1-1
TGTGCCAGCAGCGGCTCCCTGGTAATTGAAAAACTGTTTTTT	CASSGSLVIEKLFF	TRBV13	TRBJ1-4
TGTGCCAGCAGCGCCCCGCAAGAGACCCAGTACTTC	CASSAPQETQYF	TRBV7-3	TRBJ2-5
TGTGCCAGCATGTCAGGGGTGGGCTACACCTTC	CASMSGVGYTF	TRBV6-3	TRBJ1-2
TGTGCCAGCAGCAATCCAACCTGGAGTGAAGCTTTCTTT	CASSNPTWSEAFF	TRBV7-3	TRBJ1-1
TGTGCCAGCAGCTTAGAAAAGGGGAGTCACGGGGAGCTGTTTTTT	CASSLEKGSHGELFF	TRBV11-3	TRBJ2-2
TGTGCCAGCAGCCAGGCGGAGGGGCCACCCTCTGAAGCTTTCTTT	CASSQAEGPPSEAFF	TRBV14	TRBJ1-1
TGTGCCAGCAGTGAAATCAACGCAGATACGCAGTATTTT	CASSEINADTQYF	TRBV25-1	TRBJ2-3
TGCGCCAGCAGTGAGTCGATGACATTCCCTCTCGCCTACGAGCAGTACTTC	CASSESMTFPLAYEQYF	TRBV10-1	TRBJ2-7
TGCGCCAGCAGCTTGAGATCATATAGCAATCAGCCCCAGCATTTT	CASSLRSYSNQPQHF	TRBV5-1	TRBJ1-5
TGTGCCATGCCTCGGGGGTATGAGCAGTTCTTC	CAMPRGYEQFF	TRBV10-3	TRBJ2-1
TGTGCCAGCAGCGGGGAAGAGACCCAGTACTTC	CASSGEETQYF	TRBV9	TRBJ2-5
TGCGCCAGCAGCTGTAGGAGACAGGGGGGGAGGTCTGGGGCCAACGTCCTGACTTTC	CASSCRRQGGRSGANVLTF	TRBV5-1	TRBJ2-6
TGTGCCAGTATTCTGGGGGTCTCTGGAAACACCATATATTTT	CASILGVSGNTIYF	TRBV19	TRBJ1-3
TGCAGTGCCCCGGGACAGGAGGCGACCGGGGAGCTGTTTTTT	CSAPGQEATGELFF	TRBV20-1	TRBJ2-2
TGTGCCACCAGTCCCCCACGGTGGGGCGGGAGGAACACTGAAGCTTTCTTT	CATSPPRWGGRNTEAFF	TRBV24-1	TRBJ1-1
TGTGCCAGCCCCAGGGAGCGCCTATGGATGTACGAGCAGTACTTC	CASPRERLWMYEQYF	TRBV5-4	TRBJ2-7
TGTGCCAGCAGCAGGTTAAACTATGGCTACACCTTC	CASSRLNYGYTF	TRBV12-3	TRBJ1-2
TGTGCCAGCAGTGAATTCCGAGGGGGCAATCAGCCCCAGCATTTT	CASSEFRGGNQPQHF	TRBV2	TRBJ1-5
TGCGCCAGCAGCTTGGCACCCCTATACAATGAGCAGTTCTTC	CASSLAPLYNEQFF	TRBV5-1	TRBJ2-1
TGCGCCAGCAGCCGCAGGGGGCTAGATTATAGCAATCAGCCCCAGCATTTT	CASSRRGLDYSNQPQHF	TRBV4-1	TRBJ1-5
TGCGCCAGCAGCCAAGCCACTGGGGGAAACACCATATATTTT	CASSQATGGNTIYF	TRBV4-1	TRBJ1-3
TGTGCCAGTACAAAGCGGGGGGGGGCCAAGAACACTGAAGCTTTCTTT	CASTKRGGAKNTEAFF	TRBV19	TRBJ1-1
TGTGCCACCAGCAGAGGCCTCGGACAGGTGGGGGCCGGGGAGCTGTTTTTT	CATSRGLGQVGAGELFF	TRBV15	TRBJ2-2
TGTGCCAGCCTTGGAATAAGGGGCCCCCCCGAGCAGTACTTC	CASLGIRGPPEQYF	TRBV7-9	TRBJ2-7
TGTGCCAGCAGTTACAACCCCGGGACTAGAGAATACAATGAGCAGTTCTTC	CASSYNPGTREYNEQFF	TRBV6-5	TRBJ2-1
TGTGCCACCAGTGATTTGGACGACACTCTCTACGAGCAGTACTTC	CATSDLDDTLYEQYF	TRBV24-1	TRBJ2-7
TGTGCCACCAGCATGGGGGCCAGGGGAGTTAATCAGCCCCAGCATTTT	CATSMGARGVNQPQHF	TRBV15	TRBJ1-5
TGTGCCAGCAGCGAGGCGGGAGCCCGAAGCACAGATACGCAGTATTTT	CASSEAGARSTDTQYF	TRBV11-3	TRBJ2-3
TGTGCCAGCATACAGGGGAATCAGCCCCAGCATTTT	CASIQGNQPQHF	TRBV6-5	TRBJ1-5
TGTGCCAGCAGCGGGAGGGGCGGGTCTGGCTACACCTTC	CASSGRGGSGYTF	TRBV5-8	TRBJ1-2
TGTGCCAGCAGTAAACAGGGTAGCAATCAGCCCCAGCATTTT	CASSKQGSNQPQHF	TRBV25-1	TRBJ1-5
TGTGCCAGCAGCCCTAGCGGGCCTACGCAGTATTTT	CASSPSGPTQYF	TRBV7-8	TRBJ2-3
TGTGCCAGCAGACTAGCTCGCTCCTACGAGCAGTACTTC	CASRLARSYEQYF	TRBV6-1	TRBJ2-7
TGTGCCAGCAGCGAACCGGGGAGAGGTTTAACTAATGAAAAACTGTTTTTT	CASSEPGRGLTNEKLFF	TRBV13	TRBJ1-4
TGTGCCAGCAGCTCTAGCGGGCGCTACGAGCAGTACTTC	CASSSSGRYEQYF	TRBV13	TRBJ2-7
TGTGCCAATCTCCAGGAAGGTCCTAACTATGGCTACACCTTC	CANLQEGPNYGYTF	TRBV2	TRBJ1-2
TGCGCCAGCAGTGAGTCAGCGACCTACACAGGCGGCTACACCTTC	CASSESATYTGGYTF	TRBV10-1	TRBJ1-2
TGTGCCAGCAGCCAGTCTAGCACAGATACGCAGTATTTT	CASSQSSTDTQYF	TRBV7-8	TRBJ2-3
TGTGCCAGCAGTTACGCACCTGACAGGCTTCGGGTCTCCTACAATGAGCAGTTCTTC	CASSYAPDRLRVSYNEQFF	TRBV6-3	TRBJ2-1
TGTGCCAGCAGCTTACTCCAGGGGCAGGGGGACGAGCAGTACTTC	CASSLLQGQGDEQYF	TRBV7-3	TRBJ2-7
TGCGCCAGCAGCTTGGCTTCACAGGAGGGGATGTACACCGGGGAGCTGTTTTTT	CASSLASQEGMYTGELFF	TRBV5-1	TRBJ2-2
TGTGCCACCAGTGATTCCAGAGGGTGGGACCTCCAGTACTTC	CATSDSRGWDLQYF	TRBV24-1	TRBJ2-5
TGTGCCAGCAGCCAACCAGATTCGGCAACTAACTATGGCTACACCTTC	CASSQPDSATNYGYTF	TRBV14	TRBJ1-2
TGTGCCAGCAGTTATCCCCGAGGTTCCAGTAACACTGAAGCTTTCTTT	CASSYPRGSSNTEAFF	TRBV6-5	TRBJ1-1
TGTGCCAGCAGCCTGGGGTGGACAGGTTCCTACGAGCAGTACTTC	CASSLGWTGSYEQYF	TRBV14	TRBJ2-7
TGCAGTGCTAGGTCAGCGGATCAGCCCCAGCATTTT	CSARSADQPQHF	TRBV20-1	TRBJ1-5
TGTGCCAGCTCACCACTTTTCAGGGGCCCTGAAGCTTTCTTT	CASSPLFRGPEAFF	TRBV18	TRBJ1-1
TGTGCCAGTCCACAAGGGCCCCGGGACAGGGTAGGAACCCACGATTATCAGCCCCAGCATTTT	CASPQGPRDRVGTHDYQPQHF	TRBV2	TRBJ1-5
TGTGCCAGCAGCTGTGGGCCCCACCTCTACGAGCAGTACTTC	CASSCGPHLYEQYF	TRBV9	TRBJ2-7
TGTGCCACCAGTGATTTGCTAGATAAAGCTACTAATTCACCCCTCCACTTT	CATSDLLDKATNSPLHF	TRBV24-1	TRBJ1-6
TGTGCCAGCAGCGCCGGACAGGGAGCTGAAGCTTTCTTT	CASSAGQGAEAFF	TRBV3-1	TRBJ1-1
TGTGCCAGCAGGAGAGGGACTAGCGGGAGCTGGGATCAGCCCCAGCATTTT	CASRRGTSGSWDQPQHF	TRBV6-4	TRBJ1-5
TGTGCCAGCAGAATACCCCGAGGGGCAACTAATGAAAAACTGTTTTTT	CASRIPRGATNEKLFF	TRBV27	TRBJ1-4
TGTGCCAGTAGTCATTTACGTGGGAATGAGCAGTTCTTC	CASSHLRGNEQFF	TRBV19	TRBJ2-1
TGTGCCAGCAGACCCAGGGTACGGAACACTGAAGCTTTCTTT	CASRPRVRNTEAFF	TRBV27	TRBJ1-1
TGCAGCGATTCTAAAAGAGCGAGACGTGTAAAGCCGGCAGATACGCAGTATTTT	CSDSKRARRVKPADTQYF	TRBV29-1	TRBJ2-3
TGCGCCAGCAGCCAAGAGGGAGGAAGCGAGGTGGCGTACTTC	CASSQEGGSEVAYF	TRBV4-1	TRBJ2-4
TGTGCCAGCAGTATCCGGGACAGAGGCTACACCTTC	CASSIRDRGYTF	TRBV27	TRBJ1-2
TGTGCCAGCAGCCAGGTCGGGACTAGAGAGACCCAGTACTTC	CASSQVGTRETQYF	TRBV7-3	TRBJ2-5
TGTGCCAGCAGTTATGCGGGAGGAGGCGAGCAGTACTTC	CASSYAGGGEQYF	TRBV28	TRBJ2-7
TGTGCCAGCAGCCAAGGGAGTCCCCGACTAGCGGGAGGGCGTTTTGAAGGAAACACCATATATTTT	CASSQGSPRLAGGRFEGNTIYF	TRBV14	TRBJ1-3
TGTGCCATCACTAAGGGGCCCATGAACACTGAAGCTTTCTTT	CAITKGPMNTEAFF	TRBV10-3	TRBJ1-1
TGTGCCAGCAGGTTGGAGGGACGAGGTTACATTCAGTACTTC	CASRLEGRGYIQYF	TRBV6-4	TRBJ2-4
TGTGCTCGGAAACTGCCGGGACTCCCCGGGGAGCTGTTTTTT	CARKLPGLPGELFF	TRBV12-5	TRBJ2-2
TGTGCCAGTAGTAAGACAGGGTCCTACGAGCAGTACTTC	CASSKTGSYEQYF	TRBV19	TRBJ2-7
TGTGCTAGTGGTACAGGGCTCGAGGTGCGGAACAATGAGCAGTTCTTC	CASGTGLEVRNNEQFF	TRBV12-5	TRBJ2-1
TGTGCCAGCAGCGGGGGACGGTGTAGCAATCAGCCCCAGCATTTT	CASSGGRCSNQPQHF	TRBV28	TRBJ1-5
TGCAGTGCTATTTTGGGACTGGGGGCTGGAAACACCATATATTTT	CSAILGLGAGNTIYF	TRBV20-1	TRBJ1-3
TGTGCCAGCAGCTTAACAGGGACCCTCAATCAGCCCCAGCATTTT	CASSLTGTLNQPQHF	TRBV9	TRBJ1-5
TGTGCCAGCAGGCGCCCCCTACCGAACACTGAAGCTTTCTTT	CASRRPLPNTEAFF	TRBV7-9	TRBJ1-1
TGTGCCAGCAACCTGGGGGCTAGCAATCAGCCCCAGCATTTT	CASNLGASNQPQHF	TRBV7-2	TRBJ1-5
TGTGCCAGCTCACCAGGGAAATTACAGCGGGTTTGTTCAACTAATGAAAAACTGTTTTTT	CASSPGKLQRVCSTNEKLFF	TRBV18	TRBJ1-4
TGTGCCAGCCGTGTTGACAAAGGCACCGGGGAGCTGTTTTTT	CASRVDKGTGELFF	TRBV2	TRBJ2-2
TGTGCCAGCAGTATTGAGGCCGGCTACACCTTC	CASSIEAGYTF	TRBV28	TRBJ1-2
TGCGCCACATATCCGGGGGACGGCTACACCTTC	CATYPGDGYTF	TRBV10-1	TRBJ1-2
TGTGCCACCAGTGATCTGGGGATAATCAATCAGCCCCAGCATTTT	CATSDLGIINQPQHF	TRBV24-1	TRBJ1-5
TGTGCCTTGACCGGGACGCGAACAGATACGCAGTATTTT	CALTGTRTDTQYF	TRBV10-3	TRBJ2-3
TGTGCCACCAGCAGAGCCTCCCGGGACAGGGGAGGAGTACATCAGCCCCAGCATTTT	CATSRASRDRGGVHQPQHF	TRBV15	TRBJ1-5
TGTGCCAGCAGCAGCACAAAGGGACCCACAACTAATGAAAAACTGTTTTTT	CASSSTKGPTTNEKLFF	TRBV5-4	TRBJ1-4
TGCGCCAGCAGTTCCCTCAAGGGACTAGCGGGCACCGGGGAGCTGTTTTTT	CASSSLKGLAGTGELFF	TRBV10-1	TRBJ2-2
TGTGCCAGCAGCCCGTGGACAACGGCTCTCTACGAGCAGTACTTC	CASSPWTTALYEQYF	TRBV5-4	TRBJ2-7
TGTGCCAGCAGTTTACACAGGGAGTACGAGCAGTACTTC	CASSLHREYEQYF	TRBV27	TRBJ2-7
TGTGCCAGCAGCTTAGTTCAGGGAGAAAACTATGGCTACACCTTC	CASSLVQGENYGYTF	TRBV5-6	TRBJ1-2
TGTGCCAGCAGCACATTCGCTGAAGCTTTCTTT	CASSTFAEAFF	TRBV7-6	TRBJ1-1
TGCGCCAGCAGCTTTGAGGGGGAGGGCGGCTACACCTTC	CASSFEGEGGYTF	TRBV5-1	TRBJ1-2
TGTGCCAGCAGCCGTGAGGCAGGGCCCACAGATACGCAGTATTTT	CASSREAGPTDTQYF	TRBV5-5	TRBJ2-3
TGTGCCAGCAGTACGGGAGGAGATATTAGTTCGAGGGGCTACACCTTC	CASSTGGDISSRGYTF	TRBV6-1	TRBJ1-2
TGTGCCAGCGCTGGACAGGGCCATAACTATGGCTACACCTTC	CASAGQGHNYGYTF	TRBV11-2	TRBJ1-2
TGCAGTGCCAGGGGGTCGTACAACGAGCAGTACTTC	CSARGSYNEQYF	TRBV20-1	TRBJ2-7
TGTGCCAGTAGTATGAAGGTTCATAGGGAATCACCCCTCCACTTT	CASSMKVHRESPLHF	TRBV19	TRBJ1-6
TGCGCCAGCAGCCCACGCCAACAGGGGTACGAGCAGTACTTC	CASSPRQQGYEQYF	TRBV4-1	TRBJ2-7
TGTGCCACCAGTTCCGGGACATCTTTAACTGGGGCCAACGTCCTGACTTTC	CATSSGTSLTGANVLTF	TRBV24-1	TRBJ2-6
TGCAGTATCCGGGGGAGCCAAGAGACCCAGTACTTC	CSIRGSQETQYF	TRBV20-1	TRBJ2-5
TGTGCCTCTATATCCCTTGCCCCTTACAGGGCGGGGATGAACACTGAAGCTTTCTTT	CASISLAPYRAGMNTEAFF	TRBV12-5	TRBJ1-1
TGTGCCAGCAGCAGGGACGCGTTCTATGGCTACACCTTC	CASSRDAFYGYTF	TRBV7-4	TRBJ1-2
TGCGCCAGCAGCCAAGACCACGTTGAGAGTAACTATGGCTACACCTTC	CASSQDHVESNYGYTF	TRBV4-1	TRBJ1-2
TGTGCCAGCAGCGTAGCGGGCCCCTTGAACACTGAAGCTTTCTTT	CASSVAGPLNTEAFF	TRBV13	TRBJ1-1
TGTGCCAGTCAGGGACAGGGCAAGCTCCGTCTAGGGAACACTGAAGCTTTCTTT	CASQGQGKLRLGNTEAFF	TRBV6-4	TRBJ1-1
TGCGCGAAAGGCTTCTACGAGCAGTACTTC	CAKGFYEQYF	TRBV10-1	TRBJ2-7
TGCAGTGCTAGTGGAGCGGGACCCGGACAGCCCCAGCATTTT	CSASGAGPGQPQHF	TRBV20-1	TRBJ1-5
TGTGCCAGCAGCTTGAAGCGGGAGATCCCTGGGGCCAACGTCCTGACTTTC	CASSLKREIPGANVLTF	TRBV7-7	TRBJ2-6
TGCAGCGAAAAGTCACGGGCCCACCTAGGAGCCGATCAGCCCCAGCATTTT	CSEKSRAHLGADQPQHF	TRBV29-1	TRBJ1-5
TGTGCCAGCAGCCAATCCCGGAGTTCAAACGACCCGGGGGATGGCTACACCTTC	CASSQSRSSNDPGDGYTF	TRBV3-1	TRBJ1-2
TGCAGTGCGGTACCGAGCTCCTACGAGCAGTACTTC	CSAVPSSYEQYF	TRBV20-1	TRBJ2-7
TGCGCCAGCAGCCAAGGGTCAGGAGGGGGGGGTCTCCTGACAGATACGCAGTATTTT	CASSQGSGGGGLLTDTQYF	TRBV4-1	TRBJ2-3
TGTGCCAGCAGCAGGATGGACAGGGGGAGGGAAGAGACCCAGTACTTC	CASSRMDRGREETQYF	TRBV5-4	TRBJ2-5
TGTGCCAGCAGTTACAACTGGAGAGGGGATCACTACGAGCAGTACTTC	CASSYNWRGDHYEQYF	TRBV6-2	TRBJ2-7
TGTGCCAGCAGCTTCCGGAGGGATCCCAGAAAGACCGGGGAGCTGTTTTTT	CASSFRRDPRKTGELFF	TRBV5-6	TRBJ2-2
TGTGCCAGCAGCTTGGGCGTAACCGAGGGACTAGCGGGAGAGACCCAGTACTTC	CASSLGVTEGLAGETQYF	TRBV5-8	TRBJ2-5
TGTGCCCTGACTCCGACCACCGGGGAGCTGTTTTTT	CALTPTTGELFF	TRBV19	TRBJ2-2
TGTGCCAGTAGTTGCCAGGGGGGCAATCAGCCCCAGCATTTT	CASSCQGGNQPQHF	TRBV19	TRBJ1-5
TGTGCCAGCACTCGGGACAGTGCTAACTATGGCTACACCTTC	CASTRDSANYGYTF	TRBV6-2	TRBJ1-2
TGCAGTGTCTCCGGGACAAGCACAGATACGCAGTATTTT	CSVSGTSTDTQYF	TRBV20-1	TRBJ2-3
TGTGCCAGCTCGGGTCAGCCCGGGGAGCTGTTTTTT	CASSGQPGELFF	TRBV28	TRBJ2-2
TGCGCCAGCACCGTGACAGGGACTGGCTACACCTTC	CASTVTGTGYTF	TRBV10-1	TRBJ1-2
TGTGCCACCAGTGATTTGCGCCCGGTCATCCAGTCCGATGAGCAGTACTTC	CATSDLRPVIQSDEQYF	TRBV24-1	TRBJ2-7
TGTGCCAGCAGCCACAGGGGGCGCTCACTGCAGTTCTTC	CASSHRGRSLQFF	TRBV14	TRBJ2-1
TGTGCCAGCAGCGTAGGGACTGTTAGCTCCTATAATTCACCCCTCCACTTT	CASSVGTVSSYNSPLHF	TRBV9	TRBJ1-6
TGTGCCAGCAGCCTGAAGCTCAAGGCCGGGACAGTGGAACTAGGTCACTCCTACGAGCAGTACTTC	CASSLKLKAGTVELGHSYEQYF	TRBV7-3	TRBJ2-7
TGTGCCAGCAGTTTAAAGGTATTGACAGAAGAGGCGAAAAACATTCAGTACTTC	CASSLKVLTEEAKNIQYF	TRBV27	TRBJ2-4
TGTGCCAGCAGCTTCTATCCCAGAGGGAAAAGCTCCTACGAGCAGTACTTC	CASSFYPRGKSSYEQYF	TRBV7-2	TRBJ2-7
TGTGCTAGTGGTTTGGTACCCCTCAGGGGGCGCAATCAGCCCCAGCATTTT	CASGLVPLRGRNQPQHF	TRBV12-5	TRBJ1-5
TGTGCCAGCAGCCAAGATCCCCACAGGGGGGGGTTGAACACTGAAGCTTTCTTT	CASSQDPHRGGLNTEAFF	TRBV14	TRBJ1-1
TGCGCCAGCAGCCATGATCACCTCTCGTATGGCTACACCTTC	CASSHDHLSYGYTF	TRBV4-1	TRBJ1-2
TGTGCCAGCAGCCCACCATTAACGCGCCGGGTAGCAGAGCAGTTCTTC	CASSPPLTRRVAEQFF	TRBV7-9	TRBJ2-1
TGTGCCAGCAGCCTCTTTCGTAGCTCCTACAATGAGCAGTTCTTC	CASSLFRSSYNEQFF	TRBV7-8	TRBJ2-1
TGTGCCAGCTCACCAAAGGACGGGGCCAACGTCCTGACTTTC	CASSPKDGANVLTF	TRBV18	TRBJ2-6
TGTGCTAGTGGCCTGACAGAATTGGGACAAGAGACCCAGTACTTC	CASGLTELGQETQYF	TRBV12-5	TRBJ2-5
TGTGCCAGCAGTTACTCGAACTCTCCCCGGGTGAGTGACACTGAAGCTTTCTTT	CASSYSNSPRVSDTEAFF	TRBV6-6	TRBJ1-1
TGTGCCATCAAATCCAGGGGGCGTCGAATTTCACCCCTCCACTTT	CAIKSRGRRISPLHF	TRBV10-3	TRBJ1-6
TGCAGTGCTAGAGGGGGTATCTGTGAAGCTTTCTTT	CSARGGICEAFF	TRBV20-1	TRBJ1-1
TGTGCCAGCAGCCAAGATCCTGCCCCCCAAGGACTTGATTCACCCCTCCACTTT	CASSQDPAPQGLDSPLHF	TRBV3-1	TRBJ1-6
TGCAGTGCTAGAGATGCGAAGAATCAACAGGGGTGCTATGGCTACACCTTC	CSARDAKNQQGCYGYTF	TRBV20-1	TRBJ1-2
TGCAGTGCGACGGGAACATCGGACCCCGCTGACTGGGAGACCCAGTACTTC	CSATGTSDPADWETQYF	TRBV20-1	TRBJ2-5
TGTGCCAGCAACCGACCTCCTTACTTGTGGGGCGGCACTGAAGCTTTCTTT	CASNRPPYLWGGTEAFF	TRBV9	TRBJ1-1
TGTGCCAGTCCCTCAGTAGCCGGGACGGCCGGCAATCAGCCCCAGCATTTT	CASPSVAGTAGNQPQHF	TRBV19	TRBJ1-5
TGTGCCAGCAGTTTGGGGTTGAAGGATCAGCCCCAGCATTTT	CASSLGLKDQPQHF	TRBV27	TRBJ1-5
TGTGCCAGCAGCCTGCGGACCTCTGGCACAGATACGCAGTATTTT	CASSLRTSGTDTQYF	TRBV7-4	TRBJ2-3
TGTGCCAGCAGTTACTCGATCCCTGTCTGCACAGATACGCAGTATTTT	CASSYSIPVCTDTQYF	TRBV6-6	TRBJ2-3
TGTGCCAGCAGCTCCGGGCTAGGTCTTGGTGCCTACAATGAGCAGTTCTTC	CASSSGLGLGAYNEQFF	TRBV28	TRBJ2-1
TGTGCCACCAGCCGCACAGTAAAAAGTCTCTCGATTAGGGCTGAAGCTTTCTTT	CATSRTVKSLSIRAEAFF	TRBV15	TRBJ1-1
TGTGCCACCAGCAGAGATAACACTAGCGGGAGTGGTAGCTCCTACAATGAGCAGTTCTTC	CATSRDNTSGSGSSYNEQFF	TRBV15	TRBJ2-1
TGTGCCAGCAGCACCCACGGACCCTGGGCCGTCACTGAAGCTTTCTTT	CASSTHGPWAVTEAFF	TRBV7-9	TRBJ1-1
TGCAGCGTTGAAGATTCGTCTAAGCATTTCGGCGTAGATGGCTACACCTTC	CSVEDSSKHFGVDGYTF	TRBV29-1	TRBJ1-2
TGTGCCATCAGTGCTGCCACGTCACCCCTCCACTTT	CAISAATSPLHF	TRBV10-3	TRBJ1-6
TGCGCCAGCAGCTTCTCCAGGGGCCCGAACACTGAAGCTTTCTTT	CASSFSRGPNTEAFF	TRBV5-1	TRBJ1-1
TGTGCCAGCAGGCCGAACCTAGGACAGGGCTTCGAGCAGTACTTC	CASRPNLGQGFEQYF	TRBV2	TRBJ2-7
TGTGCCAGCAGTTACTCTCTAGCGGGGGACAATGAGCAGTTCTTC	CASSYSLAGDNEQFF	TRBV6-5	TRBJ2-1
TGTGCCAGCAGTCAGGGGGGTAGGCAGCCCCAGCATTTT	CASSQGGRQPQHF	TRBV6-5	TRBJ1-5
TGCGCCAGCAGTGAGGCCACCGGAAAGGGCGGAAGCTCCTACGAGCAGTACTTC	CASSEATGKGGSSYEQYF	TRBV10-1	TRBJ2-7
TGTGCCAGCAGCTGTCAAGCCATCCTTGGGGACCTTGGAAACACCATATATTTT	CASSCQAILGDLGNTIYF	TRBV5-5	TRBJ1-3
TGTGCCAGCAGTTCTGGGGGGGAAAACAATGAGCAGTTCTTC	CASSSGGENNEQFF	TRBV27	TRBJ2-1
TGCAGCGTTGCCGACAGAGTGAGACGATTTGGCTACACCTTC	CSVADRVRRFGYTF	TRBV29-1	TRBJ1-2
TGCGCCAGCAGCTTGGGGGAAACCCCATTTAATTCACCCCTCCACTTT	CASSLGETPFNSPLHF	TRBV5-1	TRBJ1-6
TGTGCCAGCAGTAGGGGGTTGACCCAGTACTTC	CASSRGLTQYF	TRBV6-8	TRBJ2-5
TGTGCCAGCCCCCCGGGACAGGGGGGGGTAAAACTGTTTTTT	CASPPGQGGVKLFF	TRBV11-3	TRBJ1-4
TGTGCCAGCAATAGAAAGCCGGAGGGTCAAAAACTGTTTTTT	CASNRKPEGQKLFF	TRBV11-3	TRBJ1-4
TGCAGCCAGAACCTAAGGACAGGGGAGGAAAAACTGTTTTTT	CSQNLRTGEEKLFF	TRBV20-1	TRBJ1-4
TGTGCCAGTAGTTCGGACTACGAGCAGTACTTC	CASSSDYEQYF	TRBV19	TRBJ2-7
TGTGCCAGCAGTTTCCAGGGACTCTCTGGGGCCAACGTCCTGACTTTC	CASSFQGLSGANVLTF	TRBV12-3	TRBJ2-6
TGCAGTGCTAGGCGTACATACGAGCAGTACTTC	CSARRTYEQYF	TRBV20-1	TRBJ2-7
TGTGCCACCAGTGATTCCCTCAACGGGTACGAGCAGTACTTC	CATSDSLNGYEQYF	TRBV24-1	TRBJ2-7
TGTGCCAGCCCTCCGGTAACTGAAGCTTTCTTT	CASPPVTEAFF	TRBV14	TRBJ1-1
TGTGCCAGCAGTTTATCGATATCCGGGACAGGGGAGGGGCCGAACACTGAAGCTTTCTTT	CASSLSISGTGEGPNTEAFF	TRBV27	TRBJ1-1
TGCGCCAGCAGCTTAGGAATTTCACTAGCGGGAGGGGCCAGCTCCTACGAGCAGTACTTC	CASSLGISLAGGASSYEQYF	TRBV5-1	TRBJ2-7
TGTGCCATGTGCCAGGGATACTATGGCTACACCTTC	CAMCQGYYGYTF	TRBV6-4	TRBJ1-2
TGTGCCAGCCCCCCGGGACTAGATCCCGATGGAAACACCATATATTTT	CASPPGLDPDGNTIYF	TRBV5-4	TRBJ1-3
TGTGCCAGCAGTTCGGGGTTGAACGAGCAGTACTTC	CASSSGLNEQYF	TRBV28	TRBJ2-7
TGTGCCAGCAGCCGTCCGTCCACAGGGGGCGAGAACATTCAGTACTTC	CASSRPSTGGENIQYF	TRBV7-9	TRBJ2-4
TGTGCCAGCTCACCACGGCACCAACTAGCATTTCGTAAGCAGTTCTTC	CASSPRHQLAFRKQFF	TRBV18	TRBJ2-1
TGTGCCAGCAGCTATAGGGGAGGATTCTCCGAGCAGTACTTC	CASSYRGGFSEQYF	TRBV13	TRBJ2-7
TGTGCCAGCTCACTAATCCTACGCTGGGCTCCGGGACAGGGATTAGGCTACACCTTC	CASSLILRWAPGQGLGYTF	TRBV18	TRBJ1-2
TGTGCCATAACGAACAGGGCCGGATATAGCAATCAGCCCCAGCATTTT	CAITNRAGYSNQPQHF	TRBV7-9	TRBJ1-5
TGTGCCAGTAGTCGGGGCGAGCCAAGCAATCAGCCCCAGCATTTT	CASSRGEPSNQPQHF	TRBV19	TRBJ1-5
TGTGCCCCCTGTCGGCGGGAGTCTGGGGCCAACGTCCTGACTTTC	CAPCRRESGANVLTF	TRBV10-3	TRBJ2-6
TGTGCCAGCAGTTCTTGGCGGGCCTTCTATGGCTACACCTTC	CASSSWRAFYGYTF	TRBV6-5	TRBJ1-2
TGCGCCAGCAGCGGCAACCCGAAATACGCCTACGAGCAGTACTTC	CASSGNPKYAYEQYF	TRBV4-3	TRBJ2-7
TGTGCCAGCAGCTACTTAGACAGGCTGAACAATGAGCAGTTCTTC	CASSYLDRLNNEQFF	TRBV7-6	TRBJ2-1
TGCGCCAAGTCAGGGAGGAGAGAGACCCAGTACTTC	CAKSGRRETQYF	TRBV10-2	TRBJ2-5
TGTGCCAGCAGTTCTTCCCTTGGGACAGGGGCTGGCTACACCTTC	CASSSSLGTGAGYTF	TRBV6-9	TRBJ1-2
TGTGCCACCAGTGGGAGGGAACTTAAGAGCTACGAGCAGTACTTC	CATSGRELKSYEQYF	TRBV24-1	TRBJ2-7
TGTGCCAGCAGCCTCACCAGGGGCACTGAAGCTTTCTTT	CASSLTRGTEAFF	TRBV2	TRBJ1-1
TGTGCCAGCAGCCTCTACCCAAGGGGCCGCGCCCAGCAGTACTTC	CASSLYPRGRAQQYF	TRBV6-3	TRBJ2-7
TGTGCCAGCAGCTTCAGGGAGGCCCAGATAGACCCGCAAGAGACCCAGTACTTC	CASSFREAQIDPQETQYF	TRBV7-9	TRBJ2-5
TGTGCCAGCAGCCGACTAGTGACTAGGGAGACCCAGTACTTC	CASSRLVTRETQYF	TRBV3-1	TRBJ2-5
TGCATTCCTCAGGGGGCTTACAAAGAGCAGTACTTC	CIPQGAYKEQYF	TRBV20-1	TRBJ2-7
TGTGCCTGGAGTAGCCACATTGGGTCGTACGAGCAGTACTTC	CAWSSHIGSYEQYF	TRBV30	TRBJ2-7
TGTGCCAGCAGTTTTCGACAGGGGTCCACGTACTATGGCTACACCTTC	CASSFRQGSTYYGYTF	TRBV27	TRBJ1-2
TGTGCCAGCAGTCGATCCGGACAGAATAGCTCCTACAATGAGCAGTTCTTC	CASSRSGQNSSYNEQFF	TRBV6-1	TRBJ2-1
TGTGCCAGCAGCCGAGGGGGGGAGCAGTACTTC	CASSRGGEQYF	TRBV7-4	TRBJ2-7
TGCGGGACAGAGAATGAAAAACTGTTTTTT	CGTENEKLFF	TRBV10-2	TRBJ1-4
TGCGCCAGCAGTGAGGGGCAGGGGGCAGGGCTGGTACCAGATTCACCCCTCCACTTT	CASSEGQGAGLVPDSPLHF	TRBV10-1	TRBJ1-6
TGTGCCTGGAGTGCCAGGGGGACAATCCTCACTGAAGCTTTCTTT	CAWSARGTILTEAFF	TRBV30	TRBJ1-1
TGTGCCAGCAGCAGGGGGGGGGAAGATACGCAGTATTTT	CASSRGGEDTQYF	TRBV6-1	TRBJ2-3
TGTGCCAGCAGCCAAGAACCACTAGCGGGTAGCACAGATACGCAGTATTTT	CASSQEPLAGSTDTQYF	TRBV3-1	TRBJ2-3
TGCAGTGCTTCTCGGGACAGGGGGAAAAAAACCGGGGAGCTGTTTTTT	CSASRDRGKKTGELFF	TRBV20-1	TRBJ2-2
TGTGCCAGCAGTTCTCCCGACAATGAGCAGTTCTTC	CASSSPDNEQFF	TRBV27	TRBJ2-1
TGTGCCACCGGTCTTCAGCGGCTCCGCTATGGCTACACCTTC	CATGLQRLRYGYTF	TRBV24-1	TRBJ1-2
TGTGCCAGCTCACACCCCTCTCGTGAGCAGTTCTTC	CASSHPSREQFF	TRBV18	TRBJ2-1
TGCAGTGCTAGAGGGGGGGGCCCGTTCTCTTGGAACATTCAGTACTTC	CSARGGGPFSWNIQYF	TRBV20-1	TRBJ2-4
TGTGCCAGCAGCAACCCCGTCTGCCTAAGAATGAGCTCCTACGAGCAGTACTTC	CASSNPVCLRMSSYEQYF	TRBV11-3	TRBJ2-7
TGTGCCAGCAGCTTAGGAACCGGGACAGCAATAAGGGTCATTCAGTACTTC	CASSLGTGTAIRVIQYF	TRBV7-9	TRBJ2-4
TGTGCCAGTAGTATTAAGGGAGGGTTTCCCCTAGCGGGCCAAGAGACCCAGTACTTC	CASSIKGGFPLAGQETQYF	TRBV19	TRBJ2-5
TGTGCCCTGTTCCCGGGACAGTGGAACTATGGCTACACCTTC	CALFPGQWNYGYTF	TRBV5-4	TRBJ1-2
TGTGCCAGCAGTGAAGTTACTCCCTTTTACTTGAGGCTGAATTCACCCCTCCACTTT	CASSEVTPFYLRLNSPLHF	TRBV2	TRBJ1-6
TGTGCCAGCAGCTTGAGGGACAGGGGGCGGACGCTCTATGGCTACACCTTC	CASSLRDRGRTLYGYTF	TRBV7-9	TRBJ1-2
TGTGCCAGCAGAGGTGGGGGGGGCACTGAAGCTTTCTTT	CASRGGGGTEAFF	TRBV6-4	TRBJ1-1
TGTGCCAGCATCCTGCTCTACGAAAAGACCCAGTACTTC	CASILLYEKTQYF	TRBV9	TRBJ2-5
TGTGCCAGCAGCGACAGGGATAAACTGTTTTTT	CASSDRDKLFF	TRBV7-2	TRBJ1-4
TGTGCCAGCAGCGACCCTTTGACTGGGGGGTGGGCGACGTATTCACCCCTCCACTTT	CASSDPLTGGWATYSPLHF	TRBV6-5	TRBJ1-6
TGTGCCAGCAGCCAAGACCCCCCGGGACACTTGGGAGGCAATCAGCCCCAGCATTTT	CASSQDPPGHLGGNQPQHF	TRBV3-1	TRBJ1-5
TGTGCCAGCAGTGACTCCCGAGCGGGGAAGGAGCCCCAGCATTTT	CASSDSRAGKEPQHF	TRBV6-4	TRBJ1-5
TGTGCCACCAGTGGGCCTCCGGCAATAAATTATAATGAAAAACTGTTTTTT	CATSGPPAINYNEKLFF	TRBV24-1	TRBJ1-4
TGCGCCAGCAGCCCTAGCGGTAAAGGTGCCTACAATGAGCAGTTCTTC	CASSPSGKGAYNEQFF	TRBV4-1	TRBJ2-1
TGCAGCGTTGAAGATTACGGACAGTGGAACACTGAAGCTTTCTTT	CSVEDYGQWNTEAFF	TRBV29-1	TRBJ1-1
TGTGCCAGCAGGTCGGGGGGGATCAATGAGCAGTTCTTC	CASRSGGINEQFF	TRBV7-3	TRBJ2-1
TGTGCCAGCAGCGAAAGCGAGGGGGGGGAAAAAATTACCGGGGAGACCCAGTACTTC	CASSESEGGEKITGETQYF	TRBV9	TRBJ2-5
TGTGCCAGCCCTGGGGGCCGGCTTTTTTATGGCTACACCTTC	CASPGGRLFYGYTF	TRBV9	TRBJ1-2
TGTGCCAGCAGCGCTAGCGGGAGCTACCGAGCTAGCACAGATACGCAGTATTTT	CASSASGSYRASTDTQYF	TRBV7-9	TRBJ2-3
TGTGCCAGTTTAGTGGACAGGTGGGCCAAAAACATTCAGTACTTC	CASLVDRWAKNIQYF	TRBV19	TRBJ2-4
TGTGCCAGCCTGGACAGGGGGCGTAATGAAAAACTGTTTTTT	CASLDRGRNEKLFF	TRBV7-8	TRBJ1-4
TGCAGTGCGCCACCGGGACAGCGGATTCAGCCCCAGCATTTT	CSAPPGQRIQPQHF	TRBV20-1	TRBJ1-5
TGTGCCAGCAATTGGAGGACAGGTGGTCGCACAGATACGCAGTATTTT	CASNWRTGGRTDTQYF	TRBV2	TRBJ2-3
TGTGCCAGTAGTACCCGGTCCCCAAGAGCGGACGTCACTGAAGCTTTCTTT	CASSTRSPRADVTEAFF	TRBV19	TRBJ1-1
TGTGCCAGCAGTTTAGTCGTGTTTAACGGCTACACCTTC	CASSLVVFNGYTF	TRBV12-3	TRBJ1-2
TGTGCCAGCCCCGGGCCGGGACAGTCCGTAGGGGCACCCCTCCACTTT	CASPGPGQSVGAPLHF	TRBV5-4	TRBJ1-6
TGCAGTGCTAGAGGGGGGGGCCCAGAGCAGTACTTC	CSARGGGPEQYF	TRBV20-1	TRBJ2-7
TGTGCCAGCAGAACCCATACTCAGCCCCAGCATTTT	CASRTHTQPQHF	TRBV7-9	TRBJ1-5
TGTGCCAGCAGCCGAAAGAGAGGGGGGCATCGCGCCGAGGAGACCCAGTACTTC	CASSRKRGGHRAEETQYF	TRBV13	TRBJ2-5
TGCGCCAGCAGCTTCTGCCAAATTGGGGGGGGGCTCCCCTACGAGCAGTACTTC	CASSFCQIGGGLPYEQYF	TRBV5-1	TRBJ2-7
TGTGCCAGCATGGGGGGCCTCGTCCCCTATGGCTACACCTTC	CASMGGLVPYGYTF	TRBV19	TRBJ1-2
TGTGCCAGCAGTGACAGCTGCGGGATTTTCACAGATACGCAGTATTTT	CASSDSCGIFTDTQYF	TRBV2	TRBJ2-3
TGTGCCAGCAGCTTACCAAGCCAAGATGAGCAGTTCTTC	CASSLPSQDEQFF	TRBV7-9	TRBJ2-1
TGCGCCAGCAGCTTGGAGGGACAGGGGGCTCCCTCTGGAAACACCATATATTTT	CASSLEGQGAPSGNTIYF	TRBV5-1	TRBJ1-3
TGTGCCAGCAGCGGCCAGAGGAACTACGAGCAGTACTTC	CASSGQRNYEQYF	TRBV9	TRBJ2-7
TGCAGTGCTAGGGGACAGGGCCAAGAGACCCAGTACTTC	CSARGQGQETQYF	TRBV20-1	TRBJ2-5
TGTGCCAGCAGCGGGGGGGTATCCTACGAGCAGTACTTC	CASSGGVSYEQYF	TRBV6-3	TRBJ2-7
TGTGCCTGGCAACACGAGCAGTACTTC	CAWQHEQYF	TRBV30	TRBJ2-7
TGTGCCAGCAGCTTAACAGGGGGTGTAGACTATGGCTACACCTTC	CASSLTGGVDYGYTF	TRBV7-2	TRBJ1-2
TGTGCCAGCAGTCCCTTACCGGCCGGGGCAAGCTCCTACGAGCAGTACTTC	CASSPLPAGASSYEQYF	TRBV27	TRBJ2-7
TGTGCCAGCAGCTATCCCAGGCTCTCCTACGAGCAGTACTTC	CASSYPRLSYEQYF	TRBV7-3	TRBJ2-7
TGTGCCAGGGGCTCATTGGACAGCCAGCCCCAGCATTTT	CARGSLDSQPQHF	TRBV2	TRBJ1-5
TGTGCCAGCAGCTCCCTGGGACAGGGCACTGCCTACGAGCAGTACTTC	CASSSLGQGTAYEQYF	TRBV7-3	TRBJ2-7
TGTGCCAGCAGTAGACAGCGGGACTACGAGCAGTACTTC	CASSRQRDYEQYF	TRBV7-8	TRBJ2-7
TGTGCCAGCAGCGTATATAGCAACTCTGGAAACACCATATATTTT	CASSVYSNSGNTIYF	TRBV9	TRBJ1-3
TGCAGTGCTAGAGAGCATAGTTCGGATTTCTACACTGAAGCTTTCTTT	CSAREHSSDFYTEAFF	TRBV20-1	TRBJ1-1
TGTGCCAGCAGTCCCTCCCTGAGAGGGCCCAGTGGTTCCTACAATGAGCAGTTCTTC	CASSPSLRGPSGSYNEQFF	TRBV12-4	TRBJ2-1
TGTGCCAGCAGCCTAGGGGGACTAGCGGGGGGGCCAAAGTACGAGCAGTACTTC	CASSLGGLAGGPKYEQYF	TRBV7-3	TRBJ2-7
TGCAGTGACAGGGGTAATTCACCCCTCCACTTT	CSDRGNSPLHF	TRBV20-1	TRBJ1-6
TGTGCCAGTAGTTTCATATTTCGACAGGATATCACAGATACGCAGTATTTT	CASSFIFRQDITDTQYF	TRBV19	TRBJ2-3
TGTGCCAGCAGCTACCCCGGCGAGCAGTTCTTC	CASSYPGEQFF	TRBV13	TRBJ2-1
TGTGCTAGTGGTTTGACCGTTGGGTTCTATGGCTACACCTTC	CASGLTVGFYGYTF	TRBV12-5	TRBJ1-2
TGCAGTGCGGCGGGACAGGGGGCAATGAACACTGAAGCTTTCTTT	CSAAGQGAMNTEAFF	TRBV20-1	TRBJ1-1
TGTGCCGTCGTGGGGGGCTATGGCTACACCTTC	CAVVGGYGYTF	TRBV3-1	TRBJ1-2
TGCGCCGCGGGGGGGCCGGGGGTCCAGTACTTC	CAAGGPGVQYF	TRBV5-1	TRBJ2-5
TGTGCCAGCGGGACTTGGGCCAACACTGAAGCTTTCTTT	CASGTWANTEAFF	TRBV5-6	TRBJ1-1
TGTGCCAGCAGTGGGACTGGGACAGGGGGGGAGCTGTTTTTT	CASSGTGTGGELFF	TRBV27	TRBJ2-2
TGTGCCACCAGTGAGGGACAGGGGGCGGACTTGCCGACTGGGGCCAACGTCCTGACTTTC	CATSEGQGADLPTGANVLTF	TRBV24-1	TRBJ2-6
TGTGCCAGCAGCTTAGGCTACATAAGCGAGACCCAGTACTTC	CASSLGYISETQYF	TRBV13	TRBJ2-5
TGTGCCAGCAGCTTAGAGGACAGGGGTAGCAATCAGCCCCAGCATTTT	CASSLEDRGSNQPQHF	TRBV7-3	TRBJ1-5
TGTGCCAGCAGATTCCCACACCCGGGTGGGACCCACGAGCAGTACTTC	CASRFPHPGGTHEQYF	TRBV6-5	TRBJ2-7
TGTGCCGCTGATCCTTTGACAGGAATAGCCAAAAACATTCAGTACTTC	CAADPLTGIAKNIQYF	TRBV10-3	TRBJ2-4
TGCGCCAGACCAGGGACAGGGGGCAAGCACTTACCCTATGGCTACACCTTC	CARPGTGGKHLPYGYTF	TRBV4-1	TRBJ1-2
TGTGCCAGCAGCGATGGACTAGGGTGTTACAATGAGCAGTTCTTC	CASSDGLGCYNEQFF	TRBV5-8	TRBJ2-1
TGCGCCAGCAGCCCCCGGGACCCCTACGAGCAGTACTTC	CASSPRDPYEQYF	TRBV5-1	TRBJ2-7
TGTGCCAGCAGCCCAAGACTAGCGGAGAAAGATACGCAGTATTTT	CASSPRLAEKDTQYF	TRBV7-4	TRBJ2-3
TGCGCCAGCAGCTTAGGACAGCGTGAGCAGTTCTTC	CASSLGQREQFF	TRBV5-1	TRBJ2-1
TGTGCCAGCAGTGAAGAGTGGGGGGGTGCCTTAGATACGCAGTATTTT	CASSEEWGGALDTQYF	TRBV6-1	TRBJ2-3
TGCAGTGCTAGTACTAGCGGGCGATTTGATACGCAGTATTTT	CSASTSGRFDTQYF	TRBV20-1	TRBJ2-3
TGCAGTGCTAGAGCCGAGGGGAGAGGGGCAAACACCGGGGAGCTGTTTTTT	CSARAEGRGANTGELFF	TRBV20-1	TRBJ2-2
TGTGCCAGCTCTGAGGGCAGACTGGAGAACACTGAAGCTTTCTTT	CASSEGRLENTEAFF	TRBV6-1	TRBJ1-1
TGTGCCAGCAGGGTGGACCATTACTACAATGAGCAGTTCTTC	CASRVDHYYNEQFF	TRBV2	TRBJ2-1
TGTGCCTGGAGTCCAAGAGCGATGAACGAGCAGTACTTC	CAWSPRAMNEQYF	TRBV30	TRBJ2-7
TGTGCCAGCAGCTTACTCCCACAGGGAAACAATGAGCAGTTCTTC	CASSLLPQGNNEQFF	TRBV7-3	TRBJ2-1
TGTGCCAGTAGTCGGGATGCCAATGAGCAGTTCTTC	CASSRDANEQFF	TRBV19	TRBJ2-1
TGTGCCAGCAGTTTGCCTTCAGTACTAAAGGGGGCTTTGAACACTGAAGCTTTCTTT	CASSLPSVLKGALNTEAFF	TRBV12-3	TRBJ1-1
TGTGCCAGCAGCGTTTGCAAACCGGAACGGACAGGGGGCCCTCAGCCCCAGCATTTT	CASSVCKPERTGGPQPQHF	TRBV5-4	TRBJ1-5
TGTGCCAGCAGCTTACCGAGCGGGATGATCCGGACCCTCCACTTT	CASSLPSGMIRTLHF	TRBV5-4	TRBJ1-6
TGTGCCAGCCCGGGACAGAACTCCTACGAGCAGTACTTC	CASPGQNSYEQYF	TRBV14	TRBJ2-7
TGTGCCAGCAGCGCCCTCTCACCAGGCACAGATACGCAGTATTTT	CASSALSPGTDTQYF	TRBV5-4	TRBJ2-3
TGTGCCTGGTTCGGGGAACGCTACAATGAGCAGTTCTTC	CAWFGERYNEQFF	TRBV30	TRBJ2-1
TGTGCCAGCACCTCTCTAGGGGGGGGCGTAGCGGACTATGGCTACACCTTC	CASTSLGGGVADYGYTF	TRBV12-3	TRBJ1-2
TGTGCCACCAGTGATTTGCTGACTAGTTGTTGGACGTTTGACAATGAGCAGTTCTTC	CATSDLLTSCWTFDNEQFF	TRBV24-1	TRBJ2-1
TGTGCCAGCAGTTGGGGGTACACAGATACGCAGTATTTT	CASSWGYTDTQYF	TRBV6-5	TRBJ2-3
TGTGCCAGCAGCCAGGTCTCTGGAAACACCATATATTTT	CASSQVSGNTIYF	TRBV7-3	TRBJ1-3
TGTGCCAGCAGCTTTCGCCCGGACAAGCGGCTAGCCAAAAACATTCAGTACTTC	CASSFRPDKRLAKNIQYF	TRBV11-2	TRBJ2-4
TGCGCCAGCAGCAGAGGGTATCGGGACAGGACTGAAGCTTTCTTT	CASSRGYRDRTEAFF	TRBV5-1	TRBJ1-1
TGTGCCAGCAGCCGGGACAGGGGGGGGGAGCAGTACTTC	CASSRDRGGEQYF	TRBV27	TRBJ2-7
TGTGCTAGTGGTTTGAAGACAGAGCAGCGTGGTTATGGCTACACCTTC	CASGLKTEQRGYGYTF	TRBV12-5	TRBJ1-2
TGTGCCAGCAGCTTACTCGCCCGGGGGCATCACACTGAAGCTTTCTTT	CASSLLARGHHTEAFF	TRBV7-3	TRBJ1-1
TGTGCCAGTAGTGTTGGGGTTGAACGGTACCTCCACTTT	CASSVGVERYLHF	TRBV19	TRBJ1-6
TGTGCCAGCAGCAACGGGGGGGTGCTCTACAATGAGCAGTTCTTC	CASSNGGVLYNEQFF	TRBV7-4	TRBJ2-1
TGTGCCACCAGTGACCCGCCACCGGGACGGAACACTGAAGCTTTCTTT	CATSDPPPGRNTEAFF	TRBV24-1	TRBJ1-1
TGTGCCAGCAGTAGAAGTAAACCACAGGGAATGTCCTACGAGCAGTACTTC	CASSRSKPQGMSYEQYF	TRBV6-3	TRBJ2-7
TGTGCCAGCAGCGAGGACAGAAGGGTCACCGGGGAGCTGTTTTTT	CASSEDRRVTGELFF	TRBV6-5	TRBJ2-2
TGTGCCAGTAGTCCAGAGGGTAAAAATGAGCAGTTCTTC	CASSPEGKNEQFF	TRBV19	TRBJ2-1
TGTGCCAGTAGTATAGGACAAGCAAAACCGGGGGGGGCCAAAAACATTCAGTACTTC	CASSIGQAKPGGAKNIQYF	TRBV19	TRBJ2-4
TGTGCCAGCAGTTACCGACAGTTAGAGACCCAGTACTTC	CASSYRQLETQYF	TRBV6-3	TRBJ2-5
TGCGCCAGCAACATGGCCTCCTATAATTCACCCCTCCACTTT	CASNMASYNSPLHF	TRBV10-2	TRBJ1-6
TGCGCCAGCAGCCAAGAATCGCCCGAGAGCTACGAGCAGTACTTC	CASSQESPESYEQYF	TRBV4-1	TRBJ2-7
TGTGCCAGCAGCGACGAGAGTTTGACAAAACTGTTTTTT	CASSDESLTKLFF	TRBV7-7	TRBJ1-4
TGTGCCAGCACGGAAGGGAGGACAGAGACCCAGTACTTC	CASTEGRTETQYF	TRBV7-4	TRBJ2-5
TGCGCCAGGGGCCGAGACGAGCAGTACTTC	CARGRDEQYF	TRBV5-1	TRBJ2-7
TGCGCCAGCCTCTTAGGCCGGGCCCAGATCGAGCAGTACTTC	CASLLGRAQIEQYF	TRBV5-1	TRBJ2-7
TGCAGTGCTCCCCCTCGGGAGGGAGTTTACGAGCAGTACTTC	CSAPPREGVYEQYF	TRBV20-1	TRBJ2-7
TGCGCCATCGGGACTAACACCGGGGAGCTGTTTTTT	CAIGTNTGELFF	TRBV10-1	TRBJ2-2
TGTGACCCGCCTAGGGGACTCTACAATGAGCAGTTCTTC	CDPPRGLYNEQFF	TRBV7-9	TRBJ2-1
TGTGCCAGCAGCTGGCTCGGAAGAAACGAGCAGTACTTC	CASSWLGRNEQYF	TRBV7-3	TRBJ2-7
TGTGCCAGCAGCGGAGACAGGGAAACCTACGAGCAGTACTTC	CASSGDRETYEQYF	TRBV14	TRBJ2-7
TGTGCCAGCAGCCCAGGGGGGAATGAGCAGTTCTTC	CASSPGGNEQFF	TRBV27	TRBJ2-1
TGTGCCAGCAGTTACATATTCCCCCTACTAGCGGACGAGCAGTACTTC	CASSYIFPLLADEQYF	TRBV6-5	TRBJ2-7
TGTGCCAGCAGTTACTCGCCACAGGGGGCGGGCTACGAGCAGTACTTC	CASSYSPQGAGYEQYF	TRBV6-3	TRBJ2-7
TGTGCCAGCAGGAGGGGACACACTGAAGCTTTCTTT	CASRRGHTEAFF	TRBV11-3	TRBJ1-1
TGTGCCATCGCCAGTCCAACTCGACGGGAGATTAACGAAAAACTGTTTTTT	CAIASPTRREINEKLFF	TRBV10-3	TRBJ1-4
TGCGCCAGCAGTCCAACTAGCGGCTCCTACGAGCAGTACTTC	CASSPTSGSYEQYF	TRBV10-2	TRBJ2-7
TGCGCCAGGGGACAGGGGGCACGCAATCAGCCCCAGCATTTT	CARGQGARNQPQHF	TRBV10-1	TRBJ1-5
TGTGCCAGCAGTGAAGTTAAGGGAGGGAACTCCTACGAGCAGTACTTC	CASSEVKGGNSYEQYF	TRBV6-1	TRBJ2-7
TGTGCCAGCAAAGCGACAGGCGGCAAAGGCACAGATACGCAGTATTTT	CASKATGGKGTDTQYF	TRBV6-3	TRBJ2-3
TGTGCCAGCTTCGTACTACAGGGACAAGGGACCGGGGAGCTGTTTTTT	CASFVLQGQGTGELFF	TRBV6-4	TRBJ2-2
TGCAGTGCTAGAGACGGGACTAGCGGTCTAGATACGCAGTATTTT	CSARDGTSGLDTQYF	TRBV20-1	TRBJ2-3
TGTGCCAGCAGCTTTCAACGGCAGAGGAACACCGGGGAGCTGTTTTTT	CASSFQRQRNTGELFF	TRBV5-5	TRBJ2-2
TGTGCCAGCAGTTACAAGGCACGAGGGGGGACTCAGTACTTC	CASSYKARGGTQYF	TRBV6-5	TRBJ2-5
TGTGCCAGCGTGGGGGGGGAAAGCTACGAGCAGTACTTC	CASVGGESYEQYF	TRBV6-5	TRBJ2-7
TGCAGCGTTGATATAGCGATAAGAAACACCATATATTTT	CSVDIAIRNTIYF	TRBV29-1	TRBJ1-3
TGCGCCAGCAGCCGGGGACAGGGGGAGTTCTACGAGCAGTACTTC	CASSRGQGEFYEQYF	TRBV10-1	TRBJ2-7
TGTGCCAGCAGCGTAAGGCCCGACACTGAAGCTTTCTTT	CASSVRPDTEAFF	TRBV7-8	TRBJ1-1
TGTGCCAGCTCCCCTCTTCTGGGGCCTGTCACAGATACGCAGTATTTT	CASSPLLGPVTDTQYF	TRBV18	TRBJ2-3
TGCGCCAGCAGCTTGAGGACAGGACGGTGGGCCTACGAGCAGTACTTC	CASSLRTGRWAYEQYF	TRBV5-1	TRBJ2-7
TGTGCCAGCAGCCAAAAAGGGGGGCCTGGCTACACCTTC	CASSQKGGPGYTF	TRBV14	TRBJ1-2
TGTGCCAGCACGGTGTGGAACACTGAAGCTTTCTTT	CASTVWNTEAFF	TRBV27	TRBJ1-1
TGTGCCCAGGACGCGGGGAACACAGATACGCAGTATTTT	CAQDAGNTDTQYF	TRBV6-1	TRBJ2-3
TGTGCCAGCGGCGCACAGGGGCCGGGTGACGCCTACGAGCAGTACTTC	CASGAQGPGDAYEQYF	TRBV28	TRBJ2-7
TGTGCCACCGGATCCAAAGGACAGGGGGCTCAGGTCCGAAACACCGGGGAGCTGTTTTTT	CATGSKGQGAQVRNTGELFF	TRBV24-1	TRBJ2-2
TGTGCCAGCAGTGAGGGGGGTTCGGGCCTCTCCTACGAGCAGTACTTC	CASSEGGSGLSYEQYF	TRBV28	TRBJ2-7
TGCGCCAGCAGCTTGGCCCCCCTACTCTGGCGGACAGGGGATCGATATGGCTACACCTTC	CASSLAPLLWRTGDRYGYTF	TRBV5-1	TRBJ1-2
TGTGCCAGCAGCTATGGGGGGGAAGGGCTAAACACCGGGGAGCTGTTTTTT	CASSYGGEGLNTGELFF	TRBV5-4	TRBJ2-2
TGTGCCAGCAGCTGGGGGGGCCTGGGCTACGAGCAGTACTTC	CASSWGGLGYEQYF	TRBV7-9	TRBJ2-7
TGCGCCAGCTTGCCACTTCCCGGGACTAGCGGGGAGCTGTTTTTT	CASLPLPGTSGELFF	TRBV10-2	TRBJ2-2
TGTGCCAGCTCGGGACTTACAGGGGGGGAAAAATCCTGCAATCAGCCCCAGCATTTT	CASSGLTGGEKSCNQPQHF	TRBV7-3	TRBJ1-5
TGCGCCACGGGGACAGGGTACGAGCAGTACTTC	CATGTGYEQYF	TRBV10-1	TRBJ2-7
TGTGCCCCTCGGGTTAGTAGGGACGAGACCCAGTACTTC	CAPRVSRDETQYF	TRBV5-6	TRBJ2-5
TGTGCCAGCAGCTTAGCTCCCGGGACTTTCAACTACGAGCAGTACTTC	CASSLAPGTFNYEQYF	TRBV7-4	TRBJ2-7
TGCAGTGCTCCGGGACAGGGGGCTGGCTACACCTTC	CSAPGQGAGYTF	TRBV20-1	TRBJ1-2
TGTGCCAGCAGGGAACCCGTTAAGAGCCTCTATGGCTACACCTTC	CASREPVKSLYGYTF	TRBV7-9	TRBJ1-2
TGTGCCAGCAGTTTACTAGGGGGCGGGGGCAATCAGCCCCAGCATTTT	CASSLLGGGGNQPQHF	TRBV27	TRBJ1-5
TGTGCCTGGAATTCTAGTGGGAGTGAGACCCAGTACTTC	CAWNSSGSETQYF	TRBV30	TRBJ2-5
TGTGCCAGCAGCCAGGGTTACACTGAAGCTTTCTTT	CASSQGYTEAFF	TRBV7-4	TRBJ1-1
TGCGCCAGCAGCTCAAATCGACAGACAGGGTTAATGACTGAAGCTTTCTTT	CASSSNRQTGLMTEAFF	TRBV5-1	TRBJ1-1
TGTGCCAGCAGTAATACGGGGGGGTCTTTCTACGAGCAGTACTTC	CASSNTGGSFYEQYF	TRBV6-5	TRBJ2-7
TGCAGTGCTAGGACCAAAACAGGGGGGAACAATCAGCCCCAGCATTTT	CSARTKTGGNNQPQHF	TRBV20-1	TRBJ1-5
TGTGCCAGCAGGCATACCGGAACCGGGGCCACCGGGACAGGCGGACCGGCCGGGGAGCTGTTTTTT	CASRHTGTGATGTGGPAGELFF	TRBV6-4	TRBJ2-2
TGCGCCAGCCGTTCGCTAGCGGGGGCTACAGATACGCAGTATTTT	CASRSLAGATDTQYF	TRBV10-2	TRBJ2-3
TGTGCCAGCAGGGGGGGGCGAAAGGTAGCCTACGAGCAGTACTTC	CASRGGRKVAYEQYF	TRBV13	TRBJ2-7
TGTGCCAGCAGGACGGGGGCGCAGACGGTTCCCTACGAGCAGTACTTC	CASRTGAQTVPYEQYF	TRBV6-1	TRBJ2-7
TGTGCCAGCAGCAAGCGGACAGGGGTAAGTAATACGCAGTATTTT	CASSKRTGVSNTQYF	TRBV11-1	TRBJ2-3
TGTGCCAGCAGTTCAGGGGAGGTAAAACTGTTTTTT	CASSSGEVKLFF	TRBV27	TRBJ1-4
TGTGCCAGCAGCCAAGGAAGGACGACTAGCGGGCATATCACAGATACGCAGTATTTT	CASSQGRTTSGHITDTQYF	TRBV3-1	TRBJ2-3
TGCAGTGCTAGAGACTCTGGGGGCACAGCTTTCTTT	CSARDSGGTAFF	TRBV20-1	TRBJ1-1
TGTGCCAGCAGCGTACCGACTAGCGGGACCGCCGGCCAAGAGACCCAGTACTTC	CASSVPTSGTAGQETQYF	TRBV9	TRBJ2-5
TGTGCCAGCAGGAGGGAGATCGAGCAGTACTTC	CASRREIEQYF	TRBV28	TRBJ2-7
TGTGCCAGCAGTCAGGCACGGACAGATACGCAGTATTTT	CASSQARTDTQYF	TRBV28	TRBJ2-3
TGCGCCAGCAGTGAGCCTAGACATAACTATGGCTACACCTTC	CASSEPRHNYGYTF	TRBV10-1	TRBJ1-2
TGTGCCAGCAGCCACAGGGGGGGGGCTAATGAAAAACTGTTTTTT	CASSHRGGANEKLFF	TRBV7-3	TRBJ1-4
TGTGCCAGCAGCCAAGGTGCGTTCATACGAACCTACGAGCAGTACTTC	CASSQGAFIRTYEQYF	TRBV14	TRBJ2-7
TGCGCCAGCAGCCCGGCTCCGACCTCGGGGGGGACTGATGAGCAGTTCTTC	CASSPAPTSGGTDEQFF	TRBV5-1	TRBJ2-1
TGTGCCAGCAGTTACCCCGGGGGGACCGGACCCGGGAGATCTAAAACCGGGGAGCTGTTTTTT	CASSYPGGTGPGRSKTGELFF	TRBV6-6	TRBJ2-2
TGTGCCACCAGTGATTTCTACGCCTCGGCAGGGGTCGCCAACTATGGCTACACCTTC	CATSDFYASAGVANYGYTF	TRBV24-1	TRBJ1-2
TGCAGTGCTAGAGGAACCAAGCGGAGTGGACGGTACAATGAGCAGTTCTTC	CSARGTKRSGRYNEQFF	TRBV20-1	TRBJ2-1
TGTGCCACCTCCCTGGAGGGGGGCCGGCTCTCTGGAAACACCATATATTTT	CATSLEGGRLSGNTIYF	TRBV24-1	TRBJ1-3
TGTGCCAGCAGCTTACAGGAGGCCCGGCCCCAGCATTTT	CASSLQEARPQHF	TRBV7-2	TRBJ1-5
TGTGCCTGGATCGACAGAATTGGCTACACCTTC	CAWIDRIGYTF	TRBV30	TRBJ1-2
TGTGCCAGCAGCTCGTGGAGGGTGGGGGAGCAGTACTTC	CASSSWRVGEQYF	TRBV7-7	TRBJ2-7
TGTGCCAGCAGCCAAGTGAAATCAACCACCTACAATGAGCAGTTCTTC	CASSQVKSTTYNEQFF	TRBV3-1	TRBJ2-1
TGTGCCAGCAGAATGGCCCGACAGGTCGAGCAGTACTTC	CASRMARQVEQYF	TRBV7-9	TRBJ2-7
TGCAGTGCTAGAGACATTATAGAGACTAGCGGTTTCGATACGCAGTATTTT	CSARDIIETSGFDTQYF	TRBV20-1	TRBJ2-3
TGTGCCAGCAGCTCCCTCGGGGGACGTAGTATCTTAACTAGCACAGATACGCAGTATTTT	CASSSLGGRSILTSTDTQYF	TRBV5-6	TRBJ2-3
TGCGCCAGCAGCGATTGGACAGGGGTAAGCTCCTACAATGAGCAGTTCTTC	CASSDWTGVSSYNEQFF	TRBV5-1	TRBJ2-1
TGTGCCAGCAGCTTATCAGGGGAAAGCGAGCAGTACTTC	CASSLSGESEQYF	TRBV7-3	TRBJ2-7
TGTGCCAGCAGTCACCTTTTTCTTGGGAGCCCGTTTACGCAGTATTTT	CASSHLFLGSPFTQYF	TRBV6-2	TRBJ2-3
TGTGCAAAGGACAGGATTGACACTGAAGCTTTCTTT	CAKDRIDTEAFF	TRBV9	TRBJ1-1
TGCGCCAGCAGCTCGCTAGAAACGAACACCGGGGAGCTGTTTTTT	CASSSLETNTGELFF	TRBV5-1	TRBJ2-2
TGCAGTGCTAGAGTCACGGGACATCGCCAGTACCAAGAGACCCAGTACTTC	CSARVTGHRQYQETQYF	TRBV20-1	TRBJ2-5
TGTGCCACCAGTGATTTGCGTGGGGGGGCAAGCCGTCCCTACGAGCAGTACTTC	CATSDLRGGASRPYEQYF	TRBV24-1	TRBJ2-7
TGTGCCACACGGGCTAGAAAACAAGAGACCCAGTACTTC	CATRARKQETQYF	TRBV6-4	TRBJ2-5
TGTGCCAGCAGCTTGAGTGGGAAAAATACTCGCGCCCCCTACGAGCAGTACTTC	CASSLSGKNTRAPYEQYF	TRBV5-5	TRBJ2-7
TGTGCCAGCATTGGAGACAGGGGCGAGCAGTACTTC	CASIGDRGEQYF	TRBV12-3	TRBJ2-7
TGTGCCCCCTTAGCGGTTTTACCGGACAATGAGCAGTTCTTC	CAPLAVLPDNEQFF	TRBV24-1	TRBJ2-1
TGTGCCAGCAGTTTCGGGTCTTGGCTCAATCAGCCCCAGCATTTT	CASSFGSWLNQPQHF	TRBV12-4	TRBJ1-5
TGTGCCAGCAGCGCCCGGTGTCGGAGGAACCAGGACGAGCAGTACTTC	CASSARCRRNQDEQYF	TRBV3-1	TRBJ2-7
TGCGCCAGCAGCCCCCCCTGGAGGGGTGGCCAAGAGACCCAGTACTTC	CASSPPWRGGQETQYF	TRBV4-3	TRBJ2-5
TGTGCCAGCAGCTTGAAGACTAGCGGGAGGTTGGGTCAGCCCCAGCATTTT	CASSLKTSGRLGQPQHF	TRBV5-4	TRBJ1-5
TGCAGTGCAGCGATGCATGGGACAGAGAACACTGAAGCTTTCTTT	CSAAMHGTENTEAFF	TRBV20-1	TRBJ1-1
TGCAGTGCTAGGATTCACCATAGCAATCAGCCCCAGCATTTT	CSARIHHSNQPQHF	TRBV20-1	TRBJ1-5
TGTGCCAGCAGCTGGTTTCCGCTAGCGGTACGGGAGTGGGACCTAGCCGGGGAGCTGTTTTTT	CASSWFPLAVREWDLAGELFF	TRBV7-8	TRBJ2-2
TGTGCCAGCAGCCCGGGGGATATGAACACTGAAGCTTTCTTT	CASSPGDMNTEAFF	TRBV14	TRBJ1-1
TGTGCCACCAGTGCCGGCATGACAGGGGGGGAGTGTGGGGGCGGGTCACCCCTCCACTTT	CATSAGMTGGECGGGSPLHF	TRBV24-1	TRBJ1-6
TGCAACCCATTAGCTCTCGCCGGTACGCAGTATTTT	CNPLALAGTQYF	TRBV20-1	TRBJ2-3
TGTGCCAGCAGCTTGATGCGGCGGACTGAAGCTTTCTTT	CASSLMRRTEAFF	TRBV5-6	TRBJ1-1
TGTGCCAGCAGCCAAGAGTCCCGGAGGGGGGGGGCCGAGCAGTACTTC	CASSQESRRGGAEQYF	TRBV4-2	TRBJ2-7
TGCAGTGCTAGGAAGTGGGGACAGGGGTTTACCCCAAGCTCCTACAATGAGCAGTTCTTC	CSARKWGQGFTPSSYNEQFF	TRBV20-1	TRBJ2-1
TGTGCCAGCAGCTTTTGTACGGTGACCCAGTACTTC	CASSFCTVTQYF	TRBV7-3	TRBJ2-5
TGTGCCAGCAGTTTCCGAAATCCCCAGCATTTT	CASSFRNPQHF	TRBV12-4	TRBJ1-5
TGCGCCAACAATACTGGAAACACCATATATTTT	CANNTGNTIYF	TRBV10-2	TRBJ1-3
TGCAGTGCTGTCCCCGGGGATCGCAATCAGCCCCAGCATTTT	CSAVPGDRNQPQHF	TRBV20-1	TRBJ1-5
TGTGCCAGCAGCCAACCGGGGGCTAGGAACTTGTCTCAGCCCCAGCATTTT	CASSQPGARNLSQPQHF	TRBV14	TRBJ1-5
TGTGCCAGCAGCGTAGACGTACTAGCGGGAGAGGCTGAAGCTTTCTTT	CASSVDVLAGEAEAFF	TRBV9	TRBJ1-1
TGCAGCGTGACTAAGCGGGACAGGGACACTGAAGCTTTCTTT	CSVTKRDRDTEAFF	TRBV29-1	TRBJ1-1
TGTGCCAGCCGGGGGGGCATGAAAAATGAGCAGTTCTTC	CASRGGMKNEQFF	TRBV11-1	TRBJ2-1
TGTGCCACCTCCCAAAAGGAGAGACAGGGGTCGAAGCTGTTTTTT	CATSQKERQGSKLFF	TRBV27	TRBJ2-2
TGTGCCAGCAGCGTAGGGCCGCTGTACTATGGCTACACCTTC	CASSVGPLYYGYTF	TRBV9	TRBJ1-2
TGTGCCACACTAGTTAATCACACTGAAGCTTTCTTT	CATLVNHTEAFF	TRBV24-1	TRBJ1-1
TGTGCCAGCTCACCAACAGGGACAAACCAAGAGACCCAGTACTTC	CASSPTGTNQETQYF	TRBV18	TRBJ2-5
TGCAGCGTTTCCCGGGACAAGGTATCACCCCTCCACTTT	CSVSRDKVSPLHF	TRBV29-1	TRBJ1-6
TGTGCCAGCAGCTTTATAGTCCCGCCACCAGAGAACACTGAAGCTTTCTTT	CASSFIVPPPENTEAFF	TRBV7-4	TRBJ1-1
TGCGCCCTGGAGGGTTTGAACACCGGGGAGCTGTTTTTT	CALEGLNTGELFF	TRBV5-1	TRBJ2-2
TGTGCCAGCAGCGGGGGAGGGCCTGAAGCTTTCTTT	CASSGGGPEAFF	TRBV7-4	TRBJ1-1
TGTGCCAGCAGTTTTGGGGGCGACAGGGGTCAAGAGACCCAGTACTTC	CASSFGGDRGQETQYF	TRBV28	TRBJ2-5
TGTGCCAGCAGTTGCCACAGGGTGCCTTCGAACACTGAAGCTTTCTTT	CASSCHRVPSNTEAFF	TRBV12-3	TRBJ1-1
TGTGCCAGCAGCAGAGGACTCCCATGCATGCAAGAGACCCAGTACTTC	CASSRGLPCMQETQYF	TRBV7-9	TRBJ2-5
TGTGCCAGCAGCTTAGTCCGGGACAGGGACCTCCAAGGACACAGGCCCGTAGGCTACACCTTC	CASSLVRDRDLQGHRPVGYTF	TRBV7-9	TRBJ1-2
TGTGCCAGCAGACGCGGGAGTAATAATGAGCAGTTCTTC	CASRRGSNNEQFF	TRBV7-4	TRBJ2-1
TGTGCCAGCAGATTCCTACTATTCGGGGAAACCACTGAAGCTTTCTTT	CASRFLLFGETTEAFF	TRBV6-6	TRBJ1-1
TGTGCCACCACTCTCACCATATATTTT	CATTLTIYF	TRBV24-1	TRBJ1-3
TGTGCCAGCAGTGAAACGGGACTAGTGAACACTGAAGCTTTCTTT	CASSETGLVNTEAFF	TRBV6-1	TRBJ1-1
TGCAGTGCTAGCGTGGGGGACAACGAGCAGTACTTC	CSASVGDNEQYF	TRBV20-1	TRBJ2-7
TGTGCAGGGACTAGCGGGCCCACCTACGAGCAGTACTTC	CAGTSGPTYEQYF	TRBV30	TRBJ2-7
TGCAGTGCTAGCCTGTGGGGGGGGGAGACAGATACGCAGTATTTT	CSASLWGGETDTQYF	TRBV20-1	TRBJ2-3
TGTGCCAGCAGCTTATTTCTAGCGGGGGGCGCGTACGAGCAGTACTTC	CASSLFLAGGAYEQYF	TRBV7-9	TRBJ2-7
TGTGCCAGCAGCCAAGATGAGCTGGGCCTCGTGAACACTGAAGCTTTCTTT	CASSQDELGLVNTEAFF	TRBV3-1	TRBJ1-1
TGTGCCAGCAGCATACGGGGAACCAAAAACATTCAGTACTTC	CASSIRGTKNIQYF	TRBV5-4	TRBJ2-4
TGTGCCAGCAGAAGAAGGAGTCAGGGGGACATTCAGTACTTC	CASRRRSQGDIQYF	TRBV2	TRBJ2-4
TGTGCCAGCAGCATTGGACATCATGGCTACACCTTC	CASSIGHHGYTF	TRBV28	TRBJ1-2
TGTGCCAGCTCACCATACAACGTAAAGGGCCAAGAGACCCAGTACTTC	CASSPYNVKGQETQYF	TRBV18	TRBJ2-5
TGTGCCAGCAGTTCGGGACTAGCGGGGAGAGATACGCAGTATTTT	CASSSGLAGRDTQYF	TRBV6-5	TRBJ2-3
TGTGCCAGCAGCTTAGAGCCCGGGGCTAACACTGAAGCTTTCTTT	CASSLEPGANTEAFF	TRBV7-9	TRBJ1-1
TGTGCCAGCAGGGGGGGGGAGCAGTACTTC	CASRGGEQYF	TRBV6-2	TRBJ2-7
TGTGCCAGCAGATCTATTGGGGGGATGAACACTGAAGCTTTCTTT	CASRSIGGMNTEAFF	TRBV6-1	TRBJ1-1
TGCGCCAGCAGAAAAATGGGGCGGACGCGTGACACTGAAGCTTTCTTT	CASRKMGRTRDTEAFF	TRBV10-1	TRBJ1-1
TGTGCCAGCAGCAAGGGATACCGGGACCCACTATCTGGGGCCAACGTCCTGACTTTC	CASSKGYRDPLSGANVLTF	TRBV9	TRBJ2-6
TGTGCCAGCAGCCCCGACGGCAATCAGCCCCAGCATTTT	CASSPDGNQPQHF	TRBV7-3	TRBJ1-5
TGTGCCAGCAGTTACCCTATCCTGCCCTACTATGGCTACACCTTC	CASSYPILPYYGYTF	TRBV6-2	TRBJ1-2
TGTGCCAGCAGCGTTAAAGACATGGGGCTTGTTTCGTGTTCCGGGGTAGAGGCTGAAGCTTTCTTT	CASSVKDMGLVSCSGVEAEAFF	TRBV13	TRBJ1-1
TGTGCCAGCAGCTTAGATACCCCAAAAAGGGATCCCTTC	CASSLDTPKRDPF	TRBV7-9	TRBJ2-7
TGTGCCAGCAGCTTATCGACAGTTACCTCTGGGGCCAACGTCCTGACTTTC	CASSLSTVTSGANVLTF	TRBV7-6	TRBJ2-6
TGCAGTGCCCCGAGGAAAACGGAGGAGACCCAGTACTTC	CSAPRKTEETQYF	TRBV20-1	TRBJ2-5
TGTGCCAGCAGCGTAGCTCGGGTTTCGGGGCTCCATGGCTACACCTTC	CASSVARVSGLHGYTF	TRBV9	TRBJ1-2
TGTCCGTTAGTCGCCTACAATGAGCAGTTCTTC	CPLVAYNEQFF	TRBV10-3	TRBJ2-1
TGTGCCACCAGTGATTTCGAGAACCGGGACAGGGCGGTCTATGGCTACACCTTC	CATSDFENRDRAVYGYTF	TRBV24-1	TRBJ1-2
TGTGCCAGCAGTGAGCGGCCCGGGACTAGCACTACGCAGTATTTT	CASSERPGTSTTQYF	TRBV25-1	TRBJ2-3
TGCGCCAGCAGCTTGGGCGTAGCGGGTTATCACTTGGGCGAGCAGTACTTC	CASSLGVAGYHLGEQYF	TRBV5-1	TRBJ2-7
TGTGCCTGGAGTGTACGTGACAAGCAGTACTTC	CAWSVRDKQYF	TRBV30	TRBJ2-7
TGTGCCAGCATCCCAGTGGCCGGGGAGCTGTTTTTT	CASIPVAGELFF	TRBV6-5	TRBJ2-2
TGTGCCAGCAGCGCCCCCCCCCCCGAACCTGAGACCCAGTACTTC	CASSAPPPEPETQYF	TRBV7-8	TRBJ2-5
TGTGCCAGCAGCCCCAGGGGGGCCTCCAACGAGCAGTACTTC	CASSPRGASNEQYF	TRBV7-3	TRBJ2-7
TGTGCTAGTGGTTCGATTGAGGAAAAACTGTTTTTT	CASGSIEEKLFF	TRBV12-5	TRBJ1-4
TGTGCCATCACACAGGGGTTTGAGACCCAGTACTTC	CAITQGFETQYF	TRBV10-3	TRBJ2-5
TGCAGCGTTACCGCTTCTAGCGAGCCCCAGCATTTT	CSVTASSEPQHF	TRBV29-1	TRBJ1-5
TGTGCCAGCAGCTTCGTCCCATACGGACTAGCGGGGGTTACCGGGGAGCTGTTTTTT	CASSFVPYGLAGVTGELFF	TRBV11-2	TRBJ2-2
TGTGCCTGGGTGACAGAGCCGGTTTATGGCTACACCTTC	CAWVTEPVYGYTF	TRBV14	TRBJ1-2
TGCAGTGCTAGGCGGGGGGCGGACAATGAAAAACTGTTTTTT	CSARRGADNEKLFF	TRBV20-1	TRBJ1-4
TGTGCCAGCAGCGCAGCAGTTTCACCCCTCCACTTT	CASSAAVSPLHF	TRBV7-9	TRBJ1-6
TGTGCCAGCAGCGTACAATTCGAGACCCAGTACTTC	CASSVQFETQYF	TRBV11-3	TRBJ2-5
TGTGCCAGCAGTTACAAGAAGGGGGAGGATTCCTACGAGCAGTACTTC	CASSYKKGEDSYEQYF	TRBV6-5	TRBJ2-7
TGTGCCTCCACCCGGGGGGGCGGCACAGATACGCAGTATTTT	CASTRGGGTDTQYF	TRBV19	TRBJ2-3
TGTGCCAGCAGTTTCGGATGGACAGTTGAAGCTTTCTTT	CASSFGWTVEAFF	TRBV28	TRBJ1-1
TGCAGTGCTAGTTGGCACCGCCACGACTTAAACTACGAGCAGTACTTC	CSASWHRHDLNYEQYF	TRBV20-1	TRBJ2-7
TGTGCCAGCAGCGGACGGGACAGGGGGGATACGTACTTC	CASSGRDRGDTYF	TRBV7-3	TRBJ2-7
TGTGCCCCTCTTCGGACAGGGATACCACGCTACAATGAGCAGTTCTTC	CAPLRTGIPRYNEQFF	TRBV10-3	TRBJ2-1
TGCGCCAGCAGCGGCGCCCGGGGGGGTGAGGGAGATACGCAGTATTTT	CASSGARGGEGDTQYF	TRBV5-1	TRBJ2-3
TGTGCCAGCAGTCATCAGGTGGAATGGGGGACTGAAGCTTTCTTT	CASSHQVEWGTEAFF	TRBV27	TRBJ1-1
TGTGCCAGCAGTCCGCGACAGGGCGAGACCCAGTACTTC	CASSPRQGETQYF	TRBV6-5	TRBJ2-5
TGCGCCAGCAGCCGGACAGGGGGCGAGACCCAGTACTTC	CASSRTGGETQYF	TRBV10-2	TRBJ2-5
TGTGCCAGCAGCGAAGGTGGGAGGGGGGAAAAACTGTTTTTT	CASSEGGRGEKLFF	TRBV7-8	TRBJ1-4
TGTGCCTATGGGGAAGGACCCACTGAAGCTTTCTTT	CAYGEGPTEAFF	TRBV12-3	TRBJ1-1
TGTGCCAGCACCCCGGGTCGGGAGGGCGCCTCCCAGCATTTT	CASTPGREGASQHF	TRBV6-2	TRBJ1-5
TGTGCCAGCAGCCAAGAGGCACAGGGAGATAATGAGCAGTTCTTC	CASSQEAQGDNEQFF	TRBV3-1	TRBJ2-1
TGTGCCAGCAGTAGAGGTGTCGGGACAGGTAAACAGCCCCAGCATTTT	CASSRGVGTGKQPQHF	TRBV6-6	TRBJ1-5
TGCGCCAGCAGCCAACCACAGCGGGAGACCCTTATTAGCAATCAGCCCCAGCATTTT	CASSQPQRETLISNQPQHF	TRBV4-3	TRBJ1-5
TGCGCCAGCAGGACAGGGGGCCCGATTTACGAGCAGTACTTC	CASRTGGPIYEQYF	TRBV10-2	TRBJ2-7
TGTGCCATCAGTGGAGAGGACAGGAGCACAGATACGCAGTATTTT	CAISGEDRSTDTQYF	TRBV10-3	TRBJ2-3
TGTGGGACGGAGAGCAGGTTGATGAACACTGAAGCTTTCTTT	CGTESRLMNTEAFF	TRBV12-3	TRBJ1-1
TGCAGTGCTAGAGGGGTGGGACTAGAGAGGAATGAGCAGTTCTTC	CSARGVGLERNEQFF	TRBV20-1	TRBJ2-1
TGTGCCAGCAGCGGTCCGAGGGACAGGGTAGTCACTGAAGCTTTCTTT	CASSGPRDRVVTEAFF	TRBV5-5	TRBJ1-1
TGCAGTGCTAGAGATCTTGGACCCCGGACAGGGGGGGGGGAGTCTAATTCACCCCTCCACTTT	CSARDLGPRTGGGESNSPLHF	TRBV20-1	TRBJ1-6
TGTGCCAGCAGCGTTACGGGGCAGTACTTC	CASSVTGQYF	TRBV11-2	TRBJ2-7
TGTGCCAGCAGCGTAGAGGGGGGGGACGAGCAGTACTTC	CASSVEGGDEQYF	TRBV9	TRBJ2-7
TGTGCCAGCAGTCGGCCCGCGGGAGTTGGGGTTTATGGACAGCCCCAGCATTTT	CASSRPAGVGVYGQPQHF	TRBV6-2	TRBJ1-5
TGTGCCAGCAGCTTGGTGACAGGGAGGGGTCTCGAGCAGTACTTC	CASSLVTGRGLEQYF	TRBV5-6	TRBJ2-7
TGCGCCAGCAGTGAGCCGAGAGGGGGTAATGAAAAACTGTTTTTT	CASSEPRGGNEKLFF	TRBV10-1	TRBJ1-4
TGTGCCAGCAGTTTATCTCGGACGGGCTCCTACAATGAGCAGTTCTTC	CASSLSRTGSYNEQFF	TRBV27	TRBJ2-1
TGTGCCATACCAAAGCAGGGGAATAGCAATCAGCCCCAGCATTTT	CAIPKQGNSNQPQHF	TRBV28	TRBJ1-5
TGTGCCAGCAGTCGCCGGAGGGGGGGGGGGATGCAAGAGACCCAGTACTTC	CASSRRRGGGMQETQYF	TRBV27	TRBJ2-5
TGTGCCAGGTGGATATCGGGTTACAATGAGCAGTTCTTC	CARWISGYNEQFF	TRBV7-9	TRBJ2-1
TGTGCCAGCAGCGTTGGCTCTGAGCCCCAGCATTTT	CASSVGSEPQHF	TRBV9	TRBJ1-5
TGTGCCAGCAGCAGTCGGGACGGCGCTCACAATGAGCAGTTCTTC	CASSSRDGAHNEQFF	TRBV11-3	TRBJ2-1
TGCGCCAGCAGCCAAGCCCCGGGACTCAGGTTCACAGATACGCAGTATTTT	CASSQAPGLRFTDTQYF	TRBV4-1	TRBJ2-3
TGCAGTGGACAGTACTCCGGGACGCCCAGCACAGATACGCAGTATTTT	CSGQYSGTPSTDTQYF	TRBV20-1	TRBJ2-3
TGTGCCAGCAGCGTCAACAGTGTCTCTCAGCCCCAGCATTTT	CASSVNSVSQPQHF	TRBV6-4	TRBJ1-5
TGTGCCAGCAGCCAAGTTGGGACCACAGATACGCAGTATTTT	CASSQVGTTDTQYF	TRBV4-2	TRBJ2-3
TGTGCCAGCAAGTTGGCGATTGAAGCTTTCTTT	CASKLAIEAFF	TRBV12-3	TRBJ1-1
TGTGCCAGCAGCCTGGAGCGGGGACTGGGTGCGAACACCGGGGAGCTGTTTTTT	CASSLERGLGANTGELFF	TRBV13	TRBJ2-2
TGTGCCAGCAGCCAAGATCAAGGACCAGTAGATACGCAGTATTTT	CASSQDQGPVDTQYF	TRBV3-1	TRBJ2-3
TGTGCCAGCAGCTTACACCGGGGGGCCCACCCAATCCTAGTTGAGCAGTTCTTC	CASSLHRGAHPILVEQFF	TRBV11-3	TRBJ2-1
TGTGCCAGAGAGGGAACGCGGCGTCAAGACACCATATATTTT	CAREGTRRQDTIYF	TRBV10-3	TRBJ1-3
TGCAGCGTTGCCCCGTGGCGCGCAGGAATAACCGGGGAGCTGTTTTTT	CSVAPWRAGITGELFF	TRBV29-1	TRBJ2-2
TGCGCCAGCAGGAAAAGCACAGGCTTTGAAGCTTTCTTT	CASRKSTGFEAFF	TRBV5-1	TRBJ1-1
TGTGCCAGCAGTGAAGGAGATTTATTTCAAGGCTACACCTTC	CASSEGDLFQGYTF	TRBV6-1	TRBJ1-2
TGCGCCAGCAGCTGCATACGTTCCCGATCCGGGACTTCCTACAATGAGCAGTTCTTC	CASSCIRSRSGTSYNEQFF	TRBV5-1	TRBJ2-1
TGCGCCAGCAGCCTTACTTCTCCGGGACATAGCACAGATACGCAGTATTTT	CASSLTSPGHSTDTQYF	TRBV4-1	TRBJ2-3
TGTGCCAGCAGCCCGGACGGAAGATCAGTCTCTGGGGCCAACGTCCTGACTTTC	CASSPDGRSVSGANVLTF	TRBV13	TRBJ2-6
TGCGCCAGCAGCACGGGGAAGGGGTACAATGAGCAGTTCTTC	CASSTGKGYNEQFF	TRBV5-1	TRBJ2-1
TGTGCCTGGGGCACGGGGCGGACAGGTTCCGGGCCCCAGCATTTT	CAWGTGRTGSGPQHF	TRBV30	TRBJ1-5
TGCGCCAGCAGTGAATACAGGGGGGCTGAGCAGTTCTTC	CASSEYRGAEQFF	TRBV10-2	TRBJ2-1
TGCGCCAGCAGCTTGATATTGCCGTCTAGCGGGTGGACCTACGAGCAGTACTTC	CASSLILPSSGWTYEQYF	TRBV5-1	TRBJ2-7
TGTGCCAGCAGCCAATTCTCGGGGCTTGAGACCCAGTACTTC	CASSQFSGLETQYF	TRBV3-1	TRBJ2-5
TGCGCCAGCAGCTCAGTGGAAGCTGGGCCCGTCGGTGACGGGGAGCTGTTTTTT	CASSSVEAGPVGDGELFF	TRBV5-1	TRBJ2-2
TGCAGTGCCCTCCGATCCAGGAACTATGGCTACACCTTC	CSALRSRNYGYTF	TRBV20-1	TRBJ1-2
TGTGCCACCTCATCTTTCTATGGCTACACCTTC	CATSSFYGYTF	TRBV24-1	TRBJ1-2
TGCGCCAGCAGCTTGGCAGGGGTGTACTTC	CASSLAGVYF	TRBV5-1	TRBJ2-7
TGCGTTTACAGGGGGCTCGGAGAAGGTCCCACAGATACGCAGTATTTT	CVYRGLGEGPTDTQYF	TRBV20-1	TRBJ2-3
TGCGCCAGCACTACAGGCAGTTTAGGGGCCTACGAGCAGTACTTC	CASTTGSLGAYEQYF	TRBV10-1	TRBJ2-7
TGTGCCAGCAGCCAAGTCCCAATAGCTAGCGGGCTGAACACCGGGGAGCTGTTTTTT	CASSQVPIASGLNTGELFF	TRBV3-1	TRBJ2-2
TGTGCCTGGAGTGTACCAGGCGGGAGTCTTTATCAGCCCCAGCATTTT	CAWSVPGGSLYQPQHF	TRBV30	TRBJ1-5
TGTGCCAGCAGTGTCCCCGGGACTAGCGGAGCAGATACGCAGTATTTT	CASSVPGTSGADTQYF	TRBV6-4	TRBJ2-3
TGTGCCAGTAGGCCACACAGGGTGGAAACAGAGACCCAGTACTTC	CASRPHRVETETQYF	TRBV19	TRBJ2-5
TGTGCCTGGACGCCCAGGGACAGCACGACTGAAGCTTTCTTT	CAWTPRDSTTEAFF	TRBV30	TRBJ1-1
TGTGCCAGCAGCTTACCTACCGGGAGGGTGGAGACCCAGTACTTC	CASSLPTGRVETQYF	TRBV7-3	TRBJ2-5
TGCGCCAGCAGCCATCCGGGGAACAATGAGCAGTTCTTC	CASSHPGNNEQFF	TRBV4-3	TRBJ2-1
TGTGCCAGCAGTCCTCAGGGGGGGCTTCTCTCCTACAATGAGCAGTTCTTC	CASSPQGGLLSYNEQFF	TRBV6-2	TRBJ2-1
TGTGCCAGCAGGAATTCCCAGGCTTTATGGGAGAAAACGGGCTACGAGCAGTACTTC	CASRNSQALWEKTGYEQYF	TRBV13	TRBJ2-7
TGTGCCAGCAGCAGACAACCCCCCAGAGCCCCCCGGGACAGGGGCTTGTTCAAGACCCAGTACTTC	CASSRQPPRAPRDRGLFKTQYF	TRBV9	TRBJ2-5
TGTGCCAGCAGTGACCGCAGGGGAAGTGGCAATGAAAAACTGTTTTTT	CASSDRRGSGNEKLFF	TRBV6-4	TRBJ1-4
TGTGCTAGTGGTTTAGATAGGGACAGGGTTGTCTACGAGCAGTACTTC	CASGLDRDRVVYEQYF	TRBV12-5	TRBJ2-7
TGCGCCAGCAGGGGGAAATACGGGGGTGTCCGACAATCCACAGATACGCAGTATTTT	CASRGKYGGVRQSTDTQYF	TRBV4-1	TRBJ2-3
TGTGCCAGCAGTTTAATTATGGGAGGGATAAACTCTGGAAACACCATATATTTT	CASSLIMGGINSGNTIYF	TRBV27	TRBJ1-3
TGTGCCAGCAGTTACTCGCCCCCGGACCCAGATACGCAGTATTTT	CASSYSPPDPDTQYF	TRBV6-6	TRBJ2-3
TGCAGTGCTAGAGGGTCTCCTAGGCGTGAAATCCTCGCGCAGTATTTT	CSARGSPRREILAQYF	TRBV20-1	TRBJ2-3
TGTGCCAGCAGCTTAGGTGGGACAGATCAAAGCAATCAGCCCCAGCATTTT	CASSLGGTDQSNQPQHF	TRBV7-9	TRBJ1-5
TGTGCCAGCAGCCCGGGACTAGCGGGGTCCTTAGATACGCAGTATTTT	CASSPGLAGSLDTQYF	TRBV7-3	TRBJ2-3
TGTGCCAGCAGGACCTATGGCTACACCTTC	CASRTYGYTF	TRBV27	TRBJ1-2
TGCAGTGCTTTCTATCTACAGCTCAAAAATGGATACCAGCCCCAGCATTTT	CSAFYLQLKNGYQPQHF	TRBV20-1	TRBJ1-5
TGCGCCAGCAGTGACCCGAGAGGGGGAGCGGTACCGATCGGGGAGCTGTTTTTT	CASSDPRGGAVPIGELFF	TRBV10-1	TRBJ2-2
TGTGCCAGCAGCTGGACTAGCGGGTCTGAGCAGTTCTTC	CASSWTSGSEQFF	TRBV5-4	TRBJ2-1
TGTGCCAGCACCGGGACAGACTATGGCTACACCTTC	CASTGTDYGYTF	TRBV7-2	TRBJ1-2
TGTGCCAGCAGGTACAGGGGGCGGCAGTACTTC	CASRYRGRQYF	TRBV12-4	TRBJ2-7
TGTGCCAGCAGCCAAGCGGATATTAATGGCTACACCTTC	CASSQADINGYTF	TRBV14	TRBJ1-2
TGTGCCAGCAGCTCGAGGGGCACAGATACGCAGTATTTT	CASSSRGTDTQYF	TRBV7-9	TRBJ2-3
TGTGCCAGCAGGGTCAGGGATCCGAGCAATCAGCCCCAGCATTTT	CASRVRDPSNQPQHF	TRBV7-3	TRBJ1-5
TGTGCCAGCAGCTTAGTCTTGGTCGGTCCCCCGGACAAAGGGAACACCGGGGAGCTGTTTTTT	CASSLVLVGPPDKGNTGELFF	TRBV11-3	TRBJ2-2
TGTGCCAGTAGTGGGCCCCAGTCAACCTACGAGCAGTACTTC	CASSGPQSTYEQYF	TRBV19	TRBJ2-7
TGTGCCTGGAGTGCCCTGCAGATCTCCTACGAGCAGTACTTC	CAWSALQISYEQYF	TRBV30	TRBJ2-7
TGTGCCAGCAGTGGCTCCGGTCTAGGCCAAGAGACCCAGTACTTC	CASSGSGLGQETQYF	TRBV2	TRBJ2-5
TGCGCCAGCAGCGGGCCCCCAGACGGACAGGGGAGGGTAAACACCGGGGAGCTGTTTTTT	CASSGPPDGQGRVNTGELFF	TRBV5-1	TRBJ2-2
TGTGCCAGCAGTGACTCGGCTACTAGCGGGAGTGAAAAACTGTTTTTT	CASSDSATSGSEKLFF	TRBV6-4	TRBJ1-4
TGTGCCAGCAAGGTATCCCCCTACGAGCAGTACTTC	CASKVSPYEQYF	TRBV27	TRBJ2-7
TGTGCCAGCAGTATCCGGATGCCGCAGTACTTC	CASSIRMPQYF	TRBV5-4	TRBJ2-5
TGCGCCAAGCACTCAGGTCCACCGAACACTGAAGCTTTCTTT	CAKHSGPPNTEAFF	TRBV5-1	TRBJ1-1
TGCGCCAGCTCTGGACAAGGGAGGGGTAGCACAGATACGCAGTATTTT	CASSGQGRGSTDTQYF	TRBV5-1	TRBJ2-3
TGTGCCAGCAGCTTACGGAAAGACTATGGCTACACCTTC	CASSLRKDYGYTF	TRBV11-2	TRBJ1-2
TGTGCTAGTGGTTTGTCGGCGCGCGAGATGGGGGTATCAGAGCCCCAGCATTTT	CASGLSAREMGVSEPQHF	TRBV12-5	TRBJ1-5
TGTGCCTGGAGTGTACGAGGTCCAACTCCTAGAGACACAGATACGCAGTATTTT	CAWSVRGPTPRDTDTQYF	TRBV30	TRBJ2-3
TGTGCCAGCAGCCTAGTAAACGGGAGGGAGCCGTCCTACGAGCAGTACTTC	CASSLVNGREPSYEQYF	TRBV7-4	TRBJ2-7
TGTGCCAAACAAGGGCTTTCTGGGGCCAACGTCCTGACTTTC	CAKQGLSGANVLTF	TRBV6-5	TRBJ2-6
TGTGCCAGCAGTTATAGGTCCCTCCGAAATTCACCCCTCCACTTT	CASSYRSLRNSPLHF	TRBV6-5	TRBJ1-6
TGCGCCAGCAGCTTAAGGACACAACACTATGAGCAGTTCTTC	CASSLRTQHYEQFF	TRBV5-1	TRBJ2-1
TGTGCCAGCAGCTTGCTAAGGTCCTACAATGAGCAGTTCTTC	CASSLLRSYNEQFF	TRBV7-9	TRBJ2-1
TGTGCCACCAGCAGAGATTCGCGGGGGGCCGTAGGTATCACAGATACGCAGTATTTT	CATSRDSRGAVGITDTQYF	TRBV15	TRBJ2-3
TGTGCCAGCACGTTCCCAGGGGAAAAACTGTTTTTT	CASTFPGEKLFF	TRBV12-3	TRBJ1-4
TGTGCTAGCAGGCGCAACTGTAGGCTACCTTGCAATCAGCCCCAGCATTTT	CASRRNCRLPCNQPQHF	TRBV7-7	TRBJ1-5
TGCGCCAGCAGCCTCGGGGGGCCGGGGAACACTGAAGCTTTCTTT	CASSLGGPGNTEAFF	TRBV4-3	TRBJ1-1
TGCAGTGCCCTCCCAAGGGGGACCGGCTACACCTTC	CSALPRGTGYTF	TRBV20-1	TRBJ1-2
TGTGCCAGCAGCACTTTCAATGAGCAGTTCTTC	CASSTFNEQFF	TRBV6-1	TRBJ2-1
TGTGCCAGCAGCTTAATGGACAGGACTAGCGTGGACGAGACCCAGTACTTC	CASSLMDRTSVDETQYF	TRBV11-2	TRBJ2-5
TGTGCCAGCAGTCCCCAGCCGGGACAGACCACTGGAAACACCATATATTTT	CASSPQPGQTTGNTIYF	TRBV27	TRBJ1-3
TGTGCCAGCAGCGTGTTCGGGACTAGGAGCTCCTACGAGCAGTACTTC	CASSVFGTRSSYEQYF	TRBV9	TRBJ2-7
TGTGCCAGCAGCTGGGTAACGCCCTCGGGCCCGAATCAGCCCCAGCATTTT	CASSWVTPSGPNQPQHF	TRBV5-6	TRBJ1-5
TGCGCCAGCATCACGGGGCCCCGCTACGAGCAGTACTTC	CASITGPRYEQYF	TRBV5-1	TRBJ2-7
TGTGCCAGCAGCTTTTCCACGGGAGGAAATAGCACTGAAGCTTTCTTT	CASSFSTGGNSTEAFF	TRBV5-4	TRBJ1-1
TGTGCCAGCAGCTTAGCTGGTTCTTCGGGACCGTGGTTCCCGAACACTGAAGCTTTCTTT	CASSLAGSSGPWFPNTEAFF	TRBV11-3	TRBJ1-1
TGTGCCAGCAGCAACAGGGGATATAGCAATCAGCCCCAGCATTTT	CASSNRGYSNQPQHF	TRBV6-4	TRBJ1-5
TGCGCCAGCAGCCTCTCGGTCTCGGGGGGGTCCGGGGAGCTGTTTTTT	CASSLSVSGGSGELFF	TRBV4-1	TRBJ2-2
TGCGCCACGTTGCCTAGGACAGGGTTTCCCTCTGGGGCCAACGTCCTGACTTTC	CATLPRTGFPSGANVLTF	TRBV5-1	TRBJ2-6
TGTGCCAGCAGCTTAGGGCCGGGACAGGGTGGGGGCTCCTACGAGCAGTACTTC	CASSLGPGQGGGSYEQYF	TRBV7-2	TRBJ2-7
TGCGCCAGCAGCTTCCCCGGTATGAACACTGAAGCTTTCTTT	CASSFPGMNTEAFF	TRBV5-1	TRBJ1-1
TGTGCCAGCAGCTATCCCCCAGGCAATGAGCAGTTCTTC	CASSYPPGNEQFF	TRBV7-9	TRBJ2-1
TGTGCCAGCAGCATACAGGGTAGCAATCAGCCCCAGCATTTT	CASSIQGSNQPQHF	TRBV9	TRBJ1-5
TGTGCCACCAGTGCGGGGGGCTCCTACGAGCAGTACTTC	CATSAGGSYEQYF	TRBV24-1	TRBJ2-7
TGTGCCAGCAGAGCTCTAGCGGACCATGAGCAGTTCTTC	CASRALADHEQFF	TRBV7-9	TRBJ2-1
TGTGCCAGCAGCTGGGGGGTGAACACTGAAGCTTTCTTT	CASSWGVNTEAFF	TRBV7-3	TRBJ1-1
TGTGCCAGCAGTGCCAACCAGGCCTCCTACGAGCAGTACTTC	CASSANQASYEQYF	TRBV25-1	TRBJ2-7
TGCGCCAGCAGCTTGGGGGCACTCGGTCACGATGGCTACACCTTC	CASSLGALGHDGYTF	TRBV5-1	TRBJ1-2
TGTGCCAGCAGCCCGTCAGGGGGGGATGGCTACACCTTC	CASSPSGGDGYTF	TRBV13	TRBJ1-2
TGTGCCAGCAGTGACCGGCGGATTACTAGCGGGTACAGGTGCTCCTACGAGCAGTACTTC	CASSDRRITSGYRCSYEQYF	TRBV6-4	TRBJ2-7
TGTGCCACCAGGACAGGGGGCAGGGAGACCCAGTACTTC	CATRTGGRETQYF	TRBV24-1	TRBJ2-5
TGTGCCAGTAGTATCGAGAGGAGGACTCAGCCCCAGCATTTT	CASSIERRTQPQHF	TRBV19	TRBJ1-5
TGTGCCAGCAGCTTAGTCTTCCGGGCACACACCGGGGAGCTGTTTTTT	CASSLVFRAHTGELFF	TRBV13	TRBJ2-2
TGTGCCAGCAGCTGGGGCGACGGGCCCACCGGGGAGCTGTTTTTT	CASSWGDGPTGELFF	TRBV11-3	TRBJ2-2
TGTGCTAGTGTCGGGAGGGGGGACTACGAGCAGTACTTC	CASVGRGDYEQYF	TRBV12-5	TRBJ2-7
TGTGCCAGCAGCCTTAAAGGGGGTGAGTACAATGAGCAGTTCTTC	CASSLKGGEYNEQFF	TRBV3-1	TRBJ2-1
TGTGCCAGCAGCTACCACAGGGGGGGGAACACTGAAGCTTTCTTT	CASSYHRGGNTEAFF	TRBV11-3	TRBJ1-1
TGCAGTGCTAGCGGCCCGGTTCAAGATAATCAGCCCCAGCATTTT	CSASGPVQDNQPQHF	TRBV20-1	TRBJ1-5
TGTGCCAGCAGGGGCCAAAGTCCGGGACAGGGGTACAATCAGCCCCAGCATTTT	CASRGQSPGQGYNQPQHF	TRBV6-5	TRBJ1-5
TGTGCCAGTAGTATAGACACAGGGAGGAACACTGAAGCTTTCTTT	CASSIDTGRNTEAFF	TRBV19	TRBJ1-1
TGCGCCAGCAGGGAGGGCGGGGAGGTCAATCAGCCCCAGCATTTT	CASREGGEVNQPQHF	TRBV10-1	TRBJ1-5
TGTGCCAGCAGCACCCCCTCTAGCGAGATCCGTGAGCAGTACTTC	CASSTPSSEIREQYF	TRBV7-4	TRBJ2-7
TGTGCCAGCACTCCGGGACAGGGTCGGAGCAATCAGCCCCAGCATTTT	CASTPGQGRSNQPQHF	TRBV9	TRBJ1-5
TGTGCCAGCAGCTTCCGTTACGGATTAGGGCAGTATTTT	CASSFRYGLGQYF	TRBV7-4	TRBJ2-3
TGTGCCTGGAGTGTAGCAGAAGTAGCGGAAGGGATTCAAGGGACGCAGTATTTT	CAWSVAEVAEGIQGTQYF	TRBV30	TRBJ2-3
TGTGCCAGCAGTGGCCGGGACATCTACGAGCAGTACTTC	CASSGRDIYEQYF	TRBV27	TRBJ2-7
TGCAGTGCTAGAGGGCGGGACAGGGGGCTAATTCTCTACAATGAGCAGTTCTTC	CSARGRDRGLILYNEQFF	TRBV20-1	TRBJ2-1
TGCGCCAGCAGCCAACCGGGACATGGTTTTTTGCCTTGGGAGGTAAGCACTGAAGCTTTCTTT	CASSQPGHGFLPWEVSTEAFF	TRBV4-1	TRBJ1-1
TGTGCCAGCAGCTTAGCTAATCATCCGACAGGGGGCGATCTGACCATTCAGTACTTC	CASSLANHPTGGDLTIQYF	TRBV7-9	TRBJ2-4
TGTGCCACCAGCAGAGCCTTTCCGCTGAGCGACTTGGGGCCGTACGAGCAGTACTTC	CATSRAFPLSDLGPYEQYF	TRBV15	TRBJ2-7
TGTGCCAGCAGCCAAAGAAGGGACCATATAGCAACTAATGAAAAACTGTTTTTT	CASSQRRDHIATNEKLFF	TRBV3-1	TRBJ1-4
TGTGCCAGCACCAGAGGCAGGGCGGGGTACGAGCAGTACTTC	CASTRGRAGYEQYF	TRBV6-4	TRBJ2-7
TGTGCCAGCAATAGACAGGATCAGCCCCAGCATTTT	CASNRQDQPQHF	TRBV28	TRBJ1-5
TGTGCCAGCAGCCTAGGATCCGGGACAGGGCGGGGCTACACCTTC	CASSLGSGTGRGYTF	TRBV4-2	TRBJ1-2
TGTGCCATCACCGCTGTGGGGACAGGCTATGGCTACACCTTC	CAITAVGTGYGYTF	TRBV10-3	TRBJ1-2
TGTGCCGCCCTGACAGCGAATTCACCCCTCCACTTT	CAALTANSPLHF	TRBV19	TRBJ1-6
TGTGCCAGCAGCTCACCTGTCCGGGACAGGGGTCGTGGGGACCGGTATGGCTACACCTTC	CASSSPVRDRGRGDRYGYTF	TRBV7-6	TRBJ1-2
TGTGCCAGCAGTTTACAATACGAGGCGATACATCAGCCCCAGCATTTT	CASSLQYEAIHQPQHF	TRBV12-3	TRBJ1-5
TGTGCGGGATGGGGGGGGATTGAGACCCAGTACTTC	CAGWGGIETQYF	TRBV12-5	TRBJ2-5
TGTGCCTGGAGAGACGAGCAGTACTTC	CAWRDEQYF	TRBV30	TRBJ2-7
TGCGCCAGCAGTGAGGAGGGGACAGGGGGGACGAATTCACCCCTCCACTTT	CASSEEGTGGTNSPLHF	TRBV10-2	TRBJ1-6
TGTGCCAGCAGCCACAGGGGCTACGAGCAGTACTTC	CASSHRGYEQYF	TRBV28	TRBJ2-7
TGTTACTTCGGACTAGCGGTTCCAGAGACCCAGTACTTC	CYFGLAVPETQYF	TRBV19	TRBJ2-5
TGTGCCAGCAGCTTGCGAGACTACCAGCGTGATCGCTCTGGAAACACCATATATTTT	CASSLRDYQRDRSGNTIYF	TRBV5-6	TRBJ1-3
TGTGCCTGGAGTGTAACACCACCGATTGCTGAAGCTTTCTTT	CAWSVTPPIAEAFF	TRBV30	TRBJ1-1
TGTGCCAGCAGCAACAGGGGCTATGGCTACACCTTC	CASSNRGYGYTF	TRBV7-8	TRBJ1-2
TGTGCCAGCTTACTACAGCTCGAACCTATGGGCACAGATACGCAGTATTTT	CASLLQLEPMGTDTQYF	TRBV2	TRBJ2-3
TGTGCCAGCAGCGGAGGGGTCCCCAGGGGGCGTTATCGGAACACTGAAGCTTTCTTT	CASSGGVPRGRYRNTEAFF	TRBV27	TRBJ1-1
TGTGCCAGCAGTTTACCCTCTCCAGATACGCAGTATTTT	CASSLPSPDTQYF	TRBV27	TRBJ2-3
TGTGCCAGCAGCTTAAACTTCCGACAGGCGGGCTACACCTTC	CASSLNFRQAGYTF	TRBV7-6	TRBJ1-2
TGCAGTGCTTACTCAGGGAACACTGAAGCTTTCTTT	CSAYSGNTEAFF	TRBV20-1	TRBJ1-1
TGCGCCAGCAGCTTGGGACCCCGACGAAACTACGAGCAGTACTTC	CASSLGPRRNYEQYF	TRBV5-1	TRBJ2-7
TGCAGTGCGAGTTCCGGGACAGGCGGGGAGGATGGCTACACCTTC	CSASSGTGGEDGYTF	TRBV20-1	TRBJ1-2
TGCAGTGCGGCCGAGGGGGACGAGGTTTACGAGCAGTACTTC	CSAAEGDEVYEQYF	TRBV20-1	TRBJ2-7
TGTGCCAGCAGCTTAGTGCTGTCCCGGGACAGGGGGCCTAGCTCCTATAATTCACCCCTCCACTTT	CASSLVLSRDRGPSSYNSPLHF	TRBV11-2	TRBJ1-6
TGTGCCAGCAGCCACTGGGGAATCCCGCAAGGTGAAAAACTGTTTTTT	CASSHWGIPQGEKLFF	TRBV6-1	TRBJ1-4
TGTGCCTGGAGTGTAGTTACAGGGGATTACGAGCAGTACTTC	CAWSVVTGDYEQYF	TRBV30	TRBJ2-7
TGTGCCAGCAGTGAAGCGCCTTGGGGGCATTCACCCCTCCACTTT	CASSEAPWGHSPLHF	TRBV2	TRBJ1-6
TGTGCCCCCAGGGCGGGTGAAAAACTGTTTTTT	CAPRAGEKLFF	TRBV5-4	TRBJ1-4
TGCAAGACAGCTGGAAACACCATATATTTT	CKTAGNTIYF	TRBV20-1	TRBJ1-3
TGTGCCAGCAGCAAGTTCTTTAGAAATGAAAAACTGTTTTTT	CASSKFFRNEKLFF	TRBV11-3	TRBJ1-4
TGTGCCAGCAGCTTAGGGGGGGAAGCACTTTCGGACAATGAGCAGTTCTTC	CASSLGGEALSDNEQFF	TRBV7-7	TRBJ2-1
TGTGCCAGCTCACCACGCGGCTTAGGAAGGGAGGCAGATACGCAGTATTTT	CASSPRGLGREADTQYF	TRBV18	TRBJ2-3
TGTGCCAGCAGTGAATTACCGAGGGCGGGGGCGGGCTACGAGCAGTACTTC	CASSELPRAGAGYEQYF	TRBV2	TRBJ2-7
TGTGCCAGGTACTTCTATCCGAACACCGGGGAGCTGTTTTTT	CARYFYPNTGELFF	TRBV11-3	TRBJ2-2
TGTGCCAGCAGCCGTCAGGAGGGGACGGGTACCGGGGAGCTGTTTTTT	CASSRQEGTGTGELFF	TRBV14	TRBJ2-2
TGCAGCAAGTCGTCATTAGGCTACGAGCAGTACTTC	CSKSSLGYEQYF	TRBV29-1	TRBJ2-7
TGCGCCAGCAGCCAAGAATCGGTAGAGGGATTCGCCGGGGAGCTGTTTTTT	CASSQESVEGFAGELFF	TRBV4-3	TRBJ2-2
TGTGCCAGCAGCTTAGCCTGGGTGGGGACGTGTTATGGTCACGAGCAGTACTTC	CASSLAWVGTCYGHEQYF	TRBV7-8	TRBJ2-7
TGTGCCAGCAGGGCAAGTTACGGAGGAGCTTTCTTT	CASRASYGGAFF	TRBV6-4	TRBJ1-1
TGTGCCAGCAGTGAATTGCGGACAGGGAAAGAGTATGGCTACACCTTC	CASSELRTGKEYGYTF	TRBV25-1	TRBJ1-2
TGTGCCATCACGGGAAGCGGGGGGAGGTGGTACTTC	CAITGSGGRWYF	TRBV10-3	TRBJ2-7
TGTGCCAGCAGTTTCGGGATTGAGGAGAACACCGGGGAGCTGTTTTTT	CASSFGIEENTGELFF	TRBV2	TRBJ2-2
TGTGCCAGCAGTGAGACGACAGGGGCTGGGAAGCCTAACTATGGCTACACCTTC	CASSETTGAGKPNYGYTF	TRBV6-6	TRBJ1-2
TGTGCCAGCGCCCCGGGACTAAGGGCTTTCTTT	CASAPGLRAFF	TRBV6-1	TRBJ1-1
TGTGCCAGCAGCAGGAGAAATTACAATCAGCCCCAGCATTTT	CASSRRNYNQPQHF	TRBV28	TRBJ1-5
TGTGCCACACCGACTAGCGGTTTTGCCTCCTACGAGCAGTACTTC	CATPTSGFASYEQYF	TRBV15	TRBJ2-7
TGTGCCACCCCGCAGGGACATGGGTACGCTAATGAAAAACTGTTTTTT	CATPQGHGYANEKLFF	TRBV6-1	TRBJ1-4
TGTGCCAGCAGTGAAGCGCACTGGGGGGCAGATACGCAGTATTTT	CASSEAHWGADTQYF	TRBV6-1	TRBJ2-3
TGTGCCAGCAGCTTAGGCGACAGGGGGACAAGCAATCAGCCCCAGCATTTT	CASSLGDRGTSNQPQHF	TRBV7-3	TRBJ1-5
TGCGCCAGCAAACTAACTTTTTACGAGCAGTACTTC	CASKLTFYEQYF	TRBV10-1	TRBJ2-7
TGTGCCAGCAGTTTTCGCAGACAGGGGCCCTACGAGCAGTACTTC	CASSFRRQGPYEQYF	TRBV27	TRBJ2-7
TGTGCCAGCATCGCGGAGCACTACGAGCAGTACTTC	CASIAEHYEQYF	TRBV6-1	TRBJ2-7
TGTGCCAGCAGCATGGGGGGGGCTCAGCCCCAGCATTTT	CASSMGGAQPQHF	TRBV7-2	TRBJ1-5
TGTGCCAGCTCACCAAAGACAGGGGGGAAGCAGCCCCAGCATTTT	CASSPKTGGKQPQHF	TRBV18	TRBJ1-5
TGTGCCAGCAGTTACTGGCGGTTTGATACGCAGTATTTT	CASSYWRFDTQYF	TRBV6-2	TRBJ2-3
TGCGCCAGCATTCTTTACAATGAGCAGTTCTTC	CASILYNEQFF	TRBV5-1	TRBJ2-1
TGCACGCTGGTCGAGCAGTTCTTC	CTLVEQFF	TRBV20-1	TRBJ2-1
TGTGCCAGCAGTGACCAGGGACAGGGCTGCGGTGAAGCTTTCTTT	CASSDQGQGCGEAFF	TRBV25-1	TRBJ1-1
TGTGCCAGCAGTCGAGAGGCCTTATACAATGAGCAGTTCTTC	CASSREALYNEQFF	TRBV6-6	TRBJ2-1
TGCAGTGCTGAGGGGGGGACCCAGTACTTC	CSAEGGTQYF	TRBV20-1	TRBJ2-5
TGTGCTAGTGGTTCCTCCGTAGGGGAGTTCGAGCATCAGCCCCAGCATTTT	CASGSSVGEFEHQPQHF	TRBV12-5	TRBJ1-5
TGTGCCAGTAGACCGGGGGCCACAGATACGCAGTATTTT	CASRPGATDTQYF	TRBV19	TRBJ2-3
TGCAGTGCTAGATCTAGCGGGACCGGGGAGCTGTTTTTT	CSARSSGTGELFF	TRBV20-1	TRBJ2-2
TGCGCCAGCAGTGAGCGGCGGGAGCCCTACAATGAGCAGTTCTTC	CASSERREPYNEQFF	TRBV10-1	TRBJ2-1
TGTGCCAGCAGCTTACCTGCGGGACAGGGAACTGAAGCTTTCTTT	CASSLPAGQGTEAFF	TRBV7-3	TRBJ1-1
TGTGCCAGCAGCAGGGGACAGGGTGACTATGGCTACACCTTC	CASSRGQGDYGYTF	TRBV7-3	TRBJ1-2
TGTGCCAGCAGTTTAATCCCCCCCGGGACCTCCTACGAGCAGTACTTC	CASSLIPPGTSYEQYF	TRBV12-3	TRBJ2-7
TGTGCCAGCAGCCAAGTTAGCGGGAAGGATGGCACCGGGGAGCTGTTTTTT	CASSQVSGKDGTGELFF	TRBV3-1	TRBJ2-2
TGTGCCAGCAGTTCTGATGATTACAGAAACAGGGTTCCCATTAATCAGCCCCAGCATTTT	CASSSDDYRNRVPINQPQHF	TRBV6-3	TRBJ1-5
TGTGCCTGGGACAGTGAAAAACTGTTTTTT	CAWDSEKLFF	TRBV30	TRBJ1-4
TGTGCCAGCAGACGCAAGCCGAAGGGGACTAGGGATTACAATGAGCAGTTCTTC	CASRRKPKGTRDYNEQFF	TRBV2	TRBJ2-1
TGTGCCAGCAGCCTCAGGGACTATGGCTACACCTTC	CASSLRDYGYTF	TRBV5-6	TRBJ1-2
TGTGCCAGCAGTGATGAAAAGACAGCCGACAGGGGAAGCAGAGAGACCCAGTACTTC	CASSDEKTADRGSRETQYF	TRBV25-1	TRBJ2-5
TGTGCCAGCAGCACCTTCTGCCAGATATCAGGGTTCGAGCAGTACTTC	CASSTFCQISGFEQYF	TRBV7-4	TRBJ2-7
TGTGCCAGCAGCTTCAGACCGGGAAAGTATCGCTACGAGCAGTACTTC	CASSFRPGKYRYEQYF	TRBV7-9	TRBJ2-7
TGCGCCAGCAGTGAGTCTACTAGCGGCGAAAATCCTGAGCAAGAGACCCAGTACTTC	CASSESTSGENPEQETQYF	TRBV10-1	TRBJ2-5
TGCGCCAGCAGCTTGTTACAGGGGTGGAACACTGAAGCTTTCTTT	CASSLLQGWNTEAFF	TRBV5-1	TRBJ1-1
TGTGCCAGCAGCAGGAGAGAGGGGTACGAGCAGTACTTC	CASSRREGYEQYF	TRBV13	TRBJ2-7
TGTGCCAGCAGTTTTACGGCCTGGACAAGATCCCCTCAGCCCCAGCATTTT	CASSFTAWTRSPQPQHF	TRBV27	TRBJ1-5
TGTGCCAGTAGTATACGACAGGGCGATCATCAGCCCCAGCATTTT	CASSIRQGDHQPQHF	TRBV19	TRBJ1-5
TGTGCTAGTGACGGGGACAAACCCTCCTACGAGCAGTACTTC	CASDGDKPSYEQYF	TRBV12-5	TRBJ2-7
TGCGCCAGCCATTTCTCCTACGAGCAGTACTTC	CASHFSYEQYF	TRBV10-1	TRBJ2-7
TGTGCCAGCAGCCAAGAGCATCATAACAGGGGGGTCTACGAGCAGTACTTC	CASSQEHHNRGVYEQYF	TRBV14	TRBJ2-7
TGCGCCAGCAGTGAGTCCGTGCACTACCGACAGGGTGGAGGTAGCTACGAGCAGTACTTC	CASSESVHYRQGGGSYEQYF	TRBV10-1	TRBJ2-7
TGTGCCACCAGCAGAGATGACGGGATGGTGAACACCGGGGAGCTGTTTTTT	CATSRDDGMVNTGELFF	TRBV15	TRBJ2-2
TGTGCCAGCAGCCATGCCTTAAGGGGGCTAAGCACAGATACGCAGTATTTT	CASSHALRGLSTDTQYF	TRBV3-1	TRBJ2-3
TGCGCCAGCAGCCGACTCGAGCAGTACTTC	CASSRLEQYF	TRBV5-1	TRBJ2-7
TGTGCCAGCAGCCCGAGTTCAATTGGGGGCGCCGGGGAGCTGTTTTTT	CASSPSSIGGAGELFF	TRBV7-3	TRBJ2-2
TGTGCCAGCAGCTCCGGGACGCAGTGTGAGCAGTTCTTC	CASSSGTQCEQFF	TRBV7-2	TRBJ2-1
TGTGCCAGCAGCGAAATTAAAGGCTACGAGCAGTACTTC	CASSEIKGYEQYF	TRBV7-2	TRBJ2-7
TGTGCCAGCATTGAGTCCCCGGGCTTTTCCTATGGCTACACCTTC	CASIESPGFSYGYTF	TRBV27	TRBJ1-2
TGCGCCAGCAGTGAGAGGGGGGGCGAGGTGGCAGATACGCAGTATTTT	CASSERGGEVADTQYF	TRBV10-1	TRBJ2-3
TGTGCCAGCAGCTTATACAGGACTCCTAATGAAAAACTGTTTTTT	CASSLYRTPNEKLFF	TRBV7-9	TRBJ1-4
TGTGCCAGCAGCTTTCTGCGGGAGGCGGGAACCTACAATGAGCAGTTCTTC	CASSFLREAGTYNEQFF	TRBV11-1	TRBJ2-1
TGTGCCAGCAGCTTTTCGGGATCAGGGGAGACTGAAGCTTTCTTT	CASSFSGSGETEAFF	TRBV9	TRBJ1-1
TGCGCCAGCAGTATGAAGGGGAACGGAAGCAATCAGCCCCAGCATTTT	CASSMKGNGSNQPQHF	TRBV10-1	TRBJ1-5
TGTGCCAGCAGCGGGAGAGAGACAGGGCTGACTGAAGCTTTCTTT	CASSGRETGLTEAFF	TRBV9	TRBJ1-1
TGCGCCAGCAGGAGACTAGCCGAAGAGACCCAGTACTTC	CASRRLAEETQYF	TRBV10-1	TRBJ2-5
TGTGCCAGCAGTCGGTTGGCTAGCGGGGGAAGGACCGGGGAGCTGTTTTTT	CASSRLASGGRTGELFF	TRBV12-3	TRBJ2-2
TGTGCCAGCAGTGACCGGTCCGGTATTAACTGGACAGGGGGAGGGGAAGGCCTCTCAGATACGCAGTATTTT	CASSDRSGINWTGGGEGLSDTQYF	TRBV6-1	TRBJ2-3
TGTGCCAGCAGTTACAATAAGGACAGGGGAGATGGAACCTATGGCTACACCTTC	CASSYNKDRGDGTYGYTF	TRBV6-2	TRBJ1-2
TGTGCCAGCAGCGGGCAAGCCACGACAGGAAACTATGGCTACACCTTC	CASSGQATTGNYGYTF	TRBV7-3	TRBJ1-2
TGTGCCAGCAGCTTACACCACCGGGGTAGCAATCAGCCCCAGCATTTT	CASSLHHRGSNQPQHF	TRBV11-3	TRBJ1-5
TGTGCCAGCAGTTCTTTTGACCCCACCGGGCCCTCCTACGAGCAGTACTTC	CASSSFDPTGPSYEQYF	TRBV12-3	TRBJ2-7
TGCGCCAGCAGCTTGGTGTCGGGACAGGGCTATGGCTACACCTTC	CASSLVSGQGYGYTF	TRBV5-1	TRBJ1-2
TGTGCCAGAGGGGACAGGAGCAGCAATCAGCCCCAGCATTTT	CARGDRSSNQPQHF	TRBV6-5	TRBJ1-5
TGTGCCTGGAGTGTACGGACAGGGGACAACTATGGCTACACCTTC	CAWSVRTGDNYGYTF	TRBV30	TRBJ1-2
TGCGCCAGCCCCCTTGACAGGGTTTACTACGAGCAGTACTTC	CASPLDRVYYEQYF	TRBV10-2	TRBJ2-7
TGTGCCAGCAGCTGCGGCCCTAGCGGTGGGAGGCAAGAGACCCAGTACTTC	CASSCGPSGGRQETQYF	TRBV5-4	TRBJ2-5
TGTGCCAGCAGTGTTTCTAGCGGGCTCCAAGAGACCCAGTACTTC	CASSVSSGLQETQYF	TRBV2	TRBJ2-5
TGTGCCAGTAGTGAAGCCCCCCGGGGGACCAATTCACCCCTCCACTTT	CASSEAPRGTNSPLHF	TRBV19	TRBJ1-6
TGTGCCAGTAGTATTTCCAGTGGACTAGCGGCCTACAATGAGCAGTTCTTC	CASSISSGLAAYNEQFF	TRBV19	TRBJ2-1
TGTGCCACCAGTGGACGATCGCCTAAAGCGGGGGAGCAAGAGACCCAGTACTTC	CATSGRSPKAGEQETQYF	TRBV24-1	TRBJ2-5
TGTGCCAGCAGCTGTGAAGACCAGCGGGAATCCGGTGTTTACGAGCAGTACTTC	CASSCEDQRESGVYEQYF	TRBV7-3	TRBJ2-7
TGTGCCTGGAGTGTAGGCCGGTACAATGAGCAGTTCTTC	CAWSVGRYNEQFF	TRBV30	TRBJ2-1
TGTGCCAGCAGCCCCTGGGCGACAGGGCTATGGTACGAGCAGTACTTC	CASSPWATGLWYEQYF	TRBV13	TRBJ2-7
TGTGCCAGCAGCTTAGCCCGGGACAGGGGGCATGGGGGATTCTACGAGCAGTACTTC	CASSLARDRGHGGFYEQYF	TRBV11-3	TRBJ2-7
TGTGCCACCAGTGATTTGACTAGCGGGGCAAGTTATGAGCAGTTCTTC	CATSDLTSGASYEQFF	TRBV24-1	TRBJ2-1
TGCGCCAGCAGCCAAGCCAAGGACAGGGCGCCTTATGGCTACACCTTC	CASSQAKDRAPYGYTF	TRBV4-1	TRBJ1-2
TGCAGTGCTAGAGATAAAGAGTTGAATTCACCCCTCCACTTT	CSARDKELNSPLHF	TRBV20-1	TRBJ1-6
TGTGCCACCAGCAGAATAGACTTCGCGGCCTACAATGAGCAGTTCTTC	CATSRIDFAAYNEQFF	TRBV15	TRBJ2-1
TGCGCCAGCAGCTCGCGAACTGAGAAATTAGGGGCAGATACGCAGTATTTT	CASSSRTEKLGADTQYF	TRBV5-1	TRBJ2-3
TGCGCCAGCAGCTTCTTGACAGGGGTAGACGATAACTATGGCTACACCTTC	CASSFLTGVDDNYGYTF	TRBV5-1	TRBJ1-2
TGCGCCAGCAGCCACCGCCCTTCGTGCCTACCCCTAGCGGGACAGTACTTC	CASSHRPSCLPLAGQYF	TRBV4-1	TRBJ2-5
TGTGCCAGCAGTGACTGGGGGGGACCTGGGTCTGAAGCTTTCTTT	CASSDWGGPGSEAFF	TRBV2	TRBJ1-1
TGCGCCAGCAGCTCCGCGGGACTTATCACAGATACGCAGTATTTT	CASSSAGLITDTQYF	TRBV5-1	TRBJ2-3
TGTGCCACGAAGACAGGGGAAGACACCGGGGAGCTGTTTTTT	CATKTGEDTGELFF	TRBV24-1	TRBJ2-2
TGTGCCAGCATGGGGGTAGTGGAGACCCAGTACTTC	CASMGVVETQYF	TRBV25-1	TRBJ2-5
TGTGCCACCAGCCGGCTCCCCGGGACAGGGGCTGGCTCCTACGAGCAGTACTTC	CATSRLPGTGAGSYEQYF	TRBV15	TRBJ2-7
TGCAGCGTAGGGAGGAACCCTCCGGGGGGGCCTCCGCATGAGCAGTTCTTC	CSVGRNPPGGPPHEQFF	TRBV29-1	TRBJ2-1
TGTGCCACCAATAAGGGGGGGGTTGTACACGGGGAGCTGTTTTTT	CATNKGGVVHGELFF	TRBV24-1	TRBJ2-2
TGTCGTCGCGACAAACTGGGGAATCAGCCCCAGCATTTT	CRRDKLGNQPQHF	TRBV11-2	TRBJ1-5
TGTGCCAGCAGTTTATCCTGCCTAGCGGGAGGCTACAATGAGCAGTTCTTC	CASSLSCLAGGYNEQFF	TRBV28	TRBJ2-1
TGTGCCAGCAGTGAAGCGACACTAGCGGGAGGAGATTCACCCCTCCACTTT	CASSEATLAGGDSPLHF	TRBV6-1	TRBJ1-6
TGTGCCAGCAGGGCGGGACAGGGGGTCGAAAAACTGTTTTTT	CASRAGQGVEKLFF	TRBV6-6	TRBJ1-4
TGTGCCTGGAGGCGACAGGGACACCAGCCCCAGCATTTT	CAWRRQGHQPQHF	TRBV30	TRBJ1-5
TGTGCCAGCAGCGCACGGGTACTAGCGGGAGCGTACACAGATACGCAGTATTTT	CASSARVLAGAYTDTQYF	TRBV5-4	TRBJ2-3
TGTGCCTGGAGTGTGGCTTCCGGGACTAGCGGGGCTGCGGAGCAGTTCTTC	CAWSVASGTSGAAEQFF	TRBV30	TRBJ2-1
TGTGCCAGCAGCCAAGATAAAAAAGCGTACCAAACCGGGACAGCGACCTCCTACGAGCAGTACTTC	CASSQDKKAYQTGTATSYEQYF	TRBV3-1	TRBJ2-7
TGTGCCAGCAGTTTAGTCTCCGGGCGTGATCCCCATCAGCCCCAGCATTTT	CASSLVSGRDPHQPQHF	TRBV12-4	TRBJ1-5
TGTGCCAGCAGAGGCAGTTTAAAGCGGAATCCCCATACGCAGTATTTT	CASRGSLKRNPHTQYF	TRBV9	TRBJ2-3
TGTGCCAGCAGTTTAAGAATAGGTCGCGGGAGGACGGACGAGAGCTTTCCCAAAAACATTCAGTACTTC	CASSLRIGRGRTDESFPKNIQYF	TRBV27	TRBJ2-4
TGCAGTGCTATTCCCGGGACGTTGGTGGAGGGCTACGAGCAGTACTTC	CSAIPGTLVEGYEQYF	TRBV20-1	TRBJ2-7
TGTGACCCGGGCCGCTACACCTTC	CDPGRYTF	TRBV28	TRBJ1-2
TGTGCCCGTTGCGCTAGCGGGAGGAATGGTGACACCGGGGAGCTGTTTTTT	CARCASGRNGDTGELFF	TRBV27	TRBJ2-2
TGTGCCAGCAGTGACTCGAGGGCGGGTAGCGGCACAGATACGCAGTATTTT	CASSDSRAGSGTDTQYF	TRBV6-4	TRBJ2-3
TGTGCCAGCAGGACTACATTCTTGTATTTT	CASRTTFLYF	TRBV9	TRBJ2-3
TGTGCCATCAGTCAGAAGAATCAGGGCATGAACACAGATACGCAGTATTTT	CAISQKNQGMNTDTQYF	TRBV10-3	TRBJ2-3
TGTGCCAGCAGCCCCCGGGGGGCGGGAGGGCCCTACAATGAGCAGTTCTTC	CASSPRGAGGPYNEQFF	TRBV5-4	TRBJ2-1
TGTGCCAGCAGGGTCTGGGCAACCTACGAGCAGTACTTC	CASRVWATYEQYF	TRBV11-2	TRBJ2-7
TGTGCCAGCAGCAACCGCACCCTCCAGACAAGAGGCTCCTACGAGCAGTACTTC	CASSNRTLQTRGSYEQYF	TRBV7-3	TRBJ2-7
TGTGCCAGCAGTTGGTCGGGAGGAGACTTC	CASSWSGGDF	TRBV28	TRBJ2-7
TGTGCCAGCTCACTGAGACATCTTAACTACGAGCAGTACTTC	CASSLRHLNYEQYF	TRBV18	TRBJ2-7
TGCGCCAGCAAGCGGGATGAAAGCAATCAGCCCCAGCATTTT	CASKRDESNQPQHF	TRBV5-1	TRBJ1-5
TGTGCCACCAAGGGGAGCAATCAGCCCCAGCATTTT	CATKGSNQPQHF	TRBV10-3	TRBJ1-5
TGTGCCAGCAGCGTAGCCAGGGGGAGGACTAGCTCCTACAATGAGCAGTTCTTC	CASSVARGRTSSYNEQFF	TRBV9	TRBJ2-1
TGTGCCAGCAGGAGGTTCAAGGCCAATCAGCCCCAGCATTTT	CASRRFKANQPQHF	TRBV6-6	TRBJ1-5
TGTGCCAGCAGCCAAGAGGGGGCTTTTGGTAGTTCCTACGAGCAGTACTTC	CASSQEGAFGSSYEQYF	TRBV3-1	TRBJ2-7
TGCAGCGGGTGGGTACAGGGGAAAAGCCAGCCCCAGCATTTT	CSGWVQGKSQPQHF	TRBV29-1	TRBJ1-5
TGCGCCAGCAGTGAGGGGTCCAGGTCCGGGACATATAACTTTGAAAAACTGTTTTTT	CASSEGSRSGTYNFEKLFF	TRBV10-1	TRBJ1-4
TGTGCCAGCAGCCACCTCGACAGGGGGCGGAACACTGAAGCTTTCTTT	CASSHLDRGRNTEAFF	TRBV13	TRBJ1-1
TGTGCCTGGACCAACCCCACAGGTTTCTACACTGAAGCTTTCTTT	CAWTNPTGFYTEAFF	TRBV30	TRBJ1-1
TGCAGTGGACCCCGGCAGTCTCTCGGGGAGCTGTTTTTT	CSGPRQSLGELFF	TRBV20-1	TRBJ2-2
TGTGCCAGCAGTGGACGCCGACGTAATTACTACGAGCAGTACTTC	CASSGRRRNYYEQYF	TRBV2	TRBJ2-7
TGCGCCAGCCCAAAGCACAGGGGGCGTCCTTTCTCCTACGAGCAGTACTTC	CASPKHRGRPFSYEQYF	TRBV5-1	TRBJ2-7
TGCGCCAGCAGCTTCACCGGGGGTCCCGCAACTGAAGCTTTCTTT	CASSFTGGPATEAFF	TRBV5-1	TRBJ1-1
TGTGCCAGCAGCTTAGAGGGGTCCCAGGGGGCGTATAGCAATCAGCCCCAGCATTTT	CASSLEGSQGAYSNQPQHF	TRBV7-4	TRBJ1-5
TGTGCCAGCAGTTACGGGGTGGAAGGCACAGATACGCAGTATTTT	CASSYGVEGTDTQYF	TRBV6-5	TRBJ2-3
TGTGCCAGCAGCCCCGAACGACTAGCGGCAGGCGGGATTTACAATGAGCAGTTCTTC	CASSPERLAAGGIYNEQFF	TRBV3-1	TRBJ2-1
TGTGCCAGCAGACAGGGGATACGCTCCTACAATGAGCAGTTCTTC	CASRQGIRSYNEQFF	TRBV6-5	TRBJ2-1
TGTGCCAGCAGGACTGATTACGAGCAGTACTTC	CASRTDYEQYF	TRBV9	TRBJ2-7
TGTGCCAGCAGCACAGTCAGGGTCTATAGCAATCAGCCCCAGCATTTT	CASSTVRVYSNQPQHF	TRBV7-3	TRBJ1-5
TGTGCCAGTAGTATAGGTGGACAGGGCGACAGCTCTGGAAACACCATATATTTT	CASSIGGQGDSSGNTIYF	TRBV19	TRBJ1-3
TGTGCCAGCAGTGTAGCGGGCCGGCAGTACTTC	CASSVAGRQYF	TRBV25-1	TRBJ2-7
TGTGCCAGTCGGACGGGGAGTCGGAGGACTGAAGCTTTCTTT	CASRTGSRRTEAFF	TRBV28	TRBJ1-1
TGTGCCAGCGAGAACGTCGAGCAGTACTTC	CASENVEQYF	TRBV6-2	TRBJ2-7
TGTGCCTGGAGGGGACAGGGGGAAGCCTACGAGCAGTACTTC	CAWRGQGEAYEQYF	TRBV30	TRBJ2-7
TGTGCCAGCAGCCAGGGACTAGCGGGCGAATTCTACGAGCAGTACTTC	CASSQGLAGEFYEQYF	TRBV3-1	TRBJ2-7
TGCGCCAGCAGCGAGTCTCTCGGGGAGCTGTTTTTT	CASSESLGELFF	TRBV5-1	TRBJ2-2
TGTGCCTACGGATATTGCACCGGGGAGCTGTTTTTT	CAYGYCTGELFF	TRBV6-4	TRBJ2-2
TGTGCCACCAGTGAAAGACCAGGGTACCCCTACGAGCAGTACTTC	CATSERPGYPYEQYF	TRBV24-1	TRBJ2-7
TGCGCCAGCAGTGACCCATGGACAGGGTTAACCCGAGAAGCTTTCTTT	CASSDPWTGLTREAFF	TRBV10-1	TRBJ1-1
TGTGCCAGCAGCTGGGCCCGGACTAGCGGGGTGCGCAATGAGCAGTTCTTC	CASSWARTSGVRNEQFF	TRBV7-3	TRBJ2-1
TGTGCCACCAGTCCCAGGGTCCACCAGCCCCAGCATTTT	CATSPRVHQPQHF	TRBV24-1	TRBJ1-5
TGTGCCAGCAGCTCTCGGGGGCGGGGGGACGACAATGAGCAGTTCTTC	CASSSRGRGDDNEQFF	TRBV7-7	TRBJ2-1
TGTGCCAGCAGTTTAGCGGGAGCGGATGGGAGGGCCTACAATGAGCAGTTCTTC	CASSLAGADGRAYNEQFF	TRBV12-3	TRBJ2-1
TGTGCCAGCAGTGTTTCCGGGGGGGGTGAACATACGCAGTATTTT	CASSVSGGGEHTQYF	TRBV6-1	TRBJ2-3
TGCAGTGCTAGAGGGGGGTGCTTGAACACCGGGGAGCTGTTTTTT	CSARGGCLNTGELFF	TRBV20-1	TRBJ2-2
TGTGCCAGTACCCAAACCGGGACTAGCGGGCAGTTCTTC	CASTQTGTSGQFF	TRBV19	TRBJ2-1
TGTGCCAAAGCGGTCCAGTTCAATGAGCAGTTCTTC	CAKAVQFNEQFF	TRBV7-8	TRBJ2-1
TGCAGTGCAGGGGCGGGACAGGGGTACTACGAGCAGTACTTC	CSAGAGQGYYEQYF	TRBV20-1	TRBJ2-7
TGTGCCAGCAGCCAAGAGGGGGATGAGCAGTTCTTC	CASSQEGDEQFF	TRBV3-1	TRBJ2-1
TGCGCCAGCAGATTAGCGTACTACGAGCAGTACTTC	CASRLAYYEQYF	TRBV10-1	TRBJ2-7
TGTGCCTCCTCCGGACAGGGGGGGAGAAGGAAGCGGCAAGAGACCCAGTACTTC	CASSGQGGRRKRQETQYF	TRBV2	TRBJ2-5
TGTGCCAGCAGTCTCCATACCTACGAGCAGTACTTC	CASSLHTYEQYF	TRBV11-3	TRBJ2-7
TGTGCCAGCAGCTTAGACTGCGGGAGCAATGAGCAGTTCTTC	CASSLDCGSNEQFF	TRBV7-4	TRBJ2-1
TGCAGTGCTAGTTCGACCTACCACCAGAATCAGCCCCAGCATTTT	CSASSTYHQNQPQHF	TRBV20-1	TRBJ1-5
TGCGCCAGCAGCTTGGCCCAAGGGTCCCTTGAGACCCAGTACTTC	CASSLAQGSLETQYF	TRBV5-1	TRBJ2-5
TGTGCCAGCAGCCAAGAAGTCCAAACCCGGGACCTAGAGACCCAGTACTTC	CASSQEVQTRDLETQYF	TRBV3-1	TRBJ2-5
TGTGCCACCAGGGACAAGACCTACGAGCAGTACTTC	CATRDKTYEQYF	TRBV24-1	TRBJ2-7
TGTGCCAGCAGCTCGCAATTAGCGGCCTCCTCTGAGCAGTTCTTC	CASSSQLAASSEQFF	TRBV9	TRBJ2-1
TGTGCCAGCAGCATGGGGGGGGCCCCCTCCTACGAGCAGTACTTC	CASSMGGAPSYEQYF	TRBV7-9	TRBJ2-7
TGTGCCAGCAGCTTGGAGAACCGCCCTAGGGACAGGGGGGATAATCAGCCCCAGCATTTT	CASSLENRPRDRGDNQPQHF	TRBV5-4	TRBJ1-5
TGTGCCAGTAGTGTCCGCGGGAGCGGGACCGGGGAGCTGTTTTTT	CASSVRGSGTGELFF	TRBV19	TRBJ2-2
TGTGCCAGCAGCCAGGATCAGCCCCAGCATTTT	CASSQDQPQHF	TRBV25-1	TRBJ1-5
TGTGCCAGCAGTTTATGGGGCAATAGCAATCAGCCCCAGCATTTT	CASSLWGNSNQPQHF	TRBV25-1	TRBJ1-5
TGTGCCAGCAGGGGCGGGAGATACGAGCAGTACTTC	CASRGGRYEQYF	TRBV6-2	TRBJ2-7
TGTGCCACCGGTCAGAATCTTGAAGCTTTCTTT	CATGQNLEAFF	TRBV24-1	TRBJ1-1
TGTGCCAGCAGCAGGTTTATAGCGAAAGATGGAGGGGTCTCCTACGAGCAGTACTTC	CASSRFIAKDGGVSYEQYF	TRBV7-9	TRBJ2-7
TGCGCCAGCAGCCAAGCGCGGGACAGTATGGACGACACTGAAGCTTTCTTT	CASSQARDSMDDTEAFF	TRBV4-1	TRBJ1-1
TGTGCCAGCAGTCCGACCCCCCAGGGATTTCCTAATTCACCCCTCCACTTT	CASSPTPQGFPNSPLHF	TRBV6-5	TRBJ1-6
TGTGCCATCAGCGGGTCCTACAATGAGCAGTTCTTC	CAISGSYNEQFF	TRBV10-3	TRBJ2-1
TGTGCCAGCAGCCAAGTCTCAGCGGGAGTGATCAGCTCCTACAATGAGCAGTTCTTC	CASSQVSAGVISSYNEQFF	TRBV4-2	TRBJ2-1
TGTGCCAGCCCCACAAAGACAGGACTCGCGAACACCGGGGAGCTGTTTTTT	CASPTKTGLANTGELFF	TRBV25-1	TRBJ2-2
TGTGCCAGCAGCCACGTGCAAAAGGGACATAGTGGCATTCAGTACTTC	CASSHVQKGHSGIQYF	TRBV4-2	TRBJ2-4
TGTGCCAGCAGCGTATGCGAAAGCGGGACGCCAGATACGCAGTATTTT	CASSVCESGTPDTQYF	TRBV9	TRBJ2-3
TGTGCCATCAGGTATAGCGGGGTAAGCACTCGCACAGATACGCAGTATTTT	CAIRYSGVSTRTDTQYF	TRBV10-3	TRBJ2-3
TGTGCCAGCAGTAGGACTAGCACAGAGCAGTACTTC	CASSRTSTEQYF	TRBV6-3	TRBJ2-7
TGTGCCAGCAGTGAGGTCCGACTAGCGGGGTACAATGAGCAGTTCTTC	CASSEVRLAGYNEQFF	TRBV6-1	TRBJ2-1
TGTGCCAGCAGTTTACCTAGGTGGACGAATTCACCCCTCCACTTT	CASSLPRWTNSPLHF	TRBV28	TRBJ1-6
TGTGCCAGCAGTTTATTCAAGGGGAGCGAAACAGATACGCAGTATTTT	CASSLFKGSETDTQYF	TRBV12-3	TRBJ2-3
TGCGCCAGCAGCGAGGGGGCCTATGGCTACACCTTC	CASSEGAYGYTF	TRBV5-1	TRBJ1-2
TGCGCCAGCAGCCCGCCTAGGAGGTCAGGTAATTCACCCCTCCACTTT	CASSPPRRSGNSPLHF	TRBV4-1	TRBJ1-6
TGTGCCAGCTGGGGCCCGCGCGGCAGGGAGTACTTC	CASWGPRGREYF	TRBV27	TRBJ2-5
TGTGCCAGCAGTTCCGAAGGGGCCGCTCCGGTTTTGCCTGGAAACACCATATATTTT	CASSSEGAAPVLPGNTIYF	TRBV2	TRBJ1-3
TGTGCCAGCAGCGGAGGATCTAGGATGAACACTGAAGCTTTCTTT	CASSGGSRMNTEAFF	TRBV7-9	TRBJ1-1
TGTGCCAGCAGCCATGTGGAAAGGACAGGGGGCAAAGAGACCCAGTACTTC	CASSHVERTGGKETQYF	TRBV5-5	TRBJ2-5
TGTGCCAGCAGCTTAGAGGTTGGGGGGCGAACAGAGACCCAGTACTTC	CASSLEVGGRTETQYF	TRBV11-3	TRBJ2-5
TGTGCCAAAATCTCGGTAGGGAGCGGGGAGCTGTTTTTT	CAKISVGSGELFF	TRBV27	TRBJ2-2
TGTGCCAGCAGTTACTCGAGGTGTCAACGAACTAGCAGGAGGGGGTACTTC	CASSYSRCQRTSRRGYF	TRBV6-6	TRBJ2-7
TGTGCCAGCAGCCACACTAGCGGGAGCGTAGACAGGGGGAGGACCGCAACTAATGAAAAACTGTTTTTT	CASSHTSGSVDRGRTATNEKLFF	TRBV27	TRBJ1-4
TGTGCCAGCATTTCCTTCGGGCTCTACGAGCAGTACTTC	CASISFGLYEQYF	TRBV5-5	TRBJ2-7
TGTGCCAGCAGTTTTCCCGCAGAAATGGACTATGGCTACACCTTC	CASSFPAEMDYGYTF	TRBV27	TRBJ1-2
TGTGCCAGCTCACCACCGCCACGGGGGGCTAATCCATACGAGCAGTACTTC	CASSPPPRGANPYEQYF	TRBV18	TRBJ2-7
TGTGCCACCAGTTTCTCTGGGATCACAGATACGCAGTATTTT	CATSFSGITDTQYF	TRBV24-1	TRBJ2-3
TGCAGTGCTAGCAAAAGGGGACAGTGCTACGAGCAGTACTTC	CSASKRGQCYEQYF	TRBV20-1	TRBJ2-7
