TGTGCCAGCAGCTATTTAGTTGGACAGGGGTCCAGCAATCAGCCCCAGCATTTT	CASSYLVGQGSSNQPQHF	TRBV7-9	TRBJ1-5
TGTGCCTGGAGTGTAGGTGGGGGAGGCTTATCCGGGGAGCTGTTTTTT	CAWSVGGGGLSGELFF	TRBV30	TRBJ2-2
TGTGCCAGCGAGGTTCGGGCAGGCTCCTACGAGCAGTACTTC	CASEVRAGSYEQYF	TRBV28	TRBJ2-7
TGTGCCACCAGCAGACCTCCTCAACAACAGGGGGCTATTCGGGAGACCCAGTACTTC	CATSRPPQQQGAIRETQYF	TRBV15	TRBJ2-5
TGTGCCAGCAGCGTAGTTGGGACAGGGCCTTACGAGCAGTACTTC	CASSVVGTGPYEQYF	TRBV9	TRBJ2-7
TGTGCCAGCAGCACCCCAGGGGAAAGTAGCAATCAGCCCCAGCATTTT	CASSTPGESSNQPQHF	TRBV7-3	TRBJ1-5
TGTGCCAGCAGCCAAGCAGGGTCATGGAACACTGAAGCTTTCTTT	CASSQAGSWNTEAFF	TRBV14	TRBJ1-1
TGTGCCAGCAGCTTCAAGGGGTGCTATGGCTACACCTTC	CASSFKGCYGYTF	TRBV7-3	TRBJ1-2
TGTGCCATCGCCAGGTTAGGATTTAATTCACCCCTCCACTTT	CAIARLGFNSPLHF	TRBV19	TRBJ1-6
TGTGCCAGCAGCGTAGTTTTGGGGAATGAGCAGTTCTTC	CASSVVLGNEQFF	TRBV9	TRBJ2-1
TGTGCCAGCAGTGAGTGGGGGACTAGGAGCTCCTACAATGAGCAGTTCTTC	CASSEWGTRSSYNEQFF	TRBV25-1	TRBJ2-1
TGTGCCACCAGTGATGGATCACAGCACACAGATACGCAGTATTTT	CATSDGSQHTDTQYF	TRBV24-1	TRBJ2-3
TGTGCCAGCAGTTTATTCAAGAAAGGGGCCCTGGTGGCGGACGAGCAGTACTTC	CASSLFKKGALVADEQYF	TRBV27	TRBJ2-7
TGTGCCAGGCCCGGGCACAGGGGCTATGGCTACACCTTC	CARPGHRGYGYTF	TRBV19	TRBJ1-2
TGTGCTAGTGGTCGGTGCGGTGCTGAAGCTTTCTTT	CASGRCGAEAFF	TRBV12-5	TRBJ1-1
TGTGCCAGCAGCCAAGACTGCTGGGACTCAACTAATGAAAAACTGTTTTTT	CASSQDCWDSTNEKLFF	TRBV3-1	TRBJ1-4
TGTGCTAGTGACCAGGGGGTATACGAGCAGTACTTC	CASDQGVYEQYF	TRBV12-5	TRBJ2-7
TGTGCCAGCAGTACCGGGGGATCCCCGTCTAACTATGGCTACACCTTC	CASSTGGSPSNYGYTF	TRBV2	TRBJ1-2
TGTGCCAGCAGCGCGGGTCAGGGTGGGGGGGTTGTCCCATACGAGCAGTACTTC	CASSAGQGGGVVPYEQYF	TRBV5-4	TRBJ2-7
TGCGCCAGTTGGACAGGGGAGCAGTACTTC	CASWTGEQYF	TRBV5-1	TRBJ2-7
TGTGCCAGCCAGTCTCTACGATACAAAAACATTCAGTACTTC	CASQSLRYKNIQYF	TRBV7-9	TRBJ2-4
TGCGCCAGCAGTGAGGAGAGCGGGATGAACCAAAGCACAGATACGCAGTATTTT	CASSEESGMNQSTDTQYF	TRBV10-1	TRBJ2-3
TGTGCCAGCAGTTACTCGAGGGGGAGGGACCAAGAACTCTATGGCTACACCTTC	CASSYSRGRDQELYGYTF	TRBV6-3	TRBJ1-2
TGCGCCAGCAGCCAAGTCCATATCCCCTATGGCTACACCTTC	CASSQVHIPYGYTF	TRBV4-1	TRBJ1-2
TGCCCCGACAGTACCCAGCATTTT	CPDSTQHF	TRBV5-1	TRBJ1-5
TGTGCCAGCAGCGCCGTAGCCCCAGGGACCCACTATGGCTACACCTTC	CASSAVAPGTHYGYTF	TRBV27	TRBJ1-2
TGTGCCAGCAGCGGGCGGGGAGGCTACACCTTC	CASSGRGGYTF	TRBV13	TRBJ1-2
TGTGCCAGCAGCTTTGGGGGGACTAGCGGGGCAATTTCCGATTACAATGAGCAGTTCTTC	CASSFGGTSGAISDYNEQFF	TRBV7-3	TRBJ2-1
TGTGCCAGCAGCCAAGATCCCTTTCGGACAGGGTGTGATGGCTACACCTTC	CASSQDPFRTGCDGYTF	TRBV14	TRBJ1-2
TGTGCCAGCAGCCAAGATCCCCCCTTCCGGGAAACGTACGAGCAGTACTTC	CASSQDPPFRETYEQYF	TRBV14	TRBJ2-7
TGTGCCAGCAGACTGGGGGCAGGGGGGCAGTACTTC	CASRLGAGGQYF	TRBV27	TRBJ2-5
TGCAGTGCTAGGAGGGGACTAGCGGGGGGGCAGGCGCCCTACGAGCAGTACTTC	CSARRGLAGGQAPYEQYF	TRBV20-1	TRBJ2-7
TGTGCCATCACCAACGGGGGGGGCGCTTTATCTGGAAACACCATATATTTT	CAITNGGGALSGNTIYF	TRBV10-3	TRBJ1-3
TGTGCCAGCAGCTCCTCACCCTTAGCGGACCTCAATGAGCAGTTCTTC	CASSSSPLADLNEQFF	TRBV7-3	TRBJ2-1
TGTGCCAGCAGCCCGGGACCGGTCTACGAGCAGTACTTC	CASSPGPVYEQYF	TRBV3-1	TRBJ2-7
TGTGCCAGCAGTAGAAAGGACAGGGATGCCGAAAAACTGTTTTTT	CASSRKDRDAEKLFF	TRBV6-2	TRBJ1-4
TGTGCCAGCGATTCTGGGCCCACTGAAGCTTTCTTT	CASDSGPTEAFF	TRBV6-5	TRBJ1-1
TGTGCCAGCAGCCTGACACAGGAATTGGGAGGGACGGGAGAAGAGACCCAGTACTTC	CASSLTQELGGTGEETQYF	TRBV7-6	TRBJ2-5
TGTGCCAGCAGCACCACGGGACCCTCTGGAAACACCATATATTTT	CASSTTGPSGNTIYF	TRBV13	TRBJ1-3
TGTGCCACCACACCGGGACAGGGGGCGAACACTGAAGCTTTCTTT	CATTPGQGANTEAFF	TRBV7-3	TRBJ1-1
TGTGCCAGCAGTTTGTTGCAACCAGAGGAGGATCCAGGCCCGAACACCGGGGAGCTGTTTTTT	CASSLLQPEEDPGPNTGELFF	TRBV27	TRBJ2-2
TGTGCCAGCAGCCCTCAGCCGGGACTTCCTGAAGCTTTCTTT	CASSPQPGLPEAFF	TRBV7-2	TRBJ1-1
TGTGCCAGCAGCCTTTCCGGGGGGGTCACAGATACGCAGTATTTT	CASSLSGGVTDTQYF	TRBV9	TRBJ2-3
TGCGCCAGCAGCTTGGTACCGGGACTAGATGGCCAAGAGACCCAGTACTTC	CASSLVPGLDGQETQYF	TRBV5-1	TRBJ2-5
TGTGCCAGCGCGCCTTCCACCGGACCCCGCCATCAGCCCCAGCATTTT	CASAPSTGPRHQPQHF	TRBV25-1	TRBJ1-5
TGTGCCACCAGTGATCTCTGGGCGATCTCCTACGAGCAGTACTTC	CATSDLWAISYEQYF	TRBV24-1	TRBJ2-7
TGTGCCAGCGATAGGGGACCGTATAGCAATCAGCCCCAGCATTTT	CASDRGPYSNQPQHF	TRBV7-2	TRBJ1-5
TGTGCCAGCAGCCATGTGGGACTAGCGGGACGTAGCACAGATACGCAGTATTTT	CASSHVGLAGRSTDTQYF	TRBV4-2	TRBJ2-3
TGTGCCAGCAGCTCTGCGATGAATGAAAAACTGTTTTTT	CASSSAMNEKLFF	TRBV5-6	TRBJ1-4
TGCAGTGCGACGAGACAGGGGATTGGCCGTACAGATACGCAGTATTTT	CSATRQGIGRTDTQYF	TRBV20-1	TRBJ2-3
TGCGCCAGCAGCTTGCGCCGGGGCCGCCTCTATAGCAATCAGCCCCAGCATTTT	CASSLRRGRLYSNQPQHF	TRBV5-1	TRBJ1-5
TGTGCCAGCAGGGCCGCCTACCAGGGAAACACCATATATTTT	CASRAAYQGNTIYF	TRBV6-5	TRBJ1-3
TGTGCCAGCAGCCTGGGGAGGGTCCCGGGACAGGACCAAGAGACCCAGTACTTC	CASSLGRVPGQDQETQYF	TRBV3-1	TRBJ2-5
TGTGCCAGCTCAATTACCAGGGGGGTTAATTTGTACGAGCAGTACTTC	CASSITRGVNLYEQYF	TRBV18	TRBJ2-7
TGTGCCAGCAGCTCACAGGAAGTCCCTGAAGCTTTCTTT	CASSSQEVPEAFF	TRBV14	TRBJ1-1
TGTGCCAGCAGCAAGCAGGGATCTGAAGCTTTCTTT	CASSKQGSEAFF	TRBV7-2	TRBJ1-1
TGTGCCAGCAGCTTAGATCCGACCATGGCCCGCAATCAGCCCCAGCATTTT	CASSLDPTMARNQPQHF	TRBV11-3	TRBJ1-5
TGCGCCAGCCGGGGACAAAAGGTTAATCAGCCCCAGCATTTT	CASRGQKVNQPQHF	TRBV10-1	TRBJ1-5
TGCAGTGCATGCGATGGGACAGGGCGGGCGCCCCAGCATTTT	CSACDGTGRAPQHF	TRBV20-1	TRBJ1-5
TGTGCCAGCAGCCACCAGTTCGGGACAGGGCCACCTGGAAACACCATATATTTT	CASSHQFGTGPPGNTIYF	TRBV14	TRBJ1-3
TGCAGCGCCTCTGCGCGGGTCAATGAGCAGTTCTTC	CSASARVNEQFF	TRBV29-1	TRBJ2-1
TGTGCCAGCAGCTTAGTTCTCGGGCCGACGAATGAGCAGTTCTTC	CASSLVLGPTNEQFF	TRBV7-9	TRBJ2-1
TGTGCCAGCAGCTTGAATGACGGGGAGCTGTTTTTT	CASSLNDGELFF	TRBV5-4	TRBJ2-2
TGTGCCAGCAGCCAAGAAGCGGTTGCCGGGACTAGCGGGGCGGGCCGGGGACCCAATGAGCAGTTCTTC	CASSQEAVAGTSGAGRGPNEQFF	TRBV3-1	TRBJ2-1
TGCGCCAGCAGTCCGACTAGGGACAGGGGGAACACTGAAGCTTTCTTT	CASSPTRDRGNTEAFF	TRBV10-1	TRBJ1-1
TGTGCCACCAGCGCGGGAGTAGGAGCAGATACGCAGTATTTT	CATSAGVGADTQYF	TRBV15	TRBJ2-3
TGTGCCAGCAGCTTGGCCCATTCTTGGGGCGAAAAACTGTTTTTT	CASSLAHSWGEKLFF	TRBV5-5	TRBJ1-4
TGTGCCAGCAGTGACTTGACAGGAGAGTCGTCACCCCTCCACTTT	CASSDLTGESSPLHF	TRBV6-4	TRBJ1-6
TGTGCCAGCATGGGAGTACCCAATAGGGGAGAGCAGTTCTTC	CASMGVPNRGEQFF	TRBV27	TRBJ2-1
TGTGCCAGCAGCTTAGCAGGGACCCAAGAGACCCAGTACTTC	CASSLAGTQETQYF	TRBV7-3	TRBJ2-5
TGTGCCAGCAGCTTCACAGGGGGGGCAGATACGCAGTATTTT	CASSFTGGADTQYF	TRBV7-2	TRBJ2-3
TGTGCCAGCAGCCAAGATCGGGACAGGGCTACCACAAATCAGCCCCAGCATTTT	CASSQDRDRATTNQPQHF	TRBV3-1	TRBJ1-5
TGTGCCAGCATGAGACGACAGAAGGATTCACCCCTCCACTTT	CASMRRQKDSPLHF	TRBV28	TRBJ1-6
TGTGCCACCAGTGACTCCGGGACAGTGGTTGGAGAAAAGTATGGCTACACCTTC	CATSDSGTVVGEKYGYTF	TRBV24-1	TRBJ1-2
TGCAGCGTACCCTACGCTAGCGGGGGAATGTTAGAGCAGTACTTC	CSVPYASGGMLEQYF	TRBV29-1	TRBJ2-7
TGTGCCAGCAGCAACCACTGGGGATGCAATCAGCCCCAGCATTTT	CASSNHWGCNQPQHF	TRBV9	TRBJ1-5
TGCAGTGCTAGAGGTCGAACGAACACTGAAGCTTTCTTT	CSARGRTNTEAFF	TRBV20-1	TRBJ1-1
TGTGCCAGCAGCCCCGGAGGGTGGGACACCGGGGAGCTGTTTTTT	CASSPGGWDTGELFF	TRBV28	TRBJ2-2
TGTGCCATCAGTGTTCGAGCTCCGATACCGAACACCGGGGAGCTGTTTTTT	CAISVRAPIPNTGELFF	TRBV10-3	TRBJ2-2
TGTGCCAGCAGCGACCTGACAGGGGGCAATCAGCCCCAGCATTTT	CASSDLTGGNQPQHF	TRBV5-5	TRBJ1-5
TGTGCCAGTCTCCCTTTATCGCAACCTTGGAACGAGCAGTACTTC	CASLPLSQPWNEQYF	TRBV19	TRBJ2-7
TGTGCCAGCAGTGAAGAAGGACAGGGTTCTCATAATTCACCCCTCCACTTT	CASSEEGQGSHNSPLHF	TRBV25-1	TRBJ1-6
TGTGCCAGCAGCGCCCCCGGAGGGGGGAGCTCCTACAATGAGCAGTTCTTC	CASSAPGGGSSYNEQFF	TRBV9	TRBJ2-1
TGTGCCAGCAGGGTCCGCGGGGGCGGAAGGGGGTCACCCCTCCACTTT	CASRVRGGGRGSPLHF	TRBV11-3	TRBJ1-6
TGTGCCAGCAGCTCCGGGCTAGTGCGAGTTAGCACAGATACGCAGTATTTT	CASSSGLVRVSTDTQYF	TRBV5-6	TRBJ2-3
TGCAGCGTCCCGGTCCTAGCGGGTGGTGTCTACGAGCAGTACTTC	CSVPVLAGGVYEQYF	TRBV29-1	TRBJ2-7
TGTGCCAGCAGCCAAAGCGATGGACAGGGGGCGAGAAGCAATCAGCCCCAGCATTTT	CASSQSDGQGARSNQPQHF	TRBV3-1	TRBJ1-5
TGTGCCAGCAGCAAAGAGGGGTCCGGCGGAGAAGAGACCCAGTACTTC	CASSKEGSGGEETQYF	TRBV2	TRBJ2-5
TGTGCCAGCAGCTGGGACAGGGGGCGAAAGGCAGGCGGGGAGCTGTTTTTT	CASSWDRGRKAGGELFF	TRBV13	TRBJ2-2
TGTGCCAGCAGTGACAAGACCGTAATATACAATGAGCAGTTCTTC	CASSDKTVIYNEQFF	TRBV6-4	TRBJ2-1
TGTGCCACCAGTGGAGATAGGGGTTTCCCCTATGGCTACACCTTC	CATSGDRGFPYGYTF	TRBV24-1	TRBJ1-2
TGTGCCAGCTCACCACGAGAGGAACTGAGGGAGAATTCACCCCTCCACTTT	CASSPREELRENSPLHF	TRBV18	TRBJ1-6
TGTGCCACTAGACAGGAACGGCCTAATTCACCCCTCCACTTT	CATRQERPNSPLHF	TRBV10-3	TRBJ1-6
TGTGCCAGCAGCCAAGATCCCCGTGAACTAGCGGGAGGTGAGCAGTACTTC	CASSQDPRELAGGEQYF	TRBV14	TRBJ2-7
TGTGCCACCAGCAGAGATGGCCAAGAAGCGGGACTTGTTCACGAGCAGTACTTC	CATSRDGQEAGLVHEQYF	TRBV15	TRBJ2-7
TGTGCCTGGAGTCGATCCGGGACCAGCGCAGATACGCAGTATTTT	CAWSRSGTSADTQYF	TRBV30	TRBJ2-3
TGTGCCAGCAGCCAAGCGGCAAAGACAGGGGTCCAGTACTTC	CASSQAAKTGVQYF	TRBV3-1	TRBJ2-5
TGTGCCAGCAGCCAAGGTAAGGGGACAGGAGGCTACGAGCAGTACTTC	CASSQGKGTGGYEQYF	TRBV3-1	TRBJ2-7
TGTGCCAGCAGCAAGGGGCGGCCTTTCTTT	CASSKGRPFF	TRBV5-6	TRBJ1-1
TGTGCCAGCAGCGCAGTGGACAGGTCCGGAGATGCCTATGGCTACACCTTC	CASSAVDRSGDAYGYTF	TRBV7-3	TRBJ1-2
TGTGCCAGCAGCTCCCGGGGACGAGTCTGGAGCTCCTACGAGCAGTACTTC	CASSSRGRVWSSYEQYF	TRBV13	TRBJ2-7
TGCGCCAGCAGCCAAGATTCTGTTTCAGGGGGTCAAGCCAAAAACATTCAGTACTTC	CASSQDSVSGGQAKNIQYF	TRBV4-1	TRBJ2-4
TGTGCCAGCAGCCTATCCGTACGACAGGGGGTTGACTCTGGGGCCAACGTCCTGACTTTC	CASSLSVRQGVDSGANVLTF	TRBV5-4	TRBJ2-6
TGCAGTGCTGGGGAGGGGGGGGGAGTGAACACTGAAGCTTTCTTT	CSAGEGGGVNTEAFF	TRBV20-1	TRBJ1-1
TGTGCCACCAGTAGCCCTCCACCGACCGGGACAGGCCTCAATCAGCCCCAGCATTTT	CATSSPPPTGTGLNQPQHF	TRBV24-1	TRBJ1-5
TGCGCCAGCAGTCCTCAGGGGGCGGGGGTCTGCAATCAGCCCCAGCATTTT	CASSPQGAGVCNQPQHF	TRBV10-1	TRBJ1-5
TGTGCCAGCAGCGCTAGCGGGTTTACCTACGAGCAGTACTTC	CASSASGFTYEQYF	TRBV7-9	TRBJ2-7
TGTGCCAGCTCACGACAGGATAGCAATCAGCCCCAGCATTTT	CASSRQDSNQPQHF	TRBV18	TRBJ1-5
TGTGCCAGCAGTTTAGCTTACGTAGCGGGAGCAAGCTACGAGCAGTACTTC	CASSLAYVAGASYEQYF	TRBV12-4	TRBJ2-7
TGTGCCAGCACCTCGCCCTCGGGGAACAATGAGCAGTTCTTC	CASTSPSGNNEQFF	TRBV2	TRBJ2-1
TGTGCCACGCCGACAGGGCAATCCCGGGATCAGCCCCAGCATTTT	CATPTGQSRDQPQHF	TRBV6-6	TRBJ1-5
TGTGCCTGGCGGCCTATAGCCACAGATACGCAGTATTTT	CAWRPIATDTQYF	TRBV30	TRBJ2-3
TGCAGTGCAAAGGGGAGAGGCTACACCTTC	CSAKGRGYTF	TRBV20-1	TRBJ1-2
TGTGCCACCAGTGACCACGGGGGGGAAGAGACCCAGTACTTC	CATSDHGGEETQYF	TRBV24-1	TRBJ2-5
TGCAGTGCTCGAAGCGGGTTCGGGAACACTGAAGCTTTCTTT	CSARSGFGNTEAFF	TRBV20-1	TRBJ1-1
TGTGCCAGCAGTCCCCCATCTAGTTACGAGCAGTACTTC	CASSPPSSYEQYF	TRBV6-4	TRBJ2-7
TGTGCCAGCGGGACGTTAGCACCCTACGAGCAGTACTTC	CASGTLAPYEQYF	TRBV6-4	TRBJ2-7
TGCGCCAGCAGGTCTGTCAGAGGGGGAGACCCCAACACTGAAGCTTTCTTT	CASRSVRGGDPNTEAFF	TRBV5-1	TRBJ1-1
TGTGCCAGCAGTACCAAGAAGGGGGAGAATTCACCCCTCCACTTT	CASSTKKGENSPLHF	TRBV2	TRBJ1-6
TGTGCCAGCAGCGTAAGGGGGGGGGGCCCCAATGAGCAGTTCTTC	CASSVRGGGPNEQFF	TRBV9	TRBJ2-1
TGTGCCAGCAGCGCAAAACTTCAGGCGGGACTAGCGAGGATCACAGATACGCAGTATTTT	CASSAKLQAGLARITDTQYF	TRBV9	TRBJ2-3
TGTGCCAGCAGCAGAGGGACTGACTGGACCCAGTACTTC	CASSRGTDWTQYF	TRBV25-1	TRBJ2-5
TGCGCCAGCAGCAGACACTACGAGCAGTACTTC	CASSRHYEQYF	TRBV4-3	TRBJ2-7
TGTGCCAGCAGCTTATCCCCGGGGGACAGGGGCTCCTACGAGCAGTACTTC	CASSLSPGDRGSYEQYF	TRBV7-3	TRBJ2-7
TGCAGTGCAAGGCTAGCGGAGAGGTACGAGCAGTACTTC	CSARLAERYEQYF	TRBV20-1	TRBJ2-7
TGTGCCAGCAGTTTACCGCCTGAGCCCAAAGCGGGACCTGGCTACACCTTC	CASSLPPEPKAGPGYTF	TRBV27	TRBJ1-2
TGCAGTGCTAGAGATCTCCATAGGAGCCGTCGCAACGAGCAGTACTTC	CSARDLHRSRRNEQYF	TRBV20-1	TRBJ2-7
TGCGCCAGCAGCCATATAGCGGGTAAAAGCTCCTACGAGCAGTACTTC	CASSHIAGKSSYEQYF	TRBV4-3	TRBJ2-7
TGTGCCAGCAGTTTAGGCTCGAATGAGCAGTTCTTC	CASSLGSNEQFF	TRBV27	TRBJ2-1
TGCGCCAGCAGCCAAGGGGAGGTTGAAAAACTGTTTTTT	CASSQGEVEKLFF	TRBV4-1	TRBJ1-4
TGTGCTAGTGGTTGCCGGGGACAGGAACTGATAGGGCGCGGCTCTGGAAACACCATATATTTT	CASGCRGQELIGRGSGNTIYF	TRBV12-5	TRBJ1-3
TGTGCCAGCTGTCATGGGCCCCGGGACGCGTCTCCAGACCTCTGGGATAACAATGAGCAGTTCTTC	CASCHGPRDASPDLWDNNEQFF	TRBV12-4	TRBJ2-1
TGCAACGTGGGAGACCTCGGTCACGAGCAGTACTTC	CNVGDLGHEQYF	TRBV29-1	TRBJ2-7
TGTGCCAGCAGTATGACAGGGGCGAATAATTCACCCCTCCACTTT	CASSMTGANNSPLHF	TRBV2	TRBJ1-6
TGTGCCAGCAGTGAGGGGGACACTAATGAAAAACTGTTTTTT	CASSEGDTNEKLFF	TRBV6-4	TRBJ1-4
TGTGCCAGCAGTTACTTAACAGGGACAGGCTACGAGCAGTACTTC	CASSYLTGTGYEQYF	TRBV6-5	TRBJ2-7
TGCAGTGCTAGAGAGTCCCCTGGACGGGTTTTGTACGAGCAGTACTTC	CSARESPGRVLYEQYF	TRBV20-1	TRBJ2-7
TGTGCCAGCAGCGTAGTACAGGGATTCCACTCCTACGAGCAGTACTTC	CASSVVQGFHSYEQYF	TRBV7-3	TRBJ2-7
TGTGCCAGCAGTCCCGGTATTGCCCCGGGGGGGACGAACTATGGCTACACCTTC	CASSPGIAPGGTNYGYTF	TRBV12-3	TRBJ1-2
TGTGCCAGCAGCCAAGAAGATAGCGGGCAGTACTTC	CASSQEDSGQYF	TRBV3-1	TRBJ2-7
TGTGCCAGCAGCGTTTCTAGCGGCTTCGAGACCCAGTACTTC	CASSVSSGFETQYF	TRBV5-4	TRBJ2-5
TGTGCCAGTAGTCCCAAACAGAATGAACAGGTAGCTTTCTTT	CASSPKQNEQVAFF	TRBV19	TRBJ1-1
TGTGCCAGCAGCGACAGTAGGGATTACACTGAAGCTTTCTTT	CASSDSRDYTEAFF	TRBV5-6	TRBJ1-1
TGCAGTGCAATTTTCGGACAGGGATATTGTAGCAATCAGCCCCAGCATTTT	CSAIFGQGYCSNQPQHF	TRBV20-1	TRBJ1-5
TGCGCCAGCAGTGAGCACGCGTTTATTCACAAACTATGCACAGATACGCAGTATTTT	CASSEHAFIHKLCTDTQYF	TRBV10-1	TRBJ2-3
TGCAGTGCTTCCACATTCGGGGGGACAGGCGGTTTCTACGAGCAGTACTTC	CSASTFGGTGGFYEQYF	TRBV20-1	TRBJ2-7
TGTGCCAGCAGCGTAGACCTCCTACAGGGACGGGCGGAAAAACTGTTTTTT	CASSVDLLQGRAEKLFF	TRBV9	TRBJ1-4
TGTGCCACCAGCAGAGATTCCGGTTCGGGACAGAGTCGAATCGGCTACGAGCAGTACTTC	CATSRDSGSGQSRIGYEQYF	TRBV15	TRBJ2-7
TGCGCCAGCAGCCAAGATCAAGAGAACAGGGCGTCCGATCAGCCCCAGCATTTT	CASSQDQENRASDQPQHF	TRBV4-1	TRBJ1-5
TGCAGCATGAGCGGGAGCGGGCAAGAGACCCAGTACTTC	CSMSGSGQETQYF	TRBV29-1	TRBJ2-5
TGTGCCAGCAAACGGCTGGGGGGGGCTGGGGCCAACGTCCTGACTTTC	CASKRLGGAGANVLTF	TRBV6-3	TRBJ2-6
TGTGCCAGCAGCTACTTCCTTTGGACCCCTAGCGGGGCTACGCAGTATTTT	CASSYFLWTPSGATQYF	TRBV5-6	TRBJ2-3
TGTGCCAGCAGCAATCAGGGTAATCAGCCCCAGCATTTT	CASSNQGNQPQHF	TRBV5-6	TRBJ1-5
TGTGCCAGCAGTAGAGAGGGTGGGGGGGGGGTTGAACCGAACACTGAAGCTTTCTTT	CASSREGGGGVEPNTEAFF	TRBV6-1	TRBJ1-1
TGCGCCAGCAGCCACTACGACAATGAGCAGTTCTTC	CASSHYDNEQFF	TRBV4-1	TRBJ2-1
TGTGCCAGCAGCTACATTCAGAGTGGATACTCCTACAATGAGCAGTTCTTC	CASSYIQSGYSYNEQFF	TRBV7-3	TRBJ2-1
TGTGCCAGCAGCTTAGATCCAGACTTCCGGGGGTCGAACACTGAAGCTTTCTTT	CASSLDPDFRGSNTEAFF	TRBV11-2	TRBJ1-1
TGTGCCATTGACGGGGTAGGGAGCAATCAGCCCCAGCATTTT	CAIDGVGSNQPQHF	TRBV10-3	TRBJ1-5
TGTGCCAGCGACAGTGAAAAACTGTTTTTT	CASDSEKLFF	TRBV6-2	TRBJ1-4
TGCAGTGCTAGAGATCGCCGACTAGAATTCAATGAGCAGTTCTTC	CSARDRRLEFNEQFF	TRBV20-1	TRBJ2-1
TGTGCCAGCAGCAGGAAACCCCCCGGGACAGGGGGAATTAATGAAAAACTGTTTTTT	CASSRKPPGTGGINEKLFF	TRBV5-4	TRBJ1-4
TGTGCCAGCAGGACAGTGGTTGTTCAGCCCCAGCATTTT	CASRTVVVQPQHF	TRBV6-4	TRBJ1-5
TGTGCCGCGGGGAAGAAAAACATTCAGTACTTC	CAAGKKNIQYF	TRBV6-4	TRBJ2-4
TGTGCCAGCAGAGTTTACACAGATACGCAGTATTTT	CASRVYTDTQYF	TRBV12-3	TRBJ2-3
TGTGCCAGCAGTGAATCGGCAGGGGTCGACTACGAGCAGTACTTC	CASSESAGVDYEQYF	TRBV25-1	TRBJ2-7
TGTGCCAGTAGTATAGACAATAACAGGGGACCGAACACTGAAGCTTTCTTT	CASSIDNNRGPNTEAFF	TRBV19	TRBJ1-1
TGTGCTAGTGGTCCTAGGGACAGGTTCACAGATACGCAGTATTTT	CASGPRDRFTDTQYF	TRBV12-5	TRBJ2-3
TGTGCCAGCAGCCTCGCCGGGACAGGGGGCGCTGATGGCTACACCTTC	CASSLAGTGGADGYTF	TRBV6-1	TRBJ1-2
TGTGCCAGCAGTGAGGGTCCGGGACAGTACGAGCAGTACTTC	CASSEGPGQYEQYF	TRBV6-4	TRBJ2-7
TGTGCCATCGTAGGACTGAGAGAGACCCAGTACTTC	CAIVGLRETQYF	TRBV28	TRBJ2-5
TGTGCCAGCAAAGAACAGGGGAACTATGGCTACACCTTC	CASKEQGNYGYTF	TRBV6-4	TRBJ1-2
TGTGCCAGCCCGGGGGCCGGGACTAGCGGGAACCGCTCCTACAATGAGCAGTTCTTC	CASPGAGTSGNRSYNEQFF	TRBV7-3	TRBJ2-1
TGCGCCAGCAGCTTGGACAGGGGGGGGGATTCTGCTTTCACTGAAGCTTTCTTT	CASSLDRGGDSAFTEAFF	TRBV5-1	TRBJ1-1
TGTGCCAGCAGCCCTGGGGACAGATGGGCTGGGGCCAACGTCCTGACTTTC	CASSPGDRWAGANVLTF	TRBV5-4	TRBJ2-6
TGTGCCAAATCCAGGGAGGGGGGACAGAACAGGGTACAAGAGACCCAGTACTTC	CAKSREGGQNRVQETQYF	TRBV11-3	TRBJ2-5
TGTGCCAGCAGCGTAATAGCGGGTCACGAGCAGTACTTC	CASSVIAGHEQYF	TRBV9	TRBJ2-7
TGTGCCAGCAGACGTAAGGGGTTGAACACTGAAGCTTTCTTT	CASRRKGLNTEAFF	TRBV7-3	TRBJ1-1
TGTGCCAGCAGCGGGCAAGGTGGCTACACCTTC	CASSGQGGYTF	TRBV7-4	TRBJ1-2
TGCAGTGCTGGCTCACCTAACAGGGATGAAGCTTTCTTT	CSAGSPNRDEAFF	TRBV20-1	TRBJ1-1
TGTGCCAGCAGCCAGCAAGTCCGCTCCTTGAATGAGCAGTTCTTC	CASSQQVRSLNEQFF	TRBV3-1	TRBJ2-1
TGCGCCAGCAGCCAAGATCGTCTGGGCGCGAAGCAGTACTTC	CASSQDRLGAKQYF	TRBV4-1	TRBJ2-7
TGCAGTGCTAGCAGGGGACTAGCGGATTGCCATGAGCAGTTCTTC	CSASRGLADCHEQFF	TRBV20-1	TRBJ2-1
TGTGCCAGCAGTCCGGGGACAGGGGTGACTGGCTACACCTTC	CASSPGTGVTGYTF	TRBV6-2	TRBJ1-2
TGTGCCAAAATGGGGACTGTCAGGTACGAGCAGTACTTC	CAKMGTVRYEQYF	TRBV19	TRBJ2-7
TGTGCCAGCAGCCAAGATGAAGGTGCACAGTGGGATAATTCACCCCTCCACTTT	CASSQDEGAQWDNSPLHF	TRBV14	TRBJ1-6
TGCGCCATCCCCTTTGGGGGGAGCTATAATTCACCCCTCCACTTT	CAIPFGGSYNSPLHF	TRBV5-1	TRBJ1-6
TGTGCCAGCTCACCGAAGTCGGTATTAGACCGTTGCCACGAGCAGTACTTC	CASSPKSVLDRCHEQYF	TRBV18	TRBJ2-7
TGTGCCAGCAGCCTCCGGGACGCCGGGGAGCTGTTTTTT	CASSLRDAGELFF	TRBV9	TRBJ2-2
TGTGCCAGCAGGCCTGGTGGCTACACCTTC	CASRPGGYTF	TRBV5-6	TRBJ1-2
TGTGCCAGCAAGGGGACCACAGGGAGGCAGCCCCAGCATTTT	CASKGTTGRQPQHF	TRBV5-4	TRBJ1-5
TGTGCCAGCATCGAGGGATTCGAAAAACTGTTTTTT	CASIEGFEKLFF	TRBV27	TRBJ1-4
TGTGCCAGCAGCCAAACTTCGATCCGGCGGATAATGAGGGACCTCCTGTTACAAGCATCACCCCTCCACTTT	CASSQTSIRRIMRDLLLQASPLHF	TRBV13	TRBJ1-6
TGCGCCAGCAGCCAAGATAACCAGACAGGGGAAAAACTGTTTTTT	CASSQDNQTGEKLFF	TRBV4-3	TRBJ1-4
TGTGCCAGCAGTCAAGACCCGGATGAAAAACTGTTTTTT	CASSQDPDEKLFF	TRBV12-3	TRBJ1-4
TGCAGCGTTGTGGACAGGGGAGAGCAGTACTTC	CSVVDRGEQYF	TRBV29-1	TRBJ2-7
TGTGCCAGCAGTTTCAGGAGGAAGGATAGAAACTATGGCTACACCTTC	CASSFRRKDRNYGYTF	TRBV6-9	TRBJ1-2
TGTGCCAGCAGTGAAGCAAACGGATTAGATACGCAGTATTTT	CASSEANGLDTQYF	TRBV6-1	TRBJ2-3
TGTGCCAGCTCACAGGGACTAGGGGCCTACGAGCAGTACTTC	CASSQGLGAYEQYF	TRBV18	TRBJ2-7
TGTGCCAGCAGCTCTCCATCACAGGGGAACACCGGGGAGCTGTTTTTT	CASSSPSQGNTGELFF	TRBV5-5	TRBJ2-2
TGTGCCAGCAGCTTAGCGACTCGCTACGAGCAGTACTTC	CASSLATRYEQYF	TRBV7-4	TRBJ2-7
TGTGCCAGCAGTGAGGGTAATTTGAGGGAGACCCAGTACTTC	CASSEGNLRETQYF	TRBV6-5	TRBJ2-5
TGTGCCAGAGCGGGAGGTGATCCTAATGAGCAGTTCTTC	CARAGGDPNEQFF	TRBV5-4	TRBJ2-1
TGTGCCAGCAGCCCAAAACCAGGGGTTAAGGACACTGAAGCTTTCTTT	CASSPKPGVKDTEAFF	TRBV7-3	TRBJ1-1
TGTGCCAGCAGCTTAACCGGGGTGGGCCGGGAGACCCAGTACTTC	CASSLTGVGRETQYF	TRBV7-9	TRBJ2-5
TGTGCCAGCAGTTTACTCCTGGAACTAGCGGATTTGAGGCAGTATTTT	CASSLLLELADLRQYF	TRBV12-3	TRBJ2-3
TGTGCCAGGGTTAGGGGGACAGGGCCCAGTTTAAACATTCAGTACTTC	CARVRGTGPSLNIQYF	TRBV27	TRBJ2-4
TGCGAAGTGGTATTAGGGGACAGGGCAGCAAGGGACTATGGCTACACCTTC	CEVVLGDRAARDYGYTF	TRBV20-1	TRBJ1-2
TGTGCCAGCAGTTACGCCACGGTTATCGAGCCCTACGAGCAGTACTTC	CASSYATVIEPYEQYF	TRBV6-5	TRBJ2-7
TGCGCCAGCAGCGTTCGAGTATTGGCAGATACGCAGTATTTT	CASSVRVLADTQYF	TRBV5-1	TRBJ2-3
TGCGCCAGCAGTCGTTGGGGAGGGGAATACGAGCAGTACTTC	CASSRWGGEYEQYF	TRBV10-1	TRBJ2-7
TGTGCCAGCAGCCAAGATCTGACAGGCGGGGCCAACGTCCTGACTTTC	CASSQDLTGGANVLTF	TRBV14	TRBJ2-6
TGTGCCAGCAGCTTGTCTCCGGATAGAGGTCCAAGGACCGGGGAGCTGTTTTTT	CASSLSPDRGPRTGELFF	TRBV5-8	TRBJ2-2
TGTGCCAGCAGTTTTCTTGGGGATACGATGGAGACCCAGTACTTC	CASSFLGDTMETQYF	TRBV27	TRBJ2-5
TGTGCCAGACGTAGGGAAAAGAATAACTATGGCTACACCTTC	CARRREKNNYGYTF	TRBV11-2	TRBJ1-2
TGTGCCAGCAGCTTAAGACAGATTAGGTGTTACGGGACAACAGATACGCAGTATTTT	CASSLRQIRCYGTTDTQYF	TRBV7-2	TRBJ2-3
TGCGCCAGCAGTGAGTCGGAGGGGGCACTTGAGAGCTCCTACAATGAGCAGTTCTTC	CASSESEGALESSYNEQFF	TRBV10-1	TRBJ2-1
TGTGCCAGCAGCCGAGAAGACTACGAGCAGTACTTC	CASSREDYEQYF	TRBV6-1	TRBJ2-7
TGTGCCAGCAGTTTTTCGAGCGGGAACGAGCAGTACTTC	CASSFSSGNEQYF	TRBV6-3	TRBJ2-7
TGCGCCAGCAGCCCCTCTCGGGGCGGCGTCTACTACGAGCAGTACTTC	CASSPSRGGVYYEQYF	TRBV4-3	TRBJ2-7
TGTGCCAGCAGCTTAAGAGGGGCGAAGGCCTCTGGGGCCAACGTCCTGACTTTC	CASSLRGAKASGANVLTF	TRBV7-2	TRBJ2-6
TGCAGTGCTAGCGGGGGGATTGGCTACACCTTC	CSASGGIGYTF	TRBV20-1	TRBJ1-2
TGCGCCAGCAGCGGGCCAACAGAGTCCGGGGAGCTGTTTTTT	CASSGPTESGELFF	TRBV5-1	TRBJ2-2
TGTGCCAGCAGCTTATGTCCAGGAGTCATTCAGTACTTC	CASSLCPGVIQYF	TRBV11-3	TRBJ2-4
TGTGCCAGCAGCCCGGGGGAGCCTGAAAGGAGCTCCTACGAGCAGTACTTC	CASSPGEPERSSYEQYF	TRBV13	TRBJ2-7
TGTGCCAGTAGTATGGGCTACCGGACAGGGCGCCAGCCCCAGCATTTT	CASSMGYRTGRQPQHF	TRBV19	TRBJ1-5
TGTGCCAGCAGCCGGAAGAGGTACGAGCAGTACTTC	CASSRKRYEQYF	TRBV12-3	TRBJ2-7
TGTGCCAGCGGGCACGACAGGGTCACAGATACGCAGTATTTT	CASGHDRVTDTQYF	TRBV6-1	TRBJ2-3
TGTGCCAGCAGCAGCTTGGGCGCTAATGAAAAACTGTTTTTT	CASSSLGANEKLFF	TRBV5-6	TRBJ1-4
TGTGCCAGCATTGAGGATATCGCAGATACGCAGTATTTT	CASIEDIADTQYF	TRBV6-5	TRBJ2-3
TGTGCCAGCAGCTCATCGGGACAGGGCGCTTTAATCTACGAGCAGTACTTC	CASSSSGQGALIYEQYF	TRBV5-8	TRBJ2-7
TGTGCCAGCAGTTACGATGCAGGCCGGGACAGGGGCAATCAGCCCCAGCATTTT	CASSYDAGRDRGNQPQHF	TRBV6-4	TRBJ1-5
TGCGCCAGCAGCCTGGGGTTAGCCTACGAGCAGTACTTC	CASSLGLAYEQYF	TRBV5-1	TRBJ2-7
TGCGCCAGCAGTATTCCACGGACTAGCGGGGGAAAAGAGACCCAGTACTTC	CASSIPRTSGGKETQYF	TRBV5-1	TRBJ2-5
TGCGCCAGCACGGGGACAGAAAAGTACTATGGCTACACCTTC	CASTGTEKYYGYTF	TRBV10-2	TRBJ1-2
TGTGCCAGCTCGTCACGTTTTGCCAAAAACATTCAGTACTTC	CASSSRFAKNIQYF	TRBV18	TRBJ2-4
TGTGCCAGCAGTGAAATCCCTAGGCCTCCCACCTACGAGCAGTACTTC	CASSEIPRPPTYEQYF	TRBV6-1	TRBJ2-7
TGTGCCAGTAGTCGTTCGGTCTTTAACTACGAGCAGTACTTC	CASSRSVFNYEQYF	TRBV19	TRBJ2-7
TGTGCCAGCAGCGTAACTAGCCGCGGGGAGCTGTTTTTT	CASSVTSRGELFF	TRBV11-2	TRBJ2-2
TGTGCCAGCAGCTTATCCCCGCTAACAAGGGAGTGCAGGAACACTGAAGCTTTCTTT	CASSLSPLTRECRNTEAFF	TRBV7-9	TRBJ1-1
TGCGCCAGCAGCCCGCAAATCTATGGCTACACCTTC	CASSPQIYGYTF	TRBV5-1	TRBJ1-2
TGTGCCAGCAGCTTCCCTGACAGAATCGGGGAGCTGTTTTTT	CASSFPDRIGELFF	TRBV5-6	TRBJ2-2
TGTGCATTAAAGGGACAGGGAAGTTCACCCCTCCACTTT	CALKGQGSSPLHF	TRBV6-2	TRBJ1-6
TGTGCCAGCAGCAAAACAGGGGGGGATAACTATGGCTACACCTTC	CASSKTGGDNYGYTF	TRBV5-4	TRBJ1-2
TGCGCCAGCAGTGAGTTCCCAGGGGATAATGAAAAACTGTTTTTT	CASSEFPGDNEKLFF	TRBV10-1	TRBJ1-4
TGTGCCAGCTCACCATCGCCGGACGACGAGCAGTACTTC	CASSPSPDDEQYF	TRBV18	TRBJ2-7
TGTGCCAGCAGTTTATATTTCCCACTAGCGGGAGGCCAGGGCTCCTACGAGCAGTACTTC	CASSLYFPLAGGQGSYEQYF	TRBV27	TRBJ2-7
TGCAGTGCCGGACAGGGATGGTATAGCAATCAGCCCCAGCATTTT	CSAGQGWYSNQPQHF	TRBV20-1	TRBJ1-5
TGTGCCAGCAGCGGAAAAACGTACCATCTGACTTTC	CASSGKTYHLTF	TRBV9	TRBJ2-6
TGTGCCAGCTCACCTCCGCGGTTCCCCCCAACCACATACGGGGAGCTGTTTTTT	CASSPPRFPPTTYGELFF	TRBV18	TRBJ2-2
TGTGCCTGGACAGGGCGCGGGGTACGGGACAGGGGTGAGACCCAGTACTTC	CAWTGRGVRDRGETQYF	TRBV30	TRBJ2-5
TGTGCCAGCAGAATGGCGGACAGGGCGGCATACGAGCAGTACTTC	CASRMADRAAYEQYF	TRBV12-4	TRBJ2-7
TGTGCCACCAGGCCCACAGGGCCCTACGAGCAGTACTTC	CATRPTGPYEQYF	TRBV24-1	TRBJ2-7
TGTGCCAGCAGGAGGGACTATGGCTACACCTTC	CASRRDYGYTF	TRBV2	TRBJ1-2
TGTGCCAGCAGCAGCCCCGTTGGGGGGGCAGGGAATGAGCAGTTCTTC	CASSSPVGGAGNEQFF	TRBV7-3	TRBJ2-1
TGTGCCAGCAGCCATTTACGGGAGGAGGAAGGGGGAAACACCATATATTTT	CASSHLREEEGGNTIYF	TRBV14	TRBJ1-3
TGTGCCAGCAGCCCGACCTTCAGGGGCCCCGTGGACTATGGCTACACCTTC	CASSPTFRGPVDYGYTF	TRBV7-3	TRBJ1-2
TGTGCCAGCAGCCAACGTAAGTTCGGCTCACAGTACTTC	CASSQRKFGSQYF	TRBV13	TRBJ2-5
TGTGCCAGCAGCAGACCCATCGACGTACCCCCTGGGACAGCACTAAGTTCCGACATTCAGTACTTC	CASSRPIDVPPGTALSSDIQYF	TRBV7-8	TRBJ2-4
TGCAGTTACGGGACCCACACTGAAGCTTTCTTT	CSYGTHTEAFF	TRBV20-1	TRBJ1-1
TGTGCCAGCAGTTACTCCCCCACGGAGTCCTACAATGAGCAGTTCTTC	CASSYSPTESYNEQFF	TRBV6-6	TRBJ2-1
TGTGCCAGCAGCTATTTGGGGGGGTGGGCACCCGGGGAGCTGTTTTTT	CASSYLGGWAPGELFF	TRBV11-2	TRBJ2-2
TGTGCCAGCAGCGGGCCCAATTCACCCCTCCACTTT	CASSGPNSPLHF	TRBV7-3	TRBJ1-6
TGCGCCAGCAGTGAGGTCGGGTGGCAATGGCAAGAGACCCAGTACTTC	CASSEVGWQWQETQYF	TRBV10-1	TRBJ2-5
TGTGCCAGCAGACTATGTAATTCACCCCTCCACTTT	CASRLCNSPLHF	TRBV5-6	TRBJ1-6
TGTGCCAGTAGTATATATAAATGGGGACAGGCTAACTATGGCTACACCTTC	CASSIYKWGQANYGYTF	TRBV19	TRBJ1-2
TGTGCCAGCAGTTCTAGGGAATCCACTGAAGCTTTCTTT	CASSSRESTEAFF	TRBV28	TRBJ1-1
TGTGCCAGTAGTATATTCGACAGGGGGGGTCCCAAGAACACTGAAGCTTTCTTT	CASSIFDRGGPKNTEAFF	TRBV19	TRBJ1-1
TGTGCCAGCAGCTTTTTACAGGGAGCGAGAATTGTTCACTCTGGAAACACCATATATTTT	CASSFLQGARIVHSGNTIYF	TRBV7-2	TRBJ1-3
TGTGCCAGCAGCGGGGCGGGACTAGATTTGGGTGAGTTCCAGTACTTC	CASSGAGLDLGEFQYF	TRBV6-4	TRBJ2-5
TGTGCCAGTAGTCTGGGCCACCGCCCCTTAGCGGGAAATCAAGAGACCCAGTACTTC	CASSLGHRPLAGNQETQYF	TRBV19	TRBJ2-5
TGTGCACCGGTTGGGACAGATCAAACAAACACCATATATTTT	CAPVGTDQTNTIYF	TRBV7-7	TRBJ1-3
TGTGCCAGCAGATTAGACAGGAGTTTTAACTATGGCTACACCTTC	CASRLDRSFNYGYTF	TRBV2	TRBJ1-2
TGTGCCAGCAGCCAAGACCCGACAGGGGGCGCTAATCGCCCGAACACTGAAGCTTTCTTT	CASSQDPTGGANRPNTEAFF	TRBV4-2	TRBJ1-1
TGTGCCAGCAGCCCACGTTCCGGGGGACATACGGGCCAGCGCAAGGGCTACACCTTC	CASSPRSGGHTGQRKGYTF	TRBV7-2	TRBJ1-2
TGTGCCAGTGGGACAGGACAGTACGGCTACACCTTC	CASGTGQYGYTF	TRBV6-4	TRBJ1-2
TGTGCCACGGTTAGGGGAGCCGGGGAGCTGTTTTTT	CATVRGAGELFF	TRBV24-1	TRBJ2-2
TGTGCCAGCAACCCGGGGAGGCAGGATACCCACGACACAGATACGCAGTATTTT	CASNPGRQDTHDTDTQYF	TRBV28	TRBJ2-3
TGTGCCAGCATTTCGGGGGCCATTCAGTACTTC	CASISGAIQYF	TRBV27	TRBJ2-4
TGCGCCAGCAGCTCAAAGGGGGACTACGAGCAGTACTTC	CASSSKGDYEQYF	TRBV5-1	TRBJ2-7
TGCAGCGTCCTTACTAGCGGGATCGCCGGGGGTTCCTACGAGCAGTACTTC	CSVLTSGIAGGSYEQYF	TRBV29-1	TRBJ2-7
TGCGCCAGCAGCTTAACCGGAGAGGACAGGTGTGGCTACACCTTC	CASSLTGEDRCGYTF	TRBV5-1	TRBJ1-2
TGTGCCAGCAGTTACCCGCGGGGGTTGCACGGAAGCTCCTACAATGAGCAGTTCTTC	CASSYPRGLHGSSYNEQFF	TRBV6-5	TRBJ2-1
TGTGCCAGCAGCCTACCTTTACCCGGGGGGAAACTCACTGAAGCTTTCTTT	CASSLPLPGGKLTEAFF	TRBV5-5	TRBJ1-1
TGTGCCAGCAGTTACTCGACCCCCCCCCGAACAGGGATAAGTCATGGCTACACCTTC	CASSYSTPPRTGISHGYTF	TRBV6-2	TRBJ1-2
TGTGCCAGCAGTTACCACCCGATCTGGGGGAAGCACTATGGCTACACCTTC	CASSYHPIWGKHYGYTF	TRBV6-9	TRBJ1-2
TGTGCCAGCCTCCAGTGGGGAAACACCATATATTTT	CASLQWGNTIYF	TRBV5-4	TRBJ1-3
TGTGCTAGTGGTTTGGTCCCCCAGGGCTTGCAAAATCAGCCCCAGCATTTT	CASGLVPQGLQNQPQHF	TRBV12-5	TRBJ1-5
TGTGCCAGCAGCTTAACGTGTACCGCCCCCCCGGACGTACGTCCTAACTATGGCTACACCTTC	CASSLTCTAPPDVRPNYGYTF	TRBV7-3	TRBJ1-2
TGTGCCAAGGGCGGGACTCCTGGAAACACCATATATTTT	CAKGGTPGNTIYF	TRBV30	TRBJ1-3
TGTGCCAGCAGTTTATGCAACCATTCGGGATTAGCGGATGAGCAGTTCTTC	CASSLCNHSGLADEQFF	TRBV28	TRBJ2-1
TGTGCCAGCAGCACGAATTACACCCGTAATTCACCCCTCCACTTT	CASSTNYTRNSPLHF	TRBV13	TRBJ1-6
TGTGCCAGCACCCCGTCTAGCGGGGAGGATTGGGTGTTAGCCAAAAACATTCAGTACTTC	CASTPSSGEDWVLAKNIQYF	TRBV12-4	TRBJ2-4
TGTGCTAGTGGTTTGGGGGACAGGGAGGATGGCTACACCTTC	CASGLGDREDGYTF	TRBV12-5	TRBJ1-2
TGCAGTGCGGGGTGTAGCAGAGGGAATGGCTACACCTTC	CSAGCSRGNGYTF	TRBV20-1	TRBJ1-2
TGTGCCACCCCTCTAAACCATCAGGGGGCCCACAATGAGCAGTTCTTC	CATPLNHQGAHNEQFF	TRBV27	TRBJ2-1
TGTGCCAGCAGCTTGTGTAGCGGGTTGTACAATGAGCAGTTCTTC	CASSLCSGLYNEQFF	TRBV7-9	TRBJ2-1
TGTGCCAGCAGTTGGTGTGGGGGGATTGCGGCTCGGGAGAATCAGCCCCAGCATTTT	CASSWCGGIAARENQPQHF	TRBV28	TRBJ1-5
TGTGCTAGTGGTTTGGAAGGGGAGGTACATTACGAGCAGTACTTC	CASGLEGEVHYEQYF	TRBV12-5	TRBJ2-7
TGCAGTGCCCTGGACAGGCATTTT	CSALDRHF	TRBV20-1	TRBJ1-5
TGTGCCAGCAGTGACCAGGGACAGGCCGGTCTTGGAAACACTGAAGCTTTCTTT	CASSDQGQAGLGNTEAFF	TRBV6-4	TRBJ1-1
TGTGCCAGCAGCAATGTTCGAGCAACCGAGCAGTACTTC	CASSNVRATEQYF	TRBV7-2	TRBJ2-7
TGTGCCAGCAGTTTGGTCAGGGACCTAAATTCACCCCTCCACTTT	CASSLVRDLNSPLHF	TRBV6-5	TRBJ1-6
TGCGCCAGCAGGATCGGATCCCGGGGTGAGCAGTTCTTC	CASRIGSRGEQFF	TRBV10-1	TRBJ2-1
TGTGCCAGCAGCAGCGTTAGGATCCGGAGCTACAATGAGCAGTTCTTC	CASSSVRIRSYNEQFF	TRBV9	TRBJ2-1
TGTGCCAACAGGACTGAAGCTTTCTTT	CANRTEAFF	TRBV6-6	TRBJ1-1
TGTGCCAGCAGCGTCGACAGTGGTGGATGCCGGTACGAGCAGTACTTC	CASSVDSGGCRYEQYF	TRBV9	TRBJ2-7
TGTGCCAGCAGCCGGGCTATAAGCGCCGGGGGCTACACCTTC	CASSRAISAGGYTF	TRBV7-3	TRBJ1-2
TGTGCCAGCGAGGGGGGGGATCCCTACGAGCAGTACTTC	CASEGGDPYEQYF	TRBV28	TRBJ2-7
TGTGCCAGCAGTGCCGCAACTGGTCAGCCCCAGCATTTT	CASSAATGQPQHF	TRBV12-4	TRBJ1-5
TGTGCTAGCAGCTTTGAGGACAGAGAAGTCTCTGGAAACACCATATATTTT	CASSFEDREVSGNTIYF	TRBV7-7	TRBJ1-3
TGTGCCACCAGTGATTTAACACTAACTCCTCTACCGGGACAGGGAGAGGGTGAAGCTTTCTTT	CATSDLTLTPLPGQGEGEAFF	TRBV24-1	TRBJ1-1
TGTGCCAGCACCTATGCTATAAGTGGCTACACCTTC	CASTYAISGYTF	TRBV12-3	TRBJ1-2
TGTGCCAGCAGTGATGATGGTCCCAGCGAGAAAATACTGGGTGTCAGCACAGATACGCAGTATTTT	CASSDDGPSEKILGVSTDTQYF	TRBV25-1	TRBJ2-3
TGTGCCAGCAGCTTGGAGGGGGACTCCTATAATTCACCCCTCCACTTT	CASSLEGDSYNSPLHF	TRBV5-4	TRBJ1-6
TGTGCCAGCAGTGAGTTGTCCGGGACTAGCATTAGAAACATTCAGTACTTC	CASSELSGTSIRNIQYF	TRBV2	TRBJ2-4
TGTGCCAGCAGCGGGACTACCGGCTACGAGCAGTACTTC	CASSGTTGYEQYF	TRBV7-2	TRBJ2-7
TGTGCCCCGGGGGCGGCCTACGAGCAGTACTTC	CAPGAAYEQYF	TRBV30	TRBJ2-7
TGTGCCGGAATTACAAGACAGGGGGTGGGTAGCACAGATACGCAGTATTTT	CAGITRQGVGSTDTQYF	TRBV6-5	TRBJ2-3
TGTGCCAGCAGTTTATCCGGGACTAGCGCCTTGACCCAGTACTTC	CASSLSGTSALTQYF	TRBV27	TRBJ2-5
TGTGCCAGCAGTCTCTCCCGGACAGGGGAGCCGAATGAAAAACTGTTTTTT	CASSLSRTGEPNEKLFF	TRBV28	TRBJ1-4
TGTGCCAGCAGTTACAGTGCCAGGGAAGATGGCTACACCTTC	CASSYSAREDGYTF	TRBV6-5	TRBJ1-2
TGTGCCATCAGTGACCAGGGGGCGGGTCCCACTGAAGCTTTCTTT	CAISDQGAGPTEAFF	TRBV10-3	TRBJ1-1
TGCGCCAGCAGCCGCGGCGGCGGGAGGCCCGCGGGACTTGGGGGGTCACCCCTCCACTTT	CASSRGGGRPAGLGGSPLHF	TRBV4-1	TRBJ1-6
TGTGCCAGCAGCCCGGGGCCTCACACCGGGGAGCTGTTTTTT	CASSPGPHTGELFF	TRBV27	TRBJ2-2
TGCGCCAGCAACACTCTGACACTCCGGGGGCGGAATAAGGACAATGAGCAGTTCTTC	CASNTLTLRGRNKDNEQFF	TRBV10-1	TRBJ2-1
TGTGCCAGCAGAGGGCGGGAGCGTTATCGAGATGGCTACACCTTC	CASRGRERYRDGYTF	TRBV28	TRBJ1-2
TGTGCTAGTGGTTTATTTACCGGGACAGGGAGCCAAACAATGAACACTGAAGCTTTCTTT	CASGLFTGTGSQTMNTEAFF	TRBV12-5	TRBJ1-1
TGTGCCAGAGAGGGCGTTGCCGGGAGCTACGAGCAGTACTTC	CAREGVAGSYEQYF	TRBV6-4	TRBJ2-7
TGTGCCAGAAAGGCGGGGGGGCGGAAGGACGAAGCCTGCACAGATACGCAGTATTTT	CARKAGGRKDEACTDTQYF	TRBV19	TRBJ2-3
TGTGCCAGCAGACCAGCTCTAGACACAGATACGCAGTATTTT	CASRPALDTDTQYF	TRBV7-8	TRBJ2-3
TGCGCCAGCAGTAGTGCGAGGCCCTCGCCCCAGCATTTT	CASSSARPSPQHF	TRBV10-1	TRBJ1-5
TGTGCCACCAGTGCGGTCCTTTGGACTTTGTGTGGGGCTGAAGCTTTCTTT	CATSAVLWTLCGAEAFF	TRBV24-1	TRBJ1-1
TGTGCCAGCAGTGTCAACATGGGACTAGCGGGCATCCCCTGGTTACGTAGGACGGGGGTCTCCTACGAGCAGTACTTC	CASSVNMGLAGIPWLRRTGVSYEQYF	TRBV6-3	TRBJ2-7
TGTGCCAGCAGTGACGGGGGGAACGCTTATAGCAATCAGCCCCAGCATTTT	CASSDGGNAYSNQPQHF	TRBV6-4	TRBJ1-5
TGTGCCAGCAGCTTAAAGGAAAGGGACAGGGAGTATTCACCCCTCCACTTT	CASSLKERDREYSPLHF	TRBV7-2	TRBJ1-6
TGTGCCAGCAGTTTATTGTCCCCCACCAGGGGGCTACACAGGGGGCAGAGCAATCAGCCCCAGCATTTT	CASSLLSPTRGLHRGQSNQPQHF	TRBV28	TRBJ1-5
TGTGCCAGCATCTATCTATTCGGCCGGGACAGGGGGGGGGCGGGTTTCAGCACAGATACGCAGTATTTT	CASIYLFGRDRGGAGFSTDTQYF	TRBV27	TRBJ2-3
TGTGCCAGCAGTGCCGGTGCGGGAAAGAAGGCCACTGAAGCTTTCTTT	CASSAGAGKKATEAFF	TRBV27	TRBJ1-1
TGTGCCAGCAGTTTATGTCGAGGGCTATACATGAACACTGAAGCTTTCTTT	CASSLCRGLYMNTEAFF	TRBV27	TRBJ1-1
TGTCAGGGGGCGCGCTCGCCCAATCAGCCCCAGCATTTT	CQGARSPNQPQHF	TRBV6-1	TRBJ1-5
TGTGCCAGCAGTAAAAGTAATGAAAAACTGTTTTTT	CASSKSNEKLFF	TRBV6-4	TRBJ1-4
TGTGCCAGCAGTTCTAGCCACCCTCTGACAGGCTCCACCTACGAGCAGTACTTC	CASSSSHPLTGSTYEQYF	TRBV12-3	TRBJ2-7
TGCGCCAGCAGTCCGACGGGAGGAGAAGCTTTCTTT	CASSPTGGEAFF	TRBV5-1	TRBJ1-1
TGCGCCAGCAGTGAGTCGAAATGGGAGGGAAGCACAGATACGCAGTATTTT	CASSESKWEGSTDTQYF	TRBV10-1	TRBJ2-3
TGTGCCACCACGGGGGCCTACTACGAGCAGTACTTC	CATTGAYYEQYF	TRBV24-1	TRBJ2-7
TGTGCCAGCAGCCAACTTATCTCCGACAGGGCACCCTTGTCACCCCTCCACTTT	CASSQLISDRAPLSPLHF	TRBV14	TRBJ1-6
TGTGCCACCAGTGGTGAGGCCCGGGGGGGCACAAAAGAGACCCAGTACTTC	CATSGEARGGTKETQYF	TRBV24-1	TRBJ2-5
TGTGCCAGCAGTGAGGACAGGAATTTAGATACGCAGTATTTT	CASSEDRNLDTQYF	TRBV25-1	TRBJ2-3
TGTGCCAGCAGCGGGCAGGGACCCCTGGGGGCCAACGTCCTGACTTTC	CASSGQGPLGANVLTF	TRBV5-4	TRBJ2-6
TGTGCCACCATAAGGACAGGGCCGCAAGAGACCCAGTACTTC	CATIRTGPQETQYF	TRBV28	TRBJ2-5
TGCGCCAGCAGTGACCGGACTAGCGGAGGGGCTGGACCAGTAGCCAAAAACATTCAGTACTTC	CASSDRTSGGAGPVAKNIQYF	TRBV10-1	TRBJ2-4
TGTGCCAGCAGCAGGGTGGGACTGCAGCCCCAGCATTTT	CASSRVGLQPQHF	TRBV9	TRBJ1-5
TGTGCCAGCAGCCCCTGGAGGGCCGGGACAGGGCCTCCTGGGGCCAACGTCCTGACTTTC	CASSPWRAGTGPPGANVLTF	TRBV5-5	TRBJ2-6
TGTGCCAGCAGCTACCTACAGGGCACCAGTGGCTACACCTTC	CASSYLQGTSGYTF	TRBV5-6	TRBJ1-2
TGTGCCTGGAGGGGGGGGTTGCATGAAGCTTTCTTT	CAWRGGLHEAFF	TRBV30	TRBJ1-1
TGCGCCAGCAATAAACGGGCGGGCGAGACTAGCAATCAGCCCCAGCATTTT	CASNKRAGETSNQPQHF	TRBV10-1	TRBJ1-5
TGTGCCACCGGTGTGAGGAAGACAACTAATGAAAAACTGTTTTTT	CATGVRKTTNEKLFF	TRBV24-1	TRBJ1-4
TGTGCCAGCAGTGAACCCTTTGGAGGCAGGAACTACGAGCAGTACTTC	CASSEPFGGRNYEQYF	TRBV6-4	TRBJ2-7
TGTGCCACCAGTGCCCCGGGGGGCCACGATACGCAGTATTTT	CATSAPGGHDTQYF	TRBV24-1	TRBJ2-3
TGCAGCGTTGCCGGACAGGGCTACGAGCAGTACTTC	CSVAGQGYEQYF	TRBV29-1	TRBJ2-7
TGTGCCAGCAGCCAGTTAGACGAGCAGTACTTC	CASSQLDEQYF	TRBV7-3	TRBJ2-7
TGTGCCAGCAGCTTAGCGATGCCTACTCAGACAGGGGGCGGTAACTATGGCTACACCTTC	CASSLAMPTQTGGGNYGYTF	TRBV7-8	TRBJ1-2
TGTGCCAGCAGCGGTATTTCTGGGGTCAATGAGCAGTTCTTC	CASSGISGVNEQFF	TRBV7-4	TRBJ2-1
TGTGCCAGCAGCTTCCAAGTCCACAGGACAGGGGTATCTCCGGGGTCCCGGACTGAAGCTTTCTTT	CASSFQVHRTGVSPGSRTEAFF	TRBV5-4	TRBJ1-1
TGTGCCAGCAGTAGGGGGCCGGGGAGGGACTCTCAGGAAAAACTGTTTTTT	CASSRGPGRDSQEKLFF	TRBV12-4	TRBJ1-4
TGTGCCAGCAGCCAAGGAACCGACAGGGAGACTGTCTCTGGGGCCAACGTCCTGACTTTC	CASSQGTDRETVSGANVLTF	TRBV4-2	TRBJ2-6
TGCAGCAGGGGGGGGGTCTACGAGCAGTACTTC	CSRGGVYEQYF	TRBV20-1	TRBJ2-7
TGTGCCAGCAGCCGAAGGGGAGCGGGACGCACTGAAGCTTTCTTT	CASSRRGAGRTEAFF	TRBV13	TRBJ1-1
TGTGCCAGCACCCTTCACGGGACAGTGAACACCGGGGAGCTGTTTTTT	CASTLHGTVNTGELFF	TRBV2	TRBJ2-2
TGTGCCAGCAGTTTGGGTGACAGGGTATACGAGCAGTACTTC	CASSLGDRVYEQYF	TRBV28	TRBJ2-7
TGTGCCAGCAGCTTGGGGGTAAGACTCGGGTCTGAAAAACTGTTTTTT	CASSLGVRLGSEKLFF	TRBV5-4	TRBJ1-4
TGCGCCAGCACTTTAAGAGGAGGGGTCGAGCAGTACTTC	CASTLRGGVEQYF	TRBV5-1	TRBJ2-7
TGCAGCGTTGAGGCGACAGGCTGCACAGATACGCAGTATTTT	CSVEATGCTDTQYF	TRBV29-1	TRBJ2-3
TGTGCCTGTATGGGGCTCCCCTATGGCTACACCTTC	CACMGLPYGYTF	TRBV27	TRBJ1-2
TGTGCCAGCAGCTTAAATCTGGGACTAGCAGCGCAGTTCTTC	CASSLNLGLAAQFF	TRBV7-3	TRBJ2-1
TGTGCCAGCAGCCGTTGGAGCAGAAATGGCTACACCTTC	CASSRWSRNGYTF	TRBV7-8	TRBJ1-2
TGTGCCAGCAGTGACCGGATTGGACTTTGTACGGCCGGGCCGCAAGAGACCCAGTACTTC	CASSDRIGLCTAGPQETQYF	TRBV2	TRBJ2-5
TGTGCCAGCAGCTCGAATGACAGGGGCCCCGACAAAAACTATGGCTACACCTTC	CASSSNDRGPDKNYGYTF	TRBV7-3	TRBJ1-2
TGTGCCAGCAGGATCCTGTTACCTATTCCTAGCACAGATACGCAGTATTTT	CASRILLPIPSTDTQYF	TRBV2	TRBJ2-3
TGTGCCAGTTGTAGGGGAGAAAAACTGTTTTTT	CASCRGEKLFF	TRBV19	TRBJ1-4
TGTGCCAGCAACGGGGGGTCCTACAATGAGCAGTTCTTC	CASNGGSYNEQFF	TRBV27	TRBJ2-1
TGCGCCAGCAGGGGGGGTCCAACCCAGTACTTC	CASRGGPTQYF	TRBV10-1	TRBJ2-5
TGTGCCAGCTTAACGGAATTGTTGAGCAATCAGCCCCAGCATTTT	CASLTELLSNQPQHF	TRBV2	TRBJ1-5
TGTGCCAGCAGGGAGAATAATGAGACCCAGTACTTC	CASRENNETQYF	TRBV7-8	TRBJ2-5
TGTGCCAGCAGTTACACGATCAGCACAGATACGCAGTATTTT	CASSYTISTDTQYF	TRBV6-5	TRBJ2-3
TGTGCCAGCAGCGAGGCCCGGATGGGTAACACTGAAGCTTTCTTT	CASSEARMGNTEAFF	TRBV14	TRBJ1-1
TGTGCCAGCAGTAAAACCTATTTAAAGGGACAGGGTGGGGTCGAGACCCAGTACTTC	CASSKTYLKGQGGVETQYF	TRBV2	TRBJ2-5
TGCAGTGCTAGCCCGGACAGGGGGCGAACTGAAGCTTTCTTT	CSASPDRGRTEAFF	TRBV20-1	TRBJ1-1
TGTGCCATAACTGGGGAGGCGGCGAGGACGGCTGAAGCTTTCTTT	CAITGEAARTAEAFF	TRBV6-3	TRBJ1-1
TGCGCCAGCACAACCATACTCAATCAGCCCCAGCATTTT	CASTTILNQPQHF	TRBV5-1	TRBJ1-5
TGTGCCAGCAGCGGGGAGGGCACGTTGGGCTACACCTTC	CASSGEGTLGYTF	TRBV9	TRBJ1-2
TGCAGTGCTAGGTATCGCCCTGGGAGGAATCAGCCCCAGCATTTT	CSARYRPGRNQPQHF	TRBV20-1	TRBJ1-5
TGTGCCAGCAGCCCCGTCAGGGCTTATGGCTACACCTTC	CASSPVRAYGYTF	TRBV9	TRBJ1-2
TGTGCCAGCAGGTATCCCCCCAGGCGGAACATTCAGTACTTC	CASRYPPRRNIQYF	TRBV6-1	TRBJ2-4
TGCGCCAGCAGCTTCGGACAGCGAGGCAATCAGCCCCAGCATTTT	CASSFGQRGNQPQHF	TRBV5-1	TRBJ1-5
TGCGCCAGCAGCTTGGTAATCGGCGATAATGAGCAGTTCTTC	CASSLVIGDNEQFF	TRBV5-1	TRBJ2-1
TGCGCCAGCAGCTTGAAAGGAAGGATGGGGACTAGCCCGGCCTACGAGCAGTACTTC	CASSLKGRMGTSPAYEQYF	TRBV5-1	TRBJ2-7
TGTGCCAGCAGCTTAAACGGACGTACTAGCAATCAGCCCCAGCATTTT	CASSLNGRTSNQPQHF	TRBV7-3	TRBJ1-5
TGCGCCAGCAGCACCGGGACAGGGTGTAACTATGGCTACACCTTC	CASSTGTGCNYGYTF	TRBV5-1	TRBJ1-2
TGTGCCAGCAGCGCTTGGACGGATCGAAATTCCACCTTC	CASSAWTDRNSTF	TRBV9	TRBJ1-2
TGCGCCAGCAAGAGGCCCCTGGCATTATCCCGGGACCCCCACACAGATACGCAGTATTTT	CASKRPLALSRDPHTDTQYF	TRBV4-3	TRBJ2-3
TGCAGTGCGCCGGGACAGGAATTGTTCGAGCAGTACTTC	CSAPGQELFEQYF	TRBV20-1	TRBJ2-7
TGTGCCAGCAGCCCACAGAGGTGGGACAGGGGATTTGTAAACTATGGCTACACCTTC	CASSPQRWDRGFVNYGYTF	TRBV7-3	TRBJ1-2
TGTGCCACCCGAGCCTACGAGCAGTACTTC	CATRAYEQYF	TRBV2	TRBJ2-7
TGCGCCAGCAGCCGGAGCAGGGATGGGGAGCGCAGCTCTGGAAACACCATATATTTT	CASSRSRDGERSSGNTIYF	TRBV4-1	TRBJ1-3
TGCGCCAGCAGCCGGGGCCCGGGGGGACCGGACAACTACGAGCAGTACTTC	CASSRGPGGPDNYEQYF	TRBV5-1	TRBJ2-7
TGCAGTGCTAGAGCCTACAGAGACAATGAGCAGTTCTTC	CSARAYRDNEQFF	TRBV20-1	TRBJ2-1
TGTGCCAGCAGCCCTAAGAGAGCTACCAGCACAGATACGCAGTATTTT	CASSPKRATSTDTQYF	TRBV3-1	TRBJ2-3
TGTGCCGAGCATCGGGGGCCCGATCAAGAGACCCAGTACTTC	CAEHRGPDQETQYF	TRBV6-4	TRBJ2-5
TGTGCCAGCAGCGTTGGTCCATTGGTCTATGGCTACACCTTC	CASSVGPLVYGYTF	TRBV13	TRBJ1-2
TGTGCCAGCAAGACAGGAACTCAAGAGACCCAGTACTTC	CASKTGTQETQYF	TRBV28	TRBJ2-5
TGCAGTGCTAGAGGAGAAGGCAGGACAGGGGGTGGAATGAACACTGAAGCTTTCTTT	CSARGEGRTGGGMNTEAFF	TRBV20-1	TRBJ1-1
TGTGCCAGCAGCCATTCGTACAGGGGGAACACTGAAGCTTTCTTT	CASSHSYRGNTEAFF	TRBV6-8	TRBJ1-1
TGTGCCAGCAGAACGTCGACAATAAATAACTATGGCTACACCTTC	CASRTSTINNYGYTF	TRBV6-5	TRBJ1-2
TGCGCCAGCACCCCCGGGACAGGGGCGCACACTGAAGCTTTCTTT	CASTPGTGAHTEAFF	TRBV10-1	TRBJ1-1
TGTGCCAGCTCACCAACGGGCGGGACGGGGAGCCGCTCCTACGAGCAGTACTTC	CASSPTGGTGSRSYEQYF	TRBV18	TRBJ2-7
TGTGCCAGCAGCTTAAGAGGGGCCTACGAGCAGTACTTC	CASSLRGAYEQYF	TRBV7-4	TRBJ2-7
TGTGCCACCAGCAGAGGAAGGACCGACTTC	CATSRGRTDF	TRBV15	TRBJ2-7
TGTGCCAGCAGCATAGGGACTAGCGGCCGAAGGCCATACAATGAGCAGTTCTTC	CASSIGTSGRRPYNEQFF	TRBV5-8	TRBJ2-1
TGTGCCAGCGGGCACGAGCAGTACTTC	CASGHEQYF	TRBV6-2	TRBJ2-7
TGTGCCAGCAGGGACAGGGCAGCGAACACTGAAGCTTTCTTT	CASRDRAANTEAFF	TRBV27	TRBJ1-1
TGTGCCACCAGCGGTAAGGACAGGGGGTCCGAAACTGAAGCTTTCTTT	CATSGKDRGSETEAFF	TRBV15	TRBJ1-1
TGTGCCAGCAGCATGGCTCAGTGGGGACAGGGGCATGGCTACACCTTC	CASSMAQWGQGHGYTF	TRBV5-4	TRBJ1-2
TGTGCCAGCAGCTTACCGGGACAGGGGGGTAGCAATCAGCCCCAGCATTTT	CASSLPGQGGSNQPQHF	TRBV13	TRBJ1-5
TGTGCCAGCAGCCAAGAAAAGTACAGCCGGTCAGATACGCAGTATTTT	CASSQEKYSRSDTQYF	TRBV3-1	TRBJ2-3
TGTGCCACCAGTGATGTATCCCATCCTACGGGGGTCCAGCCCCAGCATTTT	CATSDVSHPTGVQPQHF	TRBV24-1	TRBJ1-5
TGTGCCAGCAGTTTAGGTAGGAGAGTATTGGGCACAGATACGCAGTATTTT	CASSLGRRVLGTDTQYF	TRBV28	TRBJ2-3
TGTGCCAGCAGCCGGACGCCGGGACAGAGAGGCTACGAGCAGTACTTC	CASSRTPGQRGYEQYF	TRBV7-9	TRBJ2-7
TGTGCCAGCAGTCTGCACGGGGGGGAAGAGGGGGCAGATACGCAGTATTTT	CASSLHGGEEGADTQYF	TRBV2	TRBJ2-3
TGTGCCAGCAGCCACCAGGACAGATCTCCAGATACGCAGTATTTT	CASSHQDRSPDTQYF	TRBV13	TRBJ2-3
TGCAGCCAGTTTCAGTTTGAAATGAACACTGAAGCTTTCTTT	CSQFQFEMNTEAFF	TRBV29-1	TRBJ1-1
TGTGCCAGCAGTGACTCGCGGGACAGGGGGCTCAACACTGAAGCTTTCTTT	CASSDSRDRGLNTEAFF	TRBV6-4	TRBJ1-1
TGTGCCAGCAGCCTCTCAAGGAACAGGTATAGCAATCAGCCCCAGCATTTT	CASSLSRNRYSNQPQHF	TRBV13	TRBJ1-5
TGTGCCAGCAGCTCTGGCTCCTCAGAGCGCGAGCAGTACTTC	CASSSGSSEREQYF	TRBV5-6	TRBJ2-7
TGTGCCAGCAGTGATACTTTAGACGCAGATACGCAGTATTTT	CASSDTLDADTQYF	TRBV6-1	TRBJ2-3
TGTGCCAGCAGTGGGACAGAATCAGATACGCAGTATTTT	CASSGTESDTQYF	TRBV12-3	TRBJ2-3
TGTGCCAGCTCACCAACTAGCGGGAGAATGGATACAGATACGCAGTATTTT	CASSPTSGRMDTDTQYF	TRBV18	TRBJ2-3
TGCGCCAGCAGCTACCCGGGACAGGGGGAGAGCAATCAGCCCCAGCATTTT	CASSYPGQGESNQPQHF	TRBV5-1	TRBJ1-5
TGTGCCATAATAGCGGGGGTTCCTAGGCACCACAATGAGCAGTTCTTC	CAIIAGVPRHHNEQFF	TRBV28	TRBJ2-1
TGTGCCACACTAGCGGGAGGGCGGTTCGGCTACACCTTC	CATLAGGRFGYTF	TRBV24-1	TRBJ1-2
TGTGCCAGCAGTGAATACGACAGTTACGAGCAGTACTTC	CASSEYDSYEQYF	TRBV2	TRBJ2-7
TGCGCCAGCTTCACCGGGACTAGCGGGAGAGATACGCAGTATTTT	CASFTGTSGRDTQYF	TRBV4-3	TRBJ2-3
TGTGCCTGGGATCGGCTAGGTCATTACGAGCAGTACTTC	CAWDRLGHYEQYF	TRBV10-3	TRBJ2-7
TGTGCCAGCATTAGGCCCTCCGGGACAGGGGCAGATACGCAGTATTTT	CASIRPSGTGADTQYF	TRBV6-2	TRBJ2-3
TGTGCCAGCAGTTTATTTGTCTCTTGCTACGAGCAGTACTTC	CASSLFVSCYEQYF	TRBV28	TRBJ2-7
TGTGCCAGCTCACCTGGGCAGCCCCAGCATTTT	CASSPGQPQHF	TRBV18	TRBJ1-5
TGTGCCAGCAGCCATCTGGGGGGGCCATGCACAGATACGCAGTATTTT	CASSHLGGPCTDTQYF	TRBV3-1	TRBJ2-3
TGTGCCACCAGCAGAGTGTCCAAGGCCAGGATGTACAATGAGCAGTTCTTC	CATSRVSKARMYNEQFF	TRBV15	TRBJ2-1
TGCGCCAGCAGCCAAGCCACAGGATCCGGTAGAGATACGCAGTATTTT	CASSQATGSGRDTQYF	TRBV4-1	TRBJ2-3
TGTGCCAGCAGCCAACTGCCCGGGACAGGACTTTTCCGAAATGAGCAGTTCTTC	CASSQLPGTGLFRNEQFF	TRBV14	TRBJ2-1
TGTGCCAGCAGTGAGACTCCCGTGCGGGGGTGGTCATCATACGAGCAGTACTTC	CASSETPVRGWSSYEQYF	TRBV6-1	TRBJ2-7
TGTGCCAGCAGTTACTCGCCTGTTTGGCGGGGAACCACTGAAGCTTTCTTT	CASSYSPVWRGTTEAFF	TRBV6-8	TRBJ1-1
TGTGCCAAAGGAGGGGGCCAAGAGACCCAGTACTTC	CAKGGGQETQYF	TRBV30	TRBJ2-5
TGTGCCAGCAGTCCGAAGGGGGGGTACAATGAGCAGTTCTTC	CASSPKGGYNEQFF	TRBV6-3	TRBJ2-1
TGCAGCGCCTTAGGGGGGGGACTCTCCGGCTACACCTTC	CSALGGGLSGYTF	TRBV29-1	TRBJ1-2
TGTGCCAGCAGCTTACTGGGCCCGGGGACCACGCCCCAGCATTTT	CASSLLGPGTTPQHF	TRBV7-2	TRBJ1-5
TGCGCCAGCAGCTTGGCTAAGGGGAATCAGCCCCAGCATTTT	CASSLAKGNQPQHF	TRBV5-1	TRBJ1-5
TGTGCCAGCAGCCCCCCAGGGGGCTATAGCAATCAGCCCCAGCATTTT	CASSPPGGYSNQPQHF	TRBV7-4	TRBJ1-5
TGTGCCAGCATAAGGACAGGGAGCAATCAGCCCCAGCATTTT	CASIRTGSNQPQHF	TRBV14	TRBJ1-5
TGTGCCAGCAGTGAGCTCCCGGGACAGGGGCGTAGGAGCCATCAGCCCCAGCATTTT	CASSELPGQGRRSHQPQHF	TRBV6-4	TRBJ1-5
TGTGCCACCGGGACCTATGGCTACACCTTC	CATGTYGYTF	TRBV3-1	TRBJ1-2
TGTGCCAGCAGTTGGCCCGGGACTCCGGTTTGCAAAAGCAATCAGCCCCAGCATTTT	CASSWPGTPVCKSNQPQHF	TRBV27	TRBJ1-5
TGCACAGTATCTCCCCCACCGGGACAGGGTGCGGTCACCGGGGAGCTGTTTTTT	CTVSPPPGQGAVTGELFF	TRBV20-1	TRBJ2-2
TGTGCCAGCACTCCCGGGACATGCTACAATGAGCAGTTCTTC	CASTPGTCYNEQFF	TRBV5-4	TRBJ2-1
TGTGCCAGCAGCGAGCTGAGGACAGGTCCCTCTGGAAACACCATATATTTT	CASSELRTGPSGNTIYF	TRBV7-3	TRBJ1-3
TGTGCCTGGAGCCCCCACAGGGTGAACACTGAAGCTTTCTTT	CAWSPHRVNTEAFF	TRBV30	TRBJ1-1
TGTGCCAGCCGAGAACAATTTGGGACAGGGGCCAATTCACCCCTCCACTTT	CASREQFGTGANSPLHF	TRBV27	TRBJ1-6
TGTGCCAGTTATGTACAGGGGAGAGCCAAAAACATTCAGTACTTC	CASYVQGRAKNIQYF	TRBV27	TRBJ2-4
TGTGCCAGCAGCAGAACTCGCGGGGGCTTCCAGTACTTC	CASSRTRGGFQYF	TRBV7-3	TRBJ2-4
TGCAGTGCTAGAGACCCCTGGGCCCTCCCTGGAAACACCATATATTTT	CSARDPWALPGNTIYF	TRBV20-1	TRBJ1-3
TGTGCCAGCAGCGTTCTCAAACTAGATATACAAGAGACCCAGTACTTC	CASSVLKLDIQETQYF	TRBV7-2	TRBJ2-5
TGTGCCAGCAGCCAAGAGGGCGGGACAACGAGGGCGGCCGGGGAGCTGTTTTTT	CASSQEGGTTRAAGELFF	TRBV3-1	TRBJ2-2
TGTGCCAGCATATGTAGGGGGGGGCAGTACTTC	CASICRGGQYF	TRBV6-4	TRBJ2-7
TGCAGTGCGGGGGTGAGCTACGAGCAGTACTTC	CSAGVSYEQYF	TRBV20-1	TRBJ2-7
TGTGCCAGCAGCTTAGGACTTCTTGTACGGGGGACCAAAAGAGGCCGGAACTATGGCTACACCTTC	CASSLGLLVRGTKRGRNYGYTF	TRBV7-4	TRBJ1-2
TGTGCCAGCAGCTCATCGGGGTCATACGGCAATCAGCCCCAGCATTTT	CASSSSGSYGNQPQHF	TRBV11-3	TRBJ1-5
TGCGCCAGCAGCCAAGATCTAAAAGAAGACAGGTGGATGAACACTGAAGCTTTCTTT	CASSQDLKEDRWMNTEAFF	TRBV4-1	TRBJ1-1
TGTGCCAGTAGTATGTTAAGCGGGAGTTCGAACACTGAAGCTTTCTTT	CASSMLSGSSNTEAFF	TRBV19	TRBJ1-1
TGTGCCAAAAATCGCGTCCCTAGAAATAACACTTGCTATGGCTACACCTTC	CAKNRVPRNNTCYGYTF	TRBV7-9	TRBJ1-2
TGTGCCAGCAGTCGTCACCCCGGGACAGTAGCTCAGCCCCAGCATTTT	CASSRHPGTVAQPQHF	TRBV28	TRBJ1-5
TGTGCCATTTATGACGCCGGGGAGCTGTTTTTT	CAIYDAGELFF	TRBV7-9	TRBJ2-2
TGTGCCCCCCGTGGGCTAGGGGTAACCCAGTACTTC	CAPRGLGVTQYF	TRBV10-3	TRBJ2-5
TGTGCCAGCAGCTACTGGGGGCGGACCTACGAGCAGTACTTC	CASSYWGRTYEQYF	TRBV11-3	TRBJ2-7
TGTGCCAGCAGCGTGGGACTCTCGTACTTC	CASSVGLSYF	TRBV7-2	TRBJ2-7
TGTGCCAGCAGTGCTTCTGGCTTTAACAACAGGGGACGGGATGGCTACACCTTC	CASSASGFNNRGRDGYTF	TRBV6-4	TRBJ1-2
TGTGCCACCAGCCCCAGGGTGCCAGCCTACGAGCAGTACTTC	CATSPRVPAYEQYF	TRBV24-1	TRBJ2-7
TGTGCCAGCAGAGCAAGGCAAGAGACCCAGTACTTC	CASRARQETQYF	TRBV27	TRBJ2-5
TGCGCCAGCAGCAGACGCCCGAGCAATCAGCCCCAGCATTTT	CASSRRPSNQPQHF	TRBV5-1	TRBJ1-5
TGTGCCACCACCGTGGACAGGGGGCAAGGAAACACCATATATTTT	CATTVDRGQGNTIYF	TRBV24-1	TRBJ1-3
TGTGCCAGCAGCCCCATGGGGGCATCTAACTATGGCTACACCTTC	CASSPMGASNYGYTF	TRBV3-1	TRBJ1-2
TGTGCCAGCAGCCAAGGTTGGACCGGCTACAGCAATCAGCCCCAGCATTTT	CASSQGWTGYSNQPQHF	TRBV3-1	TRBJ1-5
TGTGCCAGCAGTAAGGGGGACAGGGTTACTGAAGCTTTCTTT	CASSKGDRVTEAFF	TRBV12-3	TRBJ1-1
TGTGCCAGCTCCGACGGGGAAGATTCACCCCTCCACTTT	CASSDGEDSPLHF	TRBV18	TRBJ1-6
TGTGCCACCCCCCGACACAGGGCTACTACTGAAGCTTTCTTT	CATPRHRATTEAFF	TRBV6-1	TRBJ1-1
TGCAGTGCTAGAGATGCCCCGGGGGGGGACGAGCAGTACTTC	CSARDAPGGDEQYF	TRBV20-1	TRBJ2-7
TGTGCCAGCAGCTTCGGGGGGCGCTACGAGCAGTACTTC	CASSFGGRYEQYF	TRBV7-8	TRBJ2-7
TGTGCCAGCAGTGATTGGACAGGGCCTGAAAAACTGTTTTTT	CASSDWTGPEKLFF	TRBV2	TRBJ1-4
TGTGCCAGCAGCCACGACAGTAGGGGCAAGCAGTACTTC	CASSHDSRGKQYF	TRBV6-5	TRBJ2-7
TGTGCCAGCAGCTTAGCGGACAGGGGAGACAAGGAGGCAGAGACCCAGTACTTC	CASSLADRGDKEAETQYF	TRBV7-4	TRBJ2-5
TGTGCCAGCAGCGCCCCACGGAGCGGCCTCTCCTACGAGCAGTACTTC	CASSAPRSGLSYEQYF	TRBV7-9	TRBJ2-7
TGTGCCAGCAGCCAAGATCCAAGGGGGGGCGGGGACTTC	CASSQDPRGGGDF	TRBV14	TRBJ2-7
TGCAGCGTGCCCCCGGGACAGCGGGATAACGAGCAGTACTTC	CSVPPGQRDNEQYF	TRBV29-1	TRBJ2-7
TGCAGTGCTAGAGATATTACAGGGGGGAGCTCTGGAAACACCATATATTTT	CSARDITGGSSGNTIYF	TRBV20-1	TRBJ1-3
TGTGCCTGGAGAGGGTTCCCATTCTACGAGCAGTACTTC	CAWRGFPFYEQYF	TRBV30	TRBJ2-7
TGTGCCAGCAGCCAAGAGATTGGACAGGGTTCATCTGAAGCTTTCTTT	CASSQEIGQGSSEAFF	TRBV14	TRBJ1-1
TGTGCCAGCAGCGGGGGATGCTATGGCTACACCTTC	CASSGGCYGYTF	TRBV5-5	TRBJ1-2
TGTGCCAGCAGCCGTGGACTCCGGGACAGGGGTAAACAGTCTGGGGCCAACGTCCTGACTTTC	CASSRGLRDRGKQSGANVLTF	TRBV9	TRBJ2-6
TGTGCCAGTAGGACTGGTGAAAAACTGTTTTTT	CASRTGEKLFF	TRBV19	TRBJ1-4
TGTGCCAGCAGTTTACAGGGGGTACATAATTCACCCCTCCACTTT	CASSLQGVHNSPLHF	TRBV27	TRBJ1-6
TGTGCTAGCAGCTTACCGACGGGGGGCGCGAACACCGGGGAGCTGTTTTTT	CASSLPTGGANTGELFF	TRBV7-7	TRBJ2-2
TGTGCCAGCAGTGAAGTGCCCCGACAGGGCGTGAACTATGGCTACACCTTC	CASSEVPRQGVNYGYTF	TRBV2	TRBJ1-2
TGTGTTGGTCAGCCCCAGCATTTT	CVGQPQHF	TRBV5-4	TRBJ1-5
TGCAGTGCGGGGGTGACAGGGTTCAATCAGCCCCAGCATTTT	CSAGVTGFNQPQHF	TRBV20-1	TRBJ1-5
TGTGCCAGCAGTGCGATCCGACAGCCGAACACTGAAGCTTTCTTT	CASSAIRQPNTEAFF	TRBV6-8	TRBJ1-1
TGTGCCAGCAGTTACTCGACCCCTCAGTGGGGGAGGAAGGACGAGCAGTACTTC	CASSYSTPQWGRKDEQYF	TRBV6-2	TRBJ2-7
TGTGCCAGCAGCACTGCCAGCGGCGTCACAGATACGCAGTATTTT	CASSTASGVTDTQYF	TRBV13	TRBJ2-3
TGCAGTGCTATCCCCTCTAGGGGGGGGGACGAGCAGTACTTC	CSAIPSRGGDEQYF	TRBV20-1	TRBJ2-7
TGTGCCAGCAGCTTGGTAAGGCCCGAAGACTCTGGAAACACCATATATTTT	CASSLVRPEDSGNTIYF	TRBV5-8	TRBJ1-3
TGCGCCAGCAGCCTCGGTGCCAGGGAAAGCTACGAGCAGTACTTC	CASSLGARESYEQYF	TRBV5-1	TRBJ2-7
TGTGCCAGGGGGAGGGCAATTCCTGGGGCCAACGTCCTGACTTTC	CARGRAIPGANVLTF	TRBV6-5	TRBJ2-6
TGTGCCAGCAGAGGGGGGAGATTGAACACTGAAGCTTTCTTT	CASRGGRLNTEAFF	TRBV12-3	TRBJ1-1
TGTGCCACCAAGCCAGGGGTTCCCCTGGCTGGAAACACCATATATTTT	CATKPGVPLAGNTIYF	TRBV24-1	TRBJ1-3
TGTGCCAGCAGCCAAGGGAGACCGGGACTAGCGGGAGGTGTGGATACTGAAGCTTTCTTT	CASSQGRPGLAGGVDTEAFF	TRBV3-1	TRBJ1-1
TGTGCTAGTGGTTACAGGGGCAATGAGCAGTTCTTC	CASGYRGNEQFF	TRBV12-5	TRBJ2-1
TGTGCCAGCTCGCGTAGACAGGTTATAATGGGCTATGGCTACACCTTC	CASSRRQVIMGYGYTF	TRBV18	TRBJ1-2
TGCGCCAGCAGCTTATTTAGACCCGGGGCCTACGAGCAGTACTTC	CASSLFRPGAYEQYF	TRBV5-1	TRBJ2-7
TGTGCCACCAGCAGAGTTCGGACAGGGAGCTCCTACGAGCAGTACTTC	CATSRVRTGSSYEQYF	TRBV15	TRBJ2-7
TGTGCCTGGAGTAACCCGGGACAGGGAAATCAGCCCCAGCATTTT	CAWSNPGQGNQPQHF	TRBV30	TRBJ1-5
TGTGCCACCAGTGATTTCCCCCTGGGGGCCTACAATGAGCAGTTCTTC	CATSDFPLGAYNEQFF	TRBV24-1	TRBJ2-1
TGTGCCAGCTCACCAGGAGGGGGCCTGGTACCCCGGAAAAACTATGGCTACACCTTC	CASSPGGGLVPRKNYGYTF	TRBV18	TRBJ1-2
TGCGCCAGCAGCTTGCGAAAAACCGGCGGGACTCGGAAAGAGACCCAGTACTTC	CASSLRKTGGTRKETQYF	TRBV5-1	TRBJ2-5
TGTGCCAGCAGCTTACTGGGGGGGGATAGCACAGATACGCAGTATTTT	CASSLLGGDSTDTQYF	TRBV7-9	TRBJ2-3
TGTGCCAGTAGTGACATCCCGGGACAGTTGCTTGAAAAACTGTTTTTT	CASSDIPGQLLEKLFF	TRBV19	TRBJ1-4
TGCAGCGAAGGGACGAACAATGAGCAGTTCTTC	CSEGTNNEQFF	TRBV29-1	TRBJ2-1
TGCGCCAGCAGCCAGGACACATGGTACGAGCAGTACTTC	CASSQDTWYEQYF	TRBV4-3	TRBJ2-7
TGTGCCAGCAGTTTATTATCTCTGAAAACGGGGGACAATCAGCCCCAGCATTTT	CASSLLSLKTGDNQPQHF	TRBV27	TRBJ1-5
TGTGCCAGCTGGGGAGGGGGGATCAATGAGCAGTTCTTC	CASWGGGINEQFF	TRBV5-6	TRBJ2-1
TGTGCCAGCAGCTTAGCGGATAGGAAAGCCAAAAACATTCAGTACTTC	CASSLADRKAKNIQYF	TRBV7-6	TRBJ2-4
TGTGCCAGCAGCCAAGATGGCCGCGGGACGATAGGGGCCAACGTCCTGACTTTC	CASSQDGRGTIGANVLTF	TRBV3-1	TRBJ2-6
TGTGCCAGCAGTGACTCCCTTCCCGGGGGGGGGGCTTTCGGGCAGTTCTTC	CASSDSLPGGGAFGQFF	TRBV6-4	TRBJ2-1
TGTGCCAGCAGCGTTACCCGGTCGGGAAACTATGGCTACACCTTC	CASSVTRSGNYGYTF	TRBV27	TRBJ1-2
TGCGCCAGCAAAGGGACAGGTATGGAATATGGCTACACCTTC	CASKGTGMEYGYTF	TRBV10-1	TRBJ1-2
TGTGCCAGCAGCTTGGGGACAGGGGGAGATACGCAGTATTTT	CASSLGTGGDTQYF	TRBV5-4	TRBJ2-3
TGTGCCAGCAGTGGTTACCTCTCAGGATCCTACGAGCAGTACTTC	CASSGYLSGSYEQYF	TRBV28	TRBJ2-7
TGCAGTGCCGAAGGGAGTCCGACGAGAGCGGGCGATTACGAGCAGTACTTC	CSAEGSPTRAGDYEQYF	TRBV20-1	TRBJ2-7
TGTGCCAGCAGTCCCGCTGTTGTATCAAGGCTTGAAGCTTTCTTT	CASSPAVVSRLEAFF	TRBV6-3	TRBJ1-1
TGTGCCCGTAAGTTCAGGGGTATGGGGGGAGCCTACGAGCAGTACTTC	CARKFRGMGGAYEQYF	TRBV6-1	TRBJ2-7
TGTGCCAGCAGTGACCAATCGTCCCGATACCGCACAGATACGCAGTATTTT	CASSDQSSRYRTDTQYF	TRBV25-1	TRBJ2-3
TGTGCCATCATATTCACAGATACGCAGTATTTT	CAIIFTDTQYF	TRBV10-3	TRBJ2-3
TGTGCCAGACGTCCCCCTGGGACCTATACGCAGTATTTT	CARRPPGTYTQYF	TRBV5-4	TRBJ2-3
TGTGCCAGCAGTTATGGACAGGGTCTGACGCCGGTTGAGCAGTACTTC	CASSYGQGLTPVEQYF	TRBV12-4	TRBJ2-7
TGTGCCAGCAGCTGGCTCAGGGGGGAACAGGGAAACACCATATATTTT	CASSWLRGEQGNTIYF	TRBV11-2	TRBJ1-3
TGTGCCTGGACCCGAGGGTCAGTTTTATACAATGAGCAGTTCTTC	CAWTRGSVLYNEQFF	TRBV30	TRBJ2-1
TGTGCCAGCAGCCGGTTCTTGGACAGGGTTGGTCAGCCCCAGCATTTT	CASSRFLDRVGQPQHF	TRBV3-1	TRBJ1-5
TGTAGTCGACAGGGATACAGCTCTGGAAACACCATATATTTT	CSRQGYSSGNTIYF	TRBV6-5	TRBJ1-3
TGCGCCAGCAGCCAGTCGATGCCGGGTTCTGGGGCCAACGTCCTGACTTTC	CASSQSMPGSGANVLTF	TRBV4-1	TRBJ2-6
TGTGCCAGCTCACCGACACCCAATGAGCAGTTCTTC	CASSPTPNEQFF	TRBV18	TRBJ2-1
TGTGCCAGCAGCCAGGTGGACGGATCCATTCAGTACTTC	CASSQVDGSIQYF	TRBV7-9	TRBJ2-4
TGTGCCAGCAGCTCCGATTACTCAGGGGAGCTGTTTTTT	CASSSDYSGELFF	TRBV7-3	TRBJ2-2
TGTGCCAGCGGGGGGGCCTACGAGCAGTACTTC	CASGGAYEQYF	TRBV12-3	TRBJ2-7
TGTGCCAGCAGCGAGTTCGCGGTAAAGGGCAACTACAATGAGCAGTTCTTC	CASSEFAVKGNYNEQFF	TRBV9	TRBJ2-1
TGTGCTAGTGTTCACTATGGGAATAACTACGAGCAGTACTTC	CASVHYGNNYEQYF	TRBV12-5	TRBJ2-7
TGCGCCAGCAGGGGACAGGGGGGGTATTGTGACTACGAGCAGTACTTC	CASRGQGGYCDYEQYF	TRBV5-1	TRBJ2-7
TGTGCCTGGATCCCTACAGATACGCAGTATTTT	CAWIPTDTQYF	TRBV30	TRBJ2-3
TGTGCCAGCAGTTGTAACCAGGGGGGGGGATTCGCCGGGGAGCTGTTTTTT	CASSCNQGGGFAGELFF	TRBV6-5	TRBJ2-2
TGTGCCAGCAGTGAAGGGGGTGGGGTAAAGGAAAAACTGTTTTTT	CASSEGGGVKEKLFF	TRBV6-4	TRBJ1-4
TGTGCCAGCAGCTTAAGGACAGGGACGAACACCGGGGAGCTGTTTTTT	CASSLRTGTNTGELFF	TRBV7-3	TRBJ2-2
TGTGCCAGCAGTGAAGCGCTTGGTACAGGGTGGCATCAGCCCCAGCATTTT	CASSEALGTGWHQPQHF	TRBV2	TRBJ1-5
TGTGCCAGCAGCTTGGGTCCGGGGACTTCCCCCGGGGGGACCGGGGAGCTGTTTTTT	CASSLGPGTSPGGTGELFF	TRBV5-6	TRBJ2-2
TGTGCCAGCAGCTTCGGAGATGAGCAGTTCTTC	CASSFGDEQFF	TRBV7-9	TRBJ2-1
TGTGCCAGCAGGGGGACAGGGGGCCATGAAAAACTGTTTTTT	CASRGTGGHEKLFF	TRBV13	TRBJ1-4
TGTGCCAGCATTGGACAGGGCTTGGCATGGCATAATGAAAAACTGTTTTTT	CASIGQGLAWHNEKLFF	TRBV27	TRBJ1-4
TGTGCCAGCAGCTTCCCGTACAATGAGCAGTTCTTC	CASSFPYNEQFF	TRBV7-9	TRBJ2-1
TGTGCCAGCAGCGGAAAGACTACCACAGTATCCGATTACGAGCAGTACTTC	CASSGKTTTVSDYEQYF	TRBV5-6	TRBJ2-7
TGTGCCAGCAGTGGGGGCCTCCACAATGAGCAGTTCTTC	CASSGGLHNEQFF	TRBV6-2	TRBJ2-1
TGTGCCAGCAGCACGGGGCTGGCTGGGTACGAGCAGTACTTC	CASSTGLAGYEQYF	TRBV7-3	TRBJ2-7
TGTGCCAGACTGGGGAGTGTTGAGCAGTACTTC	CARLGSVEQYF	TRBV6-5	TRBJ2-7
TGTGCCAGCAGCCAAGTGTGTCCAGGGGAGGGTTTTCGTACCTCCGGAAACACCATATATTTT	CASSQVCPGEGFRTSGNTIYF	TRBV3-1	TRBJ1-3
TGTGCCACCAGTGGTAAGGGAAGCTACGAGCAGTACTTC	CATSGKGSYEQYF	TRBV24-1	TRBJ2-7
TGTGCCAGCAGCGTAGCCTGGCGGGGCTACAATGAGCAGTTCTTC	CASSVAWRGYNEQFF	TRBV9	TRBJ2-1
TGTGCCAGCAGCGTACATGAACGGGCGACCAGCACAGATACGCAGTATTTT	CASSVHERATSTDTQYF	TRBV9	TRBJ2-3
TGCAGTCCCCCGTTGGGACTAGCGGGGTTAGAGCAGTACTTC	CSPPLGLAGLEQYF	TRBV20-1	TRBJ2-7
TGTGCCAGCAGCTTGAAACACAGGGGGCTCTCCTATGGCTACACCTTC	CASSLKHRGLSYGYTF	TRBV5-6	TRBJ1-2
TGCGCCAGCAGGACTAGCTGGCCCCAAGCCGGGGAGCTGTTTTTT	CASRTSWPQAGELFF	TRBV10-1	TRBJ2-2
TGCGCCAGCAGCTTGCCATCCGGGACTAGCGGGAGGACTGATTACTACGAGCAGTACTTC	CASSLPSGTSGRTDYYEQYF	TRBV5-1	TRBJ2-7
TGTGCCAGCAGCGTAGAATCTTCGCCGGGACAGGGATCGGGAGGTTTTGCAACTAATGAAAAACTGTTTTTT	CASSVESSPGQGSGGFATNEKLFF	TRBV9	TRBJ1-4
TGTGCCAGCAGCGTGAATAGTTCGGGGGTAGGGTATGAGCAGTTCTTC	CASSVNSSGVGYEQFF	TRBV9	TRBJ2-1
TGTGCCAGCTGGTTTACGGACGAGCAGTACTTC	CASWFTDEQYF	TRBV27	TRBJ2-7
TGTGCCAGCAGCTTTCCCTTATTCTCTCCCTACGAGCAGTACTTC	CASSFPLFSPYEQYF	TRBV11-1	TRBJ2-7
TGTGCCTTGGACAGGGAGAAAGGGGGTCAGCCCCAGCATTTT	CALDREKGGQPQHF	TRBV6-1	TRBJ1-5
TGTGCCAGCAGCCGGAAGGGCTTTGATGCGGGAGGCTACGAGCAGTACTTC	CASSRKGFDAGGYEQYF	TRBV7-8	TRBJ2-7
TGTGCCAGCAGCTTGTCCCCTATACCGCCGGGACTAGCGGATTATGAGCAGTTCTTC	CASSLSPIPPGLADYEQFF	TRBV5-4	TRBJ2-1
TGTGCCTGGAGCAAAGTGAGACTAGCGGGAGTTCAGAGCACCGGGGAGCTGTTTTTT	CAWSKVRLAGVQSTGELFF	TRBV30	TRBJ2-2
TGTGCCAGCAGTATTCAGCACAGGGGGGGCCTGGTGGAAGCCTATAACTATGGCTACACCTTC	CASSIQHRGGLVEAYNYGYTF	TRBV27	TRBJ1-2
TGCGCCAGCAGCTTGGCGTCCCAAAATTTAACGGAAGCCTACGAGCAGTACTTC	CASSLASQNLTEAYEQYF	TRBV5-1	TRBJ2-7
TGTGCCAGCCTAACCTTCCCGGGGGGGGGCTTCACAGATACGCAGTATTTT	CASLTFPGGGFTDTQYF	TRBV11-3	TRBJ2-3
TGTGCCAGCAGCGTCAGCGAGACCCAGTACTTC	CASSVSETQYF	TRBV7-3	TRBJ2-5
TGTGCCAGCAGCAAGAAAGTACCCTACGAGCAGTACTTC	CASSKKVPYEQYF	TRBV7-4	TRBJ2-7
TGCGCCAGCAGTGAGTCCGGGGACTACAATGAGCAGTTCTTC	CASSESGDYNEQFF	TRBV10-1	TRBJ2-1
TGTGCCAGCAGCGTCCACAGGGCTAACTATGGCTACACCTTC	CASSVHRANYGYTF	TRBV9	TRBJ1-2
TGTGCCAGTAGTATGCTACACAGAGTTTACGCTTTTGAAAAACTGTTTTTT	CASSMLHRVYAFEKLFF	TRBV19	TRBJ1-4
TGTGCCAGCAGCTTAGGGCGGGACAGGGAGGACTTC	CASSLGRDREDF	TRBV11-2	TRBJ2-7
TGTGCCAGCTGGGGACAGGGGGCCCGTGTGAACACTGAAGCTTTCTTT	CASWGQGARVNTEAFF	TRBV27	TRBJ1-1
TGCGCCAGCAGCCACGGGACAAACGGATTCGTTGGGCATTTT	CASSHGTNGFVGHF	TRBV5-1	TRBJ1-5
TGTGCCAGCAGCTTGGGACAGGGACGAGGAAACACCATATATTTT	CASSLGQGRGNTIYF	TRBV7-9	TRBJ1-3
TGTGCCAGCACCCCTATAGAACATGCCTATGGCTACACCTTC	CASTPIEHAYGYTF	TRBV12-3	TRBJ1-2
TGCGCCAGCAGTCCGGGCCGGGGTCGTTTCCGCTATGGCTACACCTTC	CASSPGRGRFRYGYTF	TRBV10-1	TRBJ1-2
TGTGCCAGCAGCCAGAATGGCCGCTGGCAGCAGCCCCAGCATTTT	CASSQNGRWQQPQHF	TRBV3-1	TRBJ1-5
TGTGCCAGTAGTCACCAGGGACATCACTCTGGGGCCAACGTCCTGACTTTC	CASSHQGHHSGANVLTF	TRBV19	TRBJ2-6
TGTGCCAGTCCGGGGGGAAAGAACCCCTACGAGCAGTACTTC	CASPGGKNPYEQYF	TRBV7-2	TRBJ2-7
TGTGCCAGCAGCGACAGGGGGTGGGATTCACCCCTCCACTTT	CASSDRGWDSPLHF	TRBV13	TRBJ1-6
TGTGCCAGCAGCAGGAGCGGGAGAAGGAGGAGGAGCTCCTACGAGCAGTACTTC	CASSRSGRRRRSSYEQYF	TRBV28	TRBJ2-7
TGCGCCAGCAGCTTGGCCTGCGCCCCTAGCGGTAGGGGGGAGCTGTTTTTT	CASSLACAPSGRGELFF	TRBV5-1	TRBJ2-2
TGCAGTGCTACCTCCAATCGCGGCTACGAGCAGTACTTC	CSATSNRGYEQYF	TRBV20-1	TRBJ2-7
TGTGCCAGCAGCTTTGAAACACGCCCTCCCCCCGCACCGGGACCTCTTGGCTACACCTTC	CASSFETRPPPAPGPLGYTF	TRBV7-2	TRBJ1-2
TGTGCCAGCAGCAACAGGCAACCCCAGCATTTT	CASSNRQPQHF	TRBV7-9	TRBJ1-5
TGTGCCTGGAGGCTAAGAAAGCCCGGGACAGCCTCCTACGAGCAGTACTTC	CAWRLRKPGTASYEQYF	TRBV30	TRBJ2-7
TGTGAATCATCTTGGCTGCGGGGGGGCCCGACCCAGTACTTC	CESSWLRGGPTQYF	TRBV5-4	TRBJ2-5
TGTGCCACCAGGCAGGGAATCCCGTTAGCCTACGAGCAGTACTTC	CATRQGIPLAYEQYF	TRBV24-1	TRBJ2-7
TGTGCCAGCAGCCAAGTTGCGGGGGAAAACACCATATATTTT	CASSQVAGENTIYF	TRBV14	TRBJ1-3
TGTGCCAGCAGCTTAGACGGCGGCGCATGGGGTCGATACGAGCAGTACTTC	CASSLDGGAWGRYEQYF	TRBV11-2	TRBJ2-7
TGTGCCAGCAGCCCGAATTTCTTCCCCCGGGACAGGGGTTCCTACGAGCAGTACTTC	CASSPNFFPRDRGSYEQYF	TRBV13	TRBJ2-7
TGTGCCCACTTCTCAGGGAGGGAAGCTTTCTTT	CAHFSGREAFF	TRBV10-3	TRBJ1-1
TGTGCCAGCAGCTTTAGACAGGGAGATGAGCAGTTCTTC	CASSFRQGDEQFF	TRBV11-2	TRBJ2-1
TGTGCTAGTGGCGATGGGCCAGGGGGCTGGGGGGGGCATAATGAGCAGTTCTTC	CASGDGPGGWGGHNEQFF	TRBV12-5	TRBJ2-1
TGTGCCAGCATGGCACTCAATGAGCAGTTCTTC	CASMALNEQFF	TRBV27	TRBJ2-1
TGTGCCAGCAGCTTGATGGACGACTACGAGCAGTACTTC	CASSLMDDYEQYF	TRBV5-8	TRBJ2-7
TGCAGTGCTAGAGAAGTTCCGGGACAGGATGGGAATGGCTACACCTTC	CSAREVPGQDGNGYTF	TRBV20-1	TRBJ1-2
TGCAGTGCTCGCAGGGGAGGGCCGTGTAACTATGGCTACACCTTC	CSARRGGPCNYGYTF	TRBV20-1	TRBJ1-2
TGTGCCAGCAGTGACGTACTCCGGGGACTAGGGATTGAGCAGTTCTTC	CASSDVLRGLGIEQFF	TRBV6-4	TRBJ2-1
TGTGCCAGCAGCTGGACTAGAGGGAACACCGGGGAGCTGTTTTTT	CASSWTRGNTGELFF	TRBV5-6	TRBJ2-2
TGTGCCAGCAGCTTAGGACAGAAGGAGTACGAGCAGTACTTC	CASSLGQKEYEQYF	TRBV7-9	TRBJ2-7
TGTGCCAGCAGCTTGCATTCCCGGGAGGGACGCACAGATACGCAGTATTTT	CASSLHSREGRTDTQYF	TRBV5-4	TRBJ2-3
TGTGCCTCGAAAAGGCTGTCAGATACGCAGTATTTT	CASKRLSDTQYF	TRBV2	TRBJ2-3
TGTGCCAGCAGCGCCCTTCCTTCCGGCTCCTACGAGCAGTACTTC	CASSALPSGSYEQYF	TRBV11-3	TRBJ2-7
TGTGCCAGCAGTGTGGACAGGGGGGGTAATGAGCAGTTCTTC	CASSVDRGGNEQFF	TRBV25-1	TRBJ2-1
TGCGCCAGCAGCCCAAGACTAGGTCCAGATACGCAGTATTTT	CASSPRLGPDTQYF	TRBV5-1	TRBJ2-3
TGTGCCAGTAGTATAGGGTCCACGGGAGGCATGGACACCGGGGAGCTGTTTTTT	CASSIGSTGGMDTGELFF	TRBV19	TRBJ2-2
TGTGCCACCAGCAGAGAGGCCAAACAGGGAGGGAGGAACACTGAAGCTTTCTTT	CATSREAKQGGRNTEAFF	TRBV15	TRBJ1-1
TGCAGCGTTAGTCTCTCTAACACCGGGGAGCTGTTTTTT	CSVSLSNTGELFF	TRBV29-1	TRBJ2-2
TGTGCCAGCAGCTTAGTAAGGACAGGGAACACTGAAGCTTTCTTT	CASSLVRTGNTEAFF	TRBV11-3	TRBJ1-1
TGCGCCAGCAGCCCTGCCAGGCCGGCAAGGGACACAGATACGCAGTATTTT	CASSPARPARDTDTQYF	TRBV5-1	TRBJ2-3
TGTGCCAGCAGCTTAATCGCGGGGAGCGACACTGAAGCTTTCTTT	CASSLIAGSDTEAFF	TRBV7-9	TRBJ1-1
TGCGCCAGCAGCGAGCGGGACAGTTATGGCTACACCTTC	CASSERDSYGYTF	TRBV4-3	TRBJ1-2
TGTGCCAGCGGGACAGGGGAGTACTTC	CASGTGEYF	TRBV6-5	TRBJ2-7
TGCAGTGCTAGAAGCACTAGCGGGAGCTCCTACGAGCAGTACTTC	CSARSTSGSSYEQYF	TRBV20-1	TRBJ2-7
TGTGCCATCAGTGAGTTGGAGGGGCCACAGCCCCAGCATTTT	CAISELEGPQPQHF	TRBV10-3	TRBJ1-5
TGTGCCTGGAGTGCGGGTCTAGCGGTTCCGGCAGATACGCAGTATTTT	CAWSAGLAVPADTQYF	TRBV30	TRBJ2-3
TGCAGTGCTAGAGCCTTACGGACTAGCGGGCCTTCGAACACCGGGGAGCTGTTTTTT	CSARALRTSGPSNTGELFF	TRBV20-1	TRBJ2-2
TGTGCCAGTAACAGGGGTAAAACTGAAGCTTTCTTT	CASNRGKTEAFF	TRBV19	TRBJ1-1
TGCAGTGCAGGGGGCGGACCTGAAGCTTTCTTT	CSAGGGPEAFF	TRBV20-1	TRBJ1-1
TGTGCCAGCAGCTTTAAGATTTCCGGCGAGCAGTACTTC	CASSFKISGEQYF	TRBV5-5	TRBJ2-7
TGTGCCAGCAGCAATAGTTCTCTCCAGTACTTC	CASSNSSLQYF	TRBV7-2	TRBJ2-4
TGTGCCAGCAGACCTAGGAACGATATAATTGGTAGGACTGAAGCTTTCTTT	CASRPRNDIIGRTEAFF	TRBV27	TRBJ1-1
TGTGCCAGCAGCTTTAGCGGGTTTGGCACAGATACGCAGTATTTT	CASSFSGFGTDTQYF	TRBV5-6	TRBJ2-3
TGTGCCAGCAGTACCCGACTAGTCCCCTACGAGCAGTACTTC	CASSTRLVPYEQYF	TRBV12-4	TRBJ2-7
TGTGCCAGCAGTACAGCGGGGCCGGGGACCCAGTACTTC	CASSTAGPGTQYF	TRBV28	TRBJ2-5
TGCAGTGCTAGGTCTCGTATCAGGAGGGACGAGCAGTACTTC	CSARSRIRRDEQYF	TRBV20-1	TRBJ2-7
TGTGCCAGCAGTCCGAGGGAAAGGGATCGAAGCTCTGGAAACACCATATATTTT	CASSPRERDRSSGNTIYF	TRBV2	TRBJ1-3
TGTGCCAGCAGCCAGCCTAATTCACCCCTCCACTTT	CASSQPNSPLHF	TRBV11-3	TRBJ1-6
TGTGCCAGCAGCCAAGATACAGGGGGAGCCTACGAGCAGTACTTC	CASSQDTGGAYEQYF	TRBV14	TRBJ2-7
TGTGCCAGCAGAGGGGGGGACAGGCCTAGCTCTGGAAACACCATATATTTT	CASRGGDRPSSGNTIYF	TRBV7-9	TRBJ1-3
TGTGCCAGAAAGAGACAGCTATGCAATCAGCCCCAGCATTTT	CARKRQLCNQPQHF	TRBV7-9	TRBJ1-5
TGTGCCAGCAGTTTTCACGCGGATGAAAAACTGTTTTTT	CASSFHADEKLFF	TRBV27	TRBJ1-4
TGCAGCATTAACAGGGCCCAAAGTCCATGGAAAGTTCGGGGGGGACCCTACGAGCAGTACTTC	CSINRAQSPWKVRGGPYEQYF	TRBV29-1	TRBJ2-7
TGTGCCAGCAGCCCCCTCCGGGGTTACTACGAGCAGTACTTC	CASSPLRGYYEQYF	TRBV6-5	TRBJ2-7
TGTGCCACCCCGGGGAGACCCTACGAGCAGTACTTC	CATPGRPYEQYF	TRBV24-1	TRBJ2-7
TGTGCCACCAGTGACCCATATGTCAACACTGAAGCTTTCTTT	CATSDPYVNTEAFF	TRBV24-1	TRBJ1-1
TGCGCCAGCAGATTGGGGCCCCACTATACCACCGGGGAGCTGTTTTTT	CASRLGPHYTTGELFF	TRBV10-2	TRBJ2-2
TGCAGTGCTGTGCAGCAGTGGGTCGCCTCCTATAATTCACCCCTCCACTTT	CSAVQQWVASYNSPLHF	TRBV20-1	TRBJ1-6
TGTGCCAGCAGGATGGAGGGAATAGGTGATACGCAGTATTTT	CASRMEGIGDTQYF	TRBV7-2	TRBJ2-3
TGTGCCAGCGGCCGGGGGTATGGCTACACCTTC	CASGRGYGYTF	TRBV27	TRBJ1-2
TGTGCTAGTGGTTTGGACTGGGGGCAGGACGAGCAGTACTTC	CASGLDWGQDEQYF	TRBV12-5	TRBJ2-7
TGTGCCAGCACGGGGACAGGGCATGGAGCTTTCTTT	CASTGTGHGAFF	TRBV27	TRBJ1-1
TGTGCCAGCAGTTACCTCCATTCCCCACGGCAACCGGGGGGAAAACTGTTTTTT	CASSYLHSPRQPGGKLFF	TRBV6-5	TRBJ1-4
TGTGCCAGCAGTGTCCTAGCGGGGGAGGTTGAGACCCAGTACTTC	CASSVLAGEVETQYF	TRBV6-4	TRBJ2-5
TGTGCCAGCAGCGTAGACAGGGCCATTGAAAAACTGTTTTTT	CASSVDRAIEKLFF	TRBV9	TRBJ1-4
TGTGCCAGCAGCGGGGGAGGGTTGGAGAGCAATCAGCCCCAGCATTTT	CASSGGGLESNQPQHF	TRBV7-3	TRBJ1-5
TGTGCCAGCAGACGGAGGGGACTCCACAATCAGCCCCAGCATTTT	CASRRRGLHNQPQHF	TRBV6-5	TRBJ1-5
TGTGCCACTTCCCCGGGACTAGCGGGAGGGTACGAGCAGTACTTC	CATSPGLAGGYEQYF	TRBV7-9	TRBJ2-7
TGTGCCAGCAGATCCGCGGTGATCGCCGGGGGGGACGAGCAGTACTTC	CASRSAVIAGGDEQYF	TRBV9	TRBJ2-7
TGTGCCATCTCCGAATACGGGTTTGGCTACACCTTC	CAISEYGFGYTF	TRBV13	TRBJ1-2
TGTGCCAGCAGTCGATCCCTGGGGGATATCGGCACTGAAGCTTTCTTT	CASSRSLGDIGTEAFF	TRBV12-3	TRBJ1-1
TGTGCCAGCAGCTTGGCGGGTGGGGACAGGGCGGTAGAAAAACTGTTTTTT	CASSLAGGDRAVEKLFF	TRBV7-3	TRBJ1-4
TGTGCCACCAGTGATTTGCAAATAGCGGGTAGGGGGTGTGAGACCCAGTACTTC	CATSDLQIAGRGCETQYF	TRBV24-1	TRBJ2-5
TGCAGTGCTAGGTCGTACTTGACTAGCGGAACCGGGGAGCTGTTTTTT	CSARSYLTSGTGELFF	TRBV20-1	TRBJ2-2
TGTGCCACCTCGCCGACAGGGCACGAGCAGTACTTC	CATSPTGHEQYF	TRBV7-3	TRBJ2-7
TGTGCCAGCAGCTTAGCCCGGGACTTCTATGGCTACACCTTC	CASSLARDFYGYTF	TRBV7-8	TRBJ1-2
TGCAGCGTTGCCCAGACAGTGATAGTTGAGCAGTTCTTC	CSVAQTVIVEQFF	TRBV29-1	TRBJ2-1
TGTGCCAGCAGGAGGGGACGGGGGGGCCGGGGGGATACGCAGTATTTT	CASRRGRGGRGDTQYF	TRBV12-3	TRBJ2-3
TGTGCCAGCAGCGTAGCCAGGACCGGGGAGCTGTTTTTT	CASSVARTGELFF	TRBV9	TRBJ2-2
TGTGCCAGCAGTTACTCGGGGGCCATGTGGATGAACACTGAAGCTTTCTTT	CASSYSGAMWMNTEAFF	TRBV6-2	TRBJ1-1
TGCAGCGTTGACGGGACAGGTAACTACGAGCAGTACTTC	CSVDGTGNYEQYF	TRBV29-1	TRBJ2-7
TGTGCCAGCTCACCCTCCCGGGACAGGGTTAGTTCAGCCTACCACGAGCAGTACTTC	CASSPSRDRVSSAYHEQYF	TRBV18	TRBJ2-7
TGTGCCAGATGGAGGGAAGGCACAGATACGCAGTATTTT	CARWREGTDTQYF	TRBV9	TRBJ2-3
TGTGCCAGCAGTGGATCCCCTACAGGTAGCAGTTATCAGCCCCAGCATTTT	CASSGSPTGSSYQPQHF	TRBV6-1	TRBJ1-5
TGTGCCAGCCAGTGGTTTAGGAACACTGAAGCTTTCTTT	CASQWFRNTEAFF	TRBV11-3	TRBJ1-1
TGTGCCAGCAGCTCGCTAGCGGGGTTCCGAGATACGCAGTATTTT	CASSSLAGFRDTQYF	TRBV7-2	TRBJ2-3
TGCGCCAGCAGTGAGCCCCCCGTCGGGGGCCCCTTGTACATTCAGTACTTC	CASSEPPVGGPLYIQYF	TRBV10-1	TRBJ2-4
TGTGCCAGCAGTTCCATCTCCCTGAAGGGGGGGGGGATTAACGAGCAGTACTTC	CASSSISLKGGGINEQYF	TRBV27	TRBJ2-7
TGCAGTCCCCCCACAGCCGAGGGGGCCAACGTCCTGACTTTC	CSPPTAEGANVLTF	TRBV20-1	TRBJ2-6
TGCGCCAGCAGCCAACCCCCCTGGGACGGACAGGGGTCGAACACTGAAGCTTTCTTT	CASSQPPWDGQGSNTEAFF	TRBV4-3	TRBJ1-1
TGTGCCACCACTTCCCCGGGACGTAACACCGGGGAGCTGTTTTTT	CATTSPGRNTGELFF	TRBV24-1	TRBJ2-2
TGCGCCAGCAGCTGGCACAGGGCGGACTGGGATACGCAGTATTTT	CASSWHRADWDTQYF	TRBV5-1	TRBJ2-3
TGCAGCCCTGACCGAGGAAAAGGGGCCTATAGCAATCAGCCCCAGCATTTT	CSPDRGKGAYSNQPQHF	TRBV29-1	TRBJ1-5
TGTGCCACCACGCGAGGCGGACAGGGTCGGAATGAAAAACTGTTTTTT	CATTRGGQGRNEKLFF	TRBV24-1	TRBJ1-4
TGCAGTGCGGGGTCACTAGGGGGCGGCTCCTACGAGCAGTACTTC	CSAGSLGGGSYEQYF	TRBV20-1	TRBJ2-7
TGTGCCAGCAGTTTAGCACAGGCGGGCCCCTACGAGCAGTACTTC	CASSLAQAGPYEQYF	TRBV27	TRBJ2-7
TGTGCCAGCAGTAACGGGGGACAGCCAGCCGGGGGCTACACCTTC	CASSNGGQPAGGYTF	TRBV7-9	TRBJ1-2
TGTGCCAGCCGGACATGGCCGGGGGAGCAGTTCTTC	CASRTWPGEQFF	TRBV6-1	TRBJ2-1
TGTGCCAGCCAGGTAGGACATGGTAGCACAGATACGCAGTATTTT	CASQVGHGSTDTQYF	TRBV6-6	TRBJ2-3
TGTGCCAGCAGCTCTGGGCGCCTTTCACCCCTCCACTTT	CASSSGRLSPLHF	TRBV7-2	TRBJ1-6
TGTGCCAGCAGGCGGGTAACGAACACCGGGGAGCTGTTTTTT	CASRRVTNTGELFF	TRBV6-3	TRBJ2-2
TGTGCCAGCAGCTATAGGGCGAACTATGGCTACACCTTC	CASSYRANYGYTF	TRBV7-9	TRBJ1-2
TGTGCCACCCCACGGCCGGGTTTCACAGGCTACACCTTC	CATPRPGFTGYTF	TRBV24-1	TRBJ1-2
TGTGCCAGCTCCCCTACGTCCGATGAGCAGTTCTTC	CASSPTSDEQFF	TRBV6-5	TRBJ2-1
TGTGCCAGCAGCTTTCCCGGGGCTGAGCAGTTCTTC	CASSFPGAEQFF	TRBV5-4	TRBJ2-1
TGTGCCACCAGCAGTATTAGCCTAGCGGGAAATGAGCAGTTCTTC	CATSSISLAGNEQFF	TRBV15	TRBJ2-1
TGTGCCAGCAGTTACTCGAGTCAGGGGGGAAAGAGTACACGAAACTCCTACAATGAGCAGTTCTTC	CASSYSSQGGKSTRNSYNEQFF	TRBV6-5	TRBJ2-1
TGTGCCAGCAGGGAGGGGGCTGAGAATAGCAATCAGCCCCAGCATTTT	CASREGAENSNQPQHF	TRBV6-6	TRBJ1-5
TGTGCCAGCAGCTCGACAGGAACTGAAGCTTTCTTT	CASSSTGTEAFF	TRBV7-8	TRBJ1-1
TGTGCCACCAGCAATGGGGGACATTGGCGGAACACTGAAGCTTTCTTT	CATSNGGHWRNTEAFF	TRBV15	TRBJ1-1
TGTGCCAGCAGTGCAGGCACCCCGGACTCCTACGAGCAGTACTTC	CASSAGTPDSYEQYF	TRBV7-8	TRBJ2-7
TGTGCCAGCAGAATCCTCAGGATCCCCAATGAGCAGTTCTTC	CASRILRIPNEQFF	TRBV6-2	TRBJ2-1
TGCGCCAGCAGCCACAGACCCGTGAACACTGAAGCTTTCTTT	CASSHRPVNTEAFF	TRBV4-1	TRBJ1-1
TGTGCCAGCAGCCTGGGACAGGGGGCGCTCTACGAGCAGTACTTC	CASSLGQGALYEQYF	TRBV6-1	TRBJ2-7
TGTGCCAGTCGACCAGAGACCCAGTACTTC	CASRPETQYF	TRBV19	TRBJ2-5
TGTGCCAGCAGCCCCCCCCCACACAGGGAGAGTGCCAACTATGGCTACACCTTC	CASSPPPHRESANYGYTF	TRBV5-4	TRBJ1-2
TGTGCCAGCAGCCCTCCCTCGGGCCCGGCCGAGCAGTACTTC	CASSPPSGPAEQYF	TRBV4-2	TRBJ2-7
TGCGCCAGCAGCTCCGGGACGGACGACGGGGAGCTGTTTTTT	CASSSGTDDGELFF	TRBV5-1	TRBJ2-2
TGCAAGGTAAATGGAGAACAGGGCGTAACTGAAGCTTTCTTT	CKVNGEQGVTEAFF	TRBV20-1	TRBJ1-1
TGTGCCAGCAGCCATAGGGGGGGCGAGCAGTACTTC	CASSHRGGEQYF	TRBV3-1	TRBJ2-7
TGTGCCAGCAGTTTAAGAGTAGGTGAAGCTTTCTTT	CASSLRVGEAFF	TRBV27	TRBJ1-1
TGTGCCAGCAGTTCTAGCGGGTTAACCTACGAGCAGTACTTC	CASSSSGLTYEQYF	TRBV27	TRBJ2-7
TGTGCCAGCAACTTGGGGGAGGGGGGGTCTGAAGCTTTCTTT	CASNLGEGGSEAFF	TRBV6-6	TRBJ1-1
TGTGCCAGCAGGGCGGGGGGCTTACAGCCCCAGCATTTT	CASRAGGLQPQHF	TRBV6-1	TRBJ1-5
TGTGCCAGGGTCCATAGGGGATACGCTAATGAAAAACTGTTTTTT	CARVHRGYANEKLFF	TRBV2	TRBJ1-4
TGTATGGACATTAATAGCAATCAGCCCCAGCATTTT	CMDINSNQPQHF	TRBV10-3	TRBJ1-5
TGTGCCAAGGGGGGGCCGACCAATGAGCAGTTCTTC	CAKGGPTNEQFF	TRBV7-9	TRBJ2-1
TGTGCCAGCAGCTTAGGTCAGCTCGAGACCCAGTACTTC	CASSLGQLETQYF	TRBV7-2	TRBJ2-5
TGTGCCAGCAGGGGTTTATGCGAGCAGTACTTC	CASRGLCEQYF	TRBV28	TRBJ2-7
TGCAGCGTTGAAGACTCTTGGACAGTGCCAGACGAGCAGTACTTC	CSVEDSWTVPDEQYF	TRBV29-1	TRBJ2-7
TGTGCCTTGCGGGGGCGAGCAGATACGCAGTATTTT	CALRGRADTQYF	TRBV30	TRBJ2-3
TGTGCCAGCAGCCATCCGAGGGAAAACTACGAGCAGTACTTC	CASSHPRENYEQYF	TRBV4-2	TRBJ2-7
TGTGCCAGCAGCTTAGCGGGCCGGGACAGAAATCAGCCCCAGCATTTT	CASSLAGRDRNQPQHF	TRBV7-9	TRBJ1-5
TGTGCTAGTGGTGTCGAAGGTTCAGGGGGCTCGTTTAGCAATCAGCCCCAGCATTTT	CASGVEGSGGSFSNQPQHF	TRBV12-5	TRBJ1-5
TGCGCCAGCAGCCGGGGGGGGGGGTGTAACACTGAAGCTTTCTTT	CASSRGGGCNTEAFF	TRBV5-1	TRBJ1-1
TGTGCCAGCAGCCAAAAAGGGACAGGGAGACTTTCCTACGAGCAGTACTTC	CASSQKGTGRLSYEQYF	TRBV4-2	TRBJ2-7
TGTGCCAGCAGCTTGGAACTTAAACAGGCTGAAAAACTGTTTTTT	CASSLELKQAEKLFF	TRBV5-6	TRBJ1-4
TGTGCCATCAGTGAGGTCCTAGCGGGCTACAATGAGCAGTTCTTC	CAISEVLAGYNEQFF	TRBV10-3	TRBJ2-1
TGTGCCAGCAGCCGGTGTTCAGGGGGAACCGGGGAGCTGTTTTTT	CASSRCSGGTGELFF	TRBV9	TRBJ2-2
TGTGCCAGCAGTCCCTGCAGCTACGAGCAGTACTTC	CASSPCSYEQYF	TRBV28	TRBJ2-7
TGCAGTGCCTATAGGGGTCGGGGCTGCTACGAGCAGTACTTC	CSAYRGRGCYEQYF	TRBV20-1	TRBJ2-7
TGTGCCACACCTTTTTCGAGAGATACGCAGTATTTT	CATPFSRDTQYF	TRBV11-1	TRBJ2-3
TGCAGTGCTAGGGGGGACAGGGGGCAGACCTACGAGCAGTACTTC	CSARGDRGQTYEQYF	TRBV20-1	TRBJ2-7
TGCAGCGTTGAAGATGACGGGGATTACGAGCAGTACTTC	CSVEDDGDYEQYF	TRBV29-1	TRBJ2-7
TGTGCCACCAGCAGGACACCCACTAGCGGGAGGGTTGAGACCCAGTACTTC	CATSRTPTSGRVETQYF	TRBV15	TRBJ2-5
TGCGCCAGTGATAGGTCCTTTGAGGGAATGTCACCCCTCCACTTT	CASDRSFEGMSPLHF	TRBV10-1	TRBJ1-6
TGTGCCACCCACCCGGGACAGGTCCGTATGAACACTGAAGCTTTCTTT	CATHPGQVRMNTEAFF	TRBV24-1	TRBJ1-1
TGTGCCAGCAGACAAGACAGGCTTCCCTACGAGCAGTACTTC	CASRQDRLPYEQYF	TRBV25-1	TRBJ2-7
TGTGCCAGCAGTGACAGGGGGCAGGACTATGGCTACACCTTC	CASSDRGQDYGYTF	TRBV6-1	TRBJ1-2
TGCGCCAGCAGCCAAGATACTCGTACAGGGCACCCTAGCACAGATACGCAGTATTTT	CASSQDTRTGHPSTDTQYF	TRBV4-1	TRBJ2-3
TGTGCTAGTGGTTTACGTCCAGGGTTCCTTTCATTCTACCAAGAGACCCAGTACTTC	CASGLRPGFLSFYQETQYF	TRBV12-5	TRBJ2-5
TGTGCCAGCAGCTTCACTGTTGGACTAGCGGGCGACTACACAGATACGCAGTATTTT	CASSFTVGLAGDYTDTQYF	TRBV5-8	TRBJ2-3
TGTGCCCTCGGCGCGGACTCCTACAATGAGCAGTTCTTC	CALGADSYNEQFF	TRBV24-1	TRBJ2-1
TGTGCCAGCAGCTCGGCAGGGGGCGGCTATGGCTACACCTTC	CASSSAGGGYGYTF	TRBV7-6	TRBJ1-2
TGCAGTGCTAGGACCCCCACAGGGGAGCGGCAGTTCTTC	CSARTPTGERQFF	TRBV20-1	TRBJ2-1
TGTGCCAGCAGCTGGGGGGACTCGGACGTCGAGCAGTACTTC	CASSWGDSDVEQYF	TRBV5-4	TRBJ2-7
TGTGCCAGCAGCCAAGGACAGGTTCGCAATCAGCCCCAGCATTTT	CASSQGQVRNQPQHF	TRBV13	TRBJ1-5
TGCGCCAGCAGCTTGAGGACTAGCGGGGTCGTCACAGATACGCAGTATTTT	CASSLRTSGVVTDTQYF	TRBV5-1	TRBJ2-3
TGTGCCAGCACCCACAGGAACTATGGCTACACCTTC	CASTHRNYGYTF	TRBV12-3	TRBJ1-2
TGCGCCAGCAGTGATCGAGCTCGCGAGCAGTACTTC	CASSDRAREQYF	TRBV10-1	TRBJ2-7
TGCGCCAGCAGCCAAGCTATCGCCTTGAGACGCGGCTACGAGCAGTACTTC	CASSQAIALRRGYEQYF	TRBV4-3	TRBJ2-7
TGTGCCAGCAGCCCCCAGGGACCTGGGGCCAACGTCCTGACTTTC	CASSPQGPGANVLTF	TRBV7-4	TRBJ2-6
TGTGCCAGCAGCGTAGATCCAGGCTATCAGGAGAAACAGGGTCCACAGCAGTACTTC	CASSVDPGYQEKQGPQQYF	TRBV9	TRBJ2-7
TGTGCCAGCAGTCCCCCACCAGGGCACTCACCCCTCCACTTT	CASSPPPGHSPLHF	TRBV12-3	TRBJ1-6
TGCAGTGCGTACGACGTAAACTACAATGAGCAGTTCTTC	CSAYDVNYNEQFF	TRBV20-1	TRBJ2-1
TGTGCCAGCAGCCAGGAACCCCGGGACAAGACAGAGACCCAGTACTTC	CASSQEPRDKTETQYF	TRBV3-1	TRBJ2-5
TGTGCCACGACACTCGGGGCTTCCCCTATGAACACTGAAGCTTTCTTT	CATTLGASPMNTEAFF	TRBV15	TRBJ1-1
TGTGCCAGCAGCGGGGGACAGGCCAACTACGAGCAGTACTTC	CASSGGQANYEQYF	TRBV9	TRBJ2-7
TGTGCCAGCAGTCCAACACCCTCCTACAATGAGCAGTTCTTC	CASSPTPSYNEQFF	TRBV6-6	TRBJ2-1
TGTGCCAGCAGCCGTACGAACGGGGAAACACCCATATATTTT	CASSRTNGETPIYF	TRBV3-1	TRBJ1-3
TGTGCCAGCAGTTTGCCATATCAGCCCCAGCATTTT	CASSLPYQPQHF	TRBV27	TRBJ1-5
TGTGCCAGCAGCCTTGCTAGCGGTGGGTACGAGCAGTACTTC	CASSLASGGYEQYF	TRBV9	TRBJ2-7
TGTGCCAGTAGTATAGATGGTGACAGGGAGAACACTGAAGCTTTCTTT	CASSIDGDRENTEAFF	TRBV19	TRBJ1-1
TGTGCCAGTAGTCTTCTTAGGACAGGGGGCAGGATAACGCCCTACGAGCAGTACTTC	CASSLLRTGGRITPYEQYF	TRBV19	TRBJ2-7
TGTGCTAGACCGGACTCCGAAAGCTACGAGCAGTACTTC	CARPDSESYEQYF	TRBV12-5	TRBJ2-7
TGTGCCAGCAGCGGGACAGTCAATGAGCAGTTCTTC	CASSGTVNEQFF	TRBV2	TRBJ2-1
TGTGCCAGCAGTGAGGGGGGTGAAGACTACGAGCAGTACTTC	CASSEGGEDYEQYF	TRBV6-5	TRBJ2-7
TGTGCCAGCAGTTCCGGGAGAAAACGCGCGCAGTTCTTC	CASSSGRKRAQFF	TRBV6-1	TRBJ2-1
TGTGCCAGTAAGTGGGGGGGTCCCTATAATTCACCCCTCCACTTT	CASKWGGPYNSPLHF	TRBV19	TRBJ1-6
TGTGCCAGCAGTGAAGCACGGAGTAAGTCAACCTACGAGCAGTACTTC	CASSEARSKSTYEQYF	TRBV6-1	TRBJ2-7
TGCGCCAGCAGCCGTCGGGACAGGGACAAAAACACCGGGGAGCTGTTTTTT	CASSRRDRDKNTGELFF	TRBV4-3	TRBJ2-2
TGCAGTGCTAGAGATTTATTTAGAGGGGGGGGCAGGGGCTCCTACAATGAGCAGTTCTTC	CSARDLFRGGGRGSYNEQFF	TRBV20-1	TRBJ2-1
TGTGCCGGGACTAGCGGCGGTACTGAGCAGTTCTTC	CAGTSGGTEQFF	TRBV5-5	TRBJ2-1
TGTGCCAGCAGCCGGACAGGGAATGAAAAACTGTTTTTT	CASSRTGNEKLFF	TRBV2	TRBJ1-4
TGCGCCAGCAGCCAAGACCCCGAGGACCGAAACCCAACGGTAATGGGGAATCAGCCCCAGCATTTT	CASSQDPEDRNPTVMGNQPQHF	TRBV4-1	TRBJ1-5
TGTGCCAGTAGTATCATCTGGATTTCGGGGTCTGAACCCCATAGCAATCAGCCCCAGCATTTT	CASSIIWISGSEPHSNQPQHF	TRBV19	TRBJ1-5
TGCGCCAGCAGGCCAGGGGGGGCCTACGAGCAGTACTTC	CASRPGGAYEQYF	TRBV5-1	TRBJ2-7
TGTGCCATCTCGCGAGCCAAAGAGACCCAGTACTTC	CAISRAKETQYF	TRBV10-3	TRBJ2-5
TGTGATCTTGGGTCGGGGACCCAGTACTTC	CDLGSGTQYF	TRBV12-3	TRBJ2-5
TGTGCCAGCAGCCACGGACAGGGGGATTGGATGCGAAAATGCCAGCCCCAGCATTTT	CASSHGQGDWMRKCQPQHF	TRBV7-3	TRBJ1-5
TGTGCCAGCAGCAACGGGGGACAGGGGGCCGTGGGGAGGTCGAGCTCCTACGAGCAGTACTTC	CASSNGGQGAVGRSSSYEQYF	TRBV28	TRBJ2-7
TGTGCCAGCAGCTGGGGGCATGGAGCCTATAATTCACCCCTCCACTTT	CASSWGHGAYNSPLHF	TRBV7-3	TRBJ1-6
TGTGCCAGCAAACTGGGTCGCCCTAGCGGGCTGACAGATACGCAGTATTTT	CASKLGRPSGLTDTQYF	TRBV13	TRBJ2-3
TGTGCCAGCAGTTCCAACGCCGGGACAGGGAGCGAGCAGTACTTC	CASSSNAGTGSEQYF	TRBV27	TRBJ2-7
TGCAGTGCCCTCAACGGACCCGATGAGCAGTTCTTC	CSALNGPDEQFF	TRBV20-1	TRBJ2-1
TGTGCCAGCCCCAGAGGACAGGGTGTCGAAGCTTTCTTT	CASPRGQGVEAFF	TRBV11-2	TRBJ1-1
TGTGCCAGCAGCTTGATTCTTCACAGGGGGTATAGCAATCAGCCCCAGCATTTT	CASSLILHRGYSNQPQHF	TRBV5-4	TRBJ1-5
TGTGCCAGCAGTGACTCCCGACAGGGGGCAAACTATGGCTACACCTTC	CASSDSRQGANYGYTF	TRBV6-4	TRBJ1-2
TGTGCCACCAGACGGGTGAACACTGAAGCTTTCTTT	CATRRVNTEAFF	TRBV24-1	TRBJ1-1
TGTGCCAGTAGTATAGCCGGAGGGAAACGGTGCAATCAGCCCCAGCATTTT	CASSIAGGKRCNQPQHF	TRBV19	TRBJ1-5
TGTGCCACCAGCTCGCGGGGGGTTACAGATACGCAGTATTTT	CATSSRGVTDTQYF	TRBV24-1	TRBJ2-3
TGTGCCAGCAGCGCGGCACAGGGTAATTCACCCCTCCACTTT	CASSAAQGNSPLHF	TRBV9	TRBJ1-6
TGTGCCAGCTCACCACCAGCATTCACGCGAAAATGTAGGGGGGGTACCAGGACTAGCACAGATACGCAGTATTTT	CASSPPAFTRKCRGGTRTSTDTQYF	TRBV18	TRBJ2-3
TGTGCCAGCAGTCCCCGGGATTCAAACAATGAGCAGTTCTTC	CASSPRDSNNEQFF	TRBV27	TRBJ2-1
TGCGCCAGCAGCACCGGACGTGGCTACACCTTC	CASSTGRGYTF	TRBV5-1	TRBJ1-2
TGTGCCAGCAGCCTCCCAGGGAAGGGCGAAAATCAGCCCCAGCATTTT	CASSLPGKGENQPQHF	TRBV4-2	TRBJ1-5
TGCGCCAGCTCACAGGTAAGCAATCAGCCCCAGCATTTT	CASSQVSNQPQHF	TRBV10-1	TRBJ1-5
TGTGCCAGCAGCCCCTTGGGACAGGGAGCGCAAGATGGCTACACCTTC	CASSPLGQGAQDGYTF	TRBV13	TRBJ1-2
TGCGCCAGCGACTATCCCTACGAGCAGTACTTC	CASDYPYEQYF	TRBV5-1	TRBJ2-7
TGTGCCAGCAGCTTCTCCCAGCGGGTATATACGCAGTATTTT	CASSFSQRVYTQYF	TRBV11-3	TRBJ2-3
TGTGCCAGCAACCAAGGGAGGGCTGAGCAGTACTTC	CASNQGRAEQYF	TRBV28	TRBJ2-7
TGTGCCAGCAGCGTCCCGCCGGGACTATTTTACGAGCAGTACTTC	CASSVPPGLFYEQYF	TRBV7-3	TRBJ2-7
TGTGCCAGCAGTTTCCCTAGCGGGGGGATCCTTGGCACCGGGGAGCTGTTTTTT	CASSFPSGGILGTGELFF	TRBV6-1	TRBJ2-2
TGTGCCAGCAGCGAGGGGGGCCGGTCCGTAAGCACAGATACGCAGTATTTT	CASSEGGRSVSTDTQYF	TRBV11-2	TRBJ2-3
TGCGCCAGCAGCGACGGACTAGTCGAGACCCAGTACTTC	CASSDGLVETQYF	TRBV5-1	TRBJ2-5
TGTGCCAGCAGCCCCGCGGCCGCCTATAGCAATCAGCCCCAGCATTTT	CASSPAAAYSNQPQHF	TRBV7-4	TRBJ1-5
TGTGCATCGGTCAGATACCTTAGCTCCTACAATGAGCAGTTCTTC	CASVRYLSSYNEQFF	TRBV15	TRBJ2-1
TGTGCCAGCAGCCCGTGGACAGGGGTTCATAGCAATCAGCCCCAGCATTTT	CASSPWTGVHSNQPQHF	TRBV11-2	TRBJ1-5
TGTGCCAGGTTGCCAGGACAGGGCGATGAGGGCAACGAGCAGTACTTC	CARLPGQGDEGNEQYF	TRBV19	TRBJ2-7
TGTGCCAGCAGAACGCAGCGGGACTACGAGCAGTACTTC	CASRTQRDYEQYF	TRBV12-3	TRBJ2-7
TGTCCCCACCCCCGACTAGGGCGACCCCGGGAGACCCAGTACTTC	CPHPRLGRPRETQYF	TRBV20-1	TRBJ2-5
TGCAGTGCTAGAGAAAATGGAGTCCGCACCGGGGAGCTGTTTTTT	CSARENGVRTGELFF	TRBV20-1	TRBJ2-2
TGTGCCAGCAGTTACTGCCGGGGCCGGGCAGATACGCAGTATTTT	CASSYCRGRADTQYF	TRBV6-5	TRBJ2-3
TGTGCCAGCAGCCAAGACAGGGGGCGCAACACTGAAGCTTTCTTT	CASSQDRGRNTEAFF	TRBV3-1	TRBJ1-1
TGCAGTGCTAGAGATTGGGGGCAGCACTCGTATTACGAGCAGTACTTC	CSARDWGQHSYYEQYF	TRBV20-1	TRBJ2-7
TGTGCCAGCAGCGGGTATGAGGGGGTGCCGGGACAGCCCCAGCATTTT	CASSGYEGVPGQPQHF	TRBV5-6	TRBJ1-5
TGTGCCAGCAGCCAAGAGTGTAAGGGGGACGCTTTCTTT	CASSQECKGDAFF	TRBV3-1	TRBJ1-1
TGCGCCAGCAGTTACACCGGGACTAGCGGAGACGACTACGAGCAGTACTTC	CASSYTGTSGDDYEQYF	TRBV10-1	TRBJ2-7
TGCAGTGCTAGAGATCCCCCGGAGGACCCCTACGAGCAGTACTTC	CSARDPPEDPYEQYF	TRBV20-1	TRBJ2-7
TGTGCCAGCAGCGTAGAGACTAGCGTCAAGGGAGGCTACGAGCAGTACTTC	CASSVETSVKGGYEQYF	TRBV9	TRBJ2-7
TGTGCCAGCAGTTACAGTGCGGGGGGACCGCATGAGCAGTTCTTC	CASSYSAGGPHEQFF	TRBV6-2	TRBJ2-1
TGTGCCACCCCGGACATGGGGGAAAAACTGTTTTTT	CATPDMGEKLFF	TRBV24-1	TRBJ1-4
TGTGCCAGCAGCCCGGAGATGGGGAGCTACGAGCAGTACTTC	CASSPEMGSYEQYF	TRBV9	TRBJ2-7
TGCAGTGCTAGAGGGGGGGACAGGGTGGAGAGGGAAAACATTCAGTACTTC	CSARGGDRVERENIQYF	TRBV20-1	TRBJ2-4
TGTGCCAGCAGTTGGCTGATCGTACCGGGCACTGAAGCTTTCTTT	CASSWLIVPGTEAFF	TRBV28	TRBJ1-1
TGTGCCAGCAGTTACTCGAAAGGTATAGCCAAAAACATTCAGTACTTC	CASSYSKGIAKNIQYF	TRBV6-5	TRBJ2-4
TGTGCCACCAGCAAATGTCCCGGGGACAGGTCTTTCCAAAACACTGAAGCTTTCTTT	CATSKCPGDRSFQNTEAFF	TRBV15	TRBJ1-1
TGTGCCATCAGTGAGTCAAGTACCGGGACAGAATCGGAGGATCACTCTAACTATGGCTACACCTTC	CAISESSTGTESEDHSNYGYTF	TRBV10-3	TRBJ1-2
TGCGCCCCGACCCAGGGGCAGAGTCAGCCCCAGCATTTT	CAPTQGQSQPQHF	TRBV5-1	TRBJ1-5
TGTGCTAGCAGGGCCTCCTACGAGCAGTACTTC	CASRASYEQYF	TRBV7-7	TRBJ2-7
TGTGCCAGCAGCACCCTTACAGGGGTCGCCGGCCAAGAGACCCAGTACTTC	CASSTLTGVAGQETQYF	TRBV13	TRBJ2-5
TGTGCCAGCAGCGATGGTAACGGGAGGGAAAATCTAAGCTCCTACGAGCAGTACTTC	CASSDGNGRENLSSYEQYF	TRBV9	TRBJ2-7
TGTGCCAGTAGTATAGATCTAGGACTAGCGGGAGCAGACGAGCAGTACTTC	CASSIDLGLAGADEQYF	TRBV19	TRBJ2-7
TGTGCTAGTGGTTTGCCTCGACTAGCGGGAGCAAGCACAGATACGCAGTATTTT	CASGLPRLAGASTDTQYF	TRBV12-5	TRBJ2-3
TGTGCCAGCAGCACCGAGGGGACTAGCGGGGGGGGGGATGAGCAGTTCTTC	CASSTEGTSGGGDEQFF	TRBV7-3	TRBJ2-1
TGTGCCAGCAGCGAGGACAGGGGGCCGTACGAGCAGTACTTC	CASSEDRGPYEQYF	TRBV7-3	TRBJ2-7
TGTGCCAGCAGTTCCCGGACTGATGGAAACACCATATATTTT	CASSSRTDGNTIYF	TRBV6-5	TRBJ1-3
TGTGCCAGCAGTGAACTGCACGGGGGGCCCCAAGAAGGCTACACCTTC	CASSELHGGPQEGYTF	TRBV6-1	TRBJ1-2
TGTGCCAGCCAGACAGGACGCTACGAGCAGTACTTC	CASQTGRYEQYF	TRBV27	TRBJ2-7
TGTGCCAGCAGTGACGACACAAAGGATTCTGGAAACACCATATATTTT	CASSDDTKDSGNTIYF	TRBV25-1	TRBJ1-3
TGTGCCAGCAGTTTATGGGTGGGGACAGTTCAGAAGGTTGCCTCCTACGAGCAGTACTTC	CASSLWVGTVQKVASYEQYF	TRBV28	TRBJ2-7
TGTGCCAGCTGGGGAGTAGAGACCCAGTACTTC	CASWGVETQYF	TRBV7-9	TRBJ2-5
TGCAGTGCTGGACAGGGGAGGAGCGCTTTCTTT	CSAGQGRSAFF	TRBV20-1	TRBJ1-1
TGCGCCAGCAGCAGGGGGGAGGGAGTCGGCTACATTCAGTACTTC	CASSRGEGVGYIQYF	TRBV5-1	TRBJ2-4
TGTGCCAGCAGTGAACCCAAGGTGAAGGGGGGCATCGAAGAGACCCAGTACTTC	CASSEPKVKGGIEETQYF	TRBV2	TRBJ2-5
TGTGCCAGTAGTATATCGAGCGGGAGGGGGGGAAAGGGGCACGAGCAGTACTTC	CASSISSGRGGKGHEQYF	TRBV19	TRBJ2-7
TGTGCCAGCAGTTACCAAAGGAGGGGCCAGCCCCAGCATTTT	CASSYQRRGQPQHF	TRBV6-6	TRBJ1-5
TGCAGTGCTAGACCAGAAGACGGGGAAAATAAGACCCAGTACTTC	CSARPEDGENKTQYF	TRBV20-1	TRBJ2-5
TGCAGTGCTAGAGCCGACGGGTTTCTGTTTCTATACGAGCAGTACTTC	CSARADGFLFLYEQYF	TRBV20-1	TRBJ2-7
TGTGCCAGCAGGAGGGTTGGAGGGGTAGAACACGAGCAGTACTTC	CASRRVGGVEHEQYF	TRBV27	TRBJ2-7
TGTGCCACCAGTCACGGCGTAGTGACTAGCGGGTGGGGTGCAGGAGAGACCCAGTACTTC	CATSHGVVTSGWGAGETQYF	TRBV24-1	TRBJ2-5
TGCAGTGCCGAGAACGAGACCCAGTACTTC	CSAENETQYF	TRBV20-1	TRBJ2-5
TGCGCCACCATAAAAGCTTTCTTT	CATIKAFF	TRBV5-1	TRBJ1-1
TGTGCTAGTGGTTTGGTACCTAATCGAATTCGGGCAAAGAGGACCCAGTACTTC	CASGLVPNRIRAKRTQYF	TRBV12-5	TRBJ2-5
TGCGCCAGCAATCCGGGGGACAGGGGATTTAGCAATCAGCCCCAGCATTTT	CASNPGDRGFSNQPQHF	TRBV10-1	TRBJ1-5
TGTGCCAGGCTTGACCCCTACGAGCAGTACTTC	CARLDPYEQYF	TRBV6-1	TRBJ2-7
TGTGCCAGCAGCTTAGGGGGGAAACGGAATGAGCAGTTCTTC	CASSLGGKRNEQFF	TRBV13	TRBJ2-1
TGTGCCAGCACTGGCAGCGGGGTCCAGTACAATGAGCAGTTCTTC	CASTGSGVQYNEQFF	TRBV7-3	TRBJ2-1
TGTGCCAGCAGTCAGCCGGACAGGGGGCCACAAGAGACCCAGTACTTC	CASSQPDRGPQETQYF	TRBV9	TRBJ2-5
TGTGCCAGCAGCTTAGGGGGCCCGGGGAATCAGCCCCAGCATTTT	CASSLGGPGNQPQHF	TRBV7-9	TRBJ1-5
TGTGCCAGCAGTTTATCAAGGACCATCGCAGAGACCCAGTACTTC	CASSLSRTIAETQYF	TRBV27	TRBJ2-5
TGTGCCAGCAGTACACAGGGCGATACGCAGTATTTT	CASSTQGDTQYF	TRBV28	TRBJ2-3
TGTGCCACCAGTGATACCCGACCAGGGAGGGGGGCCAAAAACATTCAGTACTTC	CATSDTRPGRGAKNIQYF	TRBV24-1	TRBJ2-4
TGTGCTAGTGGACTCCGGGACATTGGCGAAAAACTGTTTTTT	CASGLRDIGEKLFF	TRBV12-5	TRBJ1-4
TGTGCCACGGTACAGGGACAGATTATCCCGTTGGGGGCAACTGAAGCTTTCTTT	CATVQGQIIPLGATEAFF	TRBV24-1	TRBJ1-1
TGTGCCAGCAGTTTTCCGTGGACAGCAAGCTCCTACGAGCAGTACTTC	CASSFPWTASSYEQYF	TRBV27	TRBJ2-7
TGTGCTAGTGGTTTGAGAGCGGGGGAGGGAACTGAAGCTTTCTTT	CASGLRAGEGTEAFF	TRBV12-5	TRBJ1-1
TGTGCCAGCAGCGGGGGGCCCGGGGTAGGGACCCTAGAGGATGGCGAGCAGTACTTC	CASSGGPGVGTLEDGEQYF	TRBV7-6	TRBJ2-7
TGTGCCACCAGCAGAGTCGAGATACGGGGAAACACTGAAGCTTTCTTT	CATSRVEIRGNTEAFF	TRBV15	TRBJ1-1
TGTGCCAGTGCCGGCCCCCCCAGGTGGAATCAGCCCCAGCATTTT	CASAGPPRWNQPQHF	TRBV6-5	TRBJ1-5
TGTGCCACCAACATAATGAGCCACGACAGGGGTGACGGCTACACCTTC	CATNIMSHDRGDGYTF	TRBV15	TRBJ1-2
TGTGCCACCAGCAGATGTAGACAGGGGGAAGGGTTAGGGGGGCCCCAGCATTTT	CATSRCRQGEGLGGPQHF	TRBV15	TRBJ1-5
TGTGCCAGCAGCGGGAAGGGGACAGGGTTGGACAATGAGCAGTTCTTC	CASSGKGTGLDNEQFF	TRBV14	TRBJ2-1
TGTGCCAGCAGCGTGGGGGCACACGGGTATGGCTACACCTTC	CASSVGAHGYGYTF	TRBV9	TRBJ1-2
TGTGCCAGCAGCACCCGGGACACCGGGGAGCTGTTTTTT	CASSTRDTGELFF	TRBV13	TRBJ2-2
TGTGCCAGCAGCCAACCCCCCCCCCCGGCTAGCGGGGAGACCCAGTACTTC	CASSQPPPPASGETQYF	TRBV14	TRBJ2-5
TGTGCCCCGAAAGACAAAGAACATAGCAATCAGCCCCAGCATTTT	CAPKDKEHSNQPQHF	TRBV7-9	TRBJ1-5
TGTGCTGTACGAAGTAGAAACTACGAGCAGTACTTC	CAVRSRNYEQYF	TRBV27	TRBJ2-7
TGTGCCAGCAGCTACCTGGGAGGGGGAGTTTCACCCCTCCACTTT	CASSYLGGGVSPLHF	TRBV7-2	TRBJ1-6
TGTGCCAGCAGCGTAGATAGAAAGGGCCGAGGTGCAACTAATGAAAAACTGTTTTTT	CASSVDRKGRGATNEKLFF	TRBV9	TRBJ1-4
TGCATTCTGAGGGACAGTAGACAGCCCCAGCATTTT	CILRDSRQPQHF	TRBV20-1	TRBJ1-5
TGTGCCAGCAGTTTAGGTTTCAGAGGGACAGGGGCTGACGGATCTGGGGCCAACGTCCTGACTTTC	CASSLGFRGTGADGSGANVLTF	TRBV28	TRBJ2-6
TGTGCCAGCATTCCAAATTTGGACACCGGGGAGCTGTTTTTT	CASIPNLDTGELFF	TRBV27	TRBJ2-2
TGTGCCAGCAGCCCGACGCCAAATGAGCAGTTCTTC	CASSPTPNEQFF	TRBV28	TRBJ2-1
TGTGCCATCGGGGGGTTAGGATACGAGCAGTACTTC	CAIGGLGYEQYF	TRBV6-5	TRBJ2-7
TGTGCCACCAGTGTAGACGGGCGAGGTAGGGGGGCCAAAAACATTCAGTACTTC	CATSVDGRGRGAKNIQYF	TRBV24-1	TRBJ2-4
TGTGGACAGGAGGGCTACACTGAAGCTTTCTTT	CGQEGYTEAFF	TRBV14	TRBJ1-1
TGTGCCAGCAAGGACAGGGGATGGGGAGTCCGCTCCTACGAGCAGTACTTC	CASKDRGWGVRSYEQYF	TRBV27	TRBJ2-7
TGCGCCAGCAGCAAACCTAGCGGGCCACCAGATACGCAGTATTTT	CASSKPSGPPDTQYF	TRBV5-1	TRBJ2-3
TGTGCCAGCAGTTACCTCAATAGACAGGCGTATGTTTGCAATCAGCCCCAGCATTTT	CASSYLNRQAYVCNQPQHF	TRBV6-5	TRBJ1-5
TGTGCCAGTACCCGGGACTGTGATTTAAGGAATTCACCCCTCCACTTT	CASTRDCDLRNSPLHF	TRBV19	TRBJ1-6
TGTGCCAGCAGCGTAGTTTCGTGGGGGGCGCTGTTTTTT	CASSVVSWGALFF	TRBV9	TRBJ1-4
TGTGCCAGGAAAGGCAAACCAGGGGGGCTCTCCTACAATGAGCAGTTCTTC	CARKGKPGGLSYNEQFF	TRBV6-6	TRBJ2-1
TGTGCCAGTGTTTTACCACGGGGGCAGCCCCAGCATTTT	CASVLPRGQPQHF	TRBV19	TRBJ1-5
TGCGCCAGCAGCTTGAGGGGGACAGGTACCTACAATGAGCAGTTCTTC	CASSLRGTGTYNEQFF	TRBV5-1	TRBJ2-1
TGTGCCAGCAGCTCCCTGGGTAACTACGAGCAGTACTTC	CASSSLGNYEQYF	TRBV7-3	TRBJ2-7
TGTGCCAGCAGTTACCACCGTAACGGCGAGACCCAGTACTTC	CASSYHRNGETQYF	TRBV6-2	TRBJ2-5
TGTGCCAGCAGCCCCCTAGATCCGAACACCGGGGAGCTGTTTTTT	CASSPLDPNTGELFF	TRBV5-5	TRBJ2-2
TGCGCCAGCAGCCAACGAGCCGGGACTAGGATATACGAGCAGTACTTC	CASSQRAGTRIYEQYF	TRBV4-1	TRBJ2-7
TGTGCCAGCAGCGTAGCCAGTCCCAGACAAGGGGGGGAAAACACCATATATTTT	CASSVASPRQGGENTIYF	TRBV9	TRBJ1-3
TGTGCCAGCAGTTCATGGGGGATCCAGACTGAAGCTTTCTTT	CASSSWGIQTEAFF	TRBV27	TRBJ1-1
TGTGCCACCAGTGAACCGGACAGAGCGGAGTACACTGAAGCTTTCTTT	CATSEPDRAEYTEAFF	TRBV24-1	TRBJ1-1
TGTGCCAGCAGCGTACCCCCTTCCAGTCCAACGGGATCCTACGAGCAGTACTTC	CASSVPPSSPTGSYEQYF	TRBV13	TRBJ2-7
TGTGCCAGCAGTTACTGCCGACTAGCGGGTTCCTACGAGCAGTACTTC	CASSYCRLAGSYEQYF	TRBV6-5	TRBJ2-7
TGTGCCTTTGGGGGGAGGTTCAATCAGCCCCAGCATTTT	CAFGGRFNQPQHF	TRBV30	TRBJ1-5
TGTGCCAGCAGCGGAGTGTCCCGGACTAGCGGAAGAACACCCACAGATACGCAGTATTTT	CASSGVSRTSGRTPTDTQYF	TRBV6-5	TRBJ2-3
TGTGCCAGCAGCTTCCAGAGGGTTATATCTAATCAGCCCCAGCATTTT	CASSFQRVISNQPQHF	TRBV5-4	TRBJ1-5
TGTGCCAGCAGTTACCCCGGTCAAATTCGGAGGGGTCATAATGGCTACACCTTC	CASSYPGQIRRGHNGYTF	TRBV6-5	TRBJ1-2
TGTGCCAGCAGCTTAGGGGGGGGGACGGGATCCGAAACTGAAGCTTTCTTT	CASSLGGGTGSETEAFF	TRBV7-4	TRBJ1-1
TGTGGTTCAGACAATGAGCAGTTCTTC	CGSDNEQFF	TRBV6-2	TRBJ2-1
TGTGCCAGTAGTAAACGGGGGGAGTGCTCCTACAATGAGCAGTTCTTC	CASSKRGECSYNEQFF	TRBV19	TRBJ2-1
TGTGCCAGCAGCGCGGGGGCCTACGAGCAGTACTTC	CASSAGAYEQYF	TRBV7-3	TRBJ2-7
TGTGCCACCAGCCCAGGGGGCCTGAGTCACACTGAAGCTTTCTTT	CATSPGGLSHTEAFF	TRBV15	TRBJ1-1
TGTGCCAGCAGCAAATGGACAGGGGGCATTTATAGCAATCAGCCCCAGCATTTT	CASSKWTGGIYSNQPQHF	TRBV7-3	TRBJ1-5
TGTGCCAGCATTACTCAAGTTAACGGGGCCCTCTCTGATACGCAGTATTTT	CASITQVNGALSDTQYF	TRBV6-2	TRBJ2-3
TGCAGTGCGGGCCGAGGATTAGGGGATACGCAGTATTTT	CSAGRGLGDTQYF	TRBV20-1	TRBJ2-3
TGTGCCATCATCAGCGGGAAGGTGACAAACACCATATATTTT	CAIISGKVTNTIYF	TRBV10-3	TRBJ1-3
TGTGCCAGCAGTTACCCCCTGTTAACAGATACGCAGTATTTT	CASSYPLLTDTQYF	TRBV6-6	TRBJ2-3
TGTGCCAGCAGTTACAGAACTCCGGGTCACCCCACTGAAGCTTTCTTT	CASSYRTPGHPTEAFF	TRBV6-5	TRBJ1-1
TGTGCCAGCAGCTCTCCCCTAGCGGGGGTATACTACGAGCAGTACTTC	CASSSPLAGVYYEQYF	TRBV5-6	TRBJ2-7
TGTGCCAGCAGTTTCTCTAGCGGAGAGACCCAGTACTTC	CASSFSSGETQYF	TRBV7-6	TRBJ2-5
TGTGCCAGCAGCTTAGGGACAGGGGTTAGCTACGTGTACAATGAGCAGTTCTTC	CASSLGTGVSYVYNEQFF	TRBV11-3	TRBJ2-1
TGTGCCAGCTCACCACAGTCCCGGGGACAGGGTACAAATGAAAAACTGTTTTTT	CASSPQSRGQGTNEKLFF	TRBV18	TRBJ1-4
TGCATTATGGGGGACATGAGCAATCAGCCCCAGCATTTT	CIMGDMSNQPQHF	TRBV20-1	TRBJ1-5
TGTGCCAGCAGTGAACTGGCGACTGAAGCTTTCTTT	CASSELATEAFF	TRBV6-1	TRBJ1-1
TGTGCCAGCAGGCTTCAAAGGGATGAGCAGTTCTTC	CASRLQRDEQFF	TRBV5-5	TRBJ2-1
TGTGCCAGCAGGTACGGACTAGCGGTATCGCCTTCCTACAATGAGCAGTTCTTC	CASRYGLAVSPSYNEQFF	TRBV6-5	TRBJ2-1
TGTGCCAGCAGCCCATTCCTGACTAGTTTTAGCACAGATACGCAGTATTTT	CASSPFLTSFSTDTQYF	TRBV11-2	TRBJ2-3
TGTGCCAGCAGCCCGGGGGGACGTGTGTATGGCTACACCTTC	CASSPGGRVYGYTF	TRBV3-1	TRBJ1-2
TGCGCCAGCACCTGGGACAGGGGGCGCAGCTCTGGGGCCAACGTCCTGACTTTC	CASTWDRGRSSGANVLTF	TRBV10-1	TRBJ2-6
TGTGCCAGCAGTTTGTGGGGGGCTGGAAACACCATATATTTT	CASSLWGAGNTIYF	TRBV28	TRBJ1-3
TGTGCCAGCAGCGAGGGACAGCGTAGCTCCTACGAGCAGTACTTC	CASSEGQRSSYEQYF	TRBV9	TRBJ2-7
TGTGCCAGCAGTTACTATAAAGGGGGGGCTTCGTGCACAGATACGCAGTATTTT	CASSYYKGGASCTDTQYF	TRBV6-5	TRBJ2-3
TGCGCCAGCAGCCGGGAGGCAGTCTACGAGCAGTACTTC	CASSREAVYEQYF	TRBV4-3	TRBJ2-7
TGTGCCAGCAGTTGCCGGGACTGCGCTAATGAAAAACTGTTTTTT	CASSCRDCANEKLFF	TRBV28	TRBJ1-4
TGCAGTGTTAGGGGGCACAATCAGCCCCAGCATTTT	CSVRGHNQPQHF	TRBV20-1	TRBJ1-5
TGTGCCAGCAGCTTAGCCCTCCCGCCGGGCGGATTGAACACTGAAGCTTTCTTT	CASSLALPPGGLNTEAFF	TRBV7-6	TRBJ1-1
TGTGCCAGCAGCTGGGACACTAGCGGGAGAACCTACGAGCAGTACTTC	CASSWDTSGRTYEQYF	TRBV11-2	TRBJ2-7
TGTGCCAGCAGCGCCGTGTGGGCAGATACGCAGTATTTT	CASSAVWADTQYF	TRBV6-5	TRBJ2-3
TGTGCCAGCATCCTACCTACTGGGGCCGGCAATCAGCCCCAGCATTTT	CASILPTGAGNQPQHF	TRBV6-5	TRBJ1-5
TGTGCCACTATGGTCGACCAGCTTCAGGTGAAAGCAGATACGCAGTATTTT	CATMVDQLQVKADTQYF	TRBV28	TRBJ2-3
TGCAGTGCTAGAACAATACGGCAAGAGACCCAGTACTTC	CSARTIRQETQYF	TRBV20-1	TRBJ2-5
TGTGCCAGCAGCCAAGTCTCGTGTCTAGGAACTCCTGGGACCTACGAGCAGTACTTC	CASSQVSCLGTPGTYEQYF	TRBV14	TRBJ2-7
TGTGCCACCAACCGACAGGAGGTTAGCTATGGCTACACCTTC	CATNRQEVSYGYTF	TRBV12-3	TRBJ1-2
TGCGCCAAGGGGACGTGGTGGAGCTCCTATAATTCACCCCTCCACTTT	CAKGTWWSSYNSPLHF	TRBV10-2	TRBJ1-6
TGTGCCAGGGGGAGGGCCCTAACCGGGGAGCTGTTTTTT	CARGRALTGELFF	TRBV19	TRBJ2-2
TGTGCCAGCAGGGAGCGGGAATACAACGGAGATACGCAGTATTTT	CASREREYNGDTQYF	TRBV9	TRBJ2-3
TGTGCCAGCAGCCGCGGGGACAGTCCATATCAGCCCCAGCATTTT	CASSRGDSPYQPQHF	TRBV7-2	TRBJ1-5
TGCAGCCTCTGTTTAGGGTTTTGTAACTATGGCTACACCTTC	CSLCLGFCNYGYTF	TRBV29-1	TRBJ1-2
TGTGCCAGCAGCGCGGGACAGGGGAGCTCCTATAATTCACCCCTCCACTTT	CASSAGQGSSYNSPLHF	TRBV9	TRBJ1-6
TGTGCCAGCAGCAAGAAGGCAGGCTATGGCTACACCTTC	CASSKKAGYGYTF	TRBV6-1	TRBJ1-2
TGTGCCAGCAGCCCGGGGAACACTGAAGCTTTCTTT	CASSPGNTEAFF	TRBV13	TRBJ1-1
TGTGCCAGCAGCGTAGGCCCGGCGAAGAGGACAGGCGGTGGCTACACCTTC	CASSVGPAKRTGGGYTF	TRBV9	TRBJ1-2
TGTGCCAGCAGTTCCTGGAGGGTAGGCAATGAGCAGTTCTTC	CASSSWRVGNEQFF	TRBV12-4	TRBJ2-1
TGTGCCAGCAGCTTCTACGGGGGACATAATTCACCCCTCCACTTT	CASSFYGGHNSPLHF	TRBV11-3	TRBJ1-6
TGTGCCAGCAGCCGGTGGGCCCAGGCGAACACCGGGGAGCTGTTTTTT	CASSRWAQANTGELFF	TRBV16	TRBJ2-2
TGTGCCACCAGTGAAACCAGCAGCGGGGGCAATCAGCCCCAGCATTTT	CATSETSSGGNQPQHF	TRBV24-1	TRBJ1-5
TGTGCCAGCAGCCAAGAATACCGGACAGTAGGGGGGAGGTCCTACACTGAAGCTTTCTTT	CASSQEYRTVGGRSYTEAFF	TRBV4-2	TRBJ1-1
TGCAGTGCTTCGAGGGTAGCAGCCTTC	CSASRVAAF	TRBV20-1	TRBJ2-5
TGTGCCAGCAGCCCCCTGCCCGAGGGGCACTGTAACTATGGCTACACCTTC	CASSPLPEGHCNYGYTF	TRBV13	TRBJ1-2
TGTGCCAGCAGCCCCGGGATTTTGGGAGATTCACCCCTCCACTTT	CASSPGILGDSPLHF	TRBV11-2	TRBJ1-6
TGTGCCAGCGACCGGGACAGGGTACGCCCTTCGCAGCCCCAGCATTTT	CASDRDRVRPSQPQHF	TRBV6-4	TRBJ1-5
TGTGCCAGCACAGCCCAGGGAGGGGAAAAACTGTTTTTT	CASTAQGGEKLFF	TRBV2	TRBJ1-4
TGTGCCAGCAGCCAAGAGGGGGCTGGGGCCAACGTCCTGACTTTC	CASSQEGAGANVLTF	TRBV3-1	TRBJ2-6
TGTGCCAGCAGCCCCCCGGACAGGAACACTGAAGCTTTCTTT	CASSPPDRNTEAFF	TRBV7-3	TRBJ1-1
TGCGCCAGCAGCCAATACACGCCAGCCCCCCCTAAGCCCCAGCATTTT	CASSQYTPAPPKPQHF	TRBV4-3	TRBJ1-5
TGTGCCAGCAGCTTAGAGGGGGCCACCATATATTTT	CASSLEGATIYF	TRBV7-9	TRBJ1-3
TGTGCCAGCAGTAACCCACTGCTTAGGGTTGAGGACCCGTATTTT	CASSNPLLRVEDPYF	TRBV28	TRBJ2-3
TGTGCCAGCTCATGGGACTCCCCCGGGGAGCTGTTTTTT	CASSWDSPGELFF	TRBV18	TRBJ2-2
TGCAGCGCGGCGAGCGGGAGGGATGAAATCACAGATACGCAGTATTTT	CSAASGRDEITDTQYF	TRBV29-1	TRBJ2-3
TGTGCCAGCAGCCCCCAATTCCTAGCGGGGGGTATCTGTACGCAGTATTTT	CASSPQFLAGGICTQYF	TRBV13	TRBJ2-3
TGTGCCAGCAGCGAACGCACTTTTCCCACCGGATGTTGCTACACCTTC	CASSERTFPTGCCYTF	TRBV3-1	TRBJ1-2
TGTGCCTGGTCAGGGCGATGTCCCGGAAACACCATATATTTT	CAWSGRCPGNTIYF	TRBV30	TRBJ1-3
TGTGCCAGCAGCTTACGGCCGTCGGGACAGCGCAATCAGCCCCAGCATTTT	CASSLRPSGQRNQPQHF	TRBV11-3	TRBJ1-5
TGCAGTGCAATTACGGCTAATGAGCAGTTCTTC	CSAITANEQFF	TRBV20-1	TRBJ2-1
TGCGCCAGACAGGGCCATGGAAAAACCGGGGAGCTGTTTTTT	CARQGHGKTGELFF	TRBV5-1	TRBJ2-2
TGTGCCAGCAGCTTGTATTACCAGGGGAAGGATACGCAGTATTTT	CASSLYYQGKDTQYF	TRBV7-9	TRBJ2-3
TGTGCCAGCAGCCGGTGGGATGCCACAGATACGCAGTATTTT	CASSRWDATDTQYF	TRBV12-3	TRBJ2-3
