TGCGCCATCACGGGACAGAATGCTCAGACCCAGTACTTC	CAITGQNAQTQYF	TRBV10-1	TRBJ2-5
TGCAGCGTAGGAAGACGGGACAGGGGTTCTCCGGGCAGGTGGACTGAAGCTTTCTTT	CSVGRRDRGSPGRWTEAFF	TRBV29-1	TRBJ1-1
TGCAGCGTTGTGCCCCCGACGACAGGAGATTCGAAAGAGACCCAGTACTTC	CSVVPPTTGDSKETQYF	TRBV29-1	TRBJ2-5
TGCGCCAGCAGCCCCCTAGGATTAGCCAAAAACATTCAGTACTTC	CASSPLGLAKNIQYF	TRBV5-1	TRBJ2-4
TGTGCCAGCAGTTTATTTAATACTAATGAAAAACTGTTTTTT	CASSLFNTNEKLFF	TRBV27	TRBJ1-4
TGCAGTGCTCTGGGAGGCTATGGCTACACCTTC	CSALGGYGYTF	TRBV20-1	TRBJ1-2
TGTGCCTGGAGTGTATCCACAGATGGAACAAACCGGACGAACACTGAAGCTTTCTTT	CAWSVSTDGTNRTNTEAFF	TRBV30	TRBJ1-1
TGTGCCAGCAGCGTAAAGGGGGGGCTCCGACGAACAAAAGAGGAAGACACTGAAGCTTTCTTT	CASSVKGGLRRTKEEDTEAFF	TRBV9	TRBJ1-1
TGCGCCAGCAGGCGGTCCGTTAAAGGTCTGGACAGGGGGCATCAGCCCCAGCATTTT	CASRRSVKGLDRGHQPQHF	TRBV5-1	TRBJ1-5
TGCAGCGTTGATATAGGCGTGACTGAGCAGTTCTTC	CSVDIGVTEQFF	TRBV29-1	TRBJ2-1
TGTGCCAGCTCACCACGAGTCGGACTAGCGGGGAATGAGTTACCCGGGGAGCTGTTTTTT	CASSPRVGLAGNELPGELFF	TRBV18	TRBJ2-2
TGTGCCAGCAGCTGTCGTATAGCGGGCGTAAACATTCAGTACTTC	CASSCRIAGVNIQYF	TRBV7-9	TRBJ2-4
TGCGCCAGCAGCGCTCAAGTGACAGGGGGGAAGTACGAGCAGTACTTC	CASSAQVTGGKYEQYF	TRBV5-1	TRBJ2-7
TGTGCCAGCAGCTGGGCAGGGGTGAACACTGAAGCTTTCTTT	CASSWAGVNTEAFF	TRBV7-2	TRBJ1-1
TGTGCCAGTAGTATAGATGCACCTAGCGGGAACAATGAGCAGTTCTTC	CASSIDAPSGNNEQFF	TRBV19	TRBJ2-1
TGTGCCAGCAGTACTGGTGACAGGGGTGAGCAGTTCTTC	CASSTGDRGEQFF	TRBV6-5	TRBJ2-1
TGTGCCAGCTACGAGGAACGACCGGGATACACCACCTTC	CASYEERPGYTTF	TRBV9	TRBJ1-2
TGTGCCAGCAGCAAAATGGCGACTGTGTCCGAGCAGTACTTC	CASSKMATVSEQYF	TRBV14	TRBJ2-7
TGTGCCAGCAGCCATGCACACCCACCAGCACACGGGGAGCTGTTTTTT	CASSHAHPPAHGELFF	TRBV14	TRBJ2-2
TGCGCCACTAGCGGGACAATGTCAGAGCACACCGGGGAGCTGTTTTTT	CATSGTMSEHTGELFF	TRBV10-1	TRBJ2-2
TGCAGTGCCCCACTAGCGGGAGGACGCTCAAACACCATATATTTT	CSAPLAGGRSNTIYF	TRBV20-1	TRBJ1-3
TGTGCCAGGACCAGGCAGCGGGACTACGAGCAGTACTTC	CARTRQRDYEQYF	TRBV14	TRBJ2-7
TGTGCCATCAGGGTCGGACTTCATGACACTGAAGCTTTCTTT	CAIRVGLHDTEAFF	TRBV10-3	TRBJ1-1
TGTGCCAGCAGCTTATCGGGGGGGCCTACCAGCTCCTACAATGAGCAGTTCTTC	CASSLSGGPTSSYNEQFF	TRBV13	TRBJ2-1
TGTGCCAGCAGTGAAAAGTGTTGGGGACAGGTATCTAACTATGGCTACACCTTC	CASSEKCWGQVSNYGYTF	TRBV2	TRBJ1-2
TGTGCCAGCAGTAGGCGGGAGACCTGCAATCAGCCCCAGCATTTT	CASSRRETCNQPQHF	TRBV6-3	TRBJ1-5
TGTGCCACCAGCAGCCAGCCCGGGACAGTGTTTGGCTACACCTTC	CATSSQPGTVFGYTF	TRBV15	TRBJ1-2
TGTGCCAGCAGCTTACGGGACAGTAGGGACACCATATATTTT	CASSLRDSRDTIYF	TRBV11-3	TRBJ1-3
TGTGCCAGTAGTACTAGTCAGGACTACGAGCAGTACTTC	CASSTSQDYEQYF	TRBV19	TRBJ2-7
TGTGCCAGCAGGTTACCACAACTAGCGGGAGGACGGGCTTTCTTT	CASRLPQLAGGRAFF	TRBV6-2	TRBJ1-1
TGTGCCAGCAGCCAACGCCAAGGGGACAGTAAGTGGAACACTGAAGCTTTCTTT	CASSQRQGDSKWNTEAFF	TRBV14	TRBJ1-1
TGTGCCAGCAGTCCTCCTTTTGGAAACACCATATATTTT	CASSPPFGNTIYF	TRBV27	TRBJ1-3
TGTGCCAGCAGCTCTTTTTTCGAGGGGGCAGATACGCAGTATTTT	CASSSFFEGADTQYF	TRBV7-7	TRBJ2-3
TGCGCCAGCAGCTTTGGCCAGATGAAGGACACTGAAGCTTTCTTT	CASSFGQMKDTEAFF	TRBV5-1	TRBJ1-1
TGTGCCAGCAGCTTGGGCTACGTCCCAGGGGGGAACACTGAAGCTTTCTTT	CASSLGYVPGGNTEAFF	TRBV5-4	TRBJ1-1
TGTGCCAGCAGCTTACGAAAGCGGGAACCCTTCGGCTACGAGCAGTACTTC	CASSLRKREPFGYEQYF	TRBV7-3	TRBJ2-7
TGTGCCAGCAGCTGCCCCCTCTCGACAGCATATGAACGGGGAAACACTGAAGCTTTCTTT	CASSCPLSTAYERGNTEAFF	TRBV7-6	TRBJ1-1
TGTGCCAGCAGCCATTCCGAGACAGGAGCCTGCTACGAGCAGTACTTC	CASSHSETGACYEQYF	TRBV13	TRBJ2-7
TGCAGTGCAGGGGACAGGGACACCGGGGAGCTGTTTTTT	CSAGDRDTGELFF	TRBV20-1	TRBJ2-2
TGTGCCAGCAGTTTGGGACGCTACAATGAGCAGTTCTTC	CASSLGRYNEQFF	TRBV28	TRBJ2-1
TGTGCCAGCAGGGCGGGGCAACTAGCGGGGGGGCCATATGAGCAGTTCTTC	CASRAGQLAGGPYEQFF	TRBV6-3	TRBJ2-1
TGCGCCAGCAGCTCTGTCCAGTGCTACACCTTC	CASSSVQCYTF	TRBV5-1	TRBJ1-2
TGTGCCAGTAGTCCTCCGGGACAGTATAGCAATCAGCCCCAGCATTTT	CASSPPGQYSNQPQHF	TRBV19	TRBJ1-5
TGTGCCAGCAGCCAATTAAGCGGGAAACATGAGCAGTACTTC	CASSQLSGKHEQYF	TRBV4-2	TRBJ2-7
TGTGCCAGCAGTTTACCTCTAGCGGAGGAAGAGCAGTACTTC	CASSLPLAEEEQYF	TRBV12-4	TRBJ2-7
TGTGCCAGCGGGACAGGGGAGCATTCAGATACGCAGTATTTT	CASGTGEHSDTQYF	TRBV7-9	TRBJ2-3
TGTGCCAGCTCACCGCCGAAACAGGGGGCGGCTCCTAACTATGGCTACACCTTC	CASSPPKQGAAPNYGYTF	TRBV18	TRBJ1-2
TGTGCCAGCAACAGAGGGTACCAAGAGACCCAGTACTTC	CASNRGYQETQYF	TRBV18	TRBJ2-5
TGTGCCAGCAGCCCTGGTCAGCGGGGGGGAGGCGACTACGAGCAGTACTTC	CASSPGQRGGGDYEQYF	TRBV13	TRBJ2-7
TGTGCCAGCAGACGTCGACCGACCACTGAAGCTTTCTTT	CASRRRPTTEAFF	TRBV2	TRBJ1-1
TGCGCCAGCAGCTTCGGACAGGGACTAATGGGGTCTAAGGGGTCCTACGAGCAGTACTTC	CASSFGQGLMGSKGSYEQYF	TRBV5-1	TRBJ2-7
TGTGCCACCAGTGCCCCTGGGAGGACCCAGCCCCAGCATTTT	CATSAPGRTQPQHF	TRBV24-1	TRBJ1-5
TGTGCCAGCAGGATTGGGACAGGGCTTAATAGCAATCAGCCCCAGCATTTT	CASRIGTGLNSNQPQHF	TRBV2	TRBJ1-5
TGTGCCAGCAGTCTCGGGGCCCTCTCTGGAAACACCATATATTTT	CASSLGALSGNTIYF	TRBV2	TRBJ1-3
TGTGCCATCCCCCGGTACTATGGCTACACCTTC	CAIPRYYGYTF	TRBV27	TRBJ1-2
TGCGCCAGCAGCCAAGTCGGCAGGGTGTGGCGGAGAGGAAACACCATATATTTT	CASSQVGRVWRRGNTIYF	TRBV4-1	TRBJ1-3
TGTGCCAGCAGAACCCATAGAACAGGGGGCGACTCCTACAATGAGCAGTTCTTC	CASRTHRTGGDSYNEQFF	TRBV6-5	TRBJ2-1
TGTGCCAGCAGCTTGACCGTTCACAGGGGGCGGGATGGCTACACCTTC	CASSLTVHRGRDGYTF	TRBV5-4	TRBJ1-2
TGTGCCAGCAGCTTAACAAAGGACAGGGGTGTAGACACTGAAGCTTTCTTT	CASSLTKDRGVDTEAFF	TRBV7-3	TRBJ1-1
TGTGCCACCAGCAGTAACCGGGACAGGGAAGGAAAACTGTTTTTT	CATSSNRDREGKLFF	TRBV24-1	TRBJ1-4
TGTGCCAGTAGAAGCGGGGCAATAACTGAAAAACTGTTTTTT	CASRSGAITEKLFF	TRBV19	TRBJ1-4
TGTGCCAGCAGCCGGACTGTGGGGCCAAACTATGGCTACACCTTC	CASSRTVGPNYGYTF	TRBV14	TRBJ1-2
TGTGCCATCAAAAGCGGGACAGGGGCTTACGAGCAGTACTTC	CAIKSGTGAYEQYF	TRBV10-3	TRBJ2-7
TGTGCCAGCAGTTTCCGGGTAGATCAGCCCCAGCATTTT	CASSFRVDQPQHF	TRBV6-3	TRBJ1-5
TGTGCCTGGTTAAGGGGTCCGGGCAATCAGCCCCAGCATTTT	CAWLRGPGNQPQHF	TRBV30	TRBJ1-5
TGTGCCAGCACCGATGCGGCCGGGGTTGGCTACACCTTC	CASTDAAGVGYTF	TRBV27	TRBJ1-2
TGCAGTGCTAGAGACTCCTGGGACAGGGCTAACGGGGAGCTGTTTTTT	CSARDSWDRANGELFF	TRBV20-1	TRBJ2-2
TGTGCCATCAGCAATCCCGGAGGGTCCTACGAGCAGTACTTC	CAISNPGGSYEQYF	TRBV10-3	TRBJ2-7
TGTGCCACCAGTGATTTGGACGGGGAGATTGCCGGGGAGCTGTTTTTT	CATSDLDGEIAGELFF	TRBV24-1	TRBJ2-2
TGTGCCACCGGGACTAGAGGGAGCTCCTACAATGAGCAGTTCTTC	CATGTRGSSYNEQFF	TRBV10-3	TRBJ2-1
TGTGCCAGCAGCCTAGAGTACCCGGGACAGGGCGGACCATATAATTCACCCCTCCACTTT	CASSLEYPGQGGPYNSPLHF	TRBV5-6	TRBJ1-6
TGCAGTGCTAGAGATCTCTGTAGCTCCTACGAGCAGTACTTC	CSARDLCSSYEQYF	TRBV20-1	TRBJ2-7
TGTGCCAGCAGCGGACCAGTGTCTGAGCAGTTCTTC	CASSGPVSEQFF	TRBV7-3	TRBJ2-1
TGTGCCAGCAGAACAAGACAGTACTTC	CASRTRQYF	TRBV12-3	TRBJ2-5
TGCGCCAGCAGCGCCCGGCCTGTTAGCTCCTACAATGAGCAGTTCTTC	CASSARPVSSYNEQFF	TRBV4-1	TRBJ2-1
TGTGCCATCAGTGAGTCTTCCGGGGACAGGGGTAGCACAGATACGCAGTATTTT	CAISESSGDRGSTDTQYF	TRBV10-3	TRBJ2-3
TGCGCCAGCAGCGCTAACAGGGGGCGGTCAGCTGGGGCCAACGTCCTGACTTTC	CASSANRGRSAGANVLTF	TRBV5-1	TRBJ2-6
TGTGCCAACAGGGTGGAATATGGCTACACCTTC	CANRVEYGYTF	TRBV13	TRBJ1-2
TGTGCCAGTAGTATCCGGGGACGGAGAGAGACCCAGTACTTC	CASSIRGRRETQYF	TRBV19	TRBJ2-5
TGTGCCTCGGGACTAGCGGGGGTAGAGACCCAGTACTTC	CASGLAGVETQYF	TRBV10-3	TRBJ2-5
TGTGCCAGCAATCGGACAGAGTTGAACGAGCAGTACTTC	CASNRTELNEQYF	TRBV27	TRBJ2-7
TGTGCCAGCAGTGGCCCTCGGGACAGGGGCGGGTACTATGGCTACACCTTC	CASSGPRDRGGYYGYTF	TRBV6-4	TRBJ1-2
TGCGCCAGCAGCTTGGGCCCTAAACCCCCGTTCCGGGACCCGGGTTACGAGCAGTACTTC	CASSLGPKPPFRDPGYEQYF	TRBV5-1	TRBJ2-7
TGCAGGGGGGGCCGGGCAGATACGCAGTATTTT	CRGGRADTQYF	TRBV29-1	TRBJ2-3
TGTGCCAGCAGTAAAGGGGTAGGACAGGGGGGGGGGCCCCAGCATTTT	CASSKGVGQGGGPQHF	TRBV27	TRBJ1-5
TGTGCCAGCTCACCACTGGGGCCCTACTATGGCTACACCTTC	CASSPLGPYYGYTF	TRBV18	TRBJ1-2
TGTGCCAGCAGTTGTGACAGGGAGAGCTCCTACAATGAGCAGTTCTTC	CASSCDRESSYNEQFF	TRBV27	TRBJ2-1
TGTGCCCTCCGGGACTCTAGAGACTACGAGCAGTACTTC	CALRDSRDYEQYF	TRBV6-1	TRBJ2-7
TGTGCCAGCATTAGATTCGGGGGATACCCTAGCTCCTACAATGAGCAGTTCTTC	CASIRFGGYPSSYNEQFF	TRBV27	TRBJ2-1
TGCGCCAGCAGCTTGTCCAGGGGGGATTCCTACAATGAGCAGTTCTTC	CASSLSRGDSYNEQFF	TRBV5-1	TRBJ2-1
TGTGCCAGCAGCTTAGTTAGCGGGGATTCCCAGAAGGGATCTCCTTACAATGAGCAGTTCTTC	CASSLVSGDSQKGSPYNEQFF	TRBV5-6	TRBJ2-1
TGCAGTGCTAGAGACAGACAGGAAGGCTCTGGAAACACCATATATTTT	CSARDRQEGSGNTIYF	TRBV20-1	TRBJ1-3
TGTGCCAGCAGCTTACTCAGGACGGACTCCTACAATGAGCAGTTCTTC	CASSLLRTDSYNEQFF	TRBV7-3	TRBJ2-1
TGTGCCAGCAGTGAAAATATGGGGGCCAAGGAGACCCAGTACTTC	CASSENMGAKETQYF	TRBV6-1	TRBJ2-5
TGTGCCAGCAGTTACTTAGTTGGGACTAGCGGGGGGCTCTACAATGAGCAGTTCTTC	CASSYLVGTSGGLYNEQFF	TRBV6-5	TRBJ2-1
TGTGCCACCAGTGAACTAGCGAATGGCAGCAATCAGCCCCAGCATTTT	CATSELANGSNQPQHF	TRBV24-1	TRBJ1-5
TGTGCCAGCAGTGTCACCAATGGCTACACCTTC	CASSVTNGYTF	TRBV27	TRBJ1-2
TGCAGCGTTAGGGGACGTATTCGCGAGCAGTTCTTC	CSVRGRIREQFF	TRBV29-1	TRBJ2-1
TGCAGTGCTTCCACGGGACCCGGCGTCTACGAGCAGTACTTC	CSASTGPGVYEQYF	TRBV20-1	TRBJ2-7
TGCAGAACTAGCGTGAGCACAGATACGCAGTATTTT	CRTSVSTDTQYF	TRBV20-1	TRBJ2-3
TGTGCCAGCAGCGATGTTCGGTCGGGGAGACATGAGCAGTTCTTC	CASSDVRSGRHEQFF	TRBV13	TRBJ2-1
TGTGCCAGCAGCTCAGGGCGGAGGGTACACAGCCAGCCCCAGCATTTT	CASSSGRRVHSQPQHF	TRBV6-3	TRBJ1-5
TGTGCCACCAGCAGAGAGGGCCACCCACAGGCCAGGAGCTACGAGCAGTACTTC	CATSREGHPQARSYEQYF	TRBV15	TRBJ2-7
TGTGCCAGCTACAAAAGAGCCGGGGGCCTTCGGCTGGCTCGCAATGAGCAGTTCTTC	CASYKRAGGLRLARNEQFF	TRBV7-9	TRBJ2-1
TGTGCCAGCAGCTATACGGGGGCGTACGAGCAGTACTTC	CASSYTGAYEQYF	TRBV5-6	TRBJ2-7
TGTGCCAGCAGCCAAGCCCCCTGGGGGGGCCAGGGGTACAATGAGCAGTTCTTC	CASSQAPWGGQGYNEQFF	TRBV14	TRBJ2-1
TGTGCCAGCAGCTTAGGGAGGGATGCTGCTACATTGCACTACGAGCAGTACTTC	CASSLGRDAATLHYEQYF	TRBV7-2	TRBJ2-7
TGCGCCAGCAGCGTTCCGCCTGGATGGGGGGGGAATTCCTACAATGAGCAGTTCTTC	CASSVPPGWGGNSYNEQFF	TRBV5-1	TRBJ2-1
TGTGCCAGCCACGAGTTATACGAGCAGTACTTC	CASHELYEQYF	TRBV6-1	TRBJ2-7
TGTGCCACCAGTGATTGTGGGACTAGCGGGTCAATAAGATATGAGCAGTTCTTC	CATSDCGTSGSIRYEQFF	TRBV24-1	TRBJ2-1
TGCGCCAGCAGCCTTGCCAAGTGGACAGGAGGACTTGGGTCCTACGAGCAGTACTTC	CASSLAKWTGGLGSYEQYF	TRBV4-1	TRBJ2-7
TGTGCCAGCAGCGCTCTCTCCTACGAGCAGTACTTC	CASSALSYEQYF	TRBV7-2	TRBJ2-7
TGTGCTAGTGGTTTGGACCGGGACAGGGTGTGCAATCAGCCCCAGCATTTT	CASGLDRDRVCNQPQHF	TRBV12-5	TRBJ1-5
TGTGCCAGCAGCCTCCATCCCTCAGGGGGCGAGGCCCCCATCTACGAGCAGTACTTC	CASSLHPSGGEAPIYEQYF	TRBV13	TRBJ2-7
TGTGCCAGCAGCTTTTGTTCCCAGGCCCAGCACGAGCAGTACTTC	CASSFCSQAQHEQYF	TRBV11-2	TRBJ2-7
TGTGCTCAACAGTACACCGGGGAGCTGTTTTTT	CAQQYTGELFF	TRBV27	TRBJ2-2
TGTGCCAGCAGCGCAAATCCAGGGAAGGATTCCTATGGCTACACCTTC	CASSANPGKDSYGYTF	TRBV9	TRBJ1-2
TGTGCCAGCAGCTCCCCTAGTGAGCAGTACTTC	CASSSPSEQYF	TRBV7-9	TRBJ2-7
TGTGCCAGCAGTTACAAAGCCCAGACGGGAGAGGCTAGCAATCAGCCCCAGCATTTT	CASSYKAQTGEASNQPQHF	TRBV6-5	TRBJ1-5
TGTGCCAGCAGCAAACAGGGGCCGAGCTCTGGGGCCAACGTCCTGACTTTC	CASSKQGPSSGANVLTF	TRBV13	TRBJ2-6
TGTGCCAGCAGCCAGGGGGGCACAGATACGCAGTATTTT	CASSQGGTDTQYF	TRBV12-4	TRBJ2-3
TGTGCCAGCAGTGGACTACTAGTCGGAAACACCATATATTTT	CASSGLLVGNTIYF	TRBV6-2	TRBJ1-3
TGTGCCTTCTGTCACAATCAGCCCCAGCATTTT	CAFCHNQPQHF	TRBV30	TRBJ1-5
TGTGCCCCCGCCGGGGTGATCTCCTACGAGCAGTACTTC	CAPAGVISYEQYF	TRBV7-8	TRBJ2-7
TGTGCCAGCAGCCAAGCGGCCGGGCCGACTAGCGTCTCCTACGAGCAGTACTTC	CASSQAAGPTSVSYEQYF	TRBV14	TRBJ2-7
TGTGGGGTCCACTATGGCTACACCTTC	CGVHYGYTF	TRBV24-1	TRBJ1-2
TGTGCCTGGCCGACGGAGAGCTTGGTGAACACTGAAGCTTTCTTT	CAWPTESLVNTEAFF	TRBV30	TRBJ1-1
TGTGCCAGCAGTTACGTAGCCCCGGGACTAGGGTTATTTAGCTCCTACAATGAGCAGTTCTTC	CASSYVAPGLGLFSSYNEQFF	TRBV6-5	TRBJ2-1
TGCGCCAATGAAAGGGGAAATATAATGTCAGCTTTCTTT	CANERGNIMSAFF	TRBV10-1	TRBJ1-1
TGTGCCAGCAGCAACCTTAAGGGGTCTGGAAACACCATATATTTT	CASSNLKGSGNTIYF	TRBV9	TRBJ1-3
TGTGCCAGCAGCCAGGGCCACGAAAAACTGTTTTTT	CASSQGHEKLFF	TRBV7-3	TRBJ1-4
TGTGCCAGCAGCTTGCCCTCTAGCGGGGTTACTAGCGTTCCAGACTCCTACGAGCAGTACTTC	CASSLPSSGVTSVPDSYEQYF	TRBV5-4	TRBJ2-7
TGCAGCGTTGATCAGACCGGGACAGGGGGGAACACTGAAGCTTTCTTT	CSVDQTGTGGNTEAFF	TRBV29-1	TRBJ1-1
TGTGCCAGCAGCCATCCAACTCGAAGGGGAATGAGTGAAAGCAATCAGCCCCAGCATTTT	CASSHPTRRGMSESNQPQHF	TRBV14	TRBJ1-5
TGTGCCAGCAGTGACACAGGGCGCGGCTACGAGCAGTACTTC	CASSDTGRGYEQYF	TRBV6-1	TRBJ2-7
TGCAGCGTTGGGAAGCGGGAGAGCATTCAGTACTTC	CSVGKRESIQYF	TRBV29-1	TRBJ2-4
TGTGCCAGCAGCTTAGTCCATCGGAAGGATGGCTACACCTTC	CASSLVHRKDGYTF	TRBV7-4	TRBJ1-2
TGTGCCACCAGGGTTCCGGGACTAGCGGGAAGACGCACAGATACGCAGTATTTT	CATRVPGLAGRRTDTQYF	TRBV24-1	TRBJ2-3
TGCGCCAGCAGCCCGACAGGGCATGGCTACACCTTC	CASSPTGHGYTF	TRBV5-1	TRBJ1-2
TGTGCCAGCAGTGTGACCTTAAGCAACGGTAAGTTCTGGCCCCGGGGCGGCAGGTGTGAAGCTTTCTTT	CASSVTLSNGKFWPRGGRCEAFF	TRBV6-1	TRBJ1-1
TGTGCCAGCAGAAAGCCCCGGCCTCGGGGCACCGGGGAGCTGTTTTTT	CASRKPRPRGTGELFF	TRBV6-6	TRBJ2-2
TGTCTGAATAGGGGCGCGCCCGTCACAGATACGCAGTATTTT	CLNRGAPVTDTQYF	TRBV6-6	TRBJ2-3
TGTGCCACCAGTGCTCCGGACGGGAGCCCGAACGAGCAGTACTTC	CATSAPDGSPNEQYF	TRBV24-1	TRBJ2-7
TGTGAAGAGAATTGGGACCCAAGAGGTGACTATGGCTACACCTTC	CEENWDPRGDYGYTF	TRBV6-5	TRBJ1-2
TGTGCCAGCATTGGGGGTAGCAATCAGCCCCAGCATTTT	CASIGGSNQPQHF	TRBV28	TRBJ1-5
TGCAGTGCTAGGGGGGCAAGGTCCCTCCACTTT	CSARGARSLHF	TRBV20-1	TRBJ1-6
TGTGCCAGCAGGTTTAGATCCTACGAGCAGTACTTC	CASRFRSYEQYF	TRBV27	TRBJ2-7
TGCGCCAGCAGCCATTATCTTCCTGGGTTCAATGAGCAGTTCTTC	CASSHYLPGFNEQFF	TRBV5-1	TRBJ2-1
TGCGCCAGCAGCTTGGTACATCGCGCCGGTTACAATGAGCAGTTCTTC	CASSLVHRAGYNEQFF	TRBV5-1	TRBJ2-1
TGTGCCAGCAGTTACTTGTGGGACAGGTCTCCTTGGTTCAGGCGCTACACCTTC	CASSYLWDRSPWFRRYTF	TRBV6-6	TRBJ1-2
TGTGCCAGCAGTGACTTCGCAGGGGACTACGAGCAGTACTTC	CASSDFAGDYEQYF	TRBV6-4	TRBJ2-7
TGTGCCTGGCAGGGGGCGTCTGGCAACAGGTACGAGCAGTACTTC	CAWQGASGNRYEQYF	TRBV30	TRBJ2-7
TGTGCCAGTAGTATCGAGCTAGCGGGCTACGAGCAGTACTTC	CASSIELAGYEQYF	TRBV19	TRBJ2-7
TGTGCCAGCAGCTTGGGACGTGGAGGAAGTTCCTATGGCTACACCTTC	CASSLGRGGSSYGYTF	TRBV7-3	TRBJ1-2
TGTGCCACCAGTACGACAGGGGGTTACACAGATACGCAGTATTTT	CATSTTGGYTDTQYF	TRBV24-1	TRBJ2-3
TGTGCCAGCAGGGCATGGGGGACTAAAGCTTTCTTT	CASRAWGTKAFF	TRBV11-3	TRBJ1-1
TGTGCCAGATCGTCAATCAGGGGGCTCGAGCTTCAAGAGACCCAGTACTTC	CARSSIRGLELQETQYF	TRBV27	TRBJ2-5
TGTGCCAGCAGCTTGGGTTCCTCCACAGCGGTTTCGGAGGTCCCCTACAATGAGCAGTTCTTC	CASSLGSSTAVSEVPYNEQFF	TRBV5-4	TRBJ2-1
TGTGCCAGCAGCTTACCACAGGGGCGAATCACTGGAAACACCATATATTTT	CASSLPQGRITGNTIYF	TRBV7-9	TRBJ1-3
TGTGCTAGTGGTGGGGGACGAGAGACCCAGTACTTC	CASGGGRETQYF	TRBV12-5	TRBJ2-5
TGCGCCAGCAGCTTGGGGGGGAGCAGAAGGGTGAACACTGAAGCTTTCTTT	CASSLGGSRRVNTEAFF	TRBV5-1	TRBJ1-1
TGTGCCAGCAGTTACAGGTCCGGGACTAGCGGAAACATTCAGTACTTC	CASSYRSGTSGNIQYF	TRBV6-2	TRBJ2-4
TGTGCCAGCAGATGGGACGCATTCAATCAGCCCCAGCATTTT	CASRWDAFNQPQHF	TRBV7-3	TRBJ1-5
TGTGCCAGCAGTTACTGGCCGACTAGCGGGAGACCGCAAGAGACCCAGTACTTC	CASSYWPTSGRPQETQYF	TRBV6-5	TRBJ2-5
TGCGCCAGCAGCGGGAGGGGGAACTCCTACGAGCAGTACTTC	CASSGRGNSYEQYF	TRBV5-1	TRBJ2-7
TGTGCCTGGAGTACTACTGAGCAGTTCTTC	CAWSTTEQFF	TRBV30	TRBJ2-1
TGCGCCAGCAGCGGGGGACTAGCCACCTACGAGCAGTACTTC	CASSGGLATYEQYF	TRBV5-1	TRBJ2-7
TGCAGTGCTCGCCCAGGACCGGGGGGTAATGAGCAGTTCTTC	CSARPGPGGNEQFF	TRBV20-1	TRBJ2-1
TGTGCCAGCAGCATCGCGGCCCTGTACGAGCAGTACTTC	CASSIAALYEQYF	TRBV5-6	TRBJ2-7
TGTGCCAGCAGCTTAGGGGCCGAGCATCAGGTTTCTAGCACAGATACGCAGTATTTT	CASSLGAEHQVSSTDTQYF	TRBV5-6	TRBJ2-3
TGTGCCAGCAGCTTGGAACCAACATTCACTGAGCAGTTCTTC	CASSLEPTFTEQFF	TRBV7-2	TRBJ2-1
TGCGCCAGCGTATCAATCAGGGGGGACGAGCAGTACTTC	CASVSIRGDEQYF	TRBV5-1	TRBJ2-7
TGTGCCACCAGTGGGCTTCCGTTGACTCCCGAGACCCAGTACTTC	CATSGLPLTPETQYF	TRBV24-1	TRBJ2-5
TGTGCCAGCACTGCCACGCCGGGACAGCGCGGGAACTCCTACAATGAGCAGTTCTTC	CASTATPGQRGNSYNEQFF	TRBV27	TRBJ2-1
TGTGCCATCACAGGTACCAGGCTGAGCAATCAGCCCCAGCATTTT	CAITGTRLSNQPQHF	TRBV10-3	TRBJ1-5
TGTGCCAGCAGCTTGCCCAGGGGACAAGAGACCCAGTACTTC	CASSLPRGQETQYF	TRBV7-9	TRBJ2-5
TGTGCCAGCAGCTCACATAAGGTTAAGAGCTCCTACAATGAGCAGTTCTTC	CASSSHKVKSSYNEQFF	TRBV5-4	TRBJ2-1
TGTGCCAGCCTTCGACAGGGGGCGAAAGCTGAAGCTTTCTTT	CASLRQGAKAEAFF	TRBV13	TRBJ1-1
TGCAGTGCTACCCAGACAGGTAAGCGGGCCGGGGAGCTGTTTTTT	CSATQTGKRAGELFF	TRBV20-1	TRBJ2-2
TGTGCCAGCAGCTTCCGACCGGGGTGGAACACCGGGGAGCTGTTTTTT	CASSFRPGWNTGELFF	TRBV5-5	TRBJ2-2
TGTGCGGGACAGGGCGGGGAGCAGTACTTC	CAGQGGEQYF	TRBV11-3	TRBJ2-7
TGTGCCAGCAGCTTATTCCCCGTTAGACGGGGGAGAACTAATGAAAAACTGTTTTTT	CASSLFPVRRGRTNEKLFF	TRBV7-4	TRBJ1-4
TGTGCCAGCAGTGAGTTTCGGGGTGAGACGGGCCGATTCAGTCCGGGGATCTACAATGAGCAGTTCTTC	CASSEFRGETGRFSPGIYNEQFF	TRBV6-4	TRBJ2-1
TGTGCCAGCAGGGGGGCCCACGAGCAGTACTTC	CASRGAHEQYF	TRBV7-6	TRBJ2-7
TGTGCCAGCAGCGGGGCGGACTATAAAGGTAGTGAGCAAGAGACCCAGTACTTC	CASSGADYKGSEQETQYF	TRBV9	TRBJ2-5
TGTGCCAGCAGACCTGAGGGGAGCATCTACGAGCAGTACTTC	CASRPEGSIYEQYF	TRBV6-5	TRBJ2-7
TGTGCCAGCAGTTTAGGACTAGCGGCCTACGAGCAGTACTTC	CASSLGLAAYEQYF	TRBV27	TRBJ2-7
TGTGCCAGTAGGCAGAATGCCGGGACAGGGGAGCAGTTCTTC	CASRQNAGTGEQFF	TRBV19	TRBJ2-1
TGTGCCTGGAAAGGGGGAAACACCATATATTTT	CAWKGGNTIYF	TRBV30	TRBJ1-3
TGTGCCAGCAGCACCCTAGCGGGCCGAGAGCAGTACTTC	CASSTLAGREQYF	TRBV9	TRBJ2-7
TGTGCCAGCCAGGAGGGGGCTCGTTATCAGCCCCAGCATTTT	CASQEGARYQPQHF	TRBV2	TRBJ1-5
TGTGCCAGTTTCGAACTGGAGAGGGAGAATAGCAATCAGCCCCAGCATTTT	CASFELERENSNQPQHF	TRBV19	TRBJ1-5
TGTGCCAGCAGTTACACGGACCTGGACACTGAAGCTTTCTTT	CASSYTDLDTEAFF	TRBV6-2	TRBJ1-1
TGTGCCAGCAGCGATTCCGGGCGTGAGCAGTTCTTC	CASSDSGREQFF	TRBV9	TRBJ2-1
TGCAGTGCTAGTAGCGGGATCCGTTACGAGCAGTACTTC	CSASSGIRYEQYF	TRBV20-1	TRBJ2-7
TGTGCCAGCAGCGGGGGACGCCAGCCCCAGCATTTT	CASSGGRQPQHF	TRBV11-2	TRBJ1-5
TGTGCCAGCAGCCATGGGGACACCCGTAGTGAACCTAAGGCTTTCTTT	CASSHGDTRSEPKAFF	TRBV3-1	TRBJ1-1
TGTGCCAGCAGCTGGGGGGACGAGCAGTACTTC	CASSWGDEQYF	TRBV5-6	TRBJ2-7
TGTGCCAGCAGTGACCGGGACAGGGGGCGCGATTGGTACTTC	CASSDRDRGRDWYF	TRBV6-4	TRBJ2-7
TGTGCCAGCAGTGACCAGGGGACTGAAGCTTTCTTT	CASSDQGTEAFF	TRBV6-4	TRBJ1-1
TGCGCCAGCAGGGCACAGGACAGGGGGGGGGGCTACACCTTC	CASRAQDRGGGYTF	TRBV5-1	TRBJ1-2
TGTGCCAGCAGCTTAGGAAAGGGGGACCGAACTAATGAAAAACTGTTTTTT	CASSLGKGDRTNEKLFF	TRBV11-2	TRBJ1-4
TGTGCCAGCAGCGTCAAAACGGCCAATACCGGCGGAAACGAGCAGTACTTC	CASSVKTANTGGNEQYF	TRBV9	TRBJ2-7
TGTGCCAGAGGGGCAACTAATGAAAAACTGTTTTTT	CARGATNEKLFF	TRBV19	TRBJ1-4
TGCAGCGGACAGGGTGATGAAAAACTGTTTTTT	CSGQGDEKLFF	TRBV29-1	TRBJ1-4
TGTGCCAGCAGCAAGAGGGCAACAACGCAGTATTTT	CASSKRATTQYF	TRBV13	TRBJ2-3
TGCAGCGAGGGACAGGGGGCATCGGGGACCTACGAGCAGTACTTC	CSEGQGASGTYEQYF	TRBV29-1	TRBJ2-7
TGTGCCAGCAGACTAGCGGGATACGAGCAGTACTTC	CASRLAGYEQYF	TRBV2	TRBJ2-7
TGCGCCACCGCTCCCCTAGTTGGGGCCGAGCAGTACTTC	CATAPLVGAEQYF	TRBV5-1	TRBJ2-7
TGTGCCACTCTAGCGGGCATGCCGGACAATGAGCAGTTCTTC	CATLAGMPDNEQFF	TRBV24-1	TRBJ2-1
TGTGCCAGCAGCATACTTCCCGGCCGATGTTTGTCCTACGAGCAGTACTTC	CASSILPGRCLSYEQYF	TRBV7-3	TRBJ2-7
TGTGCCAGCAGTGATTCTGCCGGGACTAGCGGGCTTGAGACCCAGTACTTC	CASSDSAGTSGLETQYF	TRBV6-1	TRBJ2-5
TGTGCCAGAATAGACAGGGATAGCGGCTACACCTTC	CARIDRDSGYTF	TRBV6-1	TRBJ1-2
TGTGCCAGCCGTCTGGGGGGGGGGAAGGGTTACGAGCAGTACTTC	CASRLGGGKGYEQYF	TRBV25-1	TRBJ2-7
TGTGCCAGCAGACGGGTCTCGGGACAGGGAGCCACTGAAGCTTTCTTT	CASRRVSGQGATEAFF	TRBV6-2	TRBJ1-1
TGTGCCAGCAGCGGACAGGGTGCACCCTATGGCTACACCTTC	CASSGQGAPYGYTF	TRBV9	TRBJ1-2
TGTGCCACCGAACCCACAGGGTACGGGGAGCTGTTTTTT	CATEPTGYGELFF	TRBV28	TRBJ2-2
TGTGCCACACAGGGGCGGGAGCCCCAGCATTTT	CATQGREPQHF	TRBV28	TRBJ1-5
TGTGCCAGCAGCTCAGGCCATGAGCAGTTCTTC	CASSSGHEQFF	TRBV5-5	TRBJ2-1
TGTGCCACCATGGGCTCCGGGGGGGCCGAAGAGACCCAGTACTTC	CATMGSGGAEETQYF	TRBV24-1	TRBJ2-5
TGTGCCAGCAGTTTGTGCCTCATTCGGACATTGTGGGTCAGATCTAATGAAAAACTGTTTTTT	CASSLCLIRTLWVRSNEKLFF	TRBV27	TRBJ1-4
TGTGCCAGCAGTTTAGGGGGTGGCCCCTCCTACGAGCAGTACTTC	CASSLGGGPSYEQYF	TRBV12-4	TRBJ2-7
TGTGCCTGGCCCCCCTTAAGACAGGGGACAGAGCAGTACTTC	CAWPPLRQGTEQYF	TRBV30	TRBJ2-7
TGTGCCTGGAGTGTACCTCCAGGGACATTTTGTTCCTACGAGCAGTACTTC	CAWSVPPGTFCSYEQYF	TRBV30	TRBJ2-7
TGTGCCAGCAGCTTAAACGAGGGACAGAGATCCGATACGCAGTATTTT	CASSLNEGQRSDTQYF	TRBV7-9	TRBJ2-3
TGTGCCAGCAGCTTATGGGGGCTGGGCTATGGCTACACCTTC	CASSLWGLGYGYTF	TRBV7-9	TRBJ1-2
TGCGCCAGCAGTGAGTCGAAAACCGAGGGGCACCAGTACTTC	CASSESKTEGHQYF	TRBV10-1	TRBJ2-5
TGCGCCAGCAGCCAAGATAGAAACGGGCAAGAGACCCAGTACTTC	CASSQDRNGQETQYF	TRBV4-3	TRBJ2-5
TGTGCCAGCAGCCTAGGACAGTTTTCCGTCTACGAGCAGTACTTC	CASSLGQFSVYEQYF	TRBV13	TRBJ2-7
TGTGCCACCAGCAGACTACGGCAGCCCGAGCAGTACTTC	CATSRLRQPEQYF	TRBV15	TRBJ2-7
TGTGCCAGCAGCTTAGTGACAGGAAACTACGAGCAGTACTTC	CASSLVTGNYEQYF	TRBV11-2	TRBJ2-7
TGCGCCAGCAGCCAAGCGTTCAGGGGGAGATACTCCTACGAGCAGTACTTC	CASSQAFRGRYSYEQYF	TRBV4-1	TRBJ2-7
TGTGCCAGCAGTGACTCAAAGGAACAGGTCGGGGAGCTGTTTTTT	CASSDSKEQVGELFF	TRBV6-4	TRBJ2-2
TGTGCCAGCAGTTGCCGTAAGGACGGCTACAATGAGCAGTTCTTC	CASSCRKDGYNEQFF	TRBV28	TRBJ2-1
TGTGCCAGCACAAGGGAGCACAGTAGCAATCAGCCCCAGCATTTT	CASTREHSSNQPQHF	TRBV6-3	TRBJ1-5
TGCAGTGCTAGAGGGGGGGACCCCTACGAGCAGTACTTC	CSARGGDPYEQYF	TRBV20-1	TRBJ2-7
TGCGCCAGCAGCCACCGTATACTTGGGGGCGATTTCCAGCCCCAGCATTTT	CASSHRILGGDFQPQHF	TRBV4-1	TRBJ1-5
TGCGCCAGCAGCTTGAAGGCGCCAGGGGGGTGGTACTTC	CASSLKAPGGWYF	TRBV5-1	TRBJ2-4
TGTGCCACCAGCAGAGGGGGTTTAGGAAACACTGAAGCTTTCTTT	CATSRGGLGNTEAFF	TRBV15	TRBJ1-1
TGCACTGAGAGAATATTAGTACCTGAGCAGTACTTC	CTERILVPEQYF	TRBV20-1	TRBJ2-7
TGTGCCAGCAGCTCAGTCAGGCCCCAGGATGTGATGAACACTGAAGCTTTCTTT	CASSSVRPQDVMNTEAFF	TRBV2	TRBJ1-1
TGTGCCCCCGAGAGGGGGGGACCCCTTAACACCGGGGAGCTGTTTTTT	CAPERGGPLNTGELFF	TRBV9	TRBJ2-2
TGTGCCCGTGACAGGCGGAACACTGAAGCTTTCTTT	CARDRRNTEAFF	TRBV11-2	TRBJ1-1
TGTGCCAGCAAGACTAGGGGTCCCCTTACAGATACGCAGTATTTT	CASKTRGPLTDTQYF	TRBV12-3	TRBJ2-3
TGTGCCAGGGGACTCTGCCCCAATGAGCAGTTCTTC	CARGLCPNEQFF	TRBV19	TRBJ2-1
TGTGCCAGCAGTAGAAGGGGGGGCCAAATTGAGCAGTTCTTC	CASSRRGGQIEQFF	TRBV27	TRBJ2-1
TGTGCCAGCAATCTCGGCCCGTATAGCAATCAGCCCCAGCATTTT	CASNLGPYSNQPQHF	TRBV6-3	TRBJ1-5
TGTGCCAGCAGATCTGAGGGGGGGAGAAACACCATATATTTT	CASRSEGGRNTIYF	TRBV25-1	TRBJ1-3
TGTGCCAGCAGCCGTCCCAGCGGGGGTTACGAGCAGTACTTC	CASSRPSGGYEQYF	TRBV13	TRBJ2-7
TGCAGTGCTAGAGATCTATTAATCGTACACGAGCAGTACTTC	CSARDLLIVHEQYF	TRBV20-1	TRBJ2-7
TGTGCCAGCAGCTTAACGTCTCCATTTCGGACGCTGGAGAACACTGAAGCTTTCTTT	CASSLTSPFRTLENTEAFF	TRBV7-3	TRBJ1-1
TGTGCCAGCAGTTATCCCAGGGGTGGAGAAAAACTGTTTTTT	CASSYPRGGEKLFF	TRBV6-3	TRBJ1-4
TGTGCCAGCAGCTTAACCCGAGGGACAGGGGCGGGCTACGAGCAGTACTTC	CASSLTRGTGAGYEQYF	TRBV5-5	TRBJ2-7
TGTGCCAGCAGCGGAATCCCCACGAGCAGGGTCTCCTTCGGGGAGCTGTTTTTT	CASSGIPTSRVSFGELFF	TRBV11-2	TRBJ2-2
TGTGGGAAACCAGGGTTTCCAGGACTGCTCCCCATAAGCTCCTACAATGAGCAGTTCTTC	CGKPGFPGLLPISSYNEQFF	TRBV3-1	TRBJ2-1
TGCAGTGCGGGTAAGGGGGAACGCAATCAGCCCCAGCATTTT	CSAGKGERNQPQHF	TRBV20-1	TRBJ1-5
TGTGCCAGCAGGGACAGGAGCTCCTACGAGCAGTACTTC	CASRDRSSYEQYF	TRBV6-2	TRBJ2-7
TGTGCCAACCGGGACAGCTACGAAAAACTGTTTTTT	CANRDSYEKLFF	TRBV12-4	TRBJ1-4
TGTGCCTGGAGTGGTACCTCCTACGAGCAGTACTTC	CAWSGTSYEQYF	TRBV30	TRBJ2-7
TGTGCCAGCAGGGGCCCGAGTGAGCAGTTCTTC	CASRGPSEQFF	TRBV6-5	TRBJ2-1
TGCAGTGCTCCGGGACAGGGAGTGGGCTACACCTTC	CSAPGQGVGYTF	TRBV20-1	TRBJ1-2
TGCGCCAGCAGCTTGGCGGGTTTGACTAGCGGGGGAGTGGTAGGCACAGATACGCAGTATTTT	CASSLAGLTSGGVVGTDTQYF	TRBV5-1	TRBJ2-3
TGTGCCAGCAGCTTAATTCCCGGGACAGCGAACTATAATTCACCCCTCCACTTT	CASSLIPGTANYNSPLHF	TRBV7-3	TRBJ1-6
TGTGCCAGCATACTGCATGGCTACACCTTC	CASILHGYTF	TRBV7-9	TRBJ1-2
TGTGCCACTGCAAGAATAAGCACAGATACGCAGTATTTT	CATARISTDTQYF	TRBV24-1	TRBJ2-3
TGTGCCAGCAGCTTATCGGGGGGCGCGGCCTCGAACACCGGGGAGCTGTTTTTT	CASSLSGGAASNTGELFF	TRBV11-3	TRBJ2-2
TGTGCCAGGGTATGGGGCACCAGTTATTACCAAGAGACCCAGTACTTC	CARVWGTSYYQETQYF	TRBV10-3	TRBJ2-5
TGTGCCAGCAGTGACTTGTGCCCCGGGGCCCGGGGAAACACCATATATTTT	CASSDLCPGARGNTIYF	TRBV6-4	TRBJ1-3
TGTGCCAGCAGAGGCAGACTAGGTTGTTACGGCCAAGAGACCCAGTACTTC	CASRGRLGCYGQETQYF	TRBV11-2	TRBJ2-5
TGTGCCAGCAGTTTATCGCCGGGGACTAGCGGGCGGGCCATTCAGTACTTC	CASSLSPGTSGRAIQYF	TRBV27	TRBJ2-4
TGCGCCAGCAGTGACCAGACTAGCGGGAATGATTACCCCTACGAGCAGTACTTC	CASSDQTSGNDYPYEQYF	TRBV10-2	TRBJ2-7
TGTGCCACCAGTGTTGGTCATATAGGGCATCCGAATGAAAAACTGTTTTTT	CATSVGHIGHPNEKLFF	TRBV24-1	TRBJ1-4
TGTGCCACCAGCAGCTTCGGCGGGCCGGCGACCCAGTACTTC	CATSSFGGPATQYF	TRBV15	TRBJ2-5
TGCGCCAGCACCCCAGCTACCTACTGCAATCAGCCCCAGCATTTT	CASTPATYCNQPQHF	TRBV10-1	TRBJ1-5
TGCAGTGCTCGGCCCGGGACAGAGCAGTACTTC	CSARPGTEQYF	TRBV20-1	TRBJ2-7
TGTGCCACCAGCAGACCCCCTAGCGGGGCTTGGAACACCGGGGAGCTGTTTTTT	CATSRPPSGAWNTGELFF	TRBV15	TRBJ2-2
TGTGCCAGCAGCGTGCCGGGACAGGGGATAAACACTGAAGCTTTCTTT	CASSVPGQGINTEAFF	TRBV7-9	TRBJ1-1
TGTGCCATCAAACCGGACACTAAGACTGAAGCTTTCTTT	CAIKPDTKTEAFF	TRBV10-3	TRBJ1-1
TGTGCCAGCAGTCGCAAGACTAGTCAACTCGAGCAGTACTTC	CASSRKTSQLEQYF	TRBV27	TRBJ2-7
TGCAGCGTTGAAGATTCCACAGGAGAGACCCAGTACTTC	CSVEDSTGETQYF	TRBV29-1	TRBJ2-5
TGTGCCAGCAGCTTTTATATGGTAGGGGGGATGACCTACGAGCAGTACTTC	CASSFYMVGGMTYEQYF	TRBV5-4	TRBJ2-7
TGTGCCAGCAGCAAAAACCCCGACGGAGGTGACTCACCCCTCCACTTT	CASSKNPDGGDSPLHF	TRBV7-9	TRBJ1-6
TGTGCCAGCAGCCAAATTGGGGGACAGGGGGAGAGGGATGGCTACACCTTC	CASSQIGGQGERDGYTF	TRBV3-1	TRBJ1-2
TGTGCCAGCAGACAGGGGGCGATAGGGACTCAAGAGACCCAGTACTTC	CASRQGAIGTQETQYF	TRBV7-3	TRBJ2-5
TGTGCCACCCAGCGACATAATGAAAAACTGTTTTTT	CATQRHNEKLFF	TRBV24-1	TRBJ1-4
TGTGCCAGCAGTCCCGGGGGCCAGGGGACAGACTACGAGCAGTACTTC	CASSPGGQGTDYEQYF	TRBV6-4	TRBJ2-7
TGTGCCAGCAGCACTACAACGGACGAGCAGTACTTC	CASSTTTDEQYF	TRBV5-6	TRBJ2-7
TGCAGTGCTAGAGATCGGACATCCTTAAAGCGGGGGGACTACGAGCAGTACTTC	CSARDRTSLKRGDYEQYF	TRBV20-1	TRBJ2-7
TGTGCCACCAGTGATGGACAGGCGGGCACTGAAGCTTTCTTT	CATSDGQAGTEAFF	TRBV24-1	TRBJ1-1
TGCGCCAGCAGTAGACACAGGGACTGGGGAGAGAACACTGAAGCTTTCTTT	CASSRHRDWGENTEAFF	TRBV5-1	TRBJ1-1
TGTGCCAGAGGGGCGGGGGGAATCGGCTACACCTTC	CARGAGGIGYTF	TRBV2	TRBJ1-2
TGCAGTGCTAGAGAGCCAAACACCGGGGAGCTGTTTTTT	CSAREPNTGELFF	TRBV20-1	TRBJ2-2
TGCAGTGCTCTCAGGCTTTCTTCTGGAAACACCATATATTTT	CSALRLSSGNTIYF	TRBV20-1	TRBJ1-3
TGTGCCAGCAGCTTAAGCGGGGGGGGGCAGTTCTTC	CASSLSGGGQFF	TRBV7-3	TRBJ2-1
TGTGCCAGCAGCACTAGGATCCAGTACTTC	CASSTRIQYF	TRBV13	TRBJ2-5
TGTGCCAGTAGTAGGAAATGGACAGGGTCTAGAGATACCTACGAGCAGTACTTC	CASSRKWTGSRDTYEQYF	TRBV19	TRBJ2-7
TGTGCCAGCAAGCCGCCCCGACACGACTCCTACGAGCAGTACTTC	CASKPPRHDSYEQYF	TRBV7-3	TRBJ2-7
TGTGCCACGGGTAGGGAATTAGGTTCCTACAATGAGCAGTTCTTC	CATGRELGSYNEQFF	TRBV13	TRBJ2-1
TGTGACTCCGGTACAGGGGAGCAAACTGAAGCTTTCTTT	CDSGTGEQTEAFF	TRBV9	TRBJ1-1
TGCGCCAGCAGGGCCCATGGCCGACCCCCAGATACGCAGTATTTT	CASRAHGRPPDTQYF	TRBV10-2	TRBJ2-3
TGTGCCAGCAGCAATCCAGGACGGGACGAGCAGTACTTC	CASSNPGRDEQYF	TRBV7-2	TRBJ2-7
TGTGCCAGCATCTCCGGGACAGGGGCCCAAGAGACCCAGTACTTC	CASISGTGAQETQYF	TRBV27	TRBJ2-5
TGTGCCATCAGTGCGCATCCTCCCCACTTCAATGAGCAGTTCTTC	CAISAHPPHFNEQFF	TRBV10-3	TRBJ2-1
TGTGCCGCAGGATCTGAAGCTTTCTTT	CAAGSEAFF	TRBV28	TRBJ1-1
TGCAGTGCTTCGAGTCAGCCCCAGCATTTT	CSASSQPQHF	TRBV20-1	TRBJ1-5
TGTGCCAGCTCACACGTCGAGAGGGAGAAGATGAACACTGAAGCTTTCTTT	CASSHVEREKMNTEAFF	TRBV18	TRBJ1-1
TGCAGTGCTACAGGGTGGAGTAGCGGAAACACCGGGGAGCTGTTTTTT	CSATGWSSGNTGELFF	TRBV20-1	TRBJ2-2
TGCGCCAGCAGCCAAGATGCATTATCCAACTGGACAAGCTCGGTCACTGAAGCTTTCTTT	CASSQDALSNWTSSVTEAFF	TRBV4-1	TRBJ1-1
TGCGCCAGCAGCCAAGCCCGGGGCGATCAGATCTACGAGCAGTACTTC	CASSQARGDQIYEQYF	TRBV4-1	TRBJ2-7
TGTGCCAGCAGTTATTCAACAGGAGAAACTGAAGCTTTCTTT	CASSYSTGETEAFF	TRBV6-6	TRBJ1-1
TGTGCCAGCAGCCAGTGCAGGGATCCTTATGGCTACACCTTC	CASSQCRDPYGYTF	TRBV4-2	TRBJ1-2
TGTGCCACCAGCAGAGATAGAACCCCAGGGGGGTGGTACGAGCAGTACTTC	CATSRDRTPGGWYEQYF	TRBV15	TRBJ2-7
TGCGCCAGCAGCTCCTCAAACGGGGGGGGGGGCGGCAATGAGCAGTTCTTC	CASSSSNGGGGGNEQFF	TRBV5-1	TRBJ2-1
TGCAGCGTTGAGGCAGGGAGCTACGAGCAGTACTTC	CSVEAGSYEQYF	TRBV29-1	TRBJ2-7
TGTGCCAGCAAGTACGTTAACCGACTCCGTGGGAGGACCGTGAACACTGAAGCTTTCTTT	CASKYVNRLRGRTVNTEAFF	TRBV6-5	TRBJ1-1
TGTGCCAGCAGCGCCCGGGACAGGGATGAAAAACTGTTTTTT	CASSARDRDEKLFF	TRBV7-4	TRBJ1-4
TGCAGTGCTGACCCTCAGGGTTTATATCCCGGGGAGCTGTTTTTT	CSADPQGLYPGELFF	TRBV20-1	TRBJ2-2
TGTGCCAGCAGTTATGGGGAGAGGGTCGGCTATGGCTACACCTTC	CASSYGERVGYGYTF	TRBV6-5	TRBJ1-2
TGTGCCCTAATATACCCTAAATGGGGGCGGGAGAGAGGAGGCGACTCCTACGAGCAGTACTTC	CALIYPKWGRERGGDSYEQYF	TRBV11-3	TRBJ2-7
TGTGCCAGCAGTTATGCCCCTTCAAGGACTGAGGGGGCGAATGAGCAGTTCTTC	CASSYAPSRTEGANEQFF	TRBV6-6	TRBJ2-1
TGTGCCAGCAGTGACTCGACAACTAGAGGGGGGCAGACCCAGTACTTC	CASSDSTTRGGQTQYF	TRBV6-4	TRBJ2-5
TGTGCCAGCAGCCACGACGGGACTAGCGGGGGGATCCATTTTCTCACAGATACGCAGTATTTT	CASSHDGTSGGIHFLTDTQYF	TRBV7-3	TRBJ2-3
TGTGCCAGCAAGATGCTCCCGGGACAGACCCAGTACTTC	CASKMLPGQTQYF	TRBV6-3	TRBJ2-5
TGTGCCAGCAGCGTATCCAGGACAGGGGGAAACTACGAGCAGTACTTC	CASSVSRTGGNYEQYF	TRBV5-6	TRBJ2-7
TGTGCCAGCAGAAGGCCGGGTTGGTACCAAGAGACCCAGTACTTC	CASRRPGWYQETQYF	TRBV7-3	TRBJ2-5
TGTGCCAGCAGTGGATGGCAATATTGGCATGGCTACACCTTC	CASSGWQYWHGYTF	TRBV6-1	TRBJ1-2
TGCAGTGCTAGAGACGGCTATAGGGAGGGTAATGAGCAGTTCTTC	CSARDGYREGNEQFF	TRBV20-1	TRBJ2-1
TGTGCCACAGCCGCCCTCCACGACTCGGGACTCAAGTACGAGCAGTACTTC	CATAALHDSGLKYEQYF	TRBV9	TRBJ2-7
TGTGCCAGCAGCTCAGGGGCCGACACTGAAGCTTTCTTT	CASSSGADTEAFF	TRBV7-9	TRBJ1-1
TGCGCCAGCAGCTTCCGACCTACAGGAGTTGGCCGCACAGATACGCAGTATTTT	CASSFRPTGVGRTDTQYF	TRBV5-1	TRBJ2-3
TGTGCCAGCAGTTGTTGGGCGCGGGTCTTTAATTCACCCCTCCACTTT	CASSCWARVFNSPLHF	TRBV28	TRBJ1-6
TGTGCCAGCAGAAGCAACCCGTGGGGCTACGAGCAGTACTTC	CASRSNPWGYEQYF	TRBV6-2	TRBJ2-7
TGCAGTGCTAGAGACGCCGGGACAGGGAACCAGCCCCAGCATTTT	CSARDAGTGNQPQHF	TRBV20-1	TRBJ1-5
TGCGCCAGCAGCTTGGAACACAGATTACCTCTCTACACCTTC	CASSLEHRLPLYTF	TRBV5-1	TRBJ1-2
TGCAGTGCCCTTGACAGGGGCCGGTCTAGCAATCAGCCCCAGCATTTT	CSALDRGRSSNQPQHF	TRBV20-1	TRBJ1-5
TGTGCCAGCAGCTTAGTACTGGACAGGGGGAGGCGAATGTTGTGTTATGAAGCTTTCTTT	CASSLVLDRGRRMLCYEAFF	TRBV7-3	TRBJ1-1
TGCGCCAGCAGCCTAAGATTAGGGGGGGGGGAGACCCAGTACTTC	CASSLRLGGGETQYF	TRBV5-1	TRBJ2-5
TGTGCCAGCAGCCGCCCGACAGGCCCCCTCCACTTT	CASSRPTGPLHF	TRBV14	TRBJ1-6
TGTGCCAGCAGCTTAATACCCCAGGGGACCGGGGAGCTGTTTTTT	CASSLIPQGTGELFF	TRBV7-6	TRBJ2-2
TGTGCCACTTCCTTTTCGAACAGGGGGCGCAGGTCATGGTCCTACGAGCAGTACTTC	CATSFSNRGRRSWSYEQYF	TRBV7-8	TRBJ2-7
TGTGCCACCAGCGGCCCCCGGTCTAGCATTCAGTACTTC	CATSGPRSSIQYF	TRBV24-1	TRBJ2-4
TGTGCCAGCATGTGGACAGGCTCCTACGAGCAGTACTTC	CASMWTGSYEQYF	TRBV27	TRBJ2-7
TGTGCCAGCGAGGGCGGGAGGGCCTACAATGAGCAGTTCTTC	CASEGGRAYNEQFF	TRBV27	TRBJ2-1
TGTGCCAGCAGTTCGGACCATAACCCCTACGAGCAGTACTTC	CASSSDHNPYEQYF	TRBV6-5	TRBJ2-7
TGTGCCAGCAGCTTGCAGGGCCATCAGGCAAACGAGCAGTACTTC	CASSLQGHQANEQYF	TRBV5-6	TRBJ2-7
TGTGCCAGCAGCCGTCCAGCCCTAGCGCAACAAGAGACCCAGTACTTC	CASSRPALAQQETQYF	TRBV3-1	TRBJ2-5
TGTGCCAGCAGCTTGCCCTGGGGAGTTGGGGCCAACGTCCTGACTTTC	CASSLPWGVGANVLTF	TRBV5-6	TRBJ2-6
TGTGCCAGCAGTTTCCAGGGGACTGAAGCTTTCTTT	CASSFQGTEAFF	TRBV6-5	TRBJ1-1
TGTGCCAGCAGCTTAGCCCAGGGGGGGAACACTGAAGCTTTCTTT	CASSLAQGGNTEAFF	TRBV7-2	TRBJ1-1
TGCAGCGGAGGACAGAATGGCTACACCTTC	CSGGQNGYTF	TRBV29-1	TRBJ1-2
TGTGCTAGTGGTGTAGCCGGGACTAGCGGCGCCTACGAGCAGTACTTC	CASGVAGTSGAYEQYF	TRBV12-5	TRBJ2-7
TGTGCCAGCAGCAAGGATGGGACAGAGGGCTATGGCTACACCTTC	CASSKDGTEGYGYTF	TRBV5-6	TRBJ1-2
TGTGCCAGCAGTGGTTTTATAGGGGGGCTCGGGGGGACAGATACGCAGTATTTT	CASSGFIGGLGGTDTQYF	TRBV6-5	TRBJ2-3
TGTGCCACCAGCAGAGATAGGGCACCTAATCAGCCCCAGCATTTT	CATSRDRAPNQPQHF	TRBV15	TRBJ1-5
TGTGCCAGCAGCTTGGCGGGACAGGGAGAGCAGTACTTC	CASSLAGQGEQYF	TRBV5-8	TRBJ2-7
TGTGCCAGCAGCAGCAGGACAGGGGAGCAGTACTTC	CASSSRTGEQYF	TRBV7-9	TRBJ2-7
TGTGCCAGCAGTAACTGTGGTCGAGGGACTCAGCCCCAGCATTTT	CASSNCGRGTQPQHF	TRBV6-4	TRBJ1-5
TGTGCCAGCATCCCGACCGGGACAGGGTGGGAGAACACAGATACGCAGTATTTT	CASIPTGTGWENTDTQYF	TRBV7-4	TRBJ2-3
TGTGCCAGCAGCCCCGGCAGGTATCAGCCCCAGCATTTT	CASSPGRYQPQHF	TRBV7-3	TRBJ1-5
TGCAGCGGGTATCGGACAGGGGAGTGCAATCAGCCCCAGCATTTT	CSGYRTGECNQPQHF	TRBV29-1	TRBJ1-5
TGTGCCAGCAGTTACCCCCGCCCTCTTAGCACAGATACGCAGTATTTT	CASSYPRPLSTDTQYF	TRBV6-3	TRBJ2-3
TGTGCCAGCAGCTTACCTATACCAGGGCTCTCCTGGTACGAGCAGTACTTC	CASSLPIPGLSWYEQYF	TRBV11-3	TRBJ2-7
TGCAGTGCTAGACCTGCGGAATACGAGCAGTACTTC	CSARPAEYEQYF	TRBV20-1	TRBJ2-7
TGCGACACCCGCCAAAGGGGAGAGAAAAGTAAAAATTCACCCCTCCACTTT	CDTRQRGEKSKNSPLHF	TRBV10-1	TRBJ1-6
TGCGCCAGCAGTGTTCGGGGGGGGGGAACTAATGAAAAACTGTTTTTT	CASSVRGGGTNEKLFF	TRBV10-1	TRBJ1-4
TGCAGTGCTAGAGAATTCCCGGGACACTACGAGCAGTACTTC	CSAREFPGHYEQYF	TRBV20-1	TRBJ2-7
TGTGCCAGCAGTAGCGGGAGCGAAAGCAATCAGCCCCAGCATTTT	CASSSGSESNQPQHF	TRBV6-5	TRBJ1-5
TGTGCCAGCAGCGGTAATGGGGTGGTCCCAGGAGACTATAATTCACCCCTCCACTTT	CASSGNGVVPGDYNSPLHF	TRBV9	TRBJ1-6
TGCGCCAGCAGCCTGGTAGCGGGGGAGGACACCGGGGAGCTGTTTTTT	CASSLVAGEDTGELFF	TRBV5-1	TRBJ2-2
TGTGTACCCGGCGATAATCCCGGGGACGAGCAGTACTTC	CVPGDNPGDEQYF	TRBV6-2	TRBJ2-7
TGTGCCAGCAGCCAGGGCTTAGCTTTCTTT	CASSQGLAFF	TRBV7-4	TRBJ1-1
TGTGCCAGCAGCCAAGATCGGTGTACGCGGGAGAAGACCTACGAGCAGTACTTC	CASSQDRCTREKTYEQYF	TRBV14	TRBJ2-7
TGTGCCAGCAGTCCAGGGGGGACTGAAGCTTTCTTT	CASSPGGTEAFF	TRBV7-3	TRBJ1-1
TGTGCCAGCAGTAAGCCGACTCAGGGTCCCTACAATGAGCAGTTCTTC	CASSKPTQGPYNEQFF	TRBV12-3	TRBJ2-1
TGTGCCAGCAGCCCGTTTGGACACAGGGGGCAAGGCAGGGACGAGCAGTACTTC	CASSPFGHRGQGRDEQYF	TRBV9	TRBJ2-7
TGTGCCACCAGCAGAGATCGCCTCTCCCCTGACCCAAGGTCCTACAATGAGCAGTTCTTC	CATSRDRLSPDPRSYNEQFF	TRBV15	TRBJ2-1
TGTGCCAGCAGCGGAAGAATAAGTAACTATGGCTACACCTTC	CASSGRISNYGYTF	TRBV13	TRBJ1-2
TGTGCCAGCAGCGTAAAGCGCATTTCCCGGGACAGTCGACAGCCCCAGCATTTT	CASSVKRISRDSRQPQHF	TRBV7-6	TRBJ1-5
TGTGCCAGCAGCGGGACTGGCTACGAGCAGTACTTC	CASSGTGYEQYF	TRBV13	TRBJ2-7
TGTGCCTGGAGTGTAGCGGAAGGGGGCGGCTACACCTTC	CAWSVAEGGGYTF	TRBV30	TRBJ1-2
TGTGCCAGCAGCTTAGCCCCGACTAGCATCACAGATACGCAGTATTTT	CASSLAPTSITDTQYF	TRBV7-2	TRBJ2-3
TGTGCCAGCAGCGCCAGCATACCCCAGCATTTT	CASSASIPQHF	TRBV13	TRBJ1-5
TGTGCCGGCGAACAGGGCCCCCGGGAAACTCAGCCCCAGCATTTT	CAGEQGPRETQPQHF	TRBV2	TRBJ1-5
TGTGCCAGCAGTTACCCATGGGGGAAGGGCACAGATACGCAGTATTTT	CASSYPWGKGTDTQYF	TRBV6-2	TRBJ2-3
TGTGCCAGCAGTGGACAGGGGCGTTGTAAGAACACTGAAGCTTTCTTT	CASSGQGRCKNTEAFF	TRBV6-5	TRBJ1-1
TGTGCCAGCAGGGGGGGGCCCTCCTACGAGCAGTACTTC	CASRGGPSYEQYF	TRBV6-1	TRBJ2-7
TGTGCCAGCAGCGCGCTGCAGCTAGCGGGCGACCCCTACAATGAGCAGTTCTTC	CASSALQLAGDPYNEQFF	TRBV7-9	TRBJ2-1
TGCGCCAGCAGCTTCGGGGAAAAACTGTTTTTT	CASSFGEKLFF	TRBV4-3	TRBJ1-4
TGTGCCACCAGTGAGGAGCCTGGAAACAGGATGTCCTACGAGCAGTACTTC	CATSEEPGNRMSYEQYF	TRBV24-1	TRBJ2-7
TGCGCCAGCAGCCACGAACTCCGACAGGGCAATCAGCCCCAGCATTTT	CASSHELRQGNQPQHF	TRBV4-3	TRBJ1-5
TGCGCCAGCAGCCAGGTAGGACTAGGGAATGAGCAGTTCTTC	CASSQVGLGNEQFF	TRBV4-1	TRBJ2-1
TGCAGTGCTAGACTGGACAGCGCTCGTCTCAACTATGGCTACACCTTC	CSARLDSARLNYGYTF	TRBV20-1	TRBJ1-2
TGTGCCAAGCCCAGGGAGTATTGGGCCACCGGGGAGCTGTTTTTT	CAKPREYWATGELFF	TRBV19	TRBJ2-2
TGCGCCAGCAGCGACAGGGGCAGAAACGATGGCTACACCTTC	CASSDRGRNDGYTF	TRBV5-1	TRBJ1-2
TGTGCCAGCAGCCGGGGGCATCAGCCCCAGCATTTT	CASSRGHQPQHF	TRBV14	TRBJ1-5
TGTGCCAGCAGCGCAGAGACAGATCAGCCCCAGCATTTT	CASSAETDQPQHF	TRBV9	TRBJ1-5
TGTGCCAGCAGCCCGGGACAGGGGGACTACGAGCAGTACTTC	CASSPGQGDYEQYF	TRBV6-6	TRBJ2-7
TGCGCCAGCAGCCAAGCTGGACAGGGGGCCCAATCTGGGGCCAACGTCCTGACTTTC	CASSQAGQGAQSGANVLTF	TRBV4-1	TRBJ2-6
TGTGCCAGCACCGGACGGTGCGTCCCCGAGCAGTACTTC	CASTGRCVPEQYF	TRBV27	TRBJ2-7
TGTGCCAGCTCACCACCCGAGGTCAGGGTCTACGAGCAGTACTTC	CASSPPEVRVYEQYF	TRBV18	TRBJ2-7
TGTGCCAGCGTCCACCCTCACTCTACGGACGAGCAGTACTTC	CASVHPHSTDEQYF	TRBV19	TRBJ2-7
TGTGCCAGCAGCCACAGCGAGGGAAACTATGGCTACACCTTC	CASSHSEGNYGYTF	TRBV5-6	TRBJ1-2
TGTGCCACCCATTCTAGCGGGGTTAGCGGTTCCTACAATGAGCAGTTCTTC	CATHSSGVSGSYNEQFF	TRBV15	TRBJ2-1
TGTGCCAGCAGTTTAGCGTTTGGCAAACGGAACACTGAAGCTTTCTTT	CASSLAFGKRNTEAFF	TRBV27	TRBJ1-1
TGCGCCAGCTTAGGCCACACGAGTCGCTACGAGCAGTACTTC	CASLGHTSRYEQYF	TRBV5-1	TRBJ2-7
TGCGCCAGCAGCCAATTCGGGCCGACTGGACAAGAGACCCAGTACTTC	CASSQFGPTGQETQYF	TRBV5-1	TRBJ2-5
TGTGCTAGTGGCCCCAGCCGGGACAGGGGTAAGGAGGAGTCTAGCACAGATACGCAGTATTTT	CASGPSRDRGKEESSTDTQYF	TRBV12-5	TRBJ2-3
TGTGCCAGCAGCTTCGAGCCTTACGAGCAGTACTTC	CASSFEPYEQYF	TRBV6-5	TRBJ2-7
TGTGCCAGCAGCTTGGGGGCGATCAATCGTGGCTACACCTTC	CASSLGAINRGYTF	TRBV7-9	TRBJ1-2
TGTGCCAGCAGCTTAGGACCGGACAGGCCCTGGCAGAGATGTGAAGCTTTCTTT	CASSLGPDRPWQRCEAFF	TRBV7-2	TRBJ1-1
TGTGCCAGCAGTTACCAGGCCTCCTACGGGGATGCCGGATATGGCTACACCTTC	CASSYQASYGDAGYGYTF	TRBV6-5	TRBJ1-2
TGCGCCAGCAGCTTGGGTTGGCGAGGTCCGTCAACGCAAGAGACCCAGTACTTC	CASSLGWRGPSTQETQYF	TRBV5-1	TRBJ2-5
TGTGCCAGCAGCGGGACGTACACTGAAGCTTTCTTT	CASSGTYTEAFF	TRBV13	TRBJ1-1
TGTGCCAGCTCACCACTGCGTACGGGGGGGGTTGGACAAGAGACCCAGTACTTC	CASSPLRTGGVGQETQYF	TRBV18	TRBJ2-5
TGTGCCAGCTGCGGACTAGCGGGCCACACCGGGGAGCTGTTTTTT	CASCGLAGHTGELFF	TRBV12-3	TRBJ2-2
TGTGCCACCAGTGTCCGGGACTGGAATCAGCCCCAGCATTTT	CATSVRDWNQPQHF	TRBV24-1	TRBJ1-5
TGTGCCAGTAAAAGGACAGGGGGGTTGGATCAGCCCCAGCATTTT	CASKRTGGLDQPQHF	TRBV11-3	TRBJ1-5
TGTGCCAGCAGCCAAGGGGCGTCACTCGTTTGGGGAGACAATGAGCAGTTCTTC	CASSQGASLVWGDNEQFF	TRBV3-1	TRBJ2-1
TGTGCTAGTGGATTGGACAGAGGGTTCACAGATACGCAGTATTTT	CASGLDRGFTDTQYF	TRBV12-5	TRBJ2-3
TGTGCCAGCTCGACAGGGGTCGTCTGCGAGCAGTTCTTC	CASSTGVVCEQFF	TRBV6-1	TRBJ2-1
TGTGCCAGCAGTCAGGAGCGGGAGCGGAGCAATCAGCCCCAGCATTTT	CASSQERERSNQPQHF	TRBV27	TRBJ1-5
TGTGCCAGCAGCTTGGGATCCCGGGAGTCCACCTACGAGCAGTACTTC	CASSLGSRESTYEQYF	TRBV7-9	TRBJ2-7
TGCAGCGTTGACCAAAAGGTTCGAAGACAGGGGGTCTTCTTT	CSVDQKVRRQGVFF	TRBV29-1	TRBJ1-1
TGTGCCACCAGTGGCAGACAGGGAGGTCGTGCTTTCTTT	CATSGRQGGRAFF	TRBV24-1	TRBJ1-1
TGCGCCAGCTGGGGGCTAATCTATGGCTACACCTTC	CASWGLIYGYTF	TRBV10-1	TRBJ1-2
TGTGCCAGCAGTGACTTAGGGGATGGGGAAGCTTTCTTT	CASSDLGDGEAFF	TRBV6-4	TRBJ1-1
TGTGCCAGCAGCTTAAACCGGCTTAACGAGCAGTACTTC	CASSLNRLNEQYF	TRBV6-4	TRBJ2-7
TGTGCCAGCATAAAACTAGCGGGAGCGGGAAACACCATATATTTT	CASIKLAGAGNTIYF	TRBV2	TRBJ1-3
TGTGCCAGCAGCTCGCCCCCAGCTTCACCCCTCCACTTT	CASSSPPASPLHF	TRBV5-6	TRBJ1-6
TGTGCCAGCAGCCAAGTCCGAGGGATCGTGGGAAACACCATATATTTT	CASSQVRGIVGNTIYF	TRBV4-2	TRBJ1-3
TGTGCCACCTTTTATAAGAAGAGGAATGAGCAGTTCTTC	CATFYKKRNEQFF	TRBV27	TRBJ2-1
TGTGCCAGAAAGAGGCGGGACAGAAGCACCGGGGAGCTGTTTTTT	CARKRRDRSTGELFF	TRBV6-6	TRBJ2-2
TGCGCCAGCAGCCAAGACTGGATACAGGCCCAGCATTTT	CASSQDWIQAQHF	TRBV4-1	TRBJ1-5
TGTGCCAGCAACAGGGGGCCGGCCGAGCAGTACTTC	CASNRGPAEQYF	TRBV27	TRBJ2-7
TGTGCCAGCAGTGATCCAATAACCGTTAAAGCTAGCACAGATACGCAGTATTTT	CASSDPITVKASTDTQYF	TRBV6-4	TRBJ2-3
TGTGCCAGTAGTCGGACACTAAATGAAAAACTGTTTTTT	CASSRTLNEKLFF	TRBV19	TRBJ1-4
TGTGCCACCAGCGCCGGAAACACCATATATTTT	CATSAGNTIYF	TRBV15	TRBJ1-3
TGTGCCAGCAGCGTAGGGACCGAAGACAGGGCTCCCCTCCACTTT	CASSVGTEDRAPLHF	TRBV9	TRBJ1-6
TGTGCCAGCAGCCAAGATTTCATGGGGGCTGGCTACACCTTC	CASSQDFMGAGYTF	TRBV3-1	TRBJ1-2
TGTGCCAGCAGCTTAGTGCACCTAGTCACAGATACGCAGTATTTT	CASSLVHLVTDTQYF	TRBV7-9	TRBJ2-3
TGCGCCAGCAGCCCGAACATAGAGGGAGAACCCCCTAATACGCAGTATTTT	CASSPNIEGEPPNTQYF	TRBV10-1	TRBJ2-3
TGTGCCAGCAGTTACTCGTCTGGACGGGAGCAGTTCTTC	CASSYSSGREQFF	TRBV6-5	TRBJ2-1
TGTGCCCGACTAGCGGGGGCCCGGAGCTACGAGCAGTACTTC	CARLAGARSYEQYF	TRBV6-4	TRBJ2-7
TGTGCCAGCAGCTCCGAGGTAGTGCCCACAGATACGCAGTATTTT	CASSSEVVPTDTQYF	TRBV7-4	TRBJ2-3
TGTGCCAGCAGTGTGGGTCCGGGACAGGGACACCGCAATCAGCCCCAGCATTTT	CASSVGPGQGHRNQPQHF	TRBV6-8	TRBJ1-5
TGCGCCAGCAGCTTGACTAGGCTTGAAGCTTTCTTT	CASSLTRLEAFF	TRBV5-1	TRBJ1-1
TGTGCCACCCAGACAGGCTACGAGCAGTACTTC	CATQTGYEQYF	TRBV24-1	TRBJ2-7
TGTGCCACCAGTGATTTTCGGCTAGCGGGCACAGATACGCAGTATTTT	CATSDFRLAGTDTQYF	TRBV24-1	TRBJ2-3
TGTGCCAGCAGTTACATCGTCGAACCATGGGCATGCTACGAGCAGTACTTC	CASSYIVEPWACYEQYF	TRBV6-5	TRBJ2-7
TGCGCCAGCAGCCTTCCCGCTCTGGTCACCGGGGAGCTGTTTTTT	CASSLPALVTGELFF	TRBV4-3	TRBJ2-2
TGTGCCAGCAGCAAGAACCAGTGCACTAGCGGGAGGGCGAAGGGGCTAGTGAACACTGAAGCTTTCTTT	CASSKNQCTSGRAKGLVNTEAFF	TRBV5-8	TRBJ1-1
TGTGCCAGCAGCAGTGATTACCCGGACGGACCCCTCCACTTT	CASSSDYPDGPLHF	TRBV11-2	TRBJ1-6
TGTGCCAGCAGCTTAGGCCCTCCTTGGGGGAAGGTCACTGAAGCTTTCTTT	CASSLGPPWGKVTEAFF	TRBV13	TRBJ1-1
TGTGCCAGCAGCACTCGTGAAGAGCAGTACTTC	CASSTREEQYF	TRBV13	TRBJ2-7
TGTGCTAGTGGTTTGGAGGCACTAGCGGGAGGGCGTAACACTGAAGCTTTCTTT	CASGLEALAGGRNTEAFF	TRBV12-5	TRBJ1-1
TGCGCCAGCAGCTTGCATTGGAACCCCGGGACAGGGGCGTTGGCCTATAATTCACCCCTCCACTTT	CASSLHWNPGTGALAYNSPLHF	TRBV5-1	TRBJ1-6
TGTGCCAGCAGCCAATACTTTCCGTCCACCGGGGAGCTGTTTTTT	CASSQYFPSTGELFF	TRBV3-1	TRBJ2-2
TGTGCCTGGAGTGGAGCCGGGGCGGACAGGGCGTTGTTGGATACGCAGTATTTT	CAWSGAGADRALLDTQYF	TRBV30	TRBJ2-3
TGTGCCAGCAGCCTCGGGACGGGGCCAGATCAGCCCCAGCATTTT	CASSLGTGPDQPQHF	TRBV14	TRBJ1-5
TGCAGTGCTAGGCCCTTGGGACAGAAAAACACCATATATTTT	CSARPLGQKNTIYF	TRBV20-1	TRBJ1-3
TGCAGTGCTAGCAGGGATCGACAGCCCCAGCATTTT	CSASRDRQPQHF	TRBV20-1	TRBJ1-5
TGCAGTGCTAGGTCGGACAGGCATAGCAATCAGCCCCAGCATTTT	CSARSDRHSNQPQHF	TRBV20-1	TRBJ1-5
TGTGCCAGCAGCGTAGCTCGTCTGGGTTTAGATAGAAACACTGAAGCTTTCTTT	CASSVARLGLDRNTEAFF	TRBV9	TRBJ1-1
TGCAGTGCTAGGAAATGCGGCATACGGAGTAAGACCTACGAGCAGTACTTC	CSARKCGIRSKTYEQYF	TRBV20-1	TRBJ2-7
TGTGTAAAAAACAAAGACCCGGGACTAGCCCCGGCCACCTACGAGCAGTACTTC	CVKNKDPGLAPATYEQYF	TRBV30	TRBJ2-7
TGTGCCAGCAGTTATACGGTCCCGGGAGCGGGAACCCTGGGGGATGAAGCTTTCTTT	CASSYTVPGAGTLGDEAFF	TRBV6-5	TRBJ1-1
TGTGCCAGCAGCCTAAGATCGGGGCCGGACACCGGGGAGCTGTTTTTT	CASSLRSGPDTGELFF	TRBV4-2	TRBJ2-2
TGCGCCAGCAGCTTGGATTCACCTATCCAAGGGTTCTTCGGTGGAGGGGACGGCCCCTATGGCTACACCTTC	CASSLDSPIQGFFGGGDGPYGYTF	TRBV5-1	TRBJ1-2
TGTGCCAGCAGTTTCGGTTCGACAGGGGATAGCGAGCAGTACTTC	CASSFGSTGDSEQYF	TRBV28	TRBJ2-7
TGTGCCTGGACAGGGGGCCCGGAAGATACGCAGTATTTT	CAWTGGPEDTQYF	TRBV30	TRBJ2-3
TGTGCCAGCAGCGGAGCGACGAGCTCCTACAATGAGCAGTTCTTC	CASSGATSSYNEQFF	TRBV5-4	TRBJ2-1
TGTGCCAGCACATGGGACGGTGGCGAGCAGTACTTC	CASTWDGGEQYF	TRBV3-1	TRBJ2-7
TGTGCCAGCAGCCTGGGAGGGTTCGGGCACAATGAGCAGTTCTTC	CASSLGGFGHNEQFF	TRBV7-8	TRBJ2-1
TGTGCCAGCAGTTTCCCGGCGCACAGGGGATCCGGGGAGCTGTTTTTT	CASSFPAHRGSGELFF	TRBV27	TRBJ2-2
TGCGCCAGCAGTGTAGCAACGCTAGCGGGGAGCACAGATACGCAGTATTTT	CASSVATLAGSTDTQYF	TRBV10-1	TRBJ2-3
TGTGCCAGCAGCTCACGGACGGGTTTTTCACCCCTCCACTTT	CASSSRTGFSPLHF	TRBV5-6	TRBJ1-6
TGTGCCAGCAGCTTTCCCCTGGGTAGCTCCTATAATTCACCCCTCCACTTT	CASSFPLGSSYNSPLHF	TRBV13	TRBJ1-6
TGTGCCAGCAGTTTACCACCCGGGGACAGGGCCTACGAGCAGTACTTC	CASSLPPGDRAYEQYF	TRBV27	TRBJ2-7
TGTGCCAGCAGAGAGGAGGGTGAGACCCAGTACTTC	CASREEGETQYF	TRBV28	TRBJ2-5
TGCAGTGCTAGAGGGCAGACTTGTTCCCCCAAAAACATTCAGTACTTC	CSARGQTCSPKNIQYF	TRBV20-1	TRBJ2-4
TGCGCCAGCAGTGTGAGGACCAGCTCCTACGAGCAGTACTTC	CASSVRTSSYEQYF	TRBV10-1	TRBJ2-7
TGTGCCAGCAGCGAGATGGCGCCCGACTACGAGCAGTACTTC	CASSEMAPDYEQYF	TRBV13	TRBJ2-7
TGTGCCAGCAGCTGGCCGACAGGGTTTTACACTGAAGCTTTCTTT	CASSWPTGFYTEAFF	TRBV13	TRBJ1-1
TGTGCCAGCAGTTTAGAACCGGGACAGGGGGCGCACTACAATGAGCAGTTCTTC	CASSLEPGQGAHYNEQFF	TRBV27	TRBJ2-1
TGCAGTGCATACGCGGCCCACGGACTAGCGGGCAGCCGTGGTGGGAACAATGAGCAGTTCTTC	CSAYAAHGLAGSRGGNNEQFF	TRBV20-1	TRBJ2-1
TGCAGCGTTGATAGACCTAGGGACACGAACACTGAAGCTTTCTTT	CSVDRPRDTNTEAFF	TRBV29-1	TRBJ1-1
TGTGCCAGCAGGAGATCCTCTAGCGGGACTTATGAGCAGTTCTTC	CASRRSSSGTYEQFF	TRBV27	TRBJ2-1
TGTGCCAGCAGTTGCCCTCCCCTCAGGGGGAGTGCTGAAGCTTTCTTT	CASSCPPLRGSAEAFF	TRBV28	TRBJ1-1
TGTGCCAGCAGCGACTGGGGCCCCGGCGAGACCCAGTACTTC	CASSDWGPGETQYF	TRBV9	TRBJ2-5
TGTGCCAGCAGCTTAGGAAGGGGGGTGGTCTCGGCCTACGAGCAGTACTTC	CASSLGRGVVSAYEQYF	TRBV7-2	TRBJ2-7
TGTGCCAGCAGCTTGTTCCTCCAGGCCACTCAGCCCCAGCATTTT	CASSLFLQATQPQHF	TRBV7-3	TRBJ1-5
TGCGCCAGCAGCCAAGGGGTTCAGCCAAGAAAGGGTGCAACTAATGAAAAACTGTTTTTT	CASSQGVQPRKGATNEKLFF	TRBV4-1	TRBJ1-4
TGTGCCAGCAGCTTAGCGGAAGGGGAGCTGTTTTTT	CASSLAEGELFF	TRBV11-3	TRBJ2-2
TGCGCCAGCAGCACACTAGCGGGAGCGACTGGAAATCAGCCCCAGCATTTT	CASSTLAGATGNQPQHF	TRBV5-1	TRBJ1-5
TGTGCCAGCAGCCAAGAGCGTCTAGCGGGACCCTACGAGCAGTACTTC	CASSQERLAGPYEQYF	TRBV3-1	TRBJ2-7
TGTGCCAGCAGCATACCCGGGATTTTAGGAAACACCATATATTTT	CASSIPGILGNTIYF	TRBV13	TRBJ1-3
TGCGCCAGCAGCTTGCTATCACGAATCGAGACCCAGTACTTC	CASSLLSRIETQYF	TRBV5-1	TRBJ2-5
TGTGCCAGACTAGCGGGGGGGCGGGGGTCGGAGCAGTACTTC	CARLAGGRGSEQYF	TRBV6-8	TRBJ2-7
TGCGCCAGCCTAGCGGGCACAGATACGCAGTATTTT	CASLAGTDTQYF	TRBV5-1	TRBJ2-3
TGTGCCAGCACCTGCCCCAACACCGGGGTACGAAACACCATATATTTT	CASTCPNTGVRNTIYF	TRBV2	TRBJ1-3
TGCAGTGCAGACCGAAGAACCCAGGTCAAAAACATTCAGTACTTC	CSADRRTQVKNIQYF	TRBV20-1	TRBJ2-4
TGTGCCAGGGGAGGGATTGGGCGCTCCTACGAGCAGTACTTC	CARGGIGRSYEQYF	TRBV28	TRBJ2-7
TGCGCCAGCAGTGGGGATCGGGGAGGAATTGCTTTCTTT	CASSGDRGGIAFF	TRBV10-1	TRBJ1-1
TGTGCCAGCAGTTTAGCCACTGAAATGGGTATGTATAGAGAAGCTTTCTTT	CASSLATEMGMYREAFF	TRBV12-3	TRBJ1-1
TGTGCCAGCAGTTTACCCAAGGAAGTTCTTAGTCCTGAAGCTTTCTTT	CASSLPKEVLSPEAFF	TRBV27	TRBJ1-1
TGTGCCAGCGATATGGGATGCAATGAGCAGTTCTTC	CASDMGCNEQFF	TRBV28	TRBJ2-1
TGTGCCACCAGTGGACAACCTAATGAAAAACTGTTTTTT	CATSGQPNEKLFF	TRBV24-1	TRBJ1-4
TGTGCCAGCAGCTTAGCGGCGAGGGTAGATACGCAGTATTTT	CASSLAARVDTQYF	TRBV7-9	TRBJ2-3
TGCGCCAGCAGCTTGCCAGATCCCGGACAGGGTGGTAATGAAAAACTGTTTTTT	CASSLPDPGQGGNEKLFF	TRBV5-1	TRBJ1-4
TGTGCCAGGGCAGAGAGTCTCTCCTACGAGCAGTACTTC	CARAESLSYEQYF	TRBV10-3	TRBJ2-7
TGCGCCAGCAGCCATGTCCATCTCTCGGGCCCCCCAGACTACAATGAGCAGTTCTTC	CASSHVHLSGPPDYNEQFF	TRBV4-3	TRBJ2-1
TGTGCCAGCAGCCAAGAGGTAGCGGGTAGGGAGTTGAGAGATACGCAGTATTTT	CASSQEVAGRELRDTQYF	TRBV14	TRBJ2-3
TGTGCCAGCAGGCGTATCCCAGGGGCGTCCTACGAGCAGTACTTC	CASRRIPGASYEQYF	TRBV6-6	TRBJ2-7
TGCAGCGTTCATAACCCGGGACAGGGGGTGGGCTTCACAGATACGCAGTATTTT	CSVHNPGQGVGFTDTQYF	TRBV29-1	TRBJ2-3
TGCAGTGCTGATCCTCCCCCCATACAGGGGCGTGCGGTTCCAGATACGCAGTATTTT	CSADPPPIQGRAVPDTQYF	TRBV20-1	TRBJ2-3
TGTGCCAGCAGCCGTAGCGGGGAGCAGTTCTTC	CASSRSGEQFF	TRBV7-9	TRBJ2-1
TGTGCCAGCCTGGACAGGGGATGGGGAAGTCAGAATGAAAAACTGTTTTTT	CASLDRGWGSQNEKLFF	TRBV6-1	TRBJ1-4
TGCGCCAGCAGCAATCAGGGACCTTTGAACACTGAAGCTTTCTTT	CASSNQGPLNTEAFF	TRBV5-1	TRBJ1-1
TGTGCCAGCAGCTTGGGGACTAGCGGGGAGCAGTACTTC	CASSLGTSGEQYF	TRBV5-8	TRBJ2-7
TGTGCCAGCAGCGTAGAGAGGGCCACTGAAGCTTTCTTT	CASSVERATEAFF	TRBV9	TRBJ1-1
TGTGCCGAGATCCGGGACAGGCTGAAAACTGAAGCTTTCTTT	CAEIRDRLKTEAFF	TRBV6-6	TRBJ1-1
TGTGCCACCAGTGAATGCAGGGTGAACACTGAAGCTTTCTTT	CATSECRVNTEAFF	TRBV24-1	TRBJ1-1
TGCGCCAGCAGCGGTTTGCCAAGCATGAACACTGAAGCTTTCTTT	CASSGLPSMNTEAFF	TRBV5-1	TRBJ1-1
TGCAGCGTTGAAGATCCGCTGGACAGGGGTGGCTACACCTTC	CSVEDPLDRGGYTF	TRBV29-1	TRBJ1-2
TGTGCCAGCAGTGGGGGGGTTGAGCAGTACTTC	CASSGGVEQYF	TRBV27	TRBJ2-7
TGTGCCAGCAGTCCCGACAGGGCTCAGCCCCAGCATTTT	CASSPDRAQPQHF	TRBV27	TRBJ1-5
TGCAGTGCACAGGACACCGGGGAGCTGTTTTTT	CSAQDTGELFF	TRBV20-1	TRBJ2-2
TGTGCCAGCAGCCGGGCTCCGTTGGATCAGCCCCAGCATTTT	CASSRAPLDQPQHF	TRBV6-2	TRBJ1-5
TGCGCCAGCAGTGAGCTCTTCCTGCCTGAAGCTTTCTTT	CASSELFLPEAFF	TRBV10-1	TRBJ1-1
TGTGCCACCAGTGATGGTGGGGAGGGGGGATACAATGAGCAGTTCTTC	CATSDGGEGGYNEQFF	TRBV24-1	TRBJ2-1
TGTGCCGAAACGCCGTCAGGTGGCCGCACAGATACGCAGTATTTT	CAETPSGGRTDTQYF	TRBV27	TRBJ2-3
TGTGCCAGCAGCCCCCTAGCGGGTGGAGGTGATACGCAGTATTTT	CASSPLAGGGDTQYF	TRBV6-1	TRBJ2-3
TGTGCCAGCAGAGGGCGGAGTGGGGCCAGTGAAGCTTTCTTT	CASRGRSGASEAFF	TRBV7-3	TRBJ1-1
TGCGCCAGCAGCTTGGCACCCCCCTCACCTGTCTATGGCTACACCTTC	CASSLAPPSPVYGYTF	TRBV5-1	TRBJ1-2
TGCAGTGCTGGCAGCCGAGCTAACTATGGCTACACCTTC	CSAGSRANYGYTF	TRBV20-1	TRBJ1-2
TGTGCCACCACCGATCGCCTTCAAGAGACCCAGTACTTC	CATTDRLQETQYF	TRBV24-1	TRBJ2-5
TGTGCCACGGCCCCCGCCCCGGGACAGGTTAAGGAGACCCAGTACTTC	CATAPAPGQVKETQYF	TRBV24-1	TRBJ2-5
TGTGCCAGCAGCTTTACGGCAGGGTGGTCTGGAAACACCATATATTTT	CASSFTAGWSGNTIYF	TRBV13	TRBJ1-3
TGCGCCAGCAGCCAAGGGGATAACAGGGGGTCGGGGTTTAACTATGGCTACACCTTC	CASSQGDNRGSGFNYGYTF	TRBV4-1	TRBJ1-2
TGTGCCACCAGTGATTTGCAAACAGGGGTGTGTAGCCCCCGTAACTATGGCTACACCTTC	CATSDLQTGVCSPRNYGYTF	TRBV24-1	TRBJ1-2
TGTGCCAGCAGCCCAAATAAGCGGGAATACGAGCAGTACTTC	CASSPNKREYEQYF	TRBV5-4	TRBJ2-7
TGCAGTGCTAGATCGACAGGGGTCAAATTAAACTATGGCTACACCTTC	CSARSTGVKLNYGYTF	TRBV20-1	TRBJ1-2
TGTGCCAGCAGCAGCGGCGGGTGTCTTGAGACCCAGTACTTC	CASSSGGCLETQYF	TRBV4-2	TRBJ2-5
TGTGCCAGCCCTTATACAAGGAAGCTAGGGTACTCTGGAAACACCATATATTTT	CASPYTRKLGYSGNTIYF	TRBV27	TRBJ1-3
TGTGCCAGCAGCTTAGGTTGGGGGGGGTTTAGCGAGCAGTACTTC	CASSLGWGGFSEQYF	TRBV13	TRBJ2-7
TGTGCCAGCGCCAGGGGTAACAATGAGCAGTTCTTC	CASARGNNEQFF	TRBV12-4	TRBJ2-1
TGTGCCAGCAGCTTAGCCCCGGGACAGGGAAAGTTTGAAGCTTTCTTT	CASSLAPGQGKFEAFF	TRBV7-8	TRBJ1-1
TGCGCCAGCAGTGATCCGGGACGTACTCACGGCTACACCTTC	CASSDPGRTHGYTF	TRBV10-1	TRBJ1-2
TGCAAGCCCCCCCGGGACAGGGGGCTTGGCGGGATTCAGCCCCAGCATTTT	CKPPRDRGLGGIQPQHF	TRBV29-1	TRBJ1-5
TGCGCCAGCAGTCACAGGGCTCTCATTGAAGCTTTCTTT	CASSHRALIEAFF	TRBV5-1	TRBJ1-1
TGCGCCAGCAGTGTTACGGGCACAGATACGCAGTATTTT	CASSVTGTDTQYF	TRBV10-2	TRBJ2-3
TGCAGTGCTAGCAGGGGGAGTAGCACTGGGGCCAACGTCCTGACTTTC	CSASRGSSTGANVLTF	TRBV20-1	TRBJ2-6
TGTGCCACCAGTGAGTGGTTCGTGCAAAAGGACAGGAGCACTGAAGCTTTCTTT	CATSEWFVQKDRSTEAFF	TRBV24-1	TRBJ1-1
TGTGCCAGCAGCTCTTGGACAGGGTTCGTCTACGAGCAGTACTTC	CASSSWTGFVYEQYF	TRBV3-1	TRBJ2-7
TGCGCCAGCCGGAGTAGGAACACCGGGGAGCTGTTTTTT	CASRSRNTGELFF	TRBV10-1	TRBJ2-2
TGTGCCAGCAGTGTAGTCCGCAGGGAAGCTTTCTTT	CASSVVRREAFF	TRBV28	TRBJ1-1
TGTGCCAGCCCGAACGGGACAGGGGGCACAGATACGCAGTATTTT	CASPNGTGGTDTQYF	TRBV7-6	TRBJ2-3
TGCGCCAGCAGCTTGGGAATAAGTGAACGACCACGGATGAACACTGAAGCTTTCTTT	CASSLGISERPRMNTEAFF	TRBV5-1	TRBJ1-1
TGTGCCAGCAGGATGGACAGTACCTACGAGCAGTACTTC	CASRMDSTYEQYF	TRBV6-1	TRBJ2-7
TGTGCCAGCAGTGCCAGACAGGACGCCTACGAGCAGTACTTC	CASSARQDAYEQYF	TRBV28	TRBJ2-7
TGTGCCAGCAGCTTATCTAAGTCACGGCCGACCGACAGGGGGCAGCAGCCCCAGCATTTT	CASSLSKSRPTDRGQQPQHF	TRBV11-2	TRBJ1-5
TGCAGTGCTTTCAGCTCTGAAGCTTTCTTT	CSAFSSEAFF	TRBV20-1	TRBJ1-1
TGTGCCAGCAGCCACGGGAAAAATAGGTGGACCCAGTACTTC	CASSHGKNRWTQYF	TRBV13	TRBJ2-5
TGTGCCAGCAGTGACCACCGACCAGTCAGGGGGGGATGCCCGGTGCACGAGCAGTACTTC	CASSDHRPVRGGCPVHEQYF	TRBV6-4	TRBJ2-7
TGTGCCAGCAGTTCCGGGGACAGGGGGCCCGACGAGCAGTACTTC	CASSSGDRGPDEQYF	TRBV6-5	TRBJ2-7
TGTGCCAGCTTCCATCAAGTGATGCAGGGCGAAGACTATGGCTACACCTTC	CASFHQVMQGEDYGYTF	TRBV11-1	TRBJ1-2
TGCAGTGCTGAGGGTTACTGGAACGAGCAGTACTTC	CSAEGYWNEQYF	TRBV20-1	TRBJ2-7
TGCGCCAGCAGCCATGGCGGGGACGCACTGTGGTCTAGCACAGATACGCAGTATTTT	CASSHGGDALWSSTDTQYF	TRBV4-3	TRBJ2-3
TGTGCCAGTAGTGAAGGTAGAGGCGTCACCGGGGAGCTGTTTTTT	CASSEGRGVTGELFF	TRBV19	TRBJ2-2
TGCGCCAGCAGCTTGGAAGGGACAGCAGGCACTGAAGCTTTCTTT	CASSLEGTAGTEAFF	TRBV5-1	TRBJ1-1
TGTGCCAGGCCACAGAATGAAAAACTGTTTTTT	CARPQNEKLFF	TRBV30	TRBJ1-4
TGCGCCAGCAGGGCGGGGAGAACCTACGAGCAGTACTTC	CASRAGRTYEQYF	TRBV5-1	TRBJ2-7
TGTGCCAGCAGCCCGGGGGGGGAGACCCAGTACTTC	CASSPGGETQYF	TRBV28	TRBJ2-5
TGTGCCAGCAGTGACTCGCGCCTAGCGTGGGTGGATGAGCAGTTCTTC	CASSDSRLAWVDEQFF	TRBV6-4	TRBJ2-1
TGTGCCAGCAGCTTACAGGGGGCATACCTCGGCGAAGCTTTCTTT	CASSLQGAYLGEAFF	TRBV7-9	TRBJ1-1
TGTGCTAGTGGTTACTTACTAGCGGGAGCGCTGATTGCGAACACCGGGGAGCTGTTTTTT	CASGYLLAGALIANTGELFF	TRBV12-5	TRBJ2-2
TGCAGGTCCGGGGCGTGGGAGCAGTACTTC	CRSGAWEQYF	TRBV20-1	TRBJ2-7
TGTGCCATCCTCGGGGTCCGAAATCAGCCCCAGCATTTT	CAILGVRNQPQHF	TRBV10-3	TRBJ1-5
TGTGCCAACACCGGATTTTTTCGTCCGTCCGATCGCACAGATACGCAGTATTTT	CANTGFFRPSDRTDTQYF	TRBV6-5	TRBJ2-3
TGTGCCAGCAGCCTAATCGCGGGAGTCTACGAGCAGTACTTC	CASSLIAGVYEQYF	TRBV11-3	TRBJ2-7
TGCAGTGCTAGAGGGCCCGGGGGGCCCGGGAGAAACACCGGGGAGCTGTTTTTT	CSARGPGGPGRNTGELFF	TRBV20-1	TRBJ2-2
TGTGCTAGTGGTGGACAGGTATACACCTTC	CASGGQVYTF	TRBV12-5	TRBJ1-2
TGTGCCACCAGCATCAAGTCAGGGGGTATGGACTACGAGCAGTACTTC	CATSIKSGGMDYEQYF	TRBV15	TRBJ2-7
TGTGCCAGTAGTCCACTCATTCGGGGCGAGCAGTACTTC	CASSPLIRGEQYF	TRBV19	TRBJ2-7
TGTGCCAGCAGCCAGGTCCTGGCTGAGTACGAGCAGTACTTC	CASSQVLAEYEQYF	TRBV14	TRBJ2-7
TGTGCCAGCAGCTTAAGAAGGGGGGGGTGTAGGTACAATGAGCAGTTCTTC	CASSLRRGGCRYNEQFF	TRBV11-3	TRBJ2-1
TGTGCCAGCAGCCGTGGGACCCTGGGCAATCAGCCCCAGCATTTT	CASSRGTLGNQPQHF	TRBV13	TRBJ1-5
TGTGCCAGCGTTGCTGTTGAGCAGTTCTTC	CASVAVEQFF	TRBV7-4	TRBJ2-1
TGTGCCAGCAGCGTCCAGGGGGGCTACGAGCAGTACTTC	CASSVQGGYEQYF	TRBV13	TRBJ2-7
TGCAGTGCTATTTCCGGAGGGCGGGTGGGCTACACCTTC	CSAISGGRVGYTF	TRBV20-1	TRBJ1-2
TGCAGTGCGAGTATAATTCAGGGCGAAAAACTGTTTTTT	CSASIIQGEKLFF	TRBV20-1	TRBJ1-4
TGTGCCAGCAGCTTAGTAGTAACCACCCGAGGGTGGGAGACCCAGTACTTC	CASSLVVTTRGWETQYF	TRBV7-6	TRBJ2-5
TGTGCCACGACAGTACGAGAGCAGTACTTC	CATTVREQYF	TRBV28	TRBJ2-7
TGCGCCAGCAGTGAGTCACAAATCGGGGGCCGGAACGCCAATGAGCAGTTCTTC	CASSESQIGGRNANEQFF	TRBV10-1	TRBJ2-1
TGTGCCAGCAGTTACGGACAGGGGTGGGCAACTAATGAAAAACTGTTTTTT	CASSYGQGWATNEKLFF	TRBV6-3	TRBJ1-4
TGTGCCAGCAGCGGTCGGGACGGGGTGAATCAGCCCCAGCATTTT	CASSGRDGVNQPQHF	TRBV9	TRBJ1-5
TGTGCCAGCAGCCACGGGCCCCAAGAGACCCAGTACTTC	CASSHGPQETQYF	TRBV7-2	TRBJ2-5
TGTGCCAGCAGGGTCCTATCAGGGTTTGGCTCCTACGAGCAGTACTTC	CASRVLSGFGSYEQYF	TRBV7-3	TRBJ2-7
TGTGCCAGCATGAGGGGGGCTGAAGCTTTCTTT	CASMRGAEAFF	TRBV7-9	TRBJ1-1
TGTGCCAGCAGCTGGTCAGTTCCTAGCAATCAGCCCCAGCATTTT	CASSWSVPSNQPQHF	TRBV7-9	TRBJ1-5
TGTGCCAGCAGTTTAAACTGCGACAGGGGGCCCCGGACCTACGAGCAGTACTTC	CASSLNCDRGPRTYEQYF	TRBV12-3	TRBJ2-7
TGCAGCGTTGTTCCCGGGCCGGGACTGGCGCAGTACTTC	CSVVPGPGLAQYF	TRBV29-1	TRBJ2-7
TGCGCCAGCAGCTGTCGGGGGCAAGGGGGCTCCTACGAGCAGTACTTC	CASSCRGQGGSYEQYF	TRBV5-1	TRBJ2-7
TGTGCCAGCAGCGGCCCGGGACTAGCGGACGGGAGCTCCTACAATGAGCAGTTCTTC	CASSGPGLADGSSYNEQFF	TRBV7-3	TRBJ2-1
TGTGCCAAACGTAGGGGACGCTGCCAAGAGACCCAGTACTTC	CAKRRGRCQETQYF	TRBV27	TRBJ2-5
TGTGCCAGTAGTGGGACTAACACCATGAACACTGAAGCTTTCTTT	CASSGTNTMNTEAFF	TRBV19	TRBJ1-1
TGTGCCAGCAGACAGGGAGGCGACAATCAGCCCCAGCATTTT	CASRQGGDNQPQHF	TRBV14	TRBJ1-5
TGTGCCAGCAGCTTAGATGCGGGAGGGACAGATACGCAGTATTTT	CASSLDAGGTDTQYF	TRBV7-9	TRBJ2-3
TGTGCCAGCAGTTACTCGACAGGCCCGGGGTCGCAGGGCTACACCTTC	CASSYSTGPGSQGYTF	TRBV6-5	TRBJ1-2
TGTGCCAGCAGTGAATATCACCGAGGGAGAGACGGCTACACCTTC	CASSEYHRGRDGYTF	TRBV25-1	TRBJ1-2
TGTGCCAGCAGCGTAGGCGGGGGGGGGTGGGAGCAGTACTTC	CASSVGGGGWEQYF	TRBV9	TRBJ2-7
TGTGCCAGCCCTTGTCTAGCGACAGGCACAGATACGCAGTATTTT	CASPCLATGTDTQYF	TRBV9	TRBJ2-3
TGTGCCAGCATAGCGGGGGGCTACGAGCAGTACTTC	CASIAGGYEQYF	TRBV6-6	TRBJ2-7
TGTGCCACCAGTGATTGGACAGAAGAGCACGAGCAGTACTTC	CATSDWTEEHEQYF	TRBV24-1	TRBJ2-7
TGCAGTGCTAGAGATACAGGACAGGGGGCCTATGGCTACACCTTC	CSARDTGQGAYGYTF	TRBV20-1	TRBJ1-2
TGTGCCAGCAGCCTTCTAGCCTCGGCAGGTATCTACGAGCAGTACTTC	CASSLLASAGIYEQYF	TRBV14	TRBJ2-7
TGTGCCAGCAGCCGAAGCCCCTTCGGGGCCCGGTACAGCCATAAGGGGAATAGACTTGGCTACACCTTC	CASSRSPFGARYSHKGNRLGYTF	TRBV7-3	TRBJ1-2
TGTGCCAGCAGCAGTGTGGGCAATGCAACTAATGAAAAACTGTTTTTT	CASSSVGNATNEKLFF	TRBV9	TRBJ1-4
TGCGCCAGCAGTCACCAGCAGGGGGCTCGGAGCTCCTACAATGAGCAGTTCTTC	CASSHQQGARSSYNEQFF	TRBV4-1	TRBJ2-1
TGTGCCAGCATGGGGGGGGCTCGCGAGTACGAGCAGTACTTC	CASMGGAREYEQYF	TRBV2	TRBJ2-7
TGTGCCAGCAGTACCTCTAGCAATCAGCCCCAGCATTTT	CASSTSSNQPQHF	TRBV6-1	TRBJ1-5
TGTGCCAGCAGCTCTGGAGGACAGGGGGCATACAATGAGCAGTTCTTC	CASSSGGQGAYNEQFF	TRBV7-9	TRBJ2-1
TGTGCCAGGGGGACAGGGGACGAGCAGTACTTC	CARGTGDEQYF	TRBV9	TRBJ2-7
TGCGCCACGGGGACTAGCGGCGCCAACAATGAGCAGTTCTTC	CATGTSGANNEQFF	TRBV5-1	TRBJ2-1
TGTGCCAGCAGCCAAGATCGGCCACCGGGGGCAGATCAGCCCCAGCATTTT	CASSQDRPPGADQPQHF	TRBV14	TRBJ1-5
TGTGCCAGCAGTAACGCCCAGGGGGCTATAAATCAGCCCCAGCATTTT	CASSNAQGAINQPQHF	TRBV6-5	TRBJ1-5
TGTGCCACCAGTGTCCCCCGGGGGACAGGGGGGGTAAGGTACTATGGCTACACCTTC	CATSVPRGTGGVRYYGYTF	TRBV24-1	TRBJ1-2
TGTGCCAGCAGCGCGGGAGGACAGCCCCAGCATTTT	CASSAGGQPQHF	TRBV28	TRBJ1-5
TGTGCCTGGAGGCCGCTACGAGATACGCAGTATTTT	CAWRPLRDTQYF	TRBV30	TRBJ2-3
TGTGCCAGCAGTGATAGGACACACCAAGATACGCAGTATTTT	CASSDRTHQDTQYF	TRBV25-1	TRBJ2-3
TGTGCCACTAACGGGACAGGCTCCGATGGCTACACCTTC	CATNGTGSDGYTF	TRBV9	TRBJ1-2
TGTGCCAGCAGCCGGAAGGAGTACGAGCAGTACTTC	CASSRKEYEQYF	TRBV14	TRBJ2-7
TGTGCCAGCAGCCCTACCAGAAACACCATATATTTT	CASSPTRNTIYF	TRBV13	TRBJ1-3
TGTGCCATCAGTGAGCGGGGACGACCCTGGGAGAGTTTGTCCTACGAGCAGTACTTC	CAISERGRPWESLSYEQYF	TRBV10-3	TRBJ2-7
TGCGCCAGCAGCCTCAGGGGGCAACATACTGGAAACACCATATATTTT	CASSLRGQHTGNTIYF	TRBV5-1	TRBJ1-3
TGTGCCAGCAGCCCCGGCAGGACAGTAATTCCCAATCAGCCCCAGCATTTT	CASSPGRTVIPNQPQHF	TRBV11-2	TRBJ1-5
TGTGCCAGCAGCTTGCTCTGGGGACAGGGCTTTGGGGTCTCCTACGAGCAGTACTTC	CASSLLWGQGFGVSYEQYF	TRBV5-8	TRBJ2-7
TGTGCCACCAGCAGAGCGGGGACCTACGAGCAGTACTTC	CATSRAGTYEQYF	TRBV15	TRBJ2-7
TGTGCCAGCAGTGACTCCTCGGGTTCCCAGATGCGGGAAAAACTGTTTTTT	CASSDSSGSQMREKLFF	TRBV6-4	TRBJ1-4
TGTGCCAGCAGCCGGAAGACAGCTGGTGCAAATGAGCAGTTCTTC	CASSRKTAGANEQFF	TRBV3-1	TRBJ2-1
TGCAGTGCTAGAGATAGATCCACCGGACAGGGAGCCGGCGAGCAGTACTTC	CSARDRSTGQGAGEQYF	TRBV20-1	TRBJ2-7
TGTGCCACCAGCAGAGATTTTAAGATCAGGGTTAGAGAAGCTTTCTTT	CATSRDFKIRVREAFF	TRBV15	TRBJ1-1
TGTGCCAGCTGTGGGACAAACAATGAGCAGTTCTTC	CASCGTNNEQFF	TRBV3-1	TRBJ2-1
TGCAGTGCTAGAGATCCCTGGCGGGACAGGGCTCCAACTAATGAAAAACTGTTTTTT	CSARDPWRDRAPTNEKLFF	TRBV20-1	TRBJ1-4
TGTGCCAGCAGCAACAGGACAGGAGGCTATGGCTACACCTTC	CASSNRTGGYGYTF	TRBV7-3	TRBJ1-2
TGTGCCACCAGAGAATACAGGGAACTGTTTTTT	CATREYRELFF	TRBV6-1	TRBJ1-4
TGTGCCAGCAGCCACACGCCTAGCGGGATCTCTCACGAGCAGTACTTC	CASSHTPSGISHEQYF	TRBV14	TRBJ2-7
TGTGCCAGCAGCTCTGCTAGCGGGCGTGCCTACGAGCAGTACTTC	CASSSASGRAYEQYF	TRBV7-3	TRBJ2-7
TGTGCTAGTGGTTTGCCGGACCCCGGTACCGAAGGAAACAATGAGCAGTTCTTC	CASGLPDPGTEGNNEQFF	TRBV12-5	TRBJ2-1
TGTGCCAGCAGTGCTAAGGCTGGCTACACCTTC	CASSAKAGYTF	TRBV25-1	TRBJ1-2
TGCGCCAGCAGCCCGAGGCACGACAGGGGACTTAACACCGGGGAGCTGTTTTTT	CASSPRHDRGLNTGELFF	TRBV4-1	TRBJ2-2
TGTGCCAGCAGCGGGGGCACCGGGGAGCTGTTTTTT	CASSGGTGELFF	TRBV7-2	TRBJ2-2
TGTGCCTCTCAAGAGAAGGGGAATGAGCAGTTCTTC	CASQEKGNEQFF	TRBV27	TRBJ2-1
TGTGCCAGCAGCCAAGGGGGGGGAGATGAGCAGTTCTTC	CASSQGGGDEQFF	TRBV3-1	TRBJ2-1
TGCGCCAGCAGCCAAGCTAGTTCAAGACCCACAGATACGCAGTATTTT	CASSQASSRPTDTQYF	TRBV4-1	TRBJ2-3
TGTGCCAGCAGTTACTCGAAGGACATCTCTGAAGAAAAACTGTTTTTT	CASSYSKDISEEKLFF	TRBV6-2	TRBJ1-4
TGTGCCAGATTCGTGGGAGGTAATGAGCAGTTCTTC	CARFVGGNEQFF	TRBV7-6	TRBJ2-1
TGCGCCAGCAGCAACAGGGGCGGGGATTTCGGGAAAAGAAGGGGCTACACCTTC	CASSNRGGDFGKRRGYTF	TRBV10-1	TRBJ1-2
TGTGCCCCGGAAAAGGGACGCGGGGAGCGAAAGATTGGCACAGATACGCAGTATTTT	CAPEKGRGERKIGTDTQYF	TRBV27	TRBJ2-3
TGTGCCAGCAGCCGAATTTCCGGGACAGACTACGAGCAGTACTTC	CASSRISGTDYEQYF	TRBV12-4	TRBJ2-7
TGTGCCACCAGTGTCCCGTCTAGCGTAACCATTGTACGGTACAATGAGCAGTTCTTC	CATSVPSSVTIVRYNEQFF	TRBV24-1	TRBJ2-1
TGTGCCAGCAGGTCTACGACCGGGGAGCTGTTTTTT	CASRSTTGELFF	TRBV27	TRBJ2-2
TGTGCCAGCAGTTCTAGGGGGGCCAAAAACATTCAGTACTTC	CASSSRGAKNIQYF	TRBV11-3	TRBJ2-4
TGTGCCAGCAGCTTAGGTCCCTCTATTCCCTACGAGCAGTACTTC	CASSLGPSIPYEQYF	TRBV11-3	TRBJ2-7
TGTGCCAGCAGCAAGGAATGTTTGAATAGACCCAATCAGCCCCAGCATTTT	CASSKECLNRPNQPQHF	TRBV6-4	TRBJ1-5
TGTGCCAGCAGCCGGGACAGATTCGGGGGCTGTCAGCCCCAGCATTTT	CASSRDRFGGCQPQHF	TRBV13	TRBJ1-5
TGTGCCAGCAGCTTAGAACTCTTCCACTACGAGCAGTACTTC	CASSLELFHYEQYF	TRBV11-3	TRBJ2-7
TGTGCCAGCAGTATGCCCGGACAGGGGCCTTGCAATGAAAAACTGTTTTTT	CASSMPGQGPCNEKLFF	TRBV27	TRBJ1-4
TGCAGTGCCCTGGGACAGATCAATCAGCCCCAGCATTTT	CSALGQINQPQHF	TRBV20-1	TRBJ1-5
TGTGCCAGCAGCCAAGAAGCAGGCCCGGGACAGATGACTAGCACAGATACGCAGTATTTT	CASSQEAGPGQMTSTDTQYF	TRBV14	TRBJ2-3
TGCATAGGGCTATGGGATAGCAATCAGCCCCAGCATTTT	CIGLWDSNQPQHF	TRBV20-1	TRBJ1-5
TGTGCCAGCAGTTGGGGGACTAAATATAGCAATCAGCCCCAGCATTTT	CASSWGTKYSNQPQHF	TRBV27	TRBJ1-5
TGTGCCAGCTCCGTCAATCGAAGCGGGATGCATGGGGATGAGCAGTTCTTC	CASSVNRSGMHGDEQFF	TRBV27	TRBJ2-1
TGTGCCAGCAGTTGTCCCCCCCCGGGGGCCGAGACCCAGTACTTC	CASSCPPPGAETQYF	TRBV12-3	TRBJ2-5
TGCGCCAGCAGCTCGGACAGGGGAAGGAATAGCAATCAGCCCCAGCATTTT	CASSSDRGRNSNQPQHF	TRBV5-1	TRBJ1-5
TGTGCCAGCAGGCCCGGGGTGGGGGGACGGGATACGCAGTATTTT	CASRPGVGGRDTQYF	TRBV7-9	TRBJ2-3
TGTGCCAGCAGCCAAGCCGTGCGGCCCAATGAGCAGTTCTTC	CASSQAVRPNEQFF	TRBV3-1	TRBJ2-1
TGTGCCAGCAGGACAGGCATCGGGGAGCTGTTTTTT	CASRTGIGELFF	TRBV9	TRBJ2-2
TGTGCCAGCAGGGCGAGACGGACCTACGAGCAGTACTTC	CASRARRTYEQYF	TRBV6-6	TRBJ2-7
TGCGCCAGCACATTGGGCTATGGCTACACCTTC	CASTLGYGYTF	TRBV10-2	TRBJ1-2
TGTGCCAGCAGTGAAGAAGGGGTGGGGGTGAATGAGCAGTTCTTC	CASSEEGVGVNEQFF	TRBV6-1	TRBJ2-1
TGTGCCAGCAGCGTACTCCCTCTAGCGGTTGATACGCAGTATTTT	CASSVLPLAVDTQYF	TRBV9	TRBJ2-3
TGTGCCAGCAGCTTAGGGGGGGCCAGGTTAGTATCGAACACCGGGGAGCTGTTTTTT	CASSLGGARLVSNTGELFF	TRBV7-2	TRBJ2-2
TGCGCCAGCAGCCCCACGGGACAGGGCTACGAGCAGTACTTC	CASSPTGQGYEQYF	TRBV5-1	TRBJ2-7
TGTGCCACCAGTGATTTGGATACCCCGTCTCGACAGGGGGGGGAAGAGACCCAGTACTTC	CATSDLDTPSRQGGEETQYF	TRBV24-1	TRBJ2-5
TGTGCCAGCAGGCGGCCGGCGCAAAGGGAGGGGAGGGGGTACACTGAAGCTTTCTTT	CASRRPAQREGRGYTEAFF	TRBV2	TRBJ1-1
TGTGCCAGCAGTGACCCGGGGGGGTATGTTGGGAGCTACGAGCAGTACTTC	CASSDPGGYVGSYEQYF	TRBV6-4	TRBJ2-7
TGTGCCAGCAGCCCCCTGACAGGGTATTCTGAGACCCAGTACTTC	CASSPLTGYSETQYF	TRBV7-9	TRBJ2-5
TGTGCCAGCAGACCCTCCGGGACTTTGATAATGAACACTGAAGCTTTCTTT	CASRPSGTLIMNTEAFF	TRBV12-3	TRBJ1-1
TGTGCCAGCAGCTTAGCAGCCTACGAGCAGTACTTC	CASSLAAYEQYF	TRBV13	TRBJ2-7
TGTGCCAGCAGAGACAGGGGTCCGACAGTTAGATTCCAACTCCACTTC	CASRDRGPTVRFQLHF	TRBV5-4	TRBJ2-7
TGTGCCAGCAGTTACTCGAGTTACATGCCCAATGAAAAACTGTTTTTT	CASSYSSYMPNEKLFF	TRBV6-2	TRBJ1-4
TGTGCCAGCAGCACTGGGGGGGCCGACAAGACTTACGCCCGCTCCTACGAGCAGTACTTC	CASSTGGADKTYARSYEQYF	TRBV7-9	TRBJ2-7
TGTGCCAGCTCGGGGGGCTCTGGGACAGGTTCCTACGAGCAGTACTTC	CASSGGSGTGSYEQYF	TRBV18	TRBJ2-7
TGTGCCAGCAGCTTCGGGACATCCTACGAGCAGTACTTC	CASSFGTSYEQYF	TRBV5-6	TRBJ2-7
TGTGCCAGCAGCTTAGATCTGGAGGGGGGAGACAATGAGCAGTTCTTC	CASSLDLEGGDNEQFF	TRBV11-2	TRBJ2-1
TGTGCCAGTAGTGCTCTGCAGGGGGGTTCCTTGAACACTGAAGCTTTCTTT	CASSALQGGSLNTEAFF	TRBV19	TRBJ1-1
TGTGCCAGTAGTATATTCACGGATTATTACCAAGAGACCCAGTACTTC	CASSIFTDYYQETQYF	TRBV19	TRBJ2-5
TGTGCCAGCAGCCCCCTTGGTAGGGGGTTACTCAAGCGTAACTATGGCTACACCTTC	CASSPLGRGLLKRNYGYTF	TRBV7-2	TRBJ1-2
TGTGCCAAAGCGGCCTATAATTCACCCCTCCACTTT	CAKAAYNSPLHF	TRBV2	TRBJ1-6
TGCAGTGCTAGAGATGTGTCCGGGGACAGGGAATCTTCCTACGAGCAGTACTTC	CSARDVSGDRESSYEQYF	TRBV20-1	TRBJ2-7
TGTGCCAGTAGTATAGTGTCAGGGCGGGCTAACTATGGCTACACCTTC	CASSIVSGRANYGYTF	TRBV19	TRBJ1-2
TGTGCCAGCAGCCAAGAAACCCCGGGACGAAAATCCTACGAGCAGTACTTC	CASSQETPGRKSYEQYF	TRBV14	TRBJ2-7
TGTGCCACCAGTGATTTGCAGCCCACCGGAGTGGACAGGGACGACGATCCCCAGCATTTT	CATSDLQPTGVDRDDDPQHF	TRBV24-1	TRBJ1-5
TGTGCCAGCAGCCCCGTCCAGGACAGGGGAAACACCATATATTTT	CASSPVQDRGNTIYF	TRBV13	TRBJ1-3
TGTGCCAGCAGTCCGGGACATGAAAAACTGTTTTTT	CASSPGHEKLFF	TRBV2	TRBJ1-4
TGTGCTAGCAGCTTAGCGGACAGGGGCGAGCAGTACTTC	CASSLADRGEQYF	TRBV7-7	TRBJ2-7
TGTGCCTGGAGTGCCAGTGGGGGCGCCGAGCAGTACTTC	CAWSASGGAEQYF	TRBV30	TRBJ2-7
TGCAGTGCTAGAGCCGGGACTAGCGGGGGGGCCCACTACAATGAGCAGTTCTTC	CSARAGTSGGAHYNEQFF	TRBV20-1	TRBJ2-1
TGTGCCAGCCAGGGCTTAACAAAGACCCAGCCCCAGCATTTT	CASQGLTKTQPQHF	TRBV6-2	TRBJ1-5
TGTGCCAGCAGCGTAGGACGTTCAGAGACCCAGTACTTC	CASSVGRSETQYF	TRBV9	TRBJ2-5
TGTGCCAGCAGCGAAGCAAATTGCACTGAAGCTTTCTTT	CASSEANCTEAFF	TRBV7-8	TRBJ1-1
TGTGCCAGCAGTGACGGGGGGACAGGGGCCGGTTCACCCCTCCACTTT	CASSDGGTGAGSPLHF	TRBV2	TRBJ1-6
TGTGCCAGCAGCTTAAATTCCAAGACGGCTGGAAACACCATATATTTT	CASSLNSKTAGNTIYF	TRBV11-3	TRBJ1-3
TGCGCCAGCAGCCGGTTAGGAGGTTGGTCAACCAGAGGCTCTAGCTACGAGCAGTACTTC	CASSRLGGWSTRGSSYEQYF	TRBV4-3	TRBJ2-7
TGTGCCATCCAGGAGGCGGCCCTCCACTTT	CAIQEAALHF	TRBV10-3	TRBJ1-6
TGTGCCAGCATCCCATGCAGGGCGTCACCAGATACGCAGTATTTT	CASIPCRASPDTQYF	TRBV9	TRBJ2-3
TGCGCCAGCAGCCCCTGGGGGCAGGGGGGGGGAGGAGGGTATGGCTACACCTTC	CASSPWGQGGGGGYGYTF	TRBV5-1	TRBJ1-2
TGTGCCAGCAAAGAAAGGAATGAGCAGTTCTTC	CASKERNEQFF	TRBV2	TRBJ2-1
TGTGCCAGCAGTCCGGTAGGGGCAGGGGAAAAACTGTTTTTT	CASSPVGAGEKLFF	TRBV7-9	TRBJ1-4
TGTGCCAGCAGTTCAATTGGGGGTAATTCACCCCTCCACTTT	CASSSIGGNSPLHF	TRBV6-1	TRBJ1-6
TGTGCCTGGTTGGGACAGGGACATGAAAAACTGTTTTTT	CAWLGQGHEKLFF	TRBV30	TRBJ1-4
TGTTACAGGGGGGGCCTGGACACCGGGGAGCTGTTTTTT	CYRGGLDTGELFF	TRBV30	TRBJ2-2
TGTGCCAGTAGTATCCCTGAGGTGGGTTCCTACGAGCAGTACTTC	CASSIPEVGSYEQYF	TRBV19	TRBJ2-7
TGTGCCAGCAGCCTACCCTCCGGACGTGCAGGGGGCTACACCTTC	CASSLPSGRAGGYTF	TRBV13	TRBJ1-2
TGCGCCAGCAGCAAGACAGGGGGGGGGGGAGGCTACACCTTC	CASSKTGGGGGYTF	TRBV5-1	TRBJ1-2
TGCGCCAGCAGCTTGGATACAGCAGATACGCAGTATTTT	CASSLDTADTQYF	TRBV5-1	TRBJ2-3
TGTGCTAGTGGGTGGTATCGGACTAGAGTCACCTCTGGGGCCAACGTCCTGACTTTC	CASGWYRTRVTSGANVLTF	TRBV12-5	TRBJ2-6
TGTGCCATCAGCGGACAGGGGGCAGGGCTCAGAAACGAGCAGTACTTC	CAISGQGAGLRNEQYF	TRBV10-3	TRBJ2-7
TGTGCCAGCAGCGTAAGGGATAGCAATCAGCCCCAGCATTTT	CASSVRDSNQPQHF	TRBV9	TRBJ1-5
TGTGCCAGCAGCCAAGACTCTCTAGCGGGTGACGAGCAGTACTTC	CASSQDSLAGDEQYF	TRBV14	TRBJ2-7
TGCGCCAGCAGCCAAGATCCGGGCCCTGACATAGGAAATCAGCCCCAGCATTTT	CASSQDPGPDIGNQPQHF	TRBV4-1	TRBJ1-5
TGTGCCAGTGAGGGGGGGCATGAGCAGTTCTTC	CASEGGHEQFF	TRBV19	TRBJ2-1
TGTGCCAACCCGGTGGCAGAGACCCAGTACTTC	CANPVAETQYF	TRBV6-4	TRBJ2-5
TGTGCCACCAGTGATTTCAGGGACAGGAGTGATCAGCCCCAGCATTTT	CATSDFRDRSDQPQHF	TRBV24-1	TRBJ1-5
TGTGCCAGCAGCCAAGAGGGCGCACAGGGGACCTACGAGCAGTACTTC	CASSQEGAQGTYEQYF	TRBV14	TRBJ2-7
TGTGCCAGCAGCATAATCCGGTGCAAAAACATTCAGTACTTC	CASSIIRCKNIQYF	TRBV13	TRBJ2-4
TGTGCCACCAAGCCACGGGGAGACACTGAAGCTTTCTTT	CATKPRGDTEAFF	TRBV24-1	TRBJ1-1
TGTGCCACCAGTGATAAGACAGGGCGATACGAGCAGTACTTC	CATSDKTGRYEQYF	TRBV24-1	TRBJ2-7
TGTGCCAGCAGCTTAGTTCAGGACAGGGATAAAGAGACCCAGTACTTC	CASSLVQDRDKETQYF	TRBV11-3	TRBJ2-5
TGTGCCAGCAGTAGCTTGGGGGGAGTGATAGGCAATGAGCAGTTCTTC	CASSSLGGVIGNEQFF	TRBV7-9	TRBJ2-1
TGTGCCAGCAGTTTCCCCTGGGCCCGGTGGCACTACGAGCAGTACTTC	CASSFPWARWHYEQYF	TRBV12-3	TRBJ2-7
TGTGCCAGCAGTTTACGAGCCGTCGACAGGGGCGCCTACGAGCAGTACTTC	CASSLRAVDRGAYEQYF	TRBV28	TRBJ2-7
TGCAGTGCTAGCGCCAGAGGGGGGGGTTTATACAATGAGCAGTTCTTC	CSASARGGGLYNEQFF	TRBV20-1	TRBJ2-1
TGCAGTGCAGGAGGACAGGGGGCGGCCCAGTACTTC	CSAGGQGAAQYF	TRBV20-1	TRBJ2-5
TGTGCATCCGGGACAGGGCCGGGGGTGCATTTT	CASGTGPGVHF	TRBV7-6	TRBJ1-5
TGCAGTGCTAGGAAGGGGCAGGACGAGCAGTACTTC	CSARKGQDEQYF	TRBV20-1	TRBJ2-7
TGTGCCAGTAGTCGACTGGGTAACATTCAGTACTTC	CASSRLGNIQYF	TRBV19	TRBJ2-4
TGCGCCAGCAGTTTTGGGGCCAAGAATCAGCCCCAGCATTTT	CASSFGAKNQPQHF	TRBV10-1	TRBJ1-5
TGTGCCAGCAGCTTAAGGGGGACCTGTCCATTTTGGAATGGCTACACCTTC	CASSLRGTCPFWNGYTF	TRBV7-3	TRBJ1-2
TGCGCCAGCAGCTTGCTCCGGGCCCGGTTGAACACTGAAGCTTTCTTT	CASSLLRARLNTEAFF	TRBV5-1	TRBJ1-1
TGTGCCAGTAGTATAAGCAGCAACTCTCGGGGGTTTCCTAATGAAAAACTGTTTTTT	CASSISSNSRGFPNEKLFF	TRBV19	TRBJ1-4
TGTGCCAGCAGCGGGACCCTACCCCTCAACTATGGCTACACCTTC	CASSGTLPLNYGYTF	TRBV5-6	TRBJ1-2
TGTGCCATCAGTGCGTGCGGGAGTCCTGGGGGCTACACCTTC	CAISACGSPGGYTF	TRBV10-3	TRBJ1-2
TGCAGTGCCCCGGGGCCACTAGCGGGAGGGCGTGCATACGAGCAGTACTTC	CSAPGPLAGGRAYEQYF	TRBV20-1	TRBJ2-7
TGCAGTCAAGATCGGGGAGGGGATACGCAGTATTTT	CSQDRGGDTQYF	TRBV20-1	TRBJ2-3
TGCAGTGGTAGGAGCGGGATGAGGCCCCAGCATTTT	CSGRSGMRPQHF	TRBV20-1	TRBJ1-5
TGTGCCAGCAGTTTACCAGGGGGGGGGCCCCAGCATTTT	CASSLPGGGPQHF	TRBV7-3	TRBJ1-5
TGTGCCAGCAGCGTAGGGCGGGGCGGCATAAATGAGCAGTTCTTC	CASSVGRGGINEQFF	TRBV9	TRBJ2-1
TGTGCCAGCAGTTTGAATGGAGGGGGGAATGAAAAACTGTTTTTT	CASSLNGGGNEKLFF	TRBV27	TRBJ1-4
TGTGCCAGCAGCTTACGGGGACTAGCTTCGCAGTTCTTC	CASSLRGLASQFF	TRBV7-9	TRBJ2-1
TGTGCCAGCAGCCAAGCCTTCGATAACCCCTCCTACGAGCAGTACTTC	CASSQAFDNPSYEQYF	TRBV4-2	TRBJ2-7
TGTGCCAAGAGACAAAATGAAGCTTTCTTT	CAKRQNEAFF	TRBV27	TRBJ1-1
TGTGCCAGCAGCCACCGACAGGGCCACCTTCCGTACTTC	CASSHRQGHLPYF	TRBV14	TRBJ2-5
TGTGCCATCGGACAGGTTGAGACCCAGTACTTC	CAIGQVETQYF	TRBV10-3	TRBJ2-5
TGTGCCAGTATAACCAATAGACAGGGCTACACCTTC	CASITNRQGYTF	TRBV5-6	TRBJ1-2
TGTGCCTGGAGTGCAGGGCGAACTTCGGACGAGCAGTACTTC	CAWSAGRTSDEQYF	TRBV30	TRBJ2-7
TGTGCCTGGTCGCGGGACGGAACTTGGGATAATGAAAAACTGTTTTTT	CAWSRDGTWDNEKLFF	TRBV30	TRBJ1-4
TGTGCCAGCAGTGAGTCAAGGATAGACCCTTCCCTGTGGGAAACTAGCGGGAGTCTATATGGCTACACCTTC	CASSESRIDPSLWETSGSLYGYTF	TRBV6-4	TRBJ1-2
TGCGCCAGCAGCTTGAAATCCACAGACCCTTCCGATGGCTACACCTTC	CASSLKSTDPSDGYTF	TRBV5-1	TRBJ1-2
TGTGCCAGCAGGCGGGGGCAGGGGGACGAGCAGTACTTC	CASRRGQGDEQYF	TRBV4-2	TRBJ2-7
TGCAGCGTCAGAAACTATAGCAATCAGCCCCAGCATTTT	CSVRNYSNQPQHF	TRBV29-1	TRBJ1-5
TGTGCCAGCAGTGACGGGCGGCAACCTGAAGCTTTCTTT	CASSDGRQPEAFF	TRBV6-1	TRBJ1-1
TGCGCCAGCAGCTCCGCAGGGCGTAGATCCTACGAGCAGTACTTC	CASSSAGRRSYEQYF	TRBV5-1	TRBJ2-7
TGTGCCAGCAGCTTTCGCGGGAGCACCGGGGAGCTGTTTTTT	CASSFRGSTGELFF	TRBV6-1	TRBJ2-2
TGTGCCAGCAGCAGGTCGGACAGGGAGAACTACAATGAGCAGTTCTTC	CASSRSDRENYNEQFF	TRBV7-3	TRBJ2-1
TGTGCCAGCAGCTTGTATACGAAATTCAGGGGAGGCGAGTCCACAGATACGCAGTATTTT	CASSLYTKFRGGESTDTQYF	TRBV5-4	TRBJ2-3
TGTGCCAGCAGCTTAGCGCCTTACATCCCATTCCTCAGCTCCTATAATTCACCCCTCCACTTT	CASSLAPYIPFLSSYNSPLHF	TRBV7-2	TRBJ1-6
TGTGCCACCAGTGATTTGGGACAGTTATCCTACAATGAGCAGTTCTTC	CATSDLGQLSYNEQFF	TRBV24-1	TRBJ2-1
TGTGCCAGCTTCCCTAGATCACACGAGCAGTACTTC	CASFPRSHEQYF	TRBV9	TRBJ2-7
TGTGCCAGCAGCTACCAGATTGGGGGCACCCCGAACACTGAAGCTTTCTTT	CASSYQIGGTPNTEAFF	TRBV11-3	TRBJ1-1
TGTGCCAGCAGCGTAGTTAGATTGAGGGACATTCTACAGCCCCAGCATTTT	CASSVVRLRDILQPQHF	TRBV9	TRBJ1-5
TGTGCCAGCAAACAGGGGTCCACTGAAGCTTTCTTT	CASKQGSTEAFF	TRBV6-5	TRBJ1-1
TGTGCCAGCTCACCACCGAGGGGACTAGCGGGATCTCGGTATGAGCAGTTCTTC	CASSPPRGLAGSRYEQFF	TRBV18	TRBJ2-1
TGTGCCAGCAGTGCCGGTGGGACAGGGAGATCACTAAGATCACCCCTCCACTTT	CASSAGGTGRSLRSPLHF	TRBV6-1	TRBJ1-6
TGTGCCAGCAGGTTAGGGGGAGGGGTAAATGAGCAGTTCTTC	CASRLGGGVNEQFF	TRBV5-6	TRBJ2-1
TGTGCCAGCAGCAGGCTCCCTCTCGGTCGACAAGAGACCCAGTACTTC	CASSRLPLGRQETQYF	TRBV5-5	TRBJ2-5
TGTGCCAGCAGGCCCCGGGACAGGGGGCCCCAGCATTTT	CASRPRDRGPQHF	TRBV7-9	TRBJ1-5
TGTGCCAGTAGTCCGGAGCCGTACGAGCAGTACTTC	CASSPEPYEQYF	TRBV19	TRBJ2-7
TGTGCCAGCAGGGAATCCCGGGACATTAATGAGCAGTTCTTC	CASRESRDINEQFF	TRBV6-5	TRBJ2-1
TGTGCCAGCAGCCTCCGAGACACTGAAGCTTTCTTT	CASSLRDTEAFF	TRBV13	TRBJ1-1
TGTGCCAGCAGCTCCCTCCCACTAGCAGATTATGAGCAGTTCTTC	CASSSLPLADYEQFF	TRBV7-6	TRBJ2-1
TGTGCCACCAGTGAACAGACTCGTCAGACCCAGTACTTC	CATSEQTRQTQYF	TRBV24-1	TRBJ2-5
TGTGCCAGCAGCTTGTGTTGGATTTCGGGTGGTCAGGGGGCGACCAACTATGGCTACACCTTC	CASSLCWISGGQGATNYGYTF	TRBV5-6	TRBJ1-2
TGTGCCAGCAGATGTGTTACTAGCGGGAGGGCACTCCAAGAGACCCAGTACTTC	CASRCVTSGRALQETQYF	TRBV5-4	TRBJ2-5
TGTGCCAGCAGCCGTCGGGACAGGGGCATGTCACCCCTCCACTTT	CASSRRDRGMSPLHF	TRBV5-6	TRBJ1-6
TGTGCCAGCAGCTTACGGGAGCGGGACATCCTGTTTTATCAGCCCCAGCATTTT	CASSLRERDILFYQPQHF	TRBV11-3	TRBJ1-5
TGTGCCAGATCGCAGGGATCCGGGGAGCTGTTTTTT	CARSQGSGELFF	TRBV28	TRBJ2-2
TGTGCCAGCAGTTCCGGGACAGGGGAAGGCAATCAGCCCCAGCATTTT	CASSSGTGEGNQPQHF	TRBV6-6	TRBJ1-5
TGTGCCAGCAGCGGGAGACAGGGGGGCTATAATTCACCCCTCCACTTT	CASSGRQGGYNSPLHF	TRBV7-9	TRBJ1-6
TGTGCCAGCAGTAAAGGGCCGGGACAGATCCCTAACTATGGCTACACCTTC	CASSKGPGQIPNYGYTF	TRBV12-4	TRBJ1-2
TGTGCCACTGGCTACACCTTC	CATGYTF	TRBV6-5	TRBJ1-2
TGCGCCAGCAGCTTGGAAACCAGGGGTCCGGCATCAACTAATGAAAAACTGTTTTTT	CASSLETRGPASTNEKLFF	TRBV5-1	TRBJ1-4
TGTGCCAGCAGGGGGACAGGGGGCATTAAGACTGCTGAGCAGTTCTTC	CASRGTGGIKTAEQFF	TRBV6-3	TRBJ2-1
TGTGCCAGTAGTATAAAAGGCAGGTTTCGCTCCTACAATGAGCAGTTCTTC	CASSIKGRFRSYNEQFF	TRBV19	TRBJ2-1
TGTGCCAGCTGGGCCGGGACTAGCGGGAATAGCAATCAGCCCCAGCATTTT	CASWAGTSGNSNQPQHF	TRBV12-3	TRBJ1-5
TGTGCCAGGAGAAGCCGAAAAATGGGACAGGAGCAGTACTTC	CARRSRKMGQEQYF	TRBV27	TRBJ2-7
TGTGCCAGCAGCTTAATACGACTAACCCAGTACTTC	CASSLIRLTQYF	TRBV7-4	TRBJ2-5
TGTGCCAGCAGCTTATTTCGGACAGGGGCGTGCACTGAAGCTTTCTTT	CASSLFRTGACTEAFF	TRBV7-2	TRBJ1-1
TGTGCCAGCAGCTTCCGAGCAAGGAGCTCTGGGGCCAACGTCCTGACTTTC	CASSFRARSSGANVLTF	TRBV7-7	TRBJ2-6
TGTGCCAGCAGCTTAGGACTTCCGGGACAGGGGGGAGGGGAGACCTACAATGAGCAGTTCTTC	CASSLGLPGQGGGETYNEQFF	TRBV7-6	TRBJ2-1
TGTGCCACGGTTTGGACGGACTCCTATAATTCACCCCTCCACTTT	CATVWTDSYNSPLHF	TRBV19	TRBJ1-6
TGTGCCAGCAGCTTGGGTGTAACAGGGGGTGCCGGGGAGCTGTTTTTT	CASSLGVTGGAGELFF	TRBV5-6	TRBJ2-2
TGCGCCAGCAGCCAAGATGTGGGGGGCGGCGGATATGAGCAGTTCTTC	CASSQDVGGGGYEQFF	TRBV4-1	TRBJ2-1
TGTGCCAGCAGCAGAGGGGGGGGGTGTGGACAGCCCCAGCATTTT	CASSRGGGCGQPQHF	TRBV6-6	TRBJ1-5
TGTGCCTGGAGCGGCTATGGCTACACCTTC	CAWSGYGYTF	TRBV30	TRBJ1-2
TGTGCCAGCAGCTGGGGGGCCCTTCCAGATACGCAGTATTTT	CASSWGALPDTQYF	TRBV13	TRBJ2-3
TGTGCCAGCAGGCCGGACGGGGTCAATGAGCAGTTCTTC	CASRPDGVNEQFF	TRBV6-6	TRBJ2-1
TGTGCCACCAGTGATTGGGGGGGCAGTCCCTCCTACAATGAGCAGTTCTTC	CATSDWGGSPSYNEQFF	TRBV24-1	TRBJ2-1
TGCGCCAGCAGCCAAGATCCGACAGGGAACCAAGAGACCCAGTACTTC	CASSQDPTGNQETQYF	TRBV4-1	TRBJ2-5
TGCGCCAGCAGGACGGGGGGTACCTACGAGCAGTACTTC	CASRTGGTYEQYF	TRBV10-1	TRBJ2-7
TGTGCCAGTAGTGTCGACCAACGCCTGGATACGCAGTATTTT	CASSVDQRLDTQYF	TRBV19	TRBJ2-3
TGTGCCAGCAGTGATCGGGACGGGGTTGAGCAGTTCTTC	CASSDRDGVEQFF	TRBV6-4	TRBJ2-1
TGTGCCAGCAGTCCCAGCGTGGGTCCATACAATGAGCAGTTCTTC	CASSPSVGPYNEQFF	TRBV5-5	TRBJ2-1
TGCGCCAGCAGCCAAGGAGGTGAGGAGACCCAGTACTTC	CASSQGGEETQYF	TRBV5-1	TRBJ2-5
TGTGCCAGCAGTTTAGACTGTCCCCGGGACAATCAGCCCCAGCATTTT	CASSLDCPRDNQPQHF	TRBV12-4	TRBJ1-5
TGTGCCAGCAGCGACGCCCAATGGGGTGGACAGACCCAGTACTTC	CASSDAQWGGQTQYF	TRBV13	TRBJ2-5
TGTGCCAGTGGGGAACAGGTCTCCTACAATGAGCAGTTCTTC	CASGEQVSYNEQFF	TRBV12-4	TRBJ2-1
TGTGCCAGCAGACTGGCGCCCGACCGCTCTAATGAAAAACTGTTTTTT	CASRLAPDRSNEKLFF	TRBV7-9	TRBJ1-4
TGTGCCAGCAGCTTAACCCCCCGGACTAGCGTCTCCTACAATGAGCAGTTCTTC	CASSLTPRTSVSYNEQFF	TRBV5-5	TRBJ2-1
TGCGCCAGCAGCCACGATACAATTCAGCCCCAGCATTTT	CASSHDTIQPQHF	TRBV4-1	TRBJ1-5
TGTGCCAGCAGCGAGGGAGTTCGGGACAGGGGACTTAACTATGGCTACACCTTC	CASSEGVRDRGLNYGYTF	TRBV9	TRBJ1-2
TGTGCCAGCAGCTTGCCGCCGGTCAGCTCCTACAATGAGCAGTTCTTC	CASSLPPVSSYNEQFF	TRBV5-6	TRBJ2-1
TGTGCCAGCAGCCCGGTAAGTTCCAAGGGTTCGCTGTTTTTT	CASSPVSSKGSLFF	TRBV13	TRBJ1-4
TGTGCCAGCAGTGCCGTCAATTATAAGACAGGGTTCGGGCTGTTTTTT	CASSAVNYKTGFGLFF	TRBV6-6	TRBJ1-4
TGTGCCAGCAGCCAAGGGCGTCCGTCCTACAATGAGCAGTTCTTC	CASSQGRPSYNEQFF	TRBV3-1	TRBJ2-1
TGTGCCAGCAGTGAACCAATATGTAAGAGTGGGTACGAGCAGTACTTC	CASSEPICKSGYEQYF	TRBV6-4	TRBJ2-7
TGTGCCAGCAGCTTATTCGGGGACAGGGGGATGCCCCAGCATTTT	CASSLFGDRGMPQHF	TRBV7-3	TRBJ1-5
TGTGCCAGCAGCGCGCACGTTCCCAAAAACATTCAGTACTTC	CASSAHVPKNIQYF	TRBV13	TRBJ2-4
TGTGCCAGCAGTTGCCGGGGGGCAGGACACAATGAGCAGTTCTTC	CASSCRGAGHNEQFF	TRBV28	TRBJ2-1
TGTGCCAGCAGCTTACCCCTAGCGGTTTACAATGAGCAGTTCTTC	CASSLPLAVYNEQFF	TRBV7-9	TRBJ2-1
TGCGCCAGCAGCCAAGCTCGACTAGCGGGGGGGGTCTACAATGAGCAGTTCTTC	CASSQARLAGGVYNEQFF	TRBV4-1	TRBJ2-1
TGTGCCAGCAGCGGCTGGACAGGGCAGCCCCAGCATTTT	CASSGWTGQPQHF	TRBV5-6	TRBJ1-5
TGTGCCAGCAGCGGAAAGCTAGTCTCGAACACCGGGGAGCTGTTTTTT	CASSGKLVSNTGELFF	TRBV9	TRBJ2-2
TGTGCCATGCAGGGCTCACGGCAAAACATTCAGTACTTC	CAMQGSRQNIQYF	TRBV6-3	TRBJ2-4
TGTGCCAGCATCTCGTGCAACGATACGCAGTATTTT	CASISCNDTQYF	TRBV27	TRBJ2-3
TGTGCCAGCAGTAAGACAGGGTTAGACAATCAGCCCCAGCATTTT	CASSKTGLDNQPQHF	TRBV6-2	TRBJ1-5
TGCGCCAGCAGCTTGACCTGCAGTTATGGCTACACCTTC	CASSLTCSYGYTF	TRBV5-1	TRBJ1-2
TGTGCCAGCAGTGCGTTTAACAAGTGGGTCCCTGGAAACACCATATATTTT	CASSAFNKWVPGNTIYF	TRBV6-4	TRBJ1-3
TGTGCCAGCAGCGTGGGACTAGAAGCTTTCCAGTACTTC	CASSVGLEAFQYF	TRBV9	TRBJ2-5
TGTGCCAGCAGCCGACATCTCAGGGGGCGCAAGGCGAGCTCACCCCTCCACTTT	CASSRHLRGRKASSPLHF	TRBV5-4	TRBJ1-6
TGTGCCAGCAGCCCTACTAGCGGGAGGGCCTACGAGCAGTACTTC	CASSPTSGRAYEQYF	TRBV6-4	TRBJ2-7
TGTGCCAGCAGCTTACTGGAAGACAGGTACTATGATGGCTACACCTTC	CASSLLEDRYYDGYTF	TRBV11-2	TRBJ1-2
TGTGCCAGCAGCTCCCTGCGGGAGTGGGGTGGGGCCAACGTCCTGACTTTC	CASSSLREWGGANVLTF	TRBV5-6	TRBJ2-6
TGTGCCAGCAGCTGGGGGTGCCCGCTCTGGAGGTATTTT	CASSWGCPLWRYF	TRBV7-8	TRBJ2-3
TGTGCCAGCTCTACGTCCAGGACAGGGGGGACAGATACGCAGTATTTT	CASSTSRTGGTDTQYF	TRBV27	TRBJ2-3
TGTGCCAGCAGTTCGGGGACAAGCTCCTTAAACGCAACTAATGAAAAACTGTTTTTT	CASSSGTSSLNATNEKLFF	TRBV6-2	TRBJ1-4
TGTGCCAGCACGCCTCGAAGTGGCACAGATACGCAGTATTTT	CASTPRSGTDTQYF	TRBV6-3	TRBJ2-3
TGTGCCACCAGTGCCTCCCAGGGGTCGGACAGGAAAGATGAGACCCAGTACTTC	CATSASQGSDRKDETQYF	TRBV24-1	TRBJ2-5
TGTGCCAGTACTCCAGACGAGAGAACCCCCTTGCCCCAGCATTTT	CASTPDERTPLPQHF	TRBV19	TRBJ1-5
TGTGCCACCAGTGATTTCTACCTGAGCTCCTACGAGCAGTACTTC	CATSDFYLSSYEQYF	TRBV24-1	TRBJ2-7
TGTGCCAGCAGAACCCCCTACCATAAAAACATTCAGTACTTC	CASRTPYHKNIQYF	TRBV7-4	TRBJ2-4
TGTGCCAGCAGTCCACAGGGGGGGGGGGTGAACACTGAAGCTTTCTTT	CASSPQGGGVNTEAFF	TRBV28	TRBJ1-1
TGTGCCAGCAGGGATGACAGGACTTATGGCTACACCTTC	CASRDDRTYGYTF	TRBV6-6	TRBJ1-2
TGTGCCAGCAGCCAAGACACGAAAGGGGCGAACACCGGGGAGCTGTTTTTT	CASSQDTKGANTGELFF	TRBV3-1	TRBJ2-2
TGTGCCAGCAGAATTCAAGGGAGGCCTAATTCACCCCTCCACTTT	CASRIQGRPNSPLHF	TRBV7-2	TRBJ1-6
TGTGCCACCAGTGGAGTGGGGGTTGTGGGACAGGGGAGGAACTATGGCTACACCTTC	CATSGVGVVGQGRNYGYTF	TRBV24-1	TRBJ1-2
TGTGCCACCAGCAGACTTCTGGCCACCGCTCCGGGACGCACAGATACGCAGTATTTT	CATSRLLATAPGRTDTQYF	TRBV15	TRBJ2-3
TGTGCCAGCAGCCCCCTTGGAGGACAGGGACGTCGAATCTTTGAGCAGTACTTC	CASSPLGGQGRRIFEQYF	TRBV7-3	TRBJ2-7
TGTGCCAGTAGTATGGGGGCACTAAACACCATATATTTT	CASSMGALNTIYF	TRBV19	TRBJ1-3
TGTGCCAGCAGACGAGAGGGGTACACTGAAGCTTTCTTT	CASRREGYTEAFF	TRBV14	TRBJ1-1
TGTGCCAGCAGCTTGCTCGGGCCCAGGAACAATTACAATGAGCAGTTCTTC	CASSLLGPRNNYNEQFF	TRBV7-9	TRBJ2-1
TGTGCCAGCAGCTTAGCAGGGATCTCTGGGGCCAACGTCCTGACTTTC	CASSLAGISGANVLTF	TRBV7-9	TRBJ2-6
TGCAGTGCTAGTATCCTGTATAGCAATCAGCCCCAGCATTTT	CSASILYSNQPQHF	TRBV20-1	TRBJ1-5
TGTGCCAGCAACGGAACTAGGGAGGATGAGCAGTTCTTC	CASNGTREDEQFF	TRBV6-1	TRBJ2-1
TGTGCCAGCAGTATGACAGGGGTCCATCAGCCCCAGCATTTT	CASSMTGVHQPQHF	TRBV7-3	TRBJ1-5
TGTGCCAGCCCTTCAGGGGGCGAAATCTTC	CASPSGGEIF	TRBV9	TRBJ2-1
TGTGCCTGGAGTGCGAGTAGACAGGGGGCCCACTATGGCTACACCTTC	CAWSASRQGAHYGYTF	TRBV30	TRBJ1-2
TGTGCCAGCAGTTTCCAAGCCCTTCGGGAGGACAATGAGCAGTTCTTC	CASSFQALREDNEQFF	TRBV28	TRBJ2-1
TGCAGTGCTAGAGAAGGAAAGGTCGAGGGACAAGGGGAAAAACTGTTTTTT	CSAREGKVEGQGEKLFF	TRBV20-1	TRBJ1-4
TGTGCCTGGCCTCGGGGCACGACGGGGGCCAACGTCCTGACTTTC	CAWPRGTTGANVLTF	TRBV30	TRBJ2-6
TGTGCCAGCGAATTGCGGTATTCACCCCTCCACTTT	CASELRYSPLHF	TRBV11-3	TRBJ1-6
TGTGCCAGCAGTCTCTCCAGGGGGCAGAAGGGGTTCTACGAGCAGTACTTC	CASSLSRGQKGFYEQYF	TRBV6-1	TRBJ2-7
TGTGCCAGCAAAGGGAGACAATGTTCAATATTCCAGTACTTC	CASKGRQCSIFQYF	TRBV27	TRBJ2-4
TGTGCCAGCAGTGATGTTAGACTAGCGGGGGCAGATACGCAGTATTTT	CASSDVRLAGADTQYF	TRBV6-4	TRBJ2-3
TGTGCCAGCAGTCCGGGACAGGGGGAGACAAAACTGTTTTTT	CASSPGQGETKLFF	TRBV9	TRBJ1-4
TGTGCCACCAGTGATTCGCCAAATACTTTCCGGGACCAAGAGACCCAGTACTTC	CATSDSPNTFRDQETQYF	TRBV24-1	TRBJ2-5
TGTGCTAGTGCAGGGACCGATCAGCCCCAGCATTTT	CASAGTDQPQHF	TRBV12-5	TRBJ1-5
TGTGCCACCAGGAACGGAGCGGGAGATGAAGCTTTCTTT	CATRNGAGDEAFF	TRBV24-1	TRBJ1-1
TGTGCCAGCATCGATCTTAGGAACACTGAAGCTTTCTTT	CASIDLRNTEAFF	TRBV6-2	TRBJ1-1
TGTGCCAGCAGTTACTCGACCGGGGGGGTAGACGAGCAGTACTTC	CASSYSTGGVDEQYF	TRBV6-5	TRBJ2-7
TGTGCCAGCAGCTTGCAAGGGACAGGGGAGGCAACTGAAGCTTTCTTT	CASSLQGTGEATEAFF	TRBV5-6	TRBJ1-1
TGTGCCACCAGCAACGCGTTCGGGGTCTATGGCTACACCTTC	CATSNAFGVYGYTF	TRBV15	TRBJ1-2
TGTGCCATCATCCGCGGGATCTTC	CAIIRGIF	TRBV10-3	TRBJ2-1
TGTGCCTGGAGTGTAGGTCCTGAGGACAGGGGCGCACAGCCCCAGCATTTT	CAWSVGPEDRGAQPQHF	TRBV30	TRBJ1-5
TGTGCCAGCAGTTTAGCCGGGACAGGGGGAGTTGGCTACACCTTC	CASSLAGTGGVGYTF	TRBV27	TRBJ1-2
TGTGCCATCTACTTTCCAAGCGGGCCATCCACTGAAGCTTTCTTT	CAIYFPSGPSTEAFF	TRBV6-5	TRBJ1-1
TGTGCCAGCAGCCGGGCGGATACGCAGTATTTT	CASSRADTQYF	TRBV14	TRBJ2-3
TGTGCCATCAGTGACAAGGGACTTCCAAGCACAGATACGCAGTATTTT	CAISDKGLPSTDTQYF	TRBV10-3	TRBJ2-3
TGTGCCAGCGCTGGGACTAGCGGGGAGACCCAGTACTTC	CASAGTSGETQYF	TRBV14	TRBJ2-5
TGTGCCAGCAGCTCCTCATTCGGGGACTCTGGAAACACCATATATTTT	CASSSSFGDSGNTIYF	TRBV7-3	TRBJ1-3
TGTGCCAGCAGCGGAAGTAGGGAGCAGCCCCAGCATTTT	CASSGSREQPQHF	TRBV3-1	TRBJ1-5
TGTGCCAGCAGCCTCGGGACTGAGCAGTACTTC	CASSLGTEQYF	TRBV7-8	TRBJ2-7
TGCAGTGCTAGGAGTTCCCGGGGAAGGGAGGACACCGGGGAGCTGTTTTTT	CSARSSRGREDTGELFF	TRBV20-1	TRBJ2-2
TGTGCCAGCAGTTTTCGGGGGAACCTTGGCTACACCTTC	CASSFRGNLGYTF	TRBV12-3	TRBJ1-2
TGTGCCAGCAGCCACAGGGCCAGGTCTAGCACAGATACGCAGTATTTT	CASSHRARSSTDTQYF	TRBV7-4	TRBJ2-3
TGTGCCAGCAGCTTACTCCCCTTCCGGGAGCATAATGAAAAACTGTTTTTT	CASSLLPFREHNEKLFF	TRBV7-9	TRBJ1-4
TGTGCCAGCAGCCCCACCTACGAGCAGTACTTC	CASSPTYEQYF	TRBV7-2	TRBJ2-7
TGTGCCAGCAGCCAAGAATACAGGGCCGACACTGAAGCTTTCTTT	CASSQEYRADTEAFF	TRBV4-2	TRBJ1-1
TGTGCCAGCAGTTGGAAGACTAGAACCCGGCACGAGCAGTACTTC	CASSWKTRTRHEQYF	TRBV6-9	TRBJ2-7
TGTGCCAGCTCGAGTCGTCCACGGGACAGGGGCTACTATGGCTACACCTTC	CASSSRPRDRGYYGYTF	TRBV5-8	TRBJ1-2
TGCAGTGCTCGGCCAGTTACCCCCGGCGCGGTTGCCTACGAGCAGTACTTC	CSARPVTPGAVAYEQYF	TRBV20-1	TRBJ2-7
TGTGCCAGCAGCTCAACAGGGGTTGCCAAAAACATTCAGTACTTC	CASSSTGVAKNIQYF	TRBV7-9	TRBJ2-4
TGTGCCAGCAGCTTAGATCAGGGGGTTTTGGCCTACGAGCAGTACTTC	CASSLDQGVLAYEQYF	TRBV11-3	TRBJ2-7
TGTGCCAGCAGCGCGGGGGCGAACACCATATATTTT	CASSAGANTIYF	TRBV7-8	TRBJ1-3
TGTGCATCACACCCGCCCAATCAGCCCCAGCATTTT	CASHPPNQPQHF	TRBV7-6	TRBJ1-5
TGCAGCGTTGAAGGCGCGAGCCGTGGCTACAATGAGCAGTTCTTC	CSVEGASRGYNEQFF	TRBV29-1	TRBJ2-1
TGTGCCAGCTTGGGTCAGGGCAATACCTGTTTACCCCTCCACTTT	CASLGQGNTCLPLHF	TRBV25-1	TRBJ1-6
TGTGCCAGCAGCAAAGAGGGGTTTGCAGATACGCAGTATTTT	CASSKEGFADTQYF	TRBV6-1	TRBJ2-3
TGCGCCAGCAGTGATAATTTAGCGGGCTATTATGAGACCCAGTACTTC	CASSDNLAGYYETQYF	TRBV10-1	TRBJ2-5
TGTGCCAGCAGTTACAGGGCAGGGGAAGCTTCCTCCTACGAGCAGTACTTC	CASSYRAGEASSYEQYF	TRBV6-5	TRBJ2-7
TGTGCCACCAGTGCACAAGCGGAAGAGGGCTACACCTTC	CATSAQAEEGYTF	TRBV24-1	TRBJ1-2
TGTGCCAGCAGCTGGAGAGCCGCAACAGATACGCAGTATTTT	CASSWRAATDTQYF	TRBV5-4	TRBJ2-3
TGTGCCACTTCGGGGGGCGATGGCTCTAGCACAGATACGCAGTATTTT	CATSGGDGSSTDTQYF	TRBV19	TRBJ2-3
TGTGCCAGTAGTATGGCCGTAAATGGCTGCAATCAGCCCCAGCATTTT	CASSMAVNGCNQPQHF	TRBV19	TRBJ1-5
TGTGCCAGCAGCCACTACTCGACAGGGGGGTTCGGCAGCTCCTACAATGAGCAGTTCTTC	CASSHYSTGGFGSSYNEQFF	TRBV7-3	TRBJ2-1
TGTGCCAGCAGCGGTCCACCCCCAGCAATTTTATATGGCTACACCTTC	CASSGPPPAILYGYTF	TRBV11-2	TRBJ1-2
TGTGCCAGCTCATCACCAGCGGGGACGAACACTGAAGCTTTCTTT	CASSSPAGTNTEAFF	TRBV18	TRBJ1-1
TGCAGTGCTAGAGATCAGCCGGGACTAGCGGGAGATGTCTCTGGGGCCAACGTCCTGACTTTC	CSARDQPGLAGDVSGANVLTF	TRBV20-1	TRBJ2-6
TGTGCTAGTGGACTGACAGGGGGGCCCTACGAGCAGTACTTC	CASGLTGGPYEQYF	TRBV12-5	TRBJ2-7
TGTGCCAGCATGGGGAATCAGCCCCAGCATTTT	CASMGNQPQHF	TRBV6-4	TRBJ1-5
TGTGCCAGCAGCTTTCTGGACAGGGGGGGCCGGAAGTACTTC	CASSFLDRGGRKYF	TRBV11-3	TRBJ2-7
TGTGCCAGCAGCCCGAGGACAGGGCAGTGCAATCAGCCCCAGCATTTT	CASSPRTGQCNQPQHF	TRBV13	TRBJ1-5
TGTGCCAGCAGTTCCGGGGGACTAGCGGGAGGGAGGGGCACAGATACGCAGTATTTT	CASSSGGLAGGRGTDTQYF	TRBV12-3	TRBJ2-3
TGCGCCAGCAGCCAAGCGGCGCGATTAGGGGCTACCGAGCAGTACTTC	CASSQAARLGATEQYF	TRBV4-3	TRBJ2-7
TGTGCCTGGAGTGTACGCCGGGACTATGAAAAACTGTTTTTT	CAWSVRRDYEKLFF	TRBV30	TRBJ1-4
TGTGCCAGCACCCAGACAAGGGGGGGAGGCTACACCTTC	CASTQTRGGGYTF	TRBV9	TRBJ1-2
TGCAGTGCTAGAGAGGGCGAGAGGAACAGAACACCCACAGATACGCAGTATTTT	CSAREGERNRTPTDTQYF	TRBV20-1	TRBJ2-3
TGTGCCAGCAGGGAAAGACAGGGGGCGCGGCTTCCGGAAGAGACCCAGTACTTC	CASRERQGARLPEETQYF	TRBV7-3	TRBJ2-5
TGTGCCACCAGCGAAAGGGTGGATGAGCAGTTCTTC	CATSERVDEQFF	TRBV15	TRBJ2-1
TGCAGTGCTAGAGATCTCCAGGGGTTCACTGAAGCTTTCTTT	CSARDLQGFTEAFF	TRBV20-1	TRBJ1-1
TGTGCCAGCAGCCCTACGGGAAACACCATATATTTT	CASSPTGNTIYF	TRBV7-9	TRBJ1-3
TGTGCCCGACAGGGGGGCGGTGCAACTAATGAAAAACTGTTTTTT	CARQGGGATNEKLFF	TRBV28	TRBJ1-4
TGTGCCAGCAGGAGTCTGGAGGGGGTTTCTTGCTCCTACAATGAGCAGTTCTTC	CASRSLEGVSCSYNEQFF	TRBV6-4	TRBJ2-1
TGTGCCAGCAGTGAGGGTCGGGGCCTCTATGGCTACACCTTC	CASSEGRGLYGYTF	TRBV5-4	TRBJ1-2
TGCAGCGTCGCCAGGGAAGGGAACCGCTGGCAGAATCAGCCCCAGCATTTT	CSVAREGNRWQNQPQHF	TRBV29-1	TRBJ1-5
TGCGCCAGCAGCCTCGACGGGTTTGAAATTTGGGACCTCTACGAGCAGTACTTC	CASSLDGFEIWDLYEQYF	TRBV4-1	TRBJ2-7
TGCGCCAGCAGGGACAGGGGGTGGCTTGAAAAACTGTTTTTT	CASRDRGWLEKLFF	TRBV10-1	TRBJ1-4
TGCGCCAGCAGTGAATCCCCGGGACTAGCGGGCACCGGGGAGCTGTTTTTT	CASSESPGLAGTGELFF	TRBV10-1	TRBJ2-2
TGTGCCAGCCTAGAGGATGCCCCCCAGCATTTT	CASLEDAPQHF	TRBV28	TRBJ1-5
TGTGCCAGCAGCCCAGGGACAGCCTACGAGCAGTACTTC	CASSPGTAYEQYF	TRBV13	TRBJ2-7
TGTGCCAGCAACAGGGGGTATCAGCCCCAGCATTTT	CASNRGYQPQHF	TRBV6-4	TRBJ1-5
TGTGCCAGTCTAGGAGGGGACAGTACAGATACGCAGTATTTT	CASLGGDSTDTQYF	TRBV19	TRBJ2-3
TGCGCCAGCAGCCAAGACGAGAGCCATAGCAATCAGCCCCAGCATTTT	CASSQDESHSNQPQHF	TRBV4-1	TRBJ1-5
TGTGCCACCCCAGTGAGCTCCTATAATTCACCCCTCCACTTT	CATPVSSYNSPLHF	TRBV11-3	TRBJ1-6
TGTGCCAGCAGTCGAGGACAGTCAGATACGCAGTATTTT	CASSRGQSDTQYF	TRBV27	TRBJ2-3
TGCGCCAGCAGCCACAGGGGTAGCAATCAGCCCCAGCATTTT	CASSHRGSNQPQHF	TRBV4-1	TRBJ1-5
TGTGCCAGCAGCTTTGGAAGGCGGTTCTCTGGAAACACCATATATTTT	CASSFGRRFSGNTIYF	TRBV7-8	TRBJ1-3
TGTGCCAGCAGAGCGGGAGTTGCCCGCACAGATACGCAGTATTTT	CASRAGVARTDTQYF	TRBV11-3	TRBJ2-3
TGCGCCAGCAGCTTAGGTGACAGCGATTCCTATAATTCACCCCTCCACTTT	CASSLGDSDSYNSPLHF	TRBV5-1	TRBJ1-6
TGCAGTGCTACGCCGGGCCCGAGAACGAACACCGGGGAGCTGTTTTTT	CSATPGPRTNTGELFF	TRBV20-1	TRBJ2-2
TGCGCCAGCAGGCCGCTGAGAGACAGGACCCAGTACTTC	CASRPLRDRTQYF	TRBV5-1	TRBJ2-5
TGTGCCAGCAGTGACCAGCCCCAGCATTTT	CASSDQPQHF	TRBV27	TRBJ1-5
TGTGCCAGCAGCGGCCTTTGGGACAGGGGGCACCCTGAAGCTTTCTTT	CASSGLWDRGHPEAFF	TRBV11-3	TRBJ1-1
TGTGCCAGCAGCCAAGCCGCCCCACCGGGCGGGAGGGTGGGCACCGGGGAGCTGTTTTTT	CASSQAAPPGGRVGTGELFF	TRBV4-2	TRBJ2-2
TGTGCCAGTTCCCGTGACGCCCGGAACACCGGGGAGCTGTTTTTT	CASSRDARNTGELFF	TRBV19	TRBJ2-2
TGTGCCATCAGTGTTGGACAAGGATACCAAGAGACCCAGTACTTC	CAISVGQGYQETQYF	TRBV10-3	TRBJ2-5
TGTGCCAGCATAGGGGGCACTTTTCTGTTTTTT	CASIGGTFLFF	TRBV7-6	TRBJ1-4
TGTGCCAGCAGCTTAGCCAAGGTTACTACAGTACATCGGGCCTACGAGCAGTACTTC	CASSLAKVTTVHRAYEQYF	TRBV11-2	TRBJ2-7
TGTGCCAGCGGGGTCCATGGGGTCGACTATGGCTACACCTTC	CASGVHGVDYGYTF	TRBV14	TRBJ1-2
TGTGCCAGCGCCTCGGGCCAGCACACCGGGGAGCTGTTTTTT	CASASGQHTGELFF	TRBV6-5	TRBJ2-2
TGTGCCAGCACCTTCAAGGGTGATCCCGGGGAGCTGTTTTTT	CASTFKGDPGELFF	TRBV25-1	TRBJ2-2
TGTGCCAGCAGTCAGGGGAGGGGAATGGAGAACACTGAAGCTTTCTTT	CASSQGRGMENTEAFF	TRBV6-6	TRBJ1-1
TGTGCCAGCAGCAAACAACCGGGACAGGGGGGTGAAAAACTGTTTTTT	CASSKQPGQGGEKLFF	TRBV7-4	TRBJ1-4
TGCGCCAGCAGAAATCGTATGACAGGGCCGCTGGTTAATGAAAAACTGTTTTTT	CASRNRMTGPLVNEKLFF	TRBV10-1	TRBJ1-4
TGTGCCAGCAAACCTAAGACTAGCGGGAGTCTAAATAAACCCACTGGAAACACCATATATTTT	CASKPKTSGSLNKPTGNTIYF	TRBV28	TRBJ1-3
TGTGCCAGCAGTTTGGGACAGGGAGGTAGCAATCAGCCCCAGCATTTT	CASSLGQGGSNQPQHF	TRBV27	TRBJ1-5
TGTGCCAGCATGGGAGAAAGCGGGAGGCAGGTCTCTGAAGCTTTCTTT	CASMGESGRQVSEAFF	TRBV2	TRBJ1-1
TGTGCCTGGAGTGTACAGGGGGAGACCCAGTACTTC	CAWSVQGETQYF	TRBV30	TRBJ2-5
TGTGCCAGCAGCGTTTCCCCTATAGCCGGGACTTGCGAGCAGTACTTC	CASSVSPIAGTCEQYF	TRBV7-4	TRBJ2-7
TGTGCCAGCAGGGGTGTCCCCCGGGACGGCAATCAGCCCCAGCATTTT	CASRGVPRDGNQPQHF	TRBV2	TRBJ1-5
TGCAGTGCTAGGGGAGGAGCAGACAATCAGCCCCAGCATTTT	CSARGGADNQPQHF	TRBV20-1	TRBJ1-5
TGCAGTGCTAGACCTTCATCCATGAACACTGAAGCTTTCTTT	CSARPSSMNTEAFF	TRBV20-1	TRBJ1-1
TGTGCCAGCAGTTACCTCTCTGGACAGAGGGACGTCTACGAGCAGTACTTC	CASSYLSGQRDVYEQYF	TRBV6-5	TRBJ2-7
TGTGCCAGCAGTTATCGACGGACAGACCAGCCCCAGCATTTT	CASSYRRTDQPQHF	TRBV6-2	TRBJ1-5
TGCGCCAGCGGGATGAATAGCGAGTCCCCTCACTACGAGCAGTACTTC	CASGMNSESPHYEQYF	TRBV10-1	TRBJ2-7
TGTGCCAGCAGCCAAGGCCGGGTAGTTTCCTCCGGGCTTCAGACCCAGTACTTC	CASSQGRVVSSGLQTQYF	TRBV14	TRBJ2-5
TGTGCCTTGGGGGACAGGGCATCCCGTCAGAATTCACCCCTCCACTTT	CALGDRASRQNSPLHF	TRBV6-5	TRBJ1-6
TGTGCCAGCAGTTTATGTCTAGAGTACATGAACACTGAAGCTTTCTTT	CASSLCLEYMNTEAFF	TRBV28	TRBJ1-1
TGTGCCAGAGAGGACGGACAAACTAACTATGGCTACACCTTC	CAREDGQTNYGYTF	TRBV19	TRBJ1-2
TGTGCCAGCTCACACACTGAAGGAGGCGGTGATCAGCCCCAGCATTTT	CASSHTEGGGDQPQHF	TRBV18	TRBJ1-5
TGTGCCAGCAGCAGTTATTGGGACAGGGAAGGAAGTCAGCCCCAGCATTTT	CASSSYWDREGSQPQHF	TRBV13	TRBJ1-5
TGCAGTGCGTTAGTACCAAGGGAGGGGGGGTACGAGCAGTACTTC	CSALVPREGGYEQYF	TRBV20-1	TRBJ2-7
TGCAGTGCTCCCACTAAGGGACTCCACTATGGCTACACCTTC	CSAPTKGLHYGYTF	TRBV20-1	TRBJ1-2
TGTGCCAGCAGAGTTGCCAAAAACATTCAGTACTTC	CASRVAKNIQYF	TRBV6-2	TRBJ2-4
TGTGCCAGCAGTTTCCCGACAGGGACGCCGAGGTGGTTAACCGGGGAGCTGTTTTTT	CASSFPTGTPRWLTGELFF	TRBV27	TRBJ2-2
TGTGCCAGCAGCTATGGGGGGGGAGGATACGAGCAGTACTTC	CASSYGGGGYEQYF	TRBV11-3	TRBJ2-7
TGTGCCAGCAGCGAGCGACAGGGGGTGCCAGACTCCTACAATGAGCAGTTCTTC	CASSERQGVPDSYNEQFF	TRBV13	TRBJ2-1
TGCGCCAGCAGCTCAGCTAGCGGGGGGGCCTACGAGCAGTACTTC	CASSSASGGAYEQYF	TRBV5-1	TRBJ2-7
TGTGCCAGCAGCTTAGCGGACAGGCACGAGCAGTACTTC	CASSLADRHEQYF	TRBV11-2	TRBJ2-7
