TGTGCCAGCAGCTTAGAAACGAAGACAGGGGAAAATAGCAATCAGCCCCAGCATTTT	CASSLETKTGENSNQPQHF	TRBV7-2	TRBJ1-5
TGTGCCACCAGTGGGGGGAAAGGGGGCCAAGAGACCCAGTACTTC	CATSGGKGGQETQYF	TRBV24-1	TRBJ2-5
TGTGCCATCATTGGCCCCAGGGGAAACTACGAGCAGTACTTC	CAIIGPRGNYEQYF	TRBV10-3	TRBJ2-7
TGTGCCAGCAGTCCCTTAAGGGAATCCTACGAGCAGTACTTC	CASSPLRESYEQYF	TRBV6-1	TRBJ2-7
TGTGCCACCAGTGATCCGGATACGCAGTATTTT	CATSDPDTQYF	TRBV24-1	TRBJ2-3
TGTGCCAGTAGTCGAAGCACTAGAACCAGCTCTGGGGCCAACGTCCTGACTTTC	CASSRSTRTSSGANVLTF	TRBV19	TRBJ2-6
TGCAGTGCTAGAGAGGCTATGCCCCGAGGCTACGAGCAGTACTTC	CSAREAMPRGYEQYF	TRBV20-1	TRBJ2-7
TGTGCCAGCGGGACTAGCGGTGGATGGTTAGCCAAAAACATTCAGTACTTC	CASGTSGGWLAKNIQYF	TRBV14	TRBJ2-4
TGCGCCAGCAGCCGCGACAGGGGTGGGCCCCAGCATTTT	CASSRDRGGPQHF	TRBV4-1	TRBJ1-5
TGCAGTGCTAGGCCCCGTACCTCTTCACCCCTCCACTTT	CSARPRTSSPLHF	TRBV20-1	TRBJ1-6
TGTGCCAGCAGAGAAGCGGGAACCGGGGAGCTGTTTTTT	CASREAGTGELFF	TRBV28	TRBJ2-2
TGTGCCAGCGCGACGTTGGACTACGAGCAGTACTTC	CASATLDYEQYF	TRBV11-2	TRBJ2-7
TGTGCCAGCAGCCTCCGCCGGGGGAGGGCGGCCCGAGGAGCAGATACGCAGTATTTT	CASSLRRGRAARGADTQYF	TRBV14	TRBJ2-3
TGTGCCACCAGTGATTCAGCAGGGTTTGACTACGAGCAGTACTTC	CATSDSAGFDYEQYF	TRBV24-1	TRBJ2-7
TGTGCCACCAACCCGGGACCTGGACGAAAACCATCCTACAATGAGCAGTTCTTC	CATNPGPGRKPSYNEQFF	TRBV24-1	TRBJ2-1
TGTGCCAGCAGCCAAGAGAAATGGGGGGATGAGCAGTTCTTC	CASSQEKWGDEQFF	TRBV3-1	TRBJ2-1
TGTGCCAGCAGCTGGCCCTTTCAAACATATGGTAGCAATCAGCCCCAGCATTTT	CASSWPFQTYGSNQPQHF	TRBV5-4	TRBJ1-5
TGCAGTGCCCAACAGGGCCGGACCGACACTGAAGCTTTCTTT	CSAQQGRTDTEAFF	TRBV20-1	TRBJ1-1
TGTGCCAGTATCGCCGGGGGGAATCAGCCCCAGCATTTT	CASIAGGNQPQHF	TRBV19	TRBJ1-5
TGTGCCACCAGTGAAACTGGCGGGACTAGGAGGGAGACCCAGTACTTC	CATSETGGTRRETQYF	TRBV24-1	TRBJ2-5
TGTGCCAGCAGAATTACCCCCGAGCCAAAAGGGGGCACAGATACGCAGTATTTT	CASRITPEPKGGTDTQYF	TRBV6-3	TRBJ2-3
TGTGCCACCAAGGGGTTCACCGGGGAGCTGTTTTTT	CATKGFTGELFF	TRBV24-1	TRBJ2-2
TGCAGTGCTAGAGCAGGGGGGGGCTACGAGCAGTACTTC	CSARAGGGYEQYF	TRBV20-1	TRBJ2-7
TGCAGTGCTACCGGCGGGGAGAATGAGCAGTTCTTC	CSATGGENEQFF	TRBV20-1	TRBJ2-1
TGTGCCAGCAGCCGGGACAGACGAAGGATGAACACTGAAGCTTTCTTT	CASSRDRRRMNTEAFF	TRBV11-2	TRBJ1-1
TGTGCCAGCAGCCAAGGTCAGCGGGAGAGCACAGATACGCAGTATTTT	CASSQGQRESTDTQYF	TRBV14	TRBJ2-3
TGTGCCAGCAGTGAAGCGGGGGGACTAGCGGGGGGGACAGAGACCCAGTACTTC	CASSEAGGLAGGTETQYF	TRBV6-1	TRBJ2-5
TGTGCCAGCAGCCGCGGGCGGGATGAGAACAATGAGCAGTTCTTC	CASSRGRDENNEQFF	TRBV7-9	TRBJ2-1
TGTGCCAGCAACGGCGCTGACGAGCAGTACTTC	CASNGADEQYF	TRBV27	TRBJ2-7
TGTGCCAGCAGTTTAGGAGAACGTCCGAACGGGGCCGGGGAGCTGTTTTTT	CASSLGERPNGAGELFF	TRBV28	TRBJ2-2
TGTGCCAGCAGTTACTCGACGCGTGGGGCCGGGGCCACCTATGGCTACACCTTC	CASSYSTRGAGATYGYTF	TRBV6-5	TRBJ1-2
TGTGCCAGCAGCTTAACACATAGGGACGAGCAGTACTTC	CASSLTHRDEQYF	TRBV7-9	TRBJ2-7
TGTGCCAGCAGCACCCCGGGGGACCGCGCGTATCAGCCCCAGCATTTT	CASSTPGDRAYQPQHF	TRBV9	TRBJ1-5
TGTGCCAGCAGTTACTCGACTCCGGGGGGAGCCGCCTTTACAGATACGCAGTATTTT	CASSYSTPGGAAFTDTQYF	TRBV6-5	TRBJ2-3
TGTGCCACCAGTGATTTCGCAGTGGGCACTGAAGCTTTCTTT	CATSDFAVGTEAFF	TRBV24-1	TRBJ1-1
TGCGCCAGCAGCTCTAAGGACTGTAATGAAAAACTGTTTTTT	CASSSKDCNEKLFF	TRBV5-1	TRBJ1-4
TGTGCCAGCAGTTCTTTCCAGGGGAGGTATGGCTACACCTTC	CASSSFQGRYGYTF	TRBV7-3	TRBJ1-2
TGTGCCAGCAGCCGGGGTGCCAAAAACATTCAGTACTTC	CASSRGAKNIQYF	TRBV7-2	TRBJ2-4
TGCAGTGCTAGTTTATTCGGACATGGCTACACCTTC	CSASLFGHGYTF	TRBV20-1	TRBJ1-2
TGTGCCAGCAGGGGCGGACCGCCCTACGAGCAGTACTTC	CASRGGPPYEQYF	TRBV27	TRBJ2-7
TGTGCCATCAGGATAAGGACGCGCGAGCAGTACTTC	CAIRIRTREQYF	TRBV10-3	TRBJ2-7
TGTGCCAGCAGTTATAGGAGAAACCAAGAGACCCAGTACTTC	CASSYRRNQETQYF	TRBV6-5	TRBJ2-5
TGTGCCAGCAGTAAAAAGGACGGGGGTAGGGCCTACGAGCAGTACTTC	CASSKKDGGRAYEQYF	TRBV6-2	TRBJ2-7
TGTGCCATCAGTGAGTCAGAGGGGCGAAATCAGCCCCAGCATTTT	CAISESEGRNQPQHF	TRBV10-3	TRBJ1-5
TGTGCCAGCAGTTTCTCCAGGTCTCATTGGTCTGCTAGCACAGATACGCAGTATTTT	CASSFSRSHWSASTDTQYF	TRBV27	TRBJ2-3
TGTGCCAGCAGCCGGAAAGGGTGCAATCAGCCCCAGCATTTT	CASSRKGCNQPQHF	TRBV9	TRBJ1-5
TGTGCCAGCAGTGGGGGGGGAGGGCTTTGGACCCAGTACTTC	CASSGGGGLWTQYF	TRBV6-1	TRBJ2-5
TGTGCCAGTAGTATAGAGCAAAGGCCTGGGGGGGCTAACACCGGGGAGCTGTTTTTT	CASSIEQRPGGANTGELFF	TRBV19	TRBJ2-2
TGTGCCAGCAGTGGACGACCCTACGAGCAGTACTTC	CASSGRPYEQYF	TRBV6-3	TRBJ2-7
TGTGCCAGCAGCCAAGTTCGACAGGGCTCTGGGGCCAACGTCCTGACTTTC	CASSQVRQGSGANVLTF	TRBV14	TRBJ2-6
TGCAGTGCTAGAGATAACCGCAATCAGCCCCAGCATTTT	CSARDNRNQPQHF	TRBV20-1	TRBJ1-5
TGTGCCAGCAGTAAATACTCCGGGGAAAACGAGCAGTACTTC	CASSKYSGENEQYF	TRBV6-2	TRBJ2-7
TGCGCCAGCAGCGGGACGGGGGGCTTC	CASSGTGGF	TRBV5-1	TRBJ2-5
TGTGCCAACCGGGGGTACGAAGAGACCCAGTACTTC	CANRGYEETQYF	TRBV6-5	TRBJ2-5
TGTGCCAGCAGCACGACAGGTTTCGGCTCTGGAAACACCATATATTTT	CASSTTGFGSGNTIYF	TRBV27	TRBJ1-3
TGTGCCAGCAGCTTAAAAAAAGGAGATAATCGCACAGATACGCAGTATTTT	CASSLKKGDNRTDTQYF	TRBV7-3	TRBJ2-3
TGTGCCAGCAGTTTATCATTTGCCTACGAGCAGTACTTC	CASSLSFAYEQYF	TRBV27	TRBJ2-7
TGCGCCAGCACAAGGGGCACAACCTACGAGCAGTACTTC	CASTRGTTYEQYF	TRBV10-1	TRBJ2-7
TGTGCCAGCAGCGAAGAGATGAACAATGAGCAGTTCTTC	CASSEEMNNEQFF	TRBV5-4	TRBJ2-1
TGTGCCAGCAGCGCCCCCTTGGGGGCTGTGGGCTCCTACAATGAGCAGTTCTTC	CASSAPLGAVGSYNEQFF	TRBV13	TRBJ2-1
TGTGCCAGCAGACCCCGCAGGGCCGTGTATGTTACCGGGGAGCTGTTTTTT	CASRPRRAVYVTGELFF	TRBV6-5	TRBJ2-2
TGTGCCACCCCTTGGCGGGAGGGCCCTTTTACTGAAAAACTGTTTTTT	CATPWREGPFTEKLFF	TRBV6-5	TRBJ1-4
TGCAGCGTTGGCCCGACTCGGGACCTCTTC	CSVGPTRDLF	TRBV29-1	TRBJ2-1
TGTGCCAGCAGTTTATACTTTACTAGCGGGAGATCCTACGAGCAGTACTTC	CASSLYFTSGRSYEQYF	TRBV28	TRBJ2-7
TGTGCCAGCAGAGCCCTGCCGGGACAGAGGGCCTACGAGCAGTACTTC	CASRALPGQRAYEQYF	TRBV7-9	TRBJ2-7
TGTGCCACCAGCAGGGGGACTAGCGGGTGGCAGAGCACAGATACGCAGTATTTT	CATSRGTSGWQSTDTQYF	TRBV15	TRBJ2-3
TGTGCCAGTATTTGGGTTGGCGAGCAGTACTTC	CASIWVGEQYF	TRBV19	TRBJ2-7
TGTGCCAGCAGCCAAGGTGTCCGGGGGGTGGCTTTCTTT	CASSQGVRGVAFF	TRBV4-2	TRBJ1-1
TGTGCCACCAGTGATTACTGGGTCGCCCAGGGGGCTGAGCAGTACTTC	CATSDYWVAQGAEQYF	TRBV24-1	TRBJ2-7
TGTGCCACCAGTGACATAGAGTCCCTGCCGGGACAGGGCATGAACACCGGGGAGCTGTTTTTT	CATSDIESLPGQGMNTGELFF	TRBV24-1	TRBJ2-2
TGTGCCAGCAGCTTGGGGAGGACAGGGAATGCCTATGGCTACACCTTC	CASSLGRTGNAYGYTF	TRBV5-4	TRBJ1-2
TGTGCCAGCAGCGGACAGGTAACTGGAAACACCATATATTTT	CASSGQVTGNTIYF	TRBV9	TRBJ1-3
TGTGCGGGAATTCCGGGACAAGAGCCCCAGCATTTT	CAGIPGQEPQHF	TRBV12-3	TRBJ1-5
TGTGCCAGCCCCGCCGTGTACCGGGGGGCCTACGAGCAGTACTTC	CASPAVYRGAYEQYF	TRBV2	TRBJ2-7
TGTGCCAGCAGAGCCTTGACAGGCTACACTGAAGCTTTCTTT	CASRALTGYTEAFF	TRBV6-4	TRBJ1-1
TGCGCCAGACAGGGGTCCATGAACACTGAAGCTTTCTTT	CARQGSMNTEAFF	TRBV5-1	TRBJ1-1
TGTGCCAGCAGACTAAGGGACAGGAGAAACACCATATATTTT	CASRLRDRRNTIYF	TRBV12-3	TRBJ1-3
TGCGCCAGCAGCACCCCTCACCTCCCGCGGGAGAGCACAGATACGCAGTATTTT	CASSTPHLPRESTDTQYF	TRBV5-1	TRBJ2-3
TGTGCCAGTAGTATATCTGGGACAGGGCATGAGGGTTGCTCCTACGAGCAGTACTTC	CASSISGTGHEGCSYEQYF	TRBV19	TRBJ2-7
TGTGCCAGCAGCTTAGCTCGGAAAAGGACAGAAGGCACGAAATGCAATCAGCCCCAGCATTTT	CASSLARKRTEGTKCNQPQHF	TRBV7-4	TRBJ1-5
TGTGCCAGCAGCTTAGCCGGACAGGGAGGAATAGAGACCCAGTACTTC	CASSLAGQGGIETQYF	TRBV7-9	TRBJ2-5
TGTGCCAGCAGTTTACGTAAAGGAACCGTACCGGAGCGTAATGAGCAGTTCTTC	CASSLRKGTVPERNEQFF	TRBV27	TRBJ2-1
TGCGCCAGCAGTGAACAAAAAAAGTGGGCATCATGGGAGGTTCCTAGCAATCAGCCCCAGCATTTT	CASSEQKKWASWEVPSNQPQHF	TRBV10-1	TRBJ1-5
TGCGCCAGCAGCCAAGACTCGAACCATTCCAGAGGGGTTTCTGGAAACACCATATATTTT	CASSQDSNHSRGVSGNTIYF	TRBV4-1	TRBJ1-3
TGTGCCAGCCGCAGGGCCCCTAATGAAAAACTGTTTTTT	CASRRAPNEKLFF	TRBV9	TRBJ1-4
TGTGCCACCAGTGATTTCGTGGGACAGGGTTCTCGTGCAACTAATGAAAAACTGTTTTTT	CATSDFVGQGSRATNEKLFF	TRBV24-1	TRBJ1-4
TGCGCCAGCAGTGCCCCCGACAGGCACGAGCAGTACTTC	CASSAPDRHEQYF	TRBV10-2	TRBJ2-7
TGCAGTGCTAGGGAGAAGGACAGACCGTTAGGGGGACTCGAGCAGTACTTC	CSAREKDRPLGGLEQYF	TRBV20-1	TRBJ2-7
TGTGCCAGCAGTGACAGGGACAGGGCCTCCAATGAGCAGTTCTTC	CASSDRDRASNEQFF	TRBV6-1	TRBJ2-1
TGTGCCAGCACAACGGTATTTAGGGGGACTGAAGCTTTCTTT	CASTTVFRGTEAFF	TRBV5-5	TRBJ1-1
TGTGCCAGCAGCTCGAGGGCAGACTATGGCTACACCTTC	CASSSRADYGYTF	TRBV7-3	TRBJ1-2
TGTGCCAGCAGCTTAACCGACGGCACCGGGGAGCTGTTTTTT	CASSLTDGTGELFF	TRBV7-6	TRBJ2-2
TGTGCCACCAAGGGGGGGCACATGGCGCTAACCACTGAAGCTTTCTTT	CATKGGHMALTTEAFF	TRBV24-1	TRBJ1-1
TGTGCCAGCAGCAACGACAGGAGAGCCCCCACCTTC	CASSNDRRAPTF	TRBV27	TRBJ1-2
TGCGCCAGCAGCCCTAGGGGCCAAGAGACCCAGTACTTC	CASSPRGQETQYF	TRBV4-1	TRBJ2-5
TGTGCCAGCAGCTTAGTTGAGGCCCGGGCCCGAGAGGGTAAAGTTGAAGCTTTCTTT	CASSLVEARAREGKVEAFF	TRBV7-6	TRBJ1-1
TGTGCCAGCAGCCAAGAGATTGGGGGCGCCCGCGAGCAGTACTTC	CASSQEIGGAREQYF	TRBV14	TRBJ2-7
TGTGCCAGCAGCGCCGGGGAAATGGGACTAGTAAACGAGCAGTACTTC	CASSAGEMGLVNEQYF	TRBV9	TRBJ2-7
TGTGTAGGGCACTCCCAGTACTTC	CVGHSQYF	TRBV6-2	TRBJ2-4
TGTGCCAGCAGCCGGGGGACAGATTATGGCTACACCTTC	CASSRGTDYGYTF	TRBV13	TRBJ1-2
TGTGCCAGCAGTTTACGGTCGGGTTATAGCTTTTACACTGAAGCTTTCTTT	CASSLRSGYSFYTEAFF	TRBV28	TRBJ1-1
TGTGCCAGCAGCTTAGCAGTACCGGCTTCCGGACAGGGTTTCCCAAAACTGTTTTTT	CASSLAVPASGQGFPKLFF	TRBV7-6	TRBJ1-4
TGTGCCAGTAGTATAGATGTGACAGGGGCCCACAATCAGCCCCAGCATTTT	CASSIDVTGAHNQPQHF	TRBV19	TRBJ1-5
TGTGCCAGCAGCAGGTACGCGGGGTCTGAGGATGAAAAACTGTTTTTT	CASSRYAGSEDEKLFF	TRBV13	TRBJ1-4
TGCAGTGCCCAACGCAGCTCCTACGAGCAGTACTTC	CSAQRSSYEQYF	TRBV20-1	TRBJ2-7
TGCGCCAGCAGCTTACGCAGGGGGTATTCGAACACCGGGGAGCTGTTTTTT	CASSLRRGYSNTGELFF	TRBV5-1	TRBJ2-2
TGTGCCTGGCCCGAACAGGGGCCAGGGGGCAATGAGCAGTTCTTC	CAWPEQGPGGNEQFF	TRBV30	TRBJ2-1
TGTGCCAGCAGTGGTCGGGACGCCCAGTACTTC	CASSGRDAQYF	TRBV25-1	TRBJ2-5
TGTGCCAGCAGCTTCGGGCTATTGGGGGTAGGCGGGGAGCTGTTTTTT	CASSFGLLGVGGELFF	TRBV5-5	TRBJ2-2
TGTGCCAGCAGTTTATCGCACAGGGGGCGGGGCACCGAGACCCAGTACTTC	CASSLSHRGRGTETQYF	TRBV12-3	TRBJ2-5
TGTGCCATCAGTAACCCGAGGGACAGGGGCACAGATACGCAGTATTTT	CAISNPRDRGTDTQYF	TRBV10-3	TRBJ2-3
TGTGCCAGCCTCGGGACAGGGGTAACCGGAGGACTAAATCAGCCCCAGCATTTT	CASLGTGVTGGLNQPQHF	TRBV12-4	TRBJ1-5
TGTGCCAGCAGCAGGGGGGGCTCCAATGAGCAGTTCTTC	CASSRGGSNEQFF	TRBV7-3	TRBJ2-1
TGCAGCGTTGAAGGGGACCGGGCCCTTAATGAAAAACTGTTTTTT	CSVEGDRALNEKLFF	TRBV29-1	TRBJ1-4
TGTGCCAGCAGCTACGCTAGCGGAGCAGGGAGCTCCTACAATGAGCAGTTCTTC	CASSYASGAGSSYNEQFF	TRBV7-2	TRBJ2-1
TGTGCCAGCAGCCCCCCGACTAGCGGGGGGGCCTTTGAGACCCAGTACTTC	CASSPPTSGGAFETQYF	TRBV5-6	TRBJ2-5
TGTGCCAGCAGGTTGGGGCCGGAGAATGAGCAGTTCTTC	CASRLGPENEQFF	TRBV12-3	TRBJ2-1
TGTGCCAGCAGTGAACCGATCACTAGCGGTCCTACAGATACGCAGTATTTT	CASSEPITSGPTDTQYF	TRBV6-1	TRBJ2-3
TGTGCCTGGGGGGACCCCTCCTACGAGCAGTACTTC	CAWGDPSYEQYF	TRBV30	TRBJ2-7
TGTGCCAGCAGCCCCAGGACCAAGCGGACGCTCTGGGGCTGGTATTCCTTCGGGGAGCTGTTTTTT	CASSPRTKRTLWGWYSFGELFF	TRBV13	TRBJ2-2
TGCGCCAGACCGGGGGTGGATGAGCAGTTCTTC	CARPGVDEQFF	TRBV5-1	TRBJ2-1
TGTGCCAGCAGTTCGGCGCAGGGAGTGTGGGGAAATCAGCCCCAGCATTTT	CASSSAQGVWGNQPQHF	TRBV6-5	TRBJ1-5
TGTGCCAGCAGCTCGCTTGAGCGGGCAGACTCCTACGAGCAGTACTTC	CASSSLERADSYEQYF	TRBV7-9	TRBJ2-7
TGCAGTGCTAGAGTCTCTGGCAGTCGCAGACAGTACTACAATGAGCAGTTCTTC	CSARVSGSRRQYYNEQFF	TRBV20-1	TRBJ2-1
TGTGCCAGCAGCGTTATGGGGGCAACAGATACGCAGTATTTT	CASSVMGATDTQYF	TRBV9	TRBJ2-3
TGTGCCAGCAGTTTACGAGCAGTAAGTGACGAGCAGTACTTC	CASSLRAVSDEQYF	TRBV28	TRBJ2-7
TGCGCCAGCAACTACCGTTATTCGGGACAGGGGGTTATCACTGAAGCTTTCTTT	CASNYRYSGQGVITEAFF	TRBV5-1	TRBJ1-1
TGTGCCAGCAGCCCGGGACAGTATGGCTACACCTTC	CASSPGQYGYTF	TRBV9	TRBJ1-2
TGCAGTGCTTTCAGGTTTCGGGCGAACACCGGGGAGCTGTTTTTT	CSAFRFRANTGELFF	TRBV20-1	TRBJ2-2
TGTGCCACCAGTGAAGACAAAGGAGGGGAGGGGGAGCTGTTTTTT	CATSEDKGGEGELFF	TRBV24-1	TRBJ2-2
TGCAACCGAGGGCCGGAATTTTGCTCCTACAATGAGCAGTTCTTC	CNRGPEFCSYNEQFF	TRBV20-1	TRBJ2-1
TGCAGCGTTCGAGCGGGATACCCCTACGAGCAGTACTTC	CSVRAGYPYEQYF	TRBV29-1	TRBJ2-7
TGTGCCAGCAGCTTAGGACAGGGTGGGGTAAACACCGGGGAGCTGTTTTTT	CASSLGQGGVNTGELFF	TRBV5-8	TRBJ2-2
TGTGCCACCAGCAGAGTGACCAGGGGGCGCGAAAGTTTGGAGGATCAGCCCCAGCATTTT	CATSRVTRGRESLEDQPQHF	TRBV15	TRBJ1-5
TGTGCCAGCAGCGTACAGTCGGACTATGGCTACACCTTC	CASSVQSDYGYTF	TRBV5-6	TRBJ1-2
TGTGCCAGCAGTTACTCGAATTTTGCATTAGCGCGGGCGCGGAAGGTCCCTGAGGTCAACTATGGCTACACCTTC	CASSYSNFALARARKVPEVNYGYTF	TRBV6-5	TRBJ1-2
TGTGCCAGCAGCCAAAGGCGGACTAGCGGGAGACCCTACGAGCAGTACTTC	CASSQRRTSGRPYEQYF	TRBV7-3	TRBJ2-7
TGCGCCAGCACCGACAGACATGGGCTCACTGAAGCTTTCTTT	CASTDRHGLTEAFF	TRBV5-1	TRBJ1-1
TGTGCCAGCAGCGGCCACATCAAACCGGTGGGACAACGTTGCTACGAGCAGTACTTC	CASSGHIKPVGQRCYEQYF	TRBV13	TRBJ2-7
TGTGCCAGCAGCTTAGGTAATCCGGGACAGGAGACCCAGTACTTC	CASSLGNPGQETQYF	TRBV7-9	TRBJ2-5
TGCAGTGCTAGAGATAGGTGCCGGGATGATCAGCCCCAGCATTTT	CSARDRCRDDQPQHF	TRBV20-1	TRBJ1-5
TGTGCCATCAGTGACCGGGACAGGATTGACACAGATACGCAGTATTTT	CAISDRDRIDTDTQYF	TRBV10-3	TRBJ2-3
TGTGCCAGGGGGCGTGAAAATCAGCCCCAGCATTTT	CARGRENQPQHF	TRBV6-1	TRBJ1-5
TGTGCCAGCAGCCCTGTCCGACTAGCGGGCAGAAGGGACAATGAGCAGTTCTTC	CASSPVRLAGRRDNEQFF	TRBV6-4	TRBJ2-1
TGCGCCAGCAGCCGAACTCGGGACAGGGGTTATGGCTACACCTTC	CASSRTRDRGYGYTF	TRBV10-1	TRBJ1-2
TGTGCCAGCAGTGACTCGAACGCGGTGGGGGGGTACAATGAGCAGTTCTTC	CASSDSNAVGGYNEQFF	TRBV6-4	TRBJ2-1
TGTGGGGCCCATGGGAGGGAACCTTCTGAGCAGTTCTTC	CGAHGREPSEQFF	TRBV10-3	TRBJ2-1
TGTGCCCAGGGTAATGAAAAACTGTTTTTT	CAQGNEKLFF	TRBV19	TRBJ1-4
TGTGCCACCAGTGATTTCCCCATTCAGGGAGGCTACACCGGGGAGCTGTTTTTT	CATSDFPIQGGYTGELFF	TRBV24-1	TRBJ2-2
TGTGCCAGCAGCTTAGCGGGGGACAGTGGTGGCAATCAGCCCCAGCATTTT	CASSLAGDSGGNQPQHF	TRBV7-2	TRBJ1-5
TGTGCCAGCTACGGGACAGGGGACACTGAAGCTTTCTTT	CASYGTGDTEAFF	TRBV28	TRBJ1-1
TGCAGTGGGGACAGGGAGAATTACTATGGCTACACCTTC	CSGDRENYYGYTF	TRBV20-1	TRBJ1-2
TGTGCCAGTAACGTCTCCTCGGGACAGGGGGGGTGTAACACTGAAGCTTTCTTT	CASNVSSGQGGCNTEAFF	TRBV19	TRBJ1-1
TGTGCCACCACTATGGGGGGGGGTGGGTGTGAATACAATGAGCAGTTCTTC	CATTMGGGGCEYNEQFF	TRBV24-1	TRBJ2-1
TGTGCCAGCAGCGTAGCTAATGACATTCCGGAGTATAGCAATCAGCCCCAGCATTTT	CASSVANDIPEYSNQPQHF	TRBV9	TRBJ1-5
TGTGCCAGCAGCTGGGACAGGGTAGAAGGACCCTACGAGCAGTACTTC	CASSWDRVEGPYEQYF	TRBV7-3	TRBJ2-7
TGCGCCAGCAGCTTGGGGGGATCCTACGAGCAGTACTTC	CASSLGGSYEQYF	TRBV5-1	TRBJ2-7
TGTGCCAGCAGCCCTTCACCGGGAGAGTACAATGAGCAGTTCTTC	CASSPSPGEYNEQFF	TRBV5-6	TRBJ2-1
TGCGCCAGCAGCTTCCGGGACAGGGTTCAAGAGACCCAGTACTTC	CASSFRDRVQETQYF	TRBV5-1	TRBJ2-5
TGTGCCAGCAGCCTCGCCGTAGAGACCCAGTACTTC	CASSLAVETQYF	TRBV11-3	TRBJ2-5
TGCGCCAGCAGCCAAGAGTGGGGGCGACTTTACGAGCAGTACTTC	CASSQEWGRLYEQYF	TRBV4-1	TRBJ2-7
TGTGCCAGCAGCTTCCTGTCGGGGTTCCAGGGCGAGCAGTACTTC	CASSFLSGFQGEQYF	TRBV11-2	TRBJ2-7
TGTGCTAGTGTTTCATGTGGTCGGGCCCTGGCTGAAGCTTTCTTT	CASVSCGRALAEAFF	TRBV12-5	TRBJ1-1
TGTGCCAGCAGTGGGCTAGCGGGCTACAATGAGCAGTTCTTC	CASSGLAGYNEQFF	TRBV6-1	TRBJ2-1
TGTGCCAGCAGCGGGGCTACAGGGGCCTATAATCAGCCCCAGCATTTT	CASSGATGAYNQPQHF	TRBV9	TRBJ1-5
TGTGCCAGCAGTTACCCAGGGGGTAGGCTGGTTGGGTCACCCCTCCACTTT	CASSYPGGRLVGSPLHF	TRBV6-6	TRBJ1-6
TGTGCCAGCCCTACTAATAATGAGCAGTTCTTC	CASPTNNEQFF	TRBV9	TRBJ2-1
TGTGCCAGCAGCTTAACAGGGAAGGAAGCTTTCTTT	CASSLTGKEAFF	TRBV5-4	TRBJ1-1
TGTGCCACCTCCCCCGGGGGGGGATACAATGAGCAGTTCTTC	CATSPGGGYNEQFF	TRBV24-1	TRBJ2-1
TGTGCCAGCATTTACGCGCGGGAGAGGACCACAGATACGCAGTATTTT	CASIYARERTTDTQYF	TRBV27	TRBJ2-3
TGCGCCAGCAGCTTGCTTTACAGGGCGGGACATGGCTACACCTTC	CASSLLYRAGHGYTF	TRBV5-1	TRBJ1-2
TGTGCCAGCAGCGGTCGGTATTCTCGCGGGGGATCGCTTGAAAAACTGTTTTTT	CASSGRYSRGGSLEKLFF	TRBV7-9	TRBJ1-4
TGTGCCAGCACCCCCTGCAACACTGAAGCTTTCTTT	CASTPCNTEAFF	TRBV28	TRBJ1-1
TGCGCCAGCAGCTTGGAGCGAGACGGGATCTCTGGAAACACCATATATTTT	CASSLERDGISGNTIYF	TRBV5-1	TRBJ1-3
TGTGCCTGGAGTGTAACTAGCGGTCTTAACGAGCAGTACTTC	CAWSVTSGLNEQYF	TRBV30	TRBJ2-7
TGTGCCAGCAGCTTAGGGCGATCGTTGGACTACGAGCAGTACTTC	CASSLGRSLDYEQYF	TRBV7-3	TRBJ2-7
TGTGCCAGCAGTTTCTTCGGGGGGAACTCCTACGAGCAGTACTTC	CASSFFGGNSYEQYF	TRBV27	TRBJ2-7
TGTGCCAGCAGCGTAGTTCGACAGGGGGACACCGGGGAGCTGTTTTTT	CASSVVRQGDTGELFF	TRBV9	TRBJ2-2
TGCAGTGACGACAGGGGGGCACAGCCCCAGCATTTT	CSDDRGAQPQHF	TRBV20-1	TRBJ1-5
TGTGCCAGCAGTCCAGGGGACACTGAAGCTTTCTTT	CASSPGDTEAFF	TRBV6-4	TRBJ1-1
TGTGCCAGCAGAGTCAGGGACATTTACGAGCAGTACTTC	CASRVRDIYEQYF	TRBV7-9	TRBJ2-7
TGTGCTAGTGGTTTGGACAGGGCGAAAGGCTACACCTTC	CASGLDRAKGYTF	TRBV12-5	TRBJ1-2
TGTGCCAGCAGCGATCAGGGCGCTTTCTTT	CASSDQGAFF	TRBV9	TRBJ1-1
TGTGCCAGCAGCCCCAACAGGGCCAACGTCCTGACTTTC	CASSPNRANVLTF	TRBV27	TRBJ2-6
TGTGCCAGCAGACAGAAACTAGCGGGAGGGCTCTCGATCGAGCAAGAGACCCAGTACTTC	CASRQKLAGGLSIEQETQYF	TRBV6-1	TRBJ2-5
TGTGCCAGCAGCGGTTTAGCGGGCTCAGATACGCAGTATTTT	CASSGLAGSDTQYF	TRBV6-4	TRBJ2-3
TGTGCCAGCAGTGATATGGCCGGGACAGTTGCAACTAATGAAAAACTGTTTTTT	CASSDMAGTVATNEKLFF	TRBV6-1	TRBJ1-4
TGTGCCAGCAGCTGTCTAGCGGGCAGGAACACCGGGGAGCTGTTTTTT	CASSCLAGRNTGELFF	TRBV13	TRBJ2-2
TGTGCCAGCAGTGCGGCTAGTCATCATGAGCAGTTCTTC	CASSAASHHEQFF	TRBV6-1	TRBJ2-1
TGTGCCAGCAGTAAGGGGTCAGTATCGGGGGGTCCGGCTAGCACAGATACGCAGTATTTT	CASSKGSVSGGPASTDTQYF	TRBV6-5	TRBJ2-3
TGCGCCAGCAGCATACAGGGGGATAATTCACCCCTCCACTTT	CASSIQGDNSPLHF	TRBV5-1	TRBJ1-6
TGTGCCAGCCATTGGGACAGGAGTTACACTGAAGCTTTCTTT	CASHWDRSYTEAFF	TRBV28	TRBJ1-1
TGTGCCAAGGGGACAGTAAGGGAGTATAGCAATCAGCCCCAGCATTTT	CAKGTVREYSNQPQHF	TRBV28	TRBJ1-5
TGTGCCAGCAGTAAAACTCACTCCAGGCCGGTGACTGCCCCCTACGAGCAGTACTTC	CASSKTHSRPVTAPYEQYF	TRBV28	TRBJ2-7
TGTGCCAGCAGCCATGAGGGCGGGACCGGGGAGCTGTTTTTT	CASSHEGGTGELFF	TRBV7-9	TRBJ2-2
TGTGCCATCACGTCTTCAACGCAGCCCCAGCATTTT	CAITSSTQPQHF	TRBV10-3	TRBJ1-5
TGCGCCAGCTATTTTCCACAGGGCCCCGAAGGATTGTCGTGCTATGGCTACACCTTC	CASYFPQGPEGLSCYGYTF	TRBV10-1	TRBJ1-2
TGTGCCAGCACTAGCAGTAGGCGGCGCGAAACCGGGGAGCTGTTTTTT	CASTSSRRRETGELFF	TRBV27	TRBJ2-2
TGTGCCAGCAGCATAGTGGGGGGGGGCGAGTACTTC	CASSIVGGGEYF	TRBV6-4	TRBJ2-7
TGTGCCAGCAGCTTCCACAGGGGGGGAATATCCTACAATGAGCAGTTCTTC	CASSFHRGGISYNEQFF	TRBV5-6	TRBJ2-1
TGCAGTGGAATCTGGCCGGGGAATCAGCCCCAGCATTTT	CSGIWPGNQPQHF	TRBV20-1	TRBJ1-5
TGTGCCAGCAGCTTAGATAGCGACAGGCAAGCTTTCTTT	CASSLDSDRQAFF	TRBV11-2	TRBJ1-1
TGTGCCAGCAGGACACCCCCGGGACAGGGGGCCAACTCTGGGGCCAACGTCCTGACTTTC	CASRTPPGQGANSGANVLTF	TRBV7-9	TRBJ2-6
TGTGCCACCAGTGATACAAAAAAGGGTACGCATAGCAATCAGCCCCAGCATTTT	CATSDTKKGTHSNQPQHF	TRBV24-1	TRBJ1-5
TGCAGCGTTGACTCGGGGGGGGGCCGAATGAAAGGTGGCACAGATACGCAGTATTTT	CSVDSGGGRMKGGTDTQYF	TRBV29-1	TRBJ2-3
TGCGCCAGCTCCCACCGGGACAGGGACATAGACCTCTACACCGGGGAGCTGTTTTTT	CASSHRDRDIDLYTGELFF	TRBV10-1	TRBJ2-2
TGTGCCAGCAGTACCGGAGGGCGACAGGGGTTTTCCGGCTATGAAGCTTTCTTT	CASSTGGRQGFSGYEAFF	TRBV27	TRBJ1-1
TGTGCCAGCAGCAATAGGGGGGGCTACGAGCAGTACTTC	CASSNRGGYEQYF	TRBV11-3	TRBJ2-7
TGTGCCAGCAGCGCAAGGACAGGGGGCCCAGGAAACACCATATATTTT	CASSARTGGPGNTIYF	TRBV9	TRBJ1-3
TGTGCCAGCAGTTACCCCCGAGACACAGATACGCAGTATTTT	CASSYPRDTDTQYF	TRBV6-5	TRBJ2-3
TGCAGCGTTGGGGTAACCCCGACAGGACGGAGAAACGTTAGTGAAGCTTTCTTT	CSVGVTPTGRRNVSEAFF	TRBV29-1	TRBJ1-1
TGTGCCAGCAGTGAGAGGGGGGCTGGAAACACCATATATTTT	CASSERGAGNTIYF	TRBV6-1	TRBJ1-3
TGTGCCAGCAGCAGCGGAGCCTACAATGAGCAGTTCTTC	CASSSGAYNEQFF	TRBV13	TRBJ2-1
TGCGCCAGCAGCGGGAGAGGGGGCAATGAGCAGTTCTTC	CASSGRGGNEQFF	TRBV5-1	TRBJ2-1
TGTGCCAGCAGCCATTGGAGCCCTCCAGGGTTAGAGAACACTGAAGCTTTCTTT	CASSHWSPPGLENTEAFF	TRBV14	TRBJ1-1
TGTGCCAGCAGCCAACTTAACTACGAGCAGTACTTC	CASSQLNYEQYF	TRBV7-3	TRBJ2-7
TGCAGCGTTGAGCCCCAGGCGGAAGCCTACGAGCAGTACTTC	CSVEPQAEAYEQYF	TRBV29-1	TRBJ2-7
TGTGCCAGCAGTTCCCCCTACCGGGAGAAATACAATGAGCAGTTCTTC	CASSSPYREKYNEQFF	TRBV6-6	TRBJ2-1
TGTGCCAGCAGTTACCGATTAACTGGGGGGCAGACCTACGAGCAGTACTTC	CASSYRLTGGQTYEQYF	TRBV6-3	TRBJ2-7
TGTGCCAGCAGCCCGAGCCCAGGGAAGGAAAAACTGTTTTTT	CASSPSPGKEKLFF	TRBV11-3	TRBJ1-4
TGTGCCAGCAGCCCGTTTGGACCCCGGATGAACACTGAAGCTTTCTTT	CASSPFGPRMNTEAFF	TRBV13	TRBJ1-1
TGTGCCAGCAGCTTGGCTAGCGGGGAGCAGTTCTTC	CASSLASGEQFF	TRBV7-9	TRBJ2-1
TGTGCCAGCAGCATAAATTCCGACAGGGGGGGGATACGCGCTGAAGCTTTCTTT	CASSINSDRGGIRAEAFF	TRBV7-3	TRBJ1-1
TGTGCCAGCAGCTTGGCAAACATAGGGACTAGCACAGATACGCAGTATTTT	CASSLANIGTSTDTQYF	TRBV5-4	TRBJ2-3
TGCAGTGCTAGCCGACAGTTCAGCTACGAGCAGTACTTC	CSASRQFSYEQYF	TRBV20-1	TRBJ2-7
TGCGCCAGCAGCTTGGGGCACAGGGGTCCCAATCAGCCCCAGCATTTT	CASSLGHRGPNQPQHF	TRBV5-1	TRBJ1-5
TGTGCCAGCAGCGTTCCCCAACGTCTAACGCACAATGAGCAGTTCTTC	CASSVPQRLTHNEQFF	TRBV9	TRBJ2-1
TGCGCCAGCAGGGAGCCGGGACAGGCCAAAAACACTGAAGCTTTCTTT	CASREPGQAKNTEAFF	TRBV10-1	TRBJ1-1
TGTGCCAGCAGGGGACAGGGTAGGGAAAAGGGCGAGCAGTACTTC	CASRGQGREKGEQYF	TRBV6-8	TRBJ2-7
TGCGCCAGCAGTGTAGTACGCGGGAAGGTGAACACTGAAGCTTTCTTT	CASSVVRGKVNTEAFF	TRBV10-1	TRBJ1-1
TGTGCCAGTAGGGTTCGGGCTGTAGAGACCCAGTACTTC	CASRVRAVETQYF	TRBV19	TRBJ2-5
TGTGCCAGCAGCCCCGGGACTAGAGGACTAGTTTACACCGGGGAGCTGTTTTTT	CASSPGTRGLVYTGELFF	TRBV14	TRBJ2-2
TGTGCCAGTAGAACAGGGAGGGAAAAACTGTTTTTT	CASRTGREKLFF	TRBV19	TRBJ1-4
TGTGCCAGCAGCGTAGGACGCCACCTGTCCGGGGAGCCGGATCAGCCCCAGCATTTT	CASSVGRHLSGEPDQPQHF	TRBV9	TRBJ1-5
TGCAGTGCAGGACTAGACACCGGGGAGCTGTTTTTT	CSAGLDTGELFF	TRBV20-1	TRBJ2-2
TGTGCCAGCAGCCACTTGCGAGCTTACGAGCAGTACTTC	CASSHLRAYEQYF	TRBV14	TRBJ2-7
TGCGCCAGCAGCCAAGCCCGACAGGGAGTAGAAAAACTGTTTTTT	CASSQARQGVEKLFF	TRBV4-1	TRBJ1-4
TGTGCCAGCAGACTAGGGTGCTACAATGAGCAGTTCTTC	CASRLGCYNEQFF	TRBV3-1	TRBJ2-1
TGCAGTGCTGGCCCCCCCTCGGGTCGACTAAACTCCTACGAGCAGTACTTC	CSAGPPSGRLNSYEQYF	TRBV20-1	TRBJ2-7
TGTGCCAGCAGCAACTTCCCCCCCAGATATGAAAAACTGTTTTTT	CASSNFPPRYEKLFF	TRBV5-4	TRBJ1-4
TGTGCCAGCAGTGACATACGGCGGAGCTACGAGCAGTACTTC	CASSDIRRSYEQYF	TRBV25-1	TRBJ2-7
TGTGCCACGGAGGCCGGCTACACCTTC	CATEAGYTF	TRBV14	TRBJ1-2
TGCGCCAGCAGCTTACAGGCGAACACCGGGGAGCTGTTTTTT	CASSLQANTGELFF	TRBV5-1	TRBJ2-2
TGTGCCAGCAGCCAAGCCGGGACAGCCCGGGGTGGATGCCAAGAGACCCAGTACTTC	CASSQAGTARGGCQETQYF	TRBV4-2	TRBJ2-5
TGCAGCGTTGTCAAGCGGGATCCGCCTGGTACGCAGTATTTT	CSVVKRDPPGTQYF	TRBV29-1	TRBJ2-3
TGTGCCAGCAGAAAACTAGCGGGTGAGACCCAGTACTTC	CASRKLAGETQYF	TRBV12-4	TRBJ2-5
TGTGCCCCCATTTCCGAAGGGGGGACGATAAATGAGCAGTTCTTC	CAPISEGGTINEQFF	TRBV7-8	TRBJ2-1
TGCAGTGCTAGGCAAGAACCGGCTTACTACGAGCAGTACTTC	CSARQEPAYYEQYF	TRBV20-1	TRBJ2-7
TGCGCCAGCAGCTGGGCGAGTGGACATAGCAATCAGCCCCAGCATTTT	CASSWASGHSNQPQHF	TRBV5-1	TRBJ1-5
TGTGCCAGCAGGGAAGGCATGACAGGGCCAGAGCAGCCCCAGCATTTT	CASREGMTGPEQPQHF	TRBV12-3	TRBJ1-5
TGTGCCAGCAATAGCAGGTATGGCTACACCTTC	CASNSRYGYTF	TRBV27	TRBJ1-2
TGCGCCAGCATGGGACAGGGGAGCCAAGAGACCCAGTACTTC	CASMGQGSQETQYF	TRBV10-1	TRBJ2-5
TGTGCCAGCAGTGGCTATCGGACAGCATATAGCAATCAGCCCCAGCATTTT	CASSGYRTAYSNQPQHF	TRBV6-1	TRBJ1-5
TGTGCCAGCTCACCACCCCCGACAGGGACGAATTCACCCCTCCACTTT	CASSPPPTGTNSPLHF	TRBV18	TRBJ1-6
TGTGCCAGCAGCCAAGATGTCGCGGTTCACGAGACCTACGAGCAGTACTTC	CASSQDVAVHETYEQYF	TRBV3-1	TRBJ2-7
TGTGCCAGCCCCAGTGGGGGACTAGCGGGCTCTAGCACAGATACGCAGTATTTT	CASPSGGLAGSSTDTQYF	TRBV6-4	TRBJ2-3
TGTGCTAGTGGTCCCGGGACAGGGATTGCCTCTGGGGCCAACGTCCTGACTTTC	CASGPGTGIASGANVLTF	TRBV12-5	TRBJ2-6
TGTGCCAGCAGCACTAGCGGGAACCCCGGGGAGCTGTTTTTT	CASSTSGNPGELFF	TRBV5-6	TRBJ2-2
TGTGCCAGCAGTTCCTCGGTGATTAATTCACCCCTCCACTTT	CASSSSVINSPLHF	TRBV27	TRBJ1-6
TGTGCCAGCAGTCGGACTAGCCGGGGGGGGGAGCTTAATGAGCAGTTCTTC	CASSRTSRGGELNEQFF	TRBV27	TRBJ2-1
TGTGCCACCAGCAGAGGGGGACCGGCGGGGTATCAGCCCCAGCATTTT	CATSRGGPAGYQPQHF	TRBV15	TRBJ1-5
TGTGCCAGCAGTTACTCGATTTCGTGTCGGACTAGGTGCGAGCAGTACTTC	CASSYSISCRTRCEQYF	TRBV6-6	TRBJ2-7
TGCGCCAGCAGCCTGGACAGGGGTCCTATGAATGAAAAACTGTTTTTT	CASSLDRGPMNEKLFF	TRBV4-1	TRBJ1-4
TGTGCCAGCAGTCGTGCGACTAGCGGGGCTCGGCTGTTTTTT	CASSRATSGARLFF	TRBV6-1	TRBJ2-2
TGTGCCAGCAGCGGACAGGGGAGGGAGACCCAGTACTTC	CASSGQGRETQYF	TRBV13	TRBJ2-5
TGTGCCAGCAAGACCGGGACTAGCGGGTCTTCCTACAATGAGCAGTTCTTC	CASKTGTSGSSYNEQFF	TRBV6-5	TRBJ2-1
TGTGCCAGCAGCCTGGACAGGGGGGGTTCGAACACTGAAGCTTTCTTT	CASSLDRGGSNTEAFF	TRBV9	TRBJ1-1
TGCGCCAGCAGTGAGCTTGACAGGGGGCGGGACGAGCAGTACTTC	CASSELDRGRDEQYF	TRBV10-1	TRBJ2-7
TGTGCCAGCAGCCTAGGAGGGGGCTGGGCCAGGGACAATGAGCAGTTCTTC	CASSLGGGWARDNEQFF	TRBV13	TRBJ2-1
TGCAGCGGGTTATCGGGACAGGGGCTGGATACGCAGTATTTT	CSGLSGQGLDTQYF	TRBV29-1	TRBJ2-3
TGTGCCAGCAGCTTAGGAAGGACAGGCTGCTACGAGCAGTACTTC	CASSLGRTGCYEQYF	TRBV7-2	TRBJ2-7
TGTGCCAGCTCACCTCCGGGACAGGGGGGGCCTAATGAAAAACTGTTTTTT	CASSPPGQGGPNEKLFF	TRBV18	TRBJ1-4
TGCAGTGCTAGAGGTTTCGTGGACACTGAAGCTTTCTTT	CSARGFVDTEAFF	TRBV20-1	TRBJ1-1
TGTGCCAGCAGCCAGACAGGGGCGCCAACTAATGAAAAACTGTTTTTT	CASSQTGAPTNEKLFF	TRBV14	TRBJ1-4
TGTGCCAGCAGTAGGACCACCGGGGAGCTGTTTTTT	CASSRTTGELFF	TRBV11-3	TRBJ2-2
TGTGCCACCAGTGACCGGGGGGTACTCGAGCAGTACTTC	CATSDRGVLEQYF	TRBV24-1	TRBJ2-7
TGTGCCAGCAACAGACGCCACGCTGGGGCCAACGTCCTGACTTTC	CASNRRHAGANVLTF	TRBV6-1	TRBJ2-6
TGTGCCAGCAGCAACCGGGACAGGGGGCTGAACACTGAAGCTTTCTTT	CASSNRDRGLNTEAFF	TRBV6-6	TRBJ1-1
TGTGCCAGCAGTGACTCGACAAGTCCTGTCGCCAGCTCCTATAATTCACCCCTCCACTTT	CASSDSTSPVASSYNSPLHF	TRBV6-4	TRBJ1-6
TGTGCCAGCAGCTCATCATCCCGTCAGCGGTCCTACAATGAGCAGTTCTTC	CASSSSSRQRSYNEQFF	TRBV7-3	TRBJ2-1
TGTGCCAGCACCTGCTCCCAGGAGGAGCAGTACTTC	CASTCSQEEQYF	TRBV6-4	TRBJ2-7
TGTGCCAGTCTCGACGGGACAGCCGGTTTAAACGAGCAGTACTTC	CASLDGTAGLNEQYF	TRBV6-3	TRBJ2-7
TGTGCCAGCAGCTTAGGCTACTCGACTAGCGGGGTAAAGCAGTACTTC	CASSLGYSTSGVKQYF	TRBV11-2	TRBJ2-7
TGTGCCAGCAGTGACTACAGTAGCAATCAGCCCCAGCATTTT	CASSDYSSNQPQHF	TRBV6-4	TRBJ1-5
TGCGCCAGCCGGACAGGGCTTTGGACGAGGAACACTGAAGCTTTCTTT	CASRTGLWTRNTEAFF	TRBV10-1	TRBJ1-1
TGTGCCAGCAGTTTGACCGGAACAGACTATGGCTACACCTTC	CASSLTGTDYGYTF	TRBV6-9	TRBJ1-2
TGTGCCAGCAGTGACCCAAGGGGGTCCGGGACAGACTATGGCTACACCTTC	CASSDPRGSGTDYGYTF	TRBV25-1	TRBJ1-2
TGCGCCAGCAGCTTGCGGGGACAGGGTGTAGCCTATGGCTACACCTTC	CASSLRGQGVAYGYTF	TRBV5-1	TRBJ1-2
TGCAACCCTCCGGGTGTCGGGGGACGAGGTGAGACCCAGTACTTC	CNPPGVGGRGETQYF	TRBV20-1	TRBJ2-5
TGCAGTAGGGGAGTGTCCTACGAGCAGTACTTC	CSRGVSYEQYF	TRBV29-1	TRBJ2-7
TGTGCCAGCAGCGTAGCTCTCAGGAACACCGGGGAGCTGTTTTTT	CASSVALRNTGELFF	TRBV9	TRBJ2-2
TGTGCCAGCAGCCAAGACCGTTGGGACGGCTACACCTTC	CASSQDRWDGYTF	TRBV14	TRBJ1-2
TGTGCCAGCAGAACCAGGGGGCGCAGGAATGAGCAGTTCTTC	CASRTRGRRNEQFF	TRBV6-4	TRBJ2-1
TGTGCCAGCAGCCTAGGGGCTTCTTTCTTT	CASSLGASFF	TRBV3-1	TRBJ1-1
TGTGCCAGCAGCCAAAAGCAGGGAAGGTTGAACACTGAAGCTTTCTTT	CASSQKQGRLNTEAFF	TRBV14	TRBJ1-1
TGTGCCAGCAGCAGGGTCCCGTGTAGCAATCAGCCCCAGCATTTT	CASSRVPCSNQPQHF	TRBV7-9	TRBJ1-5
TGTGCCAGGGTTACGGGACAGGGGCAGTACAATGAGCAGTTCTTC	CARVTGQGQYNEQFF	TRBV27	TRBJ2-1
TGCGCCAGCAGCCAACTCCGGGACTTAGGAGATGGGGCCAACGTCCTGACTTTC	CASSQLRDLGDGANVLTF	TRBV4-1	TRBJ2-6
TGTGCCAGCAGCCAAGAGAGGGAGACCCAGTACTTC	CASSQERETQYF	TRBV3-1	TRBJ2-5
TGTGCCAGCAGCCCTTTCGGGGCCTTCCGAGGCACCTTC	CASSPFGAFRGTF	TRBV7-4	TRBJ1-2
TGTGCCAGCAGCACATCACAGGGGTTGGAATCCTACAATGAGCAGTTCTTC	CASSTSQGLESYNEQFF	TRBV12-3	TRBJ2-1
TGTGCCAGCACATTAGGGAAATACGAGCAGTACTTC	CASTLGKYEQYF	TRBV2	TRBJ2-7
TGTGCCAGCAGTTGGCGACGGGGGGCCGTCAGCACAGATACGCAGTATTTT	CASSWRRGAVSTDTQYF	TRBV27	TRBJ2-3
TGTGCCAGCAGCCAAGTTCCAAAGGAACCTCCCCAGCATTTT	CASSQVPKEPPQHF	TRBV3-1	TRBJ1-5
TGTGCCAGCAGCTCTGCCCTGCCGGGACAGTTCCCCCTCCACTTT	CASSSALPGQFPLHF	TRBV25-1	TRBJ1-6
TGTGCCACCAGCAGAACCCCGGGACTAGCGCGGTGCACAGATACGCAGTATTTT	CATSRTPGLARCTDTQYF	TRBV15	TRBJ2-3
TGTGCCAGCAGCCACCAGGTAGTAGGGACAGATGGCTACACCTTC	CASSHQVVGTDGYTF	TRBV14	TRBJ1-2
TGTGCCAGCAGTGACTCGGTGGGGGTTGGGGGATACAGGGCCTACGAGCAGTACTTC	CASSDSVGVGGYRAYEQYF	TRBV6-4	TRBJ2-7
TGTGCCAGCAGCAAGTCTTCCAGGGGTCACGGCAATGAGCAGTTCTTC	CASSKSSRGHGNEQFF	TRBV9	TRBJ2-1
TGTGCCAGCAGCTTCGGGCCCCGGGGGGGCAATGAGCAGTTCTTC	CASSFGPRGGNEQFF	TRBV7-9	TRBJ2-1
TGTGCCTGGAGTGGGGGGCACTTC	CAWSGGHF	TRBV30	TRBJ2-7
TGTGCCAGCATCCTGCAGGGAGAACACAACACCGGGGAGCTGTTTTTT	CASILQGEHNTGELFF	TRBV12-4	TRBJ2-2
TGTGCCAGTAGTCGGCTCCAGAAGGACTTTGGAACCTACGAGCAGTACTTC	CASSRLQKDFGTYEQYF	TRBV19	TRBJ2-7
TGTGCCAGCAGCTTAGCGTCCAGCACTGAAGCTTTCTTT	CASSLASSTEAFF	TRBV7-6	TRBJ1-1
TGTGCCACCAGCGAAGGCGGGGGCGAGACCCAGTACTTC	CATSEGGGETQYF	TRBV15	TRBJ2-5
TGTGCCAGCAGCTTAGGTGTCCTGATAGGAGGCTACACCTTC	CASSLGVLIGGYTF	TRBV11-2	TRBJ1-2
TGTGCCAGCAGCGTACTACCATGGTCTAGCGGGCATAGCACAGATACGCAGTATTTT	CASSVLPWSSGHSTDTQYF	TRBV9	TRBJ2-3
TGTGCCACCATGAACAGGGCAGAAGGGGCCAACGTCCTGACTTTC	CATMNRAEGANVLTF	TRBV24-1	TRBJ2-6
TGTGCCAGCAGCAAGACAGTGTGGGAGGGCTCCTACAATGAGCAGTTCTTC	CASSKTVWEGSYNEQFF	TRBV7-9	TRBJ2-1
TGTGCCAGCAGCGGTCGGGACAGGGTACACGAGCAGTACTTC	CASSGRDRVHEQYF	TRBV7-7	TRBJ2-7
TGCGCCAGCAGCTTGGAACGGACAGGGTGTAACTATGGCTACACCTTC	CASSLERTGCNYGYTF	TRBV5-1	TRBJ1-2
TGTGCCAGCAGTAAGGGTTCCTCAGATACGCAGTATTTT	CASSKGSSDTQYF	TRBV27	TRBJ2-3
TGTGCCAGCAGCTTAGACATGAGCCGGGACAGGGACTACGAGCAGTACTTC	CASSLDMSRDRDYEQYF	TRBV7-2	TRBJ2-7
TGTGCCAGCAGCTTACAACCGACAGGTTCACCCCTCCACTTT	CASSLQPTGSPLHF	TRBV7-9	TRBJ1-6
TGTGCCATCGAAACTAGCGGGATTGCACCAAAGCGCAATGAGCAGTTCTTC	CAIETSGIAPKRNEQFF	TRBV10-3	TRBJ2-1
TGTGCCAGCAGTGAAGCGAACCGGGCGTTGCAAGCTAATGAGCAGTTCTTC	CASSEANRALQANEQFF	TRBV2	TRBJ2-1
TGCGCCAGCAGCCAAGACGACCGGGGTGTCCAAGAGACCCAGTACTTC	CASSQDDRGVQETQYF	TRBV4-1	TRBJ2-5
TGTGCCAGCAGTGAAGTACGACGAAGTTACGGAGCGAACACCGGGGAGCTGTTTTTT	CASSEVRRSYGANTGELFF	TRBV2	TRBJ2-2
TGCGCCAGCAGTCAGACTAGCAGCTCTGGGGCCAACGTCCTGACTTTC	CASSQTSSSGANVLTF	TRBV4-1	TRBJ2-6
TGTGCCAGCAGCTTAGCGATACAGACACCACAAGAGACCCAGTACTTC	CASSLAIQTPQETQYF	TRBV7-8	TRBJ2-5
TGTGCCAGCAGTAACTGGCCGGGACAGGGGGCGATTAATCAGCCCCAGCATTTT	CASSNWPGQGAINQPQHF	TRBV6-5	TRBJ1-5
TGCGCCAGCAGTGAGTCCGCCACGACTAGCGGGAGGCCCTACAATGAGCAGTTCTTC	CASSESATTSGRPYNEQFF	TRBV10-1	TRBJ2-1
TGTGCCAGCAGCCAGGGGGGGAGGGTCGGCTACACCTTC	CASSQGGRVGYTF	TRBV7-3	TRBJ1-2
TGCGCCAGCCGACAATTTAAAACGACCAAACTTCGCTTCCATAGCAATCAGCCCCAGCATTTT	CASRQFKTTKLRFHSNQPQHF	TRBV10-1	TRBJ1-5
TGTGCCAGCAGTTTAGTTTGGGACAGAATCCCCTACAATGAGCAGTTCTTC	CASSLVWDRIPYNEQFF	TRBV27	TRBJ2-1
TGTGCCAGCAGAGCCGTGGGACTCCCCCAGGAGACCCAGTACTTC	CASRAVGLPQETQYF	TRBV6-3	TRBJ2-5
TGTGCCAGCAGTTTAGAACCGGGACAGGCGTACTCGTATCAGCCCCAGCATTTT	CASSLEPGQAYSYQPQHF	TRBV28	TRBJ1-5
TGTGCCAGCAGCGGTAACGAGCAGTACTTC	CASSGNEQYF	TRBV13	TRBJ2-7
TGTGCCAGCAGTTTAGTTCTAGGGAGGGGGGCAGGGCCAGTAGGACAGTACTTC	CASSLVLGRGAGPVGQYF	TRBV12-4	TRBJ2-5
TGTGCCAGCAGCTTAGGACGCTTAGCGCGGCGGTACGAGCAGTACTTC	CASSLGRLARRYEQYF	TRBV7-2	TRBJ2-7
TGTGCCAGCAGGGGGGGGAAGACTTACAATGAGCAGTTCTTC	CASRGGKTYNEQFF	TRBV27	TRBJ2-1
TGTGCCAGCAGCCCTGCCGGGCCTAGCGAGCAGTACTTC	CASSPAGPSEQYF	TRBV7-3	TRBJ2-7
TGTGCCAGCAGCGTAGTACCACGAGGGATATACTCTGGGGCCAACGTCCTGACTTTC	CASSVVPRGIYSGANVLTF	TRBV9	TRBJ2-6
TGTGCCAGCAATTTCAGGCCTAGATTGGGGGTAACAGATACGCAGTATTTT	CASNFRPRLGVTDTQYF	TRBV7-6	TRBJ2-3
TGTGCCAGCAGCCAAGGGGTTTCCGCAGGGGGTTCTGCAACTAATGAAAAACTGTTTTTT	CASSQGVSAGGSATNEKLFF	TRBV3-1	TRBJ1-4
TGCGCCAGCAGCAACTTCGCCAGGCCCTACGAGCAGTACTTC	CASSNFARPYEQYF	TRBV5-1	TRBJ2-7
TGCAGTGCTACCGAAGGGGGGACCCCTGGCTACACCTTC	CSATEGGTPGYTF	TRBV20-1	TRBJ1-2
TGTGCCAGCAGCCAAGACGTGACTCAGCCCCAGCATTTT	CASSQDVTQPQHF	TRBV14	TRBJ1-5
TGTGCCAGCAGTTTTTTTAATGGGACAGTCACTGAAGCTTTCTTT	CASSFFNGTVTEAFF	TRBV28	TRBJ1-1
TGCGCCAGCAGTGAAGGGTTATCAGGTCCCAATGAGCAGTTCTTC	CASSEGLSGPNEQFF	TRBV10-1	TRBJ2-1
TGTGCCAGCAGTTTATCAGGGGCGGGCCCGACATACACCATATATTTT	CASSLSGAGPTYTIYF	TRBV27	TRBJ1-3
TGTGCCAGCAGAATCGGGCTAGCGGGGTCCAATGAGCAGTTCTTC	CASRIGLAGSNEQFF	TRBV12-3	TRBJ2-1
TGTGCCAGCAGTCACCAGGGTCAGGTCCCCTACAATGAGCAGTTCTTC	CASSHQGQVPYNEQFF	TRBV6-1	TRBJ2-1
TGTGCCAGTAGTATCACAGCCGGGACTAGCGGGGGGGCTGCCTACGAGCAGTACTTC	CASSITAGTSGGAAYEQYF	TRBV19	TRBJ2-7
TGTGCCAGCAGTTCGGTCACTAGCGGGAGACCAGCCAAAAACATTCAGTACTTC	CASSSVTSGRPAKNIQYF	TRBV2	TRBJ2-4
TGTGCCAGCAGTTTCGCTAGAGTGTCCTACGAGCAGTACTTC	CASSFARVSYEQYF	TRBV27	TRBJ2-7
TGTGCCAGCAGTAAACGGGATAGGGGGGGGCCAATTCCCAAAAACATTCAGTACTTC	CASSKRDRGGPIPKNIQYF	TRBV6-1	TRBJ2-4
TGTGCCAGCAGCTTATTCCGGGCCGATTCACCCCTCCACTTT	CASSLFRADSPLHF	TRBV7-3	TRBJ1-6
TGCAGCGTTGTAACCCCCTATTCCCCTTACGAGCAGTACTTC	CSVVTPYSPYEQYF	TRBV29-1	TRBJ2-7
TGCAGTGCTAATCGGAGGGGGCGGAACATCGGCTACACCTTC	CSANRRGRNIGYTF	TRBV20-1	TRBJ1-2
TGTGCCACCAGTGGGAGGCGGGAGAGGGGGCCGAACACTGAAGCTTTCTTT	CATSGRRERGPNTEAFF	TRBV24-1	TRBJ1-1
TGTGCCAGGGGGCCGGAGCCCAATCAGCCCCAGCATTTT	CARGPEPNQPQHF	TRBV3-1	TRBJ1-5
TGCGCCAGCAGCGGCGGGACTAGGTACGAGCAGTACTTC	CASSGGTRYEQYF	TRBV5-1	TRBJ2-7
TGTGCCAGCAGTGAGGGGCTTCGACAGGATGCCTACGAGCAGTACTTC	CASSEGLRQDAYEQYF	TRBV6-1	TRBJ2-7
TGTGCCAGCAGCAACCCGTTACGGGACGCTGATGGCTACACCTTC	CASSNPLRDADGYTF	TRBV13	TRBJ1-2
TGTGCCTGGATTTTTTGGGGAAGGCCGGGCTACACCTTC	CAWIFWGRPGYTF	TRBV30	TRBJ1-2
TGCGCCAGCAGCCATACAGGACAGGGGGGAGACAATGAGCAGTTCTTC	CASSHTGQGGDNEQFF	TRBV4-3	TRBJ2-1
TGTGCCTGGAGTGTACTAAGCAGGGGGCACGGGCTCGTCTTT	CAWSVLSRGHGLVF	TRBV30	TRBJ1-1
TGTGCCAGCAGTTTACGAATAGCGGGAGTCCGCTCCTACAATGAGCAGTTCTTC	CASSLRIAGVRSYNEQFF	TRBV12-3	TRBJ2-1
TGTGCCACCAGTGATATAACTAAACCGAATGAGACCCAGTACTTC	CATSDITKPNETQYF	TRBV24-1	TRBJ2-5
TGTGCCAGCACTTTATCTCGGGGCCTGTACGAGCAGTACTTC	CASTLSRGLYEQYF	TRBV6-5	TRBJ2-7
TGTGCCAGCTCGAGACGCAGGACAGGGCACTTC	CASSRRRTGHF	TRBV18	TRBJ1-2
TGTGCCAGCGGCAGGGGGGCTGAAGCTTTCTTT	CASGRGAEAFF	TRBV27	TRBJ1-1
TGTGCCAGCAGGACAACACAGGGGCAGAACACTGAAGCTTTCTTT	CASRTTQGQNTEAFF	TRBV28	TRBJ1-1
TGTGCCAGCAGCGGGACTAGCGGAACTTCCTACAATGAGCAGTTCTTC	CASSGTSGTSYNEQFF	TRBV11-1	TRBJ2-1
TGTGCCAGCAGCTCCCAGGGGTATGGCTACACCTTC	CASSSQGYGYTF	TRBV9	TRBJ1-2
TGTGCCAGCAGCGACAGGTTCCCCTGCACTGAAGCTTTCTTT	CASSDRFPCTEAFF	TRBV7-2	TRBJ1-1
TGTGCCAGCAGCCATAAACAGGGCGGGTGCAACATTCAGTACTTC	CASSHKQGGCNIQYF	TRBV4-2	TRBJ2-4
TGTGCCAGCAGCAGGGGCGAGAGGGAGACCCAGTACTTC	CASSRGERETQYF	TRBV13	TRBJ2-5
TGTGCCAGCAGCTATGTCAGGGGGGGCCGATCCTACGAGCAGTACTTC	CASSYVRGGRSYEQYF	TRBV7-2	TRBJ2-7
TGTGCCAGCAGCTTATGCCCCCCTCCACCGGGACACCCCGGCTATGGCTACACCTTC	CASSLCPPPPGHPGYGYTF	TRBV11-2	TRBJ1-2
TGTGCCAGCTCACATGCAAATCCTGACGAGCAGTACTTC	CASSHANPDEQYF	TRBV18	TRBJ2-7
TGCGCCAGCAGCTTGGGTGGACAGGTTTCGGAGTACTTC	CASSLGGQVSEYF	TRBV5-1	TRBJ2-7
TGTGCCAGCAGTTACCCCTTATGCCCCTCTGGAAACACCATATATTTT	CASSYPLCPSGNTIYF	TRBV6-5	TRBJ1-3
TGCGCCAGCAGCCAAGAGGGACTAGCACCTAGGGGAGAGACCCAGTACTTC	CASSQEGLAPRGETQYF	TRBV4-1	TRBJ2-5
TGTGCCACCAGTGATGAGGGAGGTCCGTACTTC	CATSDEGGPYF	TRBV24-1	TRBJ2-7
TGCGCCAGCGCCTGGACAGGCGCTGACAATGAGCAGTTCTTC	CASAWTGADNEQFF	TRBV10-1	TRBJ2-1
TGTGCCACCACAATAGGACAGGGGGTGGGAAACACCATATATTTT	CATTIGQGVGNTIYF	TRBV24-1	TRBJ1-3
TGCAGTGCTAGAGCGCCTACAGGGAGTGGGCAGCCCCAGCATTTT	CSARAPTGSGQPQHF	TRBV20-1	TRBJ1-5
TGTGCCAGCAGGTCCTCTAGGCCCAAACGCGCGGATCAGCCCCAGCATTTT	CASRSSRPKRADQPQHF	TRBV6-5	TRBJ1-5
TGTGCCAGCAGCCTACCGGGACTAGCGGGAGTAAAGGGGGATCGCAAAAACATTCAGTACTTC	CASSLPGLAGVKGDRKNIQYF	TRBV11-2	TRBJ2-4
TGTGCCAGCAGTGAGACTAGCGGGGGGGCGCCCCGCACAGATACGCAGTATTTT	CASSETSGGAPRTDTQYF	TRBV12-4	TRBJ2-3
TGTGCCAGCAGCTTCCCGCGGGAGGACCTCAGGACAGATACGCAGTATTTT	CASSFPREDLRTDTQYF	TRBV7-9	TRBJ2-3
TGTGCCAGCAGCCAAGATGACTCCCGGGTAGGTTCTAACTATGGCTACACCTTC	CASSQDDSRVGSNYGYTF	TRBV14	TRBJ1-2
TGTGCCAGCAACTTGGGGCCGAATGAAAAACTGTTTTTT	CASNLGPNEKLFF	TRBV6-4	TRBJ1-4
TGTGCCAGCAGCTTAGTCCCTCACAGGGGGTACGAGCAGTACTTC	CASSLVPHRGYEQYF	TRBV11-2	TRBJ2-7
TGTGCCAGCAGTGAATCCAAGACAGGGAACAGGGTCTCCTACGAGCAGTACTTC	CASSESKTGNRVSYEQYF	TRBV25-1	TRBJ2-7
TGTGCCAGCAGCTCACAGGGGGAGGGAACTGAAGCTTTCTTT	CASSSQGEGTEAFF	TRBV11-2	TRBJ1-1
TGTGCCAGCAGCCCCCGAGGGCCCTTTAGCAATCAGCCCCAGCATTTT	CASSPRGPFSNQPQHF	TRBV13	TRBJ1-5
TGTGCCACCGAAGCCCCGGACAGGGGCCGTGGAGCCTACGAGCAGTACTTC	CATEAPDRGRGAYEQYF	TRBV24-1	TRBJ2-7
TGCAGTGCAGACGATACCTACGAGCAGTACTTC	CSADDTYEQYF	TRBV20-1	TRBJ2-7
TGTGCCAGCAGCCAGGAACTGGTCGAACGCAGTGGAGAAAAACTGTTTTTT	CASSQELVERSGEKLFF	TRBV14	TRBJ1-4
TGTGCCAGCAGCGTAGCGGGACTCGAGACCCAGTACTTC	CASSVAGLETQYF	TRBV9	TRBJ2-5
TGTGCCAGCAGATACAATGAGCAGTTCTTC	CASRYNEQFF	TRBV6-5	TRBJ2-1
TGTGCCAGCAGTGACTCTCCCACAGGGCAGGGTCATGAGCAGTTCTTC	CASSDSPTGQGHEQFF	TRBV6-4	TRBJ2-1
TGCAGTGCTAGAGATCTCTCGACTAGACCGCCCTACGAGCAGTACTTC	CSARDLSTRPPYEQYF	TRBV20-1	TRBJ2-7
TGTGCCAGCAGTGAAACTAGCGGGAGAGTAGGGTCCGAGCAGTACTTC	CASSETSGRVGSEQYF	TRBV6-4	TRBJ2-7
TGTGCCAGCAAACGAGGGGTATTAATGTGCTACACCTTC	CASKRGVLMCYTF	TRBV6-2	TRBJ1-2
TGTGCCAGCAGCTCTCCACCAACCCCGGAGACCCAGTACTTC	CASSSPPTPETQYF	TRBV7-2	TRBJ2-5
TGTGCCAGCAGCTCTTGGCCTAGCGTCCAAGAGACCCAGTACTTC	CASSSWPSVQETQYF	TRBV9	TRBJ2-5
TGTGCCAGCCGACCGAGGGACCCGATAGATACGCAGTATTTT	CASRPRDPIDTQYF	TRBV13	TRBJ2-3
TGTGCCAGCAGCTTTACCCTAGCGGGAATTGCCTACAATGAGCAGTTCTTC	CASSFTLAGIAYNEQFF	TRBV7-6	TRBJ2-1
TGTGCCACCAGTGAAGTTCGGGGGGGTATGGCTGGGGCCAACGTCCTGACTTTC	CATSEVRGGMAGANVLTF	TRBV24-1	TRBJ2-6
TGTGCCAGCAGGTTCCGGGACAGTCTAGCTTTCTTT	CASRFRDSLAFF	TRBV16	TRBJ1-1
TGTGCCAGCAGCGGACCTGTTGGGGGACTAGTCTACGAGCAGTACTTC	CASSGPVGGLVYEQYF	TRBV7-2	TRBJ2-7
TGTGCCATCACTCCGGGAGGATACACCGGGGAGCTGTTTTTT	CAITPGGYTGELFF	TRBV10-3	TRBJ2-2
TGTGCCAGCAGTTCCAAGACGAGAGAGACCCAGTACTTC	CASSSKTRETQYF	TRBV6-2	TRBJ2-5
TGTGCCAAGAGGCAACTTGGCTACACCTTC	CAKRQLGYTF	TRBV6-5	TRBJ1-2
TGTGCCAGCAGCCCCCGTAGACAGCTCAACTATCAGCCCCAGCATTTT	CASSPRRQLNYQPQHF	TRBV7-6	TRBJ1-5
TGTGCCAGCAGTTACAAGGTGGGCGGTCTAAGCAATCAGCCCCAGCATTTT	CASSYKVGGLSNQPQHF	TRBV6-2	TRBJ1-5
TGTGCCAGCAGCGGTGGGCTTAAAGAGACCCAGTACTTC	CASSGGLKETQYF	TRBV13	TRBJ2-5
TGTGCCAGCTCAGGGGGACAAGCTGGAAACACCATATATTTT	CASSGGQAGNTIYF	TRBV3-1	TRBJ1-3
TGTGCCACCAGTGATTTGCACGAGCCCGACAGGGAGAGCGAGCAGTACTTC	CATSDLHEPDRESEQYF	TRBV24-1	TRBJ2-7
TGTGCCAGCAGTTACGTGGGGGTATCTAGCACAGATACGCAGTATTTT	CASSYVGVSSTDTQYF	TRBV6-2	TRBJ2-3
TGCAGTGCTAGCCCGGACAGGGGGCTGGCTTTCTTT	CSASPDRGLAFF	TRBV20-1	TRBJ1-1
TGTGGGGAGGACTATCCTGAAGCTTTCTTT	CGEDYPEAFF	TRBV12-3	TRBJ1-1
TGCAGTGCTAGCCGCGGGGGTCAGCCCCAGCATTTT	CSASRGGQPQHF	TRBV20-1	TRBJ1-5
TGTGCCAGCAGTGAACCTGTGGGACAGGAGTTGAACACCGGGGAGCTGTTTTTT	CASSEPVGQELNTGELFF	TRBV6-1	TRBJ2-2
TGTGCCCTAGCGGGAAACTACGAGCAGTACTTC	CALAGNYEQYF	TRBV19	TRBJ2-7
TGTGCCAGCAGCCATCCTCTGGACAGACGGAATAACGAGCAGTACTTC	CASSHPLDRRNNEQYF	TRBV14	TRBJ2-7
TGTGCCAGCAGCCTCCTAGGACAGTTCTACGAGCAGTACTTC	CASSLLGQFYEQYF	TRBV14	TRBJ2-7
TGTGCCATTAATGGGCCGACAGGGGGGGCAACTAATGAAAAACTGTTTTTT	CAINGPTGGATNEKLFF	TRBV10-3	TRBJ1-4
TGTGCCAGCAGTTTCCGGGGACCAAGTACGATCAATGAGCAGTTCTTC	CASSFRGPSTINEQFF	TRBV6-2	TRBJ2-1
TGTGCCAGCAGAAAAGTTGGTCGGGGCTACACCTTC	CASRKVGRGYTF	TRBV28	TRBJ1-2
TGCGCCAGCAGCCAAGAAACGGGGTATACTGCCTATAATTCACCCCTCCACTTT	CASSQETGYTAYNSPLHF	TRBV4-1	TRBJ1-6
TGTGCCAGCAGGGGGCAGGGCTACACCTTC	CASRGQGYTF	TRBV6-4	TRBJ1-2
TGTGCCAGCAGTTCGGGGACAGGGGCTAGCACAGATACGCAGTATTTT	CASSSGTGASTDTQYF	TRBV6-2	TRBJ2-3
TGTGCCAGCAGCCAAGACGTTGCTAGCGGGATCTCCTACAATGAGCAGTTCTTC	CASSQDVASGISYNEQFF	TRBV4-2	TRBJ2-1
TGTGCCAGTAGTGTTCTTCGGGGACAAGCCTCTGGGGACGAGCAGTACTTC	CASSVLRGQASGDEQYF	TRBV19	TRBJ2-7
TGTGCCAGCAGCCGGGGAAACGAGCAGTACTTC	CASSRGNEQYF	TRBV4-2	TRBJ2-7
TGTGCCAGCAGCTATTGGGACAGCCCCAGCGGCAATCAGCCCCAGCATTTT	CASSYWDSPSGNQPQHF	TRBV11-2	TRBJ1-5
TGTGCCAGCAGCCCCCCCGCCGGACAGATAAAGGATCAGCCCCAGCATTTT	CASSPPAGQIKDQPQHF	TRBV7-3	TRBJ1-5
TGTGCCAGCAGCGTATTCCGGGGGGCCCCCCGGGGAGAGAGATTTAGCAATCAGCCCCAGCATTTT	CASSVFRGAPRGERFSNQPQHF	TRBV9	TRBJ1-5
TGTGCCAGCTCACCAGGTCCACTGAACACTGAAGCTTTCTTT	CASSPGPLNTEAFF	TRBV18	TRBJ1-1
TGTGCCATCAGTGGTAATGACCCAAACTACTCTGGGGCCAACGTCCTGACTTTC	CAISGNDPNYSGANVLTF	TRBV10-3	TRBJ2-6
TGCGCCAGCAGCTTGGGGGTCTCTGGGGGGGAGACCCAGTACTTC	CASSLGVSGGETQYF	TRBV5-1	TRBJ2-5
TGTGCCAGCCCCGAACATGAGTTTAGCAACACCGGGGAGCTGTTTTTT	CASPEHEFSNTGELFF	TRBV9	TRBJ2-2
TGCAGTGCTAGGACACCCCTGTGCAATCAGCCCCAGCATTTT	CSARTPLCNQPQHF	TRBV20-1	TRBJ1-5
TGCAGCGGCCTAGCGGGCGGGGGCACAGATACGCAGTATTTT	CSGLAGGGTDTQYF	TRBV29-1	TRBJ2-3
TGTGCCAGCCGCGGAACAGATACGCAGTATTTT	CASRGTDTQYF	TRBV27	TRBJ2-3
TGCAGCGTTGAAGATGCCACGGGACAGGGCCGGGGGTTCTACGAGCAGTACTTC	CSVEDATGQGRGFYEQYF	TRBV29-1	TRBJ2-7
TGTGCCAGCAGCTTTGTAGAACAGGAAGGCTACACCTTC	CASSFVEQEGYTF	TRBV11-2	TRBJ1-2
TGCGCCAGCAGCCCTCGGATGGACACTGAAGCTTTCTTT	CASSPRMDTEAFF	TRBV5-1	TRBJ1-1
TGCAGTGCTAGCACACCAGAGGTGGCACCGTACGAGCAGTACTTC	CSASTPEVAPYEQYF	TRBV20-1	TRBJ2-7
TGTGCCAGCAGTGACGCCTCCAAGGGGCGTGCGAGGACTGAAGCTTTCTTT	CASSDASKGRARTEAFF	TRBV6-4	TRBJ1-1
TGTGCCAGCAATCCCCCAGAGGGGTCTATACATGGCAATCAGCCCCAGCATTTT	CASNPPEGSIHGNQPQHF	TRBV6-3	TRBJ1-5
TGCAGTGCTAGAGTTCAGGGGCAGGACTACGAGCAGTACTTC	CSARVQGQDYEQYF	TRBV20-1	TRBJ2-7
TGTGCCACTGAGCCACCAGTTGCTTTCTTT	CATEPPVAFF	TRBV7-9	TRBJ1-1
TGCAGCGTTGAACGCATCTCCCCGGGACAGGGGAAGGGCACTGAAGCTTTCTTT	CSVERISPGQGKGTEAFF	TRBV29-1	TRBJ1-1
TGTGCCAGCAGTGTTAGGGGAGGTCCCGGGACTAGCGGGAGGTTCGAGCAGTACTTC	CASSVRGGPGTSGRFEQYF	TRBV5-8	TRBJ2-7
TGTGCCAGCAGCTTAGCGAGGGTAAGGGACGAGAACTATGGCTACACCTTC	CASSLARVRDENYGYTF	TRBV7-6	TRBJ1-2
TGTGCCAGCAGCTCAGGGGGCGGAGGGTACCAAGAGACCCAGTACTTC	CASSSGGGGYQETQYF	TRBV7-9	TRBJ2-5
TGTGCCAGCACAAGGACAGGGTTGAGCTCTGGAAACACCATATATTTT	CASTRTGLSSGNTIYF	TRBV27	TRBJ1-3
TGTGCCAGCAGTACGTTTGCGGTTACTCCGGGTTCTAACACCGGGGAGCTGTTTTTT	CASSTFAVTPGSNTGELFF	TRBV25-1	TRBJ2-2
TGTGCCAGCAGCTTAGAGGAGGCAGGGGCGCTGCTACGGGGCACAGATACGCAGTATTTT	CASSLEEAGALLRGTDTQYF	TRBV11-2	TRBJ2-3
TGTGCCAGCAGCTTCACGGGACAGTGGGAGCAGTTCTTC	CASSFTGQWEQFF	TRBV11-3	TRBJ2-1
TGTGCCAGCAGCGTCCCAAGCTATGGCTACACCTTC	CASSVPSYGYTF	TRBV13	TRBJ1-2
TGTGCCAGCAGATGGGGGCAGCCCCAGCATTTT	CASRWGQPQHF	TRBV6-4	TRBJ1-5
TGCAGTGCTTCAGAGGGAGGTCACACTGAAGCTTTCTTT	CSASEGGHTEAFF	TRBV20-1	TRBJ1-1
TGTGCTAGTGGTTTGCCGGGACGGTCCACCGGGGAGCTGTTTTTT	CASGLPGRSTGELFF	TRBV12-5	TRBJ2-2
TGTGCCAGTCAAGATGGAACCGTGGACTTTGAAGCTTTCTTT	CASQDGTVDFEAFF	TRBV27	TRBJ1-1
TGCAGCGTTGGAGGTTACGAGGGCTCCTACGAGCAGTACTTC	CSVGGYEGSYEQYF	TRBV29-1	TRBJ2-7
TGTGTTCCGGGGAGGATGGGACGGCACACCATATATTTT	CVPGRMGRHTIYF	TRBV25-1	TRBJ1-3
TGCGCCAGCAGCTACAGACAGCTGCCCTATGGCTACACCTTC	CASSYRQLPYGYTF	TRBV5-1	TRBJ1-2
TGTGCCAGTAGTATGGTTGACCGGGACAATGAGCAGTTCTTC	CASSMVDRDNEQFF	TRBV19	TRBJ2-1
TGTGCCAGCAGTGAACCTGAGGGCTCTGGAAACACCATATATTTT	CASSEPEGSGNTIYF	TRBV25-1	TRBJ1-3
TGTGCCAGCAGGCAGGACAGGGGGCAAAGCACCGAGCAGTACTTC	CASRQDRGQSTEQYF	TRBV2	TRBJ2-7
TGTGCCAGCAGCCAAGATACGCCCACAGGGCGCTGCTACGAGCAGTACTTC	CASSQDTPTGRCYEQYF	TRBV4-2	TRBJ2-7
TGCGCCAGCAGCTTGATAACGATCCCGCACGAGCAGTACTTC	CASSLITIPHEQYF	TRBV5-1	TRBJ2-7
TGTGCCAGGCGGACTACCCGAGCTTTCTTT	CARRTTRAFF	TRBV7-3	TRBJ1-1
TGTGCCAGCAGCGATACCAAAGAGACCCAGTACTTC	CASSDTKETQYF	TRBV7-4	TRBJ2-5
TGCAGTATCTCTTCACCCTCCTACAATGAGCAGTTCTTC	CSISSPSYNEQFF	TRBV20-1	TRBJ2-1
TGTGCCAGCAGCTCGGTATTTTCTCAACCAAGCTACGAGCAGTACTTC	CASSSVFSQPSYEQYF	TRBV11-2	TRBJ2-7
TGTGCCAGCAGTTTGTGGGACAGCTCTATCAATCAGCCCCAGCATTTT	CASSLWDSSINQPQHF	TRBV12-3	TRBJ1-5
TGTGCCAGCAGCGGCGCGGGGGGGACAGCCCAAGAGACCCAGTACTTC	CASSGAGGTAQETQYF	TRBV11-3	TRBJ2-5
TGTGCCATCCGGGGGGGGAGGGACTTAGATACGCAGTATTTT	CAIRGGRDLDTQYF	TRBV10-3	TRBJ2-3
TGTGCCAGCAGCCCAACCCCTCCTGCGGGAGAACCCACAGATACGCAGTATTTT	CASSPTPPAGEPTDTQYF	TRBV9	TRBJ2-3
TGTGCCAGCTACAACACAGATACGCAGTATTTT	CASYNTDTQYF	TRBV27	TRBJ2-3
TGTGCCAGCAGGGTACAGGGAAGAGAGACCCAGTACTTC	CASRVQGRETQYF	TRBV27	TRBJ2-5
TGTGCCACCAGTGATTTGAGAGAGTCGGACCTAGCGGGATTGTACCAAGAGACCCAGTACTTC	CATSDLRESDLAGLYQETQYF	TRBV24-1	TRBJ2-5
TGTGCCAGCAGCAGCGCAGGAGCTGACTACGAGCAGTACTTC	CASSSAGADYEQYF	TRBV7-4	TRBJ2-7
TGTGCCAGCAGCGTAGCCGACAGGACCGACACTGAAGCTTTCTTT	CASSVADRTDTEAFF	TRBV9	TRBJ1-1
TGTGCCAGCAGTTTGCGGCATGGCCCGGGACAGGGACGGACTGAAGCTTTCTTT	CASSLRHGPGQGRTEAFF	TRBV27	TRBJ1-1
TGTGCCAGCAGTGAGGAACGTTCACCCCTCCACTTT	CASSEERSPLHF	TRBV6-4	TRBJ1-6
TGTGCCAGCAGCCAAGATAAGGGCAGGGGGCGGAAAGGGAGACCGGTCAATCAGCCCCAGCATTTT	CASSQDKGRGRKGRPVNQPQHF	TRBV3-1	TRBJ1-5
TGTGCCAGCATTAGGTACAGAGGGATAGGGTCACCCCTCCACTTT	CASIRYRGIGSPLHF	TRBV27	TRBJ1-6
TGTGCCAGCAACGGACGGGGAAACTATGGCTACACCTTC	CASNGRGNYGYTF	TRBV6-6	TRBJ1-2
TGTGCCGATGGGGTAGAGGAAGAGCAGTACTTC	CADGVEEEQYF	TRBV9	TRBJ2-7
TGTGCCAGCCCTTTACCGGGACTGGGAGACGAGCAGTACTTC	CASPLPGLGDEQYF	TRBV6-1	TRBJ2-7
TGTGCCAGCAGCAAGCGGGTGACCAAGGTAACAGATACGCAGTATTTT	CASSKRVTKVTDTQYF	TRBV7-8	TRBJ2-3
TGTGCCAGCAGCAAACTCGGACGGACAGGGTGTCCGAGCTACGAGCAGTACTTC	CASSKLGRTGCPSYEQYF	TRBV11-2	TRBJ2-7
TGTGCCAGCGTCCTCGAGAGGGGCAGGCATTCACCCCTCCACTTT	CASVLERGRHSPLHF	TRBV11-3	TRBJ1-6
TGTGCCTGGAGTGTACAGAACCGGGCCAAGGAGTACAATGAGCAGTTCTTC	CAWSVQNRAKEYNEQFF	TRBV30	TRBJ2-1
TGTGCCAGCAGTGACAGGGGGCGAGTAGAGACCCAGTACTTC	CASSDRGRVETQYF	TRBV6-4	TRBJ2-5
TGTGCCACCAGTGAACAGTCTCGTCCTCAAGAGACCCAGTACTTC	CATSEQSRPQETQYF	TRBV24-1	TRBJ2-5
TGTGCTACCAGGTTACCGGATCAGCCCCAGCATTTT	CATRLPDQPQHF	TRBV7-2	TRBJ1-5
TGTGCCAGCAGTTTATGGCTAAACAGCGCCTTCGGGAACACTGAAGCTTTCTTT	CASSLWLNSAFGNTEAFF	TRBV27	TRBJ1-1
TGTGCCAGCAGCACATCAGTAGCAGACACTGAAGCTTTCTTT	CASSTSVADTEAFF	TRBV13	TRBJ1-1
TGTGCCAGCAGCGGTGGCAGAGAGACCCAGTACTTC	CASSGGRETQYF	TRBV6-5	TRBJ2-5
TGCGCCAGCAGTGAGACTGGCCCACCAAGTGGAAACACCATATATTTT	CASSETGPPSGNTIYF	TRBV10-1	TRBJ1-3
TGTGCCAGCAGTTCCAGGGGGACCTGGGCCAACGTCCTGACTTTC	CASSSRGTWANVLTF	TRBV27	TRBJ2-6
TGTGCCAGTAGTGGATCCGCTCGTTCAGAGCCGTGGACAGGGGGCGCAACTAATGAAAAACTGTTTTTT	CASSGSARSEPWTGGATNEKLFF	TRBV19	TRBJ1-4
TGTGCCAGCAACGGGGCATATCAGCCCCAGCATTTT	CASNGAYQPQHF	TRBV6-5	TRBJ1-5
TGTGCCAGCAGCTTAGTCCCACTAAAAACGGAGAACTCCTACGAGCAGTACTTC	CASSLVPLKTENSYEQYF	TRBV11-3	TRBJ2-7
TGCGCCAGCAGCTTATACACACCCGACCTCGGCAATCAGCCCCAGCATTTT	CASSLYTPDLGNQPQHF	TRBV5-1	TRBJ1-5
TGTGCCAGCAGCTTAGTATACGTTTATTCCAGTATAGATACGCAGTATTTT	CASSLVYVYSSIDTQYF	TRBV11-3	TRBJ2-3
TGTGCCAGCAAGCTCCTGGGGAGACGGGATTCACCCCTCCACTTT	CASKLLGRRDSPLHF	TRBV9	TRBJ1-6
TGTGCCAGCAGCAAAGGGGGGAATGGCTACACCTTC	CASSKGGNGYTF	TRBV13	TRBJ1-2
TGTGCCAGCAGCTTAACGGATGAACCTGACAGGGGTCGGGAGCTGTTTTTT	CASSLTDEPDRGRELFF	TRBV7-3	TRBJ2-2
TGTGCCAGCAGCCGGTCTACGGACAGGGAGGAAACTAATGAAAAACTGTTTTTT	CASSRSTDREETNEKLFF	TRBV3-1	TRBJ1-4
TGTGCCAGCAGCATTAGATCGGTCTCTGGAAACACCATATATTTT	CASSIRSVSGNTIYF	TRBV6-2	TRBJ1-3
TGCAGTGTTCTTCTAGCGGGGGAGACCCAGTACTTC	CSVLLAGETQYF	TRBV20-1	TRBJ2-5
TGTGCCAGCAGTTATCCCAGGCCCTACGAGCAGTACTTC	CASSYPRPYEQYF	TRBV6-5	TRBJ2-7
TGTGCCAGCAGCTCATCCGTTATGGGGGACAGGTGGTGGAACACCGGGGAGCTGTTTTTT	CASSSSVMGDRWWNTGELFF	TRBV7-2	TRBJ2-2
TGCGCCAGCAGCTTTGAGGGGCAAGAGACCCAGTACTTC	CASSFEGQETQYF	TRBV5-1	TRBJ2-5
TGCGCCAGCAGCCAAGTGATTATTGGACAGGAGAACACTGAAGCTTTCTTT	CASSQVIIGQENTEAFF	TRBV4-3	TRBJ1-1
TGTGCCAGCAGTACGTCAACAGGGGGCGTTCTGTATGGCTACACCTTC	CASSTSTGGVLYGYTF	TRBV25-1	TRBJ1-2
TGTGCCAGTAGTAGGTTCTTACCATTACGCTACGAGCAGTACTTC	CASSRFLPLRYEQYF	TRBV19	TRBJ2-7
TGTGCCAGCAGCGGGGGGGGGTGTAACTATGGCTACACCTTC	CASSGGGCNYGYTF	TRBV7-9	TRBJ1-2
TGCGCCAGCAGCCAACCTGGGACAGTAACTAACTATGGCTACACCTTC	CASSQPGTVTNYGYTF	TRBV4-1	TRBJ1-2
TGTGCCAGCAGCCACGCAGGGGATTCCCGTTGCGCTGAAGCTTTCTTT	CASSHAGDSRCAEAFF	TRBV14	TRBJ1-1
TGTGCCAGCAGCTGCCGGACAGGGGGATGTAATGAAAAACTGTTTTTT	CASSCRTGGCNEKLFF	TRBV7-2	TRBJ1-4
TGCAGTGCTCCATCGGCCCGGGGGGACTGGAACACTGAAGCTTTCTTT	CSAPSARGDWNTEAFF	TRBV20-1	TRBJ1-1
TGTGCCAGCAGTGCACAGACGCTTACAGATACGCAGTATTTT	CASSAQTLTDTQYF	TRBV27	TRBJ2-3
TGCGCCAGCAGTGAGTCATGTCCAGCCAAAAACATTCAGTACTTC	CASSESCPAKNIQYF	TRBV10-1	TRBJ2-4
TGTGCCAGCAGCGTAAGGTTACACAACTATGGCTACACCTTC	CASSVRLHNYGYTF	TRBV9	TRBJ1-2
TGTGCCAGCTCAACCCCCAGGGAAGCGGAGCTGTTTTTT	CASSTPREAELFF	TRBV6-4	TRBJ2-2
TGTGCCAGCAGCTTCCCGGGTTTGGGCCCTAGCACAGATACGCAGTATTTT	CASSFPGLGPSTDTQYF	TRBV7-3	TRBJ2-3
TGTGCCAGTAGTATAGTCCCGGCGAGCCCGTACAATGAGCAGTTCTTC	CASSIVPASPYNEQFF	TRBV19	TRBJ2-1
TGTGCCACCAGTGATTTTCGAGTGACAGATTGCTATGGCTACACCTTC	CATSDFRVTDCYGYTF	TRBV24-1	TRBJ1-2
TGCAGCGTTGAAGGAATTAGGCTAGCGGGGGCCACCGGGGAGCTGTTTTTT	CSVEGIRLAGATGELFF	TRBV29-1	TRBJ2-2
TGTGCCACCAGCCGGGGGACAGGGCTTTCTCGCTACGAGCAGTACTTC	CATSRGTGLSRYEQYF	TRBV24-1	TRBJ2-7
TGTGCCAGTAGTATACCGGGACGGGACAGCAATGAGCAGTTCTTC	CASSIPGRDSNEQFF	TRBV19	TRBJ2-1
TGTGCCAGCAGCTTCGGAGGGGGGAACACCGGGGAGCTGTTTTTT	CASSFGGGNTGELFF	TRBV13	TRBJ2-2
TGTGCCTTACCAATGGGTAGCAATCAGCCCCAGCATTTT	CALPMGSNQPQHF	TRBV11-2	TRBJ1-5
TGTGCCAGCAGCTACGGTCTCGTTTCCGCCTACGAGCAGTACTTC	CASSYGLVSAYEQYF	TRBV7-9	TRBJ2-7
TGCAGTGCTAGACTCCCAGGCAACAATCAGCCCCAGCATTTT	CSARLPGNNQPQHF	TRBV20-1	TRBJ1-5
TGTGCCAGTAGGAGGGCCGGCTACGAGCAGTACTTC	CASRRAGYEQYF	TRBV19	TRBJ2-7
TGCAGCGTACCTTCTGGGGGGCCCGCAGGGGTCCGGGGATTTCGGGAAATCGCCCAGTACTTC	CSVPSGGPAGVRGFREIAQYF	TRBV29-1	TRBJ2-5
TGTGCCAGCAGCTTTGGGACAGGGAACACTGAAGCTTTCTTT	CASSFGTGNTEAFF	TRBV13	TRBJ1-1
TGTGCCAGCAGCGTATATCCGGGACAGTGCGTCTGGAGCACAGATACGCAGTATTTT	CASSVYPGQCVWSTDTQYF	TRBV9	TRBJ2-3
TGTGCCAGCGGTGTTCGTCAGGGGGCAGCGGGAAGCAGGGATGAGCAGTTCTTC	CASGVRQGAAGSRDEQFF	TRBV25-1	TRBJ2-1
TGTGCCAGCAGTTTGCTCGGGGTTATGAACAATCAGCCCCAGCATTTT	CASSLLGVMNNQPQHF	TRBV12-4	TRBJ1-5
TGTGCCAGCAGGGGGATCCCGGGAGACTACAATGAGCAGTTCTTC	CASRGIPGDYNEQFF	TRBV6-4	TRBJ2-1
TGTGCCAGCAGCCAAGATTACCTAACTGGGGCCAACGTCCTGACTTTC	CASSQDYLTGANVLTF	TRBV14	TRBJ2-6
TGTGCCAGCAGTTTATACTGGGGGGCCAGGCAGTTCTTC	CASSLYWGARQFF	TRBV28	TRBJ2-1
TGCGCCAGCAGCTTGGCCCCCGGGACGGACTACGAGCAGTACTTC	CASSLAPGTDYEQYF	TRBV5-1	TRBJ2-7
TGTGCCAGCAGTAGTCGTGGGGGGCCTCCGAGCTCTGGAAACACCATATATTTT	CASSSRGGPPSSGNTIYF	TRBV12-3	TRBJ1-3
TGCGCCAGCAGTGAGTCGGCCGGGAGCGGCCTGCAGTTCTTC	CASSESAGSGLQFF	TRBV10-2	TRBJ2-1
TGCGCCAGCAGCCGGGGGCGTAGAAACTATGGCTACACCTTC	CASSRGRRNYGYTF	TRBV5-1	TRBJ1-2
TGTGCCAGCAGTTTCCTCCCCGAGCGGGAACTCTCTGGAAACACCATATATTTT	CASSFLPERELSGNTIYF	TRBV27	TRBJ1-3
TGTGCCAGCAGCGACGGAGATCAGCCCCAGCATTTT	CASSDGDQPQHF	TRBV6-6	TRBJ1-5
TGTGCCAGCAGCACAGGGTGCGAGCAGTACTTC	CASSTGCEQYF	TRBV5-4	TRBJ2-7
TGTGCCAGCAGTACCGTCGGACAGAATGAAAAACTGTTTTTT	CASSTVGQNEKLFF	TRBV27	TRBJ1-4
TGTGCCAGCAGTGGCCCGGGACAGGGTGACATTCAGTACTTC	CASSGPGQGDIQYF	TRBV28	TRBJ2-4
TGTGCCAGCAGCCTCTTTGAGGGAACTTATGGCTACACCTTC	CASSLFEGTYGYTF	TRBV5-6	TRBJ1-2
TGCGCCAGCAGCCAACGACTAGCTGGGAGCACAGATACGCAGTATTTT	CASSQRLAGSTDTQYF	TRBV4-1	TRBJ2-3
TGTGCCAGCAGTTACTCCTTCTCGGGACCCATTCAGTACTTC	CASSYSFSGPIQYF	TRBV6-6	TRBJ2-4
TGTGCCAGCCCCCGGAGGGGGACCTTAAATGAAAAACTGTTTTTT	CASPRRGTLNEKLFF	TRBV27	TRBJ1-4
TGTGCCAGCAGCGTAATGGCGAGGGGGCAAATCAAAAACATTCAGTACTTC	CASSVMARGQIKNIQYF	TRBV9	TRBJ2-4
TGTGCCAGCAGCCGTGCTCCGGGACAGGACTCTGGGGCCAACGTCCTGACTTTC	CASSRAPGQDSGANVLTF	TRBV3-1	TRBJ2-6
TGTGCCAGCAGGGGGAAAGCGGGGGGGAAGAGGTCCTACAATGAGCAGTTCTTC	CASRGKAGGKRSYNEQFF	TRBV6-4	TRBJ2-1
TGTGCCACCATTCGGACAGTGCTACACAACCAGTTGCTGTTTTTT	CATIRTVLHNQLLFF	TRBV24-1	TRBJ1-4
TGTGCCAGCGCCAAGCTTAGGACCGGGGGCAATCAGCCCCAGCATTTT	CASAKLRTGGNQPQHF	TRBV2	TRBJ1-5
TGTGCCAGCAGCTCAGGTAGGGACAGTAGTAGAGGCTACACCTTC	CASSSGRDSSRGYTF	TRBV7-8	TRBJ1-2
TGCGCCAGCAGTGAGTTCCAGATAGTCATTAGGGGAGGTCATGAGCAGTTCTTC	CASSEFQIVIRGGHEQFF	TRBV10-1	TRBJ2-1
TGCGCCAGCAGCCTTCCGCCCGGACAGGGCCCAAAAGAGACCCAGTACTTC	CASSLPPGQGPKETQYF	TRBV4-1	TRBJ2-5
TGTGCCAGCAGCTTAGCTCTCAGAGCCCGATACTTT	CASSLALRARYF	TRBV7-9	TRBJ1-1
TGTGCCATCAGTGATCACACAGGGGGCTACACCTTC	CAISDHTGGYTF	TRBV10-3	TRBJ1-2
TGCAGTGCATGCAGGGGTCCTTCACCCCTCCACTTT	CSACRGPSPLHF	TRBV20-1	TRBJ1-6
TGTGCCAGCAGCCACCGAGTCTCAAATGAGCAGTTCTTC	CASSHRVSNEQFF	TRBV7-4	TRBJ2-1
TGTGCCAGACCCACTCTGAGGGCATACGAGCAGTACTTC	CARPTLRAYEQYF	TRBV6-5	TRBJ2-7
TGTGCCAGCAGCAAGGATTGGTACACTACCTATAGCAATCAGCCCCAGCATTTT	CASSKDWYTTYSNQPQHF	TRBV7-2	TRBJ1-5
TGCGCCAGCGGTGGGGGGGTCTCCTACAATGAGCAGTTCTTC	CASGGGVSYNEQFF	TRBV5-1	TRBJ2-1
TGTGCCAGCAGCCATATCCGAGGGAGCTCTGGAAACACCATATATTTT	CASSHIRGSSGNTIYF	TRBV11-2	TRBJ1-3
TGTGCTAGTGGGACCGGGACTAGCTACGAGCAGTACTTC	CASGTGTSYEQYF	TRBV12-5	TRBJ2-7
TGTGCCAGCAGCCCGGGACTAGCGGAGCTCTACAATGAGCAGTTCTTC	CASSPGLAELYNEQFF	TRBV11-2	TRBJ2-1
TGTGCCAGCAGTTACGAGGGTTCGGGACTAGCTCTCACAGATACGCAGTATTTT	CASSYEGSGLALTDTQYF	TRBV6-5	TRBJ2-3
TGTGCCACCAGTGAGGGGAGGGGGACGAGGGGCAATCAGCCCCAGCATTTT	CATSEGRGTRGNQPQHF	TRBV24-1	TRBJ1-5
TGTGCCAGCAGTACCCTCGATACAATAAGGGTAGGCTACACCTTC	CASSTLDTIRVGYTF	TRBV6-2	TRBJ1-2
TGTGCCAGCAGCTTCGGAAGAACCTCCTATAATTCACCCCTCCACTTT	CASSFGRTSYNSPLHF	TRBV7-6	TRBJ1-6
TGTGCCAGTAGACAGGGATATCTCGGCAATCAGCCCCAGCATTTT	CASRQGYLGNQPQHF	TRBV19	TRBJ1-5
TGTGCCAGCACCCCCCGACTAGCGGGGAACGAGACCCAGTACTTC	CASTPRLAGNETQYF	TRBV6-4	TRBJ2-5
TGTGCCAGCAGCACTTCTAATGCGGAGGAGAATGAGCAGTTCTTC	CASSTSNAEENEQFF	TRBV7-9	TRBJ2-1
TGTGCCAGCAGTTGGGACAGGGGGCCAGAAAAAAATGAGCAGTTCTTC	CASSWDRGPEKNEQFF	TRBV28	TRBJ2-1
TGTGCCAGCAGCCGGTTAGGGGAAGACAATGAGCAGTTCTTC	CASSRLGEDNEQFF	TRBV7-2	TRBJ2-1
TGTGCCAGGGGCCTACCGGTTCGGGATGAGCAGTTCTTC	CARGLPVRDEQFF	TRBV6-4	TRBJ2-1
TGTGCCAGCAGCTTAGCCCTCGTGAGGAACACCGGGGAGCTGTTTTTT	CASSLALVRNTGELFF	TRBV7-9	TRBJ2-2
TGCAGTGCTAGCACAGTCTCGACTAATGAAAAACTGTTTTTT	CSASTVSTNEKLFF	TRBV20-1	TRBJ1-4
TGTGCCAGCAGCCCGTTAGATCACAGGGGGGAGAGGGCCTACGAGCAGTACTTC	CASSPLDHRGERAYEQYF	TRBV6-2	TRBJ2-7
TGTGCCAGCGGGATTGGGGGGGCGCCTGTCAATGAGCAGTTCTTC	CASGIGGAPVNEQFF	TRBV25-1	TRBJ2-1
TGCGCCAGCAGCTTGTGGGGGGGGGGGAGCGAAGAAAGGGGCCGCTACGAGCAGTACTTC	CASSLWGGGSEERGRYEQYF	TRBV5-1	TRBJ2-7
TGTGCCTGGAGCACGCCAGGGGGCAAGATCTCCTACGAGCAGTACTTC	CAWSTPGGKISYEQYF	TRBV30	TRBJ2-7
TGTGCCAGCAGCTTAAAACAGAGACAGGGGTATGGCTACACCTTC	CASSLKQRQGYGYTF	TRBV7-2	TRBJ1-2
TGTGCCAGCAGCGGGCCCCGGGGGGGGCGGTCTGGAAACACCATATATTTT	CASSGPRGGRSGNTIYF	TRBV7-3	TRBJ1-3
TGTGCCACCAAGACACTCTCGTATGCCGAGCAGTACTTC	CATKTLSYAEQYF	TRBV24-1	TRBJ2-7
TGTGCCAGCAGCTTAGGCGTAACAGATCAGGAGACCCAGTACTTC	CASSLGVTDQETQYF	TRBV13	TRBJ2-5
TGTGCTAGTGGTGGAATACGGAACCTAAGCTCCTACAATGAGCAGTTCTTC	CASGGIRNLSSYNEQFF	TRBV12-5	TRBJ2-1
TGTGCCAGCAGTGACGGCGGGGGACATGGCTACACCTTC	CASSDGGGHGYTF	TRBV6-1	TRBJ1-2
TGTGCCTGGAGTGCCGGCATCCTCGAAAAACTGTTTTTT	CAWSAGILEKLFF	TRBV30	TRBJ1-4
TGCAGTGCTCCGGTAACAGGGACACACACCATATATTTT	CSAPVTGTHTIYF	TRBV20-1	TRBJ1-3
TGCACGTTCAGGAGGGAAGTCAACACTGAAGCTTTCTTT	CTFRREVNTEAFF	TRBV20-1	TRBJ1-1
TGTGCCAGCAGCTTCTCCTCAGGGAGTAGAGCTTTCTTT	CASSFSSGSRAFF	TRBV5-6	TRBJ1-1
TGCAGCGATTACCTTGGGTGGGACTATGGCTACACCTTC	CSDYLGWDYGYTF	TRBV29-1	TRBJ1-2
TGTGCCAGCAGCTTAATGGGCCCGTATGGGGGCGAGCAGTACTTC	CASSLMGPYGGEQYF	TRBV7-3	TRBJ2-7
TGTGCCAGCAGCAGAATACAGGGTGGTGGCTACACCTTC	CASSRIQGGGYTF	TRBV7-4	TRBJ1-2
TGTGCCAGCAGCCAAGCCGTGCGGGCGCGTGGGTTATATGGCTACACCTTC	CASSQAVRARGLYGYTF	TRBV14	TRBJ1-2
TGTGCCACCAGGGAATCCTGGGACCACTATAACTATGGCTACACCTTC	CATRESWDHYNYGYTF	TRBV24-1	TRBJ1-2
TGCGCCAGCAGCCAAGATGCGAGACCCACAGATACGCAGTATTTT	CASSQDARPTDTQYF	TRBV4-1	TRBJ2-3
TGTGCCAGCAGTTACGGGGAAAAATCCTACGAGCAGTACTTC	CASSYGEKSYEQYF	TRBV12-3	TRBJ2-7
TGTGCCAGCAGTTTAGCAATCCTCCATATGAGTGCACCGGGGGCCGGGGCCGGGGAGCTGTTTTTT	CASSLAILHMSAPGAGAGELFF	TRBV12-4	TRBJ2-2
TGTGCCAGCAGGGCCAGATGGGACGTTGGAACCTCCTACGAGCAGTACTTC	CASRARWDVGTSYEQYF	TRBV6-2	TRBJ2-7
TGTGCCAGCAGTTATCTTAGGGAAGGTGGACAGATAGAGACCCAGTACTTC	CASSYLREGGQIETQYF	TRBV6-2	TRBJ2-5
TGTGCCAGCAGTTACTCGGGGAACACAGGTGACGAGCAGTACTTC	CASSYSGNTGDEQYF	TRBV6-5	TRBJ2-7
TGTGCCAGCAGTCTACGATGCCCCGCGCTCACAGATACGCAGTATTTT	CASSLRCPALTDTQYF	TRBV27	TRBJ2-3
TGTGCCAGCAGCTTTCGGGCCGGAAAAACCTACGAGCAGTACTTC	CASSFRAGKTYEQYF	TRBV7-3	TRBJ2-7
TGCAGGGAGTCGATAGACAGGGACTACGAGCAGTACTTC	CRESIDRDYEQYF	TRBV20-1	TRBJ2-7
TGTGCCAGCAGTGATACCGTGGCTAGCGGGCGAAACACCGGGGAGCTGTTTTTT	CASSDTVASGRNTGELFF	TRBV6-4	TRBJ2-2
TGTGCCAGCAGCGTCGGCCGGGACAGGGGGCGGATCGGGGGACCGTTCTTT	CASSVGRDRGRIGGPFF	TRBV9	TRBJ1-1
TGTGCCAGCAGCTGTGGGGCCTTAGATACGCAGTATTTT	CASSCGALDTQYF	TRBV13	TRBJ2-3
TGCAGCGGCTCGACTAAAGTCTACGAGCAGTACTTC	CSGSTKVYEQYF	TRBV29-1	TRBJ2-7
TGTGCCAGCAGCCACCGTCCGGGCCGGAACAGGGGGCAATGTGGCTACACCTTC	CASSHRPGRNRGQCGYTF	TRBV14	TRBJ1-2
TGCAGTGCTCCGACCATACTAGGCACAGATACGCAGTATTTT	CSAPTILGTDTQYF	TRBV20-1	TRBJ2-3
TGTGCCAGCAGCTTAGATGTGGGGGGGCATATTTTTGAGACCCAGTACTTC	CASSLDVGGHIFETQYF	TRBV11-3	TRBJ2-5
TGCAGCGTTGGACTAGCAGATTCACTTGCTCGGGGCACAGATACGCAGTATTTT	CSVGLADSLARGTDTQYF	TRBV29-1	TRBJ2-3
TGTGCCAGCAGTTTATGGGGGTTGGGACAGTTGGGGGGCAATCAGCCCCAGCATTTT	CASSLWGLGQLGGNQPQHF	TRBV28	TRBJ1-5
TGTGCCAGCAGCTTCAAGACTTCCGTCGCTTTCTTT	CASSFKTSVAFF	TRBV5-4	TRBJ1-1
TGTGCCACCAGTGATTTGGCGGGCCCGGGACTAGCGGAGTCGGGGTACTTC	CATSDLAGPGLAESGYF	TRBV24-1	TRBJ2-7
TGTGCCAGCAGCGGACAGCAGGGCACAGATACGCAGTATTTT	CASSGQQGTDTQYF	TRBV7-7	TRBJ2-3
TGTGCCAGCAGGATGGGGCTCTCCAAAAACATTCAGTACTTC	CASRMGLSKNIQYF	TRBV6-5	TRBJ2-4
TGCGCCAGCAGCCTATCGACAGGGGGCCGACCTACCTACAATGAGCAGTTCTTC	CASSLSTGGRPTYNEQFF	TRBV5-1	TRBJ2-1
TGTGCCAGCAGGAGGGATCAGCCCCAGCATTTT	CASRRDQPQHF	TRBV6-6	TRBJ1-5
TGTGCCAGCAGCTCCGGAGAGTACAATGAGCAGTTCTTC	CASSSGEYNEQFF	TRBV7-6	TRBJ2-1
TGTGCCAGTAGTATTGACAGGGATTATAGCAATCAGCCCCAGCATTTT	CASSIDRDYSNQPQHF	TRBV19	TRBJ1-5
TGCAGCGTTGAGAGGTGGATGAACACTGAAGCTTTCTTT	CSVERWMNTEAFF	TRBV29-1	TRBJ1-1
TGCAGTGCTGTCCGGGACAGGGGTATTCAAGAGACCCAGTACTTC	CSAVRDRGIQETQYF	TRBV20-1	TRBJ2-5
TGTGCCAGCAGCTATGGCGCAGGGACAGATACGCAGTATTTT	CASSYGAGTDTQYF	TRBV13	TRBJ2-3
TGTGCTCTAGCGGGCCAAAACGAGCAGTACTTC	CALAGQNEQYF	TRBV6-5	TRBJ2-7
TGTGCCAGCAGTCATGGCACCATATATTTT	CASSHGTIYF	TRBV6-5	TRBJ1-3
TGTGCCAGCAGCGACCTCATTGGGACCCGGGGGTCACCCCTCCACTTT	CASSDLIGTRGSPLHF	TRBV7-9	TRBJ1-6
TGTGCCAGTAGTATAGCCGGAAGGGGGGGAACTAACTATGGCTACACCTTC	CASSIAGRGGTNYGYTF	TRBV19	TRBJ1-2
TGTGCCAGCTCGACGACCTACGGGGGGCCAGAAAGAGCAGGGCTTCCCGATACGCAGTATTTT	CASSTTYGGPERAGLPDTQYF	TRBV6-4	TRBJ2-3
TGTGCCAGCAGCGTAGATTATGGGCCCATACAAGAGACCCAGTACTTC	CASSVDYGPIQETQYF	TRBV9	TRBJ2-5
TGTGCTAGCAGCACGCACAGGGTTACAGATACGCAGTATTTT	CASSTHRVTDTQYF	TRBV7-7	TRBJ2-3
TGTGCCAGCAGCAGTCTGCCTAGCCACTACGAGCAGTACTTC	CASSSLPSHYEQYF	TRBV11-2	TRBJ2-7
TGCAGCGTTACCCAACCGACAGGGGCCAATCAGCCCCAGCATTTT	CSVTQPTGANQPQHF	TRBV29-1	TRBJ1-5
TGTGCCAGCAGCTTAAGTAAGGACAGGGGGTCCTACGAGCAGTACTTC	CASSLSKDRGSYEQYF	TRBV7-9	TRBJ2-7
TGTGCCATCAGTACAAGAAGAGTAGGATCCTCGGAGAATCAGCCCCAGCATTTT	CAISTRRVGSSENQPQHF	TRBV10-3	TRBJ1-5
TGTGCCAGCAGCTTACGGGACCAGACCCAGTACTTC	CASSLRDQTQYF	TRBV9	TRBJ2-5
TGTGCCAGCACTCTCCTGAGACAGGGGGGCAGCACAGATACGCAGTATTTT	CASTLLRQGGSTDTQYF	TRBV6-8	TRBJ2-3
TGTGCCAGCAACCAGTGGATCTATCCGACGAACACCGGGGAGCTGTTTTTT	CASNQWIYPTNTGELFF	TRBV5-6	TRBJ2-2
TGCGCCAGCAGGGGGGCGGGGGGGGAAGAGGGGGGCAATCAGCCCCAGCATTTT	CASRGAGGEEGGNQPQHF	TRBV5-1	TRBJ1-5
TGTGCCACCAGCAGGACAGCATGCAATCAGCCCCAGCATTTT	CATSRTACNQPQHF	TRBV15	TRBJ1-5
TGTGCCAGCAGCTTAGGCGATTGGGCCAATCAGCCCCAGCATTTT	CASSLGDWANQPQHF	TRBV7-3	TRBJ1-5
TGTGCCAGCAGTGAATCGTATAGGGGTGAGCAGTTCTTC	CASSESYRGEQFF	TRBV6-1	TRBJ2-1
TGTGCCTATAGGGGCCACGAGCAGTACTTC	CAYRGHEQYF	TRBV6-6	TRBJ2-7
TGCGCCAGCAGCTTGAGAAATACAGATACGCAGTATTTT	CASSLRNTDTQYF	TRBV5-1	TRBJ2-3
TGTGCCAGCATACTTGTCGCGGGACAGGGATCCCAAGAGACCCAGTACTTC	CASILVAGQGSQETQYF	TRBV9	TRBJ2-5
TGTGCCAGCAGCTTGTCCGACTTCCAGCCCCAGCATTTT	CASSLSDFQPQHF	TRBV7-3	TRBJ1-5
TGTGCCAGCAGCTTAGGAGGGCCTTACTTAGGGCGCGGGGAGCTGTTTTTT	CASSLGGPYLGRGELFF	TRBV7-6	TRBJ2-2
TGTGCCAGCAGCGGTCAAGCCAGGGCCCGGGAGGGCTACACCTTC	CASSGQARAREGYTF	TRBV5-4	TRBJ1-2
TGTGCCAGCAGTGAACGCCCGGGACACTACTATGGCTACACCTTC	CASSERPGHYYGYTF	TRBV6-1	TRBJ1-2
TGCAGCGTTGAGAGGGGGGGGGGGGAGACCCAGTACTTC	CSVERGGGETQYF	TRBV29-1	TRBJ2-5
TGTGCCAGCAGTTACCACCCTGGACAGAGGACTGAAGCTTTCTTT	CASSYHPGQRTEAFF	TRBV6-6	TRBJ1-1
TGCGCCAGCTTAGATCGGGGTGGCTACACCTTC	CASLDRGGYTF	TRBV10-1	TRBJ1-2
TGTGCCAGCAGTGTTCCGGGACAAGACTCTGGAAACACCATATATTTT	CASSVPGQDSGNTIYF	TRBV6-1	TRBJ1-3
TGTGCCAGCAGAGAATTGCGGGACCCCTACGAGCAGTACTTC	CASRELRDPYEQYF	TRBV6-1	TRBJ2-7
TGTGCCAGCAGAGACCTCCGACAGGTAATTCTAGCCAAAAACATTCAGTACTTC	CASRDLRQVILAKNIQYF	TRBV12-3	TRBJ2-4
TGCGCCAGCAGGTATGAGGACAGACGAATGGTCACTAATGAAAAACTGTTTTTT	CASRYEDRRMVTNEKLFF	TRBV10-1	TRBJ1-4
TGCAGTGCGTCCAGGGGGCTCTACGAGCAGTACTTC	CSASRGLYEQYF	TRBV20-1	TRBJ2-7
TGTGCCAGCAGTTGGGACAGGGGGAGATACAGACAGCCCCAGCATTTT	CASSWDRGRYRQPQHF	TRBV6-9	TRBJ1-5
TGTGCCAGCAGCTGCGCGCCAGGGGAGGGTAACTATGGCTACACCTTC	CASSCAPGEGNYGYTF	TRBV7-3	TRBJ1-2
TGTGCCAGCAGTTACTCTAAGAAAGGGAACTATGGCTACACCTTC	CASSYSKKGNYGYTF	TRBV6-8	TRBJ1-2
TGTGCCAGCAGCTCAGCTGGGGACAAGAAGACGGCCCGCAATCAGCCCCAGCATTTT	CASSSAGDKKTARNQPQHF	TRBV7-9	TRBJ1-5
TGTGCCACCATAGGGGGGGCGAGTCACTACGAGCAGTACTTC	CATIGGASHYEQYF	TRBV24-1	TRBJ2-7
TGTGCCACCAGTGAGCAGGGGGGTACAGGTCAGCCCCAGCATTTT	CATSEQGGTGQPQHF	TRBV24-1	TRBJ1-5
TGTGCCAGCAGAACAGGGCCAAATGAGCAGTTCTTC	CASRTGPNEQFF	TRBV6-3	TRBJ2-1
TGTGCCAGCAGTGCGAAAAAGCGTACGCAGTATTTT	CASSAKKRTQYF	TRBV6-1	TRBJ2-3
TGCGCCAGCAGCTTGGTCTCCGGGGACCTGCGACAGCCTGAAGCTTTCTTT	CASSLVSGDLRQPEAFF	TRBV5-1	TRBJ1-1
TGTGCCAGACTAGCGCAGTCACCCTACGAGCAGTACTTC	CARLAQSPYEQYF	TRBV7-3	TRBJ2-7
TGTGCCAGCAGCTTAGTCGAGGGTCTATTTGGGACGAACACCGGGGAGCTGTTTTTT	CASSLVEGLFGTNTGELFF	TRBV7-3	TRBJ2-2
TGTGCCAGCAGTTACTGGGGTAGCCGGGACAGGGACTCAAACACTGAAGCTTTCTTT	CASSYWGSRDRDSNTEAFF	TRBV6-6	TRBJ1-1
TGTGCGGAAACGGGGGGGGCCAGCCCCCGCACAGATACGCAGTATTTT	CAETGGASPRTDTQYF	TRBV2	TRBJ2-3
TGTGCCACCAGTGATTGGGGGACGACCGTTCAGCCCCAGCATTTT	CATSDWGTTVQPQHF	TRBV24-1	TRBJ1-5
TGTGCCAGCAGTTGTCAGCTAGCCAAAAACATTCAGTACTTC	CASSCQLAKNIQYF	TRBV6-4	TRBJ2-4
TGTGCCAGCAGACCCCAGGGACAGGTGACAACTAATGAAAAACTGTTTTTT	CASRPQGQVTTNEKLFF	TRBV5-6	TRBJ1-4
TGTGCTAGCAGCGGCCAGGGGAAGGGCTACGAGCAGTACTTC	CASSGQGKGYEQYF	TRBV7-7	TRBJ2-7
TGTGCCAGCAGCAAGGGGGGCTCCTACGAGCAGTACTTC	CASSKGGSYEQYF	TRBV27	TRBJ2-7
TGTGCCAGCAGCAAATTGGGACTAGCGGGCTATAGGGAAGTGGCGAGGGATGAGCAGTTCTTC	CASSKLGLAGYREVARDEQFF	TRBV7-9	TRBJ2-1
TGTGCCAGCAGTGACTCCTCTCCTGGAACTTCAACTAATGAAAAACTGTTTTTT	CASSDSSPGTSTNEKLFF	TRBV6-4	TRBJ1-4
TGTGCCAGCAGCGACAGGTCTAACTATGGCTACACCTTC	CASSDRSNYGYTF	TRBV9	TRBJ1-2
TGTGCCAGCACGGGAGACCTAGGGAATGACACCGGGGAGCTGTTTTTT	CASTGDLGNDTGELFF	TRBV6-2	TRBJ2-2
TGTGCCAGCAGCTTGGGCGAGGACACCGGGGAGCTGTTTTTT	CASSLGEDTGELFF	TRBV5-4	TRBJ2-2
TGTGCCAGCAGCTTAGATCCCAGGGGTCGAGTCGTGAACACTGAAGCTTTCTTT	CASSLDPRGRVVNTEAFF	TRBV7-4	TRBJ1-1
TGTGCCAGCAACCCTAGCGAGACTAGCCCGACCTACGAGCAGTACTTC	CASNPSETSPTYEQYF	TRBV12-4	TRBJ2-7
TGTGCCAGCCCACCTCCTATAGCCCACACCGGGGAGCTGTTTTTT	CASPPPIAHTGELFF	TRBV13	TRBJ2-2
TGTGCCAGTAGTTTAGGGGCGACTAGGAGGTACAATGAGCAGTTCTTC	CASSLGATRRYNEQFF	TRBV19	TRBJ2-1
TGTGCCACCAGTGATTCCGGGGGGGTTTACAATGAGCAGTTCTTC	CATSDSGGVYNEQFF	TRBV24-1	TRBJ2-1
TGTGCCAGCAGCCAAGAGAGTAACTATGGCTACACCTTC	CASSQESNYGYTF	TRBV14	TRBJ1-2
TGTGCCAATAATACCTGGGACGCGGGGGGCTACGAGCAGTACTTC	CANNTWDAGGYEQYF	TRBV6-6	TRBJ2-7
TGTGCCAGCAGCTTAGACAGGGGCCGGTCCAAAACACAAGAGACCCAGTACTTC	CASSLDRGRSKTQETQYF	TRBV11-2	TRBJ2-5
TGTGCCAGTAGTATAGGGAGCTCCTGCGAGAAGAACACTGAAGCTTTCTTT	CASSIGSSCEKNTEAFF	TRBV19	TRBJ1-1
TGTGCCAGCTCACCAGGACCGCGGGACACTGAAGCTTTCTTT	CASSPGPRDTEAFF	TRBV18	TRBJ1-1
TGCGCCAGCAGCCCCTCAAACAATTTTTCGCCGGGACTAGCTTCGAGCCAAGAGACCCAGTACTTC	CASSPSNNFSPGLASSQETQYF	TRBV4-3	TRBJ2-5
TGCGCCAGCAGCCAAGCCCCGATGCCCAGGGGGTTCTTGAATGTAGGTCGCGAGCAGTACTTC	CASSQAPMPRGFLNVGREQYF	TRBV4-1	TRBJ2-7
TGCAGTGCTGGTAGCGGGGGGGCCAACGAGCAGTACTTC	CSAGSGGANEQYF	TRBV20-1	TRBJ2-7
TGTGCCATTTGTGGGGGAGGCTATGGCTACACCTTC	CAICGGGYGYTF	TRBV10-3	TRBJ1-2
TGTGCCAGCAGCTTTGGACTAGCAGAGCAGTTCTTC	CASSFGLAEQFF	TRBV7-6	TRBJ2-1
TGTGCCAGCAGCCAACCCCAGAGGGACTGTACAGAGCAGTACTTC	CASSQPQRDCTEQYF	TRBV3-1	TRBJ2-7
TGTGCCAGCAGCATGGAAGGAGAAAGAGGTCAAGGTCGCACAGATACGCAGTATTTT	CASSMEGERGQGRTDTQYF	TRBV7-3	TRBJ2-3
TGTGCCAGCAGCGGGTACGCAGGGGAGATGAACACTGAAGCTTTCTTT	CASSGYAGEMNTEAFF	TRBV13	TRBJ1-1
TGCAGTGCTAGAGATGCCTCCGGCCAGGGGTGGATAGCCTACGAGCAGTACTTC	CSARDASGQGWIAYEQYF	TRBV20-1	TRBJ2-7
TGTGCCAGCAGCTTAGAAAGGGGCTCCTACGAGCAGTACTTC	CASSLERGSYEQYF	TRBV7-2	TRBJ2-7
TGTGCCAGCAGCCGGCAGGCGTACGAGCAGTACTTC	CASSRQAYEQYF	TRBV7-3	TRBJ2-7
TGTGCCAGCAGTCCCTACTGGAGGGGGCTGGGCAGGGATAGCCGCAATCAGCCCCAGCATTTT	CASSPYWRGLGRDSRNQPQHF	TRBV27	TRBJ1-5
TGCAGTGCGGAACCCCTTCATGGGGGGCCGGGTCAAGAGACCCAGTACTTC	CSAEPLHGGPGQETQYF	TRBV20-1	TRBJ2-5
TGTGCCACCAGTGAAACTTGTCGCACGGGGGAAATCGACACCGGGGAGCTGTTTTTT	CATSETCRTGEIDTGELFF	TRBV24-1	TRBJ2-2
TGTGCTAGCAGCTCCGCCGGGCTCACAGATACGCAGTATTTT	CASSSAGLTDTQYF	TRBV7-7	TRBJ2-3
TGTGCCAGCAGCGCCCGGCTTCGTGTTAACACCGGGGAGCTGTTTTTT	CASSARLRVNTGELFF	TRBV13	TRBJ2-2
TGTGCCAGTAGTATACAGCAGTCGGCCTACGAGCAGTACTTC	CASSIQQSAYEQYF	TRBV19	TRBJ2-7
TGTGCCAGCAGCTCAAGAAGGGGTAATGGCTACACCTTC	CASSSRRGNGYTF	TRBV9	TRBJ1-2
TGTGCCAGCAGCCCTCGGGGGCCCAAAACGAACACTGAAGCTTTCTTT	CASSPRGPKTNTEAFF	TRBV6-5	TRBJ1-1
TGTGCCAGCAGCTTATATACTAGGGGGGGGCCGCAAGAGACCCAGTACTTC	CASSLYTRGGPQETQYF	TRBV7-3	TRBJ2-5
TGTGCCAGCAGCCAAGGGCCTACCGGGACAGGGGGCACTGAAGCTTTCTTT	CASSQGPTGTGGTEAFF	TRBV4-2	TRBJ1-1
TGTGCCAGTCGAACAGGGAATTATCAGCCCCAGCATTTT	CASRTGNYQPQHF	TRBV5-6	TRBJ1-5
TGCAGCGTTGACGGACTAGCGGGCTCCTACAATGAGCAGTTCTTC	CSVDGLAGSYNEQFF	TRBV29-1	TRBJ2-1
TGTGCCAGCAGCTGGCCGGGACTAGGAACCCGGCAAGAGACCCAGTACTTC	CASSWPGLGTRQETQYF	TRBV11-2	TRBJ2-5
TGTGCCAGCAGTGAGGGCGGGACTAGCGGGCGTCTCTACGAGCAGTACTTC	CASSEGGTSGRLYEQYF	TRBV6-4	TRBJ2-7
TGTGCCAGCAGCCAAGATAACGGGAATTCTGGGGCCAACGTCCTGACTTTC	CASSQDNGNSGANVLTF	TRBV14	TRBJ2-6
TGTGCCAGCTCACCCCCGAGTAGTACCTGCCCGCAGGGGGTCATGGACGGAACTAATTCACCCCTCCACTTT	CASSPPSSTCPQGVMDGTNSPLHF	TRBV18	TRBJ1-6
TGCAGTGCTGGGGGGGGAGAGACCCAGTACTTC	CSAGGGETQYF	TRBV20-1	TRBJ2-5
TGTGCCAGCAGCGAACAGGGCGAGCAGTACTTC	CASSEQGEQYF	TRBV11-1	TRBJ2-7
TGTGCCAGCAGGACATACGAGCAGTACTTC	CASRTYEQYF	TRBV6-1	TRBJ2-7
TGTGCCAGTACCGGATCCCGAGAGACCCAGTACTTC	CASTGSRETQYF	TRBV19	TRBJ2-5
TGTGCCAGCAGCCCCCGACAGGGGGCAGACATGTCCATGAACACTGAAGCTTTCTTT	CASSPRQGADMSMNTEAFF	TRBV28	TRBJ1-1
TGTGCCATCAGTGATTTGTATAAAAGAATTTCCCACTATGGCTACACCTTC	CAISDLYKRISHYGYTF	TRBV10-3	TRBJ1-2
TGTGCCAGCAGCTTGAGGTGGACAGAAACCACAGATACGCAGTATTTT	CASSLRWTETTDTQYF	TRBV5-8	TRBJ2-3
TGTGCCAGCAGTGCCCAGCGACAGGGCTCGACAGATACGCAGTATTTT	CASSAQRQGSTDTQYF	TRBV6-4	TRBJ2-3
TGTGCCAGTAGTATCGACCGCAGCGGGACTGATACGCAGTATTTT	CASSIDRSGTDTQYF	TRBV19	TRBJ2-3
TGTGCCAGCATCCCTTGGCCGGGGACTAGCGGATTAGATCACTCCGAGCAGTACTTC	CASIPWPGTSGLDHSEQYF	TRBV6-5	TRBJ2-7
TGCAGTGCTACCGGGACAGACACTGAAGCTTTCTTT	CSATGTDTEAFF	TRBV20-1	TRBJ1-1
TGTGCCAGCAGAGCTACGGACTCTAAACCTACTGAAGCTTTCTTT	CASRATDSKPTEAFF	TRBV12-3	TRBJ1-1
TGTGCCACCTCTTTGGACCCCGCCGGGTGGAATGAGCAGTTCTTC	CATSLDPAGWNEQFF	TRBV24-1	TRBJ2-1
TGTGCCAGCAGCGCGCAAATAGGATTGGGAGAAGGCAATGAGCAGTTCTTC	CASSAQIGLGEGNEQFF	TRBV9	TRBJ2-1
TGTGCCAGCATAAATTTCACGGAAGAGCAGTTCTTC	CASINFTEEQFF	TRBV6-5	TRBJ2-1
TGTGCCAGCAGCAGGGGGGACAGGCTGTTTTTT	CASSRGDRLFF	TRBV13	TRBJ2-2
TGTGCCAGCAGCCGCCGGGACTTTGAGACCCAGTACTTC	CASSRRDFETQYF	TRBV9	TRBJ2-5
TGTGCCAGCAGCCGGGATTCCTATAATTCACCCCTCCACTTT	CASSRDSYNSPLHF	TRBV9	TRBJ1-6
TGCGCCAGCCGAGGGACCTTCGGCTACGAGCAGTACTTC	CASRGTFGYEQYF	TRBV10-1	TRBJ2-7
TGTGCCAGCAGCCAGGGCACAGGGCCCCACCGTGGTGAGACCCAGTACTTC	CASSQGTGPHRGETQYF	TRBV6-5	TRBJ2-5
TGTGCCAGCAATGAAAACCGAAAGGGTAGCGAGCAGTACTTC	CASNENRKGSEQYF	TRBV6-2	TRBJ2-7
TGTGCCAGCATGAAAGCCGGGACTAGTGAGCAGTTCTTC	CASMKAGTSEQFF	TRBV6-6	TRBJ2-1
TGTGCCAGCAGCCCACGGGGTAAACGTCCCTACGAGCAGTACTTC	CASSPRGKRPYEQYF	TRBV13	TRBJ2-7
TGTGCCAGCAGTTACTTAGGGACAGGGGGCGCTGGCTACACCTTC	CASSYLGTGGAGYTF	TRBV6-6	TRBJ1-2
TGCAGTGCTAGACCCGGGGGCCAAGAGACCCAGTACTTC	CSARPGGQETQYF	TRBV20-1	TRBJ2-5
TGTGCCAGCATAACCAGAGAGAATCAGCCCCAGCATTTT	CASITRENQPQHF	TRBV6-4	TRBJ1-5
TGTGCCAGCAGCCAAGGACCGAGGGACGAGCAGTACTTC	CASSQGPRDEQYF	TRBV3-1	TRBJ2-7
TGCAGTGCATTTATCCTTTGGGGGGCTAAGTGCACAGATACGCAGTATTTT	CSAFILWGAKCTDTQYF	TRBV20-1	TRBJ2-3
TGTGCCAGCAGTAGGACAGGGGAACGGGAGAATCCTCCAGATACGCAGTATTTT	CASSRTGERENPPDTQYF	TRBV7-3	TRBJ2-3
TGTGCCAGCAGTGGGACAGGGGGCACAGATACGCAGTATTTT	CASSGTGGTDTQYF	TRBV7-9	TRBJ2-3
TGTGCACGACCAAGACACGGGGACACCGGGGAGCTGTTTTTT	CARPRHGDTGELFF	TRBV6-5	TRBJ2-2
TGTGCCAGCAGTTTAGATTGCCGGGACATGTTTTTGAAGGCTAGCACAGATACGCAGTATTTT	CASSLDCRDMFLKASTDTQYF	TRBV12-3	TRBJ2-3
TGTGCCAGCAGCTCTAGGAGGATCGGCTACACCTTC	CASSSRRIGYTF	TRBV7-6	TRBJ1-2
TGTGCCACCAGTGATCTTGTGGGGGGCCGCAATCAGCCCCAGCATTTT	CATSDLVGGRNQPQHF	TRBV24-1	TRBJ1-5
TGCAGTGCTAGAGATGAAAGGACTAGCGGGCCCTACGAGCAGTACTTC	CSARDERTSGPYEQYF	TRBV20-1	TRBJ2-7
TGTGCCAGCAAGAGAACCTCCTACAATGAGCAGTTCTTC	CASKRTSYNEQFF	TRBV9	TRBJ2-1
TGTGCCAGGGTAGCGGGATCGAAAACCTTGAACACCGGGGAGCTGTTTTTT	CARVAGSKTLNTGELFF	TRBV9	TRBJ2-2
TGTGCCAGCAGTGACACCCTATTTTGCGGACAGTGGGCCAACGTCCTGACTTTC	CASSDTLFCGQWANVLTF	TRBV2	TRBJ2-6
TGTGCCAGCAGCTTGAAAGGGGGAGGCAACCTATACACTGAAGCTTTCTTT	CASSLKGGGNLYTEAFF	TRBV5-4	TRBJ1-1
TGTGCCAGCAGTGAAGCCCCTCGGACGGGACAGGGGGTGAGGGAAGAGACCCAGTACTTC	CASSEAPRTGQGVREETQYF	TRBV2	TRBJ2-5
TGTGCCAGCAGTGGGCTATCCCTAGACGAGCAGTACTTC	CASSGLSLDEQYF	TRBV6-5	TRBJ2-7
TGTGCCAGTGCCACTAGCAAGCCCTACGAGCAGTACTTC	CASATSKPYEQYF	TRBV19	TRBJ2-7
TGTGCCAGCTCACCCCCGGGACAGGGAAGAGATCTCAATGAGCAGTTCTTC	CASSPPGQGRDLNEQFF	TRBV18	TRBJ2-1
TGTGCCAGCAGCTTAACTATTGCGCCAACACGTAGCTACGAGCAGTACTTC	CASSLTIAPTRSYEQYF	TRBV7-3	TRBJ2-7
TGTGCCTGGAGATGGAAGGGACAGGGCTATGGCTACACCTTC	CAWRWKGQGYGYTF	TRBV30	TRBJ1-2
TGTGCCAGGCTCGGGGGGGAGGGGGCATTCTTC	CARLGGEGAFF	TRBV7-2	TRBJ2-1
TGTGCCAGCAGTGAATTGGACAGTTCAGAGACCCAGTACTTC	CASSELDSSETQYF	TRBV6-1	TRBJ2-5
TGTGCCAGCAGTGGAACCAAACCAGGGGGGGAGCTGTTTTTT	CASSGTKPGGELFF	TRBV2	TRBJ2-2
TGCGCCAGCTGTATTGTAGCGGGCGCATATCCCAATGAGCAGTTCTTC	CASCIVAGAYPNEQFF	TRBV10-1	TRBJ2-1
TGTGCCAGCAGCGTAGCCAAGACAGGGGAAAAACTGTTTTTT	CASSVAKTGEKLFF	TRBV9	TRBJ1-4
TGTGCCAGCAGTGAGAAAATCCTAGCGGGCCGCGCCTACAATGAGCAGTTCTTC	CASSEKILAGRAYNEQFF	TRBV6-1	TRBJ2-1
TGCAGTGCCCGGACTAGCGGGGGGACGACGAACACCGGGGAGCTGTTTTTT	CSARTSGGTTNTGELFF	TRBV20-1	TRBJ2-2
TGCGCCGGCGGGAGGGGTAAACTATCCTACGAGCAGTACTTC	CAGGRGKLSYEQYF	TRBV5-1	TRBJ2-7
TGCAGTCCGGATAGGGATACCTACGAGCAGTACTTC	CSPDRDTYEQYF	TRBV20-1	TRBJ2-7
TGTGCCAGCATACTAAGGGGAACTGGAAAACTGTTTTTT	CASILRGTGKLFF	TRBV27	TRBJ1-4
TGTGCCTTCCGGGGAGAGGGGACAGATACGCAGTATTTT	CAFRGEGTDTQYF	TRBV27	TRBJ2-3
TGTGCCAGCAGCCAAACGACAGGGGGGCCTCAGCCCCAGCATTTT	CASSQTTGGPQPQHF	TRBV3-1	TRBJ1-5
TGTGCCATCAGCATGTGGACAGTGGAATTGCAGTACTTC	CAISMWTVELQYF	TRBV10-3	TRBJ2-7
TGTGCCAGCAGTTTAAAGTCCAAGGGGGCGCTAACGCAGCCCCAGCATTTT	CASSLKSKGALTQPQHF	TRBV27	TRBJ1-5
TGTGCCAGCAGCGTATCCGGGGGGGCTCGTCATGAGCAGTTCTTC	CASSVSGGARHEQFF	TRBV9	TRBJ2-1
TGTGCGGGGACGGACAGGGGGTCAGGCTACACCTTC	CAGTDRGSGYTF	TRBV7-3	TRBJ1-2
TGTGCCAGCAGCCGTCACTGGACCGGCTACACCTTC	CASSRHWTGYTF	TRBV7-3	TRBJ1-2
TGCAGCGTGACCCAAGACAGGGGGCCTGGCTACACCTTC	CSVTQDRGPGYTF	TRBV29-1	TRBJ1-2
TGTGCCAGTAGTCGTACAGGGACCCCCTCCTACGAGCAGTACTTC	CASSRTGTPSYEQYF	TRBV19	TRBJ2-7
TGTGCCAGCAGCCAAGACAAACCTTGGGGGGTCCCTAATGAGCAGTTCTTC	CASSQDKPWGVPNEQFF	TRBV3-1	TRBJ2-1
TGTGCCAGCAGAGGGGTGCAGCCTTCGAGCAATCAGCCCCAGCATTTT	CASRGVQPSSNQPQHF	TRBV2	TRBJ1-5
TGTGCCAGCAGCGGTACCCCCGGACTGACAGGGGCGGGTGGCCCAGATACGCAGTATTTT	CASSGTPGLTGAGGPDTQYF	TRBV11-2	TRBJ2-3
TGTGCCAGCAGCGTAAATTCCGGGATTTTCTACGAGCAGTACTTC	CASSVNSGIFYEQYF	TRBV9	TRBJ2-7
TGTGCCAGACACGCTCACGAGCAGTACTTC	CARHAHEQYF	TRBV12-3	TRBJ2-7
TGTGCCAGCAGCTCTGGACAGGGGGGGTACCAGCCCCAGCATTTT	CASSSGQGGYQPQHF	TRBV13	TRBJ1-5
TGTGCCAGCAGTACAGGGAGCACAGATACGCAGTATTTT	CASSTGSTDTQYF	TRBV9	TRBJ2-3
TGTGCCAGCAGCGGGGGCGAAAGCACTTCGAACACTGAAGCTTTCTTT	CASSGGESTSNTEAFF	TRBV6-1	TRBJ1-1
TGTGCTAGTGGTCAGCGGGAGGAGTACGAGCAGTACTTC	CASGQREEYEQYF	TRBV12-5	TRBJ2-7
TGTGCCAGTAGTATAGGGCCCGGGGGTCCCTTCCGGATTGAGCAGTACTTC	CASSIGPGGPFRIEQYF	TRBV19	TRBJ2-7
TGTGCCAGCAGTCCGATGGACTCTCCCGCCCAGCCGGAAATCAACACTGAAGCTTTCTTT	CASSPMDSPAQPEINTEAFF	TRBV27	TRBJ1-1
TGTGCCAGCAGCCAGGGGACAGGTCCAGGAGATACGCAGTATTTT	CASSQGTGPGDTQYF	TRBV5-6	TRBJ2-3
TGTGCCAGTAGTATAGGAAATAGCGAGTTTACGCAGTATTTT	CASSIGNSEFTQYF	TRBV19	TRBJ2-3
TGTGCCAGCAGTGGCATCCCGACCCGAGTTAGCGGGAATGAGCAGTTCTTC	CASSGIPTRVSGNEQFF	TRBV6-6	TRBJ2-1
TGTGCCAGCAATTTCGACACTGAAGCTTTCTTT	CASNFDTEAFF	TRBV19	TRBJ1-1
TGCAGTGCTAGATCCCACAGGTGGAGGGTCCCTAATGAAAAACTGTTTTTT	CSARSHRWRVPNEKLFF	TRBV20-1	TRBJ1-4
TGTGCCACCAGCAGCCCAGAGACTAGCTACGAGCAGTACTTC	CATSSPETSYEQYF	TRBV15	TRBJ2-7
TGTGCCAGCAGCTTAGCACCTGAATCAGGGGGGAAGGCTCACGAGCAGTACTTC	CASSLAPESGGKAHEQYF	TRBV11-3	TRBJ2-7
TGTGCCAGTAACGATCAGCCCCAGCATTTT	CASNDQPQHF	TRBV6-5	TRBJ1-5
TGTGCCAGCAGTGACTCGTGGCAGAAAGCGGGTCGCTTACCTACAGATACGCAGTATTTT	CASSDSWQKAGRLPTDTQYF	TRBV6-4	TRBJ2-3
TGTGCCAGCAGCTATAAACAGGGGAGAGGAAAACGTAGCACAGATACGCAGTATTTT	CASSYKQGRGKRSTDTQYF	TRBV7-3	TRBJ2-3
TGTGCCAGCAGCTTGACAGCTAATCAGCCCCAGCATTTT	CASSLTANQPQHF	TRBV7-3	TRBJ1-5
TGTGCCAGCAGCCAAGAACGGGACGGAATGGAGACCCAGTACTTC	CASSQERDGMETQYF	TRBV14	TRBJ2-5
TGCAGTGCTAGAGATATGGTAGGATTGGGACCAACTAATGAAAAACTGTTTTTT	CSARDMVGLGPTNEKLFF	TRBV20-1	TRBJ1-4
TGCGCCAGCAGCCAGAAACCCGGGGACACAAAATTCTTC	CASSQKPGDTKFF	TRBV4-1	TRBJ2-1
TGTGCCAGCAAAGGTCCCGGGGGAACGTCCTACGAGCAGTACTTC	CASKGPGGTSYEQYF	TRBV27	TRBJ2-7
TGTGCCAGCAGCTTGGCCCGGACTAGCGGCTCCTCGTACCAAGAGACCCAGTACTTC	CASSLARTSGSSYQETQYF	TRBV7-8	TRBJ2-5
TGCGCCAGCAGCCAAACCCGGGGGACTAGCGGGGGGAGGGCCTACGAGCAGTACTTC	CASSQTRGTSGGRAYEQYF	TRBV4-3	TRBJ2-7
TGCAGTGGGGGCCGGGACAGGGGTCCCCTCACTGAAGCTTTCTTT	CSGGRDRGPLTEAFF	TRBV20-1	TRBJ1-1
TGTGCCAGCAGGGACAAATCTGCGCAGTATTTT	CASRDKSAQYF	TRBV6-4	TRBJ2-3
TGTGCCAGCAGCGTGTTCCATCACTCCAGGGCGGCGAACACCGGGGAGCTGTTTTTT	CASSVFHHSRAANTGELFF	TRBV7-9	TRBJ2-2
TGTGCCAGCCCCCCCGACACAGGGGCGGACACTGAAGCTTTCTTT	CASPPDTGADTEAFF	TRBV27	TRBJ1-1
TGTGCCAGCAGCTTAGGTCAGGGGATGTATGGCTACACCTTC	CASSLGQGMYGYTF	TRBV7-2	TRBJ1-2
TGCGCCAGCAGCCCAGGAAGGACTGAAGCTTTCTTT	CASSPGRTEAFF	TRBV10-1	TRBJ1-1
TGTGCCAGCAGTCTGAACATTTCTGAAAAACTGTTTTTT	CASSLNISEKLFF	TRBV6-4	TRBJ1-4
TGCAGCGTTGGACAAACAGGGGGTGAGCAGTTCTTC	CSVGQTGGEQFF	TRBV29-1	TRBJ2-1
TGTGCCAGCAGCCGAGGGAGGGAGCAGTACTTC	CASSRGREQYF	TRBV3-1	TRBJ2-7
TGTGCCAGCAGCGGGGGGGGGGGCAACACTGAAGCTTTCTTT	CASSGGGGNTEAFF	TRBV13	TRBJ1-1
TGCAGTGCTAGAGTTGCGTGGGACAGGAACCCAGCTTTCTTT	CSARVAWDRNPAFF	TRBV20-1	TRBJ1-1
TGTGCCACCAGTGATTCGTCCGGGGGCGCCTCCTACGAGCAGTACTTC	CATSDSSGGASYEQYF	TRBV24-1	TRBJ2-7
TGTGCCAGCAGCACAGGGGATTCTGTCACAGATACGCAGTATTTT	CASSTGDSVTDTQYF	TRBV7-3	TRBJ2-3
TGTGCCAGCAGCCCCCACGATTGGGGCAATGAAAAACTGTTTTTT	CASSPHDWGNEKLFF	TRBV11-1	TRBJ1-4
TGTGCCAGCAGCTTGGTCCCGCACGAGGGCCCAAAGGAGACCCAGTACTTC	CASSLVPHEGPKETQYF	TRBV7-2	TRBJ2-5
TGTGCCAGCAGGAGGCCCGGGAATCAGCCCCAGCATTTT	CASRRPGNQPQHF	TRBV12-3	TRBJ1-5
TGTGCCAGCAGTTTGAAAAGGGGGCACCCTAATGAAAAACTGTTTTTT	CASSLKRGHPNEKLFF	TRBV6-5	TRBJ1-4
TGTGCCAGCAGCCAAGGGTTTATGGACAGGCGGTACGAGCAGTACTTC	CASSQGFMDRRYEQYF	TRBV14	TRBJ2-7
TGTGCCAGCAGCTTACCGGACAGGTATAATTCACCCCTCCACTTT	CASSLPDRYNSPLHF	TRBV7-2	TRBJ1-6
TGTGCCAGCAACAATCCCGAGGGTAATGAAAAACTGTTTTTT	CASNNPEGNEKLFF	TRBV2	TRBJ1-4
TGCAGTGCTAGGGCCCTCGCGTACAATGAGCAGTTCTTC	CSARALAYNEQFF	TRBV20-1	TRBJ2-1
TGCGCCAGCAGCTTGGGGACCGAGACAGATACGCAGTATTTT	CASSLGTETDTQYF	TRBV5-1	TRBJ2-3
TGTGCCATCAGTGACCCCCTGGCAAATGAGCAGTTCTTC	CAISDPLANEQFF	TRBV10-3	TRBJ2-1
TGCGCCAGCAGCCAAGCTCCCTGTAGGGCCCCTAATTTAATGAACACTGAAGCTTTCTTT	CASSQAPCRAPNLMNTEAFF	TRBV4-3	TRBJ1-1
TGTGCCAGCAAAACCGGGACAGGGGGGAGTCCGCACAATCAGCCCCAGCATTTT	CASKTGTGGSPHNQPQHF	TRBV28	TRBJ1-5
TGTGCCAGGGCCGGGACAGGTGGGGTGGAAAAACTGTTTTTT	CARAGTGGVEKLFF	TRBV19	TRBJ1-4
TGCAGTGCTAGAGATCACCGAGTCCAAAATGGTTACAAAAACATTCAGTACTTC	CSARDHRVQNGYKNIQYF	TRBV20-1	TRBJ2-4
TGCGCCAGCAGCGGCCCGGCCTCAGGGGCGCTTTCGTGGCAAGAGACCCAGTACTTC	CASSGPASGALSWQETQYF	TRBV5-1	TRBJ2-5
TGTGCCAGCAGTGACCCCCCGAAGGGGAACACTGAAGCTTTCTTT	CASSDPPKGNTEAFF	TRBV6-4	TRBJ1-1
TGTGCCAGCCCGGACAGGGGACACTACGAGCAGTACTTC	CASPDRGHYEQYF	TRBV6-2	TRBJ2-7
TGTGCCACCAGTGATAGTGAGTTCGAGCAGTACTTC	CATSDSEFEQYF	TRBV24-1	TRBJ2-7
TGTGCCAGCAGAGATACGACAGCGGGCAATCAGCCCCAGCATTTT	CASRDTTAGNQPQHF	TRBV6-1	TRBJ1-5
TGCAGTGCTCTAGACGCCAAAAACATTCAGTACTTC	CSALDAKNIQYF	TRBV20-1	TRBJ2-4
TGTGCCAGCAGTGAATATCCTCGAAGGGTCGCTGGGGCCAACGTCCTGACTTTC	CASSEYPRRVAGANVLTF	TRBV25-1	TRBJ2-6
TGTGCCAGCAGTTTATTCACCGGGGGGGGCATGAACACTGAAGCTTTCTTT	CASSLFTGGGMNTEAFF	TRBV12-3	TRBJ1-1
TGTGCCCCCGCTAACTACAGCAATCAGCCCCAGCATTTT	CAPANYSNQPQHF	TRBV9	TRBJ1-5
TGTGCCAGCAGCTATACCCCCCTAGGGACAGGGGACCACGCTTTCTTT	CASSYTPLGTGDHAFF	TRBV11-3	TRBJ1-1
TGCGCCCAGCGAGTCGATGAGCAGTTCTTC	CAQRVDEQFF	TRBV5-1	TRBJ2-1
TGCGCCAGCAGCCAACCCCTCGGTATGGGGGGGCACAATGAGCAGTTCTTC	CASSQPLGMGGHNEQFF	TRBV4-1	TRBJ2-1
TGTGCCAGCAGACCGACCTTGCAGGGGGCTCAAAACAATCAGCCCCAGCATTTT	CASRPTLQGAQNNQPQHF	TRBV27	TRBJ1-5
TGTGCCAGCTCGATGGGGGCTTTCTTT	CASSMGAFF	TRBV18	TRBJ1-1
TGCGCCAGCAGCCAAGATCGACTAGCAGATACGCAGTATTTT	CASSQDRLADTQYF	TRBV4-1	TRBJ2-3
TGTGCCAGCAGAAGCGGGAGTACTGGGGCCAAAAACATTCAGTACTTC	CASRSGSTGAKNIQYF	TRBV27	TRBJ2-4
TGTGCCAGCAGTGAATGTCCGGATGAGCAGTTCTTC	CASSECPDEQFF	TRBV25-1	TRBJ2-1
TGTGCCAGCAGGGTAGACAATGAGCAGTTCTTC	CASRVDNEQFF	TRBV11-3	TRBJ2-1
TGCGCCAGCAGCCACCGGGGGGAGCTGTTTTTT	CASSHRGELFF	TRBV4-3	TRBJ2-2
TGCGCCAGCACCAGGACTGAGACCCAGTACTTC	CASTRTETQYF	TRBV10-2	TRBJ2-5
TGTGCCAGCAGCTGGTCCAGGGGGCTGCGGCCCCAGCATTTT	CASSWSRGLRPQHF	TRBV7-8	TRBJ1-5
TGTGCCAGCAGTTGGACAGGGGCTCGGGGAAACACCATATATTTT	CASSWTGARGNTIYF	TRBV6-4	TRBJ1-3
TGTGCTAGCAGCTTAGTAAATCCGCCCGGGACAGGGGGCTTTTTGGGCTACACCTTC	CASSLVNPPGTGGFLGYTF	TRBV7-7	TRBJ1-2
TGTGCCAGCTCACCAAAGAGGGGGAGCAATCAGCCCCAGCATTTT	CASSPKRGSNQPQHF	TRBV18	TRBJ1-5
TGTGCCAGCAGTTTGACAGGGTCGCAGAATGAGCAGTTCTTC	CASSLTGSQNEQFF	TRBV6-9	TRBJ2-1
TGTGCCAGCAGTTACGCACGTCGGCAGAATGAAAAACTGTTTTTT	CASSYARRQNEKLFF	TRBV6-3	TRBJ1-4
TGTGCCAGCAGCCAGCGGAGGGACAGAGATACGCAGTATTTT	CASSQRRDRDTQYF	TRBV13	TRBJ2-3
TGTGCCTGGAGTACACAGAGGCACAATGAGCAGTTCTTC	CAWSTQRHNEQFF	TRBV30	TRBJ2-1
TGTGCCAGCAGCAAAAGAACGATTAGCGGGACCGGGGAGCTGTTTTTT	CASSKRTISGTGELFF	TRBV13	TRBJ2-2
TGTGCCAGCAGTTTAATATCCGGGACAGGGGCCAAAAACATTCAGTACTTC	CASSLISGTGAKNIQYF	TRBV27	TRBJ2-4
TGTGCCAGCAGCCCCGGCGGGGGCCCAAGTACGCAGTATTTT	CASSPGGGPSTQYF	TRBV14	TRBJ2-3
TGCGCCAGCAGCGCCTTGCGATCTGGCTACACCTTC	CASSALRSGYTF	TRBV10-1	TRBJ1-2
TGTGCCAGCAGTGGGACAGGGGAAGCTTTCTTT	CASSGTGEAFF	TRBV28	TRBJ1-1
TGTGCCAGCAGCCCATCGAAGCACTCCCCACGGGACAGGGGGTTTTGGATGAACACTGAAGCTTTCTTT	CASSPSKHSPRDRGFWMNTEAFF	TRBV6-5	TRBJ1-1
TGCAGCGTATGGACAGAGAGCAGGCCCCAGCATTTT	CSVWTESRPQHF	TRBV29-1	TRBJ1-5
TGTGCCAGCAGCTTAGCGAGCGGGGTACCGATTGAGCAGTTCTTC	CASSLASGVPIEQFF	TRBV7-8	TRBJ2-1
TGCGCCAGCAGCTTGCTTGGTATTGGGCTCTACGAGCAGTACTTC	CASSLLGIGLYEQYF	TRBV5-1	TRBJ2-7
TGCGCCAGGGTGGGGGGGCTCTATGGCTACACCTTC	CARVGGLYGYTF	TRBV10-1	TRBJ1-2
TGCAGTGCAAGGACTAGCGGAGTAGATACGCAGTATTTT	CSARTSGVDTQYF	TRBV20-1	TRBJ2-3
TGCGCCAGCTTGGGGTCATCCACCATATATTTT	CASLGSSTIYF	TRBV10-1	TRBJ1-3
TGTGCCAGCAGCATACGGGCGCAGGGGTCTTACAATCAGCCCCAGCATTTT	CASSIRAQGSYNQPQHF	TRBV7-3	TRBJ1-5
TGTGCCAGCAGGAAAGCCAGGGGGTTGCCCCAGCATTTT	CASRKARGLPQHF	TRBV11-3	TRBJ1-5
TGTGCCAGCAGCCCGCGCCGGGACAGGGACCGACCCTCCTACGAGCAGTACTTC	CASSPRRDRDRPSYEQYF	TRBV7-4	TRBJ2-7
TGTGCCAGCAGCGGGGAGGAACCGTCCGCATTCGATCAGCCCCAGCATTTT	CASSGEEPSAFDQPQHF	TRBV7-3	TRBJ1-5
TGTGCCAGCAGTTCCCCCGGCAGGGATAGCAATGAGCAGTTCTTC	CASSSPGRDSNEQFF	TRBV27	TRBJ2-1
TGTGCCACCAGTACCTCAGGGTACGAGCAGTACTTC	CATSTSGYEQYF	TRBV24-1	TRBJ2-7
TGTGCCACCCTCATAGGGGGGCCTTACGAGCAGTACTTC	CATLIGGPYEQYF	TRBV7-2	TRBJ2-7
TGTGCCAGCATCCGGGACAGGGGTAGCACCGGGGAGCTGTTTTTT	CASIRDRGSTGELFF	TRBV25-1	TRBJ2-2
TGCAGTGCTATTCCGGGACAGGGCCACTCTGGAAACACCATATATTTT	CSAIPGQGHSGNTIYF	TRBV20-1	TRBJ1-3
TGCGCCAGCAGCTTTCGGATCCCTAAGTCACCCCTCCACTTT	CASSFRIPKSPLHF	TRBV5-1	TRBJ1-6
TGCAGCGTTGAAGATCCCCAGGGAGGGTTCAACGCTGTCTTC	CSVEDPQGGFNAVF	TRBV29-1	TRBJ2-1
TGTGCCAGCAGCCGTGCCCGCGGTCTTCTCCAGCCCCAGCATTTT	CASSRARGLLQPQHF	TRBV9	TRBJ1-5
TGTGCCAGCAGTTCTGGACCGGGACAGGGGGCTGGAGCTTTCTTT	CASSSGPGQGAGAFF	TRBV6-2	TRBJ1-1
TGCGCCAGCAGCCAAGAGCGGGGCTACACCTTC	CASSQERGYTF	TRBV4-1	TRBJ1-2
TGTGCCAGCAGCCCGCGCCAGGGGGGGGTGAACACTGAAGCTTTCTTT	CASSPRQGGVNTEAFF	TRBV6-5	TRBJ1-1
TGCAGTGCTAGCACTGAGCGGGAGGATAGGTACAATGAGCAGTTCTTC	CSASTEREDRYNEQFF	TRBV20-1	TRBJ2-1
TGTGCCAGTAGTATAGCCCCGGGCCCCAAGGGACAGAGGGGAAACACTGAAGCTTTCTTT	CASSIAPGPKGQRGNTEAFF	TRBV19	TRBJ1-1
TGCGCCAGCAGCTTTGCCGGGACAGGGAGCATCGGCTACACCTTC	CASSFAGTGSIGYTF	TRBV5-1	TRBJ1-2
TGTGCCAGCAGCCAACGTCGTGGGGGATATACCTACGAGCAGTACTTC	CASSQRRGGYTYEQYF	TRBV3-1	TRBJ2-7
TGCGCCAGCAGCTGCAGCCCGACAGTTAGGGCTTACGAGCAGTACTTC	CASSCSPTVRAYEQYF	TRBV5-1	TRBJ2-7
TGTGCCATCATACACCCGGGTAGGGAGAACACTGAAGCTTTCTTT	CAIIHPGRENTEAFF	TRBV24-1	TRBJ1-1
TGTGCCAGCAGACCGGGACAGGGCTGGGAAGTGAATCAGCCCCAGCATTTT	CASRPGQGWEVNQPQHF	TRBV6-4	TRBJ1-5
TGTGCCAGCAGCCGGGGCCAGCGGGAGGGCTCCTACAATGAGCAGTTCTTC	CASSRGQREGSYNEQFF	TRBV5-5	TRBJ2-1
TGTGCCAGCAGCTCTCGCGGGACAACAGATACGCAGTATTTT	CASSSRGTTDTQYF	TRBV11-2	TRBJ2-3
TGTGCCATCCTACAACTAACCGCGGGAAACGAGCAGTACTTC	CAILQLTAGNEQYF	TRBV10-3	TRBJ2-7
TGCGCCAGCAGTGATGGATGGGGGGACGCCAGAGGCCACACTGAAGCTTTCTTT	CASSDGWGDARGHTEAFF	TRBV10-2	TRBJ1-1
TGTGCCAGCAGCCGGCAGGGGATTGGTCTAGCTGGAAACACCATATATTTT	CASSRQGIGLAGNTIYF	TRBV13	TRBJ1-3
TGTGCCAACCGTATAGAGACCCAGTACTTC	CANRIETQYF	TRBV6-5	TRBJ2-5
TGTGCCAGCAGCACCAACGACAGATATAGCAATCAGCCCCAGCATTTT	CASSTNDRYSNQPQHF	TRBV28	TRBJ1-5
TGTGCCAGCAGTCAGGACAGGTCCTACGAGCAGTACTTC	CASSQDRSYEQYF	TRBV28	TRBJ2-7
TGTGCCAGCAGCTTTCCGGACAGGCGCAATGGCTACACCTTC	CASSFPDRRNGYTF	TRBV11-2	TRBJ1-2
TGTGCCAGCAGCTCCCGGGACAGGGCCCGGCAAGAGACCCAGTACTTC	CASSSRDRARQETQYF	TRBV13	TRBJ2-5
TGTGCCAGCAGTTATCTAACCCAGCCCCAGCATTTT	CASSYLTQPQHF	TRBV6-5	TRBJ1-5
TGTGCCAGCAGCCAGCTTAGGGGAGGCTTACATCAGCCCCAGCATTTT	CASSQLRGGLHQPQHF	TRBV6-4	TRBJ1-5
TGTGCCAGCAGAGAATGTCCGGGGGAGAATCAGCCCCAGCATTTT	CASRECPGENQPQHF	TRBV9	TRBJ1-5
TGCGCCAGCCGGGAATGGTTGAGCACAGATACGCAGTATTTT	CASREWLSTDTQYF	TRBV5-1	TRBJ2-3
TGTGCCAGCAGCGTGCACACTAACGACAGGGAAGAGCAGTTCTTC	CASSVHTNDREEQFF	TRBV9	TRBJ2-1
TGTGCCAGCAGTTTAGAAGAGACACTCCTGGGCTACACCTTC	CASSLEETLLGYTF	TRBV28	TRBJ1-2
TGCGCCAGGGGGCCGACTGAAGCTTTCTTT	CARGPTEAFF	TRBV4-1	TRBJ1-1
TGTGCCAGCAGTGAAGAATATGAGGGACTAGCGGGGGGGGAGGCAGATACGCAGTATTTT	CASSEEYEGLAGGEADTQYF	TRBV6-1	TRBJ2-3
TGCGCCAAGCTGGTACAGTACGAGCAGTACTTC	CAKLVQYEQYF	TRBV10-1	TRBJ2-7
TGTGCCAGCAATTCCAGGGCCACCGGGGAGCTGTTTTTT	CASNSRATGELFF	TRBV6-4	TRBJ2-2
TGTGCTAGTGGTGGGGGACTCACCACTTACAATGAGCAGTTCTTC	CASGGGLTTYNEQFF	TRBV12-5	TRBJ2-1
TGTGCCAGCAGTTACTTAGACGAGCAGTACTTC	CASSYLDEQYF	TRBV6-2	TRBJ2-7
TGTGCCACAACCGGATCTCCGGGTACGCCCGGACTAGCGGGGGTGCGACAAACGGGTTGTGACGAGCAGTACTTC	CATTGSPGTPGLAGVRQTGCDEQYF	TRBV10-3	TRBJ2-7
TGTGCCAGCAAACACTATGGCTACACCTTC	CASKHYGYTF	TRBV7-6	TRBJ1-2
TGTGCCAGCAGCCAAGCGAATAGGAGGGTCCAAGAGACCCAGTACTTC	CASSQANRRVQETQYF	TRBV3-1	TRBJ2-5
TGTGCCAGCAGCTGGTATGACAGCTCCTCAAATAGCAATCAGCCCCAGCATTTT	CASSWYDSSSNSNQPQHF	TRBV5-4	TRBJ1-5
TGCGCCAGCAGCCAAATCACTAGTAGTAAATACCCTGAGCAGTTCTTC	CASSQITSSKYPEQFF	TRBV4-1	TRBJ2-1
TGTGCCAGCAGGCTGAGAAATACAGGGGGGATACAGAGGTCCACCTTC	CASRLRNTGGIQRSTF	TRBV7-9	TRBJ1-2
TGCAGCGTTGAACAAGAGGGGGAGGTAGAGACCCAGTACTTC	CSVEQEGEVETQYF	TRBV29-1	TRBJ2-5
TGCAGCGTTGAAGATGGGCATCCGTGCATCACAGGTAAGTGGGATTCGGAGACCCAGTACTTC	CSVEDGHPCITGKWDSETQYF	TRBV29-1	TRBJ2-5
TGTGCCACCAGCAGGTGCAACGGCGTCCTCTATGGCTACACCTTC	CATSRCNGVLYGYTF	TRBV15	TRBJ1-2
TGTGCCACCAGTGATTTACTAGCGGGAGGGCCATATGAGCAGTTCTTC	CATSDLLAGGPYEQFF	TRBV24-1	TRBJ2-1
TGCGCCAGCAGTGAGTCTCCAGGGGTGTCCTACGAGCAGTACTTC	CASSESPGVSYEQYF	TRBV10-1	TRBJ2-7
TGCAGCCCGACGGGGACAGACACTGAAGCTTTCTTT	CSPTGTDTEAFF	TRBV29-1	TRBJ1-1
TGTGCCAGCAGCGTCGACAGGGTTGAGACCCAGTACTTC	CASSVDRVETQYF	TRBV11-3	TRBJ2-5
TGTGCCAGCAGCTTGACGGACAGGGGGCGGGCCGGGGAAAAACTGTTTTTT	CASSLTDRGRAGEKLFF	TRBV11-2	TRBJ1-4
TGCGCCAGCAGTGAGGGAAAAACCCCGTTCAGGGGAGAGCGGCTAGAGCAGTACTTC	CASSEGKTPFRGERLEQYF	TRBV10-1	TRBJ2-7
TGTGCCAGCAAAAAAGGACCTCGCTACAATGAGCAGTTCTTC	CASKKGPRYNEQFF	TRBV7-9	TRBJ2-1
TGTGCCAGCAGCAATCGAGACAGGGGGCATGAGCAGTTCTTC	CASSNRDRGHEQFF	TRBV7-2	TRBJ2-1
TGTGCCAGCAGCGCGGGGGGCCGTACATTGAATGAGCAGTTCTTC	CASSAGGRTLNEQFF	TRBV7-7	TRBJ2-1
TGCGCACCCGGAAGGAACCACACAGATACGCAGTATTTT	CAPGRNHTDTQYF	TRBV20-1	TRBJ2-3
TGTGCTAGTGGTGCGTACAGACAGGGTAATATGGGCTACACCTTC	CASGAYRQGNMGYTF	TRBV12-5	TRBJ1-2
TGTGCCTGGAGTGTACAGGACGGGGAAAATGAAAAACTGTTTTTT	CAWSVQDGENEKLFF	TRBV30	TRBJ1-4
TGTGCCACCAGCAGCTCCAGGGGTGGGAGATCAGATACGCAGTATTTT	CATSSSRGGRSDTQYF	TRBV15	TRBJ2-3
TGTGCCAGCAGCAGGCGGGGGAGGGACGAGCAGTACTTC	CASSRRGRDEQYF	TRBV7-3	TRBJ2-7
TGCGCCAGCAGCTACCCGGGACAGGGGAAGGCTAACTATGGCTACACCTTC	CASSYPGQGKANYGYTF	TRBV5-1	TRBJ1-2
TGTGCCAGCAGCTTGCGCCGGGAGAGACAGGGAAGGGAGGAATGGAGTCAGCCCCAGCATTTT	CASSLRRERQGREEWSQPQHF	TRBV11-3	TRBJ1-5
TGCGCCAGCAGCAGTACGGGGGACAATGAGCAGTTCTTC	CASSSTGDNEQFF	TRBV4-1	TRBJ2-1
TGTGCCAGCAGTTTGACAACGGGGCCCGGAGTGCAGTACTTC	CASSLTTGPGVQYF	TRBV27	TRBJ2-7
TGTGCCAGCAGCGTAGGTCCCGGGGGCTATCGAGCGGTAAACAATGAGCAGTTCTTC	CASSVGPGGYRAVNNEQFF	TRBV9	TRBJ2-1
TGCGCCAGCAGCCACCGGCGGGAGCAGCCTGGCTACACCTTC	CASSHRREQPGYTF	TRBV4-1	TRBJ1-2
TGTGCTAGTGGTTTGGTACGCGGGGAAGCCGGGACAGCATCCAATCAGCCCCAGCATTTT	CASGLVRGEAGTASNQPQHF	TRBV12-5	TRBJ1-5
TGTGCTTATCGAGGGGCTAGGGGGTGTTTACGCACTAATACGCAGTATTTT	CAYRGARGCLRTNTQYF	TRBV30	TRBJ2-3
TGTGCCAGCAGTTACTCGGGGGTAGCACCACCGGCAACTAATGAAAAACTGTTTTTT	CASSYSGVAPPATNEKLFF	TRBV6-2	TRBJ1-4
TGTGCCAGGCCCACAGGAGAGTACTTC	CARPTGEYF	TRBV14	TRBJ2-7
TGTGCCAGCAGTTTATCCTCCAGTAAACTGAACACTGAAGCTTTCTTT	CASSLSSSKLNTEAFF	TRBV27	TRBJ1-1
TGTGCCAGCAGTATTGACAGGGCAATTGAGCAGTACTTC	CASSIDRAIEQYF	TRBV6-5	TRBJ2-7
TGTGCCATCAGTGCCATAAAGCGGGAGCGCTCTAGCACAGATACGCAGTATTTT	CAISAIKRERSSTDTQYF	TRBV10-3	TRBJ2-3
TGTGCCAGCAGAGACGACCTGTACTATGGCTACACCTTC	CASRDDLYYGYTF	TRBV28	TRBJ1-2
TGTGCCAGCAGCTTGGACTCGGACAGGGGGCTAGAGACCCAGTACTTC	CASSLDSDRGLETQYF	TRBV5-4	TRBJ2-5
TGTGCCAGCAGTTTATATACACCCCCCCAGTTTCACACTGAAGCTTTCTTT	CASSLYTPPQFHTEAFF	TRBV28	TRBJ1-1
TGCGCCAGCACCGGACTATTACCCCCATTCTACGAGCAGTACTTC	CASTGLLPPFYEQYF	TRBV5-1	TRBJ2-7
TGTGCCAGCAGCTTGACAGGAGGTGGAAATCAGCCCCAGCATTTT	CASSLTGGGNQPQHF	TRBV7-9	TRBJ1-5
TGTGCCACGACTTTCTACGGTGGTAATCAGCCCCAGCATTTT	CATTFYGGNQPQHF	TRBV6-4	TRBJ1-5
TGTGCCAGCAGTGAAGCCCTAAATCGAAAGGCCACACACGAGCAGTACTTC	CASSEALNRKATHEQYF	TRBV6-1	TRBJ2-7
TGTGCCAGCCGGGACGATACGCAGTATTTT	CASRDDTQYF	TRBV7-3	TRBJ2-3
TGTGCCAGCAGCGCCTCAAACCGGACGGACGAGCAGTACTTC	CASSASNRTDEQYF	TRBV5-8	TRBJ2-7
TGTGCTAGTGGTTTGGTACAATCTTACAATGAGCAGTTCTTC	CASGLVQSYNEQFF	TRBV12-5	TRBJ2-1
TGTGCCACCAGTGTCAAAGCCGGGACAGGGGGCCCGACAGAGACCCAGTACTTC	CATSVKAGTGGPTETQYF	TRBV24-1	TRBJ2-5
TGTGCCAGCAGCCCAGTTAGAGACAACTATAGCAATCAGCCCCAGCATTTT	CASSPVRDNYSNQPQHF	TRBV7-3	TRBJ1-5
TGTGCCAGCAGCGAGAAAAGGAACACTGAAGCTTTCTTT	CASSEKRNTEAFF	TRBV6-4	TRBJ1-1
TGTGCCAGCGCCCCCGGGACGAGGGCGAACACCGGGGAGCTGTTTTTT	CASAPGTRANTGELFF	TRBV27	TRBJ2-2
TGTGCCAGCAGTTCTACCTACGAGCAGTACTTC	CASSSTYEQYF	TRBV3-1	TRBJ2-7
TGCGCCAGCAGCAGCTTACCAGATGGAACGAACTATGGCTACACCTTC	CASSSLPDGTNYGYTF	TRBV4-1	TRBJ1-2
TGTGCCAGGCCGCAGGGAGACTACGAGCAGTACTTC	CARPQGDYEQYF	TRBV28	TRBJ2-7
TGTGCCAGCAGGGGTCAAAGAGACGAGCAGTACTTC	CASRGQRDEQYF	TRBV6-4	TRBJ2-7
TGCAGCGTTCAAACCTTGTGGGACTATGAAGAGACCCAGTACTTC	CSVQTLWDYEETQYF	TRBV29-1	TRBJ2-5
TGTGCCAGCGTGGGGGCAAGCATGAACACTGAAGCTTTCTTT	CASVGASMNTEAFF	TRBV19	TRBJ1-1
TGCAGTGCAGCAGAGCGGGATAACTACGAGCAGTACTTC	CSAAERDNYEQYF	TRBV20-1	TRBJ2-7
