TGTGCCAGCAGCATCCCCCGCGGGGGAATACAAGTTATCTCCACAGATACGCAGTATTTT	CASSIPRGGIQVISTDTQYF	TRBV5-6	TRBJ2-3
TGCAGCGTTCTGGTTGCGGAAGGGGGCGTCCCTTCTGGGCATAGCAATCAGCCCCAGCATTTT	CSVLVAEGGVPSGHSNQPQHF	TRBV29-1	TRBJ1-5
TGTGCTAGTGGTTTGATAAGGGTGGGACCCTTCACCGGGGAGCTGTTTTTT	CASGLIRVGPFTGELFF	TRBV12-5	TRBJ2-2
TGTGCCAGCCCGGGACAGGGGGTGGCCTACGAGCAGTACTTC	CASPGQGVAYEQYF	TRBV18	TRBJ2-7
TGCAGTGCTACTAGCGGGTACAATGAGCAGTTCTTC	CSATSGYNEQFF	TRBV20-1	TRBJ2-1
TGCGCCAGCAGCCAACGAGGTAAAGCGGGACCAATAACAGATACGCAGTATTTT	CASSQRGKAGPITDTQYF	TRBV4-1	TRBJ2-3
TGTGCCAGCAGCTTACCTATTAACGAGCAGTACTTC	CASSLPINEQYF	TRBV7-3	TRBJ2-7
TGTGCTAGCAGGGAGGAGGGGGACCGGAACCAAGAGACCCAGTACTTC	CASREEGDRNQETQYF	TRBV7-7	TRBJ2-5
TGTGCCAGCAGCCTCGTACAGGGTTACTACGAGCAGTACTTC	CASSLVQGYYEQYF	TRBV2	TRBJ2-7
TGTGCCATCAGTGAGTCGATAAGTCCGGGACTAGGTGCTAATCTCACAGATACGCAGTATTTT	CAISESISPGLGANLTDTQYF	TRBV10-3	TRBJ2-3
TGTGCCCTAACTCAGATCGGAATAGAAGACTATGGCTACACCTTC	CALTQIGIEDYGYTF	TRBV27	TRBJ1-2
TGTGCCAGCAGCGGGGGGAAGGTTCAGCCCCAGCATTTT	CASSGGKVQPQHF	TRBV5-5	TRBJ1-5
TGTGCCATCAGGAATCGGGGGCCGTCCCGTCCCGAGCAGTACTTC	CAIRNRGPSRPEQYF	TRBV10-3	TRBJ2-7
TGCAGCGGGCCCAGCGAGCTCAATCAGCCCCAGCATTTT	CSGPSELNQPQHF	TRBV29-1	TRBJ1-5
TGTGCCAGTAGTATTCCAGAAGCGGGGGAGAACACCGGGGAGCTGTTTTTT	CASSIPEAGENTGELFF	TRBV19	TRBJ2-2
TGTGCCAGCAGTTGGCTATCTAGCGGGGGGAAGTACTTC	CASSWLSSGGKYF	TRBV2	TRBJ2-7
TGCGCCAGCGGGACATGTTATAATTCACCCCTCCACTTT	CASGTCYNSPLHF	TRBV10-2	TRBJ1-6
TGTGCCAGCAGCGGGGTCCCGGACAGGGCGGAAAACTATGGCTACACCTTC	CASSGVPDRAENYGYTF	TRBV5-4	TRBJ1-2
TGCAGTGCTAGAGGAAGTAGTAATGAAAAACTGTTTTTT	CSARGSSNEKLFF	TRBV20-1	TRBJ1-4
TGTGCCACTGAGGGAGGGGATGTTACGCTCACCGGGGAGCTGTTTTTT	CATEGGDVTLTGELFF	TRBV24-1	TRBJ2-2
TGTGCCAGCGTGTGGGGTCACGAGCAGTACTTC	CASVWGHEQYF	TRBV6-4	TRBJ2-7
TGTGCCAGCATCCAGGAGTGGTACGAGCAGTACTTC	CASIQEWYEQYF	TRBV6-3	TRBJ2-7
TGTGCCAGTAGTATAGGCTCGGAGGGGGGCTTTGAAAAACTGTTTTTT	CASSIGSEGGFEKLFF	TRBV19	TRBJ1-4
TGTGCCAGCATTACGCTGCAGGCGAGCTACGAGCAGTACTTC	CASITLQASYEQYF	TRBV9	TRBJ2-7
TGTGCCAGCAGTAGTAGGATCTCTGGAGGGCATCAGCCCCAGCATTTT	CASSSRISGGHQPQHF	TRBV27	TRBJ1-5
TGTGCCAGCAGCCCCGCCTATCTCGCGGATCAGCCCCAGCATTTT	CASSPAYLADQPQHF	TRBV3-1	TRBJ1-5
TGTGCTAGCAGCTTAGCGGCAGATGCCGCTGAAGCTTTCTTT	CASSLAADAAEAFF	TRBV7-7	TRBJ1-1
TGTGCCAGCAGCCACGGTACCCTATCCTCTGGGGCCAACGTCCTGACTTTC	CASSHGTLSSGANVLTF	TRBV7-4	TRBJ2-6
TGTGCCAGCAGCGGATGGGACGCACATATCAATCAGCCCCAGCATTTT	CASSGWDAHINQPQHF	TRBV13	TRBJ1-5
TGCGCCAGCAGTGAAGCAATGGGGTACCGCTACGAGCAGTACTTC	CASSEAMGYRYEQYF	TRBV10-1	TRBJ2-7
TGTGCCAGCAGTTACTTCTCTGATGGGATAGAGACCCAGTACTTC	CASSYFSDGIETQYF	TRBV6-5	TRBJ2-5
TGTGCCAGCAGCTTAGAAGCACGGAGGGTAGATGAGCAGTTCTTC	CASSLEARRVDEQFF	TRBV7-2	TRBJ2-1
TGTGCCACAGGGGAAAAACTGTTTTTT	CATGEKLFF	TRBV7-6	TRBJ1-4
TGTGCCAGCTCACCACTGCAGGGGGAGCCGGTGTTTCCCTACTCCCGCTACGAGCAGTACTTC	CASSPLQGEPVFPYSRYEQYF	TRBV18	TRBJ2-7
TGTGCCAGCAGCTTGTCCGGGGGGCGGATAGCGAACACTGAAGCTTTCTTT	CASSLSGGRIANTEAFF	TRBV5-5	TRBJ1-1
TGTGCCAGCAGCTCTTTTAAGAAAGCAAAAAATGGCTACACCTTC	CASSSFKKAKNGYTF	TRBV5-6	TRBJ1-2
TGTGCCAGCAGCAGGTGGAGGGGGGCCGGCACTGAAGCTTTCTTT	CASSRWRGAGTEAFF	TRBV9	TRBJ1-1
TGTGCCATCATCAGTGGCGGACAGAACGACTATGGCTACACCTTC	CAIISGGQNDYGYTF	TRBV10-3	TRBJ1-2
TGTGCCAGCAGTTGTCGGACAGGGGGCGGCACTGAAGCTTTCTTT	CASSCRTGGGTEAFF	TRBV25-1	TRBJ1-1
TGCAGTGCCCTAGGCGGCTACGAGCAGTACTTC	CSALGGYEQYF	TRBV20-1	TRBJ2-7
TGTGCCAGCAGCAGGGGGGGCGCCTACGAGCAGTACTTC	CASSRGGAYEQYF	TRBV7-9	TRBJ2-7
TGTGCCAGCAGCTTAACGTCGGACAGAGCTAATGAAAAACTGTTTTTT	CASSLTSDRANEKLFF	TRBV7-3	TRBJ1-4
TGTGCCAGCACCCAAATTTCCGGGACAGGGGGCCCTGGGGCCAACGTCCTGACTTTC	CASTQISGTGGPGANVLTF	TRBV2	TRBJ2-6
TGTGCCAGCAGGGGTCTTTCGGGCTACAATGAGCAGTTCTTC	CASRGLSGYNEQFF	TRBV5-6	TRBJ2-1
TGTGCCAGCAGCTTAGAGTTCCGGCCGACTAGCGGGATGTACTTC	CASSLEFRPTSGMYF	TRBV11-2	TRBJ2-4
TGTGCCACCAGCCCAAGGATAGTGATACACCCCACTGAAGCTTTCTTT	CATSPRIVIHPTEAFF	TRBV15	TRBJ1-1
TGTGCCACCAGTGTAAGAGAGCGGGGTAATATTAGGGACCAAGAGACCCAGTACTTC	CATSVRERGNIRDQETQYF	TRBV24-1	TRBJ2-5
TGTGCCAGCAGAACCGAGGGGGACTGGGGAGGCTCCTACGAGCAGTACTTC	CASRTEGDWGGSYEQYF	TRBV27	TRBJ2-7
TGTGCCAGCAGCTTTACGGACAGGGCTGTAGGAAACACCATATATTTT	CASSFTDRAVGNTIYF	TRBV5-4	TRBJ1-3
TGCAGCGGTTATTCAGGGGGCATGGAGCAGTACTTC	CSGYSGGMEQYF	TRBV29-1	TRBJ2-7
TGTGCCAGCAGTTTTATCCCCATACTAGCGGGAGGGCTGTGCGAGCAGTACTTC	CASSFIPILAGGLCEQYF	TRBV28	TRBJ2-7
TGTGCCACCAGCAGATACCCCCCAGGCGTTTACGAGCAGTACTTC	CATSRYPPGVYEQYF	TRBV15	TRBJ2-7
TGCGCCAGCAGTGAGTCCAGAAGGCGACAGACCTTGAATAGCTCCTACAATGAGCAGTTCTTC	CASSESRRRQTLNSSYNEQFF	TRBV10-2	TRBJ2-1
TGTGCCAGCAGCCCTAGTGGGGGGGATGAGCAGTTCTTC	CASSPSGGDEQFF	TRBV7-3	TRBJ2-1
TGTGCCAGCAGCGGGGGGGACTTT	CASSGGDF	TRBV7-9	TRBJ1-1
TGTGCCAGCAGCCAGACAGGGGGGGAGTCTGAAGCTTTCTTT	CASSQTGGESEAFF	TRBV13	TRBJ1-1
TGTGCCAGCAGCGTAGTGACAGGCCTTGGCTACACCTTC	CASSVVTGLGYTF	TRBV7-3	TRBJ1-2
TGCGCCAGCAGCCACTGTACGCCAGGGACACCTTCGTACTCTGGGGCCAACGTCCTGACTTTC	CASSHCTPGTPSYSGANVLTF	TRBV4-1	TRBJ2-6
TGTGCCACCAGGGCTCGGGGTCACTGCAATCAGCCCCAGCATTTT	CATRARGHCNQPQHF	TRBV24-1	TRBJ1-5
TGTGCCAGCAGCAGACATTTGACTAGCGACGAGCAGTACTTC	CASSRHLTSDEQYF	TRBV9	TRBJ2-7
TGTGCCAGCAGCGGACGGGGGTGCACAGATACGCAGTATTTT	CASSGRGCTDTQYF	TRBV6-1	TRBJ2-3
TGCGCCAGCGGAGATCGCGGGAGTTCCGCCAACGTCCTGACTTTC	CASGDRGSSANVLTF	TRBV5-1	TRBJ2-6
TGTGCCAGCAGTGCTATCGGGGACAACTACGAGCAGTACTTC	CASSAIGDNYEQYF	TRBV6-1	TRBJ2-7
TGTGCCAGCAGCTTGGTAATAGGCATTGAGCAGTTCTTC	CASSLVIGIEQFF	TRBV5-4	TRBJ2-1
TGCGCCAGCAGCTTAAGGACGGCAACTAATGAAAAACTGTTTTTT	CASSLRTATNEKLFF	TRBV5-1	TRBJ1-4
TGTGCCAGCAGTTCGGCGACGGGCCTCACAGATACGCAGTATTTT	CASSSATGLTDTQYF	TRBV27	TRBJ2-3
TGTGCCAGCAGCGTCCCCGCCGGGACTGGGACCTACGAGCAGTACTTC	CASSVPAGTGTYEQYF	TRBV7-9	TRBJ2-7
TGTGCCAGCTCACCACGGTTCAGGGGCTTTAGCAATCAGCCCCAGCATTTT	CASSPRFRGFSNQPQHF	TRBV18	TRBJ1-5
TGTGCCAGCAGTGACAAAGGGGGTTCCTATCAGCCCCAGCATTTT	CASSDKGGSYQPQHF	TRBV6-4	TRBJ1-5
TGCGCCAGCAGCTCTGCTAGGTCGGGCAAGCAAGAGACCCAGTACTTC	CASSSARSGKQETQYF	TRBV5-1	TRBJ2-5
TGTGCCAGTAGTATAAACCTCCTGGGAGGGCCCACTGAAGCTTTCTTT	CASSINLLGGPTEAFF	TRBV19	TRBJ1-1
TGTGCCAGCAGCCACCGACTAGCGGGAATTCTGGGCTACGAGCAGTACTTC	CASSHRLAGILGYEQYF	TRBV14	TRBJ2-7
TGTGCCACAACCAAGACGGTAAGGGGGGATGAGCAGTTCTTC	CATTKTVRGDEQFF	TRBV24-1	TRBJ2-1
TGTGCCAGCAGCAGCCGGGACAGGGGTACACCTCATGGCTACACCTTC	CASSSRDRGTPHGYTF	TRBV9	TRBJ1-2
TGCGCCAGCAGCCAAAGGCGGACTAGCGGGGGGTGTAGAGGTCCCTACGAGCAGTACTTC	CASSQRRTSGGCRGPYEQYF	TRBV4-3	TRBJ2-7
TGTGCCAGTAGTATAGCTAGCGGGTGTACCGGGGAGCTGTTTTTT	CASSIASGCTGELFF	TRBV19	TRBJ2-2
TGTGCCAGCGGCAGACAGGGGGGGACTGAAGCTTTCTTT	CASGRQGGTEAFF	TRBV7-9	TRBJ1-1
TGTGCCTGGAGACCGACGAAAAGGCTTTTTGGAAACACCATATATTTT	CAWRPTKRLFGNTIYF	TRBV30	TRBJ1-3
TGCACGGACGAGCAGTACTTC	CTDEQYF	TRBV20-1	TRBJ2-7
TGTGCCAGTAGTATCGGAGACAGGGGCTGTTATTTCATGAACACTGAAGCTTTCTTT	CASSIGDRGCYFMNTEAFF	TRBV19	TRBJ1-1
TGTGCCAGCAGCTTAGTCCCGGGATTCACCGGGGAGCTGTTTTTT	CASSLVPGFTGELFF	TRBV7-8	TRBJ2-2
TGTGCCAGCAGCCAAAGCCAGTGCGAGCAGTACTTC	CASSQSQCEQYF	TRBV3-1	TRBJ2-7
TGTGCCAGCATTTTGGCCTACCGGTCCGAGCAGTACTTC	CASILAYRSEQYF	TRBV6-2	TRBJ2-7
TGTGCTAGCAGCTTAGCCGACATGGTCGACGAGCAGTACTTC	CASSLADMVDEQYF	TRBV7-7	TRBJ2-7
TGTGCCTGGAATTGGGGGGGTGCTCCCCATGAGCAGTTCTTC	CAWNWGGAPHEQFF	TRBV30	TRBJ2-1
TGTGCCAGCAGTTACTTACTAGCGGTGGGGGAGACCCAGTACTTC	CASSYLLAVGETQYF	TRBV12-3	TRBJ2-5
TGTGCCAGCAGCCTATTTAAAGAGACTAGTTCCTTGGGCAAGAGCTCTTACGAGCAGTACTTC	CASSLFKETSSLGKSSYEQYF	TRBV14	TRBJ2-7
TGTGCCAGCAGTCAACTTTCCGGGACAGGCATAGGGGCCAACGTCCTGACTTTC	CASSQLSGTGIGANVLTF	TRBV6-5	TRBJ2-6
TGTGCCAGCAGTTACCTAGGGACTAGCGGGGGGGGGGAGCAGTACTTC	CASSYLGTSGGGEQYF	TRBV6-5	TRBJ2-7
TGTGCCACCGAGTCAGGGTCAAAACTGTTTTTT	CATESGSKLFF	TRBV15	TRBJ1-4
TGTGCCAGCGGTAGCGGGGAGCTGTTTTTT	CASGSGELFF	TRBV7-4	TRBJ2-2
TGTGCCAGGCGGGGGACTGAAGCTTTCTTT	CARRGTEAFF	TRBV3-1	TRBJ1-1
TGTGCCAGCGCCCCAGGGGAAGGGTCTGGCAATCAGCCCCAGCATTTT	CASAPGEGSGNQPQHF	TRBV28	TRBJ1-5
TGTGCCAGCAGCTTGGAGACGATTGGGGGGGCGGCGTGGGAAGACTGCACAGATACGCAGTATTTT	CASSLETIGGAAWEDCTDTQYF	TRBV5-6	TRBJ2-3
TGCGCCAGCAGTGAGGGGTCGAAGGCCTGGGGAGGAACAAAGTACAATGAGCAGTTCTTC	CASSEGSKAWGGTKYNEQFF	TRBV10-1	TRBJ2-1
TGTGCCAGCAGTTTTAAAAAGAGACTAGACGAGCAGTACTTC	CASSFKKRLDEQYF	TRBV27	TRBJ2-7
TGTGCCAGCAGTGCTCTCTATGGCTACACCTTC	CASSALYGYTF	TRBV28	TRBJ1-2
TGTGCCAGCAGCTTATGGGGGGGGCAGCGGGTAACCTACTACGAGCAGTACTTC	CASSLWGGQRVTYYEQYF	TRBV7-9	TRBJ2-7
TGCGCCAGCAGCCAAGCCCGTCTAGGACCAGATGAGCAGTTCTTC	CASSQARLGPDEQFF	TRBV4-3	TRBJ2-1
TGCAGTGCTAGAACAGCGGACAGGGGGCCCTACGAGCAGTACTTC	CSARTADRGPYEQYF	TRBV20-1	TRBJ2-7
TGCAGTGCTATTCAAATTTCGGCGACCCCCTACGAGCAGTACTTC	CSAIQISATPYEQYF	TRBV20-1	TRBJ2-7
TGTGCCAGCAGCTTAGAGCGCATAGGAGCTATTACCACAGATACGCAGTATTTT	CASSLERIGAITTDTQYF	TRBV7-2	TRBJ2-3
TGTGCCAGCAGCTTGGTGGGACAGGGATCCGATGAGCAGTTCTTC	CASSLVGQGSDEQFF	TRBV5-6	TRBJ2-1
TGTGCCAGCAGCAGGGTCCAAGAGACCCAGTACTTC	CASSRVQETQYF	TRBV7-9	TRBJ2-5
TGTGGATCCCAAGGGCCGGGACTAGTTGCAGACTCCTACGAGCAGTACTTC	CGSQGPGLVADSYEQYF	TRBV27	TRBJ2-7
TGTGCCAGCTCACCGCCCCACAGCAAGTACTCTGGAAACACCATATATTTT	CASSPPHSKYSGNTIYF	TRBV18	TRBJ1-3
TGTGCCAGCAGCCGTGGTTATAGGGGGCCCGATGGCTACACCTTC	CASSRGYRGPDGYTF	TRBV7-3	TRBJ1-2
TGCAGCGCCTTTGGAGCAGGGGCATATAAAAACACTGAAGCTTTCTTT	CSAFGAGAYKNTEAFF	TRBV29-1	TRBJ1-1
TGTGCCAGCAGCCTCTCCAATGACAGGGAGCTTCTTCAGCCCCAGCATTTT	CASSLSNDRELLQPQHF	TRBV6-3	TRBJ1-5
TGTGCCACCAGTGAGAGGGGACAGGGGAAATTATACACTGAAGCTTTCTTT	CATSERGQGKLYTEAFF	TRBV24-1	TRBJ1-1
TGTGCCAGCAGCCTAGCGGGAGACACAGATACGCAGTATTTT	CASSLAGDTDTQYF	TRBV13	TRBJ2-3
TGTGCCAGCAGCAAGATGCGACGGGCTGAAGCTTTCTTT	CASSKMRRAEAFF	TRBV11-3	TRBJ1-1
TGTGCCAGCAGCTTAACGAGGCCCGGGGAGCTGTTTTTT	CASSLTRPGELFF	TRBV7-3	TRBJ2-2
TGTGCCAGCAGTGTGGGGGGTATGAACACTGAAGCTTTCTTT	CASSVGGMNTEAFF	TRBV27	TRBJ1-1
TGTGCCAGCAGCCGTCCTAAGGTGAGTGTTCACACTGAAGCTTTCTTT	CASSRPKVSVHTEAFF	TRBV7-9	TRBJ1-1
TGTGCCAGCAGCTATAAACAATATCAGCCCCAGCATTTT	CASSYKQYQPQHF	TRBV5-4	TRBJ1-5
TGTGCCAGCAGTTTATCGGTCGGGGACCGCAATCAGCCCCAGCATTTT	CASSLSVGDRNQPQHF	TRBV27	TRBJ1-5
TGTGCCAGCAGCATTAGAGCTGCAACTAATGAAAAACTGTTTTTT	CASSIRAATNEKLFF	TRBV11-1	TRBJ1-4
TGTGCCAGCAGTGACTCGTCCAGTCCCACTAGTGATCAGCCCCAGCATTTT	CASSDSSSPTSDQPQHF	TRBV6-4	TRBJ1-5
TGCGCCAGCAGCTCTGGGACTAGCCGCACAGATACGCAGTATTTT	CASSSGTSRTDTQYF	TRBV5-1	TRBJ2-3
TGTGCCAGCAGCCAAGATCGGACTAGCGGGGGGGCGCCCTCCGAGCAGTACTTC	CASSQDRTSGGAPSEQYF	TRBV14	TRBJ2-7
TGTGCCAGTAGGGGACCGGGACTAGCGGGAGGCACAGATACGCAGTATTTT	CASRGPGLAGGTDTQYF	TRBV19	TRBJ2-3
TGTGCCAGTTGGGACAGGCCCTACAATGAGCAGTTCTTC	CASWDRPYNEQFF	TRBV6-5	TRBJ2-1
TGTGCCAGCAGTGTGGACATATTATGCGTTCGGTACGAGCAGTACTTC	CASSVDILCVRYEQYF	TRBV25-1	TRBJ2-7
TGCAGTGCTAGAGCTCGAGTGGAGGGAAGTACTGAAGCTTTCTTT	CSARARVEGSTEAFF	TRBV20-1	TRBJ1-1
TGTGCCAGCAGTTGCGTATCGAGAAACGAGCAGTACTTC	CASSCVSRNEQYF	TRBV27	TRBJ2-7
TGTGCCAGCAGCGCGGGGCGTGCAGAAGCTTTCTTT	CASSAGRAEAFF	TRBV7-9	TRBJ1-1
TGCAGTGCTAGAGCGGTTGATAGCTGGAGCTTC	CSARAVDSWSF	TRBV20-1	TRBJ2-7
TGTGCCAGCAGCCTTTCGCCACACGAGCAGTACTTC	CASSLSPHEQYF	TRBV7-3	TRBJ2-7
TGTGCCATCAGTGGCCTGAGGACAGAATCACCCCTCCACTTT	CAISGLRTESPLHF	TRBV10-3	TRBJ1-6
TGTGCCAGCTCACCACCGTCAGGGTGGGCCACTGAAGCTTTCTTT	CASSPPSGWATEAFF	TRBV18	TRBJ1-1
TGTGCCAGCAGTTTTTCCCTTGACAGGGGAGCTTACAATGAGCAGTTCTTC	CASSFSLDRGAYNEQFF	TRBV27	TRBJ2-1
TGTGCCAGCAGTTGGACAGGACTTAGTAATTCACCCCTCCACTTT	CASSWTGLSNSPLHF	TRBV12-4	TRBJ1-6
TGTGCTAGCCCGCAGGACACTGAAGCTTTCTTT	CASPQDTEAFF	TRBV12-5	TRBJ1-1
TGTGCCAGCAGTGCCACAGGGTTTGTGAAATCTGGAAACACCATATATTTT	CASSATGFVKSGNTIYF	TRBV27	TRBJ1-3
TGCAGTGCTAGTGACAGGGGTAAGGGGTCCTACGAGCAGTACTTC	CSASDRGKGSYEQYF	TRBV20-1	TRBJ2-7
TGTGCCAGCAGGGGGAAGGGGGATGGGGCGCCGGGTGATAGCAATCAGCCCCAGCATTTT	CASRGKGDGAPGDSNQPQHF	TRBV2	TRBJ1-5
TGTGCCAGCAGTCCCCCTGGTGCCCAATTGGGGTCTAGCACAGATACGCAGTATTTT	CASSPPGAQLGSSTDTQYF	TRBV27	TRBJ2-3
TGTGCCACTGGGGGATTGGGACACAGTAGCAATCAGCCCCAGCATTTT	CATGGLGHSSNQPQHF	TRBV24-1	TRBJ1-5
TGTGCCACCAGTGAGCTCTACGGGGGCCCCCACACAGATACGCAGTATTTT	CATSELYGGPHTDTQYF	TRBV24-1	TRBJ2-3
TGTGCCAGCAGTGAAGCAGGGCCCGGGGAGCAGCCCCAGCATTTT	CASSEAGPGEQPQHF	TRBV6-1	TRBJ1-5
TGTGCCAGCGACAAAGTACTCGGAGAGGGTGGTACCTACAATGAGCAGTTCTTC	CASDKVLGEGGTYNEQFF	TRBV6-1	TRBJ2-1
TGTGCCAGCAGCCAAGGGGGGCCCCCCGGGGAGCTGTTTTTT	CASSQGGPPGELFF	TRBV3-1	TRBJ2-2
TGTGCCACCAGTGATTTGCCACGCCAGCAAGAGACCCAGTACTTC	CATSDLPRQQETQYF	TRBV24-1	TRBJ2-5
TGTGCCAGCAGCCTCACCCGACAGCTCGAAGGGGGTCATGGCTACACCTTC	CASSLTRQLEGGHGYTF	TRBV5-5	TRBJ1-2
TGTGCCAGCAGTGAATCCGAACGACAGGATCAGCCCCAGCATTTT	CASSESERQDQPQHF	TRBV25-1	TRBJ1-5
TGCGCCATGCCGGGACAGGGGGCGGAACACCAAGAGACCCAGTACTTC	CAMPGQGAEHQETQYF	TRBV5-1	TRBJ2-5
TGCAGTGCGGGAACAGGGTCTGCCCCTGAAGCTTTCTTT	CSAGTGSAPEAFF	TRBV20-1	TRBJ1-1
TGTGCCAGCAGCCTGGGGCTGTACAATGAGCAGTTCTTC	CASSLGLYNEQFF	TRBV13	TRBJ2-1
TGTGCCAGCAGCCGCCACACCGAGCCCCAGCATTTT	CASSRHTEPQHF	TRBV27	TRBJ1-5
TGTGCCAGCAGCGGTCGAAACACCGGGGAGCTGTTTTTT	CASSGRNTGELFF	TRBV13	TRBJ2-2
TGTGCCAGCAGCCATGGACGGTACAATGAGCAGTTCTTC	CASSHGRYNEQFF	TRBV7-2	TRBJ2-1
TGTGCCAGCTCACCGGCGGACTATGGCTACACCTTC	CASSPADYGYTF	TRBV18	TRBJ1-2
TGTGCCAGCAGCCCGACAGAAAGCGATAACACTGAAGCTTTCTTT	CASSPTESDNTEAFF	TRBV7-2	TRBJ1-1
TGTGCCATCAGTGTTTCTAGATTAGGCTACACCTTC	CAISVSRLGYTF	TRBV10-3	TRBJ1-2
TGTGCCAGCAGCCGAAACAAGGACGTTGAAGCTTTCTTT	CASSRNKDVEAFF	TRBV11-3	TRBJ1-1
TGTGCCAGCAGTTTACCGGACAGGCGCAATCAGCCCCAGCATTTT	CASSLPDRRNQPQHF	TRBV27	TRBJ1-5
TGTGCCAGCAGCTTGTTCCGGGGGAGGTCAGCGAACACCGGGGAGCTGTTTTTT	CASSLFRGRSANTGELFF	TRBV5-4	TRBJ2-2
TGTGCCAAGGGGACAGGGAGCTCTGGGGCCAACGTCCTGACTTTC	CAKGTGSSGANVLTF	TRBV6-1	TRBJ2-6
TGTGCCAGCAGCAAACGGACAGGAAAATCACCCCTCCACTTT	CASSKRTGKSPLHF	TRBV13	TRBJ1-6
TGTGCCAGCAGCCAAGATTTTACTAGCGGGAGGGGCACCGGGGAGCTGTTTTTT	CASSQDFTSGRGTGELFF	TRBV14	TRBJ2-2
TGCGCCAGCAGCTTGTGCGGGCCTGGGACAGTAATAGTATCCTACAATGAGCAGTTCTTC	CASSLCGPGTVIVSYNEQFF	TRBV5-1	TRBJ2-1
TGTGCCAGCAGCCACGGTTACAACTACGAGCAGTACTTC	CASSHGYNYEQYF	TRBV14	TRBJ2-7
TGCGCCAGCAGTGAGTCTGGACGGACAGCGGGCCCCTGGGACGAGCAGTACTTC	CASSESGRTAGPWDEQYF	TRBV10-1	TRBJ2-7
TGTGCCAGCAGTTTGGGCCCCGACGAGCAGTACTTC	CASSLGPDEQYF	TRBV12-4	TRBJ2-7
TGTGCCAGCAGCTTAGCGCTCCCGGGACAGGGACTGCCCGGGGAGCTGTTTTTT	CASSLALPGQGLPGELFF	TRBV7-4	TRBJ2-2
TGCGCCAGCAGTCACAGGCACAATCAGCCCCAGCATTTT	CASSHRHNQPQHF	TRBV10-1	TRBJ1-5
TGTGCCAGCAGCCGGCCCGGAGGGAGGAGCCTCACTGAAGCTTTCTTT	CASSRPGGRSLTEAFF	TRBV14	TRBJ1-1
TGCGCCAGCAGCCAAGAAGGGGTTTGCAATCAGCCCCAGCATTTT	CASSQEGVCNQPQHF	TRBV4-1	TRBJ1-5
TGCGCCACGGGGGGCGCGGAAGAAGAGACCCAGTACTTC	CATGGAEEETQYF	TRBV5-1	TRBJ2-5
TGCAGCGTTGGGTCCGGGACAGGGGCGTACGAGCAGTACTTC	CSVGSGTGAYEQYF	TRBV29-1	TRBJ2-7
TGTGCCAGCAGTTTATGCCGCCCGTCAGGAAACAGGGGTCACACTGAAGCTTTCTTT	CASSLCRPSGNRGHTEAFF	TRBV28	TRBJ1-1
TGTGCCAGCAGCTTCAGGACTAGCGGGGGGAACGAGCAGTACTTC	CASSFRTSGGNEQYF	TRBV7-8	TRBJ2-7
TGTGCCAGCAGCCAAGATTTGGGACAGGGGCTGCATCAGCCCCAGCATTTT	CASSQDLGQGLHQPQHF	TRBV14	TRBJ1-5
TGCGCCAGCAGTGCCAGGGGTTACGAAAACATTCAGTACTTC	CASSARGYENIQYF	TRBV5-1	TRBJ2-4
TGTGCCAGCAGTTTCAGGGAGGGATATGGCTACACCTTC	CASSFREGYGYTF	TRBV12-3	TRBJ1-2
TGTGCCAGCAGCTTGCCTGACTTTCCTGAAAAACTGTTTTTT	CASSLPDFPEKLFF	TRBV5-6	TRBJ1-4
TGTGCCAGCAGCTGTCCGGGGGGCACAGATACGCAGTATTTT	CASSCPGGTDTQYF	TRBV7-2	TRBJ2-3
TGTGCCAGCAGTGGCGGGGCGTTGCACTCCTACGAGCAGTACTTC	CASSGGALHSYEQYF	TRBV27	TRBJ2-7
TGCGCCAGCAGCTTCCCGGACGGGTATAGAAGGGACACCATATATTTT	CASSFPDGYRRDTIYF	TRBV5-1	TRBJ1-3
TGCAGTGCCGTGAAAAGGGCCGAGCAGTTCTTC	CSAVKRAEQFF	TRBV20-1	TRBJ2-1
TGCAGTGCTAAGTCCGGGACAGGTTTTTACAGACTCGGCTACCCCACTGGCTATGGCTACACCTTC	CSAKSGTGFYRLGYPTGYGYTF	TRBV20-1	TRBJ1-2
TGCGCCAGCAGATGCTGGCCTAGACAGGAGACAAATGACAGCGATACGCAGTATTTT	CASRCWPRQETNDSDTQYF	TRBV5-1	TRBJ2-3
TGTGCCAGCAGCTATGTCGGGGGGAACACAGATACGCAGTATTTT	CASSYVGGNTDTQYF	TRBV7-2	TRBJ2-3
TGTGCCAGCAGTTCAGGGGGATATCGGACCGGGGAGCTGTTTTTT	CASSSGGYRTGELFF	TRBV28	TRBJ2-2
TGTGCCAGCAGCTACCCGGGACAAAATTCACCCCTCCACTTT	CASSYPGQNSPLHF	TRBV5-5	TRBJ1-6
TGTGCCACCAGTGACTATCCGACCGAAGGACAGCTAGGGGGTAAGACGGGTCAGCCCCAGCATTTT	CATSDYPTEGQLGGKTGQPQHF	TRBV24-1	TRBJ1-5
TGTGCCAGCAGCTTAAGGGGGACCTACTATGGCTACACCTTC	CASSLRGTYYGYTF	TRBV7-2	TRBJ1-2
TGTGCCAGCAGCCCGCTGGGTCTCAAGGGGGCCTCTGGTTCACCCCTCCACTTT	CASSPLGLKGASGSPLHF	TRBV5-6	TRBJ1-6
TGCAGTGCTAAATACAGGGGTTATGGAAACACCATATATTTT	CSAKYRGYGNTIYF	TRBV20-1	TRBJ1-3
TGTGCCAGCACCACCTATGGCTACACCTTC	CASTTYGYTF	TRBV27	TRBJ1-2
TGCAGTAAGACCCGGGCCGGGACTAGCGGGAAACGAGCCAACACCGGGGAGCTGTTTTTT	CSKTRAGTSGKRANTGELFF	TRBV20-1	TRBJ2-2
TGTGCCAGCAGTACATTCATAGGTCCACAAAACATTCAGTACTTC	CASSTFIGPQNIQYF	TRBV6-5	TRBJ2-4
TGTGCCAGCAGTGAAGGGGGACAGGGGAGGGGAGAGCAGTTCTTC	CASSEGGQGRGEQFF	TRBV6-4	TRBJ2-1
TGTGCCCGGGCTTCGCGACAGCCCCAGCATTTT	CARASRQPQHF	TRBV10-3	TRBJ1-5
TGTGCCACCACCAAGAGCCAGAGCAATCAGCCCCAGCATTTT	CATTKSQSNQPQHF	TRBV24-1	TRBJ1-5
TGTGCCAGTAGTATAGCATCGGGACATTTCTATGGCTACACCTTC	CASSIASGHFYGYTF	TRBV19	TRBJ1-2
TGCGCCAGCAGCTTGCGCGAGACAGGCAATCGAGGGAATCAGCCCCAGCATTTT	CASSLRETGNRGNQPQHF	TRBV5-1	TRBJ1-5
TGTGCCATCCCCCCGGGGACAGGGGGGATCTGGCGAGGAAACACCATATATTTT	CAIPPGTGGIWRGNTIYF	TRBV10-3	TRBJ1-3
TGTGCCATCAAACACCCGGACAGGGTAAACACCGGGGAGCTGTTTTTT	CAIKHPDRVNTGELFF	TRBV10-3	TRBJ2-2
TGTGCCAGCAGGCTAGGGAATGAGCAGTTCTTC	CASRLGNEQFF	TRBV7-9	TRBJ2-1
TGTGCCAGCAGTAGCCGGAGGGATGACCCCGGCACAGATACGCAGTATTTT	CASSSRRDDPGTDTQYF	TRBV27	TRBJ2-3
TGTGCCAGCAGGGGACCGGGCTATGGCTACACCTTC	CASRGPGYGYTF	TRBV6-5	TRBJ1-2
TGCGCCAGCAGTGAATGCGGGAGGGCCCTAGAAGCTTTCTTT	CASSECGRALEAFF	TRBV10-2	TRBJ1-1
TGTGCCAGCAGGAAAACCCTAGCGGGCCATTCGAACACCGGGGAGCTGTTTTTT	CASRKTLAGHSNTGELFF	TRBV6-5	TRBJ2-2
TGTGCCACCAGTGGCCTGTGGACCTTTAGCTACACCTTC	CATSGLWTFSYTF	TRBV24-1	TRBJ1-2
TGTGCCAGCAGCAGCTCTGTTAGAACCAATGAGCAGTTCTTC	CASSSSVRTNEQFF	TRBV14	TRBJ2-1
TGTGCCCCGGGGGCAGAAAAACTGTTTTTT	CAPGAEKLFF	TRBV6-1	TRBJ1-4
TGTGCCAGCAGTGCTCCACTAACTAGAACTGAAGCTTTCTTT	CASSAPLTRTEAFF	TRBV6-3	TRBJ1-1
TGTGCCAGCAGCTTATTCCCCGCCGTGAGGGTGAACACTGAAGCTTTCTTT	CASSLFPAVRVNTEAFF	TRBV11-3	TRBJ1-1
TGTGCCAGCAGCACAACGGACAGCAGCACAGATACGCAGTATTTT	CASSTTDSSTDTQYF	TRBV7-9	TRBJ2-3
TGTGCCAGCCCAGGGGGCGGAAACACCATATATTTT	CASPGGGNTIYF	TRBV2	TRBJ1-3
TGCAGCTGCGATTATACTAGCGGGAGTGAGAGGCATTTT	CSCDYTSGSERHF	TRBV29-1	TRBJ1-5
TGTGCCAGCAGCTTACCGCGCCTCAGCTACCAAGCTTTCTTT	CASSLPRLSYQAFF	TRBV7-3	TRBJ1-1
TGTGCCAGTAGCCCCCACAGGCGGCCCGGGGAGCTGTTTTTT	CASSPHRRPGELFF	TRBV19	TRBJ2-2
TGTGCCAGCTCACCATCAGTGGTAGTCAGCTACGAGCAGTACTTC	CASSPSVVVSYEQYF	TRBV18	TRBJ2-7
TGTGCCAGCAGTAACCAGGGTAGATTCAATCAGCCCCAGCATTTT	CASSNQGRFNQPQHF	TRBV12-3	TRBJ1-5
TGTGCCAGCATGGGCGCAGCAGGACGAATAGGGAACACTGAAGCTTTCTTT	CASMGAAGRIGNTEAFF	TRBV11-3	TRBJ1-1
TGTGCCAGTAGTCGACGATTGAATAGCACAGATACGCAGTATTTT	CASSRRLNSTDTQYF	TRBV19	TRBJ2-3
TGCGCCAGCAGCCAGCGCGGCAGCACAGATACGCAGTATTTT	CASSQRGSTDTQYF	TRBV4-1	TRBJ2-3
TGTGCCTGGAGGTGTTGGGGTAACGAGCAGTACTTC	CAWRCWGNEQYF	TRBV30	TRBJ2-7
TGTGCCAGCAGTGCAGCTGCTGCCTACAATGAGCAGTTCTTC	CASSAAAAYNEQFF	TRBV27	TRBJ2-1
TGTGCCAGTAGTATCGGCGACTCCTACGAGCAGTACTTC	CASSIGDSYEQYF	TRBV19	TRBJ2-7
TGCGCCAGCAGCGGATGGGACAGGGCGGGCACTGAAGCTTTCTTT	CASSGWDRAGTEAFF	TRBV5-1	TRBJ1-1
TGTGCCAGTAGTATATGGAGCGGTCTGAGCTATGGCTACACCTTC	CASSIWSGLSYGYTF	TRBV19	TRBJ1-2
TGTGCCAGCAGTTTGATACTCCGACGCCAGGGACTGTTTTTT	CASSLILRRQGLFF	TRBV6-4	TRBJ1-4
TGTGCCAGCACCACAGGGGTCAGGGATGGGCCCCAGCATTTT	CASTTGVRDGPQHF	TRBV6-4	TRBJ1-5
TGTGCCAGCAGTTCCGGGGGGGAAAGAACTGAAGCTTTCTTT	CASSSGGERTEAFF	TRBV6-5	TRBJ1-1
TGTGCCAGCACTGACGGCGGGACAGGGGGCTACGAGCAGTACTTC	CASTDGGTGGYEQYF	TRBV5-6	TRBJ2-7
TGTGCCAGCAGCTTTCCAATGATCCCACCTTCCACCGGGGAGCTGTTTTTT	CASSFPMIPPSTGELFF	TRBV7-3	TRBJ2-2
TGTGCCAGCAGCCTAGCGGGCGGGTGGGGGGAAGGCTACAATGAGCAGTTCTTC	CASSLAGGWGEGYNEQFF	TRBV13	TRBJ2-1
TGTGCCAGTAGTATTCCTCTCCGCAGGGCCAGTACTTCTTTGTACGAGCAGTACTTC	CASSIPLRRASTSLYEQYF	TRBV19	TRBJ2-7
TGTGCCAGCAGCTTTGTGCGGGAGGAGCAGTACTTC	CASSFVREEQYF	TRBV13	TRBJ2-7
TGCGCCAGCAGCCAAGCCCTTAGGGCCCTCTACGAGCAGTACTTC	CASSQALRALYEQYF	TRBV4-3	TRBJ2-7
TGTGCCAGCAGCCGTACTAGCGGGAGACACCTAAGCTCCTATAATTCACCCCTCCACTTT	CASSRTSGRHLSSYNSPLHF	TRBV5-6	TRBJ1-6
TGTGCCAGCAGCCTGAAAGTGAGGGGTTTTGGGGATTTCTTGGGATTAAAGAACACCGGGGAGCTGTTTTTT	CASSLKVRGFGDFLGLKNTGELFF	TRBV3-1	TRBJ2-2
TGTGCCAGCAGCAACCTAGGGACGTACAATGAGCAGTTCTTC	CASSNLGTYNEQFF	TRBV13	TRBJ2-1
TGTGCCAGCAGTTACTCGCGTCCGACAGGGAGAGAGACCCAGTACTTC	CASSYSRPTGRETQYF	TRBV6-3	TRBJ2-5
TGTGCCATCAGTGCGGACAGGTCCGGACTCTCGAACACTGAAGCTTTCTTT	CAISADRSGLSNTEAFF	TRBV10-3	TRBJ1-1
TGTGCCAGCAGCTCGGATCAGGGGAAGTCTGGAAACACCATATATTTT	CASSSDQGKSGNTIYF	TRBV7-3	TRBJ1-3
TGTGCCAGCAGTTTCTTAGGGGGGGCCTCGGGTCTTGAGCAGTTCTTC	CASSFLGGASGLEQFF	TRBV12-3	TRBJ2-1
TGTGCCAGCCACAACAGGTTTAAGGGCTACACCTTC	CASHNRFKGYTF	TRBV6-5	TRBJ1-2
TGTGCCAGCAGCGGTCCGAGAAACTATGGCTACACCTTC	CASSGPRNYGYTF	TRBV7-4	TRBJ1-2
TGTGCCAGCAGCTGGTTGACATTAGGAGGGCAGTTCTTC	CASSWLTLGGQFF	TRBV11-3	TRBJ2-1
TGTGCCAGCAGTGTAGTGACAGGGAAGAACTATGGCTACACCTTC	CASSVVTGKNYGYTF	TRBV6-4	TRBJ1-2
TGTGCCAGCAGCTTAGCCGGGACAGGGCTAGGCTACGAGCAGTACTTC	CASSLAGTGLGYEQYF	TRBV7-3	TRBJ2-7
TGTGCCCGCCTTGTAAGCAGTCCTAGCACAGATACGCAGTATTTT	CARLVSSPSTDTQYF	TRBV10-3	TRBJ2-3
TGTGCCAGCAGCCCCCCAGGTGGCTACACCTTC	CASSPPGGYTF	TRBV9	TRBJ1-2
TGTGCCAGCAGTTTACGAACCCTCGGGACAGACTACGAGCAGTACTTC	CASSLRTLGTDYEQYF	TRBV27	TRBJ2-7
TGTGCCAGCAGTCCGGGGGGCCGCGAATCTCAAGAGACCCAGTACTTC	CASSPGGRESQETQYF	TRBV27	TRBJ2-5
TGTGCCAGCAGCTTCCGGGACAGGGAGCCACTAAACAATGAGCAGTTCTTC	CASSFRDREPLNNEQFF	TRBV7-4	TRBJ2-1
TGTGCCAGCAGTGAAACGGGGGGATGGGACACTCGGGGCTATGGCTACACCTTC	CASSETGGWDTRGYGYTF	TRBV6-1	TRBJ1-2
TGTGCCAGCAGCGGCCGCGCGGGAGCACACAATGAGCAGTTCTTC	CASSGRAGAHNEQFF	TRBV7-4	TRBJ2-1
TGCAGCGTTGTCCGGACGGTGCGCTATGGCTACACCTTC	CSVVRTVRYGYTF	TRBV29-1	TRBJ1-2
TGCAGTGCTAGAGGGCTTCAGGGACAGGGGTACAATGAAAAACTGTTTTTT	CSARGLQGQGYNEKLFF	TRBV20-1	TRBJ1-4
TGTGCCAGCAGCATGGGACAGGGGGGCACTGAAGCTTTCTTT	CASSMGQGGTEAFF	TRBV13	TRBJ1-1
TGTGCCAGCAGCATTTTGCCCCGCCTGGGGGGGGGGGACATTCAGTACTTC	CASSILPRLGGGDIQYF	TRBV7-3	TRBJ2-4
TGTGCCAGCAGCTTAGCCGGACTAGATCGTTGGGACTCCTACAATGAGCAGTTCTTC	CASSLAGLDRWDSYNEQFF	TRBV11-3	TRBJ2-1
TGTGCCAGCAGCTTACCCTTTTCTGACAGGGGGGACCATGGCTACACCTTC	CASSLPFSDRGDHGYTF	TRBV7-4	TRBJ1-2
TGTGCCAGCAGACGACGGGGAATTTATGTATACGAGCAGTACTTC	CASRRRGIYVYEQYF	TRBV6-5	TRBJ2-7
TGTGCCAGCAGTTTGGGGCTAGAGACCCAGTACTTC	CASSLGLETQYF	TRBV12-3	TRBJ2-5
TGTGCCAGCACAAGGGACAGGGGGAGGGAGATCGAGCAGTACTTC	CASTRDRGREIEQYF	TRBV2	TRBJ2-7
TGTGCCAGCAGCATCGGACAGGGGCGAGGAAACACCATATATTTT	CASSIGQGRGNTIYF	TRBV7-2	TRBJ1-3
TGTGCCAGCAGCTTGGGCGGAGGGGCTGGGGCCAACGTCCTGACTTTC	CASSLGGGAGANVLTF	TRBV7-2	TRBJ2-6
TGTGCCAGCAGCTTGAGCCGGAGGTATTTAGAGACCCAGTACTTC	CASSLSRRYLETQYF	TRBV5-5	TRBJ2-5
TGTGCAAACGGACAGTACACTGAAGCTTTCTTT	CANGQYTEAFF	TRBV12-5	TRBJ1-1
TGTGCCAGCAGCCAGGGCGAGGACTATGGCTACACCTTC	CASSQGEDYGYTF	TRBV14	TRBJ1-2
TGTGCCAGCAGCGCGTCAGCCCCGGGAAGATCGGGGGAGCTGTTTTTT	CASSASAPGRSGELFF	TRBV6-5	TRBJ2-2
TGTGCCACCAGTGCCTCTAGGAGGAGGAATGAGCAGTTCTTC	CATSASRRRNEQFF	TRBV24-1	TRBJ2-1
TGCGCCAGCAGGGGCAGGGCGAGGGGTGAGCAGTTCTTC	CASRGRARGEQFF	TRBV5-1	TRBJ2-1
TGTGCCAGCAGCCGGTCCGGGCAACTAACAGGGGGTGACAATGAGCAGTTCTTC	CASSRSGQLTGGDNEQFF	TRBV7-3	TRBJ2-1
TGTGCCAGCAGAGGTCTAGCGGATGAGCAGTTCTTC	CASRGLADEQFF	TRBV6-1	TRBJ2-1
TGTGCCAGCAGTTGTCCATGCCAACCGGGAGGTACCACCTACGAGCAGTACTTC	CASSCPCQPGGTTYEQYF	TRBV6-8	TRBJ2-7
TGTGCCAGCAGGGCCCGACAGGTCACCGGGGAGCTGTTTTTT	CASRARQVTGELFF	TRBV6-4	TRBJ2-2
TGCGCCAGCAGCTCCCGCCCGACGGGACAGGGGGAGTATTTGTTGAGCTACGAGCAGTACTTC	CASSSRPTGQGEYLLSYEQYF	TRBV5-1	TRBJ2-7
TGTGCCAGCACGCCAGCCCGGGACAGGGTCACCGGGGAGCTGTTTTTT	CASTPARDRVTGELFF	TRBV7-9	TRBJ2-2
TGTGCCAGCAGCTCGGCATACGCAAACAACACAGATACGCAGTATTTT	CASSSAYANNTDTQYF	TRBV7-3	TRBJ2-3
TGTGCCAGCAAGGGGACACGGAACACTGAAGCTTTCTTT	CASKGTRNTEAFF	TRBV28	TRBJ1-1
TGTGCCAGCAGCCCTTGGGGGGCCGAGCGTGAGACCCAGTACTTC	CASSPWGAERETQYF	TRBV9	TRBJ2-5
TGTGCCAGCAGTTTACCGTCTGGGGGACCCACTGGTGGAACCTCCTACGAGCAGTACTTC	CASSLPSGGPTGGTSYEQYF	TRBV28	TRBJ2-7
TGCGCCAGCAAAAAAACCCAGGAAGGCAGCAATCAGCCCCAGCATTTT	CASKKTQEGSNQPQHF	TRBV10-1	TRBJ1-5
TGCAGCGTCCTCCCCCGCAAGGGTCGCGAGCAGTACTTC	CSVLPRKGREQYF	TRBV29-1	TRBJ2-7
TGTGCCAGACTGGGGGCTAACAGCTCCTATAATTCACCCCTCCACTTT	CARLGANSSYNSPLHF	TRBV27	TRBJ1-6
TGCGCCAGCATCCCACAGCAAACCAATGGCTACACCTTC	CASIPQQTNGYTF	TRBV5-1	TRBJ1-2
TGTGCCAGCAGCTTAATCGGGGCCGCTACTAATGAAAAACTGTTTTTT	CASSLIGAATNEKLFF	TRBV7-8	TRBJ1-4
TGTGCCAGCAGTTTACCCAGGGGTACGAACACCGGGGAGCTGTTTTTT	CASSLPRGTNTGELFF	TRBV28	TRBJ2-2
TGTGCCAGCAGCTGGGGGCAGGACCTAAACACTGAAGCTTTCTTT	CASSWGQDLNTEAFF	TRBV7-6	TRBJ1-1
TGCGCCAGCAGCCTCGAGGCCCAACCCCCAGGTTCACCCCTCCACTTT	CASSLEAQPPGSPLHF	TRBV4-3	TRBJ1-6
TGTGCCAGCAGCCTGTTGTGTAGGGGACAGGGTTCACCCCTCCACTTT	CASSLLCRGQGSPLHF	TRBV13	TRBJ1-6
TGTGCCAGCAGTTTATGTACCCTCGGGAGCTCCTACAATGAGCAGTTCTTC	CASSLCTLGSSYNEQFF	TRBV27	TRBJ2-1
TGCGCCAGCAGCTTCGAGGGGCGGTTCCCCGAGCAGTACTTC	CASSFEGRFPEQYF	TRBV5-1	TRBJ2-7
TGTGCCAGTCGGGGAGACAGGGGAGGCTACACCTTC	CASRGDRGGYTF	TRBV19	TRBJ1-2
TGTGCCAGCAGCCCCCTTTGTTGGTACAGGGTCGGGGAGGACGAGCAGTACTTC	CASSPLCWYRVGEDEQYF	TRBV13	TRBJ2-7
TGTGCCAGCAGTGACGTGATGGGGGGCCCCAATCAGCCCCAGCATTTT	CASSDVMGGPNQPQHF	TRBV6-4	TRBJ1-5
TGTGCCAGCAGCCTCGACAGGGCGGGTGAAAAACTGTTTTTT	CASSLDRAGEKLFF	TRBV13	TRBJ1-4
TGTGCCAGCAGCAAGCCCCGACAGAACTCCTACAATGAGCAGTTCTTC	CASSKPRQNSYNEQFF	TRBV7-3	TRBJ2-1
TGTGCCAGCAGTTACGAAACGACAGGGGCCAACACTGAAGCTTTCTTT	CASSYETTGANTEAFF	TRBV6-2	TRBJ1-1
TGTGCCAGCAGCGTCCCGGGTTTACGACCCCAGCATTTT	CASSVPGLRPQHF	TRBV13	TRBJ1-5
TGTGCCAGCAGCGTAAGACAGGGGGCACGCAATCAGCCCCAGCATTTT	CASSVRQGARNQPQHF	TRBV9	TRBJ1-5
TGTGCCAGCAGTAGCGTTCTGAGGTCGCGGCCCCACACCGGGGAGCTGTTTTTT	CASSSVLRSRPHTGELFF	TRBV6-2	TRBJ2-2
TGTGCCAGCAGTAGGCAAAATGAGCAGTTCTTC	CASSRQNEQFF	TRBV6-4	TRBJ2-1
TGTGCCAGCTCACCATCCCAGAATCAGCCCCAGCATTTT	CASSPSQNQPQHF	TRBV18	TRBJ1-5
TGTGCCAGCCGTAGGGGACAGGGACGAGCTGTCTCTGGAAACACCATATATTTT	CASRRGQGRAVSGNTIYF	TRBV27	TRBJ1-3
TGTGCCAGCAGTTACATCCGCCCTAGCGGAAATGAGCAGTTCTTC	CASSYIRPSGNEQFF	TRBV6-3	TRBJ2-1
TGTGCCAGCAGCTTACCCCGCCCACGGGACAGGGATACCGAGCAGTACTTC	CASSLPRPRDRDTEQYF	TRBV11-3	TRBJ2-7
TGCAGTGCTAGCGAAGGAGAGCCGGCGGACGAGCAGTACTTC	CSASEGEPADEQYF	TRBV20-1	TRBJ2-7
TGCGCCAGCAGCCCAAAAAACCGTAGCGGCAGCGCTTACGAAGAGACCCAGTACTTC	CASSPKNRSGSAYEETQYF	TRBV4-3	TRBJ2-5
TGTGCCACCAGTAGGACAGGCGGATACGAGCAGTACTTC	CATSRTGGYEQYF	TRBV24-1	TRBJ2-7
TGTGCCAGCAAACGGGGGCGGGGGGCTTTCTTT	CASKRGRGAFF	TRBV6-4	TRBJ1-1
TGTGCCAGCAGTCCTGGACTGAACACTGAAGCTTTCTTT	CASSPGLNTEAFF	TRBV6-4	TRBJ1-1
TGTGCCAGCAGTGACTCGATAAGTTCCGGGACACCCTACGAGCAGTACTTC	CASSDSISSGTPYEQYF	TRBV6-4	TRBJ2-7
TGCGCCAGCAGCTTGGTACTAGCCGCTCAGGGGACGAGCAATCAGCCCCAGCATTTT	CASSLVLAAQGTSNQPQHF	TRBV5-1	TRBJ1-5
TGCAGTGGTATAGACAGGGACGACAGGGGCCCTGGCACCGGGGAGCTGTTTTTT	CSGIDRDDRGPGTGELFF	TRBV20-1	TRBJ2-2
TGTGCCAGCAGTGCGTACACCTATTTAGGCGGTTGTCATGTGGATAGCAATCAGCCCCAGCATTTT	CASSAYTYLGGCHVDSNQPQHF	TRBV6-1	TRBJ1-5
TGTGCCAGCAGCTTAGTAAAGGCGGGGGAAGGAGATCAGCCCCAGCATTTT	CASSLVKAGEGDQPQHF	TRBV7-4	TRBJ1-5
TGTGCCAGCAGTTGGCCACAATCCAATGAAAAACTGTTTTTT	CASSWPQSNEKLFF	TRBV6-3	TRBJ1-4
TGTGCCAGCAGCTTAGACAGGGGGGTCGCGACCCTACAAGAGACCCAGTACTTC	CASSLDRGVATLQETQYF	TRBV7-9	TRBJ2-5
TGTGCCAGACCGGGACACACCGTCTATGGCTACACCTTC	CARPGHTVYGYTF	TRBV19	TRBJ1-2
TGCGCCAGCAGCTTGGTTCCCGGACAGGGTGCTTGGAACACCGGGGAGCTGTTTTTT	CASSLVPGQGAWNTGELFF	TRBV5-1	TRBJ2-2
TGTGCTAGCAGGGGACCAATAGTGAACACTGAAGCTTTCTTT	CASRGPIVNTEAFF	TRBV7-7	TRBJ1-1
TGTGCCAGCACAGGGAGTAAAGAGACCCAGTACTTC	CASTGSKETQYF	TRBV6-1	TRBJ2-5
TGTGCCAGCAGCGTATCGTTAGGCGAGCAGTACTTC	CASSVSLGEQYF	TRBV9	TRBJ2-7
TGTGCCAGCAGTCTTAAACGCGGGAGTCAGGGGGTTGGCTACGAGCAGTACTTC	CASSLKRGSQGVGYEQYF	TRBV12-4	TRBJ2-7
TGTGCCAGCAGCGTCTCCGACGCTAGGACTGGAAACACCATATATTTT	CASSVSDARTGNTIYF	TRBV7-9	TRBJ1-3
TGTGCCATAAAAGGGGGGGACACAGATACGCAGTATTTT	CAIKGGDTDTQYF	TRBV10-3	TRBJ2-3
TGTGCCAGCACGGGCATCTATGGCTACACCTTC	CASTGIYGYTF	TRBV6-1	TRBJ1-2
TGTGCCAGCAGTCCCCGGCCTATACTAACTTCTGCCTATGAACCCACTGAAGCTTTCTTT	CASSPRPILTSAYEPTEAFF	TRBV6-2	TRBJ1-1
TGTGCCAGCAGTGTGACAGGGGGCGAGTCACCCCTCCACTTT	CASSVTGGESPLHF	TRBV25-1	TRBJ1-6
TGCAGTGCTAGTTGGTGCAGGCATGAAAAACTGTTTTTT	CSASWCRHEKLFF	TRBV20-1	TRBJ1-4
TGTGCCTCTCTTTGCTGTCATGTCCCTAACTATGGCTACACCTTC	CASLCCHVPNYGYTF	TRBV27	TRBJ1-2
TGCAGCGTTGAAGATCTAGACTATAGCAATCAGCCCCAGCATTTT	CSVEDLDYSNQPQHF	TRBV29-1	TRBJ1-5
TGTGCCAGCAGCAGGACCGGGACAGGTGGCTACACCTTC	CASSRTGTGGYTF	TRBV13	TRBJ1-2
TGTGCCAGCAGTATTGGACTAGCGGGAGGGCTTTATGAAGCTTTCTTT	CASSIGLAGGLYEAFF	TRBV6-1	TRBJ1-1
TGCAGCGTTGAAGATCCCCCTAGCGGGATTCCCTCCTACGAGCAGTACTTC	CSVEDPPSGIPSYEQYF	TRBV29-1	TRBJ2-7
TGTGCCAGCAGCGTGCGTTACAGGGAATGGGTGAACACTGAAGCTTTCTTT	CASSVRYREWVNTEAFF	TRBV9	TRBJ1-1
TGCGCCAGCAGCTTGGCGAGACAGGGCGAGCCCCAGCATTTT	CASSLARQGEPQHF	TRBV5-1	TRBJ1-5
TGCGCCAGCAGCTTGGTTAAGACAGGGAAGAGCACCGGGGAGCTGTTTTTT	CASSLVKTGKSTGELFF	TRBV5-1	TRBJ2-2
TGTGCCAGCTCACCAGGCTCTGACAGGGCAGATACGCAGTATTTT	CASSPGSDRADTQYF	TRBV18	TRBJ2-3
TGTGCCAGCAGCCAAGCCGAGACAGGCTACGAGCAGTACTTC	CASSQAETGYEQYF	TRBV3-1	TRBJ2-7
TGTGCCAGCAGTAACTTCGAGCAATCTAACTATGGCTACACCTTC	CASSNFEQSNYGYTF	TRBV6-1	TRBJ1-2
TGTGCCAGCAGTTCGTCTAGGGGCACCTCCTACGAGCAGTACTTC	CASSSSRGTSYEQYF	TRBV6-1	TRBJ2-7
TGTGCCAGCAGTCGGGGGCCGAACAGGTACAATGAGCAGTTCTTC	CASSRGPNRYNEQFF	TRBV6-5	TRBJ2-1
TGTGCCAGCAAAGGGGACAGGGAGGGGACGAACACTGAAGCTTTCTTT	CASKGDREGTNTEAFF	TRBV6-2	TRBJ1-1
TGTGCCAGCAGCTACCGCTCATCCGAAAAACTGTTTTTT	CASSYRSSEKLFF	TRBV7-9	TRBJ1-4
TGCAGCGTCACTAGAATAAAATCCTACGAGCAGTACTTC	CSVTRIKSYEQYF	TRBV29-1	TRBJ2-7
TGTGCCAGCAAGGAAGCCCGGGACAGGGAAGTGAGAACCGGGGAGCTGTTTTTT	CASKEARDREVRTGELFF	TRBV11-2	TRBJ2-2
TGCAGTGCTCGAGAGAAAAGCTCCTACAATGAGCAGTTCTTC	CSAREKSSYNEQFF	TRBV20-1	TRBJ2-1
TGCAGTGCCCAGGGTGAAAAACTGTTTTTT	CSAQGEKLFF	TRBV20-1	TRBJ1-4
TGTGCCAGCATTATAAACAGGGACTCCTACGAGCAGTACTTC	CASIINRDSYEQYF	TRBV27	TRBJ2-7
TGTGCCAGCAGCGGGGGACAGGGTAGCTCTGGGGCCAACGTCCTGACTTTC	CASSGGQGSSGANVLTF	TRBV7-9	TRBJ2-6
TGTGCCAGCAGTTTGGGGACCGGGTATAGCAATCAGCCCCAGCATTTT	CASSLGTGYSNQPQHF	TRBV6-3	TRBJ1-5
TGTGCCAGCAGACTGGGGCCAGCAGATGGCTACACCTTC	CASRLGPADGYTF	TRBV11-1	TRBJ1-2
TGTGCCAGCAGCGGGGTTTATAAGGGCTACGAGCAGTACTTC	CASSGVYKGYEQYF	TRBV5-4	TRBJ2-7
TGTGCCAGCAGCTTGGGGTGCGATACGCAGTATTTT	CASSLGCDTQYF	TRBV11-2	TRBJ2-3
TGCACCCCGGACAGGGAGGACGATCAGCCCCAGCATTTT	CTPDREDDQPQHF	TRBV29-1	TRBJ1-5
TGTGCCATCAGACGCAGGGGGTCGGATCTTATTTCGAATGGCTACACCTTC	CAIRRRGSDLISNGYTF	TRBV10-3	TRBJ1-2
TGTGCCAGCTCACCACCGCTAAGAATTGGACAGGGGTGCGAAAAACTGTTTTTT	CASSPPLRIGQGCEKLFF	TRBV18	TRBJ1-4
TGTGCCAGCAGTTTCCTGGGGGGGCGGGGGGGCACAGATACGCAGTATTTT	CASSFLGGRGGTDTQYF	TRBV28	TRBJ2-3
TGCAGTGCTAGAGATGTAGTCTACGAGCAGTACTTC	CSARDVVYEQYF	TRBV20-1	TRBJ2-7
TGTGCCAGCAGCTTCCTGGGACGAATCGAGCAGTACTTC	CASSFLGRIEQYF	TRBV11-2	TRBJ2-7
TGCGCCAGCAGTGCCGGGAACTACGAGCAGTACTTC	CASSAGNYEQYF	TRBV10-1	TRBJ2-7
TGTGCCAGTAGTATACAAATCTGCGGGAGCAGCAATCAGCCCCAGCATTTT	CASSIQICGSSNQPQHF	TRBV19	TRBJ1-5
TGTGCCAGCAGCAATTGGTCTGGGACAGGGGGTGAAGGGGAGACCCAGTACTTC	CASSNWSGTGGEGETQYF	TRBV7-3	TRBJ2-5
TGTGCCAGCAGCTTAACGAGAAAAGGGACAGGATTGAACACTGAAGCTTTCTTT	CASSLTRKGTGLNTEAFF	TRBV7-3	TRBJ1-1
TGTGCCTGGGATAGCAAGGCGTTTGAGCAGTTCTTC	CAWDSKAFEQFF	TRBV30	TRBJ2-1
TGCGCCAGCAGCCAAGATACCTGTCCCGACAGGGAGCTAGCAACTAATGAAAAACTGTTTTTT	CASSQDTCPDRELATNEKLFF	TRBV4-1	TRBJ1-4
TGTGCCAGCAGCTTACCGGGGTTGCGCTACGAGCAGTACTTC	CASSLPGLRYEQYF	TRBV7-9	TRBJ2-7
TGCAGTGCTAGAGTACGTAGCGGCCCCTCCTGCGAGACCCAGTACTTC	CSARVRSGPSCETQYF	TRBV20-1	TRBJ2-5
TGCGCCAGCAGTGACGGTGGTGGACAGGGCCCGAGCAATGAGCAGTTCTTC	CASSDGGGQGPSNEQFF	TRBV10-1	TRBJ2-1
TGTGCCAGCAGCGGGACTAGGGTGGATACGCAGTATTTT	CASSGTRVDTQYF	TRBV13	TRBJ2-3
TGTGCCAGCAGGACAGGCTATGGCTACACCTTC	CASRTGYGYTF	TRBV14	TRBJ1-2
TGTGCCAGCAGCGTACTGGAAAGTAAAAATGGAAACACCATATATTTT	CASSVLESKNGNTIYF	TRBV9	TRBJ1-3
TGTGCCAGCAGCTCAGCAGGGGCCAAAAACATTCAGTACTTC	CASSSAGAKNIQYF	TRBV3-1	TRBJ2-4
TGCGCCAGCAGCCAAGATGACAGAATGGGAGGGGGGGATCCAGATACGCAGTATTTT	CASSQDDRMGGGDPDTQYF	TRBV4-1	TRBJ2-3
TGTGCCAGCAACGACAGTGTCTTGTGGATGAACACTGAAGCTTTCTTT	CASNDSVLWMNTEAFF	TRBV6-3	TRBJ1-1
TGCGCCAGCAGATCCGGATGGACTGAAGCTTTCTTT	CASRSGWTEAFF	TRBV5-1	TRBJ1-1
TGTGCCAGCAGTTACCCGAGTCGTTTCAATGAGCAGTTCTTC	CASSYPSRFNEQFF	TRBV6-9	TRBJ2-1
TGTGCCAGCAGCAACAGGGCTCCAGTACAGCCCCAGCATTTT	CASSNRAPVQPQHF	TRBV6-1	TRBJ1-5
TGTGCCAGCAGCAGGGATAGCAATCAGCCCCAGCATTTT	CASSRDSNQPQHF	TRBV27	TRBJ1-5
TGTGCCAGCAGCCTACTAGGTACCGGGGAGCTGTTTTTT	CASSLLGTGELFF	TRBV13	TRBJ2-2
TGTGCCAGTAGTATGGTTCTGACCGGGACAGAGGGGAATCAGCCCCAGCATTTT	CASSMVLTGTEGNQPQHF	TRBV19	TRBJ1-5
TGTGCCAGCAGTCCAGGGACAGGGATCGGTGAGCAGTTCTTC	CASSPGTGIGEQFF	TRBV6-4	TRBJ2-1
TGTGCCAGCAGCTTGCGGACAGAGGATCGCGAGAACACTGAAGCTTTCTTT	CASSLRTEDRENTEAFF	TRBV7-9	TRBJ1-1
TGTGCCACCAGTTCCCCTTTGGGTACCCACTACGAGCAGTACTTC	CATSSPLGTHYEQYF	TRBV24-1	TRBJ2-7
TGTGCCTGGAGTGTACGGACAGGGGAGGAAGAGCCCCAGCATTTT	CAWSVRTGEEEPQHF	TRBV30	TRBJ1-5
TGCGCCAGCAGCCAAAGACAGGGAACTAATGAAAAACTGTTTTTT	CASSQRQGTNEKLFF	TRBV4-1	TRBJ1-4
TGTGCCAGCAGACGGCATCATAATTCACCCCTCCACTTT	CASRRHHNSPLHF	TRBV6-5	TRBJ1-6
TGTGCCAGCAGCTTATGGACTAGCGGGAGGGCGTATAGCAATCAGCCCCAGCATTTT	CASSLWTSGRAYSNQPQHF	TRBV7-8	TRBJ1-5
TGTGCCAGTAGTGACAGGGGCCCATCAGGCTACACCTTC	CASSDRGPSGYTF	TRBV19	TRBJ1-2
TGTGCCAGCAGAAAGGACAGGGAACGCTTT	CASRKDRERF	TRBV7-2	TRBJ1-1
TGCAGTGCTAGAGTAGACAGGAGACCCCTCCACTTT	CSARVDRRPLHF	TRBV20-1	TRBJ1-6
TGTGCCAGCAGTCGACAGCTACACTGCAATCAGCCCCAGCATTTT	CASSRQLHCNQPQHF	TRBV12-3	TRBJ1-5
TGTGCCAGCCGCGACAGGGGTTTGAACACTGAAGCTTTCTTT	CASRDRGLNTEAFF	TRBV7-9	TRBJ1-1
TGCAGTGCCCGTGGGGAGGTAAGGGACGAGCAGTACTTC	CSARGEVRDEQYF	TRBV20-1	TRBJ2-7
TGTGCCAGCAGTCTAGACAGGGGAGCTTTCTTT	CASSLDRGAFF	TRBV27	TRBJ1-1
TGTGCCAGCAGTAAGGGACAGGGGGCTTTGTTAATCTACGAGCAGTACTTC	CASSKGQGALLIYEQYF	TRBV27	TRBJ2-7
TGTGCCAGCAGTTCCCCGGGGCTAAACAGGGGGACAGATACGCAGTATTTT	CASSSPGLNRGTDTQYF	TRBV6-5	TRBJ2-3
TGTGCCAGCAGCTCTGACCCGGAGGATGAAAAACTGTTTTTT	CASSSDPEDEKLFF	TRBV11-2	TRBJ1-4
TGTGCCAGCAGTGACAGGGGGGGGCACCATGAAAAACTGTTTTTT	CASSDRGGHHEKLFF	TRBV6-4	TRBJ1-4
TGTGCCAGCAGCTTGACAGCATATCGAGAGACCCAGTACTTC	CASSLTAYRETQYF	TRBV7-8	TRBJ2-5
TGTGCCAGCAGCGTAGCTATCTCCCCTAGCTCTATAGCTTTCTTT	CASSVAISPSSIAFF	TRBV9	TRBJ1-1
TGTGCCAGCAGCTTAGACAGGGACTATGGCTACACCTTC	CASSLDRDYGYTF	TRBV7-3	TRBJ1-2
TGTGCCAGCAGTTTCCATTCATATGGCTACACCTTC	CASSFHSYGYTF	TRBV7-3	TRBJ1-2
TGCAGTGCTAGAGTTTCACAGGTTAGCCCCCCTCAGCCCCAGCATTTT	CSARVSQVSPPQPQHF	TRBV20-1	TRBJ1-5
TGTGCCACCAGCAGGAGGGCCCTGTACAATGAGCAGTTCTTC	CATSRRALYNEQFF	TRBV15	TRBJ2-1
TGTGCTAGTGAAAAAAGCTTGGCCAAGGATTTCACCGGGGAGCTGTTTTTT	CASEKSLAKDFTGELFF	TRBV12-5	TRBJ2-2
TGTGCCAGCAGCCAAGATCAGACTAGCGGGTTTTCTACAGATACGCAGTATTTT	CASSQDQTSGFSTDTQYF	TRBV14	TRBJ2-3
TGTGCCTGGAGTGATGCGGGGTACTCCTACGAGCAGTACTTC	CAWSDAGYSYEQYF	TRBV30	TRBJ2-7
TGTGCCAGCAGCGGGGGAAGCTCCTACGAGCAGTACTTC	CASSGGSSYEQYF	TRBV7-3	TRBJ2-7
TGTGCCAGCAAACGCGAACGAACCCTCGGACAGGGGACTGAAGCTTTCTTT	CASKRERTLGQGTEAFF	TRBV12-3	TRBJ1-1
TGTGCCAGCAGTAACACGACTAGCGGGAGTGTCTCACTTGGTTACGAGCAGTACTTC	CASSNTTSGSVSLGYEQYF	TRBV11-3	TRBJ2-7
TGTGCCATCCCTGGTTGGATGCCGGAGAACACTGAAGCTTTCTTT	CAIPGWMPENTEAFF	TRBV10-3	TRBJ1-1
TGTGCCAGCAGGATGACCTACCACGATGGCTACACCTTC	CASRMTYHDGYTF	TRBV6-5	TRBJ1-2
TGTGCCAGCAGCTTAGGCTTCGTATCCTACAGCTCCTATAATTCACCCCTCCACTTT	CASSLGFVSYSSYNSPLHF	TRBV7-2	TRBJ1-6
TGTGCCAGCAAGGGAGACAGTGGCTACACCTTC	CASKGDSGYTF	TRBV6-5	TRBJ1-2
TGTGCCAGCAGCTTAATCTGGGCGGAAGGCTCCTACGAGCAGTACTTC	CASSLIWAEGSYEQYF	TRBV11-3	TRBJ2-7
TGTGCCATCAGTGAACCGACAGGCCTCAGCAATCAGCCCCAGCATTTT	CAISEPTGLSNQPQHF	TRBV10-3	TRBJ1-5
TGTGCCAGAAGTAGACTAGATACGCAGTATTTT	CARSRLDTQYF	TRBV6-6	TRBJ2-3
TGTGCCATTGGGACTGTAGGGGGGTCCTACAATGAGCAGTTCTTC	CAIGTVGGSYNEQFF	TRBV19	TRBJ2-1
TGTGCCAGCATTCGAACCGGGACTAGGCGGGATGATGAGCAGTTCTTC	CASIRTGTRRDDEQFF	TRBV7-9	TRBJ2-1
TGTGCCAGCAGCTTTGTGGGGACTGCTAACTATGGCTACACCTTC	CASSFVGTANYGYTF	TRBV7-4	TRBJ1-2
TGCGCCAGCAGCCAAGGTGGATCGTCCTACGAGCAGTACTTC	CASSQGGSSYEQYF	TRBV4-1	TRBJ2-7
TGTGCCAGCAGTTTGACAGGGCGGGCCCGGAACACTGAAGCTTTCTTT	CASSLTGRARNTEAFF	TRBV28	TRBJ1-1
TGTGCCAGCAGTTGGGGACTAGCGGGGGGGCCGAGGAAGTACTTC	CASSWGLAGGPRKYF	TRBV27	TRBJ2-7
TGTGCCAGCGGGGTACGATGTGCCCCATTAGATGGGGGCGGGGACGAGCAGTACTTC	CASGVRCAPLDGGGDEQYF	TRBV11-2	TRBJ2-7
TGTGCCAGCAGGCCTCCCGGGACTAGCACCCAACAAGAGACCCAGTACTTC	CASRPPGTSTQQETQYF	TRBV5-4	TRBJ2-5
TGTGCTATTGGGACAGGGGGCGTTGGAGAGACCCAGTACTTC	CAIGTGGVGETQYF	TRBV7-3	TRBJ2-5
TGTGCCAGCAGCCAAGAACCGGACAGGGGCTTCGAAAACTATGGCTACACCTTC	CASSQEPDRGFENYGYTF	TRBV4-2	TRBJ1-2
TGTGCCAGCAGTTCTAGGAAGCAGAGCTCCTACGAGCAGTACTTC	CASSSRKQSSYEQYF	TRBV28	TRBJ2-7
TGCAGCGGGGGGGGAAACACCATATATTTT	CSGGGNTIYF	TRBV29-1	TRBJ1-3
TGTGCCAGCAGCTTCCCTGCGGGAGAGAAAAACTCTGGGGCCAACGTCCTGACTTTC	CASSFPAGEKNSGANVLTF	TRBV5-4	TRBJ2-6
TGTGCCAGCAGTTATCGGCTCCAACCCTCCTACGAGCAGTACTTC	CASSYRLQPSYEQYF	TRBV6-5	TRBJ2-7
TGTGCCAGCAGCCAACTCGGGTATTCGAACACTGAAGCTTTCTTT	CASSQLGYSNTEAFF	TRBV7-3	TRBJ1-1
TGCAGCGTTGTAGGCGGCAGGCCTGAGTCCTACGAGCAGTACTTC	CSVVGGRPESYEQYF	TRBV29-1	TRBJ2-7
TGTGCCAGCAGTGCCACAGGGGAGTACGAGCAGTACTTC	CASSATGEYEQYF	TRBV2	TRBJ2-7
TGCGCCAGCAGCTTGCAGGGACAGGGCCGTACCCACACTGAAGCTTTCTTT	CASSLQGQGRTHTEAFF	TRBV5-1	TRBJ1-1
TGTGCCAGCAGCCGCTCTTGCAGGAGAAACACCATATATTTT	CASSRSCRRNTIYF	TRBV7-3	TRBJ1-3
TGCGCCGAGAGACAGGTTGGGGTACGAGTCGGCTACACCTTC	CAERQVGVRVGYTF	TRBV10-1	TRBJ1-2
TGTGCCAGCAGTGACAGCTCAATAGGGAACACCGGGGAGCTGTTTTTT	CASSDSSIGNTGELFF	TRBV6-4	TRBJ2-2
TGTGCCAGCAGTGAGACCGGGACAGGGGGACGCTACACCTTC	CASSETGTGGRYTF	TRBV2	TRBJ1-2
TGTGCCAGCAGCTTAGGACAGGGGGCGGGGGGGACCAATGAAAAACTGTTTTTT	CASSLGQGAGGTNEKLFF	TRBV7-4	TRBJ1-4
TGTGCCAGCCTAGAGGACAATGAGCAGTTCTTC	CASLEDNEQFF	TRBV7-9	TRBJ2-1
TGTGCCAGCAGTTACTCGAGTGGGGGGGCGGGACCGCACGACAATGAGCAGTTCTTC	CASSYSSGGAGPHDNEQFF	TRBV6-6	TRBJ2-1
TGTGCCAGACGTCAGGGGATCTTTACTTCAGTGAACACTGAAGCTTTCTTT	CARRQGIFTSVNTEAFF	TRBV14	TRBJ1-1
TGTGCCAGCTCACCATCCCGTGGGCTCGGAGTTTCACCCCTCCACTTT	CASSPSRGLGVSPLHF	TRBV18	TRBJ1-6
TGTGCCAGCAGTTACGGCGGTCGGGACAGGGCAGCATGGGGCTACACCTTC	CASSYGGRDRAAWGYTF	TRBV6-5	TRBJ1-2
TGTGCCAGCAGCCCATGTCCCGGGACAGGGGAATATGAACTCTACGAGCAGTACTTC	CASSPCPGTGEYELYEQYF	TRBV6-4	TRBJ2-7
TGTGCCAGCACATCCGGCGGGACAGGGGACCTAAGAAGGAACACTGAAGCTTTCTTT	CASTSGGTGDLRRNTEAFF	TRBV7-9	TRBJ1-1
TGTGCCAGCCCCACGGACAGGACTAGTATGACCTACGAGCAGTACTTC	CASPTDRTSMTYEQYF	TRBV2	TRBJ2-7
TGTGCCAGGGAGGGCTTCTTACCGACTACACCCCTCCACTTT	CAREGFLPTTPLHF	TRBV6-4	TRBJ1-6
TGTGCCAGCAGTTACTCGAGTCTCAATGGGGTTGATGGCTACACCTTC	CASSYSSLNGVDGYTF	TRBV6-8	TRBJ1-2
TGTGCCAGCAGCGGTTGTATGACAGATACGCAGTATTTT	CASSGCMTDTQYF	TRBV4-2	TRBJ2-3
TGTGCCAGCATCCAGGGATATGGCTACACCTTC	CASIQGYGYTF	TRBV14	TRBJ1-2
TGTGCCAGGCCCGATAGCGGGTCAGAGACCCAGTACTTC	CARPDSGSETQYF	TRBV19	TRBJ2-5
TGTGCCAGCAGCCATCAGACAGGGACATACGAGCAGTACTTC	CASSHQTGTYEQYF	TRBV12-3	TRBJ2-7
TGCAGTGCTAGAGCCCTACGGGTCTCTGGAAACACCATATATTTT	CSARALRVSGNTIYF	TRBV20-1	TRBJ1-3
TGTGCCAGCTCAATAAAACCAGGGGGAGAGACCCAGTACTTC	CASSIKPGGETQYF	TRBV18	TRBJ2-5
TGTGCCAGCAGTGACTCGATGAGTAGCCTGGACTGGAACACTGAAGCTTTCTTT	CASSDSMSSLDWNTEAFF	TRBV6-4	TRBJ1-1
TGCGCCAGCAGCTTGGCATGGGACAGATCTTACGAGCAGTACTTC	CASSLAWDRSYEQYF	TRBV5-1	TRBJ2-7
TGCGCCAGCAGTGTCCAACGGGGGCACAATGAGCAGTTCTTC	CASSVQRGHNEQFF	TRBV10-1	TRBJ2-1
TGTGCCAGCAGAGAAAGAGGTGACTACGAGCAGTACTTC	CASRERGDYEQYF	TRBV2	TRBJ2-7
TGTGCCTGGCCCGACAGGACTGAAGCTTTCTTT	CAWPDRTEAFF	TRBV30	TRBJ1-1
TGTGCCAGTAGTATGGCCAGGGGGCCTTCCAGGAACACTGAAGCTTTCTTT	CASSMARGPSRNTEAFF	TRBV19	TRBJ1-1
TGTGCCAGCAGCGCGGGACGGGGGGGGGGAGGGGTAGCCTACGAGCAGTACTTC	CASSAGRGGGGVAYEQYF	TRBV13	TRBJ2-7
TGTGCCAGCAGCTTAGTCTTTACCCAACTAGCGGGCGAGCAGTACTTC	CASSLVFTQLAGEQYF	TRBV7-9	TRBJ2-7
TGTGCCAGCAGCTTCTTCGGGACTAGCACGACCTACGAGCAGTACTTC	CASSFFGTSTTYEQYF	TRBV11-2	TRBJ2-7
TGCGCCAGCAGTGAGTCGGGGGGCCCAATGGGAGACGAGCAGTACTTC	CASSESGGPMGDEQYF	TRBV10-2	TRBJ2-7
TGTGCCAGCAGCCAAGGACAGTCGGGGGAGAATGAGCAGTTCTTC	CASSQGQSGENEQFF	TRBV3-1	TRBJ2-1
TGTGCCAGTAGTACCATGCTACATCGAAATGAGCAGTTCTTC	CASSTMLHRNEQFF	TRBV19	TRBJ2-1
TGTGCCAGCAGCCAAGTCTATGTACAGGGGTACTACGAGCAGTACTTC	CASSQVYVQGYYEQYF	TRBV4-2	TRBJ2-7
TGTGCTAGTGGTTCCGGAAGGGACAGGGGTTGGGTTGAAAAACTGTTTTTT	CASGSGRDRGWVEKLFF	TRBV12-5	TRBJ1-4
TGCAGTGCGGGCGGGACAGTTGGAGATACGCAGTATTTT	CSAGGTVGDTQYF	TRBV20-1	TRBJ2-3
TGCGCCAGCAGTGAAGTAACAGACAGGGCTTTCTTT	CASSEVTDRAFF	TRBV10-2	TRBJ1-1
TGTGCCACCACCTCACAGGGCTCAAGCAATCAGCCCCAGCATTTT	CATTSQGSSNQPQHF	TRBV24-1	TRBJ1-5
TGTGCCAGCAGTAACGCCTCTGGAAACACCATATATTTT	CASSNASGNTIYF	TRBV28	TRBJ1-3
TGTGCCAGCAGCTTAAAAGGCTATGGTGAGCAGTTCTTC	CASSLKGYGEQFF	TRBV7-2	TRBJ2-1
TGTGCCACCAGAGAACACCGCCCCTTTAGATTCTACAATGAGCAGTTCTTC	CATREHRPFRFYNEQFF	TRBV24-1	TRBJ2-1
TGCAGTGCTAGAGGACCGCATAACTATGGCTACACCTTC	CSARGPHNYGYTF	TRBV20-1	TRBJ1-2
TGTGCCAGCAGACTGGGGGGGGGATTTAGGAACACTGAAGCTTTCTTT	CASRLGGGFRNTEAFF	TRBV6-5	TRBJ1-1
TGTGCCAGCAGTTACCTTAGGATCCTTTTTAGGAGAAGCACAGATACGCAGTATTTT	CASSYLRILFRRSTDTQYF	TRBV6-5	TRBJ2-3
TGTGCCAGCAGTGAAGAATCCCCCCTAGCGGCCGGGGAGCTGTTTTTT	CASSEESPLAAGELFF	TRBV2	TRBJ2-2
TGTGCCAGCAGTTACAGTGGGGCACCAGCGGAAACACCCCTCCACTTT	CASSYSGAPAETPLHF	TRBV6-8	TRBJ1-6
TGTGCCAGCATTGTAGGGGGTGGAAACACCATATATTTT	CASIVGGGNTIYF	TRBV11-3	TRBJ1-3
TGTGCCAGCAGTACCGACCCTACCCCCTTTAATAGCAATCAGCCCCAGCATTTT	CASSTDPTPFNSNQPQHF	TRBV27	TRBJ1-5
TGTGCCAGCAGTTTACCTGTAACGGACAACTACGAGCAGTACTTC	CASSLPVTDNYEQYF	TRBV12-3	TRBJ2-7
TGTGCCAGCAGTGTGGCGTTGGCCGCTAACTATGGCTACACCTTC	CASSVALAANYGYTF	TRBV2	TRBJ1-2
TGCAGTGCTAGAGCGGGACTAGCGGGGGGGAACACCGGGGAGCTGTTTTTT	CSARAGLAGGNTGELFF	TRBV20-1	TRBJ2-2
TGTGCCAGCAGTGATTCCGCGGGAGGCTCCGGGGAGCTGTTTTTT	CASSDSAGGSGELFF	TRBV6-4	TRBJ2-2
TGTGCCAGCAGTAGGGTCCCTAGCGGGAAGATCAATGAGCAGTTCTTC	CASSRVPSGKINEQFF	TRBV6-2	TRBJ2-1
TGTGCCAGCACGAAGGGGACCGGGTACAATGAGCAGTTCTTC	CASTKGTGYNEQFF	TRBV27	TRBJ2-1
TGTGCCAGCAGTCACGGGGTAGGACTGTATACTGAAGCTTTCTTT	CASSHGVGLYTEAFF	TRBV6-3	TRBJ1-1
TGCAGTGCTAGAGTGGGACAGGGGGACTACGAGCAGTACTTC	CSARVGQGDYEQYF	TRBV20-1	TRBJ2-7
TGTGCCAGCACCCACCCACTAGCGGTCCCCCTCTGGGACGAGCAGTACTTC	CASTHPLAVPLWDEQYF	TRBV7-3	TRBJ2-7
TGTGCCAGCAGCCCCGGAGGTCGGGATAGGGGCTACGAGCAGTACTTC	CASSPGGRDRGYEQYF	TRBV13	TRBJ2-7
TGCGCCAGCAGCTTGTCACAGGGGTCTAACACAGATACGCAGTATTTT	CASSLSQGSNTDTQYF	TRBV5-1	TRBJ2-3
TGTGCCAGCAGCCCCCGGGACAGGGGGGTCACCTCCTACGAGCAGTACTTC	CASSPRDRGVTSYEQYF	TRBV13	TRBJ2-7
TGTGCCAGCAGCCCGGGACATATGAACACTGAAGCTTTCTTT	CASSPGHMNTEAFF	TRBV11-3	TRBJ1-1
TGCAGTGCTAGTCCCACCGCTGGAACTAATGAAAAACTGTTTTTT	CSASPTAGTNEKLFF	TRBV20-1	TRBJ1-4
TGTGCCAGCAGTTTAAGAGTTAGCAATCAGCCCCAGCATTTT	CASSLRVSNQPQHF	TRBV28	TRBJ1-5
TGTGCCAGCAGCTCATTAGGGAAGTTCGGGACAGGGGCGGGTGCAACTAATGAAAAACTGTTTTTT	CASSSLGKFGTGAGATNEKLFF	TRBV7-9	TRBJ1-4
TGTGCCAATATCCACGGGACGTCTAGCTCCTACAATGAGCAGTTCTTC	CANIHGTSSSYNEQFF	TRBV14	TRBJ2-1
TGTGCCAGCAGCCCTTTAGACTATGGCTACACCTTC	CASSPLDYGYTF	TRBV7-6	TRBJ1-2
TGTGCCAGCATAACAGGTATCGCTAATACGCAGTATTTT	CASITGIANTQYF	TRBV13	TRBJ2-3
TGTGCCAGCAGCTTAGTCTCCCGAAAAAATGGCTACACCTTC	CASSLVSRKNGYTF	TRBV7-2	TRBJ1-2
TGCAGTGCTAGAGCTAGAATCGATAGCAATCAGCCCCAGCATTTT	CSARARIDSNQPQHF	TRBV20-1	TRBJ1-5
TGCGCCAGCAGCTCCCTCCAGGGGGGGAAAAATCCCAATGAGCAGTTCTTC	CASSSLQGGKNPNEQFF	TRBV5-1	TRBJ2-1
TGCGCCAGCAGCCAAGACCCCGGGACAGGGGACAATGAGCAGTTCTTC	CASSQDPGTGDNEQFF	TRBV4-1	TRBJ2-1
TGTGCCAGCAGTGACCAAAGAGAGGAGACCCAGTACTTC	CASSDQREETQYF	TRBV6-4	TRBJ2-5
TGCAGTGCTAGAGATAGCCGACAGAGAAGGGTCTCCTATAATTCACCCCTCCACTTT	CSARDSRQRRVSYNSPLHF	TRBV20-1	TRBJ1-6
TGTGCCAGCAGTTTTCGGGGGCGGATGGAACTGGCTGGGGCCAACGTCCTGACTTTC	CASSFRGRMELAGANVLTF	TRBV28	TRBJ2-6
TGTGCCAGCAGGGTGTCCTCTTCCGGGACAGGGGCTCCAGATACGCAGTATTTT	CASRVSSSGTGAPDTQYF	TRBV6-3	TRBJ2-3
TGTGCCAGCAGCCAGGTTACCCTGAACACTGAAGCTTTCTTT	CASSQVTLNTEAFF	TRBV5-6	TRBJ1-1
TGTGCCAGCAGCCAAGCTAAAAGGGGACAGGGCACCGGGGAGCTGTTTTTT	CASSQAKRGQGTGELFF	TRBV4-2	TRBJ2-2
TGCAGTGCTATGCCCCGCCCGGGACTTTGCAATCAGCCCCAGCATTTT	CSAMPRPGLCNQPQHF	TRBV20-1	TRBJ1-5
TGTGCCAGCAGTAATAACGGGGGGGGGCCCTTCGGCACAGATACGCAGTATTTT	CASSNNGGGPFGTDTQYF	TRBV27	TRBJ2-3
TGTGCCACCAGTGATTCTAGCAAAGATGAGCAGTTCTTC	CATSDSSKDEQFF	TRBV24-1	TRBJ2-1
TGTGCCTGGAGCGTTAGGGACAGGGCCAGCAATCAGCCCCAGCATTTT	CAWSVRDRASNQPQHF	TRBV30	TRBJ1-5
TGTGCCAGCCTTGCATACCGCACAGATACGCAGTATTTT	CASLAYRTDTQYF	TRBV11-2	TRBJ2-3
TGTGCCAGCAGCATAGCTTTGGACAGCTACGAGCAGTACTTC	CASSIALDSYEQYF	TRBV7-3	TRBJ2-7
TGTGCCAGCAGTGACTCTTCCCTCGGTGTAGCGGGCCCCTACAATGAGCAGTTCTTC	CASSDSSLGVAGPYNEQFF	TRBV6-4	TRBJ2-1
TGTGCCAGCTCACCACCGCCCAGGGGAAGGAGGGGTGGCTACACCTTC	CASSPPPRGRRGGYTF	TRBV18	TRBJ1-2
TGTGCCAGCGGAGGAAGGGGGGGCTATGGCTACACCTTC	CASGGRGGYGYTF	TRBV6-4	TRBJ1-2
TGTGCCAGCAGTGCCCCAGGACAGGGGATACTTCTCGGTCGCAGGATACCCATGAACACTGAAGCTTTCTTT	CASSAPGQGILLGRRIPMNTEAFF	TRBV6-4	TRBJ1-1
TGTGCCAGCAGCTTTCAGCTGGACAGGGATAATTCACCCCTCCACTTT	CASSFQLDRDNSPLHF	TRBV7-3	TRBJ1-6
TGCGCCAGCAGTGTTCGATACAATGAGCAGTTCTTC	CASSVRYNEQFF	TRBV10-1	TRBJ2-1
TGTGCCAGCAGTTACTCGAGCGGCCCCATGACAGGGGAATACACCTTC	CASSYSSGPMTGEYTF	TRBV6-5	TRBJ1-2
TGTGCCAGCAGCTTGCCCTACAGGGGGTGTCCATACGAGCAGTACTTC	CASSLPYRGCPYEQYF	TRBV7-2	TRBJ2-7
TGTGCCAGCACCCACAGGAATCAGCCCCAGCATTTT	CASTHRNQPQHF	TRBV3-1	TRBJ1-5
TGTGCCAGCAGGGACACCCCCCGGGGGTTAGATTCTTCAGATACGCAGTATTTT	CASRDTPRGLDSSDTQYF	TRBV27	TRBJ2-3
TGTGCCAGCAGCCGGGTTACAGGGTTTACGGAAAAACTGTTTTTT	CASSRVTGFTEKLFF	TRBV14	TRBJ1-4
TGTGCCAGCAGCTCCCTGGGGGGGCATACAGATACGCAGTATTTT	CASSSLGGHTDTQYF	TRBV7-2	TRBJ2-3
TGTGCCAGCAGTGCAACAGGGGGCTCTGGAAACACCATATATTTT	CASSATGGSGNTIYF	TRBV6-5	TRBJ1-3
TGTGCCAGCAGCAGGACAGGTAGCAATCAGCCCCAGCATTTT	CASSRTGSNQPQHF	TRBV11-2	TRBJ1-5
TGTGCCAGCAGAGTCCCCGTCCGAAAGGGCCCCCGGGTACCCTACGAGCAGTACTTC	CASRVPVRKGPRVPYEQYF	TRBV4-2	TRBJ2-7
TGTGCCAGCATCCCCCGGGGGCCAGCTTATGGCTACACCTTC	CASIPRGPAYGYTF	TRBV7-3	TRBJ1-2
TGCAGTAGAACAACCCGGGACAGGGGGCCGGGGATACCCACAGATACGCAGTATTTT	CSRTTRDRGPGIPTDTQYF	TRBV20-1	TRBJ2-3
TGTGCCAGCGGAGAAAAGGGAGGAGGAGACGACGAGCAGTACTTC	CASGEKGGGDDEQYF	TRBV7-2	TRBJ2-7
TGTGCCTGGGGGGGAGACTTTGGGGAGCTGTTTTTT	CAWGGDFGELFF	TRBV30	TRBJ2-2
TGTGCCAGCAGCTCTCCGGGACAGGGACATCACACTGAAGCTTTCTTT	CASSSPGQGHHTEAFF	TRBV5-4	TRBJ1-1
TGTGCCACCAGTGGACAGGGGCAAGACACTGAAGCTTTCTTT	CATSGQGQDTEAFF	TRBV24-1	TRBJ1-1
TGTGCCAGCAGCTTACCGGGACTCCGGGAGACCCAGTACTTC	CASSLPGLRETQYF	TRBV7-9	TRBJ2-5
TGTGCCAGCAGTAATGCCGCTAGGTCCTGGAGCTCCTACGAGCAGTACTTC	CASSNAARSWSSYEQYF	TRBV2	TRBJ2-7
TGCGCCAGCAGCCCGGGACAGAACGGGTTCTCTGGAAACACCATATATTTT	CASSPGQNGFSGNTIYF	TRBV4-3	TRBJ1-3
TGCGCCAGCAGCATGCAGGTCAACTCTGGAAACACCATATATTTT	CASSMQVNSGNTIYF	TRBV5-1	TRBJ1-3
TGCAGTGCTAGAGATCAAGGCCCGGGGACGGAAGGGCTAGTCTCTCACTTC	CSARDQGPGTEGLVSHF	TRBV20-1	TRBJ2-7
TGCGCCAGGGGGACACAGGGGTCCACGGGAAACACCATATATTTT	CARGTQGSTGNTIYF	TRBV10-1	TRBJ1-3
TGTGCCACCAGCAGAGGCGGGGGGGCACTCAGCACAGATACGCAGTATTTT	CATSRGGGALSTDTQYF	TRBV24-1	TRBJ2-3
TGTGCCAGCAGGTCAGTATGTTATAGCAATCAGCCCCAGCATTTT	CASRSVCYSNQPQHF	TRBV12-4	TRBJ1-5
TGTGCCAGCAGCCCCGATAGGGACAGGCTCCAAGAGACCCAGTACTTC	CASSPDRDRLQETQYF	TRBV7-3	TRBJ2-5
TGCGCCGGGAGAGAGACCCAGTACTTC	CAGRETQYF	TRBV10-1	TRBJ2-5
TGTGCCAGCAGCCATTTGGAGCGACCGGCAGATACGCAGTATTTT	CASSHLERPADTQYF	TRBV13	TRBJ2-3
TGTGCCAGCATATCGGGAGGGGGTTCACCCCTCCACTTT	CASISGGGSPLHF	TRBV11-2	TRBJ1-6
TGCATAGACGGACCCGACTATGGCTACACCTTC	CIDGPDYGYTF	TRBV29-1	TRBJ1-2
TGTGCCAGCACAGATGATGAAAAACTGTTTTTT	CASTDDEKLFF	TRBV9	TRBJ1-4
TGTGCCACAGAAAGATATACGCAGTATTTT	CATERYTQYF	TRBV24-1	TRBJ2-3
TGCGCCAGCAGCTATGGACAGGGGGGCTATGGCTACACCTTC	CASSYGQGGYGYTF	TRBV5-1	TRBJ1-2
TGCAGTGCTAGAGCCCAGGGGTGGACCCCCTACGAGCAGTACTTC	CSARAQGWTPYEQYF	TRBV20-1	TRBJ2-7
TGTGCCAGCACCTCCGACAGGGAGCCCGGGGCCTTCGAAAACACCGGGGAGCTGTTTTTT	CASTSDREPGAFENTGELFF	TRBV12-4	TRBJ2-2
TGTGCCAGCAGTTTCCCCCGGGGGGGACTAGCGGGGAGGCGGGGCACAGATACGCAGTATTTT	CASSFPRGGLAGRRGTDTQYF	TRBV27	TRBJ2-3
TGCGCCAGCAGCCACCCGGGGAATACCCCGGAGCTGTTTTTT	CASSHPGNTPELFF	TRBV4-1	TRBJ2-2
TGTGCCAGCGAAGACGACCCCGAGACAGGGGGCTCTGGGGCCAACGTCCTGACTTTC	CASEDDPETGGSGANVLTF	TRBV6-2	TRBJ2-6
TGTGCCAGCAGCATGAGACTGGGGTTCAATGGCTACACCTTC	CASSMRLGFNGYTF	TRBV7-4	TRBJ1-2
TGTGCCAGCAGCCCGGACAGGCCTCCTGAGCAGTTCTTC	CASSPDRPPEQFF	TRBV13	TRBJ2-1
TGTGCCAGCAGTGATACTTTCGACTTAGGGTACGAGCAGTACTTC	CASSDTFDLGYEQYF	TRBV6-4	TRBJ2-7
TGTGCCAGCAGCATGGGGGGTGGGTGGCCAGATACGCAGTATTTT	CASSMGGGWPDTQYF	TRBV9	TRBJ2-3
TGTGCCAGCAGCCAAGGTAAGCACTACGAGCAGTACTTC	CASSQGKHYEQYF	TRBV7-4	TRBJ2-7
TGTGCCAGCAGCCCGGGGCGTGGCTACACCTTC	CASSPGRGYTF	TRBV6-3	TRBJ1-2
TGCGCCAGCAGCCACCAAACCGGGAATTCACCCCTCCACTTT	CASSHQTGNSPLHF	TRBV4-1	TRBJ1-6
TGCAGTGCTTCACGGGAGGGTAACTATGGCTACACCTTC	CSASREGNYGYTF	TRBV20-1	TRBJ1-2
TGTGCCAGCATGGTGGAGATGGATACTAATGAAAAACTGTTTTTT	CASMVEMDTNEKLFF	TRBV12-3	TRBJ1-4
TGTGCCAGCAGCTTAAAGCGGGAGGTTGCCAAAAACATTCAGTACTTC	CASSLKREVAKNIQYF	TRBV11-3	TRBJ2-4
TGTGCCAGCAGCGTAGGTATGGGAGGGGGGACCGCGTATGAGCAGTTCTTC	CASSVGMGGGTAYEQFF	TRBV9	TRBJ2-1
TGCGCCAGCAGTGAGTCCCCGGACATTTATGGCTACACCTTC	CASSESPDIYGYTF	TRBV10-1	TRBJ1-2
TGCGCCAGCAGCCAGGGGGCTAGTTGCTACGAGCAGTACTTC	CASSQGASCYEQYF	TRBV5-1	TRBJ2-7
TGTGCCAGCAGTAAAAAGTCCCGACAGGGGTGCACTGAAGCTTTCTTT	CASSKKSRQGCTEAFF	TRBV28	TRBJ1-1
TGTGCCAGCAGCGGGCCGGGACAGGGGAACACTGAAGCTTTCTTT	CASSGPGQGNTEAFF	TRBV3-1	TRBJ1-1
TGTGCCACCAGCAGGGAGGGTACGGGACAGAGTCCGGATAATGAAAAACTGTTTTTT	CATSREGTGQSPDNEKLFF	TRBV15	TRBJ1-4
TGTGCCAGCAGCGTGTTTAAGATAGACCGTGAGCAGTTCTTC	CASSVFKIDREQFF	TRBV9	TRBJ2-1
TGTGCTAGCAGCTTAAAAGGGGGGGAGGCGAGGGACGAGCAGTACTTC	CASSLKGGEARDEQYF	TRBV7-7	TRBJ2-7
TGTGCCAGCAGCAGAGGACGTAAACGGAACACTGAAGCTTTCTTT	CASSRGRKRNTEAFF	TRBV7-9	TRBJ1-1
TGTGCCAGCAGCTTAGTGGGGACACACAAAAGGACCTTCTTT	CASSLVGTHKRTFF	TRBV7-2	TRBJ1-1
TGTGCCACCAGTGAAAGGGACCCAGAGACCCAGTACTTC	CATSERDPETQYF	TRBV24-1	TRBJ2-5
TGTGCCAGCAGTTACCGGGACAGGGGGGGGTCCTCACCCCTCCACTTT	CASSYRDRGGSSPLHF	TRBV6-9	TRBJ1-6
TGCGCCAGCAGCCAAGATCCGAAGACAGGGGGCAAGGCTTTCACTAACTATGGCTACACCTTC	CASSQDPKTGGKAFTNYGYTF	TRBV4-3	TRBJ1-2
TGTGCCAGCAGTTACAGGTACGAGCAGTACTTC	CASSYRYEQYF	TRBV6-4	TRBJ2-7
TGTGCCAGCAGCGCGACCGGGACTAGCGTAGTTTATTACGAGCAGTACTTC	CASSATGTSVVYYEQYF	TRBV6-4	TRBJ2-7
TGTGCCAGGGGGAGGTGTCAAGAGACCCAGTACTTC	CARGRCQETQYF	TRBV12-4	TRBJ2-5
TGTGCCAGCAGTTTTTACCCCTCTTGGCCTGAGCAGTTCTTC	CASSFYPSWPEQFF	TRBV6-4	TRBJ2-1
TGTGCCAGCAACGTTATACTTAAAGCAGCCTACAATGAGCAGTTCTTC	CASNVILKAAYNEQFF	TRBV5-4	TRBJ2-1
TGCGCCAGCAGCTTGGAGCAGGGAGGGACTAATGAAAAACTGTTTTTT	CASSLEQGGTNEKLFF	TRBV5-1	TRBJ1-4
TGTGCCAGCAGGGGGAACCGGACTAGCGGGGACAATGAGCAGTTCTTC	CASRGNRTSGDNEQFF	TRBV9	TRBJ2-1
TGTGCCAGCAGTGTCACCAGGGTCGCCTACGAGCAGTACTTC	CASSVTRVAYEQYF	TRBV2	TRBJ2-7
TGTGCCAGCAGCCCACAGGGGCTAGCGTCAGATACGCAGTATTTT	CASSPQGLASDTQYF	TRBV7-9	TRBJ2-3
TGTGCCAGTAGTAGTTCTATAACTGGGGGGGTGAATGGCTACACCTTC	CASSSSITGGVNGYTF	TRBV19	TRBJ1-2
TGTGCCAGCCGGAGGGGGCACGGGCTCCTTCACGAGCAGTACTTC	CASRRGHGLLHEQYF	TRBV6-3	TRBJ2-7
TGTGCCACCAGTGAAGGATCCGGACTAGCGTGGACCGGGGCCGGGGAGCTGTTTTTT	CATSEGSGLAWTGAGELFF	TRBV24-1	TRBJ2-2
TGTGCCAGCAGCTTAGGAAGACCCCCGGGACAGGGGTATGGCTACACCTTC	CASSLGRPPGQGYGYTF	TRBV7-9	TRBJ1-2
TGTGCCCCGGGTAATCAGCCCCAGCATTTT	CAPGNQPQHF	TRBV30	TRBJ1-5
TGCAGTGCTAGTGGAGGGGCCAGCTCCTACGAGCAGTACTTC	CSASGGASSYEQYF	TRBV20-1	TRBJ2-7
TGTGCCAGCAGCTTAGCGGGCGAGACCCAGTACTTC	CASSLAGETQYF	TRBV13	TRBJ2-5
TGTGCCATTAAGGACAGGGAATCCTACGAGCAGTACTTC	CAIKDRESYEQYF	TRBV7-9	TRBJ2-7
TGTGCCAGCAGTAAGGGGCCTAAGAACCGGTTTCCGGGAAACACCATATATTTT	CASSKGPKNRFPGNTIYF	TRBV12-3	TRBJ1-3
TGCGCCAGCAGCCCAACACAGGGTGGGTATGGCTACACCTTC	CASSPTQGGYGYTF	TRBV4-1	TRBJ1-2
TGTGCCAGTAATTATAGCGGGCTTACTGGGGCCAACGTCCTGACTTTC	CASNYSGLTGANVLTF	TRBV19	TRBJ2-6
TGTGCCAGCACTGCCCCGGGACAGGGCCGGGACGAGCAGTACTTC	CASTAPGQGRDEQYF	TRBV12-4	TRBJ2-7
TGTGCCAGCAGCCAAGCCCCTCGGGGGGGGGAGACCCAGTACTTC	CASSQAPRGGETQYF	TRBV14	TRBJ2-5
TGTGCCAGCAGCGCTCCAGGGCCTCAGCCCCAGCATTTT	CASSAPGPQPQHF	TRBV9	TRBJ1-5
TGTGCCAGCTCACCACCCAGGCGAACTAATGAAAAACTGTTTTTT	CASSPPRRTNEKLFF	TRBV18	TRBJ1-4
TGTGCCAGCATCGGGGGGTGGAAGGGCTCCTACGAGCAGTACTTC	CASIGGWKGSYEQYF	TRBV4-2	TRBJ2-7
TGTGCCAGCAGCGCCAACTCTCTACCCGGGACGCCCATGAATTCACCCCTCCACTTT	CASSANSLPGTPMNSPLHF	TRBV9	TRBJ1-6
TGCGCCAGCAGCTTCGCTAGCGGGGAGGCAGATACGCAGTATTTT	CASSFASGEADTQYF	TRBV5-1	TRBJ2-3
TGTGCCAGCAGCAACAGGGGGGAGACCCAGTACTTC	CASSNRGETQYF	TRBV5-6	TRBJ2-5
TGCGCCAGCAGCTTGCCGTTCAGATATGCGAAAGGGAATCAGCCCCAGCATTTT	CASSLPFRYAKGNQPQHF	TRBV5-1	TRBJ1-5
TGTGCCAGCAGAGTTATCGGGGGAGGGGGGCCCCGAGCCGACTACGAGCAGTACTTC	CASRVIGGGGPRADYEQYF	TRBV7-3	TRBJ2-7
TGTGCCAGCAGCTGTCTCAGGGGGCTAGGTGAAGCTTTCTTT	CASSCLRGLGEAFF	TRBV7-7	TRBJ1-1
TGTGCCAGCAGTGACAAGGCAGAGCGACCCTACCGGGACAGGGTTTTTACTTCCCCCGCAGAGACCCAGTACTTC	CASSDKAERPYRDRVFTSPAETQYF	TRBV6-4	TRBJ2-5
TGCGCCAGCAGCTTCCAGCCCGGGACAGGTAGGTCACCCCTCCACTTT	CASSFQPGTGRSPLHF	TRBV5-1	TRBJ1-6
TGTGCCAGCCTGGGTCCCGGGACAGCCAAACGGGCTCAGCCCCAGCATTTT	CASLGPGTAKRAQPQHF	TRBV25-1	TRBJ1-5
TGCGCCAGCAGGCGTGTAGCGGGAAGAGATGGGCAGTTCTTC	CASRRVAGRDGQFF	TRBV5-1	TRBJ2-1
TGTGCCAGCAGTCTCGACAGGGGTAAGGGGAACACTGAAGCTTTCTTT	CASSLDRGKGNTEAFF	TRBV2	TRBJ1-1
TGTGCCAGCGATAGTCCTCTCGACAGGGGAGACACCATATATTTT	CASDSPLDRGDTIYF	TRBV4-2	TRBJ1-3
TGTGTTGCCCTGCAAGGCTATTATAGCAATCAGCCCCAGCATTTT	CVALQGYYSNQPQHF	TRBV24-1	TRBJ1-5
TGCGCCAGCAGCCCCCTAGCGGGCACAGATACGCAGTATTTT	CASSPLAGTDTQYF	TRBV4-1	TRBJ2-3
TGTGCCAGCAGCGGTGGGCCACAGGACACTGAAGCTTTCTTT	CASSGGPQDTEAFF	TRBV6-4	TRBJ1-1
TGTGCCAGCAGTTTTGGGACTAGCGGGTGCTGCAGCTCCTACGAGCAGTACTTC	CASSFGTSGCCSSYEQYF	TRBV28	TRBJ2-7
TGTGCCAGCAGCTTGGGCGGTCAGGGGGCTCTAAACTATGGCTACACCTTC	CASSLGGQGALNYGYTF	TRBV5-6	TRBJ1-2
TGCAGTGCTCAGGGGGGGGACACTGAAGCTTTCTTT	CSAQGGDTEAFF	TRBV20-1	TRBJ1-1
TGTGCCAGCAGCAGCCCAGGATTGGGGACTAGAACCTACAATGAGCAGTTCTTC	CASSSPGLGTRTYNEQFF	TRBV9	TRBJ2-1
TGCGCCAGCAGCTTCTGGACTAGCGGGGAACAAAACATTCAGTACTTC	CASSFWTSGEQNIQYF	TRBV5-1	TRBJ2-4
TGTGCCAGCAGCCAAGATCCCCAGGGTCGGAACACTGAAGCTTTCTTT	CASSQDPQGRNTEAFF	TRBV3-1	TRBJ1-1
TGCGCCAGCAGCGCACGGCGGCAAGAGACCCAGTACTTC	CASSARRQETQYF	TRBV5-1	TRBJ2-5
TGTGCCAGCAGCCAAGATCCCCGAAGAGGGTATAGCCTTGAGACCCAGTACTTC	CASSQDPRRGYSLETQYF	TRBV4-2	TRBJ2-5
TGCGCCAGCAAGGTGGACGGGGCTCAGGCATATGGCTACACCTTC	CASKVDGAQAYGYTF	TRBV10-2	TRBJ1-2
TGCGCCAGCAGCTTGGGTCTTCGGGAAGGACAGGGGGGCGAGGAGTGCATGAACACTGAAGCTTTCTTT	CASSLGLREGQGGEECMNTEAFF	TRBV5-1	TRBJ1-1
TGCAGTGCTAGAGATTCCAAGGGAACGGGACCCACTGGGGCCAACGTCCTGACTTTC	CSARDSKGTGPTGANVLTF	TRBV20-1	TRBJ2-6
TGTGCCAGCAGTGTGGGATCCAAGGGGCGCCAGTACGAGCAGTACTTC	CASSVGSKGRQYEQYF	TRBV12-3	TRBJ2-7
TGTGCCAGCAGCTTAGTCTGGGGGGTCCCCTACAATGAGCAGTTCTTC	CASSLVWGVPYNEQFF	TRBV7-2	TRBJ2-1
TGTGCCAGCAGCTCCAGCGCCCAGTACTTC	CASSSSAQYF	TRBV11-3	TRBJ2-5
TGTGCCAGCATCGGGGCCGGGGGTTGGGCTAGCACAGATACGCAGTATTTT	CASIGAGGWASTDTQYF	TRBV6-3	TRBJ2-3
TGTGCCAGCAGCCATAGATTAAGCTCCTGCCACTCTGGAAACACCATATATTTT	CASSHRLSSCHSGNTIYF	TRBV14	TRBJ1-3
TGTGCCAGCTCACCATTCGGCCGGGGACTAGAGCAGTACTTC	CASSPFGRGLEQYF	TRBV18	TRBJ2-7
TGTGCCAGCAGTGGACAGAGGGCCTACGAGCAGTACTTC	CASSGQRAYEQYF	TRBV6-5	TRBJ2-7
TGTGCCAGCAGCCCAGAAGGGTATCTGAACACTGAAGCTTTCTTT	CASSPEGYLNTEAFF	TRBV7-9	TRBJ1-1
TGTGCCATCAGTGAGTCACCCAATAGCACCGGGGAGCTGTTTTTT	CAISESPNSTGELFF	TRBV10-3	TRBJ2-2
TGCAGTGCTCCCCCAAAGACCGGGGGGGCCAGGTCCGGGGAGCTGTTTTTT	CSAPPKTGGARSGELFF	TRBV20-1	TRBJ2-2
TGTGCCTGGAGTACCACCAGGGGACATCAGGGCGATACGCAGTATTTT	CAWSTTRGHQGDTQYF	TRBV30	TRBJ2-3
TGTGCCACCAGTGAGCGGAACTATGGCTACACCTTC	CATSERNYGYTF	TRBV24-1	TRBJ1-2
TGTGCCAGCAGTGAAGACTTAAGGGGGGGTGGCGAGCAGTACTTC	CASSEDLRGGGEQYF	TRBV6-1	TRBJ2-7
TGTGCCAGAGGACAGGGGGGTTATAACACTGAAGCTTTCTTT	CARGQGGYNTEAFF	TRBV6-1	TRBJ1-1
TGTGCCAGCAGCCAGGGACAGAGCTCCTATAATTCACCCCTCCACTTT	CASSQGQSSYNSPLHF	TRBV3-1	TRBJ1-6
TGTGCCAGCAGTGATCCCGACAATAGATGGACTAGCGGGGATGGTTACGAGCAGTACTTC	CASSDPDNRWTSGDGYEQYF	TRBV6-2	TRBJ2-7
TGTGCCAGTAGTATAGCGTACGAGCAGTACTTC	CASSIAYEQYF	TRBV19	TRBJ2-7
TGCGCCAGCAGCTTGGTCCGCCCGAGGGGTCTCTCTGGGGCCAACGTCCTGACTTTC	CASSLVRPRGLSGANVLTF	TRBV5-1	TRBJ2-6
TGTGCCACCAGTGATTTGGGGGGGACTAATGAAAAACTGTTTTTT	CATSDLGGTNEKLFF	TRBV24-1	TRBJ1-4
TGCAGTGGGGGAGGCCTGGTCACTGAAGCTTTCTTT	CSGGGLVTEAFF	TRBV20-1	TRBJ1-1
TGTGCCAGCAGCTCCGACCCCGGGACAGGGGGCATGAACACTGAAGCTTTCTTT	CASSSDPGTGGMNTEAFF	TRBV5-6	TRBJ1-1
TGTGCCAGCAGTGTCCCTTCGACAGACCGGAGGAGCGCTTTCTTT	CASSVPSTDRRSAFF	TRBV6-4	TRBJ1-1
TGCGCCAGCAGCTGCCCGATAAGAGGGGGGAGCTCCTACAATGAGCAGTTCTTC	CASSCPIRGGSSYNEQFF	TRBV5-1	TRBJ2-1
TGTGCCAGCCAGGGACAGACAGATACGCAGTATTTT	CASQGQTDTQYF	TRBV7-9	TRBJ2-3
TGTGCCAGCAGACTAGCGGGAGGGCCAGATACGCAGTATTTT	CASRLAGGPDTQYF	TRBV6-5	TRBJ2-3
TGTGCCAGCAGTTACCAGGGGATTCCTACGGCTAGCTCTGGGGCCAACGTCCTGACTTTC	CASSYQGIPTASSGANVLTF	TRBV6-2	TRBJ2-6
TGTGCCAGCAGTCAGGGGGCAAGTGGCTACACCTTC	CASSQGASGYTF	TRBV27	TRBJ1-2
TGTGCCAGCAGAGGGACGAGGAAGTGTTATGGTGGCTACACCTTC	CASRGTRKCYGGYTF	TRBV7-9	TRBJ1-2
TGTGCCAGCAGAGTGGGACGCGCAGATACGCAGTATTTT	CASRVGRADTQYF	TRBV12-3	TRBJ2-3
TGTGCCAGCAGCTTCTCTGCCTCCTACGAGCAGTACTTC	CASSFSASYEQYF	TRBV6-5	TRBJ2-7
TGTGCCTGTACCGGGACTAGCACCGGGGAGCTGTTTTTT	CACTGTSTGELFF	TRBV30	TRBJ2-2
TGTGCCAGCAGCTTAGATAGACACAGGGGAGAGACCCAGTACTTC	CASSLDRHRGETQYF	TRBV11-2	TRBJ2-5
TGCAGTGCTAGAGGGGGAGGCATGAACGAGCAGTACTTC	CSARGGGMNEQYF	TRBV20-1	TRBJ2-7
TGTGCCAGCAGCTTAGGACCTGGGACAGGGGTTGGGCGCAATCAGCCCCAGCATTTT	CASSLGPGTGVGRNQPQHF	TRBV7-6	TRBJ1-5
TGCGCCAGCAGCAAAGAGGCTACCTACACAGGGACTCAGTACTTC	CASSKEATYTGTQYF	TRBV5-1	TRBJ2-5
TGTGCCAGCAGCTCCCGGAAAACAGGGGGGGGCTACACCTTC	CASSSRKTGGGYTF	TRBV7-2	TRBJ1-2
TGTGCCAGCAGCCACCATACGACAGGTTGGGTGGAGCCCCAGCATTTT	CASSHHTTGWVEPQHF	TRBV14	TRBJ1-5
TGTGCCAGCAGTGAAGCGTGTCTAGAGACCCAGTACTTC	CASSEACLETQYF	TRBV25-1	TRBJ2-5
TGTGCCAGCAGTCCCCTAGGGCCCGTGAAGGGCCAGTACCAAGAGACCCAGTACTTC	CASSPLGPVKGQYQETQYF	TRBV27	TRBJ2-5
TGCGCCAGCATTGACAGGGGGCGCTCCTCTGGAAACACCATATATTTT	CASIDRGRSSGNTIYF	TRBV5-1	TRBJ1-3
TGTGCCTGGAGTGGGCCAGGGACTAGCGGGGGCTTCTACGAGCAGTACTTC	CAWSGPGTSGGFYEQYF	TRBV30	TRBJ2-7
TGTGCCAGCTCTGGGGCCAACGTCCTGACTTTC	CASSGANVLTF	TRBV6-4	TRBJ2-6
TGTGCCAGCAGTTCGATTCGGGCGTGGTCCTACAATGAGCAGTTCTTC	CASSSIRAWSYNEQFF	TRBV6-5	TRBJ2-1
TGTGCCAGCAGCTTATGTGACAGGGACCAAGAGACCCAGTACTTC	CASSLCDRDQETQYF	TRBV7-9	TRBJ2-5
TGTGCCAGCAGCTGGGGGGGCCGGTGTAGCACAGATACGCAGTATTTT	CASSWGGRCSTDTQYF	TRBV27	TRBJ2-3
TGTGCCAGCAGTTTAATCCCCCCAGGGACACGGCCGATGAACACTGAAGCTTTCTTT	CASSLIPPGTRPMNTEAFF	TRBV27	TRBJ1-1
TGTGCCAGCAGCTTCCCGCCAAACACTGAAGCTTTCTTT	CASSFPPNTEAFF	TRBV7-4	TRBJ1-1
TGCGCCAGCAGCAGGTGCCCGACAGGGACAAAGTCTGAAAAACTGTTTTTT	CASSRCPTGTKSEKLFF	TRBV5-1	TRBJ1-4
TGTGCCAGCAGTGAAAGCGGGAACAACACTGAAGCTTTCTTT	CASSESGNNTEAFF	TRBV2	TRBJ1-1
TGTGCCAGCAGTTTTCATGACAGGGTCTCCGGGGAGCTGTTTTTT	CASSFHDRVSGELFF	TRBV27	TRBJ2-2
TGTGCCAGCAGCGTGCCCACAAACTCTGGAAACACCATATATTTT	CASSVPTNSGNTIYF	TRBV9	TRBJ1-3
TGTGCCAGCAGCGTCGAATGCGGGAGTAAGGAGGCGGAGACTGAAGCTTTCTTT	CASSVECGSKEAETEAFF	TRBV9	TRBJ1-1
TGCGCCAGCAGCTTGGTACCGGGACACAACGAGCAGTACTTC	CASSLVPGHNEQYF	TRBV5-1	TRBJ2-7
TGTGCCAGCAGCTCCTCCTGGGACTACGAGCAGTACTTC	CASSSSWDYEQYF	TRBV6-2	TRBJ2-7
TGCGCCAGCAGCTTCGGCACCAACACCGCCCTCCACTTT	CASSFGTNTALHF	TRBV5-1	TRBJ1-6
TGCGCCAGCAGCTTGGGTCAACCTAGCGGGAGCAATGAGCAGTTCTTC	CASSLGQPSGSNEQFF	TRBV5-1	TRBJ2-1
TGTGCTTGTCGGGGACGGGACCCACTGGAGCTGTTTTTT	CACRGRDPLELFF	TRBV6-2	TRBJ2-2
TGTGCTCGACTAGCGGGAGGTTCTTCCTACGAGCAGTACTTC	CARLAGGSSYEQYF	TRBV7-3	TRBJ2-7
TGTGCCAGCAGTGAAGATGGACAGGGGTCCGAGCAGTACTTC	CASSEDGQGSEQYF	TRBV2	TRBJ2-7
TGTGCCAGCAGTTACGAGGTTTATAGCAATCAGCCCCAGCATTTT	CASSYEVYSNQPQHF	TRBV6-5	TRBJ1-5
TGCGCCAGCAGCTTGGCAACACCCGAGGGACCTCCCTTTCAGCCCCAGCATTTT	CASSLATPEGPPFQPQHF	TRBV5-1	TRBJ1-5
TGTGCCAGCAGCTTGTGGGACAGAATCTACAATGAGCAGTTCTTC	CASSLWDRIYNEQFF	TRBV5-5	TRBJ2-1
TGTCGAAGCGGGGACTACAATGAGCAGTTCTTC	CRSGDYNEQFF	TRBV19	TRBJ2-1
TGCAGTGCTATTGACGAGACCCGGGACGATACACCCCTCCACTTT	CSAIDETRDDTPLHF	TRBV20-1	TRBJ1-6
TGTGCCAGCAGCACTAGCGGGAGGGCACGCTACGAGCAGTACTTC	CASSTSGRARYEQYF	TRBV7-3	TRBJ2-7
TGTGCCAGCAGCTACCGGCAGACCGGGACAGGGGGCTCTGGCGGCTACACCTTC	CASSYRQTGTGGSGGYTF	TRBV11-2	TRBJ1-2
TGCGCCAGCAGCCAGCGAACCCCGGGACTAGCGGGGGCTGCGGGCACAGATACGCAGTATTTT	CASSQRTPGLAGAAGTDTQYF	TRBV4-1	TRBJ2-3
TGTGCCAGTCCGGGGCCCAGGGATTCACCCCTCCACTTT	CASPGPRDSPLHF	TRBV19	TRBJ1-6
TGTGCCAGTACCTCCATTGATGGCTACACCTTC	CASTSIDGYTF	TRBV19	TRBJ1-2
TGTGCCAGCAGACATACAGGGGCCTCGAACACTGAAGCTTTCTTT	CASRHTGASNTEAFF	TRBV28	TRBJ1-1
TGTGCCAGCAGTGAAGTGGGGGACAGGGGGGTTAACACTGAAGCTTTCTTT	CASSEVGDRGVNTEAFF	TRBV6-1	TRBJ1-1
TGTGCCAGCAGATGGGGACTAGCGGTAGCACACTCCTACAATGAGCAGTTCTTC	CASRWGLAVAHSYNEQFF	TRBV6-1	TRBJ2-1
TGTGCCATAACGGATAGCAATCAGCCCCAGCATTTT	CAITDSNQPQHF	TRBV7-9	TRBJ1-5
TGTGCCAGCAGTGAAAAGGGTTGGAACACTGAAGCTTTCTTT	CASSEKGWNTEAFF	TRBV2	TRBJ1-1
TGCGCCAGCAGCGGACGGGGGGTGATGACCCAGTACTTC	CASSGRGVMTQYF	TRBV5-1	TRBJ2-5
TGTGCCAGCAGGGAGGGAACAGAGACCCAGTACTTC	CASREGTETQYF	TRBV12-3	TRBJ2-5
TGTGCCAGCAGCTCAGGACCAGCGGGATTTAGAAATCAGCCCCAGCATTTT	CASSSGPAGFRNQPQHF	TRBV7-3	TRBJ1-5
TGTGCCAGCAGCGGTACTAAGACTGAAGCTTTCTTT	CASSGTKTEAFF	TRBV11-3	TRBJ1-1
TGTGCCAGCTACTATATGGCAAACACCGGGGAGCTGTTTTTT	CASYYMANTGELFF	TRBV28	TRBJ2-2
TGTGCCAGCAGCCAAGATACCCGGGACCCGTACGAGCAGTACTTC	CASSQDTRDPYEQYF	TRBV14	TRBJ2-7
TGTGCCATCAGTCGGGACAGGGTCTCTGGAAACACCATATATTTT	CAISRDRVSGNTIYF	TRBV10-3	TRBJ1-3
TGCAGTGCTAGAGATAGACAGGGGAAACAAGAGACCCAGTACTTC	CSARDRQGKQETQYF	TRBV20-1	TRBJ2-5
TGCAGTGCTCCAGGTCCGGCAGATACGCAGTATTTT	CSAPGPADTQYF	TRBV20-1	TRBJ2-3
TGTGCCAGCAGTGGGGCGCCAAGATATAAAGATAGCAATCAGCCCCAGCATTTT	CASSGAPRYKDSNQPQHF	TRBV27	TRBJ1-5
TGTGCCAAACACAAACGAGATGTACATGAGCAGTTCTTC	CAKHKRDVHEQFF	TRBV27	TRBJ2-1
TGTGCCAGTAGTCGGTCAATAAAACTAGCGGGAGTGACAGATACGCAGTATTTT	CASSRSIKLAGVTDTQYF	TRBV19	TRBJ2-3
TGTGCCTGGAGTGTACTAAGACCGGACAGGAGCTACGAGCAGTACTTC	CAWSVLRPDRSYEQYF	TRBV30	TRBJ2-7
TGCAGCACACCACAGGGGGGGACCAAAAACATTCAGTACTTC	CSTPQGGTKNIQYF	TRBV29-1	TRBJ2-4
TGCGCCACCCGGGCTGTGACAGATACGCAGTATTTT	CATRAVTDTQYF	TRBV10-1	TRBJ2-3
TGTGCCTGGAGTGTACGTCCCGGGGGGCTTGGAGAGAACACCGGGGAGCTGTTTTTT	CAWSVRPGGLGENTGELFF	TRBV30	TRBJ2-2
TGTGCCATGTCGGGCAATCAGCCCCAGCATTTT	CAMSGNQPQHF	TRBV6-4	TRBJ1-5
TGTGCCAGCAGCGTCCGGACAGGCTCCTATAATTCACCCCTCCACTTT	CASSVRTGSYNSPLHF	TRBV14	TRBJ1-6
TGTGCCACCTCCCAAGGCCTCAGACAGGGATACAACACCGGGGAGCTGTTTTTT	CATSQGLRQGYNTGELFF	TRBV19	TRBJ2-2
TGTGCCACCAGTGATTTGTCAGTTATTGGCACAGATACGCAGTATTTT	CATSDLSVIGTDTQYF	TRBV24-1	TRBJ2-3
TGCAGTGGCCGCCGGGACAGGGGCTCGGGCTATGGCTACACCTTC	CSGRRDRGSGYGYTF	TRBV20-1	TRBJ1-2
TGTGCCAGCAGGAGCGGGGCGGGTGGCTACACCTTC	CASRSGAGGYTF	TRBV7-2	TRBJ1-2
TGTGCCAGCAGCGAGGGACAGTGTAGCAATCAGCCCCAGCATTTT	CASSEGQCSNQPQHF	TRBV12-3	TRBJ1-5
TGCGCCAGCAGCCCCCCGGGACTCGGGGAGACCCAGTACTTC	CASSPPGLGETQYF	TRBV4-3	TRBJ2-5
TGTGCCATCAGTGATTCGGGGAAGAATCAGCCCCAGCATTTT	CAISDSGKNQPQHF	TRBV10-3	TRBJ1-5
TGTGCCAGCAGCTTGGAACACGGGCCCTATAGCAATCAGCCCCAGCATTTT	CASSLEHGPYSNQPQHF	TRBV5-6	TRBJ1-5
TGTGCCAGCAGCCCACGAAACCGGGACAGGGCAGATCCTCCCTCTGGGGCCAACGTCCTGACTTTC	CASSPRNRDRADPPSGANVLTF	TRBV7-3	TRBJ2-6
TGTGCCAGCAACTCGGGACAGGAGTCGTCAGATCTCGGGGAGCTGTTTTTT	CASNSGQESSDLGELFF	TRBV27	TRBJ2-2
TGTGCCAGCAGCGGGGCAAGGGGCCGAAACACCATATATTTT	CASSGARGRNTIYF	TRBV7-9	TRBJ1-3
TGTGCCAGCAGCCGAAGGGGAGCTTTCTTT	CASSRRGAFF	TRBV7-3	TRBJ1-1
TGTGCCAGCAGTTTAAGAGCTTTGGACAGGGGGTACTATGGCTACACCTTC	CASSLRALDRGYYGYTF	TRBV6-5	TRBJ1-2
TGTGCCTGGAGTGGGGGTCCGGGACAGGGAGTGAACACTGAAGCTTTCTTT	CAWSGGPGQGVNTEAFF	TRBV30	TRBJ1-1
TGTGCCAGCAGCAGCAGCGGTAACTATGGCTACACCTTC	CASSSSGNYGYTF	TRBV7-9	TRBJ1-2
TGCGCCAGCAGCCCACCCCGGGACAGGGGTTGCACAGATACGCAGTATTTT	CASSPPRDRGCTDTQYF	TRBV5-1	TRBJ2-3
TGTGCCAGCAGCTGCCTGGGGACTGATGTTTCGAGCTCCTACGAGCAGTACTTC	CASSCLGTDVSSSYEQYF	TRBV7-9	TRBJ2-7
TGTGCCAAAGGGGGCCGTGGAAACACCATATATTTT	CAKGGRGNTIYF	TRBV6-1	TRBJ1-3
TGTGCCAGGGGTGAGGCCTCACCCTACAATGAGCAGTTCTTC	CARGEASPYNEQFF	TRBV19	TRBJ2-1
TGTGCCAGTAGTATCACCCTTGGGGGACGTAGCAATCAGCCCCAGCATTTT	CASSITLGGRSNQPQHF	TRBV19	TRBJ1-5
TGCAGTAGGTATAGGGACTACGAGCAGTACTTC	CSRYRDYEQYF	TRBV20-1	TRBJ2-7
TGTGCCAGTACCATCCTAATTGTCATAGCCAAAAACATTCAGTACTTC	CASTILIVIAKNIQYF	TRBV19	TRBJ2-4
TGTGCCAGCCCTGAGAGATCGGAGACCCAGTACTTC	CASPERSETQYF	TRBV6-3	TRBJ2-5
TGCAGTGCTAGGACTGAGGGCACCGGGGAGCTGTTTTTT	CSARTEGTGELFF	TRBV20-1	TRBJ2-2
TGCGCCAGCAGCACATTAGGACAGAATTCTGGGCCCGAGACCCAGTACTTC	CASSTLGQNSGPETQYF	TRBV5-1	TRBJ2-5
TGTGCCAGCAGCTGGCCCAGGGGGTGTTATGGCTACACCTTC	CASSWPRGCYGYTF	TRBV11-1	TRBJ1-2
TGCGCCAGCAGCTTGGTGACCGGTCGAGCCCATGGCTACACCTTC	CASSLVTGRAHGYTF	TRBV5-1	TRBJ1-2
TGCGCCAGCAGCCAATGTGGGGGGCGAGAAGAGACCCAGTACTTC	CASSQCGGREETQYF	TRBV4-3	TRBJ2-5
TGTGCCAGCAGTGTTTTGGACCCCTACGAGCAGTACTTC	CASSVLDPYEQYF	TRBV6-4	TRBJ2-7
TGTGCCAGCAGCGCACCACAGAGCAATCAGCCCCAGCATTTT	CASSAPQSNQPQHF	TRBV11-2	TRBJ1-5
TGTGCCAGTAGACAGGCCCAAGAGACCCAGTACTTC	CASRQAQETQYF	TRBV19	TRBJ2-5
TGTGCCAGCAGCCCAAGTCCCGGGACAGGGGAGGGCAACACTGAAGCTTTCTTT	CASSPSPGTGEGNTEAFF	TRBV7-3	TRBJ1-1
TGCAGTGCTAGAGGTCAGAGGGGTTTCAATGAGCAGTTCTTC	CSARGQRGFNEQFF	TRBV20-1	TRBJ2-1
TGCGCCAGCAGCCAGGACAGCTCCTACGAGCAGTACTTC	CASSQDSSYEQYF	TRBV5-1	TRBJ2-7
TGTGCCAGCAGCCATGGACAGGGGATAAAATACAATGAGCAGTTCTTC	CASSHGQGIKYNEQFF	TRBV14	TRBJ2-1
TGTGCCAGCAGCCAGATGGAACACGGGTGTAACACCGGGGAGCTGTTTTTT	CASSQMEHGCNTGELFF	TRBV11-2	TRBJ2-2
TGTGCCAGCAGCTTAGTATACAGGGGGACTGAAGCTTTCTTT	CASSLVYRGTEAFF	TRBV7-4	TRBJ1-1
TGTGCCAGCAGCATCCCTCCACAGGGGGACCAGAAAAGGGTGAACACCGGGGAGCTGTTTTTT	CASSIPPQGDQKRVNTGELFF	TRBV13	TRBJ2-2
TGTGCCAGCAGCCAGATACAGGGGTTCGACTACGAGCAGTACTTC	CASSQIQGFDYEQYF	TRBV4-2	TRBJ2-7
TGTGCCAGCAGCCAGGGGTTTACCCGTGCGGGGGAGAACACTGAAGCTTTCTTT	CASSQGFTRAGENTEAFF	TRBV7-3	TRBJ1-1
TGTGCCAGCAGCTACGGGACATTACGGTATCAGCCCCAGCATTTT	CASSYGTLRYQPQHF	TRBV11-2	TRBJ1-5
TGTGCTAGTGCCAATTTAGTGACGCACGAGCAGTACTTC	CASANLVTHEQYF	TRBV12-5	TRBJ2-7
TGTGCCAGCAGCATTCTTTCGTACGAGCAGTACTTC	CASSILSYEQYF	TRBV11-3	TRBJ2-7
TGTGCCAGCAGCTTAGAAGTGGGACAAGGCGGAGGGGGCGGAGCTTTCTTT	CASSLEVGQGGGGGAFF	TRBV7-2	TRBJ1-1
TGCGCCAGCAAGAGACCCCTCCCGGGAGGCCTCCCCAATCAGCCCCAGCATTTT	CASKRPLPGGLPNQPQHF	TRBV5-1	TRBJ1-5
TGTGCCAGCAGTTACGCGTATTGCGCCGGCCAAGAGACCCAGTACTTC	CASSYAYCAGQETQYF	TRBV6-5	TRBJ2-5
TGTGCCAGCAGTTTATCTTTAGGACAGTTCGGCTCCTACGAGCAGTACTTC	CASSLSLGQFGSYEQYF	TRBV12-4	TRBJ2-7
TGTGCCAGTAAGACAGGGGGGGAAAAACTGTTTTTT	CASKTGGEKLFF	TRBV19	TRBJ1-4
TGTGCCAGCAGTAACGATCAGCCCCAGCATTTT	CASSNDQPQHF	TRBV6-1	TRBJ1-5
TGTGCCAGCAGCAGAGGGGGGGAGACCGGGGAGCTGTTTTTT	CASSRGGETGELFF	TRBV5-4	TRBJ2-2
TGTGCCCGACAGACGCTAAAAAACATTCAGTACTTC	CARQTLKNIQYF	TRBV7-9	TRBJ2-4
TGTGCCAGCAGTATTGACAGCATGAACACTGAAGCTTTCTTT	CASSIDSMNTEAFF	TRBV27	TRBJ1-1
TGTGCCAGCAGTTTAAATAAATCAGGGAGGAAGCCCCAGCATTTT	CASSLNKSGRKPQHF	TRBV27	TRBJ1-5
TGTGCCAGCAGTCTCAATTTGGACCCAGATACGCAGTATTTT	CASSLNLDPDTQYF	TRBV6-2	TRBJ2-3
TGTGCCAGCAGTGAAGCCCAGCGGGAGCCACTAGGAGGTAACACTGAAGCTTTCTTT	CASSEAQREPLGGNTEAFF	TRBV6-4	TRBJ1-1
TGCAGTGCTAGAGATCTAAATGAGGCAAGCTACGAGCAGTACTTC	CSARDLNEASYEQYF	TRBV20-1	TRBJ2-7
TGCGCCAGCAGCCAAGATCACCACAGGGGATCACATAGCAATCAGCCCCAGCATTTT	CASSQDHHRGSHSNQPQHF	TRBV4-3	TRBJ1-5
TGTGCCAGCTCACCACACGTGGTAGTACAGGGGGACTATGGCTACACCTTC	CASSPHVVVQGDYGYTF	TRBV18	TRBJ1-2
TGTGCCAGCAGCTTCCTATTGTGTACCAGGAAGGGAGAGACCCAGTACTTC	CASSFLLCTRKGETQYF	TRBV7-8	TRBJ2-5
TGTGCCACCAGTTCGGAGGTCTACAATGAGCAGTTCTTC	CATSSEVYNEQFF	TRBV24-1	TRBJ2-1
TGTGCCAGCAGCCAAGATAGGGACAGGGATTACGGCAATCAGCCCCAGCATTTT	CASSQDRDRDYGNQPQHF	TRBV14	TRBJ1-5
TGTGCCAGCAGCTTACCCCTAACAGGAGGTTCCTACGAGCAGTACTTC	CASSLPLTGGSYEQYF	TRBV7-4	TRBJ2-7
TGTGCCAGCAGCTTGGGAGTAGGTAAGTCACGGCTTTCTGGGGCCAACGTCCTGACTTTC	CASSLGVGKSRLSGANVLTF	TRBV5-6	TRBJ2-6
TGTGCCAGCAACCCCTCCGGGACAGGGGGCTACGAGCAGTACTTC	CASNPSGTGGYEQYF	TRBV14	TRBJ2-7
TGTGCCAGCAGTGGTGGGGGGGCGTGGGGAGCGAACACCGGGGAGCTGTTTTTT	CASSGGGAWGANTGELFF	TRBV6-1	TRBJ2-2
TGTGCCAAGGGACAGGGTATCGGGGAGCTGTTTTTT	CAKGQGIGELFF	TRBV6-5	TRBJ2-2
TGTGCCAGCAGCGCTGGTGGTAGATACACCGGGGAGCTGTTTTTT	CASSAGGRYTGELFF	TRBV7-3	TRBJ2-2
TGTGCCAGCAGGACTAGCGGGAGTAGGTACAATGAGCAGTTCTTC	CASRTSGSRYNEQFF	TRBV6-5	TRBJ2-1
TGTGCCAGCAGTTACTTCCTCAAAATGACCCGGACAGTATCCTACGAGCAGTACTTC	CASSYFLKMTRTVSYEQYF	TRBV6-5	TRBJ2-7
TGCAGTGCTCCGGGGACGGTTGAAAAACTGTTTTTT	CSAPGTVEKLFF	TRBV20-1	TRBJ1-4
TGTGAGGGGGGGGCCCCCTACAATGAGCAGTTCTTC	CEGGAPYNEQFF	TRBV7-3	TRBJ2-1
TGTGCCCATAAACATCGGGGTACGGGATACGAGCAGTACTTC	CAHKHRGTGYEQYF	TRBV12-4	TRBJ2-7
TGTGCCCAGGGACTGGGGTCTTCGCTTTCAAGCTCCTACAATGAGCAGTTCTTC	CAQGLGSSLSSSYNEQFF	TRBV27	TRBJ2-1
TGTGCCAGCAGTTACCTGAGTGAGACCCAGTACTTC	CASSYLSETQYF	TRBV27	TRBJ2-5
TGTGCCACCAGTAATCCAGCGGAAGCGTGTGGCTACACCTTC	CATSNPAEACGYTF	TRBV24-1	TRBJ1-2
TGTGCCAGCAGTTCAAGTCTTCATGCGGCATTAGGCAATGAGCAGTTCTTC	CASSSSLHAALGNEQFF	TRBV6-2	TRBJ2-1
TGTGCCAGCAGTGACTGCTCGGCGGGTCAGCCCCAGCATTTT	CASSDCSAGQPQHF	TRBV6-4	TRBJ1-5
TGCGCCAGCAGCCCGGACTCCTTC	CASSPDSF	TRBV5-1	TRBJ2-7
TGCGCCAGCACGGGTTCCTGGGGGGGGGTTTCCGAAAGCTCCTACAATGAGCAGTTCTTC	CASTGSWGGVSESSYNEQFF	TRBV10-1	TRBJ2-1
TGCAGTGCTAGGGGGACCGACTGCTACGAGCAGTACTTC	CSARGTDCYEQYF	TRBV20-1	TRBJ2-7
TGTGCCAGCAGCTTGGGCAACACTGAAGCTTTCTTT	CASSLGNTEAFF	TRBV13	TRBJ1-1
TGCGCCAGCAGTTTGTTGGACAGGGCGGATGAGCAGTTCTTC	CASSLLDRADEQFF	TRBV10-1	TRBJ2-1
TGTGCCAGCTCAAAAGAGGGGGAGACCCAGTACTTC	CASSKEGETQYF	TRBV18	TRBJ2-5
TGTGCCACCAGCAGACTCGGGCGGAGGACTACCTACACCTTC	CATSRLGRRTTYTF	TRBV15	TRBJ1-2
TGTGCCAGCAGCGACCCTCCGGGCCGGGGGACAAATCAGCCCCAGCATTTT	CASSDPPGRGTNQPQHF	TRBV9	TRBJ1-5
TGTGCCAGCAGCTTTCCCACAGGGGGACCATATGGCTACACCTTC	CASSFPTGGPYGYTF	TRBV7-9	TRBJ1-2
TGTGCCAGCGAACGAATAACGGAAGAGACCCAGTACTTC	CASERITEETQYF	TRBV9	TRBJ2-5
TGTGCCAGCAGCAGGCCGGGACACGAGCAGTACTTC	CASSRPGHEQYF	TRBV5-6	TRBJ2-7
TGTGCCATGGGGACCCGACAGGGGAATCAGCCCCAGCATTTT	CAMGTRQGNQPQHF	TRBV7-6	TRBJ1-5
TGTGCCAGCAGCGTCCAACAGGGCTCGAACACTGAAGCTTTCTTT	CASSVQQGSNTEAFF	TRBV5-6	TRBJ1-1
TGCAGCGTTGGTGGGCCCCCCATCTATGAGCAGTTCTTC	CSVGGPPIYEQFF	TRBV29-1	TRBJ2-1
TGCGCCAGCAGCCAAGACTTAGCCCGCCCGACTCCTGAAGCTTTCTTT	CASSQDLARPTPEAFF	TRBV4-1	TRBJ1-1
TGCAGCGTACAGGGAGGTGGAGTCTCCTACGAGCAGTACTTC	CSVQGGGVSYEQYF	TRBV29-1	TRBJ2-7
TGTGCCAGCAGGAAACAGGGATGGATCTTGAACACTGAAGCTTTCTTT	CASRKQGWILNTEAFF	TRBV27	TRBJ1-1
TGTGCCAGCAGCGATAAGACCCGTAGCAGTCACCTGCTTTCACCCCTCCACTTT	CASSDKTRSSHLLSPLHF	TRBV9	TRBJ1-6
TGCGCCAGCAGCGTAGGACAGATTGGGAGCAATCAGCCCCAGCATTTT	CASSVGQIGSNQPQHF	TRBV5-1	TRBJ1-5
TGTGCCTGGAGTGTAGATCTAGCGGGTTTTGACAATGAGCAGTTCTTC	CAWSVDLAGFDNEQFF	TRBV30	TRBJ2-1
TGTGAGGCCTTCCTAACTGGCTACACCTTC	CEAFLTGYTF	TRBV7-3	TRBJ1-2
TGTGCTAGCAGCTGGGCCAGGATCAGAGTGTACACTAATGAAAAACTGTTTTTT	CASSWARIRVYTNEKLFF	TRBV7-7	TRBJ1-4
TGTGCCAGCAGTAGGAGAGGGTTCGTTCGTGCCTACGAGCAGTACTTC	CASSRRGFVRAYEQYF	TRBV6-3	TRBJ2-7
TGTGCCAGCAGTAGGAGATTGAGGGCGGGAGGGGAGAAAGAGACCCAGTACTTC	CASSRRLRAGGEKETQYF	TRBV6-1	TRBJ2-5
TGTGCCAGCAGCTTACTGTTGGGGGACTCAGAGCAGTACTTC	CASSLLLGDSEQYF	TRBV7-9	TRBJ2-7
TGCGCCAGCCCTTTTGACGTGAGAACCGGGGAGCTGTTTTTT	CASPFDVRTGELFF	TRBV10-1	TRBJ2-2
TGTGCCAGCAGTTATAGGCCAAGGAGAGATACGCAGTATTTT	CASSYRPRRDTQYF	TRBV6-5	TRBJ2-3
TGCGCCAGCAGTGGGATGTGGGGGGGGCGTACCGGGGAGCTGTTTTTT	CASSGMWGGRTGELFF	TRBV10-2	TRBJ2-2
TGTGCCAGCAGCCAACGACACGGGGCTGGAAACACCATATATTTT	CASSQRHGAGNTIYF	TRBV3-1	TRBJ1-3
TGTGCCAGCAGCTTAACGAAGACAGCTTCCTACGAGCAGTACTTC	CASSLTKTASYEQYF	TRBV7-3	TRBJ2-7
TGCGCCAGCAGCTTGGCCCCCAGACTAGCGGGAGAAGGCTCCTACGAGCAGTACTTC	CASSLAPRLAGEGSYEQYF	TRBV5-1	TRBJ2-7
TGTGCCAGCAGCTTAACATCAGTACCAGGAACAGATACGCAGTATTTT	CASSLTSVPGTDTQYF	TRBV7-9	TRBJ2-3
TGTGCCAGCAGCCAAGCCAGGTTTACAGTCTCCTACGAGCAGTACTTC	CASSQARFTVSYEQYF	TRBV14	TRBJ2-7
TGTGCCAGCAGCCAAGGGCCCTGGCCCGGGTCACCCCTCCACTTT	CASSQGPWPGSPLHF	TRBV3-1	TRBJ1-6
TGTGCCAGCAGCCGAGGAGGGAGGAACACTGAAGCTTTCTTT	CASSRGGRNTEAFF	TRBV7-3	TRBJ1-1
TGCAAATCTGAGCTTGTATTCAGCTCCTACAATGAGCAGTTCTTC	CKSELVFSSYNEQFF	TRBV20-1	TRBJ2-1
TGTGCCAGCAGCCAAGGCCGAGGGGGCATTCAGTACTTC	CASSQGRGGIQYF	TRBV3-1	TRBJ2-4
TGTGCCAGCAGCATTATCCTGGACCGCTCACCCCTCCACTTT	CASSIILDRSPLHF	TRBV5-6	TRBJ1-6
TGTGCCATCAGAAACCGGGGGGGTCTAAATGAGCAGTTCTTC	CAIRNRGGLNEQFF	TRBV10-3	TRBJ2-1
TGTGCCAGCAGCTCCCTTAGTGAAGAGACCCAGTACTTC	CASSSLSEETQYF	TRBV2	TRBJ2-5
TGTGCCAGCAGCTTAGCGACTCCTAGAAACACCGGGGAGCTGTTTTTT	CASSLATPRNTGELFF	TRBV7-9	TRBJ2-2
TGTGCCAGCAGCTTAGAGGACAGGGGGTTCTACGAGCAGTACTTC	CASSLEDRGFYEQYF	TRBV7-8	TRBJ2-7
TGTGCCAGGTCCTCTATACGGCAAGCCAAAAACATTCAGTACTTC	CARSSIRQAKNIQYF	TRBV6-4	TRBJ2-4
TGTGCCAGCAGCTTAAATCCGGGGGGACAATTCGTAGCCAAAAACATTCAGTACTTC	CASSLNPGGQFVAKNIQYF	TRBV11-3	TRBJ2-4
TGTGGGGACGACGTGGGGACCTACGAGCAGTACTTC	CGDDVGTYEQYF	TRBV10-3	TRBJ2-7
TGTGCCAGCAGAGGTCAGGGGGCGTTCATCGAGCAGTACTTC	CASRGQGAFIEQYF	TRBV5-4	TRBJ2-7
TGTGCCAGCAGTTACCTCGCCCAGAGCGGGGTCAATCAGCCCCAGCATTTT	CASSYLAQSGVNQPQHF	TRBV6-3	TRBJ1-5
TGTGCCAGCAAAACGGAGTTCGGGGAGCTGTTTTTT	CASKTEFGELFF	TRBV6-4	TRBJ2-2
TGCGCCGGCTTCCTGAAAACCCAGGGTGACACCGGGGAGCTGTTTTTT	CAGFLKTQGDTGELFF	TRBV4-1	TRBJ2-2
TGTGCCAGCAAGCTGGAGACTCGGAATGAAAAACTGTTTTTT	CASKLETRNEKLFF	TRBV13	TRBJ1-4
TGTGCCAGCTCACGGGACAGTACGGATTACAATCAGCCCCAGCATTTT	CASSRDSTDYNQPQHF	TRBV18	TRBJ1-5
TGTGCCACCAGTGCCAAGGGGGGCGCTTTCTTT	CATSAKGGAFF	TRBV24-1	TRBJ1-1
TGCGCCAGCAGCTTAGATCCAGTTACATGCACAGATACGCAGTATTTT	CASSLDPVTCTDTQYF	TRBV5-1	TRBJ2-3
TGTGCCAGCAGTTCAGAGACAGGGAGTGGAACCGTGAACACTGAAGCTTTCTTT	CASSSETGSGTVNTEAFF	TRBV27	TRBJ1-1
TGTGCCAGCAGCGAAGGGGGGGTAGACGAGCAGTACTTC	CASSEGGVDEQYF	TRBV5-4	TRBJ2-7
TGTGCCACCAGTGACCATCCGGTAGCTGAACGCGGGGAGCTGTTTTTT	CATSDHPVAERGELFF	TRBV24-1	TRBJ2-2
TGTGCCAGCAGTGACACCCGAGGCTACACCTTC	CASSDTRGYTF	TRBV6-4	TRBJ1-2
TGCAGTGCTGGAGGTAGGCCTAGCAATCAGCCCCAGCATTTT	CSAGGRPSNQPQHF	TRBV20-1	TRBJ1-5
TGCGCCAGCAGTTCGGACAGCTTTGACGGTAATGAAAAACTGTTTTTT	CASSSDSFDGNEKLFF	TRBV10-2	TRBJ1-4
TGTGCCAGCAGGCTAAACCCGCTCAGGGGGACCTACAATGAGCAGTTCTTC	CASRLNPLRGTYNEQFF	TRBV16	TRBJ2-1
TGTGCCAGCACCTCACCCCATCAGCCCCAGCATTTT	CASTSPHQPQHF	TRBV9	TRBJ1-5
TGTGCCAGCAGCTTAGAGCCGGACCCGCCAGGTCTGAACACTGAAGCTTTCTTT	CASSLEPDPPGLNTEAFF	TRBV11-2	TRBJ1-1
TGTGCCCCCGGGCGGGAGAAATGGGGTAGCGAGCAGTACTTC	CAPGREKWGSEQYF	TRBV6-4	TRBJ2-7
TGCAGTGCTAGATGGTACAGGGGGCCCCCGAACACCGGGGAGCTGTTTTTT	CSARWYRGPPNTGELFF	TRBV20-1	TRBJ2-2
TGTGCCATCAGGATAATCCGGGGGCGGTGCGTGTCCTACGAGCAGTACTTC	CAIRIIRGRCVSYEQYF	TRBV10-3	TRBJ2-7
TGTGCCAGCAGCTTACGGGGGCGAGGCACCGGGGAGCTGTTTTTT	CASSLRGRGTGELFF	TRBV7-3	TRBJ2-2
TGTGCCAGCAGCTTAGAGGGGACCTCTGGAAACACCATATATTTT	CASSLEGTSGNTIYF	TRBV7-2	TRBJ1-3
TGTGCCAGCAGTCACTGCGTGGACCAAGAGACCCAGTACTTC	CASSHCVDQETQYF	TRBV27	TRBJ2-5
TGTGCCAGCAGCTTGGTCTCCCAGACAGGGCGTAACGAGCAGTACTTC	CASSLVSQTGRNEQYF	TRBV7-8	TRBJ2-7
TGTGCCAGCGGGACAGGGAGCAATCAGCCCCAGCATTTT	CASGTGSNQPQHF	TRBV28	TRBJ1-5
TGTGCCAGCAGCTTACACCCTATGGCCTCGTCCTATGGCTACACCTTC	CASSLHPMASSYGYTF	TRBV7-9	TRBJ1-2
TGTGCCAGCAGTTACTCCCCCCGCCTAGGACCGGTTTCACCCCTCCACTTT	CASSYSPRLGPVSPLHF	TRBV6-5	TRBJ1-6
TGTGCCACCGCCTGGAACATTCAGTACTTC	CATAWNIQYF	TRBV24-1	TRBJ2-4
TGTGCCACCAGCAGGGGACCGGAACTGAACACTGAAGCTTTCTTT	CATSRGPELNTEAFF	TRBV15	TRBJ1-1
TGTGCCAGCAGTTTAGGACGGCCCGATACGCAGTATTTT	CASSLGRPDTQYF	TRBV27	TRBJ2-3
TGCAGTGCTAGAGGACGTGGACAGGTGACACGCTACGAGCAGTACTTC	CSARGRGQVTRYEQYF	TRBV20-1	TRBJ2-7
TGTGCCAGTAGTATAGTCCCGAGAGATGCCAAAAACATTCAGTACTTC	CASSIVPRDAKNIQYF	TRBV19	TRBJ2-4
TGTGCCAGCAGCCAAGATCCAACCCACGGGGACAGGGGCAAAGAAAAACTGTTTTTT	CASSQDPTHGDRGKEKLFF	TRBV14	TRBJ1-4
TGTGCCAGCAGTGACCCCGTTAACAAGTCTGGACGGGTCTCTGGAAACACCATATATTTT	CASSDPVNKSGRVSGNTIYF	TRBV6-4	TRBJ1-3
TGTGCTAGCAGCTGTCTCGACAGGGACGGCAATCAGCCCCAGCATTTT	CASSCLDRDGNQPQHF	TRBV7-7	TRBJ1-5
TGCGCCAGCAGCTGTCCGATACAGGTTCATCCTAATGAGCAGTTCTTC	CASSCPIQVHPNEQFF	TRBV5-1	TRBJ2-1
TGTGCCATCAGCCAGAAACCGACTGGCTCCTATAATTCACCCCTCCACTTT	CAISQKPTGSYNSPLHF	TRBV10-3	TRBJ1-6
TGTGCCATTTTGGGACTAGCGGGATCCGGATACAATGAGCAGTTCTTC	CAILGLAGSGYNEQFF	TRBV13	TRBJ2-1
TGTGCCACCAGTGAAATTTCTCCCCCAGGGCATTCCTACGAGCAGTACTTC	CATSEISPPGHSYEQYF	TRBV24-1	TRBJ2-7
TGTGCCAGCAGCTTGGGGGAACAGCCTCCGGGCAATCAGCCCCAGCATTTT	CASSLGEQPPGNQPQHF	TRBV5-4	TRBJ1-5
TGCGCCAGCAGTGAGAAGGATAGGGGGGGGTTTAATGAGCAGTTCTTC	CASSEKDRGGFNEQFF	TRBV10-1	TRBJ2-1
TGTGCCAGCAGTGAGACCCCGCATCAGCCCCAGCATTTT	CASSETPHQPQHF	TRBV6-1	TRBJ1-5
TGTGCCAGCTCGGCCTGGGGGTATCCAGAGACCCAGTACTTC	CASSAWGYPETQYF	TRBV18	TRBJ2-5
TGCGCCAGCAGCTTGCCCTTACTAGCGGGAGAAGAAGCTTTCTTT	CASSLPLLAGEEAFF	TRBV5-1	TRBJ1-1
TGTGCCAGCAGCTTTGCTAGACAAGAGACCCAGTACTTC	CASSFARQETQYF	TRBV7-8	TRBJ2-5
TGTGCCAGCAGTTACTCGAAGGGGGCCAGGCGACTAGCGGGCAATGAGCAGTTCTTC	CASSYSKGARRLAGNEQFF	TRBV6-5	TRBJ2-1
TGTGCCAGCAGCTTCTCCCGGGACATTACCTACAATGAGCAGTTCTTC	CASSFSRDITYNEQFF	TRBV5-4	TRBJ2-1
TGTGCCCCGGTAGCGGGCCGGAGTTGCACAGATACGCAGTATTTT	CAPVAGRSCTDTQYF	TRBV28	TRBJ2-3
TGTGCCAGCAGCGTAAGGGAGGGGGAGACCCAGTACTTC	CASSVREGETQYF	TRBV7-6	TRBJ2-5
TGTGCCAGCAGAATACTAGCGTCTCATAACTTCGTCTACAATGAGCAGTTCTTC	CASRILASHNFVYNEQFF	TRBV28	TRBJ2-1
TGCAGTGCTAGCCCCCGGTCTGTTGGGATCGGCACTGAAGCTTTCTTT	CSASPRSVGIGTEAFF	TRBV20-1	TRBJ1-1
TGTGCCAGCAGTGACTCATGGGGAACGAGTCATAATGAAAAACTGTTTTTT	CASSDSWGTSHNEKLFF	TRBV6-4	TRBJ1-4
TGTGCCAGCAGTTTTTCTAGCGGGGGCCACACCGGGGAGCTGTTTTTT	CASSFSSGGHTGELFF	TRBV27	TRBJ2-2
TGTGCCACCGTAGGGACAGGGGTTGGCCGAAACACCATATATTTT	CATVGTGVGRNTIYF	TRBV27	TRBJ1-3
TGTGCCTGGAGTGTATCGACTAGCGGGCCGTACAATGAGCAGTTCTTC	CAWSVSTSGPYNEQFF	TRBV30	TRBJ2-1
TGTGCCAGCAGTCGCTTCGGACTAGCAAGTTCTAGAGCCCACGAGCAGTACTTC	CASSRFGLASSRAHEQYF	TRBV6-6	TRBJ2-7
TGCAGTGCTAGAAGGTTAGGGACTAGCGGATACAATGAGCAGTTCTTC	CSARRLGTSGYNEQFF	TRBV20-1	TRBJ2-1
TGCGCCTTCAAACGAAGGGGGGGCTCTGGGGCCAACGTCCTGACTTTC	CAFKRRGGSGANVLTF	TRBV10-1	TRBJ2-6
TGTGCCAGCAGTTACGGACCTAGCGGGCCGTACGAGCAGTACTTC	CASSYGPSGPYEQYF	TRBV6-6	TRBJ2-7
TGTGCCAGCAGCTTAGAAGCTTTCGCCGGGACGGACTACGAGCAGTACTTC	CASSLEAFAGTDYEQYF	TRBV7-4	TRBJ2-7
TGTGCCTGGGAGGTTCCAAACAGGGGGCTAAACACTGAAGCTTTCTTT	CAWEVPNRGLNTEAFF	TRBV30	TRBJ1-1
TGCGCCAGCAGCCTCTTATCAGGTCATGGCTACACCTTC	CASSLLSGHGYTF	TRBV4-3	TRBJ1-2
TGCGCCAGCAGCCAAGCAATGGTGCAGGGAGTGGGGGCTAACTATGGCTACACCTTC	CASSQAMVQGVGANYGYTF	TRBV4-1	TRBJ1-2
TGTGCCAGCAAAGGGGGAGGACGGGATGGCGAGCAGTACTTC	CASKGGGRDGEQYF	TRBV6-4	TRBJ2-7
TGTGCCAGCAGCCCACGTGAAAAACTGTTTTTT	CASSPREKLFF	TRBV5-6	TRBJ1-4
TGTGCCAGCAGCAAAGTCTCGGGCTTGACAGACAACTACGAGCAGTACTTC	CASSKVSGLTDNYEQYF	TRBV13	TRBJ2-7
TGTGCCAGCAGTTTATGTTTGACGTGGGCAGATACGCAGTATTTT	CASSLCLTWADTQYF	TRBV27	TRBJ2-3
TGTGCCAGCTCACGGGGGCGGAATGAGTTAAGCTCCTATAATTCACCCCTCCACTTT	CASSRGRNELSSYNSPLHF	TRBV18	TRBJ1-6
TGCGCCAGCAGCGGACAGGGTCAAAAGATAACTAACTATGGCTACACCTTC	CASSGQGQKITNYGYTF	TRBV5-1	TRBJ1-2
TGTGCCTGGAGTGTACCTAATCCAGTCGTTGAGGAAAACATTCAGTACTTC	CAWSVPNPVVEENIQYF	TRBV30	TRBJ2-4
TGTGCCAGCAGCAAAGCAGGGCACTCCTATAATTCACCCCTCCACTTT	CASSKAGHSYNSPLHF	TRBV7-8	TRBJ1-6
TGTGCCACCAGAGAGACTAGACATAATTCCTACGAGCAGTACTTC	CATRETRHNSYEQYF	TRBV24-1	TRBJ2-7
TGTGCCAGCAGTTACCGTGAAAGGGGTAGTAGCAATCAGCCCCAGCATTTT	CASSYRERGSSNQPQHF	TRBV6-5	TRBJ1-5
TGTGCCAGCCAGGCGTCGGCTAACTATGGCTACACCTTC	CASQASANYGYTF	TRBV27	TRBJ1-2
TGTGCCAGTAAACGAGGGGGCAATGAGCAGTTCTTC	CASKRGGNEQFF	TRBV19	TRBJ2-1
TGTGCCAGCAGTCCGGGACTAGTTCCAGCCAAAAACATTCAGTACTTC	CASSPGLVPAKNIQYF	TRBV6-1	TRBJ2-4
TGCGCCAGCAGCTTGGATAGACCGGTCAGGGGATCGAACTATGGCTACACCTTC	CASSLDRPVRGSNYGYTF	TRBV5-1	TRBJ1-2
TGTGCCAGCACCAAGCCAGGGGGGTCCTACGAGCAGTACTTC	CASTKPGGSYEQYF	TRBV12-4	TRBJ2-7
TGTGCCAGCAACTGGACTAAAGACACTGAAGCTTTCTTT	CASNWTKDTEAFF	TRBV7-7	TRBJ1-1
TGTGCCAGCAGCGGACAGGGGAACTACGAGCAGTACTTC	CASSGQGNYEQYF	TRBV11-2	TRBJ2-7
TGTAGCGGCAAATGCTACGAGCAGTACTTC	CSGKCYEQYF	TRBV6-5	TRBJ2-7
TGTGCCAGCAGCAACGTGAAGGCGACCCAAAGGGTGGCTAATGAGCAGTTCTTC	CASSNVKATQRVANEQFF	TRBV27	TRBJ2-1
TGTGCCAGCAGCTTAGCACTACTGCAGAGGAACACTGAAGCTTTCTTT	CASSLALLQRNTEAFF	TRBV7-9	TRBJ1-1
TGCGCCAGCCTTACTCCACGGGAGGAGGGAGGATACAATGAGCAGTTCTTC	CASLTPREEGGYNEQFF	TRBV5-1	TRBJ2-1
TGTGCCAGCGGGGGGCGCTCTAGAAACACCATATATTTT	CASGGRSRNTIYF	TRBV7-9	TRBJ1-3
TGTGAGACAGGGGGCGGCTACACCTTC	CETGGGYTF	TRBV3-1	TRBJ1-2
TGTGCCTGGAGTGTACCATCAGAGACCCAGTACTTC	CAWSVPSETQYF	TRBV30	TRBJ2-5
TGTGCCACCAGTCCCAGCCGGGACAGGGGGGAGACCCAGTACTTC	CATSPSRDRGETQYF	TRBV24-1	TRBJ2-5
TGTGCCAGCAGTCGGGAGGGGCGGTACGAGCAGTACTTC	CASSREGRYEQYF	TRBV6-1	TRBJ2-7
TGTGCCAGCAGCGTAGCTCTAAGGGGGGATGGAGATACGCAGTATTTT	CASSVALRGDGDTQYF	TRBV9	TRBJ2-3
TGTGCCAGCAGCTTAAAGGAACTAGCGGGAGATACGCAGTATTTT	CASSLKELAGDTQYF	TRBV7-7	TRBJ2-3
TGTGCCAGCTCACTAGCCCGGGGCGAGCAGTACTTC	CASSLARGEQYF	TRBV18	TRBJ2-7
TGTGCCAGCATAGGGACAGGGAGGGACTCCTACGAGCAGTACTTC	CASIGTGRDSYEQYF	TRBV9	TRBJ2-7
TGCAGTGCTAGAAGTCCCATGGGACAGGAAAAACTGTTTTTT	CSARSPMGQEKLFF	TRBV20-1	TRBJ1-4
TGTGCCAGCAGCCAAGGGTTTACGTCCAGGGGGCAACCCGGGAACACTGAAGCTTTCTTT	CASSQGFTSRGQPGNTEAFF	TRBV3-1	TRBJ1-1
TGTGCCAGAAGCGGGAATGGCGGGGAGCTGTTTTTT	CARSGNGGELFF	TRBV27	TRBJ2-2
TGTGCCAGCAGGTGCCCCGGGGGGACTGACTACGAGCAGTACTTC	CASRCPGGTDYEQYF	TRBV6-2	TRBJ2-7
TGCAGTGCTAGAACGGATACCTACGAGCAGTACTTC	CSARTDTYEQYF	TRBV20-1	TRBJ2-7
TGTGCCAGCAGACTAGCGGTCTTAGCCACAGATACGCAGTATTTT	CASRLAVLATDTQYF	TRBV6-2	TRBJ2-3
TGTGCCAGCAGCTTCCCTATTGAGCGCACAGATACGCAGTATTTT	CASSFPIERTDTQYF	TRBV7-8	TRBJ2-3
TGTGCCAGCAGTTTAGTTGAGGGGCCAAAATACACTGAAGCTTTCTTT	CASSLVEGPKYTEAFF	TRBV28	TRBJ1-1
TGTGCCAGCAGCTTAGCCGTCGCATTTGAAAAACTGTTTTTT	CASSLAVAFEKLFF	TRBV11-2	TRBJ1-4
TGCGCCAGCAGTGAGCGGGGGGTGAACACCGGGGAGCTGTTTTTT	CASSERGVNTGELFF	TRBV10-1	TRBJ2-2
TGCGCCAGCAGCTTGTCTAAGACAGGTCACTACGAGCAGTACTTC	CASSLSKTGHYEQYF	TRBV5-1	TRBJ2-7
TGTGCCAGCAGTTTTAACCGACTAGCGGGAGAAGATACGCAGTATTTT	CASSFNRLAGEDTQYF	TRBV28	TRBJ2-3
TGTGCCAGCAGCTTGGTAAGAACGCCTTCGGGTCCCGGGGAGCTGTTTTTT	CASSLVRTPSGPGELFF	TRBV5-6	TRBJ2-2
TGTGCCAGCAGCCCCTTTAACCCGGGACAGGGCTTCCGCTATGGCTACACCTTC	CASSPFNPGQGFRYGYTF	TRBV28	TRBJ1-2
TGTGCCTGGAGCTATTCCACATCGCAACAAGAGACCCAGTACTTC	CAWSYSTSQQETQYF	TRBV30	TRBJ2-5
TGTGCCAGCAGCGTAGGGGGGCAGGGCTACGAGCAGTACTTC	CASSVGGQGYEQYF	TRBV9	TRBJ2-7
TGTGCCAGCAGCCCTCTACAGGGGGGTCAGCCCCAGCATTTT	CASSPLQGGQPQHF	TRBV7-9	TRBJ1-5
TGCGCCAGCAGCTTACAGGTTGGACACGGTCCCGAGCAGTACTTC	CASSLQVGHGPEQYF	TRBV5-1	TRBJ2-7
TGTGCCAGGAGGGGCCCCAAAGAGACCCAGTACTTC	CARRGPKETQYF	TRBV12-3	TRBJ2-5
TGTGCCAGCAGTGAATTGTCGGGAGGGCCCAATTCACCCCTCCACTTT	CASSELSGGPNSPLHF	TRBV6-4	TRBJ1-6
TGTGCCAGCCTCAGGTCCAGGAGGCTCTCGATAGGATATGGAACGAGCTCCTACGAGCAGTACTTC	CASLRSRRLSIGYGTSSYEQYF	TRBV25-1	TRBJ2-7
TGCAGTGCTAGACCCTCATTAAGCTACGAGCAGTACTTC	CSARPSLSYEQYF	TRBV20-1	TRBJ2-7
TGCGCCAGCAGTGAGTCGAGGGACAAAGGTGGCTACACCTTC	CASSESRDKGGYTF	TRBV10-1	TRBJ1-2
TGTGCCATCCTAGGGACTAGCGGGGTGCCGGGTTCCCAGTACTTC	CAILGTSGVPGSQYF	TRBV10-3	TRBJ2-5
TGTGCCACCTATCGGGCTAGCGAGCAGTACTTC	CATYRASEQYF	TRBV24-1	TRBJ2-7
TGTGCCAGCAGCCCGCTCCCGGGACCTACTCCGCCTGACGACAACGTCGGTGGCTACACCTTC	CASSPLPGPTPPDDNVGGYTF	TRBV7-2	TRBJ1-2
TGTGCCATAGGGGGGGCCGAAGCCGGGGAGCTGTTTTTT	CAIGGAEAGELFF	TRBV6-2	TRBJ2-2
TGTGCCAGCAGGACTGGCGGGGATAATGAGCAGTTCTTC	CASRTGGDNEQFF	TRBV7-9	TRBJ2-1
TGTGCCAGCAGCTTACGGCAACAAACGACCGTGCAGTATTTT	CASSLRQQTTVQYF	TRBV7-3	TRBJ2-3
TGTGCCAGCGTCAGGATAGAGACCCAGTACTTC	CASVRIETQYF	TRBV13	TRBJ2-5
TGTGCCAGCAGCCCTCTGGGGAGGAACGAGCAGTACTTC	CASSPLGRNEQYF	TRBV7-3	TRBJ2-7
TGTGCCAGTAACAGAAAACTCGTCGGCGAGCAGTACTTC	CASNRKLVGEQYF	TRBV19	TRBJ2-7
TGTGCCAGCAGCTTATTAGGGGGGGGGACCCTGTACGAGCAGTACTTC	CASSLLGGGTLYEQYF	TRBV7-2	TRBJ2-7
TGCGCCAGCAGCTTCCCCCACAGCTTGAAGGGATGGGGGGCGGGCGCTAATCAGCCCCAGCATTTT	CASSFPHSLKGWGAGANQPQHF	TRBV5-1	TRBJ1-5
TGTGCCAGCAGCGTTAGTTTAGGGAGGACCTACGAGCAGTACTTC	CASSVSLGRTYEQYF	TRBV7-9	TRBJ2-7
TGTGCCAGCGGGACAGTTAGGCCTGAAGCTTTCTTT	CASGTVRPEAFF	TRBV6-1	TRBJ1-1
TGTGCCAGCAGTTGCTCCCGTGGCACCCCGCCCCAGCATTTT	CASSCSRGTPPQHF	TRBV6-5	TRBJ1-5
TGTGCCAGCAGCACACCAGCGGGAAAGACGAAAGAGACCCAGTACTTC	CASSTPAGKTKETQYF	TRBV5-4	TRBJ2-5
TGTGCCAGCAAACGACTAGCGGGAGTGTGCAGGACTTCGAACACCGGGGAGCTGTTTTTT	CASKRLAGVCRTSNTGELFF	TRBV6-1	TRBJ2-2
TGTGCCAGCAGTGTCCGCGATAGCGGTTGCTCCTACGAGCAGTACTTC	CASSVRDSGCSYEQYF	TRBV12-4	TRBJ2-7
TGTGCCAGCACCGGGGGAGCCTACGAGCAGTACTTC	CASTGGAYEQYF	TRBV5-4	TRBJ2-7
TGTGCCAGCACCCCAGGACTAGCGGGTTGGGAGTTCCGGGCCTACAATGAGCAGTTCTTC	CASTPGLAGWEFRAYNEQFF	TRBV6-1	TRBJ2-1
TGCAGTGCCCGGCAGGGCTACGAGCAGTACTTC	CSARQGYEQYF	TRBV20-1	TRBJ2-7
TGTGCCAGCAGTTACCCCCCCCGGGAGACGGAGGTCGCGAACACCGGGGAGCTGTTTTTT	CASSYPPRETEVANTGELFF	TRBV6-2	TRBJ2-2
TGTGCCAGTAGTGGGTGGGCCAGCACAGATACGCAGTATTTT	CASSGWASTDTQYF	TRBV19	TRBJ2-3
TGTGCCACCAGTGATTTGAACCGGGCTTGGGACAGGGGAGTCGGGGAGCTGTTTTTT	CATSDLNRAWDRGVGELFF	TRBV24-1	TRBJ2-2
TGTGCCAGCAGCTTACCCTTGTCGATAACAGGGCGAAACGAGGGGTCCTACGAGCAGTACTTC	CASSLPLSITGRNEGSYEQYF	TRBV7-3	TRBJ2-7
TGTGCCAGCAGCCAAGACCCGCAGGTGACCTATAATTCACCCCTCCACTTT	CASSQDPQVTYNSPLHF	TRBV14	TRBJ1-6
TGTGCCAGCAGCTGGGAGCCCCGAGCTAGCGGGAGCAAGGTGTACTTC	CASSWEPRASGSKVYF	TRBV7-2	TRBJ2-5
TGCAGTGCCCAATTTCCCGGGACAGGGACCCGCGACGGGGAGCTGTTTTTT	CSAQFPGTGTRDGELFF	TRBV20-1	TRBJ2-2
TGTGCCAGCAGCGGAACAGACAGAGATACGGGACAGAACAACTATGGCTACACCTTC	CASSGTDRDTGQNNYGYTF	TRBV3-1	TRBJ1-2
TGTGCCAGCAGCTGCTATTACGGTTTCAGCTACAATGAGCAGTTCTTC	CASSCYYGFSYNEQFF	TRBV7-4	TRBJ2-1
TGTGCCAGACAGCAGCCCCAGCATTTT	CARQQPQHF	TRBV10-3	TRBJ1-5
TGCAGTGCTAGACCCAGGGGACGTCAAGCTTTCTTT	CSARPRGRQAFF	TRBV20-1	TRBJ1-1
TGTGCCAGCTCACGCCGCCTATTCTGGCTCGCCTACGAGCAGTACTTC	CASSRRLFWLAYEQYF	TRBV18	TRBJ2-7
TGTGCCAGCAGTGACCCAAACAGGGAGATTATGACCAGCAATCAGCCCCAGCATTTT	CASSDPNREIMTSNQPQHF	TRBV6-4	TRBJ1-5
TGCGCCAGCAGTGAGATGGGACAGGGGGATAACTCTGGAAACACCATATATTTT	CASSEMGQGDNSGNTIYF	TRBV10-1	TRBJ1-3
TGCGCCAGCAGCCAAGATTTAAGGGGTACGAGCTCCTACGAGCAGTACTTC	CASSQDLRGTSSYEQYF	TRBV4-1	TRBJ2-7
