TGTGCCAGCAGCCTTGAGGCACCTGCAGACAGGGAGGCAGGATCCACCTACGAGCAGTACTTC	CASSLEAPADREAGSTYEQYF	TRBV9	TRBJ2-7
TGTGCCAGCACCGGGGGACTAGCGGGAGGGTTGGAAGATACGCAGTATTTT	CASTGGLAGGLEDTQYF	TRBV5-4	TRBJ2-3
TGTGCCAGCTCTCTAGAAGAGCAGTTCTTC	CASSLEEQFF	TRBV18	TRBJ2-1
TGTGCTAGTGGTCTAGCGGGCTCACCTGAGACCCAGTACTTC	CASGLAGSPETQYF	TRBV12-5	TRBJ2-5
TGTGCCAGCAGTTCGAGCGACAGGGATGACTACAATGAGCAGTTCTTC	CASSSSDRDDYNEQFF	TRBV6-5	TRBJ2-1
TGTGCCAGCCAGGGGTTGCATTTT	CASQGLHF	TRBV7-3	TRBJ1-5
TGTGCCACCGGGGGGGTTGGCCTCGGGGAGCTGTTTTTT	CATGGVGLGELFF	TRBV27	TRBJ2-2
TGTGCCAGCAGCCAAGATCGACGTTCCTACGAGCAGTACTTC	CASSQDRRSYEQYF	TRBV14	TRBJ2-7
TGTGCTAGTGGTTCCCAACGGGGGAACACTGAAGCTTTCTTT	CASGSQRGNTEAFF	TRBV12-5	TRBJ1-1
TGTGCCAGCAGCCTGGAGTCAGAGTACAATGAGCAGTTCTTC	CASSLESEYNEQFF	TRBV3-1	TRBJ2-1
TGTGCCAGTAGTAGATACGACAGGGAATGCACAGATACGCAGTATTTT	CASSRYDRECTDTQYF	TRBV19	TRBJ2-3
TGTGCCAGGACTAGCGGCGGTAAACACAATGAGCAGTTCTTC	CARTSGGKHNEQFF	TRBV25-1	TRBJ2-1
TGTGCCAGCAGTGAGATCTCAGCATACAATGAGCAGTTCTTC	CASSEISAYNEQFF	TRBV25-1	TRBJ2-1
TGCAGCGCGGACTCGAACACTGAAGCTTTCTTT	CSADSNTEAFF	TRBV29-1	TRBJ1-1
TGTGCCACCCTGACTAGCGCCAGATTACCCCCAAGCACAGATACGCAGTATTTT	CATLTSARLPPSTDTQYF	TRBV24-1	TRBJ2-3
TGTGCCTGGGCCTTGGACGGGGGCTACACCTTC	CAWALDGGYTF	TRBV30	TRBJ1-2
TGTGCCAGCAGTCCAGCAGGCTACGAGCAGTACTTC	CASSPAGYEQYF	TRBV6-5	TRBJ2-7
TGTGCTAGCAGCTTCCGGGACAGGGCACCGAACACCGGGGAGCTGTTTTTT	CASSFRDRAPNTGELFF	TRBV7-7	TRBJ2-2
TGTGCCAGCTCACCACAACAGGGGTGCACTGAAGCTTTCTTT	CASSPQQGCTEAFF	TRBV18	TRBJ1-1
TGTGCCAGCAGCTTAGTAGAGCAAAGTGGGACTGGAAACACCATATATTTT	CASSLVEQSGTGNTIYF	TRBV7-2	TRBJ1-3
TGTGCCAGCAGTTACGGAAAGTTCTGCGGGGGGGTAACAGATACGCAGTATTTT	CASSYGKFCGGVTDTQYF	TRBV6-5	TRBJ2-3
TGTGCCAGCATTAGGATCTGTTGGGACAGGGGGCGCAATCAGCCCCAGCATTTT	CASIRICWDRGRNQPQHF	TRBV27	TRBJ1-5
TGCAGCGTTGCCAAACCCCCCGGGAGGCATGAGAGGTACTATGGCTACACCTTC	CSVAKPPGRHERYYGYTF	TRBV29-1	TRBJ1-2
TGTGCCAGCCCATACCGGGACAGGGGATATAGCAATCAGCCCCAGCATTTT	CASPYRDRGYSNQPQHF	TRBV19	TRBJ1-5
TGTGCCAGCAGCCAATTTCTTAGGTCCCCTGGCTACACCTTC	CASSQFLRSPGYTF	TRBV9	TRBJ1-2
TGTGCCAGCAGCTTGGCGACAGGGGGCTGCAGCAATCAGCCCCAGCATTTT	CASSLATGGCSNQPQHF	TRBV5-6	TRBJ1-5
TGTGCCAGCATTCCGGCCCTCAGGGGGCCCTACTCCTACGAGCAGTACTTC	CASIPALRGPYSYEQYF	TRBV5-6	TRBJ2-7
TGCGCCAGCAGCCAAGCACCCGAACAGCCCGGGACTAGCGGGAGGAATGGCTACACCTTC	CASSQAPEQPGTSGRNGYTF	TRBV4-1	TRBJ1-2
TGCAGTGCTAGTTGTAGGGGGGGACGCTACACCTTC	CSASCRGGRYTF	TRBV20-1	TRBJ1-2
TGTGCCAGCAGTTTTTCAACAGGAGGACCAGGGGCGGAAGGCGGGGAGCTGTTTTTT	CASSFSTGGPGAEGGELFF	TRBV28	TRBJ2-2
TGTGCCAGCAGCCCGGGGGGAGCCTACGAGCAGTACTTC	CASSPGGAYEQYF	TRBV13	TRBJ2-7
TGTGCCAGCAGCCAATCACAGGGGACGAGTACAAGCAATCAGCCCCAGCATTTT	CASSQSQGTSTSNQPQHF	TRBV4-2	TRBJ1-5
TGCGCCAGCAGCCAAGGTACAGGGGAGGCTGGAAACACCATATATTTT	CASSQGTGEAGNTIYF	TRBV4-1	TRBJ1-3
TGTGCCAGCAGGCCAGGCGGGAATGAGCAGTTCTTC	CASRPGGNEQFF	TRBV6-4	TRBJ2-1
TGTGCCATCAGTTGGGGGGATGGAAGTGCCTACAATGAGCAGTTCTTC	CAISWGDGSAYNEQFF	TRBV10-3	TRBJ2-1
TGTGCCAGCAGTGACTGCGGGACAGCGAGTGAGACCCAGTACTTC	CASSDCGTASETQYF	TRBV6-4	TRBJ2-5
TGCGCCAGCAGCCAAGGCTGGAGAGAGACCCAGTACTTC	CASSQGWRETQYF	TRBV4-3	TRBJ2-5
TGTGCCAGCAGTTTACGGGCGGTTGCGGGAGGAAGGACAGGGAGTGGATATGAGCAGTTCTTC	CASSLRAVAGGRTGSGYEQFF	TRBV27	TRBJ2-1
TGTGCCAGCAGCCAAGATGTACCCCTGAGATTAAACATTCAGTACTTC	CASSQDVPLRLNIQYF	TRBV14	TRBJ2-4
TGTGCCAGCGAGACTAGCGGGGGACACGAGCAGTACTTC	CASETSGGHEQYF	TRBV27	TRBJ2-7
TGTGCCAGCAGGCCAGTCGGCAATCAGCCCCAGCATTTT	CASRPVGNQPQHF	TRBV6-1	TRBJ1-5
TGTGCCAGCACCTCACACAGCACTAGCGGGAGGTGGGCAACTAATGAAAAACTGTTTTTT	CASTSHSTSGRWATNEKLFF	TRBV9	TRBJ1-4
TGTGCCAGTAGTATGCCAGGCCCAGTTAATTCACCCCTCCACTTT	CASSMPGPVNSPLHF	TRBV19	TRBJ1-6
TGCGCCAGCAGCGCTCCCCTTCAGCGCTCCAATGAGCAGTTCTTC	CASSAPLQRSNEQFF	TRBV5-1	TRBJ2-1
TGCGCCAGCAGCTTGATCTCCGACCGAGGGGGTGGGGGTGAGCAGTTCTTC	CASSLISDRGGGGEQFF	TRBV5-1	TRBJ2-1
TGTGCCAGCAGTCACGGAGGTTTTAATCCCTACGAGCAGTACTTC	CASSHGGFNPYEQYF	TRBV6-5	TRBJ2-7
TGTGCCAGCTCACCACAGGGAAGGGAAAAACTGTTTTTT	CASSPQGREKLFF	TRBV18	TRBJ1-4
TGTGCCAGCATGGGGGGAAAAGGTACCGGGGAGCTGTTTTTT	CASMGGKGTGELFF	TRBV27	TRBJ2-2
TGCGCCAGCAGCTTGCCACAGGGCTTGGGTGGGTACCAAGAGACCCAGTACTTC	CASSLPQGLGGYQETQYF	TRBV5-1	TRBJ2-5
TGCGCCAGCAGCTCCCTGCAGGGCAATCAGCCCCAGCATTTT	CASSSLQGNQPQHF	TRBV5-1	TRBJ1-5
TGTGCCAGCAGCTCCTGCATCTTTAACAGGACCTTTACCGGGGAGCTGTTTTTT	CASSSCIFNRTFTGELFF	TRBV5-4	TRBJ2-2
TGTGCCCCCAGTGGACAGGGGAATTCACCCCTCCACTTT	CAPSGQGNSPLHF	TRBV5-6	TRBJ1-6
TGTGCCAGCAGCGACGGGGGAGGTTCACCCTCTCTACCCTACGAGCAGTACTTC	CASSDGGGSPSLPYEQYF	TRBV7-2	TRBJ2-7
TGCAGCGTTGGTGGTCCCCGGGATACTGAAGCTTTCTTT	CSVGGPRDTEAFF	TRBV29-1	TRBJ1-1
TGCGCCAGACTTAGGGCAGTTGAAAAACTGTTTTTT	CARLRAVEKLFF	TRBV10-1	TRBJ1-4
TGTGCCAGCAGTTTAGCGGCGTTAATCGGGGGGTGGCAGGATAGCAATCAGCCCCAGCATTTT	CASSLAALIGGWQDSNQPQHF	TRBV12-4	TRBJ1-5
TGTGCCTCATCACTAGCTATAGAGACCCAGTACTTC	CASSLAIETQYF	TRBV2	TRBJ2-5
TGTGCCAGCAGCCCCCCAGGCGGGTACAATGAGCAGTTCTTC	CASSPPGGYNEQFF	TRBV11-3	TRBJ2-1
TGTGCCAGCAGGGAGGAGATTAGCAATCAGCCCCAGCATTTT	CASREEISNQPQHF	TRBV12-3	TRBJ1-5
TGCAGTGCTAGACCCCCCGAGGGGCATAGCTACGAGCAGTACTTC	CSARPPEGHSYEQYF	TRBV20-1	TRBJ2-7
TGTGCCAGTAGTATAGGTTTTCCACCAGGGACAGCTGATACGCAGTATTTT	CASSIGFPPGTADTQYF	TRBV19	TRBJ2-3
TGTGCCAGCAGCAAACGTCCCCGGGACATACTGTATAATGAAAAACTGTTTTTT	CASSKRPRDILYNEKLFF	TRBV13	TRBJ1-4
TGTGCCAGCAGTGAACTAATCTCGACTAGCGGGTACAATGAGCAGTTCTTC	CASSELISTSGYNEQFF	TRBV2	TRBJ2-1
TGTGCCAGCAGTGCCCTAGCGTCCCGGAACACCGGGGAGCTGTTTTTT	CASSALASRNTGELFF	TRBV6-4	TRBJ2-2
TGTGCCAGCAGCCACCCCGATCAGCCCCAGCATTTT	CASSHPDQPQHF	TRBV14	TRBJ1-5
TGTGCCAGCAGTGAACCCGAACTAGCGGGAGGGCAGCGGGACCAAGAGACCCAGTACTTC	CASSEPELAGGQRDQETQYF	TRBV6-1	TRBJ2-5
TGTGCCAGCAGAACGACAGATGGCTACACCTTC	CASRTTDGYTF	TRBV7-4	TRBJ1-2
TGTGCCAGCAGCTTAATGTTGACGGAGGAGACCCAGTACTTC	CASSLMLTEETQYF	TRBV7-3	TRBJ2-5
TGTGCCACCAGTGATTTCCACAAACTCGGGCCCGAATACAATGAGCAGTTCTTC	CATSDFHKLGPEYNEQFF	TRBV24-1	TRBJ2-1
TGTGCCAGCACTGTTCGGGGTGAGCAGTTCTTC	CASTVRGEQFF	TRBV6-4	TRBJ2-1
TGTGCCACCAAATTGACAGAGCATCAGAGGTTGGGCCCTAGCACAGATACGCAGTATTTT	CATKLTEHQRLGPSTDTQYF	TRBV24-1	TRBJ2-3
TGTGCCAGCAGCGACGAGCTTTCTAGCGGGCCAGAGACCCAGTACTTC	CASSDELSSGPETQYF	TRBV9	TRBJ2-5
TGTGCCAGCAGTTTAGATCCTTTGGCGGGCTACACCTTC	CASSLDPLAGYTF	TRBV27	TRBJ1-2
TGCAGTGCGCCGGGACAGGGGATCCCCCAGCATTTT	CSAPGQGIPQHF	TRBV20-1	TRBJ1-5
TGCGCCAGCAGCTGTGTTCTGGGGGGATCGGGTAATTCACCCCTCCACTTT	CASSCVLGGSGNSPLHF	TRBV10-1	TRBJ1-6
TGCAGCGTTGTAGAGCGGGCCCACAATGAGCAGTTCTTC	CSVVERAHNEQFF	TRBV29-1	TRBJ2-1
TGTGCCAGCAGCCGCTCAGCCGAGGGGGGAAACATTCAGTACTTC	CASSRSAEGGNIQYF	TRBV7-3	TRBJ2-4
TGCAGTGCTGGGAAGGATGAACTAGCGGGAGAGTTCCTAGATACGCAGTATTTT	CSAGKDELAGEFLDTQYF	TRBV20-1	TRBJ2-3
TGTGCCAGCAGCCAAGATCCGCTCAACACTGAAGCTTTCTTT	CASSQDPLNTEAFF	TRBV3-1	TRBJ1-1
TGTGCCAGCATCGGCACAGATACGCAGTATTTT	CASIGTDTQYF	TRBV27	TRBJ2-3
TGTGCCAGCAGCCTGCGCAACCCCACCAAGGATGGCTACACCTTC	CASSLRNPTKDGYTF	TRBV7-4	TRBJ1-2
TGTGCTAGTGGTTTCTGGCAGGGGAAGAGGCCCCAGCATTTT	CASGFWQGKRPQHF	TRBV12-5	TRBJ1-5
TGCAGTATACGACTAGCGGGCTGGGGCAATGAGCAGTTCTTC	CSIRLAGWGNEQFF	TRBV20-1	TRBJ2-1
TGCAGTGCTAGAGACAGGGGCACTGAAGCTTTCTTT	CSARDRGTEAFF	TRBV20-1	TRBJ1-1
TGTGCCAGCAGTTTACCCGGCGGCGAGCAGTACTTC	CASSLPGGEQYF	TRBV28	TRBJ2-7
TGTGCCAGCAGCTATCGGACAGGGGTGGCCTACGAGCAGTACTTC	CASSYRTGVAYEQYF	TRBV13	TRBJ2-7
TGTGCCAGCATGGCGGGAGGGAATGGGGAGCTGTTTTTT	CASMAGGNGELFF	TRBV27	TRBJ2-2
TGTGCCAGCAGCGTAGGGGGGCTGTTTTTT	CASSVGGLFF	TRBV9	TRBJ1-4
TGTGCCAGCACGTCCCAGCGGGACGCCGAGCAGTACTTC	CASTSQRDAEQYF	TRBV28	TRBJ2-7
TGTGCCAGCAGTTACCCCCCCACAGGGGGTTTCTATAACGAGCAGTACTTC	CASSYPPTGGFYNEQYF	TRBV6-6	TRBJ2-7
TGCAGGAGGAAAGAGGATAGCTCCTACGAGCAGTACTTC	CRRKEDSSYEQYF	TRBV29-1	TRBJ2-7
TGTGCCAGCAGGTCCAGGGATATAAACACTGAAGCTTTCTTT	CASRSRDINTEAFF	TRBV5-4	TRBJ1-1
TGTGCCAGCAGCTTAATTAATTGGCTAGCGGCCCTGTACTTC	CASSLINWLAALYF	TRBV11-2	TRBJ2-5
TGTGCCAGCAGCTTATCGGGGGAAGTCTACGAGCAGTACTTC	CASSLSGEVYEQYF	TRBV7-7	TRBJ2-7
TGCAGTGCTCCTATCCGACGGGATGAGCAGTTCTTC	CSAPIRRDEQFF	TRBV20-1	TRBJ2-1
TGTGCCAGCAGGGCGGGAGGAGGGGATCAGCCCCAGCATTTT	CASRAGGGDQPQHF	TRBV7-9	TRBJ1-5
TGTGCCAGCAGGGTAGGACCGGGACCTTCTGGGGAGACCCAGTACTTC	CASRVGPGPSGETQYF	TRBV28	TRBJ2-5
TGTGCCAGCAGCTTAGAGTCCGACAGGGGTGAGGGGAACACTGAAGCTTTCTTT	CASSLESDRGEGNTEAFF	TRBV7-7	TRBJ1-1
TGTGCCAGCAGTGTGTTCTGGTCAGGGGTGCAGGGCCTAAATGAAAAACTGTTTTTT	CASSVFWSGVQGLNEKLFF	TRBV6-4	TRBJ1-4
TGTGCCAGCAGCAACCCCGGACGGGACTTT	CASSNPGRDF	TRBV7-9	TRBJ1-1
TGTGCCAGCAGCCCGGGTCGGGTAGCGCAGTTCTTC	CASSPGRVAQFF	TRBV13	TRBJ2-1
TGTGCCAGTACAGGGCGGGGCCGCGAGCAGTACTTC	CASTGRGREQYF	TRBV19	TRBJ2-7
TGTGCCAGCAGCTTACGCTGGGGGGGAGAAAAACTGTTTTTT	CASSLRWGGEKLFF	TRBV7-9	TRBJ1-4
TGTGCCAGCAGCGGTGACCGTACAGACAGGGATGGTTATGAAAAACTGTTTTTT	CASSGDRTDRDGYEKLFF	TRBV7-4	TRBJ1-4
TGTGCCAGCAGGTGGGCAGTGAAGAGGAGCTCCTACGAGCAGTACTTC	CASRWAVKRSSYEQYF	TRBV27	TRBJ2-7
TGCAGTGCTAGATTACCCCGACGGTGGGGTGATTATGGCTACACCTTC	CSARLPRRWGDYGYTF	TRBV20-1	TRBJ1-2
TGTGCCAGCAGTGACAGTAGGGATAGCAATCAGCCCCAGCATTTT	CASSDSRDSNQPQHF	TRBV25-1	TRBJ1-5
TGTGCCACCAGTGATTATAGGAAATCCACAGATACGCAGTATTTT	CATSDYRKSTDTQYF	TRBV24-1	TRBJ2-3
TGCAGTGCTAGAGATCCTAGGAGGTCGTTCTACGAGCAGTACTTC	CSARDPRRSFYEQYF	TRBV20-1	TRBJ2-7
TGTGCCAGCAGCGCGGGCGAGAAGCCGCGGCGTCCACCCCTCCACTTT	CASSAGEKPRRPPLHF	TRBV7-3	TRBJ1-6
TGCGCCAGCAGTGAGTCCTCAGGGGGCGCAGGATTCGGCTCCTACAATGAGCAGTTCTTC	CASSESSGGAGFGSYNEQFF	TRBV10-1	TRBJ2-1
TGTGCCATGGGGTTTCGGACAGGGTACGAGCAGTACTTC	CAMGFRTGYEQYF	TRBV10-3	TRBJ2-7
TGTGCCAGCAAGGGACAGTTGGCGACGGGAAAATCAAACTACAATGAGCAGTTCTTC	CASKGQLATGKSNYNEQFF	TRBV27	TRBJ2-1
TGTGCCAGCAGCTGGGACAGGGTCGGAAAACAGTACTTC	CASSWDRVGKQYF	TRBV6-4	TRBJ2-5
TGTGCCAGCAGCCTAGACAGGGATTTTACAGATACGCAGTATTTT	CASSLDRDFTDTQYF	TRBV6-4	TRBJ2-3
TGTGCCTGGAGTGTACGTTGGAGGGTCTGGGATGGCTACACCTTC	CAWSVRWRVWDGYTF	TRBV30	TRBJ1-2
TGTGCCATCAGTGACCGGGGACAGGGTGGGAGCTCCTACGAGCAGTACTTC	CAISDRGQGGSSYEQYF	TRBV10-3	TRBJ2-7
TGTGCCAGCAGCGGAGGACGGGGCTATGGCTACACCTTC	CASSGGRGYGYTF	TRBV7-9	TRBJ1-2
TGTGCCAGCAGCCTTTCCTCGAGGGACAGCGAGCAGTACTTC	CASSLSSRDSEQYF	TRBV9	TRBJ2-7
TGCGCCAGCAGCCAAGACGGTCTCAATGAGCAGTTCTTC	CASSQDGLNEQFF	TRBV4-1	TRBJ2-1
TGTGCCAGTATCCCAGGGGACACTGAAGCTTTCTTT	CASIPGDTEAFF	TRBV19	TRBJ1-1
TGCGCCAGCAGGGCACAGACAGGGGGCTTCGGACCCAGGAGCAATCAGCCCCAGCATTTT	CASRAQTGGFGPRSNQPQHF	TRBV4-1	TRBJ1-5
TGTGCCACCGCGTTAGTGACCCCGACAGGGAGTCGGGGTTTGGAAGCTTTCTTT	CATALVTPTGSRGLEAFF	TRBV24-1	TRBJ1-1
TGTGCCAGCAGCCTGGCGGGAGACACACCCGGGGAGCTGTTTTTT	CASSLAGDTPGELFF	TRBV3-1	TRBJ2-2
TGTGCCAGCAGCCCCCACGGGTGGGCTAATGAAAAACTGTTTTTT	CASSPHGWANEKLFF	TRBV7-9	TRBJ1-4
TGTGCCAGCAGCTTACAAGACAGGGAGACCCAGTACTTC	CASSLQDRETQYF	TRBV7-8	TRBJ2-5
TGTGCCAGCAGCTTAGAGGTCTGGGGAGGCCAATGGGACAATGAGCAGTTCTTC	CASSLEVWGGQWDNEQFF	TRBV7-2	TRBJ2-1
TGTGCCAGCACGACAGGGTGGAATGAAAAACTGTTTTTT	CASTTGWNEKLFF	TRBV27	TRBJ1-4
TGTGCCAGCAGCAGAACAGAATACTACACCGGGGAGCTGTTTTTT	CASSRTEYYTGELFF	TRBV7-9	TRBJ2-2
TGTGCCCGATGGGATACAGGGGGCGGGGCTAATGAAAAACTGTTTTTT	CARWDTGGGANEKLFF	TRBV7-7	TRBJ1-4
TGTGCCAGCAGTTTATTCGACTACGGTAGGGGGCAAGCTGGGGCCAACGTCCTGACTTTC	CASSLFDYGRGQAGANVLTF	TRBV27	TRBJ2-6
TGTGCCAGCAGTCTGGAGGTCCGAGGGAAAGCTTTCTTT	CASSLEVRGKAFF	TRBV6-5	TRBJ1-1
TGTGCCAGCAGTTCAAGATTCTACGAGCAGTACTTC	CASSSRFYEQYF	TRBV12-4	TRBJ2-7
TGTGCCAGCAGCTTCACACAGGGGCCCACGAGCACAGATACGCAGTATTTT	CASSFTQGPTSTDTQYF	TRBV5-5	TRBJ2-3
TGTGCCAGCAGCGCCGGCCAGGCCCCGGATAATGAATCACGGAGAAGCTCCTACAATGAGCAGTTCTTC	CASSAGQAPDNESRRSSYNEQFF	TRBV13	TRBJ2-1
TGCGCCAGCAGCCACCTGCCGGACAGGGGGTTCTATGGCTACACCTTC	CASSHLPDRGFYGYTF	TRBV4-1	TRBJ1-2
TGTGCCAGCAGCCTACCTGGGGGGGGAGAGACCCAGTACTTC	CASSLPGGGETQYF	TRBV4-2	TRBJ2-5
TGTGCCAGCAGCCAACGACTAGCGGGCAATGAGCAGTTCTTC	CASSQRLAGNEQFF	TRBV14	TRBJ2-1
TGTGCCAGCAGCACAGGTTCAGGGGCGCAACCAAACTACGAGCAGTACTTC	CASSTGSGAQPNYEQYF	TRBV7-9	TRBJ2-7
TGTGCCAGCAGCGCCCGGGCCTCCTACAATGAGCAGTTCTTC	CASSARASYNEQFF	TRBV11-2	TRBJ2-1
TGTGCCAGCAGTGATCTTCACAGGCTGGATGGCTACACCTTC	CASSDLHRLDGYTF	TRBV6-4	TRBJ1-2
TGCAGCGTTGACGCCCAGCGGGAGCGGGTTCTGAACACTGAAGCTTTCTTT	CSVDAQRERVLNTEAFF	TRBV29-1	TRBJ1-1
TGTGCCAGCAAACGGGACAGCACTGAAGCTTTCTTT	CASKRDSTEAFF	TRBV25-1	TRBJ1-1
TGTGCCAGCAAGGGGACTAGCGATTCATTTCCCACAGATACGCAGTATTTT	CASKGTSDSFPTDTQYF	TRBV9	TRBJ2-3
TGTGCCAGCAGCGCCGACGGGCCCACGTACGAGCAGTACTTC	CASSADGPTYEQYF	TRBV11-2	TRBJ2-7
TGTGCCAGCAGCTTAGCCCGGGCTCACGGGACGAGAGTGACAGATACGCAGTATTTT	CASSLARAHGTRVTDTQYF	TRBV7-4	TRBJ2-3
TGTGCCAGCAGTGACTTAGTGATAAATTGGGAGACCCAGTACTTC	CASSDLVINWETQYF	TRBV6-4	TRBJ2-5
TGTGCCAGCTCACCCCTTACTCAGGTAGATGAAAAACTGTTTTTT	CASSPLTQVDEKLFF	TRBV18	TRBJ1-4
TGTGCCAGGTTAGACAGGGAGTATAATTCACCCCTCCACTTT	CARLDREYNSPLHF	TRBV19	TRBJ1-6
TGTGCCAGCAGCGTCGACAGGAGTTCACCCCTCCACTTT	CASSVDRSSPLHF	TRBV7-4	TRBJ1-6
TGTGCGACCCGAGACAGGGGGGGATTGACTGGGGCCAACGTCCTGACTTTC	CATRDRGGLTGANVLTF	TRBV7-7	TRBJ2-6
TGTGCCAGCAGTTACTGTAGCTCCTACGAGCAGTACTTC	CASSYCSSYEQYF	TRBV6-9	TRBJ2-7
TGTGCCAGCATAGAACAGGGGGCCATCTATGGCTACACCTTC	CASIEQGAIYGYTF	TRBV27	TRBJ1-2
TGTGCCACCAGTGACGGGGGACAGGCGCGGACTGAAGCTTTCTTT	CATSDGGQARTEAFF	TRBV24-1	TRBJ1-1
TGTGCCAGCAGCGGCACCAACACCGGGGAGCTGTTTTTT	CASSGTNTGELFF	TRBV6-4	TRBJ2-2
TGTGCCAGCTCACCAGGGCCTGAAAAACTGTTTTTT	CASSPGPEKLFF	TRBV18	TRBJ1-4
TGTGCCTGGCCGGGGGCTAAGTTTAGCTCCTATAATTCACCCCTCCACTTT	CAWPGAKFSSYNSPLHF	TRBV6-6	TRBJ1-6
TGCGCCAGCAGCCAGATCCGGGAGGAACAAGAGACCCAGTACTTC	CASSQIREEQETQYF	TRBV10-1	TRBJ2-5
TGTGCCAGCAGCTTAAGGGACTGCGGGGCAGGCTACACCTTC	CASSLRDCGAGYTF	TRBV7-2	TRBJ1-2
TGTGCCAGTAGTGTAACTAGCGTAACGCAGTATTTT	CASSVTSVTQYF	TRBV19	TRBJ2-3
TGTGCCAGCAGTGCCCCTCCCGGGGACCCCTATGGCTACACCTTC	CASSAPPGDPYGYTF	TRBV2	TRBJ1-2
TGTGCCAGCAGTTACGATTCTTCGGAGCAGTACTTC	CASSYDSSEQYF	TRBV6-5	TRBJ2-7
TGTGCCAGCTCACCAGACAGGGTCAATTCACCCCTCCACTTT	CASSPDRVNSPLHF	TRBV18	TRBJ1-6
TGTGCCAGCAGTTATAAGGACAGTGATGACATGGGCACAGATACGCAGTATTTT	CASSYKDSDDMGTDTQYF	TRBV6-9	TRBJ2-3
TGTGCCAGCAGTTTAACGACCGGGACAGGGGTCCGGAGTAGGGGGAACCGGACAGATACGCAGTATTTT	CASSLTTGTGVRSRGNRTDTQYF	TRBV27	TRBJ2-3
TGTGCCAGCAGCTTCGCGGGGGGTCGAGCCAAAAACATTCAGTACTTC	CASSFAGGRAKNIQYF	TRBV5-8	TRBJ2-4
TGTGCCAGCAAACTGAGTTCTGGCCAAGAGACCCAGTACTTC	CASKLSSGQETQYF	TRBV2	TRBJ2-5
TGCGCCAGCAGCTTGGAGCGGGACTTCAATGAGCAGTTCTTC	CASSLERDFNEQFF	TRBV5-1	TRBJ2-1
TGCAGTGCTAGCTCCTTGGGGCTTGGCATGTATGGCTACACCTTC	CSASSLGLGMYGYTF	TRBV20-1	TRBJ1-2
TGTGCCAGCAGTGAAAGAAGGACTAGCGGTTCCCCCTACGAGCAGTACTTC	CASSERRTSGSPYEQYF	TRBV25-1	TRBJ2-7
TGTGCCAGCAGTGCAACGGCAGGGTTAAACACCATATATTTT	CASSATAGLNTIYF	TRBV6-1	TRBJ1-3
TGTGCCAGCAGTGAACCGCGAGGGGGGACTGAAGCTTTCTTT	CASSEPRGGTEAFF	TRBV2	TRBJ1-1
TGTGCCAGCAGCCCTAGGTCAGAATCACCCCTCCACTTT	CASSPRSESPLHF	TRBV7-7	TRBJ1-6
TGCAGTGCTAGAGAGGAGGCCGGGGAGCTGTTTTTT	CSAREEAGELFF	TRBV20-1	TRBJ2-2
TGTGCCAGCAGTGTGGACAGCGAGATTGAGCAGTACTTC	CASSVDSEIEQYF	TRBV25-1	TRBJ2-7
TGCAGTGCTTCTCAATGGACACCTGAAGCTTTCTTT	CSASQWTPEAFF	TRBV20-1	TRBJ1-1
TGTGCCAGCAGTTTTCTTAACATAAGTTCCTACGAGCAGTACTTC	CASSFLNISSYEQYF	TRBV6-2	TRBJ2-7
TGTGCCAGCAGCAAGGACAGTATTGTGAACACTGAAGCTTTCTTT	CASSKDSIVNTEAFF	TRBV13	TRBJ1-1
TGTGCCAGCACAGACCCTCGGACAGGGGGAACCAATCAGCCCCAGCATTTT	CASTDPRTGGTNQPQHF	TRBV5-4	TRBJ1-5
TGCGCCAGCAGCTTGGCCCGCACAGGGGTCTACGAGCAGTACTTC	CASSLARTGVYEQYF	TRBV5-1	TRBJ2-7
TGTGCCAGCAGCATCTGGTCCAGGGAAAATGAAGCTTTCTTT	CASSIWSRENEAFF	TRBV13	TRBJ1-1
TGCAGTTTAACAGGGACTTCACCCCTCCACTTT	CSLTGTSPLHF	TRBV20-1	TRBJ1-6
TGTGCCAGCACACCCACCGGGGAGCTGTTTTTT	CASTPTGELFF	TRBV12-4	TRBJ2-2
TGTGCTAGTGGTTACCTCCGAGGGGGACTAGCGGACGTCGAGACCCAGTACTTC	CASGYLRGGLADVETQYF	TRBV12-5	TRBJ2-5
TGTGCCTGGAAGCGGTCGGCAGCAAGCAATCAGCCCCAGCATTTT	CAWKRSAASNQPQHF	TRBV30	TRBJ1-5
TGTGCCAGCAGTTTGTCGGCCGAAGAGGGAGGCTCTGGAAACACCATATATTTT	CASSLSAEEGGSGNTIYF	TRBV12-3	TRBJ1-3
TGCGCCAGCAGCCTTGAACGGACGCTAGGGAGTGGCTACACCTTC	CASSLERTLGSGYTF	TRBV4-1	TRBJ1-2
TGTGCCAGCAGCTATCGGGACTGGTCTAGCACAGATACGCAGTATTTT	CASSYRDWSSTDTQYF	TRBV7-9	TRBJ2-3
TGTGCCAGCAGTTTATTTGCCCCAGGGGGTAAGTGGAACAAGGAGAAAACCCTCCACTTT	CASSLFAPGGKWNKEKTLHF	TRBV27	TRBJ1-6
TGCAGTGCTAGAGCCTCAGACCAATGTTCCTATAATTCACCCCTCCACTTT	CSARASDQCSYNSPLHF	TRBV20-1	TRBJ1-6
TGTGCCTTAAGGCATGGGGGGTCTAATGAAAAACTGTTTTTT	CALRHGGSNEKLFF	TRBV19	TRBJ1-4
TGTGCCAGCAGTTTATCGGTCGGGGGGCGGGTCTACGAGCAGTACTTC	CASSLSVGGRVYEQYF	TRBV12-4	TRBJ2-7
TGCGCCAGCAGTGAGGGCGTACGGGCCCCGGGGAATGAGCAGTTCTTC	CASSEGVRAPGNEQFF	TRBV10-1	TRBJ2-1
TGTGCCAGCAGCCTCTCCACGTCCCGGGGCCCTGCAACTAATGAAAAACTGTTTTTT	CASSLSTSRGPATNEKLFF	TRBV27	TRBJ1-4
TGTGCCAGCAGTTTCCCGGGACAGGGCTGGAATAAACAGCCCCAGCATTTT	CASSFPGQGWNKQPQHF	TRBV28	TRBJ1-5
TGCAGCGTTGAAGTGGAAACAAGCTCCTATAATTCACCCCTCCACTTT	CSVEVETSSYNSPLHF	TRBV29-1	TRBJ1-6
TGTGCCAGCAGCCAAGGACAGGGGCTGGACTCGAACACTGAAGCTTTCTTT	CASSQGQGLDSNTEAFF	TRBV3-1	TRBJ1-1
TGTGCGGTGGCGATGGGAAACACCATATATTTT	CAVAMGNTIYF	TRBV11-3	TRBJ1-3
TGTGCCACCGGGACAGGCAAGAATGGCTACACCTTC	CATGTGKNGYTF	TRBV3-1	TRBJ1-2
TGTGCCAGCCAAAACCCTTTCACAGATACGCAGTATTTT	CASQNPFTDTQYF	TRBV12-4	TRBJ2-3
TGTGCCAGCGAACTGCATGCAAGGGGGCACTATGGCTACACCTTC	CASELHARGHYGYTF	TRBV28	TRBJ1-2
TGTGCCGACCCGAGGGGGGGCGAGCAGTTCTTC	CADPRGGEQFF	TRBV19	TRBJ2-1
TGTGCCACCAGTGATGTGGGGCACAGGGGGGGGGAGGTCGGGGAGCTGTTTTTT	CATSDVGHRGGEVGELFF	TRBV24-1	TRBJ2-2
TGTGCCAGCTCTTCCGAGGGGACTAATGAAAAACTGTTTTTT	CASSSEGTNEKLFF	TRBV18	TRBJ1-4
TGCGCCAGCAGCGGACAGGGTGGCTACACCTTC	CASSGQGGYTF	TRBV4-3	TRBJ1-2
TGTGCCAGCAGCGTCCCTAGCGATGTGGCCAACGTCCTGACTTTC	CASSVPSDVANVLTF	TRBV7-9	TRBJ2-6
TGTGCCAGCAGTTGGACAGGGGTATCAAGGTACGAGCAGTACTTC	CASSWTGVSRYEQYF	TRBV27	TRBJ2-7
TGTGCCAGCAGGCCGTCCCGACTAGCGGGTTACCAAGAGACCCAGTACTTC	CASRPSRLAGYQETQYF	TRBV27	TRBJ2-5
TGCAGTGCTAGGTCCCTAGCGGGGGAGTGCTCCTACAATGAGCAGTTCTTC	CSARSLAGECSYNEQFF	TRBV20-1	TRBJ2-1
TGCGCCATCCCAGCCCACGAGCAGTACTTC	CAIPAHEQYF	TRBV10-1	TRBJ2-7
TGTGCCAGCAGTTTAGTCACCTGGCGGGCAGAATCGGAGACCCAGTACTTC	CASSLVTWRAESETQYF	TRBV12-4	TRBJ2-5
TGTGCCAGCAGCAGGGGGGCTCCTAATGAAAAACTGTTTTTT	CASSRGAPNEKLFF	TRBV7-9	TRBJ1-4
TGTGCCAGCAGCTTGATCAGGGATTTCTATGGCTACACCTTC	CASSLIRDFYGYTF	TRBV7-2	TRBJ1-2
TGCGCCAGCAGGGGCCCCGGGACCAATGAGCAGTTCTTC	CASRGPGTNEQFF	TRBV10-1	TRBJ2-1
TGTGCCAGCAGCGAACCCCCAGACAATGAGCAGTTCTTC	CASSEPPDNEQFF	TRBV9	TRBJ2-1
TGTGCTAGTGGTTTGGTAAAACCTCCAACCGGGACATGGAGAGATGAGCAGTTCTTC	CASGLVKPPTGTWRDEQFF	TRBV12-5	TRBJ2-1
TGTGCCCGGACAGGGGGCAATCAGCCCCAGCATTTT	CARTGGNQPQHF	TRBV19	TRBJ1-5
TGTGCCAGCATAAAGGGATACGAGCAGTTCTTC	CASIKGYEQFF	TRBV6-4	TRBJ2-1
TGTGCCACCAGTGATTCGAGGTCCTACAATGAGCAGTTCTTC	CATSDSRSYNEQFF	TRBV24-1	TRBJ2-1
TGTGCCAGCAGTTACGACAGGATTTACCCTTCCTACGAGCAGTACTTC	CASSYDRIYPSYEQYF	TRBV6-2	TRBJ2-7
TGTGCCAGCAGTAACGTGGACAGGCCGAACTCTGGAAACACCATATATTTT	CASSNVDRPNSGNTIYF	TRBV6-1	TRBJ1-3
TGTGCCAGCAGGGGGGCGAGCTACGAGCAGTACTTC	CASRGASYEQYF	TRBV28	TRBJ2-7
TGCAGCGTTGAAGATTTTAAAGTGCGGGTCGAGCAGTTCTTC	CSVEDFKVRVEQFF	TRBV29-1	TRBJ2-1
TGCGCCAGCCTGTGCATTCAGTACTTC	CASLCIQYF	TRBV10-1	TRBJ2-4
TGTGCCAGCAGTGAAGGGGAACCTTGGAACACTGAAGCTTTCTTT	CASSEGEPWNTEAFF	TRBV2	TRBJ1-1
TGCGCCAGCAGTGAGCCAGACGAGGGAGGGAACTATAATAGTAATGAGCAGTTCTTC	CASSEPDEGGNYNSNEQFF	TRBV10-1	TRBJ2-1
TGTGCCATTAAATCCCGTCGGCCCCCCTACGAGCAGTACTTC	CAIKSRRPPYEQYF	TRBV6-2	TRBJ2-7
TGTGCCAGCAGTTTGGACACGTCCAATGAAAAACTGTTTTTT	CASSLDTSNEKLFF	TRBV12-4	TRBJ1-4
TGCGCCAGCAGATGTCGGGCGACTAGCGGTCCCACAGATACGCAGTATTTT	CASRCRATSGPTDTQYF	TRBV10-1	TRBJ2-3
TGTGCCAGCAGGGGACAGGGGGCTCGGACGACCCAGTACTTC	CASRGQGARTTQYF	TRBV3-1	TRBJ2-5
TGTGCCAGGTCCCGATTGACGGGGGGACCCTTAGAGACCCAGTACTTC	CARSRLTGGPLETQYF	TRBV25-1	TRBJ2-5
TGTGCCAGCCGACAGGGGAGCGCTAACTATGGCTACACCTTC	CASRQGSANYGYTF	TRBV2	TRBJ1-2
TGCAGCGGCAATGGGCCCCAGGATGAGCAGTTCTTC	CSGNGPQDEQFF	TRBV29-1	TRBJ2-1
TGTGCCAGCAGCTACCGGACAGGGACAACCGGGGAGCTGTTTTTT	CASSYRTGTTGELFF	TRBV11-3	TRBJ2-2
TGTGCCAGCAGCGGCTCCGCGGACCTTAATGAAAAACTGTTTTTT	CASSGSADLNEKLFF	TRBV9	TRBJ1-4
TGTGCCACCATCACCTATTTTTTGGGGATACCCGGCTACACCTTC	CATITYFLGIPGYTF	TRBV24-1	TRBJ1-2
TGTGCCACCAGTGGAGAGGTAACTACCCAGTACTTC	CATSGEVTTQYF	TRBV24-1	TRBJ2-5
TGTGCCTCACAAGGACAATCCAAAAACACTGAAGCTTTCTTT	CASQGQSKNTEAFF	TRBV10-3	TRBJ1-1
TGTGCCAGTAGTGGAAATCCGATGTATAATTCACCCCTCCACTTT	CASSGNPMYNSPLHF	TRBV19	TRBJ1-6
TGTGCCATCCGGGGGCGGTCCTACGAGCAGTACTTC	CAIRGRSYEQYF	TRBV6-2	TRBJ2-7
TGTGCCAGCAGCCCGAGAGGGCAGTACTTC	CASSPRGQYF	TRBV7-3	TRBJ2-7
TGTGCCAGTAAAGGACACCGGGACAGGGGGCGTATGAACACTGAAGCTTTCTTT	CASKGHRDRGRMNTEAFF	TRBV19	TRBJ1-1
TGTGCCAGCAGGGGACAAGAGACCCAGTACTTC	CASRGQETQYF	TRBV11-3	TRBJ2-5
TGTGCCAGCAGACCTGTGTTTAGGCGGTATAATTATGAAAAACTGTTTTTT	CASRPVFRRYNYEKLFF	TRBV7-2	TRBJ1-4
TGTGCCAGCAGCCTCAGGGAGTCTTCTGAGGCCAATAGCTATGGCTACACCTTC	CASSLRESSEANSYGYTF	TRBV14	TRBJ1-2
TGTGCCAGCAGTGACGAAGGCTTGGCGGTGGCGGGAAACACCATATATTTT	CASSDEGLAVAGNTIYF	TRBV6-1	TRBJ1-3
TGTGCCAGCAGCTTACTAGACAGTACACGCTACGAGCAGTACTTC	CASSLLDSTRYEQYF	TRBV11-2	TRBJ2-7
TGTGCCAGCAGAAGACAGTTCTACGAGCAGTACTTC	CASRRQFYEQYF	TRBV6-4	TRBJ2-7
TGCAGTACGCAGGGGGACAATCAGCCCCAGCATTTT	CSTQGDNQPQHF	TRBV20-1	TRBJ1-5
TGTGCCAGCAGCGGACTGGGCGCCTACAATGAGCAGTTCTTC	CASSGLGAYNEQFF	TRBV7-9	TRBJ2-1
TGTGCCACCGCGCGGGGATATAGCAATCAGCCCCAGCATTTT	CATARGYSNQPQHF	TRBV6-5	TRBJ1-5
TGCAGTTGCAGGGAAGCTAACTATGGCTACACCTTC	CSCREANYGYTF	TRBV20-1	TRBJ1-2
TGCAGCGTTGTAGGGACAGGGCCTAACGGTAGCAATCAGCCCCAGCATTTT	CSVVGTGPNGSNQPQHF	TRBV29-1	TRBJ1-5
TGTGCCAGCAGCAGCGCTGGGGGGAGACTGAATGAAAAACTGTTTTTT	CASSSAGGRLNEKLFF	TRBV13	TRBJ1-4
TGTGCCAGCAGGAAGGCAGGGGTTAGAAGAACTAACTATGGCTACACCTTC	CASRKAGVRRTNYGYTF	TRBV2	TRBJ1-2
TGTGCCAGCAGCAAAGCTAGCCTAGTGCACTACGAGCAGTACTTC	CASSKASLVHYEQYF	TRBV7-3	TRBJ2-7
TGTGCCAGCACAGTAAAAGGCGGGAAACAGAACACTGAAGCTTTCTTT	CASTVKGGKQNTEAFF	TRBV7-9	TRBJ1-1
TGTGCCATCAGAAACATGGAATCCTACAATGAGCAGTTCTTC	CAIRNMESYNEQFF	TRBV10-3	TRBJ2-1
TGTGCCAGCAGCGACCGGGATGAAAAACTGTTTTTT	CASSDRDEKLFF	TRBV7-2	TRBJ1-4
TGTGCCAGCACCTGTCACAGGGCCCCAGGGAATCAGCCCCAGCATTTT	CASTCHRAPGNQPQHF	TRBV25-1	TRBJ1-5
TGTGCCAGCAGCCCAGGGCAGGGATATGGCTACACCTTC	CASSPGQGYGYTF	TRBV5-4	TRBJ1-2
TGTGCCAGCAGTGAAGACCTAGAGGACAGGGGATGCACCATATATTTT	CASSEDLEDRGCTIYF	TRBV6-1	TRBJ1-3
TGTGCCAGCAGCTACTCCGGAGTAACGTACAATGAGCAGTTCTTC	CASSYSGVTYNEQFF	TRBV7-3	TRBJ2-1
TGCGCCAGCAGTCAACAGGGTGGCTATGGCTACACCTTC	CASSQQGGYGYTF	TRBV10-1	TRBJ1-2
TGTGCCATCATTCCCCTTAGCGGGAACAACATTCAGTACTTC	CAIIPLSGNNIQYF	TRBV10-3	TRBJ2-4
TGCAGTGCTAGAGCGTTACCCGGGGAGCTGTTTTTT	CSARALPGELFF	TRBV20-1	TRBJ2-2
TGTGCCAGCAGTTCTTCGACGGGGTACGAGCAGTACTTC	CASSSSTGYEQYF	TRBV28	TRBJ2-7
TGTGCCAGCAGCTCTTTCGGGACCGAAGACTACGAGCAGTACTTC	CASSSFGTEDYEQYF	TRBV5-4	TRBJ2-7
TGTGCCAGCAAACAGGGGCTAAGCTCCTACGAGCAGTACTTC	CASKQGLSSYEQYF	TRBV6-2	TRBJ2-7
TGTGCCAGCAGCCAGGTTGGCTCTGGAAACACCATATATTTT	CASSQVGSGNTIYF	TRBV11-2	TRBJ1-3
TGCGCCAGCAACAGGGGAGATACGCAGTATTTT	CASNRGDTQYF	TRBV10-1	TRBJ2-3
TGTGCCTGGAGTACTGCGGCCGGGGAGCTGTTTTTT	CAWSTAAGELFF	TRBV30	TRBJ2-2
TGTGCCAGGTGCCGAGGGCCCAGCACAGATACGCAGTATTTT	CARCRGPSTDTQYF	TRBV27	TRBJ2-3
TGTGCCAGCCTAGGGGGGGGGAATGAGCAGTTCTTC	CASLGGGNEQFF	TRBV3-1	TRBJ2-1
TGTGCCAGCAGTAAACGGACTAGGGAAGGCAATGAGCAGTTCTTC	CASSKRTREGNEQFF	TRBV6-2	TRBJ2-1
TGTGCCAGCATGACAGAAGGAAGGGAAGAGACCCAGTACTTC	CASMTEGREETQYF	TRBV6-4	TRBJ2-5
TGTGCCAGTAGTACAGAGGAGGGAGGCTACGAGCAGTACTTC	CASSTEEGGYEQYF	TRBV19	TRBJ2-7
TGTGCCAGCAGCCAGGTTTCGGGGGGGTACAATGAGCAGTTCTTC	CASSQVSGGYNEQFF	TRBV14	TRBJ2-1
TGTGCCAGCCCCTGGGGGATACAAGCTTTCTTT	CASPWGIQAFF	TRBV11-3	TRBJ1-1
TGTGCCCAGGGCATAAATAAAGGGTCCTACGAGCAGTACTTC	CAQGINKGSYEQYF	TRBV30	TRBJ2-7
TGTGCCAGCAGCTTCCCAACGGCGGGGTACAATGAGCAGTTCTTC	CASSFPTAGYNEQFF	TRBV7-9	TRBJ2-1
TGTGCCAGGGGGGCTTTGTCCCGCTATGGCTACACCTTC	CARGALSRYGYTF	TRBV2	TRBJ1-2
TGTGCCAGCAGGGATCCGGGACGCTACGAGCAGTACTTC	CASRDPGRYEQYF	TRBV6-1	TRBJ2-7
TGTGCCAGCAGCCTTAGGGGGCGAGCTTTCTTT	CASSLRGRAFF	TRBV6-5	TRBJ1-1
TGTGCCAGCAGCTTAGACAGGTCCTACGAGCAGTACTTC	CASSLDRSYEQYF	TRBV7-9	TRBJ2-7
TGTGCCAGCAGCTTGGGCGACAGGGAGGATAAGGCGCGCTCCTATAATTCACCCCTCCACTTT	CASSLGDREDKARSYNSPLHF	TRBV5-4	TRBJ1-6
TGTGCCTGGAGAAAGCGGGAGGGAGGCTACACCTTC	CAWRKREGGYTF	TRBV30	TRBJ1-2
TGTGCCAGCCGACGACCCTACGAGCAGTACTTC	CASRRPYEQYF	TRBV27	TRBJ2-7
TGTGCCAGCAGCTTAGACCAGGGGAGAGATCTAGTTTCAGATACGCAGTATTTT	CASSLDQGRDLVSDTQYF	TRBV7-4	TRBJ2-3
TGTGCCACAATCCCGGTGGGATGGACTAGCACAGATACGCAGTATTTT	CATIPVGWTSTDTQYF	TRBV6-5	TRBJ2-3
TGTGCCAGCTCACCACCACTTGTGGGGGGGTCCTATAATTCACCCCTCCACTTT	CASSPPLVGGSYNSPLHF	TRBV18	TRBJ1-6
TGTGCCAGCAGCGTCGGGCCAGGGTATGGCTACACCTTC	CASSVGPGYGYTF	TRBV13	TRBJ1-2
TGCGCCAGCAGCTTCAAAGCTTTCTTT	CASSFKAFF	TRBV5-1	TRBJ1-1
TGCGCCAGCAGCTGGGGGGGCCGGAAGGAACGCTGCACAGATACGCAGTATTTT	CASSWGGRKERCTDTQYF	TRBV10-2	TRBJ2-3
TGTGCCATCAGTGGTCATAGCGGGACGCCACAGAACACCGGGGAGCTGTTTTTT	CAISGHSGTPQNTGELFF	TRBV10-3	TRBJ2-2
TGTGCCAGCAGTTATCTTGAGGTCGGGGGGCTTTGTAACTATGGCTACACCTTC	CASSYLEVGGLCNYGYTF	TRBV6-5	TRBJ1-2
TGTGCCAGCAGCGAGGGATCGAGAGATACGCAGTATTTT	CASSEGSRDTQYF	TRBV28	TRBJ2-3
TGTGCCAGCAGTTTATTCCTCAGACGCGCGCCGAACACTGAAGCTTTCTTT	CASSLFLRRAPNTEAFF	TRBV28	TRBJ1-1
TGCGCCAGCAGCTTCCAGGGACTCGACGAAAAACTGTTTTTT	CASSFQGLDEKLFF	TRBV5-1	TRBJ1-4
TGTGCCAGCAGCCAACTAGCCAATGAGCAGTTCTTC	CASSQLANEQFF	TRBV3-1	TRBJ2-1
TGTGCCAGCTCACCACCTCAGGGCTCACCCCTCCACTTT	CASSPPQGSPLHF	TRBV18	TRBJ1-6
TGTGCCAGCAGCCCGAGTGGCTATGGCTACACCTTC	CASSPSGYGYTF	TRBV14	TRBJ1-2
TGCAGTGCTGGGGCGATACGGATTGTCGTCTCCTACGAGCAGTACTTC	CSAGAIRIVVSYEQYF	TRBV20-1	TRBJ2-7
TGTGCCAGCAGCCCTTCTTACAGGTACTATGGCTACACCTTC	CASSPSYRYYGYTF	TRBV25-1	TRBJ1-2
TGTGCCACCAGTGATCCCTCGGACAGGGGGGGGAAGCCCCAGCATTTT	CATSDPSDRGGKPQHF	TRBV24-1	TRBJ1-5
TGCGCCAGCAGCTGGACAGGGCAAGCTAGCTACGAGCAGTACTTC	CASSWTGQASYEQYF	TRBV5-1	TRBJ2-7
TGTGCCAGCAGCCAAGGGGTTGGGGGCACAGATACGCAGTATTTT	CASSQGVGGTDTQYF	TRBV14	TRBJ2-3
TGTGCCAGCAGCCAAATCAGGGGGCAAAGAGGCTACACCTTC	CASSQIRGQRGYTF	TRBV4-2	TRBJ1-2
TGTGCCAGCAGCGGGGCTAGCGGGTCCTCCTACGAGCAGTACTTC	CASSGASGSSYEQYF	TRBV13	TRBJ2-7
TGTGCCAGCAGCTTGCAGGGGTTTACCTACAATGAGCAGTTCTTC	CASSLQGFTYNEQFF	TRBV7-9	TRBJ2-1
TGTGCCAGCAGCGACCCCACAGGGTCTCAGCCCCAGCATTTT	CASSDPTGSQPQHF	TRBV5-6	TRBJ1-5
TGCGCCAGCAGCTTGGCCCCCGACAGGGGTTTCCATTCTGAAGCTTTCTTT	CASSLAPDRGFHSEAFF	TRBV5-1	TRBJ1-1
TGTGCCAGCAGCCAAGGGCCGGACAGGTGGGAAGATACGCAGTATTTT	CASSQGPDRWEDTQYF	TRBV14	TRBJ2-3
TGTGCCAGCAGCAAGGGATGGACTCAGACCTACGAGCAGTACTTC	CASSKGWTQTYEQYF	TRBV7-3	TRBJ2-7
TGTGCCAGCAGCTGGACAGGGCTGTACTCCCAGAACACTGAAGCTTTCTTT	CASSWTGLYSQNTEAFF	TRBV5-4	TRBJ1-1
TGCAGTGCTAGTGCACGGGACCCCCGGAATTCACCCCTCCACTTT	CSASARDPRNSPLHF	TRBV20-1	TRBJ1-6
TGTGCCAGCACCCTTAGGGCCCGTGACGCCTACAATGAGCAGTTCTTC	CASTLRARDAYNEQFF	TRBV7-3	TRBJ2-1
TGTGCCAGCAGCCCCAGCGGGATTAGCTCCTACGAGCAGTACTTC	CASSPSGISSYEQYF	TRBV7-2	TRBJ2-7
TGTGCCAGCAGTCCCGCCAATAGCGGCGGATACGAGCAGTACTTC	CASSPANSGGYEQYF	TRBV14	TRBJ2-7
TGTGCCAGCTCACCAAGCGGTACTAGCACAGATACGCAGTATTTT	CASSPSGTSTDTQYF	TRBV18	TRBJ2-3
TGCAGCGACACTTTGGGAGAAGGTGGGGCCAACGTCCTGACTTTC	CSDTLGEGGANVLTF	TRBV29-1	TRBJ2-6
TGTGCCAGCAGCTGGGATCCACGGGGATGTCGTAATTTGTACACCATATATTTT	CASSWDPRGCRNLYTIYF	TRBV7-6	TRBJ1-3
TGTGCCAGCAGCGTTCGTAGTCCATTTTACACTGAAGCTTTCTTT	CASSVRSPFYTEAFF	TRBV9	TRBJ1-1
TGCGCCAGTAAAAAGGGGAAGGGCACTGAAGCTTTCTTT	CASKKGKGTEAFF	TRBV10-2	TRBJ1-1
TGCGCCAGCCCATGGATAGGTTTAGCCAAAAACATTCAGTACTTC	CASPWIGLAKNIQYF	TRBV10-1	TRBJ2-4
TGCGCCAGCAGGTCGACTCCGGGACTTGAGCAGTTCTTC	CASRSTPGLEQFF	TRBV10-1	TRBJ2-1
TGTGCCAGCAGCTCGGCACGACATAATTCACCCCTCCACTTT	CASSSARHNSPLHF	TRBV5-4	TRBJ1-6
TGTGCCAGCTCGTTGCGGGGCGGTCACTACAATGAGCAGTTCTTC	CASSLRGGHYNEQFF	TRBV18	TRBJ2-1
TGTGCCAGCAGTGTCCCCACCCTAGCGGGCGACTACGAGCAGTACTTC	CASSVPTLAGDYEQYF	TRBV6-4	TRBJ2-7
TGCAGCGTCTGGTCCGGGGGGGGGGTGGTCTATAATTCACCCCTCCACTTT	CSVWSGGGVVYNSPLHF	TRBV29-1	TRBJ1-6
TGCGCCAGCAGCTTGCCGGGGGGTAGGCCCTACGAGCAGTACTTC	CASSLPGGRPYEQYF	TRBV5-1	TRBJ2-7
TGTGCCAGCACCGGGCGGCCCACAGATACGCAGTATTTT	CASTGRPTDTQYF	TRBV7-3	TRBJ2-3
TGTTGGACCGCGGGTAGCTACGAGCAGTACTTC	CWTAGSYEQYF	TRBV19	TRBJ2-7
TGTGCCAGCAGCTTAGCTTGCGGGGCTTGCAATCAGCCCCAGCATTTT	CASSLACGACNQPQHF	TRBV11-2	TRBJ1-5
TGTGCCAGCAGCTCCTGCCCCCGACTAGCGGGGGGGCCGAGGAGCTCCTACAATGAGCAGTTCTTC	CASSSCPRLAGGPRSSYNEQFF	TRBV5-6	TRBJ2-1
TGTGCCAGCAGGTCGAGGGGGCCCGCGTGGAGGGGATCTGGGGCCAACGTCCTGACTTTC	CASRSRGPAWRGSGANVLTF	TRBV6-4	TRBJ2-6
TGTGCCAGCAGCTTAGCGGGGGGTAATGAAAAACTGTTTTTT	CASSLAGGNEKLFF	TRBV7-8	TRBJ1-4
TGTGCCAGCAGTGAGCTTAGGGGGAACACCGGGGAGCTGTTTTTT	CASSELRGNTGELFF	TRBV6-2	TRBJ2-2
TGTGCCAGCAGCCGAGACAGGGGCCCCTACGAGCAGTACTTC	CASSRDRGPYEQYF	TRBV9	TRBJ2-7
TGTGCCAGCAGCTTGGTCCTCGGGGCCGGTATGGGGGGCTACGAGCAGTACTTC	CASSLVLGAGMGGYEQYF	TRBV5-5	TRBJ2-7
TGCGCCAGCAGCGGGGGTTGCCTCTATGGCTACACCTTC	CASSGGCLYGYTF	TRBV5-1	TRBJ1-2
TGTGCCAGCAGTGGGGGGGACGGAGAAAAACTGTTTTTT	CASSGGDGEKLFF	TRBV7-9	TRBJ1-4
TGCAGTGCCCTCGTACAGGGGGACGGCTACACCTTC	CSALVQGDGYTF	TRBV20-1	TRBJ1-2
TGTGCCAGCAGCTTTGACATCACTGAAGCTTTCTTT	CASSFDITEAFF	TRBV11-3	TRBJ1-1
TGTGCCAGTATGCCTAGCGGGATCGACTATACGCAGTATTTT	CASMPSGIDYTQYF	TRBV2	TRBJ2-3
TGTGCCAGCGAATTGGACAGGTCTGAAGCTTTCTTT	CASELDRSEAFF	TRBV11-3	TRBJ1-1
TGTGCCAGCTGGAGTCGCACGACTAGCGGGACGGGGGTCAACACCGGGGAGCTGTTTTTT	CASWSRTTSGTGVNTGELFF	TRBV28	TRBJ2-2
TGTGCCAAGTCTAGCGGGCTGGACAATGAGCAGTTCTTC	CAKSSGLDNEQFF	TRBV11-2	TRBJ2-1
TGCGCCAGCAGCCAAGAAGGTGACAGTCCCCCCTATGGCTACACCTTC	CASSQEGDSPPYGYTF	TRBV4-1	TRBJ1-2
TGTGCCAGCAGCGGGAAGGGTTCCGCTAACTATGGCTACACCTTC	CASSGKGSANYGYTF	TRBV7-3	TRBJ1-2
TGTGCCAGCATGGGTCCCACTGACATATATGGCTACACCTTC	CASMGPTDIYGYTF	TRBV6-2	TRBJ1-2
TGTGCCAGCAGCGTAGGACTAGCGGGCTACAATGAGCAGTTCTTC	CASSVGLAGYNEQFF	TRBV9	TRBJ2-1
TGTGCCAGCAGTGACAGACAGGGGGAAACAGAAGGGGACACTGAAGCTTTCTTT	CASSDRQGETEGDTEAFF	TRBV6-4	TRBJ1-1
TGTGCCAGCAGCTTGACAACTATGAGCTACGAGCAGTACTTC	CASSLTTMSYEQYF	TRBV5-6	TRBJ2-7
TGTGCTAGTGGCCGGGCCTACTTTATAGATACGCAGTATTTT	CASGRAYFIDTQYF	TRBV12-5	TRBJ2-3
TGTGCCAGCAGCTTGCGAGGGACAGGGACCTTAGAAGCTAACTATGGCTACACCTTC	CASSLRGTGTLEANYGYTF	TRBV5-4	TRBJ1-2
TGTGCCAGCAGTTACTCGAACAAAGAGACTAGCGGGGCCTTGGGTCGAGCCTACGAGCAGTACTTC	CASSYSNKETSGALGRAYEQYF	TRBV6-5	TRBJ2-7
TGTGCCCGTCCCCTACTAGCGGGAGGGCGAAGCGAGTCTGGGGCCAACGTCCTGACTTTC	CARPLLAGGRSESGANVLTF	TRBV10-3	TRBJ2-6
TGTGCCATATGCAGGGAGGATAGCAATCAGCCCCAGCATTTT	CAICREDSNQPQHF	TRBV6-5	TRBJ1-5
TGCAGTGCTAGAGGAGGGGGACACGACTCAATGAACACTGAAGCTTTCTTT	CSARGGGHDSMNTEAFF	TRBV20-1	TRBJ1-1
TGTGCCAGCATAGACAGGGGTAACTATGGCTACACCTTC	CASIDRGNYGYTF	TRBV27	TRBJ1-2
TGTGCCAGCAAATCCTGGACGCCTGAGCAGTTCTTC	CASKSWTPEQFF	TRBV2	TRBJ2-1
TGCGCCAGCAGTGGGGGCGATTACACTGAAGCTTTCTTT	CASSGGDYTEAFF	TRBV10-2	TRBJ1-1
TGTGCCAGCAGCGGGGGACTAGCAGCCGAGACCCAGTACTTC	CASSGGLAAETQYF	TRBV11-2	TRBJ2-5
TGTGCCAGCAGCTTCCGGAGAGGGTTAAATGAGCAGTTCTTC	CASSFRRGLNEQFF	TRBV7-9	TRBJ2-1
TGCGCCAGCAGCTTGACGCCATTCTTGAGCTACGAGCAGTACTTC	CASSLTPFLSYEQYF	TRBV5-1	TRBJ2-7
TGCAGTGCTAGAGTCGGGGGGCCCCGCAATCAGCCCCAGCATTTT	CSARVGGPRNQPQHF	TRBV20-1	TRBJ1-5
TGCGCCAGCAGCTTGGCTTTGGACGCGAGCCGTAGCAATCAGCCCCAGCATTTT	CASSLALDASRSNQPQHF	TRBV5-1	TRBJ1-5
TGTGCCAGCAGGGGTAGGAGGGGGTATAGCAATCAGCCCCAGCATTTT	CASRGRRGYSNQPQHF	TRBV12-3	TRBJ1-5
TGTGCCTGGAGTGAGCTGGGGGGGGGGCTTAGAGGCTACGAGCAGTACTTC	CAWSELGGGLRGYEQYF	TRBV30	TRBJ2-7
TGTGCCAGCAGCCCCCGGGACAGGGCCTCAAACACTGAAGCTTTCTTT	CASSPRDRASNTEAFF	TRBV13	TRBJ1-1
TGCGCCAGCAGTGCTCGCCGAACAGGGTGCTACGAGCAGTACTTC	CASSARRTGCYEQYF	TRBV10-1	TRBJ2-7
TGTGCCAGCAGTGTTAGGGGACCGGGGGAAAAACTGTTTTTT	CASSVRGPGEKLFF	TRBV28	TRBJ1-4
TGTGCCATACAACCCGAGCAGTACTTC	CAIQPEQYF	TRBV10-3	TRBJ2-7
TGTGCCAGCAGTCAGAACACACAGTCGACAGGGCCGCAACTCTATGGCTACACCTTC	CASSQNTQSTGPQLYGYTF	TRBV6-4	TRBJ1-2
TGTGCCACCAGTGATTTGACCAACAATCAGCCCCAGCATTTT	CATSDLTNNQPQHF	TRBV24-1	TRBJ1-5
TGTGCCAGCAGCCACGGGTCTGGAAACACCATATATTTT	CASSHGSGNTIYF	TRBV5-4	TRBJ1-3
TGTGCCAGTCGCCAGGCTGGAAACACCATATATTTT	CASRQAGNTIYF	TRBV19	TRBJ1-3
TGCAGTGCTCGCGGGGCAGGGGCCTACGAGCAGTACTTC	CSARGAGAYEQYF	TRBV20-1	TRBJ2-7
TGCGCCAGCAGTGATCTGGAGACAGAAGTTGGAAACACCATATATTTT	CASSDLETEVGNTIYF	TRBV10-1	TRBJ1-3
TGTGCCAGCAGGACAGGACTATACACCGGGGAGCTGTTTTTT	CASRTGLYTGELFF	TRBV6-4	TRBJ2-2
TGTGCCAGCAGCGTACGGTTCGTGCTCCGGGACAGGGGGCTCGGGAGCAATCAGCCCCAGCATTTT	CASSVRFVLRDRGLGSNQPQHF	TRBV9	TRBJ1-5
TGTGCCAGCGGTTGTGGACCTGACACAAAAGGGACAGCAATAGGCACAGATACGCAGTATTTT	CASGCGPDTKGTAIGTDTQYF	TRBV2	TRBJ2-3
TGTGCCAGTAGTTGCGGGCAGTACTTC	CASSCGQYF	TRBV19	TRBJ2-7
TGTGCTAGTGGTTTGGTACTTCGCTACCGGGACGGCTACGAGCAGTACTTC	CASGLVLRYRDGYEQYF	TRBV12-5	TRBJ2-7
TGTGCCAGCAGCCTACCGGGGCCCGAATACGAGCAGTACTTC	CASSLPGPEYEQYF	TRBV3-1	TRBJ2-7
TGCAGTGCTAGTTGGGAGGGTTATCAGCCCCAGCATTTT	CSASWEGYQPQHF	TRBV20-1	TRBJ1-5
TGCGCCAGCAGCCACGCCGAATTCGTGAGGGCCTTC	CASSHAEFVRAF	TRBV4-1	TRBJ1-2
TGTGCCAGCTCCCTGGGCTCCTACAATGAGCAGTTCTTC	CASSLGSYNEQFF	TRBV27	TRBJ2-1
TGTGCCAGCAGCGCCTCCCAGGGGGAAGGCTACAATGAGCAGTTCTTC	CASSASQGEGYNEQFF	TRBV9	TRBJ2-1
TGTGCCAGCAGCCACGGACAGGGGGGGACAGATACGCAGTATTTT	CASSHGQGGTDTQYF	TRBV13	TRBJ2-3
TGCGCCAGCAGCTTGTCCGGCCGGGACTTGACGGTGAACACTGAAGCTTTCTTT	CASSLSGRDLTVNTEAFF	TRBV5-1	TRBJ1-1
TGCGCCAGCTCAAAATGGCCCAGGGCACCATACTCCTACGAGCAGTACTTC	CASSKWPRAPYSYEQYF	TRBV10-2	TRBJ2-7
TGTGCCAGCAGCCCCGATCACCCGGGACTAGCCCAAGAGAACACCGGGGAGCTGTTTTTT	CASSPDHPGLAQENTGELFF	TRBV12-4	TRBJ2-2
TGTGCCAGCAGTTTCTCGGGAGGTAACACTGAAGCTTTCTTT	CASSFSGGNTEAFF	TRBV27	TRBJ1-1
TGCAGTGCTAGAGATCCTACCGAGGCCGGGGTATGGTACGAGCAGTACTTC	CSARDPTEAGVWYEQYF	TRBV20-1	TRBJ2-7
TGTGCCAGCAGCTTCAGAGGCGGAGAGGTGAACGATACGCAGTATTTT	CASSFRGGEVNDTQYF	TRBV7-9	TRBJ2-3
TGTGTACCGACAGGGCCTAATACGCAGTATTTT	CVPTGPNTQYF	TRBV24-1	TRBJ2-3
TGTGCCACCAGTGATTGTGGGGGCTGCACTGAAGCTTTCTTT	CATSDCGGCTEAFF	TRBV24-1	TRBJ1-1
TGCAGCGTTCCCCGGGACAGAACACAGCCCCAGCATTTT	CSVPRDRTQPQHF	TRBV29-1	TRBJ1-5
TGTGCCAGCACGCTAGGGGGCAGGGTTCCGAACGTCAATCAGCCCCAGCATTTT	CASTLGGRVPNVNQPQHF	TRBV2	TRBJ1-5
TGTGCCACCGGGACTAGCGGTAGGGAGCAGTACTTC	CATGTSGREQYF	TRBV11-2	TRBJ2-7
TGCGCCAGCAGCCCGGGGGGGCCGGGACAGGTCTTAGGTCAGTACTTC	CASSPGGPGQVLGQYF	TRBV5-1	TRBJ2-5
TGCGCCAGCAGCTTCCAGGGACAGGGTGGGGTAGGGAGGGACACTGAAGCTTTCTTT	CASSFQGQGGVGRDTEAFF	TRBV5-1	TRBJ1-1
TGCAGTGCCTGTACCATACAGGGCGGTAATGAAAAACTGTTTTTT	CSACTIQGGNEKLFF	TRBV20-1	TRBJ1-4
TGTGCCAGCAGTGAGGTTTCGGGGGGGGGTCCCACTGAAGCTTTCTTT	CASSEVSGGGPTEAFF	TRBV6-4	TRBJ1-1
TGTGCTAGCAGCTTAGCGAGACGCAGGACTAGCGGGCCTCGATATGGACCTTACAATGAGCAGTTCTTC	CASSLARRRTSGPRYGPYNEQFF	TRBV7-7	TRBJ2-1
TGTGCCAGCAGCTTATACGGGGGGTTGTCTTCTGGAAACACCATATATTTT	CASSLYGGLSSGNTIYF	TRBV11-2	TRBJ1-3
TGTGCCAGCTCACCTAACCACGGTCGGGCCCATGGCTACACCTTC	CASSPNHGRAHGYTF	TRBV18	TRBJ1-2
TGTGCCAGCAAGACTAAAAAGCGGGGAGACGAGCAGTACTTC	CASKTKKRGDEQYF	TRBV6-5	TRBJ2-7
TGTGCCAGCAGCCAGTATGGTCCTGAGTATTTT	CASSQYGPEYF	TRBV4-2	TRBJ2-3
TGTGCCAGCAGCGCCCCAGTCCGGGACACATACGAGCAGTACTTC	CASSAPVRDTYEQYF	TRBV9	TRBJ2-7
TGTGCCAGCAGCTTAACGTCCAAGAGGAACACTGAAGCTTTCTTT	CASSLTSKRNTEAFF	TRBV7-3	TRBJ1-1
TGCGCCCTCAGGGACCCCAATGAAAAACTGTTTTTT	CALRDPNEKLFF	TRBV5-1	TRBJ1-4
TGTGCCAGCAGCCACTTGTGCGGCGGCTACACTGAAGCTTTCTTT	CASSHLCGGYTEAFF	TRBV4-2	TRBJ1-1
TGCAGTGCTAGAGCCACCATGTCAACCTGGGATTTTCTCGGCCACTACGAGCAGTACTTC	CSARATMSTWDFLGHYEQYF	TRBV20-1	TRBJ2-7
TGCAGTGCCTCGGGGTGGATCGAGCAGTACTTC	CSASGWIEQYF	TRBV20-1	TRBJ2-7
TGTGCCAGCAGCGGAGCCGGGACAGGGCCGGAGCAGTACTTC	CASSGAGTGPEQYF	TRBV11-3	TRBJ2-7
TGCGCCAGCAGTATAGTCCTAGCGGTGGGGAATGAGCAGTTCTTC	CASSIVLAVGNEQFF	TRBV5-1	TRBJ2-1
TGCAGCGCGACTAGCGGGGTCTACAATGAGCAGTTCTTC	CSATSGVYNEQFF	TRBV29-1	TRBJ2-1
TGTGCCAGCAGTTTATATCAATCTAGCGGGTACGAGCAGTACTTC	CASSLYQSSGYEQYF	TRBV12-3	TRBJ2-7
TGTGCCAGCAGGGACAGGGGGACAGATACGCAGTATTTT	CASRDRGTDTQYF	TRBV11-2	TRBJ2-3
TGTGCCAGCACCTCCCGGACAGGGTGGGATCAGCCCCAGCATTTT	CASTSRTGWDQPQHF	TRBV27	TRBJ1-5
TGTGCCAGCAGCTTAGACAGACAGGGCCCGCATTGTCAGCCCCAGCATTTT	CASSLDRQGPHCQPQHF	TRBV11-3	TRBJ1-5
TGTGCCAGCAGCTCCTTCTGCGGAGGGATCTACAATGAGCAGTTCTTC	CASSSFCGGIYNEQFF	TRBV5-6	TRBJ2-1
TGTGCCAGCCCAGGGGGCCTGAATCAGCCCCAGCATTTT	CASPGGLNQPQHF	TRBV27	TRBJ1-5
TGCGCCAGCACGGGGGCTTCAGGGCAGCCCCAGCATTTT	CASTGASGQPQHF	TRBV10-1	TRBJ1-5
TGTGCCAGTAGTATTCCCCCGGGGCAGAGCTCCTACGAGCAGTACTTC	CASSIPPGQSSYEQYF	TRBV19	TRBJ2-7
TGTGCCAAACGCCCGACGGGGGACTACAATGAGCAGTTCTTC	CAKRPTGDYNEQFF	TRBV4-2	TRBJ2-1
TGTGCCAGGCAACTAGCGACCGGGGAGCTGTTTTTT	CARQLATGELFF	TRBV6-4	TRBJ2-2
TGTGCCAGCAGTAGGCGGCGGGGGGGCTCCTGCGAGACCTACGAGCAGTACTTC	CASSRRRGGSCETYEQYF	TRBV7-6	TRBJ2-7
TGCAGTGCTAGCGGGAATCAAGAGACCCAGTACTTC	CSASGNQETQYF	TRBV20-1	TRBJ2-5
TGTGCCAGCAGTTTATGCGGCTCCTACAATGAGCAGTTCTTC	CASSLCGSYNEQFF	TRBV27	TRBJ2-1
TGTGCCAGTACCGACAGGGAAACCAAAAACATTCAGTACTTC	CASTDRETKNIQYF	TRBV19	TRBJ2-4
TGTGCCAGTGAGTCCACGACCTACAATGAGCAGTTCTTC	CASESTTYNEQFF	TRBV6-6	TRBJ2-1
TGTGCCACCCCGGGGGACAGTAATGAGCAGTACTTC	CATPGDSNEQYF	TRBV24-1	TRBJ2-7
TGCAGTGCTAGACCCAGTCAGAAATCTGAAGCTTTCTTT	CSARPSQKSEAFF	TRBV20-1	TRBJ1-1
TGCGCCAGCAGCCGCACCGGACAGGGCGAACAAGAGACCCAGTACTTC	CASSRTGQGEQETQYF	TRBV5-1	TRBJ2-5
TGTGCCAGCAGTTACGTGGGACTATCCAGGGCTTTCTTT	CASSYVGLSRAFF	TRBV6-5	TRBJ1-1
TGTGCCAGCAGAAATCGGACAAGAATTCCGAGTAGCAATCAGCCCCAGCATTTT	CASRNRTRIPSSNQPQHF	TRBV7-3	TRBJ1-5
TGCGCCAGCAGCTTGGAAAAAACCCGTAGCGGGAAGGTATCCAAACGGAGGAATGAGCAGTTCTTC	CASSLEKTRSGKVSKRRNEQFF	TRBV5-1	TRBJ2-1
TGTGCCAGCAGTTCCGGACAGTCTTCACCCCTCCACTTT	CASSSGQSSPLHF	TRBV6-5	TRBJ1-6
TGTGCCAGCAGCCTCCCGTCTAGCGGGCCGGATACGCAGTATTTT	CASSLPSSGPDTQYF	TRBV7-8	TRBJ2-3
TGTGCCAGCAGTTGCCGCCCCGGGACAGATGCCTACGAGCAGTACTTC	CASSCRPGTDAYEQYF	TRBV2	TRBJ2-7
TGTGCCAGCAGCAGGGCCGGACAGGGGGCGACTGGGGCCAACGTCCTGACTTTC	CASSRAGQGATGANVLTF	TRBV7-9	TRBJ2-6
TGCAGTGCTAGAATGAAGGACTTAGCGGGGTTTGAGCAGTTCTTC	CSARMKDLAGFEQFF	TRBV20-1	TRBJ2-1
TGTGCCAGCAGGGGGGACAATGAGCAGTTCTTC	CASRGDNEQFF	TRBV6-4	TRBJ2-1
TGCAGTGCTAGGCAGCGGGACAAGACCCAGTACTTC	CSARQRDKTQYF	TRBV20-1	TRBJ2-5
TGTGCCAGCTTGAGCCCCCTCGAGGTGAGCCAAGACACCTTC	CASLSPLEVSQDTF	TRBV28	TRBJ1-2
TGTGCCAGCAGTGACTCCACGGCCTGTCCATCCAATCAGCCCCAGCATTTT	CASSDSTACPSNQPQHF	TRBV6-4	TRBJ1-5
TGTGCCAGCAGCCAAGGCAGTCAGGGACGAGACTACGAGCAGTACTTC	CASSQGSQGRDYEQYF	TRBV4-2	TRBJ2-7
TGTGCCATCTTATCGAGCGGGAGACTCAATGAAAAACTGTTTTTT	CAILSSGRLNEKLFF	TRBV10-3	TRBJ1-4
TGTGCCAGCAGCTTAGGGGGCCGAGCCTACGAGCAGTACTTC	CASSLGGRAYEQYF	TRBV5-4	TRBJ2-7
TGTGCCACCAGTGATTTCGTCCGCTGGACAGGGGTCTTC	CATSDFVRWTGVF	TRBV24-1	TRBJ2-1
TGTGCCAGCATGGTGGACAGGGACAAAGCCTACGAGCAGTACTTC	CASMVDRDKAYEQYF	TRBV6-3	TRBJ2-7
TGTGCCAGCAGAAGCTTTCGACGGGACGCAGGAGGAAACACCATATATTTT	CASRSFRRDAGGNTIYF	TRBV28	TRBJ1-3
TGTGCCAGCAGCGAACCTAGAGGCCCCTCTGGAAACACCATATATTTT	CASSEPRGPSGNTIYF	TRBV9	TRBJ1-3
TGTGCCAGCACCACCCCAAGCGGGAAAAAGTCACCCCTCCACTTT	CASTTPSGKKSPLHF	TRBV12-4	TRBJ1-6
TGCGCCAGCCCATCCCCGGACAGGATATTGGGGCTAGCCAAAAACATTCAGTACTTC	CASPSPDRILGLAKNIQYF	TRBV10-1	TRBJ2-4
TGTGCCAGCAGCAAAGGACAGGCCTACAATGAGCAGTTCTTC	CASSKGQAYNEQFF	TRBV7-2	TRBJ2-1
TGTGCCAGCAGCCAAGGGGGGACTAGCACAGATACGCAGTATTTT	CASSQGGTSTDTQYF	TRBV3-1	TRBJ2-3
TGTGCCAGCAGCTTAAAAACCGACAGCTCCTACGAGCAGTACTTC	CASSLKTDSSYEQYF	TRBV7-3	TRBJ2-7
TGTGCCAGCAGGACAGGACAGGGGGAGAATGAGCAGTTCTTC	CASRTGQGENEQFF	TRBV11-2	TRBJ2-1
TGCGCCAGCAGCCAAGATCCGATCCCTGGTGTTAAGGGACAGGGCCCACGCTATGGCTACACCTTC	CASSQDPIPGVKGQGPRYGYTF	TRBV4-3	TRBJ1-2
TGTGCCAGCAGCTCTTTCGCAGTAGGCGATCGTTCACCCCTCCACTTT	CASSSFAVGDRSPLHF	TRBV7-6	TRBJ1-6
TGTGCCACCAGAACTCTTTGGACAGGAAACGGCTACACCTTC	CATRTLWTGNGYTF	TRBV24-1	TRBJ1-2
TGTGCCAGCAGCGTGGCCCGGGAGGCCCACGAGCAGTACTTC	CASSVAREAHEQYF	TRBV9	TRBJ2-7
TGTGCCAGCAGCTTAAACAGAGCTAGCTCCTACGAGCAGTACTTC	CASSLNRASSYEQYF	TRBV7-8	TRBJ2-7
TGTGCCCGCGGGGGACCTAATGAAAAACTGTTTTTT	CARGGPNEKLFF	TRBV28	TRBJ1-4
TGTGCCAGCAGTTTCGACAGGGCCCGGAACACTGAAGCTTTCTTT	CASSFDRARNTEAFF	TRBV27	TRBJ1-1
TGTGCCAAGGCCGTTAGGGGGAAGCCCTACGAGCAGTACTTC	CAKAVRGKPYEQYF	TRBV6-1	TRBJ2-7
TGCAGCGTTGACAGGGGGGACAAGGAAAAACTGTTTTTT	CSVDRGDKEKLFF	TRBV29-1	TRBJ1-4
TGTGCCAGCAGCCCCAGGGGGGAGAGGTACAATGAGCAGTTCTTC	CASSPRGERYNEQFF	TRBV6-6	TRBJ2-1
TGTGCCAGCAGCGAAGGCTACACCTTC	CASSEGYTF	TRBV7-9	TRBJ1-2
TGTGCCAGCAGTTTCACGACAGGGAGAGAAGCTTTCTTT	CASSFTTGREAFF	TRBV6-5	TRBJ1-1
TGTGCCAGTAAGACAGGGGCCTACGAGCAGTACTTC	CASKTGAYEQYF	TRBV19	TRBJ2-7
TGTGCCAGCAGCTTGGCTTCCACTAGCGGGACCCCTAGCACAGATACGCAGTATTTT	CASSLASTSGTPSTDTQYF	TRBV11-2	TRBJ2-3
TGTGCCAGCAGTGACCCCAAGGGGCACAGGGGGCGGGAGCCCCAGCATTTT	CASSDPKGHRGREPQHF	TRBV6-1	TRBJ1-5
TGTGCCAGCTTGAGTGCGGGACAGGGGGCAGTTACTGAAGCTTTCTTT	CASLSAGQGAVTEAFF	TRBV6-6	TRBJ1-1
TGTGCCAGCAGGCAGGGGGAAGAGACCCAGTACTTC	CASRQGEETQYF	TRBV7-8	TRBJ2-5
TGTGCCAGCAGTAGGAGTTTCTACGAGCAGTACTTC	CASSRSFYEQYF	TRBV5-6	TRBJ2-7
TGCGCCAGCAGCTTACTGCTAGGCCCGGGGATCTACAATGAGCAGTTCTTC	CASSLLLGPGIYNEQFF	TRBV5-1	TRBJ2-1
TGTGCCAGCAGTGATCCTGGTCAGGGGAGTCTGACAGATACGCAGTATTTT	CASSDPGQGSLTDTQYF	TRBV25-1	TRBJ2-3
TGTGCCAGCAGCATACCAGGGCGACTTCGGAACGAGCAGTACTTC	CASSIPGRLRNEQYF	TRBV7-9	TRBJ2-7
TGCAGTGCTAGAGATCACGGGGGGCTCAATCAGCCCCAGCATTTT	CSARDHGGLNQPQHF	TRBV20-1	TRBJ1-5
TGCGCCAGCAGCCAAGATCAGGGGGACAGCGATGAGCAGTTCTTC	CASSQDQGDSDEQFF	TRBV4-3	TRBJ2-1
TGTGCCAGGAACCCACGAAATACCCCACGGAGGGTGTATAGCTCCTATAATTCACCCCTCCACTTT	CARNPRNTPRRVYSSYNSPLHF	TRBV3-1	TRBJ1-6
TGCAGCGTTGACCCTTCCCGGAGATTACCTGAACGCACAGATACGCAGTATTTT	CSVDPSRRLPERTDTQYF	TRBV29-1	TRBJ2-3
TGTGCCTGGAGTGAACTGAGGAGGACAGGGCTCGGGACGAACACTGAAGCTTTCTTT	CAWSELRRTGLGTNTEAFF	TRBV30	TRBJ1-1
TGTGCCAGCAGCTTACCCGTATTGACAGGGAGGTACTGGACTGAAGCTTTCTTT	CASSLPVLTGRYWTEAFF	TRBV7-2	TRBJ1-1
TGTGCCAGCAGTTACGCTAGGGTACGACGGCTGACTGAAGCTTTCTTT	CASSYARVRRLTEAFF	TRBV6-5	TRBJ1-1
TGTGCCAGCTCACCTGATAGGGGGACCGGGGAGCTGTTTTTT	CASSPDRGTGELFF	TRBV18	TRBJ2-2
TGTGCCAGCAGATTCCCAGGGGCCTCCTCTGGGGCCAACGTCCTGACTTTC	CASRFPGASSGANVLTF	TRBV6-5	TRBJ2-6
TGTGCCAGCAGCTTAGCGCATATGGTGGAGATTTTACCTAACTATGGCTACACCTTC	CASSLAHMVEILPNYGYTF	TRBV7-6	TRBJ1-2
TGTGCCAGCAGCCAGGAAACTAGCGGGTCGCTCCCAGGCTCCTACAATGAGCAGTTCTTC	CASSQETSGSLPGSYNEQFF	TRBV7-9	TRBJ2-1
TGTGCCAGCAGACTAGCGGGGGGGGTAAGGGAGTACAATGAGCAGTTCTTC	CASRLAGGVREYNEQFF	TRBV6-1	TRBJ2-1
TGTGCCAGCAGCTTAGAAACTACGGGAGGGTGTAGCTCCTACAATGAGCAGTTCTTC	CASSLETTGGCSSYNEQFF	TRBV7-2	TRBJ2-1
TGCGCCAGCAGTGAGCGGGACCCCGTTTCACCCCTCCACTTT	CASSERDPVSPLHF	TRBV10-2	TRBJ1-6
TGTGCCAGCAGCTTATACCGGACTGGAGGCTACACCTTC	CASSLYRTGGYTF	TRBV7-2	TRBJ1-2
TGTGCCAGCAGTGAGCACCAGGGCCCGCGGAACACTGAAGCTTTCTTT	CASSEHQGPRNTEAFF	TRBV6-1	TRBJ1-1
TGTGCCAGCAGTTCCGTGGGAGAGGGACAGAATCAGCCCCAGCATTTT	CASSSVGEGQNQPQHF	TRBV27	TRBJ1-5
TGTGCCAGCGAGGATGAGTTACGAAACATTCAGTACTTC	CASEDELRNIQYF	TRBV6-5	TRBJ2-4
TGTGCCAGCAGCCGAACTTGGCGCAGTCGGCAGTACTTC	CASSRTWRSRQYF	TRBV3-1	TRBJ2-5
TGTGCCAGCAACCTGGGACAGGGCGCTAATGGCTACACCTTC	CASNLGQGANGYTF	TRBV9	TRBJ1-2
TGTGCCAGCAGCCGGGGGAACGAGCAGTACTTC	CASSRGNEQYF	TRBV5-8	TRBJ2-7
TGTGCCAGCAGCCTAATCGTGAATAGCGCAGAAGCTTGCAATGAGCAGTTCTTC	CASSLIVNSAEACNEQFF	TRBV6-5	TRBJ2-1
TGTGCCAGTAATCGTAGTCGACTAGTCAAGGACAATGAGCAGTTCTTC	CASNRSRLVKDNEQFF	TRBV19	TRBJ2-1
TGTGCCAGCAGGAATTATAATGAAAAACTGTTTTTT	CASRNYNEKLFF	TRBV9	TRBJ1-4
TGTGCCAGCAGCTTCGGAGTGACAGAGCTCAGTGTCGAGCAGTACTTC	CASSFGVTELSVEQYF	TRBV7-6	TRBJ2-7
TGTGCCAGCAGTATTGCAAAACTCTTT	CASSIAKLF	TRBV6-5	TRBJ1-1
TGTGCCAGCAGCTTAGCCGCGGTCTCCTACGAGCAGTACTTC	CASSLAAVSYEQYF	TRBV7-9	TRBJ2-7
TGCGCCAGCAGCTTGCTCTGGGCACAGGGGTGCGAGCAGTACTTC	CASSLLWAQGCEQYF	TRBV5-1	TRBJ2-7
TGTGCCAGCAGCTCCCCGGGGGGGAGGCCCCGTAATGAAGCTTTCTTT	CASSSPGGRPRNEAFF	TRBV12-3	TRBJ1-1
TGCGCCAGCAGCTTGACGACAGGTTCTCCGCAAGGCTACACCTTC	CASSLTTGSPQGYTF	TRBV5-1	TRBJ1-2
TGTGCCAGCAGGGATATGGGGAAGACGGTAACCGGAAACACCATATATTTT	CASRDMGKTVTGNTIYF	TRBV6-1	TRBJ1-3
TGTGCCAGCATCCAGGGGTCCTACGAGCAGTACTTC	CASIQGSYEQYF	TRBV6-5	TRBJ2-7
TGTGCCAGCAGTGACGACAGGGGGCAGTACTTC	CASSDDRGQYF	TRBV6-4	TRBJ2-7
TGTGCCAGCAGCCCCCCCAGGGGGCGCACACGCTACGAGCAGTACTTC	CASSPPRGRTRYEQYF	TRBV7-4	TRBJ2-7
TGTGCCAGCAGCCACAACCCGACTAGATCGAACACCGGGGAGCTGTTTTTT	CASSHNPTRSNTGELFF	TRBV14	TRBJ2-2
TGTGCCAGCAGTGAGGGGAAACAGCCCCAGCATTTT	CASSEGKQPQHF	TRBV6-4	TRBJ1-5
TGTGCCAGCAGCCCGGGACTAGCGGGCGGTCTCCGAGAGACCCAGTACTTC	CASSPGLAGGLRETQYF	TRBV9	TRBJ2-5
TGCAGTGCTAGAGATCCGCCCATAGATATGAACACTGAAGCTTTCTTT	CSARDPPIDMNTEAFF	TRBV20-1	TRBJ1-1
TGTGCCAGCAGCGTACCTAGCGGGAACGGTGTGCTAGGCGAGCAGTACTTC	CASSVPSGNGVLGEQYF	TRBV5-6	TRBJ2-7
TGCGCCAGCAGCCAAGACGGGGGAAGGCCTAGCAATCAGCCCCAGCATTTT	CASSQDGGRPSNQPQHF	TRBV4-3	TRBJ1-5
TGTGCCAGCAGCCAACAGGGGGGCCCGACCGGGGCCAACGTCCTGACTTTC	CASSQQGGPTGANVLTF	TRBV3-1	TRBJ2-6
TGTGCCAGCAGCTTGGGTATGACTAGATCTGCTGAGCAGTTCTTC	CASSLGMTRSAEQFF	TRBV5-4	TRBJ2-1
TGTGCCAGCAGTTACCGGCTCGGGTACACCGGGGAGCTGTTTTTT	CASSYRLGYTGELFF	TRBV6-6	TRBJ2-2
TGTGCCAGCTTTTTAAAGAGGATCACAGATACGCAGTATTTT	CASFLKRITDTQYF	TRBV7-9	TRBJ2-3
TGTGCCAGCTCACAAATAGGACAGGGGAGGCGTGAAGCTTTCTTT	CASSQIGQGRREAFF	TRBV18	TRBJ1-1
TGTGCCAGCCAAGTTGGGGCTTTCTTT	CASQVGAFF	TRBV5-8	TRBJ1-1
TGTGCCAGCTCACCAATTTTAGCGGGTGTTGGGACCCAGTACTTC	CASSPILAGVGTQYF	TRBV18	TRBJ2-5
TGTGCCAGCAGTACCAGGGCGGACACTGAAGCTTTCTTT	CASSTRADTEAFF	TRBV7-3	TRBJ1-1
TGTGCCAGCAGCCAAGGGGAAAGTTGCACCGGGGAGCTGTTTTTT	CASSQGESCTGELFF	TRBV5-4	TRBJ2-2
TGTGCCAGCAGCCGGCTACGGCCGGCGGCCTACGAGCAGTACTTC	CASSRLRPAAYEQYF	TRBV4-2	TRBJ2-7
TGTGCCAGCAGCCTGGGGGGATACATTCAGTACTTC	CASSLGGYIQYF	TRBV5-8	TRBJ2-4
TGCGCCAGCAAATACGGTGAGAACACTGAAGCTTTCTTT	CASKYGENTEAFF	TRBV4-1	TRBJ1-1
TGTGCCAGCAGCTGGGCGACAGGGCCCAAGGTGTTCGAAGCTTTCTTT	CASSWATGPKVFEAFF	TRBV9	TRBJ1-1
TGTGCCAGCAGTTACTCGTACAAGGAGGATACGCAGTATTTT	CASSYSYKEDTQYF	TRBV6-5	TRBJ2-3
TGTGCCAGCAGTGAACTAGCGGGGGTATGGGACTACGAGCAGTACTTC	CASSELAGVWDYEQYF	TRBV6-4	TRBJ2-7
TGCGCCGGGGGGGTTGAGCAGTTCTTC	CAGGVEQFF	TRBV10-1	TRBJ2-1
TGTGCCAGCAGTTACTATTGGGAAGTGGAAAAACTGTTTTTT	CASSYYWEVEKLFF	TRBV6-5	TRBJ1-4
TGTGCCAGCAGCGAGCGCAGGAGCTTAGGCAATCAGCCCCAGCATTTT	CASSERRSLGNQPQHF	TRBV7-2	TRBJ1-5
TGTGCCAGCGCCACGCCGGGACTAGCGGGAGATTACGTGGGAAACACCATATATTTT	CASATPGLAGDYVGNTIYF	TRBV6-5	TRBJ1-3
TGCGCCAGCAGTGGCCCCGGGACAGGGGGCGAAAAACTGTTTTTT	CASSGPGTGGEKLFF	TRBV10-1	TRBJ1-4
TGTGCCAGCAGCTTGGCGACTAGCCGCGGCACAGATACGCAGTATTTT	CASSLATSRGTDTQYF	TRBV5-5	TRBJ2-3
TGTGCTAGCAGGGTTTCACTACAATACGAGCAGTACTTC	CASRVSLQYEQYF	TRBV7-7	TRBJ2-7
TGTGCCAGCAGCCAAGTATGCCACCCCCGGGACAGAAGGGGACCTGAAGCTTTCTTT	CASSQVCHPRDRRGPEAFF	TRBV3-1	TRBJ1-1
TGTGCCAGCAGCTTAGAAGGACAGGGCCTTGGCGCGAACACCGGGGAGCTGTTTTTT	CASSLEGQGLGANTGELFF	TRBV5-5	TRBJ2-2
TGCGCCAGCAGCGAGTGTCCCGAAAAGGGCTATGGCTACACCTTC	CASSECPEKGYGYTF	TRBV10-1	TRBJ1-2
TGTGCCAGCAGTGGTTGGCCCTCGTATGAGCAGTTCTTC	CASSGWPSYEQFF	TRBV6-5	TRBJ2-1
TGTGCCAGCAGCTGTAAACCAGGGGACCAAGAGACCCAGTACTTC	CASSCKPGDQETQYF	TRBV13	TRBJ2-5
TGCAGTGCTAGAGAGGTCTACGAGCAGTACTTC	CSAREVYEQYF	TRBV20-1	TRBJ2-7
TGTGCCAGCAGCTTGAGACGAGGCAACAGCCTCTACGAGCAGTACTTC	CASSLRRGNSLYEQYF	TRBV5-5	TRBJ2-7
TGCGCCAGCAGTATGACTAGCGGGGGGAGCTACGAGCAGTACTTC	CASSMTSGGSYEQYF	TRBV4-1	TRBJ2-7
TGTGCTAGTGTCCCGGGACAGATCACAGATACGCAGTATTTT	CASVPGQITDTQYF	TRBV12-5	TRBJ2-3
TGTGCCAGCAGTTTAGATCCTCAAGACTGGTCCGGCTACAATGAGCAGTTCTTC	CASSLDPQDWSGYNEQFF	TRBV28	TRBJ2-1
TGTGCCAGCAGCTTAGGCCCGCGCCGCTACGAGCAGTACTTC	CASSLGPRRYEQYF	TRBV7-4	TRBJ2-7
TGTGCCAGTAGTATGAACCACCGGGACAGGGGGCCTACAGATACGCAGTATTTT	CASSMNHRDRGPTDTQYF	TRBV19	TRBJ2-3
TGTGCCAGCAGCTTGTTGAAAACACTCAATGAGCAGTTCTTC	CASSLLKTLNEQFF	TRBV5-6	TRBJ2-1
TGTGCCAGCAGTTACCCCGGTCACGATGAAAAACTGTTTTTT	CASSYPGHDEKLFF	TRBV6-3	TRBJ1-4
TGCAGTGCTAGTCACCCCCTGCCGGGACAGCTAGATACGCAGTATTTT	CSASHPLPGQLDTQYF	TRBV20-1	TRBJ2-3
TGTGCCAGGATATGGGACAGCGACCGTCAGCCCCAGCATTTT	CARIWDSDRQPQHF	TRBV27	TRBJ1-5
TGTGCCAGCTCACCGGGGAATCAGCCCCAGCATTTT	CASSPGNQPQHF	TRBV18	TRBJ1-5
TGCGCCAGCAGCTTGGAGGGCACCAATCAAGAACTGGGCAGCTCCTACAATGAGCAGTTCTTC	CASSLEGTNQELGSSYNEQFF	TRBV5-1	TRBJ2-1
TGTGCCAGCACTAGCGGGTACGCGAACACCGGGGAGCTGTTTTTT	CASTSGYANTGELFF	TRBV6-4	TRBJ2-2
TGCGCCAGCAGCTCCCGTGGGGGCAGACATAGTGGCTACACCTTC	CASSSRGGRHSGYTF	TRBV5-1	TRBJ1-2
TGTGCCATCGGAACCCTGGGAGCCGGGACTCTAAGGAACACTGAAGCTTTCTTT	CAIGTLGAGTLRNTEAFF	TRBV10-3	TRBJ1-1
TGTGCCAGCAGCGTGGGGACGGGGCCGGCCTACGAGCAGTACTTC	CASSVGTGPAYEQYF	TRBV9	TRBJ2-7
TGTGCCAGCGATTCTGTGGGGGGCAACGAGCAGTACTTC	CASDSVGGNEQYF	TRBV27	TRBJ2-7
TGTGCCAGCATTGGGGGGAGCGTCTACAATGAGCAGTTCTTC	CASIGGSVYNEQFF	TRBV6-2	TRBJ2-1
TGTGCCAGCAGCCCAAGGGGGGCAGGACTGGGAAAAAATCAGCCCCAGCATTTT	CASSPRGAGLGKNQPQHF	TRBV5-8	TRBJ1-5
TGTGCCAGCAGCGTCCTCCTAGGAGGATACAATGAGCAGTTCTTC	CASSVLLGGYNEQFF	TRBV3-1	TRBJ2-1
TGCAGTGCTAGAGAAAAGGGCCCGGGACAGGGGGAGACCCAGTACTTC	CSAREKGPGQGETQYF	TRBV20-1	TRBJ2-5
TGTGCCAGCAGCTGGCCGACTTTGTCTACCGGGGAGCTGTTTTTT	CASSWPTLSTGELFF	TRBV11-3	TRBJ2-2
TGTGCCACCAGTGATTTCCAGAGTAATTCACCCCTCCACTTT	CATSDFQSNSPLHF	TRBV24-1	TRBJ1-6
TGTGCCAGCAGCCTTTGTGAGAGGTGGGCTAACTATGGCTACACCTTC	CASSLCERWANYGYTF	TRBV5-4	TRBJ1-2
TGTGCTAGTGGCATGCGGGAGAGTAGCAACACTGAAGCTTTCTTT	CASGMRESSNTEAFF	TRBV12-5	TRBJ1-1
TGTGCCAGCGTAGGGGGCGTGACTTCCTACGAGCAGTACTTC	CASVGGVTSYEQYF	TRBV27	TRBJ2-7
TGTGCCAGCAGTTACCAGCCGGGACTAGCGGGAGTCTCCACTGAAGCTTTCTTT	CASSYQPGLAGVSTEAFF	TRBV6-5	TRBJ1-1
TGCAGCGACGGACAGGGGAGAGAGGAAGAGACCCAGTACTTC	CSDGQGREEETQYF	TRBV29-1	TRBJ2-5
TGTGCCAGCATTACTCATGTGATAGAGTACGAGCAGTACTTC	CASITHVIEYEQYF	TRBV2	TRBJ2-7
TGTGCCAGCAGCTGGGAAGGGGACAATTCACCCCTCCACTTT	CASSWEGDNSPLHF	TRBV13	TRBJ1-6
TGTGCCAGCAGTTTGGCACTGGACAGGGCAGGGAGCGAGCAGTTCTTC	CASSLALDRAGSEQFF	TRBV6-5	TRBJ2-1
TGTGCCAGCAGCCAAGCGGTGGGAATTAATTCACCCCTCCACTTT	CASSQAVGINSPLHF	TRBV14	TRBJ1-6
TGTGCCAGCAGCAGCTTTTACAAACAGGGGAGACTTCGCAATCAGCCCCAGCATTTT	CASSSFYKQGRLRNQPQHF	TRBV13	TRBJ1-5
TGTGCCAGCAGCCAAGTGATGAGACTAGCGGGGAGAGGGGAGCTGTTTTTT	CASSQVMRLAGRGELFF	TRBV3-1	TRBJ2-2
TGTGCCACCAGCAGACCGGGCGGCTCTGGAAACACCATATATTTT	CATSRPGGSGNTIYF	TRBV15	TRBJ1-3
TGCGCCAGCAGCACACAGTATTCCTACGAGCAGTACTTC	CASSTQYSYEQYF	TRBV5-1	TRBJ2-7
TGTGCCAGCAGTAGTAGCCAGGGGGGGGTGAACACTGAAGCTTTCTTT	CASSSSQGGVNTEAFF	TRBV27	TRBJ1-1
TGTGCCAGCAGTTACCCCCCTTCCGCGGGACTGACCGGGGAGCTGTTTTTT	CASSYPPSAGLTGELFF	TRBV6-5	TRBJ2-2
TGTGCCAGCAGCCAAGGGGGAGAGGGCTATGCCACCGGGGAGCTGTTTTTT	CASSQGGEGYATGELFF	TRBV3-1	TRBJ2-2
TGTGCCAGCCCCCGGGACAGGGGGAACACTGAAGCTTTCTTT	CASPRDRGNTEAFF	TRBV2	TRBJ1-1
TGCAGTGCTAGATTTTTGGGACGGGTAAAGACCCAGTACTTC	CSARFLGRVKTQYF	TRBV20-1	TRBJ2-5
TGTGCCAGCTCACCACCGCAAGGACAGGGGGGTGCCTCCAATCAGCCCCAGCATTTT	CASSPPQGQGGASNQPQHF	TRBV18	TRBJ1-5
TGTGCCAGGGACCAGACTTTCATCAATGAGCAGTTCTTC	CARDQTFINEQFF	TRBV6-2	TRBJ2-1
TGTGCCAGCAGTGGCCACAGGGGGCCTAACTATGGCTACACCTTC	CASSGHRGPNYGYTF	TRBV6-1	TRBJ1-2
TGTGCCAGATTCGGACAGGATACAACTAATGAAAAACTGTTTTTT	CARFGQDTTNEKLFF	TRBV11-3	TRBJ1-4
TGTGCCAGCAGCCCTGTGGCTAGCGGCCGGGCTACGCAGTATTTT	CASSPVASGRATQYF	TRBV7-2	TRBJ2-3
TGCGCCAGCAGCCTGGAGCGGGGGGACGAGGGCTACGAGCAGTACTTC	CASSLERGDEGYEQYF	TRBV4-1	TRBJ2-7
TGCGCCAGCAGCTGGGAAACCATAGGGAGCTCCTACAATGAGCAGTTCTTC	CASSWETIGSSYNEQFF	TRBV5-1	TRBJ2-1
TGTGCCAGCAGTGCGCGGGGCGCAAACGAGCAGTACTTC	CASSARGANEQYF	TRBV6-1	TRBJ2-7
TGTGCCAGCAGCTCTGACAGTAGCTACGAGCAGTACTTC	CASSSDSSYEQYF	TRBV7-6	TRBJ2-7
TGCGCCAGCGCCAGGGTCGGCCTGCGAACGAACACTGAAGCTTTCTTT	CASARVGLRTNTEAFF	TRBV5-1	TRBJ1-1
TGTGCCACCGTCCCCTCCCAGGCCCGTAATCAGCCCCAGCATTTT	CATVPSQARNQPQHF	TRBV24-1	TRBJ1-5
TGCGCCAGCAGGTCCGCCCTTAAGATACGAGCGGGAACCACGGAGAGAGATACGCAGTATTTT	CASRSALKIRAGTTERDTQYF	TRBV10-1	TRBJ2-3
TGTGCCAGCAGCTTCCAGGGTGCTAACTATGGCTACACCTTC	CASSFQGANYGYTF	TRBV13	TRBJ1-2
TGTGCCAGCACTCACCCCAGGGGCCATGGAGATACGCAGTATTTT	CASTHPRGHGDTQYF	TRBV6-3	TRBJ2-3
TGTGCCAGCAGCGCCGGGACTAGATGGTCCTACGAGCAGTACTTC	CASSAGTRWSYEQYF	TRBV12-3	TRBJ2-7
TGTGCCAGCAGGACTAGCGGGTACAATGAGCAGTTCTTC	CASRTSGYNEQFF	TRBV6-5	TRBJ2-1
TGTGCCAGCAGCCCCCAGCTAACATCTGAAGCTTTCTTT	CASSPQLTSEAFF	TRBV7-8	TRBJ1-1
TGTGCCAGCAGCGGGGGGGGACCGGCTAATTCACCCCTCCACTTT	CASSGGGPANSPLHF	TRBV13	TRBJ1-6
TGTGCCAGCAGTTACTCGATGCCACTAGCGGGAGCTGAGCAGTACTTC	CASSYSMPLAGAEQYF	TRBV6-6	TRBJ2-7
TGTGCTAGTGGTTCTGCGAGCGGGAGTCAATCCTACAATGAGCAGTTCTTC	CASGSASGSQSYNEQFF	TRBV12-5	TRBJ2-1
TGTGCCAGCAGTTTTACCGGGCACCGCGGACTAGCGGGCATTAATTATGAGCAGTTCTTC	CASSFTGHRGLAGINYEQFF	TRBV27	TRBJ2-1
TGTGCCAGCAGTACCCCAGGGGGCGAGCAGTACTTC	CASSTPGGEQYF	TRBV27	TRBJ2-7
TGTGCCAGCAGTTTATACCGAGGTGGGACAGTGAGAACTAATGAAAAACTGTTTTTT	CASSLYRGGTVRTNEKLFF	TRBV28	TRBJ1-4
TGCAGGCTATATCGACTAGCGGGGGGGCCGTGGGATACGCAGTATTTT	CRLYRLAGGPWDTQYF	TRBV20-1	TRBJ2-3
TGCAGTGGGCGGGAGTTGGAAAAACTGTTTTTT	CSGRELEKLFF	TRBV20-1	TRBJ1-4
TGCGCCAGCAGCTTGGAGGCGCGGACGGATAACACTGAAGCTTTCTTT	CASSLEARTDNTEAFF	TRBV5-1	TRBJ1-1
TGTGCCAGCAGCGTAGTTAGCCCCGGGGGCTACGAGCAGTACTTC	CASSVVSPGGYEQYF	TRBV9	TRBJ2-7
TGTGCCAGCATATATATTCAGGGAGTCTACGAGCAGTACTTC	CASIYIQGVYEQYF	TRBV7-3	TRBJ2-7
TGCAGTGCTCCCGGCTGGGGCGTGTTTATCGGCAGTATGAACACTGAAGCTTTCTTT	CSAPGWGVFIGSMNTEAFF	TRBV20-1	TRBJ1-1
TGTGCCAGCAGCGAACATGAGCAGTTCTTC	CASSEHEQFF	TRBV7-9	TRBJ2-1
TGTGCCACCAGCAGAGATTGGACAGGCTACGAGCAGTACTTC	CATSRDWTGYEQYF	TRBV15	TRBJ2-7
TGTGACGCGGGACAGTCTGGCCCCTACGAGCAGTACTTC	CDAGQSGPYEQYF	TRBV2	TRBJ2-7
TGTGCCAGCAGCTTAGGCTCCAGAGCCTACGAGCAGTACTTC	CASSLGSRAYEQYF	TRBV7-2	TRBJ2-7
TGTGCCAGCAGCCGACCGGGCGGGGGGAACACTGAAGCTTTCTTT	CASSRPGGGNTEAFF	TRBV14	TRBJ1-1
TGTGCCAAACAGTCCTTCTACAATGAGCAGTTCTTC	CAKQSFYNEQFF	TRBV9	TRBJ2-1
TGTGCCAGTGTGACAGGCTGCGCAGATACGCAGTATTTT	CASVTGCADTQYF	TRBV6-2	TRBJ2-3
TGTGCCAGCAGCTATCCAAGGCCAGGCCGGAATTCACCCCTCCACTTT	CASSYPRPGRNSPLHF	TRBV7-9	TRBJ1-6
TGTGCCAGCAGCTCGGAGCAGTACTTC	CASSSEQYF	TRBV11-3	TRBJ2-7
TGTGCCAGCAGTTGGACTAGCGGGTGGCAAGAGACCCAGTACTTC	CASSWTSGWQETQYF	TRBV6-5	TRBJ2-5
TGTGCCAGCAGCGGACAGGAGAATTCACCCCTCCACTTT	CASSGQENSPLHF	TRBV7-3	TRBJ1-6
TGTGCCACCAGTGAGATTTCTAATTCGACAGGGTCGTCCTATAATTCACCCCTCCACTTT	CATSEISNSTGSSYNSPLHF	TRBV24-1	TRBJ1-6
TGCGCCAGCCTAGGCCCCAGGGGTGGGACTAATGAAAAACTGTTTTTT	CASLGPRGGTNEKLFF	TRBV10-2	TRBJ1-4
TGTGCCAGAGCGGGACAGGGGTGTTGGGGTGGGGAGCTGTTTTTT	CARAGQGCWGGELFF	TRBV6-1	TRBJ2-2
TGTGCCAGCACCAAAAGCCTGAAAGGGGATAACTATGGCTACACCTTC	CASTKSLKGDNYGYTF	TRBV7-6	TRBJ1-2
TGTGCCAGCAGCCTCGACAGGGGGCAAAGAACCTACGAGCAGTACTTC	CASSLDRGQRTYEQYF	TRBV13	TRBJ2-7
TGTGCCACCAGCAGAGATCTAGGGGGCAGGTCAGGCTACACCTTC	CATSRDLGGRSGYTF	TRBV15	TRBJ1-2
TGTGCCAGCAGACGCGAAGCTTTCTTT	CASRREAFF	TRBV12-3	TRBJ1-1
TGTGCCAGCACCCCACCGACAGGGGCCTTCCGGGGTGAAGCTTTCTTT	CASTPPTGAFRGEAFF	TRBV6-5	TRBJ1-1
TGTGCCAGTAGCCAACCGGGACAGGGACGGAACACTGAAGCTTTCTTT	CASSQPGQGRNTEAFF	TRBV19	TRBJ1-1
TGCAGTGCTAGATCTAGGCTACGGAGTGTAGGGCTAGCCAAAAACATTCAGTACTTC	CSARSRLRSVGLAKNIQYF	TRBV20-1	TRBJ2-4
TGTGCCAGCAGCCATAATCAGGCATACTCCTATAATTCACCCCTCCACTTT	CASSHNQAYSYNSPLHF	TRBV3-1	TRBJ1-6
TGTGCCAGCAGCTTGTACCGACACAGGGCCCTATGCACAGATACGCAGTATTTT	CASSLYRHRALCTDTQYF	TRBV5-5	TRBJ2-3
TGTGCCAGCAGTGACGAGCAGGGAACCGGAAACACCATATATTTT	CASSDEQGTGNTIYF	TRBV2	TRBJ1-3
TGTGCCAGCAGCGGTGTAACTAGCACAGATACGCAGTATTTT	CASSGVTSTDTQYF	TRBV7-8	TRBJ2-3
TGTGCCAGCGACAGCAGAGGTGGAAACACCATATATTTT	CASDSRGGNTIYF	TRBV9	TRBJ1-3
TGTGCCAGCAGCCTCAAGGGGAGAGCCCTCCACTTT	CASSLKGRALHF	TRBV3-1	TRBJ1-6
TGTGCCAGCAGCTTACAGGAGCAGGCCGACGAGCAGTACTTC	CASSLQEQADEQYF	TRBV7-9	TRBJ2-7
TGCGCCAGCAGTGGGTTCACAGGGGGCGTTTATAGAACTGAAGCTTTCTTT	CASSGFTGGVYRTEAFF	TRBV10-1	TRBJ1-1
TGCGCCAGCAGCCTGCGATGGGGTCACGTCGAGACCCAGTACTTC	CASSLRWGHVETQYF	TRBV5-1	TRBJ2-5
TGCGCCAGCAGTGAGGGGACAGGGGGCACCACAGATACGCAGTATTTT	CASSEGTGGTTDTQYF	TRBV10-1	TRBJ2-3
TGTGCCAGCAGCTGCGAGCGAAGCACTGAAGCTTTCTTT	CASSCERSTEAFF	TRBV9	TRBJ1-1
TGCGCCAGCAGCCAAGCCCATTACAGCGGGAACCGTTCCTACGAGCAGTACTTC	CASSQAHYSGNRSYEQYF	TRBV4-1	TRBJ2-7
TGTGCCTGGAGTGGTCCTAGTAGGGGTGTAAATGAGCAGTTCTTC	CAWSGPSRGVNEQFF	TRBV30	TRBJ2-1
TGCAGTGCAATTCCCCTACTCTTAAACACCGGGGAGCTGTTTTTT	CSAIPLLLNTGELFF	TRBV20-1	TRBJ2-2
TGCAGTGCTTACGGACAGGGTCAAACTAACTATGGCTACACCTTC	CSAYGQGQTNYGYTF	TRBV20-1	TRBJ1-2
TGCAGTGCTAAGGGTCCTAAAGTGCAAAGGGATAGCAATCAGCCCCAGCATTTT	CSAKGPKVQRDSNQPQHF	TRBV20-1	TRBJ1-5
TGTGCCAGCAGTATGGTGGCATGGACAGTATGGACTTTTGAAAGGAAGGGGGACAATCAGCCCCAGCATTTT	CASSMVAWTVWTFERKGDNQPQHF	TRBV6-4	TRBJ1-5
TGTGCCAGCAGCAGGACGGGACTAGCTGGAAGACATGAGCAGTTCTTC	CASSRTGLAGRHEQFF	TRBV13	TRBJ2-1
TGCAGCGAAAAGGGGCCGTCCGGGAACACTGAAGCTTTCTTT	CSEKGPSGNTEAFF	TRBV29-1	TRBJ1-1
TGTGCCAGCAGTTTATCTTGGAATGGGGCCTCTGGAAACACCATATATTTT	CASSLSWNGASGNTIYF	TRBV28	TRBJ1-3
TGTGCCAGCAGCGGAAACAGGGCCGACTATGGCTACACCTTC	CASSGNRADYGYTF	TRBV7-3	TRBJ1-2
TGTGCCAGCAGGCCATCAGGGGGAGAAGCTTTCTTT	CASRPSGGEAFF	TRBV6-5	TRBJ1-1
TGCGCCAGCAGCCAGGCAGGGACAGACGTCAATCAGCCCCAGCATTTT	CASSQAGTDVNQPQHF	TRBV4-1	TRBJ1-5
TGCAGTGCTAGAGATAGAGGGAGGGGAGGGGACACTGAAGCTTTCTTT	CSARDRGRGGDTEAFF	TRBV20-1	TRBJ1-1
TGTGCCAGCGCAATTGTCCGACAGGGGGCCAACGTCCTGACTTTC	CASAIVRQGANVLTF	TRBV5-6	TRBJ2-6
TGTGCCAGCAGCTGTCTCCCCCGGGACAGGGCCTGGGACTACGAGCAGTACTTC	CASSCLPRDRAWDYEQYF	TRBV5-4	TRBJ2-7
TGTGCGATGGCAGGGACAGGGGGGAGCTCCTACAATGAGCAGTTCTTC	CAMAGTGGSSYNEQFF	TRBV6-2	TRBJ2-1
TGTGCCAGCAGTTACTCGACCACGGGACAGTACGAGCAGTACTTC	CASSYSTTGQYEQYF	TRBV6-5	TRBJ2-7
TGCAGTGCTAGAGACGCGGGGGGGTATTGCACCTACGAGCAGTACTTC	CSARDAGGYCTYEQYF	TRBV20-1	TRBJ2-7
TGTGCCAGCAGCCAGTTGGTTTCGGGACAGGAGGGAAACACCATATATTTT	CASSQLVSGQEGNTIYF	TRBV4-2	TRBJ1-3
TGCGCCAGCAGTGTCCCAGGTGACGAGCAGTACTTC	CASSVPGDEQYF	TRBV10-1	TRBJ2-7
TGTGCCAGCAGCCTCGGGGGAAACACCGGGGAGCTGTTTTTT	CASSLGGNTGELFF	TRBV9	TRBJ2-2
TGTGCCAGCTCACCACGCGTGGGTGGGAATCAGCCCCAGCATTTT	CASSPRVGGNQPQHF	TRBV18	TRBJ1-5
TGTGCCAGCAGTGTAGGGGAACAGGATCCATGGACTGAAAAACTGTTTTTT	CASSVGEQDPWTEKLFF	TRBV6-4	TRBJ1-4
TGTGCCAGTAGTATCGGGTATAACAATGAGCAGTTCTTC	CASSIGYNNEQFF	TRBV19	TRBJ2-1
TGCAGTGCTAGAGATCTGTACAGGGGGGCTGTTTACTTC	CSARDLYRGAVYF	TRBV20-1	TRBJ2-5
TGTGCCAGCAGTCCAACGGGGGACTACGAGCAGTACTTC	CASSPTGDYEQYF	TRBV27	TRBJ2-7
TGTGAGGGGGACGCAGATACGCAGTATTTT	CEGDADTQYF	TRBV6-5	TRBJ2-3
TGTGCCAGCAGCAACCCCTCTAAATCTCACAGGGGGGGGAACGGCACTGGAAACACCATATATTTT	CASSNPSKSHRGGNGTGNTIYF	TRBV13	TRBJ1-3
TGTGCCAGCAGCTTGCTAGGGACAGGGGAGGAAGCTTTCTTT	CASSLLGTGEEAFF	TRBV5-4	TRBJ1-1
TGCAGTGCTAGTCCTATTACAGGGGGCTCAAGCTCCTACGAGCAGTACTTC	CSASPITGGSSSYEQYF	TRBV20-1	TRBJ2-7
TGTGCCAGCAGCCGGAGGCTGGCCTCCTACGAGCAGTACTTC	CASSRRLASYEQYF	TRBV3-1	TRBJ2-7
TGTGCCAGAACTGAAAAACTGTTTTTT	CARTEKLFF	TRBV12-3	TRBJ1-4
TGTGCCAGCAGCTCCTCGCCCACAGGGCATCAGCCCCAGCATTTT	CASSSSPTGHQPQHF	TRBV7-9	TRBJ1-5
TGTGCCAGCAAAGGGACAGCTGAAAAACTGTTTTTT	CASKGTAEKLFF	TRBV11-3	TRBJ1-4
TGTGCCAGCAGGGCCTGGGAGGCGTCTAGCACAGATACGCAGTATTTT	CASRAWEASSTDTQYF	TRBV12-3	TRBJ2-3
TGTGCCACCGAGGAACGCAATCAGCCCCAGCATTTT	CATEERNQPQHF	TRBV24-1	TRBJ1-5
TGTGCCAGCAGTAGCGGATCTAGCGGGGGGGCCCGGTCCTACAATGAGCAGTTCTTC	CASSSGSSGGARSYNEQFF	TRBV28	TRBJ2-1
TGCGCCAGCAGCCTAGAGACGGGGACGATGCTAGCGAGCAATGAGCAGTTCTTC	CASSLETGTMLASNEQFF	TRBV5-1	TRBJ2-1
TGTGCCACCAAATCTAAACGGACAGGGGTTGAGACCCAGTACTTC	CATKSKRTGVETQYF	TRBV24-1	TRBJ2-5
TGTGCCAGCAGCTTTTTAGTCGGGGTGAGCTACGAGCAGTACTTC	CASSFLVGVSYEQYF	TRBV5-4	TRBJ2-7
TGCGCCAGCAGCCAAGATCCGAATCGGAACACTGAAGCTTTCTTT	CASSQDPNRNTEAFF	TRBV4-1	TRBJ1-1
TGTGCCAGCAGTTCCCCGTCGTCTCATGAGCAGTTCTTC	CASSSPSSHEQFF	TRBV27	TRBJ2-1
TGTGCCAGCAGTGTTCGACAGGATCAGCCCCAGCATTTT	CASSVRQDQPQHF	TRBV14	TRBJ1-5
TGTGCCAGTAGTATGGGTTCAGGGGCCATGAACACTGAAGCTTTCTTT	CASSMGSGAMNTEAFF	TRBV19	TRBJ1-1
TGTGCCAGCCCGCGTAAGGGCCAGCCGGCGCTGAACACTGAAGCTTTCTTT	CASPRKGQPALNTEAFF	TRBV7-2	TRBJ1-1
TGTGCCAGCAGTAACGTAGGTCAGGGACAGGGGGCCAGCTCTGGAAACACCATATATTTT	CASSNVGQGQGASSGNTIYF	TRBV6-4	TRBJ1-3
TGTGCCAGCAGCGGGAACCTAGCGGGGTTATGGAGCTACGAGCAGTACTTC	CASSGNLAGLWSYEQYF	TRBV14	TRBJ2-7
TGTGCCAGCAGTCGTCGGGGCGGGAATCAGCCCCAGCATTTT	CASSRRGGNQPQHF	TRBV6-5	TRBJ1-5
TGTGCCAGCATCAGGGGGCTGAACACTGAAGCTTTCTTT	CASIRGLNTEAFF	TRBV7-2	TRBJ1-1
TGTGCCAGCAGCCGGGTAGGGGGGGCCAAAGGCGGGGAGCTGTTTTTT	CASSRVGGAKGGELFF	TRBV7-3	TRBJ2-2
TGTGCCAGCAGAAAATCCCGGGACCTGCAAGAGACCCAGTACTTC	CASRKSRDLQETQYF	TRBV7-2	TRBJ2-5
TGTGCCAGCAATGCGAAGGGGGTCACTGAAGCTTTCTTT	CASNAKGVTEAFF	TRBV27	TRBJ1-1
TGTGCCAGCAGCCTGGTTTGTCCCCGGCACCAACGGGACAGTTATTCATGGAGCACAGATACGCAGTATTTT	CASSLVCPRHQRDSYSWSTDTQYF	TRBV7-4	TRBJ2-3
TGCAGCGGAGGAGGGACATGTGGAAACACCATATATTTT	CSGGGTCGNTIYF	TRBV29-1	TRBJ1-3
TGTGCCAGCTCACCGCAGACAGTAAGCAATCAGCCCCAGCATTTT	CASSPQTVSNQPQHF	TRBV18	TRBJ1-5
TGTGCCACCAGGGGGGGTTCCTACAATGAGCAGTTCTTC	CATRGGSYNEQFF	TRBV15	TRBJ2-1
TGCAGTGCCCGGAAGGGGGGATTAGAAGCTTTCTTT	CSARKGGLEAFF	TRBV20-1	TRBJ1-1
TGTGCCAGCAGCCAAGTCCGACTCGATCAGCCCCAGCATTTT	CASSQVRLDQPQHF	TRBV14	TRBJ1-5
TGTGCCAGCTCACCAACGGGGAGCGACACCATATATTTT	CASSPTGSDTIYF	TRBV18	TRBJ1-3
TGCAGCGTTACAGCGGGAGGGACAGGGGGAACCTACGAGCAGTACTTC	CSVTAGGTGGTYEQYF	TRBV29-1	TRBJ2-7
TGTGCCAGCAGCCAAGATCCCAGGGGAGGGTACACTGAAGCTTTCTTT	CASSQDPRGGYTEAFF	TRBV3-1	TRBJ1-1
TGCGCCAGCAGCTCGGACGTTGTGCAAGAGACCCAGTACTTC	CASSSDVVQETQYF	TRBV4-1	TRBJ2-5
TGTGCCAGCAGCTTAAGAGATGGGTATAAACGGAGGGACAGGGGGCGCGGGTTGGCCTACGAGCAGTACTTC	CASSLRDGYKRRDRGRGLAYEQYF	TRBV7-3	TRBJ2-7
TGTGCCAGCAGCTACGACAGGATAAATCAGCCCCAGCATTTT	CASSYDRINQPQHF	TRBV5-5	TRBJ1-5
TGCGCCTCCTCAGGGGGCAGCTCTAACACCGGGGAGCTGTTTTTT	CASSGGSSNTGELFF	TRBV10-1	TRBJ2-2
TGTGCCAGCAGCTTAGGAACCCAAAATACAGGGGGCCGTACGCAGTATTTT	CASSLGTQNTGGRTQYF	TRBV7-2	TRBJ2-3
TGTGCCACCAGTGAATCGACCCCGACAGGCCTGGGTAGGTCACGCGAGCAGTACTTC	CATSESTPTGLGRSREQYF	TRBV24-1	TRBJ2-7
TGTGCCAGCAGTTTAGCGGCCCCCGGAAAAGATACGCAGTATTTT	CASSLAAPGKDTQYF	TRBV28	TRBJ2-3
TGTGCCAGCAGCCAAGATCCAACCGGGACATCCCGCTACGAGCAGTACTTC	CASSQDPTGTSRYEQYF	TRBV14	TRBJ2-7
TGTGCCAGCAGTTACGGCAGATGGGCCGGTTACGAGCAGTACTTC	CASSYGRWAGYEQYF	TRBV6-2	TRBJ2-7
TGTGCCAGCAGTGAGGAGCCGGGACAGACTAATGAAAAACTGTTTTTT	CASSEEPGQTNEKLFF	TRBV2	TRBJ1-4
TGTGCCAGCAGCACCGGGACAGGGTCTAACACTGAAGCTTTCTTT	CASSTGTGSNTEAFF	TRBV13	TRBJ1-1
TGTGCCAGTAGAACCAACTTTAGTCTCAATCAGCCCCAGCATTTT	CASRTNFSLNQPQHF	TRBV19	TRBJ1-5
TGTGCCAGCAGAAGACAGTATCCCTACGAGCAGTACTTC	CASRRQYPYEQYF	TRBV27	TRBJ2-7
TGTGCCACCGTAGCGTTTAGCAATCAGCCCCAGCATTTT	CATVAFSNQPQHF	TRBV24-1	TRBJ1-5
TGTGCCACCAGTGCTGGGGGACTAGCGGGGGGGCCCAGTCCCTCCTACAATGAGCAGTTCTTC	CATSAGGLAGGPSPSYNEQFF	TRBV24-1	TRBJ2-1
TGTGCCAGCAGCACGAAAGGTTACTATGGCTACACCTTC	CASSTKGYYGYTF	TRBV7-9	TRBJ1-2
TGCGCCAGCAGTGAAGGAGACCCGGGACTAGCGGAGCGGGTCAGCCTTCCCTACGAGCAGTACTTC	CASSEGDPGLAERVSLPYEQYF	TRBV10-2	TRBJ2-7
TGCGCCAGCCGACAACGTTACAATGAGCAGTTCTTC	CASRQRYNEQFF	TRBV10-1	TRBJ2-1
TGTGCCAGCAGTGAACTGGGCAAATACAATGAGCAGTTCTTC	CASSELGKYNEQFF	TRBV6-4	TRBJ2-1
TGTGCCAGCAGTTTAGGCCCTAGTCGGGGAGACCGCAACTCCTACGAGCAGTACTTC	CASSLGPSRGDRNSYEQYF	TRBV27	TRBJ2-7
TGTGCCACACCGGTGGGAAATGAGCAGTTCTTC	CATPVGNEQFF	TRBV7-9	TRBJ2-1
TGCGCCAGCAGCCGTACGTCGGACACAGATACGCAGTATTTT	CASSRTSDTDTQYF	TRBV10-1	TRBJ2-3
TGCGCCAGCAGCTTGGCCTGCACCGTTCACAGGGCAAGAACTAACTATGGCTACACCTTC	CASSLACTVHRARTNYGYTF	TRBV5-1	TRBJ1-2
TGTGCCTGGAGTGGGCTCCGGGACAGTCTCGACACCATATATTTT	CAWSGLRDSLDTIYF	TRBV30	TRBJ1-3
TGTGCCAGCAGCCGGAAGCGGGAGGAGACTGAAGCTTTCTTT	CASSRKREETEAFF	TRBV13	TRBJ1-1
TGTGCCAGCAGCCCTCTTTCAGGGAGCAATCAGCCCCAGCATTTT	CASSPLSGSNQPQHF	TRBV7-7	TRBJ1-5
TGTGCCAGCAGCTTAGCACGACAGGGGGCTGAATACTTC	CASSLARQGAEYF	TRBV11-2	TRBJ1-2
TGCAGTGCTAGACTTAAAGGGGGACACTCCCCAAATAGCAATCAGCCCCAGCATTTT	CSARLKGGHSPNSNQPQHF	TRBV20-1	TRBJ1-5
TGTGCCAGCAGCCTGGCAGGGGGTCACGTAGAGACCCAGTACTTC	CASSLAGGHVETQYF	TRBV14	TRBJ2-5
TGTGCCAGCAGCTTAGCATTGAGGCCCCACACCGGGGAGCTGTTTTTT	CASSLALRPHTGELFF	TRBV7-4	TRBJ2-2
TGCGCCAGCAGCTCCAGGGGTGGGCGACGGGGGAGAGTTGAGACCCAGTACTTC	CASSSRGGRRGRVETQYF	TRBV5-1	TRBJ2-5
TGTGCCAGCCACATTAGCGGGATTAGTGAGACCCAGTACTTC	CASHISGISETQYF	TRBV6-5	TRBJ2-5
TGTGCCAGCAGCATCAGGAATGTTGATACGCAGTATTTT	CASSIRNVDTQYF	TRBV6-5	TRBJ2-3
TGTGCCAGCAGCCTGACTAATGAAAAACTGTTTTTT	CASSLTNEKLFF	TRBV6-4	TRBJ1-4
TGTGCCAGCAGCGATGGAGCCCGGGACCAAGAGACCCAGTACTTC	CASSDGARDQETQYF	TRBV11-3	TRBJ2-5
TGTGCCAGCAGTTGCAGCGGCACAGATACGCAGTATTTT	CASSCSGTDTQYF	TRBV6-5	TRBJ2-3
TGTGCCAGCAGCTTGTGCGGGGGTAAAACGACTAGCACAGATACGCAGTATTTT	CASSLCGGKTTSTDTQYF	TRBV5-6	TRBJ2-3
TGTGCCAGCAGCAATCCACGGACAGGGCCTCTTGCTGGAAACACCATATATTTT	CASSNPRTGPLAGNTIYF	TRBV7-6	TRBJ1-3
TGCAGTGCTATTCGATCCGGGCACACCGGGGAGCTGTTTTTT	CSAIRSGHTGELFF	TRBV20-1	TRBJ2-2
TGTGCCAGCAGCCCGCCTGGATGGTACCAGGGGGGATTCGATACGCAGTATTTT	CASSPPGWYQGGFDTQYF	TRBV27	TRBJ2-3
TGCAGCGTTGCCAGGGACAGCAAGGAGTACGAGCAGTACTTC	CSVARDSKEYEQYF	TRBV29-1	TRBJ2-7
TGCAGTGCTAGGTTACCCCCTTCAGGGATAGCTTTCTTT	CSARLPPSGIAFF	TRBV20-1	TRBJ1-1
TGTGCCAGCAGCGCTAGCGTGGTCACGGACACTTTCGAAAAACTGTTTTTT	CASSASVVTDTFEKLFF	TRBV5-5	TRBJ1-4
TGCAGTGCTAGAGAAACCCGGAACACTGAAGCTTTCTTT	CSARETRNTEAFF	TRBV20-1	TRBJ1-1
TGCGCCAGCAACCAATACGTTCAAGAGCATCAGCCCCAGCATTTT	CASNQYVQEHQPQHF	TRBV5-1	TRBJ1-5
TGTGCCAGCAGCCAAGATACCGGGACCTTGGGCACAGATACGCAGTATTTT	CASSQDTGTLGTDTQYF	TRBV14	TRBJ2-3
TGTGCCAGCAGTTACCCCAATTCCCGGGGGAATCAGCCCCAGCATTTT	CASSYPNSRGNQPQHF	TRBV6-5	TRBJ1-5
TGTGCCAGCTCAACGGACAGGGACTCTGGAAACACCATATATTTT	CASSTDRDSGNTIYF	TRBV18	TRBJ1-3
TGCAGTGCATTGGGGGCGGGTCCTTTAGTCTATAATTCACCCCTCCACTTT	CSALGAGPLVYNSPLHF	TRBV20-1	TRBJ1-6
TGTGCCAGCAGTCGGTACAAAAAACTGTTTTTT	CASSRYKKLFF	TRBV27	TRBJ1-4
TGTGCCAGCAGTGTATGGACAGTGTACACCGGGGAGCTGTTTTTT	CASSVWTVYTGELFF	TRBV2	TRBJ2-2
TGTGCCAGCAGCAACCGCGGGAGGTCACACGGCTACAATGAGCAGTTCTTC	CASSNRGRSHGYNEQFF	TRBV7-9	TRBJ2-1
TGTGCCAGCAGCCAAGAATTCGACAGGGGATTTGAAAAACTGTTTTTT	CASSQEFDRGFEKLFF	TRBV3-1	TRBJ1-4
TGTGCCAGCAGTTCTGACCGTATTAGCTGGATGAACACTGAAGCTTTCTTT	CASSSDRISWMNTEAFF	TRBV2	TRBJ1-1
TGTGCCAGCATGAAGGGCCGTAATGAGCAGTTCTTC	CASMKGRNEQFF	TRBV6-2	TRBJ2-1
TGTGCCAGCAGCCGTTGTCAGCCGCCTCAGCCCCAGCATTTT	CASSRCQPPQPQHF	TRBV11-3	TRBJ1-5
TGTGCCAGCAGCTCGTCTCCTGGACGGCGGCCCCAGCATTTT	CASSSSPGRRPQHF	TRBV3-1	TRBJ1-5
TGTGCCAGCAGAAGGCCAAAGCCCCAGCATTTT	CASRRPKPQHF	TRBV27	TRBJ1-5
TGTGCCAGCAGTGTTGGGGGCAGACAGACGCAGTATTTT	CASSVGGRQTQYF	TRBV27	TRBJ2-3
TGTGCCAGCGCGTGCCTCGGCCGTGGGAGCGGGGAGCTGTTTTTT	CASACLGRGSGELFF	TRBV2	TRBJ2-2
TGTGCCACCCGCCGAGAGCTCACCGGGGAGCTGTTTTTT	CATRRELTGELFF	TRBV7-9	TRBJ2-2
TGTGCCAGCAGTGACCAAGGATCGAACACCGGGGAGCTGTTTTTT	CASSDQGSNTGELFF	TRBV12-3	TRBJ2-2
TGTGCCAGCAGCTGGGCGTACGAGCAGTACTTC	CASSWAYEQYF	TRBV11-2	TRBJ2-7
TGCAGTGCTGTAGCGGGAGACCTGGCGTACGAGCAGTACTTC	CSAVAGDLAYEQYF	TRBV20-1	TRBJ2-7
TGTGCCAGCACAGGTCCGGGAGAAAACCGCCCGTTTCCCCTTGAGTACCCGAACACCGGGGAGCTGTTTTTT	CASTGPGENRPFPLEYPNTGELFF	TRBV6-5	TRBJ2-2
TGCGCCAGCAGCTTGCTGTCAGGGGGGGGGAACACTGAAGCTTTCTTT	CASSLLSGGGNTEAFF	TRBV5-1	TRBJ1-1
TGTGCCAGCAGCAGAAATGGCGGGTCGACTGAAGCTTTCTTT	CASSRNGGSTEAFF	TRBV7-3	TRBJ1-1
TGCGCCAGCAGCTGGGGTCAGCCCCAGCATTTT	CASSWGQPQHF	TRBV5-1	TRBJ1-5
TGTGCCAGCAGTTCCCGACAGGGACTTCCCGCCGACTCTGGAAACACCATATATTTT	CASSSRQGLPADSGNTIYF	TRBV6-3	TRBJ1-3
TGTGCCAGCAGGAGCGGGAGCGCCTACGAGCAGTACTTC	CASRSGSAYEQYF	TRBV6-1	TRBJ2-7
TGTGCCAGCAGCAGGGTAGTGAACACTGAAGCTTTCTTT	CASSRVVNTEAFF	TRBV13	TRBJ1-1
TGTGCCAGTAGTATTATAGTCGACAGGTGTAACTATGGCTACACCTTC	CASSIIVDRCNYGYTF	TRBV19	TRBJ1-2
TGCAGCGTTGTGGGAGCACGGCATGAAAAACTGTTTTTT	CSVVGARHEKLFF	TRBV29-1	TRBJ1-4
TGTGCCAGCAGCCAGGGGCGGACCAACACCGGGGAGCTGTTTTTT	CASSQGRTNTGELFF	TRBV5-6	TRBJ2-2
TGTGCCAGCAGCCAACCCCGGTGCTATAATTCACCCCTCCACTTT	CASSQPRCYNSPLHF	TRBV14	TRBJ1-6
TGTGCCACCAGTGATTTGCACGACGGGACGGGGATCCCGCCTAACTATGGCTACACCTTC	CATSDLHDGTGIPPNYGYTF	TRBV24-1	TRBJ1-2
TGTGCCAGCAGCGGGACAGGGCCAAATAACTACGAGCAGTACTTC	CASSGTGPNNYEQYF	TRBV7-2	TRBJ2-7
TGTGCCAGCATTTCGGGAGGGTTAGTTCCCTACAATGAGCAGTTCTTC	CASISGGLVPYNEQFF	TRBV27	TRBJ2-1
TGTGCCAGCAGTTTCCTAGCGGAAGAGACCCAGTACTTC	CASSFLAEETQYF	TRBV6-6	TRBJ2-5
TGCGCCAGCAGCTTCTCAGGGAAGGAGAACACTGAAGCTTTCTTT	CASSFSGKENTEAFF	TRBV5-1	TRBJ1-1
TGTGCCAGCAGTGAAGCCAACGGGACACAAGAGACCCAGTACTTC	CASSEANGTQETQYF	TRBV6-1	TRBJ2-5
TGCAGTGCTAGGGGAGAGGGGAAGACCCAGTACTTC	CSARGEGKTQYF	TRBV20-1	TRBJ2-5
TGTGCCAGTAGCAGGGGGATTAGCTTC	CASSRGISF	TRBV19	TRBJ2-7
TGCGCCAGCAGTCCGCAGGGCGAGCAGTACTTC	CASSPQGEQYF	TRBV10-2	TRBJ2-7
TGTGCCAGCAGCGGGGGGGGGGATACGCAGTATTTT	CASSGGGDTQYF	TRBV7-3	TRBJ2-3
TGTGCCAGCACAACACAGGACAGGGGGCCACAGCCCCAGCATTTT	CASTTQDRGPQPQHF	TRBV6-2	TRBJ1-5
TGTGCCAGCAGCAAAGGGGAGTCGAACGAGACCCAGTACTTC	CASSKGESNETQYF	TRBV7-2	TRBJ2-5
TGCAGCGTTGAAGGTAGGGACGGGGGCGGGAGGTCCGAGGATACGCAGTATTTT	CSVEGRDGGGRSEDTQYF	TRBV29-1	TRBJ2-3
TGCAGTGCTAATAGGACTAGCGGGCAAGAGACCCAGTACTTC	CSANRTSGQETQYF	TRBV20-1	TRBJ2-5
TGTGCCACCAGTGAGACAGGGCTTGATCAGCCCCAGCATTTT	CATSETGLDQPQHF	TRBV24-1	TRBJ1-5
TGTGCCAGCAGTTTACGGGACAGGGGGAACACCGGGGAGCTGTTTTTT	CASSLRDRGNTGELFF	TRBV28	TRBJ2-2
TGTGCCAGGACTAGCGCGGCAGATACGCAGTATTTT	CARTSAADTQYF	TRBV30	TRBJ2-3
TGTGCCAGCAGTAGGTTGATTAATGAAAAACTGTTTTTT	CASSRLINEKLFF	TRBV14	TRBJ1-4
TGCAGTGCCCCTACAGTGTACTTATGTCCCCAGTACTTC	CSAPTVYLCPQYF	TRBV20-1	TRBJ2-5
TGTGCCAGTAGTCCGGGACAGGGCCCGACATCACCCCTCCACTTT	CASSPGQGPTSPLHF	TRBV19	TRBJ1-6
TGTGCCAGCAGCGTTCAGCAGACTAGCGAGCCAAGCACAGATACGCAGTATTTT	CASSVQQTSEPSTDTQYF	TRBV9	TRBJ2-3
TGTGCCAGCAAACGGGACAGTCACCCCCCTACCGAGACCCAGTACTTC	CASKRDSHPPTETQYF	TRBV6-4	TRBJ2-5
TGCAGTGCTAGAGCCCCGAGGACTCGCACAGATACGCAGTATTTT	CSARAPRTRTDTQYF	TRBV20-1	TRBJ2-3
TGTGCCAGCAGTTTTCCTTGGGGTCCTAATGAAAAACTGTTTTTT	CASSFPWGPNEKLFF	TRBV28	TRBJ1-4
TGTGCCGGTAGAATTTCCGGACAGGGTACAACTAATGAAAAACTGTTTTTT	CAGRISGQGTTNEKLFF	TRBV10-3	TRBJ1-4
TGTGGGTACCTCCCACAGTACACCTTC	CGYLPQYTF	TRBV28	TRBJ1-2
TGTGCCAGCAGCGGGGCCCACACCGGGGAGCTGTTTTTT	CASSGAHTGELFF	TRBV27	TRBJ2-2
TGTGCCACGGCCGGGACAGACGAGCAGTACTTC	CATAGTDEQYF	TRBV11-1	TRBJ2-7
TGTGCCAGCGGGGGGCAGGGTGGCTACACCTTC	CASGGQGGYTF	TRBV9	TRBJ1-2
TGCAGCGTTGAAGATGACCCAATAGCGGGGGGCTCCTACGAGCAGTACTTC	CSVEDDPIAGGSYEQYF	TRBV29-1	TRBJ2-7
TGCAGTGCTAGCCTTACAGGCCCGAGTAATGAAAAACTGTTTTTT	CSASLTGPSNEKLFF	TRBV20-1	TRBJ1-4
TGTGCCAGCAGCTTGAGTGGCACCCAGTACTTC	CASSLSGTQYF	TRBV5-8	TRBJ2-5
TGTGCCAGCAGCAAGGGGAACACTGAAGCTTTCTTT	CASSKGNTEAFF	TRBV7-9	TRBJ1-1
TGTGCCAGCAGCCTTCGCTATGACACTGAAGCTTTCTTT	CASSLRYDTEAFF	TRBV14	TRBJ1-1
TGCGCCAGCAGTCGGAGGGGGTCAGATACGCAGTATTTT	CASSRRGSDTQYF	TRBV10-2	TRBJ2-3
TGTGCCACACGGCCCCTAGCGGGGGGAGATGAGCAGTTCTTC	CATRPLAGGDEQFF	TRBV6-2	TRBJ2-1
TGTGCCAGCAGTAAATATAGCCGTGTGCGGGGCAACACTGAAGCTTTCTTT	CASSKYSRVRGNTEAFF	TRBV6-1	TRBJ1-1
TGCAGCGGTGCTCCCGGCGAGATGAACACTGAAGCTTTCTTT	CSGAPGEMNTEAFF	TRBV29-1	TRBJ1-1
TGTGCCAGTAGTATAGATGCAAGTTCGACAGCCGGGGAGCTGTTTTTT	CASSIDASSTAGELFF	TRBV19	TRBJ2-2
TGTGCCAGCAGCAGGGGACAGGGGGAAAAACTGTTTTTT	CASSRGQGEKLFF	TRBV7-9	TRBJ1-4
TGTGCCACCAGTGCCCCACCCTCAGGATCCTACGAGCAGTACTTC	CATSAPPSGSYEQYF	TRBV24-1	TRBJ2-7
TGTGCCAGCAGTGAAGCGTCGACTAGCGGGACGCCCCAGTACTTC	CASSEASTSGTPQYF	TRBV6-1	TRBJ2-5
TGTGCCAGCAGCAAGACACTAAGCTCCTATAATTCACCCCTCCACTTT	CASSKTLSSYNSPLHF	TRBV12-3	TRBJ1-6
TGTGCCAGCAGCCCCATCGAGTCTAATGGCTACACCTTC	CASSPIESNGYTF	TRBV2	TRBJ1-2
TGCGCCAGCAGCTTGCCCCCTTCAGACAGGTGGGGCTATGGCTACACCTTC	CASSLPPSDRWGYGYTF	TRBV5-1	TRBJ1-2
TGTGAAGCGGCGGGAGGAACGCAGTATTTT	CEAAGGTQYF	TRBV9	TRBJ2-3
TGTGCCAAGGGGGGGAGGTGTAGCACAGATACGCAGTATTTT	CAKGGRCSTDTQYF	TRBV5-4	TRBJ2-3
TGTGCCAGCAGCAATAGAGGGCGGGGGCAAGAGACCCAGTACTTC	CASSNRGRGQETQYF	TRBV7-3	TRBJ2-5
TGTGCCAGCAGAGTCTGGGGCAGTGGAAACACCATATATTTT	CASRVWGSGNTIYF	TRBV3-1	TRBJ1-3
TGTGCCAGCAGTCACGACAGAGATGGCTACACCTTC	CASSHDRDGYTF	TRBV6-3	TRBJ1-2
TGTGCCAGCAGTCTCCGACAGGGCCCTGCCGAGCAGTACTTC	CASSLRQGPAEQYF	TRBV6-1	TRBJ2-7
TGCGCCAGCAATCTTACCCGTGACAGGGCTAATGAGCAGTTCTTC	CASNLTRDRANEQFF	TRBV5-1	TRBJ2-1
TGTGCCAGCAGCGTCTTGTACAGGGCCTTCGATACGCAGTATTTT	CASSVLYRAFDTQYF	TRBV13	TRBJ2-3
TGTGCCAGCAGCCATTGTACTAGCTTCCGGGAGACCCAGTACTTC	CASSHCTSFRETQYF	TRBV11-2	TRBJ2-5
TGCGCCAGCAGCTCGAGAGGGGAGTTCGGCCGCACTGAAGCTTTCTTT	CASSSRGEFGRTEAFF	TRBV5-1	TRBJ1-1
TGCGCCCCGGGACTAGCGGGGGGGTACGAGCAGTACTTC	CAPGLAGGYEQYF	TRBV10-1	TRBJ2-7
TGTGCCAGCAGCCACCCAATGTATGTCAGCGACTCTGGCTACGAGCAGTACTTC	CASSHPMYVSDSGYEQYF	TRBV14	TRBJ2-7
TGTGCCACCCGACCTGGGACGTTCGGGAACACTGAAGCTTTCTTT	CATRPGTFGNTEAFF	TRBV24-1	TRBJ1-1
TGTGCCAGCAGCGTCGATACTGGGCAAGAGACCCAGTACTTC	CASSVDTGQETQYF	TRBV7-6	TRBJ2-5
TGTGCCAGTAGGTCCAGGGGACCTGAAGCTTTCTTT	CASRSRGPEAFF	TRBV19	TRBJ1-1
TGTGCCAGCAGCGAATCAAGGACGGCTGAACAAATTGGCTACACCTTC	CASSESRTAEQIGYTF	TRBV13	TRBJ1-2
TGTGCCAGCAGTTACTCGTGCGTTTGGGAGACCCAGTACTTC	CASSYSCVWETQYF	TRBV6-6	TRBJ2-5
TGTGCCAGCAGCTCAAAGCGGGATCTTTTCTACGAGCAGTACTTC	CASSSKRDLFYEQYF	TRBV5-6	TRBJ2-7
TGTGCCAGCAGTTCGACAGCCTTGGTTCAAGAGACCCAGTACTTC	CASSSTALVQETQYF	TRBV6-4	TRBJ2-5
TGTGCCAGCATTAAGGGGTCCACTAGCTCCTACAATGAGCAGTTCTTC	CASIKGSTSSYNEQFF	TRBV6-8	TRBJ2-1
TGTGCCAGCAGCCGATATCCTAACTCGCCCGGGACTAGAAGTAATAACAATGAGCAGTTCTTC	CASSRYPNSPGTRSNNNEQFF	TRBV7-4	TRBJ2-1
TGTGCCAGGGGGGGAGTGTTGCAAGAGACCCAGTACTTC	CARGGVLQETQYF	TRBV9	TRBJ2-5
TGCGCCAGCAGCCAACTGAACAGTAGCATGAACACTGAAGCTTTCTTT	CASSQLNSSMNTEAFF	TRBV4-3	TRBJ1-1
TGTGCCAGCAGTTACTCGAAGCGACAGGGTACTTGGGTCAACGAGCAGTACTTC	CASSYSKRQGTWVNEQYF	TRBV6-5	TRBJ2-7
TGTGCCAGCAGCTTGCGAACCCCCGGCACCGGGGAGCTGTTTTTT	CASSLRTPGTGELFF	TRBV5-5	TRBJ2-2
TGTGCCAGCACCGGGGCGGAGGGGCCCAGGGACATTCAGTACTTC	CASTGAEGPRDIQYF	TRBV2	TRBJ2-4
TGTGCCAGCAGCCCAAGAGGTAGGGGTTACAATGAGCAGTTCTTC	CASSPRGRGYNEQFF	TRBV13	TRBJ2-1
TGTGCCAGCAGTTCGCACTGTGGGGGCGCACACGAGCAGTACTTC	CASSSHCGGAHEQYF	TRBV6-4	TRBJ2-7
TGTGCCAGCAGCTGCCGGGACAGTGGCTACACCTTC	CASSCRDSGYTF	TRBV7-6	TRBJ1-2
TGTGCCAGCATCACAGGGGAGAGGCCCTACGAGCAGTACTTC	CASITGERPYEQYF	TRBV6-4	TRBJ2-7
TGTGCCTGGAGTCGAGGACAGGGAGCGCCCACAGATACGCAGTATTTT	CAWSRGQGAPTDTQYF	TRBV30	TRBJ2-3
TGTGCCAGCAGTGGACAGAACTCCTATAATTCACCCCTCCACTTT	CASSGQNSYNSPLHF	TRBV27	TRBJ1-6
TGTGCCAGCAGCGTAAGGGGGGCGACTACAGATACGCAGTATTTT	CASSVRGATTDTQYF	TRBV13	TRBJ2-3
TGTGCCAGCATCCGGGGGCCCCATCAGCCCCAGCATTTT	CASIRGPHQPQHF	TRBV27	TRBJ1-5
TGTGCCAGCAGTACCCAAAAATACTATGGCTACACCTTC	CASSTQKYYGYTF	TRBV28	TRBJ1-2
TGTGCCAGCAGTTTAGGGGGGAGCAATCAGCCCCAGCATTTT	CASSLGGSNQPQHF	TRBV27	TRBJ1-5
TGTGCCAGCAGCTATCCGGGGTGGGGTGGAGGCACCTTC	CASSYPGWGGGTF	TRBV7-9	TRBJ1-2
TGTGCCGAGGACAGGGTGGTCCACTTC	CAEDRVVHF	TRBV25-1	TRBJ2-7
TGTGCCAGCAGAAACTCCCCCCGGGACGAGCAGTACTTC	CASRNSPRDEQYF	TRBV6-5	TRBJ2-7
TGTGCCAGCAGCCTTAGCTCACCCGGGACAGCTTCCTATAATTCACCCCTCCACTTT	CASSLSSPGTASYNSPLHF	TRBV14	TRBJ1-6
TGTGCCAGCAGCGGACTAGCGGGAGAAGAGCAGTACTTC	CASSGLAGEEQYF	TRBV6-6	TRBJ2-7
TGTGCCAGCTCACCAGAGACTAGCGGCGGAAACACAGATACGCAGTATTTT	CASSPETSGGNTDTQYF	TRBV18	TRBJ2-3
TGTGCCAGCAGCCGCAGCTGGGCCAAAAACATTCAGTACTTC	CASSRSWAKNIQYF	TRBV7-2	TRBJ2-4
TGTGCCACCAGTGATTTGCACCGGGGTCTCGAGACCCAGTACTTC	CATSDLHRGLETQYF	TRBV24-1	TRBJ2-5
TGTGCCAGCAGCTTAGATGGACCTAGGGACGCTTTCTTT	CASSLDGPRDAFF	TRBV11-3	TRBJ1-1
TGCGCCAGCAGCTCTAGCGGGGGATTCGGTACAGATACGCAGTATTTT	CASSSSGGFGTDTQYF	TRBV5-1	TRBJ2-3
TGTGCCAGGCATACCGGGGGCAGCCGGGCGGCCGAGACCCAGTACTTC	CARHTGGSRAAETQYF	TRBV6-6	TRBJ2-5
TGTGCCAGTAGCACCAGAGGGATGGACGAGCAGTACTTC	CASSTRGMDEQYF	TRBV19	TRBJ2-7
TGTGCCAGCAGTAAAGGAGCGTCAATTGAGCAGTTCTTC	CASSKGASIEQFF	TRBV12-3	TRBJ2-1
TGTGCCAGCAGCTTTCTCAGTAGGCAAGAGACCCAGTACTTC	CASSFLSRQETQYF	TRBV5-5	TRBJ2-5
TGTGCCAGCAGTGAGGACAGGGCAGCGCCGAACACTGAAGCTTTCTTT	CASSEDRAAPNTEAFF	TRBV2	TRBJ1-1
TGTGCCACCAGGGATTATGCTAGCGGGGCTGTCCCGTACAATGAGCAGTTCTTC	CATRDYASGAVPYNEQFF	TRBV24-1	TRBJ2-1
TGCGCCAGCAGCTTGGGGGTTCAGCCCCGGGACAGGGGGCCTAAACTGTTTTTT	CASSLGVQPRDRGPKLFF	TRBV5-1	TRBJ1-4
TGTGCCAGCAGCCTTAATTCTAAACGGATATTTGGGGGGGGCTACACCTTC	CASSLNSKRIFGGGYTF	TRBV13	TRBJ1-2
TGTGCCAGCACCGCAGGGAAGGTCGGGGAGGAGAAGCAAAACACTGAAGCTTTCTTT	CASTAGKVGEEKQNTEAFF	TRBV27	TRBJ1-1
TGTGCCAGCAGTTTATGGACTAGAATAGGTGAGACCCAGTACTTC	CASSLWTRIGETQYF	TRBV28	TRBJ2-5
TGTGCCAGCAGCCATTTCAGGGGGGCCTACGAGCAGTACTTC	CASSHFRGAYEQYF	TRBV7-3	TRBJ2-7
TGTGCCAGCAGCGCAGGGTTGGAAGGGGGCAATCAGCCCCAGCATTTT	CASSAGLEGGNQPQHF	TRBV7-3	TRBJ1-5
TGTGCCAGCAGCCAAGATGCCAACGGCAGTCCCCAGCATTTT	CASSQDANGSPQHF	TRBV14	TRBJ1-5
TGTGCCAGCAGCCACAGCAGGGTCCAAGGACGCTACACCTTC	CASSHSRVQGRYTF	TRBV4-2	TRBJ1-2
TGTGCCAGCAGCTTAGAACTCCGGGGTCAGCAGTACTTC	CASSLELRGQQYF	TRBV7-9	TRBJ2-5
TGTGCCAGCTGGCACCGTGCATTCTTTGGTTCACCCCTCCACTTT	CASWHRAFFGSPLHF	TRBV7-3	TRBJ1-6
TGCAGTGCTCTGGGCCAAAATTCCACCGGGGAGCTGTTTTTT	CSALGQNSTGELFF	TRBV20-1	TRBJ2-2
TGTGCCAGCATCACTTCGTTAGCGGGCTTTGCCGGGGAGCTGTTTTTT	CASITSLAGFAGELFF	TRBV2	TRBJ2-2
TGTGCCACCAGCAGAGCCCGACTAGCGGGAGTATATAATTCACCCCTCCACTTT	CATSRARLAGVYNSPLHF	TRBV15	TRBJ1-6
TGTGCCAGCAACACGACTAGCGGGAGGGCCCACGACGAGCAGTACTTC	CASNTTSGRAHDEQYF	TRBV7-2	TRBJ2-7
TGTGCCAGCAAGGGGATCAGGGGGATGTACAATGAGCAGTTCTTC	CASKGIRGMYNEQFF	TRBV6-4	TRBJ2-1
TGTGCCAGCTCACCAAGCTCGGGGTATAATTCACCCCTCCACTTT	CASSPSSGYNSPLHF	TRBV18	TRBJ1-6
TGTGCCTGGGGACAGGGACAGGGGCTTTACGAGCAGTACTTC	CAWGQGQGLYEQYF	TRBV30	TRBJ2-7
TGCGCCAGCGGGTTAGCGCCATCCTACGAGCAGTACTTC	CASGLAPSYEQYF	TRBV5-1	TRBJ2-7
TGTGCCAGCAGTGTCGCCGATAATTCACCCCTCCACTTT	CASSVADNSPLHF	TRBV6-1	TRBJ1-6
TGTGCCAGCAGAGTACAGGGCTATGGCTACACCTTC	CASRVQGYGYTF	TRBV27	TRBJ1-2
TGTGCCAGGGGAGCGGGAGGAGAGACCCAGTACTTC	CARGAGGETQYF	TRBV6-6	TRBJ2-5
TGTGCCAGCACCCCGGGAGGATCGGGGGTGAACACTGAAGCTTTCTTT	CASTPGGSGVNTEAFF	TRBV27	TRBJ1-1
TGTGCCAACAGACTAGCGGGGGGCGAGCAGTACTTC	CANRLAGGEQYF	TRBV19	TRBJ2-7
TGTGCCAGCAGTGATGGGCCTCGAGAGACGCTCCGTGAAGCTTTCTTT	CASSDGPRETLREAFF	TRBV25-1	TRBJ1-1
TGCGCCACACAGGTGGGGTCGGTGGCCTATAATTCACCCCTCCACTTT	CATQVGSVAYNSPLHF	TRBV5-1	TRBJ1-6
TGTGCCAGCAGCTTAGAAGACTGGGACGGGCAGCCCCAGCATTTT	CASSLEDWDGQPQHF	TRBV7-6	TRBJ1-5
TGTGCCAGCAGCGGTCACGGTTTAGCTAACTATGGCTACACCTTC	CASSGHGLANYGYTF	TRBV13	TRBJ1-2
TGTGCCAGCATCGGGACAGGGGGCGGTAATCAGCCCCAGCATTTT	CASIGTGGGNQPQHF	TRBV27	TRBJ1-5
TGTGCCAGCAGCGTTCTACAGGGCTATGGCTACACCTTC	CASSVLQGYGYTF	TRBV9	TRBJ1-2
TGTGCCAGCAGCTTAGCCCGGCGGGCTATTGGGGCTTACTCGGAGAGCTCCTATAATTCACCCCTCCACTTT	CASSLARRAIGAYSESSYNSPLHF	TRBV7-9	TRBJ1-6
TGTGCCAGCAGCGGGGCCTACGAGCAGTACTTC	CASSGAYEQYF	TRBV5-6	TRBJ2-7
TGTGCCAGCAGCCAGCTTCGAGGCGAGACCTACGAGCAGTACTTC	CASSQLRGETYEQYF	TRBV3-1	TRBJ2-7
TGTGCCAGCAGGGCGAGCTTAGTGGAGATTCATAGCAATCAGCCCCAGCATTTT	CASRASLVEIHSNQPQHF	TRBV6-5	TRBJ1-5
TGCAGCGTTAGAAGCCTTGAGGGAATCGAGCAGTACTTC	CSVRSLEGIEQYF	TRBV29-1	TRBJ2-7
TGTGCCAGCAGCCTTAATCGCCGGGACAGGGAACCCGGGTATTCACCCCTCCACTTT	CASSLNRRDREPGYSPLHF	TRBV27	TRBJ1-6
TGCGCCAGCTTCTGGAGCTCCTACGAGCAGTACTTC	CASFWSSYEQYF	TRBV10-2	TRBJ2-7
TGTGCCAGCAGCTTAGGGACCTATAAATCAAAGGGGAGCTACAATGAGCAGTTCTTC	CASSLGTYKSKGSYNEQFF	TRBV11-2	TRBJ2-1
TGCAGTGCTAACACAAAACCAGTGAACACTGAAGCTTTCTTT	CSANTKPVNTEAFF	TRBV20-1	TRBJ1-1
TGTGCCAGCAGCTGGGGGACTAGCGGGGGGTACAATGAGCAGTTCTTC	CASSWGTSGGYNEQFF	TRBV7-2	TRBJ2-1
TGTGCCAGCAGCATGGAAATGGGGCGACGGGGACAGGGGGGCTCTGGGGCCAACGTCCTGACTTTC	CASSMEMGRRGQGGSGANVLTF	TRBV11-1	TRBJ2-6
TGTGCCAGCCAGGACGCAGTATACTATGGCTACACCTTC	CASQDAVYYGYTF	TRBV7-9	TRBJ1-2
TGTGCCAGCAGCTTAAAAAAGGGAAGCTCCTACGAGCAGTACTTC	CASSLKKGSSYEQYF	TRBV11-2	TRBJ2-7
TGTGCCAGCAGCTTCCCGACAGTCCGGTCCTCTGGGGCCAACGTCCTGACTTTC	CASSFPTVRSSGANVLTF	TRBV7-9	TRBJ2-6
TGCAGCGTTGAAGGCCCCCCATGCTACGAGCAGTACTTC	CSVEGPPCYEQYF	TRBV29-1	TRBJ2-7
TGTGCCAGTCGGGAATTTGAAAAACTGTTTTTT	CASREFEKLFF	TRBV19	TRBJ1-4
TGTGCCAGCAGTGTATCAAGGAGGGCACACCCGGGTAACCAAGAGACCCAGTACTTC	CASSVSRRAHPGNQETQYF	TRBV28	TRBJ2-5
TGTGCCAGCACCGACAGGATGGAGACCCAGTACTTC	CASTDRMETQYF	TRBV7-3	TRBJ2-5
TGCGCCAGCCCCAGGACAGGGAGAAGCACCGGGGAGCTGTTTTTT	CASPRTGRSTGELFF	TRBV10-1	TRBJ2-2
TGTGCCAGCAGTGACTCAGGGACAGCGACTGAAGCTTTCTTT	CASSDSGTATEAFF	TRBV6-4	TRBJ1-1
TGTGCCAGGGATGGACAGGGCTCGAATGAAAAACTGTTTTTT	CARDGQGSNEKLFF	TRBV19	TRBJ1-4
TGTGCCAGCAGCCATACGGAACCTTTCTACGAGCAGTACTTC	CASSHTEPFYEQYF	TRBV3-1	TRBJ2-7
TGTGCCACCAGCAGAGGGAGGCACAGGGAGGCCTATGGCTACACCTTC	CATSRGRHREAYGYTF	TRBV15	TRBJ1-2
TGTGCCAGCAGCCAGGGACAGGGGTGGAATGAGCAGTTCTTC	CASSQGQGWNEQFF	TRBV3-1	TRBJ2-1
TGTGCCAGCAGCAAAGGACTACCTAACTATGGCTACACCTTC	CASSKGLPNYGYTF	TRBV7-2	TRBJ1-2
TGTGCCACCTGGGAGGGTACCCTCCACTTT	CATWEGTLHF	TRBV24-1	TRBJ1-6
TGCGCCAGCAGTGAGTCGACTGGCCGGCGTAGCCTAGGGGGGAGGGATGAAAAACTGTTTTTT	CASSESTGRRSLGGRDEKLFF	TRBV10-1	TRBJ1-4
TGTGCCACCAGTGAGGGATTACTGAACCATAGGTGCTATCAAGAGACCCAGTACTTC	CATSEGLLNHRCYQETQYF	TRBV24-1	TRBJ2-5
TGTGCCATCAGTGAGGAAGCAGTTTCACCCCTCCACTTT	CAISEEAVSPLHF	TRBV10-3	TRBJ1-6
TGTGCCTGGCTTGGACGGGCCTACGAGCAGTACTTC	CAWLGRAYEQYF	TRBV30	TRBJ2-7
TGTGCCAGCAGCCTAATCCGGATCCGTGAGCAGTTCTTC	CASSLIRIREQFF	TRBV7-2	TRBJ2-1
TGTGCCAGCAGCCCTAGTTTGCGGGGCACTGAAGCTTTCTTT	CASSPSLRGTEAFF	TRBV7-4	TRBJ1-1
TGTGCCAGCAGCTTAGCGGAGCTAGGGGGCACAACCTGCCACGAGCAGTACTTC	CASSLAELGGTTCHEQYF	TRBV7-8	TRBJ2-7
TGTGCCACCAGTGCAGGTAGCTCAGTGAACAAAAACATTCAGTACTTC	CATSAGSSVNKNIQYF	TRBV24-1	TRBJ2-4
TGTGCCAGCAGCGCGAGCATGAACACTGAAGCTTTCTTT	CASSASMNTEAFF	TRBV11-2	TRBJ1-1
TGTGCCAGCAGCTTAAAGCGCATCTACGAGCAGTACTTC	CASSLKRIYEQYF	TRBV7-6	TRBJ2-7
TGTGCCAGCAGCTTCTCGGAGAGCAGCTACGAGCAGTACTTC	CASSFSESSYEQYF	TRBV5-5	TRBJ2-7
TGTGCCAGCAAGGGCGTCCCGGGACATCGATGCTCCTACGAGCAGTACTTC	CASKGVPGHRCSYEQYF	TRBV3-1	TRBJ2-7
TGTGCCAGCATCCGCGGAGAAGCTTTCTTT	CASIRGEAFF	TRBV25-1	TRBJ1-1
TGTGCCACCACCTCGACGCACAGGGCCTACGAGCAGTACTTC	CATTSTHRAYEQYF	TRBV24-1	TRBJ2-7
TGTGCCTGGAGATGTTTTCAAAGGAGCCCGGTTGTGGCGACAGTAAGCACTGAAGCTTTCTTT	CAWRCFQRSPVVATVSTEAFF	TRBV30	TRBJ1-1
TGTGACCAGGGTCAAGAGACCCAGTACTTC	CDQGQETQYF	TRBV11-3	TRBJ2-5
TGTGCTACGGCAGGCAGAGAGACCCAGTACTTC	CATAGRETQYF	TRBV12-5	TRBJ2-5
TGTGCCAGCAGCCACAGGGGGCGGTTGGACTACGAGCAGTACTTC	CASSHRGRLDYEQYF	TRBV2	TRBJ2-7
TGTGCCACCAGTGTTGCTCGGGGGAGACGAGAGCAGTACTTC	CATSVARGRREQYF	TRBV24-1	TRBJ2-7
TGCGCCAGCAGCTTTGAGACAGAGCAGTTCTTC	CASSFETEQFF	TRBV5-1	TRBJ2-1
TGTGCCAGCAGCGCCCCGACAGGGGGCGGAGGGGATCAGCCCCAGCATTTT	CASSAPTGGGGDQPQHF	TRBV7-3	TRBJ1-5
TGCGCCAGCCCCCGGGGTACAACCGGGGAGCTGTTTTTT	CASPRGTTGELFF	TRBV10-1	TRBJ2-2
TGTGCCTTTCAAATTGCCTTAACCGCCAATGGCTACACCTTC	CAFQIALTANGYTF	TRBV6-2	TRBJ1-2
TGTGCCAGCAGTATACAGGGGGTGGGGGTAGGGCAAGAGACCCAGTACTTC	CASSIQGVGVGQETQYF	TRBV27	TRBJ2-5
TGTGCCAGTCTGCCCCTCCGGGACAGGGGCGCTAACTATGGCTACACCTTC	CASLPLRDRGANYGYTF	TRBV27	TRBJ1-2
TGTGCCAGCAGCTTACGCAGGAGACCCCATTACAATGAGCAGTTCTTC	CASSLRRRPHYNEQFF	TRBV7-2	TRBJ2-1
TGTGCCAGCAGCCAAGTCCGGATTGGGAATGAGAGAACCGCCTACGAGCAGTACTTC	CASSQVRIGNERTAYEQYF	TRBV4-2	TRBJ2-7
TGTGCCAGCAGCTCAATATCGAGGGCGGACGAGCAGTACTTC	CASSSISRADEQYF	TRBV13	TRBJ2-7
TGTGCCTGGAGTGTAACGGGGGGCCCAAATCAGCCCCAGCATTTT	CAWSVTGGPNQPQHF	TRBV30	TRBJ1-5
TGTGCCAGCAGTTTAGGGGGCCTCATCGCGAACACCGGGGAGCTGTTTTTT	CASSLGGLIANTGELFF	TRBV27	TRBJ2-2
TGTGCCAGCAGTTTGGCCGGGACTAGCGGGACTAACACAGATACGCAGTATTTT	CASSLAGTSGTNTDTQYF	TRBV28	TRBJ2-3
TGTGCCAGCAGCCAAGTCTCCGGCCAGTTGCAGCCCCAGCATTTT	CASSQVSGQLQPQHF	TRBV3-1	TRBJ1-5
TGTGCCAGCAGAACCCCGGGGGGACAAGACTACGAGCAGTACTTC	CASRTPGGQDYEQYF	TRBV6-5	TRBJ2-7
TGTGCCAGCTCAGGACAGGGGCTTGACGAGCAGTACTTC	CASSGQGLDEQYF	TRBV18	TRBJ2-7
TGTGCCAGCAGCCAAGCCGTAACGGCGGGGGTGGGAGAAAGAGGGAACGAGCAGTACTTC	CASSQAVTAGVGERGNEQYF	TRBV14	TRBJ2-7
TGCGCCAAAATGGGACGGGAGAATCAGCCCCAGCATTTT	CAKMGRENQPQHF	TRBV10-2	TRBJ1-5
TGTGCTAGCAGCCCACAGGGGGCTGAGGAGCCCCAGCATTTT	CASSPQGAEEPQHF	TRBV7-7	TRBJ1-5
TGTGCCAGCAGCGAATCTATTACACCAGGGAACTATGGCTACACCTTC	CASSESITPGNYGYTF	TRBV7-2	TRBJ1-2
TGTGCCAGCAGCTTAATGCGCGGCGTCTGTACCGGGGAGCTGTTTTTT	CASSLMRGVCTGELFF	TRBV7-9	TRBJ2-2
TGTGCCAGCAGCGCGGGTCGAAAGTCCTGGGGACCGAAGGTTCCCGAGCAGTACTTC	CASSAGRKSWGPKVPEQYF	TRBV7-8	TRBJ2-7
TGTGCCAGACCAGCCGGGACAGCGTCTTTTGAAAAACTGTTTTTT	CARPAGTASFEKLFF	TRBV19	TRBJ1-4
TGTGCCAGCAGTGAGCGGCGGGACAGGGTACCAGGGAACACTGAAGCTTTCTTT	CASSERRDRVPGNTEAFF	TRBV2	TRBJ1-1
TGCAGTGCTAGAGAGTCCAGGGGTTGTCACGGCGAGCAGTACTTC	CSARESRGCHGEQYF	TRBV20-1	TRBJ2-7
TGTGCCAGCAGCGGCACAGGGGACCCCGAGCAGTACTTC	CASSGTGDPEQYF	TRBV5-4	TRBJ2-7
TGTGCCAGAGGAGGGACTAACTATGGCTACACCTTC	CARGGTNYGYTF	TRBV25-1	TRBJ1-2
TGTGCCAGCAGCTTAAGCCGCCCCAGGGGTGGGAATTTCGGGAAAGAGACCCAGTACTTC	CASSLSRPRGGNFGKETQYF	TRBV7-3	TRBJ2-5
TGCGCCAGCAGCGGTGTACGGGCCGGGTTTTGGTGCTACGAGCAGTACTTC	CASSGVRAGFWCYEQYF	TRBV4-3	TRBJ2-7
TGCAGTGCACTTCGTAACGATGGTCTCGGGGAGCTGTTTTTT	CSALRNDGLGELFF	TRBV20-1	TRBJ2-2
TGTGCCAGCAGTGACTCTTCCTCTAGAGGTGCGACCCCTGAGAACACCGGGGAGCTGTTTTTT	CASSDSSSRGATPENTGELFF	TRBV6-4	TRBJ2-2
TGTGCCAGCAGCTTGGTGTGGACAGGACCTGGGGTGCAGTACTTC	CASSLVWTGPGVQYF	TRBV5-4	TRBJ2-7
TGTGCCAGCAGCCATGAGCCCCCTGTACAGAATTGTAGCGCGAACACCGGGGAGCTGTTTTTT	CASSHEPPVQNCSANTGELFF	TRBV13	TRBJ2-2
TGCAGTGCTCAACCATTGATCGTAGGCTTGCTGTTTTTT	CSAQPLIVGLLFF	TRBV20-1	TRBJ2-2
TGTGCCAGCAGCCAATCACTCGGGGAGGAAGAGACCCAGTACTTC	CASSQSLGEEETQYF	TRBV14	TRBJ2-5
TGTGCCAGCAGTATCCAATGGGGCTGCACAGATACGCAGTATTTT	CASSIQWGCTDTQYF	TRBV6-2	TRBJ2-3
TGTGCCAGCAGCCCTAGTAGTGACCGCAGCCAGCCCCAGCATTTT	CASSPSSDRSQPQHF	TRBV3-1	TRBJ1-5
TGTGCCAGCAGGACTAGCGGGGTAGGTTTTTTGTACAATGAGCAGTTCTTC	CASRTSGVGFLYNEQFF	TRBV5-6	TRBJ2-1
TGTGCCAGCAGCCCAGGACAGGGCTACGAGCAGTACTTC	CASSPGQGYEQYF	TRBV7-2	TRBJ2-7
TGTGCCAGCAGCAGGTTCAGGGTACCTGGGAGGGTGAACACTGAAGCTTTCTTT	CASSRFRVPGRVNTEAFF	TRBV13	TRBJ1-1
