TGTGCCAGCAGCACGGGACAGGTGGGGGCCATTCGCTCTGGGGCCAACGTCCTGACTTTC	CASSTGQVGAIRSGANVLTF	TRBV7-4	TRBJ2-6
TGTGCCAGCAGCCAAGGGGGGGGTAAGGTTTTAACTGAGCAGTTCTTC	CASSQGGGKVLTEQFF	TRBV14	TRBJ2-1
TGTGCCAGCAGTTACTTGGGACAGGGTCTGAGTGGCTACACCTTC	CASSYLGQGLSGYTF	TRBV6-5	TRBJ1-2
TGCGCCAGCAGCGAGTTGCTAGCGGCGTTTAACACCGGGGAGCTGTTTTTT	CASSELLAAFNTGELFF	TRBV4-1	TRBJ2-2
TGCAGCGTTCAGCGGCGCCCCTTACCGGGGGAAGAGACCCAGTACTTC	CSVQRRPLPGEETQYF	TRBV29-1	TRBJ2-5
TGTGCCAGCAGGCCGGGACAGTCGTATAATTCACCCCTCCACTTT	CASRPGQSYNSPLHF	TRBV7-3	TRBJ1-6
TGCGCCAGCAGCTTGCTGGGACAGACAAAAAACATTCAGTACTTC	CASSLLGQTKNIQYF	TRBV5-1	TRBJ2-4
TGCAGTGCTAGAGCTAGCCCTTTTTGCACAGATACGCAGTATTTT	CSARASPFCTDTQYF	TRBV20-1	TRBJ2-3
TGTGCCACCAGCCAGGAGAACTATGGCTACACCTTC	CATSQENYGYTF	TRBV24-1	TRBJ1-2
TGTGCTAGCAGCTGTGTGAGGAGACGCTACGAGCAGTACTTC	CASSCVRRRYEQYF	TRBV7-7	TRBJ2-7
TGCAGCGTACTAGACAGGGGGCAGGTGAACTATGGCTACACCTTC	CSVLDRGQVNYGYTF	TRBV29-1	TRBJ1-2
TGTGCCAGCAGTTCTGTAGGGGAGCAGTACTTC	CASSSVGEQYF	TRBV6-5	TRBJ2-7
TGTGCCACCAAGCGGGGAGCTAGCACAGATACGCAGTATTTT	CATKRGASTDTQYF	TRBV24-1	TRBJ2-3
TGTGCCAGCAGGACTAGCGGGAGGGCTACCTACAATGAGCAGTTCTTC	CASRTSGRATYNEQFF	TRBV11-2	TRBJ2-1
TGTGCCAGCAGTGCTTCGGGCTTACACGACGAGCAGTACTTC	CASSASGLHDEQYF	TRBV6-1	TRBJ2-7
TGTGCCAGCAGCGCCCTCTCCCCCAGGGCCCAACGTCGCAATCAGCCCCAGCATTTT	CASSALSPRAQRRNQPQHF	TRBV9	TRBJ1-5
TGCAGTGCTAGTGACTTCCCCGAGCAGTACTTC	CSASDFPEQYF	TRBV20-1	TRBJ2-7
TGCGCCAGCAGGGTGGACGAGGACTTC	CASRVDEDF	TRBV5-1	TRBJ2-7
TGTGCTAGTGGTTTGGTACATAGGGACACTGAAGCTTTCTTT	CASGLVHRDTEAFF	TRBV12-5	TRBJ1-1
TGTGCCAGCAGCCGGGCGATTAAAGAGACCCAGTACTTC	CASSRAIKETQYF	TRBV7-3	TRBJ2-5
TGTGCCAGCAAGACCCGACAGGGCAATCAGCCCCAGCATTTT	CASKTRQGNQPQHF	TRBV7-4	TRBJ1-5
TGTGCCAGCAGCTTAAACAAACGAAGTAAGAACACCGGGGAGCTGTTTTTT	CASSLNKRSKNTGELFF	TRBV11-2	TRBJ2-2
TGCGCCATAGTCTCGTACAATGAGCAGTTCTTC	CAIVSYNEQFF	TRBV10-1	TRBJ2-1
TGCAGTGCTCAGCAGGGGAATCCCCGAAACACTGAAGCTTTCTTT	CSAQQGNPRNTEAFF	TRBV20-1	TRBJ1-1
TGCGCCAGCCAGGACAAGTCGTACGCCTACGAGCAGTACTTC	CASQDKSYAYEQYF	TRBV10-1	TRBJ2-7
TGTGCCAGCAGCGCCGAGGGTGTTCGAGAGACCCAGTACTTC	CASSAEGVRETQYF	TRBV5-8	TRBJ2-5
TGTGCCAGCAGCTACAGGAGGAGGCGTAATTCACCCCTCCACTTT	CASSYRRRRNSPLHF	TRBV7-2	TRBJ1-6
TGCGCCAGCAGCAACTCTCTGGAAAAACTGTTTTTT	CASSNSLEKLFF	TRBV5-1	TRBJ1-4
TGTGCCAGCAGACCGTCCACGAAGGGGGAGCTGTTTTTT	CASRPSTKGELFF	TRBV12-3	TRBJ2-2
TGTGCCAGCAGCCGGTTGGGGGGGTCTGATGAAAAACTGTTTTTT	CASSRLGGSDEKLFF	TRBV5-6	TRBJ1-4
TGCGCCAGCAGTGAAAATACAGGGGATGAAAAACTGTTTTTT	CASSENTGDEKLFF	TRBV10-1	TRBJ1-4
TGTGCTAGTGGTTGCTTACTTACAGGGGTCAATCAGCCCCAGCATTTT	CASGCLLTGVNQPQHF	TRBV12-5	TRBJ1-5
TGTGCCAGCAGTGATCTCGGGACAGGCGGCGGGAGAGGCGAGCAGTACTTC	CASSDLGTGGGRGEQYF	TRBV25-1	TRBJ2-7
TGTGCCATCAAAGGCGACAGGGACCGCCAGCCCCAGCATTTT	CAIKGDRDRQPQHF	TRBV10-3	TRBJ1-5
TGTGCCAGCAGCGTACTAGCGGGAGGGCTTGGCCAGCCCCAGCATTTT	CASSVLAGGLGQPQHF	TRBV27	TRBJ1-5
TGTGCCAGTCTACGAGAAGGGGTATATAATTCACCCCTCCACTTT	CASLREGVYNSPLHF	TRBV6-5	TRBJ1-6
TGCAGTGCTCCCCCGGACAGGGGCTTCAATCAGCCCCAGCATTTT	CSAPPDRGFNQPQHF	TRBV20-1	TRBJ1-5
TGTGCCAGGACAGACACCGGGGAGCTGTTTTTT	CARTDTGELFF	TRBV19	TRBJ2-2
TGTGCCAGCAGCCCGCGGGGCGGGAACACTGAAGCTTTCTTT	CASSPRGGNTEAFF	TRBV7-3	TRBJ1-1
TGTGCCATCAATAGGCGCTCCTACGAGCAGTACTTC	CAINRRSYEQYF	TRBV10-3	TRBJ2-7
TGTGCCAGCAGCTTACGAGGATCAGGGACCTTGTGGGGATCCAAAAACATTCAGTACTTC	CASSLRGSGTLWGSKNIQYF	TRBV7-3	TRBJ2-4
TGTGCCAGCAGTTTACTGGGAGTTGGCTCCTACGAGCAGTACTTC	CASSLLGVGSYEQYF	TRBV27	TRBJ2-7
TGTGCCAGCAGCTTATTGACGGGACAGGGAAACTCTGGGGCCAACGTCCTGACTTTC	CASSLLTGQGNSGANVLTF	TRBV7-8	TRBJ2-6
TGTGCCAGCAGCCCAGACAGGGACTTT	CASSPDRDF	TRBV5-6	TRBJ1-1
TGCAGCTCCCTGGAGAATGAGCAGTTCTTC	CSSLENEQFF	TRBV29-1	TRBJ2-1
TGTGCCAGCAGCTTGGGGCAACGACTACCGGGACTAGCGGGGGTAGAGACCCAGTACTTC	CASSLGQRLPGLAGVETQYF	TRBV5-6	TRBJ2-5
TGTGCCAGCAGCAGATGTAGCTTGGCCGCGGAAAAACTGTTTTTT	CASSRCSLAAEKLFF	TRBV6-5	TRBJ1-4
TGTGCCAGTGCTGACATAGACTTC	CASADIDF	TRBV19	TRBJ2-7
TGTGCCAGCAGCCCGGGGGGGGGGGGGTCTAGCACAGATACGCAGTATTTT	CASSPGGGGSSTDTQYF	TRBV7-3	TRBJ2-3
TGTGCCAGCAGCCAAGAAGGTTACTTGGGGTCCCCAGCTTTCTTT	CASSQEGYLGSPAFF	TRBV3-1	TRBJ1-1
TGTGCCAGCAGCAAGGACAGGGGTGTCCGCAATCAGCCCCAGCATTTT	CASSKDRGVRNQPQHF	TRBV13	TRBJ1-5
TGTGCCAGCAGGTTCCGTGGGACCCGAACCGGGGAGCTGTTTTTT	CASRFRGTRTGELFF	TRBV5-4	TRBJ2-2
TGTGCCAGCAGCCACGGCGGGGACTATGGCTACACCTTC	CASSHGGDYGYTF	TRBV9	TRBJ1-2
TGCGCCAGCGAGATCCGGACGGGATGCACAGATACGCAGTATTTT	CASEIRTGCTDTQYF	TRBV5-1	TRBJ2-3
TGCGCCAGCAGCTTGGACCCGTCGCGGGAGGGGGGCAATCAGCCCCAGCATTTT	CASSLDPSREGGNQPQHF	TRBV5-1	TRBJ1-5
TGTGCCAGCAGCTTAGGCGGCTCATACGAGCAGTACTTC	CASSLGGSYEQYF	TRBV5-6	TRBJ2-7
TGTGCCAGCAGTGTAAAAACACTAGCGGTGATTCAGACCGATACGCAGTATTTT	CASSVKTLAVIQTDTQYF	TRBV2	TRBJ2-3
TGTGCCTGGATTGGCCGCGTAAATAAAGTAGCGGCCACCGAGCAGTACTTC	CAWIGRVNKVAATEQYF	TRBV30	TRBJ2-7
TGCGCCAGCAGCTTGGGATGGCCCTTCTCTATCGGGGAGCTGTTTTTT	CASSLGWPFSIGELFF	TRBV5-1	TRBJ2-2
TGCAGTGCTACCTATACCCTAAAAAACAGGGTATTGGGGGAGACCCAGTACTTC	CSATYTLKNRVLGETQYF	TRBV20-1	TRBJ2-5
TGTGCCAGCAGTTACCTCAAACCCCTAGGGGCGAGTTATGAGCAGTTCTTC	CASSYLKPLGASYEQFF	TRBV6-5	TRBJ2-1
TGTGCCAGCAGTAACTTCCGGAGGGAGGAGCAGTTCTTC	CASSNFRREEQFF	TRBV27	TRBJ2-1
TGCAGCGTTGGATACCGGACACTCTATGGCTACACCTTC	CSVGYRTLYGYTF	TRBV29-1	TRBJ1-2
TGTGCCAGCAGCTTAGCAAAGGACAGAGCCGGGGAGCTGTTTTTT	CASSLAKDRAGELFF	TRBV11-2	TRBJ2-2
TGTGCCAGCCCGAGTCCCGGGAAGCTGTGTCCCCCGATACGACGGGGTAACTCCTACGAGCAGTACTTC	CASPSPGKLCPPIRRGNSYEQYF	TRBV6-3	TRBJ2-7
TGTGCCAGCAGTGCTCGCGGGAGCTATTCCTACGAGCAGTACTTC	CASSARGSYSYEQYF	TRBV6-4	TRBJ2-7
TGTGCCAGCTCACCAACAGGGGAACCTTACGAGCAGTACTTC	CASSPTGEPYEQYF	TRBV18	TRBJ2-7
TGTGCCAGCAGTTGGGAGTCAAATGAGCAGTTCTTC	CASSWESNEQFF	TRBV27	TRBJ2-1
TGTGCCAGCAGTTACGTCCCTAGCGGGGGGAACATTCAGTACTTC	CASSYVPSGGNIQYF	TRBV6-6	TRBJ2-4
TGTGCCACCAGTACCCCGGGACAAGTCAGGTGCCAAGAGACCCAGTACTTC	CATSTPGQVRCQETQYF	TRBV24-1	TRBJ2-5
TGTGCCAGCAGCTCCCGGGGCCCCTCAGGGCATAGCAATCAGCCCCAGCATTTT	CASSSRGPSGHSNQPQHF	TRBV7-7	TRBJ1-5
TGTGCCAGCAACTGGGAACGCCACGAGCAGTACTTC	CASNWERHEQYF	TRBV27	TRBJ2-7
TGTGCCAGCAGGTCTGAAAGTACCACCCACCGGGTCAGCTCCTACAATGAGCAGTTCTTC	CASRSESTTHRVSSYNEQFF	TRBV6-5	TRBJ2-1
TGTGCCAGCAGCGTGGTCTCGGCGGATGAGCAGTTCTTC	CASSVVSADEQFF	TRBV9	TRBJ2-1
TGTGCCAGCAGCTTGTCGGCGATATACCTCGAGCAGTACTTC	CASSLSAIYLEQYF	TRBV5-6	TRBJ2-7
TGTGCCACCAGTGTTCCGAGGGGACGGGTCAGGGACGGTCAGCCCCAGCATTTT	CATSVPRGRVRDGQPQHF	TRBV24-1	TRBJ1-5
TGTGCCAGCAGCTTCGGTACCCGGGACAGGGTCACAGATACGCAGTATTTT	CASSFGTRDRVTDTQYF	TRBV11-3	TRBJ2-3
TGTGCCAGCAGTGACACCAGTTTCTATGGCTACACCTTC	CASSDTSFYGYTF	TRBV12-3	TRBJ1-2
TGTGCCAGCAGTGAACTGGGGGGGGCCCTTAACTTC	CASSELGGALNF	TRBV6-1	TRBJ2-7
TGTGCCAGCAGCGTAGCCACCGGGACAGGACCAGGCTACACCTTC	CASSVATGTGPGYTF	TRBV9	TRBJ1-2
TGCAGCGTTGTAGTTTTCTCAGCGGGAATCTTCGGCCACTATCTTCAGAACACCGGGGAGCTGTTTTTT	CSVVVFSAGIFGHYLQNTGELFF	TRBV29-1	TRBJ2-2
TGTGCCAGCAGTTATGCTAGGTCAGAGCAGTTCTTC	CASSYARSEQFF	TRBV2	TRBJ2-1
TGCGCCAGCAGCCGGGCAGAACTGGCCGGTGAAGCTTTCTTT	CASSRAELAGEAFF	TRBV4-3	TRBJ1-1
TGTGCCAGCACCGGGACTAATCAGCCCCAGCATTTT	CASTGTNQPQHF	TRBV12-4	TRBJ1-5
TGTGCCAGCTCACCCAGGGCAAGGTGCGGGGAGCTGTTTTTT	CASSPRARCGELFF	TRBV7-4	TRBJ2-2
TGTGCCAGCAGCCCTAAACGGACGTATCCCAAAGAGACCCAGTACTTC	CASSPKRTYPKETQYF	TRBV11-3	TRBJ2-5
TGTGCCAGCAGCCCCCATAGAACTAGCGGGAGGGCGCAGACCCAGTACTTC	CASSPHRTSGRAQTQYF	TRBV7-2	TRBJ2-5
TGTGCCAGAAAATTCCCTCTGGGAGGGAGATCCTCCTACGAGCAGTACTTC	CARKFPLGGRSSYEQYF	TRBV25-1	TRBJ2-7
TGTGCCAGCAGCGGTTTCCTGAAGGATACGCAGTATTTT	CASSGFLKDTQYF	TRBV7-9	TRBJ2-3
TGCGCCAGCAGCCAAGGCGGAGCAGGAGGGGAGCAGTACTTC	CASSQGGAGGEQYF	TRBV4-1	TRBJ2-7
TGTGCCAGTAGTATGCCGGGACTTAGGAGAAAATCCTACGAGCAGTACTTC	CASSMPGLRRKSYEQYF	TRBV19	TRBJ2-7
TGTGCCAGCACGAGACAGGGTAGATATGGCTACACCTTC	CASTRQGRYGYTF	TRBV28	TRBJ1-2
TGTGCCAGCAGCCAATGGGGTATGAACACTGAAGCTTTCTTT	CASSQWGMNTEAFF	TRBV14	TRBJ1-1
TGTGCCACCAGCAGAGATGACCTTGGGGCTACGCGTAGGGTGAACACTGAAGCTTTCTTT	CATSRDDLGATRRVNTEAFF	TRBV15	TRBJ1-1
TGCAGCGTTCCTTCGGGGGGACGTGGCGTGAACACTGAAGCTTTCTTT	CSVPSGGRGVNTEAFF	TRBV29-1	TRBJ1-1
TGCGCCAGCAGCACCGTAGCGGGGTGCACAGATACGCAGTATTTT	CASSTVAGCTDTQYF	TRBV4-1	TRBJ2-3
TGTGCCAGCAGGGCGGTCGGACACTCCACCGCCGCAGGCACTGAAGCTTTCTTT	CASRAVGHSTAAGTEAFF	TRBV3-1	TRBJ1-1
TGTGCCAGTAGTCAGCGGGGGGGGCTCTCCTACGAGCAGTACTTC	CASSQRGGLSYEQYF	TRBV19	TRBJ2-7
TGTGCCAGCAGTACCTTTCGTGCAACTAATGAAAAACTGTTTTTT	CASSTFRATNEKLFF	TRBV7-9	TRBJ1-4
TGTGCCAGCAGCATTGGGGGAGAGACCCAGTACTTC	CASSIGGETQYF	TRBV7-4	TRBJ2-5
TGCGCCAGCAGCCATTGCACCAATCAGCCCCAGCATTTT	CASSHCTNQPQHF	TRBV4-3	TRBJ1-5
TGTGCCAGCAGCGTAAGCGAGTCAGAATTTCGGAGGGAGACCCAGTACTTC	CASSVSESEFRRETQYF	TRBV9	TRBJ2-5
TGTGCCAGCAGTTCGCGAGGGAGCCGGAACTCCTACAATGAGCAGTTCTTC	CASSSRGSRNSYNEQFF	TRBV27	TRBJ2-1
TGCAGTGCTAGAGATCTCTCGGATGCGTCCGGGGAGCTGTTTTTT	CSARDLSDASGELFF	TRBV20-1	TRBJ2-2
TGCAGCGTTGAAGCGGGCGTCCTGGTCCGCTATGGCTACACCTTC	CSVEAGVLVRYGYTF	TRBV29-1	TRBJ1-2
TGTGCCATCAGTGTCACAGGGGGGGGGGACGAGCAGTACTTC	CAISVTGGGDEQYF	TRBV10-3	TRBJ2-7
TGTGCCAGCAGTTACGCACCACAGGGGGCTTTAGTACCAGGGAACCTCTCCTACGAGCAGTACTTC	CASSYAPQGALVPGNLSYEQYF	TRBV6-6	TRBJ2-7
TGTGCCATCAGTGAGTCGCCGGGGGGGCCGCAGTTCTTC	CAISESPGGPQFF	TRBV10-3	TRBJ2-1
TGTGCCAGCAGCTTGCAACAAGAGAAGATTAACCGCTACGAGCAGTACTTC	CASSLQQEKINRYEQYF	TRBV5-6	TRBJ2-7
TGTGCCAGCAGTACAGGGAACACTGAAGCTTTCTTT	CASSTGNTEAFF	TRBV2	TRBJ1-1
TGTGCCTGGAGTGGCGACAGGGCTGGCTCCTACGAGCAGTACTTC	CAWSGDRAGSYEQYF	TRBV30	TRBJ2-7
TGTGCCAGCAGCATCTTATGGGCCTTGCCGGCTGAAGCTTTCTTT	CASSILWALPAEAFF	TRBV7-3	TRBJ1-1
TGTGCCAGCAGCCCCTGGACAGGGTTTTTGGGTAGACGGGGCTACACCTTC	CASSPWTGFLGRRGYTF	TRBV13	TRBJ1-2
TGTGCCAGCAAACAGACTGTTCCGGGACAGGGCCTGAACACTGAAGCTTTCTTT	CASKQTVPGQGLNTEAFF	TRBV27	TRBJ1-1
TGTGCCAGCAGAACTACCCGACAGGGAGGAGAGACCCAGTACTTC	CASRTTRQGGETQYF	TRBV12-3	TRBJ2-5
TGTGCCAGCAGCAGACAGGGTAGCCTTACTGAAGCTTTCTTT	CASSRQGSLTEAFF	TRBV11-2	TRBJ1-1
TGTGCCAGCAGCTCGGGACAGGGACAAGAGACCCAGTACTTC	CASSSGQGQETQYF	TRBV11-2	TRBJ2-5
TGTGCCAGCAGCTCGGAGACAGGGGGGCCCCCGTCTGGGGCCAACGTCCTGACTTTC	CASSSETGGPPSGANVLTF	TRBV5-4	TRBJ2-6
TGTGCTAGCAGCAGGGCGATCACTGAAGCTTTCTTT	CASSRAITEAFF	TRBV7-7	TRBJ1-1
TGTGCCAGCAGCCCCGCGGGACGGGAAAAAGTTGACGAGCAGTACTTC	CASSPAGREKVDEQYF	TRBV14	TRBJ2-7
TGTGCCAGCAGCTTCAATAGGGGGTACCATACGCAGTATTTT	CASSFNRGYHTQYF	TRBV13	TRBJ2-3
TGTGCCAGCAGTTTGCTAGCGGGAGTACCTTACGAGCAGTACTTC	CASSLLAGVPYEQYF	TRBV28	TRBJ2-7
TGTGCCAGCAGCTTCAGCAGGGGTTCCTACGAGCAGTACTTC	CASSFSRGSYEQYF	TRBV5-4	TRBJ2-7
TGTGCCAGATCAACGGCCACCGGGACAGCGGGTTACTACGAGCAGTACTTC	CARSTATGTAGYYEQYF	TRBV6-5	TRBJ2-7
TGTGCCAGCAGCATGGGACACTATAGCAATCAGCCCCAGCATTTT	CASSMGHYSNQPQHF	TRBV13	TRBJ1-5
TGTGCCAGCAGTGGACAGGGGAAGACTAATGAAAAACTGTTTTTT	CASSGQGKTNEKLFF	TRBV6-5	TRBJ1-4
TGTGCCAGCAGTGATAACCCCGGGACTAGCGGCATCATGCTAGCCAAAAACATTCAGTACTTC	CASSDNPGTSGIMLAKNIQYF	TRBV6-1	TRBJ2-4
TGCGCCAGCACGGGAGGGGTATGCATTGGGGCTTTCTTT	CASTGGVCIGAFF	TRBV5-1	TRBJ1-1
TGTGCCAGCAGTCGTTCTACGCACTCCTACAATGAGCAGTTCTTC	CASSRSTHSYNEQFF	TRBV2	TRBJ2-1
TGTGCCACCAGTGACACTTTTACCCACGGGAGGGTTTCGGACTACGAGCAGTACTTC	CATSDTFTHGRVSDYEQYF	TRBV24-1	TRBJ2-7
TGTGCCAGCAGCTCGTTGACAGTCTTCAGTAGCAATCAGCCCCAGCATTTT	CASSSLTVFSSNQPQHF	TRBV11-2	TRBJ1-5
TGCGCCAGCAGCGAAAGCGGGTGGGGGTTCATGAACACTGAAGCTTTCTTT	CASSESGWGFMNTEAFF	TRBV5-1	TRBJ1-1
TGTGCCAGCAGAACCCCGGGACAGATGCCGACCTACAATGAGCAGTTCTTC	CASRTPGQMPTYNEQFF	TRBV27	TRBJ2-1
TGTGCCAGCAGTGAAACAGGGGGCGCATTTTGGGAAAACATTCAGTACTTC	CASSETGGAFWENIQYF	TRBV6-1	TRBJ2-4
TGTGCCAGCAGTATTCCGACTAGCGGGGGGCATGTGTCTGGGTTATCCTACGAGCAGTACTTC	CASSIPTSGGHVSGLSYEQYF	TRBV6-1	TRBJ2-7
TGCAGCGTGGGACTAGTGGGGCCGGTAGCCAAAAACATTCAGTACTTC	CSVGLVGPVAKNIQYF	TRBV29-1	TRBJ2-4
TGTGCCAGCAGCGTAGTTTTGGACCCACAGGGGAAGACAACCGGGGAGCTGTTTTTT	CASSVVLDPQGKTTGELFF	TRBV9	TRBJ2-2
TGTGCCACCAGTGATTTGACGGGACAGGCAACTACGCAGTATTTT	CATSDLTGQATTQYF	TRBV24-1	TRBJ2-3
TGTGCCAGCAGCTTAGCGTTCCTTCATTTCGGGCGGGAGAACTATGGCTACACCTTC	CASSLAFLHFGRENYGYTF	TRBV7-9	TRBJ1-2
TGCGCCAGCTCTAACGTGGGGGGCTACGAGCAGTACTTC	CASSNVGGYEQYF	TRBV10-1	TRBJ2-7
TGTGCCAGCAGTGACAGTGACAGCAGGTCACCCCTCCACTTT	CASSDSDSRSPLHF	TRBV6-4	TRBJ1-6
TGCGCCAGCAGCCCGCTCGCGGGGGTAGGGCCCTTT	CASSPLAGVGPF	TRBV5-1	TRBJ1-1
TGTGCCAGCAGCTTAGGACAGGGACACGACACTGAAGCTTTCTTT	CASSLGQGHDTEAFF	TRBV11-2	TRBJ1-1
TGTGCCAGCAATCCAAGGGGGGCCTACAATGAGCAGTTCTTC	CASNPRGAYNEQFF	TRBV25-1	TRBJ2-1
TGTGCCAGCAGCTCTCGGGGGGGGGGGAAATATGAGCAGTTCTTC	CASSSRGGGKYEQFF	TRBV11-3	TRBJ2-1
TGCGCCAGCAGCACCCCGACAGGGAGTGATAGCAATCAGCCCCAGCATTTT	CASSTPTGSDSNQPQHF	TRBV5-1	TRBJ1-5
TGTGCCACACGGGACGGGCACCAGCCCCAGCATTTT	CATRDGHQPQHF	TRBV6-2	TRBJ1-5
TGTGCCTGGAGCCGGGGGGGGGGAAACACCATATATTTT	CAWSRGGGNTIYF	TRBV30	TRBJ1-3
TGTGCCAGCACAGGACAGGGGGGCGAGCAGTACTTC	CASTGQGGEQYF	TRBV13	TRBJ2-7
TGTGCCAGCAGCAGCTGGGACAGGGGTCCATATGATACGCAGTATTTT	CASSSWDRGPYDTQYF	TRBV7-7	TRBJ2-3
TGTGCCAGCAGCTTACCGCAAGGGGGCATTGGCCAAGAGACCCAGTACTTC	CASSLPQGGIGQETQYF	TRBV7-9	TRBJ2-5
TGTGCCAGCAGTTTTGCTGTTTGCAATCAGCCCCAGCATTTT	CASSFAVCNQPQHF	TRBV12-4	TRBJ1-5
TGTGCTAGCAGCTTATACACTGGCCGGAGGGGCGGGTACTCTGGAAACACCATATATTTT	CASSLYTGRRGGYSGNTIYF	TRBV7-7	TRBJ1-3
TGTGCCAGCAGCGTAGGGTTTCCCCTAGCGGCGGGGACCTCCTACGAGCAGTACTTC	CASSVGFPLAAGTSYEQYF	TRBV9	TRBJ2-7
TGTGCCAGCAGCAGTCAGGCAGCGATCTACGAGCAGTACTTC	CASSSQAAIYEQYF	TRBV7-2	TRBJ2-7
TGCAGTGCTTCACCAGTGGGACTAGCGGGTTCGGAGCAGTTCTTC	CSASPVGLAGSEQFF	TRBV20-1	TRBJ2-1
TGTGCCAGCCCGGTGGGGCGCTCCTACGAGCAGTACTTC	CASPVGRSYEQYF	TRBV28	TRBJ2-7
TGTGCCAGCAGTACGCGGACTAGGGGGGTTGAGTACAATGAGCAGTTCTTC	CASSTRTRGVEYNEQFF	TRBV27	TRBJ2-1
TGCGCCAGCAGCTGCGACCACGGTGATATCTACAATGAGCAGTTCTTC	CASSCDHGDIYNEQFF	TRBV5-1	TRBJ2-1
TGCGCCAGCAGCCCATTAACTGAGGCGTACAATGAGCAGTTCTTC	CASSPLTEAYNEQFF	TRBV5-1	TRBJ2-1
TGTGCCAGCAGTACGACCGCCGGGACTAGCGGCGCGGTCTCGGAGCAGTACTTC	CASSTTAGTSGAVSEQYF	TRBV6-1	TRBJ2-7
TGCAGTGCTAGAGCCCGGGCGCCGGGACAGCCCATCTACGAGCAGTACTTC	CSARARAPGQPIYEQYF	TRBV20-1	TRBJ2-7
TGTGCCTGGACCCGGACAGGGTTTGGCTACACCTTC	CAWTRTGFGYTF	TRBV30	TRBJ1-2
TGCGCCAGCAGCCAAGATTGGAGGACGAAAGGGGAGGCCAACGTCCTGACTTTC	CASSQDWRTKGEANVLTF	TRBV4-1	TRBJ2-6
TGCGCCAGCAGTGCAACCTGGGGGGGAGATCCGCAGGGGGATACGCAGTATTTT	CASSATWGGDPQGDTQYF	TRBV10-2	TRBJ2-3
TGTGCCAGCCACATAATTGGGACATGGAATTCACCCCTCCACTTT	CASHIIGTWNSPLHF	TRBV6-4	TRBJ1-6
TGTGCCGGGCAGTATAATCAGCCCCAGCATTTT	CAGQYNQPQHF	TRBV15	TRBJ1-5
TGCGCCAGCAGCCAAGTGGAGGACAGGGAAGGGAGCTCCTACGAGCAGTACTTC	CASSQVEDREGSSYEQYF	TRBV4-3	TRBJ2-7
TGTGCCAGCCCAGCGACAGTAGGCTACACCTTC	CASPATVGYTF	TRBV19	TRBJ1-2
TGTGCCAGCAGCGTCACGCCAGATTCACTTAATGAAAAACTGTTTTTT	CASSVTPDSLNEKLFF	TRBV9	TRBJ1-4
TGTGCCAGCAGCTTCGTTGGGACGGGGGGGGGGGTGCAGTACTTC	CASSFVGTGGGVQYF	TRBV7-4	TRBJ2-7
TGTGCCAGCCGGTGGACAGGGTGTTTGAACACTGAAGCTTTCTTT	CASRWTGCLNTEAFF	TRBV28	TRBJ1-1
TGCGCCAGCAACCGACAGGGGGCCTATCCTTCACCCCTCCACTTT	CASNRQGAYPSPLHF	TRBV10-1	TRBJ1-6
TGTGCCAGCAGCTTACAGGGGGGCTGTTCGGGCGAGCAGTACTTC	CASSLQGGCSGEQYF	TRBV11-3	TRBJ2-7
TGTGCCACCGAGAGCCCTAGCGGGATGCTCTCCTACGAGCAGTACTTC	CATESPSGMLSYEQYF	TRBV24-1	TRBJ2-7
TGTGCCAGCAGTTTTCAGCGGGATCGCCGCAATCCCGTGATTCAAGAGACCCAGTACTTC	CASSFQRDRRNPVIQETQYF	TRBV27	TRBJ2-5
TGTGCCAGCAGCGGGGTGGAGAGCGGGGAGCTGTTTTTT	CASSGVESGELFF	TRBV6-4	TRBJ2-2
TGTGCCAGCAAGACAGGGCTGAGGGATGGCTACACCTTC	CASKTGLRDGYTF	TRBV11-1	TRBJ1-2
TGCAGTGCTAGTGTTTCGGGGACTTACAATCAGCCCCAGCATTTT	CSASVSGTYNQPQHF	TRBV20-1	TRBJ1-5
TGCAGTGCGGGTACTTACCCCAATGAGCAGTTCTTC	CSAGTYPNEQFF	TRBV20-1	TRBJ2-1
TGTGCCAGCAGTTACAGTTGTCAAGTGTCTAAAGCGGGTTCTAGCACAGATACGCAGTATTTT	CASSYSCQVSKAGSSTDTQYF	TRBV6-5	TRBJ2-3
TGTGCCAGCTCTCTAGGCGAGCAGTACTTC	CASSLGEQYF	TRBV7-3	TRBJ2-7
TGTGCCAGCAGCTTAGCCCCGACTAGCGGCGGGGAGACCCAGTACTTC	CASSLAPTSGGETQYF	TRBV11-3	TRBJ2-5
TGTGCCAGCAGCCTAACAACTAGCGGGTGGTGCACAGATACGCAGTATTTT	CASSLTTSGWCTDTQYF	TRBV13	TRBJ2-3
TGTGCCAGCAGTGGTGGACTGGGTTCCCAAGAGACCCAGTACTTC	CASSGGLGSQETQYF	TRBV27	TRBJ2-5
TGTGCCAGCAAAAAAGGACAGGGGGACGAGCAGTACTTC	CASKKGQGDEQYF	TRBV27	TRBJ2-7
TGTGCCAGCAGCCAACGCCCCAGGACTAGGAGCACAGATACGCAGTATTTT	CASSQRPRTRSTDTQYF	TRBV3-1	TRBJ2-3
TGTGCCAGCAGTACTGAGGGTATCTCCGAAGAGACCCAGTACTTC	CASSTEGISEETQYF	TRBV27	TRBJ2-5
TGCGCCAGCAGCCAACCTAGCGAGAGCGAGCAGTACTTC	CASSQPSESEQYF	TRBV4-3	TRBJ2-7
TGTGCCAGCAGATTGTCGGCGCGAATAGCGGGAACGGAGATGTACTTC	CASRLSARIAGTEMYF	TRBV6-5	TRBJ2-4
TGTGCCAGCAGCCCCGCCTACGAGCAGTACTTC	CASSPAYEQYF	TRBV11-2	TRBJ2-7
TGTGCCAGCAGCCAAGGGCGCGAGACCCAGTACTTC	CASSQGRETQYF	TRBV3-1	TRBJ2-5
TGTGCCAGCAGTTCAAAGTCCCGGGGCGAGCAGTACTTC	CASSSKSRGEQYF	TRBV6-2	TRBJ2-7
TGTGCCAGCAGTTACCTAAAAGGAGCGTCATACGAGCAGTACTTC	CASSYLKGASYEQYF	TRBV6-3	TRBJ2-7
TGTGCCATCAGTGAGATACAGGGTGCTGGAAACACCATATATTTT	CAISEIQGAGNTIYF	TRBV10-3	TRBJ1-3
TGCAGTGCTAGAGGGCGGTCTCCACCTTCCCCGCGGGAGCGGGGGTGTTCCTACAATGAGCAGTTCTTC	CSARGRSPPSPRERGCSYNEQFF	TRBV20-1	TRBJ2-1
TGTGCCAGCAGCCCGGGACCCCAGGGGAGTATTCAGCCCCAGCATTTT	CASSPGPQGSIQPQHF	TRBV3-1	TRBJ1-5
TGTGCCAGCAGCATCCCGGGACAGGGCCTGGCTATTTACACCGGGGAGCTGTTTTTT	CASSIPGQGLAIYTGELFF	TRBV13	TRBJ2-2
TGTGCCAGCCACCGGGCCCACTACAATGAGCAGTTCTTC	CASHRAHYNEQFF	TRBV6-4	TRBJ2-1
TGTGCCAGCATCATCCGGGACAGGGGAGTCCAATCCTCGGGAGTAATCCAGAATCAGCCCCAGCATTTT	CASIIRDRGVQSSGVIQNQPQHF	TRBV6-8	TRBJ1-5
TGTGCCAGCAGCGGATTACCGGACAGGGGGCCTTCCGGGGCCAACGTCCTGACTTTC	CASSGLPDRGPSGANVLTF	TRBV7-3	TRBJ2-6
TGTGCCAGCAGCTTACGTTCAGGGTTTAACGAGCAGTACTTC	CASSLRSGFNEQYF	TRBV11-2	TRBJ2-7
TGCAGTGCCGGGAACCCCCTCGGGGCCTACCGAGGGGCCAACGTCCTGACTTTC	CSAGNPLGAYRGANVLTF	TRBV20-1	TRBJ2-6
TGTGCCAGCATGTTCCAGGGGGCAGGAATTAGCAATCAGCCCCAGCATTTT	CASMFQGAGISNQPQHF	TRBV27	TRBJ1-5
TGTGCCAGCACAATTCTAAGGGGTAGACCTGGCAATCAGCCCCAGCATTTT	CASTILRGRPGNQPQHF	TRBV6-4	TRBJ1-5
TGCGCCAGCCACCAGGGGGCTTTGAGTGAAGCTTTCTTT	CASHQGALSEAFF	TRBV5-1	TRBJ1-1
TGTGCCAGCTCACCTCCCCAATGGGCTCCGGAGACCCAGTACTTC	CASSPPQWAPETQYF	TRBV18	TRBJ2-5
TGTGCCAGCCCGAGGACAGGGTGTTGTTTTCTAACAGAGACCCAGTACTTC	CASPRTGCCFLTETQYF	TRBV7-9	TRBJ2-5
TGTGCCAGCAGTCCCAAGAGAAAGGGGGACTACGAGCAGTACTTC	CASSPKRKGDYEQYF	TRBV27	TRBJ2-7
TGCGCCAGCAGCTGGTCCGAGCAGGGCGGAAACACCATATATTTT	CASSWSEQGGNTIYF	TRBV5-1	TRBJ1-3
TGTGCCAGCAGAGATACCATGACTAGCGGGGAATACAATGAGCAGTTCTTC	CASRDTMTSGEYNEQFF	TRBV12-4	TRBJ2-1
TGTGCGTCAGGGGGAGATCAGCCCCAGCATTTT	CASGGDQPQHF	TRBV3-1	TRBJ1-5
TGTGCCAGCAAACCAGTCCCGGGACAGGGGGGGTTTTGGTACTCTGGAAACACCATATATTTT	CASKPVPGQGGFWYSGNTIYF	TRBV27	TRBJ1-3
TGTGCCAGCAGCTCAACCCCCAACGGGACTCCCTTCAAGGGACTAGCCAAAAACATTCAGTACTTC	CASSSTPNGTPFKGLAKNIQYF	TRBV7-3	TRBJ2-4
TGTGCCAGCAGCTCTCATGTAGGCAATCAGCCCCAGCATTTT	CASSSHVGNQPQHF	TRBV7-2	TRBJ1-5
TGTGCCAGCTTCCATCCCGGGAGTCACGCCTACGAGCAGTACTTC	CASFHPGSHAYEQYF	TRBV19	TRBJ2-7
TGCAGCGAAACGGAGGGGGATACGCAGTATTTT	CSETEGDTQYF	TRBV29-1	TRBJ2-3
TGTGCCAGCTCACCACTCATATGGCCCTTGCCCCGGGACAGGGGAGGGGGATCCTCCTACAATGAGCAGTTCTTC	CASSPLIWPLPRDRGGGSSYNEQFF	TRBV18	TRBJ2-1
TGTGCCAGCAGCTATATACAGCTTGTCAGTAGGCAGTTCTTC	CASSYIQLVSRQFF	TRBV7-4	TRBJ2-1
TGTGCCAGCAGCCAGGCGGACACGAACACTGAAGCTTTCTTT	CASSQADTNTEAFF	TRBV7-9	TRBJ1-1
TGTGCCAGCAGCTTAGCGATAAATTCCGACAGGGGGGTCTCTGAAGCTTTCTTT	CASSLAINSDRGVSEAFF	TRBV7-8	TRBJ1-1
TGTGCCAGCAGGGCGGGGGGTGAGCAGTTCTTC	CASRAGGEQFF	TRBV6-1	TRBJ2-1
TGTGCCAGCAGCGGATGGGGTTCCTACGAGCAGTACTTC	CASSGWGSYEQYF	TRBV7-9	TRBJ2-7
TGTGCCAGCATGGGACAGCTAGGCACAGATACGCAGTATTTT	CASMGQLGTDTQYF	TRBV6-8	TRBJ2-3
TGTGCCAGCAGCAGCGCGATGCACCCAGATACGCAGTATTTT	CASSSAMHPDTQYF	TRBV7-7	TRBJ2-3
TGTGCCAGCAGGCGTAGAGGGTGGGCCAAAAACATTCAGTACTTC	CASRRRGWAKNIQYF	TRBV6-5	TRBJ2-4
TGTGCCACCGACTCCCGGGAACCCTCTGGGGCCAACGTCCTGACTTTC	CATDSREPSGANVLTF	TRBV28	TRBJ2-6
TGTGCCAGCAGTGAGGGGGGGGAGACCCAGTACTTC	CASSEGGETQYF	TRBV6-1	TRBJ2-5
TGTGCCAGCAGTGAATCCGGGACAGGGATACCTCTCTACGAGCAGTACTTC	CASSESGTGIPLYEQYF	TRBV2	TRBJ2-7
TGCAGCGTCAACAGGGGGTCAAGACGTGGCTACACCTTC	CSVNRGSRRGYTF	TRBV29-1	TRBJ1-2
TGTGCCTGGCCAAGGGGGTTTCGAGGCAATCAGCCCCAGCATTTT	CAWPRGFRGNQPQHF	TRBV30	TRBJ1-5
TGCGCCACCCGGGACAGAGATACGCAGTATTTT	CATRDRDTQYF	TRBV10-1	TRBJ2-3
TGTGCCAGCAGTGTCCCGGACGAGCAGTACTTC	CASSVPDEQYF	TRBV6-3	TRBJ2-7
TGTGCCAGCAGCTTCCGTGAACTGTTTTACGAGCAGTACTTC	CASSFRELFYEQYF	TRBV7-9	TRBJ2-7
TGTGCCAGCAGTCCCACTCATATTCCTCGGGGAAATCAGCCCCAGCATTTT	CASSPTHIPRGNQPQHF	TRBV6-1	TRBJ1-5
TGTGCCAGCAGCTTTGACGTTTTGAACACCGGGGAGCTGTTTTTT	CASSFDVLNTGELFF	TRBV5-4	TRBJ2-2
TGTGCCAGCATCAGGGATACGAGGGGACTCCAAGAGACCCAGTACTTC	CASIRDTRGLQETQYF	TRBV27	TRBJ2-5
TGTGCCAGCAGCCAGACCCGGGACAGGGGTGGGTATGGCTACACCTTC	CASSQTRDRGGYGYTF	TRBV7-9	TRBJ1-2
TGTGCCAGTAGTATACCTTGCCCTAGCGGCGAGCAGTACTTC	CASSIPCPSGEQYF	TRBV19	TRBJ2-7
TGCGCCAGCAGTGGACGATACACTGAAGCTTTCTTT	CASSGRYTEAFF	TRBV10-1	TRBJ1-1
TGTGCCAGCAGCTTGAGGGGAGCAAACATTCAGTACTTC	CASSLRGANIQYF	TRBV7-3	TRBJ2-4
TGTGCCAGCAGTTGCCGACGCCTGTCTAACTACGAGCAGTACTTC	CASSCRRLSNYEQYF	TRBV7-9	TRBJ2-7
TGTGCCAGCAGCGTAGGGCAGGGGGCCTACGAGCAGTACTTC	CASSVGQGAYEQYF	TRBV9	TRBJ2-7
TGCAGTGCTAGAGATGCCCGGGGTCACACTGAAGCTTTCTTT	CSARDARGHTEAFF	TRBV20-1	TRBJ1-1
TGTGCCAGTAGTATACAACCCGGACTAGCGCGTGTTGGGATCTTC	CASSIQPGLARVGIF	TRBV19	TRBJ2-1
TGTGCCAGCAGTTTGGGGGGGGGGGGCTACACCTTC	CASSLGGGGYTF	TRBV12-4	TRBJ1-2
TGTGCCAGCAGCAGCACTCTAGACACCAATGAGCAGTTCTTC	CASSSTLDTNEQFF	TRBV7-7	TRBJ2-1
TGTGCCACCGTCCCGACAGGGCGATCCTATAATTCACCCCTCCACTTT	CATVPTGRSYNSPLHF	TRBV27	TRBJ1-6
TGCGCCAGCAGCTTCCCCACTTACTTTAATCCCAACACCGGGGAGCTGTTTTTT	CASSFPTYFNPNTGELFF	TRBV5-1	TRBJ2-2
TGTGCCAGCAGTTTTTATCAGAGGATCAACACCGGGGAGCTGTTTTTT	CASSFYQRINTGELFF	TRBV28	TRBJ2-2
TGCAGTGCTAGACACTCGGGACGTCTGAATGAGCAGTTCTTC	CSARHSGRLNEQFF	TRBV20-1	TRBJ2-1
TGCAGTGCAGGGTCACAGGGCACTGAAGCTTTCTTT	CSAGSQGTEAFF	TRBV20-1	TRBJ1-1
TGTGCCAGAGAAGGTGTTGACACTGAAGCTTTCTTT	CAREGVDTEAFF	TRBV6-4	TRBJ1-1
TGTGCCAGCAGTTACAGGGGACCGGGACTAGCGGCGGATGAGCAGTTCTTC	CASSYRGPGLAADEQFF	TRBV6-5	TRBJ2-1
TGCGCCAGCAGCCCCCACCCATTGGGGGTTTCTTCCTACGAGCAGTACTTC	CASSPHPLGVSSYEQYF	TRBV10-1	TRBJ2-7
TGCGCCAGCAGCTTGCCCTGGCACGGTTTCCACCTCTCTGGAAACACCATATATTTT	CASSLPWHGFHLSGNTIYF	TRBV5-1	TRBJ1-3
TGTGCCAGCAGCCAGATGGCTGGGATGCAGTACTTC	CASSQMAGMQYF	TRBV14	TRBJ2-7
TGTGCCAGCAGGCACCAGGGGGACACTGAAGCTTTCTTT	CASRHQGDTEAFF	TRBV12-4	TRBJ1-1
TGCAGTGCTCCAGACAGGGAGGCTGAAGCTTTCTTT	CSAPDREAEAFF	TRBV20-1	TRBJ1-1
TGTGCCAGGCCCAATGAGCAGTTCTTC	CARPNEQFF	TRBV10-3	TRBJ2-1
TGTGCCTGGAGCTCTACCCAGGACAGCGCTTCGGGAGTTTGTCCGATTCAGCCCCAGCATTTT	CAWSSTQDSASGVCPIQPQHF	TRBV30	TRBJ1-5
TGTGCCAGCAGCGCTGCGGGCTACTACGAGCAGTACTTC	CASSAAGYYEQYF	TRBV7-4	TRBJ2-7
TGTGCCAGCAGTTTACGGTATATAACAGAGCAGTACTTC	CASSLRYITEQYF	TRBV28	TRBJ2-7
TGTGCCAGCAGTGCTCCGAGAAGCTCGAACTATGGCTACACCTTC	CASSAPRSSNYGYTF	TRBV6-1	TRBJ1-2
TGTGCCAGCAGTGAAGCGCATTTATCAGGGGAGCAGTTCTTC	CASSEAHLSGEQFF	TRBV6-1	TRBJ2-1
TGTGCCAGCAGTTTACCCCCCCCCACCGGAAGGGGTTGTGGAAACACCATATATTTT	CASSLPPPTGRGCGNTIYF	TRBV27	TRBJ1-3
TGTGCCAGCAGCTTAGGCCAGGGCGATGAGCAGTTCTTC	CASSLGQGDEQFF	TRBV7-2	TRBJ2-1
TGTGCCAGCAGTCCCCCAGGGGGTTGTACACAGCAGCCCCAGCATTTT	CASSPPGGCTQQPQHF	TRBV27	TRBJ1-5
TGTGCCAGCAGCTCCTTAGTCAGGGGGCTGGTCACGAGCACTGAAGCTTTCTTT	CASSSLVRGLVTSTEAFF	TRBV11-3	TRBJ1-1
TGCAGTGCACCCGGTCCCTCGGGGGGGGCGGGCACAGATACGCAGTATTTT	CSAPGPSGGAGTDTQYF	TRBV20-1	TRBJ2-3
TGTGCCAGCAGCACAGGCGTCCGGGACAGGGGCACAGATACGCAGTATTTT	CASSTGVRDRGTDTQYF	TRBV6-4	TRBJ2-3
TGTGCCACCAGTGATTTGACCCCAGGGGGGATAACCTACGAGCAGTACTTC	CATSDLTPGGITYEQYF	TRBV24-1	TRBJ2-7
TGCGCCAGCAGTGAGCTTATGGGAGGGCCCCACAATCAGCCCCAGCATTTT	CASSELMGGPHNQPQHF	TRBV10-1	TRBJ1-5
TGTGCCAGCAGGAGCAGGACTGAAGCTTTCTTT	CASRSRTEAFF	TRBV6-4	TRBJ1-1
TGTGCCAGCGGCATTCTTGGAAGGGGGGAATTGGGCAATCAGCCCCAGCATTTT	CASGILGRGELGNQPQHF	TRBV7-9	TRBJ1-5
TGCAGCCGGACAGGGCGACCCAACACTGAAGCTTTCTTT	CSRTGRPNTEAFF	TRBV20-1	TRBJ1-1
TGTGCCAGCAGTGAAGGTGGGTGGCGGGATGCGAATAGCAATCAGCCCCAGCATTTT	CASSEGGWRDANSNQPQHF	TRBV2	TRBJ1-5
TGTGCCAGCACGAAGAGGGGCAGCTCCTACAATGAGCAGTTCTTC	CASTKRGSSYNEQFF	TRBV7-8	TRBJ2-1
TGTGCCAGCAGGGGGGGGGGCCTCTACGAGCAGTACTTC	CASRGGGLYEQYF	TRBV12-4	TRBJ2-7
TGTGCCAGGCCACGCCAGAAACCGGCTAATGTTCTTAAGCAGTACTTC	CARPRQKPANVLKQYF	TRBV7-3	TRBJ2-7
TGTGCCAACCGGACAGATTTTGTGAATAGCAATCAGCCCCAGCATTTT	CANRTDFVNSNQPQHF	TRBV24-1	TRBJ1-5
TGTGCCAGCAGCGGTTCGGGACCTTGGCGGTACAATGAGCAGTTCTTC	CASSGSGPWRYNEQFF	TRBV7-3	TRBJ2-1
TGTGCCAGCAGCTTGCAAAAACTAGCGGGAGATTCACCCCTCCACTTT	CASSLQKLAGDSPLHF	TRBV5-6	TRBJ1-6
TGCGCCAGCAGTGTCGGGGACGAGCAGTACTTC	CASSVGDEQYF	TRBV10-1	TRBJ2-7
TGTGCCAGCAGTGACACCCCTACCGGGACGGACCGCTCAGATCAGCCCCAGCATTTT	CASSDTPTGTDRSDQPQHF	TRBV6-4	TRBJ1-5
TGCGCCAGCAGCCAAGGACCCAGCGGGAAAACCAGCTCCTACGAGCAGTACTTC	CASSQGPSGKTSSYEQYF	TRBV4-1	TRBJ2-7
TGTGCCAGCAGTGACGGACTAGCGGGCAATGAGCAGTTCTTC	CASSDGLAGNEQFF	TRBV6-4	TRBJ2-1
TGTGCCAGTACCAGGGACACACTGCCCGGCCGTTCTTCGAGCAATCAGCCCCAGCATTTT	CASTRDTLPGRSSSNQPQHF	TRBV19	TRBJ1-5
TGCAGTGGTCCAGCTCGGGGGAAAAGCTCCTACAATGAGCAGTTCTTC	CSGPARGKSSYNEQFF	TRBV20-1	TRBJ2-1
TGCAATTGGGACAGGGGGGAGGGCTTTATCTCTGGAAACACCATATATTTT	CNWDRGEGFISGNTIYF	TRBV20-1	TRBJ1-3
TGCAGCGTTGAGGCGGTGAGGGGGGGAGAAAAACTGTTTTTT	CSVEAVRGGEKLFF	TRBV29-1	TRBJ1-4
TGTGCCAGCAGACAGGAAAAACTGTTTTTT	CASRQEKLFF	TRBV28	TRBJ1-4
TGTGCCAGCAAAAGCCCGACGGGGGGCGGGGCCTACAATGAGCAGTTCTTC	CASKSPTGGGAYNEQFF	TRBV7-3	TRBJ2-1
TGTGCCAGCATCAGGCGGGAATATGGCTACACCTTC	CASIRREYGYTF	TRBV28	TRBJ1-2
TGCAGTGCTCTTCTACGGGATGGCTACACCTTC	CSALLRDGYTF	TRBV20-1	TRBJ1-2
TGTGCCACGACCGGGACCTGGGGGACTGAAGCTTTCTTT	CATTGTWGTEAFF	TRBV24-1	TRBJ1-1
TGTGCCATCAGGCCCGACAGGGTTAATAGCAATCAGCCCCAGCATTTT	CAIRPDRVNSNQPQHF	TRBV10-3	TRBJ1-5
TGCCGGCAAACTAACTATGGCTACACCTTC	CRQTNYGYTF	TRBV20-1	TRBJ1-2
TGCAGTGCTAGACAGGAATACCAAGAGACCCAGTACTTC	CSARQEYQETQYF	TRBV20-1	TRBJ2-5
TGTGCCTGCATCCTGGGGCGGAATCAGCCCCAGCATTTT	CACILGRNQPQHF	TRBV30	TRBJ1-5
TGTGCCAGCAGCCAAGATCCGGGGGTTAGCGGCAATCAGCCCCAGCATTTT	CASSQDPGVSGNQPQHF	TRBV3-1	TRBJ1-5
TGTGCCATCAGTCCGCAACCCAGGGAAGGGAGAGACCCCCAGCATTTT	CAISPQPREGRDPQHF	TRBV10-3	TRBJ1-5
TGTGCCAGCAGTGAAGTGACTGACAGGGACACTGAAGCTTTCTTT	CASSEVTDRDTEAFF	TRBV6-4	TRBJ1-1
TGCGCCCGTCGGGGAGGAAGTGAAGCTTTCTTT	CARRGGSEAFF	TRBV10-2	TRBJ1-1
TGCAGTGCTACAACGTGTAGTGTACAGGGCAAGCCTAGCACAGATACGCAGTATTTT	CSATTCSVQGKPSTDTQYF	TRBV20-1	TRBJ2-3
TGTGCCAGCAGTAGCCCCACTAGCGGGAGAGATACGCAGTATTTT	CASSSPTSGRDTQYF	TRBV6-3	TRBJ2-3
TGTGCCACACGGACAGGGGACTGGACCGGGGAGCTGTTTTTT	CATRTGDWTGELFF	TRBV27	TRBJ2-2
TGTGCCACCCTAGACAGGGCTGTCGGGGAGCTGTTTTTT	CATLDRAVGELFF	TRBV5-8	TRBJ2-2
TGTGCCAGCAGCACTTCTGGAAACACCATATATTTT	CASSTSGNTIYF	TRBV7-9	TRBJ1-3
TGTGCCAGCAGCGTAGGAAGAGGGGCTAGCGGGTTTGGAACGGATGAGCAGTTCTTC	CASSVGRGASGFGTDEQFF	TRBV9	TRBJ2-1
TGTGCCAGCAGTGCCAGGGGGCTGCATGACACTGAAGCTTTCTTT	CASSARGLHDTEAFF	TRBV6-4	TRBJ1-1
TGTGCCGCCGGGTCGGGGTTGTGGGAAGGGGACGAGCAGTACTTC	CAAGSGLWEGDEQYF	TRBV24-1	TRBJ2-7
TGTGCCACTTCGCTGTCCTCCTACGAGCAGTACTTC	CATSLSSYEQYF	TRBV24-1	TRBJ2-7
TGTGCCAGCAGCTTGAGGCCGGACAGGGGGCATGGCTACACCTTC	CASSLRPDRGHGYTF	TRBV5-4	TRBJ1-2
TGCGCCAGCAGCTTGACCAAAACCGGGACAAACGAGCAGTACTTC	CASSLTKTGTNEQYF	TRBV5-1	TRBJ2-7
TGTGCCAGCAGCTTCCGGGACAGGGTCTTGACAGATACGCAGTATTTT	CASSFRDRVLTDTQYF	TRBV7-4	TRBJ2-3
TGTGCCACCACAAGGGGGTCATACGAGCAGTACTTC	CATTRGSYEQYF	TRBV24-1	TRBJ2-7
TGTGCCAGCAGTTACATCTCTAGGACAGGGTTGCACGAGCAGTACTTC	CASSYISRTGLHEQYF	TRBV6-6	TRBJ2-7
TGTGCCACACCAGGGGTCATGTACACCAATGAGCAGTTCTTC	CATPGVMYTNEQFF	TRBV27	TRBJ2-1
TGCGCCAGCAGCTTGACCAGTCAGACAGGGTTCTACGAGCAGTACTTC	CASSLTSQTGFYEQYF	TRBV5-1	TRBJ2-7
TGTGCCAGCAGCTTAGGCAGAAGACAGGGGGCCAACGTCCTGACTTTC	CASSLGRRQGANVLTF	TRBV11-2	TRBJ2-6
TGTGCCAGCTATCAGGGCTATGAGCAGTACTTC	CASYQGYEQYF	TRBV6-5	TRBJ2-7
TGTGCCAGCAGTGGGGGGGGGGGGGGGAGCTCCTACAATGAGCAGTTCTTC	CASSGGGGGSSYNEQFF	TRBV5-4	TRBJ2-1
TGTGCCTGGGGGAACTGGGGGATAGGGACTGAAGCTTTCTTT	CAWGNWGIGTEAFF	TRBV30	TRBJ1-1
TGTGCCAGCAGTAACCAGCCCAATCAGCCCCAGCATTTT	CASSNQPNQPQHF	TRBV28	TRBJ1-5
TGTGCCAGCAGAGAAGGGTTAAACTATGGCTACACCTTC	CASREGLNYGYTF	TRBV6-3	TRBJ1-2
TGTGCCACCAGCGCGGGGAATCGCTACGAGCAGTACTTC	CATSAGNRYEQYF	TRBV15	TRBJ2-7
TGTGCCAGCAGTGACTCTCCCGGGGGCTCTACCCACGAGCAGTACTTC	CASSDSPGGSTHEQYF	TRBV6-4	TRBJ2-7
TGCAGCGTTCCAGCAGGGAACTCCTACGAGCAGTACTTC	CSVPAGNSYEQYF	TRBV29-1	TRBJ2-7
TGTGCCAGCAGCCCTAGCTCCTATAATTCACCCCTCCACTTT	CASSPSSYNSPLHF	TRBV6-5	TRBJ1-6
TGTGCCAGCAGCTCCGGGGACAGGGTACTGTTTTTT	CASSSGDRVLFF	TRBV9	TRBJ1-4
TGTGCCAGCAGTGAAAGCCCCCGACAGGGGGCAAATGGCTACACCTTC	CASSESPRQGANGYTF	TRBV6-1	TRBJ1-2
TGCAGTGGGACGAAGGAAAATTCACCCCTCCACTTT	CSGTKENSPLHF	TRBV20-1	TRBJ1-6
TGTGCCACCAGCCCGACAGGGCAGTCCGGGGAGCTGTTTTTT	CATSPTGQSGELFF	TRBV15	TRBJ2-2
TGCGCCAGCAGCCAAGCACGCTTGGAGGGACAGGGTAATTGGAACTACGAGCAGTACTTC	CASSQARLEGQGNWNYEQYF	TRBV4-1	TRBJ2-7
TGCGCCAGCACGGGGGGCCGGCACGAGCAGTACTTC	CASTGGRHEQYF	TRBV5-1	TRBJ2-7
TGCGCCAGCAGCTTCATCCGGGCCGGGACAGAAGCTTTCTTT	CASSFIRAGTEAFF	TRBV5-1	TRBJ1-1
TGCAGCCTAGCGGGCGGGCAGAGTTCCTACGAGCAGTACTTC	CSLAGGQSSYEQYF	TRBV29-1	TRBJ2-7
TGTGCCAGCAGCTTGGCACGGGCCTACAATGAGCAGTTCTTC	CASSLARAYNEQFF	TRBV5-6	TRBJ2-1
TGTGCCTGGAGATGGGGGGGGGAATCCTACGATACGCAGTATTTT	CAWRWGGESYDTQYF	TRBV30	TRBJ2-3
TGTGCCAGCAGGTCCCAGGACAGGGTACATGAAGGGGCCAACGTCCTGACTTTC	CASRSQDRVHEGANVLTF	TRBV6-1	TRBJ2-6
TGTGCCAGCATAAACGGGAGTGATGGCTACACCTTC	CASINGSDGYTF	TRBV2	TRBJ1-2
TGTGCCAGCAGGGGGCCGTTGTACCAAGAGACCCAGTACTTC	CASRGPLYQETQYF	TRBV11-3	TRBJ2-5
TGTGCCAGCAGCCCCCCTCATGGAGACAATGAGCAGTTCTTC	CASSPPHGDNEQFF	TRBV5-8	TRBJ2-1
TGCGCCAGCAGTAAATTCCTGCCGGAAGAGGAGGTAAAAGGGTCCTCTGGGGCCAACGTCCTGACTTTC	CASSKFLPEEEVKGSSGANVLTF	TRBV10-1	TRBJ2-6
TGTGCTAGTGGTCCAAAGGGACAGGGGGCTCTGAATGAGCAGTTCTTC	CASGPKGQGALNEQFF	TRBV12-5	TRBJ2-1
TGTGCCAGCAGTTGGCTTCCCTCCGGGTGGACAGGGGAAGCTTTCTTT	CASSWLPSGWTGEAFF	TRBV6-8	TRBJ1-1
TGCAGTGCTAGTCAGGGGTCAAACATTCAGTACTTC	CSASQGSNIQYF	TRBV20-1	TRBJ2-4
TGTGCCAGCAGTCGAGGACGAGAGGCTGGCTACGAGCAGTACTTC	CASSRGREAGYEQYF	TRBV28	TRBJ2-7
TGCAGTGCTAGAGCTAGGGGTCGAGTCGAGTATGGCTACACCTTC	CSARARGRVEYGYTF	TRBV20-1	TRBJ1-2
TGTGCCATCAGGCCGGGCAATGAGCAGTTCTTC	CAIRPGNEQFF	TRBV10-3	TRBJ2-1
TGTGCCAGCAGCGATTGGAAAACTCCGAAAGCCTACGAGCAGTACTTC	CASSDWKTPKAYEQYF	TRBV9	TRBJ2-7
TGTGCCACCAGTGATTTAGACAGGGGGGGGCGCACAGATACGCAGTATTTT	CATSDLDRGGRTDTQYF	TRBV24-1	TRBJ2-3
TGTGCCAGCAATTCCCCGGGGCTCACAGATACGCAGTATTTT	CASNSPGLTDTQYF	TRBV27	TRBJ2-3
TGTGCCAGCAGCATTAAGGAAGAGCAGTTCTTC	CASSIKEEQFF	TRBV7-3	TRBJ2-1
TGTGCCAGCAGCAGTGACGACAGCTCCGGGGATCAGCCCCAGCATTTT	CASSSDDSSGDQPQHF	TRBV11-3	TRBJ1-5
TGTGCCACCAGTGATAACGCAGGGGATGGCTACACCTTC	CATSDNAGDGYTF	TRBV24-1	TRBJ1-2
TGTGCCAGCGAGCCGGGACAGTGTTCAGATACGCAGTATTTT	CASEPGQCSDTQYF	TRBV6-3	TRBJ2-3
TGTGCCAGCAGTTACGACCCCCCTTCTCGCGAAAATGGGCCCCAGCATTTT	CASSYDPPSRENGPQHF	TRBV6-6	TRBJ1-5
TGTGCCAGCATCGGAGGCGAAGAAAAACTGTTTTTT	CASIGGEEKLFF	TRBV6-5	TRBJ1-4
TGTGCCAGCAGCCAAAGAATGAAAAACAGCGATCAGCCCCAGCATTTT	CASSQRMKNSDQPQHF	TRBV3-1	TRBJ1-5
TGTGCCAGCTCACCCCGGGAGGTTTACTACGAGCAGTACTTC	CASSPREVYYEQYF	TRBV18	TRBJ2-7
TGTGCCAGCAGCCGTTACGACAGGGGGCGCCGGGGCGAAAAACTGTTTTTT	CASSRYDRGRRGEKLFF	TRBV3-1	TRBJ1-4
TGTGCCAGCAGCTTGGGGGCCACAACCGGGGAGCTGTTTTTT	CASSLGATTGELFF	TRBV13	TRBJ2-2
TGTGCCTCACGAGGTATGTTTGCCTACAATGAGCAGTTCTTC	CASRGMFAYNEQFF	TRBV6-4	TRBJ2-1
TGTGCCACCAGTGGAGTGGTCGGGGGAAGCACGGCGTTCAATGAGCAGTTCTTC	CATSGVVGGSTAFNEQFF	TRBV24-1	TRBJ2-1
TGTGCCAGCAGCTTAACTAGAACCTGGCATACGCAGTATTTT	CASSLTRTWHTQYF	TRBV7-9	TRBJ2-3
TGTGCTAGTGGTTTGGGGGGGGAAGCTTTCTTT	CASGLGGEAFF	TRBV12-5	TRBJ1-1
TGTGCCAGCAGCTGTTGGCTAGGACAGGGTACTTGCTCCTACGAGCAGTACTTC	CASSCWLGQGTCSYEQYF	TRBV7-9	TRBJ2-7
TGTGCCAGCAGTTCGCCGGGACAGGGCGGGGACCCTAAGGACACTGAAGCTTTCTTT	CASSSPGQGGDPKDTEAFF	TRBV27	TRBJ1-1
TGTGCCAGCAGCTGCGGGAGCTGGGCCGTGAATGAGCAGTTCTTC	CASSCGSWAVNEQFF	TRBV7-2	TRBJ2-1
TGTGCCAGCAGAGCTAGCGGGAGGTACGAGCAGTACTTC	CASRASGRYEQYF	TRBV6-5	TRBJ2-7
TGTGCCTGGAGTTGGGTGGCTAACAGGGCGGAGAGTAATGGCTACACCTTC	CAWSWVANRAESNGYTF	TRBV30	TRBJ1-2
TGTGCCAGTACTTCCCTTCGGACAGGGGTGAAGAAGAACACTGAAGCTTTCTTT	CASTSLRTGVKKNTEAFF	TRBV19	TRBJ1-1
TGTGCCAGCAGCTACCCACTAGCGGGAGAGGTTTCGACCTACGAGCAGTACTTC	CASSYPLAGEVSTYEQYF	TRBV7-6	TRBJ2-7
TGCGCCAGCATAGAGAGCGGGATGTGGGGTCAGGAGCAGTACTTC	CASIESGMWGQEQYF	TRBV10-1	TRBJ2-7
TGTGCCTGGAGGTTAGTTGATACGGGAGTTTTAAAGTACGAGCAGTACTTC	CAWRLVDTGVLKYEQYF	TRBV30	TRBJ2-7
TGTGCCAGCAGTTACAATGTGGGACAGGGGGCGCCAGGGGAGACCCAGTACTTC	CASSYNVGQGAPGETQYF	TRBV6-5	TRBJ2-5
TGTGCCAGCAGTGAAGTACGGCGCTGCAGACCCACTAGACCAGCTAGTAAGGCAAAGGATGAGCAGTTCTTC	CASSEVRRCRPTRPASKAKDEQFF	TRBV6-1	TRBJ2-1
TGTGCCAGCAGTTATTTAAAAGGGCTAGCCAAAAACATTCAGTACTTC	CASSYLKGLAKNIQYF	TRBV6-5	TRBJ2-4
TGTGCCACCAGCGGCGACCAGATGCTATTGGGAGGGCGGGCCTACGAGCAGTACTTC	CATSGDQMLLGGRAYEQYF	TRBV15	TRBJ2-7
TGCGCCAGCAGCTTGGGACACTTAGGCTCTGGAAACACCATATATTTT	CASSLGHLGSGNTIYF	TRBV5-1	TRBJ1-3
TGTGCCAGCAGCCAAGTTCAGACAGGGGGTTGCAATCAGCCCCAGCATTTT	CASSQVQTGGCNQPQHF	TRBV4-2	TRBJ1-5
TGTGCCAGCAGTGACTCTGCGGACCTGTCTATATACTATGGCTACACCTTC	CASSDSADLSIYYGYTF	TRBV6-4	TRBJ1-2
TGTGCTCCGAGGACAGGGCCCTACAATGAGCAGTTCTTC	CAPRTGPYNEQFF	TRBV6-4	TRBJ2-1
TGCGCCAGGGGGTCGCATTCACCCCTCCACTTT	CARGSHSPLHF	TRBV10-1	TRBJ1-6
TGCAGGACCACAAGCGGGACGACAGATACGCAGTATTTT	CRTTSGTTDTQYF	TRBV20-1	TRBJ2-3
TGTGCCAGCACAGGGGGAATCCACGAAAAACTGTTTTTT	CASTGGIHEKLFF	TRBV6-4	TRBJ1-4
TGTGCCACCAGACGGACGCCAGATACGCAGTATTTT	CATRRTPDTQYF	TRBV24-1	TRBJ2-3
TGTGCCAGCAGCGCGTCTCCGGGACAGGGACGCCCGACAGATACGCAGTATTTT	CASSASPGQGRPTDTQYF	TRBV7-3	TRBJ2-3
TGTGCCAGCAGTCGGGAAACCCTCTCCAGGGGGGGCACTGAAGCTTTCTTT	CASSRETLSRGGTEAFF	TRBV27	TRBJ1-1
TGTGCCAGCAGCGGGGACCCACTAGCGGGCTTTTTGGCAAACACCGGGGAGCTGTTTTTT	CASSGDPLAGFLANTGELFF	TRBV7-3	TRBJ2-2
TGTGCCTGGCATAAGGAGGATGAAAAACTGTTTTTT	CAWHKEDEKLFF	TRBV30	TRBJ1-4
TGTGCCAGCAGCTTGGGCAAGCCGGACAGGGCACAGCAGTACTTC	CASSLGKPDRAQQYF	TRBV7-9	TRBJ2-7
TGTGCCAGCAGCCAAGATTTCCGCCCGGGACAGGGGCAAGAGACCCAGTACTTC	CASSQDFRPGQGQETQYF	TRBV14	TRBJ2-5
TGTGCCAGCAGGCTGAGGAGCACAGATACGCAGTATTTT	CASRLRSTDTQYF	TRBV28	TRBJ2-3
TGCAGTGCTAGAGCAGCCCGGGACAACGAGCAGTACTTC	CSARAARDNEQYF	TRBV20-1	TRBJ2-7
TGTGCCAGCAGCTTGCTGGACAGGGAGGCCTACGAGCAGTACTTC	CASSLLDREAYEQYF	TRBV5-4	TRBJ2-7
TGTGCCAGCAGCGTGAGGGGGAGCGACTACAATGAGCAGTTCTTC	CASSVRGSDYNEQFF	TRBV13	TRBJ2-1
TGTGCCTGGAGTGTAGGAATCCCGGGACAGGAGGACAATGAGCAGTTCTTC	CAWSVGIPGQEDNEQFF	TRBV30	TRBJ2-1
TGTGCTAGTGGTTTAAAAAGGCCGAGTGGAAACACCATATATTTT	CASGLKRPSGNTIYF	TRBV12-5	TRBJ1-3
TGTGCCAGCAGCCAGACAGGGGAAGCCCCCCAGCATTTT	CASSQTGEAPQHF	TRBV14	TRBJ1-5
TGCAGTGCCGGGACAGCAGCTTTCTTT	CSAGTAAFF	TRBV20-1	TRBJ1-1
TGTGCCAGCGTCAGCGGGAGGCGCAATCAGCCCCAGCATTTT	CASVSGRRNQPQHF	TRBV6-4	TRBJ1-5
TGTGCCAGCAGCTTATCACGGGACAGGGCCTTCTCTGGAAACACCATATATTTT	CASSLSRDRAFSGNTIYF	TRBV7-2	TRBJ1-3
TGTGCCAGCAGTGACTCCCGAGGGTCCTACGAGCAGTACTTC	CASSDSRGSYEQYF	TRBV6-4	TRBJ2-7
TGTGCCAGCAGCACCTCTATAGATACGCAGTATTTT	CASSTSIDTQYF	TRBV13	TRBJ2-3
TGTGCCAGCAGCACGGGGCAGGTAATAGATACGCAGTATTTT	CASSTGQVIDTQYF	TRBV7-8	TRBJ2-3
TGTGCCAGCTCACCAGGGAGTGGGGGGTGGCGTTGGATGAACACTGAAGCTTTCTTT	CASSPGSGGWRWMNTEAFF	TRBV18	TRBJ1-1
TGTGCCAGTCCTTTATATCTCTACGAGCAGTACTTC	CASPLYLYEQYF	TRBV19	TRBJ2-7
TGTGCCAGCAGCGTATCCAGGGCAGATTCACCCCTCCACTTT	CASSVSRADSPLHF	TRBV13	TRBJ1-6
TGTGCCAGCAGTAAGAAGGAAGGACCGTACTTC	CASSKKEGPYF	TRBV12-4	TRBJ2-5
TGTGCCAGCCTCCCGGGACAGGCCTCTAACTATGGCTACACCTTC	CASLPGQASNYGYTF	TRBV27	TRBJ1-2
TGTGCCAGCAGTTTCCGGGTGGATGCAGATACGCAGTATTTT	CASSFRVDADTQYF	TRBV12-3	TRBJ2-3
TGTGCCAGTAGTATGAGGCCGGGACCACCCTACGAGCAGTACTTC	CASSMRPGPPYEQYF	TRBV19	TRBJ2-7
TGTGCCAGCAGTGACATTGTAGCCAGCAGCAATGAGCAGTTCTTC	CASSDIVASSNEQFF	TRBV6-4	TRBJ2-1
TGTGCCAGCAGCCTTCAGGGGTGTAGCAATCAGCCCCAGCATTTT	CASSLQGCSNQPQHF	TRBV13	TRBJ1-5
TGTGCCAGCAGCCGCAGGGCCAGGGAGCAGTACTTC	CASSRRAREQYF	TRBV9	TRBJ2-7
TGTGCCACAAGGGTTGCCTACGAGCAGTACTTC	CATRVAYEQYF	TRBV15	TRBJ2-7
TGCAGTGCTAGAGATCCCGATCAGGGACGGAGCTCCTACGAGCAGTACTTC	CSARDPDQGRSSYEQYF	TRBV20-1	TRBJ2-7
TGTGCCAGCAGCTTAATTGGACCTAGCGGGAATGAGCCACTGAACACAGATACGCAGTATTTT	CASSLIGPSGNEPLNTDTQYF	TRBV7-7	TRBJ2-3
TGTGCCAGCAGCTACAGGGGGTTGCAGTACTTC	CASSYRGLQYF	TRBV6-1	TRBJ2-7
TGTGCCAGCAGCTCGATCGAAATACAGGGTGACGAGCAGTACTTC	CASSSIEIQGDEQYF	TRBV11-3	TRBJ2-7
TGCGCCAGCAGCCAAGATGGAACTAGCGGGAGGGCTCAGCCATCTAGCTCCTACAATGAGCAGTTCTTC	CASSQDGTSGRAQPSSSYNEQFF	TRBV4-1	TRBJ2-1
TGCAGTGCTAGGTTGCTCGGGACAGCAGGGACCGAGTCTGGGCTGTTTTTT	CSARLLGTAGTESGLFF	TRBV20-1	TRBJ1-4
TGTGCCAGCAGTGACTTTCCTAGAAACCACAATGAGCAGTTCTTC	CASSDFPRNHNEQFF	TRBV6-4	TRBJ2-1
TGCAGTGCTAGACTCGGCATAATTCAAGAGACCCAGTACTTC	CSARLGIIQETQYF	TRBV20-1	TRBJ2-5
TGTGCCATCAAGGACAGGGACACTGAAGCTTTCTTT	CAIKDRDTEAFF	TRBV10-3	TRBJ1-1
TGCGCCAGTACTAGACCTGAGCAGTTCTTC	CASTRPEQFF	TRBV10-1	TRBJ2-1
TGCGCCAGCAACCGGGATGGCTACACCTTC	CASNRDGYTF	TRBV10-1	TRBJ1-2
TGTGCCAGCAGCCGAGGGGGCGATGGCTACACCTTC	CASSRGGDGYTF	TRBV7-2	TRBJ1-2
TGTGCCAGCAGTTTAGTAGGACGACAAGAAGAGACCCAGTACTTC	CASSLVGRQEETQYF	TRBV12-4	TRBJ2-5
TGTGCCAGCAGCGGGTCCCGGGACAGGGGGCCCTACGAGCAGTACTTC	CASSGSRDRGPYEQYF	TRBV13	TRBJ2-7
TGTGCCAGCAGCCTCGGAGCCTCCTATGGCTACACCTTC	CASSLGASYGYTF	TRBV7-4	TRBJ1-2
TGCGCCGCGAACAGGGGGGGCAACTCTGGAAACACCATATATTTT	CAANRGGNSGNTIYF	TRBV4-3	TRBJ1-3
TGCAGTTCCCCTTTTTACGGCTCCTATACGCAGTATTTT	CSSPFYGSYTQYF	TRBV20-1	TRBJ2-3
TGTGCCAGCAGTAAGACGGACCCCTACGAGCAGTACTTC	CASSKTDPYEQYF	TRBV6-1	TRBJ2-7
TGTGCCACCAGTCTCGCTAGGAGGCTAAGCGAGCAGTACTTC	CATSLARRLSEQYF	TRBV24-1	TRBJ2-7
TGTGCCAGCACCTTGCAGAGAAATGAGCAGTTCTTC	CASTLQRNEQFF	TRBV3-1	TRBJ2-1
TGTGCCAGCAAGAGTACCTTTCTGATTCCCGAGCAGTACTTC	CASKSTFLIPEQYF	TRBV6-1	TRBJ2-7
TGTGCCACCAGTGACCTCGGGGGGGCGGGTTACGAGCAGTACTTC	CATSDLGGAGYEQYF	TRBV24-1	TRBJ2-7
TGTGCCAGCATACCAATAGACAGGGAGTACAATGAGCAGTTCTTC	CASIPIDREYNEQFF	TRBV2	TRBJ2-1
TGTGCCAGCAGTGAGGGGCGGGAAATTGCCACTGAAGCTTTCTTT	CASSEGREIATEAFF	TRBV6-1	TRBJ1-1
TGTGCCTGGCACAAAATGGGGGAGTCACCCCTCCACTTT	CAWHKMGESPLHF	TRBV30	TRBJ1-6
TGCAGTGCTGGCTTGGCCGCTTTGGACTTAATCTACGAGCAGTACTTC	CSAGLAALDLIYEQYF	TRBV20-1	TRBJ2-7
TGTGCCAGCGGGGGTTTAGCGTACTTC	CASGGLAYF	TRBV3-1	TRBJ2-7
TGTGCTAGTGGTTTGCACAGGGCTGGGAGGACCTACGAGCAGTACTTC	CASGLHRAGRTYEQYF	TRBV12-5	TRBJ2-7
TGTGCCGCACACCCATGGGAGCGGACCTACGAGCAGTACTTC	CAAHPWERTYEQYF	TRBV19	TRBJ2-7
TGTGCCAGCAGGGCGAGCAGGGATAGGACTAATGGCTACACCTTC	CASRASRDRTNGYTF	TRBV25-1	TRBJ1-2
TGTGCCAGCAGTTTATGCACCGCCCAGGGGCGGGGGGCCAACGTCCTGACTTTC	CASSLCTAQGRGANVLTF	TRBV28	TRBJ2-6
TGTGCGGGGTGCTACGAGCAGTACTTC	CAGCYEQYF	TRBV28	TRBJ2-7
TGTGCCAGCACCCGGAGGACTAATGAAAAACTGTTTTTT	CASTRRTNEKLFF	TRBV27	TRBJ1-4
TGTGCCAGCAGAATTCCTAGGGGCTACAATGAGCAGTTCTTC	CASRIPRGYNEQFF	TRBV28	TRBJ2-1
TGTGCCAGCAGCACACGACTAGCGGGGGACAAAAACATTCAGTACTTC	CASSTRLAGDKNIQYF	TRBV11-3	TRBJ2-4
TGTGCCAGCAGCCAAGATCTCACAGGTTTAGAGCTTTACGAGCAGTACTTC	CASSQDLTGLELYEQYF	TRBV14	TRBJ2-7
TGCAGCGTTGAGTCAGTGGGACAGTATGCCTACGAGCAGTACTTC	CSVESVGQYAYEQYF	TRBV29-1	TRBJ2-7
TGTGCCAGCAGTTCCCACGGCAGAAGGTATGGCTACACCTTC	CASSSHGRRYGYTF	TRBV27	TRBJ1-2
TGTGCCAGCAGTTGGGGCCGAAAGTGGAACACCGGGGAGCTGTTTTTT	CASSWGRKWNTGELFF	TRBV27	TRBJ2-2
TGTGCCACCGTACAACCGGGACTAGGCACAGATACGCAGTATTTT	CATVQPGLGTDTQYF	TRBV24-1	TRBJ2-3
TGTGCCAGCAGCCAGGGGGAATTGGGAATGGGGGACAGGGGAATTCACGAGCAGTACTTC	CASSQGELGMGDRGIHEQYF	TRBV13	TRBJ2-7
TGTGCCAGCAGCTTAGTGCAGGGACAGGGAGCTAACTATGGCTACACCTTC	CASSLVQGQGANYGYTF	TRBV7-6	TRBJ1-2
TGTGCCAGCAGAGGAAGGGGACGACTCAACGAGCAGTACTTC	CASRGRGRLNEQYF	TRBV14	TRBJ2-7
TGCAATCTAGGACAGGATTCACCCCTCCACTTT	CNLGQDSPLHF	TRBV20-1	TRBJ1-6
TGTGCCAGCAGACAGGGGACCTACGAGCAGTACTTC	CASRQGTYEQYF	TRBV6-2	TRBJ2-7
TGTGCCAGCAGCTTGAGCGGGAACCGAGCTAACTATGGCTACACCTTC	CASSLSGNRANYGYTF	TRBV7-9	TRBJ1-2
TGTGCCAGCACTGTGCGTATGATAGGCACCGGGGAGCTGTTTTTT	CASTVRMIGTGELFF	TRBV6-5	TRBJ2-2
TGTGCCAGCATCAGTGCCAGGGGCATGGAGCAGTACTTC	CASISARGMEQYF	TRBV4-2	TRBJ2-7
TGTGCCAGCAGTGAAGGGGATACGAGGTTTCCCGACTATAATTCACCCCTCCACTTT	CASSEGDTRFPDYNSPLHF	TRBV6-1	TRBJ1-6
TGTGCCAGCAGTGACTCGGAGGAGGGGCGCCAAGAATATAATTCACCCCTCCACTTT	CASSDSEEGRQEYNSPLHF	TRBV6-4	TRBJ1-6
TGCGCCAGCAGCCTTCTAGCGGGTGCGAAGCCCGGGGAGCTGTTTTTT	CASSLLAGAKPGELFF	TRBV4-3	TRBJ2-2
TGCGCCAGCAGCTGCAACGGCCAGGGCGGTTCACCCCTCCACTTT	CASSCNGQGGSPLHF	TRBV5-1	TRBJ1-6
TGTGCCAGCAGTAAGGGACGGGGGGGATGGAAGTGTATTGAGAATGAAAAACTGTTTTTT	CASSKGRGGWKCIENEKLFF	TRBV25-1	TRBJ1-4
TGTGCCAGCAGCTTGGGACAGACGGAAACTGAAGCTTTCTTT	CASSLGQTETEAFF	TRBV7-2	TRBJ1-1
TGTGCCAGCAGTACCAAATCCACTAGCCAAGAGCAGTACTTC	CASSTKSTSQEQYF	TRBV6-5	TRBJ2-7
TGCGCCTTGGGGAATTTTCCATACGCCTACGAGCAGTACTTC	CALGNFPYAYEQYF	TRBV10-1	TRBJ2-7
TGCGCCAGCAGCCAAGAGGAACCGGGTCCTAACTATGGCTACACCTTC	CASSQEEPGPNYGYTF	TRBV4-3	TRBJ1-2
TGTGCCAGCATACGAGGGAGACTGAGATATAGCAATCAGCCCCAGCATTTT	CASIRGRLRYSNQPQHF	TRBV27	TRBJ1-5
TGCGCCAGCAGCTTGAAGCGGCTAAAAGATACGCAGTATTTT	CASSLKRLKDTQYF	TRBV5-1	TRBJ2-3
TGTGCCAGCAGCTTAGAGTACAGGGGCACTGAAGCTTTCTTT	CASSLEYRGTEAFF	TRBV11-3	TRBJ1-1
TGTGCCAGCAGCTTGCACGACTCTGGGGCCAACGTCCTGACTTTC	CASSLHDSGANVLTF	TRBV5-6	TRBJ2-6
TGTGCCAGCAGTCTAGGGGCTTTCGGGACACCCACCTCTGGAAACACCATATATTTT	CASSLGAFGTPTSGNTIYF	TRBV12-4	TRBJ1-3
TGTGCCAGCTCACCCGCAGTTACGAATGAAAAACTGTTTTTT	CASSPAVTNEKLFF	TRBV18	TRBJ1-4
TGTGCCAGCAGTAAGGGGCGTATCGAATACGAGCAGTACTTC	CASSKGRIEYEQYF	TRBV6-4	TRBJ2-7
TGTGCCAGCAGCCCTGGGGGACAGGGCTACAATGAGCAGTTCTTC	CASSPGGQGYNEQFF	TRBV7-9	TRBJ2-1
TGTGCCAGCAGCCCAAACAGGGGCTCCTACGAGCAGTACTTC	CASSPNRGSYEQYF	TRBV5-4	TRBJ2-7
TGTGCCTGGAGGCCGGCGGGCCACTGTAGAAGGACCCAGTACTTC	CAWRPAGHCRRTQYF	TRBV30	TRBJ2-5
TGCGCCAGCTGTACCGGGGGAACCTACGAGCAGTACTTC	CASCTGGTYEQYF	TRBV10-1	TRBJ2-7
TGCAGCGTTATCGTCCCAGTAGTAACAGGGGGCTTTAATCAGCCCCAGCATTTT	CSVIVPVVTGGFNQPQHF	TRBV29-1	TRBJ1-5
TGCGCCAGCAGCTGGGTGGGTTTCTATGGCTACACCTTC	CASSWVGFYGYTF	TRBV5-1	TRBJ1-2
TGTGCCACCAGTTTCGGGACGGTCCCAGCCATGAAGGCTGGGGCCAACGTCCTGACTTTC	CATSFGTVPAMKAGANVLTF	TRBV24-1	TRBJ2-6
TGTGCCAGCAGTTACCGGGACAGGGAGTTAACTAATGAAAAACTGTTTTTT	CASSYRDRELTNEKLFF	TRBV27	TRBJ1-4
TGTGCCAGCAGTTTTAGGACAGGGGTCCATCAGCCCCAGCATTTT	CASSFRTGVHQPQHF	TRBV28	TRBJ1-5
TGTGCCAGCAGTGAAGTTACGCATGTCCATCCCTCTGGGGCCAACGTCCTGACTTTC	CASSEVTHVHPSGANVLTF	TRBV6-1	TRBJ2-6
TGTGCCAGCAGTTACGACTGGGGCGGTGGCTACACCTTC	CASSYDWGGGYTF	TRBV6-2	TRBJ1-2
TGTGCCAGCAGCTTGCACTCCCTTGGACACTCCTACGAGCAGTACTTC	CASSLHSLGHSYEQYF	TRBV5-4	TRBJ2-7
TGTGCCAGCAGCTTGCCGCCAGGGGCGCGGCATTCACCCCTCCACTTT	CASSLPPGARHSPLHF	TRBV5-6	TRBJ1-6
TGTGCCAGTAGTAGTGTGGAGGGGGCTGAAGCTTTCTTT	CASSSVEGAEAFF	TRBV19	TRBJ1-1
TGTGCCAGCAGTCCCGCGGGAGACAGCACCGGGGAGCTGTTTTTT	CASSPAGDSTGELFF	TRBV27	TRBJ2-2
TGTGCCAGCAGCCAATTAGGACGAGCAACTAATGAAAAACTGTTTTTT	CASSQLGRATNEKLFF	TRBV3-1	TRBJ1-4
TGTGCCAGTATCGGACATACCGAAAAACTGTTTTTT	CASIGHTEKLFF	TRBV19	TRBJ1-4
TGTGCCAGTAGTGAACAGGTCAGGAACACTGAAGCTTTCTTT	CASSEQVRNTEAFF	TRBV19	TRBJ1-1
TGTGCCAGCAGTCCAGGGACGGAAAATCAGCCCCAGCATTTT	CASSPGTENQPQHF	TRBV28	TRBJ1-5
TGTGCCAGCAGTTACCGGGACAGCCCCCCCCCTCTCTATGGCTACACCTTC	CASSYRDSPPPLYGYTF	TRBV6-2	TRBJ1-2
TGTGCCCAGGCAGGTGGAGGGAACACTGAAGCTTTCTTT	CAQAGGGNTEAFF	TRBV5-4	TRBJ1-1
TGTGCCAGTATTTGGCAGACGAACACCGGGGAGCTGTTTTTT	CASIWQTNTGELFF	TRBV2	TRBJ2-2
TGTGCCAGCAGTTTGGGGGCGGGGAGATACGAGCAGTACTTC	CASSLGAGRYEQYF	TRBV27	TRBJ2-7
TGCGCCAGCAGCCATCAGTTTGGGAGGGCTGGATTCGCCAAAAACATTCAGTACTTC	CASSHQFGRAGFAKNIQYF	TRBV4-1	TRBJ2-4
TGTGCCAGCAGTTTAGCCCCCCGGCAGAGTGACCTGTTTTTT	CASSLAPRQSDLFF	TRBV12-3	TRBJ1-4
TGTGCCAGCAGCTGGGTAAAAACAGGGAGCTCATACGAGCAGTACTTC	CASSWVKTGSSYEQYF	TRBV13	TRBJ2-7
TGTGCCAGCAGTGTAACACTAGCGGGAGTCGGCTTGGTGAACTATGGCTACACCTTC	CASSVTLAGVGLVNYGYTF	TRBV25-1	TRBJ1-2
TGTGCCAGCAGCTTAAGCTGTAGACCGAACACCGGGGAGCTGTTTTTT	CASSLSCRPNTGELFF	TRBV11-2	TRBJ2-2
TGTGCCAGCAGTGACCCCCCGGGCAGGGTGGATACAGAGACCCAGTACTTC	CASSDPPGRVDTETQYF	TRBV6-4	TRBJ2-5
TGTGCCAGCAGCACAGGGGCCCGGGCCTACGAGCAGTACTTC	CASSTGARAYEQYF	TRBV7-3	TRBJ2-7
TGCGCCAGCAGCACTAAAATCGGGAAACCGGCTGGAAACACCATATATTTT	CASSTKIGKPAGNTIYF	TRBV5-1	TRBJ1-3
TGTGCCACTCCCCTCCAGGGGAATTCACCCCTCCACTTT	CATPLQGNSPLHF	TRBV27	TRBJ1-6
TGTGCCAGCAGCTTAACCCCGGAGGGAGAAATTACTGAAGCTTTCTTT	CASSLTPEGEITEAFF	TRBV11-2	TRBJ1-1
TGTGCCAGCAGCATAAGAGGATATGGCTACACCTTC	CASSIRGYGYTF	TRBV7-7	TRBJ1-2
TGCGCCAGCAGTGAGCACTTAGTCTGGGTCAGGGGCTACAATGAGCAGTTCTTC	CASSEHLVWVRGYNEQFF	TRBV10-1	TRBJ2-1
TGTGCCAGCAGCCAAGACGTAAGGTGGACAGGGGGTGACCCCTCCTACGAGCAGTACTTC	CASSQDVRWTGGDPSYEQYF	TRBV14	TRBJ2-7
TGTGCCAGCAGTTACGACAGGGGAGGTGACTATGAAGCTTTCTTT	CASSYDRGGDYEAFF	TRBV6-8	TRBJ1-1
TGTGCCAGCAGTTACTCGAAAAGGGATAGGCCAGCGAGCAGCTCCTACGAGCAGTACTTC	CASSYSKRDRPASSSYEQYF	TRBV6-5	TRBJ2-7
TGTGCCAGGGGGCGAGGGGGAGCTTTCTTT	CARGRGGAFF	TRBV6-4	TRBJ1-1
TGTGCCAGTAGTATAAAATGTCCGGGAAGGACCGGGGAGCTGTTTTTT	CASSIKCPGRTGELFF	TRBV19	TRBJ2-2
TGCAGCGTCCGTCGGACAGGGGGCTACACCTTC	CSVRRTGGYTF	TRBV29-1	TRBJ1-2
TGCGCCAGCAGCCTCAGTACAAAGGACAGGAACGAGCAGTACTTC	CASSLSTKDRNEQYF	TRBV4-1	TRBJ2-7
TGTGCCAGCAGCTACGACGAAACCTCGGACAGGGTAAACACCGAGCAGTACTTC	CASSYDETSDRVNTEQYF	TRBV5-4	TRBJ2-7
TGTGCCAGCAGTTTTAACTTAGATGGGTCGGGAATGAACACTGAAGCTTTCTTT	CASSFNLDGSGMNTEAFF	TRBV28	TRBJ1-1
TGTGCCATCACCTCGGGCCGGTATGAAAAACTGTTTTTT	CAITSGRYEKLFF	TRBV10-3	TRBJ1-4
TGTGCCAGCAGCCCAAGGGGGGAAGAGACCCAGTACTTC	CASSPRGEETQYF	TRBV13	TRBJ2-5
TGTGCCAGCAGTTTAGCCCCCGTGACAGGGGGCTTGCCCCAGCATTTT	CASSLAPVTGGLPQHF	TRBV27	TRBJ1-5
TGTGCTAGTGGTTTGGTACCGGTAAGGGTCCAAGAGACCCAGTACTTC	CASGLVPVRVQETQYF	TRBV12-5	TRBJ2-5
TGTGCCAGCAGCTTAGTCAAGCGGGAGCAGTTCTTC	CASSLVKREQFF	TRBV11-2	TRBJ2-1
TGTGCCAGCAGTGACCGGCAACCAACTAACGGCACAGATACGCAGTATTTT	CASSDRQPTNGTDTQYF	TRBV6-4	TRBJ2-3
TGTGCCAGCAGACCGGGCACAGGGAAGGACAATCAGCCCCAGCATTTT	CASRPGTGKDNQPQHF	TRBV6-4	TRBJ1-5
TGCAGCAACTGGGACAGGGGGCTGACGGTACACGCCCACTCTAACTATGGCTACACCTTC	CSNWDRGLTVHAHSNYGYTF	TRBV29-1	TRBJ1-2
TGTGCCAGCAACTTTTGGGGGGTAGCCAAAAACATTCAGTACTTC	CASNFWGVAKNIQYF	TRBV6-5	TRBJ2-4
TGTGCCAGCAGTGACGGCCCGGGACTAGCGGGTGAGTACTTC	CASSDGPGLAGEYF	TRBV6-4	TRBJ2-5
TGTGCCAGCAGCCGCCCGAACCGGGACAGGGCGTTATGCCCAGAGACCCAGTACTTC	CASSRPNRDRALCPETQYF	TRBV14	TRBJ2-5
TGTGCCAGCAGTCTCAAGTACAGGGACGAGAACACTGAAGCTTTCTTT	CASSLKYRDENTEAFF	TRBV12-4	TRBJ1-1
TGTGCCAGCAGAGACAGGGAAAAGCAGTACTTC	CASRDREKQYF	TRBV9	TRBJ2-7
TGTGCCAGCAGCCTGACTGTCCGGGACAGGGTAACGAACTATGGCTACACCTTC	CASSLTVRDRVTNYGYTF	TRBV14	TRBJ1-2
TGTGCCAGCAGTTACGTAGACAGGGTCTCTGAAAAACTGTTTTTT	CASSYVDRVSEKLFF	TRBV6-5	TRBJ1-4
TGCAGTGCTAGAGTCTATGGCGACTATGGCTACACCTTC	CSARVYGDYGYTF	TRBV20-1	TRBJ1-2
TGTGCCAGCAGTTCGAAACAGGGGGCGGACTATGGCTACACCTTC	CASSSKQGADYGYTF	TRBV6-9	TRBJ1-2
TGTGCCAGCAGCAGGGAGGGCGCCAACACCGGGGAGCTGTTTTTT	CASSREGANTGELFF	TRBV13	TRBJ2-2
TGTGCCAGCAGAAAGCGGGGTGGCTACGAGCAGTACTTC	CASRKRGGYEQYF	TRBV9	TRBJ2-7
TGCAGTGAAGTCGCCCCAAAAGCGGGGGCGGGGGGTGAGAACGAGCAGTACTTC	CSEVAPKAGAGGENEQYF	TRBV20-1	TRBJ2-7
TGTGCCAGCAGTGAAGGAGCCCAGGATGAAGCTTTCTTT	CASSEGAQDEAFF	TRBV2	TRBJ1-1
TGTGCCAGCAGCTTAGGTGGAGGGAACACCGGGGAGCTGTTTTTT	CASSLGGGNTGELFF	TRBV7-9	TRBJ2-2
TGTGCCAGCAGCTTCTTTACGGAAAAAAACATTCAGTACTTC	CASSFFTEKNIQYF	TRBV7-9	TRBJ2-4
TGCGCCAGCCGTAGGTGGAGGGGGCAGTACTTC	CASRRWRGQYF	TRBV5-1	TRBJ2-7
TGTGCCAGCAGCCATACAGGACAGGGAGCTAACTATGGCTACACCTTC	CASSHTGQGANYGYTF	TRBV3-1	TRBJ1-2
TGTGCCAGCAGCTTACTCTCACCGGGGGACTCAGGCTACACCTTC	CASSLLSPGDSGYTF	TRBV11-3	TRBJ1-2
TGTGCCAGCAGCCAAGATAAGGGGGCGGGGGAGCTGTTTTTT	CASSQDKGAGELFF	TRBV14	TRBJ2-2
TGTGCCAGCTCACCAGGTAACGAGGGAACATCCTACGAGCAGTACTTC	CASSPGNEGTSYEQYF	TRBV18	TRBJ2-7
TGTGCTTGTGGACAGCCCGAGACCCAGTACTTC	CACGQPETQYF	TRBV5-5	TRBJ2-5
TGCGCCAGCAGCTTGACACCCCGTGGACTAGCGGGAATCCCTGGGGAGCTGTTTTTT	CASSLTPRGLAGIPGELFF	TRBV5-1	TRBJ2-2
TGTGCCAGCAAGGAAAAGAACACTGAAGCTTTCTTT	CASKEKNTEAFF	TRBV27	TRBJ1-1
TGTGCCAGCAGCCAAGCAAGCGGGAGAAACACCGGGGAGCTGTTTTTT	CASSQASGRNTGELFF	TRBV4-2	TRBJ2-2
TGTGCCAGCAGCCAAGATGGGTCGAACATTGAGGAGGAGACCCAGTACTTC	CASSQDGSNIEEETQYF	TRBV3-1	TRBJ2-5
TGTGCCAGCAGTGCGGACAGAGTTAACTATGGCTACACCTTC	CASSADRVNYGYTF	TRBV6-4	TRBJ1-2
TGTGCCAGGGGCACAGGGTTTGGAAACACCATATATTTT	CARGTGFGNTIYF	TRBV6-5	TRBJ1-3
TGTGCCTGGCAGGCCGGGACTAGCGGGGGGGCGACTTTTACCTACGAGCAGTACTTC	CAWQAGTSGGATFTYEQYF	TRBV30	TRBJ2-7
TGTGCCAGCAGCTGGTATTGGGGGGCAGGCGAAAACATTCAGTACTTC	CASSWYWGAGENIQYF	TRBV5-4	TRBJ2-4
TGTGCCAGCAGTAGGAGGCCCATTAATTCACCCCTCCACTTT	CASSRRPINSPLHF	TRBV6-6	TRBJ1-6
TGTGCCAGCAGCAAAACTTATTACACCGGGGAGCTGTTTTTT	CASSKTYYTGELFF	TRBV11-2	TRBJ2-2
TGCGCCAGCAGCTCAGCACATCTGGAAGAGACGCCCACTAATGAAAAACTGTTTTTT	CASSSAHLEETPTNEKLFF	TRBV5-1	TRBJ1-4
TGCAGTGCTAGAGATCTGGGGGACAGGGGGGGGGGACGGGGTCAGCCCCAGCATTTT	CSARDLGDRGGGRGQPQHF	TRBV20-1	TRBJ1-5
TGTGCCAGCAGTGAAGCACCAGGGGCAAGAGCAACTAATGAAAAACTGTTTTTT	CASSEAPGARATNEKLFF	TRBV6-1	TRBJ1-4
TGCGCCAGCAGCCAAGATGCGGAGTTCCACTATGGCTACACCTTC	CASSQDAEFHYGYTF	TRBV4-1	TRBJ1-2
TGCGCCAGCAGCCATCGAAGCAATGAGCAGTTCTTC	CASSHRSNEQFF	TRBV4-3	TRBJ2-1
TGTGCCAGCAACCCCTCCGGGACAGGCGGAAACGAGCAGTACTTC	CASNPSGTGGNEQYF	TRBV11-3	TRBJ2-7
TGTGCCAGCAAAGAGGGAGGGGGATCAAAACCCACCGGGGAGCTGTTTTTT	CASKEGGGSKPTGELFF	TRBV7-9	TRBJ2-2
TGTGCCAGCTGGGGGGGGGCCTACGAGCAGTACTTC	CASWGGAYEQYF	TRBV18	TRBJ2-7
TGTGCCAGCAGCGGTTCCAGGGGGGGGGGCACATGCACAGATACGCAGTATTTT	CASSGSRGGGTCTDTQYF	TRBV5-6	TRBJ2-3
TGCACTTTGGGGGCCCCAGGCCTCTCCTACAATGAGCAGTTCTTC	CTLGAPGLSYNEQFF	TRBV20-1	TRBJ2-1
TGTGCCAGCAGTTACTCCAACCTCGTTAGGGGGGGTCAGCAGCCCCAGCATTTT	CASSYSNLVRGGQQPQHF	TRBV6-5	TRBJ1-5
TGTGCCAGCAGCGGTGCTCGGCCAGGATCCACAGATACGCAGTATTTT	CASSGARPGSTDTQYF	TRBV7-4	TRBJ2-3
TGTGCCAGCAGTTTATCGACAGGGGAGACCCAGTACTTC	CASSLSTGETQYF	TRBV27	TRBJ2-5
TGTGCCAGCAGTTACCCCTACCAGCCCCAGCATTTT	CASSYPYQPQHF	TRBV6-5	TRBJ1-5
TGTGCCAGTAGTTCTCCAGGAGGGAATACGCAGTATTTT	CASSSPGGNTQYF	TRBV19	TRBJ2-3
TGTGCCAGCAGCACGGGGCCGCCTGAAGCTTTCTTT	CASSTGPPEAFF	TRBV7-3	TRBJ1-1
TGTGCCAGCAGCCAAGATGAAGGAAGGGGGAAAAGAAATTCACCCCTCCACTTT	CASSQDEGRGKRNSPLHF	TRBV14	TRBJ1-6
TGCGCCAGCACTAAGGGAACCACTGAAGCTTTCTTT	CASTKGTTEAFF	TRBV5-1	TRBJ1-1
TGTGCCAGCAGCCGGCAGGACCAGGGCAATCAGCCCCAGCATTTT	CASSRQDQGNQPQHF	TRBV3-1	TRBJ1-5
TGTGCCAGCAGCAGGGCAGCCCGGCCGGGCTACGAGCAGTACTTC	CASSRAARPGYEQYF	TRBV9	TRBJ2-7
TGTGCCTGGAGTGGATCAGAAGGAGGGATGATTTTGGGAGAGTACTTC	CAWSGSEGGMILGEYF	TRBV30	TRBJ2-5
TGTGCCAGCAGTTTACCGCCCCCAGGGAACGAAAAACTGTTTTTT	CASSLPPPGNEKLFF	TRBV27	TRBJ1-4
TGTGCCAGCAGTTACTATGGAAGGGGGGCCCGGACCTACAATGAGCAGTTCTTC	CASSYYGRGARTYNEQFF	TRBV6-5	TRBJ2-1
TGTGCCAGCAGCCCGTTTCGGAGAGCTGAGCAGTTCTTC	CASSPFRRAEQFF	TRBV7-8	TRBJ2-1
TGTGCCAGCAGCTGGGGGAGACAGCGGGATGGAAATGAGCAGTTCTTC	CASSWGRQRDGNEQFF	TRBV11-2	TRBJ2-1
TGCGCCAGCAGCCAAGATGAAGGACAGCAAATTTTGCGGCGGAACACTGAAGCTTTCTTT	CASSQDEGQQILRRNTEAFF	TRBV4-3	TRBJ1-1
TGTGCCAGCAGCGTTGCTCCTTTTACCCCGGGACCGAAAAACGAGCAGTACTTC	CASSVAPFTPGPKNEQYF	TRBV7-4	TRBJ2-7
TGTGCCAGCAGCTCCGGAGGTGAGGACTACAGCAATGAGCAGTTCTTC	CASSSGGEDYSNEQFF	TRBV13	TRBJ2-1
TGCGCCAGCCCGGCGGGTTCCTACAATGAGCAGTTCTTC	CASPAGSYNEQFF	TRBV5-1	TRBJ2-1
TGTGCCAGCAGTGAGACCGGCAGGGGGCAGCCCCAGCATTTT	CASSETGRGQPQHF	TRBV6-4	TRBJ1-5
TGTGCCAGCCGGTTCCATTTGGTAGATAGACGTGAAAAACTGTTTTTT	CASRFHLVDRREKLFF	TRBV5-4	TRBJ1-4
TGTGCCAGCCACCCACCGCGACGGGAGACCCAGTACTTC	CASHPPRRETQYF	TRBV7-6	TRBJ2-5
TGTGCCAGCAGCTTAGAATGTCTCGCCCGGCGGCTGGATTCACCCCTCCACTTT	CASSLECLARRLDSPLHF	TRBV11-3	TRBJ1-6
TGTGCCAGCAGCGGGGGGGTCTCAAATGAGCAGTTCTTC	CASSGGVSNEQFF	TRBV13	TRBJ2-1
TGTGCCAGCAGTTCCCTAAACCAGGCAACTAATGAAAAACTGTTTTTT	CASSSLNQATNEKLFF	TRBV7-2	TRBJ1-4
TGTGTAAAGGGCCAAGAGACCCAGTACTTC	CVKGQETQYF	TRBV6-2	TRBJ2-5
TGCGCCAGCAGCCCCAGGGGGGAGGTCTATGGCTACACCTTC	CASSPRGEVYGYTF	TRBV10-1	TRBJ1-2
TGTGCCAGCAGCCCCCCTAGACAGGGACCAAGAGAGACCCAGTACTTC	CASSPPRQGPRETQYF	TRBV7-4	TRBJ2-5
TGTGCCAGCAGCGGGACAGGGATCCAAGCCAAAAACATTCAGTACTTC	CASSGTGIQAKNIQYF	TRBV5-4	TRBJ2-4
TGTGCCTGGAGGGAAGGAGACGGCTCCTACAATGAGCAGTTCTTC	CAWREGDGSYNEQFF	TRBV30	TRBJ2-1
TGTGCCATCACACATCCCCCGACTGAAGCTTTCTTT	CAITHPPTEAFF	TRBV10-3	TRBJ1-1
TGTGCCAGCAGTTACGGGCATTCGGATCTTCATGGACTGTGCGGCTCCTACGAGCAGTACTTC	CASSYGHSDLHGLCGSYEQYF	TRBV6-6	TRBJ2-7
TGTGCCAGCAGCATCCCCGGGCGTGTTAGGAACAATCAGCCCCAGCATTTT	CASSIPGRVRNNQPQHF	TRBV7-6	TRBJ1-5
TGCGCCAGCAGCTCGTTTCCCACCCCAGACGGGTCCAACAATGAGCAGTTCTTC	CASSSFPTPDGSNNEQFF	TRBV5-1	TRBJ2-1
TGCGCCAGCAGCGTGGCCGGGACTCTTTCTGGAAACACCATATATTTT	CASSVAGTLSGNTIYF	TRBV5-1	TRBJ1-3
TGTGCCAGCAGTGCGGGAGGGTTGAACACTGAAGCTTTCTTT	CASSAGGLNTEAFF	TRBV27	TRBJ1-1
TGTGCCAGCTCACCCCCAATGCTCCCCCGGGGACTAGCGGACCGGAGCCCAACCGGGGAGCTGTTTTTT	CASSPPMLPRGLADRSPTGELFF	TRBV18	TRBJ2-2
TGCAGTGCTAGACTCCAGGGTTACAACTATGGCTACACCTTC	CSARLQGYNYGYTF	TRBV20-1	TRBJ1-2
TGTGCCGAGAGAGGGACAGGGTCGGGGGGAACTGAAGCTTTCTTT	CAERGTGSGGTEAFF	TRBV30	TRBJ1-1
TGCGCCAGCAACGACAAGCTAGCGGGGGCACAAGAGACCCAGTACTTC	CASNDKLAGAQETQYF	TRBV5-1	TRBJ2-5
TGTGCCAGCAGCAAGGACAGTCGGGACACTGAAGCTTTCTTT	CASSKDSRDTEAFF	TRBV7-6	TRBJ1-1
TGCGCCAGCAGCCAAGCGCACGATGGGGCTAACTATGGCTACACCTTC	CASSQAHDGANYGYTF	TRBV4-1	TRBJ1-2
TGTGCCAGCAGCTTACCTAGCCGTTCCCGGGACGCGAATGAGCAGTTCTTC	CASSLPSRSRDANEQFF	TRBV11-1	TRBJ2-1
TGTGCCACCAGTGATTTACCAGGCTTCTTT	CATSDLPGFF	TRBV24-1	TRBJ1-1
TGTGCTCTAGGACGAACTAATGAAAAACTGTTTTTT	CALGRTNEKLFF	TRBV7-3	TRBJ1-4
TGTGCCAGCAGCTTAGATGAGGTACGGGTGGAGGGCTACACCTTC	CASSLDEVRVEGYTF	TRBV11-3	TRBJ1-2
TGTGCCAGCACGGACAGCTCTGGGGCCAACGTCCTGACTTTC	CASTDSSGANVLTF	TRBV6-5	TRBJ2-6
TGTGCCAGCAGGACCAGGACAGCGGGGAACACCGGGGAGCTGTTTTTT	CASRTRTAGNTGELFF	TRBV6-1	TRBJ2-2
TGTGCCAGCAGCTTGGGCCTTTGCGTCTCTGGAAACACCATATATTTT	CASSLGLCVSGNTIYF	TRBV5-6	TRBJ1-3
TGTGCCAGCAGACCGGGACAGCTCGCGATAATCTCTGGAAACACCATATATTTT	CASRPGQLAIISGNTIYF	TRBV7-3	TRBJ1-3
TGTGCCAGCAGATCTCCCCCCCCCTCATGCACCCCGAACACTGAAGCTTTCTTT	CASRSPPPSCTPNTEAFF	TRBV6-4	TRBJ1-1
TGTGCCAGCAATCCACAGGGAACACTAGAGACCCAGTACTTC	CASNPQGTLETQYF	TRBV28	TRBJ2-5
TGTGCTAGTGGTTTGGCCGGAGCTACGGTCACAGATACGCAGTATTTT	CASGLAGATVTDTQYF	TRBV12-5	TRBJ2-3
TGTGCCAGCTCACCGAGGGGGGCGGACAATGAGCAGTTCTTC	CASSPRGADNEQFF	TRBV18	TRBJ2-1
TGTGCCAGCTCACCCTGGCCGGCGGAATGTAGCGGGCGGAATGAGCAGTTCTTC	CASSPWPAECSGRNEQFF	TRBV18	TRBJ2-1
TGTGCCAGTAGTAACCCGGGACAGCGGGCCTCCTACGAGCAGTACTTC	CASSNPGQRASYEQYF	TRBV19	TRBJ2-7
TGTGCCAGCAGTAGGGACAGGGGAAATCAGCCCCAGCATTTT	CASSRDRGNQPQHF	TRBV2	TRBJ1-5
TGCAGTGCCCCTCCCGTCGCCGGACAGACTGAACAGCCCCAGCATTTT	CSAPPVAGQTEQPQHF	TRBV20-1	TRBJ1-5
TGCAGTGCTAGAACCGTATATAGAGAGGACGAGCAGTACTTC	CSARTVYREDEQYF	TRBV20-1	TRBJ2-7
TGTGCCACCAGTGATTTGAAGGACGGCCCCGAGCAGTACTTC	CATSDLKDGPEQYF	TRBV24-1	TRBJ2-7
TGCGCCAGCATCCCCAACGGACAGGGGGCGGTCTACGAGCAGTACTTC	CASIPNGQGAVYEQYF	TRBV10-2	TRBJ2-7
TGTGCCAGCAACGGCACGGGACAGGGGAAAGGCTCTGGAAACACCATATATTTT	CASNGTGQGKGSGNTIYF	TRBV27	TRBJ1-3
TGTGCCAGCAGCGCGCGGCAGTCCGTGATGGGACAGGGGGCGTTTGCCTACGAGCAGTACTTC	CASSARQSVMGQGAFAYEQYF	TRBV7-9	TRBJ2-7
TGTGCCAGCTCACGGAGGGACAGTACTCAGCCCCAGCATTTT	CASSRRDSTQPQHF	TRBV18	TRBJ1-5
TGTGCCAGCAGTCAGGGGGCCTACGAGCAGTACTTC	CASSQGAYEQYF	TRBV6-5	TRBJ2-7
TGTGCCAGCGGAGGGGCTGAAGCTTTCTTT	CASGGAEAFF	TRBV6-4	TRBJ1-1
TGTGCCAGCAGCTTAAACACTAGCGGGCCCTACGAGCAGTACTTC	CASSLNTSGPYEQYF	TRBV11-2	TRBJ2-7
TGTGCCTGGAGTTTTGACAGGGATAATGAAAAACTGTTTTTT	CAWSFDRDNEKLFF	TRBV30	TRBJ1-4
TGTGCCAGCAGTCCAGCGAGGGACCCCTGTGGTGGATGGCAGCCCCAGCATTTT	CASSPARDPCGGWQPQHF	TRBV6-2	TRBJ1-5
TGTGCCAGCAGCGTACGTTCACGAGCTGGCCCCTACGAGCAGTACTTC	CASSVRSRAGPYEQYF	TRBV9	TRBJ2-7
TGTGCCAGCAGCCCCTCTCTGGGACAGGGGACCGCCTACGAGCAGTACTTC	CASSPSLGQGTAYEQYF	TRBV4-2	TRBJ2-7
TGCAGCGGACGGGGGCGCAAGGCCCTCCACTTT	CSGRGRKALHF	TRBV29-1	TRBJ1-6
TGTGCCACCAGTGATTCCGACTATACCGGGGCCAACGTCCTGACTTTC	CATSDSDYTGANVLTF	TRBV24-1	TRBJ2-6
TGTGCCAGCAGTCTAGCGGGTACGCAGTATTTT	CASSLAGTQYF	TRBV27	TRBJ2-3
TGTGCCTGGAAGCCCAACAGGGTAACAACTAATGAAAAACTGTTTTTT	CAWKPNRVTTNEKLFF	TRBV30	TRBJ1-4
TGTGCCAGCAGTGAAGTCCCACTTAGGAACACTGAAGCTTTCTTT	CASSEVPLRNTEAFF	TRBV6-1	TRBJ1-1
TGTGCCACCAGTGTAGTGCAGATTACGAACACTGAAGCTTTCTTT	CATSVVQITNTEAFF	TRBV24-1	TRBJ1-1
TGTGCCATCAGTGAGTCGATGGCCACAGGGGGATCTGGCTACACCTTC	CAISESMATGGSGYTF	TRBV10-3	TRBJ1-2
TGTGCCAGCAGTTTCTTCCCTATGTATCAGCCCCAGCATTTT	CASSFFPMYQPQHF	TRBV12-4	TRBJ1-5
TGTGCCAGCAGCACCAGGGACAACACTGAAGCTTTCTTT	CASSTRDNTEAFF	TRBV13	TRBJ1-1
TGCGCCAGCAGCATTCGGACGGGCAATCAGCCCCAGCATTTT	CASSIRTGNQPQHF	TRBV4-1	TRBJ1-5
TGCGCCAGCAGCCGGGGGAAGGCGTCGTCCTACGAGCAGTACTTC	CASSRGKASSYEQYF	TRBV5-1	TRBJ2-7
TGTGCCAGCAGCTTACCCGCGTCCAATCAGCCCCAGCATTTT	CASSLPASNQPQHF	TRBV11-2	TRBJ1-5
TGTGCCAGCAGCAGACTAGCGGAGCAGTACTTC	CASSRLAEQYF	TRBV2	TRBJ2-7
TGCAACGGGGGGGGAAGTAATGAGCAGTTCTTC	CNGGGSNEQFF	TRBV29-1	TRBJ2-1
TGTGCCAGCAGGGGAATCAAAGGGCCTGGAGGGGAGACCCAGTACTTC	CASRGIKGPGGETQYF	TRBV7-4	TRBJ2-5
TGCAGTGCTAGACGGGCCTACGAGCAGTACTTC	CSARRAYEQYF	TRBV20-1	TRBJ2-7
TGTGCCAGCAGTGCCCAGGGACGGTGCTATGGCTACACCTTC	CASSAQGRCYGYTF	TRBV6-1	TRBJ1-2
TGTGCCAGCAGCGCAGAGGGACTAGGAATAGATACGCAGTATTTT	CASSAEGLGIDTQYF	TRBV5-6	TRBJ2-3
TGTGCCAGCAGCTTGGTTTGCGGGACTAATGAAAAACTGTTTTTT	CASSLVCGTNEKLFF	TRBV5-5	TRBJ1-4
TGTGCCAGCAGCGTAGGCTACCGGGACAGGGGGGACTATGGCTACACCTTC	CASSVGYRDRGDYGYTF	TRBV9	TRBJ1-2
TGTGCCAGCAGTGAAGCTCTAGCGCCGTCTAACTATGGCTACACCTTC	CASSEALAPSNYGYTF	TRBV2	TRBJ1-2
TGTGCCAGCTCCACCCTTCCTTGTCTAGCGGGGGTGTCCTACGAGCAGTACTTC	CASSTLPCLAGVSYEQYF	TRBV27	TRBJ2-7
TGTGCCAGCAGCCCCCTTGGCTCAAGGGGTCGGGGGGAGACCCAGTACTTC	CASSPLGSRGRGETQYF	TRBV13	TRBJ2-5
TGTGCCAGCAGCACGATCTTCCAGGGACCCCAATATGGCTACACCTTC	CASSTIFQGPQYGYTF	TRBV13	TRBJ1-2
TGTGCCAGCAGTTGGTACGAGAACAGAGAGGTTACCGCTTTCAACTATGGCTACACCTTC	CASSWYENREVTAFNYGYTF	TRBV12-4	TRBJ1-2
TGTGCCAGCAGCCAGTCCCCCCCTCGGCTTTATGACGGTTATGGCTACACCTTC	CASSQSPPRLYDGYGYTF	TRBV3-1	TRBJ1-2
TGCGCCAGCAGCCCAGGGTTTTGCGAGCGGGGGGAAGATAGGCTGTTTTTT	CASSPGFCERGEDRLFF	TRBV5-1	TRBJ1-4
TGTGCCAGCAGTGACGGGACTAGCGGGCCAGAGACAGATACGCAGTATTTT	CASSDGTSGPETDTQYF	TRBV6-4	TRBJ2-3
TGTGCCAGCAGCTTAGAAACGGATCAGGGGTTAAATCAGCCCCAGCATTTT	CASSLETDQGLNQPQHF	TRBV7-3	TRBJ1-5
TGCAGCTACCAGAATGACAGGAAGGGCACTGAAGCTTTCTTT	CSYQNDRKGTEAFF	TRBV29-1	TRBJ1-1
TGTGCCAGCAGTTTAACCGGGACAGCAATTAATAACTATGGCTACACCTTC	CASSLTGTAINNYGYTF	TRBV12-3	TRBJ1-2
TGTGCCAGCAGTTTAGTCTCCTGGGACAGGGAGGACTACGAGCAGTACTTC	CASSLVSWDREDYEQYF	TRBV27	TRBJ2-7
TGCGCCAGGACTAGGTCGAGCTCCTACGAGCAGTACTTC	CARTRSSSYEQYF	TRBV10-1	TRBJ2-7
TGTGCCAGCAGCTTCGTACGGCACGAGCAGTACTTC	CASSFVRHEQYF	TRBV7-8	TRBJ2-7
TGCGCCAGCAGCTCAGGGGAAGGAAACACCATATATTTT	CASSSGEGNTIYF	TRBV5-1	TRBJ1-3
TGCAGCGGCGGAGGGCGGGAGAATAAGTACAATGAGCAGTTCTTC	CSGGGRENKYNEQFF	TRBV29-1	TRBJ2-1
TGTGCCAGCCTCAAGGGCCCAAACAATGAGCAGTTCTTC	CASLKGPNNEQFF	TRBV6-1	TRBJ2-1
TGTGTAAGAGGCGGGGACACTGAAGCTTTCTTT	CVRGGDTEAFF	TRBV5-4	TRBJ1-1
TGTGCCATCCCCCCAGGGGGAAGCTCCTATAATTCACCCCTCCACTTT	CAIPPGGSSYNSPLHF	TRBV10-3	TRBJ1-6
TGTGCCACCAGCAGAGATATATTTCGCGGGACGAAGCAAGAGACCCAGTACTTC	CATSRDIFRGTKQETQYF	TRBV15	TRBJ2-5
TGTGCCAGTAGCCCCTCACGGGGGGGCCCCATCGAAGAGACCCAGTACTTC	CASSPSRGGPIEETQYF	TRBV19	TRBJ2-5
TGTGCCAGCAGCGCCACAGGGAGGGTGGACAATGAGCAGTTCTTC	CASSATGRVDNEQFF	TRBV9	TRBJ2-1
TGTGCCACCACACAGGGGGGGTTAAGGAACACTGAAGCTTTCTTT	CATTQGGLRNTEAFF	TRBV24-1	TRBJ1-1
TGTGCCAGCAGTTTCCGAGCGGACAATGAGCAGTTCTTC	CASSFRADNEQFF	TRBV6-2	TRBJ2-1
TGCAGTGCTAGATTCTCAAGGACAGGGGGCTACTCAAGGGGCTACACCTTC	CSARFSRTGGYSRGYTF	TRBV20-1	TRBJ1-2
TGTGCCAGCAGAGGACAGCGGGGCTGTTACTCCTACGAGCAGTACTTC	CASRGQRGCYSYEQYF	TRBV6-3	TRBJ2-7
TGTGCCACGATACCTAACAGGGCGGCCTACGAGCAGTACTTC	CATIPNRAAYEQYF	TRBV6-4	TRBJ2-7
TGTGCCAGCAGCTTGGTACCCTCGAGGGATACCGGGGAGCTGTTTTTT	CASSLVPSRDTGELFF	TRBV5-4	TRBJ2-2
TGTGCCAGCACTGAGGGTTACAATGAGCAGTTCTTC	CASTEGYNEQFF	TRBV28	TRBJ2-1
TGTGCCAGCAGTTGCGAACCAGACCGGGAGACCCAGTACTTC	CASSCEPDRETQYF	TRBV28	TRBJ2-5
TGTGCCAGCAGTTGTCGAATCCCACGGAATCAGCACACTGAAGCTTTCTTT	CASSCRIPRNQHTEAFF	TRBV28	TRBJ1-1
TGCCGAGGGACTAGGAACGGAACAGATACGCAGTATTTT	CRGTRNGTDTQYF	TRBV10-1	TRBJ2-3
TGCGCCAGCAGTGAGGGGACAGGGCCGGGCGATCGTGGCACCGGGGAGCTGTTTTTT	CASSEGTGPGDRGTGELFF	TRBV10-1	TRBJ2-2
TGTGCCAGCAGCTTACCCCGACTAGCGGGGACCTACGAGCAGTACTTC	CASSLPRLAGTYEQYF	TRBV7-2	TRBJ2-7
TGCGCCAGCAGCCAAGCCTACCCAAATTATGGCTACACCTTC	CASSQAYPNYGYTF	TRBV4-1	TRBJ1-2
TGTGCCAGCAGCGGTCAATCCAGGGCTCCCTACGAGCAGTACTTC	CASSGQSRAPYEQYF	TRBV7-9	TRBJ2-7
TGTGCCAGCAGCCTCCTTAGGGGGAGCTCCTACGAGCAGTACTTC	CASSLLRGSSYEQYF	TRBV5-8	TRBJ2-7
TGTGCCAGCAGCAGCAGCGAGAGGGAGCAAGAGACCCAGTACTTC	CASSSSEREQETQYF	TRBV13	TRBJ2-5
TGTGCCAGCAGTTACTTACGGAGGAATCAGCCCCAGCATTTT	CASSYLRRNQPQHF	TRBV6-5	TRBJ1-5
TGTGCCAGCAGCCAGGGCCCTGGGGCCAACGTCCTGACTTTC	CASSQGPGANVLTF	TRBV28	TRBJ2-6
TGCGCCAGCAGCACATGGGGGGCCTACGAGCAGTACTTC	CASSTWGAYEQYF	TRBV4-1	TRBJ2-7
TGTGCCAGGGGCTCCTACAATGAGCAGTTCTTC	CARGSYNEQFF	TRBV28	TRBJ2-1
TGTGCCAGCAGGATCGGGGGGCCAAGCACAGATACGCAGTATTTT	CASRIGGPSTDTQYF	TRBV6-5	TRBJ2-3
TGTGCCAGCAGCGAATTGTCAGGTCAGCCCCAGCATTTT	CASSELSGQPQHF	TRBV13	TRBJ1-5
TGCGCCAGCCCCCCGGACAGGGGCGACTCCTACGAGCAGTACTTC	CASPPDRGDSYEQYF	TRBV10-1	TRBJ2-7
TGTGCCAGCAGGGCGACAGAAAAACTGTTTTTT	CASRATEKLFF	TRBV11-3	TRBJ1-4
TGTGCCAGCAGCGATAGCGGGAGTGGTGGGGATATCTCCTACGAGCAGTACTTC	CASSDSGSGGDISYEQYF	TRBV6-2	TRBJ2-7
TGTGCCAGCAGTGAATTAAGGGTAGCTTTCTTT	CASSELRVAFF	TRBV25-1	TRBJ1-1
TGTGCCAGCAGCGGACAGAGGGTTAGCTCTGGAAACACCATATATTTT	CASSGQRVSSGNTIYF	TRBV7-4	TRBJ1-3
TGTGCCAGTAGTACCCCAGGGGGGGGCGGGGAAGAGACCCAGTACTTC	CASSTPGGGGEETQYF	TRBV19	TRBJ2-5
TGCAGTGCTAGAGACGCATACCAGTACTTC	CSARDAYQYF	TRBV20-1	TRBJ2-7
TGTGCCAGCAGCCAAAAGGCATCGGGCAATCAGCCCCAGCATTTT	CASSQKASGNQPQHF	TRBV11-2	TRBJ1-5
TGTGCCAGCAGTTATGTGGGGGGTTGGAACACTGAAGCTTTCTTT	CASSYVGGWNTEAFF	TRBV6-5	TRBJ1-1
TGTGCCAGCAGCCCGATTAGTCAAGGGGTGTTTAACTATGGCTACACCTTC	CASSPISQGVFNYGYTF	TRBV7-3	TRBJ1-2
TGTGCCAGCAGCGCAGCCACAAGGGCCCGGGAAAAACTGTTTTTT	CASSAATRAREKLFF	TRBV13	TRBJ1-4
TGTGCCAGCAGCTGTCGACAGGGCGGGGGCTACACCTTC	CASSCRQGGGYTF	TRBV7-9	TRBJ1-2
TGTGCCAGCAGTATGGGGCCGGACCCCAATCAGCCCCAGCATTTT	CASSMGPDPNQPQHF	TRBV6-1	TRBJ1-5
TGTGCCAGCCTGTGTCAACGGAACTACGAGCAGTACTTC	CASLCQRNYEQYF	TRBV7-6	TRBJ2-7
TGTGCCACCATATCCTTGGGGCGATTAGATACGCAGTATTTT	CATISLGRLDTQYF	TRBV24-1	TRBJ2-3
TGTGCCACAGAACCTCCGGGACTAGCGGACGTCAAAAACATTCAGTACTTC	CATEPPGLADVKNIQYF	TRBV2	TRBJ2-4
TGTGCCAGCAGCCAGGCCGGGACAGGGGGCAGTAATGAAAAACTGTTTTTT	CASSQAGTGGSNEKLFF	TRBV5-5	TRBJ1-4
TGTGCCAGCAGTGGGCTGCTAAAAGGGGGAGGCGATACGCAGTATTTT	CASSGLLKGGGDTQYF	TRBV27	TRBJ2-3
TGCGCCAGCAGTGAGCGAAGGGCAGATACGCAGTATTTT	CASSERRADTQYF	TRBV10-1	TRBJ2-3
TGTGCCAGCAGCTTAAGGGCCGAGTTTGATTCCTACGAGCAGTACTTC	CASSLRAEFDSYEQYF	TRBV7-3	TRBJ2-7
TGCAGCGTTGGGGACAGGGCCGGCGGGAATCAGCCCCAGCATTTT	CSVGDRAGGNQPQHF	TRBV29-1	TRBJ1-5
TGTGCCAGCAGTCATGGCGGGGGAGGAAGCTCCTATAATTCACCCCTCCACTTT	CASSHGGGGSSYNSPLHF	TRBV2	TRBJ1-6
TGCGCCAGCAGTAGGAGGGGGCTAAGAAGCAATCAGCCCCAGCATTTT	CASSRRGLRSNQPQHF	TRBV10-2	TRBJ1-5
TGCGCCAGCAGCTTCATGGGGACTGAAGGCGGGGAGCTGTTTTTT	CASSFMGTEGGELFF	TRBV5-1	TRBJ2-2
TGTGCCAGCAGTCCCCCGGGAAGGAACACCGGGGAGCTGTTTTTT	CASSPPGRNTGELFF	TRBV12-3	TRBJ2-2
TGTGCCAGCAGCTTCAAGACAGGGCATTTTAGCAATCAGCCCCAGCATTTT	CASSFKTGHFSNQPQHF	TRBV7-2	TRBJ1-5
TGCAGTGCTTTCGGGAGGGTTATAAGCTATAGCAATCAGCCCCAGCATTTT	CSAFGRVISYSNQPQHF	TRBV20-1	TRBJ1-5
TGTGCCATCAGCTACGACAGAGAGAAAAATGAAAAACTGTTTTTT	CAISYDREKNEKLFF	TRBV10-3	TRBJ1-4
TGTGCCAGCTCTGGGCGTGTGAGTCAGCCCCAGCATTTT	CASSGRVSQPQHF	TRBV18	TRBJ1-5
TGTGCCAGTATTCAGGAGGGGTACGAGCAGTACTTC	CASIQEGYEQYF	TRBV19	TRBJ2-7
TGTGCCAGCAGCGAACGAGGTGCAGTTAGGTTCATGAACACTGAAGCTTTCTTT	CASSERGAVRFMNTEAFF	TRBV7-9	TRBJ1-1
TGTGCCAGCAGTGCACTAAATTGTTTAGACGGGGGACAGCCCCAGCATTTT	CASSALNCLDGGQPQHF	TRBV6-8	TRBJ1-5
TGTGCCAGCAGTGAAATGGGGGGGCCCAATGAGCAGTTCTTC	CASSEMGGPNEQFF	TRBV2	TRBJ2-1
TGTGCCAGCAGCCGAGTTCAGCAGGGCTTGGGAACTGAAGCTTTCTTT	CASSRVQQGLGTEAFF	TRBV13	TRBJ1-1
TGTGCCAGCAGCGTAGTTGAAGATAAACACACTGAAGCTTTCTTT	CASSVVEDKHTEAFF	TRBV7-2	TRBJ1-1
TGTGCCAGCAGTGAAGCGCCAGTCACCGAACCACTAGAGGGGAATGAGCAGTTCTTC	CASSEAPVTEPLEGNEQFF	TRBV6-1	TRBJ2-1
TGTGCCAGCAGCTTAGAACATCCCCTAAAGAGCCCGCCGGAGCGGTCAAGAACCTATGGCTACACCTTC	CASSLEHPLKSPPERSRTYGYTF	TRBV11-3	TRBJ1-2
TGTGCCAGCAGTCCATGGACAGGGCAGCAGGCCCAGCATTTT	CASSPWTGQQAQHF	TRBV6-1	TRBJ1-5
TGTGCCAGCAGCGTCAACAGACTAGCGGGGATAGAGACCCAGTACTTC	CASSVNRLAGIETQYF	TRBV7-8	TRBJ2-5
TGTGCCAGCAGCGTTCCGGGACAGAACGGGGAGCAGTACTTC	CASSVPGQNGEQYF	TRBV5-6	TRBJ2-7
TGTGCCAGCAGTTTGTTGGCCCCCGGGACGGGCACAGATACGCAGTATTTT	CASSLLAPGTGTDTQYF	TRBV27	TRBJ2-3
TGTGCCAGTAGTATAGATGGGGGTAGGCGCACAGATACGCAGTATTTT	CASSIDGGRRTDTQYF	TRBV19	TRBJ2-3
TGTGCCAAAACTGTCCAGCCCCAGCATTTT	CAKTVQPQHF	TRBV6-8	TRBJ1-5
TGTGCCAGCAGCTTTGACGGAGCGGGACTAGTTGCCTCCTACGAGCAGTACTTC	CASSFDGAGLVASYEQYF	TRBV7-4	TRBJ2-7
TGTGCCAGCAGGTCGACTAGTGGTTACAATGAGCAGTTCTTC	CASRSTSGYNEQFF	TRBV13	TRBJ2-1
TGTGCCAGCAGTTCACGGACGACTTCGTTCAAAAACATTCAGTACTTC	CASSSRTTSFKNIQYF	TRBV12-3	TRBJ2-4
TGTGCCAGCAGCCAGACAGGGGTTCTCCAGGGACGGAAGGGGTTCTACAATGAGCAGTTCTTC	CASSQTGVLQGRKGFYNEQFF	TRBV7-2	TRBJ2-1
TGTGCCAGCAGCGACAGTCTGGGAAACACCATATATTTT	CASSDSLGNTIYF	TRBV7-9	TRBJ1-3
TGTGCCAGCAGCCAAGAGCAGGGCTACGAGCAGTACTTC	CASSQEQGYEQYF	TRBV3-1	TRBJ2-7
TGTGCCAGCAGTTCCCCTGGGGAGCCCTACGAGCAGTACTTC	CASSSPGEPYEQYF	TRBV12-3	TRBJ2-7
TGTGCCACCAGTGATTCCAAACGGAGGTTCCATCAGCCCCAGCATTTT	CATSDSKRRFHQPQHF	TRBV24-1	TRBJ1-5
TGTGCCAGCAGAGGGACAGGGGGCAGGAATAGCAATCAGCCCCAGCATTTT	CASRGTGGRNSNQPQHF	TRBV6-5	TRBJ1-5
TGTGCCTGGAGTCCGCCGGGACAGATCGACACTGAAGCTTTCTTT	CAWSPPGQIDTEAFF	TRBV30	TRBJ1-1
TGTGCCAGCAGCTGGCGGGAGCTAGTTAGGAGCACAGATACGCAGTATTTT	CASSWRELVRSTDTQYF	TRBV11-2	TRBJ2-3
TGCGCCAGCAGCTGGGTGACCGGACAGGAAAAACTGTTTTTT	CASSWVTGQEKLFF	TRBV5-1	TRBJ1-4
TGCGCCAGCAGGGGATATTGGGGGAACACTGAAGCTTTCTTT	CASRGYWGNTEAFF	TRBV10-1	TRBJ1-1
TGCAGTGCCCCGTCGGGGGGGGGTGTCTCCTACGAGCAGTACTTC	CSAPSGGGVSYEQYF	TRBV20-1	TRBJ2-7
TGTGCCATCAGTGATGGGGACAGTCAGCCCCAGCATTTT	CAISDGDSQPQHF	TRBV10-3	TRBJ1-5
TGTGCCAGCAGTTACGGTCGGGCGGCGACAGATACGCAGTATTTT	CASSYGRAATDTQYF	TRBV6-3	TRBJ2-3
TGTGCCAGCAGCGCACCATTCCCCGGGACTAGTGATAACGAGCAGTACTTC	CASSAPFPGTSDNEQYF	TRBV13	TRBJ2-7
TGTGCCAGCAAAGGACAGGCACGGTCTATAGCCGCCCTGAACACTGAAGCTTTCTTT	CASKGQARSIAALNTEAFF	TRBV7-8	TRBJ1-1
TGTGCCAGCAGCTTGACCCCCCGGACCGCCTACAATGAGCAGTTCTTC	CASSLTPRTAYNEQFF	TRBV5-5	TRBJ2-1
TGTGCCAGCACTGCGGCCAATAGAAATGAGCAGTTCTTC	CASTAANRNEQFF	TRBV6-5	TRBJ2-1
TGTGCCTGGAGTCTGCCGGGACAGGGTCGCAACAGCACAGATACGCAGTATTTT	CAWSLPGQGRNSTDTQYF	TRBV30	TRBJ2-3
TGCAGTGCTAGAGATGACACAGGGGGAACCCTCATCCGCAATCAGCCCCAGCATTTT	CSARDDTGGTLIRNQPQHF	TRBV20-1	TRBJ1-5
TGTGCCAGCAGCAAATGGCCAAACACTGAAGCTTTCTTT	CASSKWPNTEAFF	TRBV11-3	TRBJ1-1
TGTGCCAGCAGTGAACAACGGGTGTCCTACGAGCAGTACTTC	CASSEQRVSYEQYF	TRBV6-4	TRBJ2-7
TGTGCCAGCAGCTGGTCGGGAGGGCCCTGGGAGCAGTATTTT	CASSWSGGPWEQYF	TRBV11-3	TRBJ2-3
TGTGCCAGCAGGAAAACTAGCGGGAGGGCGAAAGTAGGCTACACCTTC	CASRKTSGRAKVGYTF	TRBV6-1	TRBJ1-2
TGTGCCAGCAGGCAGGGGAGCTACGAGCAGTACTTC	CASRQGSYEQYF	TRBV13	TRBJ2-7
TGTGCCTGGACCTTGACAGGGTCGACCTATAATTCACCCCTCCACTTT	CAWTLTGSTYNSPLHF	TRBV30	TRBJ1-6
TGTGCCAGCAGCCCTCCGGGACAGGGCCTGAACACTGAAGCTTTCTTT	CASSPPGQGLNTEAFF	TRBV9	TRBJ1-1
TGCGCCAGGGATCACAGGGCTAACTATGGCTACACCTTC	CARDHRANYGYTF	TRBV5-1	TRBJ1-2
TGTGCCAGCAGCTTGAATCCACAGGGGGCGCGACTTACTGAAGCTTTCTTT	CASSLNPQGARLTEAFF	TRBV7-4	TRBJ1-1
TGTGCCAGCCCAGGACACTCCTACGAGCAGTACTTC	CASPGHSYEQYF	TRBV12-4	TRBJ2-7
TGTGCCAGCAGCTTACCCCTGGGGCCCCACACTGAAGCTTTCTTT	CASSLPLGPHTEAFF	TRBV7-4	TRBJ1-1
TGTGCCAGCAGCCTTGGACAGGGAGAAGGAGAAGAGACCCAGTACTTC	CASSLGQGEGEETQYF	TRBV9	TRBJ2-5
TGTGCCAGCAGTGGCCCGATCACGGGACGGCTATCTTGCCTCGAGCAGTACTTC	CASSGPITGRLSCLEQYF	TRBV6-4	TRBJ2-7
TGTGCCAGCAGCTCGGGCGAAAATGGCTACACCTTC	CASSSGENGYTF	TRBV5-5	TRBJ1-2
TGCAGTGCTAGTGGACTAGCGCTTGATACGCAGTATTTT	CSASGLALDTQYF	TRBV20-1	TRBJ2-3
TGTGCCAGCAGTTTAATCCACAGGGCCTCTGGGGCCAACGTCCTGACTTTC	CASSLIHRASGANVLTF	TRBV27	TRBJ2-6
TGTGCCAGCCATATGGCGCTTGGGCGGTCCTACAATGAGCAGTTCTTC	CASHMALGRSYNEQFF	TRBV25-1	TRBJ2-1
TGTGCCAGCAGCCGAACGGGGATACAGGGCACAGATACGCAGTATTTT	CASSRTGIQGTDTQYF	TRBV11-3	TRBJ2-3
TGTGCCAGCAGCTCGGAAGGGGGCGTGAACACTGAAGCTTTCTTT	CASSSEGGVNTEAFF	TRBV7-2	TRBJ1-1
TGTGCCAGCAAGGCGACAATAGAAGAGACCCAGTACTTC	CASKATIEETQYF	TRBV7-2	TRBJ2-5
TGTGCCAGCAGCTGGTGGACGGACGAGCAGTACTTC	CASSWWTDEQYF	TRBV11-2	TRBJ2-7
TGTGCCAGCAGCTTAGACCCCGGGGTTGAGCTTAATTCACCCCTCCACTTT	CASSLDPGVELNSPLHF	TRBV7-7	TRBJ1-6
TGTGCCAGCGACAGGAACGCAGATACGCAGTATTTT	CASDRNADTQYF	TRBV7-8	TRBJ2-3
TGTGCCAAGTGTCTAGGGGACCGGCCTTCAGGGGCCAACGTCCTGACTTTC	CAKCLGDRPSGANVLTF	TRBV6-6	TRBJ2-6
TGTGCCAGTCGCGATGGGACAGTGAACACTGAAGCTTTCTTT	CASRDGTVNTEAFF	TRBV19	TRBJ1-1
TGTGCCAGCTACAGGGTAGGCTACACCTTC	CASYRVGYTF	TRBV6-4	TRBJ1-2
TGTGCCAGCAGCCGTACGGGGCACCTAAATAGCACAGATACGCAGTATTTT	CASSRTGHLNSTDTQYF	TRBV7-9	TRBJ2-3
TGTGCCAAGATCGTCTCTAGCAATCAGCCCCAGCATTTT	CAKIVSSNQPQHF	TRBV24-1	TRBJ1-5
TGTGCCAGCCAAAGGCAGGGGGCTAGCTACGAGCAGTACTTC	CASQRQGASYEQYF	TRBV28	TRBJ2-7
TGTGCCACCAGCAAGGACAGTGACCAAGAGACCCAGTACTTC	CATSKDSDQETQYF	TRBV15	TRBJ2-5
TGTGCCAGCAGCTTGAGGGACAGACCCTACGAGCAGTACTTC	CASSLRDRPYEQYF	TRBV7-9	TRBJ2-7
TGTGCCAGCAGTTTTTCGACAGGGCCGAGTTCACCCCTCCACTTT	CASSFSTGPSSPLHF	TRBV28	TRBJ1-6
TGTGCCAGCAGCCAAGGGGAAGTGGGGGGGGACAAACAAGTCCTAGCCAAAAACATTCAGTACTTC	CASSQGEVGGDKQVLAKNIQYF	TRBV14	TRBJ2-4
TGCGCCAGCAGCTTGTGGGGGACAGCAATATACGAGCAGTACTTC	CASSLWGTAIYEQYF	TRBV5-1	TRBJ2-7
TGCAGTGCTCGGGGAGGGACCGGGGAGCTGTTTTTT	CSARGGTGELFF	TRBV20-1	TRBJ2-2
TGTGCCAGCAGCGTCCTGGGAGGGAGCAATCAGCCCCAGCATTTT	CASSVLGGSNQPQHF	TRBV9	TRBJ1-5
TGTGCCAGCAGTCCCCCCGGGACAGCGGTGGAAGGGTCCTATAATTCACCCCTCCACTTT	CASSPPGTAVEGSYNSPLHF	TRBV6-4	TRBJ1-6
TGTGCCAGCAGCCAAGAGACCCACTACGAGCAGTACTTC	CASSQETHYEQYF	TRBV14	TRBJ2-7
TGTGCTAGTGGGTTGAGGGACGAAAGCGGGGAGCTGTTTTTT	CASGLRDESGELFF	TRBV12-5	TRBJ2-2
TGTGCCAGCAGCAGTAGCCCGGATAATGCGGGGACGGTCCGTGACGTCGGGAAGATGAACACTGAAGCTTTCTTT	CASSSSPDNAGTVRDVGKMNTEAFF	TRBV7-3	TRBJ1-1
TGTGCCAGCAGCCGATGGAGAGAACTAGCGGGGGGGCGGAACAATGAGCAGTTCTTC	CASSRWRELAGGRNNEQFF	TRBV13	TRBJ2-1
TGCAGCGTTGAGAGGGACAGAATGTGTTCTGGAAACACCATATATTTT	CSVERDRMCSGNTIYF	TRBV29-1	TRBJ1-3
TGTGCCAGCAGTATTACCGGCTATGGCTACACCTTC	CASSITGYGYTF	TRBV6-2	TRBJ1-2
TGCGCCAGCAGTGAGGCACAGGTAGATCAGCCCCAGCATTTT	CASSEAQVDQPQHF	TRBV10-1	TRBJ1-5
TGTGCCAGCAGTGAGGGCACGAGCGGGATTTTCTCCCAGACCCAGTACTTC	CASSEGTSGIFSQTQYF	TRBV6-4	TRBJ2-5
TGTGCCAGCAGTTACTCCTTCTTGGAGGTAGATGGGACAGGGGTGAATTTTCAGCCCCAGCATTTT	CASSYSFLEVDGTGVNFQPQHF	TRBV6-5	TRBJ1-5
TGCGCCAGCAGCCTGGTACGATGTTATCTGAACACTGAAGCTTTCTTT	CASSLVRCYLNTEAFF	TRBV4-1	TRBJ1-1
TGTGCCAGCGGGGCTCAGCCCCAGCATTTT	CASGAQPQHF	TRBV5-5	TRBJ1-5
TGTGCCAGCAGTGATCTCGGACCTGGCATAGGGCAGCTACTGAGGAGTACAGATACGCAGTATTTT	CASSDLGPGIGQLLRSTDTQYF	TRBV12-3	TRBJ2-3
TGTGCCATCAGTGCGTGGCAGGGTTTCATTGACAATCAGCCCCAGCATTTT	CAISAWQGFIDNQPQHF	TRBV10-3	TRBJ1-5
TGTGCCAGCAGCCTGTCAAAAACTTCTGTAGTGTACGAGCAGTACTTC	CASSLSKTSVVYEQYF	TRBV9	TRBJ2-7
TGTGCCTGGAGTGTACTCCCTGGAGGGACAGGGGGCTATAGCAATCAGCCCCAGCATTTT	CAWSVLPGGTGGYSNQPQHF	TRBV30	TRBJ1-5
TGTGCCAGCAGCCAAGAGACCGGGACAGGGTCCTACGAGCAGTACTTC	CASSQETGTGSYEQYF	TRBV14	TRBJ2-7
TGTGCCAGCAGCACACAGGGACCCAACGCCTACGAGCAGTACTTC	CASSTQGPNAYEQYF	TRBV7-3	TRBJ2-7
TGTGCCATGCTGGGATGGTCGGGCGAGCAGTACTTC	CAMLGWSGEQYF	TRBV24-1	TRBJ2-7
TGCGCGAAGACAGCCTTGATGAACACTGAAGCTTTCTTT	CAKTALMNTEAFF	TRBV5-1	TRBJ1-1
TGTGCCATCAGTGATGGGTCGGTGGACGGATTGGTTGAGCAGTTCTTC	CAISDGSVDGLVEQFF	TRBV10-3	TRBJ2-1
TGCAGTGCTAGAGCCGGGCGGTACCTCACAGATACGCAGTATTTT	CSARAGRYLTDTQYF	TRBV20-1	TRBJ2-3
TGTGCCAGCAGGGTCTTAGACGTAAGCAATGAGCAGTTCTTC	CASRVLDVSNEQFF	TRBV6-3	TRBJ2-1
TGTGCCAGCAGCTTAGGTACAGGGGGAGGCATGAACACTGAAGCTTTCTTT	CASSLGTGGGMNTEAFF	TRBV7-3	TRBJ1-1
TGTGCCAGCAGCGCGGGGGACGGAGGGTCCTACGAGCAGTACTTC	CASSAGDGGSYEQYF	TRBV13	TRBJ2-7
TGTGCCAGACGAGGGGGGGGAAGGAGCTCCTACGAGCAGTACTTC	CARRGGGRSSYEQYF	TRBV19	TRBJ2-7
TGTGCCAGCAGTCCTGCACAGGGGTCGCGACATCAGCCCCAGCATTTT	CASSPAQGSRHQPQHF	TRBV6-1	TRBJ1-5
TGTGCCAGCAGCTGGACACGCAATCAGCCCCAGCATTTT	CASSWTRNQPQHF	TRBV5-6	TRBJ1-5
TGTCAGCCGGGACATGACAAAATCACCGGGGAGCTGTTTTTT	CQPGHDKITGELFF	TRBV10-3	TRBJ2-2
TGTGCCAGCAGCCACGGACCCACGCTAGTGTCCTACGAGCAGTACTTC	CASSHGPTLVSYEQYF	TRBV9	TRBJ2-7
TGTGCCTGGACCCGGAGCTCCGGGGAGCTGTTTTTT	CAWTRSSGELFF	TRBV30	TRBJ2-2
TGTGCCAGTAGTATAAAATCACTATTGGCCGCTAGCGGGCATCCGTTCACCGAGACCCAGTACTTC	CASSIKSLLAASGHPFTETQYF	TRBV19	TRBJ2-5
TGTGCCAGCAGCCAAGCCCAGCGGGAATACCCCGCCGTGGCGCAGTATTTT	CASSQAQREYPAVAQYF	TRBV4-2	TRBJ2-3
TGTGCCACCCCGGGCTACGAGCAGTACTTC	CATPGYEQYF	TRBV6-5	TRBJ2-7
TGTGCCAGCAGCTTACCAGGGACAGGGGTTGAGACCCAGTACTTC	CASSLPGTGVETQYF	TRBV11-2	TRBJ2-5
TGTGCCAGCACGGAACAGGAAGGGTCTGGAAACACCATATATTTT	CASTEQEGSGNTIYF	TRBV28	TRBJ1-3
TGTGCCAGCAGCTTGACATACTCCTACGAGCAGTACTTC	CASSLTYSYEQYF	TRBV7-3	TRBJ2-7
TGTGCCAGCAGTGTCGCATCGGGGACTCGGACTAGCACAGATACGCAGTATTTT	CASSVASGTRTSTDTQYF	TRBV6-1	TRBJ2-3
TGTGCCAGCAGCTGGACCAAAGTGGGGACAGACTTGAATGAAAAACTGTTTTTT	CASSWTKVGTDLNEKLFF	TRBV5-4	TRBJ1-4
TGTGCCAGCAGCCAACAAAGTAGGGGTACCGGGGAGCTGTTTTTT	CASSQQSRGTGELFF	TRBV14	TRBJ2-2
TGTGCCAGCAGCTTAGTACCGGGTTTCCCTGAAGCTTTCTTT	CASSLVPGFPEAFF	TRBV11-3	TRBJ1-1
TGTGCCACCAGCTTTAAATCTAGGATTAGCGCGAACACCGGGGAGCTGTTTTTT	CATSFKSRISANTGELFF	TRBV24-1	TRBJ2-2
TGTGCCAGCAGGCTGGGGGAAGAGACCCAGTACTTC	CASRLGEETQYF	TRBV6-2	TRBJ2-5
TGTGCTAGTGGTTTGCTGACGCACGCAGATACGCAGTATTTT	CASGLLTHADTQYF	TRBV12-5	TRBJ2-3
TGTGCCAGCAGTGGAATCGGGACTAGCGTAGACAATGAGCAGTTCTTC	CASSGIGTSVDNEQFF	TRBV6-5	TRBJ2-1
TGTGTGAAGGGGGGGCCACAGGGGTCCGGGGAGCTGTTTTTT	CVKGGPQGSGELFF	TRBV28	TRBJ2-2
TGTGCCAGCGGAAGGACAGGGATCGACACCATATATTTT	CASGRTGIDTIYF	TRBV7-6	TRBJ1-3
TGTGCCAGCAGTTATACCCCCTGGGGGGCTTCGTTGGGGGCAAGGTCCAGAGCAGATACGCAGTATTTT	CASSYTPWGASLGARSRADTQYF	TRBV6-2	TRBJ2-3
TGTGCCAGCAGTGACGGCACACCCTATGGCTACACCTTC	CASSDGTPYGYTF	TRBV6-4	TRBJ1-2
TGTGCCAGCAGCCCCGACCCCCTGGTCATCTCCTACGAGCAGTACTTC	CASSPDPLVISYEQYF	TRBV9	TRBJ2-7
TGTGCCAGCAGTTTTTCCCTAGATAGCGGGTTGAACACCGGGGAGCTGTTTTTT	CASSFSLDSGLNTGELFF	TRBV27	TRBJ2-2
TGTGCCAGCAAGGCCTTGGGTTGCGGGGAGACCCAGTACTTC	CASKALGCGETQYF	TRBV2	TRBJ2-5
TGTGCCAGCAGGGGGGAAAACAGGGTTAAGGTCACTGGGGACACCATATATTTT	CASRGENRVKVTGDTIYF	TRBV11-3	TRBJ1-3
TGTGCCAGCAGCTTCCCCAGGTGGGGCGCTTCCCCGGGAGGCTACACCTTC	CASSFPRWGASPGGYTF	TRBV5-6	TRBJ1-2
TGTGCCAGCAGGCCTCCCCCGCCGGATCTCACTGAAGCTTTCTTT	CASRPPPPDLTEAFF	TRBV6-3	TRBJ1-1
TGTGCCAGCAGTTCCGTGGCAGGACAGCATAAGGCATATATGAACACTGAAGCTTTCTTT	CASSSVAGQHKAYMNTEAFF	TRBV27	TRBJ1-1
TGTGCCAGCAGACCCAGGACAGCCCCGGAGGAATACTCTGGAAACACCATATATTTT	CASRPRTAPEEYSGNTIYF	TRBV6-8	TRBJ1-3
TGTGCCAGCAGGGACCCTTTAACTGCCCAGCATTTT	CASRDPLTAQHF	TRBV6-4	TRBJ1-5
TGTGCCAGGGACAGGTCGAACACTGAAGCTTTCTTT	CARDRSNTEAFF	TRBV27	TRBJ1-1
TGCGCCAGCATAGCCCCAGCAGATACGCAGTATTTT	CASIAPADTQYF	TRBV10-1	TRBJ2-3
TGTGCCAGCCAAGTGGGGGGGGGCTTCAGTAAATACAATGAGCAGTTCTTC	CASQVGGGFSKYNEQFF	TRBV6-2	TRBJ2-1
TGTGCCAGCAGTGAAAAAAACACAGAAAGGTCTGGAAACACCATATATTTT	CASSEKNTERSGNTIYF	TRBV6-4	TRBJ1-3
TGTGCCAGCACGACGGGACAGGGATCTGATACGCAGTATTTT	CASTTGQGSDTQYF	TRBV6-5	TRBJ2-3
TGCAGCGTAGAGAGGGGGGGTTCTGGAAACACCATATATTTT	CSVERGGSGNTIYF	TRBV29-1	TRBJ1-3
TGTGCCAGCAGTTCACGGGCCGGGACAGCCACCGCAGAGACCCAGTACTTC	CASSSRAGTATAETQYF	TRBV6-5	TRBJ2-5
TGTGCCCGGAAAGCGGACAATTCACCCCTCCACTTT	CARKADNSPLHF	TRBV14	TRBJ1-6
TGTGCCAGCAGTTCCGCATTGACAGCAGTCGACGAGCAGTACTTC	CASSSALTAVDEQYF	TRBV6-9	TRBJ2-7
TGTGCCAGCAGTTACTGGACAGGGGGCTGTCGTAGCACAGATACGCAGTATTTT	CASSYWTGGCRSTDTQYF	TRBV6-6	TRBJ2-3
TGTGCCATCCCGCCGGGGGGTTATAATTCACCCCTCCACTTT	CAIPPGGYNSPLHF	TRBV10-3	TRBJ1-6
TGTGCCAGCAGCACAGGGGCAACTAACTATGGCTACACCTTC	CASSTGATNYGYTF	TRBV13	TRBJ1-2
TGTGCCAGCAGCGAGCCCACAAATTCACCCCTCCACTTT	CASSEPTNSPLHF	TRBV7-6	TRBJ1-6
TGTGCCAGCAGCGTCCAGGGGGGGCCGGACACTGAAGCTTTCTTT	CASSVQGGPDTEAFF	TRBV13	TRBJ1-1
TGTGCCAGTATTCATAACCTCGGAGGACTAGCGGGGGTTAAAGAGACCCAGTACTTC	CASIHNLGGLAGVKETQYF	TRBV19	TRBJ2-5
TGCAGTGCTAGCGACAGGGGCAGCTATAATTCACCCCTCCACTTT	CSASDRGSYNSPLHF	TRBV20-1	TRBJ1-6
TGTGCCAGCATGGGGTCTAGGTATGCGGTCTATGGCTACACCTTC	CASMGSRYAVYGYTF	TRBV14	TRBJ1-2
TGTGCCAGCGGAACCAACCTGAGTGGACAGGGGCCGGGAACCTACAATGAGCAGTTCTTC	CASGTNLSGQGPGTYNEQFF	TRBV11-3	TRBJ2-1
TGTGCCACCAGTGATTCCGTCCTATGGACCACTGAAGCTTTCTTT	CATSDSVLWTTEAFF	TRBV24-1	TRBJ1-1
TGTGCCAGCAGTGACGGACAGGGCGTTGCTGGCTACACCTTC	CASSDGQGVAGYTF	TRBV6-1	TRBJ1-2
TGTGCCAGCAGCTCCGGGGGACATTCCTACCAAGAGACCCAGTACTTC	CASSSGGHSYQETQYF	TRBV13	TRBJ2-5
TGTGCCAGCAGTTTTGCGGGCAGGGCGGGTAGGTACAGGGGCTCTGGGGCCAACGTCCTGACTTTC	CASSFAGRAGRYRGSGANVLTF	TRBV12-4	TRBJ2-6
TGTGCCAGCAGCCCACAGGGGTTCGCAGTTTACAATGAGCAGTTCTTC	CASSPQGFAVYNEQFF	TRBV7-9	TRBJ2-1
TGTGCCTGGAGTGTAGAACACTACGAGCAGTACTTC	CAWSVEHYEQYF	TRBV30	TRBJ2-7
TGTGCCAGCAGTTATCGACTTAATGGTGGCTACACCTTC	CASSYRLNGGYTF	TRBV6-2	TRBJ1-2
TGTGCCAGCACACTAGCGGGCCTTAATACGCAGTATTTT	CASTLAGLNTQYF	TRBV27	TRBJ2-3
TGTGCCAGCAGCTCCGTTCAGGGAGCCGAGACCCAGTACTTC	CASSSVQGAETQYF	TRBV5-4	TRBJ2-5
TGTGCCAGCAGCGTCCGGCCTGAAGAGACCCAGTACTTC	CASSVRPEETQYF	TRBV13	TRBJ2-5
TGTGCCACCAGTGATTCACGGGGGGCATCGGTTAATGAAAAACTGTTTTTT	CATSDSRGASVNEKLFF	TRBV24-1	TRBJ1-4
TGTGCCAGCAGCCCTTGGACAGGGGTTTTTGGGGATCAGCCCCAGCATTTT	CASSPWTGVFGDQPQHF	TRBV13	TRBJ1-5
TGTGCCAGCAGTTACACATGGGACAGACTGGTTGATTCACCCCTCCACTTT	CASSYTWDRLVDSPLHF	TRBV6-5	TRBJ1-6
TGTGCCAGCAGCTTAGACAGGGGGACTGGAAACACCATATATTTT	CASSLDRGTGNTIYF	TRBV7-2	TRBJ1-3
TGTGCCAGCAGTGACTCCATGCTGGAGACAGGGGTTGATGGCTACACCTTC	CASSDSMLETGVDGYTF	TRBV6-4	TRBJ1-2
TGCAGTGCCGCGTCGTCGAACCCTGAAAAACTGTTTTTT	CSAASSNPEKLFF	TRBV20-1	TRBJ1-4
TGTGCCAGCAGACAGCCGGGACAAAGAGGTAATGAAAAACTGTTTTTT	CASRQPGQRGNEKLFF	TRBV6-5	TRBJ1-4
TGTGCCAGCTCACCACCGGGGGGCGAAGCTTTCTTT	CASSPPGGEAFF	TRBV18	TRBJ1-1
TGTGCCAGTAGTATAGGACGAGGGGGATATCAAGAGACCCAGTACTTC	CASSIGRGGYQETQYF	TRBV19	TRBJ2-5
TGTGCCAGCAGCGTACCAGGGGATTCGGCCGGCTCCTACGAGCAGTACTTC	CASSVPGDSAGSYEQYF	TRBV5-6	TRBJ2-7
TGCGCCAGAACAGGGTGGGCAACTAATGAAAAACTGTTTTTT	CARTGWATNEKLFF	TRBV5-1	TRBJ1-4
TGTGCCAGCAACACGGGACAGGGCGGTCCCCCCTACGAGCAGTACTTC	CASNTGQGGPPYEQYF	TRBV7-3	TRBJ2-7
TGTGCCAGCAGCGAATCCTCTAGCGGGACCCATTGTCAAGAGACCCAGTACTTC	CASSESSSGTHCQETQYF	TRBV7-9	TRBJ2-5
TGTGCCAGCAGTGGGGACAGCTCCTACAATGAGCAGTTCTTC	CASSGDSSYNEQFF	TRBV25-1	TRBJ2-1
TGTGCCATCAGGACAGGACAGAGATGTAGCAATCAGCCCCAGCATTTT	CAIRTGQRCSNQPQHF	TRBV10-3	TRBJ1-5
TGTGCCAGCAGCTCTAGCGGGTTACTCAATGAGCAGTTCTTC	CASSSSGLLNEQFF	TRBV5-4	TRBJ2-1
TGTGCCAGCAGCTGCACTCCCAACTTAGACTGTAGGAGCTCCTACGAGCAGTACTTC	CASSCTPNLDCRSSYEQYF	TRBV5-6	TRBJ2-7
TGTGCCAGCAGCGCGACAGGCTCCTACGAGCAGTACTTC	CASSATGSYEQYF	TRBV9	TRBJ2-7
TGCGCCAGCAGCTTCCAGGGGGCTACTCTGGAGCCAACTAATGAAAAACTGTTTTTT	CASSFQGATLEPTNEKLFF	TRBV5-1	TRBJ1-4
TGTGCCAGCAGCATCTCGACCCAGGGGTCGACCTACGAGCAGTACTTC	CASSISTQGSTYEQYF	TRBV7-3	TRBJ2-7
TGTGCCAGCAGCTGGGACAGGGCCCATAGCAATCAGCCCCAGCATTTT	CASSWDRAHSNQPQHF	TRBV5-6	TRBJ1-5
TGTGCCAGCAGCCGAATGAACACTGAAGCTTTCTTT	CASSRMNTEAFF	TRBV3-1	TRBJ1-1
TGCGCCAGCAGCCAAGAAGATGGGGCGAACACCGGGGAGCTGTTTTTT	CASSQEDGANTGELFF	TRBV4-1	TRBJ2-2
TGTGCCAGCAGCGCGGCGGGGGAGGGCAGCAATCAGCCCCAGCATTTT	CASSAAGEGSNQPQHF	TRBV9	TRBJ1-5
TGTGCCAGCAGCTTCGACTACCTACAAGGGACTGCTGGGGCCAACGTCCTGACTTTC	CASSFDYLQGTAGANVLTF	TRBV5-6	TRBJ2-6
TGTGCCAGCAGCTTCAGCAATCAGCCCCAGCATTTT	CASSFSNQPQHF	TRBV5-4	TRBJ1-5
TGTGCCAGCAGCTACTCCAGGGGAGTTACCGCCTCTGGAAACACCATATATTTT	CASSYSRGVTASGNTIYF	TRBV7-2	TRBJ1-3
TGCAGTGCGAAGTACAACTATTACAATGAGCAGTTCTTC	CSAKYNYYNEQFF	TRBV20-1	TRBJ2-1
TGTGCCAGCAGCCCCCAGCCCCCCTTC	CASSPQPPF	TRBV9	TRBJ2-7
TGTGAGCGGGGCTCTGGGGCCAACGTCCTGACTTTC	CERGSGANVLTF	TRBV25-1	TRBJ2-6
TGTGCCAGCAGTTTCGAAACTAGCGGGGTGTCCGACAATGAGCAGTTCTTC	CASSFETSGVSDNEQFF	TRBV28	TRBJ2-1
TGTGCCAGCATGGACAGCCCACACAATGAGCAGTTCTTC	CASMDSPHNEQFF	TRBV28	TRBJ2-1
TGTGCCAGCAGCTCCACCAACCCCAGGGGATATCAGCCCCAGCATTTT	CASSSTNPRGYQPQHF	TRBV7-8	TRBJ1-5
TGTGCCTGGAAACGAGCTGCTTTCTTT	CAWKRAAFF	TRBV30	TRBJ1-1
TGTGCCACAATTTCAGGGACAGGGGGCAGTCAGCCCCAGCATTTT	CATISGTGGSQPQHF	TRBV24-1	TRBJ1-5
TGTGCCAGCAGCGCGTCCCAGTTTCTGGACGAGCAGTACTTC	CASSASQFLDEQYF	TRBV13	TRBJ2-7
TGTGCCACCAGTGAGGTTCGCCTAGGGGTCCGCACTGAAGCTTTCTTT	CATSEVRLGVRTEAFF	TRBV24-1	TRBJ1-1
TGTGCCACCAGCCTCGCCCGGACAGGGTACGCCTACGAGCAGTACTTC	CATSLARTGYAYEQYF	TRBV15	TRBJ2-7
TGTGCCAGCAGCGGGGGATCAGGGACTGGGTGTTATGGCTACACCTTC	CASSGGSGTGCYGYTF	TRBV13	TRBJ1-2
TGTGCCAGCAGCTTACGAGACAGGGCCTACGAGCAGTACTTC	CASSLRDRAYEQYF	TRBV7-9	TRBJ2-7
TGTGCCAGCAGACGCTACACTGAAGCTTTCTTT	CASRRYTEAFF	TRBV6-6	TRBJ1-1
TGTGCCAGCAGCTTGGTTTTCCTCCCAGCGAACTCAGATACGCAGTATTTT	CASSLVFLPANSDTQYF	TRBV5-8	TRBJ2-3
TGTGCCACCCTAATACCCATTCCTGAGCTAGCGGCAGATACGCAGTATTTT	CATLIPIPELAADTQYF	TRBV24-1	TRBJ2-3
TGCGCCAGCAGCCAAGTCCCGAGACTAGCGGGAGCGAACACCGGGGAGCTGTTTTTT	CASSQVPRLAGANTGELFF	TRBV4-1	TRBJ2-2
TGTGCCATCAGTGACCAGGAGACTAGCGGGCGGTACGAGCAGTACTTC	CAISDQETSGRYEQYF	TRBV10-3	TRBJ2-7
TGTGCCACAGCAGGGACTAGCGTTACCGGTCTTACGCAGTATTTT	CATAGTSVTGLTQYF	TRBV19	TRBJ2-3
TGTGCCAGCAGCAGGGGACGGAGCTACGAGCAGTACTTC	CASSRGRSYEQYF	TRBV13	TRBJ2-7
TGTTGCAGTGGCTACACCTTC	CCSGYTF	TRBV19	TRBJ1-2
TGCGTATTCGCCGACAATCAGCCCCAGCATTTT	CVFADNQPQHF	TRBV10-2	TRBJ1-5
TGTGCCAGCAGTGCCGCTGAAGGCTTCGGGGAGAGCTCCTACAATGAGCAGTTCTTC	CASSAAEGFGESSYNEQFF	TRBV2	TRBJ2-1
TGTGCCAGCAGCTTCCCGGGGGGGCCAATCTACGAGCAGTACTTC	CASSFPGGPIYEQYF	TRBV7-9	TRBJ2-7
TGTGCCAGCAGAACCCTCCTACTAGCGGGAGTCGGTACCTACGAGCAGTACTTC	CASRTLLLAGVGTYEQYF	TRBV6-6	TRBJ2-7
TGTGCCGTTCGGTTGGACAGGAGGGAAAAACTGTTTTTT	CAVRLDRREKLFF	TRBV6-4	TRBJ1-4
TGTGCCTGGCCCCAGAGTGAAAAACTGTTTTTT	CAWPQSEKLFF	TRBV30	TRBJ1-4
TGTGCCAGCAGCGCAAGACGAAACATTCAGTACTTC	CASSARRNIQYF	TRBV13	TRBJ2-4
TGTGCCAGCAGAAGACCGGGACTAGCGGTGGACTCCTACGAGCAGTACTTC	CASRRPGLAVDSYEQYF	TRBV2	TRBJ2-7
TGTGCCAGCAGTTCCCTAGAAATAAGACAGGGACTCGGGGTCGAAGAGACCCAGTACTTC	CASSSLEIRQGLGVEETQYF	TRBV27	TRBJ2-5
TGTGCCAGCAGCTCCCTCCCAGGGATTTTACGTTTAGCTAACTATGGCTACACCTTC	CASSSLPGILRLANYGYTF	TRBV3-1	TRBJ1-2
TGTGCCAGCAGTTTAGGTGCAGGGGAGCTCGAGACCCAGTACTTC	CASSLGAGELETQYF	TRBV27	TRBJ2-5
TGTGCCTGGAGTGAGGGGCAGAAGGAAAAACTGTTTTTT	CAWSEGQKEKLFF	TRBV30	TRBJ1-4
TGTGCCAGTAGTATAAAAAACGACCTCGGCTACACCTTC	CASSIKNDLGYTF	TRBV19	TRBJ1-2
TGCAGTGCTAGAGATCTGGACAGGTATAGCAATCAGCCCCAGCATTTT	CSARDLDRYSNQPQHF	TRBV20-1	TRBJ1-5
TGTGCCAGCAGTTTAGGGACAGGGGGGCCTAGCAATCAGCCCCAGCATTTT	CASSLGTGGPSNQPQHF	TRBV27	TRBJ1-5
TGCGCCAGCAGGGAACTAGCGGGAGATAACGAGCAGTACTTC	CASRELAGDNEQYF	TRBV5-1	TRBJ2-7
TGTGCCAGCAGCCAAGCCCTCTCTAACTCCTACGAGCAGTACTTC	CASSQALSNSYEQYF	TRBV14	TRBJ2-7
TGTGCCAGCAGTCCCTGGGTTACCACAGATACGCAGTATTTT	CASSPWVTTDTQYF	TRBV6-5	TRBJ2-3
TGTGCCAGCAGTATGGACAGGGGTGAAGCTTTCTTT	CASSMDRGEAFF	TRBV27	TRBJ1-1
TGTGCCAGCAGTTCCCCCCTACAGCCCCAGCATTTT	CASSSPLQPQHF	TRBV6-1	TRBJ1-5
TGTGCCAGCACAACCCGTTGCGGGGAGAACGAGCAGTACTTC	CASTTRCGENEQYF	TRBV7-3	TRBJ2-7
TGTGCCAGCAGTTTAGGGGGCTCCACTGGAAACACCATATATTTT	CASSLGGSTGNTIYF	TRBV27	TRBJ1-3
TGTGCCAGCAGCAAGAGGGGGCGGAACACTGAAGCTTTCTTT	CASSKRGRNTEAFF	TRBV5-5	TRBJ1-1
TGTGCCAGCAGCCATCCGCGGACAGAAAACACCGGGGAGCTGTTTTTT	CASSHPRTENTGELFF	TRBV13	TRBJ2-2
TGTGCCAGTTCGGGGTTGCGCTCTGGGGCCAACGTCCTGACTTTC	CASSGLRSGANVLTF	TRBV6-6	TRBJ2-6
TGTGCCAGCAGTAGCGGGCAATCTCAAAGTCCAGATACGCAGTATTTT	CASSSGQSQSPDTQYF	TRBV28	TRBJ2-3
TGTGCCAGCAGCCGGGGGGCCGGAGATACGCAGTATTTT	CASSRGAGDTQYF	TRBV7-6	TRBJ2-3
TGTGCCAGCAACGGCGGGATTATACCATACCAGGGACAGGGGTACTTC	CASNGGIIPYQGQGYF	TRBV25-1	TRBJ2-4
TGCAGTGCGAACTCAGGGGTTAGGACTGAAGCTTTCTTT	CSANSGVRTEAFF	TRBV20-1	TRBJ1-1
TGCAGTGCTAGAGGGGGGTGGACAGGGAAAACCGAGCAGTACTTC	CSARGGWTGKTEQYF	TRBV20-1	TRBJ2-7
TGTGCCAGCAGCAGCCAGACGCAGGGGGAAGGGGCCAACGTCCTGACTTTC	CASSSQTQGEGANVLTF	TRBV13	TRBJ2-6
TGTGCTAGTCCCTCAGGAAGTCCAGGACTAAGTTACGAGCAGTACTTC	CASPSGSPGLSYEQYF	TRBV12-5	TRBJ2-7
TGCGCCAGCAGCCCCGAATATCCTAATGAGCAGTTCTTC	CASSPEYPNEQFF	TRBV4-1	TRBJ2-1
TGCGCCTACAGGCTCTGCACAGATACGCAGTATTTT	CAYRLCTDTQYF	TRBV10-1	TRBJ2-3
TGTGCCAGCATGCGCCGGACAGGGAGAAACTATGGCTACACCTTC	CASMRRTGRNYGYTF	TRBV7-7	TRBJ1-2
TGTGCCAGCAGCGATTCCCGGGACAGGGCGCCCTATATGAACACTGAAGCTTTCTTT	CASSDSRDRAPYMNTEAFF	TRBV9	TRBJ1-1
TGTGCCAGCAGCACTGAGACAGGGGGCCGGATGAACACTGAAGCTTTCTTT	CASSTETGGRMNTEAFF	TRBV7-7	TRBJ1-1
TGCGCCAGCCATCGAGGACAGGGCCGGGAATCCCAGCATTTT	CASHRGQGRESQHF	TRBV5-1	TRBJ1-5
TGTGCCAGCAGTCAGGCCTACGAGCAGTACTTC	CASSQAYEQYF	TRBV2	TRBJ2-7
TGTGCCAGCAGCTTATTAGGGACAGGGCAAAACTATGGCTACACCTTC	CASSLLGTGQNYGYTF	TRBV5-4	TRBJ1-2
TGTGCCAGCAGTCTCTTTGGAGACAGGGCCTACAGCTCCTACGAGCAGTACTTC	CASSLFGDRAYSSYEQYF	TRBV6-4	TRBJ2-7
TGTGCCAGCAGCTTAACCCGCATAAGGCCGGGGGCTTTCTTT	CASSLTRIRPGAFF	TRBV7-3	TRBJ1-1
TGTGCCAGCAGCACGAAGGGACAGGTCAATCAGCCCCAGCATTTT	CASSTKGQVNQPQHF	TRBV9	TRBJ1-5
TGCAGTGCAACTACTTCAAGGGGACAGCCCCAGCATTTT	CSATTSRGQPQHF	TRBV20-1	TRBJ1-5
TGCGCCAGCAGCCAAGATTATCCGGGACACCGCGAGCAGTACTTC	CASSQDYPGHREQYF	TRBV4-1	TRBJ2-7
TGTGCTAGTGGTGGGGCTAGACACCAGCGGTCCTACGAGCAGTACTTC	CASGGARHQRSYEQYF	TRBV12-5	TRBJ2-7
TGTGCCATACCTGCGTTAAGACTCAGGCACGAGCAGTACTTC	CAIPALRLRHEQYF	TRBV10-3	TRBJ2-7
TGCAGTGCAAATCGGGGGCTGAACACTGAAGCTTTCTTT	CSANRGLNTEAFF	TRBV20-1	TRBJ1-1
TGTGCCAGCAGCCGGGCAGGGGAGCTTAGCAATCAGCCCCAGCATTTT	CASSRAGELSNQPQHF	TRBV7-3	TRBJ1-5
TGTGCCAGCAGTGGCATCGGCACTGAAGCTTTCTTT	CASSGIGTEAFF	TRBV6-1	TRBJ1-1
TGTGCCACCAGTGATTTGTGCACCACAGGGGGCGTGGGGAGATACGAGCAGTACTTC	CATSDLCTTGGVGRYEQYF	TRBV24-1	TRBJ2-7
TGTGCCACCAGCAGAGTGTTACAGGGGGGTCTCTACAATGAGCAGTTCTTC	CATSRVLQGGLYNEQFF	TRBV15	TRBJ2-1
TGTGCCAGCAGCTTAAAACTTACAGGGGTACCCTATGGCTACACCTTC	CASSLKLTGVPYGYTF	TRBV7-4	TRBJ1-2
TGCGCCAGCAGCATAGCAGCCAATGAGCAGTTCTTC	CASSIAANEQFF	TRBV5-1	TRBJ2-1
