TGTGCCAGCAGTCGGCATAGTGGCTACACCTTC	CASSRHSGYTF	TRBV5-4	TRBJ1-2
TGTGCCAGCATTAAGGCCGGGACTAGACGGCCCGATACGCAGTATTTT	CASIKAGTRRPDTQYF	TRBV27	TRBJ2-3
TGTGCTAGTGGTTTCCAAGGGGGGCGTGGCCAAGAGACCCAGTACTTC	CASGFQGGRGQETQYF	TRBV12-5	TRBJ2-5
TGCGCCAGCAGCTTCTACTGCCGGGGCACCCTCTCGATCACTGAAGCTTTCTTT	CASSFYCRGTLSITEAFF	TRBV5-1	TRBJ1-1
TGCAGTGCTAGAGATCCATACGACAACACTGAAGCTTTCTTT	CSARDPYDNTEAFF	TRBV20-1	TRBJ1-1
TGCAGTGCGGACGCGCCGGGACTAGCCCAGGGGTATGAGCAGTTCTTC	CSADAPGLAQGYEQFF	TRBV20-1	TRBJ2-1
TGTGCCAGCAGCGATGGGGGGGATCTCAACACCGGGGAGCTGTTTTTT	CASSDGGDLNTGELFF	TRBV9	TRBJ2-2
TGCAGTGCTAGCTGGAGTACCTACAATGAGCAGTTCTTC	CSASWSTYNEQFF	TRBV20-1	TRBJ2-1
TGTACGGACAGCGGGTTCACTGAAGCTTTCTTT	CTDSGFTEAFF	TRBV7-9	TRBJ1-1
TGTGCCAGCAGCGGGGCAGGGAAATTATTTATCACCTACGAGCAGTACTTC	CASSGAGKLFITYEQYF	TRBV7-3	TRBJ2-7
TGTGCCAGCAGCACGGGGGACAGGACCGAGCAGTTCTTC	CASSTGDRTEQFF	TRBV7-3	TRBJ2-1
TGTGCCAGCAGCGGTAACGTGGGGCGAAATCAGCCCCAGCATTTT	CASSGNVGRNQPQHF	TRBV5-4	TRBJ1-5
TGCAGTGCTAGGTTACGGGACAGGGGTAAATTGAACACTGAAGCTTTCTTT	CSARLRDRGKLNTEAFF	TRBV20-1	TRBJ1-1
TGTGCCAGCAGCTCAAGCCTCTGGGACAGGAATGAAAAACTGTTTTTT	CASSSSLWDRNEKLFF	TRBV11-1	TRBJ1-4
TGTGCCAGCAGCGGACTAGCGGATACGGCCTACGAGCAGTACTTC	CASSGLADTAYEQYF	TRBV9	TRBJ2-7
TGTGCCAGCAGCGTAGGAATGGACAGGGAGGATGAGCAGTTCTTC	CASSVGMDREDEQFF	TRBV9	TRBJ2-1
TGCAGCGCGGGAGGGACTAGCGGTAGTGAAGAGACCCAGTACTTC	CSAGGTSGSEETQYF	TRBV29-1	TRBJ2-5
TGTGCCTGGAGTGAAAAGGGGGAAAAACTGTTTTTT	CAWSEKGEKLFF	TRBV30	TRBJ1-4
TGTGCCAGCAGTTGTGACAGGGAAAGGGTCAGCTATGGCTACACCTTC	CASSCDRERVSYGYTF	TRBV5-6	TRBJ1-2
TGCGCCAGCAGCCAAGATGTTGGGCCCCGGGACAGGGCTCAAATCTATGGCTACACCTTC	CASSQDVGPRDRAQIYGYTF	TRBV4-3	TRBJ1-2
TGCGCCAGCACCGGGGACAGGGGGGTTCCCGAATATAATTCACCCCTCCACTTT	CASTGDRGVPEYNSPLHF	TRBV10-1	TRBJ1-6
TGTGCCAGCAGCTTAAACAGGGGGCGCCGCAATGGCTACACCTTC	CASSLNRGRRNGYTF	TRBV7-6	TRBJ1-2
TGTGCCAGCAGCTTACCCAACTATGGCTACACCTTC	CASSLPNYGYTF	TRBV7-9	TRBJ1-2
TGTGCCAGCAGAGGGAAGCGCTACGAGCAGTACTTC	CASRGKRYEQYF	TRBV27	TRBJ2-7
TGTGCCTGGGGTCGCAGGGATAACTACGAGCAGTACTTC	CAWGRRDNYEQYF	TRBV30	TRBJ2-7
TGTGCCATCAGTGAGCCGGGACAGGGGCTTAACACCATATATTTT	CAISEPGQGLNTIYF	TRBV10-3	TRBJ1-3
TGTGCCAGCAGTTACGGAGGTAGGGCAGGGTTTAGCAATCAGCCCCAGCATTTT	CASSYGGRAGFSNQPQHF	TRBV6-5	TRBJ1-5
TGTGCCATCAGTGAGTCGATGGGTCCGAACTACACCATATATTTT	CAISESMGPNYTIYF	TRBV10-3	TRBJ1-3
TGTGCCAGCAGTAGGGGTACTGACAGGGGGCAGCATAATTCACCCCTCCACTTT	CASSRGTDRGQHNSPLHF	TRBV25-1	TRBJ1-6
TGTGCCAGCAGCGCGGACAGGGATCAGCCCCAGCATTTT	CASSADRDQPQHF	TRBV7-8	TRBJ1-5
TGTGCCAGCAGTGTTTGGACTAGCGGCCCTGAGCAGTTCTTC	CASSVWTSGPEQFF	TRBV6-5	TRBJ2-1
TGTGCCAGCGAGGGGGCCCGGGGGCGGAGGAGCTCTGGAAACACCATATATTTT	CASEGARGRRSSGNTIYF	TRBV7-2	TRBJ1-3
TGCGCCAGCAGTGAGCGGGGGGTGCCAAGTGAGCAGTACTTC	CASSERGVPSEQYF	TRBV10-1	TRBJ2-7
TGCAGCGACAGGACCAGCAATCAGCCCCAGCATTTT	CSDRTSNQPQHF	TRBV29-1	TRBJ1-5
TGTGCCAGCAGTTACTGGGGGGGCCTCACCTACGAGCAGTACTTC	CASSYWGGLTYEQYF	TRBV6-8	TRBJ2-7
TGCGCCAGCAGCTTGGGGTCTGACAGGGAACCTGCTAATGAAAAACTGTTTTTT	CASSLGSDREPANEKLFF	TRBV5-1	TRBJ1-4
TGTGCCAGCAGTTACTCCCAACCGAGGACGAACTATGGCTACACCTTC	CASSYSQPRTNYGYTF	TRBV6-5	TRBJ1-2
TGTGCCACCAGTGACGGGAGGTCTCCCTACGAGCAGTACTTC	CATSDGRSPYEQYF	TRBV24-1	TRBJ2-7
TGTGCCAGCAGCGGAACTGGTATTGAGACCCAGTACTTC	CASSGTGIETQYF	TRBV9	TRBJ2-5
TGTGCGTTAGAGGGGGAGACCCAGTACTTC	CALEGETQYF	TRBV30	TRBJ2-5
TGTGCCAGCAGCTCAGGGGAGGCCCCCGAACTTCGTAGAAGCAATCAGCCCCAGCATTTT	CASSSGEAPELRRSNQPQHF	TRBV7-9	TRBJ1-5
TGTGCCAGCATGAGGGACAGAGCAACTAATGAAAAACTGTTTTTT	CASMRDRATNEKLFF	TRBV7-9	TRBJ1-4
TGCAGTGCTAGGAGAACCCATTCCGGAGCCGGAATAAAACTGTTTTTT	CSARRTHSGAGIKLFF	TRBV20-1	TRBJ1-4
TGCAGTGCTAGGACCCCCCTGGACAGTGGGCTCTATAATGAAAAACTGTTTTTT	CSARTPLDSGLYNEKLFF	TRBV20-1	TRBJ1-4
TGTGCCATCAGTGGCAACTACGACAGGGGGGTGAACACTGAAGCTTTCTTT	CAISGNYDRGVNTEAFF	TRBV10-3	TRBJ1-1
TGTGCCAGCAGCCAAAGGGGGGCAATTAATCAGCCCCAGCATTTT	CASSQRGAINQPQHF	TRBV7-2	TRBJ1-5
TGTGCCAGCAGCGACAGGACTGAAAAACTGTTTTTT	CASSDRTEKLFF	TRBV3-1	TRBJ1-4
TGTGCCAGCAGTTCTCCGGGACAGGAGGGGACTGGGGCCAACGTCCTGACTTTC	CASSSPGQEGTGANVLTF	TRBV27	TRBJ2-6
TGTGCCAGCATATGGACAGTCAATTCACCCCTCCACTTT	CASIWTVNSPLHF	TRBV7-2	TRBJ1-6
TGTGCCAGCAGCTTAACTCCCTGGACAACAGATACGCAGTATTTT	CASSLTPWTTDTQYF	TRBV7-2	TRBJ2-3
TGTGCCAGCAGCTACCGCCGGGACAGGGGTTCTTCAAGCAATCAGCCCCAGCATTTT	CASSYRRDRGSSSNQPQHF	TRBV5-6	TRBJ1-5
TGTGCCAGCAGCTTGGAGAGGGGGCTCGATCAGCCCCAGCATTTT	CASSLERGLDQPQHF	TRBV11-3	TRBJ1-5
TGCGCCAGCGGGGACGGAAACACCATATATTTT	CASGDGNTIYF	TRBV10-1	TRBJ1-3
TGTGCCAGCAGCTTCGTGCCCGGGACAGGGAGGCTGGTGTCCTACGAGCAGTACTTC	CASSFVPGTGRLVSYEQYF	TRBV11-3	TRBJ2-7
TGTGCCAGCAGCTTAAAACACAGGGATTCACCCCTCCACTTT	CASSLKHRDSPLHF	TRBV11-3	TRBJ1-6
TGTGCGGACGTGCCGACGAGCAATCAGCCCCAGCATTTT	CADVPTSNQPQHF	TRBV30	TRBJ1-5
TGCAGTGCTAGCATAGGGGGGCAACCAGTACCCCTCCACTTT	CSASIGGQPVPLHF	TRBV20-1	TRBJ1-6
TGTGCCAGCAGTTACGGGACAGGGAACCGGGTGCCGGAGAACACTGAAGCTTTCTTT	CASSYGTGNRVPENTEAFF	TRBV6-2	TRBJ1-1
TGTGCCAGCAGCTCCTCAGTCGAGGGGGGCAATCAGCCCCAGCATTTT	CASSSSVEGGNQPQHF	TRBV7-9	TRBJ1-5
TGCAGCGTTGAGACCCCTGAAGCTTTCTTT	CSVETPEAFF	TRBV29-1	TRBJ1-1
TGCAGTGCTACCCACGGCCCATGGGCTATTGGCTACACCTTC	CSATHGPWAIGYTF	TRBV20-1	TRBJ1-2
TGTGCCATGTTTCTAGGGATTACCCAAGCCGGGGAGCTGTTTTTT	CAMFLGITQAGELFF	TRBV27	TRBJ2-2
TGTGCCAGCAGCTTAATTAGCACAGGGTGGGACAATTCACCCCTCCACTTT	CASSLISTGWDNSPLHF	TRBV7-8	TRBJ1-6
TGCAGTGCTAGAGATAGTCAGAGCAGGGAACGAGCTCATCAGCCCCAGCATTTT	CSARDSQSRERAHQPQHF	TRBV20-1	TRBJ1-5
TGTGCCAGCATCCTCCCGGGGGGGTCCAATGAGCAGTTCTTC	CASILPGGSNEQFF	TRBV14	TRBJ2-1
TGTGCCAGCAGTGACCGGGACACGGGGAATCAGCCCCAGCATTTT	CASSDRDTGNQPQHF	TRBV2	TRBJ1-5
TGTGCCAGCAGCCCATTTCGCCGACAGGGACACGAGCAGTACTTC	CASSPFRRQGHEQYF	TRBV7-3	TRBJ2-7
TGTGCCTGGAGACCGGGGGGTAGCTTACCCGGGGAGCTGTTTTTT	CAWRPGGSLPGELFF	TRBV30	TRBJ2-2
TGTGCCAGCAGCAACTACAGACTAGGGCTCACCGGGGAGCTGTTTTTT	CASSNYRLGLTGELFF	TRBV7-2	TRBJ2-2
TGTGCCAGCAGCTTTAGGGGAGTTGGGGCAACTAATGAAAAACTGTTTTTT	CASSFRGVGATNEKLFF	TRBV5-6	TRBJ1-4
TGCGCCAGCAGCTGGACACCCCATCTAGCACCGGGGGAGAGCACAGATACGCAGTATTTT	CASSWTPHLAPGESTDTQYF	TRBV5-1	TRBJ2-3
TGTGCCAGCAGGAACTGGGTATTTCAATATGAGCAGTTCTTC	CASRNWVFQYEQFF	TRBV12-4	TRBJ2-1
TGTGCCAGCGCGACGAGGGGATACACTGAAGCTTTCTTT	CASATRGYTEAFF	TRBV27	TRBJ1-1
TGTGCCAGCAGAAAACAGTACAGGGGGTCCGAAAAACTGTTTTTT	CASRKQYRGSEKLFF	TRBV11-2	TRBJ1-4
TGCGCCAGCAGCCAAGAGTCAAGCCCTCAGGGGCATGAGCAGTTCTTC	CASSQESSPQGHEQFF	TRBV4-1	TRBJ2-1
TGTGCCACCAGCAGGGAAGGGAGGGATACCTACGAGCAGTACTTC	CATSREGRDTYEQYF	TRBV15	TRBJ2-7
TGTGCCACCAGCAGTCCCATTGACAGGGGGGTAGATCAGCCCCAGCATTTT	CATSSPIDRGVDQPQHF	TRBV15	TRBJ1-5
TGTGCCAGCAGTGCTCACCGGGCGGGAAAAGCCAAAAACATTCAGTACTTC	CASSAHRAGKAKNIQYF	TRBV2	TRBJ2-4
TGTGCCAGCAGTTCAGGAAGGGGGGGCAACACTGAAGCTTTCTTT	CASSSGRGGNTEAFF	TRBV25-1	TRBJ1-1
TGTGCCAGCAGGGCACTAGCGGGAGGGTACCCACCCTTC	CASRALAGGYPPF	TRBV7-9	TRBJ2-7
TGTGCCAGCAGTTCGACTAGCGCTTTAAGCTCCTACAATGAGCAGTTCTTC	CASSSTSALSSYNEQFF	TRBV12-3	TRBJ2-1
TGTGCCAGCAGCTTGTGCGGACACCCCAACACTGAAGCTTTCTTT	CASSLCGHPNTEAFF	TRBV7-9	TRBJ1-1
TGTGCCAGCAGGGTGGGCCCAGGGGGCGAAAAACTGTTTTTT	CASRVGPGGEKLFF	TRBV6-1	TRBJ1-4
TGTGCTAGTGGTTTGGCAGGGGCCCACAGAGAGACCCAGTACTTC	CASGLAGAHRETQYF	TRBV12-5	TRBJ2-5
TGTGCCAGCAGCCAACCAGCAGGGGGCAATCAGCCCCAGCATTTT	CASSQPAGGNQPQHF	TRBV13	TRBJ1-5
TGTGCCACCTGGGGGGCGTACTTC	CATWGAYF	TRBV24-1	TRBJ2-5
TGCGCCAGCAGTAGCGGGAGTGTATGGTTGGTCGAGACCCAGTACTTC	CASSSGSVWLVETQYF	TRBV10-1	TRBJ2-5
TGTGCCAGCTCGGGGGGGGGCTACGAGCAGTACTTC	CASSGGGYEQYF	TRBV6-5	TRBJ2-7
TGCGCCAGCAGCTTGCCCAACGCCCCGGGTGAAGGCTACACCTTC	CASSLPNAPGEGYTF	TRBV5-1	TRBJ1-2
TGCGCCAGCAGCTTGCCTAGACATACGCAGTATTTT	CASSLPRHTQYF	TRBV5-1	TRBJ2-3
TGCGCCAGCAGTATAAACCAGGTAGGGGACCTGAACACTGAAGCTTTCTTT	CASSINQVGDLNTEAFF	TRBV10-2	TRBJ1-1
TGCAGTGTCCCCGCCCTGGGGGATGTTCAGCCCCAGCATTTT	CSVPALGDVQPQHF	TRBV20-1	TRBJ1-5
TGTGCCAGCAGTTTAGGGCGGTGGCTTGATTCAACTAATGAAAAACTGTTTTTT	CASSLGRWLDSTNEKLFF	TRBV12-4	TRBJ1-4
TGTGCCAGCAGTGTCATCAGTCATCAGCCCCAGCATTTT	CASSVISHQPQHF	TRBV2	TRBJ1-5
TGTGCCAGCAGTTTCGCAAGAAAAGAAGTAATGGCGAAAGAGACCCAGTACTTC	CASSFARKEVMAKETQYF	TRBV6-4	TRBJ2-5
TGTGCCAGCATGTCAGCGGGGCAAGAGACCCAGTACTTC	CASMSAGQETQYF	TRBV28	TRBJ2-5
TGCAGCGTTGCGGGTTATAGGTGTCGAATTTCCTACGAGCAGTACTTC	CSVAGYRCRISYEQYF	TRBV29-1	TRBJ2-7
TGTGCCAGCAGCGATTGGGACCCCGCCAGACTAGCGGTAATAGATACGCAGTATTTT	CASSDWDPARLAVIDTQYF	TRBV7-3	TRBJ2-3
TGTGCCAAACACTCTAAGTTGAATAGCAATCAGCCCCAGCATTTT	CAKHSKLNSNQPQHF	TRBV27	TRBJ1-5
TGTGCCTGGAGTCGGAGCTACGAGCAGTACTTC	CAWSRSYEQYF	TRBV30	TRBJ2-7
TGTGCCAGCAGCCGGGACAGGGGGCAGGCTGAAGCTTTCTTT	CASSRDRGQAEAFF	TRBV5-6	TRBJ1-1
TGTGCCAGCAGGTCCTCGACTAGCGGGGGGAACTACAATGAGCAGTTCTTC	CASRSSTSGGNYNEQFF	TRBV7-2	TRBJ2-1
TGTGCCAGCAGCGAGGGAGAGTATCGCTATGGCTACACCTTC	CASSEGEYRYGYTF	TRBV5-4	TRBJ1-2
TGTGCCAGCAAAACAGGGTGCAATGAGCAGTTCTTC	CASKTGCNEQFF	TRBV25-1	TRBJ2-1
TGCAGTGCTACCGACAGGAAGTTCGGGCTCGCCTACGAGCAGTACTTC	CSATDRKFGLAYEQYF	TRBV20-1	TRBJ2-7
TGTGCCAGCAGTGAACAGAAAGGGAACACTGAAGCTTTCTTT	CASSEQKGNTEAFF	TRBV2	TRBJ1-1
TGTGCCAGCGCGACACAGGGGCCGAAGTACTTC	CASATQGPKYF	TRBV7-8	TRBJ2-7
TGTGCCATCAATGGCTACACCTTC	CAINGYTF	TRBV7-2	TRBJ1-2
TGTGCCACCAGCCCTCATGGCAATAGACAGGGCTACACCTTC	CATSPHGNRQGYTF	TRBV24-1	TRBJ1-2
TGTGCCAGTAGTAGTCCGACTAGCGGCCCTAGCACAGATACGCAGTATTTT	CASSSPTSGPSTDTQYF	TRBV19	TRBJ2-3
TGTGCCAGCAGCACCGACAGGGAGGACTACGAGCAGTACTTC	CASSTDREDYEQYF	TRBV9	TRBJ2-7
TGCGCCAGCAGCCATGGGGGGACTAGCGGGTATGAGCAGTTCTTC	CASSHGGTSGYEQFF	TRBV4-3	TRBJ2-1
TGTGCCAGCAGGACCGGGGCCTCTGATACGCAGTATTTT	CASRTGASDTQYF	TRBV3-1	TRBJ2-3
TGTGCCAGCAGTCCGAGGTCCAATGAGCAGTTCTTC	CASSPRSNEQFF	TRBV28	TRBJ2-1
TGCGCCACCTTCTGGGAACCACACAATGAGCAGTTCTTC	CATFWEPHNEQFF	TRBV10-2	TRBJ2-1
TGTGCCAGCAGCGAAGGACCGAGGGGAGAGAGATCCTACGAGCAGTACTTC	CASSEGPRGERSYEQYF	TRBV13	TRBJ2-7
TGTGCCAGCAGCACTGGGGGGCGAGAGCAGTACTTC	CASSTGGREQYF	TRBV13	TRBJ2-7
TGTGCCAGCAGCCCATGGAGGGGGGGCTACACCTTC	CASSPWRGGYTF	TRBV6-5	TRBJ1-2
TGTGCCTGGGACGGGAGGTCCTACGAGCAGTACTTC	CAWDGRSYEQYF	TRBV30	TRBJ2-7
TGTGCCAGCAGCTTGAATGGTGAGGCGAATTCACCCCTCCACTTT	CASSLNGEANSPLHF	TRBV7-6	TRBJ1-6
TGTGCCAGGTGTCGTCCCGGGACAAGCAATCAGCCCCAGCATTTT	CARCRPGTSNQPQHF	TRBV28	TRBJ1-5
TGTGCCAGCAGTTTGACAGGGGGACTAGGTTGTGGCAATCAGCCCCAGCATTTT	CASSLTGGLGCGNQPQHF	TRBV27	TRBJ1-5
TGTGCCAGCAGCTTACCGGGGGTTATGCCGTATAGCAATCAGCCCCAGCATTTT	CASSLPGVMPYSNQPQHF	TRBV13	TRBJ1-5
TGTGCCAGTGGGGAGCCTACTAGCGGGAGGGCGGGGTACGAGCAGTACTTC	CASGEPTSGRAGYEQYF	TRBV6-5	TRBJ2-7
TGTGCCAGCAGCTCGAGGGGCGGGAGGGCGGGAAACACCATATATTTT	CASSSRGGRAGNTIYF	TRBV7-8	TRBJ1-3
TGTGCCAGCAGTGACACTGAGGGGTGTTCCACTGAAGCTTTCTTT	CASSDTEGCSTEAFF	TRBV6-4	TRBJ1-1
TGCGCCAGCAGCCCATCCTACACTGAAGCTTTCTTT	CASSPSYTEAFF	TRBV4-3	TRBJ1-1
TGCAGCGTCACTTTCCACCCCCACAGGGTATACAATGAGCAGTTCTTC	CSVTFHPHRVYNEQFF	TRBV29-1	TRBJ2-1
TGCGCCAGCTTTCTCGAAGTCGCCTACGAGCAGTACTTC	CASFLEVAYEQYF	TRBV10-1	TRBJ2-7
TGTGCCAGCAGTGAGACAGGACGGAACACTGAAGCTTTCTTT	CASSETGRNTEAFF	TRBV6-1	TRBJ1-1
TGCGCCAGCTGTACCTACAACGATACGCAGTATTTT	CASCTYNDTQYF	TRBV5-1	TRBJ2-3
TGTGCCACCAGTGATTTGCGGGACAGTTGCGAAGAAGCTTTCTTT	CATSDLRDSCEEAFF	TRBV24-1	TRBJ1-1
TGTGCCAGCAGGGGGTCTGGGGGGGCTCAAAACGAGCAGTACTTC	CASRGSGGAQNEQYF	TRBV7-4	TRBJ2-7
TGTGCCAGCCGATGGACTAGCGGGAAATACAATGAGCAGTTCTTC	CASRWTSGKYNEQFF	TRBV11-2	TRBJ2-1
TGCAGTGCTCGGACGGGGGGGAACACTGAAGCTTTCTTT	CSARTGGNTEAFF	TRBV20-1	TRBJ1-1
TGCGCCAGCAGCCTCACGGGAAACACCATATATTTT	CASSLTGNTIYF	TRBV4-1	TRBJ1-3
TGCAGTGCTAGAGCGGTGGGGGGGAAAAACATTCAGTACTTC	CSARAVGGKNIQYF	TRBV20-1	TRBJ2-4
TGTGCCAGCAGCTTGGAACGGGGTTCGAGCTCCTACGAGCAGTACTTC	CASSLERGSSSYEQYF	TRBV5-4	TRBJ2-7
TGTGCCAGTAGCCGCCAGGGCGATAGCTATGGCTACACCTTC	CASSRQGDSYGYTF	TRBV19	TRBJ1-2
TGTGCCAGCAGCTCACAGGGGGGACACACTGAAGCTTTCTTT	CASSSQGGHTEAFF	TRBV5-4	TRBJ1-1
TGTGCCACCAGTGATTTGCAGAAAAAGGGAACTAGCGGGAGTGAAGAGACCCAGTACTTC	CATSDLQKKGTSGSEETQYF	TRBV24-1	TRBJ2-5
TGTGCCAGCAGCATCAAGCGGGAGAAATCTTATACCGAGACCCAGTACTTC	CASSIKREKSYTETQYF	TRBV5-4	TRBJ2-5
TGTGCCAGCAGAGGGAGCTACGAGCAGTACTTC	CASRGSYEQYF	TRBV7-3	TRBJ2-7
TGCGCCAGCAGCCCCGGGACAGGGGGCGACCAATGCGACCAGAACACTGAAGCTTTCTTT	CASSPGTGGDQCDQNTEAFF	TRBV4-1	TRBJ1-1
TGTGCCAGCAGCCGGAGGACAGGGGGCCTTGATGAGCAGTTCTTC	CASSRRTGGLDEQFF	TRBV3-1	TRBJ2-1
TGTGCCAGCGTAAGGACAGGGAGGGTCGAGCAGTACTTC	CASVRTGRVEQYF	TRBV25-1	TRBJ2-7
TGTGCCAGCAGTGACAGGGGCTGGAGCTCCTATAATTCACCCCTCCACTTT	CASSDRGWSSYNSPLHF	TRBV6-4	TRBJ1-6
TGTGCCAGCTCCGAACAAGTTGAAAAACTGTTTTTT	CASSEQVEKLFF	TRBV28	TRBJ1-4
TGTGCCACCAGCAGACCCCCAAAGGGGTCAGATGTTCAGCCCCAGCATTTT	CATSRPPKGSDVQPQHF	TRBV15	TRBJ1-5
TGTGCCAGCAGCCCCTCCTATCCAAACCGGGACAGGCGAGCCAAAAACATTCAGTACTTC	CASSPSYPNRDRRAKNIQYF	TRBV13	TRBJ2-4
TGTGCCAGCAGCCATAGGAGGACTTCGACCCAGTACTTC	CASSHRRTSTQYF	TRBV13	TRBJ2-5
TGTGCCAGCAGCCAAGCCCCCGCGGGAGGGGGCTACACCTTC	CASSQAPAGGGYTF	TRBV4-2	TRBJ1-2
TGTGCCAGCAGCCAACGTTTGGAGCGACAGGCCTACAATGAGCAGTTCTTC	CASSQRLERQAYNEQFF	TRBV14	TRBJ2-1
TGTGCCAGCAGACCTCCTGGTCCTACGGACAGGGGGGTAGGAAACACCATATATTTT	CASRPPGPTDRGVGNTIYF	TRBV6-1	TRBJ1-3
TGTGCCATCATTGGGCAGGGGGCGTCCCACACTGAAGCTTTCTTT	CAIIGQGASHTEAFF	TRBV10-3	TRBJ1-1
TGCGCCAGCACCACAGGGTATGAGCAGTACTTC	CASTTGYEQYF	TRBV5-1	TRBJ2-7
TGTGCCAGCAGCTTAGATTTAACCAGGGAAGGCTGGTTGAATCAGCCCCAGCATTTT	CASSLDLTREGWLNQPQHF	TRBV11-3	TRBJ1-5
TGCAGCGTCCGGGACAAGGTTCACACCTTC	CSVRDKVHTF	TRBV29-1	TRBJ1-2
TGTGCCAGCAGCCGCTGTGGTAGGGGTTGGAGTTCTTGGGACGAAAAACTGTTTTTT	CASSRCGRGWSSWDEKLFF	TRBV7-3	TRBJ1-4
TGTGCCAGCAGTCCCAGGGATTCCAGTGATTGCAATCAGCCCCAGCATTTT	CASSPRDSSDCNQPQHF	TRBV6-1	TRBJ1-5
TGTGCCAGCAGCCAAGACCATCCCAAGGGGGGGGGACAAGAGACCCAGTACTTC	CASSQDHPKGGGQETQYF	TRBV4-2	TRBJ2-5
TGTGCCAGCAGCAGGGCGGGACAGGGGCACTACAATGAGCAGTTCTTC	CASSRAGQGHYNEQFF	TRBV7-3	TRBJ2-1
TGCCCCGAGGGGGGGGGGGCCGACATTCAGTACTTC	CPEGGGADIQYF	TRBV5-1	TRBJ2-4
TGTGCCAGCAGCCACGAACCGATGTACGAGCAGTACTTC	CASSHEPMYEQYF	TRBV11-3	TRBJ2-7
TGCAGCGTAGATAATGATTCTGAAGCTTTCTTT	CSVDNDSEAFF	TRBV29-1	TRBJ1-1
TGTGCCAGCAGAAGGACAGAAAAACTGTTTTTT	CASRRTEKLFF	TRBV6-1	TRBJ1-4
TGTGCCAGCAGCTTATCTCGACTAGGTATTTCCTTTTCTAATGAAAAACTGTTTTTT	CASSLSRLGISFSNEKLFF	TRBV11-3	TRBJ1-4
TGTGCCAGCAGTAATGACAGGACCGACTGTAATGAAAAACTGTTTTTT	CASSNDRTDCNEKLFF	TRBV6-4	TRBJ1-4
TGCGCCAGCATGCAAGTGGGGGGGGGGGCACAGGAGCAGTACTTC	CASMQVGGGAQEQYF	TRBV10-2	TRBJ2-7
TGTGCCACCAGTGATCTAGGGTTAGACCAGCATTTT	CATSDLGLDQHF	TRBV24-1	TRBJ1-5
TGTGCCAGCAGGAGTGTCGCAGACAAGAACACCGGGGAGCTGTTTTTT	CASRSVADKNTGELFF	TRBV28	TRBJ2-2
TGTGCCAGCAGTAGAGACAGGGGGCGAAGCAATCAGCCCCAGCATTTT	CASSRDRGRSNQPQHF	TRBV6-2	TRBJ1-5
TGTGCCAGCAGCCCCCTGACAGACTACGAGCAGTACTTC	CASSPLTDYEQYF	TRBV7-9	TRBJ2-7
TGTGCCAGCAGTTACTCGGGCATACCGGTCCTCTACAATGAGCAGTTCTTC	CASSYSGIPVLYNEQFF	TRBV6-6	TRBJ2-1
TGTGCCAGCAGCCCTGGGGAGGGAGATACGCAGTATTTT	CASSPGEGDTQYF	TRBV9	TRBJ2-3
TGTGCCATCTCCCCACAGGGGGCCCTTTATCAGCCCCAGCATTTT	CAISPQGALYQPQHF	TRBV2	TRBJ1-5
TGTGCCAGCAGTGAACTAGGACTAGCGGGTTCCTACGAGCAGTACTTC	CASSELGLAGSYEQYF	TRBV6-1	TRBJ2-7
TGTGCCAGCAGAAAAACGGGGGGAAGCTACAATGAGCAGTTCTTC	CASRKTGGSYNEQFF	TRBV6-6	TRBJ2-1
TGCCTAGCAAGGACCTACGAGCAGTACTTC	CLARTYEQYF	TRBV20-1	TRBJ2-7
TGTGCCAGCAGCATTCCGGGACAGGGGACTGAAGCTTTCTTT	CASSIPGQGTEAFF	TRBV13	TRBJ1-1
TGTGCCAGCAGCTCGCTCAGGACAGGGGGCTATGGCTACACCTTC	CASSSLRTGGYGYTF	TRBV7-3	TRBJ1-2
TGCGCCAGCAGCTCCCCAGGAGGTCTGAGTGAAGCTTTCTTT	CASSSPGGLSEAFF	TRBV5-1	TRBJ1-1
TGCGCCAGCAGCTGGACAGGCCCGTACGAGCAGTACTTC	CASSWTGPYEQYF	TRBV5-1	TRBJ2-7
TGTGCCAGCAGCTTGGGGACAGGCCGCTACGAGCAGTACTTC	CASSLGTGRYEQYF	TRBV7-9	TRBJ2-7
TGCGCCAGCAGCTACAAACAGGGTTGGGAGACGAACACTGAAGCTTTCTTT	CASSYKQGWETNTEAFF	TRBV5-1	TRBJ1-1
TGTGCCAGCAGCGTAGCCCTCGAGGGGGGCACAGATACGCAGTATTTT	CASSVALEGGTDTQYF	TRBV9	TRBJ2-3
TGTGCCAGCAGTTCGGGGGGCGTAGCCTACGAGCAGTACTTC	CASSSGGVAYEQYF	TRBV6-5	TRBJ2-7
TGTGCCAGCAGCCCGCCCTGGGCCGTTCACAGGGCCTACGAGCAGTACTTC	CASSPPWAVHRAYEQYF	TRBV3-1	TRBJ2-7
TGTGCCACCAGCAGAGATCGACCCATATTTATGAACACTGAAGCTTTCTTT	CATSRDRPIFMNTEAFF	TRBV15	TRBJ1-1
TGCGCCAGCAGCTGGATCCCTGGACAGGGAACCGGGGAGCTGTTTTTT	CASSWIPGQGTGELFF	TRBV5-1	TRBJ2-2
TGTGCCAGCAGCACTTCCGGGACTAGCGGGAGTTTACTTGAAGCTTTCTTT	CASSTSGTSGSLLEAFF	TRBV11-3	TRBJ1-1
TGTGCCAGTAGTATAGATCTAAGACCGTCGTGGTGTGGCTACACCTTC	CASSIDLRPSWCGYTF	TRBV19	TRBJ1-2
TGTGCCAGCAGTTTCTTTTCACCGGACAATCAGCCCCAGCATTTT	CASSFFSPDNQPQHF	TRBV27	TRBJ1-5
TGTGCCAGCAGGGACCCCCGGGGCCTTGAAGCTTTCTTT	CASRDPRGLEAFF	TRBV6-5	TRBJ1-1
TGTGCCAGCAGTTATTCCCCCTACTCAACTGACTACGAGCAGTACTTC	CASSYSPYSTDYEQYF	TRBV6-9	TRBJ2-7
TGTGCCAGCAGCTTAGTTAGACAGGGGTTGAATCAGCCCCAGCATTTT	CASSLVRQGLNQPQHF	TRBV11-2	TRBJ1-5
TGTGCCAGCAGTCTAGCGGGTAGCTACGAGCAGTACTTC	CASSLAGSYEQYF	TRBV28	TRBJ2-7
TGTGCCAGCAGTTACCACACATCGGCTACTGAAGCTTTCTTT	CASSYHTSATEAFF	TRBV28	TRBJ1-1
TGCGCCAGCAGCCAAGATCCACAACATGGGGACAGGGGGAGTGATACGCAGTATTTT	CASSQDPQHGDRGSDTQYF	TRBV4-1	TRBJ2-3
TGTGCCATCAGTGAGTCGCCCAGACGCTTAGCCGGGGAGCTGTTTTTT	CAISESPRRLAGELFF	TRBV10-3	TRBJ2-2
TGTGCCAGAGAAAGTGGAACAGATACGCAGTATTTT	CARESGTDTQYF	TRBV7-4	TRBJ2-3
TGTGCCAGCTCTACAGACCGGGAATGGGAGACCCAGTACTTC	CASSTDREWETQYF	TRBV7-2	TRBJ2-5
TGCGCCAGCAGCCATAAGTTTCAAGGAGGGCGAGTAGCCAAAAACATTCAGTACTTC	CASSHKFQGGRVAKNIQYF	TRBV4-1	TRBJ2-4
TGCAGTGCTAGAACCCCGGGACAGGGGGAAAAACTGTTTTTT	CSARTPGQGEKLFF	TRBV20-1	TRBJ1-4
TGTGCCAGCAGAATGCTAGCGGGAGGATACAATGAGCAGTTCTTC	CASRMLAGGYNEQFF	TRBV5-4	TRBJ2-1
TGTGCCAGCAGCTGGCTACCTAATCAGCCCCAGCATTTT	CASSWLPNQPQHF	TRBV5-5	TRBJ1-5
TGTGCCAGCATCCTAGGGTGCAATGAGCAGTTCTTC	CASILGCNEQFF	TRBV2	TRBJ2-1
TGCAGTGCTAGACCGGGACAGGGAGAAGCTTTCTTT	CSARPGQGEAFF	TRBV20-1	TRBJ1-1
TGTGCCAGCAGTTTACCCTTGGGGAGGTCACAGCCCCAGCATTTT	CASSLPLGRSQPQHF	TRBV27	TRBJ1-5
TGTGCCAGCAGTTTATCGGGAGGGGGGGTAGACGAGCAGTACTTC	CASSLSGGGVDEQYF	TRBV27	TRBJ2-7
TGCGCCAGCAGCCACACCCAGACAGTCAAGCTAACTAATGAAAAACTGTTTTTT	CASSHTQTVKLTNEKLFF	TRBV4-3	TRBJ1-4
TGTGCCAGCAGTTACTTGGTCACAAGCTACGAGCAGTACTTC	CASSYLVTSYEQYF	TRBV6-3	TRBJ2-7
TGTGCCAGCTCCCGGAGCTCCTATAATTCACCCCTCCACTTT	CASSRSSYNSPLHF	TRBV7-4	TRBJ1-6
TGCGCCAGCAGCCAAGATTGGGGCCCGGTTCGGGATCGTGAAGCTTTCTTT	CASSQDWGPVRDREAFF	TRBV4-1	TRBJ1-1
TGTGCCACCAGGGATAGCGGGCCGGGGGGCGGGGAGCTGTTTTTT	CATRDSGPGGGELFF	TRBV24-1	TRBJ2-2
TGTGCCAGCAGCTTAGGTGCCACAGATACGCAGTATTTT	CASSLGATDTQYF	TRBV7-9	TRBJ2-3
TGTGCCAGCAGTTACCGCGGGGATGAGCAGTTCTTC	CASSYRGDEQFF	TRBV6-5	TRBJ2-1
TGTGCCAGCAGACACCCGGGACGTGCTGATTCGGAAGAGACCCAGTACTTC	CASRHPGRADSEETQYF	TRBV6-2	TRBJ2-5
TGTGCTAGTGGTTTGGTACTGGGGCGGAACACCTTC	CASGLVLGRNTF	TRBV12-5	TRBJ1-2
TGCAGTGCTAGGAGCTTCCGGGTAGAGGCGTCACCCCTCCACTTT	CSARSFRVEASPLHF	TRBV20-1	TRBJ1-6
TGTGCCAGCAGCGAGAAAACTCAGTACAATGAGCAGTTCTTC	CASSEKTQYNEQFF	TRBV11-2	TRBJ2-1
TGTGCCAGCAGTTTGAACCGCGGGGGTTATCGCTCCTACGAGCAGTACTTC	CASSLNRGGYRSYEQYF	TRBV27	TRBJ2-7
TGTGCCAGCAGCCGCCCTCCCCACTGTAGGCGATTCAACACTGAAGCTTTCTTT	CASSRPPHCRRFNTEAFF	TRBV7-2	TRBJ1-1
TGCAGCGCCGAGGCAGGGGGCGATTTAAATCAGCCCCAGCATTTT	CSAEAGGDLNQPQHF	TRBV29-1	TRBJ1-5
TGTGCCAGCAGCCATAGGTCGGATAATCAGCCCCAGCATTTT	CASSHRSDNQPQHF	TRBV3-1	TRBJ1-5
TGCGCCAGCAGCCCTACAGGGCGGCCCTACGAGCAGTACTTC	CASSPTGRPYEQYF	TRBV5-1	TRBJ2-7
TGCAGTGCTAGAGATGCTGGGCCGACTAGCCGCACAGATACGCAGTATTTT	CSARDAGPTSRTDTQYF	TRBV20-1	TRBJ2-3
TGTGCCACCAGTGATATGAGACAGGGGGCGAACACTGAAGCTTTCTTT	CATSDMRQGANTEAFF	TRBV24-1	TRBJ1-1
TGTGCCAGCAGCTACGAACGAATAGCGGGGGGGGGGGCATACGAGCAGTACTTC	CASSYERIAGGGAYEQYF	TRBV7-3	TRBJ2-7
TGTGCTAGTGGTTTGGTAACAGGGCCCCTTAACACTGAAGCTTTCTTT	CASGLVTGPLNTEAFF	TRBV12-5	TRBJ1-1
TGTGCCAGCAGCATCGATACCCCTAGGCCGGCAAGACATGAGCAGTTCTTC	CASSIDTPRPARHEQFF	TRBV13	TRBJ2-1
TGTGCCAGCAGCACAGGGGGGGGCCCCGACTCCTACGAGCAGTACTTC	CASSTGGGPDSYEQYF	TRBV7-9	TRBJ2-7
TGTGCCAGCAGCTCGCCGGATAGTACGAGGCTCTACGAGCAGTACTTC	CASSSPDSTRLYEQYF	TRBV7-2	TRBJ2-7
TGCAGTGCTTACCGGGACAGGGTTCACTCACGCTCCTATAATTCACCCCTCCACTTT	CSAYRDRVHSRSYNSPLHF	TRBV20-1	TRBJ1-6
TGCAGTGCAGCGGGGGGGCAGTCTAACCTTAACAATGAGCAGTTCTTC	CSAAGGQSNLNNEQFF	TRBV20-1	TRBJ2-1
TGTGCCTGGCCGTCCACTAGCGGGAGCCCACTCACAGATACGCAGTATTTT	CAWPSTSGSPLTDTQYF	TRBV30	TRBJ2-3
TGTGCCACCAGCAGACAAATGTACAGGGGCAATCAGCCCCAGCATTTT	CATSRQMYRGNQPQHF	TRBV15	TRBJ1-5
TGTGCTAGAGCCAGCGGGAGGGATCACACTGAAGCTTTCTTT	CARASGRDHTEAFF	TRBV12-5	TRBJ1-1
TGTGCCACGGTGCCAGGCAGGGGGCTACCTAGCAATCAGCCCCAGCATTTT	CATVPGRGLPSNQPQHF	TRBV6-3	TRBJ1-5
TGCGCCAGAGGTGGGACGTTTAATGAGCAGTTCTTC	CARGGTFNEQFF	TRBV10-1	TRBJ2-1
TGTGCCAGCGACGGGGGCGACTATAGCAATCAGCCCCAGCATTTT	CASDGGDYSNQPQHF	TRBV19	TRBJ1-5
TGTGCCAGCAGCCAAGATCACCGACTAGCGGGGCGTCGGTTCCCCGATGAGCAGTACTTC	CASSQDHRLAGRRFPDEQYF	TRBV4-2	TRBJ2-7
TGTGCCAGCAGCCGGGGGGGCCCTCTTGTGAAGAAGGGGATGTCCGGGTACGAGCAGTACTTC	CASSRGGPLVKKGMSGYEQYF	TRBV27	TRBJ2-7
TGTGCCAGCAGTTACCCAACCACGACCACTAGCGGGGAGTTAGAGACCCAGTACTTC	CASSYPTTTTSGELETQYF	TRBV6-5	TRBJ2-5
TGTGCCAGCAGCCAAGATGACCTAGCGGGCCCTAACGAGCAGTACTTC	CASSQDDLAGPNEQYF	TRBV14	TRBJ2-7
TGTGCCTGGAGTGTAGGCGGGAGGGGGAACACCGGGGAGCTGTTTTTT	CAWSVGGRGNTGELFF	TRBV30	TRBJ2-2
TGTGCCAGCAGCTTTAGGAGGGTGTTGGACTCCTACGAGCAGTACTTC	CASSFRRVLDSYEQYF	TRBV7-9	TRBJ2-7
TGTGCCAGCAGCCTAGTGACAGGGAAGGGGCCCCAGCATTTT	CASSLVTGKGPQHF	TRBV4-2	TRBJ1-5
TGCGCCAGCGGGGGGGGGATGTACAATGAGCAGTTCTTC	CASGGGMYNEQFF	TRBV5-1	TRBJ2-1
TGTGCCAGCAGCCAAGGTGAAAACAGGGGGACTTATAGCAATCAGCCCCAGCATTTT	CASSQGENRGTYSNQPQHF	TRBV14	TRBJ1-5
TGCGCCAGCAGTGAGGGGGGCTACACCTTC	CASSEGGYTF	TRBV10-1	TRBJ1-2
TGTGCCAGCGGGGTAGCTTTCTTT	CASGVAFF	TRBV25-1	TRBJ1-1
TGTGCCAGCAGCCCGACAGGGAGCGTAGTCGGCAATCAGCCCCAGCATTTT	CASSPTGSVVGNQPQHF	TRBV6-2	TRBJ1-5
TGTGCCTGCAGGCCCGGGACAGGGGCAGACGAGCAGTACTTC	CACRPGTGADEQYF	TRBV30	TRBJ2-7
TGTGCCTGGAGGGGACCAGACACTGAAGCTTTCTTT	CAWRGPDTEAFF	TRBV30	TRBJ1-1
TGTGCCAGCAGCTCCGTTTGGGGGTTTGTGATTGACTATGGCTACACCTTC	CASSSVWGFVIDYGYTF	TRBV11-2	TRBJ1-2
TGTGCCAGCAGCCGAAAGAGGGGCATGAACACTGAAGCTTTCTTT	CASSRKRGMNTEAFF	TRBV13	TRBJ1-1
TGCGCCAGCAGTAGGACAGGGGGAAGCCTGTTTTTT	CASSRTGGSLFF	TRBV10-2	TRBJ2-2
TGTGCCAGCAGCTTAGGGACAGGGCGTGCTTTCTTT	CASSLGTGRAFF	TRBV7-8	TRBJ1-1
TGTGCCAGCAGCCAAGAACCACAATGGAGGGGAGGGGGCGGGAAGTACGAGCAGTACTTC	CASSQEPQWRGGGGKYEQYF	TRBV3-1	TRBJ2-7
TGTGCCACCAGTGATTGGACGTCGAATGAGCAGTTCTTC	CATSDWTSNEQFF	TRBV24-1	TRBJ2-1
TGTGCCAGCAGCTTAGGACGCAATGAGCAGTTCTTC	CASSLGRNEQFF	TRBV7-9	TRBJ2-1
TGTGCCAGCAGCGTGACTAGCGCCTACAATGAGCAGTTCTTC	CASSVTSAYNEQFF	TRBV7-4	TRBJ2-1
TGTGCCAGCAGCAGGGGGGGGCAGGGGGCGGGTATCTTC	CASSRGGQGAGIF	TRBV7-9	TRBJ2-1
TGTGCCAGCAGCGGCCTCCTGGGGGGAAATGATGAGCAGTTCTTC	CASSGLLGGNDEQFF	TRBV5-6	TRBJ2-1
TGCAGCGTTGAGGCCGGGACAGGAAATCAGCCCCAGCATTTT	CSVEAGTGNQPQHF	TRBV29-1	TRBJ1-5
TGTGCCAGCAGTTTGCAGGAGAACATTCAGTACTTC	CASSLQENIQYF	TRBV28	TRBJ2-4
TGTGCCAGCAGCTTGGCCGCCATACAGGGAGGTGGCTACACCTTC	CASSLAAIQGGGYTF	TRBV5-6	TRBJ1-2
TGTGCCAGCAGCTCCCGACAGGTACAGGGATATGGCTACACCTTC	CASSSRQVQGYGYTF	TRBV9	TRBJ1-2
TGTGCCAGGAAACAGGGGGGAACAAGCTCTGGAAACACCATATATTTT	CARKQGGTSSGNTIYF	TRBV3-1	TRBJ1-3
TGTGCCAGTCTTAACCAGACTAGGTTACCCGGGGAGCTGTTTTTT	CASLNQTRLPGELFF	TRBV12-3	TRBJ2-2
TGTGCCAGCAGCTTATTCGGACCGATTCCAGGGACAAAGTTCTTC	CASSLFGPIPGTKFF	TRBV7-3	TRBJ2-1
TGTGCCAGTGAAGGGACGCAGGCCTACGAGCAGTACTTC	CASEGTQAYEQYF	TRBV7-9	TRBJ2-7
TGTGCCAGCAGCAACGGAGACCGGGACAAACGAGAGTCCTACGAGCAGTACTTC	CASSNGDRDKRESYEQYF	TRBV13	TRBJ2-7
TGTGCCAGCAGCGTCTGGACAGCCCCAGATACGCAGTATTTT	CASSVWTAPDTQYF	TRBV5-5	TRBJ2-3
TGTGCCAGCAGCCTCTTAGGACTAGCCTACGAGCAGTACTTC	CASSLLGLAYEQYF	TRBV14	TRBJ2-7
TGTGCCAGCAGGGGAATCGTACAAGGCAGGTTTGACAATGAGCAGTTCTTC	CASRGIVQGRFDNEQFF	TRBV28	TRBJ2-1
TGTGCCAGCAGCTTAGCGTTTCCCCGACTCCGGGGGGGGTCAAGGAAATGTGAAGCTTTCTTT	CASSLAFPRLRGGSRKCEAFF	TRBV7-2	TRBJ1-1
TGTGCCAGCAGCCAAGACGGTGGGGGAGCAGGACTCTACGAGCAGTACTTC	CASSQDGGGAGLYEQYF	TRBV14	TRBJ2-7
TGTGCCATCACTCCGACTAGCGGGACTACAGACGAGCAGTACTTC	CAITPTSGTTDEQYF	TRBV10-3	TRBJ2-7
TGTGCCAGCAGCTGGGCTGATTATGGCTACACCTTC	CASSWADYGYTF	TRBV11-2	TRBJ1-2
TGTACGAGGGACAAGGGTCAGCCCCAGCATTTT	CTRDKGQPQHF	TRBV11-2	TRBJ1-5
TGTGCCGCGGACAGGTTGGGTCTGAACACTGAAGCTTTCTTT	CAADRLGLNTEAFF	TRBV19	TRBJ1-1
TGCGCCAGCAGCTACCCACACGGCGAATCTGAAGCTTTCTTT	CASSYPHGESEAFF	TRBV5-1	TRBJ1-1
TGTGCCAGCAGCGGGCAGGGAGGCTCACCCCTCCACTTT	CASSGQGGSPLHF	TRBV7-3	TRBJ1-6
TGTGCCTGGAGTGTCCCCCACAAGGGGGCATCGGAGCAGTACTTC	CAWSVPHKGASEQYF	TRBV30	TRBJ2-7
TGCAGTGCTAGAGAGGAGACAGGGGGCCCTCAGCCCCAGCATTTT	CSAREETGGPQPQHF	TRBV20-1	TRBJ1-5
TGTGCCCCAAGGAATGGGGGCACCGGGGAGCTGTTTTTT	CAPRNGGTGELFF	TRBV6-6	TRBJ2-2
TGTGCCAGCAGCGGGAGGGGGACAGTCCCTCTGAGTCCAGAGGACTACGAGCAGTACTTC	CASSGRGTVPLSPEDYEQYF	TRBV9	TRBJ2-7
TGTGCCAGCAGCGGGCACTTCGGGGGGCCGCTCGGCAATAGGGCCTACGAGCAGTACTTC	CASSGHFGGPLGNRAYEQYF	TRBV5-8	TRBJ2-7
TGTGCCAGCAGGAGGCATCGGGGTAGGGACGAGCAGTACTTC	CASRRHRGRDEQYF	TRBV6-4	TRBJ2-7
TGTGCCACCAGTGATTTTAGGTTGCAGGGCGACAATCAGCCCCAGCATTTT	CATSDFRLQGDNQPQHF	TRBV24-1	TRBJ1-5
TGTGCCAGCAGTTTCAAACGTGGACTGAACACTGAAGCTTTCTTT	CASSFKRGLNTEAFF	TRBV27	TRBJ1-1
TGTGCTAGTGGTTTGGTAATCCGTAGTCCGGGCACTAGAGAAAAACACTACAATGAGCAGTTCTTC	CASGLVIRSPGTREKHYNEQFF	TRBV12-5	TRBJ2-1
TGTGCCAGCAGCCACGCAGGTGAAAAACTGTTTTTT	CASSHAGEKLFF	TRBV4-2	TRBJ1-4
TGTGCCAGCAGCCTTAATCGGGGGGGCGACGAGCAGTACTTC	CASSLNRGGDEQYF	TRBV7-3	TRBJ2-7
TGTGCCAGCAGGTACAGGGGGCATTCCTACGAGCAGTACTTC	CASRYRGHSYEQYF	TRBV7-3	TRBJ2-7
TGTGCCAGCTCACCATGGAGCCGTGGGAGGGACACTGAAGCTTTCTTT	CASSPWSRGRDTEAFF	TRBV18	TRBJ1-1
TGTGCCAGCAGCTCGATCTCCTGCTCTGGGGCCAACGTCCTGACTTTC	CASSSISCSGANVLTF	TRBV11-2	TRBJ2-6
TGTGCCAGCAGCGATTGGACAGGGGTTCCACAGCCCCAGCATTTT	CASSDWTGVPQPQHF	TRBV9	TRBJ1-5
TGTGCCAGCAGTGAAGCGCGACGAGGTTCTAACGAGCAGTACTTC	CASSEARRGSNEQYF	TRBV2	TRBJ2-7
TGTGCCAGCAGTCCATATTACACGAGACCGCAGTACTTC	CASSPYYTRPQYF	TRBV6-5	TRBJ2-5
TGCGCCAGCAGCTTGGAGGTTTGTACTGTTTACGTCCGGGCGGGGGCCCTGAACACTGAAGCTTTCTTT	CASSLEVCTVYVRAGALNTEAFF	TRBV5-1	TRBJ1-1
TGCGCCAGCAGCTACGGAAAGGTGCTTCTAGGGCTCAGCTCCTACGAGCAGTACTTC	CASSYGKVLLGLSSYEQYF	TRBV5-1	TRBJ2-7
TGTGCCATCAGACCAAATTATCTAGACAGTCCCCGCAATCAGCCCCAGCATTTT	CAIRPNYLDSPRNQPQHF	TRBV10-3	TRBJ1-5
TGTGCCATCATGGGACTTATGAGTGGAAACACCATATATTTT	CAIMGLMSGNTIYF	TRBV10-3	TRBJ1-3
TGTGCCAGCGGAAGACAGCACAACAAATCCTACGAGCAGTACTTC	CASGRQHNKSYEQYF	TRBV6-2	TRBJ2-7
TGCATGGAGGGGAACTACGAGCAGTACTTC	CMEGNYEQYF	TRBV20-1	TRBJ2-7
TGTGCCAGCAGCTCTGTGGGGGGGGATCAGCCCCAGCATTTT	CASSSVGGDQPQHF	TRBV7-8	TRBJ1-5
TGCAGTGCTTGGAGACAGGGGGTAGAAAAACTGTTTTTT	CSAWRQGVEKLFF	TRBV20-1	TRBJ1-4
TGTGCCAGCAGGCCTCAGGGGGACGAGCAGTACTTC	CASRPQGDEQYF	TRBV12-4	TRBJ2-7
TGCGCCAGCAGTGAGTCGGGGGAAACTAATGAAAAACTGTTTTTT	CASSESGETNEKLFF	TRBV10-1	TRBJ1-4
TGTGCCAGCAGTGGGACTCCTTACGAGCAGTACTTC	CASSGTPYEQYF	TRBV27	TRBJ2-7
TGCAGTGCTTGCAGACATGAAGCGGGTTTTGTCACAGATACGCAGTATTTT	CSACRHEAGFVTDTQYF	TRBV20-1	TRBJ2-3
TGTGCCTGCCCTCCCGGGACTACAGATACGCAGTATTTT	CACPPGTTDTQYF	TRBV6-5	TRBJ2-3
TGCGCCAGCAGCTTGTTGGGGGCGAGGATGGTCCATCAGCCCCAGCATTTT	CASSLLGARMVHQPQHF	TRBV5-1	TRBJ1-5
TGTGCCAGCAGTTTATCGGAAGTCGAGTCCCCTCGGGTTGGAAACATTCAGTACTTC	CASSLSEVESPRVGNIQYF	TRBV12-4	TRBJ2-4
TGTGCCAGCAGCTTGCCGGAGAGATCCGCTACGCAGTATTTT	CASSLPERSATQYF	TRBV5-4	TRBJ2-3
TGTGCTAGTGGTTTGGTAGGTCTAGGGAATGAGCAGTTCTTC	CASGLVGLGNEQFF	TRBV12-5	TRBJ2-1
TGTGCCAGCAGCGCCCCCGTCCCCCGGAAGGAGTATACGCAGTATTTT	CASSAPVPRKEYTQYF	TRBV13	TRBJ2-3
TGTGCCAGCAGCGCGCCTGTTCGGAACTACGAGCAGTACTTC	CASSAPVRNYEQYF	TRBV7-7	TRBJ2-7
TGTGCCAGCAGTTACGGGGGTAATACCGGCCAAGAGACCCAGTACTTC	CASSYGGNTGQETQYF	TRBV6-5	TRBJ2-5
TGTGCCAGCAGTGAGCCTTTCGACAGGGGCTACGAGCAGTACTTC	CASSEPFDRGYEQYF	TRBV6-4	TRBJ2-7
TGTGCCAGCGTCCAGGGGTTGGGACTAGCGGGACCCTACGAGCAGTACTTC	CASVQGLGLAGPYEQYF	TRBV6-4	TRBJ2-7
TGCAGTGCTAGAACCGGCGGGGAGACAAATAGCAATCAGCCCCAGCATTTT	CSARTGGETNSNQPQHF	TRBV20-1	TRBJ1-5
TGCGCCAGCAGCCCAACAGGGGTAAAGCAGTACTTC	CASSPTGVKQYF	TRBV5-1	TRBJ2-7
TGTGCCATCCAATCCTACGGCGCAGGCACTGAAGCTTTCTTT	CAIQSYGAGTEAFF	TRBV10-3	TRBJ1-1
TGCATCCTGGGGGGGTTAGGCTCTGGGGCCAACGTCCTGACTTTC	CILGGLGSGANVLTF	TRBV20-1	TRBJ2-6
TGTGCCAGCAGTTCACAAAGTGGAGAGACCCAGTACTTC	CASSSQSGETQYF	TRBV6-2	TRBJ2-5
TGTGCCAGCAGCGGTGGGGAAGGGGACAGGGTAAGCACTGAAGCTTTCTTT	CASSGGEGDRVSTEAFF	TRBV13	TRBJ1-1
TGTGCCAGCAGCTTGCTAGCCTCTACGGAAGGTAGTTATCTCAATGAGCAGTTCTTC	CASSLLASTEGSYLNEQFF	TRBV5-6	TRBJ2-1
TGTGCCAGCAGCCCTAGCGGCCTTCCCACAGATACGCAGTATTTT	CASSPSGLPTDTQYF	TRBV7-2	TRBJ2-3
TGTGCCACCAGGAAGGGGACCACCGGGGAGCTGTTTTTT	CATRKGTTGELFF	TRBV24-1	TRBJ2-2
TGTGCCAGCAGCGAGGGGGGCACCGGGGAGCTGTTTTTT	CASSEGGTGELFF	TRBV11-2	TRBJ2-2
TGCAGCGATCGAGGGTTGCCCCAGCATTTT	CSDRGLPQHF	TRBV29-1	TRBJ1-5
TGTGCCAGCAGTGAAGGCCGAGGGGGGGGTAGCACAGATACGCAGTATTTT	CASSEGRGGGSTDTQYF	TRBV2	TRBJ2-3
TGTGCCACCAGTGATATTAGTAAACAGGGGTGGGAGCAGTACTTC	CATSDISKQGWEQYF	TRBV24-1	TRBJ2-7
TGTGCCGGTGCAGGCGAACTTAGCAGCAATCAGCCCCAGCATTTT	CAGAGELSSNQPQHF	TRBV30	TRBJ1-5
TGTGCCAGCAGTGAGCCACCAGGGAGCTACTATGGCTACACCTTC	CASSEPPGSYYGYTF	TRBV6-4	TRBJ1-2
TGCGCCAGCAGCGCCACAGGGGGTGAGCAGTTCTTC	CASSATGGEQFF	TRBV5-1	TRBJ2-1
TGTGCCAGCAGGAGGGAACAGAACCCTAACTATGGCTACACCTTC	CASRREQNPNYGYTF	TRBV7-3	TRBJ1-2
TGTGCCAGCGCTAAAGTCGCATTTGTGACAGAACCCAATCAGCCCCAGCATTTT	CASAKVAFVTEPNQPQHF	TRBV7-3	TRBJ1-5
TGTGCCAGCAGTTACTCGTCTTCCTACACCTCCTACAATGAGCAGTTCTTC	CASSYSSSYTSYNEQFF	TRBV6-5	TRBJ2-1
TGTGCCAGCAGCTTAACCGAGGACAAGTACCAGTACTTC	CASSLTEDKYQYF	TRBV7-3	TRBJ2-5
TGTGCCAGCAACGCTGGCACCGGGGAGCTGTTTTTT	CASNAGTGELFF	TRBV27	TRBJ2-2
TGCGCCAGCAGCTTGGAACTAGGGAGTGGACAGGGGAGAAGAAACACCATATATTTT	CASSLELGSGQGRRNTIYF	TRBV5-1	TRBJ1-3
TGTGCCAGCAGTGAGACTGATAAAGAGACCCAGTACTTC	CASSETDKETQYF	TRBV2	TRBJ2-5
TGTGCCAGCAGGGCTGTTAACAGGTATAGTAATGAAAAACTGTTTTTT	CASRAVNRYSNEKLFF	TRBV6-2	TRBJ1-4
TGTGCCAGCAGCTCGCAAGGTTTTAATTCACCCCTCCACTTT	CASSSQGFNSPLHF	TRBV12-3	TRBJ1-6
TGTGCCAGCAGGGAGGGAATAGAGCAGTACTTC	CASREGIEQYF	TRBV6-3	TRBJ2-7
TGCGCCAGCAGGTTGACAGGGAATGAAGAAGAGACCCAGTACTTC	CASRLTGNEEETQYF	TRBV10-1	TRBJ2-5
TGCAGCGTTGAGGAGGCAGGGTATAGCAATCAGCCCCAGCATTTT	CSVEEAGYSNQPQHF	TRBV29-1	TRBJ1-5
TGCGCCAGCGACGCACAGCCTGATCAGCCCCAGCATTTT	CASDAQPDQPQHF	TRBV5-1	TRBJ1-5
TGCGCCAGCAGTAAGCGGGACTATGGCTACACCTTC	CASSKRDYGYTF	TRBV5-1	TRBJ1-2
TGTGCTAGTGGTTGGGGGGGGGTGGACGAGCAGTACTTC	CASGWGGVDEQYF	TRBV12-5	TRBJ2-7
TGTGCCAGCAGCCCTAACCCAAAAACCTACAATGAGCAGTTCTTC	CASSPNPKTYNEQFF	TRBV3-1	TRBJ2-1
TGTGCCAGTAGTATAAGTCCCGGGACAGGTAATGAAAAACTGTTTTTT	CASSISPGTGNEKLFF	TRBV19	TRBJ1-4
TGTGCCAGCAGTATACTGGTTAAGTACAATGAGCAGTTCTTC	CASSILVKYNEQFF	TRBV6-5	TRBJ2-1
TGCAGTGCTACCTCCCTAGACAGGGCTAGACCTGGCTACACCTTC	CSATSLDRARPGYTF	TRBV20-1	TRBJ1-2
TGTGCCATCAGTAGCTTTTCTAGCGGGAGTACCTACAATGAGCAGTTCTTC	CAISSFSSGSTYNEQFF	TRBV10-3	TRBJ2-1
TGTGCCAGCAGTCCCCGGGGTCGGCAACGTCAGGATGGCTACACCTTC	CASSPRGRQRQDGYTF	TRBV6-1	TRBJ1-2
TGTGCCAGCTCACCAGGTAGGGGATACAATGAGCAGTTCTTC	CASSPGRGYNEQFF	TRBV18	TRBJ2-1
TGTGCCACGCTCCTAGCGGGTTATAAGGCCTACGAGCAGTACTTC	CATLLAGYKAYEQYF	TRBV24-1	TRBJ2-7
TGTGCCAGCAGTTTTCCCCAGGGCAAGGTGAACACTGAAGCTTTCTTT	CASSFPQGKVNTEAFF	TRBV12-3	TRBJ1-1
TGTGCCACCAGTGACCCGGGACAGGGGGAGACCCAGTACTTC	CATSDPGQGETQYF	TRBV24-1	TRBJ2-5
TGCGCCAGCAGCTTGGGGAGGGGGCGAAGAGAGACCCAGTACTTC	CASSLGRGRRETQYF	TRBV5-1	TRBJ2-5
TGTGCCAGCCCACCGGGGCCCGGGACAGAGGACTCCTACGAGCAGTACTTC	CASPPGPGTEDSYEQYF	TRBV14	TRBJ2-7
TGCAGTGCCAAACATGACTACAATGAGCAGTTCTTC	CSAKHDYNEQFF	TRBV20-1	TRBJ2-1
TGTGCCTGGGGAGTCAGGCTGGTTGGGGGGGGGGACGGTAGAGCGGCGACCCAGTACTTC	CAWGVRLVGGGDGRAATQYF	TRBV30	TRBJ2-5
TGCAGCGACCGCTGGAGGGACAGGATTATATTGGGCAGTACGAAGTTAAGCAATCAGCCCCAGCATTTT	CSDRWRDRIILGSTKLSNQPQHF	TRBV29-1	TRBJ1-5
TGCAGTGCAGCTGGAGCCCGAAGTGACAGCTCCTACGAGCAGTACTTC	CSAAGARSDSSYEQYF	TRBV20-1	TRBJ2-7
TGTGCCAGCTCACCAGCAGGGGATTGGCACATTCAGTACTTC	CASSPAGDWHIQYF	TRBV18	TRBJ2-4
TGTGCCAGCAGCATAAGGACAGGGAAGGACCAGTCCCCCTACGAGCAGTACTTC	CASSIRTGKDQSPYEQYF	TRBV7-9	TRBJ2-7
TGTGCCAGCAGCTTTCCGGAACAGGGGCGGAACCTGAACACTGAAGCTTTCTTT	CASSFPEQGRNLNTEAFF	TRBV9	TRBJ1-1
TGCGCCAGCAGCCAAGATGGAGTGTCAGGGAATTTGCAAGCAAGCTTC	CASSQDGVSGNLQASF	TRBV4-3	TRBJ2-7
TGTGCCAGCAGCCAATGGGTGGGACAGGGTTATAAGAACACTGAAGCTTTCTTT	CASSQWVGQGYKNTEAFF	TRBV3-1	TRBJ1-1
TGTGCCAAGGGTGACGGTTGGACCTACGAGCAGTACTTC	CAKGDGWTYEQYF	TRBV14	TRBJ2-7
TGTGCCAGCAGCTTAAGCGGGGCTATAGGGATCGGGGAGCTGTTTTTT	CASSLSGAIGIGELFF	TRBV7-3	TRBJ2-2
TGTGCCACCAGTGATGCGCCGGACGGGACTACAGATACGCAGTATTTT	CATSDAPDGTTDTQYF	TRBV24-1	TRBJ2-3
TGTGCCAGCAGCTTGGACAGGGAGATTTTGGTAGGGTACTTC	CASSLDREILVGYF	TRBV13	TRBJ2-4
TGTGCCAGCAGCTTAGCCTTGGGGGCCGGCCCTGAAGCTTTCTTT	CASSLALGAGPEAFF	TRBV7-2	TRBJ1-1
TGCGCCAGCAGCCAAGATTGGCCGGGACAGGGGGTTAGAAACTGGAAGATGAACACTGAAGCTTTCTTT	CASSQDWPGQGVRNWKMNTEAFF	TRBV4-1	TRBJ1-1
TGTGCCAGCACAGGGGTCTTTTACTATGGCTACACCTTC	CASTGVFYYGYTF	TRBV2	TRBJ1-2
TGTGCCAGCAGCCCCCCCGAGACAGGGCAAAATCAGCCCCAGCATTTT	CASSPPETGQNQPQHF	TRBV7-9	TRBJ1-5
TGTGCCAGCAGCCTGGGACAGGGTCATGAAGCTTTCTTT	CASSLGQGHEAFF	TRBV7-2	TRBJ1-1
TGCGCCAGCAGCCAAGTAGACAGGGAGGGGGGCCAGCCCCAGCATTTT	CASSQVDREGGQPQHF	TRBV4-1	TRBJ1-5
TGTGCCAGCAGTGGGACAGACTGGAGGTCCTACGAGCAGTACTTC	CASSGTDWRSYEQYF	TRBV6-3	TRBJ2-7
TGTGCCAGCAGTGCCCCGGGACAAGCCTACAATGAGCAGTTCTTC	CASSAPGQAYNEQFF	TRBV2	TRBJ2-1
TGTGCCAGCAAGGAGGGGCCCCCCCCCGGCTCCTACGAGCAGTACTTC	CASKEGPPPGSYEQYF	TRBV12-3	TRBJ2-7
TGCGCCAGCAGCTTGGCCGGGGAGGGTAACAATGAGCAGTTCTTC	CASSLAGEGNNEQFF	TRBV5-1	TRBJ2-1
TGTGCCAGCAGTGAGTTGGCGTATGGCTACACCTTC	CASSELAYGYTF	TRBV6-4	TRBJ1-2
TGTGCCAGCAGCCTGGACCTAGGAAGCTCCTACAATGAGCAGTTCTTC	CASSLDLGSSYNEQFF	TRBV14	TRBJ2-1
TGCGCCAGCAGCGTGGCGGGTGGGACAGGGGGCAATCAGCCCCAGCATTTT	CASSVAGGTGGNQPQHF	TRBV5-1	TRBJ1-5
TGTGCCAGCAGTTACTCGGTCACTAGCGGGAGCGAGCAGTACTTC	CASSYSVTSGSEQYF	TRBV6-3	TRBJ2-7
TGCAGTGCTAGAGATCGGGGGGAAGCCGAGACCCAGTACTTC	CSARDRGEAETQYF	TRBV20-1	TRBJ2-5
TGTGCCAGCAGTTTTGACAGGTACAATCAGCCCCAGCATTTT	CASSFDRYNQPQHF	TRBV28	TRBJ1-5
TGCGCCAGCAGGACGGGGGGGATCGCCTACGAGCAGTACTTC	CASRTGGIAYEQYF	TRBV5-1	TRBJ2-7
TGCAGCGCCCCCCTGCCCGGGACGGGAGAGACCCAGTACTTC	CSAPLPGTGETQYF	TRBV29-1	TRBJ2-5
TGTGCCAGCCAGAGAGGTAGCTCCTATAATTCACCCCTCCACTTT	CASQRGSSYNSPLHF	TRBV7-3	TRBJ1-6
TGCAGTGCTAGACTTCGGTACGAGCAGTACTTC	CSARLRYEQYF	TRBV20-1	TRBJ2-7
TGTGCCAGCTCACCACATGAGCAGGGGCGCCATGGCTACACCTTC	CASSPHEQGRHGYTF	TRBV18	TRBJ1-2
TGTGCCACCCACAGGGGCTATGGCTACACCTTC	CATHRGYGYTF	TRBV6-2	TRBJ1-2
TGTGCCAGCAGCGGGCCTGGGGGGATGGACCAGGGGGAAAAACTGTTTTTT	CASSGPGGMDQGEKLFF	TRBV14	TRBJ1-4
TGCGCCAGCAGGGTCATCAGGGAAAACATTCAGTACTTC	CASRVIRENIQYF	TRBV5-1	TRBJ2-4
TGTGCCAGCAGCTTAGCCACCTCAGAGAACTATGGCTACACCTTC	CASSLATSENYGYTF	TRBV7-2	TRBJ1-2
TGTGCCAGCAGCGTGGGTTTCACTCGGCCGGGACTAGCGGGGGGTTGGGTGCCCTACGAGCAGTACTTC	CASSVGFTRPGLAGGWVPYEQYF	TRBV9	TRBJ2-7
TGTGCCAGCATCTGCAGGGCTTGGGAGGCCTACGAGCAGTACTTC	CASICRAWEAYEQYF	TRBV28	TRBJ2-7
TGTGCCAGCACCTGTTTGGGGAACCACACCTTC	CASTCLGNHTF	TRBV27	TRBJ1-2
TGTGCCAGCAGCCAAGATTCTCAACGAGGGACTAGCTGGTTACCCCAAGAGACCCAGTACTTC	CASSQDSQRGTSWLPQETQYF	TRBV4-2	TRBJ2-5
TGTGCCAGCAGTCCCGCCAGTTCGGACAGCGGGGAGCTGTTTTTT	CASSPASSDSGELFF	TRBV6-2	TRBJ2-2
TGTGCCAGCAGTTTTCGGCGGGACAGGGCCAAAAACATTCAGTACTTC	CASSFRRDRAKNIQYF	TRBV12-3	TRBJ2-4
TGTGCCAGCAGCGTAGTCGGGGAGGGCGGGACAGGGGAAGACTACGAGCAGTACTTC	CASSVVGEGGTGEDYEQYF	TRBV9	TRBJ2-7
TGCAGTGCTCGAGACAGGCAGGGCACAGATACGCAGTATTTT	CSARDRQGTDTQYF	TRBV20-1	TRBJ2-3
TGTGCCAGCAGCCAAGTCCCGGGAGCGGATATCTTC	CASSQVPGADIF	TRBV14	TRBJ2-1
TGTGCCAGCAGCATGCCGGGGGCGGCGTATGGCTACACCTTC	CASSMPGAAYGYTF	TRBV11-3	TRBJ1-2
TGTGCCAGCAAAGGAAAACAGGATACTTACCCGGCACGGAATAATGAAAAACTGTTTTTT	CASKGKQDTYPARNNEKLFF	TRBV18	TRBJ1-4
TGTGCCAGCAGCCAAGATAGAGGAAAGTTAGCCAAAAACATTCAGTACTTC	CASSQDRGKLAKNIQYF	TRBV14	TRBJ2-4
TGCAGTGCTAGAGCTTACGCAGCTGATTATGGACCCACTGAAGCTTTCTTT	CSARAYAADYGPTEAFF	TRBV20-1	TRBJ1-1
TGTGCCAGCAGCTACCGGGCCTCCGATACGCAGTATTTT	CASSYRASDTQYF	TRBV7-2	TRBJ2-3
TGTGCCAGCAGTTACTCGAGGTGGGACGCCGCTAGCACAGATACGCAGTATTTT	CASSYSRWDAASTDTQYF	TRBV6-5	TRBJ2-3
TGTGCCAGCAGCTTAACCCGCCTCCCTCGGGCCCCCCCGTACGAGCAGTACTTC	CASSLTRLPRAPPYEQYF	TRBV7-2	TRBJ2-7
TGTGCCAGCTCACCACCCGGCCTTAGACAGGGAACTGAAAAACTGTTTTTT	CASSPPGLRQGTEKLFF	TRBV18	TRBJ1-4
TGTGCCAGCAGTGCCGGGGACAGGGGGCGGGGCAATGAGCAGTTCTTC	CASSAGDRGRGNEQFF	TRBV27	TRBJ2-1
TGTGCCAGCAGTCGCGCGGAAGAGACCCAGTACTTC	CASSRAEETQYF	TRBV6-4	TRBJ2-5
TGCGCCAGCAGCGGAGGGGTCGCAGAGGACACTGAAGCTTTCTTT	CASSGGVAEDTEAFF	TRBV5-1	TRBJ1-1
TGTGCCAGCAGTTACCCAGGTGACAGGCCGGAGAACACTGAAGCTTTCTTT	CASSYPGDRPENTEAFF	TRBV6-5	TRBJ1-1
TGTGCCAGCAGCTTTGGGGAGGTTACCGGCCCGTTGGTACTTCAGCCCCAGCATTTT	CASSFGEVTGPLVLQPQHF	TRBV7-9	TRBJ1-5
TGTGCCAGCAGCTTCCCGAGTCAGGGGGTCATGGTGGGAACTGAAGCTTTCTTT	CASSFPSQGVMVGTEAFF	TRBV5-5	TRBJ1-1
TGTGCCAGCAAGGGGGGAGCGGGAACTTCAGAGACCCAGTACTTC	CASKGGAGTSETQYF	TRBV11-1	TRBJ2-5
TGTGCCAGCATTGGTGGACAGGGGCAGTACTTC	CASIGGQGQYF	TRBV6-5	TRBJ2-7
TGCGCCAGCAGTGCAGACTGGCGGGACAATGAGCAGTTCTTC	CASSADWRDNEQFF	TRBV10-1	TRBJ2-1
TGTGCCAGCTCACCACCCTTCCTGCCTCAAAGTCAAGAGACCCAGTACTTC	CASSPPFLPQSQETQYF	TRBV18	TRBJ2-5
TGTGCCAGCTCAGGCACCTGGATGCGCAATCAGCCCCAGCATTTT	CASSGTWMRNQPQHF	TRBV18	TRBJ1-5
TGTGCCAGCAGTTTAACCGGGACCCCCCCCTACGAGCAGTACTTC	CASSLTGTPPYEQYF	TRBV28	TRBJ2-7
TGCGCCAGCAGTAGAGGGACCGGGGGTACTGAAGCTTTCTTT	CASSRGTGGTEAFF	TRBV5-1	TRBJ1-1
TGTGCCAGCAGCAGCATCACAGGGGGTTACAATGAGCAGTTCTTC	CASSSITGGYNEQFF	TRBV7-9	TRBJ2-1
TGCGCCAGCAGCCAAGAGAATACAGACGCTGGAAACACCATATATTTT	CASSQENTDAGNTIYF	TRBV4-3	TRBJ1-3
TGTGCCATCAGGACAGGGGCGTATAGCAATCAGCCCCAGCATTTT	CAIRTGAYSNQPQHF	TRBV25-1	TRBJ1-5
TGTGCCAGCAGTTATACCAGGGGTGGAGATAATGAAAAACTGTTTTTT	CASSYTRGGDNEKLFF	TRBV6-5	TRBJ1-4
TGCGCCAGCAGCTTGTGGAATTACTCCGACAGGGGAATTAATCAGCCCCAGCATTTT	CASSLWNYSDRGINQPQHF	TRBV5-1	TRBJ1-5
TGTGCCAAGGAACCCTTTAGCGGGTCACCCCTCCACTTT	CAKEPFSGSPLHF	TRBV28	TRBJ1-6
TGTGCCAGCAGCCATCCAGGGGTGATTACGACCTATAGCAATCAGCCCCAGCATTTT	CASSHPGVITTYSNQPQHF	TRBV7-9	TRBJ1-5
TGCAGCGTTGCGGGGGGGGGGAACGGAAACACCATATATTTT	CSVAGGGNGNTIYF	TRBV29-1	TRBJ1-3
TGCGCCAGCAGGCGAAATGGGGGGGCTAAGAGCTCCTACAATGAGCAGTTCTTC	CASRRNGGAKSSYNEQFF	TRBV5-1	TRBJ2-1
TGTGCCAGCAGTTGCCCGGGACTATACCCCGTTCGCACAGATACGCAGTATTTT	CASSCPGLYPVRTDTQYF	TRBV2	TRBJ2-3
TGTGCCAGCAGTTACTTAGACGGCTACACCTTC	CASSYLDGYTF	TRBV6-6	TRBJ1-2
TGTGCCAGCAGCAGTCCCCCCCAACAGCAGGTCCGAATTTATGGCTACACCTTC	CASSSPPQQQVRIYGYTF	TRBV27	TRBJ1-2
TGTGCCAGCAGTTACCAGGGAGCTACCCTCTCTCTGGCAAATGAAAAACTGTTTTTT	CASSYQGATLSLANEKLFF	TRBV6-3	TRBJ1-4
TGTGCCTGGAGTGTCCAGGGGGCGTGCCGTGTGGCTGAAGCTTTCTTT	CAWSVQGACRVAEAFF	TRBV30	TRBJ1-1
TGTGCCAGCAGCCACCCCGGGACAGGGGGGTGCCAAGAGACCCAGTACTTC	CASSHPGTGGCQETQYF	TRBV9	TRBJ2-5
TGTGCCAGCAGCCAAGTGAACCGGGGGGGTACTTCGAACACCGGGGAGCTGTTTTTT	CASSQVNRGGTSNTGELFF	TRBV14	TRBJ2-2
TGTGCCAGCAGCTTCCATGAAGCTTTCTTT	CASSFHEAFF	TRBV14	TRBJ1-1
TGTGCCAGCATCTTAGTCACGTTACATCCTCGCTACACCTTC	CASILVTLHPRYTF	TRBV6-4	TRBJ1-2
TGTGCCAGCAATGGCCTACCCTTCCCACCTTACTACGAGCAGTACTTC	CASNGLPFPPYYEQYF	TRBV6-6	TRBJ2-7
TGTGCCAGCAGCGGAAGGGGGGTTGAGACCCAGTACTTC	CASSGRGVETQYF	TRBV7-3	TRBJ2-5
TGTGCCAGCACCCCTGGCCGGGGGCATGGGTATAATTCACCCCTCCACTTT	CASTPGRGHGYNSPLHF	TRBV7-3	TRBJ1-6
TGTGCCAGCAGCCATCACCCGGGTAGACCGACTGAAGCTTTCTTT	CASSHHPGRPTEAFF	TRBV3-1	TRBJ1-1
TGTGCCACCAGTGAGAACCTTCAGGGAGGACGACCAGTCTATGGCTACACCTTC	CATSENLQGGRPVYGYTF	TRBV24-1	TRBJ1-2
TGTGCTAGTGGTTTGACTGGACATCCTCCAGATACGCAGTATTTT	CASGLTGHPPDTQYF	TRBV12-5	TRBJ2-3
TGTGCCACCAGTGGCAGCGATTTAGGGGCGGACACTGAAGCTTTCTTT	CATSGSDLGADTEAFF	TRBV24-1	TRBJ1-1
TGCAGTGCTAACAGGGAGTCCTACGAGCAGTACTTC	CSANRESYEQYF	TRBV20-1	TRBJ2-7
TGTGCCAGTAGCGGGCGTGGGACAGATACGCAGTATTTT	CASSGRGTDTQYF	TRBV6-5	TRBJ2-3
TGCGCCAGCAGCTTGCAGGGGCCCCGGGACAGCCATCAAGAAGCTTTCTTT	CASSLQGPRDSHQEAFF	TRBV5-1	TRBJ1-1
TGTGCACCACAGGGGGACTCTGGAAACACCATATATTTT	CAPQGDSGNTIYF	TRBV3-1	TRBJ1-3
TGTGCCAGCAAGCTAGACACAGCTGAGCAGTTCTTC	CASKLDTAEQFF	TRBV3-1	TRBJ2-1
TGTGCCAGCAGCCGTCGACGCACAGATACGCAGTATTTT	CASSRRRTDTQYF	TRBV13	TRBJ2-3
TGTGCCAGCAGCCGGACAGGGCCCAATCTCTGGCAAGAGACCCAGTACTTC	CASSRTGPNLWQETQYF	TRBV7-3	TRBJ2-5
TGTGCCAGCAGTGAAACAGGGAGTTACGAGCAGTACTTC	CASSETGSYEQYF	TRBV6-1	TRBJ2-7
TGCGCCGACGGACAGGGGGCGAAGAAGTTCAGATCCTATGGCTACACCTTC	CADGQGAKKFRSYGYTF	TRBV10-1	TRBJ1-2
TGTGCCAGCAGCGTACCATTCTGGGGGTCGAATGAGCAGTTCTTC	CASSVPFWGSNEQFF	TRBV9	TRBJ2-1
TGTGCCAGCAGCCCAGGGTCTGGGAGGGGTTACGAGCAGTACTTC	CASSPGSGRGYEQYF	TRBV7-3	TRBJ2-7
TGTGCCAGCAGCTTGGCACATGGGCCCCAGCATTTT	CASSLAHGPQHF	TRBV5-4	TRBJ1-5
TGTGCCAGCAGCTATAGGGGGCGGTATGGCTACACCTTC	CASSYRGRYGYTF	TRBV7-2	TRBJ1-2
TGTGCCAGCCTTGGACGAGTTGAGCAAGAGACCCAGTACTTC	CASLGRVEQETQYF	TRBV25-1	TRBJ2-5
TGCAGTGCAAGGACAGTTTGGGGCCCCTACGAGCAGTACTTC	CSARTVWGPYEQYF	TRBV20-1	TRBJ2-7
TGTGCCAGCGCCCGGGACAGGTCTGGAAACACCATATATTTT	CASARDRSGNTIYF	TRBV6-1	TRBJ1-3
TGTGCCAGCAGCTTAGGGTGCCTGTTACAGGGGCCGTACGAGCAGTACTTC	CASSLGCLLQGPYEQYF	TRBV7-9	TRBJ2-7
TGTGCCAGTAGTATCTCTCCGGGACGCCAGGAACAGCCCCAGCATTTT	CASSISPGRQEQPQHF	TRBV19	TRBJ1-5
TGTGCCAGCAGCCACCCAAGGCGGGATAGCGGGTCCGGCACAGATACGCAGTATTTT	CASSHPRRDSGSGTDTQYF	TRBV14	TRBJ2-3
TGCGCCAGCAGCTTGGCCTCCGCGGACGAGCAGTACTTC	CASSLASADEQYF	TRBV5-1	TRBJ2-7
TGTGCCTGGAGTGTATCTAGCGGGCCTTTCCCCTACGAGCAGTACTTC	CAWSVSSGPFPYEQYF	TRBV30	TRBJ2-7
TGTGCCAGCAGCTTGAGACCAATTCGGGGGCCCTACGAGCAGTACTTC	CASSLRPIRGPYEQYF	TRBV5-6	TRBJ2-7
TGCAGTGCTCTCCCCCTACAGGGGGGTCACTATGGCTACACCTTC	CSALPLQGGHYGYTF	TRBV20-1	TRBJ1-2
TGCGCCAGCAGCCAGAAGGAGGTGAATCAAGAGACCCAGTACTTC	CASSQKEVNQETQYF	TRBV4-1	TRBJ2-5
TGTGCCAGCAGCTTACCCTCGGCTGGGTTGAACACTGAAGCTTTCTTT	CASSLPSAGLNTEAFF	TRBV7-3	TRBJ1-1
TGCGCCAGCAGCCCGACAGGCTTTCAAAACACTGAAGCTTTCTTT	CASSPTGFQNTEAFF	TRBV10-1	TRBJ1-1
TGTGCCAGCAGCTTAGTGTGGACAGGGGCCTGGTATGGCTACACCTTC	CASSLVWTGAWYGYTF	TRBV11-2	TRBJ1-2
TGCGCCAGCAGGGGGACAGGGCGTAGCAATCAGCCCCAGCATTTT	CASRGTGRSNQPQHF	TRBV10-1	TRBJ1-5
TGTGCTAGTGGTACCGCCCCAGGGTTCTTGGATTCACCCCTCCACTTT	CASGTAPGFLDSPLHF	TRBV12-5	TRBJ1-6
TGTGCCAGCAACTCCAGCGGTTTGCGGCGGAGCCAGCCCCAGCATTTT	CASNSSGLRRSQPQHF	TRBV2	TRBJ1-5
TGTGCCAGCTCACCGGGTCCCATTGAAAAACTGTTTTTT	CASSPGPIEKLFF	TRBV18	TRBJ1-4
TGCGCCAGCAGCCGGGAGGACAGGGAAGGAACTAATGAAAAACTGTTTTTT	CASSREDREGTNEKLFF	TRBV4-1	TRBJ1-4
TGCGCCAGCAGCTTTTCCGCCCTTAGCACAGATACGCAGTATTTT	CASSFSALSTDTQYF	TRBV5-1	TRBJ2-3
TGTGCCAGCAATGGGGGGGGCCGGCTGGAGGAGCAGTACTTC	CASNGGGRLEEQYF	TRBV6-2	TRBJ2-7
TGTGCCAGCAGCTTAATCCGGGGCCCCCCTGAAGCTTTCTTT	CASSLIRGPPEAFF	TRBV11-2	TRBJ1-1
TGTGCCAGCAGTGATCCTGTAACCAAAGAGACCCAGTACTTC	CASSDPVTKETQYF	TRBV6-1	TRBJ2-5
TGTGCCAGCAGCCAGCCCACAGGGCAAGAGACCCAGTACTTC	CASSQPTGQETQYF	TRBV14	TRBJ2-5
TGTGCCAGCAGTGCTCCCAGGGCATCTCTTAGCTTCTGGAAGCCTGCAACTAATGAAAAACTGTTTTTT	CASSAPRASLSFWKPATNEKLFF	TRBV27	TRBJ1-4
TGTGCCAGCAGACAGGGCAGCTCTGGAAACACCATATATTTT	CASRQGSSGNTIYF	TRBV14	TRBJ1-3
TGTGCCAGTAGTCAGATGGACAGGGGAGTCACGAGCAATCAGCCCCAGCATTTT	CASSQMDRGVTSNQPQHF	TRBV19	TRBJ1-5
TGTGCCATCCGGGACAGGGCTACCGGGGAGCTGTTTTTT	CAIRDRATGELFF	TRBV10-3	TRBJ2-2
TGTGCCAGCAGGGCCGGGACAGGGGTCCGCTACGAGCAGTACTTC	CASRAGTGVRYEQYF	TRBV2	TRBJ2-7
TGTGCCAGCAGCGCCGGGACAACGAAAACAGATACGCAGTATTTT	CASSAGTTKTDTQYF	TRBV7-3	TRBJ2-3
TGTGCCAGCAGCGGCCCACGGTTTCAGCCCCAGCATTTT	CASSGPRFQPQHF	TRBV13	TRBJ1-5
TGTGCCAGCAGCACTAGGGACAGGGCGTCCTATAATTCACCCCTCCACTTT	CASSTRDRASYNSPLHF	TRBV14	TRBJ1-6
TGTGCCAGCAGCCCACCCCGGTCCTATGGCTACACCTTC	CASSPPRSYGYTF	TRBV7-3	TRBJ1-2
TGTGCCAGCAGAGGGACAGGGGGTTCTGGTCCCAATGAGCAGTTCTTC	CASRGTGGSGPNEQFF	TRBV6-2	TRBJ2-1
TGTGCCACCAGTGATTTCCAATTGGGACAGGGTGTACAGTGCAATCAGCCCCAGCATTTT	CATSDFQLGQGVQCNQPQHF	TRBV24-1	TRBJ1-5
TGCGCCAGCAGCCAAGATCCTCAGGGCAAGGACAATGAGCAGTTCTTC	CASSQDPQGKDNEQFF	TRBV4-1	TRBJ2-1
TGTGCCAGCAGTTACTCAACTAAAGTGACCAATCAGCCCCAGCATTTT	CASSYSTKVTNQPQHF	TRBV6-5	TRBJ1-5
TGTGCTAGTGGTTTGGTACACACGTTCCCAGGACAGGGCTTT	CASGLVHTFPGQGF	TRBV12-5	TRBJ1-1
TGTGCCAGCAGTTCCGTGTGGACTTGTGAAGCTTTCTTT	CASSSVWTCEAFF	TRBV6-5	TRBJ1-1
TGTGCCAGCAGTTTATCCCAAAATAGCGGGAACGAGCAGTACTTC	CASSLSQNSGNEQYF	TRBV27	TRBJ2-7
TGCAGTGCTAGAGGGGGGGAGGAGGGTGTGGGTAGACACTATAATTCACCCCTCCACTTT	CSARGGEEGVGRHYNSPLHF	TRBV20-1	TRBJ1-6
TGCAGTGCTAGACTACAGACTAGCGGGGCCCCCGAGACCCAGTACTTC	CSARLQTSGAPETQYF	TRBV20-1	TRBJ2-5
TGTGCCAGCAGCTCCCGGGACGACGAGCAGTTCTTC	CASSSRDDEQFF	TRBV13	TRBJ2-1
TGTGCCAGCAGCTTGGCCTCGCCGGGACTCCCTATGTACGACCCAACCGGGGAGCTGTTTTTT	CASSLASPGLPMYDPTGELFF	TRBV5-4	TRBJ2-2
TGTGCCAGTACCGTCGGACTAGCGGGTACTAACACCGGGGAGCTGTTTTTT	CASTVGLAGTNTGELFF	TRBV19	TRBJ2-2
TGTGCCACCAGTGATAGCTACCAGGGGTGCTTC	CATSDSYQGCF	TRBV24-1	TRBJ1-2
TGTGGGTCAGAACAGCCCCAGCATTTT	CGSEQPQHF	TRBV3-1	TRBJ1-5
TGTGCCAGCAGCCGCCGACCCCCGGCAGTGAACACTGAAGCTTTCTTT	CASSRRPPAVNTEAFF	TRBV3-1	TRBJ1-1
TGTGCCAGCAACTCGCCACGGGGGGGTAGCACAGATACGCAGTATTTT	CASNSPRGGSTDTQYF	TRBV6-3	TRBJ2-3
TGTGCCAGCATCCCAAGGGGGGAATACGGAGGGGAGTATTTT	CASIPRGEYGGEYF	TRBV27	TRBJ2-3
TGTGCCAGCAGCTTATTCCGGGACGGTACTGAGCAGTTCTTC	CASSLFRDGTEQFF	TRBV11-3	TRBJ2-1
TGTGCCAGCAGACCTCGACAGGGGGAGGGGAACACTGAAGCTTTCTTT	CASRPRQGEGNTEAFF	TRBV6-4	TRBJ1-1
TGTGCCAGCAGGCAGGGTAAAGAGACCCAGTACTTC	CASRQGKETQYF	TRBV7-9	TRBJ2-5
TGTGCCGGGACAGCAGTCTTGTGCATTCAGTACTTC	CAGTAVLCIQYF	TRBV19	TRBJ2-4
TGTGCCAGCAGCAGGCGGTGGGGGCCAAACACCATATATTTT	CASSRRWGPNTIYF	TRBV13	TRBJ1-3
TGTGCCAGCAGCTTAGGATATTTCCGCTCTGGAAACACCATATATTTT	CASSLGYFRSGNTIYF	TRBV7-9	TRBJ1-3
TGTGCCACCAGCAGACTGTGCGGAGGGGGATCCTACGAGCAGTACTTC	CATSRLCGGGSYEQYF	TRBV15	TRBJ2-7
TGTGCCAGCAGCCAAGGGGGAGAGGGGGGGCCTCCCTACGAGCAGTACTTC	CASSQGGEGGPPYEQYF	TRBV4-2	TRBJ2-7
TGTGCCAGCAGTATACGGGGGGTCGATGGACAAGAGACCCAGTACTTC	CASSIRGVDGQETQYF	TRBV6-4	TRBJ2-5
TGCAGTGCTAGAGCTTGGCTTAAGGATGACAGGGGAGTTGGTAACTATGGCTACACCTTC	CSARAWLKDDRGVGNYGYTF	TRBV20-1	TRBJ1-2
TGTGCCAGCAGTTGGGTTTGGACAGGACTGGTCTATAGCAATCAGCCCCAGCATTTT	CASSWVWTGLVYSNQPQHF	TRBV2	TRBJ1-5
TGCGCCAGCAGTGAGGCCGCGGGAGAGGCTCACGAGCAGTACTTC	CASSEAAGEAHEQYF	TRBV10-1	TRBJ2-7
TGTGCCAGCAGTGCCAAGGAGACGGGGGCGGACGAGCAGTACTTC	CASSAKETGADEQYF	TRBV2	TRBJ2-7
TGTGCCAGCACGAGCACGTCCGCCGGGACAGGCTATGGCTACACCTTC	CASTSTSAGTGYGYTF	TRBV9	TRBJ1-2
TGTGCCATCACCGGTAGGGGGGCCCGCATTGAAGAGACCCAGTACTTC	CAITGRGARIEETQYF	TRBV10-3	TRBJ2-5
TGTGCCAGCAGTGAAGCGCAGGTACTTGTTAATTCACCCCTCCACTTT	CASSEAQVLVNSPLHF	TRBV6-1	TRBJ1-6
TGTGCCAGCAGTTTATCCTCTGGACTAGCGGGCCAACAAGAGACCCAGTACTTC	CASSLSSGLAGQQETQYF	TRBV27	TRBJ2-5
TGTGCCTGGAGGCCCTTCGGAAGAGCGGGACAAGTGGGCTACACCTTC	CAWRPFGRAGQVGYTF	TRBV30	TRBJ1-2
TGTGCCAGTAGTAACCCGGGGGGGTCCATAACTAACTATGGCTACACCTTC	CASSNPGGSITNYGYTF	TRBV19	TRBJ1-2
TGTGCCAGTGCCACGGGACTAGCGGAAGCCAAAAACATTCAGTACTTC	CASATGLAEAKNIQYF	TRBV4-2	TRBJ2-4
TGTGCCAGCAGCCAAGATCTAGCGGGGAACTCCTACGAGCAGTACTTC	CASSQDLAGNSYEQYF	TRBV4-2	TRBJ2-7
TGTGCCAGCAGTTACTCGAGACTTCAGGGGGACACTGAAGCTTTCTTT	CASSYSRLQGDTEAFF	TRBV6-5	TRBJ1-1
TGCGCCAGCGGGCGATGGGCAGATACGCAGTATTTT	CASGRWADTQYF	TRBV10-1	TRBJ2-3
TGTGCCAGCAGGGCGTCTTGCGAGTCCAATCAGCCCCAGCATTTT	CASRASCESNQPQHF	TRBV2	TRBJ1-5
TGTGTGGGGACTAGCGGGGGTGAGCAGTACTTC	CVGTSGGEQYF	TRBV27	TRBJ2-7
TGTGCCAGCCCAGCGGGACGGGACACTGAAGCTTTCTTT	CASPAGRDTEAFF	TRBV6-5	TRBJ1-1
TGTGCCAGCAGGGAGTTTCCTAGTGCCTACGAGCAGTACTTC	CASREFPSAYEQYF	TRBV6-1	TRBJ2-7
TGTGCCAGCAGCGGAACCGGGGGAGCTAACTATGGCTACACCTTC	CASSGTGGANYGYTF	TRBV6-1	TRBJ1-2
TGTGCCAGGGCGCAAAAACCCCGGCCCGAGTATGAAGAGACCCAGTACTTC	CARAQKPRPEYEETQYF	TRBV6-4	TRBJ2-5
TGTGCCACCAGTAAGGGGCAGGATGAGCAGTTCTTC	CATSKGQDEQFF	TRBV24-1	TRBJ2-1
TGCGCCAGCCCGTCGTCCGAAGCTGGGGCCAACGTCCTGACTTTC	CASPSSEAGANVLTF	TRBV10-1	TRBJ2-6
TGCGCCAGCAGCGGCGTCCGACTCGGGTCCTACGAGCAGTACTTC	CASSGVRLGSYEQYF	TRBV5-1	TRBJ2-7
TGCGCCAGCAGCCACCTGCTTCCCGGGAGGGGGGTCAGCTGGAACACCGGGGAGCTGTTTTTT	CASSHLLPGRGVSWNTGELFF	TRBV4-1	TRBJ2-2
TGCGCCAGCACGGGGGACAGGGATACTTGCCAGCCCCAGCATTTT	CASTGDRDTCQPQHF	TRBV4-1	TRBJ1-5
TGTGCCAGCAGTGAAAACCAGGGGTGGCTCTATGGCTACACCTTC	CASSENQGWLYGYTF	TRBV6-1	TRBJ1-2
TGTGCCACCAGGAATGGATCACCCCTCCACTTT	CATRNGSPLHF	TRBV24-1	TRBJ1-6
TGTGCCAGCATTGGGGCCACTAACTATGGCTACACCTTC	CASIGATNYGYTF	TRBV6-6	TRBJ1-2
TGTGCCAGCAGCTGTCCCATACTGCGACTACCCGGGCTCTCCTATAATTCACCCCTCCACTTT	CASSCPILRLPGLSYNSPLHF	TRBV7-3	TRBJ1-6
TGCGCCAGCAGCTCGGGGAGGGCTACTGAAGCTTTCTTT	CASSSGRATEAFF	TRBV5-1	TRBJ1-1
TGCGCCAGCAGCTCGCGGTATGGCTACACCTTC	CASSSRYGYTF	TRBV10-1	TRBJ1-2
TGTGCTAGTGGTTTGCGTTTACTAGCGGGTAGGGTTTATGTGCAGTTCTTC	CASGLRLLAGRVYVQFF	TRBV12-5	TRBJ2-1
TGTGCCAGCAATCGGCATCTAGCCAAAAACATTCAGTACTTC	CASNRHLAKNIQYF	TRBV6-2	TRBJ2-4
TGTGCCACCAGAGGGCCCCAGCAAATGTTCGGGAACACTGAAGCTTTCTTT	CATRGPQQMFGNTEAFF	TRBV24-1	TRBJ1-1
TGCGCCAGCAGCTTTGGACCGTCTGGAAACACCATATATTTT	CASSFGPSGNTIYF	TRBV5-1	TRBJ1-3
TGTGCCAGCAGCTTAGGTTGTGATGCCGGGACAGGGGGCGCCGGCAATCAGCCCCAGCATTTT	CASSLGCDAGTGGAGNQPQHF	TRBV7-9	TRBJ1-5
TGTGCCAGCAGTTTCTCCCACCTAGACGAGACCCAGTACTTC	CASSFSHLDETQYF	TRBV27	TRBJ2-5
TGTGCCAGCAGCTGGGGGGGGTCTGAGCAGTTCTTC	CASSWGGSEQFF	TRBV5-6	TRBJ2-1
TGTGCCACCTGGAGCCGGGCAGGCTACGAGCAGTACTTC	CATWSRAGYEQYF	TRBV24-1	TRBJ2-7
TGTGCCAGCAGCTTAGACCTAGATTCACCCCTCCACTTT	CASSLDLDSPLHF	TRBV11-2	TRBJ1-6
TGTGCCACCAGTGATATGAACCCGGGGTACCGCCCTGAAGCTTTCTTT	CATSDMNPGYRPEAFF	TRBV24-1	TRBJ1-1
TGTGCTAGTGCGTGTGCGGGGCGTTCCGGGGAGCTGTTTTTT	CASACAGRSGELFF	TRBV12-5	TRBJ2-2
TGCGCCAGCAAGGTGAACGCCGGGGGCGGGTTGGCCTACGAGCAGTACTTC	CASKVNAGGGLAYEQYF	TRBV4-3	TRBJ2-7
TGTGCCAGCAGACCAGGGCGGAGTGGAAACACCATATATTTT	CASRPGRSGNTIYF	TRBV27	TRBJ1-3
TGTGCCAGCAGCTGCCCCCGGGACAGGAGAGAGCAGTACTTC	CASSCPRDRREQYF	TRBV5-5	TRBJ2-7
TGTGCCAGCCTTTCTGACAGGACCAATTCACCCCTCCACTTT	CASLSDRTNSPLHF	TRBV11-1	TRBJ1-6
TGTGCCACCAGTGATCTAGCGGGTGTCATTGAGCAGTACTTC	CATSDLAGVIEQYF	TRBV24-1	TRBJ2-7
TGTGCCGAGGCCTTAGATGAGCAGTTCTTC	CAEALDEQFF	TRBV9	TRBJ2-1
TGTGCCAGCAGCGTAGAATGGACTAGGACCCGTGAGCAGTTCTTC	CASSVEWTRTREQFF	TRBV9	TRBJ2-1
TGTGCCAGCAGTTATTCGAAGGGAGGACAGAGAGCTGAAGCTTTCTTT	CASSYSKGGQRAEAFF	TRBV6-9	TRBJ1-1
TGTGCCAGCAGCAAGGGCCCAGCAGGGGATCAGGGAGAGACCCAGTACTTC	CASSKGPAGDQGETQYF	TRBV7-3	TRBJ2-5
TGTGCCAGTACTCGAACCGGGGAGCTGTTTTTT	CASTRTGELFF	TRBV19	TRBJ2-2
TGTGCCAGCGTCTCTGCCACAGATACGCAGTATTTT	CASVSATDTQYF	TRBV2	TRBJ2-3
TGTGCCAGCAGTGACTCCCGGGACAGGGCGCATTCCGAACGAAGTGAGCAGTTCTTC	CASSDSRDRAHSERSEQFF	TRBV6-4	TRBJ2-1
TGTGCCAGCAGCGAAGACGGGACAGGGGAGACCCAGTACTTC	CASSEDGTGETQYF	TRBV7-3	TRBJ2-5
TGCAGTGCTATTTCTTGGGACAGGGGCAGAAATGAAGCTTTCTTT	CSAISWDRGRNEAFF	TRBV20-1	TRBJ1-1
TGTGCCAGCAGCCAAGCCGGGACAGGCGGGGGTGGCTACACCTTC	CASSQAGTGGGGYTF	TRBV14	TRBJ1-2
TGTGCCCAGATCCCAGTTCCCCCCTTC	CAQIPVPPF	TRBV12-3	TRBJ1-2
TGTGCCAGCAGGGACCGGGACGGCACCTACGAGCAGTACTTC	CASRDRDGTYEQYF	TRBV12-3	TRBJ2-7
TGTGCCAGCAGCTTAGTCGGGGGGGCGCCGCAGTTCTTC	CASSLVGGAPQFF	TRBV7-8	TRBJ2-1
TGTGCCAGCAGTGTAGTTGCGTCGCACGGGCAGCCCCAGCATTTT	CASSVVASHGQPQHF	TRBV6-4	TRBJ1-5
TGTGCCACCTGGCCCCAGATCACCGGGGAGCTGTTTTTT	CATWPQITGELFF	TRBV2	TRBJ2-2
TGCAGTGCTAGAGAGCTTACTAGCGGGAGGGCCCAGGGGGGGGTGCCTGCCCTCTCCTACGAGCAGTACTTC	CSARELTSGRAQGGVPALSYEQYF	TRBV20-1	TRBJ2-7
TGTGCCAGCAGCACGACGAAGGTAGAGAGCAATCAGCCCCAGCATTTT	CASSTTKVESNQPQHF	TRBV9	TRBJ1-5
TGTGCCAGCAGCCAAGCAGGGGAGGGCTATGGCTACACCTTC	CASSQAGEGYGYTF	TRBV3-1	TRBJ1-2
TGCAGTGCTATAGTTTGGGGGGCCGTAGAGCAGTACTTC	CSAIVWGAVEQYF	TRBV20-1	TRBJ2-7
TGTGCTAAAAGAAAGAACACTGAAGCTTTCTTT	CAKRKNTEAFF	TRBV2	TRBJ1-1
TGTGCCAGCAGCGTAGCAGACAGGGGGCGCGTGAACACTGAAGCTTTCTTT	CASSVADRGRVNTEAFF	TRBV9	TRBJ1-1
TGTGCCAGCAGTTTTAACGGGACAGGGAGGGCTTTCTTT	CASSFNGTGRAFF	TRBV12-3	TRBJ1-1
TGTGCCAGCAGCTGTCGGGGACCGTTGATGAACACTGAAGCTTTCTTT	CASSCRGPLMNTEAFF	TRBV7-2	TRBJ1-1
TGTGCCACCAGCAAAGACAGGGACGAGCAGTACTTC	CATSKDRDEQYF	TRBV15	TRBJ2-7
TGTGCCAGCAGCTTACCTCATAAAGTCCGAGGGGGCCTAACTAACTATGGCTACACCTTC	CASSLPHKVRGGLTNYGYTF	TRBV7-7	TRBJ1-2
TGTGCCAGCAGCGTCTCACGGCCGATGCTCTCCTACGAGCAGTACTTC	CASSVSRPMLSYEQYF	TRBV5-4	TRBJ2-7
TGTGCCAGCAGTTTGGACAGGGGCGCCCTCCACTTT	CASSLDRGALHF	TRBV27	TRBJ1-6
TGTGCCAGCAGCTTGCATGGAAGGGAGCAGTTCTTC	CASSLHGREQFF	TRBV7-9	TRBJ2-1
TGTGCCAGCAGTTTTGAACTGGGGGACGTGCGAACCGGGGAGCTGTTTTTT	CASSFELGDVRTGELFF	TRBV27	TRBJ2-2
TGTGCCAGCAGCCTTGACAGGTGCTTCCAGGAGCGGGTTGACTATGGCTACACCTTC	CASSLDRCFQERVDYGYTF	TRBV4-2	TRBJ1-2
TGTGCCAGCAGTTACTCGGATGACAGGGCTTCCTCCTACGAGCAGTACTTC	CASSYSDDRASSYEQYF	TRBV6-5	TRBJ2-7
TGTGCCAGCAGTGGGGACCTGCACTACGAGCAGTACTTC	CASSGDLHYEQYF	TRBV6-4	TRBJ2-7
TGCAGTGCTAGTCCAGCGTATTCACCCCTCCACTTT	CSASPAYSPLHF	TRBV20-1	TRBJ1-6
TGTGCCGGACCTACAGGGGGGAGCTCCTACGAGCAGTACTTC	CAGPTGGSSYEQYF	TRBV19	TRBJ2-7
TGTGCCACCAGTGACCTAGGGACAGGGACTCGGCGCAGCTCCTACAATGAGCAGTTCTTC	CATSDLGTGTRRSSYNEQFF	TRBV24-1	TRBJ2-1
TGCAGCGTTGATCGAGACAGCTACGAGCAGTACTTC	CSVDRDSYEQYF	TRBV29-1	TRBJ2-7
TGTGCTAGTGGTTTGGTAAAGGGGGGCCCAAAATCCTACGAGCAGTACTTC	CASGLVKGGPKSYEQYF	TRBV12-5	TRBJ2-7
TGTGCCAGCAGCTTTCCGTTATGGGGAGGGTCTGGGGCCAACGTCCTGACTTTC	CASSFPLWGGSGANVLTF	TRBV7-2	TRBJ2-6
TGTGCCAGCAGCACCAGTGTTCAGGGTTATGAGCAGTTCTTC	CASSTSVQGYEQFF	TRBV6-5	TRBJ2-1
TGCAGTCAAGCGGGAGGACCTTGTGTCTACGAGCAGTACTTC	CSQAGGPCVYEQYF	TRBV20-1	TRBJ2-7
TGTGCCATCAGTGAGTTCGGACAGGGGGCACCTAATTCACCCCTCCACTTT	CAISEFGQGAPNSPLHF	TRBV10-3	TRBJ1-6
TGTGCCAGCAGTGACCCCCGGGGAGGTATCACCACCGGGGAGCTGTTTTTT	CASSDPRGGITTGELFF	TRBV12-4	TRBJ2-2
TGTGCCAGCAGGGAAGGGCTCGACAGGGCGGGGCTGACCCAGTACTTC	CASREGLDRAGLTQYF	TRBV9	TRBJ2-5
TGCAGTGCTAGAGATTATCCTAGTAACAATAACGAGCAGTACTTC	CSARDYPSNNNEQYF	TRBV20-1	TRBJ2-7
TGTGCCAGCAGATTGTCGGGCAGGGGATACGAGCAGTACTTC	CASRLSGRGYEQYF	TRBV6-1	TRBJ2-7
TGCAGCGTTGAAGGTCCCGCCAGGGGAGGTCGGCAGTTCTTC	CSVEGPARGGRQFF	TRBV29-1	TRBJ2-1
TGCAGCGTGACAGCAGAGGGGTGGCAGCATTTT	CSVTAEGWQHF	TRBV29-1	TRBJ1-5
TGTGCCAGCAGTTTATGCGGGACAGGGGGCGGCTCTCTGAACACTGAAGCTTTCTTT	CASSLCGTGGGSLNTEAFF	TRBV27	TRBJ1-1
TGTGCCAGCAGTGACTCCAGGGTCTACGAGCAGTACTTC	CASSDSRVYEQYF	TRBV6-4	TRBJ2-7
TGTGCCACCAGGGCAGGAGGCAATCAGCCCCAGCATTTT	CATRAGGNQPQHF	TRBV24-1	TRBJ1-5
TGCGCCATCGACAGGGCGGACTATGGCTACACCTTC	CAIDRADYGYTF	TRBV5-1	TRBJ1-2
TGCAGTGGGGTGGGGGACAGGGGGAACTATGGCTACACCTTC	CSGVGDRGNYGYTF	TRBV20-1	TRBJ1-2
TGTGCCAGCAGTCCAAGAGGGAGGACTGAAGCTTTCTTT	CASSPRGRTEAFF	TRBV28	TRBJ1-1
TGTGCCAGCAGTGCCTGCATCCGGAGGGATCAGCCCCAGCATTTT	CASSACIRRDQPQHF	TRBV27	TRBJ1-5
TGCAGTATGCTATTCCGTCTAGGCTACAGGGGGGGATACGAGCAGTACTTC	CSMLFRLGYRGGYEQYF	TRBV20-1	TRBJ2-7
TGTGCCAAACGGGGGGTTCAGACACCCTACGAGCAGTACTTC	CAKRGVQTPYEQYF	TRBV19	TRBJ2-7
TGTGCCAGCAGTTCGACTAGCGGGTTAGGCGTCCCTAGCACAGATACGCAGTATTTT	CASSSTSGLGVPSTDTQYF	TRBV6-4	TRBJ2-3
TGCGCCAGCAGCCGCATCGACAGGGACACAGATACGCAGTATTTT	CASSRIDRDTDTQYF	TRBV4-3	TRBJ2-3
TGTGCCAGCTCCGAATGGGCCTACGAGCAGTACTTC	CASSEWAYEQYF	TRBV6-5	TRBJ2-7
TGTGCCAGCAGCGGGAGAGGAGACACCGGGGAGCTGTTTTTT	CASSGRGDTGELFF	TRBV27	TRBJ2-2
TGTGCCTGGAGTCGTCTGATCAGGGCCACTGAAGCTTTCTTT	CAWSRLIRATEAFF	TRBV30	TRBJ1-1
TGTGCCAGCACTCGTGTGGAACCCCGGACGTCCCATGAAAAACTGTTTTTT	CASTRVEPRTSHEKLFF	TRBV28	TRBJ1-4
TGTGCCAGCTCACGGTTGGACAGGGGTCCCCGGTACTTC	CASSRLDRGPRYF	TRBV18	TRBJ2-7
TGCAGTGCTAGGGATACGGATGGTAGCTACGAGCAGTACTTC	CSARDTDGSYEQYF	TRBV20-1	TRBJ2-7
TGTGCCAGCAGTCCTAAGGACTTAGACACCGCTACCGGGGAGCTGTTTTTT	CASSPKDLDTATGELFF	TRBV2	TRBJ2-2
TGTGCCAGCGGGACAGGGGGCATTTACAATGAGCAGTTCTTC	CASGTGGIYNEQFF	TRBV6-6	TRBJ2-1
TGTGCCAGCAGCGCCGCGGAACCATGGGCCTACAATGAGCAGTTCTTC	CASSAAEPWAYNEQFF	TRBV13	TRBJ2-1
TGTGCCAGCAGCCATCTAGGGGTTAAGGGCTACACCTTC	CASSHLGVKGYTF	TRBV3-1	TRBJ1-2
TGCGCCAGCAGCCACCGACAGACAGGGGGCGGCGGTAGGAACACTGAAGCTTTCTTT	CASSHRQTGGGGRNTEAFF	TRBV4-1	TRBJ1-1
TGTGCCAGCAGTTTTTCAAGGAACAGGGAAGGGGGAGAGACCCAGTACTTC	CASSFSRNREGGETQYF	TRBV27	TRBJ2-5
TGTGCCACCAGTGAAAGGGGAAATATACCTTGCGAGCAGTACTTC	CATSERGNIPCEQYF	TRBV24-1	TRBJ2-7
TGTGCCAGCAGCTCTGAGCAGTACTTC	CASSSEQYF	TRBV7-4	TRBJ2-7
TGTGCCAGCATGGGCAGGGGTACTAATGAAAAACTGTTTTTT	CASMGRGTNEKLFF	TRBV7-9	TRBJ1-4
TGTGCCAGGGGCCGACAGGGGGCGCCCTTAGGCACTGAAGCTTTCTTT	CARGRQGAPLGTEAFF	TRBV12-3	TRBJ1-1
TGTGCCAGTAGTATAGTAGGAGGCCCGCGGAAGGGATGGAATGAAAAACTGTTTTTT	CASSIVGGPRKGWNEKLFF	TRBV19	TRBJ1-4
TGTGCCAGCAGCACCGCGACGTACAATGAGCAGTTCTTC	CASSTATYNEQFF	TRBV7-3	TRBJ2-1
TGTGCCTGTGTGGAGGGGGCGGATACGCAGTATTTT	CACVEGADTQYF	TRBV30	TRBJ2-3
TGTGCCAGCAGTAGCGGTATCGACAATGAGCAGTTCTTC	CASSSGIDNEQFF	TRBV28	TRBJ2-1
TGTGCCACCAGTGATTTAGGGAAGGGGGTTTACTATGGCTACACCTTC	CATSDLGKGVYYGYTF	TRBV24-1	TRBJ1-2
TGTGCCAGTAGAAGGCGGGGGACAGATACGCAGTATTTT	CASRRRGTDTQYF	TRBV19	TRBJ2-3
TGTGCCAGCAGCCGCCCCGTTCCGCCGGGACTAGCGGGCCCTAAAGCGAACACCGGGGAGCTGTTTTTT	CASSRPVPPGLAGPKANTGELFF	TRBV7-9	TRBJ2-2
TGCGCCAGCAAGCAGTTCCCTAGCGGGGGGGCAGGGCCCTACGAGCAGTACTTC	CASKQFPSGGAGPYEQYF	TRBV10-1	TRBJ2-7
TGTGCCACCGATAGACAGTTTAGCTACGAGCAGTACTTC	CATDRQFSYEQYF	TRBV24-1	TRBJ2-7
TGTGCCAGCAGTTACGGGGGGAAACGGAACGAGCAGTACTTC	CASSYGGKRNEQYF	TRBV28	TRBJ2-7
TGTGCCAGCAGCCAGGGGTGCAATCAGCCCCAGCATTTT	CASSQGCNQPQHF	TRBV11-3	TRBJ1-5
TGTGCCAGCAGTTGCTCACACAGGCGCAAGCAAGAGACCCAGTACTTC	CASSCSHRRKQETQYF	TRBV12-3	TRBJ2-5
TGTGCCAGCAAACGGCAGGAATCCTCCTACGAGCAGTACTTC	CASKRQESSYEQYF	TRBV6-1	TRBJ2-7
TGCAGTGCTATAGACGTCTCCTACGAGCAGTACTTC	CSAIDVSYEQYF	TRBV20-1	TRBJ2-7
TGCAGTGCTAATAGGGTTTGGACAGATACGCAGTATTTT	CSANRVWTDTQYF	TRBV20-1	TRBJ2-3
TGCGCCAGCAGGAGGGGACCGGCTTCGGCGTTCACAGATACGCAGTATTTT	CASRRGPASAFTDTQYF	TRBV10-1	TRBJ2-3
TGTGCCAGCAGCCAGGGGGGGAGTAGCAATCAGCCCCAGCATTTT	CASSQGGSSNQPQHF	TRBV12-4	TRBJ1-5
TGTGCCAGCAGCTGGAACGAGCAGTACTTC	CASSWNEQYF	TRBV7-2	TRBJ2-7
TGTGCCATGTGTGTCACAGGGCCCTCCTGTAACTATGGCTACACCTTC	CAMCVTGPSCNYGYTF	TRBV19	TRBJ1-2
TGTGCCAGCAGCTTTGGGACTATCAATAGCAATCAGCCCCAGCATTTT	CASSFGTINSNQPQHF	TRBV5-6	TRBJ1-5
TGTGCCAGCAGCAGTCAAAATAACTCCTACAATGAGCAGTTCTTC	CASSSQNNSYNEQFF	TRBV5-4	TRBJ2-1
TGCAGTGCGACGGCATATGGCTACACCTTC	CSATAYGYTF	TRBV20-1	TRBJ1-2
TGCGCCAGCAGCTTTGGTCTCCGGGGACTAGCGGTTTTTAGCTCCTACGAGCAGTACTTC	CASSFGLRGLAVFSSYEQYF	TRBV5-1	TRBJ2-7
TGTGCCACCCGACAGGGGAGAGAAGCTTTCTTT	CATRQGREAFF	TRBV24-1	TRBJ1-1
TGTGCCAGCAGCAAGGGAGAGTATAGCAATCAGCCCCAGCATTTT	CASSKGEYSNQPQHF	TRBV7-9	TRBJ1-5
TGTGCCTGGATTCTCCGGGCGGCCAATGAGCAGTTCTTC	CAWILRAANEQFF	TRBV30	TRBJ2-1
TGTGCCAGCAGCGTGTACAGGGTGAACACTGAAGCTTTCTTT	CASSVYRVNTEAFF	TRBV13	TRBJ1-1
TGCGCCAGCAGACTCAGCGGGATCTATGGCTACACCTTC	CASRLSGIYGYTF	TRBV10-1	TRBJ1-2
TGTGCCAGCTCACAGAGGCCTGACGAGCAGTACTTC	CASSQRPDEQYF	TRBV18	TRBJ2-7
TGCGCCAGCAGCCACAGCGTTGACAGGGAGAAGACGAGCAATCAGCCCCAGCATTTT	CASSHSVDREKTSNQPQHF	TRBV4-1	TRBJ1-5
TGTGCCAGCAGCCAAGACCGACACGGACTACTTACTACCTACAATGAGCAGTTCTTC	CASSQDRHGLLTTYNEQFF	TRBV3-1	TRBJ2-1
TGCGCCAGCAGCCATCCTTCCCGGACTAGCGGGGTTAAGGAAGAGACCCAGTACTTC	CASSHPSRTSGVKEETQYF	TRBV4-1	TRBJ2-5
TGTGCCAGCAGCGGCCGGAGGACAATACAGGAGGGCTACACCTTC	CASSGRRTIQEGYTF	TRBV7-3	TRBJ1-2
TGTGCCAGCAGCACGAGGGACAGAGGCGAGAACACTGAAGCTTTCTTT	CASSTRDRGENTEAFF	TRBV13	TRBJ1-1
TGTGCCAGCAGCAACAGGGGACAGGTTTATGAAAAACTGTTTTTT	CASSNRGQVYEKLFF	TRBV5-6	TRBJ1-4
TGTGCCAGCAGTTTTCCCAACTTGGGGAGCTCCTACAATGAGCAGTTCTTC	CASSFPNLGSSYNEQFF	TRBV12-4	TRBJ2-1
TGCGCCAGCAGCCAAGCGTACAGGTGGACCGGGGAGCTGTTTTTT	CASSQAYRWTGELFF	TRBV4-1	TRBJ2-2
TGCGCCAGCAGCTTCTGCAGTCCCTATGGCTACACCTTC	CASSFCSPYGYTF	TRBV5-1	TRBJ1-2
TGTGCCACCAGTGACAGAACTCTAGGCAGTATCACAGATACGCAGTATTTT	CATSDRTLGSITDTQYF	TRBV24-1	TRBJ2-3
TGCAGTGCTCGAAACACAGGGGACTACCGCACAGATACGCAGTATTTT	CSARNTGDYRTDTQYF	TRBV20-1	TRBJ2-3
TGTGCCAGCAGCTTAGGTAGGCACCGGGCCACTGACAATGAGCAGTTCTTC	CASSLGRHRATDNEQFF	TRBV11-2	TRBJ2-1
TGTGCCAGCAGCTCGGTGGGGGCAGGTCCCCAGCATTTT	CASSSVGAGPQHF	TRBV7-3	TRBJ1-5
TGTGCCAGCAGTTACTTCACAGGGGGCCTAGTGGGCTACGAGCAGTACTTC	CASSYFTGGLVGYEQYF	TRBV6-2	TRBJ2-7
TGTGCCAGCAGCCCAGGGGATAGAGACAATGAGCAGTTCTTC	CASSPGDRDNEQFF	TRBV7-3	TRBJ2-1
TGTGCCAGCATTGGACAGGCTGCAACTAATGAAAAACTGTTTTTT	CASIGQAATNEKLFF	TRBV6-1	TRBJ1-4
TGTGCCAGCAGCGTAGGGCGGCTTTCCAACACCGGGGAGCTGTTTTTT	CASSVGRLSNTGELFF	TRBV9	TRBJ2-2
TGTGCCAGCAGCGTAAGACAGGGGAACACTAATGAAAAACTGTTTTTT	CASSVRQGNTNEKLFF	TRBV7-4	TRBJ1-4
TGCGCCAGCAGCTTTTGCTCAAGCTCAGACGGGGGCTCCGCGAACACCGGGGAGCTGTTTTTT	CASSFCSSSDGGSANTGELFF	TRBV5-1	TRBJ2-2
TGTGCCAGCAGTACGGGACAGTCACCTGAAGCTTTCTTT	CASSTGQSPEAFF	TRBV6-5	TRBJ1-1
TGTGCCAGCAGCTTAGGCTGGGACACTGAGCAGTTCTTC	CASSLGWDTEQFF	TRBV7-9	TRBJ2-1
TGCGCCAGCAGCCAAGGACAGGGGACTGGAAACACCATATATTTT	CASSQGQGTGNTIYF	TRBV4-3	TRBJ1-3
TGTGCCAGCAGCGCACGTAGGGGAAAGGGCAGTGAGCAGTACTTC	CASSARRGKGSEQYF	TRBV7-4	TRBJ2-7
TGTGCCAGCAGCTCCCTAGAGTGTGGATTTCCGTCGGTAGCGGGTGCCAATGAGCAGTTCTTC	CASSSLECGFPSVAGANEQFF	TRBV5-4	TRBJ2-1
TGTGCCAGCAGTTACGGGGAGGAGGGCTACACCTTC	CASSYGEEGYTF	TRBV6-5	TRBJ1-2
TGTGCCAGCAGCAAGGGGGGGGGTGAGCAGTTCTTC	CASSKGGGEQFF	TRBV13	TRBJ2-1
TGTGCCACCGCGGGAACCAATGAGCAGTTCTTC	CATAGTNEQFF	TRBV27	TRBJ2-1
TGTGCCAGCCAAACAGGGGGCTCTAAAGCTGGGGATGGCTACACCTTC	CASQTGGSKAGDGYTF	TRBV6-6	TRBJ1-2
TGTGCCAGCAACGACAGCTATGGCTACACCTTC	CASNDSYGYTF	TRBV9	TRBJ1-2
TGTGCCAGCAGCGGAGGGGGCCGCTATGGCTACACCTTC	CASSGGGRYGYTF	TRBV7-3	TRBJ1-2
TGTGCCAGCAGCAACGGACAGATAAATCAGCCCCAGCATTTT	CASSNGQINQPQHF	TRBV7-9	TRBJ1-5
TGTGCCAGCAGTTTGTCCCCGGGACAGGAGGGGGCCAACGTCCTGACTTTC	CASSLSPGQEGANVLTF	TRBV12-3	TRBJ2-6
TGTGCCTGGAGACGGGAGACCCAGTACTTC	CAWRRETQYF	TRBV30	TRBJ2-5
TGTGCCAGCAGCCCACCGCGGTCTGGAAACACCATATATTTT	CASSPPRSGNTIYF	TRBV5-6	TRBJ1-3
TGCGCCAGCAGCGTACTGGAGGGAATTTACCCAGATACGCAGTATTTT	CASSVLEGIYPDTQYF	TRBV4-1	TRBJ2-3
TGTGCCAGCATGGTGACGTCCTACGAGCAGTACTTC	CASMVTSYEQYF	TRBV27	TRBJ2-7
TGTGCCAGCACAGCCTATGCATGGACAGACTATGGCTACACCTTC	CASTAYAWTDYGYTF	TRBV7-3	TRBJ1-2
TGTGCCAGCGACAGCGGCAATCAGCCCCAGCATTTT	CASDSGNQPQHF	TRBV27	TRBJ1-5
TGCGCCAGCAAAGGGGGATCCTCTGGGGCCAACGTCCTGACTTTC	CASKGGSSGANVLTF	TRBV10-1	TRBJ2-6
TGCGCCAGCAGCTTGGCAAGCCCTAGCGGGGAGCCGTACGAGCAGTACTTC	CASSLASPSGEPYEQYF	TRBV5-1	TRBJ2-7
TGCAGTGCCGGTTTTAGACAGGGGGGGAACCTGTTCTTT	CSAGFRQGGNLFF	TRBV20-1	TRBJ1-1
TGTGCCAGTAGTATGGGGGAGCGCGGGGAGCTGTTTTTT	CASSMGERGELFF	TRBV19	TRBJ2-2
TGTGCCAGCCCAGACAGGGCAAAAGAGCAGTACTTC	CASPDRAKEQYF	TRBV2	TRBJ2-7
TGCGCCAGCAGCCAAGGGTGGGAACAACTAGCGGGAGGGCAGAACTACGAGCAGTACTTC	CASSQGWEQLAGGQNYEQYF	TRBV4-3	TRBJ2-7
TGTGCCAGCAGCTTAGCACCCGGGACTAGCGGCCAAGAGACCCAGTACTTC	CASSLAPGTSGQETQYF	TRBV7-9	TRBJ2-5
TGTGCCAGCAGAACGAACTACGAGCAGTACTTC	CASRTNYEQYF	TRBV27	TRBJ2-7
TGTGCCTGGCCACAGGTTGAAAAACTGTTTTTT	CAWPQVEKLFF	TRBV30	TRBJ1-4
TGTGCCAGCAGCCGGCTGCAGCCCCAGCATTTT	CASSRLQPQHF	TRBV6-5	TRBJ1-5
TGTGCCAGCAGTGATCGTTCATGGCGGCGGCCGACTGAAGCAGGAAACACCATATATTTT	CASSDRSWRRPTEAGNTIYF	TRBV6-1	TRBJ1-3
TGTGCCAGCAGTGAATACCGACATAATGGGTACCATCAGCCCCAGCATTTT	CASSEYRHNGYHQPQHF	TRBV25-1	TRBJ1-5
TGCACCGGCCCCGGGACAGGGCGGGGACGCTATGGCTACACCTTC	CTGPGTGRGRYGYTF	TRBV20-1	TRBJ1-2
TGTGCCACCAGTGCCAGCGGACAGGGGGTCTTC	CATSASGQGVF	TRBV24-1	TRBJ2-1
TGTGCTAGCAGCTTAGCGCTGGCTAGCGGGAGGCAGGAGCAGTTCTTC	CASSLALASGRQEQFF	TRBV7-7	TRBJ2-1
TGTGCCACCGGCGGGACAGGACGGTCAGGAAACACCATATATTTT	CATGGTGRSGNTIYF	TRBV24-1	TRBJ1-3
TGCGCCAGCAGCCAAGAGGTACAAGCGACCCAGTACTTC	CASSQEVQATQYF	TRBV4-3	TRBJ2-5
TGTGCCAGCTACCCCACCGGGACTAGCGGGACTAGATTGTACGAGCAGTACTTC	CASYPTGTSGTRLYEQYF	TRBV6-5	TRBJ2-7
TGTGCCAGCAGCGGAACTCCGAAAGGGGCTTTCGGGCCCGAGCAGTACTTC	CASSGTPKGAFGPEQYF	TRBV9	TRBJ2-7
TGTGCCATTCTAGGGGGGCGCTATAATTCACCCCTCCACTTT	CAILGGRYNSPLHF	TRBV19	TRBJ1-6
TGTGCCAGCAGCCCCTCTGGCTACGAGCAGTACTTC	CASSPSGYEQYF	TRBV9	TRBJ2-7
TGTGCTAGCAGCTCCCCGACAGGCGGGAGCACAGATACGCAGTATTTT	CASSSPTGGSTDTQYF	TRBV7-7	TRBJ2-3
TGCAGCGTTGTCATACAGGCGTGTCAGCCCCAGCATTTT	CSVVIQACQPQHF	TRBV29-1	TRBJ1-5
TGCAGTGCTCCGAAGGACAGGGGATCCTGGCACACTGAAGCTTTCTTT	CSAPKDRGSWHTEAFF	TRBV20-1	TRBJ1-1
TGTGCCAGCAGCTGGTTCCTTACCGGGACGAGTGAGCAGTTCTTC	CASSWFLTGTSEQFF	TRBV11-3	TRBJ2-1
TGTGCCAGCAGTAAGGGGACTAGCGGGCGCAATGAGCAGTTCTTC	CASSKGTSGRNEQFF	TRBV25-1	TRBJ2-1
TGTGCCAGCAGCTTACCCGGGGATACGCAGTATTTT	CASSLPGDTQYF	TRBV11-2	TRBJ2-3
TGTGCCAGCAGTAAAACATGGAGGACAGGGGGGGTTGGGGAAGCCTACGAGCAGTACTTC	CASSKTWRTGGVGEAYEQYF	TRBV6-1	TRBJ2-7
TGTGCCATCAGGGGACTCGAGCAGTACTTC	CAIRGLEQYF	TRBV10-3	TRBJ2-7
TGTGCCACACTGCGGCATCCGAACACCGGGGAGCTGTTTTTT	CATLRHPNTGELFF	TRBV27	TRBJ2-2
TGTGCCAGCAGCCAACTCGGGGGGCCAGGGAGCTCCTACAATGAGCAGTTCTTC	CASSQLGGPGSSYNEQFF	TRBV14	TRBJ2-1
TGTGCCAGCAGCGGCGAGGACAGCGGGGGCCAAGAGACCCAGTACTTC	CASSGEDSGGQETQYF	TRBV5-6	TRBJ2-5
TGTGCCAGCAGCTCGGCTAGCGGGAACTTGGAGCAGTACTTC	CASSSASGNLEQYF	TRBV7-9	TRBJ2-7
TGTGCCAGCAGCAGGGCAAGGTCCCAGCATTTT	CASSRARSQHF	TRBV13	TRBJ1-5
TGTGCCACCAGTGAACCCGCTGGACGGCGAGGGGGCAGCTCCTACGAGCAGTACTTC	CATSEPAGRRGGSSYEQYF	TRBV24-1	TRBJ2-7
TGTGCCAGCAGCTTAGATCAGGAAGGGTTGGGATACAGGATGAACACTGAAGCTTTCTTT	CASSLDQEGLGYRMNTEAFF	TRBV7-2	TRBJ1-1
TGTGCCAGCAGTGCCCACCGGGACATTACCAAGGCCTACGAGCAGTACTTC	CASSAHRDITKAYEQYF	TRBV6-1	TRBJ2-7
TGTGCCAGCAGCTTTCCCGAGGGCGCCTACGAGCAGTACTTC	CASSFPEGAYEQYF	TRBV7-4	TRBJ2-7
TGTGCCAGCAAGCTCCTGTGTACGCAGTATTTT	CASKLLCTQYF	TRBV6-1	TRBJ2-3
TGCAAGGCTGGTACGGCCCGCTATGGCTACACCTTC	CKAGTARYGYTF	TRBV20-1	TRBJ1-2
TGCGCCAGCAGCCGACGGCCTTTGACAGGGCTGATTAATCAGCCCCAGCATTTT	CASSRRPLTGLINQPQHF	TRBV4-3	TRBJ1-5
TGTGCCAGCAGCCCCCGGGACAGGGGTGGAGAAGGCTACACCTTC	CASSPRDRGGEGYTF	TRBV9	TRBJ1-2
TGTGCCAGCAGTCGTGCTGGCACAGATACGCAGTATTTT	CASSRAGTDTQYF	TRBV12-4	TRBJ2-3
TGTGCCAGCAGTGAAACGGAGGGCACGGAGCAGAAGGCCTACGAGCAGTACTTC	CASSETEGTEQKAYEQYF	TRBV6-1	TRBJ2-7
TGTGCCAGCAGCCAGGGGGGACACGGGTTGAATGAGCAGTTCTTC	CASSQGGHGLNEQFF	TRBV14	TRBJ2-1
TGTGCCTGGAGGATAGCCGGGCTGGTATGGCTCAGGGCCAAAAACATTCAGTACTTC	CAWRIAGLVWLRAKNIQYF	TRBV30	TRBJ2-4
TGTGCCAGCAGTTTAATGGACACTAGCGGGAGTGAAAGAGAGCAGTACTTC	CASSLMDTSGSEREQYF	TRBV12-4	TRBJ2-7
TGTGCCAGCAGTTGTGGGACAGAGGACTATGGCTACACCTTC	CASSCGTEDYGYTF	TRBV14	TRBJ1-2
TGTGCCAGATTTGGGGACCAGGGGTACACCGGGGAGCTGTTTTTT	CARFGDQGYTGELFF	TRBV11-3	TRBJ2-2
TGTGCCAGCAGTGGTGGTGGGGGCCCCCCCGTAACGAGGGGTTACAATGAGCAGTTCTTC	CASSGGGGPPVTRGYNEQFF	TRBV2	TRBJ2-1
TGTGCCAGCTGGCGGGAGGGGTCCTATGAAGAGACCCAGTACTTC	CASWREGSYEETQYF	TRBV27	TRBJ2-5
TGTGCCAGCAATAAAACTAGCGGGAGCTTATATAATTCACCCCTCCACTTT	CASNKTSGSLYNSPLHF	TRBV6-4	TRBJ1-6
TGTGCCAGCAGCGCCCACCGAAGGACAGGCCGTCGGATCTACGAGCAGTACTTC	CASSAHRRTGRRIYEQYF	TRBV9	TRBJ2-7
TGTGCCAGCAGGGACCCTCAGCCCCAGCATTTT	CASRDPQPQHF	TRBV6-5	TRBJ1-5
TGTGCCAGCAGCATCAAATGGGCGCCCTCTGGAAACACCATATATTTT	CASSIKWAPSGNTIYF	TRBV11-3	TRBJ1-3
TGCAGCGTTGAAAAAGGCTACACTGAAGCTTTCTTT	CSVEKGYTEAFF	TRBV29-1	TRBJ1-1
TGCGCCAGCAGCCCGGGACAGCTGTGCACCATATATTTT	CASSPGQLCTIYF	TRBV5-1	TRBJ1-3
TGTGCCAGCAGCCAAGCGGGACACCAGGGGGATAACTATGGCTACACCTTC	CASSQAGHQGDNYGYTF	TRBV3-1	TRBJ1-2
TGCAGTGCTAGGGGGCCTAGGAACACCGGGGAGCTGTTTTTT	CSARGPRNTGELFF	TRBV20-1	TRBJ2-2
TGTGCCACCAGCAACTACTACTCAGATACGCAGTATTTT	CATSNYYSDTQYF	TRBV15	TRBJ2-3
TGTGCCGGTGACCCGGGGACTAGCGGGGGGGAGCAGTTCTTC	CAGDPGTSGGEQFF	TRBV25-1	TRBJ2-1
TGTGCCATCAGTGAGTTTAGGATGACAGAGCAGTACTTC	CAISEFRMTEQYF	TRBV10-3	TRBJ2-7
TGTGCCTGGAGTGTACGCCGGGACAGGGGGGAGGGTGAGACCCAGTACTTC	CAWSVRRDRGEGETQYF	TRBV30	TRBJ2-5
TGTGCCAGCAGCCATCCTTACAATGAGCAGTTCTTC	CASSHPYNEQFF	TRBV3-1	TRBJ2-1
TGTGCCAGCAGCGGACAGGGGAATGAGCAGTTCTTC	CASSGQGNEQFF	TRBV7-8	TRBJ2-1
TGTGCCAGCAGCGGGTCCAGGGGTTGGGGCTATGGCTACACCTTC	CASSGSRGWGYGYTF	TRBV13	TRBJ1-2
TGTGCCAGCAGCTTGGGGACAAGTAGGGGAGGGAAGGATACGCAGTATTTT	CASSLGTSRGGKDTQYF	TRBV5-4	TRBJ2-3
TGTGCCAGCTTACCTTTCCGGGACACTGGAAACACCATATATTTT	CASLPFRDTGNTIYF	TRBV6-2	TRBJ1-3
TGCGCCAGCAGCCAGGACAGGGCTGCAACTAATGAAAAACTGTTTTTT	CASSQDRAATNEKLFF	TRBV4-1	TRBJ1-4
TGTGCCAGCATAGGGACAGGTGGATACACCGGGGAGCTGTTTTTT	CASIGTGGYTGELFF	TRBV12-3	TRBJ2-2
TGCGCCAGCAGGACTAGCCAAGGAGAAGTCTACAATGAGCAGTTCTTC	CASRTSQGEVYNEQFF	TRBV5-1	TRBJ2-1
TGTGCCAGCAGCCCTAGGGGGCACTCCTATAATTCACCCCTCCACTTT	CASSPRGHSYNSPLHF	TRBV6-5	TRBJ1-6
TGTGCCAGCAGTCGAGATCGGGTCTTTTACAATGAGCAGTTCTTC	CASSRDRVFYNEQFF	TRBV6-1	TRBJ2-1
TGTGCCAGCAGCCTTGAGGGTTTAACTGAAGCTTTCTTT	CASSLEGLTEAFF	TRBV7-9	TRBJ1-1
TGTGCCAGCCCCCGCACCGGGACTGGGAACACTGAAGCTTTCTTT	CASPRTGTGNTEAFF	TRBV28	TRBJ1-1
TGTGCCAGCAACCAGGGGGGTAACACTGAAGCTTTCTTT	CASNQGGNTEAFF	TRBV6-6	TRBJ1-1
TGTGCCAGCAGCAAGTGGCGGCCTCAAGAGACCCAGTACTTC	CASSKWRPQETQYF	TRBV7-3	TRBJ2-5
TGTGCCAGGGGATTCGGGACAGGGAGATCCTACGAGCAGTACTTC	CARGFGTGRSYEQYF	TRBV6-5	TRBJ2-7
TGTGCCAGCAGCTTAGGTAATAACGAGCAGTACTTC	CASSLGNNEQYF	TRBV7-4	TRBJ2-7
TGTGCCAGCAGGACAGTGGATGGCTACACCTTC	CASRTVDGYTF	TRBV7-3	TRBJ1-2
TGTGCCACCGCACAGGGGGCGCTACCCTATGGCTACACCTTC	CATAQGALPYGYTF	TRBV6-5	TRBJ1-2
TGTGCCAGCAGCTTGGTAAGAATCAGGGGGCTAGCCAAAAACATTCAGTACTTC	CASSLVRIRGLAKNIQYF	TRBV5-6	TRBJ2-4
TGTGCCACCAGTGATTTGCGGGACAGTTATGGGGGCTACGAGCAGTACTTC	CATSDLRDSYGGYEQYF	TRBV24-1	TRBJ2-7
TGTGCCAGCAGCCTTTCCGGAAGATACGAGCAGTTCTTC	CASSLSGRYEQFF	TRBV13	TRBJ2-1
TGTGCCACCAGTGATTTTGTGACGGACAGTCATAGCTCCTATAATTCACCCCTCCACTTT	CATSDFVTDSHSSYNSPLHF	TRBV24-1	TRBJ1-6
TGTGCCAGTAGTATCCATGGGGGGGAGGACACCGGGGAGCTGTTTTTT	CASSIHGGEDTGELFF	TRBV19	TRBJ2-2
TGTGCCAGCAGCCCGCCGACGGCGGATAATCAGCCCCAGCATTTT	CASSPPTADNQPQHF	TRBV3-1	TRBJ1-5
TGTGCCAGCAGCCAAGCTCGAAGGGACAGGGCCTGGAACACTGAAGCTTTCTTT	CASSQARRDRAWNTEAFF	TRBV4-2	TRBJ1-1
TGTGCCAGCAGTTATAAGTTTTCTCAGGGTGGGGTCATGCCGAACACTGAAGCTTTCTTT	CASSYKFSQGGVMPNTEAFF	TRBV6-5	TRBJ1-1
TGTGCCAGCAGTTTAGGTGCAGGGGGGGATAAGGACACTGAAGCTTTCTTT	CASSLGAGGDKDTEAFF	TRBV28	TRBJ1-1
TGTGCCATCGGGGGGTCTGAGAACACTGAAGCTTTCTTT	CAIGGSENTEAFF	TRBV3-1	TRBJ1-1
TGTGCCAGCAGCCTCCCCACGCAGTGTCCGGGATCTGGAAACACCATATATTTT	CASSLPTQCPGSGNTIYF	TRBV6-4	TRBJ1-3
TGCAGTGCGGTCCCGCCCTACAATGAGCAGTTCTTC	CSAVPPYNEQFF	TRBV20-1	TRBJ2-1
TGTGCCAGCAGCTTACGGAGGGGGGAAGCCAAAAACATTCAGTACTTC	CASSLRRGEAKNIQYF	TRBV7-3	TRBJ2-4
TGTGCCTTCACACTCGGCAGGGGGTTGCGGGCCTACGAGCAGTACTTC	CAFTLGRGLRAYEQYF	TRBV28	TRBJ2-7
TGCGCCAGCAGTGATTGCAGGGTACGAAAGGATGTCTACGAGCAGTACTTC	CASSDCRVRKDVYEQYF	TRBV10-1	TRBJ2-7
TGTGCCAGCCGCGTTCCCCCGGACAGGGAATCGTCGGACTCCTACGAGCAGTACTTC	CASRVPPDRESSDSYEQYF	TRBV5-4	TRBJ2-7
TGTGCCAGCAGCCAGCCCTCGCCCGGGGGGTGTGCCGAGCAGTACTTC	CASSQPSPGGCAEQYF	TRBV14	TRBJ2-7
TGTGCCAGCAGTGAAGTGCGGGCCCGAGGTACCGGGGAGCTGTTTTTT	CASSEVRARGTGELFF	TRBV6-1	TRBJ2-2
TGCAGTGCAAAGGGGGCAAGATACGAGCAGTACTTC	CSAKGARYEQYF	TRBV20-1	TRBJ2-7
TGTGCCAGCAACAGTCGGGAGGATCAGGGGAGGGATGGCTACACCTTC	CASNSREDQGRDGYTF	TRBV6-3	TRBJ1-2
TGTGCCAGCAGCCCGGGGAGGGGGGGCTACACCTTC	CASSPGRGGYTF	TRBV6-5	TRBJ1-2
TGCAGTGCTAGATACCGTGCGGCGAACACCGGGGAGCTGTTTTTT	CSARYRAANTGELFF	TRBV20-1	TRBJ2-2
TGTGCCAGCAGCCAGTTTTACGGGGGTCGCGTGAACACTGAAGCTTTCTTT	CASSQFYGGRVNTEAFF	TRBV7-4	TRBJ1-1
TGTGCCAGCAGCCGTGTGTTACGACTAGTCGCCTACGAGCAGTACTTC	CASSRVLRLVAYEQYF	TRBV9	TRBJ2-7
TGTGCCAGCAGCTTCCTGGGGCGACGGACTAGCGAGGAGCAGTTCTTC	CASSFLGRRTSEEQFF	TRBV7-4	TRBJ2-1
TGTGCTAACCTGTCACCCCTCCACTTT	CANLSPLHF	TRBV12-5	TRBJ1-6
TGTGCCAGCCTTGACGGCCCCGCCAGGGGGCTCAGCAATCAGCCCCAGCATTTT	CASLDGPARGLSNQPQHF	TRBV11-2	TRBJ1-5
TGTGCCAGCAGCGATAGTCGGGCCCGAACCGAGCAGTACTTC	CASSDSRARTEQYF	TRBV5-6	TRBJ2-7
TGTGCCAGCAGCGTTAGTACGAGGGACGAGCAGTACTTC	CASSVSTRDEQYF	TRBV11-3	TRBJ2-7
TGCGCCAGCAGCCAACGAAGCGGGAAGGATGAGCAGTTCTTC	CASSQRSGKDEQFF	TRBV4-3	TRBJ2-1
TGTGCCAGCAGCCACCATGCAGGGATAAGACCGGCTGGAAACATTCAGTACTTC	CASSHHAGIRPAGNIQYF	TRBV7-2	TRBJ2-4
TGTGCCAGCAGCCAAGACGGGACCCTCACTGAAGCTTTCTTT	CASSQDGTLTEAFF	TRBV14	TRBJ1-1
TGTGCTAGTGGTGCAGTCTTCTGGGTAGCGGGAGGGCAGCCCCAGCATTTT	CASGAVFWVAGGQPQHF	TRBV12-5	TRBJ1-5
TGTGCCAGCAGCAGTGAGGGAAGCAATCAGCCCCAGCATTTT	CASSSEGSNQPQHF	TRBV28	TRBJ1-5
TGTGCCAGTACAATCAACCGCGGGGCACCCAATGAAAAACTGTTTTTT	CASTINRGAPNEKLFF	TRBV19	TRBJ1-4
TGCGCCAGCAGCTTGGATGCAGGGGCGGGGGACTGCTATGGCTACACCTTC	CASSLDAGAGDCYGYTF	TRBV5-1	TRBJ1-2
TGTGCCCAGGGCCCCAGGGAAGAGACCCAGTACTTC	CAQGPREETQYF	TRBV30	TRBJ2-5
TGTGCCAGCAGCGATTCGAGTGCGGGAGCTGGAAACACCATATATTTT	CASSDSSAGAGNTIYF	TRBV13	TRBJ1-3
TGTGCCAGCAGCCCCGTTACGTCGAAGACAGGGGGGTCAGCGTACGAGCAGTACTTC	CASSPVTSKTGGSAYEQYF	TRBV7-9	TRBJ2-7
TGCAGTGCTAGAGGCCTAGCGGGAATTTACGAGCAGTACTTC	CSARGLAGIYEQYF	TRBV20-1	TRBJ2-7
TGCAGTGCTAGAGCTTCCAATTGGGGGCGGGTCTCAGAGGGGGTCGAGCCCCAGCATTTT	CSARASNWGRVSEGVEPQHF	TRBV20-1	TRBJ1-5
TGTGCCAGCAGCTTGCCCAGGGGGCTACGTGGCTACACCTTC	CASSLPRGLRGYTF	TRBV7-3	TRBJ1-2
TGTGCCAGCAGTGAAGTCCCCTCACCAATGACCAGGGCGTTCTACAATGAGCAGTTCTTC	CASSEVPSPMTRAFYNEQFF	TRBV2	TRBJ2-1
TGTGCCAGTAGTTGTGACAGGGGCGGCTACGAGCAGTACTTC	CASSCDRGGYEQYF	TRBV19	TRBJ2-7
TGTGCCACCAGTGATTTCACGGAAGCTTTCTTT	CATSDFTEAFF	TRBV24-1	TRBJ1-1
TGCAGTGCAACAGGGTCGAATGGCTACACCTTC	CSATGSNGYTF	TRBV20-1	TRBJ1-2
TGTGCCAGCAGCTTAGCGCGAGGACAGGGAGGGAATGAGCAGTTCTTC	CASSLARGQGGNEQFF	TRBV7-7	TRBJ2-1
TGTGCCAGCAGTTCGCAGGGTCAGGCCATCAATCAGCCCCAGCATTTT	CASSSQGQAINQPQHF	TRBV2	TRBJ1-5
TGCAGTGCTAGTGGGGTGCTCCGCAATCAGCCCCAGCATTTT	CSASGVLRNQPQHF	TRBV20-1	TRBJ1-5
TGTGCCAGCAGCTTGGATAAATCGGGGTACAATGAGCAGTTCTTC	CASSLDKSGYNEQFF	TRBV5-4	TRBJ2-1
TGTGCCAGCAGCGTTTCCTTAGCGGGAGAGGGGAGCTCCTACAATGAGCAGTTCTTC	CASSVSLAGEGSSYNEQFF	TRBV9	TRBJ2-1
TGTGCCAGCAGTGTCGAGCAGTACTTC	CASSVEQYF	TRBV9	TRBJ2-7
TGTGCCATCAGTGGTATTCTGCGGTCGTATAGCGCTCACTCCTACGAGCAGTACTTC	CAISGILRSYSAHSYEQYF	TRBV10-3	TRBJ2-7
TGTGCCAGCAGTTACGAACCTAGCCGCGAGCAGTACTTC	CASSYEPSREQYF	TRBV6-3	TRBJ2-7
TGTGCCAGCAGCCAAGCCTCAGGGTGCTACGAGCAGTACTTC	CASSQASGCYEQYF	TRBV4-2	TRBJ2-7
TGTGCCACAGAACGTTGGAGCAATCAGCCCCAGCATTTT	CATERWSNQPQHF	TRBV6-3	TRBJ1-5
TGTGCCAGCAAGGGGAGGCTTGCGGAAGATCAAGAGACCCAGTACTTC	CASKGRLAEDQETQYF	TRBV6-3	TRBJ2-5
TGTGCCAGCAGCGTCTTGGGGACAGACGAGCAGTACTTC	CASSVLGTDEQYF	TRBV9	TRBJ2-7
TGTGCCAGCAGCCTAAGTGGGGAGCAGTACTTC	CASSLSGEQYF	TRBV13	TRBJ2-7
TGCAGTGCTGGGACAGCAGGCAATCAGCCCCAGCATTTT	CSAGTAGNQPQHF	TRBV20-1	TRBJ1-5
TGTGCCAGCAGCACTAGCCGCGGGGAGCTGTTTTTT	CASSTSRGELFF	TRBV3-1	TRBJ2-2
TGTGCCAGCAGTGACTCGGGCCAGGGGGGCATAGACTACAATGAGCAGTTCTTC	CASSDSGQGGIDYNEQFF	TRBV6-4	TRBJ2-1
TGTGCCAGCAGCAGGGGGAAGTGCAATCAGCCCCAGCATTTT	CASSRGKCNQPQHF	TRBV5-6	TRBJ1-5
TGTGCCAGCAGCTTAGTTGGGGGAGGGCGGAACATTCAGTACTTC	CASSLVGGGRNIQYF	TRBV11-3	TRBJ2-4
TGTGCCAGCAGTTTGGTCGGGGCCGCGGATAGCTCCTACGAGCAGTACTTC	CASSLVGAADSSYEQYF	TRBV27	TRBJ2-7
TGTGCCACCAGTGCCCAGGGGGCTGGAAACACCATATATTTT	CATSAQGAGNTIYF	TRBV24-1	TRBJ1-3
TGTGCCAGCAGCCCAGTTGACACCGGGGAGCTGTTTTTT	CASSPVDTGELFF	TRBV7-9	TRBJ2-2
TGTGCCAGCAGTTTAACAAGGACTAGGGCCTACAATGAGCAGTTCTTC	CASSLTRTRAYNEQFF	TRBV27	TRBJ2-1
TGTGCCTGGATAGCAATCTCCTACAATGAGCAGTTCTTC	CAWIAISYNEQFF	TRBV30	TRBJ2-1
TGTGCCAGCAGTCCAGGGGGGGGGATTTTAGATGAGCAGTTCTTC	CASSPGGGILDEQFF	TRBV6-4	TRBJ2-1
TGTGCCAGCAGCCCCTGGCTTAGGGGGTTAACTTTGTATAGCAATCAGCCCCAGCATTTT	CASSPWLRGLTLYSNQPQHF	TRBV4-2	TRBJ1-5
TGTGCCAGCAGTTACCCATATAGGGCCTACGAGCAGTACTTC	CASSYPYRAYEQYF	TRBV6-2	TRBJ2-7
TGTGCCAGTGCGACCTGGACAGGTGATAACACCGGGGAGCTGTTTTTT	CASATWTGDNTGELFF	TRBV6-5	TRBJ2-2
TGTGCCAGCAGACCTAGGGGAGAAGGGTCAGATACGCAGTATTTT	CASRPRGEGSDTQYF	TRBV6-8	TRBJ2-3
TGTGCCAGCCCTCGGGTCCGGGGACACGTAGGAATTCCCCAGGGGGGTCGGGAAGAGACCCAGTACTTC	CASPRVRGHVGIPQGGREETQYF	TRBV6-5	TRBJ2-5
TGTGCCAGCAGCGGACAGCGTGCTAACTATGGCTACACCTTC	CASSGQRANYGYTF	TRBV3-1	TRBJ1-2
TGTGCCAGCAGCGTAGGACCACTCAGGAACACTGAAGCTTTCTTT	CASSVGPLRNTEAFF	TRBV9	TRBJ1-1
TGTGCCAGCAGTGACTCGACTCCCTGGACTAGCGGGACGGATGAGCAGTTCTTC	CASSDSTPWTSGTDEQFF	TRBV6-4	TRBJ2-1
TGTGCCAGCTCACAGGGGGCCGTACTAAGTCAGCCCCAGCATTTT	CASSQGAVLSQPQHF	TRBV11-2	TRBJ1-5
TGTGCCAGCAGCCAAGGGCGTCAGGGCAAGGACACCGGGGAGCTGTTTTTT	CASSQGRQGKDTGELFF	TRBV4-2	TRBJ2-2
TGTGCTAGCAGCTTAGATACGGCTCGAAACAATCAGCCCCAGCATTTT	CASSLDTARNNQPQHF	TRBV7-7	TRBJ1-5
TGTGCCAGCAGCAGACGACGGGGGGGGGGGGTGGGCACAGATACGCAGTATTTT	CASSRRRGGGVGTDTQYF	TRBV7-2	TRBJ2-3
TGTGCCAGCAGTTATAGGGGACAGGCGATGAACACTGAAGCTTTCTTT	CASSYRGQAMNTEAFF	TRBV28	TRBJ1-1
TGTGCCAGCTCACCAAGCGGGAGGTCCGGACAGGAGGAGGAAGCTTTCTTT	CASSPSGRSGQEEEAFF	TRBV18	TRBJ1-1
TGTGCCAGCAGCTTGCTGGGACCCAAGCCGCCCCTCGCCCCGGGACAGGGTGAGAATTCACCCCTCCACTTT	CASSLLGPKPPLAPGQGENSPLHF	TRBV5-8	TRBJ1-6
TGTGCCAGCAGTCCCGGACAGGGTGCAACTAATGAAAAACTGTTTTTT	CASSPGQGATNEKLFF	TRBV6-3	TRBJ1-4
TGCGCCATTAGGGACAGGGATAGCAATCAGCCCCAGCATTTT	CAIRDRDSNQPQHF	TRBV5-1	TRBJ1-5
TGTGCCATAAATCCCGTCTTAAGCTACGAGCAGTACTTC	CAINPVLSYEQYF	TRBV6-4	TRBJ2-7
TGTGCCAGCAGCTCAGGAGGACGTTTGGAGACCCAGTACTTC	CASSSGGRLETQYF	TRBV7-3	TRBJ2-5
TGTGCCAGCAGTTACGAGACGGGACAGCTTGCTAATGAAAAACTGTTTTTT	CASSYETGQLANEKLFF	TRBV6-5	TRBJ1-4
TGTGCCAGCAGCAAATGTCCCCCCCCTTCCAGGGAGACTGGGCAGCCCCAGCATTTT	CASSKCPPPSRETGQPQHF	TRBV7-4	TRBJ1-5
TGTGCCAGCCAATACGGACACAGGGGAAATGAGCAGTTCTTC	CASQYGHRGNEQFF	TRBV27	TRBJ2-1
TGTGCCAGCAGGGAACGGAGTCCCTACGAGCAGTACTTC	CASRERSPYEQYF	TRBV6-5	TRBJ2-7
TGTGCCAGCAGCAAGATCGGGCAAGAGACCCAGTACTTC	CASSKIGQETQYF	TRBV7-3	TRBJ2-5
TGTGCCAGCAGTTACCTGACTAACTATGGCTACACCTTC	CASSYLTNYGYTF	TRBV6-5	TRBJ1-2
TGTGCCAGCAGCCAATCCCGACAGGGTGCGCACAATGAGCAGTTCTTC	CASSQSRQGAHNEQFF	TRBV16	TRBJ2-1
TGTGCCAGCAGCGTAGAGGGGGGTAGGTCCTGCGCCCCCCAGTACTTC	CASSVEGGRSCAPQYF	TRBV9	TRBJ2-5
TGTGCCAGCCCGGGACTGGATGAAAAACTGTTTTTT	CASPGLDEKLFF	TRBV6-4	TRBJ1-4
TGTGCCAGCAGCCTGAAGGGAAATTTTTTCAGATATAATTCACCCCTCCACTTT	CASSLKGNFFRYNSPLHF	TRBV7-9	TRBJ1-6
TGCGCCAGCAGCTTGCCAAGACAGCCCCAGCATTTT	CASSLPRQPQHF	TRBV5-1	TRBJ1-5
TGTGCCAGCAGTTTTGACTATACGCAGTATTTT	CASSFDYTQYF	TRBV6-1	TRBJ2-3
TGCGCCAGCAGTCGGACGGGGTACGAGCAGTACTTC	CASSRTGYEQYF	TRBV10-1	TRBJ2-7
TGTGCCAGCAGCCAAGATACCTGGGCAGGGCAGGTTCAGCCCCAGCATTTT	CASSQDTWAGQVQPQHF	TRBV14	TRBJ1-5
TGTGCCAGCAGTTCCGTATTCAGACAGGGCACCCTTGGGGGGCCCCAGCATTTT	CASSSVFRQGTLGGPQHF	TRBV12-4	TRBJ1-5
TGTGCCAGCATTCATTCATATACTTCGTGCCCAGTCACTGAAGCTTTCTTT	CASIHSYTSCPVTEAFF	TRBV5-8	TRBJ1-1
TGCAGTGAGTCGGCCTACGAGCAGTACTTC	CSESAYEQYF	TRBV20-1	TRBJ2-7
TGTGCCTGGCTCGGGGCTAATGAAAAACTGTTTTTT	CAWLGANEKLFF	TRBV30	TRBJ1-4
TGTGCCAGCAGCCCCCGGGCGAATACGCAGTATTTT	CASSPRANTQYF	TRBV28	TRBJ2-3
TGTGAGGCCGGGATTAGCTCTGGAAACACCATATATTTT	CEAGISSGNTIYF	TRBV6-1	TRBJ1-3
TGTGCCAAAGTCCGGGACAGGGCTCCCCAAGAGACCCAGTACTTC	CAKVRDRAPQETQYF	TRBV27	TRBJ2-5
TGTGCCACCAGTGGCCGGCTTAAGGGGCCTAGGGGCTACAATGAGCAGTTCTTC	CATSGRLKGPRGYNEQFF	TRBV24-1	TRBJ2-1
TGTGCTAGTGGTATCAGGGGATCTGAAGCTTTCTTT	CASGIRGSEAFF	TRBV12-5	TRBJ1-1
TGCAGTGCTAGAGGTACCTTAGTACCCGAGCGGGAGGGGGAGAAAAACGAGCAGTACTTC	CSARGTLVPEREGEKNEQYF	TRBV20-1	TRBJ2-7
TGTGCCAGCCCGCGGGACAGAACCTACGAGCAGTACTTC	CASPRDRTYEQYF	TRBV6-3	TRBJ2-7
TGTGCCAGCAGCACGCAGTGGTCTAGCGTTTTTAGGGCTGAGCAGTTCTTC	CASSTQWSSVFRAEQFF	TRBV7-9	TRBJ2-1
TGTGCCAGCAGCGACAGGGGAATGTACGAGCAGTACTTC	CASSDRGMYEQYF	TRBV5-4	TRBJ2-7
TGTGCCAAACACCAGGGGGGCGGGGAGCTGTTTTTT	CAKHQGGGELFF	TRBV28	TRBJ2-2
TGTGCCAGCAGTGGACTGGGGCAGCCCTCTAATCAGCCCCAGCATTTT	CASSGLGQPSNQPQHF	TRBV28	TRBJ1-5
TGTGCCAGCAGTTTATGGGAGACGAACACTGAAGCTTTCTTT	CASSLWETNTEAFF	TRBV28	TRBJ1-1
TGCGCCAGCAGCCCAGGACTAGCGGGCAGTCACGATACGCAGTATTTT	CASSPGLAGSHDTQYF	TRBV4-3	TRBJ2-3
TGCGCCAGCAGCTTGGCCACCCTCTTGAAATTGGGGGGGCTAGGACGCACAGATACGCAGTATTTT	CASSLATLLKLGGLGRTDTQYF	TRBV5-1	TRBJ2-3
TGCGCCAGCAGCCAAGGGGGGAATGGCTACACCTTC	CASSQGGNGYTF	TRBV4-1	TRBJ1-2
TGTGCCATCCCGGAACTAAGCTCCTATAATTCACCCCTCCACTTT	CAIPELSSYNSPLHF	TRBV19	TRBJ1-6
TGTGCCACCAGCCAAGGACAGGAGGGCCAGCCCCAGCATTTT	CATSQGQEGQPQHF	TRBV15	TRBJ1-5
TGTGCCAGCAGCTTAAGAACCCTCGGGGGCCAGAAGACTCCCGGCTACACCTTC	CASSLRTLGGQKTPGYTF	TRBV7-3	TRBJ1-2
TGTGCCAGCAGCGTCGACCAGGTCCCAGCTAGGACCCGAAACATTCAGTACTTC	CASSVDQVPARTRNIQYF	TRBV9	TRBJ2-4
TGTGCTAGTGGTAATCCCCGAGGACCACCCAAGAACACTGAAGCTTTCTTT	CASGNPRGPPKNTEAFF	TRBV12-5	TRBJ1-1
TGCAGTGCTAGGATCGCCCTCGCCAAAAACATTCAGTACTTC	CSARIALAKNIQYF	TRBV20-1	TRBJ2-4
TGCGCCAGCAGCCAAGATTTAAGGGCCCATGGCTACACCTTC	CASSQDLRAHGYTF	TRBV4-3	TRBJ1-2
TGCGCCAGCAGTGAAAAGGGTGACACTGAAGCTTTCTTT	CASSEKGDTEAFF	TRBV10-1	TRBJ1-1
TGCGCCAGCAGCCCCGATGGCTACACCTTC	CASSPDGYTF	TRBV5-1	TRBJ1-2
TGCGCCAGCAGCCTCTATTATAGCAATCAGCCCCAGCATTTT	CASSLYYSNQPQHF	TRBV4-3	TRBJ1-5
TGTGCCAGCAGCTTAGTCGACAGCGGTTCTGAAGCTTTCTTT	CASSLVDSGSEAFF	TRBV7-9	TRBJ1-1
TGCGCCAGCAGTGAGACGCGACCCGGGAGGGCCCTATTGTGGCCCTACGAGCAGTACTTC	CASSETRPGRALLWPYEQYF	TRBV10-2	TRBJ2-7
TGTGCCAGCAGTCATCACCACTTGCACAATGAGCAGTTCTTC	CASSHHHLHNEQFF	TRBV6-5	TRBJ2-1
TGTGCGCACAGCTATGGCTACACCTTC	CAHSYGYTF	TRBV28	TRBJ1-2
TGCGCCAGACAGGGTCGGCGGGGCTATGGCTACACCTTC	CARQGRRGYGYTF	TRBV10-1	TRBJ1-2
TGCAGTGCTGGGAGGGGTGAGCAGTTCTTC	CSAGRGEQFF	TRBV20-1	TRBJ2-1
TGTGCCAGCAGCGTCAGCGACCCCCGCACCGGGGAGCTGTTTTTT	CASSVSDPRTGELFF	TRBV9	TRBJ2-2
TGTGCCAGCAGGTGGGGGGGAGGGGGCAAGAGGTTGCCAACCGGGGAGCTGTTTTTT	CASRWGGGGKRLPTGELFF	TRBV6-5	TRBJ2-2
TGTGCCAGCAGCGGGACTAGCGGGGATGAGCAGTTCTTC	CASSGTSGDEQFF	TRBV13	TRBJ2-1
TGTGCCAGCAGCCCGGGACTCGTAGGTGAGACCCAGTACTTC	CASSPGLVGETQYF	TRBV13	TRBJ2-5
TGTGCCAGCAGGGGGGACTTTAACATTCAGTACTTC	CASRGDFNIQYF	TRBV7-9	TRBJ2-4
TGTGCCAGCAGTTACGCCTGTGACAGGGGAAAAGCAGAGACCCAGTACTTC	CASSYACDRGKAETQYF	TRBV6-3	TRBJ2-5
TGCGCCAGCAGCCATGGAGGAGGGAACAGCTACACCTTC	CASSHGGGNSYTF	TRBV4-1	TRBJ1-2
TGTGCCAGCAGCAGCCAGGGACAGGGTGAAAAACTGTTTTTT	CASSSQGQGEKLFF	TRBV13	TRBJ1-4
TGTGCCTGGACTGGATCCACAGGGAGGTCGAACACCGGGGAGCTGTTTTTT	CAWTGSTGRSNTGELFF	TRBV30	TRBJ2-2
TGTGCCAGCAGCGTAGCCCCCTCTGGCTACGAGCAGTACTTC	CASSVAPSGYEQYF	TRBV9	TRBJ2-7
TGCGCCAGCAGCCAAGAAGCAACTAGCGGGAGATTCGAGCAGTACTTC	CASSQEATSGRFEQYF	TRBV4-1	TRBJ2-7
TGTGCCAGCAGCGGGGGAAAGGGGCGGGGGGAAGCTGAAGCTTTCTTT	CASSGGKGRGEAEAFF	TRBV7-9	TRBJ1-1
TGCGCCAGCGGTAGGGGGATGTCCAGCTTC	CASGRGMSSF	TRBV4-3	TRBJ1-2
TGTGCCACGCGGGTGGACCTAACCTGGACAGGGAAATGCTGCTACGAGCAGTACTTC	CATRVDLTWTGKCCYEQYF	TRBV24-1	TRBJ2-7
TGTGCCAGCAGCCAACCCCTAGCGGGTTATACGCAGTATTTT	CASSQPLAGYTQYF	TRBV3-1	TRBJ2-3
TGTGCCAGCGTTTCCGGGACAGGGGGCGCCTACGAGCAGTACTTC	CASVSGTGGAYEQYF	TRBV27	TRBJ2-7
TGCGCCAGCAGCCAAGACAGGGGGGGTCAGCCCCAGCATTTT	CASSQDRGGQPQHF	TRBV4-1	TRBJ1-5
TGTGCCAGCACTACCGGACGGCAAGTGAACACTGAAGCTTTCTTT	CASTTGRQVNTEAFF	TRBV7-9	TRBJ1-1
TGTGCCAGCAGCTGCAGACAGGCGAAGATCCGAAGACCGAACACTGAAGCTTTCTTT	CASSCRQAKIRRPNTEAFF	TRBV5-4	TRBJ1-1
TGCGCCAGCAGCTTGTTGGGATACGAGCAGTACTTC	CASSLLGYEQYF	TRBV5-1	TRBJ2-7
TGTGCCAGCCCTAGCTCTGGGGCCAACGTCCTGACTTTC	CASPSSGANVLTF	TRBV2	TRBJ2-6
TGCAGTGCTAGAGATCATCCGGGACAAGTTATGTACGAGCAGTACTTC	CSARDHPGQVMYEQYF	TRBV20-1	TRBJ2-7
TGTGCCACCAGTGATTTATCAGCGGGATCGACTGCCTACGAGCAGTACTTC	CATSDLSAGSTAYEQYF	TRBV24-1	TRBJ2-7
TGTGCCACCGGGAGTGGGGGTTTCCAAGAGACCCAGTACTTC	CATGSGGFQETQYF	TRBV24-1	TRBJ2-5
TGTGCCAGCGCCTACGAGCAGTACTTC	CASAYEQYF	TRBV2	TRBJ2-7
TGTGCCAGCAGCTTACCAGCGGGAACTCGACCATCGGTCGGGGAGACTGAAGCTTTCTTT	CASSLPAGTRPSVGETEAFF	TRBV13	TRBJ1-1
TGCGCCAGGGACAGTAAGTTGTCCTCCTACGAGCAGTACTTC	CARDSKLSSYEQYF	TRBV4-3	TRBJ2-7
TGTGCCAGCAGCTTATCCGATGAAAAACTGTTTTTT	CASSLSDEKLFF	TRBV7-3	TRBJ1-4
TGCGCCAGCAGTTCACAGGGCACCTACAATGAGCAGTTCTTC	CASSSQGTYNEQFF	TRBV10-1	TRBJ2-1
TGTGCCAGCAGCCTCTTGAACGGCCCAGGTAACTATGGCTACACCTTC	CASSLLNGPGNYGYTF	TRBV7-3	TRBJ1-2
TGTGCCACCAGCAGAGGGGGGAGGAGGTTGGAAAAACTGTTTTTT	CATSRGGRRLEKLFF	TRBV15	TRBJ1-4
TGCGCCAGCACCCACTGTCTTGTTTCCTACGAGCAGTACTTC	CASTHCLVSYEQYF	TRBV4-1	TRBJ2-7
TGTGCCAGCGCAAGCCGAATAACCCGGGACAGGGGCCTTCAGAAAGAGACCCAGTACTTC	CASASRITRDRGLQKETQYF	TRBV6-4	TRBJ2-5
TGTGCCAGCAGCGTAGACGGCCTCGACGAAAGCGAGCAGTACTTC	CASSVDGLDESEQYF	TRBV9	TRBJ2-7
TGTGCCACCAGTGATTTTAGCGGGAGGGGGGCAGAGACCCAGTACTTC	CATSDFSGRGAETQYF	TRBV24-1	TRBJ2-5
TGTGCCAGCAGCGTAGAAAGACAGTCCACTGAAGCTTTCTTT	CASSVERQSTEAFF	TRBV9	TRBJ1-1
TGTGCCAGCAAACCCAAAGACAGGGGGAGGGAAAAACTGTTTTTT	CASKPKDRGREKLFF	TRBV7-9	TRBJ1-4
TGTGCCAGCACAGACAGGGTCTCTGGATACTATGGCTACACCTTC	CASTDRVSGYYGYTF	TRBV7-9	TRBJ1-2
TGTGCCACCAGAACACAGACAGGGGATAGCAATCAGCCCCAGCATTTT	CATRTQTGDSNQPQHF	TRBV24-1	TRBJ1-5
TGCAGTGCTAGATTAACAGGGAATCAGCCCCAGCATTTT	CSARLTGNQPQHF	TRBV20-1	TRBJ1-5
TGCGCCAGCAGCTTGCGACAGGGCTACGATTCACCCCTCCACTTT	CASSLRQGYDSPLHF	TRBV5-1	TRBJ1-6
TGTGCCAGCAGTCCATCCCCGGAGTGCAATGAGCAGTTCTTC	CASSPSPECNEQFF	TRBV2	TRBJ2-1
TGTGCCAGCAGCTTATCTAGAACCCCGGAGGGGGGGTACGAGCAGTACTTC	CASSLSRTPEGGYEQYF	TRBV7-3	TRBJ2-7
TGTGCCAGCAGTTACCACCGGACATGCCGTGAGTACCAAGAGACCCAGTACTTC	CASSYHRTCREYQETQYF	TRBV6-5	TRBJ2-5
TGTGCCAGCAGCTCCTCTACTGGGACTAGCGGGAATCCAGAGACCCAGTACTTC	CASSSSTGTSGNPETQYF	TRBV11-2	TRBJ2-5
TGTGCCACCCGAATCCTCAAGGGGGGGGTACATGAGCAGTTCTTC	CATRILKGGVHEQFF	TRBV24-1	TRBJ2-1
TGTGCCAGCAGCTTAGATTTAAGGCAAGACAGGGCCAGAACTGAAGCTTTCTTT	CASSLDLRQDRARTEAFF	TRBV11-3	TRBJ1-1
TGTGCCAGCAGGTTCCACGGCGAACCACTAGCGGGAGGCGAACCCTACAATGAGCAGTTCTTC	CASRFHGEPLAGGEPYNEQFF	TRBV6-5	TRBJ2-1
TGTGCCAGCACCACTAGACAGGGCGGCAATCAGCCCCAGCATTTT	CASTTRQGGNQPQHF	TRBV6-4	TRBJ1-5
TGTGCCAGCAGCCAACAGAGGGCGTCGGGGGCCTACGAGCAGTACTTC	CASSQQRASGAYEQYF	TRBV7-2	TRBJ2-7
TGTGCCAGTAGTCGGACTTCCCCCGCGGTCCAAAATGAAAAACTGTTTTTT	CASSRTSPAVQNEKLFF	TRBV19	TRBJ1-4
TGTGCCAGCAGCAAAATTTTCCCCGGGACAGCTCCTTATCAGCCCCAGCATTTT	CASSKIFPGTAPYQPQHF	TRBV7-3	TRBJ1-5
TGTGCCAGCAGCTTATCAACCGGGGAGCTGTTTTTT	CASSLSTGELFF	TRBV7-9	TRBJ2-2
TGTGCTAGTGGCCCCCTAGATAACGGGGGAGGGGACCACGAGCAGTACTTC	CASGPLDNGGGDHEQYF	TRBV12-5	TRBJ2-7
TGTGCCACCAGCTCTCTTCGGTCACCTTTGTGGGAACGGAATCAGAAAACCTACGAGCAGTACTTC	CATSSLRSPLWERNQKTYEQYF	TRBV15	TRBJ2-7
TGTGCCAGCAGTCCCGGGGGGGGGTCCGCCGCCTACAATGAGCAGTTCTTC	CASSPGGGSAAYNEQFF	TRBV27	TRBJ2-1
TGTGCCAGCAGCTTATTCCGGGACAGGGCCGGGGGCCTATACAATGAGCAGTTCTTC	CASSLFRDRAGGLYNEQFF	TRBV7-3	TRBJ2-1
TGTGCCAGCAGTTTATGCCAGCGGGAGAGTACCTACGAGCAGTACTTC	CASSLCQRESTYEQYF	TRBV28	TRBJ2-7
TGTGCCAGCAGTAGAGGGGTCACCGGGGAGCTGTTTTTT	CASSRGVTGELFF	TRBV28	TRBJ2-2
TGTGCTCAGTGCCAGGGCTATGGCTACACCTTC	CAQCQGYGYTF	TRBV9	TRBJ1-2
TGTGCCACCAGTGATTTGGTTAAGTGGGACAGCTCCAGGGGGTGGTGCACAGATACGCAGTATTTT	CATSDLVKWDSSRGWCTDTQYF	TRBV24-1	TRBJ2-3
