TGCAGTGCTAGAGTGAGATCAAGGGGGGCAGGTAGCTCCTACGAGCAGTACTTC	CSARVRSRGAGSSYEQYF	TRBV20-1	TRBJ2-7
TGTGCCAGCTGCGAACCCACAGGGGCTAGCACTGAAGCTTTCTTT	CASCEPTGASTEAFF	TRBV6-4	TRBJ1-1
TGTGCCAGCAGTGAAACGGTCCAAGGGGGGGCGAGAGATACGCAGTATTTT	CASSETVQGGARDTQYF	TRBV25-1	TRBJ2-3
TGTGCCACCAGTGATTATGACCCCAGCTTTGGCAATGAGCAGTTCTTC	CATSDYDPSFGNEQFF	TRBV24-1	TRBJ2-1
TGTGCCAGCAGCCAGGGACAGGGGAGCGTCACGGATACGCAGTATTTT	CASSQGQGSVTDTQYF	TRBV3-1	TRBJ2-3
TGCAGTGCTAGAGGAATACAGACTGAAGCTTTCTTT	CSARGIQTEAFF	TRBV20-1	TRBJ1-1
TGTGCCAGCAGCTTGCCACTCCAGGGGGGCACCACTGGGGCCAACGTCCTGACTTTC	CASSLPLQGGTTGANVLTF	TRBV5-8	TRBJ2-6
TGTGCCAGCAGTGACAGATACGAGCAGTACTTC	CASSDRYEQYF	TRBV6-1	TRBJ2-7
TGTGCCAGCAGCTATTGGGGACGCAATCAGCCCCAGCATTTT	CASSYWGRNQPQHF	TRBV13	TRBJ1-5
TGCGCCAGCAGCTCCGGGACAGGGGCTCAGCCCCAGCATTTT	CASSSGTGAQPQHF	TRBV5-1	TRBJ1-5
TGTGCCAGCAGCTTAGCCTCGACAGGGGTCGTGGGCCATCAGCCCCAGCATTTT	CASSLASTGVVGHQPQHF	TRBV7-4	TRBJ1-5
TGTGCCCTTGGGACTTGGGAAGATACGCAGTATTTT	CALGTWEDTQYF	TRBV5-5	TRBJ2-3
TGTGCCAGGGGCCGACAGGGTGCACAGCCCCAGCATTTT	CARGRQGAQPQHF	TRBV6-6	TRBJ1-5
TGTGCCAGCAGCCCGCATTCAGTAATCTCCTACAATGAGCAGTTCTTC	CASSPHSVISYNEQFF	TRBV7-4	TRBJ2-1
TGTGCCAGCAGCTTTCACCCGGACCACGAGCAGTACTTC	CASSFHPDHEQYF	TRBV7-3	TRBJ2-7
TGTGCCAGCAGCGACATCGATCCCACCCCAAGAGTGAAAGAGGGCTACACCTTC	CASSDIDPTPRVKEGYTF	TRBV13	TRBJ1-2
TGTGCCAGCAGCCCTCTCGGGGGACTAGGCAACGTGGGGTACGAGCAGTACTTC	CASSPLGGLGNVGYEQYF	TRBV6-5	TRBJ2-7
TGTGCCCGGCTCAAGACGTACGTGGGGTACGAGCAGTACTTC	CARLKTYVGYEQYF	TRBV6-2	TRBJ2-7
TGTGCCAGCAGTGACCCCTCCGGGACAGGGGACCGCCCCATGAACACTGAAGCTTTCTTT	CASSDPSGTGDRPMNTEAFF	TRBV6-4	TRBJ1-1
TGTGCCAGCAGCCTACCGGGACAGGGGAGCACAGATACGCAGTATTTT	CASSLPGQGSTDTQYF	TRBV7-3	TRBJ2-3
TGCGCCAGCAGCAGTTTGGCCTCAAGAAATGATACGCAGTATTTT	CASSSLASRNDTQYF	TRBV4-1	TRBJ2-3
TGTGCCAGCAGCTTACCGTCCTCTAGCGAGACCCAGTACTTC	CASSLPSSSETQYF	TRBV7-3	TRBJ2-5
TGCATTATCCCCGGACAGGGGGGGGGGTATAATTCACCCCTCCACTTT	CIIPGQGGGYNSPLHF	TRBV20-1	TRBJ1-6
TGCGCCAGCAGCTTGGGTTGGGGACAGGGAAAGACCCAGTACTTC	CASSLGWGQGKTQYF	TRBV5-1	TRBJ2-5
TGTGCCACGACTAGCGGGGAGACCCAGTACTTC	CATTSGETQYF	TRBV19	TRBJ2-5
TGCAGTGCTCACTTAGGGGAGTTCCCCAATGAAAAACTGTTTTTT	CSAHLGEFPNEKLFF	TRBV20-1	TRBJ1-4
TGCAGTGCCGCAACAGGGGGCCGATCCAGGTACGAGCAGTACTTC	CSAATGGRSRYEQYF	TRBV20-1	TRBJ2-7
TGTGCCACCAGTGATTTGCCGGCGGGAGGTTCTACCCCATCCTACAATGAGCAGTTCTTC	CATSDLPAGGSTPSYNEQFF	TRBV24-1	TRBJ2-1
TGTGCCAGCAGCTTTCGGGCCAGGATGCACTATGGCTACACCTTC	CASSFRARMHYGYTF	TRBV5-5	TRBJ1-2
TGTGCCAGCAGTGCCGGGGCTGGAGGTTTTCAGCCCCAGCATTTT	CASSAGAGGFQPQHF	TRBV12-4	TRBJ1-5
TGCGCCAGCAGCTGCCCGGGACGCCCCTATGGCTACACCTTC	CASSCPGRPYGYTF	TRBV5-1	TRBJ1-2
TGTGCCAGCAGCCCCCCCGACGGGGGGGCCTACGAGCAGTACTTC	CASSPPDGGAYEQYF	TRBV13	TRBJ2-7
TGCAGCGTTGCTAGTACGTCAAAGGGGGGGGAGAATAGGCTAGCCAAAAACATTCAGTACTTC	CSVASTSKGGENRLAKNIQYF	TRBV29-1	TRBJ2-4
TGTGCCAGCAGCATTTTAAGGAGCAATCAGCCCCAGCATTTT	CASSILRSNQPQHF	TRBV7-3	TRBJ1-5
TGTGCCAGAAGGGACAGGGTTTTTGTTGAAAAACTGTTTTTT	CARRDRVFVEKLFF	TRBV19	TRBJ1-4
TGTGCCAGCAGCTGTACACTAGCGGGAGGGGGGAAGTACAATGAGCAGTTCTTC	CASSCTLAGGGKYNEQFF	TRBV7-2	TRBJ2-1
TGTGCCAGCATCGGGGACAGGGAAGGTAGCAATCAGCCCCAGCATTTT	CASIGDREGSNQPQHF	TRBV5-6	TRBJ1-5
TGTGCCAGCTCCAGCTATCCGGTTAGAGAGACCCAGTACTTC	CASSSYPVRETQYF	TRBV7-9	TRBJ2-5
TGTGCCAGCAGCAAATGGGCCAGACAGGGGGGCACCGGGGAGCTGTTTTTT	CASSKWARQGGTGELFF	TRBV5-8	TRBJ2-2
TGCAGGACTTCCTACGAGCAGTACTTC	CRTSYEQYF	TRBV20-1	TRBJ2-7
TGCGCCAGGTCAGGGGACTTCTACAATGAGCAGTTCTTC	CARSGDFYNEQFF	TRBV10-1	TRBJ2-1
TGTGCCAGCAGCTGTCTCCACCTCGTTCTCTACGAGCAGTACTTC	CASSCLHLVLYEQYF	TRBV5-5	TRBJ2-7
TGTGCCAGCAGTGGAGGGACTGAAGCTTTCTTT	CASSGGTEAFF	TRBV2	TRBJ1-1
TGTGCCAGCAGTTTCAGGGTTAGAGCTAATTCACCCCTCCACTTT	CASSFRVRANSPLHF	TRBV28	TRBJ1-6
TGCAGTGCTAGAGATTGCCTGGCCTGGGGGACTAGCGGGATCGACTTAGGCTACGAGCAGTACTTC	CSARDCLAWGTSGIDLGYEQYF	TRBV20-1	TRBJ2-7
TGTGCCTGGACCGACTCCCAAGAGACCCAGTACTTC	CAWTDSQETQYF	TRBV30	TRBJ2-5
TGCGCCAGCAGCTATGCCGGGATAGTGAACAATGAGCAGTTCTTC	CASSYAGIVNNEQFF	TRBV5-1	TRBJ2-1
TGTGCCAGCAGTTCAGTAAATCACTTTAAGGTTACCAGGGGGAAGGTGAACACTGAAGCTTTCTTT	CASSSVNHFKVTRGKVNTEAFF	TRBV27	TRBJ1-1
TGTGCCAGCAGCCCCCCCGGGGAGGCAGGCCCCTACGAGCAGTACTTC	CASSPPGEAGPYEQYF	TRBV3-1	TRBJ2-7
TGTGCCAGCAGCCAAGAAATTGGGACAACTCGGGAGACCGGGGAGCTGTTTTTT	CASSQEIGTTRETGELFF	TRBV3-1	TRBJ2-2
TGTGCCAGCAGCAAGCGGACAGGACTACAGGTCACAGATACGCAGTATTTT	CASSKRTGLQVTDTQYF	TRBV7-3	TRBJ2-3
TGCAGTGCTAGAGTTGAAATAGGGGGGCCCGTTAGCAATCAGCCCCAGCATTTT	CSARVEIGGPVSNQPQHF	TRBV20-1	TRBJ1-5
TGTGCCAGCCCTAGCGGGACCGACGAGCAGTACTTC	CASPSGTDEQYF	TRBV6-5	TRBJ2-7
TGTGCCAGCAGCCGATCTAGCGGGGGGCTTGAGGATCTAGTCAGTGAATCCTACAATGAGCAGTTCTTC	CASSRSSGGLEDLVSESYNEQFF	TRBV7-9	TRBJ2-1
TGCGCCAGCAGCCCTAGCACAGATACGCAGTATTTT	CASSPSTDTQYF	TRBV5-1	TRBJ2-3
TGTGCCAGCAGCTTAGATCCCCGGGACAGGACCTCCTACGAGCAGTACTTC	CASSLDPRDRTSYEQYF	TRBV11-2	TRBJ2-7
TGTGCCAGCAGCGCCCGCCCGACCTGCAACACTGAAGCTTTCTTT	CASSARPTCNTEAFF	TRBV13	TRBJ1-1
TGCAGTGCTAGAGTCGAAACCCAGGACAGCTCCTACAATGAGCAGTTCTTC	CSARVETQDSSYNEQFF	TRBV20-1	TRBJ2-1
TGTGCCAGCAGCTTCTTCAGGGCATTCTACGAGCAGTACTTC	CASSFFRAFYEQYF	TRBV11-3	TRBJ2-7
TGTGCCAGCAGCCAAGCGGGGGGGATGGACACCATATATTTT	CASSQAGGMDTIYF	TRBV4-2	TRBJ1-3
TGTGCCAGTAGTATAGATACGGGGGCCGGTAGGGGAAACTACGAGCAGTACTTC	CASSIDTGAGRGNYEQYF	TRBV19	TRBJ2-7
TGCAGTGCTAGATACAAGGGGGACAGGGCGTACGAGCAGTACTTC	CSARYKGDRAYEQYF	TRBV20-1	TRBJ2-7
TGTGCCAGCAGCGCCAGGGACAGGGCGGGTCTCATAAATGAGCAGTTCTTC	CASSARDRAGLINEQFF	TRBV5-6	TRBJ2-1
TGTGCCAGCAGCGGCAACACTGAAGCTTTCTTT	CASSGNTEAFF	TRBV7-6	TRBJ1-1
TGTGCCAGCAGCTTAGTCCAGTCCCCGCAGGGGCGCTATGGCTACACCTTC	CASSLVQSPQGRYGYTF	TRBV7-9	TRBJ1-2
TGTGCCATCAGTGAGCCTGGGGGCGGGGAGCTGTTTTTT	CAISEPGGGELFF	TRBV10-3	TRBJ2-2
TGTGCCCGCAGCAGCTTGCCAATCGAGGATTGGGACACAGATACGCAGTATTTT	CARSSLPIEDWDTDTQYF	TRBV11-3	TRBJ2-3
TGTGCCAGCAGCTTATACGGGACTAGCGGCGATCGGACAGATACGCAGTATTTT	CASSLYGTSGDRTDTQYF	TRBV7-9	TRBJ2-3
TGTGCCAGCAGTTACTGGGCTTCCTACGAGCAGTACTTC	CASSYWASYEQYF	TRBV6-2	TRBJ2-7
TGTGCCAGCAGCGTAGTAACGAGACACGAGCAGTACTTC	CASSVVTRHEQYF	TRBV9	TRBJ2-7
TGTGCCACCAGTGACGCCAGTTCGGAAGAGACCCAGTACTTC	CATSDASSEETQYF	TRBV24-1	TRBJ2-5
TGTGCCAGCAGTGACCTACACGTGGCGGGGCGAGAGACCCAGTACTTC	CASSDLHVAGRETQYF	TRBV6-4	TRBJ2-5
TGTGCCAGCAGTTTAACAGGGTTCTCTGGAAACACCATATATTTT	CASSLTGFSGNTIYF	TRBV28	TRBJ1-3
TGTGCCAGCAGCTTACAGGGTGCTTTCTTT	CASSLQGAFF	TRBV11-3	TRBJ1-1
TGTGCCACCAGTGATGGACCCCGGCAAAAGTATTTT	CATSDGPRQKYF	TRBV24-1	TRBJ2-3
TGTGCCAGCAGCTTAGATCTGTTGACAGGGGCCACCGGGGAGCTGTTTTTT	CASSLDLLTGATGELFF	TRBV7-3	TRBJ2-2
TGTGCCACCTTCAGGACTGCAACTAATGAAAAACTGTTTTTT	CATFRTATNEKLFF	TRBV12-3	TRBJ1-4
TGTGCCAGCAGTGGTCCGGGACTAGTTGAGGCGGCCCCCTACAATGAGCAGTTCTTC	CASSGPGLVEAAPYNEQFF	TRBV6-5	TRBJ2-1
TGTGCCAGCAAGACGAAGGATACGCAGTATTTT	CASKTKDTQYF	TRBV2	TRBJ2-3
TGTGCCAGCAGTGACTCTGCGTCTCCCGGGACAACGTGTAGCACAGATACGCAGTATTTT	CASSDSASPGTTCSTDTQYF	TRBV6-4	TRBJ2-3
TGTGCCACCAGTGAAGGGAACAGGGAGATTAAAAGCTCCTATAATTCACCCCTCCACTTT	CATSEGNREIKSSYNSPLHF	TRBV24-1	TRBJ1-6
TGTGCCTGGGCCCGACAGGGTGGCTACACCTTC	CAWARQGGYTF	TRBV30	TRBJ1-2
TGCAGTGCTAGGAAAAGGGGTTATTTT	CSARKRGYF	TRBV20-1	TRBJ1-3
TGCGCCAGCAGTGAGTCTCATCGCAGCAGGGGGCAGCCCCAGCATTTT	CASSESHRSRGQPQHF	TRBV10-1	TRBJ1-5
TGTGCCTGGAGTGTACGAGAGCGCCGGAGTGATGAGACCCAGTACTTC	CAWSVRERRSDETQYF	TRBV30	TRBJ2-5
TGTGCCAGTAATTCGGTGGGGAGACAGCCCCAGCATTTT	CASNSVGRQPQHF	TRBV19	TRBJ1-5
TGTGCCAGCAGCTTAGCGAGAAATCCGGGGCGCACAGATACGCAGTATTTT	CASSLARNPGRTDTQYF	TRBV7-2	TRBJ2-3
TGTGCCTGCACCGGGGGCAAACCCCTTAATGAAAAACTGTTTTTT	CACTGGKPLNEKLFF	TRBV27	TRBJ1-4
TGTGCCAGCAGTGGTGCAAGCCCCCAGAATTCAGATACGCAGTATTTT	CASSGASPQNSDTQYF	TRBV12-4	TRBJ2-3
TGCGCCAGCAGCGTCCGGTTTGCGACAGGTCGCTATAATTCACCCCTCCACTTT	CASSVRFATGRYNSPLHF	TRBV5-1	TRBJ1-6
TGTGCCAGCAGTAGCATATATGGCTACACCTTC	CASSSIYGYTF	TRBV6-5	TRBJ1-2
TGTGCCAGCGCTAGCGGGAGCTACGAGCAGTACTTC	CASASGSYEQYF	TRBV6-3	TRBJ2-7
TGTGCCAGCAGTTTACTGGGGCCCTCATACGGGGAGCTGTTTTTT	CASSLLGPSYGELFF	TRBV12-4	TRBJ2-2
TGTGCCAGTAGTGTTGGGCTTTACAATGAGCAGTTCTTC	CASSVGLYNEQFF	TRBV19	TRBJ2-1
TGTGCCAGCCCAACACGGTACACTGAAGCTTTCTTT	CASPTRYTEAFF	TRBV27	TRBJ1-1
TGCGCCAGCAGGCCCCTCCCGAACACCGGGGAGCTGTTTTTT	CASRPLPNTGELFF	TRBV5-1	TRBJ2-2
TGCGCCAGCAGCCAAGCTCAATCCAGGAGAGGGACCGGGGAGCTGTTTTTT	CASSQAQSRRGTGELFF	TRBV4-1	TRBJ2-2
TGCGCCAGCCCTCGGGAATGGAATCAGCCCCAGCATTTT	CASPREWNQPQHF	TRBV10-1	TRBJ1-5
TGCGCCAGCAGCCAAGATCGCGATGGTGAGCAGTTCTTC	CASSQDRDGEQFF	TRBV4-1	TRBJ2-1
TGTGCCAAGGACAGAGACACAGATACGCAGTATTTT	CAKDRDTDTQYF	TRBV15	TRBJ2-3
TGTGCCAGCAGCTTTACCCCCGGCCGGGACACCGGGGAGCTGTTTTTT	CASSFTPGRDTGELFF	TRBV7-3	TRBJ2-2
TGTGCCACCAGTAACTCCAGGCGACTGGGGGAGCTGTTTTTT	CATSNSRRLGELFF	TRBV24-1	TRBJ2-2
TGCGCCAGACAGGGGGAGGACAAGTTAGCTAACTATGGCTACACCTTC	CARQGEDKLANYGYTF	TRBV5-1	TRBJ1-2
TGTGCCAGCAGCCAATCCCCCGGACAGGACCGGCGCAGCACTGAAGCTTTCTTT	CASSQSPGQDRRSTEAFF	TRBV3-1	TRBJ1-1
TGTGAGCGAATAAGAACCAGGGCGGCCCAGAACACTGAAGCTTTCTTT	CERIRTRAAQNTEAFF	TRBV12-3	TRBJ1-1
TGTGCCAGCACAGGGGGACCAGGGGGGGGGAACACTGAAGCTTTCTTT	CASTGGPGGGNTEAFF	TRBV2	TRBJ1-1
TGTGCTAGTGGTTTCCCCCGGACAGCCCCCCGTGACACCGGGGAGCTGTTTTTT	CASGFPRTAPRDTGELFF	TRBV12-5	TRBJ2-2
TGTGCCAGCAAACTAGCGGGGGGAAGCTCCTACAATGAGCAGTTCTTC	CASKLAGGSSYNEQFF	TRBV28	TRBJ2-1
TGCAGTGCTAGAGTAAAACCAGGGTCCACTAGCGGGAGAGCCAAAAACATTCAGTACTTC	CSARVKPGSTSGRAKNIQYF	TRBV20-1	TRBJ2-4
TGTGCCAACCGCAGGGGGCGATTCTCTGAAGCTTTCTTT	CANRRGRFSEAFF	TRBV28	TRBJ1-1
TGCGCCAGCCGGTGCCAATTGTTTCCCCTTTTAGGGGGGGAGACCCAGTACTTC	CASRCQLFPLLGGETQYF	TRBV10-1	TRBJ2-5
TGTGCCAGCAGTTACCCTAGGGACGGGGTCAATTCACCCCTCCACTTT	CASSYPRDGVNSPLHF	TRBV6-2	TRBJ1-6
TGTGCCAGCTCAGCCGACCCAGGGGGCCTAGGCTCTGGGGCCAACGTCCTGACTTTC	CASSADPGGLGSGANVLTF	TRBV18	TRBJ2-6
TGTGCCAGCAGCCCACCGCAGAACTGGGGCCCCTACGAGCAGTACTTC	CASSPPQNWGPYEQYF	TRBV3-1	TRBJ2-7
TGTGCCACCAGCAGAGCCCACAGGGGTGTTGGTCAGCCCCAGCATTTT	CATSRAHRGVGQPQHF	TRBV15	TRBJ1-5
TGTGCCAGCAGCTCGGTCCACCTTACGCCCCTCTTC	CASSSVHLTPLF	TRBV5-5	TRBJ2-1
TGTGCCAGCAGCTTAGGAAGTGACCTAGACCTCTACGAGCAGTACTTC	CASSLGSDLDLYEQYF	TRBV7-3	TRBJ2-7
TGTGCCAGCAGAGACGTCCGGGGACTGGGGGGGAGCTCCTACGAGCAGTACTTC	CASRDVRGLGGSSYEQYF	TRBV9	TRBJ2-7
TGTGCCAGCAGGGTCGGACTAGCGGCGGGCAATGAGCAGTTCTTC	CASRVGLAAGNEQFF	TRBV14	TRBJ2-1
TGTGCCAGCAAAGGGGAACAAACGGATGAGACCCAGTACTTC	CASKGEQTDETQYF	TRBV6-2	TRBJ2-5
TGTGCCAGCAGCCAAGAGTTGACAGGCGGACCCTGTAATTCACCCCTCCACTTT	CASSQELTGGPCNSPLHF	TRBV3-1	TRBJ1-6
TGTGCCAGCAGGAGGGGATCGGGCAATCAGCCCCAGCATTTT	CASRRGSGNQPQHF	TRBV6-5	TRBJ1-5
TGTGCCAGCAGTTACTTCAAACAGGGGGAGAGCACCGGGGAGCTGTTTTTT	CASSYFKQGESTGELFF	TRBV6-5	TRBJ2-2
TGTGCCAGCTTGACAGGGGCGAAAGAAGCTTTCTTT	CASLTGAKEAFF	TRBV7-3	TRBJ1-1
TGTGCCTGGACTGGGAATGAGCAGTTCTTC	CAWTGNEQFF	TRBV30	TRBJ2-1
TGTGCCAGCAGCCAAGGGGATCGACTAGGAGCTAGCACAGATACGCAGTATTTT	CASSQGDRLGASTDTQYF	TRBV3-1	TRBJ2-3
TGTGCCATCAATAGCGGGGTGACGGAGAACACCGGGGAGCTGTTTTTT	CAINSGVTENTGELFF	TRBV10-3	TRBJ2-2
TGTGCCAGCAAGGGGGGGAAGTATAATTCACCCCTCCACTTT	CASKGGKYNSPLHF	TRBV6-1	TRBJ1-6
TGTGCCAGTAGTATGTCGGAGAGGACTAGCGGGGGGGCCTTATCCACAGATACGCAGTATTTT	CASSMSERTSGGALSTDTQYF	TRBV19	TRBJ2-3
TGTGCCAGCACAAGGGGGCAGCCCCCTGAGCAGTTCTTC	CASTRGQPPEQFF	TRBV27	TRBJ2-1
TGTGCCAGCAGCTTATATGTAAGGAAGGAGCAGTACTTC	CASSLYVRKEQYF	TRBV7-8	TRBJ2-7
TGCAGTGCTGGAGCTCTAAAGACAGGTAGTTCACCCCTCCACTTT	CSAGALKTGSSPLHF	TRBV20-1	TRBJ1-6
TGCGCCAGCAGCGGGTCGAGGGAGAACAGAGAGCAGTACTTC	CASSGSRENREQYF	TRBV5-1	TRBJ2-7
TGTGCCAGCAGCTTAGGCGGCGGGACAGGGCAAACCTATTTT	CASSLGGGTGQTYF	TRBV7-3	TRBJ1-3
TGTGCCAGCAGCCGGGGGGCAACTAATGAAAAACTGTTTTTT	CASSRGATNEKLFF	TRBV13	TRBJ1-4
TGCACCCACCCAGGGGTCCGGGTGAACACCGGGGAGCTGTTTTTT	CTHPGVRVNTGELFF	TRBV20-1	TRBJ2-2
TGTGCCAGCCCGACAGACAGGGCCATCGAGCAGTACTTC	CASPTDRAIEQYF	TRBV6-2	TRBJ2-7
TGTGCCAGCAGCTTGTCGAGGCAGGGAGAGACCCAGTACTTC	CASSLSRQGETQYF	TRBV5-6	TRBJ2-5
TGTGCCGGGGAAGAAAGAGGGCCTAATGAGCAGTTCTTC	CAGEERGPNEQFF	TRBV28	TRBJ2-1
TGTGCCAGCAGCCAAGATAGCGACGAGCAGTACTTC	CASSQDSDEQYF	TRBV4-2	TRBJ2-7
TGTGCCAGCAGTGAGCGACAGGAGGTTGGTCAGAATGCAACTAATGAAAAACTGTTTTTT	CASSERQEVGQNATNEKLFF	TRBV6-3	TRBJ1-4
TGTGCCAGCAGCCCCCCCCGACATATATATAGCAATCAGCCCCAGCATTTT	CASSPPRHIYSNQPQHF	TRBV28	TRBJ1-5
TGCGCCAGCAGTGTGGTCAGTCCAAAGGGGGGGGAGGTAGATACGCAGTATTTT	CASSVVSPKGGEVDTQYF	TRBV10-1	TRBJ2-3
TGCAGTGCTAGCCCTGAGACCCAGTACTTC	CSASPETQYF	TRBV20-1	TRBJ2-5
TGCGCCAGCATAGCGGGGTCTGATGAGCAGTTCTTC	CASIAGSDEQFF	TRBV10-1	TRBJ2-1
TGTGCCAGCAGCGGAGCCCCATATGCCGGGGGGGCCGGGGCTGCCGGGGAGCTGTTTTTT	CASSGAPYAGGAGAAGELFF	TRBV9	TRBJ2-2
TGTGCCAGCAGCCACACCCCAGATCGGGGGGGCGCCCAAGAGACCCAGTACTTC	CASSHTPDRGGAQETQYF	TRBV3-1	TRBJ2-5
TGTGCCAGGGACCTCCTTCACGGCGATCTCTCTGGGGCCAACGTCCTGACTTTC	CARDLLHGDLSGANVLTF	TRBV19	TRBJ2-6
TGTGCCAGGACCCCCTGGACAGGGGTCACCGGGGAGCTGTTTTTT	CARTPWTGVTGELFF	TRBV9	TRBJ2-2
TGTGCCAGCAGCGAGGGAGAGACCACAGATACGCAGTATTTT	CASSEGETTDTQYF	TRBV7-9	TRBJ2-3
TGTGCCAGCAGTGATCCGGGGCCCGAGAGGCCTTCCTACAATGAGCAGTTCTTC	CASSDPGPERPSYNEQFF	TRBV6-1	TRBJ2-1
TGTGCCAGCAGCGACAGGGATTGTGAAAAACTGTTTTTT	CASSDRDCEKLFF	TRBV2	TRBJ1-4
TGTGCCAGCGGGTGTACTGTACGGGGAAGCCAAGAGACCCAGTACTTC	CASGCTVRGSQETQYF	TRBV12-4	TRBJ2-5
TGTGCCAGCAGCTTAGGGCGAAAACCTAACTATGGCTACACCTTC	CASSLGRKPNYGYTF	TRBV7-8	TRBJ1-2
TGCGCCAGCCCGTCAGGGCGAGGCTACGAGCAGTACTTC	CASPSGRGYEQYF	TRBV4-1	TRBJ2-7
TGTGCCAGCCCCCCCCTTACTAGCGGGAGGGGGGGTGAGCAGTACTTC	CASPPLTSGRGGEQYF	TRBV2	TRBJ2-7
TGTGCCAGCAGCTTAAACAGCTCTACGTACGAGCAGTACTTC	CASSLNSSTYEQYF	TRBV7-3	TRBJ2-7
TGTGCCACCTGCGTAAAGGAAGCTTTCTTT	CATCVKEAFF	TRBV19	TRBJ1-1
TGTGCCAGCAGCTTAACGTCGGGACAGGTACCAGATACGCAGTATTTT	CASSLTSGQVPDTQYF	TRBV11-3	TRBJ2-3
TGTGCCAGCAGGAAACAATTGTCCCGGGACAGGGAGGGCTCCTACGAGCAGTACTTC	CASRKQLSRDREGSYEQYF	TRBV11-3	TRBJ2-7
TGTGCCAGCAGCCACCCGGCCGAGCAGTACTTC	CASSHPAEQYF	TRBV11-3	TRBJ2-7
TGTGCCACAGACACCTTAGCGGATGAGCAGTTCTTC	CATDTLADEQFF	TRBV24-1	TRBJ2-1
TGTGCCTGGAGTGTACAAAAGGACCCCAATCAGCCCCAGCATTTT	CAWSVQKDPNQPQHF	TRBV30	TRBJ1-5
TGTGCCAGCAGCGTGGCGTGGAGGGCTAACTATGGCTACACCTTC	CASSVAWRANYGYTF	TRBV7-3	TRBJ1-2
TGTGCCAGCAGCTTACTACGACTTCCATCAGGGGGATCCTACGAGCAGTACTTC	CASSLLRLPSGGSYEQYF	TRBV7-3	TRBJ2-7
TGTGCCAGCAGTTTCCGTCCGCGACACACCCCCTACGAGCAGTACTTC	CASSFRPRHTPYEQYF	TRBV12-3	TRBJ2-7
TGTGCCAGCAGTTGGGCAGAAAGTACCGGGGAGCTGTTTTTT	CASSWAESTGELFF	TRBV12-4	TRBJ2-2
TGTGCCAGCAGCCAAGATGACGGCGAGGGCGATCCGCGCAATCAGCCCCAGCATTTT	CASSQDDGEGDPRNQPQHF	TRBV14	TRBJ1-5
TGTGCCAGTAGTATAGTGCCCGTAAGCGTAACCACAGATACGCAGTATTTT	CASSIVPVSVTTDTQYF	TRBV19	TRBJ2-3
TGTGCCAGCAGCGGGGACAGACGGGCTTTCTTT	CASSGDRRAFF	TRBV13	TRBJ1-1
TGTGCCAGCAGCCGCCTCGTAGACGTTTTTCTAGCCAAAAACATTCAGTACTTC	CASSRLVDVFLAKNIQYF	TRBV14	TRBJ2-4
TGTGCCAGCAGGGGGACGCGGTGGAGCTCCTACGAGCAGTACTTC	CASRGTRWSSYEQYF	TRBV6-6	TRBJ2-7
TGTGCCAGCAGCGGGACTAGCGGGGAAAATGAGCAGTTCTTC	CASSGTSGENEQFF	TRBV9	TRBJ2-1
TGTGCCAGCACAGGGGGCCAGGCCGGGGAGCTGTTTTTT	CASTGGQAGELFF	TRBV6-5	TRBJ2-2
TGTGCCAGCGACAGCTTGTCACCCCTCCACTTT	CASDSLSPLHF	TRBV7-3	TRBJ1-6
TGTGCCAGCAAAGGGGCCGGGTTACGCGTGGGGGCCAACGTCCTGACTTTC	CASKGAGLRVGANVLTF	TRBV27	TRBJ2-6
TGTGCCACAACTGATCGTTTTAGGCCTGAGCAGTTCTTC	CATTDRFRPEQFF	TRBV6-5	TRBJ2-1
TGTGCCAGCAGGAATAGCGCCAATGAGCAGTTCTTC	CASRNSANEQFF	TRBV5-6	TRBJ2-1
TGTGCCATTACCCCGAGGGTGCGATTGTTTGGCGCTGAAGCTTTCTTT	CAITPRVRLFGAEAFF	TRBV7-3	TRBJ1-1
TGTGCCACCAGCCCTATAGGGGCCTATGGCTACACCTTC	CATSPIGAYGYTF	TRBV24-1	TRBJ1-2
TGTGCCAGCAGCGTGCCGGGACAGGGGCCTGGGAATTCACCCCTCCACTTT	CASSVPGQGPGNSPLHF	TRBV3-1	TRBJ1-6
TGTGCCAGCAGCGGACAACGGGGGCTGTATGGCTACACCTTC	CASSGQRGLYGYTF	TRBV13	TRBJ1-2
TGTGCCAGCAGCCGTCGAGAGGACACCGGGGAGCTGTTTTTT	CASSRREDTGELFF	TRBV14	TRBJ2-2
TGCAGCCGGGACATCTATAATTCACCCCTCCACTTT	CSRDIYNSPLHF	TRBV20-1	TRBJ1-6
TGTGCCAGCAGTTTATTTAGTGGGCCCGGTTGCACAGATACGCAGTATTTT	CASSLFSGPGCTDTQYF	TRBV28	TRBJ2-3
TGTGCCAGCAGTTGGGCAGACACTGAAGCTTTCTTT	CASSWADTEAFF	TRBV27	TRBJ1-1
TGTGCCAGTAGTATAGAGGGGGGGGTTAGGTATGGCTACACCTTC	CASSIEGGVRYGYTF	TRBV19	TRBJ1-2
TGCAGCGTTGAAGATTCGGGAACACAGGGAGATACGCAGTATTTT	CSVEDSGTQGDTQYF	TRBV29-1	TRBJ2-3
TGTGCCAGCGCGGCGCCAACGGGCTACACCTTC	CASAAPTGYTF	TRBV6-6	TRBJ1-2
TGTGCCACCCTGGGACAGGGGGGGAACACTGAAGCTTTCTTT	CATLGQGGNTEAFF	TRBV7-7	TRBJ1-1
TGTGCCAGCAGGGTGCGCTCGGGGGAAAAACTGTTTTTT	CASRVRSGEKLFF	TRBV13	TRBJ1-4
TGCAGTGCTAGACCCCGCGGGAGCGGAGAGACCCAGTACTTC	CSARPRGSGETQYF	TRBV20-1	TRBJ2-5
TGTGCCAGCAGTTACAACATTCGGCGGGAGGGTAGAAACTATGGCTACACCTTC	CASSYNIRREGRNYGYTF	TRBV6-6	TRBJ1-2
TGTGCCACCAGTGATTTCGCTAAGAGCATTGGAAACACCATATATTTT	CATSDFAKSIGNTIYF	TRBV24-1	TRBJ1-3
TGTGCCAGCAGCTTAGATCCGGGTAAGGGAAACACCATATATTTT	CASSLDPGKGNTIYF	TRBV7-9	TRBJ1-3
TGTGCCACCAGTGATGGTCCGGGACTAGGCCTCTATGGCTACACCTTC	CATSDGPGLGLYGYTF	TRBV24-1	TRBJ1-2
TGTGCCAGCACCACCAACATCAGGGGGAATGAAAAACTGTTTTTT	CASTTNIRGNEKLFF	TRBV27	TRBJ1-4
TGTGCCAGCAGCTTATTCAACTGGACAGGGCCGGGGTTGGTAAGAAATTCACCCCTCCACTTT	CASSLFNWTGPGLVRNSPLHF	TRBV11-2	TRBJ1-6
TGTGCCAGCTCACCCATCACTAGCGGGGAGCTGTTTTTT	CASSPITSGELFF	TRBV18	TRBJ2-2
TGTGCCAGCAGGGGGGTAAAGGCCGGGGAGCTGTTTTTT	CASRGVKAGELFF	TRBV5-4	TRBJ2-2
TGTGCCAGCAGCTTGCCGGGACACGAGCAGTACTTC	CASSLPGHEQYF	TRBV7-2	TRBJ2-7
TGTGCCAGCAGCTTGGTGGGGGACGAGCAGTACTTC	CASSLVGDEQYF	TRBV5-6	TRBJ2-7
TGCGCCAGCAGGTGTTATGGCTACACCTTC	CASRCYGYTF	TRBV4-1	TRBJ1-2
TGTGCCAGCCTAGCGGGGAGAACCAACAATGAGCAGTTCTTC	CASLAGRTNNEQFF	TRBV25-1	TRBJ2-1
TGCGCCAGCAGCCAAGCTAGGGGGCGGAACACTGAAGCTTTCTTT	CASSQARGRNTEAFF	TRBV4-1	TRBJ1-1
TGTGCCTGGATCTTGGACAGGGGGGCACACACTGAAGCTTTCTTT	CAWILDRGAHTEAFF	TRBV30	TRBJ1-1
TGTGCCAGCAGTTACGGAGCAGGGTGGAACATTCAGTACTTC	CASSYGAGWNIQYF	TRBV6-2	TRBJ2-4
TGTGCCAGCAGCCCCGGGCCTGACTATGGCTACACCTTC	CASSPGPDYGYTF	TRBV7-2	TRBJ1-2
TGTGCCAGCAGCTTAACGGGGGTGGCTTTCTTT	CASSLTGVAFF	TRBV11-3	TRBJ1-1
TGCGCCAGCAGCCATGAGTGGGGAAGGCAAGAGCAGTTCTTC	CASSHEWGRQEQFF	TRBV4-3	TRBJ2-1
TGTGCCAGCAGTGAGGGTTCCGGGACAGGCTACGAGCAGTACTTC	CASSEGSGTGYEQYF	TRBV6-4	TRBJ2-7
TGCGCCAGCAGCAGACCCAAAGCATCTCCAGGGGGTCAGCCCCAGCATTTT	CASSRPKASPGGQPQHF	TRBV5-1	TRBJ1-5
TGTGCCAGCTCAGGGAAAATATCCTATAATTCACCCCTCCACTTT	CASSGKISYNSPLHF	TRBV7-7	TRBJ1-6
TGTGCCAGCAGTTGCCCCGAGCGGGGGGGTGAGCAGTTCTTC	CASSCPERGGEQFF	TRBV6-3	TRBJ2-1
TGCGCCAGCAGTGAGGACCCTCGGGAGGGGGTTAATCAGCCCCAGCATTTT	CASSEDPREGVNQPQHF	TRBV10-1	TRBJ1-5
TGTGCCAGCAGTGCCAACAGCCGCGATACGCAGTATTTT	CASSANSRDTQYF	TRBV28	TRBJ2-3
TGTGCCGACCGGCGGGGACTAGCGGGCCCCTACTCCTACGAGCAGTACTTC	CADRRGLAGPYSYEQYF	TRBV6-1	TRBJ2-7
TGTGCCACCAGTGCTGGGTACCGAGGGGCCTATAATTCACCCCTCCACTTT	CATSAGYRGAYNSPLHF	TRBV24-1	TRBJ1-6
TGTGCCAGCAGGGTCCTAGGGGGAGGCCTAGATACGCAGTATTTT	CASRVLGGGLDTQYF	TRBV14	TRBJ2-3
TGCGCCAGCAGGAGAGGTAGCTACACCGGGGAGCTGTTTTTT	CASRRGSYTGELFF	TRBV5-1	TRBJ2-2
TGTGCCAGCAGGGGGCCCCGGGGGATAATAGCCAAAAACATTCAGTACTTC	CASRGPRGIIAKNIQYF	TRBV6-1	TRBJ2-4
TGTGCCAGCAGCGTAGCGCAGGGGGCGCCCACTAACTATGGCTACACCTTC	CASSVAQGAPTNYGYTF	TRBV9	TRBJ1-2
TGTGCCAGCAGCCCTAGGGACAGGGGGCTAAGAAACACCATATATTTT	CASSPRDRGLRNTIYF	TRBV6-8	TRBJ1-3
TGTGCCAGCAGTGAAGCCAATAACGCTTCGATATACAATGAGCAGTTCTTC	CASSEANNASIYNEQFF	TRBV6-1	TRBJ2-1
TGTGCCAGCAGCCTCCCGGGCGGTGAGCAGTTCTTC	CASSLPGGEQFF	TRBV2	TRBJ2-1
TGTGCCAGCTCACCCAAGGAAGACAGCAATCAGCCCCAGCATTTT	CASSPKEDSNQPQHF	TRBV18	TRBJ1-5
TGCGCCAGCAGCACAGGGGCCTCCTATAATTCACCCCTCCACTTT	CASSTGASYNSPLHF	TRBV10-1	TRBJ1-6
TGTGCCAGCTCACCCTACCCGACAGCTCCGAGTGGCTACACCTTC	CASSPYPTAPSGYTF	TRBV18	TRBJ1-2
TGTGCCAGCAGCCAACCTTCGAAGCAGGACGAGCAGTACTTC	CASSQPSKQDEQYF	TRBV13	TRBJ2-7
TGCGCCACGCCAATCTCCAGGGGGCCCAATGAAAAACTGTTTTTT	CATPISRGPNEKLFF	TRBV10-1	TRBJ1-4
TGTGTACCGGGATCAACTAATGAAAAACTGTTTTTT	CVPGSTNEKLFF	TRBV19	TRBJ1-4
TGTGCCAGCAGCAAAAGTGACAGCGTCTCTAACTATGGCTACACCTTC	CASSKSDSVSNYGYTF	TRBV3-1	TRBJ1-2
TGCAGTGCTAGAGAGGCAGGGGTAGGCAATGAGCAGTTCTTC	CSAREAGVGNEQFF	TRBV20-1	TRBJ2-1
TGTGCCAGCAGCGTACCGAGGAGGACCCAGTACTTC	CASSVPRRTQYF	TRBV9	TRBJ2-5
TGTGCCAGCCCCGGCTATGAAAACCCCTATCGGGGGGGGTACCAAGAGACCCAGTACTTC	CASPGYENPYRGGYQETQYF	TRBV6-2	TRBJ2-5
TGTGCCAGCAGCCGAGACCTAAACCAAGAGACCCAGTACTTC	CASSRDLNQETQYF	TRBV7-3	TRBJ2-5
TGTGCCAGCAGTTATAACGGGGGTAGCTCCTACAATGAGCAGTTCTTC	CASSYNGGSSYNEQFF	TRBV6-1	TRBJ2-1
TGTGCCAGCACTTCCGCCCAGGAAGATAGCAATCAGCCCCAGCATTTT	CASTSAQEDSNQPQHF	TRBV27	TRBJ1-5
TGCGCCAGCAGCTGTAAAGCAGTTAACTATGGCTACACCTTC	CASSCKAVNYGYTF	TRBV5-1	TRBJ1-2
TGTGCCACCAGTCGGGGACACGGGCATGAGCAGTTCTTC	CATSRGHGHEQFF	TRBV24-1	TRBJ2-1
TGTGCCAGCAGCACAGGGTCGGAAAAACTGTTTTTT	CASSTGSEKLFF	TRBV13	TRBJ1-4
TGTGCCAGCAGTGCCGAAGAATTCCGACACCGGCGAACGCAGTACTTC	CASSAEEFRHRRTQYF	TRBV6-1	TRBJ2-5
TGTGCCAGCAGCCCAACTGAAAGGGGGGACGGAACGAACACCGGGGAGCTGTTTTTT	CASSPTERGDGTNTGELFF	TRBV6-1	TRBJ2-2
TGCAGTGCTAGAGGGACAGGTGACTATGGCTACACCTTC	CSARGTGDYGYTF	TRBV20-1	TRBJ1-2
TGTGCCAGCACTTTTGATGGCTACACCTTC	CASTFDGYTF	TRBV11-3	TRBJ1-2
TGTGCCAGCAGTTTCTCGGGGGGCGCCTACAATGAGCAGTTCTTC	CASSFSGGAYNEQFF	TRBV12-4	TRBJ2-1
TGCGCCAGCAGTGAGACTCCGGCTAGCGAAGAGACCCAGTACTTC	CASSETPASEETQYF	TRBV10-1	TRBJ2-5
TGCGCCAGCAGTGTTTCAAAACAGGGCTTTGAATACAATGAGCAGTTCTTC	CASSVSKQGFEYNEQFF	TRBV10-1	TRBJ2-1
TGCGCCAGTGAACAGCGTTGCGGTTACGAGCAGTACTTC	CASEQRCGYEQYF	TRBV5-1	TRBJ2-7
TGCGCCAGCACCGGCATCTACGAGCAGTACTTC	CASTGIYEQYF	TRBV10-1	TRBJ2-7
TGTGCCAGCAATAGCCGACAGAAAGAAAAACTGTTTTTT	CASNSRQKEKLFF	TRBV7-3	TRBJ1-4
TGTGCCAGCATTATATGGGGGCGAGAGACTAATGAAAAACTGTTTTTT	CASIIWGRETNEKLFF	TRBV7-2	TRBJ1-4
TGTGCCAGCAGTGCACGGACTAGCGGGGGCAGCTCCTACGAGCAGTACTTC	CASSARTSGGSSYEQYF	TRBV6-4	TRBJ2-7
TGTGCCAGCAGCCAAGACCCCCAGTCCGAGCGGGGATGCTCCTACAATGAGCAGTTCTTC	CASSQDPQSERGCSYNEQFF	TRBV14	TRBJ2-1
TGTGCCAGCATCTATGGGGGGACAGGGGGAAACACCATATATTTT	CASIYGGTGGNTIYF	TRBV7-3	TRBJ1-3
TGTGCCTGTTGGACGTCGGGCTCTGGGGCCAACGTCCTGACTTTC	CACWTSGSGANVLTF	TRBV30	TRBJ2-6
TGTGCCAGTCCCGAGGGTCTGGGATCCGTCGCTAGCACAGATACGCAGTATTTT	CASPEGLGSVASTDTQYF	TRBV19	TRBJ2-3
TGTGCCTGGAGTGTACGAAGGTCGACGGCCCTTGACGAGCAGTACTTC	CAWSVRRSTALDEQYF	TRBV30	TRBJ2-7
TGTGCCAGCAGTTATCCTCCCGGGACAGGGTGCTCTGGAAACACCATATATTTT	CASSYPPGTGCSGNTIYF	TRBV6-5	TRBJ1-3
TGTGCTAGTGGTTTGTGCAGGTGGGCCAAAAACATTCAGTACTTC	CASGLCRWAKNIQYF	TRBV12-5	TRBJ2-4
TGTGCCAGCTCCAGACTAGCGGAGGAGCAGTACTTC	CASSRLAEEQYF	TRBV7-3	TRBJ2-7
TGCAGTGCTTATATATCACAGGGTATAAGCTCCTATAATTCACCCCTCCACTTT	CSAYISQGISSYNSPLHF	TRBV20-1	TRBJ1-6
TGTGCCAGCACTTACGGGTTATATAGCAATCAGCCCCAGCATTTT	CASTYGLYSNQPQHF	TRBV5-4	TRBJ1-5
TGTGCCAGCATGAGACAGCGGGAGGGTGGCTACACCTTC	CASMRQREGGYTF	TRBV25-1	TRBJ1-2
TGTGCCAGCAGCTTGGCTGGACCAGGGAGGTACAACTATGGCTACACCTTC	CASSLAGPGRYNYGYTF	TRBV7-9	TRBJ1-2
TGTGCCAGCAGCTTGGGACCAGGGGTCTGCGGGGAGCTGTTTTTT	CASSLGPGVCGELFF	TRBV5-6	TRBJ2-2
TGTGCCATCAGTGAGTCAATCTCTAAATGGCGGGGTGTCAACTATGGCTACACCTTC	CAISESISKWRGVNYGYTF	TRBV10-3	TRBJ1-2
TGTGCCAGCAGTTTTCCCAAGCTAAGCCTAAGCTACGAGCAGTACTTC	CASSFPKLSLSYEQYF	TRBV27	TRBJ2-7
TGTGCCAGCAGCTTAACCCGAGCAGGCCCGGATTTCTCCTACGAGCAGTACTTC	CASSLTRAGPDFSYEQYF	TRBV7-9	TRBJ2-7
TGTGCCACCAGTCCCTCGGACAGGGACTCCTACAATGAGCAGTTCTTC	CATSPSDRDSYNEQFF	TRBV24-1	TRBJ2-1
TGTGCCAGCAGCTTATCAAGGCACGACCAGGAGGGGGGCTCCTACGAGCAGTACTTC	CASSLSRHDQEGGSYEQYF	TRBV5-6	TRBJ2-7
TGCAGTGCTAGCTTGACAGGGTATGGCTACACCTTC	CSASLTGYGYTF	TRBV20-1	TRBJ1-2
TGTGCCAGCCCAAGTAGCGGCACAGATACGCAGTATTTT	CASPSSGTDTQYF	TRBV7-6	TRBJ2-3
TGTGCCAGCAGCTTGCCGGCCCTGGAGGAAGGGAAGAACACTGAAGCTTTCTTT	CASSLPALEEGKNTEAFF	TRBV5-6	TRBJ1-1
TGTGCCAGCAGCCATTCGCGCGGGGCTCTAGCTTTCTTT	CASSHSRGALAFF	TRBV3-1	TRBJ1-1
TGTGCCAGCAGCTTAGTCCGGAACCAGGGGAACGTGAGCTACACCTTC	CASSLVRNQGNVSYTF	TRBV7-9	TRBJ1-2
TGTGCCAGCAGACAATTCCCGGACAGCAGAACTGAAGCTTTCTTT	CASRQFPDSRTEAFF	TRBV12-4	TRBJ1-1
TGTGCCAGCAATCGAACCAGCACAGATACGCAGTATTTT	CASNRTSTDTQYF	TRBV12-3	TRBJ2-3
TGTGCCAGCAGCGGGTCCCGAAGGGGGGGGAGATTAAGCTCCTACGAGCAGTACTTC	CASSGSRRGGRLSSYEQYF	TRBV6-2	TRBJ2-7
TGTGCCAGCAGCTTGGCGGCCCTGAGCAAACACGAGCAGTACTTC	CASSLAALSKHEQYF	TRBV7-2	TRBJ2-7
TGTGCCAGCAGCCATCCTGGCGTGACCCAGTACTTC	CASSHPGVTQYF	TRBV14	TRBJ2-5
TGCAGTGCAGGGACAGGGTCGCGGAGGCAACGAAACACCATATATTTT	CSAGTGSRRQRNTIYF	TRBV20-1	TRBJ1-3
TGTGCCCATTGCTGGGAGGCCCCAGATACGCAGTATTTT	CAHCWEAPDTQYF	TRBV24-1	TRBJ2-3
TGTGCCAGCAGCCAAGGGACAATAGATCTGGGAGATCTCGGATCACCCCTCCACTTT	CASSQGTIDLGDLGSPLHF	TRBV14	TRBJ1-6
TGTGCCAGCAGCAGGCGGGAGCGCAATGAGCAGTTCTTC	CASSRRERNEQFF	TRBV7-2	TRBJ2-1
TGTGCCACCATTAGCGGCTCCTACGAGCAGTACTTC	CATISGSYEQYF	TRBV19	TRBJ2-7
TGTGCCAGCAGTTACCGAAGCGGGGGTAAGCACATTCAGTACTTC	CASSYRSGGKHIQYF	TRBV6-6	TRBJ2-4
TGTGCCAGCAGCTTGGCCTGTCGGCCCACAGATACGCAGTATTTT	CASSLACRPTDTQYF	TRBV5-4	TRBJ2-3
TGTGCCACGGGCACGTATGAAAAACTGTTTTTT	CATGTYEKLFF	TRBV19	TRBJ1-4
TGCAGTGCTAGCTACTTTGTGGACAGGGGGAGGCTCTCTGGGGCCAACGTCCTGACTTTC	CSASYFVDRGRLSGANVLTF	TRBV20-1	TRBJ2-6
TGTGCCAGCAGAGGCTCGCATTATGAGACGCAGTATTTT	CASRGSHYETQYF	TRBV6-1	TRBJ2-3
TGTGCCAGCAGTGACTCGAAAGGGGGACAGGGGGCGAGTGAAGCTTTCTTT	CASSDSKGGQGASEAFF	TRBV6-4	TRBJ1-1
TGTGCCAGCAGTTACTCGATCGACAGGGGAGCCGCCGGACACGAGCAGTACTTC	CASSYSIDRGAAGHEQYF	TRBV6-5	TRBJ2-7
TGTGCCAGCAGGTTAATTTCGGGGCGCTTAATAAGCTCCTACAATGAGCAGTTCTTC	CASRLISGRLISSYNEQFF	TRBV28	TRBJ2-1
TGTGCCAGCTCACCCATCGGGACTAGCGGGGGGGCCTTAAACACCGGGGAGCTGTTTTTT	CASSPIGTSGGALNTGELFF	TRBV18	TRBJ2-2
TGTGCCAGCAGTTACAGGGAGAATGAAAAACTGTTTTTT	CASSYRENEKLFF	TRBV12-3	TRBJ1-4
TGTGCCAGCAGTTACCCCAGCAGGGATAGGGGAACTGGCTACACCTTC	CASSYPSRDRGTGYTF	TRBV6-5	TRBJ1-2
TGTGCCAGCTCCCAGGACCCGGGACAGGGCTTTACGCAGTATTTT	CASSQDPGQGFTQYF	TRBV18	TRBJ2-3
TGTGCCAGCAGCTTAGGGTCAGGACAGAGGCTTGAGCAGTTCTTC	CASSLGSGQRLEQFF	TRBV5-4	TRBJ2-1
TGTGCCAGCAGCTCGTCGAGCGGGAGGGCTTACAATGAGCAGTTCTTC	CASSSSSGRAYNEQFF	TRBV6-4	TRBJ2-1
TGCAGCGTCGCCGGGACAGGAGGGAAAGACTGCAATCAGCCCCAGCATTTT	CSVAGTGGKDCNQPQHF	TRBV29-1	TRBJ1-5
TGTGCCAGCAGCTCACCCAGGGACAGGGGTGGCGCAACTAATGAAAAACTGTTTTTT	CASSSPRDRGGATNEKLFF	TRBV7-9	TRBJ1-4
TGCGGAACTGAACTTGGGGCCGATGGCTACACCTTC	CGTELGADGYTF	TRBV20-1	TRBJ1-2
TGCGCCAGCAGTGAAAGGGCCATTAGCACAGATACGCAGTATTTT	CASSERAISTDTQYF	TRBV10-1	TRBJ2-3
TGCGCCAGCAGCTTGGAAGGGACAGGGGCCACAGATACGCAGTATTTT	CASSLEGTGATDTQYF	TRBV5-1	TRBJ2-3
TGTGCCAGCAGGGGCTTCGTAAGCACAGATACGCAGTATTTT	CASRGFVSTDTQYF	TRBV6-5	TRBJ2-3
TGTGCCACCAGCAGGGGGGACAGGGGGAGAATCTCCTACGAGCAGTACTTC	CATSRGDRGRISYEQYF	TRBV15	TRBJ2-7
TGCGCCAGCAGCCAACATCCTATCGGGTACAGGGGGAACTATGGCTACACCTTC	CASSQHPIGYRGNYGYTF	TRBV4-1	TRBJ1-2
TGTGCCAGCAGTTCCGAGCCCGGGTCCTACGAGCAGTACTTC	CASSSEPGSYEQYF	TRBV6-6	TRBJ2-7
TGTGCCAGCAGTTTGCCACCGGGACAGGTCAATCAGCCCCAGCATTTT	CASSLPPGQVNQPQHF	TRBV28	TRBJ1-5
TGTGCCAGCAGCGCTGAAGGTGACAGGGTTCGACCTAATTCACCCCTCCACTTT	CASSAEGDRVRPNSPLHF	TRBV7-9	TRBJ1-6
TGTGCCCCCCCCGACAGGTTCCGCCGCCAAGAGACCCAGTACTTC	CAPPDRFRRQETQYF	TRBV10-3	TRBJ2-5
TGTGCCAGCAGCCCGGCGACAGGATTTCTAAGTCAGCCCCAGCATTTT	CASSPATGFLSQPQHF	TRBV5-6	TRBJ1-5
TGTGCCAGCAGCGTAAAAGTAAGTACAGGGGGCTCCACAGATACGCAGTATTTT	CASSVKVSTGGSTDTQYF	TRBV9	TRBJ2-3
TGTGCCAGGGGGGGGCGTGGGAGAAGCTCCTACAATGAGCAGTTCTTC	CARGGRGRSSYNEQFF	TRBV7-9	TRBJ2-1
TGTGCCAGCATCCAGAAGGACCGGGGACTAGCGTCTCCCCAGGGAGGAGCCAAAAACATTCAGTACTTC	CASIQKDRGLASPQGGAKNIQYF	TRBV7-3	TRBJ2-4
TGTGCCAGCAGCCAAGATCGAACGGGTGAAAAACTGTTTTTT	CASSQDRTGEKLFF	TRBV4-2	TRBJ1-4
TGTGCCAGCAGTTTCAGAATCCAGTTCCACCCCACTGAAGCTTTCTTT	CASSFRIQFHPTEAFF	TRBV12-4	TRBJ1-1
TGTGCCAGCAGCCCCCTAGCGGGAAGTCAACGAGTGATCTTC	CASSPLAGSQRVIF	TRBV13	TRBJ2-1
TGTGCCAGCAGACTGACAGGGAACACTGAAGCTTTCTTT	CASRLTGNTEAFF	TRBV27	TRBJ1-1
TGTGCCAGCAGTTTGGGGGCGGGTTACGAGCAGTACTTC	CASSLGAGYEQYF	TRBV12-4	TRBJ2-7
TGTGCCAGCAGCGGGGAGGCCGTCGGGGAGCTGTTTTTT	CASSGEAVGELFF	TRBV7-3	TRBJ2-2
TGCGCCAGCAGTCACCTCGCTGAGACCCAGTACTTC	CASSHLAETQYF	TRBV10-1	TRBJ2-5
TGTGCCACCAGCAGAAAGGACAGCACTGAAGCTTTCTTT	CATSRKDSTEAFF	TRBV15	TRBJ1-1
TGCGCCAGCAGCCACTTAGACTCTTCTCCTAGCACAGATACGCAGTATTTT	CASSHLDSSPSTDTQYF	TRBV4-1	TRBJ2-3
TGCAGTGCCGTCGACATCTTC	CSAVDIF	TRBV20-1	TRBJ2-1
TGCAGCGAATGCTACCGCGGGCTACGCACAGATACGCAGTATTTT	CSECYRGLRTDTQYF	TRBV29-1	TRBJ2-3
TGTGCCAGCAGCCAAGCCCCCCATAGACACAATGAGCAGTTCTTC	CASSQAPHRHNEQFF	TRBV3-1	TRBJ2-1
TGTGCCAGCAGCGGGAGGGACAGGGGCCCGGAGGGGGGGTACACTGAAGCTTTCTTT	CASSGRDRGPEGGYTEAFF	TRBV28	TRBJ1-1
TGTGCCAGCAGTGATGTGGGAGGGAAAAAGGATAGCAATCAGCCCCAGCATTTT	CASSDVGGKKDSNQPQHF	TRBV25-1	TRBJ1-5
TGTGTCCGGTGTAGGGAGTACAATGAGCAGTTCTTC	CVRCREYNEQFF	TRBV6-5	TRBJ2-1
TGTGCCAGCAGTGGTAGACTAGAGGGCACAGATACGCAGTATTTT	CASSGRLEGTDTQYF	TRBV25-1	TRBJ2-3
TGTGCCAGCAGTTTTAGGATACCAGGGAGCGCGTTACGTGGGTACGAGCAGTACTTC	CASSFRIPGSALRGYEQYF	TRBV27	TRBJ2-7
TGTGCCAGCAGCCAAGATGTTTGGGGAATTATTGGGGGTCATTCACCCCTCCACTTT	CASSQDVWGIIGGHSPLHF	TRBV14	TRBJ1-6
TGTGCCAGCAGCGACAACAGGGGGCCGTGCGCTTTCTTT	CASSDNRGPCAFF	TRBV9	TRBJ1-1
TGTGCCAGCAGTTCGAGGGACCCGGCGGCTTATAGCAATCAGCCCCAGCATTTT	CASSSRDPAAYSNQPQHF	TRBV27	TRBJ1-5
TGTGCCAGCAGAACGCGGGGTCCCGGGGGGGAGACCCAGTACTTC	CASRTRGPGGETQYF	TRBV28	TRBJ2-5
TGTGCCAGCAGTTTATCGAGTTCTCTTGACCGAGAGAGCTCCTACAATGAGCAGTTCTTC	CASSLSSSLDRESSYNEQFF	TRBV27	TRBJ2-1
TGCGCCAGCAGCCAGCCAGACTCGGGTGGCTACACCTTC	CASSQPDSGGYTF	TRBV4-3	TRBJ1-2
TGTGCCACCAGTGAAATCTTCCCCTACGAGCAGTACTTC	CATSEIFPYEQYF	TRBV24-1	TRBJ2-7
TGTGCCATCAGGAATTTTGGCAGAGCGGGAAGCCGGAATTCGGCCTACGAGCAGTACTTC	CAIRNFGRAGSRNSAYEQYF	TRBV10-3	TRBJ2-7
TGTGCCAGCAGTTACTCTAACCGCGGGAGGAAATATGGCTACACCTTC	CASSYSNRGRKYGYTF	TRBV6-2	TRBJ1-2
TGTGCCCGTAGACTAGCGGGAGGGCAGTACAATGAGCAGTTCTTC	CARRLAGGQYNEQFF	TRBV27	TRBJ2-1
TGTGCCACCAGTATTTGGGAGGGCCTAAGGGAGACCCAGTACTTC	CATSIWEGLRETQYF	TRBV24-1	TRBJ2-5
TGTGCCACCCTGCACAGGGGGGGGAACACTGAAGCTTTCTTT	CATLHRGGNTEAFF	TRBV24-1	TRBJ1-1
TGTGCCAAAGGGGTAGAGGGGAGGCTAACAGGGTACGAGCAGTACTTC	CAKGVEGRLTGYEQYF	TRBV12-4	TRBJ2-7
TGTGCCAGCGTTACAGGGGGCCCCCCTAGCACAGATACGCAGTATTTT	CASVTGGPPSTDTQYF	TRBV5-8	TRBJ2-3
TGCGCCAGCAGCTTTGGGGTAGTAAGCTTTTGCACAGATACGCAGTATTTT	CASSFGVVSFCTDTQYF	TRBV4-1	TRBJ2-3
TGTGCCAGCGTTCTAAGAGGGGACAATGAGCAGTTCTTC	CASVLRGDNEQFF	TRBV11-3	TRBJ2-1
TGTGCCAGTAGTAAAACGGGACCAGGTAACTATGGCTACACCTTC	CASSKTGPGNYGYTF	TRBV19	TRBJ1-2
TGTGCCAGCAGCCCCGGGACTAGAGAGACCCAGTACTTC	CASSPGTRETQYF	TRBV7-3	TRBJ2-5
TGTGCCAGCAGCCCCTTCGGGCAGAACACTGAAGCTTTCTTT	CASSPFGQNTEAFF	TRBV7-4	TRBJ1-1
TGCGCCAGCCGGGACTGGTCCTACAATGAGCAGTTCTTC	CASRDWSYNEQFF	TRBV10-1	TRBJ2-1
TGTGCCAGCAGCTGGGGCGGACAGCCGAGAGAACATTCACCCCTCCACTTT	CASSWGGQPREHSPLHF	TRBV7-3	TRBJ1-6
TGTGCCACCAGTGATGGCCGGGACAACACCGGGGAGCTGTTTTTT	CATSDGRDNTGELFF	TRBV24-1	TRBJ2-2
TGCGCCAGCGGTGTCAGGGTAAGAGAGACCCAGTACTTC	CASGVRVRETQYF	TRBV4-1	TRBJ2-5
TGTGCCACTGGACGGAGCTCCTATAATTCACCCCTCCACTTT	CATGRSSYNSPLHF	TRBV27	TRBJ1-6
TGTGCCAGCAGCCTGACAGGGTATAGCAATCAGCCCCAGCATTTT	CASSLTGYSNQPQHF	TRBV7-9	TRBJ1-5
TGCGCCAGCAGCCAAGTAGGGGGACTCGGGGAGCTGTTTTTT	CASSQVGGLGELFF	TRBV4-1	TRBJ2-2
TGTGCCAGCAGCCAGGCGGGCTCGGGACAGGGCTACGAGCAGTACTTC	CASSQAGSGQGYEQYF	TRBV14	TRBJ2-7
TGTGCCACCAGCTACCGGGACAACACCATATATTTT	CATSYRDNTIYF	TRBV24-1	TRBJ1-3
TGTGCCAGCAGCCTGGGGGTGACTAGCGGTTGGGGGGACAATGAGCAGTTCTTC	CASSLGVTSGWGDNEQFF	TRBV9	TRBJ2-1
TGTGCCAGCAGGTCCGACAGGGGCCGCTACACCTTC	CASRSDRGRYTF	TRBV6-5	TRBJ1-2
TGCGCCAGCAGCTGGACTAGCGGGGACCCGAGAGGGGGCTACGAGCAGTACTTC	CASSWTSGDPRGGYEQYF	TRBV5-1	TRBJ2-7
TGCGCCAGCAGCTTGCTACCCACCGAGCAGTACTTC	CASSLLPTEQYF	TRBV5-1	TRBJ2-7
TGCGCCAGCAGCTCAGGGACAGATACGCAGTATTTT	CASSSGTDTQYF	TRBV5-1	TRBJ2-3
TGTGCCAGCAGCGTGCGGACAGGGCCTGAGAACACTGAAGCTTTCTTT	CASSVRTGPENTEAFF	TRBV9	TRBJ1-1
TGCAGTGCGGCGGTTGGGGACTCCCGCTACACCTTC	CSAAVGDSRYTF	TRBV20-1	TRBJ1-2
TGTGCCAGCAGCCCTTACAGGCCGGAAAAAACAGAGACCCAGTACTTC	CASSPYRPEKTETQYF	TRBV6-5	TRBJ2-5
TGTGCCAGCAGCAGGAACACTGAAGCTTTCTTT	CASSRNTEAFF	TRBV13	TRBJ1-1
TGTGCCACCAGTGAAACAGGCGTTGGCACAGATACGCAGTATTTT	CATSETGVGTDTQYF	TRBV24-1	TRBJ2-3
TGTGCCACCACCTCCGGATTGCAACTTTACGAGCAGTACTTC	CATTSGLQLYEQYF	TRBV24-1	TRBJ2-7
TGCAGCGCCGAGACCGAGACCCAGTACTTC	CSAETETQYF	TRBV29-1	TRBJ2-5
TGTGCCAGCAGCACGGGGACCAGCGGGAGGGCGAGGAAATACGAGCAGTACTTC	CASSTGTSGRARKYEQYF	TRBV7-4	TRBJ2-7
TGCAGTGCTAGAGATCTTCTCCGGGACGGTCCCCTTGAAGCTTTCTTT	CSARDLLRDGPLEAFF	TRBV20-1	TRBJ1-1
TGTGCCAGCAGCGGATTGAGTTCTCGAGAGGATGGCTACACCTTC	CASSGLSSREDGYTF	TRBV5-4	TRBJ1-2
TGTGCCAGCAGTTGGATGGTCTCTGGGGCCAACGTCCTGACTTTC	CASSWMVSGANVLTF	TRBV9	TRBJ2-6
TGCGCCAGCAGCTTGCGCATCTTTTGGCGTTACTACGAGCAGTACTTC	CASSLRIFWRYYEQYF	TRBV5-1	TRBJ2-7
TGTGCCAGCAGCCAGGGACTAGACGAGCAGTACTTC	CASSQGLDEQYF	TRBV7-9	TRBJ2-7
TGTGCCAGCAGTCGCCTGACTAGAGCAGACAGCCGGGGCTCCTACAATGAGCAGTTCTTC	CASSRLTRADSRGSYNEQFF	TRBV6-3	TRBJ2-1
TGTGCCAGCAGCTTGCAACGTCCCAAAGAGGAGCAGTTCTTC	CASSLQRPKEEQFF	TRBV5-6	TRBJ2-1
TGTGCCACCAGTGATTTGGTTTCCGCCCGAGACGCCTACGAGCAGTACTTC	CATSDLVSARDAYEQYF	TRBV24-1	TRBJ2-7
TGTGCCAGCAGCTTACCGAGTTTGACAGGGACTAACTATGGCTACACCTTC	CASSLPSLTGTNYGYTF	TRBV7-9	TRBJ1-2
TGTGCCAGCAGCGGCAAAAGGACCTCTTTAGTGGAGACCCAGTACTTC	CASSGKRTSLVETQYF	TRBV5-6	TRBJ2-5
TGTGCCAGCAGTGCCGGAGGGGGGGAGTCAGATACGCAGTATTTT	CASSAGGGESDTQYF	TRBV6-1	TRBJ2-3
TGTGCCAGCAGTGGGGGGACATCGGGCTACACCTTC	CASSGGTSGYTF	TRBV27	TRBJ1-2
TGTGCCAGCAGTTACGTTCGAGACTGTACCGACGAGCAGTACTTC	CASSYVRDCTDEQYF	TRBV6-6	TRBJ2-7
TGTGCCAGCACAGGGGTAATGACCCAGTACTTC	CASTGVMTQYF	TRBV27	TRBJ2-5
TGTGCCAGCTCAATGAACACTAGTGGTAACACCGGGGAGCTGTTTTTT	CASSMNTSGNTGELFF	TRBV18	TRBJ2-2
TGTGCCACCGGAGGGACTGAAGCTTTCTTT	CATGGTEAFF	TRBV10-3	TRBJ1-1
TGTGCCAGCAGCTTAGCTTGTCTGGAGGCGGAGGATGGCTACACCTTC	CASSLACLEAEDGYTF	TRBV11-2	TRBJ1-2
TGTGCCAGCAGTGAGACGGGGCACACTGAAGCTTTCTTT	CASSETGHTEAFF	TRBV25-1	TRBJ1-1
TGTGCCAGCAATAATAGGGGACGGGGGAGTGCAGATACGCAGTATTTT	CASNNRGRGSADTQYF	TRBV7-3	TRBJ2-3
TGCGCCAGCAGCCAACATAGGAAAGCGTACCAAGAGACCCAGTACTTC	CASSQHRKAYQETQYF	TRBV4-1	TRBJ2-5
TGTGCCTGGAGACAAATCCCGGGCAGTTCTTCGAACACCGGGGAGCTGTTTTTT	CAWRQIPGSSSNTGELFF	TRBV30	TRBJ2-2
TGCGCCAGCTTTACAATAGGGGTAATCTCCCTCGAGACCCAGTACTTC	CASFTIGVISLETQYF	TRBV5-1	TRBJ2-5
TGTGCCAGCAGTTCGGAGGGGTACGATACGCAGTATTTT	CASSSEGYDTQYF	TRBV27	TRBJ2-3
TGCAGTGCTAGAGATCTGGACGGGGAAGGGCGCGAGCAGTACTTC	CSARDLDGEGREQYF	TRBV20-1	TRBJ2-7
TGTGCCAGCAGTTTGGGGGAGGGTCGTCAGCCCCAGCATTTT	CASSLGEGRQPQHF	TRBV28	TRBJ1-5
TGTGCCAGCAGTTATGGACAGGGTTATGTACCGGGCGAGACCCAGTACTTC	CASSYGQGYVPGETQYF	TRBV27	TRBJ2-5
TGTGCCAGCTACCAGGGCCCTTCCGAAGCTTTCTTT	CASYQGPSEAFF	TRBV19	TRBJ1-1
TGTGCCACCAGTGATTTCGTGAACAACACTGAAGCTTTCTTT	CATSDFVNNTEAFF	TRBV24-1	TRBJ1-1
TGTGCCAGAGATTACGGGCAGCAGTTCTTC	CARDYGQQFF	TRBV28	TRBJ2-1
TGTGCCAGCAGCCGGGAGCCCGCGGAAGGAGCTTTCTTT	CASSREPAEGAFF	TRBV14	TRBJ1-1
TGTGCCTGGAGTGTAGGCTGGACAGATACGCAGTATTTT	CAWSVGWTDTQYF	TRBV30	TRBJ2-3
TGTGCCAGCAGCTTAAACGATGAGGGCGCTGAAGCTTTCTTT	CASSLNDEGAEAFF	TRBV7-2	TRBJ1-1
TGCGCCAGCAGCTGCAGGGGGGGCTACGAGCAGTACTTC	CASSCRGGYEQYF	TRBV5-1	TRBJ2-7
TGTGCCAGCAGTAGCCCGCGACAGGGGGCCGCTGGGGAGCCCTTGGGGAACACCGGGGAGCTGTTTTTT	CASSSPRQGAAGEPLGNTGELFF	TRBV6-4	TRBJ2-2
TGTGCCAAAACAGGGAGGCAGCCCCAGCATTTT	CAKTGRQPQHF	TRBV24-1	TRBJ1-5
TGTGCCAGCAGCAATTTCGAGTCTGGAAACACCATATATTTT	CASSNFESGNTIYF	TRBV12-4	TRBJ1-3
TGTGCCAGCAGCGAAAGTGGATATCGGTCCTCGTATGAGCAGTTCTTC	CASSESGYRSSYEQFF	TRBV11-3	TRBJ2-1
TGCGCCAGCAATCCCGGGGGGGCGGTATGTTCACCCCTCCACTTT	CASNPGGAVCSPLHF	TRBV10-1	TRBJ1-6
TGTGCCAGCAGTGAAAACCACAGGGAAACTGAAGCTTTCTTT	CASSENHRETEAFF	TRBV6-3	TRBJ1-1
TGCAGTGCTCCGGGGGCCCCGCACGGCACAGATACGCAGTATTTT	CSAPGAPHGTDTQYF	TRBV20-1	TRBJ2-3
TGTGCCAGCGGACAGGGGTTCACCGGGGAGCTGTTTTTT	CASGQGFTGELFF	TRBV7-9	TRBJ2-2
TGTGCCAGCAGCCCCGGACAAAGCTCCTACAATGAGCAGTTCTTC	CASSPGQSSYNEQFF	TRBV7-2	TRBJ2-1
TGCAGTGCTAGCCTACCTAGAAACTACGAGCAGTACTTC	CSASLPRNYEQYF	TRBV20-1	TRBJ2-7
TGTGCTAGTGGTTCCCGGACAGGGGGCGGTGCCTACGAGCAGTACTTC	CASGSRTGGGAYEQYF	TRBV12-5	TRBJ2-7
TGTGCCAGCAGCGAACAGGGGTCAGGTGGCTACACCTTC	CASSEQGSGGYTF	TRBV7-3	TRBJ1-2
TGCGCCAGCAGCTTGGGATTCACACAGGGGGCGTATTCGGGCAGATGCTATGGCTACACCTTC	CASSLGFTQGAYSGRCYGYTF	TRBV5-1	TRBJ1-2
TGTGCCAGCAGCGGGCTGGGCACTGAAGCTTTCTTT	CASSGLGTEAFF	TRBV13	TRBJ1-1
TGTGCCAGTACAGTAGCGAGGACCGGATTGTTGAATGGCTACACCTTC	CASTVARTGLLNGYTF	TRBV19	TRBJ1-2
TGTGCCAGCAGCCTAACACTCGGGGGTATTTCAAACTATGGCTACACCTTC	CASSLTLGGISNYGYTF	TRBV3-1	TRBJ1-2
TGTGCCAGCAGTGGACGACTCCGGGACAGTGGATATAGCAATCAGCCCCAGCATTTT	CASSGRLRDSGYSNQPQHF	TRBV27	TRBJ1-5
TGCAGTGCTAGAGATTCGGGACCGGGCTGGTGTGAAGCTTTCTTT	CSARDSGPGWCEAFF	TRBV20-1	TRBJ1-1
TGTGCCAGCAGCCCGCAAAATCAAGAGACCCAGTACTTC	CASSPQNQETQYF	TRBV7-3	TRBJ2-5
TGTGCCAGCAGCTTCTACCCTCTGCGGGAGATCTACGAGCAGTACTTC	CASSFYPLREIYEQYF	TRBV7-9	TRBJ2-7
TGCGCCAGCAGTAAGGGAAAAGGGTACGAGCAGTACTTC	CASSKGKGYEQYF	TRBV10-1	TRBJ2-7
TGTGCCAGCAGCTTTATTGAGGGGTTAATTAATGAAAAACTGTTTTTT	CASSFIEGLINEKLFF	TRBV11-2	TRBJ1-4
TGTGCCAGCAGCTTTGGACGTAAGGGGTATGGCTACACCTTC	CASSFGRKGYGYTF	TRBV7-9	TRBJ1-2
TGCGCCAGCAGCTGGAGGGTTATTTTGAATCAGCCCCAGCATTTT	CASSWRVILNQPQHF	TRBV5-1	TRBJ1-5
TGTGCCAGCAGCACGACTAGTGGAGGAACAACTCACTCCTACGAGCAGTACTTC	CASSTTSGGTTHSYEQYF	TRBV7-9	TRBJ2-7
TGTGCCACCAGTGATCGGTACCGCTCCTACAATGAGCAGTTCTTC	CATSDRYRSYNEQFF	TRBV24-1	TRBJ2-1
TGTGCCAGCGGTAGCGGGATACCGGATACGCAGTATTTT	CASGSGIPDTQYF	TRBV27	TRBJ2-3
TGTGCCAGCAGCCGGGGGCCAATATTTTCCTACAATGAGCAGTTCTTC	CASSRGPIFSYNEQFF	TRBV7-2	TRBJ2-1
TGTGCCAGCAGCCAAGAGACCAACTGCCGGACTTACAATGAGCAGTTCTTC	CASSQETNCRTYNEQFF	TRBV14	TRBJ2-1
TGTGCCAGCAGGATCCACAGGGGAGATAATGAAAAACTGTTTTTT	CASRIHRGDNEKLFF	TRBV11-2	TRBJ1-4
TGTGCCAGCAGCTTAGACAGGGAGGAAACGTATGGCTACACCTTC	CASSLDREETYGYTF	TRBV7-6	TRBJ1-2
TGTGCCAGCAGCAGAAAAGGGGGCTGTGAAGCTTTCTTT	CASSRKGGCEAFF	TRBV7-4	TRBJ1-1
TGTGCCAGCAGCCGCGCCGGGACACCGTCGAACACTGAAGCTTTCTTT	CASSRAGTPSNTEAFF	TRBV7-7	TRBJ1-1
TGTGCCAGCAGCAGGACAGCGGGGGGAGGTAACACTGAAGCTTTCTTT	CASSRTAGGGNTEAFF	TRBV7-3	TRBJ1-1
TGTGCCAGCACCCCGGTTATTTGGGAGTACAATGAGCAGTTCTTC	CASTPVIWEYNEQFF	TRBV5-6	TRBJ2-1
TGTGCCACCAGTCCGACCCACTATGGCTACACCTTC	CATSPTHYGYTF	TRBV24-1	TRBJ1-2
TGTGCCGGAAAGGGGAGGAGTGACGAGGAAGCTTTCTTT	CAGKGRSDEEAFF	TRBV6-1	TRBJ1-1
TGTGCCACCAGCGGTATGACAGGGAAGGAGGTTCCCAATCAGCCCCAGCATTTT	CATSGMTGKEVPNQPQHF	TRBV24-1	TRBJ1-5
TGTGCCAGCATGCTTTCCAGCCCCAGCGGGAGTAGGGAGACAGATACGCAGTATTTT	CASMLSSPSGSRETDTQYF	TRBV6-5	TRBJ2-3
TGCAGCGTTGAAGTGGACACCGGGGAGCTGTTTTTT	CSVEVDTGELFF	TRBV29-1	TRBJ2-2
TGTGCCAGCAGTGAAAATCGCCGGGACAGGGGGTTTGAGCAGTTCTTC	CASSENRRDRGFEQFF	TRBV25-1	TRBJ2-1
TGTGCCAGCAGGTTTGACAGGGGGCGGCTAGCCAAAAACATTCAGTACTTC	CASRFDRGRLAKNIQYF	TRBV12-3	TRBJ2-4
TGTGCCACCAGCAGAGCGTGGACGAGCACTGGGGCCAACGTCCTGACTTTC	CATSRAWTSTGANVLTF	TRBV15	TRBJ2-6
TGCAGTGCTGGCCGACAGGTGAGACTGTATGGCTACACCTTC	CSAGRQVRLYGYTF	TRBV20-1	TRBJ1-2
TGTGCCAGCAGGGTACGGGGGGGCCCGGGGACCTACGAGCAGTACTTC	CASRVRGGPGTYEQYF	TRBV6-1	TRBJ2-7
TGTGCCAGCAGCAGGGATCGGTCTGGGGCCAACGTCCTGACTTTC	CASSRDRSGANVLTF	TRBV5-6	TRBJ2-6
TGTGCCAGCAGCCTGGGGCCCGAGACCCAGTACTTC	CASSLGPETQYF	TRBV6-4	TRBJ2-5
TGTGCCAGCAAACCGCGACGGCTGGGTCGCACAGATACGCAGTATTTT	CASKPRRLGRTDTQYF	TRBV7-3	TRBJ2-3
TGTGCCAGCCTCGAACTGTCGGTGGGCACCGGGGAGCTGTTTTTT	CASLELSVGTGELFF	TRBV27	TRBJ2-2
TGTGCCAGTAGTATGTTGAAAGGAGAATCAGCCTACAATGAGCAGTTCTTC	CASSMLKGESAYNEQFF	TRBV19	TRBJ2-1
TGTGCCAGTAGTAGTCCCACTCAGGGACAGATGTCAATGAACACTGAAGCTTTCTTT	CASSSPTQGQMSMNTEAFF	TRBV19	TRBJ1-1
TGTGCCAGCAGCCCTGGGGGGGCCTACGAGCAGTACTTC	CASSPGGAYEQYF	TRBV4-2	TRBJ2-7
TGTGCCAGCAGTGACACGGTTGTTTTAGAGCAGTACTTC	CASSDTVVLEQYF	TRBV2	TRBJ2-7
TGTGCCAGCAGTGAGACCAGGGGGGGCGCACCTGCCTACGAGCAGTACTTC	CASSETRGGAPAYEQYF	TRBV25-1	TRBJ2-7
TGCAGTGCTGGCATTGGGGGATGGGCCCGTGAGCAGTTCTTC	CSAGIGGWAREQFF	TRBV20-1	TRBJ2-1
TGCGCCAGCAGCTCCCCGTTGACAGGGATCGGACAGCCCCAGCATTTT	CASSSPLTGIGQPQHF	TRBV5-1	TRBJ1-5
TGCGCCAGCACTCCGTGGTCTGAGCAGTACTTC	CASTPWSEQYF	TRBV10-1	TRBJ2-7
TGCAGTGCTAGACGGCGACATGGGGGCTCGCGCACAGATACGCAGTATTTT	CSARRRHGGSRTDTQYF	TRBV20-1	TRBJ2-3
TGTGCCACCAGTGATCTGACTATGGAACTAGCGGTATGCACCGGGGAGCTGTTTTTT	CATSDLTMELAVCTGELFF	TRBV24-1	TRBJ2-2
TGTGCCAGCAGCGTGGGGACTAGGAGGGAAGATACGCAGTATTTT	CASSVGTRREDTQYF	TRBV6-4	TRBJ2-3
TGTGCCACCACCCAGGTGAAGGACCCAACTAATGAAAAACTGTTTTTT	CATTQVKDPTNEKLFF	TRBV24-1	TRBJ1-4
TGTGCCAGCAGCCGCGGCAAGGGCTACAATGAGCAGTTCTTC	CASSRGKGYNEQFF	TRBV7-2	TRBJ2-1
TGTGCCAGGGCCCCGAACACCGGGGAGCTGTTTTTT	CARAPNTGELFF	TRBV6-5	TRBJ2-2
TGTGCCACCAACTCTGCAGCTCAGCCCCAGCATTTT	CATNSAAQPQHF	TRBV24-1	TRBJ1-5
TGCGCCAGCAGTGAGAGGGGGATCGCCACTGAAGCTTTCTTT	CASSERGIATEAFF	TRBV10-1	TRBJ1-1
TGTGCCAGTAGAGGATGTCTCACTACTGCCGATAGCAATCAGCCCCAGCATTTT	CASRGCLTTADSNQPQHF	TRBV19	TRBJ1-5
TGCAGTGCTAGAGGAATCGTAGGGGGGGGGTTTTCCTACAATGAGCAGTTCTTC	CSARGIVGGGFSYNEQFF	TRBV20-1	TRBJ2-1
TGTGCCAGCACCGGAGGACAGGGCAGGCCCCAGCATTTT	CASTGGQGRPQHF	TRBV11-1	TRBJ1-5
TGTGCCAGCAGCGAAAGGACTAGCGGGCGTTGTAATACGCAGTATTTT	CASSERTSGRCNTQYF	TRBV7-4	TRBJ2-3
TGTGCCAGCAGTCCGCGGGAGTGGGAGACGAACACCGGGGAGCTGTTTTTT	CASSPREWETNTGELFF	TRBV6-1	TRBJ2-2
TGTGCCACCAGCAGAGAAACCTACGAGCAGTACTTC	CATSRETYEQYF	TRBV15	TRBJ2-7
TGTGCCAGCAGCTTAGGGACAGGGAATCAGCCCCAGCATTTT	CASSLGTGNQPQHF	TRBV11-3	TRBJ1-5
TGCGCCAGCAGCTTGCCCCTTGGGACAGGGTGCAACTACGAGCAGTACTTC	CASSLPLGTGCNYEQYF	TRBV5-1	TRBJ2-7
TGTGCCAGCAGCCACCCGAATATAGAATGGACCTACAATGAGCAGTTCTTC	CASSHPNIEWTYNEQFF	TRBV7-3	TRBJ2-1
TGTGCCAGCAGCATAACGGGACTAGGCTACACCGGGGAGCTGTTTTTT	CASSITGLGYTGELFF	TRBV13	TRBJ2-2
TGTGCCAGCAGCTTAGCACGTGTTGAACTAGCGGGAGCCTGGGAAAACACTGAAGCTTTCTTT	CASSLARVELAGAWENTEAFF	TRBV7-2	TRBJ1-1
TGTGCCAGCAGCTACCTGCGACCGGGACAGGGGACTGAAGCTTTCTTT	CASSYLRPGQGTEAFF	TRBV7-9	TRBJ1-1
TGTGCCAGCAGCTTTAGACTAGCGGCCTCCTACGAGCAGTACTTC	CASSFRLAASYEQYF	TRBV7-2	TRBJ2-7
TGTGCCAGCAAGCCCGGGGGGATGGCCGGCTACACCTTC	CASKPGGMAGYTF	TRBV27	TRBJ1-2
TGCGCCAGCAGTGGGGCCAGGGGATTATGCACCGGGGAGCTGTTTTTT	CASSGARGLCTGELFF	TRBV10-1	TRBJ2-2
TGTGCCAGCAGCTACACCTCACGGCAGGGGGCGACAGAGCAGTACTTC	CASSYTSRQGATEQYF	TRBV7-9	TRBJ2-7
TGTGCCAGCAGCTTAGACCTTAGAGCACAGACAGGGGCGGAAAATAATTCACCCCTCCACTTT	CASSLDLRAQTGAENNSPLHF	TRBV7-2	TRBJ1-6
TGTGCCAGCACGGTACACGGGGGGGGCTCGGGGATGAACACTGAAGCTTTCTTT	CASTVHGGGSGMNTEAFF	TRBV7-3	TRBJ1-1
TGTGCCAGCAGCTTGTTCAGACCGTACGAGCAGTACTTC	CASSLFRPYEQYF	TRBV5-8	TRBJ2-7
TGTGCCAGCATTCTCGGGTCGGCTCCTGGAAACACCATATATTTT	CASILGSAPGNTIYF	TRBV6-4	TRBJ1-3
TGTGCCAGCAGCGCCCCCCACGGGGGGCTGGGCTACGAGCAGTACTTC	CASSAPHGGLGYEQYF	TRBV5-4	TRBJ2-7
TGTGCCAGCAGTTTGGGGGATGAAAAACTGTTTTTT	CASSLGDEKLFF	TRBV28	TRBJ1-4
TGTGCCAGCAAAGCCGGGACAGGGCCTCAGCCCCAGCATTTT	CASKAGTGPQPQHF	TRBV6-8	TRBJ1-5
TGTGCCAGCAGCCAAGCACGAAGGTCACCCACAGATACGCAGTATTTT	CASSQARRSPTDTQYF	TRBV14	TRBJ2-3
TGTGCCAGCAGCTCCAAGCGAGGCTGGCGCCGCCAGGTCTCCTACGAGCAGTACTTC	CASSSKRGWRRQVSYEQYF	TRBV7-9	TRBJ2-7
TGCAGTGCTAGTAGACTCTTTCTTTTAAACACCATATATTTT	CSASRLFLLNTIYF	TRBV20-1	TRBJ1-3
TGTGCCTGTACGATCTCAGCTTTCTTT	CACTISAFF	TRBV30	TRBJ1-1
TGTGCCAACGGACAGGGCGAGCAGTACTTC	CANGQGEQYF	TRBV6-5	TRBJ2-7
TGTGCCAGCAGCCAAGGCATGGGACCCCCATTCAGCTCCTATAATTCACCCCTCCACTTT	CASSQGMGPPFSSYNSPLHF	TRBV3-1	TRBJ1-6
TGTGCCAGCAGTTTAACGCGGCGGTACGAGCAGTACTTC	CASSLTRRYEQYF	TRBV27	TRBJ2-7
TGTGCTAGTGGTTTAGTAGTGAGGGTGACCTTGGAAAAACTGTTTTTT	CASGLVVRVTLEKLFF	TRBV12-5	TRBJ1-4
TGTGCTAGTGGTTTGGCCTTCCGGGACAGGGCCTACGAGCAGTACTTC	CASGLAFRDRAYEQYF	TRBV12-5	TRBJ2-7
TGTGCCAGCTACCTTAGCGGGGGGACCTACAATGAGCAGTTCTTC	CASYLSGGTYNEQFF	TRBV7-9	TRBJ2-1
TGTGCCAGCAGTGGGTTGACATACCGGGGGTTACGTGTAACGTCCGGCACCGGGGAGCTGTTTTTT	CASSGLTYRGLRVTSGTGELFF	TRBV6-2	TRBJ2-2
TGTGCCAGCAGTGACTCGGCGGGGGGGCCCTCCCCTTTCACAGATACGCAGTATTTT	CASSDSAGGPSPFTDTQYF	TRBV6-4	TRBJ2-3
TGCGCCAGCAGTGGGTCAGACCGGGGGCGGCCCACTGAAGCTTTCTTT	CASSGSDRGRPTEAFF	TRBV10-2	TRBJ1-1
TGTGCCACCAGACAGGTTTACTACAATGAGCAGTTCTTC	CATRQVYYNEQFF	TRBV24-1	TRBJ2-1
TGTGCCAGCAGTGGAGTGGGACAGAAGGGGTCACCCCTCCACTTT	CASSGVGQKGSPLHF	TRBV27	TRBJ1-6
TGTGCCAGCAGCCAGGCAGATCTGGTCAATCAGCCCCAGCATTTT	CASSQADLVNQPQHF	TRBV13	TRBJ1-5
TGCGCCAGCAGCTTGGAGGGGTCGAATGAGCAGTTCTTC	CASSLEGSNEQFF	TRBV5-1	TRBJ2-1
TGTGCCAGCAGTTTGCGACAGTTTGGCTACACCTTC	CASSLRQFGYTF	TRBV27	TRBJ1-2
TGCAGTGCTAGCAACGGCGACGGGGAGCTGTTTTTT	CSASNGDGELFF	TRBV20-1	TRBJ2-2
TGTGCCAGCAAAACTTTCCGGGCGCAGTTCTTC	CASKTFRAQFF	TRBV6-4	TRBJ2-1
TGTGCCAGCAGAGTCGGGGGGGGCACGCCCCAGCATTTT	CASRVGGGTPQHF	TRBV27	TRBJ1-5
TGTGCCAGCCCCTCGCTACCCGGCTACACCTTC	CASPSLPGYTF	TRBV2	TRBJ1-2
TGCGCCAGCAGTGCGGACCGATGGGCTTTACGGGAAGAGACCCAGTACTTC	CASSADRWALREETQYF	TRBV10-1	TRBJ2-5
TGTGCCAGCAGTTACCCTTCGGGACAAGAAAGAGCCAAAAACATTCAGTACTTC	CASSYPSGQERAKNIQYF	TRBV6-6	TRBJ2-4
TGTGCCAGCAGTTATGGCAGGGACATTGGCTACACCTTC	CASSYGRDIGYTF	TRBV27	TRBJ1-2
TGTGCTGGCACAGCTTTGAGTTGTAACACTGAAGCTTTCTTT	CAGTALSCNTEAFF	TRBV3-1	TRBJ1-1
TGTGCCAGCAGCGCGACGGATACGTACGAGCAGTACTTC	CASSATDTYEQYF	TRBV7-9	TRBJ2-7
TGTGCCACCAGTGATCCAGGGACCATCCAGCAGGCCTATGGCTACACCTTC	CATSDPGTIQQAYGYTF	TRBV24-1	TRBJ1-2
TGCGCCAGCAGCTTGTTTCCGGACATGAAGGGCTACACCTTC	CASSLFPDMKGYTF	TRBV5-1	TRBJ1-2
TGCAGTGCTAGAGCACGCGAAAGAGGGACAGAGCTGTCCTACGAGCAGTACTTC	CSARARERGTELSYEQYF	TRBV20-1	TRBJ2-7
TGTGCCAGCAGCGCCCCGGGACAGGACCATGGCTACACCTTC	CASSAPGQDHGYTF	TRBV5-4	TRBJ1-2
TGTGCCAGCAGTGACCGATCGGTCGGCAACTTGAACACTGAAGCTTTCTTT	CASSDRSVGNLNTEAFF	TRBV25-1	TRBJ1-1
TGTGCCAGCGTTCCCTGTCGAGATTGGACAGGGGAGACCCAGTACTTC	CASVPCRDWTGETQYF	TRBV28	TRBJ2-5
TGTGCCAGCAGCTCAGAAACGGCCCCCGGCTACACCTTC	CASSSETAPGYTF	TRBV7-2	TRBJ1-2
TGTGCCTGGAGCCCTACAGGGTCACCCCTCCACTTT	CAWSPTGSPLHF	TRBV30	TRBJ1-6
TGTGCCAGCAGTTACAAGCTGAAAACTAGCGGGAGGAATCAGCCCCAGCATTTT	CASSYKLKTSGRNQPQHF	TRBV6-3	TRBJ1-5
TGTGCCACCAAACAGGACACTGAAGCTTTCTTT	CATKQDTEAFF	TRBV24-1	TRBJ1-1
TGTGCCAGCTCACATAGGGGGGCTGCTTTCTTT	CASSHRGAAFF	TRBV18	TRBJ1-1
TGTGCCAGCAGCATTTCAGACAGGTACGAGCAGTACTTC	CASSISDRYEQYF	TRBV13	TRBJ2-7
TGTGCCAGCAGCTTAAGGGGGGCAGGACCGAACACTGAAGCTTTCTTT	CASSLRGAGPNTEAFF	TRBV7-7	TRBJ1-1
TGTGCCACCAGTGGTTACGACGTGGTAAACATTCAGTACTTC	CATSGYDVVNIQYF	TRBV24-1	TRBJ2-4
TGTGCCAGCTCACCCCTTTCGGGACAGGGCGTCTTTACGGGTAACTATGGCTACACCTTC	CASSPLSGQGVFTGNYGYTF	TRBV18	TRBJ1-2
TGTGCCAGCAGCGCGGTCCCTGTTTTACCGGGACTCGGGTGGCCTAATGAAAAACTGTTTTTT	CASSAVPVLPGLGWPNEKLFF	TRBV9	TRBJ1-4
TGCATGGCGGGAGGGGATAGAGCCTACAATGAGCAGTTCTTC	CMAGGDRAYNEQFF	TRBV20-1	TRBJ2-1
TGTGCCAGCAGTCGGACTAGCGGGATCTGCTGCACAGATACGCAGTATTTT	CASSRTSGICCTDTQYF	TRBV7-8	TRBJ2-3
TGCGCCAGCAGCTCTCAAGTAGCGGGTAGAGCAGATACGCAGTATTTT	CASSSQVAGRADTQYF	TRBV5-1	TRBJ2-3
TGTGCCAGCAGTCCTTGGACACCCTATGGCTACACCTTC	CASSPWTPYGYTF	TRBV27	TRBJ1-2
TGTGCCAGCAGACGGGGGGGGATAGACTACGAGCAGTACTTC	CASRRGGIDYEQYF	TRBV27	TRBJ2-7
TGCAGTGCTTGGTGCTCGGCTTGTAATTCACCCCTCCACTTT	CSAWCSACNSPLHF	TRBV20-1	TRBJ1-6
TGTGCCAGCAGTGACCGGGGGGACAGGAGGGGGATTTATGAAAAACTGTTTTTT	CASSDRGDRRGIYEKLFF	TRBV6-1	TRBJ1-4
TGCGCCAGCAGGACCGAGGAGCAGTTCTTC	CASRTEEQFF	TRBV10-2	TRBJ2-1
TGTGGGAAGCAGACAGCAGTCGCCTACGAGCAGTACTTC	CGKQTAVAYEQYF	TRBV3-1	TRBJ2-7
TGTGCCAGCAGCTGGTCGGTGTGGACTAGCGCATCAGATACGCAGTATTTT	CASSWSVWTSASDTQYF	TRBV7-8	TRBJ2-3
TGCGCCAGCAGCTTTAAGGAGGACAGGGGAGGGCTGAACACTGAAGCTTTCTTT	CASSFKEDRGGLNTEAFF	TRBV5-1	TRBJ1-1
TGTGCCAGCAGCAGTGGGACAGCTGTAGAAGAGACCCAGTACTTC	CASSSGTAVEETQYF	TRBV7-9	TRBJ2-5
TGTGCCAGCAGTGACTCAAGAGGCGGACAGGGTAAACCACGTGAAAAACTGTTTTTT	CASSDSRGGQGKPREKLFF	TRBV25-1	TRBJ1-4
TGCAGTGCTTCGGGGGGCCTCATCGGCCTCTCCTACAATGAGCAGTTCTTC	CSASGGLIGLSYNEQFF	TRBV20-1	TRBJ2-1
TGTGCTAGTGGTTTACCGGGCGGGGGCACGGCCTACGAGCAGTACTTC	CASGLPGGGTAYEQYF	TRBV12-5	TRBJ2-7
TGCAGCGTTGGGGTAGAGGGGAGGTTAGATGAGCAGTTCTTC	CSVGVEGRLDEQFF	TRBV29-1	TRBJ2-1
TGCAGTGCAGTTAAAAGGAACGAGCAGTACTTC	CSAVKRNEQYF	TRBV20-1	TRBJ2-7
TGCAGTGCTAGAGTACTTAGACAAATCACCGGGGAGCTGTTTTTT	CSARVLRQITGELFF	TRBV20-1	TRBJ2-2
TGCAAAGACAAACTAGCGGGAGGGCCATGTACCGGGGAGCTGTTTTTT	CKDKLAGGPCTGELFF	TRBV20-1	TRBJ2-2
TGTGCCACCAGGATAGGTAGTTCAGGGGAATGGTATGGCTACACCTTC	CATRIGSSGEWYGYTF	TRBV24-1	TRBJ1-2
TGTGCCAGCAGATCTACCCCCGGGACAGCCCCATACCTGCAGTACTTC	CASRSTPGTAPYLQYF	TRBV6-5	TRBJ2-7
TGCAGCGCATCGTGGGACAGGGGGAACACTGAAGCTTTCTTT	CSASWDRGNTEAFF	TRBV29-1	TRBJ1-1
TGTGCCAGCAGCCCCCGGAAGAACACTGAAGCTTTCTTT	CASSPRKNTEAFF	TRBV7-9	TRBJ1-1
TGTGCCAGCAGCAATTTCAGGGACAGCTACACTGAAGCTTTCTTT	CASSNFRDSYTEAFF	TRBV7-4	TRBJ1-1
TGTGCCAGCAGCCGGGGCCACAATGAGCAGTTCTTC	CASSRGHNEQFF	TRBV5-4	TRBJ2-1
TGTGCCAGCACAGGGACAGTCCGGACCTACGAGCAGTACTTC	CASTGTVRTYEQYF	TRBV2	TRBJ2-7
TGTGCCACCAGCGTACCACTAGCGGGAGTCGAGAACACCGGGGAGCTGTTTTTT	CATSVPLAGVENTGELFF	TRBV15	TRBJ2-2
TGTGCCAGCTTGGGACGTGGTCCCTACGAGCAGTACTTC	CASLGRGPYEQYF	TRBV9	TRBJ2-7
TGCGCCAGCAGCTTTAGACAGGGGTGGAACTATGGCTACACCTTC	CASSFRQGWNYGYTF	TRBV5-1	TRBJ1-2
TGTGCCATTAAGATTCCCTCTTCCGGGGTCTATAGCAATCAGCCCCAGCATTTT	CAIKIPSSGVYSNQPQHF	TRBV6-5	TRBJ1-5
TGTGCCAGCACTAGGTGGGGGGCGCAGTACTTC	CASTRWGAQYF	TRBV6-5	TRBJ2-7
TGTGCCAGCAGTGCTGTTTCGAGTATGGGTGAGCGGCAAGAGACCCAGTACTTC	CASSAVSSMGERQETQYF	TRBV25-1	TRBJ2-5
TGTGCCACCAGTGATACCCCCCCACCGGGACTGGGTAGCTCCTACAATGAGCAGTTCTTC	CATSDTPPPGLGSSYNEQFF	TRBV24-1	TRBJ2-1
TGTGCCAGCAGTCGGACGGGGGTATCTGAAGCTTTCTTT	CASSRTGVSEAFF	TRBV6-1	TRBJ1-1
TGTGCCAGCAGTTTATGTGGGGGGCTGACGACCGAGAGGAGCTCCTATAATTCACCCCTCCACTTT	CASSLCGGLTTERSSYNSPLHF	TRBV28	TRBJ1-6
TGTGCCAGCAGCTTAGTAGCGGGGAACAACTACGAGCAGTACTTC	CASSLVAGNNYEQYF	TRBV11-2	TRBJ2-7
TGTGCCAGCAGCTTATTCTTATTCGGAACAGATACGCAGTATTTT	CASSLFLFGTDTQYF	TRBV11-2	TRBJ2-3
TGTGCCAGCGTATGGGAACAGGGGGCGGTAACCCTCCACTTT	CASVWEQGAVTLHF	TRBV27	TRBJ1-6
TGTGCCAGCAGCAGGATGAGAGGGGGCTACGAGCAGTACTTC	CASSRMRGGYEQYF	TRBV7-3	TRBJ2-7
TGCGCCAGCAGCCCCAAGGACAGGGAGAATTCACCCCTCCACTTT	CASSPKDRENSPLHF	TRBV4-1	TRBJ1-6
TGCAGCGTTGAACGGGGGGGAATTTATAATGAGCAGTTCTTC	CSVERGGIYNEQFF	TRBV29-1	TRBJ2-1
TGTGCCAACACTAGGGATGAGCAGTTCTTC	CANTRDEQFF	TRBV7-9	TRBJ2-1
TGTGCCGGGACTGACACTGAAGCTTTCTTT	CAGTDTEAFF	TRBV6-4	TRBJ1-1
TGTGCCAGTATTTTGAACACTGAAGCTTTCTTT	CASILNTEAFF	TRBV10-3	TRBJ1-1
TGTGCCAGGTGGGGGGATACGCAGTATTTT	CARWGDTQYF	TRBV28	TRBJ2-3
TGTGCCAGCAGTGCTTCCATTAGTCAGCCCCAGCATTTT	CASSASISQPQHF	TRBV2	TRBJ1-5
TGCGCCAGCAGTTCCCCATTAAACACGACAGGGAAGGACGAGCAGTACTTC	CASSSPLNTTGKDEQYF	TRBV10-1	TRBJ2-7
TGCGCCAGCAGCGGGAGCGACGGCTACACCTTC	CASSGSDGYTF	TRBV4-3	TRBJ1-2
TGTGCCAGCAGCTTACTTCGGGGGGATGAAGCTTTCTTT	CASSLLRGDEAFF	TRBV7-3	TRBJ1-1
TGTGCCAGCAGCTATGGTCTGACAGTAAAAAATGGCTACACCTTC	CASSYGLTVKNGYTF	TRBV13	TRBJ1-2
TGTGCCAGCAGTAAGACTCCGGGACAGGGAGGACGATACGAGCAGTACTTC	CASSKTPGQGGRYEQYF	TRBV6-2	TRBJ2-7
TGTGAACCCCCCGACAGGGGGCCAGGCACTGAAGCTTTCTTT	CEPPDRGPGTEAFF	TRBV6-4	TRBJ1-1
TGTGCCAGCAGGGACCAGGGGAGCGAGGAGAACACTGAAGCTTTCTTT	CASRDQGSEENTEAFF	TRBV5-5	TRBJ1-1
TGTGCCAGCAGCGTAACAGGGGGCGGTACAGGTCCCCAGCATTTT	CASSVTGGGTGPQHF	TRBV7-3	TRBJ1-5
TGTGCCACATTATACAGGCCGAACACTGAAGCTTTCTTT	CATLYRPNTEAFF	TRBV11-2	TRBJ1-1
TGTGCCAGCAGTGTTGACGGGACAGTAGACCGGACTATGAACACTGAAGCTTTCTTT	CASSVDGTVDRTMNTEAFF	TRBV6-2	TRBJ1-1
TGTGCCAGCAGCCAAGTGCCAAGACTGGAGCAGTACTTC	CASSQVPRLEQYF	TRBV14	TRBJ2-7
TGCAGCGTTGAAACACCGGGACCTACAGATACGCAGTATTTT	CSVETPGPTDTQYF	TRBV29-1	TRBJ2-3
TGTGCCAGCAGCTGGGCCCGGACTGAGCAGTTCTTC	CASSWARTEQFF	TRBV5-6	TRBJ2-1
TGCGCCAGCAGAAAACAGGGGAGCAGCAATCAGCCCCAGCATTTT	CASRKQGSSNQPQHF	TRBV4-1	TRBJ1-5
TGTGCCAGCAGCTTAACTGGGACAGGTCCGACGATGCTGTTTTTT	CASSLTGTGPTMLFF	TRBV13	TRBJ2-2
TGTGCCAGCAGAACGGGCGCGTCCTCTAGCGGGACTTCCTCCTACAATGAGCAGTTCTTC	CASRTGASSSGTSSYNEQFF	TRBV25-1	TRBJ2-1
TGTGCCAGACAGGGTGGGGTCACCGGGGAGCTGTTTTTT	CARQGGVTGELFF	TRBV19	TRBJ2-2
TGTGCCAGCAGTATCACTAGCGGGAACTCCTACGAGCAGTACTTC	CASSITSGNSYEQYF	TRBV28	TRBJ2-7
TGTGCCAGCAGCTTACGACAGGGGGCAAAGGATAGCACAGATACGCAGTATTTT	CASSLRQGAKDSTDTQYF	TRBV11-3	TRBJ2-3
TGTGCCACCCGGGAAAGGGGCTACGAGCAGTACTTC	CATRERGYEQYF	TRBV24-1	TRBJ2-7
TGTGCCAGCAGGTTCAGGGGCAATCAGCCCCAGCATTTT	CASRFRGNQPQHF	TRBV6-1	TRBJ1-5
TGTGCCAGCAGTCCCGAAAGCGGGACTAGCGGGTACGCAGATACGCAGTATTTT	CASSPESGTSGYADTQYF	TRBV6-1	TRBJ2-3
TGTGCCAGCAGCCCTAAGTTCCGGGACTCCACAGATACGCAGTATTTT	CASSPKFRDSTDTQYF	TRBV11-3	TRBJ2-3
TGCGCCAGCAGCAAAGGGGGCACTCCTGAAGCTTTCTTT	CASSKGGTPEAFF	TRBV4-1	TRBJ1-1
TGTGCTAGTGGTTTGGCCGTCGGGCGGGGGGGGCGGCAGTTCTTC	CASGLAVGRGGRQFF	TRBV12-5	TRBJ2-1
TGTGCCAGCTCACCCAAGACAGGCGGGTACTCCTACGAGCAGTACTTC	CASSPKTGGYSYEQYF	TRBV18	TRBJ2-7
TGTGCCGTCCCAGGGGGAATTCAAGTTGTCTCGTTTCGCTCTGGCTACACCTTC	CAVPGGIQVVSFRSGYTF	TRBV7-8	TRBJ1-2
TGCAGTGCTAGCTACCTAGGGGGGCAGGGGGCTCCTGGGGCCAACGTCCTGACTTTC	CSASYLGGQGAPGANVLTF	TRBV20-1	TRBJ2-6
TGTGCCAGCAGCGGCTCCGGGGCCTTAGCTTTCTTT	CASSGSGALAFF	TRBV13	TRBJ1-1
TGTGCCAGCAGCCACAGGGGACAACTGTTTTTT	CASSHRGQLFF	TRBV14	TRBJ1-4
TGCGCCAGCAGCTTGGCGGGACAGGTAGCAGATACGCAGTATTTT	CASSLAGQVADTQYF	TRBV5-1	TRBJ2-3
TGCAGCGTTCTAGCGGGATGTATCCAAGAGACCCAGTACTTC	CSVLAGCIQETQYF	TRBV29-1	TRBJ2-5
TGTGCCATAGCCCGGTCGGGGGGCGATGAAGCTTTCTTT	CAIARSGGDEAFF	TRBV28	TRBJ1-1
TGCGCCAGCAGCTTCGACACTGAAGCTTTCTTT	CASSFDTEAFF	TRBV5-1	TRBJ1-1
TGTGCCAGCAGTGAATCCGCCCTAAGGGAATTTGGCTACACCTTC	CASSESALREFGYTF	TRBV2	TRBJ1-2
TGTGCCAGCAGCTCAGGGGGCGCAGGCAATCAGCCCCAGCATTTT	CASSSGGAGNQPQHF	TRBV7-9	TRBJ1-5
TGTGCCAGCAGCTTCCGTCACAGGGTTAGAGAAAAACTGTTTTTT	CASSFRHRVREKLFF	TRBV7-9	TRBJ1-4
TGTGCCAGCTCATGGGTGGCGGACAGCACCGGGGAGCTGTTTTTT	CASSWVADSTGELFF	TRBV18	TRBJ2-2
TGCAGTGCTAGGTTAAAGCGCAGCTTTAGCTCCTACGAGCAGTACTTC	CSARLKRSFSSYEQYF	TRBV20-1	TRBJ2-7
TGTGCCAGCAGTAAGCTACGCTCTGGGGCCAACGTCCTGACTTTC	CASSKLRSGANVLTF	TRBV28	TRBJ2-6
TGTGCCAGCAGTGACCCCTGTATTGCACCGTCCCCTGAAGCTTTCTTT	CASSDPCIAPSPEAFF	TRBV6-1	TRBJ1-1
TGTGCCATCAGTGTTAACGAGGAAGCTTTCTTT	CAISVNEEAFF	TRBV10-3	TRBJ1-1
TGTGCCACCAGGTCCCGAAATATGGGGATGGGGGTGGATGAGCAGTTCTTC	CATRSRNMGMGVDEQFF	TRBV24-1	TRBJ2-1
TGTGCCAGCAGGTCCGGGACCGGGACTGCTAGAGAGACCCAGTACTTC	CASRSGTGTARETQYF	TRBV27	TRBJ2-5
TGTGCCAGCAGTTACCCCTGTAACTCTAGCGGGTTCTGGGCCTCCTACAATGAGCAGTTCTTC	CASSYPCNSSGFWASYNEQFF	TRBV6-9	TRBJ2-1
TGTGCCACCAGTGACAGGGGAATCCTGAACACCGGGGAGCTGTTTTTT	CATSDRGILNTGELFF	TRBV24-1	TRBJ2-2
TGTGCCTGGTGGGACTACGAGCAGTACTTC	CAWWDYEQYF	TRBV30	TRBJ2-7
TGTGCCAGCAGCTTAGGAAACGTCAGGGGGGGGGGCCGCCTCAGGGCTGAGCAGTTCTTC	CASSLGNVRGGGRLRAEQFF	TRBV11-3	TRBJ2-1
TGTGCCTGGACTGGGGACAGGGGCAACAATGAAAAACTGTTTTTT	CAWTGDRGNNEKLFF	TRBV30	TRBJ1-4
TGTGCCAGCAGCGCTACGGGTTCCTACGAGCAGTACTTC	CASSATGSYEQYF	TRBV7-3	TRBJ2-7
TGTGCCAGCAGCTTAAGAGCAAAGACAGGGGGCGCCCACGAGCAGTACTTC	CASSLRAKTGGAHEQYF	TRBV7-3	TRBJ2-7
TGCGCCAGCAGCTTGAGACAGGAGAGCCGAACTAATGAAAAACTGTTTTTT	CASSLRQESRTNEKLFF	TRBV5-1	TRBJ1-4
TGTGCCAGCAGTTTACTCGAAGGACCCAGGGGGAGCTCCTATAATTCACCCCTCCACTTT	CASSLLEGPRGSSYNSPLHF	TRBV27	TRBJ1-6
TGTGCCAGCAGCGCGGGAGGGGGATTCTACACCATATATTTT	CASSAGGGFYTIYF	TRBV9	TRBJ1-3
TGTGCCAGCAGTGACAAGGACAGGGGGCGGAAAAATCAGCCCCAGCATTTT	CASSDKDRGRKNQPQHF	TRBV6-4	TRBJ1-5
TGCAGCGTTCTGACGGGTACCACTGAAGCTTTCTTT	CSVLTGTTEAFF	TRBV29-1	TRBJ1-1
TGTGCCAGCGAGCAGGGGCAAGAGACCCAGTACTTC	CASEQGQETQYF	TRBV2	TRBJ2-5
TGTGCCAGCAGCGTAGTCTTACAGGGTGGCCAGGTCGGTTCCAGCTCCTATAATTCACCCCTCCACTTT	CASSVVLQGGQVGSSSYNSPLHF	TRBV9	TRBJ1-6
TGTGCCAGTAGTATACAAGGTTATTTACACGAAAAACTGTTTTTT	CASSIQGYLHEKLFF	TRBV19	TRBJ1-4
TGTGCCAGCTGTCCCGGGACTAGGGAGAACTACAATGAGCAGTTCTTC	CASCPGTRENYNEQFF	TRBV6-1	TRBJ2-1
TGTGCCAGCAGCCCCCAGCCAGGAAGCGAGCAGTACTTC	CASSPQPGSEQYF	TRBV9	TRBJ2-7
TGTGCCAGCAAGGCCCGGGACAGGGGGATGAGGCAGCCCCAGCATTTT	CASKARDRGMRQPQHF	TRBV7-9	TRBJ1-5
TGCGCCAGCAGCTTGAAAACCCAAGCAGGGACTGAAAAACTGTTTTTT	CASSLKTQAGTEKLFF	TRBV5-1	TRBJ1-4
TGTGCCATCCGCCCTGACAGGATCGCCGACGAGCAGTACTTC	CAIRPDRIADEQYF	TRBV28	TRBJ2-7
TGTGCCAGCAGCTTAACCGGAAGGCTATACTACGAGCAGTACTTC	CASSLTGRLYYEQYF	TRBV7-3	TRBJ2-7
TGTGCCAGCAGACCCAGGGGGTACGAGCAGTACTTC	CASRPRGYEQYF	TRBV28	TRBJ2-7
TGTGCCAGCAGCCTCAGGGGGGGCATTAACAATGAGCAGTTCTTC	CASSLRGGINNEQFF	TRBV4-2	TRBJ2-1
TGCAGTGCTAGAGCACGGGGGGAAGAGACCCAGTACTTC	CSARARGEETQYF	TRBV20-1	TRBJ2-5
TGCAGCGTAAGGTTGACTAGCGGGGGGCGGCCGGGCGAGTACAATGAGCAGTTCTTC	CSVRLTSGGRPGEYNEQFF	TRBV29-1	TRBJ2-1
TGTGCCAGCAGTGACAGGGACAGGTGGGGAAATCAGCCCCAGCATTTT	CASSDRDRWGNQPQHF	TRBV6-2	TRBJ1-5
TGCGCCAGCAGGGGCTATAATTCACCCCTCCACTTT	CASRGYNSPLHF	TRBV10-1	TRBJ1-6
TGTGCCACCACCCAAAGGGGGGGCGGAACTAGCACAGATACGCAGTATTTT	CATTQRGGGTSTDTQYF	TRBV24-1	TRBJ2-3
TGCGCCAGCAGCGAATATGGCCGAACTGGGGCCAACGTCCTGACTTTC	CASSEYGRTGANVLTF	TRBV5-1	TRBJ2-6
TGTGCCAGCAGTTACGGGGGGACAGCGTACACAGATACGCAGTATTTT	CASSYGGTAYTDTQYF	TRBV6-5	TRBJ2-3
TGCGCCAAGGCCGGGACAATTGGAAGCTCCTACGAGCAGTACTTC	CAKAGTIGSSYEQYF	TRBV5-1	TRBJ2-7
TGTGCCAGCAGCCAAGAAGCACTAGGCGGGGATACGCAGTATTTT	CASSQEALGGDTQYF	TRBV3-1	TRBJ2-3
TGTGCCAGCAGCGCCCTTTCGCGGAAAGATACGCAGTATTTT	CASSALSRKDTQYF	TRBV9	TRBJ2-3
TGTGCCAGCAGCCCCCTGGTGGGGGAGTTTAATCGCGAGCAGTACTTC	CASSPLVGEFNREQYF	TRBV11-2	TRBJ2-7
TGCGCCAGCATTAATCGTCCGGGAGGATCCTACGAGCAGTACTTC	CASINRPGGSYEQYF	TRBV10-2	TRBJ2-7
TGTGCCAGCAGCGTAGGTTCCGCCGGGACTAGCGGGAGACTGGGGGCCCACGAGCAGTACTTC	CASSVGSAGTSGRLGAHEQYF	TRBV9	TRBJ2-7
TGTGCCAGCTCACCCAGGGGAAAGAACACTGAAGCTTTCTTT	CASSPRGKNTEAFF	TRBV18	TRBJ1-1
TGTGCTAGCGGTGATTCTAGGGGTAACTCCTACGAGCAGTACTTC	CASGDSRGNSYEQYF	TRBV7-7	TRBJ2-7
TGTGCCTCCATAGCTAACTATGGCTACACCTTC	CASIANYGYTF	TRBV7-8	TRBJ1-2
TGCGCCAGCAGCGTGACAGTTGGGCAGCCCCAGCATTTT	CASSVTVGQPQHF	TRBV5-1	TRBJ1-5
TGTGCCACCAGTGATTTGGGGGAGGCCCAGCATTTT	CATSDLGEAQHF	TRBV24-1	TRBJ1-5
TGTGCCAGCAGCCAGGAGAGGGGGCGCGCTGGAAACACCATATATTTT	CASSQERGRAGNTIYF	TRBV14	TRBJ1-3
TGTGCCAGCAGGGGGCATCGCCAAGAGACCCAGTACTTC	CASRGHRQETQYF	TRBV6-5	TRBJ2-5
TGCAGTGCTAGAGGGGGGACTATATGCAGTGAGCAGTTCTTC	CSARGGTICSEQFF	TRBV20-1	TRBJ2-1
TGCGCCAGCCCAGGGGGCGGGCCCCAGCATTTT	CASPGGGPQHF	TRBV10-1	TRBJ1-5
TGTGCCAGCAGCTTAGAATGCCTCCTTAATGAAAAACTGTTTTTT	CASSLECLLNEKLFF	TRBV11-2	TRBJ1-4
TGTGCTAGTGGTTTCGAATTTAGGGGTACTGCTTTCTTT	CASGFEFRGTAFF	TRBV12-5	TRBJ1-1
TGTGCCAGCAAAGTGTACCAGCCCCAGCATTTT	CASKVYQPQHF	TRBV12-4	TRBJ1-5
TGTGCCAGCAGCTTAGGGCGGCGGGAGAATTACGAGCAGTACTTC	CASSLGRRENYEQYF	TRBV11-1	TRBJ2-7
TGTGCCAGCAGCACTGGAGATGGCTACACCTTC	CASSTGDGYTF	TRBV9	TRBJ1-2
TGTGCCAGCAGACTAGCGGTACTAAGTGCCTACGAGCAGTACTTC	CASRLAVLSAYEQYF	TRBV12-4	TRBJ2-7
TGTGCCAGACCGGGAAAGAGCAATCAGCCCCAGCATTTT	CARPGKSNQPQHF	TRBV28	TRBJ1-5
TGTGCCAGCAGCTTAGTGGATGGGACGGAGACCGCTTTCTTT	CASSLVDGTETAFF	TRBV7-3	TRBJ1-1
TGTGCCAGCAGTGGACTAGCGGGAGTCCGCTACGAGCAGTACTTC	CASSGLAGVRYEQYF	TRBV6-5	TRBJ2-7
TGTGCCAGCTTCGGGGAAAACACCGGGGAGCTGTTTTTT	CASFGENTGELFF	TRBV6-4	TRBJ2-2
TGTGCTAGTGGTTTGGTGACCCAGTGGGCACCCCTCCACTTT	CASGLVTQWAPLHF	TRBV12-5	TRBJ1-6
TGTGCCAGCAGCTTAGCTGAAGGACCGGGACTCGTTGGCTACACCTTC	CASSLAEGPGLVGYTF	TRBV13	TRBJ1-2
TGTGCCAGCAGGGCTCGACAGGCCTCCTACAATGAGCAGTTCTTC	CASRARQASYNEQFF	TRBV6-5	TRBJ2-1
TGTGCCAGTAGTATAGATTTAGCGGGAGTGACCCAGTACTTC	CASSIDLAGVTQYF	TRBV19	TRBJ2-5
TGCGCCAGCAGCTCACTAGCGGGTAGGCACAATGAGCAGTTCTTC	CASSSLAGRHNEQFF	TRBV5-1	TRBJ2-1
TGTGCCACCAGCGGTCCGGGACAATGTACTAATGAAAAACTGTTTTTT	CATSGPGQCTNEKLFF	TRBV15	TRBJ1-4
TGTGCCAGCAGCTTTAACGAGCAGTACTTC	CASSFNEQYF	TRBV11-3	TRBJ2-7
TGTGCCAGCAGCGGGGCTTCCCTTGAATCTGGGGCCAACGTCCTGACTTTC	CASSGASLESGANVLTF	TRBV5-6	TRBJ2-6
TGTGCCAGCAGTACCGGGACAGGCAATCAGCCCCAGCATTTT	CASSTGTGNQPQHF	TRBV27	TRBJ1-5
TGTGCCAGCAGTGGAACTTCGACAGGGGGCGTCTCCTATAATTCACCCCTCCACTTT	CASSGTSTGGVSYNSPLHF	TRBV2	TRBJ1-6
TGTGCCACCGGGGGGGAAGGCCACGGGGAGCTGTTTTTT	CATGGEGHGELFF	TRBV6-5	TRBJ2-2
TGTGCCAGCAGGCCGGGACATAACAATAATTCACCCCTCCACTTT	CASRPGHNNNSPLHF	TRBV6-6	TRBJ1-6
TGTGCCAGCAGCGTGGTAGACAAGGAGTACGAGCAGTACTTC	CASSVVDKEYEQYF	TRBV12-4	TRBJ2-7
TGTGCCAGCAGCGGTGCGGTAATCACTGAAGCTTTCTTT	CASSGAVITEAFF	TRBV11-2	TRBJ1-1
TGTGCCAGCAGGAGTGGAGGGCCGGGGGGGTCCTACAATGAGCAGTTCTTC	CASRSGGPGGSYNEQFF	TRBV6-6	TRBJ2-1
TGTGCCAGGAAGACGAGGAAGGACCGAGCTAACTATGGCTACACCTTC	CARKTRKDRANYGYTF	TRBV3-1	TRBJ1-2
TGTGCCAGCAGTGACGTAAGGGGGGTCACCTTC	CASSDVRGVTF	TRBV6-2	TRBJ1-2
TGTGCCAGCACCCCGACAGGGTGTGACACTGAAGCTTTCTTT	CASTPTGCDTEAFF	TRBV7-2	TRBJ1-1
TGTGCCAGCAGTGAATATAGTTTAAGGCTCGCCCCTAATACGCAGTATTTT	CASSEYSLRLAPNTQYF	TRBV25-1	TRBJ2-3
TGTGCCAGCAGCTTAGGGGGGGCTTTTAGCTACGAGCAGTACTTC	CASSLGGAFSYEQYF	TRBV7-2	TRBJ2-7
TGTGCCAGCAGTAAGCAGGACATCCACGAGCAGTACTTC	CASSKQDIHEQYF	TRBV25-1	TRBJ2-7
TGCGCCAGCAGCTTGCCGGTATCATGTGGACAGGGGGGGGAGCCCCAGCATTTT	CASSLPVSCGQGGEPQHF	TRBV5-1	TRBJ1-5
TGTGCCAGCAGATCCACAGGGCTTTTATCAATGGCCACAGATACGCAGTATTTT	CASRSTGLLSMATDTQYF	TRBV28	TRBJ2-3
TGTAGGGGGGTTAGGATGAACACTGAAGCTTTCTTT	CRGVRMNTEAFF	TRBV19	TRBJ1-1
TGTGCCACCAGGTGTACCCCCACACAAGAGACCCAGTACTTC	CATRCTPTQETQYF	TRBV24-1	TRBJ2-5
TGTGCCAGCTCACCGCTGGGACAGGGGGCTGGGGTCGTAAACACTGAAGCTTTCTTT	CASSPLGQGAGVVNTEAFF	TRBV18	TRBJ1-1
TGCAGTGCCCAGAGGATATTCTACAATGAGCAGTTCTTC	CSAQRIFYNEQFF	TRBV20-1	TRBJ2-1
TGTGCCAGCTCACCCAACAGGGGGGCGACTAGCTCCTACAATGAGCAGTTCTTC	CASSPNRGATSSYNEQFF	TRBV18	TRBJ2-1
TGTGCCAGCAGTGACTCGCAACTAGCGGAAGGAGAGACCCAGTACTTC	CASSDSQLAEGETQYF	TRBV6-4	TRBJ2-5
TGTGCCAGCAGCTTGCCAGTCACTGAAGCTTTCTTT	CASSLPVTEAFF	TRBV5-6	TRBJ1-1
TGTGCCAGCAGTGTTTGTTTCAGACGCAACACTGAAGCTTTCTTT	CASSVCFRRNTEAFF	TRBV6-4	TRBJ1-1
TGTGCCAGCAGCACGGGGGGGAAGACCCACACCGGGGAGCTGTTTTTT	CASSTGGKTHTGELFF	TRBV9	TRBJ2-2
TGTGCTAGTGGAAGGCAGGGCATAAAGATGAGCAATCAGCCCCAGCATTTT	CASGRQGIKMSNQPQHF	TRBV12-5	TRBJ1-5
TGTGCCAGCAGTCTTTTCAGGGTTCCGGGCTTT	CASSLFRVPGF	TRBV6-5	TRBJ1-1
TGTGCCAGCAGTTTAGCGGGGAACCCCTACAATGAGCAGTTCTTC	CASSLAGNPYNEQFF	TRBV13	TRBJ2-1
TGCGCCAGCAGCCAAGGACTAGGGGCGAACTACGAGCAGTACTTC	CASSQGLGANYEQYF	TRBV4-1	TRBJ2-7
TGTGCCAGCAGTGGGCTTACAGCTTTCTTT	CASSGLTAFF	TRBV6-2	TRBJ1-1
TGCGCCAGCAGCCAAACCGTCAACGGGGGAGGGGACCAAGAGACCCAGTACTTC	CASSQTVNGGGDQETQYF	TRBV4-1	TRBJ2-5
TGTGCCAGCAGTTACGGACGGACTAGCGGGCCCGACCCGAACACCGGGGAGCTGTTTTTT	CASSYGRTSGPDPNTGELFF	TRBV6-5	TRBJ2-2
TGTGCCAGCAGTGGGGGGACCAGATGGTACAATGAGCAGTTCTTC	CASSGGTRWYNEQFF	TRBV6-5	TRBJ2-1
TGTGTGTCCGTGGTACTGACTTTC	CVSVVLTF	TRBV3-1	TRBJ2-6
TGTGCCAGCAGCCAAGAATCCCGGCAACTTCCAGATACGCAGTATTTT	CASSQESRQLPDTQYF	TRBV3-1	TRBJ2-3
TGTGCCAGCAGGGACAGGGGGCAAACTCGGTACACTGAAGCTTTCTTT	CASRDRGQTRYTEAFF	TRBV2	TRBJ1-1
TGTGCCAGCAGCATGAGGCGCGGGAGGGACCTAAGAGCATACAATGAGCAGTTCTTC	CASSMRRGRDLRAYNEQFF	TRBV5-5	TRBJ2-1
TGTGCCAGCAGCGTAGAACTTGACTTTGTCGATAGTACTGAGCAGTTCTTC	CASSVELDFVDSTEQFF	TRBV9	TRBJ2-1
TGTGCTAGCAGCGTCCGAGACAGGGCATTTTCCTATAATTCACCCCTCCACTTT	CASSVRDRAFSYNSPLHF	TRBV7-7	TRBJ1-6
TGTGCCAGCAGCCAAGCGGGATTTGGGGGCGGATCGAACACTGAAGCTTTCTTT	CASSQAGFGGGSNTEAFF	TRBV3-1	TRBJ1-1
TGTGCCAGCAGTTACGAGCAAAGGGTCAACTATGGCTACACCTTC	CASSYEQRVNYGYTF	TRBV6-5	TRBJ1-2
TGTGCCAGCAGCCGATTGGGTGGGGGTAGCCTTTGGGCCTACGAGCAGTACTTC	CASSRLGGGSLWAYEQYF	TRBV3-1	TRBJ2-7
TGTGCCAGCAGCTTACTGGGGGATTGGGACAACACTGAAGCTTTCTTT	CASSLLGDWDNTEAFF	TRBV11-3	TRBJ1-1
TGTGCCAGCACCAGACCGGTTAAGGGACAGGGGGCTGGGGAACGCCGGAATCAGCCCCAGCATTTT	CASTRPVKGQGAGERRNQPQHF	TRBV7-4	TRBJ1-5
TGTGCCAGGGGTCAACTAGCATACAATGAGCAGTTCTTC	CARGQLAYNEQFF	TRBV7-3	TRBJ2-1
TGTGCCAGCAGTGAGGCAACCAGGGGAGGTTCTAATCAGCCCCAGCATTTT	CASSEATRGGSNQPQHF	TRBV6-1	TRBJ1-5
TGTGCTAGCACCTTTTTAGAGTGGCCGTGGCTTAGCTCCTATAATTCACCCCTCCACTTT	CASTFLEWPWLSSYNSPLHF	TRBV7-7	TRBJ1-6
TGTGCCAGCAGTTTTCCGGGACAGGGTTTAGAGACCCAGTACTTC	CASSFPGQGLETQYF	TRBV28	TRBJ2-5
TGTGCCAGCAGCGTAGGGCAGGGAATCACTGAAGCTTTCTTT	CASSVGQGITEAFF	TRBV9	TRBJ1-1
TGTGCCAGCAGCTGGGGTGTCCTTAACAATGAGCAGTTCTTC	CASSWGVLNNEQFF	TRBV7-4	TRBJ2-1
TGTGCCAGCAGCCCACACGGTGGGACTAGCGGGGGCTACGAGCAGTACTTC	CASSPHGGTSGGYEQYF	TRBV11-3	TRBJ2-7
TGTGCCAGCAGCCAATTTTTAGGGCGAGGTAACTATGGCTACACCTTC	CASSQFLGRGNYGYTF	TRBV3-1	TRBJ1-2
TGTGCCAGCAGTTCCGCACTTTGGGGCCCCGAGCAGTACTTC	CASSSALWGPEQYF	TRBV6-6	TRBJ2-7
TGTGCCAGCAGTTACACCTGGACTAGCCAAGATACGCAGTATTTT	CASSYTWTSQDTQYF	TRBV6-2	TRBJ2-3
TGTGCCAGCAGTTATGAAGGAACTGAAGTTTTTAGGTGGGGTACCTGTAGCAATCAGCCCCAGCATTTT	CASSYEGTEVFRWGTCSNQPQHF	TRBV6-5	TRBJ1-5
TGTGCCAGCAGCTGGGGGGACAGGGACTTC	CASSWGDRDF	TRBV7-9	TRBJ2-7
TGTGCCAGTAGTATAGATCCACCAGGCGGCCCAACTAATGAAAAACTGTTTTTT	CASSIDPPGGPTNEKLFF	TRBV19	TRBJ1-4
TGTGCCAGCAGGGATGGCCAAGTGTCCTACGAGCAGTACTTC	CASRDGQVSYEQYF	TRBV28	TRBJ2-7
TGTGCCAGCAGTTTATCATTTGGTCAGTCTTTAGGGACGCGAAACACCATATATTTT	CASSLSFGQSLGTRNTIYF	TRBV27	TRBJ1-3
TGTGCCCCACGGGGCCCGCCGATCACTGAAGCTTTCTTT	CAPRGPPITEAFF	TRBV6-5	TRBJ1-1
TGCGCCAGCAGCCAAGATCGAGGGCTGCTATACGAGCAGTACTTC	CASSQDRGLLYEQYF	TRBV4-3	TRBJ2-7
TGTGCCAGCAGCTTAGCGGGATCCACAGATACGCAGTATTTT	CASSLAGSTDTQYF	TRBV2	TRBJ2-3
TGTGCCAGCCACCAAGACAGGGGGAAGAACACTGAAGCTTTCTTT	CASHQDRGKNTEAFF	TRBV6-4	TRBJ1-1
TGTGCCAGTAGTATAGCACAGGGCAATCAGCCCCAGCATTTT	CASSIAQGNQPQHF	TRBV19	TRBJ1-5
TGTGCCAGCAGTTTATCACGCTACGAGCAGTACTTC	CASSLSRYEQYF	TRBV27	TRBJ2-7
TGCGCCAGCAGCTGGACAGGGGGCAGATACACTGAAGCTTTCTTT	CASSWTGGRYTEAFF	TRBV5-1	TRBJ1-1
TGCGCCAGCAGCTTGGGGGGGGGAAGTTATTACGAGCAGTACTTC	CASSLGGGSYYEQYF	TRBV5-1	TRBJ2-7
TGTGCCAGCAGCCAGGTTTGCCGGGACTCCTACGAGCAGTACTTC	CASSQVCRDSYEQYF	TRBV14	TRBJ2-7
TGTGCCACCACCCTCCCCGACAGGGGACAGGCGCATGAGCAGTTCTTC	CATTLPDRGQAHEQFF	TRBV6-4	TRBJ2-1
TGTGCCAGCAGCGACAGCCCGCATTATTGGCATCAGCCCCAGCATTTT	CASSDSPHYWHQPQHF	TRBV7-3	TRBJ1-5
TGTGCCACAATCACTAGGAATGAGCAGTTCTTC	CATITRNEQFF	TRBV6-4	TRBJ2-1
TGTGCCAGCAGAGGAGTGTCGGATAGCACCGGGGAGCTGTTTTTT	CASRGVSDSTGELFF	TRBV6-6	TRBJ2-2
TGTGCCAGCAGCCGACAGGGCGAGCAGTACTTC	CASSRQGEQYF	TRBV7-3	TRBJ2-7
TGCAGTGCTAGAGTATACGCGGGACCACTAGCCAAAAACATTCAGTACTTC	CSARVYAGPLAKNIQYF	TRBV20-1	TRBJ2-4
TGTGCCAGCAGTTATCCCCCGGGGGAAAAACTGTTTTTT	CASSYPPGEKLFF	TRBV6-5	TRBJ1-4
TGTGCCAGCAAAAGGGGGCCAACCGGTGAAGCTTTCTTT	CASKRGPTGEAFF	TRBV6-4	TRBJ1-1
TGTGCCAGCGTCCGGCCGGGACAGGCAAACGGGGAGCTGTTTTTT	CASVRPGQANGELFF	TRBV14	TRBJ2-2
TGTGCCAGCAGTGACGTACCGCCCCGGGACAGGAATAGCAATCAGCCCCAGCATTTT	CASSDVPPRDRNSNQPQHF	TRBV6-4	TRBJ1-5
TGTGCCAGCAGCTTAGATTTCGAGTGCCCTTGGACCCAGTACTTC	CASSLDFECPWTQYF	TRBV7-2	TRBJ2-5
TGTGCCAGCAGCCCCACTAGCGGGCGCTACGAGCAGTACTTC	CASSPTSGRYEQYF	TRBV13	TRBJ2-7
TGTGCCAGCAGCTCTCAGACCGGGACAAGGGTCACCGGGGAGCTGTTTTTT	CASSSQTGTRVTGELFF	TRBV7-9	TRBJ2-2
TGTGCCACCAGTGTGACTAACACTGAAGCTTTCTTT	CATSVTNTEAFF	TRBV24-1	TRBJ1-1
TGCGCCAGCAGCTTGGCGGACAAGGGGACAGTCCCCCGGGCGAGATTTTGGGGCAATCAGCCCCAGCATTTT	CASSLADKGTVPRARFWGNQPQHF	TRBV5-1	TRBJ1-5
TGTGCCAGCAATGCCCCCCCCCTCAGGAGGCGCTCCTACGAGCAGTACTTC	CASNAPPLRRRSYEQYF	TRBV28	TRBJ2-7
TGTGCCACCAATCACGGGGGGGCAGATGAGCAGTTCTTC	CATNHGGADEQFF	TRBV24-1	TRBJ2-1
TGTGCCAGCAGTGTGCTAGCAAATGACGAGCAGTACTTC	CASSVLANDEQYF	TRBV27	TRBJ2-7
TGCAGTGCTCGTCGGAGGGTAGAGACCCAGTACTTC	CSARRRVETQYF	TRBV20-1	TRBJ2-5
TGTGCCAGCAGACGTACGGACCTCCTCTACGAGCAGTACTTC	CASRRTDLLYEQYF	TRBV2	TRBJ2-7
TGTGCCAGCAGCTTAGGCACTGAGGGTACCGGGGAGCTGTTTTTT	CASSLGTEGTGELFF	TRBV7-9	TRBJ2-2
TGCGCCAGCAGTCCCCGGACCTACACGCAGTACTTC	CASSPRTYTQYF	TRBV4-1	TRBJ2-7
TGTGCCATCAGTGAGTCCCGGAGCTCCTATAATTCACCCCTCCACTTT	CAISESRSSYNSPLHF	TRBV10-3	TRBJ1-6
TGTGCCAGCAGACTAACAGGGGAGGAATACGAGCAGTACTTC	CASRLTGEEYEQYF	TRBV6-1	TRBJ2-7
TGTGCCAGTAGGACCCAGGGGGGGGGATTAGACACCGGGGAGCTGTTTTTT	CASRTQGGGLDTGELFF	TRBV19	TRBJ2-2
TGTGCCAGCAGTTTTCAGCTCCCCGACACAGATACGCAGTATTTT	CASSFQLPDTDTQYF	TRBV27	TRBJ2-3
TGTGCAGCCAGACAGGGGAGGTTGAACACTGAAGCTTTCTTT	CAARQGRLNTEAFF	TRBV7-3	TRBJ1-1
TGTGCCTGGAAACCCCGGGGGGGCCATTCGAAGTATTCTAATGAGCAGTTCTTC	CAWKPRGGHSKYSNEQFF	TRBV30	TRBJ2-1
TGTGCCAGCAGCTTACTGTTTATGATCAATGAGCAGTTCTTC	CASSLLFMINEQFF	TRBV5-6	TRBJ2-1
TGTGCCAGCAGTTACTCGATCTTGCCACGCGGGACTAGATCTCCCACTTCAGATACGCAGTATTTT	CASSYSILPRGTRSPTSDTQYF	TRBV6-5	TRBJ2-3
TGTGCCAGCAGCTTCGGGACGTCTTCCGGAGACTATGGCTACACCTTC	CASSFGTSSGDYGYTF	TRBV13	TRBJ1-2
TGTGCCAGCAGCTTCGAAGAAGGGTGGCTCGGGCAGCCCCAGCATTTT	CASSFEEGWLGQPQHF	TRBV5-6	TRBJ1-5
TGTGCCAGCAGCCAAGATGCCCACCCCGGGCGGTATTCCCCCGGGGAGCTGTTTTTT	CASSQDAHPGRYSPGELFF	TRBV3-1	TRBJ2-2
TGTGCCAGCAGCCCAGTGGGACTAGCGGGGGATAGGAACTGGAACACCGGGGAGCTGTTTTTT	CASSPVGLAGDRNWNTGELFF	TRBV7-2	TRBJ2-2
TGCAGTGCTAGGCTGGGGAAAATGACAATAATCTACGAGCAGTACTTC	CSARLGKMTIIYEQYF	TRBV20-1	TRBJ2-7
TGCAGTGCTAGATTTCTCAGTTGTCTAGCGGCCTACGAGCAGTACTTC	CSARFLSCLAAYEQYF	TRBV20-1	TRBJ2-7
TGTGCCAGCAGTTACAGGCATTGGGGGAGCAATCAGCCCCAGCATTTT	CASSYRHWGSNQPQHF	TRBV6-5	TRBJ1-5
TGTGCCAGCAGTTTCTCCTCCCTGCTCACAGATACGCAGTATTTT	CASSFSSLLTDTQYF	TRBV28	TRBJ2-3
TGTGCCACCAGTCTGCGGGGGGGCGAGACCCAGTACTTC	CATSLRGGETQYF	TRBV24-1	TRBJ2-5
TGCAGTGCTAGACCGATTACAGGTTGGGGCTACACCTTC	CSARPITGWGYTF	TRBV20-1	TRBJ1-2
TGTGCCAGCAGTTTAGTAGACTCCTACGAGCAGTACTTC	CASSLVDSYEQYF	TRBV12-3	TRBJ2-7
TGTGCCAGCAGTGAAGCTGCATTCGGGGGGGACGACCAAGAGACCCAGTACTTC	CASSEAAFGGDDQETQYF	TRBV6-1	TRBJ2-5
TGTGCCAGCAGTTCATGGACGGTACTGGGACCTGGGGCCAACGTCCTGACTTTC	CASSSWTVLGPGANVLTF	TRBV27	TRBJ2-6
TGTGCCAGGATCCGCCTCGCCTACAATGAGCAGTTCTTC	CARIRLAYNEQFF	TRBV25-1	TRBJ2-1
TGCAGTGCTAGGGTTCGGGGCCTGATCACAGATACGCAGTATTTT	CSARVRGLITDTQYF	TRBV20-1	TRBJ2-3
TGCAGTGCTAGGGTTCCGGGGGGACAGTACGAGCAGTACTTC	CSARVPGGQYEQYF	TRBV20-1	TRBJ2-7
TGTGCCAGCTCACCTAGATACAGTTGGGTCTATGGCTACACCTTC	CASSPRYSWVYGYTF	TRBV18	TRBJ1-2
TGTGCCAGCAGCGATTCAACTACGGCGGCCTACGAGCAGTACTTC	CASSDSTTAAYEQYF	TRBV9	TRBJ2-7
TGTGCCAGCAGTGCATTAGCCGGACAGGCCAATGAAGCTTTCTTT	CASSALAGQANEAFF	TRBV13	TRBJ1-1
TGTGCCAGCAGTTGTAGCAGGACTTCAACTGAAGCTTTCTTT	CASSCSRTSTEAFF	TRBV27	TRBJ1-1
TGTGCCAGCAGTGACTCTCCGAGGGGGTACTACGAGCAGTACTTC	CASSDSPRGYYEQYF	TRBV6-4	TRBJ2-7
TGCGCCAGCGACCCCGTGGACTCCCTAGGCTACGAGCAGTACTTC	CASDPVDSLGYEQYF	TRBV10-1	TRBJ2-7
TGCAGTGCTAGAGATCTTGCGCCTTATGACGAGCAGTACTTC	CSARDLAPYDEQYF	TRBV20-1	TRBJ2-7
TGTTGCTTTTTCGGGACTAGAGCAGATACGCAGTATTTT	CCFFGTRADTQYF	TRBV20-1	TRBJ2-3
TGCAGTGCTAGGGACAGGGGGCCCTGGAACACTGAAGCTTTCTTT	CSARDRGPWNTEAFF	TRBV20-1	TRBJ1-1
TGTGCCAGCAACTTCCCCCTAAGACGCGGAACCCAAGAGACCCAGTACTTC	CASNFPLRRGTQETQYF	TRBV6-4	TRBJ2-5
TGTGCCAGCAGTTATCCCATGGGAAACACCATATATTTT	CASSYPMGNTIYF	TRBV6-5	TRBJ1-3
TGTGCCAGCAGCTTAGACCCCCGCAGGGGGAGCTGGAACACTGAAGCTTTCTTT	CASSLDPRRGSWNTEAFF	TRBV7-9	TRBJ1-1
TGTGCCAGCAGCAGGGGGACGGCAAGCTCCTATAATTCACCCCTCCACTTT	CASSRGTASSYNSPLHF	TRBV7-6	TRBJ1-6
TGCGCCAGCAGCTTAAGAACGGGACGCAATGCAACTAATGAAAAACTGTTTTTT	CASSLRTGRNATNEKLFF	TRBV5-1	TRBJ1-4
TGTGCCACCATCGACAGGGGGGACACTGAAGCTTTCTTT	CATIDRGDTEAFF	TRBV24-1	TRBJ1-1
TGTGCCAGCAGTGAATGGACAGACCTCACCGGGGAGCTGTTTTTT	CASSEWTDLTGELFF	TRBV25-1	TRBJ2-2
TGTGCCAGCAGACTTGCGGGGGACGGGAGGCGGGGGTTCTCTGGGGCCAACGTCCTGACTTTC	CASRLAGDGRRGFSGANVLTF	TRBV12-3	TRBJ2-6
TGTGCCAGCAGCTTAGCCTCAGGGATACCCAAAAACATTCAGTACTTC	CASSLASGIPKNIQYF	TRBV7-9	TRBJ2-4
TGCAGTGCTGGGGGAGGGAGTACCACAGATACGCAGTATTTT	CSAGGGSTTDTQYF	TRBV20-1	TRBJ2-3
TGTGCCAGCATCGACCTGGGCGGGACTGAAGCTTTCTTT	CASIDLGGTEAFF	TRBV6-2	TRBJ1-1
TGTGCCAGAAACCCTAGCGGGATAGTTAACACCGGGGAGCTGTTTTTT	CARNPSGIVNTGELFF	TRBV11-2	TRBJ2-2
TGTGCCACCAGATGTGGGGACAGATTTCTTGCCACCTACGAGCAGTACTTC	CATRCGDRFLATYEQYF	TRBV24-1	TRBJ2-7
TGTGCCAGCAGCCATCCGGGACAGGGGGCCAAATACGAGCAGTACTTC	CASSHPGQGAKYEQYF	TRBV4-2	TRBJ2-7
TGTGCCAGCAGCACGCGGGAAGCCGGGGAGCTGTTTTTT	CASSTREAGELFF	TRBV7-9	TRBJ2-2
TGCGTCCGGGACAGGGACACTGAAGCTTTCTTT	CVRDRDTEAFF	TRBV20-1	TRBJ1-1
TGTGCAAGGGCCATGTTTAGGGTGGGAAACACCATATATTTT	CARAMFRVGNTIYF	TRBV25-1	TRBJ1-3
TGTGCCAGCAGCGACAGCTACAATGAGCAGTTCTTC	CASSDSYNEQFF	TRBV7-6	TRBJ2-1
TGTGCCAGCAGCAAAGCCCCGGGGGGGGCCGGGGAGTTGCCCACAGAGACCCAGTACTTC	CASSKAPGGAGELPTETQYF	TRBV11-2	TRBJ2-5
TGCAGTGCTAGAGCCCAGGGACTAAACCAGACCCAGTACTTC	CSARAQGLNQTQYF	TRBV20-1	TRBJ2-5
TGTGCCAGACCCCGCAACGGCATAGGAAACACCATATATTTT	CARPRNGIGNTIYF	TRBV27	TRBJ1-3
TGTGCCAGCAGCACCCCGCGTGTCTTC	CASSTPRVF	TRBV9	TRBJ2-1
TGTGCCAGCAGCCGACGGCTAGCGGTTTTCCCCTTGGATGAGCAGTTCTTC	CASSRRLAVFPLDEQFF	TRBV7-6	TRBJ2-1
TGCAGTGCTAGAGAAGGGGACAGAGTCACCTACGAGCAGTACTTC	CSAREGDRVTYEQYF	TRBV20-1	TRBJ2-7
TGCAGTAGCAGAGGGAATAATGGCTACACCTTC	CSSRGNNGYTF	TRBV20-1	TRBJ1-2
TGTGCCAGCAGTCTCAAGGGGGGGACCTACAATGAGCAGTTCTTC	CASSLKGGTYNEQFF	TRBV28	TRBJ2-1
TGTGCATCCCGGGGGGAAGGCCTCTACAATGAGCAGTTCTTC	CASRGEGLYNEQFF	TRBV2	TRBJ2-1
TGTGCCAGCAGTTACGGGAGGGGTGAGCAGTTCTTC	CASSYGRGEQFF	TRBV12-4	TRBJ2-1
TGCGCCAGCAGCTGCCTCGGTCCGAGAGAGAATTCACCCCTCCACTTT	CASSCLGPRENSPLHF	TRBV5-1	TRBJ1-6
TGTGCTAGTGGTCGAGCCGGGAGGGGGCCAGATACGCAGTATTTT	CASGRAGRGPDTQYF	TRBV12-5	TRBJ2-3
TGTGCCAGCAGCTTTGTACCGACAGGAGGCAACTATGGCTACACCTTC	CASSFVPTGGNYGYTF	TRBV7-9	TRBJ1-2
TGTGCCTGCCCGGGGGAGCAGTACTTC	CACPGEQYF	TRBV30	TRBJ2-7
TGCAGCTTCCCAGGGTTCCTCAGTGAGCAGTACTTC	CSFPGFLSEQYF	TRBV29-1	TRBJ2-7
TGTGCTAGTGGTTTATACCGGGAGGGAAAAGGGACTGGGGCCAACGTCCTGACTTTC	CASGLYREGKGTGANVLTF	TRBV12-5	TRBJ2-6
TGTGCCACCGAACGGACTGAAGCTTTCTTT	CATERTEAFF	TRBV24-1	TRBJ1-1
TGCGCCAGCAGCCAAGATAAAGATGGACTAGCGGGGAGTTACAATGAGCAGTTCTTC	CASSQDKDGLAGSYNEQFF	TRBV4-1	TRBJ2-1
TGTGCCAGCAGCTTACGACTTAAGGGGGTCACTAACTATGGCTACACCTTC	CASSLRLKGVTNYGYTF	TRBV11-1	TRBJ1-2
TGTGCCAGCAGAGGGGGTCAGCCCCAGCATTTT	CASRGGQPQHF	TRBV6-3	TRBJ1-5
TGTGCCACCAGCAGGGAGAGGGCCGGGGAGCTGTTTTTT	CATSRERAGELFF	TRBV15	TRBJ2-2
TGCGCCAGCAGCCAAGAGCCTGTCCGGAGGGACGGACTTGTAAATTCACCCCTCCACTTT	CASSQEPVRRDGLVNSPLHF	TRBV4-1	TRBJ1-6
TGTGCCAGCAACGGGGGGGAGGGGACCAATGAGCAGTTCTTC	CASNGGEGTNEQFF	TRBV6-5	TRBJ2-1
TGTGCCAGCAGCGTTATAGCACTAGGGACTAGCGAACGAAAAGAGACCCAGTACTTC	CASSVIALGTSERKETQYF	TRBV9	TRBJ2-5
TGTGCCAGCAGCCACTCGTTCGTAGGGGCCCCGAGGGAGGAAAACTATGGCTACACCTTC	CASSHSFVGAPREENYGYTF	TRBV13	TRBJ1-2
TGTGCCACCAGTGATTTCCCGGGACAGCTTGGGTCACCCCTCCACTTT	CATSDFPGQLGSPLHF	TRBV24-1	TRBJ1-6
TGTGCCACCAGTGATTTTGGGGGACAGGGGAACCTTGAGCAGTACTTC	CATSDFGGQGNLEQYF	TRBV24-1	TRBJ2-7
TGTGCTAGTGGTTTCGGGGCTTGCTACGAGCAGTACTTC	CASGFGACYEQYF	TRBV12-5	TRBJ2-7
TGTGCCAGCAGCGTAGGACCTCTAGGCGGGAGCATAAAAGAGACCCAGTACTTC	CASSVGPLGGSIKETQYF	TRBV9	TRBJ2-5
TGTGCCAGCAGCTTACCCCGGGACGACGCTTTCTTT	CASSLPRDDAFF	TRBV11-2	TRBJ1-1
TGTGCCAGCAGCCGCAAAACTAGCGGGAGGGGAAGGGGCCTGAACACTGAAGCTTTCTTT	CASSRKTSGRGRGLNTEAFF	TRBV13	TRBJ1-1
TGTGCCAGCAGTGGAAGCGGGACAGGGGTTTGCTACAATGAGCAGTTCTTC	CASSGSGTGVCYNEQFF	TRBV6-1	TRBJ2-1
TGTGCCAGCAGCCAAGCCAGGAACTGGGCCTTAGACAATCAGCCCCAGCATTTT	CASSQARNWALDNQPQHF	TRBV14	TRBJ1-5
TGTGCCAGGTCGGCCGGGACTTTTGAAGCTTTCTTT	CARSAGTFEAFF	TRBV6-1	TRBJ1-1
TGTGCCAGCAGCGGCTTCTCTGGAAACACCATATATTTT	CASSGFSGNTIYF	TRBV6-6	TRBJ1-3
TGTGCCACCAGTGATTTGTCATTCGACTCTAACTATGGCTACACCTTC	CATSDLSFDSNYGYTF	TRBV24-1	TRBJ1-2
TGTGCCACTAGGAGGAAAAGGACAGGATGGCAGTTCTTC	CATRRKRTGWQFF	TRBV10-3	TRBJ2-1
TGTGCTAGTGGTTTGGATTCCCCTGCCAAAAACATTCAGTACTTC	CASGLDSPAKNIQYF	TRBV12-5	TRBJ2-4
TGTGCCAGCAGTTTAAACTGGACTAGATTAAACCAAGAGACCCAGTACTTC	CASSLNWTRLNQETQYF	TRBV12-3	TRBJ2-5
TGCGCCAGCAGCATGTCAGCGGGAAAACCGGTACAAAAACTGTTTTTT	CASSMSAGKPVQKLFF	TRBV4-1	TRBJ1-4
TGTGCCAGCAAGCCGGGTATGAACACTGAAGCTTTCTTT	CASKPGMNTEAFF	TRBV12-3	TRBJ1-1
TGTGCCACCCCTCTACCAGGGCCCCGTAGCAATCAGCCCCAGCATTTT	CATPLPGPRSNQPQHF	TRBV6-2	TRBJ1-5
TGCAGTGCCGGAAATGGACAGGGTTACGAGCAGTACTTC	CSAGNGQGYEQYF	TRBV20-1	TRBJ2-7
TGTGCCAGCAGGGGGATGGCAAATGAAAAACTGTTTTTT	CASRGMANEKLFF	TRBV6-3	TRBJ1-4
TGTGCCAGCAGCTTGGTAGCTAAGGGACAGGCCACCAACTATGGCTACACCTTC	CASSLVAKGQATNYGYTF	TRBV5-6	TRBJ1-2
TGTGCCAGCAGTTATAGGGGGCCCGGCTATGGCTACACCTTC	CASSYRGPGYGYTF	TRBV6-3	TRBJ1-2
TGTGCCAGCAGCTATGAACCCGGGACAGGGCAGACTGGGGCCAACGTCCTGACTTTC	CASSYEPGTGQTGANVLTF	TRBV14	TRBJ2-6
TGTGCCAGCAGCACCGGGGAGGGGCCGTGTTATTATAGCAATCAGCCCCAGCATTTT	CASSTGEGPCYYSNQPQHF	TRBV13	TRBJ1-5
TGTGCCAGCTCACCACTGGATAGGGGGGGGGCCAATCAGCCCCAGCATTTT	CASSPLDRGGANQPQHF	TRBV18	TRBJ1-5
TGTGCCACCAGTGATCGCGGGGTATACAATGAGCAGTTCTTC	CATSDRGVYNEQFF	TRBV24-1	TRBJ2-1
TGTGCCAGCAGCCAGTCAGAGGGGTTAGCAACTAATGAAAAACTGTTTTTT	CASSQSEGLATNEKLFF	TRBV3-1	TRBJ1-4
TGCGCCAGCAGCTCAGGGAGGGCTGAGCAGTTCTTC	CASSSGRAEQFF	TRBV5-1	TRBJ2-1
TGCGCCAGGACCCTAGAGGGCTACACCTTC	CARTLEGYTF	TRBV10-2	TRBJ1-2
TGCGCCAGCAGCTTAAGGGACTATGACAATGGCTACACCTTC	CASSLRDYDNGYTF	TRBV5-1	TRBJ1-2
TGTGCCAGCAGCTTAGGCAGCACGGGACTAGCGGGGGAGCCAGATACGCAGTATTTT	CASSLGSTGLAGEPDTQYF	TRBV7-9	TRBJ2-3
TGTGCTAGTGGTTTACCAGGACACATTCAGTACTTC	CASGLPGHIQYF	TRBV12-5	TRBJ2-4
TGTGCCAGCAGTTTCTTAGGGAAGGGGAACACTGAAGCTTTCTTT	CASSFLGKGNTEAFF	TRBV6-1	TRBJ1-1
TGTGCCAGCTCACCACAATCGGCAGATGGCTACACCTTC	CASSPQSADGYTF	TRBV18	TRBJ1-2
TGTGCCAGAACCAACCGGACAGGGGGCGGGAAGCCCCAGCATTTT	CARTNRTGGGKPQHF	TRBV5-6	TRBJ1-5
TGTGCCAGCAGCATTAGGGGGGTACAAGAGACCCAGTACTTC	CASSIRGVQETQYF	TRBV5-8	TRBJ2-5
TGTGCCAGCAGCCATATGGACAGGCATGCAACTAATGAAAAACTGTTTTTT	CASSHMDRHATNEKLFF	TRBV5-4	TRBJ1-4
TGCGCCAGCCGATGGGGGGGTGCGGGAGAGCAGTACTTC	CASRWGGAGEQYF	TRBV10-1	TRBJ2-7
TGTGCCAGCAGCTGGTGGGATCACAATGAGCAGTTCTTC	CASSWWDHNEQFF	TRBV7-2	TRBJ2-1
TGTGTACCTTCGGACAAGACGAACACTGAAGCTTTCTTT	CVPSDKTNTEAFF	TRBV2	TRBJ1-1
TGTGCCAGCTCACCGAGCGAGGGAGTTGGGGGAACTACGATTGAAAAACTGTTTTTT	CASSPSEGVGGTTIEKLFF	TRBV18	TRBJ1-4
TGTGCCAGCAGCCAAGCCCTTCCCCGTATGCAAAGTCTAGCCAAAAACATTCAGTACTTC	CASSQALPRMQSLAKNIQYF	TRBV3-1	TRBJ2-4
TGTGCCAGCAGCTCCAGGGGAGGTAATGATGAGCAGTTCTTC	CASSSRGGNDEQFF	TRBV9	TRBJ2-1
TGTGCCAGCAGCTTAGCGTGGTGCCCTATAGAACTTCCGATGCGGAGAGGTAATTCACCCCTCCACTTT	CASSLAWCPIELPMRRGNSPLHF	TRBV7-4	TRBJ1-6
TGTGCCAGCAGCTCGGCTGGAGGGGCCAACGTCCTGACTTTC	CASSSAGGANVLTF	TRBV5-6	TRBJ2-6
TGCAGTGCTAGAGATTCGGCCCTGAAGGATGAGCAGTTCTTC	CSARDSALKDEQFF	TRBV20-1	TRBJ2-1
TGTGCCAGCAGCCAAGACTTAATTATCCAGGATTCACCCCTCCACTTT	CASSQDLIIQDSPLHF	TRBV3-1	TRBJ1-6
TGTGCCAGCAGCGCCGCGGACAGGGTGAGGAACACTGAAGCTTTCTTT	CASSAADRVRNTEAFF	TRBV11-2	TRBJ1-1
TGTGCCACCAGTGATTTGGGAATAATGCCTATCGCCCCCGCGGACAGTTTCTATAATTCACCCCTCCACTTT	CATSDLGIMPIAPADSFYNSPLHF	TRBV24-1	TRBJ1-6
TGTGCCAGCAGCTGGCGTACTAGCGGGAGACGTAACAGGCGCAATGAGCAGTTCTTC	CASSWRTSGRRNRRNEQFF	TRBV11-2	TRBJ2-1
TGTGCTAGCAGCGCAACGGACACTGAAGCTTTCTTT	CASSATDTEAFF	TRBV7-7	TRBJ1-1
TGTGCCAGTAGTCCCGGACTAGCGTCTTTGGATGAGCAGTTCTTC	CASSPGLASLDEQFF	TRBV19	TRBJ2-1
TGTGCCAGCTCACCGCGGACAGCCAATAGCAATCAGCCCCAGCATTTT	CASSPRTANSNQPQHF	TRBV18	TRBJ1-5
TGCGCCAGCAGCCTAGGCAGGGAGACAGAGACCCAGTACTTC	CASSLGRETETQYF	TRBV5-1	TRBJ2-5
TGTGCCAGCAGCCGCGGACTAGTACCGACGCAGTATTTT	CASSRGLVPTQYF	TRBV3-1	TRBJ2-3
TGTGCCAGCAGGGGAATTGATCAGCCCCAGCATTTT	CASRGIDQPQHF	TRBV27	TRBJ1-5
TGTGCCTGGAGTGTACGTCAACCTCCAGAGGTAGACGGCACAGATACGCAGTATTTT	CAWSVRQPPEVDGTDTQYF	TRBV30	TRBJ2-3
TGTGCCCGGGACAGGGCGGGATGCAATCAGCCCCAGCATTTT	CARDRAGCNQPQHF	TRBV6-4	TRBJ1-5
TGTGCCAGCATTGCGGGCCCCGATGGCTACACCTTC	CASIAGPDGYTF	TRBV12-3	TRBJ1-2
TGTGCCCCCCCCCCGGCGAGCAATCAGCCCCAGCATTTT	CAPPPASNQPQHF	TRBV24-1	TRBJ1-5
TGTGCCAGCAGCTTAGGGGGGACAAGAGGGAGAAACACCATATATTTT	CASSLGGTRGRNTIYF	TRBV7-4	TRBJ1-3
TGTGCCAGCAGTTTATTGGGGCCGGTAGTGGGTTACGAGCAGTACTTC	CASSLLGPVVGYEQYF	TRBV28	TRBJ2-7
TGTGCCAGCAGTTACCTTGGGACAGGGACTGAGCAGTTCTTC	CASSYLGTGTEQFF	TRBV6-3	TRBJ2-1
TGTGCTAGTGGGTTGACAGATGCGGGGAAGGGCGGTAAGATTTACAATGAGCAGTTCTTC	CASGLTDAGKGGKIYNEQFF	TRBV12-5	TRBJ2-1
TGTGCCTGGAACCCAAGCGGGGGGGGAGTGGAGCAGTACTTC	CAWNPSGGGVEQYF	TRBV30	TRBJ2-7
TGTGCCACCAGTGATATACTAGCGGGGCCTGGCACAGATACGCAGTATTTT	CATSDILAGPGTDTQYF	TRBV24-1	TRBJ2-3
TGTGCCAGCAGGGGGTCTAGGAAGTTAGAAAAACTGTTTTTT	CASRGSRKLEKLFF	TRBV11-1	TRBJ1-4
TGTGCCTGTTCCCCTTGGCTTACGACAGGGATGGGCTACGAGCAGTACTTC	CACSPWLTTGMGYEQYF	TRBV30	TRBJ2-7
TGTGCCAGCAGCTTAGGGCTATGGGGGGGCCGGGGATGCATAAATGAGCAGTTCTTC	CASSLGLWGGRGCINEQFF	TRBV7-3	TRBJ2-1
TGTGCCAGCAGCACTCAGGGGGGGAACACCGGGGAGCTGTTTTTT	CASSTQGGNTGELFF	TRBV11-3	TRBJ2-2
TGCAGTGCTAGAGATCCCCCTAGGGGGGCGACCCAGTACTTC	CSARDPPRGATQYF	TRBV20-1	TRBJ2-5
TGTGCCAGCAGCACCCGACTAGCGGGCTCCTACGAGCAGTACTTC	CASSTRLAGSYEQYF	TRBV9	TRBJ2-7
TGTGCCAGCAGCTTGAGGGAAGCGAACACTGAAGCTTTCTTT	CASSLREANTEAFF	TRBV5-4	TRBJ1-1
TGCAGTGCTAGAGATGGTAGCGGTCAGCCCCAGCATTTT	CSARDGSGQPQHF	TRBV20-1	TRBJ1-5
TGTGCCAGCGACCCGGACAGGGGTGCCAAAAACATTCAGTACTTC	CASDPDRGAKNIQYF	TRBV27	TRBJ2-4
TGTGCCAGCAGTCCCCGGGACAGGCACTTTAATGAAAAACTGTTTTTT	CASSPRDRHFNEKLFF	TRBV28	TRBJ1-4
TGCGCCAGCAGCTTGGAGAGCCCCGGACAGGGAGGGACTGGGGCCAACGTCCTGACTTTC	CASSLESPGQGGTGANVLTF	TRBV5-1	TRBJ2-6
TGTGCCAGCAGTCCAGCGGGAGGTGACACAGATACGCAGTATTTT	CASSPAGGDTDTQYF	TRBV7-3	TRBJ2-3
TGCGCCAGCAGTGAGGGGAGCCACAGGGCTGGAAACACCATATATTTT	CASSEGSHRAGNTIYF	TRBV10-1	TRBJ1-3
TGCAGCCTCCCTAGGACCTCTGGAAACACCATATATTTT	CSLPRTSGNTIYF	TRBV29-1	TRBJ1-3
TGTGCCAGCAGCGATAGGGGGGGTAGCACAGATACGCAGTATTTT	CASSDRGGSTDTQYF	TRBV7-3	TRBJ2-3
TGTGCCAGCAGCTTAGTTGGGAGTACGACTAGCTACCACGGGGAGCTGTTTTTT	CASSLVGSTTSYHGELFF	TRBV11-2	TRBJ2-2
TGTGCCAGCAGCAGGCGTGAGGAGGCCTCCTACGAGCAGTACTTC	CASSRREEASYEQYF	TRBV13	TRBJ2-7
TGTGCCACCAACGGACGATGGACGAACACCGGGGAGCTGTTTTTT	CATNGRWTNTGELFF	TRBV24-1	TRBJ2-2
TGTCAGACTAGCGGGCCTGGGAGGAGCTCCTACAATGAGCAGTTCTTC	CQTSGPGRSSYNEQFF	TRBV7-9	TRBJ2-1
TGTGCCAGCAGTGGGGGGACAGATATCGGGACAAAACGTCATACGAGGAAACTGTTTTTT	CASSGGTDIGTKRHTRKLFF	TRBV6-8	TRBJ1-4
TGTGCCAGCAGTTACTCGAGCGGGGGGGGGGGCCCGTACGAGCAGTACTTC	CASSYSSGGGGPYEQYF	TRBV6-3	TRBJ2-7
TGTGCTAGTGGCCACCCCCCCGGCACGCCCCTGGAGAACACTGAAGCTTTCTTT	CASGHPPGTPLENTEAFF	TRBV12-5	TRBJ1-1
TGTGCCAGCAGCTTGTGCTCTACTCGCTTTTCCCAAGAGACCCAGTACTTC	CASSLCSTRFSQETQYF	TRBV7-9	TRBJ2-5
TGTGCCAGCAGTGAAGGGCCGAGCAATGAGCAGTTCTTC	CASSEGPSNEQFF	TRBV2	TRBJ2-1
TGTGCCAGCAGCTTACGCAAGGGTCCGGGACAGGGGGCGCGCTATAGCAATCAGCCCCAGCATTTT	CASSLRKGPGQGARYSNQPQHF	TRBV7-9	TRBJ1-5
TGTGCCAGCAGCTTGCCCCCAGGGTACACTGAAGCTTTCTTT	CASSLPPGYTEAFF	TRBV5-6	TRBJ1-1
TGTGCCAGCAGCCGCGGGGCCAACGATACGCAGTATTTT	CASSRGANDTQYF	TRBV27	TRBJ2-3
TGTGCCAGCAGTTCTTCCAGGGGGGGTGCTTTCTTT	CASSSSRGGAFF	TRBV6-1	TRBJ1-1
TGTGCCAGCAGCGAGGGAGGGGACGGCTCTGGAAACACCATATATTTT	CASSEGGDGSGNTIYF	TRBV9	TRBJ1-3
TGTGCAGTAAAGTCAGGGGGCGCGGGGACCTACGAGCAGTACTTC	CAVKSGGAGTYEQYF	TRBV27	TRBJ2-7
TGTGCCAGCAGCCTAGCGGGGGGACAAGAGACCCAGTACTTC	CASSLAGGQETQYF	TRBV13	TRBJ2-5
TGTGCCAGCAGTTACTCCGGGTATGACCAAGCTTTCTTT	CASSYSGYDQAFF	TRBV6-6	TRBJ1-1
TGCGCCAGCGGTCCTCAAGGCACAGATACGCAGTATTTT	CASGPQGTDTQYF	TRBV5-1	TRBJ2-3
TGCGCCAGCAGCCGAGTGCGGGACGGAGAGACCCAGTACTTC	CASSRVRDGETQYF	TRBV4-1	TRBJ2-5
TGTGCCAGCAGAGACGATACGCAGTATTTT	CASRDDTQYF	TRBV6-5	TRBJ2-3
TGCAGCGTTGACCCCTCGGGGGGAGGCTGTGGTATAGGAAACATTCAGTACTTC	CSVDPSGGGCGIGNIQYF	TRBV29-1	TRBJ2-4
TGTGCCAGCAGTTACGCCCTTTGGACTTTTAACTATGGCTACACCTTC	CASSYALWTFNYGYTF	TRBV6-9	TRBJ1-2
TGCGCCAGCACACGACCACATGGGATGAACACTGAAGCTTTCTTT	CASTRPHGMNTEAFF	TRBV4-1	TRBJ1-1
TGTGCCAGCAGCACTGTTCGGGCAGATACGCAGTATTTT	CASSTVRADTQYF	TRBV9	TRBJ2-3
TGTGGTCCCCGGGGTAACTGGACGGCGTACGAGCAGTACTTC	CGPRGNWTAYEQYF	TRBV12-3	TRBJ2-7
TGCGCCAGCAGCCCCCCTAGCGCAGTTGAGACCCAGTACTTC	CASSPPSAVETQYF	TRBV5-1	TRBJ2-5
TGCAGTGCTAGCTCCCTTGGCTCACCCCTCCACTTT	CSASSLGSPLHF	TRBV20-1	TRBJ1-6
TGTGCCAGCAGTTGGGGCTCGTGGGAAGCTTTCTTT	CASSWGSWEAFF	TRBV12-3	TRBJ1-1
TGTGCCAGCAGCGTAGGGTCTCCTTTCCGGTACAATGAGCAGTTCTTC	CASSVGSPFRYNEQFF	TRBV9	TRBJ2-1
TGTGCCAGCAGTTCCTCCCGGGGCCCTAACTATGGCTACACCTTC	CASSSSRGPNYGYTF	TRBV6-1	TRBJ1-2
TGTGCCAGCAGCTTAGATCGGGACAGGGGCTTAGAGACCCAGTACTTC	CASSLDRDRGLETQYF	TRBV7-2	TRBJ2-5
TGTGCCAGCAGCCGGGGACAGGTGGTTCAGCCCCAGCATTTT	CASSRGQVVQPQHF	TRBV3-1	TRBJ1-5
TGTGCCAGCAGTTACCGTCCGGGACAGGGCACTGAAGCTTTCTTT	CASSYRPGQGTEAFF	TRBV12-4	TRBJ1-1
TGCGCCAGCAGCTTGTCGATTGTCGTGCCACTGGACCGAAATGAGCAGTTCTTC	CASSLSIVVPLDRNEQFF	TRBV5-1	TRBJ2-1
TGTGCCAGCAGTTTATATGATTACCCGGGGCCTCATTCACCCCTCCACTTT	CASSLYDYPGPHSPLHF	TRBV27	TRBJ1-6
TGTGCCAGCACCCCCGCCCAGGGTGGGAATGGCTACACCTTC	CASTPAQGGNGYTF	TRBV6-5	TRBJ1-2
TGTGCCAGCAGCTCCGGGGGCAGTGAAAAACTGTTTTTT	CASSSGGSEKLFF	TRBV5-5	TRBJ1-4
TGTGCCAGCAGTGTGGAACGACCGGGGGGGGAGTACAATGAGCAGTTCTTC	CASSVERPGGEYNEQFF	TRBV6-1	TRBJ2-1
TGCAGTGCTAGATATAAGGACAGGGTATCGCAAGAGACCCAGTACTTC	CSARYKDRVSQETQYF	TRBV20-1	TRBJ2-5
TGTGCCAGCAGCGTACCGGGACGGGTCTTTGAGCAGTACTTC	CASSVPGRVFEQYF	TRBV7-2	TRBJ2-7
TGTGCCAGCAGCTTAGGGACAGCTTTCAGCTCCTACGAGCAGTACTTC	CASSLGTAFSSYEQYF	TRBV7-3	TRBJ2-7
TGTGCCAGCTCAGCAGGGAGCAATCAGCCCCAGCATTTT	CASSAGSNQPQHF	TRBV6-4	TRBJ1-5
TGTGCCAGCAGCTTAGGTGAGGGACAGGGGCCCCAGCATTTT	CASSLGEGQGPQHF	TRBV7-9	TRBJ1-5
TGTGCCAGCAGCTACTTCCCTTACGTCAACGAGCAGTACTTC	CASSYFPYVNEQYF	TRBV7-9	TRBJ2-7
TGTGCCAGCAGCCAAGATAAACGGAATGAAAAACTGTTTTTT	CASSQDKRNEKLFF	TRBV14	TRBJ1-4
TGCGCCAGCAGGCCCACGCAGGGTCGGAACACTGAAGCTTTCTTT	CASRPTQGRNTEAFF	TRBV10-1	TRBJ1-1
TGCGCCAGCGGGGTGCACTACGAGCAGTACTTC	CASGVHYEQYF	TRBV5-1	TRBJ2-7
TGCGCCAGCACACAGGGAGGCCTTCGCGGCTATGGCTACACCTTC	CASTQGGLRGYGYTF	TRBV5-1	TRBJ1-2
TGTGCCAGCAGCTTACTAGCGGGAGCAAGGCGGACTGGGGCCAACGTCCTGACTTTC	CASSLLAGARRTGANVLTF	TRBV11-2	TRBJ2-6
TGTGCCAGCAGTGACTCGCTGAGGGGAGGCGAGACCCAGTACTTC	CASSDSLRGGETQYF	TRBV6-4	TRBJ2-5
TGCGCCAGCAGCTTGGCCGCCCGGACCCAGGGTGGGCCGTATGGCTCCTATAATTCACCCCTCCACTTT	CASSLAARTQGGPYGSYNSPLHF	TRBV5-1	TRBJ1-6
TGCGCCAGCAGCTGTGACAGCCTCTCTGGAAACACCATATATTTT	CASSCDSLSGNTIYF	TRBV4-3	TRBJ1-3
TGTGCCAGCAGTTACTTTCCGAGGGGTGAAGCTTTCTTT	CASSYFPRGEAFF	TRBV6-6	TRBJ1-1
TGTGCCAGCAGTGAGATAGGGGGTCGCGAGCAGTACTTC	CASSEIGGREQYF	TRBV6-1	TRBJ2-7
TGTGCCACCAGTGATTTGCAGAAGCGGCTAGCGGGGAGGGAAGGCGAGCAGTTCTTC	CATSDLQKRLAGREGEQFF	TRBV24-1	TRBJ2-1
TGCAGTGCATGGTGGGATGACCCAGTCCTGAATTCACCCCTCCACTTT	CSAWWDDPVLNSPLHF	TRBV20-1	TRBJ1-6
TGTGCCAGCAGCCAAGGGCGAACCTCCTACGAGCAGTACTTC	CASSQGRTSYEQYF	TRBV14	TRBJ2-7
TGTGCCACCAGTTGTCCCCTGGGACTTGGAGCTTTCTTT	CATSCPLGLGAFF	TRBV24-1	TRBJ1-1
TGTGCCAGCAGGGAGGGGCCGGGGGAGCTGTTTTTT	CASREGPGELFF	TRBV6-5	TRBJ2-2
TGCAGTGCTAGGAAAGGGGGCGCCAAGGGGGACTATGGCTACACCTTC	CSARKGGAKGDYGYTF	TRBV20-1	TRBJ1-2
TGTGCCAGCAGTTTAGCAACTCGTTTAGAGGGTTCCTGGGACGAGCAGTATTTT	CASSLATRLEGSWDEQYF	TRBV27	TRBJ2-3
TGTGCCTGGAGTGTACCGAAAGACAGGTACCAAGAGACCCAGTACTTC	CAWSVPKDRYQETQYF	TRBV30	TRBJ2-5
TGTGCCAGCAGCCAAGGGGGGACAGCCCGCTACGAGCAGTACTTC	CASSQGGTARYEQYF	TRBV14	TRBJ2-7
TGTGCCAGCAGTTCGGTCGCGGGAGGCCGCAATGAGCAGTTCTTC	CASSSVAGGRNEQFF	TRBV6-5	TRBJ2-1
