TGTGCCAGCCTGGCAGCGGAGACCCAGTACTTC	CASLAAETQYF	TRBV9	TRBJ2-5
TGTGCCAGCAGCTCCATCTTAACCGGGACAGGGGGAGAGACCCAGTACTTC	CASSSILTGTGGETQYF	TRBV7-8	TRBJ2-5
TGTGCCAGCCTGATTGGGACTAGCGGGACGGGTTACCCCTACGAGCAGTACTTC	CASLIGTSGTGYPYEQYF	TRBV27	TRBJ2-7
TGTGCCATCATGGGCTCCTACGAGCAGTACTTC	CAIMGSYEQYF	TRBV10-3	TRBJ2-7
TGTGCCAGCAGCGACGCCGGGACAGTAGGGCAGGTCCCCTTCTCCTACGAGCAGTACTTC	CASSDAGTVGQVPFSYEQYF	TRBV13	TRBJ2-7
TGCGCCAGCAGCCAAGTTCGGACTAATGAGCAGTTCTTC	CASSQVRTNEQFF	TRBV4-3	TRBJ2-1
TGTGCCAGTAGCGCCTGCAGGGTTTATAGCAATCAGCCCCAGCATTTT	CASSACRVYSNQPQHF	TRBV19	TRBJ1-5
TGTGCCAGTAGCCAGGACAGGAGGAACACTGAAGCTTTCTTT	CASSQDRRNTEAFF	TRBV19	TRBJ1-1
TGTGCCAGCAGCTTACTCGGACAGCGGCTTACCTACGAGCAGTACTTC	CASSLLGQRLTYEQYF	TRBV7-9	TRBJ2-7
TGTGCCAGCTTCGACAGGACGGGCTACACCTTC	CASFDRTGYTF	TRBV27	TRBJ1-2
TGTGCCAGCAGCAATGTAGGCCTAGCGGGAGAGTTATTCACTGAAGCTTTCTTT	CASSNVGLAGELFTEAFF	TRBV5-4	TRBJ1-1
TGTGCCAGCAGCCTGTACATTGACAGCGAGACCCAGTACTTC	CASSLYIDSETQYF	TRBV13	TRBJ2-5
TGTGCCAGCAGCGAGGGGGGGAGAGGGCAGTACTTC	CASSEGGRGQYF	TRBV13	TRBJ2-7
TGTGCCAGCAGCTTACTCAGGCACAGGGGAAAAGGAAACACCATATATTTT	CASSLLRHRGKGNTIYF	TRBV7-9	TRBJ1-3
TGTGCCAGCAGCCACTTAGAAGACAGGGAGGTGCCCCAGCATTTT	CASSHLEDREVPQHF	TRBV14	TRBJ1-5
TGTGCCAGCAGCTCACAGGGCCCCCACTTTAACTACGAGCAGTACTTC	CASSSQGPHFNYEQYF	TRBV5-5	TRBJ2-7
TGTGCCAGCGCCCAGGGGGAAGAGACCCAGTACTTC	CASAQGEETQYF	TRBV7-7	TRBJ2-5
TGCGCCAGCAGCTTGGCCGACAGGGCTGACACTGAAGCTTTCTTT	CASSLADRADTEAFF	TRBV5-1	TRBJ1-1
TGTGCCAGCAGCCAACCCGGTCGCCGGTGCAGTGGAAACTATGGCTACACCTTC	CASSQPGRRCSGNYGYTF	TRBV7-3	TRBJ1-2
TGTGCCAGCAGCTTACCGGGACCTTTCGCCTACAATGAGCAGTTCTTC	CASSLPGPFAYNEQFF	TRBV7-3	TRBJ2-1
TGTGCCAGCAGCGGGCGCCCAGTAAGCAAATCGAACACTGAAGCTTTCTTT	CASSGRPVSKSNTEAFF	TRBV9	TRBJ1-1
TGTGCCAGCATGTCTACAGATACGCAGTATTTT	CASMSTDTQYF	TRBV6-5	TRBJ2-3
TGTGCCACCAGTGGACAGGGAGGGTTTACTGAAGCTTTCTTT	CATSGQGGFTEAFF	TRBV24-1	TRBJ1-1
TGTGCCAGCACGGGGACAGGGGTACGCAATGAAAAACTGTTTTTT	CASTGTGVRNEKLFF	TRBV12-4	TRBJ1-4
TGTGCCAGCAGCCAACTTAAGGTGGTTAACGGGGCTGGGGCCAACGTCCTGACTTTC	CASSQLKVVNGAGANVLTF	TRBV3-1	TRBJ2-6
TGTGCCAAGGACAGTTCGGGGAGGATTCTCCACGAGCAGTACTTC	CAKDSSGRILHEQYF	TRBV19	TRBJ2-7
TGTGCCAAGGGGTATCTGGAGGTCTTC	CAKGYLEVF	TRBV7-3	TRBJ2-1
TGTGCAGGACCGAGGGGCTTCACTTACGAGCAGTACTTC	CAGPRGFTYEQYF	TRBV5-6	TRBJ2-7
TGTGCCAGGGGGGGACTAGCGAACACCGGGGAGCTGTTTTTT	CARGGLANTGELFF	TRBV27	TRBJ2-2
TGTGCCAGCAGTTACGACAGGGGGAGACGTGAAAAACTGTTTTTT	CASSYDRGRREKLFF	TRBV6-5	TRBJ1-4
TGTGCCAGCAGCAGACCGGGACGTTATGAAAAACTGTTTTTT	CASSRPGRYEKLFF	TRBV11-2	TRBJ1-4
TGTGCCAGCAGCGGCCCGGGGAATTTGGGCAATCAGCCCCAGCATTTT	CASSGPGNLGNQPQHF	TRBV7-4	TRBJ1-5
TGTGCCAGCAGCTCGGACAGGGTCTACAATGAGCAGTTCTTC	CASSSDRVYNEQFF	TRBV7-3	TRBJ2-1
TGTGCCAGCAGCTTGAGAGGAGCCAGCTCCTATAATTCACCCCTCCACTTT	CASSLRGASSYNSPLHF	TRBV7-2	TRBJ1-6
TGTGCCAGCACCGCCGCAGCGTACCCAAACGAGCAGTACTTC	CASTAAAYPNEQYF	TRBV7-2	TRBJ2-7
TGTGCCACCAGCAGAGAAAGCTTCGGCCACATTGACAGGGACCAAGAGACCCAGTACTTC	CATSRESFGHIDRDQETQYF	TRBV15	TRBJ2-5
TGTGCCAGCAGCAGCTACAGGGGCGAAAACACCATATATTTT	CASSSYRGENTIYF	TRBV5-8	TRBJ1-3
TGTGCCAGCAGTTTATTTTCTGAGGGTAGTCTCAACGTCCTGACTTTC	CASSLFSEGSLNVLTF	TRBV27	TRBJ2-6
TGTGCCACAGGACTAGCGGGGTACAATGAGCAGTTCTTC	CATGLAGYNEQFF	TRBV19	TRBJ2-1
TGCGCCAGCAGTTCCAGTCCCACGGAGCGGGGGCTGCAATGCGAGACCCAGTACTTC	CASSSSPTERGLQCETQYF	TRBV10-1	TRBJ2-5
TGTGCCAGCAGCTTTTCATTACTAGCGGGAGCGGGGAACACCGGGGAGCTGTTTTTT	CASSFSLLAGAGNTGELFF	TRBV7-6	TRBJ2-2
TGTGCCAGCAGCGGCCGGGACAGTGCCCAAGAGACCCAGTACTTC	CASSGRDSAQETQYF	TRBV13	TRBJ2-5
TGCAGTGCTAGAGATGGAATGGGACAGGTTCCTGGAAACACCATATATTTT	CSARDGMGQVPGNTIYF	TRBV20-1	TRBJ1-3
TGTGCCAGTAGTTCCCCGGGCCAAGAGACCCAGTACTTC	CASSSPGQETQYF	TRBV19	TRBJ2-5
TGTGCCACCAGTGATTTGATGGGCCACACTGAAGCTTTCTTT	CATSDLMGHTEAFF	TRBV24-1	TRBJ1-1
TGTGCCAGCAGCCCGACTAGCGTTGGGTCCTTTCAAGAGACCCAGTACTTC	CASSPTSVGSFQETQYF	TRBV13	TRBJ2-5
TGTGCCAGCAGTTTATCGCATAGCGGCGTGGGAGCAGATACGCAGTATTTT	CASSLSHSGVGADTQYF	TRBV28	TRBJ2-3
TGTGCCAGCTCAGAGGGAACAGCCAAAAACATTCAGTACTTC	CASSEGTAKNIQYF	TRBV18	TRBJ2-4
TGTGCCACCAGACTCGGGGGGAGGCTCTCCTACGAGCAGTACTTC	CATRLGGRLSYEQYF	TRBV24-1	TRBJ2-7
TGCGCCAGCAGCTTAAATCTAGGGGTGGTGCGGCAGTATTTT	CASSLNLGVVRQYF	TRBV5-1	TRBJ2-3
TGCGCCAGACCTGACTTCATGAACACTGAAGCTTTCTTT	CARPDFMNTEAFF	TRBV4-1	TRBJ1-1
TGTGCCAGCATCTCCCCCGCGGGAGGGGGTTCACCCCTCCACTTT	CASISPAGGGSPLHF	TRBV6-2	TRBJ1-6
TGTGCCATCAGCCTTCGCGGGTGCCTAGACGCCAAAAACATTCAGTACTTC	CAISLRGCLDAKNIQYF	TRBV10-3	TRBJ2-4
TGTGCCATCAGCACCCGGGACAGGGGTGAAAAACTGTTTTTT	CAISTRDRGEKLFF	TRBV10-3	TRBJ1-4
TGTGCCAGCAGGGCGGACAGGGGTGGGGATAGCAATCAGCCCCAGCATTTT	CASRADRGGDSNQPQHF	TRBV27	TRBJ1-5
TGTGCCAGCAGTTCCTTGGCTCAGAACACCGGGGAGCTGTTTTTT	CASSSLAQNTGELFF	TRBV27	TRBJ2-2
TGTGCCAGCAGTTTGCCGGGACAGGGGCTTAATCAGCCCCAGCATTTT	CASSLPGQGLNQPQHF	TRBV28	TRBJ1-5
TGTGCCAGCAGTTTAAAAGGGGGACCTAACTATGGCTACACCTTC	CASSLKGGPNYGYTF	TRBV27	TRBJ1-2
TGTGCCAGCAGCGGACGCGGACAGGAAGAAGCTTTCTTT	CASSGRGQEEAFF	TRBV7-6	TRBJ1-1
TGTGCCAGTAGTTCAGGAAAGACAGGGTTCGAGTGGGCTGGAAACACCATATATTTT	CASSSGKTGFEWAGNTIYF	TRBV19	TRBJ1-3
TGTGCCAACCCCCGATATGGGTATGGCTACACCTTC	CANPRYGYGYTF	TRBV6-4	TRBJ1-2
TGTGCCAGCAGTGGGAGGGAAAGATATGGAAACACCATATATTTT	CASSGRERYGNTIYF	TRBV4-2	TRBJ1-3
TGCGCCAGCACCGGCAGGGGGGAGGAGTCAAATGAAAAACTGTTTTTT	CASTGRGEESNEKLFF	TRBV10-1	TRBJ1-4
TGTGCCAGCAGCGCTGGGAGCATAACTGAAGCTTTCTTT	CASSAGSITEAFF	TRBV9	TRBJ1-1
TGTGCCAGCAGTGCCTACCCTTGCGGGACAGGGGACGGATCCTGCCGGGCTAATCAGCCCCAGCATTTT	CASSAYPCGTGDGSCRANQPQHF	TRBV6-4	TRBJ1-5
TGTGCCACCACCCCTTCCTCAAAGGGGGGGCCCCAGCATTTT	CATTPSSKGGPQHF	TRBV24-1	TRBJ1-5
TGCAGTGCTAGAGGGCGGGAGGGAGCCCAGCATTTT	CSARGREGAQHF	TRBV20-1	TRBJ1-5
TGTGCCAGCAGCGTAGTAGGGTTACCCCCCCCCGGGGCGTACGAGCAGTACTTC	CASSVVGLPPPGAYEQYF	TRBV9	TRBJ2-7
TGTGCCAAGACTAGACCTGAGACTAAACACTACAATGAGCAGTTCTTC	CAKTRPETKHYNEQFF	TRBV6-4	TRBJ2-1
TGTGCCAGCAGCTTACAAAGGGGGCTCCACTTC	CASSLQRGLHF	TRBV7-2	TRBJ2-7
TGCGCCAGCAGCTTAACAGGCCCGGGGGGCCTTCACTACGAGCAGTACTTC	CASSLTGPGGLHYEQYF	TRBV5-1	TRBJ2-7
TGCAGTGCTACGGGGGCGATCAACTATGGCTACACCTTC	CSATGAINYGYTF	TRBV20-1	TRBJ1-2
TGTGCCAGCGTCCTAGCGGAAACCGGGGAGCTGTTTTTT	CASVLAETGELFF	TRBV14	TRBJ2-2
TGTGCCAGCAGCTTAGTCCAATCGCTACCCCGTCAGCGGGATTACAATGAGCAGTTCTTC	CASSLVQSLPRQRDYNEQFF	TRBV7-4	TRBJ2-1
TGCGCCAGCAGCTGGGGTAGTTCCACAGATACGCAGTATTTT	CASSWGSSTDTQYF	TRBV5-1	TRBJ2-3
TGTGCCAGCAGCCCGAATAGGGGGGCCAATATACCCACCTACGAGCAGTACTTC	CASSPNRGANIPTYEQYF	TRBV6-2	TRBJ2-7
TGTGCCATCAGTGAGACATGGATCCCGGTAGATAGGCTTTGTACAGTTGACATTCAGTACTTC	CAISETWIPVDRLCTVDIQYF	TRBV10-3	TRBJ2-4
TGTGCCAGCACGGCGAGTGGAGTTAGCTCCTACGAGCAGTACTTC	CASTASGVSSYEQYF	TRBV28	TRBJ2-7
TGTGCCAGCAGTCCCCCTTATAACAACACCGGGGAGCTGTTTTTT	CASSPPYNNTGELFF	TRBV6-1	TRBJ2-2
TGCAGTGCTAGATCGGGGGGGGGGGAGCCCTACAATGAGCAGTTCTTC	CSARSGGGEPYNEQFF	TRBV20-1	TRBJ2-1
TGTGCCAGCTCGTGGGGGGCCCCCTACGAGCAGTACTTC	CASSWGAPYEQYF	TRBV9	TRBJ2-7
TGTGCCAGCAGCCAAAGAGGGTGGGCAGAGACCCAGTACTTC	CASSQRGWAETQYF	TRBV3-1	TRBJ2-5
TGTGCCAGCTCACCGCGGGGGCTCAGCACAGATACGCAGTATTTT	CASSPRGLSTDTQYF	TRBV18	TRBJ2-3
TGTGCCACCAGCCACGAAAATCCTCCACGGCAAACCTTGAAAAACATTCAGTACTTC	CATSHENPPRQTLKNIQYF	TRBV15	TRBJ2-4
TGCAGTGCTAGGACTTACGATCCCAACACTGGCAATCAGCCCCAGCATTTT	CSARTYDPNTGNQPQHF	TRBV20-1	TRBJ1-5
TGTGCCTGGCAACTCGGACAGGGCAACCACTATGGCTACACCTTC	CAWQLGQGNHYGYTF	TRBV30	TRBJ1-2
TGTGCCAGCAGCCCCCAGGGGGTTCCCCTCCACTTT	CASSPQGVPLHF	TRBV7-3	TRBJ1-6
TGTGCCAGCAGTTTAGTTCGGTTCTACAATGAGCAGTTCTTC	CASSLVRFYNEQFF	TRBV27	TRBJ2-1
TGTGCCGCCGCGCTGGCAGATACGCAGTATTTT	CAAALADTQYF	TRBV10-3	TRBJ2-3
TGTGCCAGCAGCTTAGTTTCCCGTCCGGGACGAAGGAATGAGCAGTTCTTC	CASSLVSRPGRRNEQFF	TRBV7-4	TRBJ2-1
TGTGCCAGCAGCTTAGCCTCCACGGGAACCGCCTCTGGGGCCAACGTCCTGACTTTC	CASSLASTGTASGANVLTF	TRBV7-9	TRBJ2-6
TGTGCCAGCATATTGAGACAGGGTCGGAACAATGAGCAGTTCTTC	CASILRQGRNNEQFF	TRBV6-5	TRBJ2-1
TGTGCCAGCAGCGGCAAGGAGGGCACCGGGGAGCTGTTTTTT	CASSGKEGTGELFF	TRBV11-3	TRBJ2-2
TGTGCCAGCAGGGAGACAGAATTGGAAAAACTGTTTTTT	CASRETELEKLFF	TRBV12-4	TRBJ1-4
TGTGCCAGTGACGTGGGACAGGGGGAAAAACTGTTTTTT	CASDVGQGEKLFF	TRBV7-3	TRBJ1-4
TGTGCCAGCAGCTTAGCCGGACTAGCGGGTGAAAGCTACGAGCAGTACTTC	CASSLAGLAGESYEQYF	TRBV7-2	TRBJ2-7
TGCAGTGCTAAAAAATCTAGTGGAAATGACACAGATACGCAGTATTTT	CSAKKSSGNDTDTQYF	TRBV20-1	TRBJ2-3
TGTGCCAGCAGCCGGGGGGACTTGGGTACAGATACGCAGTATTTT	CASSRGDLGTDTQYF	TRBV4-2	TRBJ2-3
TGTGCCAGCTCACCACCCGACAAAGCCTACGAGCAGTACTTC	CASSPPDKAYEQYF	TRBV18	TRBJ2-7
TGTGCCAGCAGTTACTCACCGGACAGAAGCACCTTC	CASSYSPDRSTF	TRBV6-5	TRBJ1-2
TGCAGTGCTAGAGGAACTAGACCTAGCGGGGGGAATGAGCAGTTCTTC	CSARGTRPSGGNEQFF	TRBV20-1	TRBJ2-1
TGTGCCATCAGTGCCCAGAGCAGGGATTCTCGTAGCTACGAGCAGTACTTC	CAISAQSRDSRSYEQYF	TRBV10-3	TRBJ2-7
TGTGCCAGCAGCGGGGACACTGGAAACACCATATATTTT	CASSGDTGNTIYF	TRBV7-9	TRBJ1-3
TGTGCCAGCACAGGGGGCCCCTACGAGCAGTACTTC	CASTGGPYEQYF	TRBV6-4	TRBJ2-7
TGTGCCAGCAGCCAATTGTATGGGACTAACGACTATGGCTACACCTTC	CASSQLYGTNDYGYTF	TRBV3-1	TRBJ1-2
TGCAGTGCAGAAGGAGGTAGTGACACCGGGGAGCTGTTTTTT	CSAEGGSDTGELFF	TRBV20-1	TRBJ2-2
TGTGCCAGCAGCTTAACCAAGACTAGCGGCATTTACTCCAATGAGCAGTTCTTC	CASSLTKTSGIYSNEQFF	TRBV7-3	TRBJ2-1
TGTGCCAGCCCGGGAGGGGGCTGTGATATTTGGTACTCCTACGAGCAGTACTTC	CASPGGGCDIWYSYEQYF	TRBV7-6	TRBJ2-7
TGTGCCAGCACAAATCGAGGGGGCGCAAGCAATCAGCCCCAGCATTTT	CASTNRGGASNQPQHF	TRBV27	TRBJ1-5
TGTGCCAGCAGCGGGACAGGCCGGACTGAAGCTTTCTTT	CASSGTGRTEAFF	TRBV7-4	TRBJ1-1
TGTGCCAGCCGCCCGCGCACAAGCGGACAGGACCACGAAAAACTGTTTTTT	CASRPRTSGQDHEKLFF	TRBV14	TRBJ1-4
TGTGCCAGCAGCTTGGCTGGGAAGGATCAGCCCCAGCATTTT	CASSLAGKDQPQHF	TRBV5-4	TRBJ1-5
TGTGCCAGCTCACCACCCTTACGTGAGCAGTACTTC	CASSPPLREQYF	TRBV18	TRBJ2-7
TGTGCCAGCAGCAATGGCAGGAACACCGGGGAGCTGTTTTTT	CASSNGRNTGELFF	TRBV7-7	TRBJ2-2
TGTGCTAGCAGCTTATTCCCAGCAACCCAAAATCAGCCCCAGCATTTT	CASSLFPATQNQPQHF	TRBV7-7	TRBJ1-5
TGTGCCAGCAGGGCCACTCCAAAGCAGGTAGCTTTCTTT	CASRATPKQVAFF	TRBV6-5	TRBJ1-1
TGCGCCAGCAGTGATCATTCCTCCGGAGCCAAAAACATTCAGTACTTC	CASSDHSSGAKNIQYF	TRBV10-1	TRBJ2-4
TGTGCCTGGAGTGCCATAATCATGCGATTTGAGTATGAGAGCTCCTATAATTCACCCCTCCACTTT	CAWSAIIMRFEYESSYNSPLHF	TRBV30	TRBJ1-6
TGTGCCAGCAGTGAGGGGATGCTGGAGCCCACACCCGACTACGAGCAGTACTTC	CASSEGMLEPTPDYEQYF	TRBV6-1	TRBJ2-7
TGTGCCAGCAGCTTCAATTCCGGGGAGCTGTTTTTT	CASSFNSGELFF	TRBV5-4	TRBJ2-2
TGCGCCAGCAGCTTCGCGCGGGGACTCTCCACAGATACGCAGTATTTT	CASSFARGLSTDTQYF	TRBV5-1	TRBJ2-3
TGTGCCAGCAGCTCTCTAGGGAACACTGAAGCTTTCTTT	CASSSLGNTEAFF	TRBV5-4	TRBJ1-1
TGTGCCACCAGTGATGCCCAGGGGGGAGATATGCTGAACACTGAAGCTTTCTTT	CATSDAQGGDMLNTEAFF	TRBV24-1	TRBJ1-1
TGTGCCAGCAGTGACTCGACCAGGTCAGGGCATGGATCTTACAATCAGCCCCAGCATTTT	CASSDSTRSGHGSYNQPQHF	TRBV6-4	TRBJ1-5
TGTGCCAGCAGTGAAGTACCGGGACAGGGGGAGGACGAGCAGTACTTC	CASSEVPGQGEDEQYF	TRBV6-1	TRBJ2-7
TGTGCCAGCAGTAGACGGGGGGGCTCCTACGAGCAGTACTTC	CASSRRGGSYEQYF	TRBV6-4	TRBJ2-7
TGCGCCAGCAGCCACTTATGGGACAGGACCTCCTTGAACACTGAAGCTTTCTTT	CASSHLWDRTSLNTEAFF	TRBV4-1	TRBJ1-1
TGTGCCAGCAGTGTGAACCCCCCAGGGGAGGGGGACAATGAGCAGTTCTTC	CASSVNPPGEGDNEQFF	TRBV6-1	TRBJ2-1
TGTGCCAGCAGTGTAGGGGGGGAAACCGGGGAGCTGTTTTTT	CASSVGGETGELFF	TRBV6-1	TRBJ2-2
TGCGCCAGCAGTGAGGGCCGGGACAGATTGGTCTATAATTCACCCCTCCACTTT	CASSEGRDRLVYNSPLHF	TRBV10-1	TRBJ1-6
TGTGCCAGCAGTTACCGGGGAGAGCGGAGCAATCAGCCCCAGCATTTT	CASSYRGERSNQPQHF	TRBV6-3	TRBJ1-5
TGCGCCAGCAGCCGGAGAAACACCATATATTTT	CASSRRNTIYF	TRBV4-3	TRBJ1-3
TGCAGTGCTAGAGATGGTGGGAGGCAACCCACAGATACGCAGTATTTT	CSARDGGRQPTDTQYF	TRBV20-1	TRBJ2-3
TGTGCCAGCAGCCCCAGGGGAAGCGGGACCATGAGTGAGCAGTTCTTC	CASSPRGSGTMSEQFF	TRBV27	TRBJ2-1
TGTGCAGCCGGAAAAGGGGATTACTATGGCTACACCTTC	CAAGKGDYYGYTF	TRBV9	TRBJ1-2
TGCGCCAGCAGCTTCCTTCAAGCATCCCAGACAGGATATGGCTACACCTTC	CASSFLQASQTGYGYTF	TRBV5-1	TRBJ1-2
TGTGCCAGTGGTGTAGTTGAGAGCTCCTACGAGCAGTACTTC	CASGVVESSYEQYF	TRBV5-6	TRBJ2-7
TGTGCCAGCAGTGACTCAGACCGGACGGGGTACGAGCAGTACTTC	CASSDSDRTGYEQYF	TRBV6-4	TRBJ2-7
TGTGCCAGCAGCTTAGCCAGAGGCAGATACAACACCGGGGAGCTGTTTTTT	CASSLARGRYNTGELFF	TRBV7-9	TRBJ2-2
TGTGCCACCAGTGAGTCCTGGGGGGGCGCACCCGACGTGGACGCAGATACGCAGTATTTT	CATSESWGGAPDVDADTQYF	TRBV24-1	TRBJ2-3
TGCAGCGTTGGCGGGACCGGGGAGCTGTTTTTT	CSVGGTGELFF	TRBV29-1	TRBJ2-2
TGTGCCAGCAGCCGACTAGCGGGCCTATCTGGGGCCAACGTCCTGACTTTC	CASSRLAGLSGANVLTF	TRBV5-6	TRBJ2-6
TGTGCCAGCAGCAGAGCACGACAGGGTGTCAACACTGAAGCTTTCTTT	CASSRARQGVNTEAFF	TRBV11-2	TRBJ1-1
TGTGCCAGCAGTTACTGGACAGGTGAGAACACTGAAGCTTTCTTT	CASSYWTGENTEAFF	TRBV6-3	TRBJ1-1
TGCGCCAGCAGCTTCATGGGCCCACCTGTGAAAAACATTCAGTACTTC	CASSFMGPPVKNIQYF	TRBV5-1	TRBJ2-4
TGTGCCAGCAGCTTGGCAGATTATCAGCCCCAGCATTTT	CASSLADYQPQHF	TRBV11-2	TRBJ1-5
TGTGCCAGCAGTTGGGGGGAAGCGGGACTCGATACGCAGTATTTT	CASSWGEAGLDTQYF	TRBV27	TRBJ2-3
TGTGCCAGCACGCACCGGGGGCCAAAGAATCAGCCCCAGCATTTT	CASTHRGPKNQPQHF	TRBV7-8	TRBJ1-5
TGCGCCAGCAGCAAGGGGGTTAGAGAAGGGCCGTCGGAGCTGTTTTTT	CASSKGVREGPSELFF	TRBV5-1	TRBJ2-2
TGTGCCAGCCCTCCGACAGGGAGGGGAAACACCATATATTTT	CASPPTGRGNTIYF	TRBV6-5	TRBJ1-3
TGCAGTGCCCCTGCAGGGGCCTATAATTCACCCCTCCACTTT	CSAPAGAYNSPLHF	TRBV20-1	TRBJ1-6
TGTGCCACCAGTGATTTGGCCCTTCGGTATGGCTACACCTTC	CATSDLALRYGYTF	TRBV24-1	TRBJ1-2
TGTGCCAGCAGCAGTGGGCCCACTAACCAAGGCTACACCTTC	CASSSGPTNQGYTF	TRBV7-3	TRBJ1-2
TGTGCTAGCAGCCCCCCACAGGGGCTATTCGGCTATGGCTACACCTTC	CASSPPQGLFGYGYTF	TRBV7-7	TRBJ1-2
TGCGCCAGCAGCCAAGGTCAGGTTATCCCAAGTCGCTCCTACGAGCAGTACTTC	CASSQGQVIPSRSYEQYF	TRBV4-1	TRBJ2-7
TGTGCCAGCAGTGAACACAGGGGTCACAAAAACATTCAGTACTTC	CASSEHRGHKNIQYF	TRBV2	TRBJ2-4
TGTGCCAGCAGTTACTCAAGAGATTTGGGGAGGAATCAGCCCCAGCATTTT	CASSYSRDLGRNQPQHF	TRBV6-5	TRBJ1-5
TGTGCCAGCAGCTTGGGGTTTTCGATCGGACTGGCGAACACCGGGGAGCTGTTTTTT	CASSLGFSIGLANTGELFF	TRBV5-6	TRBJ2-2
TGCAGCGTTGAATATTTGGGGCCCTTGGGGGTGGGACAGAAAGGAAACTATGGCTACACCTTC	CSVEYLGPLGVGQKGNYGYTF	TRBV29-1	TRBJ1-2
TGTGCCAGGGCCCCGGGGGCCAGGGACGGAAACATTCAGTACTTC	CARAPGARDGNIQYF	TRBV19	TRBJ2-4
TGTGCCAGCACCGGCTGGGAACTCAGAGGAGGCACAGATACGCAGTATTTT	CASTGWELRGGTDTQYF	TRBV9	TRBJ2-3
TGTGCCAGCAGCCAAGCCCCGGGGGGGGAGCAGTACTTC	CASSQAPGGEQYF	TRBV4-2	TRBJ2-7
TGTGCCTGGAGGCCCAGGACGGGGGGAATTGCAGATACGCAGTATTTT	CAWRPRTGGIADTQYF	TRBV30	TRBJ2-3
TGTGCCAGCAGTAAGATTACATGGACCCAGTACTTC	CASSKITWTQYF	TRBV28	TRBJ2-5
TGTGCCAGCAGCTTATACCGACAGGCTAGATATAGCAATCAGCCCCAGCATTTT	CASSLYRQARYSNQPQHF	TRBV11-3	TRBJ1-5
TGTGCCTGGAGTCCACGGGATCCTGCCTACAATGAGCAGTTCTTC	CAWSPRDPAYNEQFF	TRBV30	TRBJ2-1
TGTGCCAGCGAGGCCAATTCACCCCTCCACTTT	CASEANSPLHF	TRBV5-4	TRBJ1-6
TGTGCCAGCAGCCAGGCCGGGACAGTCGGGGGGGGGATTAATCAGCCCCAGCATTTT	CASSQAGTVGGGINQPQHF	TRBV13	TRBJ1-5
TGTGCCAGCAGTGAGCGGGGTCAAGGGGAGACCCAGTACTTC	CASSERGQGETQYF	TRBV6-4	TRBJ2-5
TGTGCCAGCAGCTTTTCCCCTAATGGGGCTCCCTACGAGCAGTACTTC	CASSFSPNGAPYEQYF	TRBV5-4	TRBJ2-7
TGTGCCAGCAGCTCAGGTCGCAGAGGCTCTGGGGCCAACGTCCTGACTTTC	CASSSGRRGSGANVLTF	TRBV6-2	TRBJ2-6
TGCGCCAGCAGCTTGGGTCTAGGACAGGGGAGAAACATTCAGTACTTC	CASSLGLGQGRNIQYF	TRBV5-1	TRBJ2-4
TGTGCCAGCTCACCACGGGGGGGACAGGGGGCGCGGGGCTCCTACGAGCAGTACTTC	CASSPRGGQGARGSYEQYF	TRBV18	TRBJ2-7
TGTGCCTGGAGTGTAGTTCAAGGCTTTATAAGGGACTATGGCTACACCTTC	CAWSVVQGFIRDYGYTF	TRBV30	TRBJ1-2
TGCGCCAGCAGCTTGATTCTGGAAGTCACTGAAGCTTTCTTT	CASSLILEVTEAFF	TRBV5-1	TRBJ1-1
TGTGCCAGCAGCCAAACCTATCGGGACAGGGCTCCTACCGGGGAGCTGTTTTTT	CASSQTYRDRAPTGELFF	TRBV3-1	TRBJ2-2
TGCGCCAGGGAAAGGGCGAAGGAGCTGTTTTTT	CARERAKELFF	TRBV5-1	TRBJ2-2
TGCAGTGCATATGAGGTCACTGGAGAAGCTTTCTTT	CSAYEVTGEAFF	TRBV20-1	TRBJ1-1
TGTGCCACCAGCAGAAGGTTGGGACAGGGAGCTAGCACAGATACGCAGTATTTT	CATSRRLGQGASTDTQYF	TRBV15	TRBJ2-3
TGTGCCAGCAGTCCCCGGGCGGATAACGAGCAGTACTTC	CASSPRADNEQYF	TRBV3-1	TRBJ2-7
TGTGCCAGCAGTGAGAGGACCGTATACCCATGTCCAAACATTCAGTACTTC	CASSERTVYPCPNIQYF	TRBV2	TRBJ2-4
TGTGCCAGCAGTTACCACAGGGAAGAAAAACTGTTTTTT	CASSYHREEKLFF	TRBV6-2	TRBJ1-4
TGTGCCAGCAGTTGGTCGGACAGCCCCTCCGGTTCATATCAGCCCCAGCATTTT	CASSWSDSPSGSYQPQHF	TRBV9	TRBJ1-5
TGTGCCAGCTGGGCCTGGGGATACTATGGCTACACCTTC	CASWAWGYYGYTF	TRBV19	TRBJ1-2
TGTGCCAGCAGTGTTTCCTGGGGGGCTACCGGGGAGCTGTTTTTT	CASSVSWGATGELFF	TRBV6-1	TRBJ2-2
TGTGCCGAAAAGGGTTGTGGGCCCGCTATGAACACTGAAGCTTTCTTT	CAEKGCGPAMNTEAFF	TRBV3-1	TRBJ1-1
TGTGCCAGCAGCGAGTACCTAGCGGGAGGAGGAGACAATGAGCAGTTCTTC	CASSEYLAGGGDNEQFF	TRBV3-1	TRBJ2-1
TGTGCCAGCAGCGTGCAGGGGGACGATACGCAGTATTTT	CASSVQGDDTQYF	TRBV9	TRBJ2-3
TGTGCCAGCAGCCATACGGAAAAACTGTTTTTT	CASSHTEKLFF	TRBV14	TRBJ1-4
TGTGCCAGCAGCTTGCGGGAATGTCGGAACACTGAAGCTTTCTTT	CASSLRECRNTEAFF	TRBV5-4	TRBJ1-1
TGCGCCAGCAGCTTGGCCCCGCGGGGGCCGAACACTGAAGCTTTCTTT	CASSLAPRGPNTEAFF	TRBV5-1	TRBJ1-1
TGTGCCACAACCACGACAGGGGGCTACACCTTC	CATTTTGGYTF	TRBV12-4	TRBJ1-2
TGTGCCAGCAGCCTCGACAGGGTTGCTGAAGCTTTCTTT	CASSLDRVAEAFF	TRBV3-1	TRBJ1-1
TGTGCTTCGGGAAGGACAGATACGCAGTATTTT	CASGRTDTQYF	TRBV5-6	TRBJ2-3
TGTGCCAGCAGCCAAGATACCGAGGGGGGCTCGAACAAAAACATTCAGTACTTC	CASSQDTEGGSNKNIQYF	TRBV4-2	TRBJ2-4
TGTGCCAGCAGCCCCAAATTCCGGGACAATAGCAATCAGCCCCAGCATTTT	CASSPKFRDNSNQPQHF	TRBV3-1	TRBJ1-5
TGTGCCAGAACTGGACCATGCTCCTACGAGCAGTACTTC	CARTGPCSYEQYF	TRBV19	TRBJ2-7
TGTGCCACCAGGCCCGAGCGTACGGGGGTCTCCGAACCCTACGAGCAGTACTTC	CATRPERTGVSEPYEQYF	TRBV24-1	TRBJ2-7
TGTGCCACCTACAGGACAGCCCCGGAAGAATACAATGAGCAGTTCTTC	CATYRTAPEEYNEQFF	TRBV24-1	TRBJ2-1
TGTGCCAGCAGTGGATTGGGGGGACGGACCAGGTACAATGAGCAGTTCTTC	CASSGLGGRTRYNEQFF	TRBV25-1	TRBJ2-1
TGTGCCAGCAGCCAAGATTTTCCAGCACCTAGCACAGATACGCAGTATTTT	CASSQDFPAPSTDTQYF	TRBV3-1	TRBJ2-3
TGTGCCAGCAGCTGGTTCGGGACCTACACCTTC	CASSWFGTYTF	TRBV9	TRBJ1-2
TGTGCCAGCAGCGTGTCCCGGGACAGAATCACTGAAGCTTTCTTT	CASSVSRDRITEAFF	TRBV7-9	TRBJ1-1
TGTGCCAGCAGCCAAGATCCTAACAGGACGAACTACGAGCAGTACTTC	CASSQDPNRTNYEQYF	TRBV3-1	TRBJ2-7
TGTGCCTGGGCTATAAAGGGACAGGGTGGAAACACCATATATTTT	CAWAIKGQGGNTIYF	TRBV30	TRBJ1-3
TGTGCCAGCAGCTCGGACCTAAAGCCATTAGCCAAAAACATTCAGTACTTC	CASSSDLKPLAKNIQYF	TRBV7-8	TRBJ2-4
TGTGCCACCAGTGGGACAGGGTTGGGATTGACGACCCAGTACTTC	CATSGTGLGLTTQYF	TRBV24-1	TRBJ2-5
TGCAGTGCTAGACAGGGGCGAAACACCATATATTTT	CSARQGRNTIYF	TRBV20-1	TRBJ1-3
TGCAGCGTTGGGATTGGGCTCCGTAGCGGGAAGGCCTACGAGCAGTACTTC	CSVGIGLRSGKAYEQYF	TRBV29-1	TRBJ2-7
TGTGCCTGGAGTGTACTAGTACTAGCGGGAGGGGGCTACAATGAGCAGTTCTTC	CAWSVLVLAGGGYNEQFF	TRBV30	TRBJ2-1
TGTGCCAGCAGGATCCGGGCAGACGAGCAGTACTTC	CASRIRADEQYF	TRBV2	TRBJ2-7
TGCGCCAGCAACAAGGGGGGCAAGGCTACAGATACGCAGTATTTT	CASNKGGKATDTQYF	TRBV10-1	TRBJ2-3
TGTGCCAGCAGCCCGTATCCTGCGGGAGTCGGGGCCTACGAGCAGTACTTC	CASSPYPAGVGAYEQYF	TRBV13	TRBJ2-7
TGTGCCAGCAGGCCCGGGGGGGGCTACACCTTC	CASRPGGGYTF	TRBV27	TRBJ1-2
TGTGCCAGCAGCCAAGATCTCCCAGGGAAGTGGGGACAGATAGGCAATCAGCCCCAGCATTTT	CASSQDLPGKWGQIGNQPQHF	TRBV14	TRBJ1-5
TGTGCCAGTAGTATATGGGTCTTGATCTATGGCTACACCTTC	CASSIWVLIYGYTF	TRBV19	TRBJ1-2
TGTGCCAGCAGTAGATGTGTTGGCGGACACACCGGGGAGCTGTTTTTT	CASSRCVGGHTGELFF	TRBV7-2	TRBJ2-2
TGTGCCAGCAGTTACATACCGGGACAGGGGGGCAATCAGCCCCAGCATTTT	CASSYIPGQGGNQPQHF	TRBV6-3	TRBJ1-5
TGCGCCAGCAGCGGACAGGAATACACTGAAGCTTTCTTT	CASSGQEYTEAFF	TRBV5-1	TRBJ1-1
TGTGCCAGCAGATTTGGACAGGGGGGCTACACCTTC	CASRFGQGGYTF	TRBV6-5	TRBJ1-2
TGTGCCAGCAGCTTTCGACAGGTTCCCTACGAGCAGTACTTC	CASSFRQVPYEQYF	TRBV5-4	TRBJ2-7
TGCGCCAGCAGCTTGTCCCGGGGGCAAAGAAAGGCCCAGCATTTT	CASSLSRGQRKAQHF	TRBV5-1	TRBJ1-5
TGTGCCAGCAGTGAGCCACTGTACAATGAGCAGTTCTTC	CASSEPLYNEQFF	TRBV6-1	TRBJ2-1
TGCGCCAGCAGCTTTTACCGCCGGGCCTACGAGCAGTACTTC	CASSFYRRAYEQYF	TRBV5-1	TRBJ2-7
TGTGCCAGCAGCTTAGACGCACGGCTGAGACTAGTACCAGCCTACGAGCAGTACTTC	CASSLDARLRLVPAYEQYF	TRBV11-3	TRBJ2-7
TGTGCCAGCAGCCCCCGGGGGGTAGCTGTCCCACAAGAGACCCAGTACTTC	CASSPRGVAVPQETQYF	TRBV6-5	TRBJ2-5
TGTGCCAGCAGTTTATCCAGGCCCTCGCAGTACTTC	CASSLSRPSQYF	TRBV28	TRBJ2-5
TGCAGCGTTGTACCGGAGGGGACCATTAGCAATCAGCCCCAGCATTTT	CSVVPEGTISNQPQHF	TRBV29-1	TRBJ1-5
TGTGCCAGCAGCCCGCAGGCACCCTACGAGCAGTACTTC	CASSPQAPYEQYF	TRBV13	TRBJ2-7
TGTGCCAGCAGCTTATCCCTCCCGGGACCTAGGGAGACCCAGTACTTC	CASSLSLPGPRETQYF	TRBV7-6	TRBJ2-5
TGTGCCAAGAGGAGGACCTGGGTCGAGTTAAAAGAGACCCAGTACTTC	CAKRRTWVELKETQYF	TRBV5-8	TRBJ2-5
TGTGCCAGCAGCTTAAGTAGCGGGGATACGCAGTATTTT	CASSLSSGDTQYF	TRBV7-9	TRBJ2-3
TGTGCCAGCAGCACCCGACAGGAATCCGCGAACACCGGGGAGCTGTTTTTT	CASSTRQESANTGELFF	TRBV5-6	TRBJ2-2
TGTGCCAGCAGGAATCCCCCCCGGGGAGGGAACACTGAAGCTTTCTTT	CASRNPPRGGNTEAFF	TRBV9	TRBJ1-1
TGTGCCAGCAGTTTAGATATGGCTAATAACTACGAGCAGTACTTC	CASSLDMANNYEQYF	TRBV27	TRBJ2-7
TGCGCCAGCAGCTTGGCAAAATCCGGGCGGCAGAACACTGAAGCTTTCTTT	CASSLAKSGRQNTEAFF	TRBV5-1	TRBJ1-1
TGTGCCACCAGTGATTCTATCTTGACAAGCTACAATGAGCAGTTCTTC	CATSDSILTSYNEQFF	TRBV24-1	TRBJ2-1
TGTGCCAGCAGTGGTGCGGGACCCGGCACAGATACGCAGTATTTT	CASSGAGPGTDTQYF	TRBV28	TRBJ2-3
TGTGCCAGCAGAGTTTATAGTGGCAGCTACGAGCAGTACTTC	CASRVYSGSYEQYF	TRBV25-1	TRBJ2-7
TGCAGTGCCGGACGCGAGACCCACTACGAGCAGTACTTC	CSAGRETHYEQYF	TRBV20-1	TRBJ2-7
TGTGCCTGGAGGGGACTCCCTTTGCAAGATAATGAGCAGTTCTTC	CAWRGLPLQDNEQFF	TRBV30	TRBJ2-1
TGCGCCAGCAGCTATGGGGGTAACTATGGCTACACCTTC	CASSYGGNYGYTF	TRBV5-1	TRBJ1-2
TGCGCCAGCAGCTTGGTTCCTCAGCGGTTTTACAATGAGCAGTTCTTC	CASSLVPQRFYNEQFF	TRBV5-1	TRBJ2-1
TGTGCTAGTGGGCCCAAGGGCTATGGCTACACCTTC	CASGPKGYGYTF	TRBV12-5	TRBJ1-2
TGTGCCAGCAGCTCGGACAGGGCTGAAGAGACCCAGTACTTC	CASSSDRAEETQYF	TRBV5-6	TRBJ2-5
TGTGCCAGCAGTTTAGTCACCCTCGCAGGGGGAGGGCAGGATCAGCCCCAGCATTTT	CASSLVTLAGGGQDQPQHF	TRBV28	TRBJ1-5
TGCAGCGTTGTGCCTGGACAGGGAGGGAACTATGGCTACACCTTC	CSVVPGQGGNYGYTF	TRBV29-1	TRBJ1-2
TGTGCCAGCAGCTTGGGCCGACTAGCGGCAGATACGCAGTATTTT	CASSLGRLAADTQYF	TRBV5-5	TRBJ2-3
TGTGCCAGCAGACCCCCCTTCCGGGGGCATAGCAATCAGCCCCAGCATTTT	CASRPPFRGHSNQPQHF	TRBV12-4	TRBJ1-5
TGTGCCAGGGCGGGGTTTAGCGTCTACGAGCAGTACTTC	CARAGFSVYEQYF	TRBV6-1	TRBJ2-7
TGCGCCAGCAGCCAAGATGGTACGCCGGCCCCTAGCACAGATACGCAGTATTTT	CASSQDGTPAPSTDTQYF	TRBV4-1	TRBJ2-3
TGTGCCAGCAGCCAAGATGGGACTTCGGAACTTGGCTCCTACGAGCAGTACTTC	CASSQDGTSELGSYEQYF	TRBV14	TRBJ2-7
TGTGCCACCAGTGAAGGCACAGGGTATAGCAATCAGCCCCAGCATTTT	CATSEGTGYSNQPQHF	TRBV24-1	TRBJ1-5
TGCGGGACAGGGTCCGGGGAGCTGTTTTTT	CGTGSGELFF	TRBV10-2	TRBJ2-2
TGTGCCACCAGCAGAGATATGACAGGGGAGACCCAGTACTTC	CATSRDMTGETQYF	TRBV15	TRBJ2-5
TGTGCCAGCAGCTTGAGGATCCCACCCAAGATAGGCACAGATACGCAGTATTTT	CASSLRIPPKIGTDTQYF	TRBV5-4	TRBJ2-3
TGCGCCAGCTCGAGTCAGCCCCAGCATTTT	CASSSQPQHF	TRBV5-1	TRBJ1-5
TGCGCCAGCATCGCTCTTCCTACGACTAGGGCCGGGGAGCTGTTTTTT	CASIALPTTRAGELFF	TRBV5-1	TRBJ2-2
TGTGCCAGCAGCCGGATGGGCCCCTGCAGGAACACTGAAGCTTTCTTT	CASSRMGPCRNTEAFF	TRBV3-1	TRBJ1-1
TGTGCCAGCAGAGAAGGCTACACCTTC	CASREGYTF	TRBV7-9	TRBJ1-2
TGTGCCAGCAGTACCTGCGGGAGGGTCAAGGGGGCTAATGAAAAACTGTTTTTT	CASSTCGRVKGANEKLFF	TRBV6-5	TRBJ1-4
TGTGCCAGCAGCGTAGCCCCAGGCAACAGAACAGTTGAGACCTACGAGCAGTACTTC	CASSVAPGNRTVETYEQYF	TRBV9	TRBJ2-7
TGCGCCAGCAGCCAAGGCACATCGGGGCAAAATTATAGTAATTCACCCCTCCACTTT	CASSQGTSGQNYSNSPLHF	TRBV4-1	TRBJ1-6
TGTGCCAGCAGTTTAGTAAGGGTCCACGAGCAGTACTTC	CASSLVRVHEQYF	TRBV28	TRBJ2-7
TGTGCCAGCAGTGGGTCGGAGTCTCTTCGGGAGGCCACCCTGAGCTCCTACGAGCAGTACTTC	CASSGSESLREATLSSYEQYF	TRBV27	TRBJ2-7
TGTGCCACCACGAAGACCGGGGTCTTC	CATTKTGVF	TRBV24-1	TRBJ2-7
TGCGCCAGCAGTGAGTGGTCGGGGGCCCCGTTAGGTGGCGATACGCAGTATTTT	CASSEWSGAPLGGDTQYF	TRBV10-1	TRBJ2-3
TGTGCCAGCAGTGTACGGGCAGGAAGCGGGAGAGTTAGCACAGATACGCAGTATTTT	CASSVRAGSGRVSTDTQYF	TRBV6-5	TRBJ2-3
TGCAGCGTTGAAGAGACCGGGCTGCAGGGAGCAGATACGCAGTATTTT	CSVEETGLQGADTQYF	TRBV29-1	TRBJ2-3
TGTGCCAGTAATTCACGGGGCACCTACGAGCAGTACTTC	CASNSRGTYEQYF	TRBV19	TRBJ2-7
TGTGCCAGCAGCCAGATAGACTATGGCTACACCTTC	CASSQIDYGYTF	TRBV7-3	TRBJ1-2
TGTGTGATTCAGGCCTACGAGCAGTACTTC	CVIQAYEQYF	TRBV12-3	TRBJ2-7
TGCAGTGCTAGATGTGGCCCCCGGGGGACGAACACCGGGGAGCTGTTTTTT	CSARCGPRGTNTGELFF	TRBV20-1	TRBJ2-2
TGTGCCAGCAGTTATTGGGATCCTCAGCCCCAGCATTTT	CASSYWDPQPQHF	TRBV6-9	TRBJ1-5
TGTGCCAGCAGCTTAACCTGGGGGGGAACGCAGCCCCAGCATTTT	CASSLTWGGTQPQHF	TRBV5-6	TRBJ1-5
TGTGCCCCGTCAGGGACTCGGCTTAGAGAAGCTTTCTTT	CAPSGTRLREAFF	TRBV19	TRBJ1-1
TGTGCCAGTACGCCCGCGGGAGGCCCCCGTGAGCAGTTCTTC	CASTPAGGPREQFF	TRBV19	TRBJ2-1
TGCGCCAGCAAACCTGGGAAGGATTCCCGGGACAGGGGGCGCTGGATCCGTCGGAACACTGAAGCTTTCTTT	CASKPGKDSRDRGRWIRRNTEAFF	TRBV10-1	TRBJ1-1
TGTGCCAGCTCACCCTCTCAAGGGAGGGGTTGGCACACTGAAGCTTTCTTT	CASSPSQGRGWHTEAFF	TRBV18	TRBJ1-1
TGTGCCAGCAGCTATGGACTGATTTACAATGAGCAGTTCTTC	CASSYGLIYNEQFF	TRBV5-6	TRBJ2-1
TGTGCCAGCAGGGCCTCAGCAGTAAATGATACGCAGTATTTT	CASRASAVNDTQYF	TRBV27	TRBJ2-3
TGTGCCAGCAGCCAAGTGGCTCCCAGGGCGGGCGGAAACACCATATATTTT	CASSQVAPRAGGNTIYF	TRBV3-1	TRBJ1-3
TGTGTCAAAATGTCCGGGCGGGAGACCTACGAGCAGTACTTC	CVKMSGRETYEQYF	TRBV7-9	TRBJ2-7
TGTGCCAGCTCACCACCGGTCTGGGGGGGGAACTATGGCTACACCTTC	CASSPPVWGGNYGYTF	TRBV18	TRBJ1-2
TGCAGTGCTAGCAGCGACAGGGGAACTGAAGCTTTCTTT	CSASSDRGTEAFF	TRBV20-1	TRBJ1-1
TGTGCCAGCAGCGGACAGGACAAAGCTTTCTTT	CASSGQDKAFF	TRBV9	TRBJ1-1
TGTGCCATGAGCGCGAGGACTAGCGGGGCGCATGAGCAGTTCTTC	CAMSARTSGAHEQFF	TRBV27	TRBJ2-1
TGTGCCAGCAGTTTGCCGGGACAGGTTACAGAGACCCAGTACTTC	CASSLPGQVTETQYF	TRBV27	TRBJ2-5
TGTGCCAGCTGGCCAAGGGGATGCGGCACTGAAGCTTTCTTT	CASWPRGCGTEAFF	TRBV5-6	TRBJ1-1
TGTGCCAGCAGGGGAGGAGTTACCGGGACAGCTCGTGGCTACACCTTC	CASRGGVTGTARGYTF	TRBV5-6	TRBJ1-2
TGTGCCAGCAGCCAAGAGAAACTAGCGGGAGAATCAGACTTCTACGAGCAGTACTTC	CASSQEKLAGESDFYEQYF	TRBV14	TRBJ2-7
TGTGCCAGCAGTGAAGGGGAGGTCCGGGACACTATTGATGTTTATCCCGCCTACGAGCAGTACTTC	CASSEGEVRDTIDVYPAYEQYF	TRBV6-1	TRBJ2-7
TGTGCCAGCAGCGTAGGGGACGTATTTAATGAGCAGTTCTTC	CASSVGDVFNEQFF	TRBV9	TRBJ2-1
TGCGCCAGCAGCTTGGAGAAGGGGTCTAGCGGGCGCTTAGCCAAAAACATTCAGTACTTC	CASSLEKGSSGRLAKNIQYF	TRBV5-1	TRBJ2-4
TGCGCCAGCAGTGCTGCGGCGTTGGAAAATGAAAAACTGTTTTTT	CASSAAALENEKLFF	TRBV10-1	TRBJ1-4
TGTGCCCCAGGATTTTCGGGAGAGACCCAGTACTTC	CAPGFSGETQYF	TRBV28	TRBJ2-5
TGTGCCTGGAGTGGGGGAAGGACTTATAGCAATCAGCCCCAGCATTTT	CAWSGGRTYSNQPQHF	TRBV30	TRBJ1-5
TGCGCCAGCAGTACCCCCCTCCCCAGACAGGTATATAGCAATCAGCCCCAGCATTTT	CASSTPLPRQVYSNQPQHF	TRBV10-1	TRBJ1-5
TGTGCCAGCAGTTACGGGGGGCAGGGTGAGGAGGGCGGGGAGCTGTTTTTT	CASSYGGQGEEGGELFF	TRBV6-5	TRBJ2-2
TGCAGCGTTACTTTTTTGACAGATGAAAAACTGTTTTTT	CSVTFLTDEKLFF	TRBV29-1	TRBJ1-4
TGTGCCAGCAGTGACTCCGGGGGACAGGCTACTGGTGGCCAAGAGACCCAGTACTTC	CASSDSGGQATGGQETQYF	TRBV6-4	TRBJ2-5
TGTGCCAGCAGCGAACGGATGTACAATGAGCAGTTCTTC	CASSERMYNEQFF	TRBV13	TRBJ2-1
TGTGCCAGCAGCGTCGTTAGCTCCTACGAGCAGTACTTC	CASSVVSSYEQYF	TRBV9	TRBJ2-7
TGTGCCAGCACTGGGGGGCCCACTCCTCAAATCTCCTACGAGCAGTACTTC	CASTGGPTPQISYEQYF	TRBV19	TRBJ2-7
TGCAGCGGCACTAGCGGGAGGGCAGCCTACACCGGGGAGCTGTTTTTT	CSGTSGRAAYTGELFF	TRBV29-1	TRBJ2-2
TGTGCCAGCAGCGAAGGACAAAATGAGCAGTTCTTC	CASSEGQNEQFF	TRBV7-9	TRBJ2-1
TGTGCCAGCAGCCATAGGGTATCAGTACCGAACACCGGGGAGCTGTTTTTT	CASSHRVSVPNTGELFF	TRBV7-9	TRBJ2-2
TGTGCCATTCAAACAGGGGGGGCGGGTGGCTACACCTTC	CAIQTGGAGGYTF	TRBV10-3	TRBJ1-2
TGTGCCAGCAGCTTAGGTAGACCTAGCGCAGAACCAGATACGCAGTATTTT	CASSLGRPSAEPDTQYF	TRBV7-4	TRBJ2-3
TGTGCCAGCAGTGAAACTTCCAGGGGGGAGACCCAGTACTTC	CASSETSRGETQYF	TRBV6-1	TRBJ2-5
TGTGCCAGCATGGATACAGGGGGCACCACTGAAGCTTTCTTT	CASMDTGGTTEAFF	TRBV27	TRBJ1-1
TGTGCCAGCAGATTACTATCACACGGGGACAGGGCGGACTGTAACACTGAAGCTTTCTTT	CASRLLSHGDRADCNTEAFF	TRBV27	TRBJ1-1
TGTGCCAGCAGTGAAGCGGAGCGTGTGGAATCTGAAGATACGCAGTATTTT	CASSEAERVESEDTQYF	TRBV6-1	TRBJ2-3
TGTGCCAGCAGCGCCTACCGCTACACAGTGAACACTGAAGCTTTCTTT	CASSAYRYTVNTEAFF	TRBV5-6	TRBJ1-1
TGTGCCAGCAGCGGGGGGGGCAAAAAAAACACAGATACGCAGTATTTT	CASSGGGKKNTDTQYF	TRBV14	TRBJ2-3
TGTGCCAGCAGCTTAGGGGGGGGGCCCTCGTATACCGGGGAGCTGTTTTTT	CASSLGGGPSYTGELFF	TRBV11-2	TRBJ2-2
TGTGCCACCGTTAACGTCGGTTGTTGTTACGAGCAGTACTTC	CATVNVGCCYEQYF	TRBV24-1	TRBJ2-7
TGTGCCAGCAGTTCAATCGGCCGTAAAAACAATCAGCCCCAGCATTTT	CASSSIGRKNNQPQHF	TRBV27	TRBJ1-5
TGTGCCATCAATGCCAGGGGGGAGCGGGTATACAATGAGCAGTTCTTC	CAINARGERVYNEQFF	TRBV10-3	TRBJ2-1
TGTGCCAGCAGTAACGCGGGAGGTAAGGCCTACGAGCAGTACTTC	CASSNAGGKAYEQYF	TRBV25-1	TRBJ2-7
TGTGCCAGCATTTTTTTCACCGGGGAGGAGCACAATGAGCAGTTCTTC	CASIFFTGEEHNEQFF	TRBV28	TRBJ2-1
TGTGCCATCAGCTCTCGGGCCAAAAACATTCAGTACTTC	CAISSRAKNIQYF	TRBV10-3	TRBJ2-4
TGTGCCTGGAGTGTAGAGGGGGGCGAGAACACTGAAGCTTTCTTT	CAWSVEGGENTEAFF	TRBV30	TRBJ1-1
TGTGCCACCAGTGCAAGTCAAGGCTCAGGGCAGGTCACTGAAGCTTTCTTT	CATSASQGSGQVTEAFF	TRBV24-1	TRBJ1-1
TGTGCCAGCAGCTTAGACCACGTGTGGCAGTACTTC	CASSLDHVWQYF	TRBV7-9	TRBJ2-5
TGTGCCAGCAGCAACGGGACAGAATTCGAGCAGTACTTC	CASSNGTEFEQYF	TRBV13	TRBJ2-7
TGCAGTCTAGTACTAAATAACTCTGGAAACACCATATATTTT	CSLVLNNSGNTIYF	TRBV20-1	TRBJ1-3
TGTGCCAGCAGCCACAATTCCCAGCGGGAGGGGCCCTACAATGAGCAGTTCTTC	CASSHNSQREGPYNEQFF	TRBV14	TRBJ2-1
TGTGCCAGCAGCTTAGAGGGGTCTGCCTACGAGCAGTACTTC	CASSLEGSAYEQYF	TRBV7-9	TRBJ2-7
TGTGCCAGCAGCTTGGCGTGGCGTCGGGCTAGTCACGAGCAGTACTTC	CASSLAWRRASHEQYF	TRBV5-6	TRBJ2-7
TGTGCCAGCAGTCCGGGGGATAACACTGAAGCTTTCTTT	CASSPGDNTEAFF	TRBV27	TRBJ1-1
TGTGCCAGCAGCTTAAGATGCTGGGGGGGGCCAGATGAGACCCAGTACTTC	CASSLRCWGGPDETQYF	TRBV11-3	TRBJ2-5
TGTGCCAGCAGGGGCGAAAAGCTAGCCAAAAACATTCAGTACTTC	CASRGEKLAKNIQYF	TRBV7-9	TRBJ2-4
TGTGCCAGCAGCTTAAAGCCTCACAGGGTGAACACTGAAGCTTTCTTT	CASSLKPHRVNTEAFF	TRBV7-3	TRBJ1-1
TGTGCCAGCAGCCCCAAAGACAGGGGACGCTCCTACGAGCAGTACTTC	CASSPKDRGRSYEQYF	TRBV3-1	TRBJ2-7
TGTGCCAGCCCCGGGCCCTACAATGAGCAGTTCTTC	CASPGPYNEQFF	TRBV4-2	TRBJ2-1
TGCGCCAGCAGCCGAGGCGGGAGGAACACTGAAGCTTTCTTT	CASSRGGRNTEAFF	TRBV5-1	TRBJ1-1
TGCAGTGCTAGCTACCCAGGGGGAGTTCCTGTCTACGAGCAGTACTTC	CSASYPGGVPVYEQYF	TRBV20-1	TRBJ2-7
TGCGCCAGCAGCCCAACTTGGATCCCGGGGGTAAACACCATATATTTT	CASSPTWIPGVNTIYF	TRBV4-1	TRBJ1-3
TGCGCCAGCAGCCAAGATGAGGGGGATGGCTACACCTTC	CASSQDEGDGYTF	TRBV4-3	TRBJ1-2
TGCGCCAGCAGCTTTGCTACGGAGTCAGAGCAGTACTTC	CASSFATESEQYF	TRBV5-1	TRBJ2-7
TGTGCCAGCAGCGTCAGCATTGGACCTGAGACCCAGTACTTC	CASSVSIGPETQYF	TRBV13	TRBJ2-5
TGTGCCAGCAGTGAATTGGGACAGGCCCACACTGAAGCTTTCTTT	CASSELGQAHTEAFF	TRBV25-1	TRBJ1-1
TGTGCCCCGGGAGGGGGGGTCGGGGAGCTGTTTTTT	CAPGGGVGELFF	TRBV28	TRBJ2-2
TGTGCCAGCAGCATCCAGGACAGGGGGTCGAACACTGAAGCTTTCTTT	CASSIQDRGSNTEAFF	TRBV9	TRBJ1-1
TGCAGTGCTAGACCAGAAGGTAGGGGGCTGGATGGCTACACCTTC	CSARPEGRGLDGYTF	TRBV20-1	TRBJ1-2
TGCGCCAGCAGCAGCGTCGGGGGAACGCACACTGAAGCTTTCTTT	CASSSVGGTHTEAFF	TRBV5-1	TRBJ1-1
TGTGCCAAATCCGACAGGGGGCATGGCTACACCTTC	CAKSDRGHGYTF	TRBV10-3	TRBJ1-2
TGTGCCAGCTCACCATGTAGAGGACAGTCCTACGAGCAGTACTTC	CASSPCRGQSYEQYF	TRBV18	TRBJ2-7
TGTGCCAGCAGCCAACCCAGGGAAGGCCCCTACGAGCAGTACTTC	CASSQPREGPYEQYF	TRBV14	TRBJ2-7
TGCAGTGCTACAGAACACGAGCAGTACTTC	CSATEHEQYF	TRBV20-1	TRBJ2-7
TGTGCCAGCAGTGAGGCCATTCCGCGGAAAACCTGGGGGGACAATCAGCCCCAGCATTTT	CASSEAIPRKTWGDNQPQHF	TRBV2	TRBJ1-5
TGTGCCAGCAGACGTCGACCGGGAGAGACCCAGTACTTC	CASRRRPGETQYF	TRBV7-2	TRBJ2-5
TGTTCTGGGAGGCTGTATAGGTATGAGCAGTTCTTC	CSGRLYRYEQFF	TRBV6-5	TRBJ2-1
TGTGCCACCAGCAGATATTCCGGGGGGGAGCCCACAGATACGCAGTATTTT	CATSRYSGGEPTDTQYF	TRBV15	TRBJ2-3
TGTGCCAGCTCCGGGGTTGGAGATTTTCGGGGGCCCCGAAGCGAAAAACTGTTTTTT	CASSGVGDFRGPRSEKLFF	TRBV18	TRBJ1-4
TGTGCCTGGAGTGTGCCGACTAGCGCTGAGCAGTACTTC	CAWSVPTSAEQYF	TRBV30	TRBJ2-7
TGTGCCAGGGGGCTGGGCTACGAGCAGTACTTC	CARGLGYEQYF	TRBV2	TRBJ2-7
TGTGCCAGCAGCGTAGCCAGGGGGGATACTAGGATAGGTTCACCGGACTTC	CASSVARGDTRIGSPDF	TRBV9	TRBJ2-7
TGCGCCAGCAGCTTCTTTCTCCGCTTGGAGAATGAGCAGTTCTTC	CASSFFLRLENEQFF	TRBV5-1	TRBJ2-1
TGCAGTGCTAGAGCTCAGCAGTTGAATGAGCAGTTCTTC	CSARAQQLNEQFF	TRBV20-1	TRBJ2-1
TGTGCCAGCAGTTACCGGGGGGGCCGCACAGATACGCAGTATTTT	CASSYRGGRTDTQYF	TRBV6-5	TRBJ2-3
TGCAGCACAGTGCTAGGGTTGTATGAGCAGTTCTTC	CSTVLGLYEQFF	TRBV29-1	TRBJ2-1
TGTGCCAGCAGTTACTACCCGGGGGCGCGGAAGGGAGACACTGAAGCTTTCTTT	CASSYYPGARKGDTEAFF	TRBV6-5	TRBJ1-1
TGTGCCAGCTCACGGACAGGGGCGTCCTATGGCTACACCTTC	CASSRTGASYGYTF	TRBV18	TRBJ1-2
TGTGCCAGCACAGGGGTTGGGGACACTGAAGCTTTCTTT	CASTGVGDTEAFF	TRBV27	TRBJ1-1
TGCAGTGCTACTTACATTAGGGGGCTCACAGCAGCCTATGGCTACACCTTC	CSATYIRGLTAAYGYTF	TRBV20-1	TRBJ1-2
TGTGCCAGCAGTTACTCGGAGTGCTCTTGGGTCAACTATGGCTACACCTTC	CASSYSECSWVNYGYTF	TRBV6-5	TRBJ1-2
TGTGCCAGCAGTGTGGGCCAGGGACTAGCGGGCCGTTCAGATACGCAGTATTTT	CASSVGQGLAGRSDTQYF	TRBV2	TRBJ2-3
TGTGCCACCAGTCACTTGGGGCTGCACACCATATATTTT	CATSHLGLHTIYF	TRBV24-1	TRBJ1-3
TGTGCCAGCAGTTTAGACTCTTTTGATACGTTGGAGACCCAGTACTTC	CASSLDSFDTLETQYF	TRBV28	TRBJ2-5
TGTGCCAGCAGCTTAGTGGACCGCAAAGAGACCCAGTACTTC	CASSLVDRKETQYF	TRBV7-8	TRBJ2-5
TGTGCCAGCAGCTCTCGGCACGGGGAAGGACACGAGCAGTACTTC	CASSSRHGEGHEQYF	TRBV9	TRBJ2-7
TGTGCCAGCAGTGACTCGAGTAACAGGGGATGGAACACTGAAGCTTTCTTT	CASSDSSNRGWNTEAFF	TRBV6-4	TRBJ1-1
TGCAGTGCTAGAGATGGTCCCGGGGGAAGGTATAGCAATCAGCCCCAGCATTTT	CSARDGPGGRYSNQPQHF	TRBV20-1	TRBJ1-5
TGCGCCAGCAGCTTGCGTGACAGGGGACCTCTACATGAGCAGTTCTTC	CASSLRDRGPLHEQFF	TRBV5-1	TRBJ2-1
TGTGCCAGGTGGAGAGAACTAGCGGACGGATCCCGGGGTGTCTCTGGAAACACCATATATTTT	CARWRELADGSRGVSGNTIYF	TRBV27	TRBJ1-3
TGTGCCAGCAGGGTTGGGAGGCGACAGCCCCAGCATTTT	CASRVGRRQPQHF	TRBV7-6	TRBJ1-5
TGTGCCAGCAGTTACCTGAAACATTGCAGGGAGTACGAGCAGTACTTC	CASSYLKHCREYEQYF	TRBV6-6	TRBJ2-7
TGCAGGATACGAGGGTGCGAGGTGAACACTGAAGCTTTCTTT	CRIRGCEVNTEAFF	TRBV20-1	TRBJ1-1
TGTGCCAGCAGCCAAGGATCCGAAGTTGGGGTGGGGGATGAGCAGTACTTC	CASSQGSEVGVGDEQYF	TRBV14	TRBJ2-7
TGTGCCAGCAGCGGAGTGAAGAGCTCACCCCTCCACTTT	CASSGVKSSPLHF	TRBV7-9	TRBJ1-6
TGTGCCAGCAGCTTAGCCGGGTACCGGGACAGGGGGGGAGTTTTCGAGGACGAGCAGTACTTC	CASSLAGYRDRGGVFEDEQYF	TRBV7-9	TRBJ2-7
TGCGCCAGCAGCCGGGGTCAGGGGCATACTAATGAAAAACTGTTTTTT	CASSRGQGHTNEKLFF	TRBV4-3	TRBJ1-4
TGTGCCAGCAGTTCTGGACAGGGGGCTCACTCCACCGGGGAGCTGTTTTTT	CASSSGQGAHSTGELFF	TRBV27	TRBJ2-2
TGTGCTAGTGGTTTGCAAATAGGGGGGGTTGAGCAGTACTTC	CASGLQIGGVEQYF	TRBV12-5	TRBJ2-7
TGTGCCACCAGCAGAGATGCCCCCACAGGGGGCGCCCTAGGGCAGACTAGCACAGATACGCAGTATTTT	CATSRDAPTGGALGQTSTDTQYF	TRBV15	TRBJ2-3
TGTGCCAGCAGCAAGTCCACAGGGTCTTCCTACAATGAGCAGTTCTTC	CASSKSTGSSYNEQFF	TRBV13	TRBJ2-1
TGTGCCAGCAGCCGGAGGAGCGGACATGCCAATTCACCCCTCCACTTT	CASSRRSGHANSPLHF	TRBV3-1	TRBJ1-6
TGTGCCAGCTCACCACGTTCCCCCAGGGGGCCCTCCTACGAGCAGTACTTC	CASSPRSPRGPSYEQYF	TRBV18	TRBJ2-7
TGTGCCAGCAGCCCGGGGGATTGGGTGGAGCATCGCTCCTATAATTCACCCCTCCACTTT	CASSPGDWVEHRSYNSPLHF	TRBV3-1	TRBJ1-6
TGTGCCAGCTCACCACGGGACAGGACGGAGCCGAACACCGGGGAGCTGTTTTTT	CASSPRDRTEPNTGELFF	TRBV18	TRBJ2-2
TGTGCCAGCAGTGTGGTCCGGGACGATTTTAGCTCCTACAATGAGCAGTTCTTC	CASSVVRDDFSSYNEQFF	TRBV6-5	TRBJ2-1
TGTGCCAGCAGCGGGGGCCGGGGAGACAATGAGCAGTTCTTC	CASSGGRGDNEQFF	TRBV11-2	TRBJ2-1
TGTGCCAGCAGGTCGGGGGATGGGGCCAAAAACATTCAGTACTTC	CASRSGDGAKNIQYF	TRBV6-8	TRBJ2-4
TGCAGTGCTAGTCTCCAGGACTGGGGGTTTGCGGGGGTCGGAAACACCATATATTTT	CSASLQDWGFAGVGNTIYF	TRBV20-1	TRBJ1-3
TGCGCCAGCCGGGCGACAGGGAATTCCTACGAGCAGTACTTC	CASRATGNSYEQYF	TRBV10-1	TRBJ2-7
TGTGCCAGCAGCCGACAGGGTAGCCACTATGGCTACACCTTC	CASSRQGSHYGYTF	TRBV5-5	TRBJ1-2
TGTGCCAGCAGCGGAGCGGGGCCCTACGAGCAGTACTTC	CASSGAGPYEQYF	TRBV7-9	TRBJ2-7
TGCGCCAGCAGCCAAGCAGGGGTAGTAAACTATGGCTACACCTTC	CASSQAGVVNYGYTF	TRBV4-1	TRBJ1-2
TGTGCCAGCTCACGAGGGACAGGGGGCGGCGGCACAGATACGCAGTATTTT	CASSRGTGGGGTDTQYF	TRBV27	TRBJ2-3
TGTGCCAGCAACGTCACAGGGGGTTGGAACACTGAAGCTTTCTTT	CASNVTGGWNTEAFF	TRBV28	TRBJ1-1
TGCAGCGTTTACCCGGGACAGGGGGGCAATCAGCCCCAGCATTTT	CSVYPGQGGNQPQHF	TRBV29-1	TRBJ1-5
TGCGCCAGCAGTAATGGGGGCACAGATACGCAGTATTTT	CASSNGGTDTQYF	TRBV10-1	TRBJ2-3
TGTGCCAGCAGTGACGGGATAATTTGGTTGACAGGGGTAACGAGAGACACTGAAGCTTTCTTT	CASSDGIIWLTGVTRDTEAFF	TRBV6-4	TRBJ1-1
TGTGCCAGCAGTAGAGCGCTCCACAATGGAAACACCATATATTTT	CASSRALHNGNTIYF	TRBV12-3	TRBJ1-3
TGTGCCAGCAGCTGGGGAAAAGATAGGCGAGAGACCCAGTACTTC	CASSWGKDRRETQYF	TRBV7-2	TRBJ2-5
TGCGCCAGCAGTGAGGGTACGGTTAAGGCTCATGGCTACACCTTC	CASSEGTVKAHGYTF	TRBV10-1	TRBJ1-2
TGCGCCAGCAGTGAGGCCGTAAGACAGAGCTCCTACGAGCAGTACTTC	CASSEAVRQSSYEQYF	TRBV10-2	TRBJ2-7
TGTGCCAGCAGAGATCCACTGGTAACGTCGGTGAAATCAGATACGCAGTATTTT	CASRDPLVTSVKSDTQYF	TRBV12-3	TRBJ2-3
TGTGCCAGCAGCTTAGAGTGTAGCGGGCCCCCCTCCTACGAGCAGTACTTC	CASSLECSGPPSYEQYF	TRBV11-3	TRBJ2-7
TGTGCCAGCAGTTACGGACGGACAGGGGGGGGAGACACCGGGGAGCTGTTTTTT	CASSYGRTGGGDTGELFF	TRBV6-5	TRBJ2-2
TGCAGTGCTAGACGCTATGGACTCCAAGAGACCCAGTACTTC	CSARRYGLQETQYF	TRBV20-1	TRBJ2-5
TGCGCCCCCCTTGACAGGGCTGAGGGGTCGGTGGGCCAGCCCCAGCATTTT	CAPLDRAEGSVGQPQHF	TRBV10-2	TRBJ1-5
TGTGCCAGCAGGAAAATACAGGGGGCTTCGAATCAAGAGACCCAGTACTTC	CASRKIQGASNQETQYF	TRBV6-5	TRBJ2-5
TGCAGTGCTGGAACCCCACAGGGGGCCTATGGCTACACCTTC	CSAGTPQGAYGYTF	TRBV20-1	TRBJ1-2
TGCAGTGCTACCCCACAGGGGGGTCGCGAGCAGTACTTC	CSATPQGGREQYF	TRBV20-1	TRBJ2-7
TGTGCCAGCAGCAGTACCCCCGTTCGACAGGGCCCGATAGATAGCAATCAGCCCCAGCATTTT	CASSSTPVRQGPIDSNQPQHF	TRBV11-2	TRBJ1-5
TGTGCCAGCACGTTGCGGGAGGGCCCTAGGGGGTACGAGCAGTACTTC	CASTLREGPRGYEQYF	TRBV6-1	TRBJ2-7
TGTGCCAGCAGGGTAAACCTTAAAGCCAAAAACATTCAGTACTTC	CASRVNLKAKNIQYF	TRBV6-2	TRBJ2-4
TGTGCCAGCACAACCAGCTCCAGCACAGATACGCAGTATTTT	CASTTSSSTDTQYF	TRBV27	TRBJ2-3
TGTGCCAGCAGTCCCTCCAGATCCCGCAGGGGACTCTCCTACGAGCAGTACTTC	CASSPSRSRRGLSYEQYF	TRBV6-2	TRBJ2-7
TGTGCCAGCAGCTTGACGATGTTTAGGGGACCTAAAACGGGCAACACTGAAGCTTTCTTT	CASSLTMFRGPKTGNTEAFF	TRBV11-3	TRBJ1-1
TGTGCCAGAGTGGAGTGGAGAAATGAGCAGTTCTTC	CARVEWRNEQFF	TRBV7-2	TRBJ2-1
TGTGCCAGCAGGACTCGGGGAAGGCACTATGGCTACACCTTC	CASRTRGRHYGYTF	TRBV6-6	TRBJ1-2
TGTGCCACCAGTGACTTGGGACAGGGAAACAACACCGGGGAGCTGTTTTTT	CATSDLGQGNNTGELFF	TRBV24-1	TRBJ2-2
TGTGCCAGCAGTTCTCGGGACCATGAGCAGTTCTTC	CASSSRDHEQFF	TRBV6-6	TRBJ2-1
TGCGCCAGCAGTAGATCCGTAGAGTATGAGCAGTTCTTC	CASSRSVEYEQFF	TRBV10-1	TRBJ2-1
TGTGCCAGCAGCTTAGTCTTACTAGCGGGAGCCGCGGATTCGAAAGGCAATGAGCAGTTCTTC	CASSLVLLAGAADSKGNEQFF	TRBV7-2	TRBJ2-1
TGTGCCAGCAGTTTAAACAGGGCGGGTCAGCCCCAGCATTTT	CASSLNRAGQPQHF	TRBV12-4	TRBJ1-5
TGCGCCAGCAGTCCCGGGCCTGGAAACACCATATATTTT	CASSPGPGNTIYF	TRBV10-1	TRBJ1-3
TGTGCCAGCAGCTTGGGGGACAGGGATCTCTACGAGCAGTACTTC	CASSLGDRDLYEQYF	TRBV7-9	TRBJ2-7
TGTGCCAGCAGCACGGGGGGTAACAGCTCCTACGAGCAGTACTTC	CASSTGGNSSYEQYF	TRBV13	TRBJ2-7
TGTGCCAGCTCATCGTGGGACAGGGCATCAGAGTACAATGAGCAGTTCTTC	CASSSWDRASEYNEQFF	TRBV18	TRBJ2-1
TGTGCCAAGGGGAGAGGGCGTACTAATGAAAAACTGTTTTTT	CAKGRGRTNEKLFF	TRBV9	TRBJ1-4
TGTGCCAGCAGTGTTAGGGCCCTCAACTACGAGCAGTACTTC	CASSVRALNYEQYF	TRBV6-5	TRBJ2-7
TGTGCCAGCAGTGAAAGGCCTCCGGGACAGGGCGTGGCTTTCTTT	CASSERPPGQGVAFF	TRBV25-1	TRBJ1-1
TGTGCCAGCAGCTTAGGGTCCACAGGGGTCCTGACGACTAATGAAAAACTGTTTTTT	CASSLGSTGVLTTNEKLFF	TRBV11-2	TRBJ1-4
TGCAGCGCCCAGGGGACTTGGGCAGATAATGAAAAACTGTTTTTT	CSAQGTWADNEKLFF	TRBV29-1	TRBJ1-4
TGTGCCAGCGATTATTTGCTGTGGGACAGTTGTCGGTACACCGGGGAGCTGTTTTTT	CASDYLLWDSCRYTGELFF	TRBV5-8	TRBJ2-2
TGTGCCAGCACCTTGTCACCGGGGTCAGGGGGGTCGATACCAGAGACCCAGTACTTC	CASTLSPGSGGSIPETQYF	TRBV6-2	TRBJ2-5
TGTGCCAGCCTTGGGGAGGCCGGGACCGGCAATGAGCAGTTCTTC	CASLGEAGTGNEQFF	TRBV14	TRBJ2-1
TGCGCCAGCAGTTTCGGGGGGGACACCGGGGAGCTGTTTTTT	CASSFGGDTGELFF	TRBV10-1	TRBJ2-2
TGTGCCAGCAGTTACTCGAGACCCAGGGCGAACTATGGCTACACCTTC	CASSYSRPRANYGYTF	TRBV6-5	TRBJ1-2
TGTGCCAGCAGCTTAGTCACTGAGGCAGAGCAGTACTTC	CASSLVTEAEQYF	TRBV7-6	TRBJ2-7
TGTGCCAGCAGTGTATGGACAGGGCGAGACTACGAGCAGTACTTC	CASSVWTGRDYEQYF	TRBV25-1	TRBJ2-7
TGCGCCAGGACCCCGGACTGCGACGAGCAGTACTTC	CARTPDCDEQYF	TRBV10-1	TRBJ2-7
TGTGCCAGCCGTGGACTAGCGGGGTTAGAGACCCAGTACTTC	CASRGLAGLETQYF	TRBV19	TRBJ2-5
TGCAGTGCTATAACCACGAAGGCCCAAGTTCAGCCCCAGCATTTT	CSAITTKAQVQPQHF	TRBV20-1	TRBJ1-5
TGTGCCAGCAGTGACGTACCGGATGGCTACACCTTC	CASSDVPDGYTF	TRBV6-4	TRBJ1-2
TGTGCCAGCAGGTACTGGACTAGCGGGGTATTCAATGAGCAGTTCTTC	CASRYWTSGVFNEQFF	TRBV2	TRBJ2-1
TGTGCCAGCAGCCAAGATCCAGCCCTGGATTCACCCCTCCACTTT	CASSQDPALDSPLHF	TRBV4-2	TRBJ1-6
TGTGCCAGCAGCTTTTTGGGTACGGACGACCAAGGACCATATCAGCCCCAGCATTTT	CASSFLGTDDQGPYQPQHF	TRBV11-2	TRBJ1-5
TGCGCCAGCAGCTTCCCAGGGAGGGGGGATACGCAGTATTTT	CASSFPGRGDTQYF	TRBV5-1	TRBJ2-3
TGTGCCAGCAGCTTAGGGCGGGGCCCAGTGAGTTTGTATAGCAATCAGCCCCAGCATTTT	CASSLGRGPVSLYSNQPQHF	TRBV7-6	TRBJ1-5
TGTGCCAGCAGCTTAGACAAGGGGCAGAACACTGAAGCTTTCTTT	CASSLDKGQNTEAFF	TRBV11-2	TRBJ1-1
TGTGCCACCAGCAGAGGTTATAGGGTTAGCTCCTACAATGAGCAGTTCTTC	CATSRGYRVSSYNEQFF	TRBV15	TRBJ2-1
TGTGCCAGCAGCTTAGAGGGAAGGGAGGGGTTCAGCTCGAATGACCACTGCACAGATACGCAGTATTTT	CASSLEGREGFSSNDHCTDTQYF	TRBV7-9	TRBJ2-3
TGCGCCAGCAGCTTGCACCGGACGGCGGGTGAGCAGTTCTTC	CASSLHRTAGEQFF	TRBV5-1	TRBJ2-1
TGTGCCAGCAGCGACGGGACAGGGGGCTACACCTTC	CASSDGTGGYTF	TRBV13	TRBJ1-2
TGTGCCAGCAGCTTAGGCTGGACTCTTACAGATACGCAGTATTTT	CASSLGWTLTDTQYF	TRBV7-9	TRBJ2-3
TGTGCCACCAGTGACCGGGGGCACCCCTATAATTCACCCCTCCACTTT	CATSDRGHPYNSPLHF	TRBV24-1	TRBJ1-6
TGTGCCAGCAGCTCTAATCCGGGACAGGGTGGGGATAGCAATCAGCCCCAGCATTTT	CASSSNPGQGGDSNQPQHF	TRBV7-3	TRBJ1-5
TGTGCCAGCAGCGTGGTTATGGGGGTGCCTAATGAAAAACTGTTTTTT	CASSVVMGVPNEKLFF	TRBV7-4	TRBJ1-4
TGTGCCAGCAGCTTAGGAATACTAGCGGGAGCGACAGAGAACGAGCAGTACTTC	CASSLGILAGATENEQYF	TRBV7-4	TRBJ2-7
TGTGCCTGGATCATCACGCAGAGGAGTGAGCAGTTCTTC	CAWIITQRSEQFF	TRBV30	TRBJ2-1
TGCGCCAGCAGCCATCAAGCGGTCTATGGCTACACCTTC	CASSHQAVYGYTF	TRBV4-1	TRBJ1-2
TGTGCCAGCAGCCAGGAGGCGAGACAGGGGGAACGCGTGAGCTCCTACGAGCAGTACTTC	CASSQEARQGERVSSYEQYF	TRBV5-6	TRBJ2-7
TGCGCCAGCAGCTTGACACAGGGAGGGGAGAATGAAAAACTGTTTTTT	CASSLTQGGENEKLFF	TRBV5-1	TRBJ1-4
TGTGCCAGCAGCCGCTGGACCCACCTGTGGCCCCGGACTGAAGCTTTCTTT	CASSRWTHLWPRTEAFF	TRBV3-1	TRBJ1-1
TGTGCCATCAGTGAGTCCTCTCACTCCGGGGGAAGAGGAAGAAACACCGGGGAGCTGTTTTTT	CAISESSHSGGRGRNTGELFF	TRBV10-3	TRBJ2-2
TGTGCCAGCAGCTTAGCCCCCCGGACGGAAGCCTACGAGCAGTACTTC	CASSLAPRTEAYEQYF	TRBV13	TRBJ2-7
TGTGCCAGCAGCCACCGAAGGGACACAGATACGCAGTATTTT	CASSHRRDTDTQYF	TRBV14	TRBJ2-3
TGTGCCTGGAGTTCCAAGGCAGGGGGGAGGAACACTGAAGCTTTCTTT	CAWSSKAGGRNTEAFF	TRBV30	TRBJ1-1
TGTGCCAGCAGTGCGACTAGCGGGGTCCCCTACAATGAGCAGTTCTTC	CASSATSGVPYNEQFF	TRBV6-4	TRBJ2-1
TGTGCCACCAGTGATCGGAAACAGGACCAAGAGACCCAGTACTTC	CATSDRKQDQETQYF	TRBV24-1	TRBJ2-5
TGTGCCAGCAGGCTGAGGTCGGGTAGGGGGAAGACCCAGTACTTC	CASRLRSGRGKTQYF	TRBV12-4	TRBJ2-5
TGTGCCAGCACCCTTCCCGGGCCCTTCTGCAATGAGCAGTTCTTC	CASTLPGPFCNEQFF	TRBV6-1	TRBJ2-1
TGTGCCACCAGTGGGTGGGCGTCCTACGAGCAGTACTTC	CATSGWASYEQYF	TRBV24-1	TRBJ2-7
TGCAGTGCTAGAGGGGGGGCCCCAGATACGCAGTATTTT	CSARGGAPDTQYF	TRBV20-1	TRBJ2-3
TGTGCCATCAGGCCGGGACACACCGGGGAGCTGTTTTTT	CAIRPGHTGELFF	TRBV10-3	TRBJ2-2
TGCGCCAGCAGCTTGGAGGGGGGCCCTCATTCACCCCTCCACTTT	CASSLEGGPHSPLHF	TRBV5-1	TRBJ1-6
TGTGAGGACAGGGGTACCCTCCACTTT	CEDRGTLHF	TRBV12-3	TRBJ1-6
TGTGCCCGGGGGGGGAACACTGAGCAGTTCTTC	CARGGNTEQFF	TRBV9	TRBJ2-1
TGTGCCAGCAGCGTGTGTTTCTCAGGGAGGGATCAGCCCCAGCATTTT	CASSVCFSGRDQPQHF	TRBV9	TRBJ1-5
TGTGCCAGCATCCGGGACAGGGGGGGAAACACCATATATTTT	CASIRDRGGNTIYF	TRBV25-1	TRBJ1-3
TGTGCCAGCAGCGAGGCTTTGGCAGGGCCCTTTACTTCTAACTATGGCTACACCTTC	CASSEALAGPFTSNYGYTF	TRBV9	TRBJ1-2
TGTGCCAGCAGTTTACCCCGGCAGGGGGATGGCTACACCTTC	CASSLPRQGDGYTF	TRBV27	TRBJ1-2
TGTGCCAGCAGTGGGCAGGGTAGCAATCAGCCCCAGCATTTT	CASSGQGSNQPQHF	TRBV6-5	TRBJ1-5
TGCAGTGCTAGAGGCGCACGAGGGGTAGCAACTAATGAAAAACTGTTTTTT	CSARGARGVATNEKLFF	TRBV20-1	TRBJ1-4
TGTGCCAGCAGCGTACTCGGGGAACGAGAAAAACTGTTTTTT	CASSVLGEREKLFF	TRBV9	TRBJ1-4
TGCAGTGCTATGACCCAACCTCAGCCCCAGCATTTT	CSAMTQPQPQHF	TRBV20-1	TRBJ1-5
TGTGCCAGCAGCATGAGGGGACAGGGCTATGGCTACACCTTC	CASSMRGQGYGYTF	TRBV5-6	TRBJ1-2
TGTGCCAGCCGTATAAACTACGAGCAGTACTTC	CASRINYEQYF	TRBV7-9	TRBJ2-7
TGTGCCAGCAGTCCCCGGGGCGGGGCGGAGCAGTACTTC	CASSPRGGAEQYF	TRBV6-4	TRBJ2-7
TGTGCCAGCAGCTTGCAGGCCGGAAATGAAAAACTGTTTTTT	CASSLQAGNEKLFF	TRBV5-4	TRBJ1-4
TGTGCCAGCAGCCAAGATCTCTTTTATGAAGAGACCCAGTACTTC	CASSQDLFYEETQYF	TRBV14	TRBJ2-5
TGTGCCAGCAGCTTTGAACGACCAGACAACAGGGACACTGAAGCTTTCTTT	CASSFERPDNRDTEAFF	TRBV11-2	TRBJ1-1
TGTGCCAGCAGCAGTCTGACTGCTCTGCGGACAGGGAGCAATCAGCCCCAGCATTTT	CASSSLTALRTGSNQPQHF	TRBV9	TRBJ1-5
TGTGCCAGCTTACAGGGACACCCGGTGGTCAAAACCCAGTACTTC	CASLQGHPVVKTQYF	TRBV7-3	TRBJ2-5
TGCGCCAGCAGCTTGCCCCCCCCCCAGCGGGAAATCCTTCGGGGACTCGAGCAGTACTTC	CASSLPPPQREILRGLEQYF	TRBV5-1	TRBJ2-7
TGTGCCACCCCGGGCGGAGGGGAACCCTACAATGAGCAGTTCTTC	CATPGGGEPYNEQFF	TRBV24-1	TRBJ2-1
TGTGCCATCAGTGAGCCCGGGAGGGGAAGCCTTCCTGGAAACACCATATATTTT	CAISEPGRGSLPGNTIYF	TRBV10-3	TRBJ1-3
TGCGCCAGCAGCCAAGGAATGCCGGGGGAGGGCAAGGTTGGCTACACCTTC	CASSQGMPGEGKVGYTF	TRBV4-1	TRBJ1-2
TGCGCCAGCAGCTTGTCAGAGGAGGGGGGTTGGTTCAATGAGCAGTTCTTC	CASSLSEEGGWFNEQFF	TRBV5-1	TRBJ2-1
TGTGCCATCAGTGTTGGGACAGGGGTGCGCACCCACTCCTACGAGCAGTACTTC	CAISVGTGVRTHSYEQYF	TRBV10-3	TRBJ2-7
TGCGCCAGCAGTTTGGGGGACACTGAAGCTTTCTTT	CASSLGDTEAFF	TRBV10-1	TRBJ1-1
TGTGTGGGACCAGCAGAGACCCAGTACTTC	CVGPAETQYF	TRBV28	TRBJ2-5
TGTGCCAGCAGGAGGGTACTAGCGGGAGGCAGGGGACCCTCCTACAATGAGCAGTTCTTC	CASRRVLAGGRGPSYNEQFF	TRBV6-1	TRBJ2-1
TGTGCCAGCAGCCAATCGTTCTACCGGACAGGTAGCCTCAATCAGCCCCAGCATTTT	CASSQSFYRTGSLNQPQHF	TRBV3-1	TRBJ1-5
TGTGCCAGCAGCCAAGCCGGAGGAGGAGAGACCCAGTACTTC	CASSQAGGGETQYF	TRBV3-1	TRBJ2-5
TGTGCCAGCAGCCAAGATTTAGGGGTTGACGTCCACGGGGAGCTGTTTTTT	CASSQDLGVDVHGELFF	TRBV4-2	TRBJ2-2
TGTGCCAGCAGCGTAGAACCCCTATTCTATGGCTACACCTTC	CASSVEPLFYGYTF	TRBV9	TRBJ1-2
TGTGCCAGCAGCTTACTTGCGGCGAGCTCCTACAATGAGCAGTTCTTC	CASSLLAASSYNEQFF	TRBV7-8	TRBJ2-1
TGCGCCAGCAGCTTGTTCCTAGCGGGAGGTGAGCAGTTCTTC	CASSLFLAGGEQFF	TRBV5-1	TRBJ2-1
TGTGCCAGCAGTGAGACTAGCCTCCCAAACGAGCAGTACTTC	CASSETSLPNEQYF	TRBV6-1	TRBJ2-7
TGTGCCAGCAGTGGTGTCCGACGACAGATCGGGTCCCTGTATAGCAATCAGCCCCAGCATTTT	CASSGVRRQIGSLYSNQPQHF	TRBV6-3	TRBJ1-5
TGTGCCAGCCTTCGGGTCGATGTGAGAAGCTCCTACGAGCAGTACTTC	CASLRVDVRSSYEQYF	TRBV11-3	TRBJ2-7
TGTGCCAGCAGCTTAGCCCCGGGGCACAGGCTGACCGGGGAGCTGTTTTTT	CASSLAPGHRLTGELFF	TRBV7-9	TRBJ2-2
TGCAGTGCTAGATTCCAGGGGGATGGAAACACCATATATTTT	CSARFQGDGNTIYF	TRBV20-1	TRBJ1-3
TGTGCCAGCAGTTTATCAAAGAGCTCCGCTTTCTTT	CASSLSKSSAFF	TRBV28	TRBJ1-1
TGTGCTAGTGGTTCCCCTAACGGGCCCGGAACCGGGGAGCTGTTTTTT	CASGSPNGPGTGELFF	TRBV12-5	TRBJ2-2
TGCAGTGCTAGAGATCGAACCGGGAGGTCCGACTACGAGCAGTACTTC	CSARDRTGRSDYEQYF	TRBV20-1	TRBJ2-7
TGTGCCAGCAGCGGCCACAGGGTAGCTGGAAACACCATATATTTT	CASSGHRVAGNTIYF	TRBV7-2	TRBJ1-3
TGTGCCAGCAATCAGGGAGGTCCCTACGAGCAGTACTTC	CASNQGGPYEQYF	TRBV7-3	TRBJ2-7
TGTGCCAGCAGTACGACGAGGGGCGGGGAGCTGTTTTTT	CASSTTRGGELFF	TRBV6-2	TRBJ2-2
TGTGCCAGCAGCAATAGACGTAGGGGGGGGATCGAGCAGTACTTC	CASSNRRRGGIEQYF	TRBV7-4	TRBJ2-7
TGTGCCAGCAGCCAGAATTGGACAGGGTCAGCCCAGCATTTT	CASSQNWTGSAQHF	TRBV4-2	TRBJ1-5
TGCAGCGCAGGGAGTAGCAAATTTCTGAACACTGAAGCTTTCTTT	CSAGSSKFLNTEAFF	TRBV29-1	TRBJ1-1
TGTGCCAGCTCCTGGGGGGCGGACTCCTACGAGCAGTACTTC	CASSWGADSYEQYF	TRBV18	TRBJ2-7
TGTGCCGACCCAGGGACTAGCCAAGAGACCCAGTACTTC	CADPGTSQETQYF	TRBV24-1	TRBJ2-5
TGTGCCAGCAGCTCACAGGGAGAATCTGGGGCCAACGTCCTGACTTTC	CASSSQGESGANVLTF	TRBV5-4	TRBJ2-6
TGTGCCACCAGCAGAGCTAGGGCCCGCTACAATGAGCAGTTCTTC	CATSRARARYNEQFF	TRBV15	TRBJ2-1
TGTGCCAGCAGCTTAATTGACTTACCCTCCTACGAGCAGTACTTC	CASSLIDLPSYEQYF	TRBV11-2	TRBJ2-7
TGTGCCAGCAGCGCGACGAGCGGATGTGAGCAGTACTTC	CASSATSGCEQYF	TRBV7-9	TRBJ2-7
TGCAGTGCAACCGTTAGTGAGCAGTTCTTC	CSATVSEQFF	TRBV20-1	TRBJ2-1
TGCGCCAGCAGGCCTATTCGGCGAACCGTATACAATGAGCAGTTCTTC	CASRPIRRTVYNEQFF	TRBV5-1	TRBJ2-1
TGTGCCAGCAGTGACCATAACGGACAGTCCGGGGCCAGGGCCTCCTATAATTCACCCCTCCACTTT	CASSDHNGQSGARASYNSPLHF	TRBV6-1	TRBJ1-6
TGTGCCAGCAGGGCTCCCTACGAGCAGTACTTC	CASRAPYEQYF	TRBV25-1	TRBJ2-7
TGTGCCAGCGGGGGGAGGCAGTATTTT	CASGGRQYF	TRBV6-2	TRBJ2-3
TGTGCCAGCAGTTACTCGAGTTCCCCATCTGGAAACACCATATATTTT	CASSYSSSPSGNTIYF	TRBV6-5	TRBJ1-3
TGCAGCGATGTCGCAGCCGGGGGGGGGCTTCAAGAGACCCAGTACTTC	CSDVAAGGGLQETQYF	TRBV29-1	TRBJ2-5
TGTGCCAGCAGCCAAGAGTACGGGAGGGGGGTAGAGCCCTACGAGCAGTACTTC	CASSQEYGRGVEPYEQYF	TRBV14	TRBJ2-7
TGTGCCAGCCGCCAACGATATAAGACGCAGTATTTT	CASRQRYKTQYF	TRBV6-4	TRBJ2-3
TGTGCCACCAGTGATTTCCCGGGCTTCCCGGGACAGGGCCCGGCTTCCTACGAGCAGTACTTC	CATSDFPGFPGQGPASYEQYF	TRBV24-1	TRBJ2-7
TGCGCCAGCAGCTTGACAGGTCGTGGTGAAGCTTTCTTT	CASSLTGRGEAFF	TRBV5-1	TRBJ1-1
TGTGCCAGCAGACCTTGGGGGGTAGAGACCCAGTACTTC	CASRPWGVETQYF	TRBV6-5	TRBJ2-5
TGTGCCAGCCGATCCTACTACTACGAGCAGTACTTC	CASRSYYYEQYF	TRBV7-9	TRBJ2-7
TGTGCCAGCAGTTACGCCGAGGGAGGGAGAGATACGCAGTATTTT	CASSYAEGGRDTQYF	TRBV6-6	TRBJ2-3
TGTGCCAGCAGCCCATTGTCGTCGGGCAGGGCGCTTGGAAACACCATATATTTT	CASSPLSSGRALGNTIYF	TRBV5-6	TRBJ1-3
TGTGCCAGCAGTTCCGGACAGGGGGCGCAGAACACTGAAGCTTTCTTT	CASSSGQGAQNTEAFF	TRBV6-5	TRBJ1-1
TGTGCCAGCAGCCAAGAGACCCCCCCTGACGACGAGACCCAGTACTTC	CASSQETPPDDETQYF	TRBV14	TRBJ2-5
TGTGCCACCAACTACCGGGACGTTAGCAATCAGCCCCAGCATTTT	CATNYRDVSNQPQHF	TRBV24-1	TRBJ1-5
TGTGCCATCAGTGGGCAGGGTGATGTAACAACTAATGAAAAACTGTTTTTT	CAISGQGDVTTNEKLFF	TRBV10-3	TRBJ1-4
TGCGCCAGCAGCTTGACGGATTACCGCTACGAGCAGTACTTC	CASSLTDYRYEQYF	TRBV5-1	TRBJ2-7
TGTGCCAGCAGTTACTCGAGTGACAGCACAGATACGCAGTATTTT	CASSYSSDSTDTQYF	TRBV6-5	TRBJ2-3
TGTGCCAGTAGTATCCTAACCAAGCAACCGGGGGCGAACACTGAAGCTTTCTTT	CASSILTKQPGANTEAFF	TRBV19	TRBJ1-1
TGCGCCAGCAGTGAGGCTGGGGAGGACGGGACCCAGTACTTC	CASSEAGEDGTQYF	TRBV10-1	TRBJ2-5
TGCGCCAGCAGCGAAGGACAGGTTCCGGCGGGGATTGCCTACGAGCAGTACTTC	CASSEGQVPAGIAYEQYF	TRBV5-1	TRBJ2-7
TGTGCCAGCAGTCTGAAGAGGACAGCAGGCCCCTGGGGCTACAATGAGCAGTTCTTC	CASSLKRTAGPWGYNEQFF	TRBV27	TRBJ2-1
TGTGCCAGCAGTATGGACAGGGCTTTCTCCTACGAGCAGTACTTC	CASSMDRAFSYEQYF	TRBV27	TRBJ2-7
TGCAGTGCCCTGCGTAAATCGGCCTACAATGAGCAGTTCTTC	CSALRKSAYNEQFF	TRBV20-1	TRBJ2-1
TGTGCCAGCAGTGGGGACTGGCGCGGGGAGCTGTTTTTT	CASSGDWRGELFF	TRBV6-5	TRBJ2-2
TGTGCCAGCAGCTTAGGACTAGCGGGGTGCGGGGAGCTGTTTTTT	CASSLGLAGCGELFF	TRBV7-2	TRBJ2-2
TGTGCCAGCAGTTCCTATAGACTAGCGGAAGACCTCTCTGGGGCCAACGTCCTGACTTTC	CASSSYRLAEDLSGANVLTF	TRBV6-3	TRBJ2-6
TGTGCCAGCAACGCGGGAGCGGATGGCTACACCTTC	CASNAGADGYTF	TRBV6-5	TRBJ1-2
TGTGCCAGCAGCCAAGACGTACTAGCGGGAGATATTAATGAAAAACTGTTTTTT	CASSQDVLAGDINEKLFF	TRBV4-2	TRBJ1-4
TGTGCCAGCAGGGTCCTGACGGGAACTGAAGCTTTCTTT	CASRVLTGTEAFF	TRBV28	TRBJ1-1
TGTGCCACCAGCAGAGGTGGACAGGTGTGGGGGATGAACACTGAAGCTTTCTTT	CATSRGGQVWGMNTEAFF	TRBV15	TRBJ1-1
TGTGCCTGGACCGTAGGGACTAGGCGGAGTTCCCAAGAGACCCAGTACTTC	CAWTVGTRRSSQETQYF	TRBV30	TRBJ2-5
TGTGCCAGCAGCAATACCTCGTTGGGACACTTCGAGACCCAGTACTTC	CASSNTSLGHFETQYF	TRBV13	TRBJ2-5
TGTGCCAGCCGTGCGGGCAATGAGCAGTTCTTC	CASRAGNEQFF	TRBV12-4	TRBJ2-1
TGTGCCAGCAGCCCAGACCTGACTTTAGTCTGCTACGAGCAGTACTTC	CASSPDLTLVCYEQYF	TRBV7-3	TRBJ2-7
TGTGCCAGCATTTACGTACTAGCGGTTGGCCCAGATACGCAGTATTTT	CASIYVLAVGPDTQYF	TRBV13	TRBJ2-3
TGCAGTGCTCCCTTACTAGCGGGAGGGCCACGCTACAATGAGCAGTTCTTC	CSAPLLAGGPRYNEQFF	TRBV20-1	TRBJ2-1
TGTGCCAGCAGCTTTGTCTGGCGAACTTACAATGAGCAGTTCTTC	CASSFVWRTYNEQFF	TRBV5-4	TRBJ2-1
TGTGCCAGCAGCGTCACCGGGGAGCTGTTTTTT	CASSVTGELFF	TRBV13	TRBJ2-2
TGTGCCACCCCGGATCTACAAAAGACTAAGTTCAAAAACATTCAGTACTTC	CATPDLQKTKFKNIQYF	TRBV24-1	TRBJ2-4
TGTGCCAGCAGTGAAGGGAATTACCCAAGAGTTGCCCTGTCTGGAAACACCATATATTTT	CASSEGNYPRVALSGNTIYF	TRBV6-1	TRBJ1-3
TGTGCCAGCAGCTTAGTGGTCAGGTACAATGAGCAGTTCTTC	CASSLVVRYNEQFF	TRBV7-9	TRBJ2-1
TGCGCCAGCAGGGAGGCCAGGACGCCCCGGGATGGGGAGAGCTACGAGCAGTACTTC	CASREARTPRDGESYEQYF	TRBV10-2	TRBJ2-7
TGTGCCACTGGGCGGTATCCAGTGCACACTGAAGCTTTCTTT	CATGRYPVHTEAFF	TRBV10-3	TRBJ1-1
TGTGCCAGCAGGACAGGGGGATGCTACACTGAAGCTTTCTTT	CASRTGGCYTEAFF	TRBV25-1	TRBJ1-1
TGTGCCAGCAGCTTATCCGGGACAAACACTGAAGCTTTCTTT	CASSLSGTNTEAFF	TRBV7-3	TRBJ1-1
TGCGCCAGCAGTGGTAAGGGGGGCGACAATGAGCAGTTCTTC	CASSGKGGDNEQFF	TRBV10-1	TRBJ2-1
TGTGCCAGCAAAGAGGTTGGCTCCTACGAGCAGTACTTC	CASKEVGSYEQYF	TRBV9	TRBJ2-7
TGCAGTGCTAGAGCGCCGAGGGAGTTGGACGAGCAGTACTTC	CSARAPRELDEQYF	TRBV20-1	TRBJ2-7
TGCGCCAGCAGCCGACCGTTCAACAGGGGGCGGATTGAAAAACTGTTTTTT	CASSRPFNRGRIEKLFF	TRBV5-1	TRBJ1-4
TGTGCCAGCAGCAATAACATGGACAGGGGCCTCAGAGTTAATTCACCCCTCCACTTT	CASSNNMDRGLRVNSPLHF	TRBV13	TRBJ1-6
TGTGCCAGCAGCTCTACTAGCGGGAAGTCCTACGAGCAGTACTTC	CASSSTSGKSYEQYF	TRBV5-6	TRBJ2-7
TGTGCCAGCAGGAACGGGGACAGCGGGAATTCACCCCTCCACTTT	CASRNGDSGNSPLHF	TRBV6-4	TRBJ1-6
TGTGCCAGCAGCTTAGCAACAGCGGGGGCTAGCTCCTACAATGAGCAGTTCTTC	CASSLATAGASSYNEQFF	TRBV7-2	TRBJ2-1
TGTGCCAATCTTTCCGCGAGGGATAATTCACCCCTCCACTTT	CANLSARDNSPLHF	TRBV6-5	TRBJ1-6
TGCAGTGCTATCATTCAGGGTGGTGTTTACACTGAAGCTTTCTTT	CSAIIQGGVYTEAFF	TRBV20-1	TRBJ1-1
TGTGCCAGCAGGGGGACTCCACTCCGACAGGGGATCATGAACACTGAAGCTTTCTTT	CASRGTPLRQGIMNTEAFF	TRBV6-1	TRBJ1-1
TGCAGTGCTAGAAGACATGACAGGGCACGCTACACCGGGGAGCTGTTTTTT	CSARRHDRARYTGELFF	TRBV20-1	TRBJ2-2
TGTGCCAGCAGCCGGGGGACACTCTACAATGAGCAGTTCTTC	CASSRGTLYNEQFF	TRBV7-4	TRBJ2-1
TGTGCCAGCAGTTACGGGGGAGCGCGAGCCAAAAACATTCAGTACTTC	CASSYGGARAKNIQYF	TRBV6-5	TRBJ2-4
TGTGCCACCAGCATCAACACGGCAGGGAATGGCTACACCTTC	CATSINTAGNGYTF	TRBV15	TRBJ1-2
TGTGCCACCAGTGCCCAGGGTTCAGGGACCTATGGCTACACCTTC	CATSAQGSGTYGYTF	TRBV24-1	TRBJ1-2
TGTGCCAGCAGCGGTCAGGCTGCGACGCCCTGGGCCAACGTCCTGACTTTC	CASSGQAATPWANVLTF	TRBV7-3	TRBJ2-6
TGTGCCAGCAGCTTGGCCAAGGACAGGGCTGAAGCTTTCTTT	CASSLAKDRAEAFF	TRBV5-8	TRBJ1-1
TGTGCCAGCAGTGACCCAGCCAGGGGTGATTCCCTCCACTTT	CASSDPARGDSLHF	TRBV2	TRBJ1-6
TGTGCCAGTAGCCCTGGGGATAATCAGCCCCAGCATTTT	CASSPGDNQPQHF	TRBV19	TRBJ1-5
TGTGCCAGCAACCAGGGGCCCTCTGAAGCTTTCTTT	CASNQGPSEAFF	TRBV13	TRBJ1-1
TGCGCCAGCAGTGAAACCCAGGGATATAGCAATCAGCCCCAGCATTTT	CASSETQGYSNQPQHF	TRBV10-1	TRBJ1-5
TGTGCCATCAGTGAGTCGGGTGACGGCGACTCCTACGAGCAGTACTTC	CAISESGDGDSYEQYF	TRBV10-3	TRBJ2-7
TGTGCCAGCACCTTGTTCGGACTGCCTTACGAGCAGTACTTC	CASTLFGLPYEQYF	TRBV6-2	TRBJ2-7
TGTGCCAGCAGCTGGGGACAGTCCTATGGCTACACCTTC	CASSWGQSYGYTF	TRBV11-2	TRBJ1-2
TGTGCCAGCAAGCTACGCCAGGACAGGGGTAACATCACCGGGGAGCTGTTTTTT	CASKLRQDRGNITGELFF	TRBV25-1	TRBJ2-2
TGCGCCACCGTTCCGATCTTGACAGGGCTAGGAGGGGGTGGGTTAACAAACTATGGCTACACCTTC	CATVPILTGLGGGGLTNYGYTF	TRBV5-1	TRBJ1-2
TGTGCCAGCAGGGACCGTAAAGGTGGGAACACTGAAGCTTTCTTT	CASRDRKGGNTEAFF	TRBV2	TRBJ1-1
TGTGCCAGCAGCCCGCCGGGACAGGGATACGAGCAGTACTTC	CASSPPGQGYEQYF	TRBV7-3	TRBJ2-7
TGTGCCAGCAGTGCGGACAGGGGAAATCAGCCCCAGCATTTT	CASSADRGNQPQHF	TRBV27	TRBJ1-5
TGTGCCAGTAGGGCTATAAAGGGACAGCGGTCCTACGAGCAGTACTTC	CASRAIKGQRSYEQYF	TRBV19	TRBJ2-7
TGTGCCAGCAGCTTACCGGGGCTGGACACTGAAGCTTTCTTT	CASSLPGLDTEAFF	TRBV7-4	TRBJ1-1
TGCAGTGCACCGACACGACAGGTAGTGAAAACGAACACCGGGGAGCTGTTTTTT	CSAPTRQVVKTNTGELFF	TRBV20-1	TRBJ2-2
TGTGCCAGCAGCTTACGCACCAAGGGGGAAAAGGACTATAGCAATCAGCCCCAGCATTTT	CASSLRTKGEKDYSNQPQHF	TRBV7-9	TRBJ1-5
TGTGCCAGCAGCGAGACAGACTATGGCTACACCTTC	CASSETDYGYTF	TRBV7-6	TRBJ1-2
TGTGCCAGCCCGGGACATCAACTCTACGAGCAGTACTTC	CASPGHQLYEQYF	TRBV7-2	TRBJ2-7
TGTGCCAGCAGTGCATTGAACGAAAGCGAGCAGTACTTC	CASSALNESEQYF	TRBV6-1	TRBJ2-7
TGTGCCAGCCCCCAGGGCCCCGAGCCCCAGCATTTT	CASPQGPEPQHF	TRBV6-5	TRBJ1-5
TGCGCCAGCAGGACTAATGACGAAGCAGAAACAGGGGGCTGGAAAGGCAATCAGCCCCAGCATTTT	CASRTNDEAETGGWKGNQPQHF	TRBV10-1	TRBJ1-5
TGCGCCAGCAGCCAAGACAGCACCCACCCCCCCTCCTACGAGCAGTACTTC	CASSQDSTHPPSYEQYF	TRBV4-1	TRBJ2-7
TGTGCCAGCAGCTCCGGGACAGCAAGGGGAAACACTGAAGCTTTCTTT	CASSSGTARGNTEAFF	TRBV11-2	TRBJ1-1
TGTGCCAGCAGGCCTCGCATTTCAAGGTACAATGAGCAGTTCTTC	CASRPRISRYNEQFF	TRBV6-5	TRBJ2-1
TGTGCCAGCAGTTATAGACTCTGTACCTCTGGGGCCAACGTCCTGACTTTC	CASSYRLCTSGANVLTF	TRBV6-9	TRBJ2-6
TGTGCCAGCACCCTCGCGGGAGGAGAGAACACCGGGGAGCTGTTTTTT	CASTLAGGENTGELFF	TRBV27	TRBJ2-2
TGTGCCACGACTAGCGGGGATGAGCAGTTCTTC	CATTSGDEQFF	TRBV2	TRBJ2-1
TGTGCCAGCATCGCTCCCCACAACAGGGCTAAAGGGTGTCCGAACACCGGGGAGCTGTTTTTT	CASIAPHNRAKGCPNTGELFF	TRBV25-1	TRBJ2-2
TGTGCCAGCAGATCTGGACAGTTACATCAGCCCCAGCATTTT	CASRSGQLHQPQHF	TRBV27	TRBJ1-5
TGTGCCTGGAGTGCTAGGGGAAATTTGGGAAACACCATATATTTT	CAWSARGNLGNTIYF	TRBV30	TRBJ1-3
TGTGCCAGCAGCACGCCGCCCCTAGTATTGGGAGGCTACGAGCAGTACTTC	CASSTPPLVLGGYEQYF	TRBV5-4	TRBJ2-7
TGTGCCAGCGGCCGGGACAGGGGCTGCTTAGCATCCTACAATGAGCAGTTCTTC	CASGRDRGCLASYNEQFF	TRBV9	TRBJ2-1
TGTGCCAGCAGCTTAGCGCGCTTGTCTATGACCGGGGAGCTGTTTTTT	CASSLARLSMTGELFF	TRBV7-2	TRBJ2-2
TGTGCCAGCAGCGAGGGCGAATTCTTAGGTGGCAATCAGCCCCAGCATTTT	CASSEGEFLGGNQPQHF	TRBV5-4	TRBJ1-5
TGTGCCAGCAGTTGGACTAGCGGGAATTACGAGCAGTACTTC	CASSWTSGNYEQYF	TRBV6-2	TRBJ2-7
TGTGCCAGCAGTCCGCAGGGCTACGAGCAGTACTTC	CASSPQGYEQYF	TRBV6-5	TRBJ2-7
TGTGCCAGCAGACGGGGGCATCAAGATAGGTTGGAGCGGCGGTTAGCCAAAAACATTCAGTACTTC	CASRRGHQDRLERRLAKNIQYF	TRBV6-4	TRBJ2-4
TGTGCCAGCAGCCTGGGTAAGAGGGGGGATAAAGCGAACACCGGGGAGCTGTTTTTT	CASSLGKRGDKANTGELFF	TRBV4-2	TRBJ2-2
TGTGCCAGCAGCTATGTTGGGGGGGGCCACATTCAGTACTTC	CASSYVGGGHIQYF	TRBV9	TRBJ2-4
TGTGCCAGCAGCCAAGATAACTCAGGGGGAACCATATATTTT	CASSQDNSGGTIYF	TRBV14	TRBJ1-3
TGTGCCAGCAGCCATAGGAGGGGGAGCCGTTCTGGAGATTACAATGAGCAGTTCTTC	CASSHRRGSRSGDYNEQFF	TRBV14	TRBJ2-1
TGCAGTGCTCCGCCGGGACAGAAAGAGACCCAGTACTTC	CSAPPGQKETQYF	TRBV20-1	TRBJ2-5
TGTGCCAGCAGTCCCAACTTTCAGCCCCAGCATTTT	CASSPNFQPQHF	TRBV27	TRBJ1-5
TGTGCCAGTAGTTTTAATTGGGACAGAAGCTCCTACAATGAGCAGTTCTTC	CASSFNWDRSSYNEQFF	TRBV19	TRBJ2-1
TGTGCCAGCAGAGGAGAAGCTTTCTTT	CASRGEAFF	TRBV6-8	TRBJ1-1
TGTGCCAGCAGCCAAGATGTGGTCAGAGCGGGATTTGTATCCTACGAGCAGTACTTC	CASSQDVVRAGFVSYEQYF	TRBV4-2	TRBJ2-7
TGTGCTAGTGTATGGACAGAGGGGTATCGCTACGAGCAGTACTTC	CASVWTEGYRYEQYF	TRBV12-5	TRBJ2-7
TGTGCCAGCAGCTGGGACAGTTGGAATTCACCCCTCCACTTT	CASSWDSWNSPLHF	TRBV5-5	TRBJ1-6
TGTGCCAGCAGCCCCGCCGTTTCTAGTATAGGGGTACGGCTCAGTTTTTTCATTCAGTACTTC	CASSPAVSSIGVRLSFFIQYF	TRBV11-2	TRBJ2-4
TGTGCCAGCAGTCCCCTCCGATCCTACAATGAGCAGTTCTTC	CASSPLRSYNEQFF	TRBV27	TRBJ2-1
TGTGCCAGCAGCCAAGACACACCCGTAGGGGGCCCAACCGGGGAGCTGTTTTTT	CASSQDTPVGGPTGELFF	TRBV14	TRBJ2-2
TGTGCCAGCAGTTACTCCCCTGGGAGAATTTCAGATACGCAGTATTTT	CASSYSPGRISDTQYF	TRBV6-3	TRBJ2-3
TGTGCCACCAGTGCGCAGGTCACTGAAGCTTTCTTT	CATSAQVTEAFF	TRBV24-1	TRBJ1-1
TGTGCCAGCAGCTCGGGGGCGGGGTTAACGAACACTGAAGCTTTCTTT	CASSSGAGLTNTEAFF	TRBV9	TRBJ1-1
TGCAGTGCTAGAGATCAGCGGGAGATCGGAAACACCATATATTTT	CSARDQREIGNTIYF	TRBV20-1	TRBJ1-3
TGCAGTGCTAGAGTGGCCAGACAGGATGGCTACACCTTC	CSARVARQDGYTF	TRBV20-1	TRBJ1-2
TGTGCCAGCAGCCTAGGGCGATGGGGGGCTCATCAAGATGAAAAACTGTTTTTT	CASSLGRWGAHQDEKLFF	TRBV13	TRBJ1-4
TGTGCCGACACTAGGGACCATAACGAGCAGTACTTC	CADTRDHNEQYF	TRBV6-5	TRBJ2-7
TGTGCCACCAGCAAGTGGGGTGAGCCCGGAGGAAACTATGGCTACACCTTC	CATSKWGEPGGNYGYTF	TRBV15	TRBJ1-2
TGTGCCAGCAGCAGGGGGCTCTACGAGCAGTACTTC	CASSRGLYEQYF	TRBV27	TRBJ2-7
TGCGCCAGCAGTGAGTCACTATTTCTGAAAAGGGCGGGAGCCCCCGACAATGAGCAGTTCTTC	CASSESLFLKRAGAPDNEQFF	TRBV10-2	TRBJ2-1
TGCGCCAGCAGCTTGGGGACAGGGGCCCCCAATCAGCCCCAGCATTTT	CASSLGTGAPNQPQHF	TRBV5-1	TRBJ1-5
TGTGCCAGCTGGGGGCAGGGGGTAACGAACACTGAAGCTTTCTTT	CASWGQGVTNTEAFF	TRBV6-5	TRBJ1-1
TGCGCCAGCAGTGAGAGGCACCCGGGACTAGCGGGAGGGGGTGGAAGAGCTAACTATGGCTACACCTTC	CASSERHPGLAGGGGRANYGYTF	TRBV10-1	TRBJ1-2
TGTGCCAGCAGTGATAGCCGGGGGGGGGGTAATTCACCCCTCCACTTT	CASSDSRGGGNSPLHF	TRBV6-5	TRBJ1-6
TGTGCCAGCAGCTTGAAGCGGGGGGGATACGAGCAGTACTTC	CASSLKRGGYEQYF	TRBV5-5	TRBJ2-7
TGTGCCAGCAGCTTGGACCCTCGGGACAGAACAGATACGCAGTATTTT	CASSLDPRDRTDTQYF	TRBV5-6	TRBJ2-3
TGCGCCAGCAGCTTGGTCCGCCGGACAGGGGGGACCTACAATGAGCAGTTCTTC	CASSLVRRTGGTYNEQFF	TRBV5-1	TRBJ2-1
TGTGCCAGCAGCAGCGGACAGGGTAGGGGGGACCACAGCTACGAGCAGTACTTC	CASSSGQGRGDHSYEQYF	TRBV7-3	TRBJ2-7
TGTGCCAGCGATGCGGGCTACATGCCGAACACCGGGGAGCTGTTTTTT	CASDAGYMPNTGELFF	TRBV5-4	TRBJ2-2
TGTGCCTGGAGATTCTACCACCCCACTCCCCTCCACACTGAAGCTTTCTTT	CAWRFYHPTPLHTEAFF	TRBV30	TRBJ1-1
TGTGCCAGCAGTTACGGCGGGGCGGATACGCAGTATTTT	CASSYGGADTQYF	TRBV6-3	TRBJ2-3
TGTGCCAGTAGGCGGTTGGAGAGGGATTACGAGCAGTACTTC	CASRRLERDYEQYF	TRBV19	TRBJ2-7
TGCGCCAGCAGTGAGGATCCGGGACAGCAGGATAGCAATCAGCCCCAGCATTTT	CASSEDPGQQDSNQPQHF	TRBV10-1	TRBJ1-5
TGTGCCCACCGCGGGAGGGAAACTGGGGCCAACGTCCTGACTTTC	CAHRGRETGANVLTF	TRBV30	TRBJ2-6
TGTGCCAGCAGCGGGTTGCCGGGGGGGAAAACAGATACGCAGTATTTT	CASSGLPGGKTDTQYF	TRBV7-3	TRBJ2-3
TGTGCCAGCAGCGACCATCTGGGACTAGCGGGAAGGTCCTACGAGCAGTACTTC	CASSDHLGLAGRSYEQYF	TRBV13	TRBJ2-7
TGTGCCAGCAGCTCCCGGAAGAGTAATGAGGGGTATGAGCAGTTCTTC	CASSSRKSNEGYEQFF	TRBV13	TRBJ2-1
TGCAGTGCTAGAGCTCGAAGGGGGCTTAGCACTGAAGCTTTCTTT	CSARARRGLSTEAFF	TRBV20-1	TRBJ1-1
TGCGCCAGCAGCTTGAAGGGCACAATCGGACACCCAGATACGCAGTATTTT	CASSLKGTIGHPDTQYF	TRBV5-1	TRBJ2-3
TGTGCCAGGGGACAGGGGGAGGAGAGCAATCAGCCCCAGCATTTT	CARGQGEESNQPQHF	TRBV28	TRBJ1-5
TGTGCCATCCCCCGGATTCACAACGTTTTTGCTAACACAGATACGCAGTATTTT	CAIPRIHNVFANTDTQYF	TRBV27	TRBJ2-3
TGTGCCAGCAGTTCCGCCCTTCCCTCACAGGGGTTTAGGTATAATTCACCCCTCCACTTT	CASSSALPSQGFRYNSPLHF	TRBV6-5	TRBJ1-6
TGTGCCATCAGTGAGCCCTTGGGACAGGGGGATACGTCCTACAATGAGCAGTTCTTC	CAISEPLGQGDTSYNEQFF	TRBV10-3	TRBJ2-1
TGTGAACAGGGGGCTTTGCCCCCCCAGCATTTT	CEQGALPPQHF	TRBV2	TRBJ1-5
TGTGCCAGCAGCGCCTCTATACGGGACAGGGTGGTGGAAGCTTTCTTT	CASSASIRDRVVEAFF	TRBV9	TRBJ1-1
TGTGCCATTTTCCTGGGCAAGAGAGCTAACTATGGCTACACCTTC	CAIFLGKRANYGYTF	TRBV28	TRBJ1-2
TGTGCCAGCTCACCACTCGGGGGACAGGTAATCGGGCAGAACACCGGGGAGCTGTTTTTT	CASSPLGGQVIGQNTGELFF	TRBV18	TRBJ2-2
TGTGCCAGCAGCTTAGGGCAAGCGGGACGGGGCTACGAGCAGTACTTC	CASSLGQAGRGYEQYF	TRBV7-7	TRBJ2-7
TGTGCCTGGCAGGATGACGAGCAGTACTTC	CAWQDDEQYF	TRBV30	TRBJ2-7
TGTGCCAGCAGTTTGAGCGACAAGGGGAACTACAATGAGCAGTTCTTC	CASSLSDKGNYNEQFF	TRBV27	TRBJ2-1
TGTGCCAGTAGTATGATCCAGGGCATCAATGAAAAACTGTTTTTT	CASSMIQGINEKLFF	TRBV19	TRBJ1-4
TGTGCCAGCAGTTTACAGGGTTACAATGAGCAGTTCTTC	CASSLQGYNEQFF	TRBV28	TRBJ2-1
TGTGCCAGAAGTGAGAGGATCCTGGAGACCCAGTACTTC	CARSERILETQYF	TRBV19	TRBJ2-5
TGCAGTGCTAGACCTTGCGGACTAGCGCCGGCCTCCGCCTACGAGCAGTACTTC	CSARPCGLAPASAYEQYF	TRBV20-1	TRBJ2-7
TGTGCCAGCAGCCCAAACAGGGCCCCCGAGCAGTACTTC	CASSPNRAPEQYF	TRBV7-9	TRBJ2-7
TGCGCCAGCAGCCTTCAAGCGGCCCCCAGGGGGGGGGTCACCGGGGAGCTGTTTTTT	CASSLQAAPRGGVTGELFF	TRBV4-1	TRBJ2-2
TGCGCCAAACGGGACAGGAGCCCATACGAGCAGTACTTC	CAKRDRSPYEQYF	TRBV5-1	TRBJ2-7
TGCGCCAGCAGCCAAGAGGGGGCCCCGGGGGGGGGCTACACCTTC	CASSQEGAPGGGYTF	TRBV4-1	TRBJ1-2
TGTGCCAGCAGTGAACGGGGAGCCAAAAACATTCAGTACTTC	CASSERGAKNIQYF	TRBV2	TRBJ2-4
TGTGCCAGCAGCGGAGGGGTTGGCTACACCTTC	CASSGGVGYTF	TRBV13	TRBJ1-2
TGTGCCAGCAGCTGGGGACAGGATAGGGGCAATCAGCCCCAGCATTTT	CASSWGQDRGNQPQHF	TRBV11-2	TRBJ1-5
TGTGCCAGCAGTAAGGACAGGGACGACTATAGCAATCAGCCCCAGCATTTT	CASSKDRDDYSNQPQHF	TRBV12-3	TRBJ1-5
TGTGCCAGCAGCCATCTATACCGACAGGCCCGCTACGAGCAGTACTTC	CASSHLYRQARYEQYF	TRBV3-1	TRBJ2-7
TGTGCCAGCAGGAATCCAGGGAGCGAACTGTTTTTT	CASRNPGSELFF	TRBV6-5	TRBJ1-4
TGCGCCAGCAGTGGCTGGGGGGGCACAGATACGCAGTATTTT	CASSGWGGTDTQYF	TRBV10-1	TRBJ2-3
TGTGCCAGCAGCAGGCCGGACAGGAGGCGGGGTCAAGAGACCCAGTACTTC	CASSRPDRRRGQETQYF	TRBV7-4	TRBJ2-5
TGTGCCGGGTACAGATCCGAGGTAAACACTGAAGCTTTCTTT	CAGYRSEVNTEAFF	TRBV19	TRBJ1-1
TGTGCCCCGAGAGGTCGACGAGGATTAGAGACCCAGTACTTC	CAPRGRRGLETQYF	TRBV6-2	TRBJ2-5
TGCAGCGTTGATCCTCGTCGCCCGGGGGGGTGGACAGATACGCAGTATTTT	CSVDPRRPGGWTDTQYF	TRBV29-1	TRBJ2-3
TGTGCCAGCAGCAACACCGGGACAGTAGGGAGCAATCAGCCCCAGCATTTT	CASSNTGTVGSNQPQHF	TRBV7-9	TRBJ1-5
TGTGCCAGCAGCTTGGAGGGGGCGATCAATGAGCAGTTCTTC	CASSLEGAINEQFF	TRBV5-6	TRBJ2-1
TGCGCCAGCAGCCAAGATAGGGGGGGAGGAGAGACCCAGTACTTC	CASSQDRGGGETQYF	TRBV4-1	TRBJ2-5
TGTGCCAGCAGCTCTAGACATCCTACGCAGTATTTT	CASSSRHPTQYF	TRBV14	TRBJ2-3
TGTGCCAGCAGCACCTCCGAGCGGGCTCTCGAGACCCAGTACTTC	CASSTSERALETQYF	TRBV7-2	TRBJ2-5
TGTGCCAGCAGCCAAGATGCGCAGGTAGCGGGGAGGGGCAATGAGCAGTTCTTC	CASSQDAQVAGRGNEQFF	TRBV3-1	TRBJ2-1
TGTGCATTGGAGGGGGGGAAAGTAGGGACAGATACGCAGTATTTT	CALEGGKVGTDTQYF	TRBV6-2	TRBJ2-3
TGTGCCAGCAGCCAAGACTATCCCGGGGCTTATTGGGGTAATGAAAAACTGTTTTTT	CASSQDYPGAYWGNEKLFF	TRBV4-2	TRBJ1-4
TGCGCCAGCAGTGATCGGTTGCGATTTAATTATAATTCACCCCTCCACTTT	CASSDRLRFNYNSPLHF	TRBV10-1	TRBJ1-6
TGCAGCGTTTCTCTAGGACCGGGGGGACCTACCGGGGAGCTGTTTTTT	CSVSLGPGGPTGELFF	TRBV29-1	TRBJ2-2
TGTGCCAGCAGACGGTCCCCTAGGTCGGGAGGGAGAGGCTACACCTTC	CASRRSPRSGGRGYTF	TRBV6-5	TRBJ1-2
TGTGCCAGCAGTGAATATCCAGGGTACCCATCGAACACCGGGGAGCTGTTTTTT	CASSEYPGYPSNTGELFF	TRBV25-1	TRBJ2-2
TGTGCCAGTCGGCCGCAGACAGGACGTCTCTACGAGCAGTACTTC	CASRPQTGRLYEQYF	TRBV25-1	TRBJ2-7
TGTGCCAGCTGCCGGGAGGCGAGTGAAGCTTTCTTT	CASCREASEAFF	TRBV25-1	TRBJ1-1
TGTGCCAGCAGCGCCGGGACAGAAACTGTCACAGATACGCAGTATTTT	CASSAGTETVTDTQYF	TRBV7-9	TRBJ2-3
TGTGCCAGCAGCCCGGGAACCCGGCGGGGGGACGACACAGATACGCAGTATTTT	CASSPGTRRGDDTDTQYF	TRBV7-3	TRBJ2-3
TGTGCCAGCAGTTTTTTGTCCCGGGGGAATCAGCCCCAGCATTTT	CASSFLSRGNQPQHF	TRBV27	TRBJ1-5
TGTGCCAGCAGCTTGGCCTCGGGGGACCTTAACGAGCAGTACTTC	CASSLASGDLNEQYF	TRBV5-6	TRBJ2-7
TGTGCCAGCAGTGATACGGGGGCGCGAAGAAAACTGTTTTTT	CASSDTGARRKLFF	TRBV6-1	TRBJ1-4
TGCGCCAGCAGTAAGGACACTGGCCCCCTCCACTTT	CASSKDTGPLHF	TRBV10-1	TRBJ1-6
TGCAGTGCTGCCGCGGAGGGGGGGGGCCAGGATTTCACAGATACGCAGTATTTT	CSAAAEGGGQDFTDTQYF	TRBV20-1	TRBJ2-3
TGTGCCAGCAGTGAAATCCGCATCGCTAGCGGGATTAAGATACCTCTACCCACCGGGGAGCTGTTTTTT	CASSEIRIASGIKIPLPTGELFF	TRBV6-5	TRBJ2-2
TGCAGTGCTAGAATTATCAAGGGACAGCCTGAGGGTTGTGATAATGAAAAACTGTTTTTT	CSARIIKGQPEGCDNEKLFF	TRBV20-1	TRBJ1-4
TGTGCCAGCAGCGAACGCAGGGGGCAGATGCCCGTCCTGACTTTC	CASSERRGQMPVLTF	TRBV27	TRBJ2-6
TGTGCCAGCAGCGGGGGGGGTAGGTTAGCTAGCACAGATACGCAGTATTTT	CASSGGGRLASTDTQYF	TRBV7-2	TRBJ2-3
TGTGCCAGCAGTACCCCACAGCCCAACTATGGCTACACCTTC	CASSTPQPNYGYTF	TRBV28	TRBJ1-2
TGCAGTGCAGGACGCCGGGGCGGACCTCAAGAGACCCAGTACTTC	CSAGRRGGPQETQYF	TRBV20-1	TRBJ2-5
TGTGCCAGCACTACTCTTTCTAGCGGGGGGGCCCGGGAGACCCAGTACTTC	CASTTLSSGGARETQYF	TRBV2	TRBJ2-5
TGTGCCAGCAGCTTTCAGTACGGTGGCTACACCTTC	CASSFQYGGYTF	TRBV7-4	TRBJ1-2
TGTGCCAGCAGCTTCAGGGAAATGAACACTGAAGCTTTCTTT	CASSFREMNTEAFF	TRBV9	TRBJ1-1
TGTGCCAGCAGCCAAGAAACATTGGGACAGGGGTACGGGAGGAGCTCCTACGAGCAGTACTTC	CASSQETLGQGYGRSSYEQYF	TRBV3-1	TRBJ2-7
TGTGCCAGCAGCTACCTGCCGGGACTAGCGGGTCAGATAGACAACTACGAGCAGTACTTC	CASSYLPGLAGQIDNYEQYF	TRBV13	TRBJ2-7
TGTGCCAGCAGCTTCCCAGGGTCCGTTGGGACTCAGCCCCAGCATTTT	CASSFPGSVGTQPQHF	TRBV5-4	TRBJ1-5
TGTGCCAGCAGCGTGAGAGGACAGGGTTCAGCTTTCTTT	CASSVRGQGSAFF	TRBV7-9	TRBJ1-1
TGTGCCAGCAGCCACCTCTGTGACAGGGACTATGGCTACACCTTC	CASSHLCDRDYGYTF	TRBV7-3	TRBJ1-2
TGTGCCAGCAGCGGGGCCGGGACTAGCGGGGTCAACTACGAGCAGTACTTC	CASSGAGTSGVNYEQYF	TRBV7-2	TRBJ2-7
TGTGCCAGCAGGGGAGGCCGACAGGGGTCTTCCTACAATGAGCAGTTCTTC	CASRGGRQGSSYNEQFF	TRBV28	TRBJ2-1
TGTGCCAGCAGCTTCCCGGACAGGAGAGAGCAGTACTTC	CASSFPDRREQYF	TRBV5-4	TRBJ2-7
TGCAGGTACTCCGGGACAGGGCCGAGCAATCAGCCCCAGCATTTT	CRYSGTGPSNQPQHF	TRBV20-1	TRBJ1-5
TGTGCCAGCAGTGGGAGAGAGAGACAGTATTTT	CASSGRERQYF	TRBV6-1	TRBJ2-3
TGCGCCAGCAGCTGCGAAGAAAAGGACGATGGCTACACCTTC	CASSCEEKDDGYTF	TRBV5-1	TRBJ1-2
TGCGCCAGCAGCTGGACTAGCGGGGGCAATCAGACCGGGGAGCTGTTTTTT	CASSWTSGGNQTGELFF	TRBV5-1	TRBJ2-2
TGTGCCTGGTCAGGGACAGGGCCGGTGGGAGACAATGAGCAGTTCTTC	CAWSGTGPVGDNEQFF	TRBV30	TRBJ2-1
TGTGCCAGCAGCTTAGCAAGGGCTCGGACAGTGTTAGAAGCTTTCTTT	CASSLARARTVLEAFF	TRBV7-8	TRBJ1-1
TGTGCCAGCAGTGGCGGGAGGGCCGGGGCAGATACGCAGTATTTT	CASSGGRAGADTQYF	TRBV6-1	TRBJ2-3
TGTGCCAGTAGTTCCAGGAGGGCCACTGAAGCTTTCTTT	CASSSRRATEAFF	TRBV19	TRBJ1-1
TGCGCCAGCAGCCAAGAGACAGGGGGCCGGATTCAGCCCCAGCATTTT	CASSQETGGRIQPQHF	TRBV4-1	TRBJ1-5
TGTGCCAGCAGCCCTAGCGGGAGTACAGATACGCAGTATTTT	CASSPSGSTDTQYF	TRBV11-3	TRBJ2-3
TGTGCCAGCAGACGGACAGATCGGAACACTGAAGCTTTCTTT	CASRRTDRNTEAFF	TRBV11-3	TRBJ1-1
TGTGCCAGCAGCATACCGGGGGGGCAGTCGGTCTACGAGCAGTACTTC	CASSIPGGQSVYEQYF	TRBV13	TRBJ2-7
TGTGCTAGCAGCTGCTTAACATGGGGGAACTCTGGAAACACCATATATTTT	CASSCLTWGNSGNTIYF	TRBV7-7	TRBJ1-3
TGTGCCAGCAGCCATGGGGGACAGGGTTCCGGGGAGCTGTTTTTT	CASSHGGQGSGELFF	TRBV4-2	TRBJ2-2
TGTGCCAGCAGTGTTCTGTGTCCGGGACAGGTGTACAATGAGCAGTTCTTC	CASSVLCPGQVYNEQFF	TRBV6-1	TRBJ2-1
TGTGCCAGTAGCCGCCTCAGGACCTACGAGCAGTACTTC	CASSRLRTYEQYF	TRBV19	TRBJ2-7
TGTGCCAGCAGCCTGGGGCCAGTGGCGGTGAACACTGAAGCTTTCTTT	CASSLGPVAVNTEAFF	TRBV9	TRBJ1-1
TGCGCCAGCAGCACGCGACTAGCGGGGGGAGCCTCCTACGAGCAGTACTTC	CASSTRLAGGASYEQYF	TRBV5-1	TRBJ2-7
TGTGCCACCAGTGATAGCCCGCGGGCCTCCTACGAGCAGTACTTC	CATSDSPRASYEQYF	TRBV24-1	TRBJ2-7
TGTGCCAGCAGCCATTGCTTCGGTGGGGGGGTGCAGACCAAATGGGAGACCCAGTACTTC	CASSHCFGGGVQTKWETQYF	TRBV14	TRBJ2-5
TGTGCCAGCCCTATTAGGGACGGCTACAATGAGCAGTTCTTC	CASPIRDGYNEQFF	TRBV7-3	TRBJ2-1
TGTGCCAGCAGGTTACCAAGAGGAACTGGGGCCAACGTCCTGACTTTC	CASRLPRGTGANVLTF	TRBV6-5	TRBJ2-6
TGCGCCAGCAGGGGGGACAGTGCCTACAATGAGCAGTTCTTC	CASRGDSAYNEQFF	TRBV10-1	TRBJ2-1
TGTGCCAGGCGGGGCGAAAACACTGAAGCTTTCTTT	CARRGENTEAFF	TRBV27	TRBJ1-1
TGCGCCAGCACAGGGGGGCCGTTACCTTTAGGTCTGAGCCCTCGGCCGTACGAGCAGTACTTC	CASTGGPLPLGLSPRPYEQYF	TRBV5-1	TRBJ2-7
TGTGCCAGCCATGACTTTGACACCGGGGAGCTGTTTTTT	CASHDFDTGELFF	TRBV7-9	TRBJ2-2
TGTGCCAGCAGCTTAGTCGGGGTAACCCAGCATTTT	CASSLVGVTQHF	TRBV13	TRBJ1-5
TGTGCCAGCAGCCGGGGGGGCCTTAATGAGCAGTTCTTC	CASSRGGLNEQFF	TRBV7-4	TRBJ2-1
TGCGCCAGCATGGACGCAGGACACGGCAATCAGCCCCAGCATTTT	CASMDAGHGNQPQHF	TRBV10-2	TRBJ1-5
TGCAGTGCCGCCATCCGGGACATTACTTCCTACAATGAGCAGTTCTTC	CSAAIRDITSYNEQFF	TRBV20-1	TRBJ2-1
TGTGCCAGCAGCTGTGTCGGAGGGTCTAAGGGGGCCAACGTCCTGACTTTC	CASSCVGGSKGANVLTF	TRBV7-4	TRBJ2-6
TGTGCCAGCAGGGACCGCTGTCAAGAGACCCAGTACTTC	CASRDRCQETQYF	TRBV11-3	TRBJ2-5
TGTGCCAGCAGTTACTCGAGCACTAGGGCAAACACCGGGGAGCTGTTTTTT	CASSYSSTRANTGELFF	TRBV6-3	TRBJ2-2
TGTGCCAGCTCACCACCGAGAAACGACAGGGACGAGCAGTACTTC	CASSPPRNDRDEQYF	TRBV18	TRBJ2-7
TGTGCCAGCAGTGAATATGGAAACCCCCGTCGACTCAATCAGCCCCAGCATTTT	CASSEYGNPRRLNQPQHF	TRBV25-1	TRBJ1-5
TGTGCCAGCAGCTGTGGGGTCAGCTCCTATAATTCACCCCTCCACTTT	CASSCGVSSYNSPLHF	TRBV5-6	TRBJ1-6
TGTGCCAGCAGTTTAACCCCCGGGACCAGAGACTACAATGAGCAGTTCTTC	CASSLTPGTRDYNEQFF	TRBV27	TRBJ2-1
TGTGCCAGCAGTTACCTGAGATTGTTACCCGGGGACAATCAGCCCCAGCATTTT	CASSYLRLLPGDNQPQHF	TRBV6-5	TRBJ1-5
TGCAGTGCTAGAGGTGGACAGGTGGAAACTGAAGCTTTCTTT	CSARGGQVETEAFF	TRBV20-1	TRBJ1-1
TGTGCCAGCAGCTATCAGGTAAGGAAAGACACCGGGGAGCTGTTTTTT	CASSYQVRKDTGELFF	TRBV5-5	TRBJ2-2
TGTGCCAGCCAGGGGGTGGTTGGGGCCAACGTCCTGACTTTC	CASQGVVGANVLTF	TRBV9	TRBJ2-6
TGTGCTAGTGGTTTGAAACGAATGGACGGCCTTGAAAACTTACGAGAGACCCAGTACTTC	CASGLKRMDGLENLRETQYF	TRBV12-5	TRBJ2-5
TGTGCCACAAAAGGTTTACATCCCAACTATGGCTACACCTTC	CATKGLHPNYGYTF	TRBV24-1	TRBJ1-2
TGTGCCAGCAGCGACGGTACAGGGGACTCGGGGTACAATGAGCAGTTCTTC	CASSDGTGDSGYNEQFF	TRBV9	TRBJ2-1
TGTGCCAGCAAGGACTTCACGACCCAGTACTTC	CASKDFTTQYF	TRBV6-4	TRBJ2-5
TGTGCCTGGTGGGGACCCTACAATGAGCAGTTCTTC	CAWWGPYNEQFF	TRBV30	TRBJ2-1
TGTGCCAGCAGTCCGATCCCTCGCGGGAGCGAGACCCAGTACTTC	CASSPIPRGSETQYF	TRBV6-4	TRBJ2-5
TGTGCCAGCAGCGGTTGCCAGGATACAGGCTCCTACGAGCAGTACTTC	CASSGCQDTGSYEQYF	TRBV7-6	TRBJ2-7
TGCAGCGTTGGAGTGGAGTGGGGCTCCTACGAGCAGTACTTC	CSVGVEWGSYEQYF	TRBV29-1	TRBJ2-7
TGTGCCAGCAGCACAGGGGACTCCTACGAGCAGTACTTC	CASSTGDSYEQYF	TRBV11-1	TRBJ2-7
TGCGCCAGCAGTGAGTCTACATATGGGCGGAGGAACACTGAAGCTTTCTTT	CASSESTYGRRNTEAFF	TRBV10-2	TRBJ1-1
TGTGCTAGTGGTTTGGGAGGGAGTGGCGAGGGCCCTGAAGCTTTCTTT	CASGLGGSGEGPEAFF	TRBV12-5	TRBJ1-1
TGTGCCAGCAGTTTAGCCACCTGCCCCTTAGGAGGGTGCTCCTACGAGCAGTACTTC	CASSLATCPLGGCSYEQYF	TRBV12-3	TRBJ2-7
TGTGCCAGCAGTTACTCGGGCTCCAGGCCGTGGAACACTGAAGCTTTCTTT	CASSYSGSRPWNTEAFF	TRBV6-5	TRBJ1-1
TGTGCTAGTGGTTGCACAGGGAGTCCGGGAGAGACCCAGTACTTC	CASGCTGSPGETQYF	TRBV12-5	TRBJ2-5
TGTGCCAGCAGCCCCGCCGGGACGAGAATGAAGAGCTCCTACAATGAGCAGTTCTTC	CASSPAGTRMKSSYNEQFF	TRBV7-9	TRBJ2-1
TGTGCCAGCAGTTTTATGGTGGACTTC	CASSFMVDF	TRBV28	TRBJ2-7
TGTGCCAGCAGTTACACACTAGCGGGAGGGGGCACAGATACGCAGTATTTT	CASSYTLAGGGTDTQYF	TRBV6-5	TRBJ2-3
TGTGCCAGCAGTCAGCGCGCTGAAGCTTTCTTT	CASSQRAEAFF	TRBV28	TRBJ1-1
TGTGCCATCAGTGAGTCGGTGGGACTAGCGGGCCCCCGCTACGAGCAGTACTTC	CAISESVGLAGPRYEQYF	TRBV10-3	TRBJ2-7
TGCGCCAGCAGCCAAGATAACTTTCAAAGTTTACTCTTGAATGAGCAGTTCTTC	CASSQDNFQSLLLNEQFF	TRBV4-1	TRBJ2-1
TGTGCCAGTACCCTGGCTACAGGGACAGATACGCAGTATTTT	CASTLATGTDTQYF	TRBV19	TRBJ2-3
TGTGCCAGCAGCTTATGCCCCAACAAGCAGGGGGATAGCAATCAGCCCCAGCATTTT	CASSLCPNKQGDSNQPQHF	TRBV7-9	TRBJ1-5
TGTGCCAGCAGCTTAGGGGCGAGGAATGAAAAACTGTTTTTT	CASSLGARNEKLFF	TRBV7-3	TRBJ1-4
TGCAGCGTTGAAGAAGGGGGGTTGCGCTCCTACGAGCAGTACTTC	CSVEEGGLRSYEQYF	TRBV29-1	TRBJ2-7
TGTGCCAGCACCAAGGAAGCGGGACGGAGCAATGAGCAGTTCTTC	CASTKEAGRSNEQFF	TRBV6-4	TRBJ2-1
TGTGCCAGCAGGGAGACAGGTCGATTGAACACTGAAGCTTTCTTT	CASRETGRLNTEAFF	TRBV27	TRBJ1-1
TGTGCCAGCAGTTACCCGGGGGCAAACATTCAGTACTTC	CASSYPGANIQYF	TRBV6-6	TRBJ2-4
TGCGCCAGCAGCTTGCATCCCCCGGCCTGGGGCTTTTCTTACTATGGCTACACCTTC	CASSLHPPAWGFSYYGYTF	TRBV5-1	TRBJ1-2
TGTGCCGGGGATTCAGGAACTAATGAAAAACTGTTTTTT	CAGDSGTNEKLFF	TRBV6-1	TRBJ1-4
TGTGCCAGTAGGACCGCGGGAGTTGCCGGGGAGCTGTTTTTT	CASRTAGVAGELFF	TRBV19	TRBJ2-2
TGTGCCAGCAGCTTAGCGGGGGACGCATTGCCGTCCTACAATGAGCAGTTCTTC	CASSLAGDALPSYNEQFF	TRBV7-2	TRBJ2-1
TGTGCCAGCAGCCAAAGGAAAAGAGCGGCCTGGGAGTACTTC	CASSQRKRAAWEYF	TRBV14	TRBJ2-5
TGTGCCAGCAGCCCCACAGCGGGAACGTTCTTC	CASSPTAGTFF	TRBV13	TRBJ2-1
TGCGCCAGCAAACCTAGCGGGGGGGCCTACGAGCAGTACTTC	CASKPSGGAYEQYF	TRBV4-1	TRBJ2-7
TGTGCCAGCAGTATCAGCGGCTACACCTTC	CASSISGYTF	TRBV12-3	TRBJ1-2
TGCAGTGCGGAAGGGGGGGGCTGCCAAGAGACCCAGTACTTC	CSAEGGGCQETQYF	TRBV20-1	TRBJ2-5
TGCGCCAGCAGCGGTGGGAAAGGATACGAGCAGTACTTC	CASSGGKGYEQYF	TRBV5-1	TRBJ2-7
TGTGCCAGCAGCCAAGCGGACTGGCCCTCAGACAGGAGTGGCCCGCCATACGAGCAGTACTTC	CASSQADWPSDRSGPPYEQYF	TRBV4-2	TRBJ2-7
TGTGCCAGCAGCGCGACCGGGGCGTATTTAGCTAACTATGGCTACACCTTC	CASSATGAYLANYGYTF	TRBV7-9	TRBJ1-2
TGTGCCACCAGTGATTTGCGCGAGAGGGACACCTCTGGGGCCAACGTCCTGACTTTC	CATSDLRERDTSGANVLTF	TRBV24-1	TRBJ2-6
TGTGCCAGCACCCCCCGGGGGCCAGGGTCTTCACCCCTCCACTTT	CASTPRGPGSSPLHF	TRBV5-8	TRBJ1-6
TGTGCCAGCATTGGGACTAGCGGGAGTATTTACAATGAGCAGTTCTTC	CASIGTSGSIYNEQFF	TRBV2	TRBJ2-1
TGTGCCAGCATTGCTAGCGGGGGGAACAATGAGCAGTTCTTC	CASIASGGNNEQFF	TRBV28	TRBJ2-1
TGTGCCAGCAGTCCCTTTAGGGCGACCGGGGAGCTGTTTTTT	CASSPFRATGELFF	TRBV27	TRBJ2-2
TGTGCCAGCAGCCCACTACAAGCGAGGGTGAACTACGAGCAGTACTTC	CASSPLQARVNYEQYF	TRBV7-8	TRBJ2-7
TGTGCCAGCAGCCAAGACCGGCGACAGGTTAAGTACTTC	CASSQDRRQVKYF	TRBV3-1	TRBJ2-7
TGTGCCAGCCCCACTACAGATACGCAGTATTTT	CASPTTDTQYF	TRBV5-6	TRBJ2-3
TGTGCCTGGCGATTGGGGGGAATGGCCAAAAACATTCAGTACTTC	CAWRLGGMAKNIQYF	TRBV27	TRBJ2-4
TGCGCCAGCAGCCATCTAACAGGGCGGGGTCAGCCCCAGCATTTT	CASSHLTGRGQPQHF	TRBV4-1	TRBJ1-5
TGTGCCAGCAGCGTCCCCCCAATACTAGCGGTATACATTGGCTCCTACAATGAGCAGTTCTTC	CASSVPPILAVYIGSYNEQFF	TRBV7-9	TRBJ2-1
TGTGCCAGCAGCCTCCCCCGGGACGAGGCAGGGCACGAGCAGTACTTC	CASSLPRDEAGHEQYF	TRBV5-4	TRBJ2-7
TGTGCCAGTAGGGTTTCGGCGGAGTACAGGAATGAAAAACTGTTTTTT	CASRVSAEYRNEKLFF	TRBV19	TRBJ1-4
TGTGCCAGCAGCCAGCCGACCCAGGGCGCACCCCTCCACTTT	CASSQPTQGAPLHF	TRBV4-2	TRBJ1-6
TGTGCCAGCGTCTATTATAGGACCGATGGAAAATACGAGCAGTACTTC	CASVYYRTDGKYEQYF	TRBV7-9	TRBJ2-7
TGTGCCAGCAGCTTACCGACAGGGGGCGCGTTTAGCGCACCCCTCCACTTT	CASSLPTGGAFSAPLHF	TRBV7-9	TRBJ1-6
TGTGCCAGCAGTCCCCCGGACAGCGAGCAGTACTTC	CASSPPDSEQYF	TRBV12-4	TRBJ2-7
TGTGCCATCAGTGATTCGGGGTGTCAGGGGCACTACGAGCAGTACTTC	CAISDSGCQGHYEQYF	TRBV10-3	TRBJ2-7
TGTGCCAGCAGGGACGGAATTTCTGAAGCTTTCTTT	CASRDGISEAFF	TRBV13	TRBJ1-1
TGCAGTGCTAGGTCCGGGCGGGACAGGTATAGCAATCAGCCCCAGCATTTT	CSARSGRDRYSNQPQHF	TRBV20-1	TRBJ1-5
TGTGCCAGCAGCTTAAAGAGGGGGACAGACACTGAAGCTTTCTTT	CASSLKRGTDTEAFF	TRBV11-3	TRBJ1-1
TGTGCCAGCAGCCCCCGAACAGGGGGCCTTAAAGGGAACACCATATATTTT	CASSPRTGGLKGNTIYF	TRBV7-9	TRBJ1-3
TGCGCCAGCAGTCGGGAAGGGACAGGGGGGAATCAGCCCCAGCATTTT	CASSREGTGGNQPQHF	TRBV4-1	TRBJ1-5
TGTGCCTGGGATCGGAACAGAATTGACGAGCAGTACTTC	CAWDRNRIDEQYF	TRBV30	TRBJ2-7
TGCAGTGCTAGTGGCGGCCCCCAGTTCACCGGGGAGCTGTTTTTT	CSASGGPQFTGELFF	TRBV20-1	TRBJ2-2
TGTGCCAGCAGCTTAGGACAGGGCGAAGCAAATTCACCCCTCCACTTT	CASSLGQGEANSPLHF	TRBV7-2	TRBJ1-6
TGTGCCAGCAGCTTAGAACCGGGCGTTGCACCCCTCCACTTT	CASSLEPGVAPLHF	TRBV7-9	TRBJ1-6
TGTGCCAGCAGCGTGGGACAGGGGCTTCAGAACACTGAAGCTTTCTTT	CASSVGQGLQNTEAFF	TRBV9	TRBJ1-1
TGTGCCATCACAAGGGACAGGGCTCTTCTCGGGGAGCTGTTTTTT	CAITRDRALLGELFF	TRBV10-3	TRBJ2-2
TGTGCCTGGAGAATTCCGGGACAGGGTCTGAACACTGAAGCTTTCTTT	CAWRIPGQGLNTEAFF	TRBV30	TRBJ1-1
TGCAGCGACAAGGAGGTCACTGAAGCTTTCTTT	CSDKEVTEAFF	TRBV29-1	TRBJ1-1
TGTGCCAGCAGGGAGGGGCCGGGACGGGGTCAGCCCCAGCATTTT	CASREGPGRGQPQHF	TRBV25-1	TRBJ1-5
TGTGCCAGCAGTTACTCGACCGCTAGCGGGGGGGCGGAGCGGGGGGGGGCCCCCAATGAGCAGTTCTTC	CASSYSTASGGAERGGAPNEQFF	TRBV6-5	TRBJ2-1
TGTGCCATCAGTGGACTGGGGCAAGAGACCCAGTACTTC	CAISGLGQETQYF	TRBV10-3	TRBJ2-5
TGTGCCAGCAGCGAGGACAGGGCGTGCTATGGCTACACCTTC	CASSEDRACYGYTF	TRBV7-9	TRBJ1-2
TGTGCCAGCAGAAAGCACGACCCCTCGGACAGCGAAGGGACTTCACCCCTCCACTTT	CASRKHDPSDSEGTSPLHF	TRBV27	TRBJ1-6
TGTGCCAGCAAGACAGAGGGCATATATGGCTACACCTTC	CASKTEGIYGYTF	TRBV6-4	TRBJ1-2
TGCAGTGCCCCGCTACAGGGGGACACGCAGTATTTT	CSAPLQGDTQYF	TRBV20-1	TRBJ2-3
TGCGCCAGCAGGAGGGCGGTTTCCGTGTATAGCAATCAGCCCCAGCATTTT	CASRRAVSVYSNQPQHF	TRBV10-1	TRBJ1-5
TGTGCTAGTGGTTTGAGACCCAGGGGGCCAAGTACTGAAGCTTTCTTT	CASGLRPRGPSTEAFF	TRBV12-5	TRBJ1-1
TGTGCCAGCAGCGTCGGGACGACATCCTGTGAAGCTTTCTTT	CASSVGTTSCEAFF	TRBV5-4	TRBJ1-1
TGCAGTGCTCCAGCAACTGGGTACGAGCAGTACTTC	CSAPATGYEQYF	TRBV20-1	TRBJ2-7
TGCGCCAGCAGCTTGACATGGCCGAGCGGGCCCGATGAGCAGTTCTTC	CASSLTWPSGPDEQFF	TRBV5-1	TRBJ2-1
TGTGCCAGCAGCATATCCCATACTAGCGGGAGAATGTCCTTGCGAGCTTTCTTT	CASSISHTSGRMSLRAFF	TRBV5-4	TRBJ1-1
TGTGCCAGCAGCCAGACTAGCGACTACACAGATACGCAGTATTTT	CASSQTSDYTDTQYF	TRBV14	TRBJ2-3
TGTGCCAGCAGCGAGGGGCAAACTCAGCCCCAGCATTTT	CASSEGQTQPQHF	TRBV11-3	TRBJ1-5
TGTGCCAGCAGGGACAGGGGGCCTATGTTTACGAGCAATCAGCCCCAGCATTTT	CASRDRGPMFTSNQPQHF	TRBV28	TRBJ1-5
TGTGCCAGCAGTTTAGACTCCTACGAGCAGTACTTC	CASSLDSYEQYF	TRBV12-3	TRBJ2-7
TGTGCCAGCAGCCGTAGGACCTGGCCTTACGAGCAGTACTTC	CASSRRTWPYEQYF	TRBV14	TRBJ2-7
TGTGCCAGATGCCGGGACAGGGATTTTCAGGGAAACACCATATATTTT	CARCRDRDFQGNTIYF	TRBV9	TRBJ1-3
TGTGCCAGCAGTCCGCCTACAAGAGACAATGAGCAGTTCTTC	CASSPPTRDNEQFF	TRBV12-3	TRBJ2-1
TGTGCCAGCAGCGCAGGACCTCTCGAGCAGTACTTC	CASSAGPLEQYF	TRBV13	TRBJ2-7
TGTGCCAGTAGTCAGGCGAAGGCAGATACGCAGTATTTT	CASSQAKADTQYF	TRBV19	TRBJ2-3
TGTGCCAGCAGCTTACATCTCACAAAAAACATTCAGTACTTC	CASSLHLTKNIQYF	TRBV13	TRBJ2-4
TGTGCCAGCAGAGCGGGGGCGGGCTACGAGCAGTACTTC	CASRAGAGYEQYF	TRBV9	TRBJ2-7
TGCAGTGCTAGAGATCCCCGAGTGAGGACCGAGCAGTACTTC	CSARDPRVRTEQYF	TRBV20-1	TRBJ2-7
TGCGCCAGCAGCCAAGCCGGTACGAGAGACTCCTACGAGCAGTACTTC	CASSQAGTRDSYEQYF	TRBV4-1	TRBJ2-7
TGCGCCAGCAGCGGGGAAGGGCAAGAGACCCAGTACTTC	CASSGEGQETQYF	TRBV5-1	TRBJ2-5
TGCGCCAGCAGCTACAATACTAATGAAAAACTGTTTTTT	CASSYNTNEKLFF	TRBV5-1	TRBJ1-4
TGCAGTGCTCCGCTAAGGGGATCCTACGAGCAGTACTTC	CSAPLRGSYEQYF	TRBV20-1	TRBJ2-7
TGTGCCAGCAGCCGGCGCTGCTACGAGCAGTACTTC	CASSRRCYEQYF	TRBV16	TRBJ2-7
TGTGCCAGCAGTCCTCCTGGCAGGTGTCGGGACGACGATAGCAATCAGCCCCAGCATTTT	CASSPPGRCRDDDSNQPQHF	TRBV6-2	TRBJ1-5
TGTGCCAGCAGCAGCTTCGGGAGGGGAACAGATACGCAGTATTTT	CASSSFGRGTDTQYF	TRBV5-6	TRBJ2-3
TGTGCCAGCAGCTTAGTTACTCCGACAGGTCTGTTTTTT	CASSLVTPTGLFF	TRBV11-3	TRBJ1-4
TGTGCCAGCAGCCACGGCCGGAGGAACACTGAAGCTTTCTTT	CASSHGRRNTEAFF	TRBV14	TRBJ1-1
TGCAGCGTTGTCGGGACAGCCGGGGTGAACACTGAAGCTTTCTTT	CSVVGTAGVNTEAFF	TRBV29-1	TRBJ1-1
TGTGCCAGCAGCTTAGCCCATGTAAAAGGGGACACTGGCTACGAGCAGTACTTC	CASSLAHVKGDTGYEQYF	TRBV7-2	TRBJ2-7
TGTGCCAGCAGCCCAGGGTCACGACTAGCGGGTTGCCCGTATGAGCAGTTCTTC	CASSPGSRLAGCPYEQFF	TRBV5-4	TRBJ2-1
TGCGCCAGCAGCCAAGATCTAGTCACAGGGACGTACGAGCAGTACTTC	CASSQDLVTGTYEQYF	TRBV4-3	TRBJ2-7
TGTGCCAGCAGCTTAGTTTTGGGGGAAACTACTAATGAAAAACTGTTTTTT	CASSLVLGETTNEKLFF	TRBV7-8	TRBJ1-4
TGTGCCAGCAGTCCCGACAGGGCGCTCTCCTACGAGCAGTACTTC	CASSPDRALSYEQYF	TRBV6-1	TRBJ2-7
TGTGCCAGCAGTGGGTCCCTGGGGACTTTAGGGGGGGCGGGCTATGGCTACACCTTC	CASSGSLGTLGGAGYGYTF	TRBV28	TRBJ1-2
TGTGCTAGTGACGTCGGGGGGGATGGCTACACCTTC	CASDVGGDGYTF	TRBV12-5	TRBJ1-2
TGTGCCAGCAGCGAGCTAGTGGACAATGAGCAGTTCTTC	CASSELVDNEQFF	TRBV3-1	TRBJ2-1
TGCGCCAGCAGTGCACTGAGAGCTAGAGCAAACTACGAGCAGTACTTC	CASSALRARANYEQYF	TRBV10-1	TRBJ2-7
TGCGCCAGCAGCGGGACAGAAGAGAGTTGGGGTACTAATGAAAAACTGTTTTTT	CASSGTEESWGTNEKLFF	TRBV5-1	TRBJ1-4
TGTGCCAGCAGCGCCCTCCTGGCAGAGGGGGAGACCCAGTACTTC	CASSALLAEGETQYF	TRBV9	TRBJ2-5
TGTGCCAGCAGCGGCAGGCCCTATGGCTACACCTTC	CASSGRPYGYTF	TRBV5-5	TRBJ1-2
TGTGCCAGCAGTTACCTGGGGCCCGAGACCCAGTACTTC	CASSYLGPETQYF	TRBV6-5	TRBJ2-5
TGTGCCAGTATCGAGGGGGATTTTGAGCAGTTCTTC	CASIEGDFEQFF	TRBV6-3	TRBJ2-1
TGTGCCAGCAGCTTGCTCTACTCTGGAAACACCATATATTTT	CASSLLYSGNTIYF	TRBV13	TRBJ1-3
TGTGCCAGCAGCCAAGATTCCGAGAACGGAGGAGGGGATACGCAGTATTTT	CASSQDSENGGGDTQYF	TRBV14	TRBJ2-3
TGTGCCAGCAGCGTAGCGTGGGAAAATCTGAGAATAATTGGCTATGGCTACACCTTC	CASSVAWENLRIIGYGYTF	TRBV9	TRBJ1-2
TGTGCCAGCAGTGAGGGGAGCTATGGCTACACCTTC	CASSEGSYGYTF	TRBV25-1	TRBJ1-2
TGTGGCTCGGCACAGGCCTATCAGCCCCAGCATTTT	CGSAQAYQPQHF	TRBV2	TRBJ1-5
TGTGCCAGCAGCCTTAGACATGAGCAGTTCTTC	CASSLRHEQFF	TRBV7-3	TRBJ2-1
TGTGCCAGCAGTTCCCAGGGGCACAATGAGCAGTTCTTC	CASSSQGHNEQFF	TRBV6-6	TRBJ2-1
TGTGCCAGCCACGGAAATATCTCGGGACAGGCGTATGAGCAGTTCTTC	CASHGNISGQAYEQFF	TRBV7-9	TRBJ2-1
TGTGCCAGCAGCTATACTCGCTCAACCCGAAGATCCTACAATGAGCAGTTCTTC	CASSYTRSTRRSYNEQFF	TRBV3-1	TRBJ2-1
TGCAGTGCTAGGCGGAACCCTAGGGGGGATTCCTACAATGAGCAGTTCTTC	CSARRNPRGDSYNEQFF	TRBV20-1	TRBJ2-1
TGTGCCAATCCGGTGAGTAATGAAAAACTGTTTTTT	CANPVSNEKLFF	TRBV6-1	TRBJ1-4
TGCAGTGCCGAAAAGGACAACACTGAAGCTTTCTTT	CSAEKDNTEAFF	TRBV20-1	TRBJ1-1
TGTGCCAGCAGCAACCGACCCCGGGGCCCCTGGAGAGCAGTGGGCAGAGCTTTCTTT	CASSNRPRGPWRAVGRAFF	TRBV11-2	TRBJ1-1
TGTGCCAGCGGGGGACTGGCCTATGGCTACACCTTC	CASGGLAYGYTF	TRBV27	TRBJ1-2
TGTGCCACCCACGGACCCTATGGCTACACCTTC	CATHGPYGYTF	TRBV24-1	TRBJ1-2
TGTGCCAGTAGTAGAGGGCACCGGACTAGTGTGGAGACCCAGTACTTC	CASSRGHRTSVETQYF	TRBV19	TRBJ2-5
TGTGCCAGAGGGACTAGGCGCCTAGATACGCAGTATTTT	CARGTRRLDTQYF	TRBV19	TRBJ2-3
TGCAGCGTTGAAATAGGGGTCCCGAGCACAGATACGCAGTATTTT	CSVEIGVPSTDTQYF	TRBV29-1	TRBJ2-3
TGTGCCAGCAGCGAGGCAGGGCAGGGTTCCACTGAAGCTTTCTTT	CASSEAGQGSTEAFF	TRBV13	TRBJ1-1
TGCAGCGCCCGACAGGGGCAGTTCTTC	CSARQGQFF	TRBV29-1	TRBJ2-1
TGTGCCAGCAGCTTGGTTCAGGGCCCCCCCCGAAATCAGCCCCAGCATTTT	CASSLVQGPPRNQPQHF	TRBV5-5	TRBJ1-5
TGTGCCAGCAGCTTGCTCCAGGGAAAGACCTACGAGCAGTACTTC	CASSLLQGKTYEQYF	TRBV5-6	TRBJ2-7
TGTGCTAGTGGACACAGGGGGATGAACACTGAAGCTTTCTTT	CASGHRGMNTEAFF	TRBV12-5	TRBJ1-1
TGCAGCGTTGAAGCGGCCCTTATACAAAATGCGACTGTTCATAAGGAAGGGTACGAGCAGTACTTC	CSVEAALIQNATVHKEGYEQYF	TRBV29-1	TRBJ2-7
TGTGCCTGGAGAGACGGGTCGATCGCATCACCTAACTATGGCTACACCTTC	CAWRDGSIASPNYGYTF	TRBV30	TRBJ1-2
TGTGCCTGGACCCCATCCGGGACAGAATACGAGCAGTACTTC	CAWTPSGTEYEQYF	TRBV30	TRBJ2-7
TGTGCCAGCAGCCAAGAACAGAACGACGAGCAGTACTTC	CASSQEQNDEQYF	TRBV14	TRBJ2-7
TGTGCCAGCAGCTTAGAGCAGGGGGCGACGATGAATCAGCCCCAGCATTTT	CASSLEQGATMNQPQHF	TRBV7-9	TRBJ1-5
TGTGCCAGCCCTTTCCCATTGGCCAACGACAGGGGTTTTAACCATAAAGAGCAGTACTTC	CASPFPLANDRGFNHKEQYF	TRBV2	TRBJ2-7
TGTGCCAGCCACAGGAACAGGGGGTTCCACACTGAAGCTTTCTTT	CASHRNRGFHTEAFF	TRBV13	TRBJ1-1
TGCGCCAGCAGCACCCAGGCCGGACTTTCGGCTTTAGGCCAAGAGACCCAGTACTTC	CASSTQAGLSALGQETQYF	TRBV5-1	TRBJ2-5
TGTGCCAGCAGCTTTAGGAGGGTATCCCGAAACACCATATATTTT	CASSFRRVSRNTIYF	TRBV7-4	TRBJ1-3
TGTGCCAGCAGCTTTCTCCGTGGCTACACCTTC	CASSFLRGYTF	TRBV11-3	TRBJ1-2
TGTGCCAGCAGCTTAAGCCAGGCCTCCCGCGGGAGCCAAGAGACCCAGTACTTC	CASSLSQASRGSQETQYF	TRBV7-3	TRBJ2-5
TGTGCCACCAGTGATTACGACCCTCAAGAGACCCAGTACTTC	CATSDYDPQETQYF	TRBV24-1	TRBJ2-5
TGTGCCAGCAGCCCAGTCCATAGGACTAGCGGGATAAAACCCTCTGGGGCCAACGTCCTGACTTTC	CASSPVHRTSGIKPSGANVLTF	TRBV7-3	TRBJ2-6
TGCAGTGCCCCTGACCGCAATGAGCAGTTCTTC	CSAPDRNEQFF	TRBV20-1	TRBJ2-1
TGCAGTGCTAGGTCGGCCCACACGACTAGCGGAAGAGCGTACTTC	CSARSAHTTSGRAYF	TRBV20-1	TRBJ2-5
TGTGCCAGCAGGATTAGCAGTGCCTACGAGCAGTACTTC	CASRISSAYEQYF	TRBV6-4	TRBJ2-7
TGCGCCAGCAGCCAAGAGAGTACTGGGCCCGTCCCCTACGAGCAGTACTTC	CASSQESTGPVPYEQYF	TRBV4-1	TRBJ2-7
TGTGCCAGCCCACAACCGTCAGTCAATGAGCAGTTCTTC	CASPQPSVNEQFF	TRBV5-6	TRBJ2-1
TGCGCCAGCAGCCGGGCACAGGGGGGGCGAATCTCTAGCACAGATACGCAGTATTTT	CASSRAQGGRISSTDTQYF	TRBV4-1	TRBJ2-3
TGTGCTAGTGGTTTGCGGAGGTCCGGAGGGTCGGAGAACACTGAAGCTTTCTTT	CASGLRRSGGSENTEAFF	TRBV12-5	TRBJ1-1
TGTGCCAGCAGCACCGGGGAAGGAGGGAACACCGGGGAGCTGTTTTTT	CASSTGEGGNTGELFF	TRBV5-6	TRBJ2-2
TGCGCCAGCAGGGGGGTGGGTTACAATCAGCCCCAGCATTTT	CASRGVGYNQPQHF	TRBV10-1	TRBJ1-5
TGTGCCAGCAGCTGGACCACGCGACCCCTAGGCGAGACCCAGTACTTC	CASSWTTRPLGETQYF	TRBV5-6	TRBJ2-5
TGTGCCAGCAGGGGATGGGCGGGCCAAGAGACCCAGTACTTC	CASRGWAGQETQYF	TRBV28	TRBJ2-5
TGTGCCAGCAGCCCCCCCCCCCTCAGGGGGGAGTGGACTTTTAGCAATCAGCCCCAGCATTTT	CASSPPPLRGEWTFSNQPQHF	TRBV13	TRBJ1-5
TGTGCCAGCAGTCCCGGACTAGCGGGTGCCCAGAAGGTCACAGATACGCAGTATTTT	CASSPGLAGAQKVTDTQYF	TRBV6-3	TRBJ2-3
TGTGCCAGCAGCACACCCTGCGGCCCAGCGTCATACGAGCAGTACTTC	CASSTPCGPASYEQYF	TRBV2	TRBJ2-7
TGTGCTAGCAGCTCGCCCCGGACTAGCCTAGACACTGAAGCTTTCTTT	CASSSPRTSLDTEAFF	TRBV7-7	TRBJ1-1
TGTGCCAGCAGTTCCCTGGAGAGCACAGATACGCAGTATTTT	CASSSLESTDTQYF	TRBV28	TRBJ2-3
TGTGCCAGCAGCTTATGGGAGTGGACAGGGAAGGACTCGGTTGGGAGCTCCTACAATGAGCAGTTCTTC	CASSLWEWTGKDSVGSSYNEQFF	TRBV7-9	TRBJ2-1
TGTGCCAGCAGTTGGCCCAAACTAGCGGGGGGTTCTAATGAGCAGTTCTTC	CASSWPKLAGGSNEQFF	TRBV6-5	TRBJ2-1
TGTGCCAGCAGCCAAGATTATAAACTCGCAGGGAGCACAGATACGCAGTATTTT	CASSQDYKLAGSTDTQYF	TRBV3-1	TRBJ2-3
TGTGCCTGGAGGCTGAATCAGCCCCAGCATTTT	CAWRLNQPQHF	TRBV30	TRBJ1-5
TGTGCCAGTATGCCTGAAAACGACTATGGCTACACCTTC	CASMPENDYGYTF	TRBV19	TRBJ1-2
TGTGCCAGCAGCCCTCTAGCGGCTTACAATGAGCAGTTCTTC	CASSPLAAYNEQFF	TRBV13	TRBJ2-1
TGTGCCAGCAGTGAATTACTCGGGGAAGAGACCCAGTACTTC	CASSELLGEETQYF	TRBV2	TRBJ2-5
TGTGCCAGCAGTGTCGCACTAGCGGGAGGGGTGTCGCTAGCCAAAAACATTCAGTACTTC	CASSVALAGGVSLAKNIQYF	TRBV2	TRBJ2-4
TGTGCCAGCAGCTTACAGGGAGGTCGGGGCAGCACAGATACGCAGTATTTT	CASSLQGGRGSTDTQYF	TRBV7-9	TRBJ2-3
TGTGCCAGCAGGGGGGTAGGGAGATCTAACACCGGGGAGCTGTTTTTT	CASRGVGRSNTGELFF	TRBV7-3	TRBJ2-2
TGCAGTGCTAGAATGCTAGCGAGATACGAGCAGTACTTC	CSARMLARYEQYF	TRBV20-1	TRBJ2-7
TGTGCCAGGTCTCCAGGGAGCTCCTATAATTCACCCCTCCACTTT	CARSPGSSYNSPLHF	TRBV19	TRBJ1-6
TGCGCCAGTTTCCCCGTCGGACCGGCTGTTCAAGAGACCCAGTACTTC	CASFPVGPAVQETQYF	TRBV5-1	TRBJ2-5
TGTGCCAGCAGCCACAGCTCTGGAAACACCATATATTTT	CASSHSSGNTIYF	TRBV14	TRBJ1-3
TGTGCCAGCCGGGATGGCCTTCACTACGAGCAGTACTTC	CASRDGLHYEQYF	TRBV7-3	TRBJ2-7
TGTGCCAGCACCCATGACCAGGGAGGGAATTCACCCCTCCACTTT	CASTHDQGGNSPLHF	TRBV9	TRBJ1-6
TGTGCCAGCAGCGACCTTCGGTCAGGGAACACTGAAGCTTTCTTT	CASSDLRSGNTEAFF	TRBV7-4	TRBJ1-1
TGTGCCAGCAGTGGTCGTAATGAAAAACTGTTTTTT	CASSGRNEKLFF	TRBV6-8	TRBJ1-4
TGTGCCAGCAGCCAAGGATCCTTTGGACAGGGGAAGATTAATGAAAAACTGTTTTTT	CASSQGSFGQGKINEKLFF	TRBV4-2	TRBJ1-4
TGCAGTGCCGACAAGCAGTTCTTC	CSADKQFF	TRBV20-1	TRBJ2-1
TGCGCCAGCAGCCATCCAGCCGGGACAGAAGAGCAGTACTTC	CASSHPAGTEEQYF	TRBV4-1	TRBJ2-7
TGTGCCAGCAGTTTTACGACTAGCGGGGACAGCACAGATACGCAGTATTTT	CASSFTTSGDSTDTQYF	TRBV28	TRBJ2-3
TGCGCCAGCAGCCATTACCTAGCGGGATCCTACGAGCAGTACTTC	CASSHYLAGSYEQYF	TRBV4-1	TRBJ2-7
TGTGCCAGCAAGTGGGGGGCCAGAGATGAGCAGTTCTTC	CASKWGARDEQFF	TRBV2	TRBJ2-1
TGTGCCAGCAGTAAGGACAGGGCGGTACCATACACCGGGGAGCTGTTTTTT	CASSKDRAVPYTGELFF	TRBV6-5	TRBJ2-2
TGTGCCAGTACCCAGACAGGGGGGAGCAATCAGCCCCAGCATTTT	CASTQTGGSNQPQHF	TRBV19	TRBJ1-5
TGTGCCAGCAGTAACGAAGCGGGGGGAGGGAATGAGCAGTTCTTC	CASSNEAGGGNEQFF	TRBV6-5	TRBJ2-1
TGTGCCAGCAGCTTAGAGGGGGCCCAAGAGACCCAGTACTTC	CASSLEGAQETQYF	TRBV7-2	TRBJ2-5
TGCAGTGCTAGAGATCCCCTGCAGGGACAGGGGGGGAGACATCAGCCCCAGCATTTT	CSARDPLQGQGGRHQPQHF	TRBV20-1	TRBJ1-5
TGCGCCAGCAGCCGTGGACAGGGGAACACTGAAGCTTTCTTT	CASSRGQGNTEAFF	TRBV4-3	TRBJ1-1
TGTGCCAGCAGCGAAGGAGTCCCGCGACGGGATAAGACAAGATACTTATACAATGAGCAGTTCTTC	CASSEGVPRRDKTRYLYNEQFF	TRBV7-3	TRBJ2-1
TGTGCCAGCATCCGCGGGACAGGGAGGGATGAAGCTTTCTTT	CASIRGTGRDEAFF	TRBV25-1	TRBJ1-1
TGTGCCAGCATCAGGCGAACCTGTAGGGACGAGCAGTACTTC	CASIRRTCRDEQYF	TRBV11-3	TRBJ2-7
TGTGCCACCAGTGATTGCGTTTATATTGCCCGTCCAAACGAGCAGTACTTC	CATSDCVYIARPNEQYF	TRBV24-1	TRBJ2-7
TGTGCCAGCAGCGGACTAAACCAAAATAATTCACCCCTCCACTTT	CASSGLNQNNSPLHF	TRBV9	TRBJ1-6
TGTGCCAGCAGTGACGCCCGGAGGGGCTCTGGAAACACCATATATTTT	CASSDARRGSGNTIYF	TRBV6-4	TRBJ1-3
TGCGCCAGCAGCTTGGGAAGAGGGGACTATCAGCCCCAGCATTTT	CASSLGRGDYQPQHF	TRBV5-1	TRBJ1-5
TGTGCCAGCAGTTACTCGGGGACTAGCGGGCAGGCAGATACGCAGTATTTT	CASSYSGTSGQADTQYF	TRBV6-2	TRBJ2-3
