TGTGCCAGCTCACCGGCTGGCCCACAGGGGGCTCAGCCCCAGCATTTT	CASSPAGPQGAQPQHF	TRBV18	TRBJ1-5
TGTGCCACCAGTGAAGGGGCGGTCATGAACACTGAAGCTTTCTTT	CATSEGAVMNTEAFF	TRBV24-1	TRBJ1-1
TGTGCCAGGAGGACGACGCAGTTCTTC	CARRTTQFF	TRBV5-4	TRBJ2-1
TGTGCTAGCAGCTTAGGCGCACAGGGAAAACTGTTTTTT	CASSLGAQGKLFF	TRBV7-7	TRBJ1-4
TGTGCCAGATGGGGGAAAGAATTTCTCTACGAGCAGTACTTC	CARWGKEFLYEQYF	TRBV19	TRBJ2-7
TGTGCCAGCAGCTTAACACCACAGGGGTGGCTACTTAACTATGGCTACACCTTC	CASSLTPQGWLLNYGYTF	TRBV7-9	TRBJ1-2
TGTGCCATACCCGACAGGTTAAACGAGCAGTACTTC	CAIPDRLNEQYF	TRBV10-3	TRBJ2-7
TGTGCCAGCAGCCGGACTAGGGGGAGCACAGATACGCAGTATTTT	CASSRTRGSTDTQYF	TRBV7-3	TRBJ2-3
TGCGCCAGCAGCTTGACATTTTGGACAGGGAACACTGAAGCTTTCTTT	CASSLTFWTGNTEAFF	TRBV5-1	TRBJ1-1
TGTGCCAGCAGCTTGGCCCTAATAGATCCTCTCAATCAGCCCCAGCATTTT	CASSLALIDPLNQPQHF	TRBV5-4	TRBJ1-5
TGTGCCAGCAAAAGGGGGCCTTTCGAGCAGTACTTC	CASKRGPFEQYF	TRBV6-8	TRBJ2-7
TGTGCCAGCAGCACCCACGCAAGCGGGAGGTGTGGCTACACCTTC	CASSTHASGRCGYTF	TRBV13	TRBJ1-2
TGTGCCAGCAGCTTAGAAAGGGGCAGAGCCAAAAACATTCAGTACTTC	CASSLERGRAKNIQYF	TRBV7-9	TRBJ2-4
TGTGCCAGCAGCGTTCCCGGGACTAGCGGGAGTAATAGACAAGAGACCCAGTACTTC	CASSVPGTSGSNRQETQYF	TRBV9	TRBJ2-5
TGTGCCATTCGGACCGAGAAGCAGTACTTC	CAIRTEKQYF	TRBV19	TRBJ2-7
TGTGCCAGTAGTATAGATGTCGGTAGGGACTGCAGCTCCTACAATGAGCAGTTCTTC	CASSIDVGRDCSSYNEQFF	TRBV19	TRBJ2-1
TGTGCCAGCATAATCGCGGGAGATGGTGTTCAGCCCCAGCATTTT	CASIIAGDGVQPQHF	TRBV24-1	TRBJ1-5
TGCGCCAGCAGCGAACAGAGCGGGGACCACACAGATACGCAGTATTTT	CASSEQSGDHTDTQYF	TRBV5-1	TRBJ2-3
TGTGCCAGCAGCCCGAAGCGGGAGGACACCGGGGAGCTGTTTTTT	CASSPKREDTGELFF	TRBV14	TRBJ2-2
TGCGCCAGCAGCCATGCCCATAACTATGGCTACACCTTC	CASSHAHNYGYTF	TRBV4-1	TRBJ1-2
TGTGCCAGCAGTTGGGCACTAGCGGGAGGGCAAAGCTCCTACAATGAGCAGTTCTTC	CASSWALAGGQSSYNEQFF	TRBV12-3	TRBJ2-1
TGCGCCAGCAGCGGGACAGAGTCCTACGAGCAGTACTTC	CASSGTESYEQYF	TRBV5-1	TRBJ2-7
TGTGCTAGTGGTAGTCTAAACCCGGGCAGGGGGCAAGAGACCCAGTACTTC	CASGSLNPGRGQETQYF	TRBV12-5	TRBJ2-5
TGTGCCAGCAGCGTAGTAGACACCAATGAGCAGTTCTTC	CASSVVDTNEQFF	TRBV9	TRBJ2-1
TGTGCCAGCAGGGGACAGGCGGGGGGCTCCTACGAGCAGTACTTC	CASRGQAGGSYEQYF	TRBV12-4	TRBJ2-7
TGTGCCAGCAGCTCACCCCCCGGGACATCCGAGGGCCCCACAGATACGCAGTATTTT	CASSSPPGTSEGPTDTQYF	TRBV13	TRBJ2-3
TGTGCCAGCAGCCTTCGGAGGGATGGCTACACCTTC	CASSLRRDGYTF	TRBV6-1	TRBJ1-2
TGTGCCAGCAGCCAAGAGACTCTCACAAATGGCTACACCTTC	CASSQETLTNGYTF	TRBV3-1	TRBJ1-2
TGTGCCAGTAGGACAGGGGGTGAAAAACTGTTTTTT	CASRTGGEKLFF	TRBV7-2	TRBJ1-4
TGTGCCAGCAGTTACTTAGGAAGGGCAGGGCATAGCACAGATACGCAGTATTTT	CASSYLGRAGHSTDTQYF	TRBV6-5	TRBJ2-3
TGTGCCAGCAGCTTAACCCCCCCCCGCGGGAGAAGGAGTAGCGGCTACACCTTC	CASSLTPPRGRRSSGYTF	TRBV5-4	TRBJ1-2
TGTGCCAGCAGTTTATGGGACGACTACGAGCAGTACTTC	CASSLWDDYEQYF	TRBV27	TRBJ2-7
TGTGCCAGCAGTTTATGCAGGGGGCCGTGCTATGGCTACACCTTC	CASSLCRGPCYGYTF	TRBV27	TRBJ1-2
TGTGCCAGCAGCTTAAGTGCAGTAGCAAACACCATATATTTT	CASSLSAVANTIYF	TRBV7-8	TRBJ1-3
TGTGCCAGCAGTCAACTGGCAGGGCCCTCCTCCCAGGCGTCGACTGACAATGAGCAGTTCTTC	CASSQLAGPSSQASTDNEQFF	TRBV27	TRBJ2-1
TGTGCTAGTGGTTTGTACCTCGTCAACTGGGCCGAGGAGCAGTACTTC	CASGLYLVNWAEEQYF	TRBV12-5	TRBJ2-7
TGTGCCAGCAGTGACGTGGGGGCGGGCTGCTCTGGAAACACCATATATTTT	CASSDVGAGCSGNTIYF	TRBV6-4	TRBJ1-3
TGCGCCAGCAGCCCCTGGGGGTCCTACGAGCAGTACTTC	CASSPWGSYEQYF	TRBV4-1	TRBJ2-7
TGTGCCAGCATCAGCCCCCCCGGCTATGGCTACACCTTC	CASISPPGYGYTF	TRBV25-1	TRBJ1-2
TGTGCCAGCAGTTACTCGATAATCTCGGGGGACAATGAGCAGTTCTTC	CASSYSIISGDNEQFF	TRBV6-5	TRBJ2-1
TGTGCCAGCAGTGTCCCCTCGAAGGACCTCCCAGGGGAGTTCCTCCACACTGAAGCTTTCTTT	CASSVPSKDLPGEFLHTEAFF	TRBV28	TRBJ1-1
TGTGCCAGCACGCACTCGTTGGAGGCGAGCCTCGAAGCTTTCTTT	CASTHSLEASLEAFF	TRBV27	TRBJ1-1
TGCGCCAGCAGCCAACGTGTGGAGCCAGGCCAAGAGACCCAGTACTTC	CASSQRVEPGQETQYF	TRBV4-3	TRBJ2-5
TGTGCCAGCAGCTTGGATGTGACAGGGGACCAAGCTTTCTTT	CASSLDVTGDQAFF	TRBV5-4	TRBJ1-1
TGTGCCAGCAGCTGTGACAGGCCGGGGGCCCTCCACTTT	CASSCDRPGALHF	TRBV11-3	TRBJ1-6
TGCGCCAGCAGCCCAGTAAAAAATGAAAAACTGTTTTTT	CASSPVKNEKLFF	TRBV4-1	TRBJ1-4
TGTGCCAGCAGTGAAACAGCGGGAGAGACCCAGTACTTC	CASSETAGETQYF	TRBV6-4	TRBJ2-5
TGTGCCAGCAGTGACAACTGGGGGAGAACCCATGAGCAGTTCTTC	CASSDNWGRTHEQFF	TRBV6-4	TRBJ2-1
TGTGCCAGCAGTTACGACAGTCAAGACAGGGTTATTCAGCCCCAGCATTTT	CASSYDSQDRVIQPQHF	TRBV6-2	TRBJ1-5
TGTGCCAGCCGGGCCTCCGCCAGGGGAGGTCGCACTGAAGCTTTCTTT	CASRASARGGRTEAFF	TRBV5-8	TRBJ1-1
TGTGCCAGCAGCCGTAGAGGGAGAGGGTATAGCAATCAGCCCCAGCATTTT	CASSRRGRGYSNQPQHF	TRBV6-4	TRBJ1-5
TGTGCCAGAGGGCCCTGGTACAGGGCCCACGCCCCCGCAGATACGCAGTATTTT	CARGPWYRAHAPADTQYF	TRBV7-2	TRBJ2-3
TGCGCCAGCAGCGGGGGGAGGGAGGACAGTCACTATGGCTACACCTTC	CASSGGREDSHYGYTF	TRBV5-1	TRBJ1-2
TGCGCCAGCATCCGGGGCTATCCATCTAACTATGGCTACACCTTC	CASIRGYPSNYGYTF	TRBV10-2	TRBJ1-2
TGCGCCAGCACAGCGAGCTCTCAGCCCCAGCATTTT	CASTASSQPQHF	TRBV5-1	TRBJ1-5
TGTGCCAGCCCGAGAGGGGCAAGCAAATACTACGAGCAGTACTTC	CASPRGASKYYEQYF	TRBV27	TRBJ2-7
TGTGCCAGCTACCTTCCGCACCGGGACAGGGGGTATGGCTACACCTTC	CASYLPHRDRGYGYTF	TRBV2	TRBJ1-2
TGTGCCAGCAGCTTAGAATTAGGGAGTAAAAATGGGGATATGAACACTGAAGCTTTCTTT	CASSLELGSKNGDMNTEAFF	TRBV7-6	TRBJ1-1
TGTGCCACCAGTGGGACAGGGGGCTGGGCAGCCGCTATTCTCCTAAAGGGGGAGCAGTTCTTC	CATSGTGGWAAAILLKGEQFF	TRBV24-1	TRBJ2-1
TGCGCCAGCAGCCAAGATCGACAGGGAACGTACGAGCAGTACTTC	CASSQDRQGTYEQYF	TRBV4-1	TRBJ2-7
TGTGCCAGCAGATCCCCGGGACTAGGGGGCTTCGAGCAGTACTTC	CASRSPGLGGFEQYF	TRBV6-5	TRBJ2-7
TGTGCCAGCAGCTTAGGGGAGCGGGATGGGGACTGCGATCACTTAGAGACCCAGTACTTC	CASSLGERDGDCDHLETQYF	TRBV7-9	TRBJ2-5
TGTGCCAGCAGAAAACCGGGACTAGGATACTCCGGGGAGCTGTTTTTT	CASRKPGLGYSGELFF	TRBV7-9	TRBJ2-2
TGTGCCAGCAGTGAAGCATTAGGGGCTGTCAACGGCTACACCTTC	CASSEALGAVNGYTF	TRBV6-1	TRBJ1-2
TGCAGTGCTAGAGCGCGGGGGCTGGGACATACTAGCAATCAGCCCCAGCATTTT	CSARARGLGHTSNQPQHF	TRBV20-1	TRBJ1-5
TGTGCCAGGGCTCTAGGAGGAGATACGCAGTATTTT	CARALGGDTQYF	TRBV11-3	TRBJ2-3
TGTGCTAGTGGTTTGGTAAAATCGGATTGCCAAGAGACCCAGTACTTC	CASGLVKSDCQETQYF	TRBV12-5	TRBJ2-5
TGTGCCAGCAGTGACTGGGGCGATGGCTACACCTTC	CASSDWGDGYTF	TRBV6-1	TRBJ1-2
TGTGCCAGCAGTGCCTTGGACAGGCTGGGTTACGAGCAGTACTTC	CASSALDRLGYEQYF	TRBV27	TRBJ2-7
TGTGCCAGCAGCTCACCGTCCGGGGAGGACAGGGGGGAAGAGACCCAGTACTTC	CASSSPSGEDRGEETQYF	TRBV7-2	TRBJ2-5
TGTGCCAGCAGTTACTCGACTGGGGGGGTGGGCTACGAGCAGTACTTC	CASSYSTGGVGYEQYF	TRBV6-5	TRBJ2-7
TGTGCCAGCAGTTACACTAGACTGAGATGGGTCCACAATGAGCAGTTCTTC	CASSYTRLRWVHNEQFF	TRBV6-8	TRBJ2-1
TGTGCCAGCAGCTCTGGGAGGGAGTTTGAGCAGTTCTTC	CASSSGREFEQFF	TRBV7-9	TRBJ2-1
TGTGCCAGCAGGCCTAGTTCGGAGCAGTACTTC	CASRPSSEQYF	TRBV28	TRBJ2-7
TGTGCCAGTAGTAAACACGGGACCCGTGCTAATACAGATACGCAGTATTTT	CASSKHGTRANTDTQYF	TRBV19	TRBJ2-3
TGCAGCGTGTCCCCGGGACAGGGACTCCCTCCGTATGGCTACACCTTC	CSVSPGQGLPPYGYTF	TRBV29-1	TRBJ1-2
TGTGCCAGCAGTGAGGTACGGTTACAGGGTCTTATACTCCAGTACGAGCAGTACTTC	CASSEVRLQGLILQYEQYF	TRBV6-4	TRBJ2-7
TGTGCCAGCAGCGAAATGGCTAGGATCGCACACACCGGGGAGCTGTTTTTT	CASSEMARIAHTGELFF	TRBV7-9	TRBJ2-2
TGCAGTGCTAGAGGCCGTGCCGGGGCTGCCAATGAGCAGTTCTTC	CSARGRAGAANEQFF	TRBV20-1	TRBJ2-1
TGCGCCACGGGCACAAAACGGACTAGCGGGATAGACCAAGAGACCCAGTACTTC	CATGTKRTSGIDQETQYF	TRBV10-1	TRBJ2-5
TGTGCCAGCAGCGGACAGGGTTTGATAGCTTTCTTT	CASSGQGLIAFF	TRBV7-3	TRBJ1-1
TGTGCCAGCAGCCAAGATCCACGTTCTGGCAAAGCCAAAAACATTCAGTACTTC	CASSQDPRSGKAKNIQYF	TRBV4-2	TRBJ2-4
TGTGCCAGCAGTTATGGCATGGACAGGGGGTCCTACGAGCAGTACTTC	CASSYGMDRGSYEQYF	TRBV28	TRBJ2-7
TGTGCCAGCAGTGTGGTTCCTTTACAGGGGGCTGGCTACGAGCAGTACTTC	CASSVVPLQGAGYEQYF	TRBV2	TRBJ2-7
TGCGCCAGCAGTGATCTTCAGGCCCATGAAGCTTTCTTT	CASSDLQAHEAFF	TRBV10-1	TRBJ1-1
TGTGCCAGCAGTCAGGGGAAGGATGAGCAGTTCTTC	CASSQGKDEQFF	TRBV5-6	TRBJ2-1
TGTGCCAGCATCCCTCCGAACGTGGGACAGGGGGCGTATAGCAATCAGCCCCAGCATTTT	CASIPPNVGQGAYSNQPQHF	TRBV6-1	TRBJ1-5
TGTGCCACCCTCGTTTATAAACAGGGCAAGACTGAAGCTTTCTTT	CATLVYKQGKTEAFF	TRBV15	TRBJ1-1
TGTGCCAGCAGCGCCCCTATACCGGGGAGTAATGAAAAACTGTTTTTT	CASSAPIPGSNEKLFF	TRBV9	TRBJ1-4
TGTGCCAGCAGTAAAGGGCCCAGGGGGGCCCACTACACAGATACGCAGTATTTT	CASSKGPRGAHYTDTQYF	TRBV6-5	TRBJ2-3
TGTGCCAGCAGTCCACACAACGGAAACACCATATATTTT	CASSPHNGNTIYF	TRBV12-3	TRBJ1-3
TGTGCCAGCAGCGTAGTTATCCCCTCAGGGGGTCCTTGGGCTTTCTTT	CASSVVIPSGGPWAFF	TRBV9	TRBJ1-1
TGTGCCAGCAGCTGTTGGGACAGGAGGGCCAAAAACATTCAGTACTTC	CASSCWDRRAKNIQYF	TRBV7-2	TRBJ2-4
TGTGCCGGACAGGGAGATCAGGCCGGCTACACCTTC	CAGQGDQAGYTF	TRBV12-5	TRBJ1-2
TGTGCCAGTAGTATGTCCGCCCGCTGTGTCCTCTGCATAAACACCGGGGAGCTGTTTTTT	CASSMSARCVLCINTGELFF	TRBV19	TRBJ2-2
TGTGCCAGCAGCTTGCGGACTGGGACAAGTGGACACACCTTC	CASSLRTGTSGHTF	TRBV11-2	TRBJ1-2
TGCGCCAGCAGTGAAACCGGGGCGGAGTCTGAAGCTTTCTTT	CASSETGAESEAFF	TRBV10-1	TRBJ1-1
TGTGCCAGCAGCCAAGGTGGGGGGGGATCAGATACGCAGTATTTT	CASSQGGGGSDTQYF	TRBV3-1	TRBJ2-3
TGTGCCAGCAGCAGGAGGGACAGCGTCGGACGATTCACTGAAGCTTTCTTT	CASSRRDSVGRFTEAFF	TRBV7-3	TRBJ1-1
TGTGCCAGCAGCCAAGATCCTCGGGGTCCCAATCAGCCCCAGCATTTT	CASSQDPRGPNQPQHF	TRBV14	TRBJ1-5
TGTGCCAGCAGCTTAGGCCCTCCGTACAATGAGCAGTTCTTC	CASSLGPPYNEQFF	TRBV11-2	TRBJ2-1
TGTGCCAGCACGAGGGAGGCTCGCACAGATACGCAGTATTTT	CASTREARTDTQYF	TRBV6-1	TRBJ2-3
TGTGCCAGCAGCTTTCAGGGCACTGAAGCTTTCTTT	CASSFQGTEAFF	TRBV6-5	TRBJ1-1
TGCAGCGTTTACCCCGGGACTAGCGTCAACACCGGGGAGCTGTTTTTT	CSVYPGTSVNTGELFF	TRBV29-1	TRBJ2-2
TGTGCCACCAGTGATTCAATCGTAACAGAGCACTCTGGAAACACCATATATTTT	CATSDSIVTEHSGNTIYF	TRBV24-1	TRBJ1-3
TGTGCCAGCAGTTCCAGGGAATCTGAAAAACTGTTTTTT	CASSSRESEKLFF	TRBV6-1	TRBJ1-4
TGTGCCGGGGGGGGAACTAGCTCCTACGAGCAGTACTTC	CAGGGTSSYEQYF	TRBV6-5	TRBJ2-7
TGTGCCAGCAGCCAAGAAAAAGTGCCGGGACGGGAGACCCAGTACTTC	CASSQEKVPGRETQYF	TRBV14	TRBJ2-5
TGCGCCAGCAGCTTGCGGGGGAGGATTGAAGCTTTCTTT	CASSLRGRIEAFF	TRBV5-1	TRBJ1-1
TGTGCCAGCAGCTTGGCCGCTCCAGGATACAATGAGCAGTTCTTC	CASSLAAPGYNEQFF	TRBV5-4	TRBJ2-1
TGTGCCAGCAGTTTGGGGGGGGACAATGAGCAGTTCTTC	CASSLGGDNEQFF	TRBV6-5	TRBJ2-1
TGTGCCAGCAGTGACAGTTGCAGCACTGAAGCTTTCTTT	CASSDSCSTEAFF	TRBV2	TRBJ1-1
TGTGCCAGCAGTTACAGACAGGGGGAGACCCAGTACTTC	CASSYRQGETQYF	TRBV12-3	TRBJ2-5
TGTGCCAGCAGTTTACTACTACCGGGGACGGGGATTATATCCTACGAGCAGTACTTC	CASSLLLPGTGIISYEQYF	TRBV27	TRBJ2-7
TGTGCCAGCAGTTTACCAGGGGGAGCCTACGAGCAGTACTTC	CASSLPGGAYEQYF	TRBV28	TRBJ2-7
TGCCACGGGACAGAGGACGGAACTGAAGCTTTCTTT	CHGTEDGTEAFF	TRBV29-1	TRBJ1-1
TGTGCCAGCAGTGAAGCCCCAGACGATCTCAATCAGCCCCAGCATTTT	CASSEAPDDLNQPQHF	TRBV6-1	TRBJ1-5
TGTGCCAGCAAAGGACAGGTCTACAATGAGCAGTTCTTC	CASKGQVYNEQFF	TRBV6-2	TRBJ2-1
TGTGCCAGCTTGGGAGAAGGGGAAGAGACCCAGTACTTC	CASLGEGEETQYF	TRBV7-2	TRBJ2-5
TGTGCCAGCAGCGGGGCCCAACGTAATGGCTACACCTTC	CASSGAQRNGYTF	TRBV9	TRBJ1-2
TGTGCCAGGACCTACGAGCAGTACTTC	CARTYEQYF	TRBV6-4	TRBJ2-7
TGTGCCAGCATCCGATCAGGGGATCAGCCCCAGCATTTT	CASIRSGDQPQHF	TRBV27	TRBJ1-5
TGCGCCAGCAGCCAAGGTAAGGAAGACCTAGCGGGGAATGAGCAGTTCTTC	CASSQGKEDLAGNEQFF	TRBV4-1	TRBJ2-1
TGCGCCAGCTACTGCGGGAGGCAGTACTTC	CASYCGRQYF	TRBV10-1	TRBJ2-7
TGTGCCAGCAGCTTAGATTTACCAAATCAGCCCCAGCATTTT	CASSLDLPNQPQHF	TRBV11-3	TRBJ1-5
TGTGCCAGCAGCCAAGGGCACAGGGGGCGCAAAGAGACCCAGTACTTC	CASSQGHRGRKETQYF	TRBV3-1	TRBJ2-5
TGTGCCAGCAGCCTAGCGGGAGCCGGGGAGCTGTTTTTT	CASSLAGAGELFF	TRBV11-3	TRBJ2-2
TGTGCCAGCAAGGAGGGAGCTGCCAAAAACATTCAGTACTTC	CASKEGAAKNIQYF	TRBV5-6	TRBJ2-4
TGTGCCAGCAGCCATGGAGACAGGGGGGCGACGCCCCAGCATTTT	CASSHGDRGATPQHF	TRBV14	TRBJ1-5
TGTGCCAGCAGCCTAACAGGGGCGGACACCTTC	CASSLTGADTF	TRBV14	TRBJ1-2
TGTGCCAGTAGCCTGGGCGTTGAGCAGTTCTTC	CASSLGVEQFF	TRBV19	TRBJ2-1
TGCAGTGCATCCGGGACAGGGATGGGGGAGCCCCAGCATTTT	CSASGTGMGEPQHF	TRBV20-1	TRBJ1-5
TGTGCCAGCAGTGACGAAACCTCCAGAAGTCTTTACCTGTACTTC	CASSDETSRSLYLYF	TRBV6-1	TRBJ2-4
TGCAGTGCTAGCTATCCGGGACAGCGCAATGAGCAGTTCTTC	CSASYPGQRNEQFF	TRBV20-1	TRBJ2-1
TGTGCCAGCAGCGGAGAGGGGTATGGAAGGCAGTACTTC	CASSGEGYGRQYF	TRBV13	TRBJ2-5
TGTGCTAGTGGGGCTTTGACCCGCCCCCCCACAGATACGCAGTATTTT	CASGALTRPPTDTQYF	TRBV12-5	TRBJ2-3
TGTGCCAGCAGCTTGCGGGGCCCCGTTGGCTACACCTTC	CASSLRGPVGYTF	TRBV5-6	TRBJ1-2
TGTGCCAGCAGCGTAGCTGGTCGGGCCAGGACTGTGCAGTACTTC	CASSVAGRARTVQYF	TRBV6-5	TRBJ2-4
TGTCACAGGGGCTACGAGCAGTACTTC	CHRGYEQYF	TRBV30	TRBJ2-7
TGTGCCAGCAGCGGCCCCGGGGACAGCCGATATAATGGCTACACCTTC	CASSGPGDSRYNGYTF	TRBV13	TRBJ1-2
TGTGCCAGCGGACACCCAGTGACTTGGCCGCAGCCCCAGCATTTT	CASGHPVTWPQPQHF	TRBV11-3	TRBJ1-5
TGTGCCAGCAGCCATATTTGGACTAGCGGGTACGAGCAGTACTTC	CASSHIWTSGYEQYF	TRBV4-2	TRBJ2-7
TGCGCCAGCGGAGGGGGCCCGGAGGCACCCCTCCACTTT	CASGGGPEAPLHF	TRBV4-3	TRBJ1-6
TGTGCCAGCTCCCAGCGGGGCATCCCCGGGGAGCTGTTTTTT	CASSQRGIPGELFF	TRBV27	TRBJ2-2
TGTGCCAGCAGCTTCCGACAGCAAGAGACCCAGTACTTC	CASSFRQQETQYF	TRBV7-8	TRBJ2-5
TGTGCCAGCAGCGGGTCCCCCACAGTCCCGGTCTCACCCCTCCACTTT	CASSGSPTVPVSPLHF	TRBV7-3	TRBJ1-6
TGCGCCAGCAGCTGTAGCGAGCAGTACTTC	CASSCSEQYF	TRBV5-1	TRBJ2-7
TGCAGCGTTGCCGCTGGGTCCCTCGAGCAGTACTTC	CSVAAGSLEQYF	TRBV29-1	TRBJ2-7
TGTGCCACAGCGGACAGGGGTAGGGACACTGAAGCTTTCTTT	CATADRGRDTEAFF	TRBV19	TRBJ1-1
TGTGCCAGCAGTGCAGGGACAGGGGGCTACACCTTC	CASSAGTGGYTF	TRBV2	TRBJ1-2
TGTGCCAGCAGCTTATACAGGGCACCCGAAAAACTGTTTTTT	CASSLYRAPEKLFF	TRBV11-2	TRBJ1-4
TGTGCCAGCAGCTTACCTGAGACCCAGTACTTC	CASSLPETQYF	TRBV13	TRBJ2-5
TGTGCCAGCAGTACAGGACTAGCGGGTAGGACGAATGAGCAGTTCTTC	CASSTGLAGRTNEQFF	TRBV28	TRBJ2-1
TGTGCCAGCAGCTTACGAGGGGAGCGGGGCGCAACTAATGAAAAACTGTTTTTT	CASSLRGERGATNEKLFF	TRBV11-2	TRBJ1-4
TGTGCCAGCAGCTTAGCGCCCTTACTAGAAGATACGCAGTATTTT	CASSLAPLLEDTQYF	TRBV7-6	TRBJ2-3
TGTGCCAGCAGCCCCGCAGGGATCCAGCCCCAGCATTTT	CASSPAGIQPQHF	TRBV13	TRBJ1-5
TGTGCCAGCAGCCCGGGACTAGCAGACGAGCAGTACTTC	CASSPGLADEQYF	TRBV13	TRBJ2-7
TGTGAGGGGAAAGATAGCAATCAGCCCCAGCATTTT	CEGKDSNQPQHF	TRBV28	TRBJ1-5
TGCGCCAGCAGTGTGGATCCCGGTGGCTACGAGCAGTACTTC	CASSVDPGGYEQYF	TRBV10-1	TRBJ2-7
TGTATGGGGGGTAACTCCTATAATTCACCCCTCCACTTT	CMGGNSYNSPLHF	TRBV6-6	TRBJ1-6
TGTGCCAGCAGCACCGTAGCCCGGCTGGTATCCTACGAGCAGTACTTC	CASSTVARLVSYEQYF	TRBV6-3	TRBJ2-7
TGTGCCAGCAGCTACCCGGGGGGGTTTGAGGGCTACACCTTC	CASSYPGGFEGYTF	TRBV14	TRBJ1-2
TGTGCCAGCAGCCAAGAGTCACCGGGACAGGGGGCTATGACCGGGGAGCTGTTTTTT	CASSQESPGQGAMTGELFF	TRBV14	TRBJ2-2
TGCAGTGCTAGAGGGATTCCGTCCTACGAGCAGTACTTC	CSARGIPSYEQYF	TRBV20-1	TRBJ2-7
TGTGCCAGCAGCGGGGTCCGCGACGGACAGGGGGCTTCCTACAATGAGCAGTTCTTC	CASSGVRDGQGASYNEQFF	TRBV7-3	TRBJ2-1
TGTGCCTGGATCGGGGGGGTTGGGAGCTCCTACGAGCAGTACTTC	CAWIGGVGSSYEQYF	TRBV30	TRBJ2-7
TGTGCCGCCCCAAGGGTCTACGAGCAGTACTTC	CAAPRVYEQYF	TRBV7-8	TRBJ2-7
TGTGCCACCAGTGACCCCCCGGGACAGGGGGGATGTCCAGGATGTTCACCCCTCCACTTT	CATSDPPGQGGCPGCSPLHF	TRBV24-1	TRBJ1-6
TGCGCCAGCAGCCGCCTGCCGGGACAGAAGCGGGCCAAAAACATTCAGTACTTC	CASSRLPGQKRAKNIQYF	TRBV4-3	TRBJ2-4
TGTGCCAGAAGAAAGACGCCTTGGGGAGGAGAGCAGTACTTC	CARRKTPWGGEQYF	TRBV12-4	TRBJ2-7
TGTGCCAGCAGCCGCGGATGGCGGGGGGGCACAGATACGCAGTATTTT	CASSRGWRGGTDTQYF	TRBV14	TRBJ2-3
TGTGCCAGCAGCTTAAATAGGACAGGGGGATTCGGCCGGGAGAACACTGAAGCTTTCTTT	CASSLNRTGGFGRENTEAFF	TRBV11-3	TRBJ1-1
TGTGCCAGCAGCCGGCCCGATTCTCAGGGACAGGGGGCGTTCACTGAAGCTTTCTTT	CASSRPDSQGQGAFTEAFF	TRBV5-4	TRBJ1-1
TGTGCCATCAGCAGGACAGGGTGGCTAGATAGAAGTTCCTACAATGAGCAGTTCTTC	CAISRTGWLDRSSYNEQFF	TRBV10-3	TRBJ2-1
TGCAGTGCTAGGAAAATGGGGGAGCAAAAACCCGGACTCATAGCTCTTCGATATGAGCAGTTCTTC	CSARKMGEQKPGLIALRYEQFF	TRBV20-1	TRBJ2-1
TGCGCCAGCAGCTTGAAAACAGCGATGGATAGCAATCAGCCCCAGCATTTT	CASSLKTAMDSNQPQHF	TRBV5-1	TRBJ1-5
TGCAGTGCTTTCAAGTGGACAACATACAATGAGCAGTTCTTC	CSAFKWTTYNEQFF	TRBV20-1	TRBJ2-1
TGTGCCACCAGTGATGAAGTACCGACAGGGAGACCTGGAAACACCATATATTTT	CATSDEVPTGRPGNTIYF	TRBV24-1	TRBJ1-3
TGTGCCAGCAGCCGGACAGGAGGTTGTGAAAAACTGTTTTTT	CASSRTGGCEKLFF	TRBV5-4	TRBJ1-4
TGTGATAAGCAATTTCGGTACACCGGGGAGCTGTTTTTT	CDKQFRYTGELFF	TRBV27	TRBJ2-2
TGTGCCAGAGACAGGGACACGAACACTGAAGCTTTCTTT	CARDRDTNTEAFF	TRBV6-4	TRBJ1-1
TGTGCCAGCAGTTACCTCTTTAAGGACTACGAGCAGTACTTC	CASSYLFKDYEQYF	TRBV6-5	TRBJ2-7
TGTGCCATCCCGTCCGGCCCTCACACTGAAGCTTTCTTT	CAIPSGPHTEAFF	TRBV10-3	TRBJ1-1
TGCGCCAGCAGGGGATTGGGGCGGCGTCTCGGTGAGCAGTTCTTC	CASRGLGRRLGEQFF	TRBV10-2	TRBJ2-1
TGTGCCAGCAGTACTAGCGAGCAGTACTTC	CASSTSEQYF	TRBV6-6	TRBJ2-7
TGTGCCAGCAGCGGTAGGGGGCGAGACGGCGGAGGCTACACCTTC	CASSGRGRDGGGYTF	TRBV11-2	TRBJ1-2
TGTGCCAGCAGTGACAACCCATGGGGGTCCGACACCGGGGAGCTGTTTTTT	CASSDNPWGSDTGELFF	TRBV6-4	TRBJ2-2
TGTGCCAGCAGTGAACCGACCGAGGGGACCACTGAAGCTTTCTTT	CASSEPTEGTTEAFF	TRBV25-1	TRBJ1-1
TGCAGTGCGCGGACGATAGCCAAAAACATTCAGTACTTC	CSARTIAKNIQYF	TRBV20-1	TRBJ2-4
TGTGCCACCAGTGAACCTTTGACAGTCTGGACAGCTAACTATGGCTACACCTTC	CATSEPLTVWTANYGYTF	TRBV24-1	TRBJ1-2
TGTGCCAGCAGTCATGTGGTAACAAATGAGCAGTTCTTC	CASSHVVTNEQFF	TRBV6-6	TRBJ2-1
TGTGCCAGCAGAGGTCCGACTAGCGGGATCACAGATACGCAGTATTTT	CASRGPTSGITDTQYF	TRBV27	TRBJ2-3
TGTGAGTCAGGGAACACTGAAGCTTTCTTT	CESGNTEAFF	TRBV11-3	TRBJ1-1
TGCGCCAGCAGTCCTACCCGGGAAGATACGCAGTATTTT	CASSPTREDTQYF	TRBV10-2	TRBJ2-3
TGCGCCAGCAGTGTAGTTGACAGACACTCTGGAAACACCATATATTTT	CASSVVDRHSGNTIYF	TRBV10-1	TRBJ1-3
TGTGCCAGCAGCGGCAACCTAGCGGGGGAAGGGTGGAAGGTGGCCTACGAGCAGTACTTC	CASSGNLAGEGWKVAYEQYF	TRBV7-8	TRBJ2-7
TGTGCCAGCATCAGGGCGGTGCATGAGCAGTTCTTC	CASIRAVHEQFF	TRBV25-1	TRBJ2-1
TGTGCATGGAAACTCTTGGGGAGCTCCTACAATGAGCAGTTCTTC	CAWKLLGSSYNEQFF	TRBV6-5	TRBJ2-1
TGTGCCAGCAGCTTAGCGAACCGCTCCGGGACTTTATCCGGGGAGCTGTTTTTT	CASSLANRSGTLSGELFF	TRBV7-2	TRBJ2-2
TGTGCCAGCAGCCAAGGCAAAACGCTGCAGTTCTTC	CASSQGKTLQFF	TRBV28	TRBJ2-1
TGTGCCAGCAGTGAGTTAACAGTAAGAGTGGTGGACACTGAAGCTTTCTTT	CASSELTVRVVDTEAFF	TRBV6-1	TRBJ1-1
TGTGGTAAACGGGACAGGGTGGCCCCAACTAATGAAAAACTGTTTTTT	CGKRDRVAPTNEKLFF	TRBV24-1	TRBJ1-4
TGTGCCAGCAGTCGGGTGGTTAATTCACCCCTCCACTTT	CASSRVVNSPLHF	TRBV28	TRBJ1-6
TGTGCCACCAGTGATTCAGGGTCCTACGAGCAGTACTTC	CATSDSGSYEQYF	TRBV24-1	TRBJ2-7
TGTGCCAGCAGCGTAGAGGGGGGCTACGAGCAGTACTTC	CASSVEGGYEQYF	TRBV9	TRBJ2-7
TGTGCCAGCAGCGTAGCTAGCGGGAGAATTCAAGAGACCCAGTACTTC	CASSVASGRIQETQYF	TRBV9	TRBJ2-5
TGTGCCAGCAGTTCCCAAGGGACAGGGGGGGCAGCTTTCTTT	CASSSQGTGGAAFF	TRBV6-6	TRBJ1-1
TGTGCCAGCATGTGGACACGCTCTGGAAACACCATATATTTT	CASMWTRSGNTIYF	TRBV6-3	TRBJ1-3
TGCGCCAGCAGCCAAGAAAGGGGCTCCGGGTACGAGCAGTACTTC	CASSQERGSGYEQYF	TRBV4-3	TRBJ2-7
TGCAGTGCTAGTCCGGAGGAGCACTACGAGCAGTACTTC	CSASPEEHYEQYF	TRBV20-1	TRBJ2-7
TGTGCCAGCAGAGGGGGGTCGTGGGACAGGGATGAGGGTGCTAGCACAGATACGCAGTATTTT	CASRGGSWDRDEGASTDTQYF	TRBV7-9	TRBJ2-3
TGTGCCAGCAGCTTGGCACCTTCACGGAGTAACTACGAGCAGTACTTC	CASSLAPSRSNYEQYF	TRBV5-8	TRBJ2-7
TGTGCCCGCGGGCCGCTTTATGGCTACACCTTC	CARGPLYGYTF	TRBV27	TRBJ1-2
TGTGCCAGCACGATGCGTTGCGAGCAGTACTTC	CASTMRCEQYF	TRBV6-4	TRBJ2-7
TGTGCCTGGAGTGTACAAGGGGGGACCTACGAGCAGTACTTC	CAWSVQGGTYEQYF	TRBV30	TRBJ2-7
TGTGCCAGCAGCTTACCAGTCCGACTAGGGGGCAGCCGGCATGAGCAGTTCTTC	CASSLPVRLGGSRHEQFF	TRBV7-2	TRBJ2-1
TGTGCCCGGTTTCCGGACTGGGGGGGCGGACTCGGGGGTTGCAACAATGAGCAGTTCTTC	CARFPDWGGGLGGCNNEQFF	TRBV10-3	TRBJ2-1
TGCAGTGCTCGGGACGAGGCGCCGCCCCAGCATTTT	CSARDEAPPQHF	TRBV20-1	TRBJ1-5
TGTGCCCGTACACACAATGAGCAGTTCTTC	CARTHNEQFF	TRBV6-2	TRBJ2-1
TGCGCCAGCAGCTTGGCATCGCGGGAGTACGAGCAGTACTTC	CASSLASREYEQYF	TRBV5-1	TRBJ2-7
TGTGCCAGCAGTGCCCCCGTCCTACCGGACAGGGCTATAGTCGACAATGAGCAGTTCTTC	CASSAPVLPDRAIVDNEQFF	TRBV25-1	TRBJ2-1
TGTGCCAGCAGTCCGTATTGGGGCTCCTACGAGCAGTACTTC	CASSPYWGSYEQYF	TRBV6-4	TRBJ2-7
TGTGCCAGCATTCCCGGGGGACGGAGGCTTGTCTCTGGGGCCAACGTCCTGACTTTC	CASIPGGRRLVSGANVLTF	TRBV6-5	TRBJ2-6
TGCGCCAGCAGCTTCGGCGGGACAAACCCCTACGAGCAGTACTTC	CASSFGGTNPYEQYF	TRBV5-1	TRBJ2-7
TGTGCCAGCAGCCCAGGGTTCACAGATACGCAGTATTTT	CASSPGFTDTQYF	TRBV3-1	TRBJ2-3
TGTGCCCCGACAGTGGAGCGCCTCCACTTT	CAPTVERLHF	TRBV27	TRBJ1-6
TGTGCCAGCAGCTCGGGTCCGGGACTAGCGGGAGCGAGCACCGGGGAGCTGTTTTTT	CASSSGPGLAGASTGELFF	TRBV5-5	TRBJ2-2
TGTGCCAGCAGTTATCACGGGGGCGGCTATGGCTACACCTTC	CASSYHGGGYGYTF	TRBV27	TRBJ1-2
TGTGCCAGCAGTTACACGGGGGCGTTATACGAGCAGTACTTC	CASSYTGALYEQYF	TRBV6-5	TRBJ2-7
TGTGCCACCAGTGATTTGACTGGAGGACAGGGGGCACGGACCTACGAGCAGTACTTC	CATSDLTGGQGARTYEQYF	TRBV24-1	TRBJ2-7
TGTGCCAGCAGTTTAGGGTCTAGCGGGTCAAATAATGAGCAGTTCTTC	CASSLGSSGSNNEQFF	TRBV27	TRBJ2-1
TGTGCCAGCAGCTTTGGGGACAGCGAGCAGTACTTC	CASSFGDSEQYF	TRBV11-1	TRBJ2-7
TGCGCCAGCCGTTACTTTAGTTCCGGGGAGCTGTTTTTT	CASRYFSSGELFF	TRBV5-1	TRBJ2-2
TGCGCCAGTAGATTAGGGACAGTGGCGGCAGCCAAAAACATTCAGTACTTC	CASRLGTVAAAKNIQYF	TRBV4-1	TRBJ2-4
TGTGCCAGCAGCACGGGACCGAACACTGAAGCTTTCTTT	CASSTGPNTEAFF	TRBV13	TRBJ1-1
TGCAGTGCTAGAGATCAGTTCCGGACAGCCAACTCCTACGAGCAGTACTTC	CSARDQFRTANSYEQYF	TRBV20-1	TRBJ2-7
TGTGCCAACCCGGGGACTAGCGGGACAGAGAACTACAATGAGCAGTTCTTC	CANPGTSGTENYNEQFF	TRBV10-3	TRBJ2-1
TGTGCCAGCAGTTTACGTCGGTCTAGCGGGATTTTAATCTTC	CASSLRRSSGILIF	TRBV12-4	TRBJ2-1
TGTGCCAGCAGCTTAGGGAATAGGACGGAGAACACCGGGGAGCTGTTTTTT	CASSLGNRTENTGELFF	TRBV13	TRBJ2-2
TGCAGTGCTAGTTATGGGACTAGCGGGGGCCAGAGGCAGCAGTACTTC	CSASYGTSGGQRQQYF	TRBV20-1	TRBJ2-7
TGTGCCAGCAGCGAGCAATGCTTAGGGGGGAATAATTCACCCCTCCACTTT	CASSEQCLGGNNSPLHF	TRBV7-4	TRBJ1-6
TGTGCCAGCAGGGACAGGGGCCTCTACGAGCAGTACTTC	CASRDRGLYEQYF	TRBV11-2	TRBJ2-7
TGTGCCAGCAGCCAAGATGACTTAGGTCCTGGAAACACCATATATTTT	CASSQDDLGPGNTIYF	TRBV14	TRBJ1-3
TGTGCCAGCAGTGAAGCCTCCCGGGGAAAGCTAACTGAAGCTTTCTTT	CASSEASRGKLTEAFF	TRBV2	TRBJ1-1
TGCGCCAGCAGCTTTAGGGACAGACCCTACGAGCAGTACTTC	CASSFRDRPYEQYF	TRBV5-1	TRBJ2-7
TGCACGGAGGCCGGGACGATGGAGACCCAGTACTTC	CTEAGTMETQYF	TRBV20-1	TRBJ2-5
TGCAGTGCTAGAGGCCGGGACAGGGCCGGAGAGACCCAGTACTTC	CSARGRDRAGETQYF	TRBV20-1	TRBJ2-5
TGTGCCAGCAGTGAAGCGAATCCGAAATCGGGGCCCGGGGGGAACACTGAAGCTTTCTTT	CASSEANPKSGPGGNTEAFF	TRBV6-1	TRBJ1-1
TGTGCCAGCACTCTAGCGACTCGGGGGCTGAGAGTCTACGAGCAGTACTTC	CASTLATRGLRVYEQYF	TRBV7-6	TRBJ2-7
TGCGCCAGCAGCTTGGAGTTACGACTACGGGGATCCTACGAGCAGTACTTC	CASSLELRLRGSYEQYF	TRBV5-1	TRBJ2-7
TGTGCCAGCAACCAGGACAGGGTCTACGAGCAGTACTTC	CASNQDRVYEQYF	TRBV11-2	TRBJ2-7
TGTGCCAGCAGCATCCTAGTTCGACGAGGCGTCTTC	CASSILVRRGVF	TRBV7-9	TRBJ2-1
TGTGCCAGCAGCCCGTGCTTCAGGGGGGGGGCTAGGGAGCAGTTCTTC	CASSPCFRGGAREQFF	TRBV11-2	TRBJ2-1
TGTGCCTGGAGTGTTGCTAGTCGGGAGGCAGCTGAAGCTTTCTTT	CAWSVASREAAEAFF	TRBV30	TRBJ1-1
TGTGCCAGCAGGAACAGGGCGCCCAATGAGCAGTTCTTC	CASRNRAPNEQFF	TRBV6-1	TRBJ2-1
TGTGCCAAGGTTACGTGGGCCGGGAACGAGCAGTACTTC	CAKVTWAGNEQYF	TRBV6-3	TRBJ2-7
TGCGCCAGCAGCTTGGATTCGGGCCCACCTACTAACTATGGCTACACCTTC	CASSLDSGPPTNYGYTF	TRBV5-1	TRBJ1-2
TGTGCCAGCAGCCGTCAGTCACCTAGGGGGCCGCACTACGAGCAGTACTTC	CASSRQSPRGPHYEQYF	TRBV5-4	TRBJ2-7
TGTGCCACCAGTGCCTACAGGGTTGTCTCGGCCTCTGGAAACACCATATATTTT	CATSAYRVVSASGNTIYF	TRBV24-1	TRBJ1-3
TGTGCCAGCAGCTGGGGGATCACAATCTACGAGCAGTACTTC	CASSWGITIYEQYF	TRBV5-6	TRBJ2-7
TGTGCCAGCAGGGAAGTCAGGGGGCGAGGTGAAAAACTGTTTTTT	CASREVRGRGEKLFF	TRBV7-6	TRBJ1-4
TGTGCCAGCAGCGGGAGGGTGGATTCACCCCTCCACTTT	CASSGRVDSPLHF	TRBV5-4	TRBJ1-6
TGTGCCAGCAGTGTGATGGACACCGGGGAGCTGTTTTTT	CASSVMDTGELFF	TRBV6-2	TRBJ2-2
TGTGCCAGCTCACCTTACAGGGGCACCTACAATGAGCAGTTCTTC	CASSPYRGTYNEQFF	TRBV18	TRBJ2-1
TGTGCCAGCTCACTTCCTAGACCCGACTCCTACGAGCAGTACTTC	CASSLPRPDSYEQYF	TRBV18	TRBJ2-7
TGTGCCAGCAGTGAACGTGGCAGCGGGAGCGCGGGGGCCTACGAGCAGTACTTC	CASSERGSGSAGAYEQYF	TRBV6-4	TRBJ2-7
TGTGCCAGCACGACCGGGACAGGCTCTGGGGCCAACGTCCTGACTTTC	CASTTGTGSGANVLTF	TRBV6-1	TRBJ2-6
TGCAGTGCTAGAGATCTCGTAATTTCAGGGGGGCAGCCCCAGCATTTT	CSARDLVISGGQPQHF	TRBV20-1	TRBJ1-5
TGTGCCAGCAGTGGGGGACAGGGAGGTGAAAGGGAGACCCAGTACTTC	CASSGGQGGERETQYF	TRBV6-3	TRBJ2-5
TGTGCTAGCAGCGCAGGGGGGCCCGCTGAAGCTTTCTTT	CASSAGGPAEAFF	TRBV7-7	TRBJ1-1
TGTGCCAGCAGCCAAACAGGGTATGAGTGGAGAGGCTACACCTTC	CASSQTGYEWRGYTF	TRBV7-3	TRBJ1-2
TGCGCCAGCAGAGAGTTAGGGGCCAAAAACATTCAGTACTTC	CASRELGAKNIQYF	TRBV5-1	TRBJ2-4
TGTGCCAGCAGCTTAGGGCGTGGGGACGGCTACACCTTC	CASSLGRGDGYTF	TRBV11-2	TRBJ1-2
TGCGCCAGCAGCTTGGCTAGCAGAGCCAAAAACATTCAGTACTTC	CASSLASRAKNIQYF	TRBV5-1	TRBJ2-4
TGTGCCAGGTCGACAGGGGAGCAGTACTTC	CARSTGEQYF	TRBV27	TRBJ2-7
TGTGCCAGCAGCTTCAGGGTGAACACTGAAGCTTTCTTT	CASSFRVNTEAFF	TRBV7-8	TRBJ1-1
TGTGCCAGCAGCTTACAGGGGGGAGCCACAGAGACCCAGTACTTC	CASSLQGGATETQYF	TRBV7-4	TRBJ2-5
TGTGCCAGCAGGGGGGCCCCAGTCAATGAGCAGTTCTTC	CASRGAPVNEQFF	TRBV9	TRBJ2-1
TGTGCCAGTTGGGAAGCGGGACTGAGTCAAGAGACCCAGTACTTC	CASWEAGLSQETQYF	TRBV19	TRBJ2-5
TGTGCCAGCAGCACGAGTTACTACGAGCAGTACTTC	CASSTSYYEQYF	TRBV5-6	TRBJ2-7
TGCGCCAGCAGCCAGGACATTTCCGGGACACAAAATCCGGGGGATTCTGGAAACACCATATATTTT	CASSQDISGTQNPGDSGNTIYF	TRBV4-1	TRBJ1-3
TGTGCCAGCAGCCCACTGCACACTGAAGCTTTCTTT	CASSPLHTEAFF	TRBV5-4	TRBJ1-1
TGCGCCAGCAACAAAGCCCTAAAAGGACAGCAGAGAAGAGAGACCCAGTACTTC	CASNKALKGQQRRETQYF	TRBV5-1	TRBJ2-5
TGTGCCAGCAGCTTACTAAGGCACTACGAGCAGTACTTC	CASSLLRHYEQYF	TRBV11-3	TRBJ2-7
TGTGCCAGCAGTTACGGGGGGGGCATGAATGAGCAGTTCTTC	CASSYGGGMNEQFF	TRBV6-2	TRBJ2-1
TGCAGTGCTATCCGTACACAGGGCCACACTGAAGCTTTCTTT	CSAIRTQGHTEAFF	TRBV20-1	TRBJ1-1
TGTGCCAGCAGCCGGTGGGGCGAGCAGTACTTC	CASSRWGEQYF	TRBV9	TRBJ2-7
TGTGCCAGCAGCGTGTGGGGGGGCGGTGCCAAAAACATTCAGTACTTC	CASSVWGGGAKNIQYF	TRBV13	TRBJ2-4
TGTGCCAGCAGTTTCCGATACCCGGGACAGGAGATGCCCACTGAAGCTTTCTTT	CASSFRYPGQEMPTEAFF	TRBV28	TRBJ1-1
TGCAGTGCTGGGACGTCAGGGGGCATACCGAACACCGGGGAGCTGTTTTTT	CSAGTSGGIPNTGELFF	TRBV20-1	TRBJ2-2
TGTGCTAGCAGCTTACGACAGGGGCCGGCTTTCTTT	CASSLRQGPAFF	TRBV7-7	TRBJ1-1
TGCAGTGCTCTTAGGACAGGAGACTACGAGCAGTACTTC	CSALRTGDYEQYF	TRBV20-1	TRBJ2-7
TGCAGTGCTAGAGATACGGGCCGGGACAGCGTTCAGCCCCAGCATTTT	CSARDTGRDSVQPQHF	TRBV20-1	TRBJ1-5
TGTGCCAGCCACCCGCAGGATCAGCCCCAGCATTTT	CASHPQDQPQHF	TRBV7-9	TRBJ1-5
TGCGCCAGCAGCCCACCGATAGGGATGAGGCTGTCTGGGGCCAACGTCCTGACTTTC	CASSPPIGMRLSGANVLTF	TRBV5-1	TRBJ2-6
TGTGCCAGCAGTCCAGGTCCGCGGACCCAACCAAGTGAAAAACTGTTTTTT	CASSPGPRTQPSEKLFF	TRBV6-5	TRBJ1-4
TGTGCTAGTGGTTTGTATTCTAAACTGAACACTGAAGCTTTCTTT	CASGLYSKLNTEAFF	TRBV12-5	TRBJ1-1
TGTGCCAGCACCCGGGGGCACGCCTACGAGCAGTACTTC	CASTRGHAYEQYF	TRBV6-8	TRBJ2-7
TGTGCCAGCAGTTACCTAGCGGGACGGAGCTCCTACAATGAGCAGTTCTTC	CASSYLAGRSSYNEQFF	TRBV6-6	TRBJ2-1
TGTGCCAGCAGTTACCAGAGCCTCTGCTCCTACGAGCAGTACTTC	CASSYQSLCSYEQYF	TRBV6-9	TRBJ2-7
TGTGCCAGTAGCCTAGGGATCTACTCCTACAATGAGCAGTTCTTC	CASSLGIYSYNEQFF	TRBV19	TRBJ2-1
TGTGCCAGCAGCTTTTTGCCGGACACGACCGGGACAGAATACGAGCAGTACTTC	CASSFLPDTTGTEYEQYF	TRBV7-9	TRBJ2-7
TGCGCCAGCCTCCCCCTGCCAGGGCCGGCAACTAATGAAAAACTGTTTTTT	CASLPLPGPATNEKLFF	TRBV10-1	TRBJ1-4
TGCAGTGCTAGAACTTGGACTAGCGGGGACAATGAGCAGTTCTTC	CSARTWTSGDNEQFF	TRBV20-1	TRBJ2-1
TGTGCCAGCAGGGTAAGGGAACCAGATACGCAGTATTTT	CASRVREPDTQYF	TRBV25-1	TRBJ2-3
TGTGCCTCCGTGGGGGCGAACACCGGGGAGCTGTTTTTT	CASVGANTGELFF	TRBV30	TRBJ2-2
TGCGCCAGCAGCTTCGATATAGGTTCAGATACGCAGTATTTT	CASSFDIGSDTQYF	TRBV5-1	TRBJ2-3
TGTGCCAGCAGCTGCCGGTCACAGGGGGGGGATGGCTACACCTTC	CASSCRSQGGDGYTF	TRBV5-8	TRBJ1-2
TGTGCCAGCAGCCAGGGACTAAGGGATTTACAAGAGACCCAGTACTTC	CASSQGLRDLQETQYF	TRBV7-4	TRBJ2-5
TGTGCCAGCAGCTGGTCACAGGGGAGGAGCTACGAGCAGTACTTC	CASSWSQGRSYEQYF	TRBV7-4	TRBJ2-7
TGTGCCAGCAGCTGCGGCCTTCCGCTCGACAGGAGGGGGAATCAGCCCCAGCATTTT	CASSCGLPLDRRGNQPQHF	TRBV5-6	TRBJ1-5
TGTGCTAGTCCGCCAGATTCCAATCAGCCCCAGCATTTT	CASPPDSNQPQHF	TRBV12-5	TRBJ1-5
TGTGCCTGGAGTGTACGGGTGGACAGGGACGGAGAGACCCAGTACTTC	CAWSVRVDRDGETQYF	TRBV30	TRBJ2-5
TGTGCCAGCAGCTTCGAAACTAGCAATCAGCCCCAGCATTTT	CASSFETSNQPQHF	TRBV11-2	TRBJ1-5
TGTGCCAGCAGCGAAGGCCGCGGGGAGCTGTTTTTT	CASSEGRGELFF	TRBV7-7	TRBJ2-2
TGTGCCGCGCAAGAGGTCAGGGGGCTGCCCCAGCATTTT	CAAQEVRGLPQHF	TRBV6-1	TRBJ1-5
TGTGCCAGCAGGCCCATGAGTACCACAATGCCTGCCAAAAACATTCAGTACTTC	CASRPMSTTMPAKNIQYF	TRBV6-4	TRBJ2-4
TGTGCCAGCTCACCATCTACCTATAGCAATCAGCCCCAGCATTTT	CASSPSTYSNQPQHF	TRBV18	TRBJ1-5
TGCAGTGCCGCCCAGGGTGCCGGGGCCTACGAGCAGTACTTC	CSAAQGAGAYEQYF	TRBV20-1	TRBJ2-7
TGCAGTGCGGGGGTCGACAGGTCAGCTTTCTTT	CSAGVDRSAFF	TRBV20-1	TRBJ1-1
TGTGCCAGCAGTTACTCGCTGGGGCCTTTACAAGAGACCCAGTACTTC	CASSYSLGPLQETQYF	TRBV6-5	TRBJ2-5
TGTGCCAGCAGCTTGCGCGGCGGGGACACTGAAGCTTTCTTT	CASSLRGGDTEAFF	TRBV5-5	TRBJ1-1
TGTGCCAGCAGCATGGATGGCAGTAAAGTACACACTGAAGCTTTCTTT	CASSMDGSKVHTEAFF	TRBV9	TRBJ1-1
TGTGCCAGCAGCCGTAGAGGGGCAGAGACCCAGTACTTC	CASSRRGAETQYF	TRBV13	TRBJ2-5
TGTGCCAGCAGGTCGGGACTAGCGGGACGGAGAGATACGCAGTATTTT	CASRSGLAGRRDTQYF	TRBV28	TRBJ2-3
TGTGCCAGCAGCTCCAAGGAAGGGACAGGCGGGTACTCCTACGAGCAGTACTTC	CASSSKEGTGGYSYEQYF	TRBV7-2	TRBJ2-7
TGTATTCCCCGACTAGCGGGAGTGGCTGAAGCTTTCTTT	CIPRLAGVAEAFF	TRBV19	TRBJ1-1
TGTGCCTGGAGTCGCCCCCGGAGTGAACAAGAGACCCAGTACTTC	CAWSRPRSEQETQYF	TRBV30	TRBJ2-5
TGTGCCAGCAGCGGCCCGGGACTAGCGGGAGGTAGGGCTAGCACAGATACGCAGTATTTT	CASSGPGLAGGRASTDTQYF	TRBV3-1	TRBJ2-3
TGTGCCAGCAGTTGGCTCGGGGTAGGGCCTTTGAACACTGAAGCTTTCTTT	CASSWLGVGPLNTEAFF	TRBV6-3	TRBJ1-1
TGTGCCACCAGCACACAGGGGATTGGTCAGCCCCAGCATTTT	CATSTQGIGQPQHF	TRBV15	TRBJ1-5
TGTGCCAGCAGTCCAGAACACGCCGGGACGGTTGGAAGGAACACTGAAGCTTTCTTT	CASSPEHAGTVGRNTEAFF	TRBV6-2	TRBJ1-1
TGCGCCAGCAGGGAGGCGGGTCCCTACGAGCAGTACTTC	CASREAGPYEQYF	TRBV10-1	TRBJ2-7
TGCGCCAGCAGCAATAAGGGGGTAGTCTATGGCTACACCTTC	CASSNKGVVYGYTF	TRBV5-1	TRBJ1-2
TGTGCCAGCAGCTTGGAACCAGGAGAGGACCGTGCCTCCTACGAGCAGTACTTC	CASSLEPGEDRASYEQYF	TRBV5-6	TRBJ2-7
TGTGCCAGCAGCTTAATCCGGACAAGCTGCACAGATACGCAGTATTTT	CASSLIRTSCTDTQYF	TRBV5-5	TRBJ2-3
TGTGCCACCAGTGAATCCGACACGTGCCCCTACGAGCAGTACTTC	CATSESDTCPYEQYF	TRBV24-1	TRBJ2-7
TGTGCCAGCAGCACCGGGACTAACTACGGCGCCCAGTACTTC	CASSTGTNYGAQYF	TRBV6-4	TRBJ2-5
TGCGCCAGCAGTGAGTCTCTCCGGAGGGGGTTATACAATGAGCAGTTCTTC	CASSESLRRGLYNEQFF	TRBV10-1	TRBJ2-1
TGTGCCACCAGTGACGGGAAAACCGGGACAGGGGAAAAACTGTTTTTT	CATSDGKTGTGEKLFF	TRBV24-1	TRBJ1-4
TGTGCCAGCAATGGGGGCGCGAGGTACGAGCAGTACTTC	CASNGGARYEQYF	TRBV25-1	TRBJ2-7
TGCGCCAGCAGCTGGCGTTGCCCAGATACGCAGTATTTT	CASSWRCPDTQYF	TRBV5-1	TRBJ2-3
TGTGCCAGTAGTATAGATAATTGGGCAAGTGGACAGGCACACAATCAGCCCCAGCATTTT	CASSIDNWASGQAHNQPQHF	TRBV19	TRBJ1-5
TGCAGTGCTGCACGACCATGTATGGGCTGGGCCTCCTACGAGCAGTACTTC	CSAARPCMGWASYEQYF	TRBV20-1	TRBJ2-7
TGTGCCAGCAGCCAAGTCATTAGCGGGGGGGCAGATACGCAGTATTTT	CASSQVISGGADTQYF	TRBV3-1	TRBJ2-3
TGTGCCTACACGGGGCCGGGAGAGACCCAGTACTTC	CAYTGPGETQYF	TRBV19	TRBJ2-5
TGTGCCACCAGCAGAGATAACAAGAGCTGTTGGGACGCAAGAAATATTAACTATGGCTACACCTTC	CATSRDNKSCWDARNINYGYTF	TRBV15	TRBJ1-2
TGTGCCATCAGTGAGACAGCGGGGGAAAAACTGTTTTTT	CAISETAGEKLFF	TRBV10-3	TRBJ1-4
TGTGCCAGCAGCTTTTCCAGACTAGAGATCGCAGATACGCAGTATTTT	CASSFSRLEIADTQYF	TRBV5-5	TRBJ2-3
TGTGCCAGCAGCGGACAGGGGCCTGAAGCTTTCTTT	CASSGQGPEAFF	TRBV5-6	TRBJ1-1
TGTGCCATATTTTTCCTTGACGATACGCAGTATTTT	CAIFFLDDTQYF	TRBV10-3	TRBJ2-3
TGCGCCAGCAGTGACAGCCGGGACAGGGGGATGGTGAGGGCGACTAATGAAAAACTGTTTTTT	CASSDSRDRGMVRATNEKLFF	TRBV10-1	TRBJ1-4
TGTGCTAGTGGTTACAGGCGGCTAGTTCCGACGGACAGATCGTACAATGAGCAGTTCTTC	CASGYRRLVPTDRSYNEQFF	TRBV12-5	TRBJ2-1
TGTGCCTGGAGTGAAACAGGGATAAACCATGAAAAACTGTTTTTT	CAWSETGINHEKLFF	TRBV30	TRBJ1-4
TGTGCCAGCAGCCAGAAGAAACGGGGAGCCAAAAACATTCAGTACTTC	CASSQKKRGAKNIQYF	TRBV3-1	TRBJ2-4
TGTGCCAGCAGTCCGTCTAGCACAGATACGCAGTATTTT	CASSPSSTDTQYF	TRBV6-2	TRBJ2-3
TGTGCCAGTAGTCTATTGACTAGAGACGTGGTCAATAGCAATCAGCCCCAGCATTTT	CASSLLTRDVVNSNQPQHF	TRBV19	TRBJ1-5
TGCGCCAGCAGTCTGGACAGGCGCAATTCACCCCTCCACTTT	CASSLDRRNSPLHF	TRBV10-1	TRBJ1-6
TGTGCCAGTAGTATAGCTAAATCTAGGAACAATGAGCAGTTCTTC	CASSIAKSRNNEQFF	TRBV19	TRBJ2-1
TGTGCCAGCAGCGTAGGTCTCACGGGACTCGCAGTCTTTAGCTCCTACAATGAGCAGTTCTTC	CASSVGLTGLAVFSSYNEQFF	TRBV9	TRBJ2-1
TGTGCCCAGGGGGGCTCTGGAAACACCATATATTTT	CAQGGSGNTIYF	TRBV11-2	TRBJ1-3
TGTGCCACCAGTGATTTGGGGGGACAGGGGAATAATTCACCCCTCCACTTT	CATSDLGGQGNNSPLHF	TRBV24-1	TRBJ1-6
TGTGCCAGCAGTGGCCGGAGCCACCGGGACAGGGCCGCGAATGGCTACACCTTC	CASSGRSHRDRAANGYTF	TRBV6-1	TRBJ1-2
TGTGCCAGCAACAGGCGGATTTCCTACGAGCAGTACTTC	CASNRRISYEQYF	TRBV6-4	TRBJ2-7
TGTGCCAGTATCGCAAACCGGGACAGGGAAACTAGGTACCAAGAGACCCAGTACTTC	CASIANRDRETRYQETQYF	TRBV19	TRBJ2-5
TGTGCCAGCTCTGGGCAGGTGGAAAAGACTGACCCAAATGAGCAGTTCTTC	CASSGQVEKTDPNEQFF	TRBV6-5	TRBJ2-1
TGTGCCAGCAGCTCGGGTAGGGGACAGGAGCTCAGTAGAGTCGCCTACGAGCAGTACTTC	CASSSGRGQELSRVAYEQYF	TRBV7-8	TRBJ2-7
TGTGCCAGCAGGAGGGGGGGCATCAACACCGGGGAGCTGTTTTTT	CASRRGGINTGELFF	TRBV27	TRBJ2-2
TGTGCCAGCAGCTTGGAGAAATGCTACAATGAGCAGTTCTTC	CASSLEKCYNEQFF	TRBV5-6	TRBJ2-1
TGTGCCAGCAGGTTGTCAAGACAGTGGCTGCCTGAAAAACTGTTTTTT	CASRLSRQWLPEKLFF	TRBV6-5	TRBJ1-4
TGTGCCACCAGTAACCAGGGGTATAAGACCGGGGAGCTGTTTTTT	CATSNQGYKTGELFF	TRBV24-1	TRBJ2-2
TGTGCCAGCAGCACGGAAGACAGGCTAAGGTACGAGCAGTACTTC	CASSTEDRLRYEQYF	TRBV7-3	TRBJ2-7
TGCAGTGCTAGGGGGACATGGGGGGATGAGCAGTTCTTC	CSARGTWGDEQFF	TRBV20-1	TRBJ2-1
TGCGCCAGCAGCTCTCGGACAGGGAATCAGCCCCAGCATTTT	CASSSRTGNQPQHF	TRBV5-1	TRBJ1-5
TGTGCCAGCAGTGACGGGGATGGGGGAGGGGATGAGCAGTTCTTC	CASSDGDGGGDEQFF	TRBV6-4	TRBJ2-1
TGTGCCAGCAGCAGGATTGGACAGGGCAACGGTACCGGGGAGCTGTTTTTT	CASSRIGQGNGTGELFF	TRBV7-2	TRBJ2-2
TGTGCCAGCAGCCGACGGCTAACTAGGGGAGTAAGAACCAAAAACATTCAGTACTTC	CASSRRLTRGVRTKNIQYF	TRBV3-1	TRBJ2-4
TGTGCCAGCAGCACAAGTACCAGGAGGACCTACGAGCAGTACTTC	CASSTSTRRTYEQYF	TRBV14	TRBJ2-7
TGTGCCAGCCAGATGACAGGGGGGAATGAGCAGTTCTTC	CASQMTGGNEQFF	TRBV27	TRBJ2-1
TGTGCCAGCAGCTTACTCCACCGGGGCCCGAGGAAGGATACGCAGTATTTT	CASSLLHRGPRKDTQYF	TRBV7-7	TRBJ2-3
TGTGCTAGTGGCCGGACAGTAAAGGGGTCTAACTATGGCTACACCTTC	CASGRTVKGSNYGYTF	TRBV12-5	TRBJ1-2
TGCGCCAGCAGCTCCGGGGGGTGGGGTCAATACTATGGCTACACCTTC	CASSSGGWGQYYGYTF	TRBV5-1	TRBJ1-2
TGCAGCGTTGCTTGGGACAGTCCGTACTCCTCCTACGAGCAGTACTTC	CSVAWDSPYSSYEQYF	TRBV29-1	TRBJ2-7
TGCGCCAGCATATCGCCAATTGGGGGGGAACCCATCAATGAGCAGTTCTTC	CASISPIGGEPINEQFF	TRBV10-2	TRBJ2-1
TGTGCCAGCAGCCACGGGATTCAGAATCCCACAGATACGCAGTATTTT	CASSHGIQNPTDTQYF	TRBV13	TRBJ2-3
TGTGCCAGCAGCCAAGCCCCCGCCGGGACTAGCGGGGGGGCGGGTGTAACCAAGGGCACAGATACGCAGTATTTT	CASSQAPAGTSGGAGVTKGTDTQYF	TRBV3-1	TRBJ2-3
TGTGCCAGCAGCTTCCGCGAGTCCGCTGGAAACACCATATATTTT	CASSFRESAGNTIYF	TRBV11-3	TRBJ1-3
TGCGCCAGCAGCCAAGATGCAGACTTTGGTGGCTACACCTTC	CASSQDADFGGYTF	TRBV4-1	TRBJ1-2
TGCAGTGCTAGAGATGGAGCAGTCAGGGGGCGGGGTGGAACTACGTCCTATAATTCACCCCTCCACTTT	CSARDGAVRGRGGTTSYNSPLHF	TRBV20-1	TRBJ1-6
TGTGCCAGCAGCTTAGTTTCAGCGGAAGAAAGCTCCTACAATGAGCAGTTCTTC	CASSLVSAEESSYNEQFF	TRBV7-8	TRBJ2-1
TGTGCCACCGGACAGGGGAGCGCAGCTTTCTTT	CATGQGSAAFF	TRBV24-1	TRBJ1-1
TGCGCCAGCAGCTTGGACTCCGCAGGGGGCGAGACTAACATTCAGTACTTC	CASSLDSAGGETNIQYF	TRBV5-1	TRBJ2-4
TGTGCCACCAGTGTCGACATCCCCTGGACGTTCATTCAGTACTTC	CATSVDIPWTFIQYF	TRBV24-1	TRBJ2-4
TGTGCCAGCTCACCGGGAGGGCAAGAGACCCAGTACTTC	CASSPGGQETQYF	TRBV18	TRBJ2-5
TGTGCCAGCAGTTTACACCCGCCGGGACAGGGCGATCAGCCCCAGCATTTT	CASSLHPPGQGDQPQHF	TRBV28	TRBJ1-5
TGTGCCAGCAGCTCTGTAAACCCAGGACTAGTTGTTGAGCAGTTCTTC	CASSSVNPGLVVEQFF	TRBV11-3	TRBJ2-1
TGTGCCAGCAGCTTGCATTTTCTAGCGGTAGAGAGGAGGAACGAGCAGTACTTC	CASSLHFLAVERRNEQYF	TRBV5-4	TRBJ2-7
TGTGCCAGCAAACAAAGGGACAGGTACGAGCAGTACTTC	CASKQRDRYEQYF	TRBV6-4	TRBJ2-7
TGTGCCAGCAGCTTAGATCTTGTCTCTAGCGGGGGGGCCGTCCCCTACGAGCAGTACTTC	CASSLDLVSSGGAVPYEQYF	TRBV11-2	TRBJ2-7
TGTGCCAGCTCACCACGGAAACCCCCCGGGGAGCTGTTTTTT	CASSPRKPPGELFF	TRBV18	TRBJ2-2
TGTGCCAGCAGTTACTCGAGTCCCCTTACAGTCTATGGCTACACCTTC	CASSYSSPLTVYGYTF	TRBV6-2	TRBJ1-2
TGTGCCAGCAGCTCGTTTCTCAGGGACCCTCCTGGGGACACTGAAGCTTTCTTT	CASSSFLRDPPGDTEAFF	TRBV7-9	TRBJ1-1
TGTGCCAGCAGGGGCCATACTGAAGCTTTCTTT	CASRGHTEAFF	TRBV6-6	TRBJ1-1
TGTGCCAGCAGCTTACATTGCCGACGGGAGTACAACGAGCAGTACTTC	CASSLHCRREYNEQYF	TRBV7-4	TRBJ2-7
TGTGCCAGCAGCGCATATCTAGCGAGACGATACAATGAGCAGTTCTTC	CASSAYLARRYNEQFF	TRBV7-2	TRBJ2-1
TGTGCCAGCAGCTTGACCACGGGGAGGGGTAAAGATGAGCAGTTCTTC	CASSLTTGRGKDEQFF	TRBV5-6	TRBJ2-1
TGTGCCAGCAGCCAAGGGCTGGGGTGGAGCACAGATACGCAGTATTTT	CASSQGLGWSTDTQYF	TRBV4-2	TRBJ2-3
TGTGCCAGCAGCCAACAATCAGACAGGCACCACGCCTACGAGCAGTACTTC	CASSQQSDRHHAYEQYF	TRBV3-1	TRBJ2-7
TGCGCCAGCAGTGAGGAGGGGCCGATTACGGTGAACACTGAAGCTTTCTTT	CASSEEGPITVNTEAFF	TRBV10-1	TRBJ1-1
TGTGCCAGCAGTTACTCGAAACCACCAGGGACAGGGGACCCCTACGAGCAGTACTTC	CASSYSKPPGTGDPYEQYF	TRBV6-5	TRBJ2-7
TGTGCCAGCAAGAAAGGGCGTAGGGGGGGACTAGCGGGCATTACTCAAGAGACCCAGTACTTC	CASKKGRRGGLAGITQETQYF	TRBV7-3	TRBJ2-5
TGTGCCAGCGGGGCCAATCAGCCCCAGCATTTT	CASGANQPQHF	TRBV12-3	TRBJ1-5
TGTGCCAGCAGCGACGGGGATGGTAGCAATCAGCCCCAGCATTTT	CASSDGDGSNQPQHF	TRBV13	TRBJ1-5
TGTGCCAGCAGTCTAGGACAGGGGCGGGCCTACGAGCAGTACTTC	CASSLGQGRAYEQYF	TRBV2	TRBJ2-7
TGTGCCACCAGTGATTTCCCGGGACAGGGGTGGAGCAATCAGCCCCAGCATTTT	CATSDFPGQGWSNQPQHF	TRBV24-1	TRBJ1-5
TGCAGCTCTTCAGGGGAGGGGGGTAACTATGGCTACACCTTC	CSSSGEGGNYGYTF	TRBV29-1	TRBJ1-2
TGCAGTGCGGGGGGGTTGTTCGAGCAGTACTTC	CSAGGLFEQYF	TRBV20-1	TRBJ2-7
TGTGCCAGCAGCCAGGGGGCAGGGACTTACACCGGGGAGCTGTTTTTT	CASSQGAGTYTGELFF	TRBV3-1	TRBJ2-2
TGTGCCAGCAGGACAGGGGCACACATTCAGTACTTC	CASRTGAHIQYF	TRBV6-5	TRBJ2-4
TGTGCCAGCAGTTTATGTTTTCAGGTGACTCAGCCCCAGCATTTT	CASSLCFQVTQPQHF	TRBV27	TRBJ1-5
TGCAGTGCTGAGGGCAAATACGATACGCAGTATTTT	CSAEGKYDTQYF	TRBV20-1	TRBJ2-3
TGTGCCACCAGCAGAGAGAGGGACACTGAAGCTTTCTTT	CATSRERDTEAFF	TRBV15	TRBJ1-1
TGCAGTGCGGGTCCAGGGACAAAACGCTCACCCCTCCACTTT	CSAGPGTKRSPLHF	TRBV20-1	TRBJ1-6
TGTGCCAGCAGTGCCGACAGGGGGAACACCGGGGAGCTGTTTTTT	CASSADRGNTGELFF	TRBV28	TRBJ2-2
TGTGCCAGTAGTATAGATGAGGCGAGAACTGAAGCTTTCTTT	CASSIDEARTEAFF	TRBV19	TRBJ1-1
TGTGCCAGCAGCAAGCTAACAGGGGGCTATGGCTACACCTTC	CASSKLTGGYGYTF	TRBV9	TRBJ1-2
TGCGCCAGCAGCTTGTCTCGGGCAGGCACAGATACGCAGTATTTT	CASSLSRAGTDTQYF	TRBV5-1	TRBJ2-3
TGTGCCAGCAGCTTCCCGTCAAGGAGTGGACAGGCTAATGAAAAACTGTTTTTT	CASSFPSRSGQANEKLFF	TRBV5-5	TRBJ1-4
TGTGCCAATAGGAGGACAGGCTATGGTAATGAAAAACTGTTTTTT	CANRRTGYGNEKLFF	TRBV6-2	TRBJ1-4
TGTGCCACCAGTGATCAGCAGGGAGATAGCAATCAGCCCCAGCATTTT	CATSDQQGDSNQPQHF	TRBV24-1	TRBJ1-5
TGTGCCAGCAGCCCCCCCACTGCAGGGTCACCCCTCCACTTT	CASSPPTAGSPLHF	TRBV5-5	TRBJ1-6
TGTGCCGAGGGATTAAGCGGGACTGGGGCCAACGTCCTGACTTTC	CAEGLSGTGANVLTF	TRBV12-5	TRBJ2-6
TGTGCCAGCAGCCAAGTAGTCCCTGGGGGAGGGGGGTATAGCAATCAGCCCCAGCATTTT	CASSQVVPGGGGYSNQPQHF	TRBV4-2	TRBJ1-5
TGTGCCAGCAGTGGTGATATACTAAGAACCAGGGGGGGTAGCTCCTACAATGAGCAGTTCTTC	CASSGDILRTRGGSSYNEQFF	TRBV2	TRBJ2-1
TGTGCCAGCAGGGTAACAGTTGATGGCTACACCTTC	CASRVTVDGYTF	TRBV28	TRBJ1-2
TGTGCCAGCAGCTTAGGAGGACAGGTTCCGGACTACGAGCAGTACTTC	CASSLGGQVPDYEQYF	TRBV7-4	TRBJ2-7
TGTGCCAGCAGTTACTCGAGGTTGGCCCTCCAAGAGACCCAGTACTTC	CASSYSRLALQETQYF	TRBV6-6	TRBJ2-5
TGTGCCTGGAGTGTACGGAGGAAAATCCGGGACGTTCCCTACGAGCAGTACTTC	CAWSVRRKIRDVPYEQYF	TRBV30	TRBJ2-7
TGTGCCAGCAGCCCGACAGTGCATTACGAGCAGTACTTC	CASSPTVHYEQYF	TRBV7-9	TRBJ2-7
TGTGCCAGCCGGGACAGGGCATGGAATCAGCCCCAGCATTTT	CASRDRAWNQPQHF	TRBV27	TRBJ1-5
TGTGCCACCAGTGATCCGGCGCTTGCCAAAAACATTCAGTACTTC	CATSDPALAKNIQYF	TRBV24-1	TRBJ2-4
TGTGCCAGCAACCCCTCTGAGTATTCCAGGAGCCTCGGTTACAATGAGCAGTTCTTC	CASNPSEYSRSLGYNEQFF	TRBV6-1	TRBJ2-1
TGCCGGGGGACTCAAGGAGAGACCCAGTACTTC	CRGTQGETQYF	TRBV20-1	TRBJ2-5
TGCGCCAGCAGCCACGACACACACCAAAGGGCCGGGGAGCTGTTTTTT	CASSHDTHQRAGELFF	TRBV4-1	TRBJ2-2
TGTGCCAGCAGCCGGGGAGGCTACGAGCAGTACTTC	CASSRGGYEQYF	TRBV7-9	TRBJ2-7
TGCGCCAGCAGCCTCCCGGGGGAGAATCAGCCCCAGCATTTT	CASSLPGENQPQHF	TRBV4-3	TRBJ1-5
TGTGCCATCATTGGGACAGGGCAGACGAAAGAGACCCAGTACTTC	CAIIGTGQTKETQYF	TRBV10-3	TRBJ2-5
TGTGCCAGCTCCGTCGACGGCGGGAGAGGGGGCAATGAGCAGTTCTTC	CASSVDGGRGGNEQFF	TRBV18	TRBJ2-1
TGTGCCAGCAGCGTAGGGGGGCTCAATCAGCCCCAGCATTTT	CASSVGGLNQPQHF	TRBV6-3	TRBJ1-5
TGTGCCCGTCCTTCGACTAGCGGGAGTAGCCATGAGCAGTTCTTC	CARPSTSGSSHEQFF	TRBV27	TRBJ2-1
TGCGCCAGCAGCTCACCGGGACAGGTCTTCAACACTGAAGCTTTCTTT	CASSSPGQVFNTEAFF	TRBV5-1	TRBJ1-1
TGTGCCAGCAGCGGGGAGACATACACCTTC	CASSGETYTF	TRBV5-6	TRBJ1-2
TGTGCCAGCAGCTTGAACAGGACTAGCGGGAGGGGAGGAAGAGAGACCCAGTACTTC	CASSLNRTSGRGGRETQYF	TRBV5-4	TRBJ2-5
TGCGCCAGCAGCCCCCGAAACGGGGGCAGCAATCAGCCCCAGCATTTT	CASSPRNGGSNQPQHF	TRBV4-1	TRBJ1-5
TGTGCCACCGGGGACAGTGGGGCTTTCTTT	CATGDSGAFF	TRBV27	TRBJ1-1
TGTGCCAGCAGTTACTCAGGGCAAGGGGGCTATGGCTACACCTTC	CASSYSGQGGYGYTF	TRBV6-5	TRBJ1-2
TGCAGTGCCCCAGGGGTGAAAAGGTACGAGCAGTACTTC	CSAPGVKRYEQYF	TRBV20-1	TRBJ2-7
TGTGCCAGCAGCCTGACTAGCCCTAGCACAGATACGCAGTATTTT	CASSLTSPSTDTQYF	TRBV3-1	TRBJ2-3
TGTGCCAGCAGTGCCCCCATTAACAGGCTCTACGAGCAGTACTTC	CASSAPINRLYEQYF	TRBV6-1	TRBJ2-7
TGTGCCAGCAGTCCGGACAGGGGGGGCTACACCTTC	CASSPDRGGYTF	TRBV6-5	TRBJ1-2
TGTGCCAGCAGGTCTCCTAGCGGAAGGCCGAACTCCTACGAGCAGTACTTC	CASRSPSGRPNSYEQYF	TRBV28	TRBJ2-7
TGTGCTAGTCCGGTTCATGCAGGAACCGGGGAGCTGTTTTTT	CASPVHAGTGELFF	TRBV12-5	TRBJ2-2
TGCGCCCTTCCCAACAGGTATAGCAATCAGCCCCAGCATTTT	CALPNRYSNQPQHF	TRBV5-1	TRBJ1-5
TGTGCCAGCAGTCTCCGAAAGGCCTACGAGCAGTACTTC	CASSLRKAYEQYF	TRBV27	TRBJ2-7
TGTGCCAGCTTGGGGGTTGAAAAACTGTTTTTT	CASLGVEKLFF	TRBV27	TRBJ1-4
TGCGCCAGCAGCAGCTCCGGACAATGTCCATGTGAAGCTTTCTTT	CASSSSGQCPCEAFF	TRBV5-1	TRBJ1-1
TGTGCCAGCAGCCCTTGGACGTCCAGGAGCAATCAGCCCCAGCATTTT	CASSPWTSRSNQPQHF	TRBV14	TRBJ1-5
TGTGCCAGCAGCTTAGATCCCGACAGGGGGCAGGGAAATAGTGAGCAGTTCTTC	CASSLDPDRGQGNSEQFF	TRBV11-2	TRBJ2-1
TGTGCCATCAAAAGTTCAAATTGCCAGGACAACGGAGATCAGCCCCAGCATTTT	CAIKSSNCQDNGDQPQHF	TRBV10-3	TRBJ1-5
TGTGCCATCAGCAGGGGGACTGGAAACACCATATATTTT	CAISRGTGNTIYF	TRBV10-3	TRBJ1-3
TGTGCCACGACTTCCCAGCATTTT	CATTSQHF	TRBV5-5	TRBJ1-5
TGCGCCAGCAGTGAGGGCGGGGGGGGCCAAGGCGGGGAGCTGTTTTTT	CASSEGGGGQGGELFF	TRBV10-1	TRBJ2-2
TGTGCCAGCAGCCAAGAAGTAGACCGGGACAGGGTGCGGGCCAATCAGCCCCAGCATTTT	CASSQEVDRDRVRANQPQHF	TRBV14	TRBJ1-5
TGTGCCAGCAGGACGGACCTAGGGGAGTGGGGGAGCGAGCAGTACTTC	CASRTDLGEWGSEQYF	TRBV6-1	TRBJ2-7
TGTGCCAGTACAGCCCATCCACAGGGGGAGAACGAGCAGTACTTC	CASTAHPQGENEQYF	TRBV19	TRBJ2-7
TGTGCCAGCAGCCGGCCCGCGGACAGGGCCCTTCAGCCCCAGCATTTT	CASSRPADRALQPQHF	TRBV3-1	TRBJ1-5
TGTGCCACCAGCAGAGATCATTCTTCCGGGGCTGCAACTAATGAAAAACTGTTTTTT	CATSRDHSSGAATNEKLFF	TRBV15	TRBJ1-4
TGCGCCAGCAGCCAAGACTTGAGGGGGTACGAGCAGTACTTC	CASSQDLRGYEQYF	TRBV4-1	TRBJ2-7
TGCAGTGCTAGAGCAGGCCGAAAGGTCAGGGATGAGCAGTTCTTC	CSARAGRKVRDEQFF	TRBV20-1	TRBJ2-1
TGTGCCAGCACTCATCAGGTTGCCTACGAGCAGTACTTC	CASTHQVAYEQYF	TRBV25-1	TRBJ2-7
TGTGCCAGCAGTGAAGCCTGGCCGGGACAGGACGAGCAGTACTTC	CASSEAWPGQDEQYF	TRBV6-1	TRBJ2-7
TGTGCCAGCAGCGTATCGTCGTTAGGAACCTACGAGCAGTACTTC	CASSVSSLGTYEQYF	TRBV9	TRBJ2-7
TGTGCCATCAGTGAGTCCACAGGGGACAATGAAAAACTGTTTTTT	CAISESTGDNEKLFF	TRBV10-3	TRBJ1-4
TGTGCCACCAGTGAAACAAGTCCTAATGAGGAAGCTTTCTTT	CATSETSPNEEAFF	TRBV24-1	TRBJ1-1
TGCGCCAGCAGCGTCCACAGCGACGAGCAGTACTTC	CASSVHSDEQYF	TRBV5-1	TRBJ2-7
TGTGCCAGCAGTGAAAAAAGGGGCCTGGACACTGAAGCTTTCTTT	CASSEKRGLDTEAFF	TRBV6-1	TRBJ1-1
TGTGCCAGCAAAAGGGAAGAATCGGGCTACACCTTC	CASKREESGYTF	TRBV6-1	TRBJ1-2
TGTGCCAGCAGCTTACGAGCTGCGAAGGCGGGAGTAAATGAGCAGTTCTTC	CASSLRAAKAGVNEQFF	TRBV7-2	TRBJ2-1
TGCGCCAGCAGCTTTCGCTTTCCACTAGCGGGAGTTGTGGCCTACGAGCAGTACTTC	CASSFRFPLAGVVAYEQYF	TRBV5-1	TRBJ2-7
TGTGCCAGCAGTTTAGGCTTGCCCAGCCACATGCTTGACCGCTACAATGAGCAGTTCTTC	CASSLGLPSHMLDRYNEQFF	TRBV12-3	TRBJ2-1
TGTGCCAGCAGCCGCTGCGGTGAGCAGTTCTTC	CASSRCGEQFF	TRBV5-5	TRBJ2-1
TGTGCCAGCAGCCACCTTAGTGGAAAACAGGTAAGGGGGGTGGAGACCCAGTACTTC	CASSHLSGKQVRGVETQYF	TRBV4-2	TRBJ2-5
TGCAGTGCTACGCCCGGCCCTGAAGCTTTCTTT	CSATPGPEAFF	TRBV20-1	TRBJ1-1
TGTGCCATCAATTCCCCGGGACAGGGTCAGCCCCAGCATTTT	CAINSPGQGQPQHF	TRBV10-3	TRBJ1-5
TGTGCCAGCGGGTATGCCCTGGCCAAAAACATTCAGTACTTC	CASGYALAKNIQYF	TRBV6-1	TRBJ2-4
TGTGCTAGTGGGGGACGTATGGCCACTGAAGCTTTCTTT	CASGGRMATEAFF	TRBV12-5	TRBJ1-1
TGTGCCAGCAGCGTAGGCGTGACTAGCGGGGGTCATGTTAACACCGGGGAGCTGTTTTTT	CASSVGVTSGGHVNTGELFF	TRBV9	TRBJ2-2
TGTGCCAGCAGTTCCTTGCGGGAGTCCAACCGGCAGTCCTACGAGCAGTACTTC	CASSSLRESNRQSYEQYF	TRBV12-4	TRBJ2-7
TGTGCCAGCAGCTGGAGGGGTCCGTGCCTATATGGCTACACCTTC	CASSWRGPCLYGYTF	TRBV7-9	TRBJ1-2
TGCGCCAGCAGCGTTGTTTCGACAGCAGGTCTCTCTGAAAAAGCTAACTATGGCTACACCTTC	CASSVVSTAGLSEKANYGYTF	TRBV5-1	TRBJ1-2
TGTGCCAGCAGCGAGCGTGGACAGGGTGCTGTTGACTACGAGCAGTACTTC	CASSERGQGAVDYEQYF	TRBV7-4	TRBJ2-7
TGTGCCAGCAGTAAAAATCGGGACAACCACACTGAAGCTTTCTTT	CASSKNRDNHTEAFF	TRBV6-3	TRBJ1-1
TGTGCCAGCAGTGACTCCCCCGGGGGGGAGAATGAAAAACTGTTTTTT	CASSDSPGGENEKLFF	TRBV6-4	TRBJ1-4
TGTGCCAGTAGTATAGAGGCAGGCACGGGGAGGATTAGAACAGATACGCAGTATTTT	CASSIEAGTGRIRTDTQYF	TRBV19	TRBJ2-3
TGCGCCAGCAGACTCAAAGGGGACGGCAATCAGCCCCAGCATTTT	CASRLKGDGNQPQHF	TRBV5-1	TRBJ1-5
TGTGCCAGCTCGAGCGGGAAACAAGAGACCCAGTACTTC	CASSSGKQETQYF	TRBV5-4	TRBJ2-5
TGTGCCAGCAGTTGTAACGCCCCTTTTGGAAACACCATATATTTT	CASSCNAPFGNTIYF	TRBV6-5	TRBJ1-3
TGTGCCAGCCACAGGGAGGCCTACGAGCAGTACTTC	CASHREAYEQYF	TRBV5-6	TRBJ2-7
TGCAGTGCTAGGCCGCCTAGCGGGTTCGAGCAGTACTTC	CSARPPSGFEQYF	TRBV20-1	TRBJ2-7
TGTGCCACCAGTTTATACAGGGCCGGGCCTCGCCACTCTGGCTACACCTTC	CATSLYRAGPRHSGYTF	TRBV24-1	TRBJ1-2
TGTGCCAGCTCACCACCCCGACAGGCAGGCAATCAGCCCCAGCATTTT	CASSPPRQAGNQPQHF	TRBV18	TRBJ1-5
TGTGCCGAGAAGGGAGGGGGATACGAGCAGTACTTC	CAEKGGGYEQYF	TRBV24-1	TRBJ2-7
TGTGCCAGCAGCGGTCCGGGACAGGGTGGATCCTACGAGCAGTACTTC	CASSGPGQGGSYEQYF	TRBV5-5	TRBJ2-7
TGTGCTAGTGGTTTGGTACGGACAGGGCCCTACGAGCAGTACTTC	CASGLVRTGPYEQYF	TRBV12-5	TRBJ2-7
TGTGCCAGCTGGAATAGGGAATTTAGGGTTATGTTTCTGGGACAGGGGGCAAGTGAAGCTTTCTTT	CASWNREFRVMFLGQGASEAFF	TRBV6-4	TRBJ1-1
TGTGCCAGCAGCCCTCGATCCATCTCCTACGAGCAGTACTTC	CASSPRSISYEQYF	TRBV5-6	TRBJ2-7
TGTGCCAGCAGCTATTCAGGGGGGGGCTGGACGGAGCAGTTCTTC	CASSYSGGGWTEQFF	TRBV13	TRBJ2-1
TGTGCCAGCAGCTTAGAACACTCTGGGACAAAGGTGAACACTGAAGCTTTCTTT	CASSLEHSGTKVNTEAFF	TRBV7-4	TRBJ1-1
TGTGCCAGCAGCCGCCTGTGCCTAAAACAAGAGACCCAGTACTTC	CASSRLCLKQETQYF	TRBV9	TRBJ2-5
TGCGCCAGCAGTGAACTGGGACACACTGAAGCTTTCTTT	CASSELGHTEAFF	TRBV10-1	TRBJ1-1
TGTGCCAGCAGCTTACCCTGGACAGCATATGACTATGGCTACACCTTC	CASSLPWTAYDYGYTF	TRBV7-9	TRBJ1-2
TGCGCCAGCAGTTCCATCGAACCACAGCCCCAGCATTTT	CASSSIEPQPQHF	TRBV10-1	TRBJ1-5
TGTGCCAGCAGGAGAAGTCGGACGGGACTCCAAGCCGCTAGCACTGAAGCTTTCTTT	CASRRSRTGLQAASTEAFF	TRBV6-2	TRBJ1-1
TGTGCCCCGACGCCACCCCTCCACTTT	CAPTPPLHF	TRBV28	TRBJ1-6
TGTGCCAGCAGTTCCCGGGGGAGGAACACCGGGGAGCTGTTTTTT	CASSSRGRNTGELFF	TRBV28	TRBJ2-2
TGTGCCACCAGCCCGACCTCCAGGGGGTCTAATGAGCAGTTCTTC	CATSPTSRGSNEQFF	TRBV15	TRBJ2-1
TGTGCCAGCAGCGGGACAGTAACGAACACCGGGGAGCTGTTTTTT	CASSGTVTNTGELFF	TRBV9	TRBJ2-2
TGTGCCAGCAGCTTAGATCCCAGCCTAGCGGGGTACAATGAGCAGTTCTTC	CASSLDPSLAGYNEQFF	TRBV11-3	TRBJ2-1
TGTGCCAGCAGCTTGGCTGCCCCCACTCCCTACAATGAGCAGTTCTTC	CASSLAAPTPYNEQFF	TRBV5-8	TRBJ2-1
TGTGCCAGCAGCTGCCAGGGTATCGTGGGGGCTTTGGCCGGCTACACCTTC	CASSCQGIVGALAGYTF	TRBV11-2	TRBJ1-2
TGTGCCAGCAGCCCGGGACAGGGGGATCAGCCCCAGCATTTT	CASSPGQGDQPQHF	TRBV13	TRBJ1-5
TGCAGTGCTAGCGGGACAGGGCCAGCTAGGAACACTGAAGCTTTCTTT	CSASGTGPARNTEAFF	TRBV20-1	TRBJ1-1
TGTGCCAGCAGTTTACGCTGCCACTCAGAGACCCAGTACTTC	CASSLRCHSETQYF	TRBV28	TRBJ2-5
TGTGCCAGCAGCTTGGAACTAGCGGGGGGGCGAAGCTACGAGCAGTACTTC	CASSLELAGGRSYEQYF	TRBV5-6	TRBJ2-7
TGTGCCAGCAGTGACGTGGGCGCAATTTATGGCTACACCTTC	CASSDVGAIYGYTF	TRBV6-4	TRBJ1-2
TGTGCCAGCAGTGAAACTACCGGGACAGGGGGCAACCGCCAAGAGACCCAGTACTTC	CASSETTGTGGNRQETQYF	TRBV6-1	TRBJ2-5
TGTGCCAGCGGACGGTTGAACACCGGGGAGCTGTTTTTT	CASGRLNTGELFF	TRBV25-1	TRBJ2-2
TGTGCCACGGGGGCGACGGGAAACACCATATATTTT	CATGATGNTIYF	TRBV24-1	TRBJ1-3
TGCAGTGCTAGAGGACAGGGGGCGCTCCCTTTTTACGAGCAGTACTTC	CSARGQGALPFYEQYF	TRBV20-1	TRBJ2-7
TGCAGTGCCCCTAGCGGGGCTAGCTCCTACAATGAGCAGTTCTTC	CSAPSGASSYNEQFF	TRBV20-1	TRBJ2-1
TGCGCCAGCAGCTTTAGGGTTTCCCAAGAGACCCAGTACTTC	CASSFRVSQETQYF	TRBV5-1	TRBJ2-5
TGTGCCAGCAGCTTTGGAATTAGCCTAGCGGGAGGCTCGAAAAACATTCAGTACTTC	CASSFGISLAGGSKNIQYF	TRBV7-8	TRBJ2-4
TGCGCCAGCAGCTTGGTAACTTCCGAGCAGTACTTC	CASSLVTSEQYF	TRBV5-1	TRBJ2-7
TGTGCCAGCAGTTATGGACAGCACAATGAGCAGTTCTTC	CASSYGQHNEQFF	TRBV6-3	TRBJ2-1
TGTGCCAGCAGTTTAAGGGTTACTAGCGGTTCCGATGAGCAGTTCTTC	CASSLRVTSGSDEQFF	TRBV12-4	TRBJ2-1
TGTGCCAGCAGTGAACGACCCCATAGGGGGCAGTCTACGTCCCAGCATTTT	CASSERPHRGQSTSQHF	TRBV6-1	TRBJ1-5
TGTGCCTGGAAACCCCGAGGGGGTATCAATCAGCCCCAGCATTTT	CAWKPRGGINQPQHF	TRBV30	TRBJ1-5
TGTGCCAGCAGACAGGTGGAGTTTAACACTGAAGCTTTCTTT	CASRQVEFNTEAFF	TRBV25-1	TRBJ1-1
TGTGCCAGCAGCCAGTCGGGGGCAGAGCAGTACTTC	CASSQSGAEQYF	TRBV13	TRBJ2-7
TGTGCCAGCAAGAGTCGGGGAGAGACCCAGTACTTC	CASKSRGETQYF	TRBV5-5	TRBJ2-5
TGTGCCAGGCTGAAGAAGGTCCGGCAAGAGACCCAGTACTTC	CARLKKVRQETQYF	TRBV19	TRBJ2-5
TGTGCCATCAATTCTAGGAACTCCTACGAGCAGTACTTC	CAINSRNSYEQYF	TRBV19	TRBJ2-7
TGCGGAACTTTCGTGGGTGGAAACTACAATGAGCAGTTCTTC	CGTFVGGNYNEQFF	TRBV20-1	TRBJ2-1
TGTGCCAGCAGCTGGGCCGGGACAGGGGAGAATAACTATGGCTACACCTTC	CASSWAGTGENNYGYTF	TRBV5-4	TRBJ1-2
TGTGCCAGCAGCGTCCTTTTAGGACAGGGGAGGATGAACACTGAAGCTTTCTTT	CASSVLLGQGRMNTEAFF	TRBV9	TRBJ1-1
TGTGCCAGCAGCAAGGACAGGGGAATCTCTGGAAACACCATATATTTT	CASSKDRGISGNTIYF	TRBV9	TRBJ1-3
TGTGCCAGCAGTGACCATCGGGGGGCCCTTAGCTCCTACAATGAGCAGTTCTTC	CASSDHRGALSSYNEQFF	TRBV6-4	TRBJ2-1
TGTGCCAGCAGCTTAGACCAGCGGGAATGCAAGGCTTGCTCCTACAATGAGCAGTTCTTC	CASSLDQRECKACSYNEQFF	TRBV7-9	TRBJ2-1
TGTGCCACCAGTGATTTGTCACGCCACCGTCAGGGCAATCAGCCCCAGCATTTT	CATSDLSRHRQGNQPQHF	TRBV24-1	TRBJ1-5
TGTGCCAGCAGTCAGGGGCGGAGCGACTATGGCTACACCTTC	CASSQGRSDYGYTF	TRBV6-1	TRBJ1-2
TGTGCCAGCTCCTTCCAAATTTACAATGAGCAGTTCTTC	CASSFQIYNEQFF	TRBV18	TRBJ2-1
TGCGCCAGCAGGCGGCGGGGGCGTATGAACACTGAAGCTTTCTTT	CASRRRGRMNTEAFF	TRBV5-1	TRBJ1-1
TGTGCCAGCGCCGATTACGAGCAGTACTTC	CASADYEQYF	TRBV6-2	TRBJ2-7
TGTGCCAGCAGTTACATTGCGGGAGACGAGCAGTACTTC	CASSYIAGDEQYF	TRBV6-5	TRBJ2-7
TGCGCCAGCAGCTTGTCGGTGCCGGGTTGGTACGAGCAGTACTTC	CASSLSVPGWYEQYF	TRBV5-1	TRBJ2-7
TGTGCCAGCAGCCGGCGGACTAGCGGTCCCTGCGGGGAGCTGTTTTTT	CASSRRTSGPCGELFF	TRBV11-2	TRBJ2-2
TGTGCCAGCAGTGGATTTGATGGGCAGAAACACGAGCAGTACTTC	CASSGFDGQKHEQYF	TRBV6-2	TRBJ2-7
TGTGCCAGCAGAGGGCCCTACTATGGCTACACCTTC	CASRGPYYGYTF	TRBV12-3	TRBJ1-2
TGCGCCAGCAGCTTGGAAAAAAGGTTGGGGAGACAAGAGACCCAGTACTTC	CASSLEKRLGRQETQYF	TRBV5-1	TRBJ2-5
TGTGCCAGCGGGGGGGCCTCCCTGCAAGAGACCCAGTACTTC	CASGGASLQETQYF	TRBV7-3	TRBJ2-5
TGTGCCAGCAGCGGGATCGGGGGACAGCTGGAAAACACTGAAGCTTTCTTT	CASSGIGGQLENTEAFF	TRBV5-6	TRBJ1-1
TGCGCCAGCAGCCAAGACGGGTCCCAGGGCCCTGGGGGGTGGATTACCTACGAGCAGTACTTC	CASSQDGSQGPGGWITYEQYF	TRBV4-1	TRBJ2-7
TGCGCCCAGCCAAGTCCGTACCAAGAGACCCAGTACTTC	CAQPSPYQETQYF	TRBV10-1	TRBJ2-5
TGTGCCACGAGGACTAGTAGCAATCAGCCCCAGCATTTT	CATRTSSNQPQHF	TRBV24-1	TRBJ1-5
TGTGCCAGCAGCGCCCCTCGACAGGGAGTCACAGATACGCAGTATTTT	CASSAPRQGVTDTQYF	TRBV7-3	TRBJ2-3
TGTGCCAGCATCCAAAAGGGGGGGACAGGGGGCGCTAGCACCGGGGAGCTGTTTTTT	CASIQKGGTGGASTGELFF	TRBV2	TRBJ2-2
TGTGCCAGCAGTTCCGACAGGGGGGGGAACACTGAAGCTTTCTTT	CASSSDRGGNTEAFF	TRBV6-5	TRBJ1-1
TGCAGTGCTAGCGGACATCAGCCCCAGCATTTT	CSASGHQPQHF	TRBV20-1	TRBJ1-5
TGTGCCAGCAGCCAAGGACCACCCCGGGGCTACGAGCAGTACTTC	CASSQGPPRGYEQYF	TRBV3-1	TRBJ2-7
TGTGCCAGCAGCTTAGATCCCCCTGGGATGGGAGAGACCCAGTACTTC	CASSLDPPGMGETQYF	TRBV11-2	TRBJ2-5
TGCAGTGCTTCAAACCCGTGCCGGGGGGAGTCCTACGAGCAGTACTTC	CSASNPCRGESYEQYF	TRBV20-1	TRBJ2-7
TGTGCCAGCAGTTTAGCGCACTGCTCCAGGGATGGCTACACCTTC	CASSLAHCSRDGYTF	TRBV12-3	TRBJ1-2
TGTGCCAGCAGTTTATCCGAGTTTTGGACTTTGGCTCCAGATACGCAGTATTTT	CASSLSEFWTLAPDTQYF	TRBV27	TRBJ2-3
TGTGCCAGCAGTAACCTTGTAAGCACAGATACGCAGTATTTT	CASSNLVSTDTQYF	TRBV27	TRBJ2-3
TGTGCCAGCAGCACAGTCTTAGAGCAGTTCTTC	CASSTVLEQFF	TRBV5-6	TRBJ2-1
TGTGCCACCAGCACCGACGACAGGGCGACGAACACCGGGGAGCTGTTTTTT	CATSTDDRATNTGELFF	TRBV15	TRBJ2-2
TGCGCCAGCAGCCAAGATCTAGAGCGGGCGGAGCAGTACTTC	CASSQDLERAEQYF	TRBV4-3	TRBJ2-7
TGTGCCAGCAGCGACAGGGGGTCGGCCAACGTCCTGACTTTC	CASSDRGSANVLTF	TRBV11-3	TRBJ2-6
TGTGCCAGCAGCTTGGCCCAGTCTTGGGCCAACGTCCTGACTTTC	CASSLAQSWANVLTF	TRBV5-4	TRBJ2-6
TGTGCCAGCAGCCCCTGGGGACCCTCCTACAATGAGCAGTTCTTC	CASSPWGPSYNEQFF	TRBV7-3	TRBJ2-1
TGTGCCAGCAGCTTCCAACCTCGAACAAGGAGCGACCTTAACTATGGCTACACCTTC	CASSFQPRTRSDLNYGYTF	TRBV5-6	TRBJ1-2
TGCAGTGCTGCTAGCGGGGGGGATAAGAAGAACGAGCAGTACTTC	CSAASGGDKKNEQYF	TRBV20-1	TRBJ2-7
TGTGCCAGCAGCTATGACAGGGGAGCCTACGAGCAGTACTTC	CASSYDRGAYEQYF	TRBV11-2	TRBJ2-7
TGTATACCCCGGGCTGGAAACACCATATATTTT	CIPRAGNTIYF	TRBV7-9	TRBJ1-3
TGTGCCAGCTCACCAAGGGGGTCGGGATGGATGAACACCGGGGAGCTGTTTTTT	CASSPRGSGWMNTGELFF	TRBV18	TRBJ2-2
TGTGCCAGTAGTAGAGTTAGGGAGGGAATCCGCAATCAGCCCCAGCATTTT	CASSRVREGIRNQPQHF	TRBV19	TRBJ1-5
TGTGCCAGCTACCCTCTGACAGGGCCTGAAGCTTTCTTT	CASYPLTGPEAFF	TRBV2	TRBJ1-1
TGTGCCAGCAGCGGGGACAGGGGGGGCGAAAAACTGTTTTTT	CASSGDRGGEKLFF	TRBV13	TRBJ1-4
TGCGCCAGCAGTGAGTCCCCGGACAGGGTTGGAGAAGGCTATGGCTACACCTTC	CASSESPDRVGEGYGYTF	TRBV10-1	TRBJ1-2
TGCGCCAGCAGCCAAGACCCAACAAGGGGAATCGAGCAGTACTTC	CASSQDPTRGIEQYF	TRBV4-3	TRBJ2-7
TGTGCCAGCAGCCGACTGATTGAGCAGTACTTC	CASSRLIEQYF	TRBV7-3	TRBJ2-7
TGTGCCAGCAGTTCGGTAGGCCACAGGGTGGGATGTGAGCAGTTCTTC	CASSSVGHRVGCEQFF	TRBV6-1	TRBJ2-1
TGCGCCAGCACCAGCCGGGTGGGGAGCTCTGGAAACACCATATATTTT	CASTSRVGSSGNTIYF	TRBV10-2	TRBJ1-3
TGTGCCAGCAGTGAACGAAAGGGGGCGATGGAGGACTCGACCAATGAAAAACTGTTTTTT	CASSERKGAMEDSTNEKLFF	TRBV6-1	TRBJ1-4
TGTGCCAGCAGCCTGGGAGGGAGCACAGATACGCAGTATTTT	CASSLGGSTDTQYF	TRBV13	TRBJ2-3
TGCAGCGCGAAGTTGCGGGAGACCGGTAATGAAAAACTGTTTTTT	CSAKLRETGNEKLFF	TRBV29-1	TRBJ1-4
TGTGCCAGCAGCCAAGCCGGACTGGAAGAGACCCAGTACTTC	CASSQAGLEETQYF	TRBV3-1	TRBJ2-5
TGTGCTAGTGGTTCTTGGGTGCGGGAGGGGTGGGACTACGAGCAGTACTTC	CASGSWVREGWDYEQYF	TRBV12-5	TRBJ2-7
TGTGCCAGCAGCCCCCGGCGAAACAATCAGCCCCAGCATTTT	CASSPRRNNQPQHF	TRBV3-1	TRBJ1-5
TGTGCCAGCAGTGACGCTCTGGGGGCACATTCACCCCTCCACTTT	CASSDALGAHSPLHF	TRBV6-4	TRBJ1-6
TGTGCCAGCAGCTGGGCTTGGCGCCATGGCTACACCTTC	CASSWAWRHGYTF	TRBV5-4	TRBJ1-2
TGTGCCAGCAGCCACCGGAGGGGCGGTGTTTACGAGCAGTACTTC	CASSHRRGGVYEQYF	TRBV7-3	TRBJ2-7
TGTGCAGGACAGGGATCGGCTAACTATGGCTACACCTTC	CAGQGSANYGYTF	TRBV9	TRBJ1-2
TGTGCCATCAGTGAGTGTGGCGGGCGCACCGGGGAGCTGTTTTTT	CAISECGGRTGELFF	TRBV10-3	TRBJ2-2
TGTGCCAGCAGTTATCCCGGGCGTTGCTGCTATGGCTACACCTTC	CASSYPGRCCYGYTF	TRBV27	TRBJ1-2
TGTGCCTCCTTTTCCGGGGGGTGGGATAGCAATCAGCCCCAGCATTTT	CASFSGGWDSNQPQHF	TRBV19	TRBJ1-5
TGCAGTGCCAACACAGTGTACAGGGCCAAGACGGAGCCTGAAGCTTTCTTT	CSANTVYRAKTEPEAFF	TRBV20-1	TRBJ1-1
TGCGCCAGCAGCTTGGACCCGCCGGCCTACGAGCAGTACTTC	CASSLDPPAYEQYF	TRBV5-1	TRBJ2-7
TGTGCCAGCAGCGTTGACAGGGGGCCTCTTAGCAATCAGCCCCAGCATTTT	CASSVDRGPLSNQPQHF	TRBV7-3	TRBJ1-5
TGTGCCAGCAGCTTTCGTAGGTGCACCGGGGAGCTGTTTTTT	CASSFRRCTGELFF	TRBV7-3	TRBJ2-2
TGCAGCGTGACTGAGAACACTGAAGCTTTCTTT	CSVTENTEAFF	TRBV29-1	TRBJ1-1
TGTGCCAGTCCCCCCGGACAGGAAAAAGAGACCCAGTACTTC	CASPPGQEKETQYF	TRBV27	TRBJ2-5
TGTGCCAGCAGCTTAATAGGGGGCAATCAGCCCCAGCATTTT	CASSLIGGNQPQHF	TRBV7-6	TRBJ1-5
TGTGCCACCAGCAGGGGTAGGACTGGGCCAGCTGAAGCTTTCTTT	CATSRGRTGPAEAFF	TRBV15	TRBJ1-1
TGTGCCAGCAGCTTGGATACTAGCGGGTACAATGAGCAGTTCTTC	CASSLDTSGYNEQFF	TRBV5-6	TRBJ2-1
TGCGCCAGCAGCTTGGGGCCGGCCCAGTACTTC	CASSLGPAQYF	TRBV5-1	TRBJ2-5
TGTGCCAGTACACGTAACGAGCGGGAGCCGGATGGCAATCAGCCCCAGCATTTT	CASTRNEREPDGNQPQHF	TRBV19	TRBJ1-5
TGTGCTAGTGGTTTGGTACGGGAGATCTTAACAGCGAATGAAAAACTGTTTTTT	CASGLVREILTANEKLFF	TRBV12-5	TRBJ1-4
TGTGCCAGCAGCTTGCAGGGGTTCTACAATGAGCAGTTCTTC	CASSLQGFYNEQFF	TRBV3-1	TRBJ2-1
TGTGCCAGTAAGAAGGGTCGGAACACCGGGGAGCTGTTTTTT	CASKKGRNTGELFF	TRBV19	TRBJ2-2
TGTGCCAGTACTAGCTTTCAAGAGACCCAGTACTTC	CASTSFQETQYF	TRBV19	TRBJ2-5
TGTGCCACCAGTAAAGCGTGGGATCAGCCCCAGCATTTT	CATSKAWDQPQHF	TRBV24-1	TRBJ1-5
TGTGCCAGCAGCCAAGGGGCGGGCGGGAGGCTCAATCAGCCCCAGCATTTT	CASSQGAGGRLNQPQHF	TRBV16	TRBJ1-5
TGTGCCAGCAGCTTAGCGACCACAATCAACACAGATACGCAGTATTTT	CASSLATTINTDTQYF	TRBV7-4	TRBJ2-3
TGTGCCACCGGACAGCCCTTTGGGATCAACCGACCGGAAAAACTGTTTTTT	CATGQPFGINRPEKLFF	TRBV19	TRBJ1-4
TGCGCCAGCAGCCCCAGTACCTCAAGCCGGGACAGGATGTTTATGGAGACCCAGTACTTC	CASSPSTSSRDRMFMETQYF	TRBV5-1	TRBJ2-5
TGTGCCACCCCGTATGGAGGGGGACTGAAATTGACAGATACGCAGTATTTT	CATPYGGGLKLTDTQYF	TRBV24-1	TRBJ2-3
TGTGCCAGCAAACACGACAGAAGATGCCAGCCCCAGCATTTT	CASKHDRRCQPQHF	TRBV6-2	TRBJ1-5
TGTGCCAGCAGCCAAGGGGGTTTAATACCCTACGAGCAGTACTTC	CASSQGGLIPYEQYF	TRBV4-2	TRBJ2-7
TGTGCCAGCAGTTTAACCAGCGGGAGCGGATTCTCCTACGAGCAGTACTTC	CASSLTSGSGFSYEQYF	TRBV27	TRBJ2-7
TGCGCCAGCCCGAGACAAGACGAGCAGTACTTC	CASPRQDEQYF	TRBV10-1	TRBJ2-7
TGTGCCAGCAGCCTAACGGCCCCCAATCAGCCCCAGCATTTT	CASSLTAPNQPQHF	TRBV5-6	TRBJ1-5
TGTGCCAGCAGCCAAGATCGAGCCCGGGGTGGGTGGTACTTC	CASSQDRARGGWYF	TRBV3-1	TRBJ2-7
TGTGCCAGCTCACCGGGAGGCCCGGGGGCAGGAGAGACCCAGTACTTC	CASSPGGPGAGETQYF	TRBV18	TRBJ2-5
TGTGCCTACTCATTGGCGGCATGGGATACGCAGTATTTT	CAYSLAAWDTQYF	TRBV30	TRBJ2-3
TGTGCCAGCAGTCGACAGAAAGGTAACTATGGCTACACCTTC	CASSRQKGNYGYTF	TRBV27	TRBJ1-2
TGTGCCAGCGACAGGACATGGCGAAACACCATATATTTT	CASDRTWRNTIYF	TRBV6-1	TRBJ1-3
TGTGCCAGCAGCGCCGAAACGGGGGGCCTCTTTGGCTACACCTTC	CASSAETGGLFGYTF	TRBV7-9	TRBJ1-2
TGTGCCAGCAGCGGACGTACACCCTATAATTCACCCCTCCACTTT	CASSGRTPYNSPLHF	TRBV11-2	TRBJ1-6
TGTGCCAGCACGGGACTAGCGGGTGCCGTAGAGACCCAGTACTTC	CASTGLAGAVETQYF	TRBV28	TRBJ2-5
TGCGCCAGCAGCTTGCGGGGGGGTGGAAACACCATATATTTT	CASSLRGGGNTIYF	TRBV5-1	TRBJ1-3
TGTGCCAGGACGAAAGGCTACACCTTC	CARTKGYTF	TRBV19	TRBJ1-2
TGTGCCAGCAGGCCCTCCTATGGCTACACCTTC	CASRPSYGYTF	TRBV7-7	TRBJ1-2
TGTGCCAGCAGTTACTCGGGAACTCCCCCGGGGGGAACCTACGAGCAGTACTTC	CASSYSGTPPGGTYEQYF	TRBV6-6	TRBJ2-7
TGCGCCAGCAGCTGGGGCGGTTTGACACTGTTTTTT	CASSWGGLTLFF	TRBV5-1	TRBJ1-4
TGTGCCAGCAGCAAGATGGAACGTTTGGAGCAGTACTTC	CASSKMERLEQYF	TRBV13	TRBJ2-7
TGTGCTAGCAGCTGCTGCTGGGTAGGCTACGAGCAGTACTTC	CASSCCWVGYEQYF	TRBV7-7	TRBJ2-7
TGCAGTGCTCAGGGTGAAGTGGGCTACACCTTC	CSAQGEVGYTF	TRBV20-1	TRBJ1-2
TGTGCCAGCAGCCACCAGACTTGTTCCGGGGAGCTGTTTTTT	CASSHQTCSGELFF	TRBV5-8	TRBJ2-2
TGTGCCAGCACAGGGGGGTGGGGTGGTGAAGCTAATGAAAAACTGTTTTTT	CASTGGWGGEANEKLFF	TRBV6-5	TRBJ1-4
TGTGCCACCAGTGAGGGGTATTCTACGGACGAGCAGTACTTC	CATSEGYSTDEQYF	TRBV24-1	TRBJ2-7
TGCAGTGCTAGCCGGCGGGGACAGTCCTACAATGAGCAGTTCTTC	CSASRRGQSYNEQFF	TRBV20-1	TRBJ2-1
TGTGCCAGCAGCCAAGACCGAAAACAGGGACACACTGAAGCTTTCTTT	CASSQDRKQGHTEAFF	TRBV14	TRBJ1-1
TGTGCCAGCTCACCACTCGGTGCCGGGACAGGGCGCGAGCAGTACTTC	CASSPLGAGTGREQYF	TRBV18	TRBJ2-7
TGTGCCAGCAGCGAGGGACAGGGATGGAGCTACGAGCAGTACTTC	CASSEGQGWSYEQYF	TRBV5-6	TRBJ2-7
TGTGCCAGCAGCACAACGGGGACTAGCGGGATATCCGATACGCAGTATTTT	CASSTTGTSGISDTQYF	TRBV7-9	TRBJ2-3
TGTGCCAGCAGCTTGGTAGGTGTTCCTGGGGGGCCCCCGAGCAGCAATCAGCCCCAGCATTTT	CASSLVGVPGGPPSSNQPQHF	TRBV5-6	TRBJ1-5
TGCAGTGCAAAAGGACGGTTGTATGAGCAGTTCTTC	CSAKGRLYEQFF	TRBV20-1	TRBJ2-1
TGCGCCAGCAGCCCGAACGGACAGTACGAGCAGTACTTC	CASSPNGQYEQYF	TRBV5-1	TRBJ2-7
TGTGCCAGCAGCTTAGCCGGGTCGGCTAGCTACGAGCAGTACTTC	CASSLAGSASYEQYF	TRBV7-2	TRBJ2-7
TGTGCCAGCAGCCCCAGGGGGGCGCTGAACACTGAAGCTTTCTTT	CASSPRGALNTEAFF	TRBV9	TRBJ1-1
TGTGCCATCAGAACGCGATCCTACGAGCAGTACTTC	CAIRTRSYEQYF	TRBV10-3	TRBJ2-7
TGTGCCAGCAGCATGATTTCACTCTCGGGTCCGAACACCGGGGAGCTGTTTTTT	CASSMISLSGPNTGELFF	TRBV13	TRBJ2-2
TGTGCCAGCAGCAGCCGGGGGAACAGGGAAAAACTGTTTTTT	CASSSRGNREKLFF	TRBV6-4	TRBJ1-4
TGTGCCAGCAGTAGGACAGATAGCCCACCCCTCCACTTT	CASSRTDSPPLHF	TRBV7-2	TRBJ1-6
TGTGCCAGCAGCCAAGAACTAGCGGGAGATTCGGTCTACGAGCAGTACTTC	CASSQELAGDSVYEQYF	TRBV14	TRBJ2-7
TGTGCCAGCAGCTTAGCAGTACTAGCGGGAGTGAGGTACTTC	CASSLAVLAGVRYF	TRBV11-2	TRBJ2-5
TGTGCCAGCAGTTTACAGGGTAATTCACCCCTCCACTTT	CASSLQGNSPLHF	TRBV12-4	TRBJ1-6
TGCAGCGTTGCCAGCAAGGAATTGGGACAGGGCTACGAGCAGTACTTC	CSVASKELGQGYEQYF	TRBV29-1	TRBJ2-7
TGTGCCAGCAGCCTCGGACAGGGCTGTAACACCGGGGAGCTGTTTTTT	CASSLGQGCNTGELFF	TRBV3-1	TRBJ2-2
TGTGCCAGCACTCCAGGGGGCGGGGAAAAACTGTTTTTT	CASTPGGGEKLFF	TRBV2	TRBJ1-4
TGTGCCAGCAGCGCCGGGACTAGCTCCTACAATGAGCAGTTCTTC	CASSAGTSSYNEQFF	TRBV7-4	TRBJ2-1
TGTGCCAGCAGTCCTCCGGTGTCGGGCCGCAATTCACCCCTCCACTTT	CASSPPVSGRNSPLHF	TRBV12-3	TRBJ1-6
TGCAGTGCTAGAGACCGGGCTAGGGGCAATCAGCCCCAGCATTTT	CSARDRARGNQPQHF	TRBV20-1	TRBJ1-5
TGTGCCAGCAGCAGACAGGTGTGTGAGCAGTTCTTC	CASSRQVCEQFF	TRBV14	TRBJ2-1
TGTGCCAGCAGCCAAGAGGACAGGGGAAAGTACACCGGGGAGCTGTTTTTT	CASSQEDRGKYTGELFF	TRBV3-1	TRBJ2-2
TGTGCCAGCACGCCGGGGCAGCCCCAGCATTTT	CASTPGQPQHF	TRBV5-6	TRBJ1-5
TGTGCCAGCAGTGACGCAAACAGGGGGGAAGTTAACTATGGCTACACCTTC	CASSDANRGEVNYGYTF	TRBV6-4	TRBJ1-2
TGTGCCATCAGACGGGACGAGCAGTACTTC	CAIRRDEQYF	TRBV10-3	TRBJ2-7
TGTGCCAGCAGCCCAATTATGGGCCCCACGACCCGCTACGAGCAGTACTTC	CASSPIMGPTTRYEQYF	TRBV7-3	TRBJ2-7
TGTGCCAGCAGCGCCCCTGAAGGACTTAGCGGGAATAGCTCCTACAATGAGCAGTTCTTC	CASSAPEGLSGNSSYNEQFF	TRBV7-4	TRBJ2-1
TGCGCCAGCAGGGGCCCGGGACAGGGCGGGATCCTGGATATAAAGGGGGGCCTATCGAACACTGAAGCTTTCTTT	CASRGPGQGGILDIKGGLSNTEAFF	TRBV10-1	TRBJ1-1
TGTGCCAGCAAACCGAGGGCCTATCAGCCCCAGCATTTT	CASKPRAYQPQHF	TRBV11-2	TRBJ1-5
TGTGCCAGCAGGACTAGCGGGGGGAATGAGCAGTTCTTC	CASRTSGGNEQFF	TRBV9	TRBJ2-1
TGTGCCAGCTCACCAACCTGCAGGGCTTCCGGCAATCAGCCCCAGCATTTT	CASSPTCRASGNQPQHF	TRBV18	TRBJ1-5
TGTGCCAGCAGCCCCAATCTCCCATGGCGTGGGCTCAATGAAAAACTGTTTTTT	CASSPNLPWRGLNEKLFF	TRBV4-2	TRBJ1-4
TGTGCCAGCAGGAGGTCCCCCGGGGGGGCAGATACGCAGTATTTT	CASRRSPGGADTQYF	TRBV12-3	TRBJ2-3
TGTGCCATCAGCACGGACAGGCTGGGCTACACCTTC	CAISTDRLGYTF	TRBV10-3	TRBJ1-2
TGTGCCAGCAGCTCCAGTTACGTGTCACGGCGCCGCTATGGCTACACCTTC	CASSSSYVSRRRYGYTF	TRBV7-3	TRBJ1-2
TGTGCTAGTGGTTTGCCCGGACGAGGGGAGACCCAGTACTTC	CASGLPGRGETQYF	TRBV12-5	TRBJ2-5
TGTGCCAGCAGCCAAGATTCAACGGGACAGATGTTCTCTGGAAACACCATATATTTT	CASSQDSTGQMFSGNTIYF	TRBV3-1	TRBJ1-3
TGTGCCAGCAGCCAAAAAGGGGGGGAGTGTGAGCAGTTCTTC	CASSQKGGECEQFF	TRBV14	TRBJ2-1
TGTGCCAGCAGCACTCAGGGAAGGGGACGGGACCGTCCCGAGCAGTACTTC	CASSTQGRGRDRPEQYF	TRBV7-4	TRBJ2-7
TGTGCCAGCAGATGGACAGCTCAGCCCCAGCATTTT	CASRWTAQPQHF	TRBV6-6	TRBJ1-5
TGCAGTGCTAGTCGATTCAGCGGAAACACCATATATTTT	CSASRFSGNTIYF	TRBV20-1	TRBJ1-3
TGTGCCAGCGACAGTGCAGATACGCAGTATTTT	CASDSADTQYF	TRBV27	TRBJ2-3
TGTGCCACCCCAGGGATCTACAATGAGCAGTTCTTC	CATPGIYNEQFF	TRBV24-1	TRBJ2-1
TGTGCCATCAGTGCAGGGCCCGATTACGAGCAGTACTTC	CAISAGPDYEQYF	TRBV10-3	TRBJ2-7
TGTGCCAGCAAGTCTAGGGGGACAGGACCTCAGCCCCAGCATTTT	CASKSRGTGPQPQHF	TRBV27	TRBJ1-5
TGTGCCAGCAGCTTACCAAGGGGTCCGACTAGAGGGGATTGCTACGAGCAGTACTTC	CASSLPRGPTRGDCYEQYF	TRBV7-3	TRBJ2-7
TGTGCCAAAATGGGCAGGGGGCCTCGAGGGCGTAATGAGCAGTTCTTC	CAKMGRGPRGRNEQFF	TRBV9	TRBJ2-1
TGTGCCACCGTGGGACTAGCGATCTATAGCACAGATACGCAGTATTTT	CATVGLAIYSTDTQYF	TRBV24-1	TRBJ2-3
TGTGCTAGTGGTACTGGACTAGCGGGAGCCATGAACACTGAAGCTTTCTTT	CASGTGLAGAMNTEAFF	TRBV12-5	TRBJ1-1
TGTGCCAGCAGCCATGCGGGAGGGCAAGACACTGAAGCTTTCTTT	CASSHAGGQDTEAFF	TRBV14	TRBJ1-1
TGTGCCAGCAGCTTGGGGAGGGGGCGGAAAGAAAAACTGTTTTTT	CASSLGRGRKEKLFF	TRBV11-3	TRBJ1-4
TGTGCCAGCAGCCGGGGGGGGTGGACCAACTATGGCTACACCTTC	CASSRGGWTNYGYTF	TRBV13	TRBJ1-2
TGCAGCGTTGCTAGCGGGTGCTACGAGCAGTACTTC	CSVASGCYEQYF	TRBV29-1	TRBJ2-7
TGTGCCAGCAGGTACAAAGGGGAGCAGTACTTC	CASRYKGEQYF	TRBV6-3	TRBJ2-7
TGTGCCAGCAGCTCTGGGGCTCACGAGCAGTACTTC	CASSSGAHEQYF	TRBV9	TRBJ2-7
TGTGCCAGCAGCCCCCGGTCGGCGGAGACCCAGTACTTC	CASSPRSAETQYF	TRBV3-1	TRBJ2-5
TGTGCCAGCAGCTTGGCGGGGACCGGGACAGGGTCTGAAGCTTTCTTT	CASSLAGTGTGSEAFF	TRBV5-4	TRBJ1-1
TGCGCCAGCAGCCATACAGGGCGGAGTTGTAGCAATCAGCCCCAGCATTTT	CASSHTGRSCSNQPQHF	TRBV5-1	TRBJ1-5
TGTGCCAGCAGCAACCAGCTGCGAGGGGGGGTAGTTTGCGGCCAAGATACGCAGTATTTT	CASSNQLRGGVVCGQDTQYF	TRBV13	TRBJ2-3
TGTGCCAGCTCAAGCAGTGGGGTCCGAGAGACCCAGTACTTC	CASSSSGVRETQYF	TRBV18	TRBJ2-5
TGCGCCAGCCCACCCGACAGATCTTACCGAGAAAAACTGTTTTTT	CASPPDRSYREKLFF	TRBV10-1	TRBJ1-4
TGTGCCAGCAGTTACATTCGAGAGAGGGGGGGGTTACCGACCCCAGATACGCAGTATTTT	CASSYIRERGGLPTPDTQYF	TRBV6-5	TRBJ2-3
TGTGCCAGCAGCGGGATGGGGGATGGCTACACCTTC	CASSGMGDGYTF	TRBV9	TRBJ1-2
TGTGCCAGCAGCTTAGCACAGAAGATCTATGGCTACACCTTC	CASSLAQKIYGYTF	TRBV11-3	TRBJ1-2
TGTGCCAGCAGCTTAGATCACCCGGGACTAGCGGGAGTTGGATACGAGCAGTACTTC	CASSLDHPGLAGVGYEQYF	TRBV11-2	TRBJ2-7
TGTGCCAGCAGCTTTTCTCCCCACAATGAGCAGTTCTTC	CASSFSPHNEQFF	TRBV7-9	TRBJ2-1
TGCGCCAGCAGCCCCCAGGGACAAAGGTTATGTCAGCCCCAGCATTTT	CASSPQGQRLCQPQHF	TRBV5-1	TRBJ1-5
TGTGCCAGCAGCTTAGCAGGCCACAGGGAGCCCCAGCATTTT	CASSLAGHREPQHF	TRBV7-4	TRBJ1-5
TGTGCCAGCAGCGTATCCACCCGGGACAGGGGGCGCTTCGATGGCTACACCTTC	CASSVSTRDRGRFDGYTF	TRBV9	TRBJ1-2
TGTGCCAGCAGCTTGGCCACCCGCCCCAGCGCAACTAATGAAAAACTGTTTTTT	CASSLATRPSATNEKLFF	TRBV5-4	TRBJ1-4
TGTGCCAGCAGTTTCGAGGCGGGATTCTACACAGATACGCAGTATTTT	CASSFEAGFYTDTQYF	TRBV12-4	TRBJ2-3
TGTGCCAGCAGTGATGTCCGCGGCACAGATACGCAGTATTTT	CASSDVRGTDTQYF	TRBV6-4	TRBJ2-3
TGCGCCAGCAGCTTGTACAACAGAAGGGAAGGGGCAACTAATGAAAAACTGTTTTTT	CASSLYNRREGATNEKLFF	TRBV5-1	TRBJ1-4
TGTGCCAGGGGGGTATACGAGCAGTACTTC	CARGVYEQYF	TRBV7-2	TRBJ2-7
TGTGCCAGCAGCCAAGATGGACTTCCCCCAGGACAGGGCGAAGAGACCCAGTACTTC	CASSQDGLPPGQGEETQYF	TRBV3-1	TRBJ2-5
TGTGCCAGCAGCTTGATGGGGGAGAATCAGCCCCAGCATTTT	CASSLMGENQPQHF	TRBV7-4	TRBJ1-5
TGTGCCAGCAGTAGCTGGAACACTGAAGCTTTCTTT	CASSSWNTEAFF	TRBV6-1	TRBJ1-1
TGTGCCAGCAGCTTGCAGAAGGACAACTATTCACCCCTCCACTTT	CASSLQKDNYSPLHF	TRBV7-2	TRBJ1-6
TGTGCCAGCAGTGAACCAGGGAGATCAGATACGCAGTATTTT	CASSEPGRSDTQYF	TRBV6-1	TRBJ2-3
TGTGCCAGCAGCCACGGCGGGGTCCCCGGATATGGCTACACCTTC	CASSHGGVPGYGYTF	TRBV3-1	TRBJ1-2
TGTGCCAGCAGCCGTAAAACACAGGACGCCAACACCGGGGAGCTGTTTTTT	CASSRKTQDANTGELFF	TRBV3-1	TRBJ2-2
TGTGCCAGCAGCTTGGCCGTGGACAGGAGTTCGGCTAACTATGGCTACACCTTC	CASSLAVDRSSANYGYTF	TRBV5-4	TRBJ1-2
TGCGCCAGCAGCTCCCCCCCTGGGACCCCCCGAGGCTACACCTTC	CASSSPPGTPRGYTF	TRBV5-1	TRBJ1-2
TGCGCCAGCAGAGGGCTTGTCCTATTGACCTCCTACGAGCAGTACTTC	CASRGLVLLTSYEQYF	TRBV10-1	TRBJ2-7
TGTGCCAGCAGCCCCGAAATGAAAGCGGGAAGGTGGCCGAATGAAAAACTGTTTTTT	CASSPEMKAGRWPNEKLFF	TRBV7-3	TRBJ1-4
TGTGCCAGCAGTAAATATTCAGGGCCGGGCTACACCTTC	CASSKYSGPGYTF	TRBV6-2	TRBJ1-2
TGCGCCAGCAGCGTAAGACAGGATCTCCATAGCTCCTACGAGCAGTACTTC	CASSVRQDLHSSYEQYF	TRBV4-3	TRBJ2-7
TGTGCCTGGCCATCTAGATGGGGCTTGAACACTGAAGCTTTCTTT	CAWPSRWGLNTEAFF	TRBV30	TRBJ1-1
TGTGCCAGCAGCGATGGCGGGACAGGGATCACCGGGGAGCTGTTTTTT	CASSDGGTGITGELFF	TRBV6-5	TRBJ2-2
TGCCCGCCAACAGATAATGAAAAACTGTTTTTT	CPPTDNEKLFF	TRBV20-1	TRBJ1-4
TGCAGCGTTCTCCATAAAGCCGACACAGCTCAGCCCCAGCATTTT	CSVLHKADTAQPQHF	TRBV29-1	TRBJ1-5
TGTGCCAGCAGCTCCTGGGGGTTTTTGGTTGGAAACACCATATATTTT	CASSSWGFLVGNTIYF	TRBV7-3	TRBJ1-3
TGTGCCAGCATAGGGAAGATATGGGCCTACGAGCAGTACTTC	CASIGKIWAYEQYF	TRBV7-8	TRBJ2-7
TGTGCCAGCTCACCGGGAGGCCACGGAAACATTCAGTACTTC	CASSPGGHGNIQYF	TRBV18	TRBJ2-4
TGTGCCACCCCTCCTAACAGGGATTGGGGAAAACACGGCTACACCTTC	CATPPNRDWGKHGYTF	TRBV6-5	TRBJ1-2
TGCGCCAGCAAAACCGGGAGTGGGGAGCTGTTTTTT	CASKTGSGELFF	TRBV10-2	TRBJ2-2
TGTGCCAGCAGTTATATCCAGGGGAGGGGGTCCAAAAACATTCAGTACTTC	CASSYIQGRGSKNIQYF	TRBV6-5	TRBJ2-4
TGTGCCAGCAGCGAGGCTCCCCGGGACAGGGGGGTCGGATCCTATAATTCACCCCTCCACTTT	CASSEAPRDRGVGSYNSPLHF	TRBV6-3	TRBJ1-6
TGTGCCAGCAGTGAAGCCGCACAGGAGGGTCAGCCCCAGCATTTT	CASSEAAQEGQPQHF	TRBV2	TRBJ1-5
TGCAGTGCTAGAGTGGGGGGGGGGGAGCAGTACTTC	CSARVGGGEQYF	TRBV20-1	TRBJ2-7
TGCGCCAGCAGCTGGAATATAACTAGCGGGAGCAGGACAGATACGCAGTATTTT	CASSWNITSGSRTDTQYF	TRBV5-1	TRBJ2-3
TGTGCCAGCAGTGGACAGGGGGACTATGGCTACACCTTC	CASSGQGDYGYTF	TRBV6-1	TRBJ1-2
TGTGCCAGCAGCGCCGGGGGAGGGGGGGGTGGCTACACCTTC	CASSAGGGGGGYTF	TRBV13	TRBJ1-2
TGCGCCAGCAGCTTGGCTAAGCAGGCCCTGGATACGCAGTATTTT	CASSLAKQALDTQYF	TRBV5-1	TRBJ2-3
TGTGCCAGCAGGAGGGCAGGGGAAGGATGCTCCTATAATTCACCCCTCCACTTT	CASRRAGEGCSYNSPLHF	TRBV6-8	TRBJ1-6
TGTGCCAGCAGCGGAGGACAACAGGGCAGTCCTGTCGAGCAGTACTTC	CASSGGQQGSPVEQYF	TRBV7-3	TRBJ2-7
TGTGCCAGCAGTCCGACAGGGGGCTTTCGGGACCACTATGCTTTCTTT	CASSPTGGFRDHYAFF	TRBV28	TRBJ1-1
TGTTGGCCGGAACTCTACAATGAGCAGTTCTTC	CWPELYNEQFF	TRBV19	TRBJ2-1
TGTGCCAGTAGTAGGAACCGGGGGGGATCAACAGAGACCCAGTACTTC	CASSRNRGGSTETQYF	TRBV19	TRBJ2-5
TGTGCCAGCAGTTACCTGAAGAACACTGAAGCTTTCTTT	CASSYLKNTEAFF	TRBV6-6	TRBJ1-1
TGTGCCAGCAGCGAGGAGACAGGAATTAGCCAAGAGACCCAGTACTTC	CASSEETGISQETQYF	TRBV9	TRBJ2-5
TGTGCCAGCAGAGCCCTAGCGGGCGGCGAGCAGTACTTC	CASRALAGGEQYF	TRBV7-9	TRBJ2-7
TGTGCCAGCAGCCTGTCAGATCAGAACACCGGGGAGCTGTTTTTT	CASSLSDQNTGELFF	TRBV13	TRBJ2-2
TGTGCCAGCAGCTTAGCGGGACATTACGAAAAACTGTTTTTT	CASSLAGHYEKLFF	TRBV11-3	TRBJ1-4
TGTGCCAGCAGGACTAGCGGGATCGAAAGGAACGAGCAGTACTTC	CASRTSGIERNEQYF	TRBV7-2	TRBJ2-7
TGTGCCAGCCACCGGAAATCACCCCTCCACTTT	CASHRKSPLHF	TRBV27	TRBJ1-6
TGTGCCAGCAGTTTCAAGGAGGGGATCATTTGCTCCTACAATGAGCAGTTCTTC	CASSFKEGIICSYNEQFF	TRBV6-5	TRBJ2-1
TGTGCCAGCAGCTTAGAGGAGGAGACCCAGTACTTC	CASSLEEETQYF	TRBV11-2	TRBJ2-5
TGTGCCAGCAGCCAAGACAGGTGTGTAAACACCTTC	CASSQDRCVNTF	TRBV9	TRBJ1-2
TGTGCCAGCAGGGAGCGGGAATCCAGAGATACGCAGTATTTT	CASRERESRDTQYF	TRBV7-6	TRBJ2-3
TGTGCCAGCAGCCGCTGTGAGGGGGACTATGGCTACACCTTC	CASSRCEGDYGYTF	TRBV3-1	TRBJ1-2
TGCGCCAGCAGTGAGTCTCGAGCGGCAAAGCGTAACGAGCAGTACTTC	CASSESRAAKRNEQYF	TRBV10-1	TRBJ2-7
TGTGCCAGCAGCCAAGCGGGGACAGGGGGGAGCAATGAGCAGTTCTTC	CASSQAGTGGSNEQFF	TRBV3-1	TRBJ2-1
TGTGCCACCAGTGAGGTGACTAGCGGGGGGGCCCAAGGCGGGGAGCTGTTTTTT	CATSEVTSGGAQGGELFF	TRBV24-1	TRBJ2-2
TGCGCCAGCAGCACCCCCCGGGACAGGGTTGATTCTAGCACAGATACGCAGTATTTT	CASSTPRDRVDSSTDTQYF	TRBV5-1	TRBJ2-3
TGCAGCGTAATGTTAGGCGAAGAGACCCAGTACTTC	CSVMLGEETQYF	TRBV29-1	TRBJ2-5
TGTGCCAGCAGTTATTGGGCCGCGGAGAGTACCTACAATGAGCAGTTCTTC	CASSYWAAESTYNEQFF	TRBV6-9	TRBJ2-1
TGTGCCAGCAGTCCAAGTCACTATGGCTACACCTTC	CASSPSHYGYTF	TRBV13	TRBJ1-2
TGTGCCAGCACGGGACAGGGGGCGGAGCCCCAGCATTTT	CASTGQGAEPQHF	TRBV28	TRBJ1-5
TGTGCCAGCAGAAAAAAACCGGGACAGGCTACCTACGAGCAGTACTTC	CASRKKPGQATYEQYF	TRBV27	TRBJ2-7
TGTGCCAGCAGCTCACAGTACGACAGTCGGAGGACGCAGTATTTT	CASSSQYDSRRTQYF	TRBV5-4	TRBJ2-3
TGTGCCAGCAGCTTAGGCTGCCCCTGGGGGAGGAGGGAAGAGACCCAGTACTTC	CASSLGCPWGRREETQYF	TRBV11-2	TRBJ2-5
TGTGCCAGCAGCGTACGGGGAATTGGGACTGATGAGCAGTTCTTC	CASSVRGIGTDEQFF	TRBV7-9	TRBJ2-1
TGTGCCAGCAGTTATGGACATCAGCCCCAGCATTTT	CASSYGHQPQHF	TRBV6-5	TRBJ1-5
TGTGCCAGCTGTCGGGGCAGTCAAAGCAATCAGCCCCAGCATTTT	CASCRGSQSNQPQHF	TRBV7-2	TRBJ1-5
TGCGCCAGCAGCACTGGGACTAGAGGCTCCTACGAGCAGTACTTC	CASSTGTRGSYEQYF	TRBV5-1	TRBJ2-7
TGTGCCAGCAGAACCGGACGAAAGGCTGAAGCTTTCTTT	CASRTGRKAEAFF	TRBV14	TRBJ1-1
TGCGCCAGCAGCTTGGAGTCCTATATACTAGCGGGAGTCACTAATGAAAAACTGTTTTTT	CASSLESYILAGVTNEKLFF	TRBV5-1	TRBJ1-4
TGTGCCAGCTCCACCAGGGGGGGCGAGCAGTACTTC	CASSTRGGEQYF	TRBV18	TRBJ2-7
TGCGCCAGCAGCTTGCGGGAGGGGGCCCGTAACGAGCAGTACTTC	CASSLREGARNEQYF	TRBV5-1	TRBJ2-7
TGCAGTGGAGGCAGGATGAACACTGAAGCTTTCTTT	CSGGRMNTEAFF	TRBV20-1	TRBJ1-1
TGTGCCAGCAGGGTGACGGCTGAAAGGGGAAGGGGGCCCGCGTACTACAATGAGCAGTTCTTC	CASRVTAERGRGPAYYNEQFF	TRBV2	TRBJ2-1
TGTGCCAGCAGCCCCTCCGGCGGGTGGTGCTTCTTC	CASSPSGGWCFF	TRBV3-1	TRBJ2-1
TGCAGTGCTAGAGCGGGACTAGCGGGGAGCAATGAGCAGTTCTTC	CSARAGLAGSNEQFF	TRBV20-1	TRBJ2-1
TGTGCCAGCATCCAATACCCGGCGAACACCGGGGAGCTGTTTTTT	CASIQYPANTGELFF	TRBV6-5	TRBJ2-2
TGTGCCAGCAGCTTACCTAACGGCATGAGGCCTTTTAATGAAAAACTGTTTTTT	CASSLPNGMRPFNEKLFF	TRBV11-2	TRBJ1-4
TGTGCCACCAGTGATTTAAGTCTTAACACTAGCGGGAGGGCTACGGCTAACACTGAAGCTTTCTTT	CATSDLSLNTSGRATANTEAFF	TRBV24-1	TRBJ1-1
TGTGCCATCCGGGGGGGCTACACCTTC	CAIRGGYTF	TRBV19	TRBJ1-2
TGTGCCAGGATGGGACAGAGGTATGGCTACACCTTC	CARMGQRYGYTF	TRBV6-5	TRBJ1-2
TGTGCCAGCAGCTTGGGGGGGTTAGATGAGCAGTTCTTC	CASSLGGLDEQFF	TRBV5-5	TRBJ2-1
TGTGCCAGCAGCCCTGGAGGGAACGAAAAGCACGAGCAGTACTTC	CASSPGGNEKHEQYF	TRBV11-3	TRBJ2-7
TGTGCCACCAGTGATTTGACCTGCTTACAGGGGGCAGTTTACAAGCAGCCCCAGCATTTT	CATSDLTCLQGAVYKQPQHF	TRBV24-1	TRBJ1-5
TGTGCCATCCCTCTTTTCGGGACAGGGGGCCCAAGCTCCTATAATTCACCCCTCCACTTT	CAIPLFGTGGPSSYNSPLHF	TRBV27	TRBJ1-6
TGTGCCAGCAGCTTCTGGGACCCCGGGACTAGCGGGAGGTCCGATGACAATGAGCAGTTCTTC	CASSFWDPGTSGRSDDNEQFF	TRBV5-6	TRBJ2-1
TGTGCCAGCAGCCAAGATGGGGGGGAAGGAAGCCCACGCTACGAGCAGTACTTC	CASSQDGGEGSPRYEQYF	TRBV14	TRBJ2-7
TGTGCCAGCAGTTCCCATCCCGAAAGGGCTAACTATGGCTACACCTTC	CASSSHPERANYGYTF	TRBV28	TRBJ1-2
TGTGCCAGCAGCGTAAACAACTACAAAGGGTTCTCTGGGGCCAACGTCCTGACTTTC	CASSVNNYKGFSGANVLTF	TRBV13	TRBJ2-6
TGTGCCAGCAGCTCTGAGCGTTCCGGGGTAGTGAACATTCAGTACTTC	CASSSERSGVVNIQYF	TRBV7-2	TRBJ2-4
TGTGCCAGCAGTCGGCGGGGATTCATGAACACTGAAGCTTTCTTT	CASSRRGFMNTEAFF	TRBV6-4	TRBJ1-1
TGTGCCAGCAGTGGAGGACAGGGCCCTGAAGCTTTCTTT	CASSGGQGPEAFF	TRBV6-1	TRBJ1-1
TGTGCCAGCAGCCTGCCGTCTGGGGAGCCCAAAAACATTCAGTACTTC	CASSLPSGEPKNIQYF	TRBV7-3	TRBJ2-4
TGCGCCAGCAGTGAGCGGGGGGCTAATGAGCAGTTCTTC	CASSERGANEQFF	TRBV10-1	TRBJ2-1
TGCGCCGTCCCCCCGGTAGGGGAGCAGTTCTTC	CAVPPVGEQFF	TRBV10-2	TRBJ2-1
TGTGCCAGCAGCTTAGAGGAACTAAGCAACCTTACAGATACGCAGTATTTT	CASSLEELSNLTDTQYF	TRBV11-2	TRBJ2-3
TGTGCCAGCCCCGCGGGAGCCGCGGACTCCTACGAGCAGTACTTC	CASPAGAADSYEQYF	TRBV12-3	TRBJ2-7
TGCAGTGCTAGTTGCCTGAGGGTTGGCCGGGACAGTTATGGCTACACCTTC	CSASCLRVGRDSYGYTF	TRBV20-1	TRBJ1-2
TGTGCCAGCAGTGAAGCTATACTGGGACAGGGGGGGGTTTATAGCAATCAGCCCCAGCATTTT	CASSEAILGQGGVYSNQPQHF	TRBV6-1	TRBJ1-5
TGTGCCAGCAGCAGTACGACATACTCCTACGAGCAGTACTTC	CASSSTTYSYEQYF	TRBV13	TRBJ2-7
TGTGCCAGCAGCTTAGATGACAACAATGAGCAGTTCTTC	CASSLDDNNEQFF	TRBV11-3	TRBJ2-1
TGTGCCAGCAGTGGTGGCCTGAGACCAGGGGTGACGTCCTCCTACGAGCAGTACTTC	CASSGGLRPGVTSSYEQYF	TRBV27	TRBJ2-7
TGTGCCAGCAGCGGATGCAATCCACTAGCGGGAGTAGACAATCAGCCCCAGCATTTT	CASSGCNPLAGVDNQPQHF	TRBV7-9	TRBJ1-5
TGTGCTAGCAGCCCAAGGAGTTCCCCCTACGAGCAGTACTTC	CASSPRSSPYEQYF	TRBV7-7	TRBJ2-7
TGTGCCAGCAGGAGGGGCGCTACCTCAAAGTACACCTTC	CASRRGATSKYTF	TRBV3-1	TRBJ1-2
TGTGCCAGCAGCCCAGTCAGAGGACAGAGACCCTACGAGCAGTACTTC	CASSPVRGQRPYEQYF	TRBV14	TRBJ2-7
TGCACAGCAGGGATGAGCTCCTATAATTCACCCCTCCACTTT	CTAGMSSYNSPLHF	TRBV20-1	TRBJ1-6
TGTGCCAGCAGCTTATGTGACGACGGGAAAGAGACCCAGTACTTC	CASSLCDDGKETQYF	TRBV7-4	TRBJ2-5
TGTGCCAGCAGTGGCCAACTAAACGGGATTAGTAACTATGGCTACACCTTC	CASSGQLNGISNYGYTF	TRBV6-6	TRBJ1-2
TGTGCCAGCCGGGGCACTGAAGCTTTCTTT	CASRGTEAFF	TRBV27	TRBJ1-1
TGCAGCGTTGGCAGCTACGAGCAGTACTTC	CSVGSYEQYF	TRBV29-1	TRBJ2-7
TGTGCCAGCAGCGGGGGTCCGGAAGGCATCAACACAGATACGCAGTATTTT	CASSGGPEGINTDTQYF	TRBV7-6	TRBJ2-3
TGCGCCAGCAGCCAAGCAGGCTCCTACGAGCAGTACTTC	CASSQAGSYEQYF	TRBV4-1	TRBJ2-7
TGCAGCGTTGAAGATTTGCCGGTCTCTGAGAGGACCGCTGGAAGGATGAACACTGAAGCTTTCTTT	CSVEDLPVSERTAGRMNTEAFF	TRBV29-1	TRBJ1-1
TGTGCCAGCAGCTTCGGGACATGGCCACATGAGCAGTTCTTC	CASSFGTWPHEQFF	TRBV7-8	TRBJ2-1
TGTGCCAGCATAAAGAGAACCTACGAGCAGTACTTC	CASIKRTYEQYF	TRBV6-6	TRBJ2-7
TGTGCCAGCAGCCTCAGAGGTTCAGATACGCAGTATTTT	CASSLRGSDTQYF	TRBV5-6	TRBJ2-3
TGTGCCAGCAGCGACCGGGACAGGGTGCCTCAGCCCCAGCATTTT	CASSDRDRVPQPQHF	TRBV7-3	TRBJ1-5
TGCGCCAGCAGCGTAGGGACAGCGCCAGATACGCAGTATTTT	CASSVGTAPDTQYF	TRBV5-1	TRBJ2-3
TGCAGCGTTCCCTACTACGAGCAGTACTTC	CSVPYYEQYF	TRBV29-1	TRBJ2-7
TGTGCCAGCAGCGGAAGCCCGGGACAGGGGGCCTACGAGCAGTACTTC	CASSGSPGQGAYEQYF	TRBV13	TRBJ2-7
TGCGCCAGCAGCCAAGATCTAAGTCCCATCACAGGGGTTGAAGAGACCCAGTACTTC	CASSQDLSPITGVEETQYF	TRBV4-3	TRBJ2-5
TGTGCCAGCAGCGTAGAAGCCACTCTTAACGCAGAGCACGAAGCTTTCTTT	CASSVEATLNAEHEAFF	TRBV9	TRBJ1-1
TGTGCCAGCTCACATATCCTGGCCCGGCGATCCTACAATGAGCAGTTCTTC	CASSHILARRSYNEQFF	TRBV18	TRBJ2-1
TGTGCCAGCAGTACGGGGCTAGGCTACGAGCAGTACTTC	CASSTGLGYEQYF	TRBV12-4	TRBJ2-7
TGTGCCAGCAGCCAAGATTCAGGGCCCGGCACAGATACGCAGTATTTT	CASSQDSGPGTDTQYF	TRBV14	TRBJ2-3
TGTGCCAGCAGTGAAGCGCTTGGCTGGGGGGACGAGCAGTACTTC	CASSEALGWGDEQYF	TRBV2	TRBJ2-7
TGCAGTGCTACCGGGGGGACACATAATTCACCCCTCCACTTT	CSATGGTHNSPLHF	TRBV20-1	TRBJ1-6
TGTGCCAGCAGCCAACCATCCCAGCTCAGCAATCAGCCCCAGCATTTT	CASSQPSQLSNQPQHF	TRBV3-1	TRBJ1-5
TGTGCCAGCGGGCCTTGGTCCCGGGGACTGGTGAACAATGAGCAGTTCTTC	CASGPWSRGLVNNEQFF	TRBV7-9	TRBJ2-1
TGCGCCAGCAGTGGGACTAGCGGGAACCGTAGCGAGCAGTACTTC	CASSGTSGNRSEQYF	TRBV10-1	TRBJ2-7
TGTGCCAGCAGCGTCCGGGGAGGGGCAAACACCGGGGAGCTGTTTTTT	CASSVRGGANTGELFF	TRBV13	TRBJ2-2
TGTGCCAGCGAAGACAGGGGTGGTAACTATGGCTACACCTTC	CASEDRGGNYGYTF	TRBV7-3	TRBJ1-2
TGTGCCAGCAGCCAAGAGCTCCAGTTAACCGGGACAGGGGGCACCACCTACGAGCAGTACTTC	CASSQELQLTGTGGTTYEQYF	TRBV3-1	TRBJ2-7
TGCAGTGCTAGAGATAGACCTGGCACAGATACGCAGTATTTT	CSARDRPGTDTQYF	TRBV20-1	TRBJ2-3
TGTGCTAGTGGTTTGGTAAGCGGTAAGAGTCGGGCGTTCCGACTCACGGAAGAGACCCAGTACTTC	CASGLVSGKSRAFRLTEETQYF	TRBV12-5	TRBJ2-5
TGCGCCAGCAGCCAAGATAAGACCTGTAGCAATCAGCCCCAGCATTTT	CASSQDKTCSNQPQHF	TRBV4-1	TRBJ1-5
TGCGCCAGCAGCTCTCCTTGCCGGGGGCGCAACACCGGGGAGCTGTTTTTT	CASSSPCRGRNTGELFF	TRBV5-1	TRBJ2-2
TGTGCCACCCTGCGGGCCAACGTCCTGACTTTC	CATLRANVLTF	TRBV24-1	TRBJ2-6
TGCACTTTGGGACTAGCGGGGGGGGGGGTAGATACGCAGTATTTT	CTLGLAGGGVDTQYF	TRBV20-1	TRBJ2-3
TGTGCCAGCAGCCAAGCCAGGGGGCAAAGCTGGAGCACAGATACGCAGTATTTT	CASSQARGQSWSTDTQYF	TRBV3-1	TRBJ2-3
TGTGCCAGCAGCCAGAGGGTTCGTGTGCAGTACTTC	CASSQRVRVQYF	TRBV4-2	TRBJ2-7
TGTGCCAGCAGCGTGGAGTTTCTGGGCAATGAGCAGTTCTTC	CASSVEFLGNEQFF	TRBV9	TRBJ2-1
TGTGCCAGCAGAGTAACTACCTATGAAAAACTGTTTTTT	CASRVTTYEKLFF	TRBV11-3	TRBJ1-4
TGTGCCAGCAGCTTACCTAACGAACGGAGCTACGAGCAGTACTTC	CASSLPNERSYEQYF	TRBV7-9	TRBJ2-7
TGTGCCAGTAGTATAAGCTGTGTCAATTCACCCCTCCACTTT	CASSISCVNSPLHF	TRBV19	TRBJ1-6
TGTGCCAGCAGCTGCGACCACAGGGTGTTACAGCCCCAGCATTTT	CASSCDHRVLQPQHF	TRBV5-8	TRBJ1-5
TGTGCCAGCAGCCGTAAGGGAACTGAAGCTTTCTTT	CASSRKGTEAFF	TRBV11-2	TRBJ1-1
TGTGCCAGCAGCTCCCCAGGGGGCCGACAACGCTACGAGCAGTACTTC	CASSSPGGRQRYEQYF	TRBV7-8	TRBJ2-7
TGTGCCACCGCCCGCCTGGAGAGGTCACCCCTCCACTTT	CATARLERSPLHF	TRBV24-1	TRBJ1-6
TGTGCTATAAGAGGGACTAGCGGCTCCGGGGCCAACGTCCTGACTTTC	CAIRGTSGSGANVLTF	TRBV9	TRBJ2-6
TGTGCCAGCAGTTTGGGGGCCAATCAGCCCCAGCATTTT	CASSLGANQPQHF	TRBV28	TRBJ1-5
TGTGCCAGTAGTATCCGTAGTGGAGGGGGCGGTTGGTCCTACGAGCAGTACTTC	CASSIRSGGGGWSYEQYF	TRBV19	TRBJ2-7
TGTGCCAGCCCAGGGGGCTCCTACGAGCAGTACTTC	CASPGGSYEQYF	TRBV19	TRBJ2-7
TGTGCCAGCAGTTCACCAGGGCGGCATGGCTACACCTTC	CASSSPGRHGYTF	TRBV28	TRBJ1-2
TGTGCCAGCGTCGGGACAGGGCAAGAGACCCAGTACTTC	CASVGTGQETQYF	TRBV9	TRBJ2-5
TGCGCCAGCAGTTTCAATGACATTCATTGCAATCAGCCCCAGCATTTT	CASSFNDIHCNQPQHF	TRBV10-1	TRBJ1-5
TGCGCCAGCAGCCAGGCCCGGGAACCCCCGGGGGGAGGGAGAGAGGCCAAAAACATTCAGTACTTC	CASSQAREPPGGGREAKNIQYF	TRBV4-1	TRBJ2-4
TGTGCCAGCTCACCAAGTCGGGCTGAGACCCAGTACTTC	CASSPSRAETQYF	TRBV18	TRBJ2-5
TGCGCCAGCATTGGCTTAGTGGCTTTCTTT	CASIGLVAFF	TRBV10-2	TRBJ1-1
TGTGCCAGCAAGGGACAGAGTTGGATAATCTACGAGCAGTACTTC	CASKGQSWIIYEQYF	TRBV5-6	TRBJ2-7
TGTGCCAGCCGCCGGGACAGGGGCCGGCAGCCCCAGCATTTT	CASRRDRGRQPQHF	TRBV6-4	TRBJ1-5
TGTGCCAGCACCCAGGGAACCGGGGAGCTGTTTTTT	CASTQGTGELFF	TRBV12-4	TRBJ2-2
TGTGCCAGCAGTTATTCGGCCGGGACTAGATATGAGCAGTTCTTC	CASSYSAGTRYEQFF	TRBV6-9	TRBJ2-1
TGTGCCAGCAGTCCACTCTCGGGATTAGAAGCCTTTTTTTCCTACAATGAGCAGTTCTTC	CASSPLSGLEAFFSYNEQFF	TRBV6-4	TRBJ2-1
TGTGCCAGCAGCCCGGGAGGCCCTGAACTTGGGAGCAATCAGCCCCAGCATTTT	CASSPGGPELGSNQPQHF	TRBV7-8	TRBJ1-5
TGCGCCAGCAGTATCCAGGGGGCGTTGGTTCGGTCCTACGAGCAGTACTTC	CASSIQGALVRSYEQYF	TRBV5-1	TRBJ2-7
TGTGCCAGCAGAAGGCGCTCAGGGGTCCGGGAGGACGAGCAGTACTTC	CASRRRSGVREDEQYF	TRBV9	TRBJ2-7
TGTGCCAGGGGTACAGGGCACTTCGGCTACGAGCAGTACTTC	CARGTGHFGYEQYF	TRBV6-5	TRBJ2-7
TGTGCCAGTAGCCTCCCGACTCTTTGCACTAATGAAAAACTGTTTTTT	CASSLPTLCTNEKLFF	TRBV19	TRBJ1-4
TGTGCCAGCAGTTTTCCGGGCTTTCCAAACATTCAGTACTTC	CASSFPGFPNIQYF	TRBV28	TRBJ2-4
TGTGCCAGCAGCTTACGACAGGGGGAGCGGCACTATGGCTACACCTTC	CASSLRQGERHYGYTF	TRBV5-4	TRBJ1-2
TGTGCCAGCAGTGACTCGCCAGGACATGGTTCTCTCGGCTACACCTTC	CASSDSPGHGSLGYTF	TRBV6-4	TRBJ1-2
TGTGCCAGCAGCCAAAGTCGGACAGGGCATACGCAGTATTTT	CASSQSRTGHTQYF	TRBV14	TRBJ2-3
TGTGCCAGCAGCCCCCCGGGCAAAGGGTTACACGAGCAGTACTTC	CASSPPGKGLHEQYF	TRBV7-3	TRBJ2-7
TGCAGTGCGGTCTCTTCGGAGGACGAGGCTAGCAATCAGCCCCAGCATTTT	CSAVSSEDEASNQPQHF	TRBV20-1	TRBJ1-5
TGTGCCAGCAGAAGGGACAGGGAAGGGTTCGGCTCCTACGAGCAGTACTTC	CASRRDREGFGSYEQYF	TRBV6-4	TRBJ2-7
TGTGCCAGCAGGGAGGGTTGGGTGGGGAAGTCCACCGGGGAGCTGTTTTTT	CASREGWVGKSTGELFF	TRBV28	TRBJ2-2
TGTGCCACCAGTGATTTGCATATAAGGGCAGATACGCAGTATTTT	CATSDLHIRADTQYF	TRBV24-1	TRBJ2-3
TGCGCCAGCAGCTACCTCCTGGGAAACACCATATATTTT	CASSYLLGNTIYF	TRBV5-1	TRBJ1-3
TGTGCCAGCAGCGGGGTAAGCAGAATCCAAGAGACCCAGTACTTC	CASSGVSRIQETQYF	TRBV13	TRBJ2-5
TGCAGTGCTAGCGACGACGTGTCCGGTAAGTCCTACAATGAGCAGTTCTTC	CSASDDVSGKSYNEQFF	TRBV20-1	TRBJ2-1
TGCAGTGCTAGAGACTCCCAGTCCTCTGAACGTCCCACCGGGGAGCTGTTTTTT	CSARDSQSSERPTGELFF	TRBV20-1	TRBJ2-2
TGCAGTGCTAGAGGGGGGACTAGCGGGTCGACCGGGGAGCTGTTTTTT	CSARGGTSGSTGELFF	TRBV20-1	TRBJ2-2
TGTGCCAGCAGTTACTCGCGACCCGGTCCGGGACAGGGGGGGCTTCGGCAAGAGACCCAGTACTTC	CASSYSRPGPGQGGLRQETQYF	TRBV6-3	TRBJ2-5
TGTGCCAGCACGGGGACAAAACGATGCTCCTACGAGCAGTACTTC	CASTGTKRCSYEQYF	TRBV7-9	TRBJ2-7
TGTGCCAGCAGCTTAGATCGCGGGATGGCCTATGGCTACACCTTC	CASSLDRGMAYGYTF	TRBV11-2	TRBJ1-2
TGTGCCAGCAGCAGCGGGCTTTACTACAATGAGCAGTTCTTC	CASSSGLYYNEQFF	TRBV7-2	TRBJ2-1
TGTGCCAGCTCACCGTTGGGACCTTTTAATGAAAAACTGTTTTTT	CASSPLGPFNEKLFF	TRBV18	TRBJ1-4
TGTGCCAGCAAATACGCAAGGGTCCGAGAGGGGGGCTACACCTTC	CASKYARVREGGYTF	TRBV6-2	TRBJ1-2
TGTGCCAGCAGCTTGTATGAGCGGGAGAGCTCTTATAGCAATCAGCCCCAGCATTTT	CASSLYERESSYSNQPQHF	TRBV5-6	TRBJ1-5
TGTGCCAGCAGCTTAGACATGGTTCGGGGGCGCATGCCGGGCGACGAGCAGTACTTC	CASSLDMVRGRMPGDEQYF	TRBV7-9	TRBJ2-7
TGTGCCAGCAGAACTGAGAGCCGGCGCCTAAAGAACACTGAAGCTTTCTTT	CASRTESRRLKNTEAFF	TRBV6-5	TRBJ1-1
TGTGCCAGCAGGTTACAGGGGTCGCATGTCACCGGGGAGCTGTTTTTT	CASRLQGSHVTGELFF	TRBV2	TRBJ2-2
TGTGCCAGCAGCTTGGATGGGGCCGGGGAGCTGTTTTTT	CASSLDGAGELFF	TRBV5-5	TRBJ2-2
TGTGCCAGCAGTGACTCGATCGTCACAATTGGGGGCACTGAAGCTTTCTTT	CASSDSIVTIGGTEAFF	TRBV6-4	TRBJ1-1
TGTGCCAGCCCCGGGAAGTTAGGGGAGGGGACTGAAGCTTTCTTT	CASPGKLGEGTEAFF	TRBV5-6	TRBJ1-1
TGTGCCAGCAGCAATCGAGGGACAGGGGATAATGAGCAGTTCTTC	CASSNRGTGDNEQFF	TRBV7-9	TRBJ2-1
TGTGCCAGCAAAAGGGGGTTTTCCCATGAAAAACTGTTTTTT	CASKRGFSHEKLFF	TRBV25-1	TRBJ1-4
TGTGCCAGCAGCACAGGCCTCCCCCGCCTAGCCACTGAAGCTTTCTTT	CASSTGLPRLATEAFF	TRBV7-4	TRBJ1-1
TGTGCCAGCACATTAGGGACGATGAACACTGAAGCTTTCTTT	CASTLGTMNTEAFF	TRBV11-2	TRBJ1-1
TGTGCCAGCAGCTCCCCCGAAGCGGTCTTAGATACGCAGTATTTT	CASSSPEAVLDTQYF	TRBV11-3	TRBJ2-3
TGTGCCAGCAGCAGGGGGGGCGAATGGTCCTACAATGAGCAGTTCTTC	CASSRGGEWSYNEQFF	TRBV9	TRBJ2-1
TGTGCCAGCAGCTTAGTATTAGAGAGTGGGATAGGCGTGAATCAGCCCCAGCATTTT	CASSLVLESGIGVNQPQHF	TRBV7-2	TRBJ1-5
TGTGCCAGCAGGGGAAACCCTACAGCGGGATTCCAGAGAGTTGCCTATGGCTACACCTTC	CASRGNPTAGFQRVAYGYTF	TRBV28	TRBJ1-2
TGTGGAACCTCCTTAGAGGGGGGGCTGGAGCCCCAGCATTTT	CGTSLEGGLEPQHF	TRBV28	TRBJ1-5
TGCGCCAGCAGCTTGGGACCCGGTCCCTACAATGAGCAGTTCTTC	CASSLGPGPYNEQFF	TRBV5-1	TRBJ2-1
TGTGCCACACAGATCGGATATAGCAATCAGCCCCAGCATTTT	CATQIGYSNQPQHF	TRBV24-1	TRBJ1-5
TGTGCCAGCAGTTTCCTGGGCGGTCAGAGTTGTGACGAGCAGTACTTC	CASSFLGGQSCDEQYF	TRBV28	TRBJ2-7
TGTGCCAGCAGCGACAGGGGAGTCTACGAGCAGTACTTC	CASSDRGVYEQYF	TRBV9	TRBJ2-7
TGTGCCAGCAGTTTAAGGGGGGTGGGCAATCAGCCCCAGCATTTT	CASSLRGVGNQPQHF	TRBV27	TRBJ1-5
TGCAGTGCTAGAGATGAGGGGGGGAGGCCCCAGCATTTT	CSARDEGGRPQHF	TRBV20-1	TRBJ1-5
TGTGCCACCAGCAGAGCTATGTTAGCGGGCGACCTAACAAGGTTAAATTACCAAGAGACCCAGTACTTC	CATSRAMLAGDLTRLNYQETQYF	TRBV15	TRBJ2-5
TGCAGTGCGAAGGGGGGCTCTGGAAACACCATATATTTT	CSAKGGSGNTIYF	TRBV20-1	TRBJ1-3
TGTGCCAGCAGCGTCAGCGGGACAAAGATGAACACTGAAGCTTTCTTT	CASSVSGTKMNTEAFF	TRBV7-2	TRBJ1-1
TGCGCCAGCAGCTGTAAACTTCCGGCGAACACCGGGGAGCTGTTTTTT	CASSCKLPANTGELFF	TRBV5-1	TRBJ2-2
TGCGCCAGCAGCGCAGCGATCAACACCGGGGAGCTGTTTTTT	CASSAAINTGELFF	TRBV5-1	TRBJ2-2
TGTGCCAGCAGCTGCAAGCGGTTGGGAACCTCCTACGAGCAGTACTTC	CASSCKRLGTSYEQYF	TRBV11-3	TRBJ2-7
TGTGCCAGCAGGGGGCACTCGCACTACGAGCAGTACTTC	CASRGHSHYEQYF	TRBV7-3	TRBJ2-7
TGTGCCAGGTCAAAGGACAGGGAATTCACTGAAGCTTTCTTT	CARSKDREFTEAFF	TRBV19	TRBJ1-1
TGTGCCAGCAGTCTATCATTCAGGACAGGGAAGGCGGATTACAGCTTTCCAAGCAATCAGCCCCAGCATTTT	CASSLSFRTGKADYSFPSNQPQHF	TRBV27	TRBJ1-5
TGTGCCGGGGGCGGGAGAGTGGTTCAAGAGACCCAGTACTTC	CAGGGRVVQETQYF	TRBV19	TRBJ2-5
TGTGCCAGCACGCGACAAGGCGAGACCCAGTACTTC	CASTRQGETQYF	TRBV6-4	TRBJ2-5
TGTGCCAGCAGCTTAACGAGGAGACCGAAAACGGACTATGGCTACACCTTC	CASSLTRRPKTDYGYTF	TRBV7-3	TRBJ1-2
TGTGCCAGCAGCTTAGAGAAGAGGGCTGACACTGAAGCTTTCTTT	CASSLEKRADTEAFF	TRBV7-9	TRBJ1-1
TGCAGTGCCACGGACCGATCCAGGGAGATCCTACGGAAAGACGGGGAGCTGTTTTTT	CSATDRSREILRKDGELFF	TRBV20-1	TRBJ2-2
TGTGCCAGCAGCTTAGATGCCACCGGGGGGTGGGAGGCAACTAATGAAAAACTGTTTTTT	CASSLDATGGWEATNEKLFF	TRBV11-3	TRBJ1-4
TGCAGTGCTAGGGGACAAATTCCCTATGGCTACACCTTC	CSARGQIPYGYTF	TRBV20-1	TRBJ1-2
TGTGCCAGCAGCCAACTAGCTAAAGCCGGGGAGCTGTTTTTT	CASSQLAKAGELFF	TRBV3-1	TRBJ2-2
TGCAGTGCTAGCGACACGGGACAGGCGATCGGGGAGCTGTTTTTT	CSASDTGQAIGELFF	TRBV20-1	TRBJ2-2
TGTGCCAGCCCGGGAATGGGACAGGGGCCTAGGGAGTACTATGGCTACACCTTC	CASPGMGQGPREYYGYTF	TRBV19	TRBJ1-2
TGTGCCAGCAGCTTGTTTCGGGGGGGCCCGGAAACCACAGATACGCAGTATTTT	CASSLFRGGPETTDTQYF	TRBV5-6	TRBJ2-3
TGTGCCAGCAGCCCCATCCCATGGCCGGGACAGGGGGCTCCGGAAGCTTTCTTT	CASSPIPWPGQGAPEAFF	TRBV13	TRBJ1-1
TGTGCCAGCAGCTTAACCGGGACAGGGGCCAACAGCACAGATACGCAGTATTTT	CASSLTGTGANSTDTQYF	TRBV7-3	TRBJ2-3
TGTGCCAGCAGTTTAGGTCCAGGGGTAAGGCTCAACACTGAAGCTTTCTTT	CASSLGPGVRLNTEAFF	TRBV28	TRBJ1-1
TGTGCCAGCAGTGTAGGGCCGTGCACCGGGGAGCTGTTTTTT	CASSVGPCTGELFF	TRBV3-1	TRBJ2-2
TGTGCCAGCAGCGACCAGGGGGGGTATGAAAAACTGTTTTTT	CASSDQGGYEKLFF	TRBV9	TRBJ1-4
TGTGCCAGTAGTCCGGGACAGGGCAATGAAAAACTGTTTTTT	CASSPGQGNEKLFF	TRBV19	TRBJ1-4
TGTGCCTGGAGAGAAAGGAGCTCCTACGAGCAGTACTTC	CAWRERSSYEQYF	TRBV30	TRBJ2-7
TGTGCCAGCAGAGTCTTTGAAGGGGAAGCTTTCTTT	CASRVFEGEAFF	TRBV28	TRBJ1-1
TGTGCCAGCAGGAGGGGTCAGCCCCAGCATTTT	CASRRGQPQHF	TRBV28	TRBJ1-5
TGTGCCACCAGTGCTGATCACAGGCGGGGGCAGCCCCAGCATTTT	CATSADHRRGQPQHF	TRBV24-1	TRBJ1-5
TGTGCTAGTGGTTTGACGCCGAGACGCCCGTACGAGCAGTACTTC	CASGLTPRRPYEQYF	TRBV12-5	TRBJ2-7
TGTGCCAGCAGTTACTCCCACCATCCAGGGCTGGACGGAGAGGCCTTTTCCCGCACCGGGGAGCTGTTTTTT	CASSYSHHPGLDGEAFSRTGELFF	TRBV6-5	TRBJ2-2
TGTGCCAGCAGCTTCCGGAGGGGCAGACCAACTAATGAAAAACTGTTTTTT	CASSFRRGRPTNEKLFF	TRBV5-6	TRBJ1-4
TGCGCCAGCAGCTTGTTCTACAGGTCATGCTATGGCTACACCTTC	CASSLFYRSCYGYTF	TRBV5-1	TRBJ1-2
TGTGCCAGCAGCGTCAGGTGTAAAGGGGAATACACTGAAGCTTTCTTT	CASSVRCKGEYTEAFF	TRBV9	TRBJ1-1
TGCAGCGTTGAAAGGACTGGACAGAGGGCTTTCTTT	CSVERTGQRAFF	TRBV29-1	TRBJ1-1
TGTGCCAGCAGCCTAAAGGGGGTTAGGGATCAGCCCCAGCATTTT	CASSLKGVRDQPQHF	TRBV7-3	TRBJ1-5
TGTGCCAGCAGCTTAGAAGGAGAATTCGGCGGGACTAGCTGCGGCACAGATACGCAGTATTTT	CASSLEGEFGGTSCGTDTQYF	TRBV11-2	TRBJ2-3
TGTGCCAGCAGCTTAAGTCCCCTAGGTGGGCACGAGCAGTACTTC	CASSLSPLGGHEQYF	TRBV11-2	TRBJ2-7
TGTGCCACCACTATCTCCCGTCGGCGTAACAATGAGCAGTTCTTC	CATTISRRRNNEQFF	TRBV24-1	TRBJ2-1
TGTGCCACCGGTTCTAGGGGGCAGCTGAGAGGCTCCTACAATGAGCAGTTCTTC	CATGSRGQLRGSYNEQFF	TRBV24-1	TRBJ2-1
TGTGCCAGCACGGGACAGACTGGGGAGGCCCCTGAAGCTTTCTTT	CASTGQTGEAPEAFF	TRBV27	TRBJ1-1
TGCGCCAGCAGTAGGAAGAGCTTATACCAGTACTTC	CASSRKSLYQYF	TRBV5-1	TRBJ2-5
TGTGCCAGCAGTGCCTCAGGGACCTCCTACGAGCAGTACTTC	CASSASGTSYEQYF	TRBV6-1	TRBJ2-7
TGTGCCAGCAGTGAGGATGGGGAGGACGAGCAGTACTTC	CASSEDGEDEQYF	TRBV27	TRBJ2-7
TGTGCCCGTTTTGGACTAGCGGGCCGGGGGACCCGCACAGATACGCAGTATTTT	CARFGLAGRGTRTDTQYF	TRBV6-5	TRBJ2-3
TGTGCCAGCAGCAACACGGGCGTCACCGGGGAGCTGTTTTTT	CASSNTGVTGELFF	TRBV13	TRBJ2-2
TGCGCCAGCAGCTTAAGAACCACCATATGGAAGGAGACCCAGTACTTC	CASSLRTTIWKETQYF	TRBV5-1	TRBJ2-5
TGTGCCAGCAGCCAAGGTAGGGGTAACTGGTGGCAGTACTTC	CASSQGRGNWWQYF	TRBV14	TRBJ2-7
TGCAGTGCTAGAGCCCACGGGGGGGTTAGAAGCTCCTACAATGAGCAGTTCTTC	CSARAHGGVRSSYNEQFF	TRBV20-1	TRBJ2-1
TGCAGTGCTAGAGTGCCCTCCGGGGGCGCAAGAAACACCATATATTTT	CSARVPSGGARNTIYF	TRBV20-1	TRBJ1-3
TGCAGTGCACCTTCAGACAGGGTTCACAATGAGCAGTTCTTC	CSAPSDRVHNEQFF	TRBV20-1	TRBJ2-1
TGTGCCAGCAGCCAAGGATCAGGGAATGAAAAACTGTTTTTT	CASSQGSGNEKLFF	TRBV4-2	TRBJ1-4
TGTGCCTGTCACCTGCCACCCTCCATGAACACTGAAGCTTTCTTT	CACHLPPSMNTEAFF	TRBV30	TRBJ1-1
TGTGCCAGCAGCTTGTTGGGAAGAGCCTACGAGCAGTACTTC	CASSLLGRAYEQYF	TRBV7-4	TRBJ2-7
TGCACAGCCGGGGGGGGAGGGGGCGATAGCAATCAGCCCCAGCATTTT	CTAGGGGGDSNQPQHF	TRBV20-1	TRBJ1-5
