TGTGCCAGCAGTGGCCCAGACAATGAGCAGTTCTTC	CASSGPDNEQFF	TRBV6-4	TRBJ2-1
TGTGCCACCAGCACGGCATCCTTCCCAGCTGGGAACACTGAAGCTTTCTTT	CATSTASFPAGNTEAFF	TRBV15	TRBJ1-1
TGTGCCTGGGGGCCGGGACGCTACAATGAGCAGTTCTTC	CAWGPGRYNEQFF	TRBV30	TRBJ2-1
TGTGCCAGCAGTACGGAAAGGGGGGGAACCGCCTACAATGAGCAGTTCTTC	CASSTERGGTAYNEQFF	TRBV27	TRBJ2-1
TGTGCCAGTAGTATTTGTAGTCCAGGTTGGACTGAGCAGTTCTTC	CASSICSPGWTEQFF	TRBV19	TRBJ2-1
TGCAGTGCTAGCCGGGACAGTGGGATTCACGAGCAGTACTTC	CSASRDSGIHEQYF	TRBV20-1	TRBJ2-7
TGTGCCAGCAGCTTAGTGGCCCAACCACAGGATAACACCATATATTTT	CASSLVAQPQDNTIYF	TRBV7-9	TRBJ1-3
TGTGCCAGCAATTTAGGTCAGCCCCAGCATTTT	CASNLGQPQHF	TRBV6-4	TRBJ1-5
TGTGCCAGCAGCGTTAGCGGGTACACCGGGGAGCTGTTTTTT	CASSVSGYTGELFF	TRBV7-3	TRBJ2-2
TGTGCCAGCAGTTCGGGGAGGCAGCCCCAGCATTTT	CASSSGRQPQHF	TRBV6-5	TRBJ1-5
TGTGCCAGCAGCGGGTTTATCGAAAACACCGGGGAGCTGTTTTTT	CASSGFIENTGELFF	TRBV7-2	TRBJ2-2
TGTGCCAGCAGTTTACAACTCTTTCAGAGCGGGACGGAAAGCAATCAGCCCCAGCATTTT	CASSLQLFQSGTESNQPQHF	TRBV27	TRBJ1-5
TGTGCCAGCAGTGAAAAACAGCCGAGCTCCTATAATTCACCCCTCCACTTT	CASSEKQPSSYNSPLHF	TRBV6-1	TRBJ1-6
TGTGCCAGCAGCCAAGGGAACCCGGACAGGGAAAGATTCTCCTATAATTCACCCCTCCACTTT	CASSQGNPDRERFSYNSPLHF	TRBV4-2	TRBJ1-6
TGCGCCAGCAGCGGTCCTAATGAGGGTGAGCAGTACTTC	CASSGPNEGEQYF	TRBV4-1	TRBJ2-7
TGTGCCAGCAGGACAAGAACTAATCAGCCCCAGCATTTT	CASRTRTNQPQHF	TRBV27	TRBJ1-5
TGTGCCACCGAATTGTCTCTGGAGGGTATCATGAACACTGAAGCTTTCTTT	CATELSLEGIMNTEAFF	TRBV15	TRBJ1-1
TGTGCCAGCAGCGTAGAGGAATACACCCAAGACAATGAGCAGTTCTTC	CASSVEEYTQDNEQFF	TRBV9	TRBJ2-1
TGTGCCAGCAGCAGAAAAAGGCCTGGTGCCCCAATAGATACGCAGTATTTT	CASSRKRPGAPIDTQYF	TRBV13	TRBJ2-3
TGCAGTGCTAGAGTCCGGGGGAGGGGCCAGCCCCAGCATTTT	CSARVRGRGQPQHF	TRBV20-1	TRBJ1-5
TGCGCCAGCAGTCGCGCCCCGGGACAGTTCCACTCTGGAAACACCATATATTTT	CASSRAPGQFHSGNTIYF	TRBV10-1	TRBJ1-3
TGTGCCAGCAGTGACGGGCGACAGTCGAACACTGAAGCTTTCTTT	CASSDGRQSNTEAFF	TRBV6-4	TRBJ1-1
TGTGCCAGCATCCTTTGGGATCGAGGAAACACCATATATTTT	CASILWDRGNTIYF	TRBV28	TRBJ1-3
TGTGCCAGCAGTAGCCGGGGGGCCCCTGTAGATCAGCCCCAGCATTTT	CASSSRGAPVDQPQHF	TRBV25-1	TRBJ1-5
TGTGCCAGCTCAGTCCCGGGACGATATAGCAATCAGCCCCAGCATTTT	CASSVPGRYSNQPQHF	TRBV18	TRBJ1-5
TGCGCCGTGGGACTAGCGGGAAGGACCGGGGAGCTGTTTTTT	CAVGLAGRTGELFF	TRBV5-1	TRBJ2-2
TGTGCTAGTGGTTCGGGGGACAGCGTCTATGGCTACACCTTC	CASGSGDSVYGYTF	TRBV12-5	TRBJ1-2
TGTGCCAGCCTAGTCAGCTACCCCTCTGGAAACACCATATATTTT	CASLVSYPSGNTIYF	TRBV7-3	TRBJ1-3
TGTGCCAGCAGTTTTCCGGGACTAGGGCCCACCGGGGAGCTGTTTTTT	CASSFPGLGPTGELFF	TRBV27	TRBJ2-2
TGTGCCTGGAGTGTGCTGATTTCCGAGACCCAGTACTTC	CAWSVLISETQYF	TRBV30	TRBJ2-5
TGTGCCAGCAGCCGGGACTGGTCTAGCGGGTGGACAAACACAGATACGCAGTATTTT	CASSRDWSSGWTNTDTQYF	TRBV5-4	TRBJ2-3
TGCAGCGTCCTGTGTCGAAAACACAATGAGCAGTTCTTC	CSVLCRKHNEQFF	TRBV29-1	TRBJ2-1
TGTGCCAGCAGCAGCTCCGGCTCCTACAATGAGCAGTTCTTC	CASSSSGSYNEQFF	TRBV11-3	TRBJ2-1
TGTGCTCGAATATCGGAGCAGTACTTC	CARISEQYF	TRBV24-1	TRBJ2-7
TGTGCCATGGCTTCCTGGGAAGGGGCAAGGAGCACAGATACGCAGTATTTT	CAMASWEGARSTDTQYF	TRBV10-3	TRBJ2-3
TGTGCCAGCAGCGTTCGGGGAGGGAAACTATCACCCCTCCACTTT	CASSVRGGKLSPLHF	TRBV9	TRBJ1-6
TGTGCCAGCACTTTTCCTATTCCGGGACTAGTCACCGGGGAGCTGTTTTTT	CASTFPIPGLVTGELFF	TRBV28	TRBJ2-2
TGTGCCTGGAGTGGGGACAGGGATGAGCAGTACTTC	CAWSGDRDEQYF	TRBV30	TRBJ2-7
TGTGCCAGCAGCCGGGAGGTTATCTACGAGCAGTACTTC	CASSREVIYEQYF	TRBV13	TRBJ2-7
TGCAGTGCCATCGGGCTGAGGCCAGGGCCCACTGAAGCTTTCTTT	CSAIGLRPGPTEAFF	TRBV20-1	TRBJ1-1
TGTGCCAGCAGTGTTAAAGACAGGGAGGCCGGAAACACCATATATTTT	CASSVKDREAGNTIYF	TRBV25-1	TRBJ1-3
TGTGCCAGCAGTGACTCGGTTGGTCTAGGGACATCCTTACCAGACACTGAAGCTTTCTTT	CASSDSVGLGTSLPDTEAFF	TRBV6-4	TRBJ1-1
TGTGCCAGCAGTGACTCGAAATTCACGGATGGCTACACCTTC	CASSDSKFTDGYTF	TRBV6-4	TRBJ1-2
TGTGCCAGCAGCGTCTCAGGCTCTGGGGCCAACGTCCTGACTTTC	CASSVSGSGANVLTF	TRBV13	TRBJ2-6
TGCAGCGGCCCAGGGCGGGCTTTCTTT	CSGPGRAFF	TRBV29-1	TRBJ1-1
TGTGCCAGCTCGGGGGAGAATGAAAAACTGTTTTTT	CASSGENEKLFF	TRBV18	TRBJ1-4
TGTGCCACCAGTGATTTCCTTGGACTAGCCTGGGATACGCAGTATTTT	CATSDFLGLAWDTQYF	TRBV24-1	TRBJ2-3
TGTGCCAGCAGGCAAGACATTCGGGGACTTAACCACTATGGCTACACCTTC	CASRQDIRGLNHYGYTF	TRBV6-5	TRBJ1-2
TGCAGTGCTAGTCTGAGTGCTGGTCTCGAGCAGTACTTC	CSASLSAGLEQYF	TRBV20-1	TRBJ2-7
TGTGCCAGCAGCCTAGCGGGAGTTGCCACAGATACGCAGTATTTT	CASSLAGVATDTQYF	TRBV6-3	TRBJ2-3
TGCGCCAGCAGATCCTGGCGCAACTATGGCTACACCTTC	CASRSWRNYGYTF	TRBV5-1	TRBJ1-2
TGCGCCAGCAGCACGGGATCAGCCGGGACAGAGACCCAGTACTTC	CASSTGSAGTETQYF	TRBV10-1	TRBJ2-5
TGTGCCAGCAGCTTTCGGCTTAGGGGGCGCACTGAAGCTTTCTTT	CASSFRLRGRTEAFF	TRBV7-2	TRBJ1-1
TGTGCCAGCAGCCCAGCTACGGGACAGCGGACGCCTTCGGGTTATCAGCCCCAGCATTTT	CASSPATGQRTPSGYQPQHF	TRBV7-3	TRBJ1-5
TGTGCCAGCAGCTTAGGGGAGGGACGATACACCGGGGAGCTGTTTTTT	CASSLGEGRYTGELFF	TRBV11-2	TRBJ2-2
TGTGCCAGCAATGGCCGGGGTTCCTCCTACGAGCAGTACTTC	CASNGRGSSYEQYF	TRBV9	TRBJ2-7
TGTGCCACCAGTGATAAGGTCAGGACAGGGGGGGGTGGCTACACCTTC	CATSDKVRTGGGGYTF	TRBV24-1	TRBJ1-2
TGTGCCAGCAGCCAGATGGGGGCGCCGTACGAGCAGTACTTC	CASSQMGAPYEQYF	TRBV3-1	TRBJ2-7
TGCGCCTTCTTCCCCCGACAGAATGGCTACACCTTC	CAFFPRQNGYTF	TRBV10-1	TRBJ1-2
TGTGCCAGCAGCTCCCGACAGGGGTTTATAAGCTCTGGAAACACCATATATTTT	CASSSRQGFISSGNTIYF	TRBV13	TRBJ1-3
TGTGCCAGTAGTATAAAGGTCAGAACCCGGGGATTTCCCTATGGCTACACCTTC	CASSIKVRTRGFPYGYTF	TRBV19	TRBJ1-2
TGCGCCAGAGTCCAGTGTCTAGAACAAGAGACCCAGTACTTC	CARVQCLEQETQYF	TRBV10-1	TRBJ2-5
TGTGCCAGCAGCGTAGCTGTTCTCCAGTCGGGGGCCTACGAGCAGTACTTC	CASSVAVLQSGAYEQYF	TRBV9	TRBJ2-7
TGTGCCAGCAGCAGAGGGCGTAACATTCAGTACTTC	CASSRGRNIQYF	TRBV7-2	TRBJ2-4
TGTGCCAGCTCTCCCTTAAGGGGGGGAATTGAGAATACAGATACGCAGTATTTT	CASSPLRGGIENTDTQYF	TRBV25-1	TRBJ2-3
TGTGCCAGCAGTTACCGGCAGGCCTGGAATGAAAAACTGTTTTTT	CASSYRQAWNEKLFF	TRBV6-5	TRBJ1-4
TGTGCCACCGACGTTAGCTTAGGCTCCTACAATGAGCAGTTCTTC	CATDVSLGSYNEQFF	TRBV24-1	TRBJ2-1
TGTGCCAGTAGTATCAGGGGTCCGAATGAAAAACTGTTTTTT	CASSIRGPNEKLFF	TRBV19	TRBJ1-4
TGTGCCAGCAGCCCCCACCCGGAAGATACCAGGGGACGCGAAAAACTGTTTTTT	CASSPHPEDTRGREKLFF	TRBV6-1	TRBJ1-4
TGTGCCAGCAGTCCAAAAGGCTGTTTTAAGCAAGGGAGCGAGCAGTACTTC	CASSPKGCFKQGSEQYF	TRBV28	TRBJ2-7
TGTGCCAGCAGAAGGTGGACTAGCGGGGGGGCCAGCTCCTACGAGCAGTACTTC	CASRRWTSGGASSYEQYF	TRBV6-5	TRBJ2-7
TGTGCCAGCAGCTTCAAAGGGACAGGGAAAAGCTCCTACGAGCAGTACTTC	CASSFKGTGKSSYEQYF	TRBV11-3	TRBJ2-7
TGTGCCAGCAGTCAACGCCGGATCTACGAGCAGTACTTC	CASSQRRIYEQYF	TRBV7-2	TRBJ2-7
TGCACATCGGGAGTCCTGAACACTGAAGCTTTCTTT	CTSGVLNTEAFF	TRBV20-1	TRBJ1-1
TGCGCCAGCAGCGGGCGGGTGCGCATTAACGTCCATCCCACCGGGGAGCTGTTTTTT	CASSGRVRINVHPTGELFF	TRBV4-3	TRBJ2-2
TGCGCCAGCAGCCTTTTTTTGAGAACAGGTGGGGCCTACGAGCAGTACTTC	CASSLFLRTGGAYEQYF	TRBV5-1	TRBJ2-7
TGTGCCACCCCGGGGCACGTCGAGAAGGGTAGCTCCTACGAGCAGTACTTC	CATPGHVEKGSSYEQYF	TRBV24-1	TRBJ2-7
TGTGCCAGCAGTGGCCAGGGTTTCTGGACTCAAGAGACCCAGTACTTC	CASSGQGFWTQETQYF	TRBV28	TRBJ2-5
TGCAGTGCTAGAGGATTAAACAAGGTTGAAAGAGCTTTCTTT	CSARGLNKVERAFF	TRBV20-1	TRBJ1-1
TGTGCCAGCACCTTTGGAATTCCAGGGGGCGTGAATCAGCCCCAGCATTTT	CASTFGIPGGVNQPQHF	TRBV6-4	TRBJ1-5
TGTGCCAGCAGTGAGGGGAGGGGACCTTTAGTGGAGCTGTTTTTT	CASSEGRGPLVELFF	TRBV25-1	TRBJ2-2
TGTGCTAGTGGTTTGTCTAAGGAGGGTAGAGGATCATGGGGGGGGAGGGAGCAGTACTTC	CASGLSKEGRGSWGGREQYF	TRBV12-5	TRBJ2-7
TGTGCCAGCAGCTTGCCACAGGGCTCCTACGAGCAGTACTTC	CASSLPQGSYEQYF	TRBV5-4	TRBJ2-7
TGCAGCGTTGACGCATCCAGGGGGCCGGCTGGCTACACCTTC	CSVDASRGPAGYTF	TRBV29-1	TRBJ1-2
TGTGCCAGTAGTATAGGGACTAGCGGGAGAGAGCAGTACTTC	CASSIGTSGREQYF	TRBV19	TRBJ2-7
TGTGCCAGCAGCCAAGACGGGGGCTCTCCCTACGAGCAGTACTTC	CASSQDGGSPYEQYF	TRBV14	TRBJ2-7
TGTGCCGGTGAGGGCGAAGCCTACGAGCAGTACTTC	CAGEGEAYEQYF	TRBV9	TRBJ2-7
TGTGCCAGCAGCCCAGGGTACGAGCAGTACTTC	CASSPGYEQYF	TRBV14	TRBJ2-7
TGTGCCAGCAGCGTTATGGAGCAGGGCAACTACGAGCAGTACTTC	CASSVMEQGNYEQYF	TRBV7-2	TRBJ2-7
TGTGCCAGCAGCCAGTTCCCCGGGACTAGGATAACCGAGCAGTACTTC	CASSQFPGTRITEQYF	TRBV14	TRBJ2-7
TGTGCCAGCAGCTTATGGGGGGGGGACCAAGAGACCCAGTACTTC	CASSLWGGDQETQYF	TRBV7-7	TRBJ2-5
TGTGCTAGCAGCTTACCAAGTGGGGGCGGGCCTAACTATGGCTACACCTTC	CASSLPSGGGPNYGYTF	TRBV7-7	TRBJ1-2
TGCAGTGCTAGAGCAGGCCTCCAGACAGATACGCAGTATTTT	CSARAGLQTDTQYF	TRBV20-1	TRBJ2-3
TGTGCCAGCACCCAACAACGGAGGGAATACAATGAGCAGTTCTTC	CASTQQRREYNEQFF	TRBV28	TRBJ2-1
TGTGCCACAGGGGCCAGTGGGGACACTGAAGCTTTCTTT	CATGASGDTEAFF	TRBV6-3	TRBJ1-1
TGCAGTGCTTCTGCAGGGTACGAGCAGTACTTC	CSASAGYEQYF	TRBV20-1	TRBJ2-7
TGTGCCAGCTCGGGTGGACTAGCGGGGATCGGGGAGCTGTTTTTT	CASSGGLAGIGELFF	TRBV28	TRBJ2-2
TGTGCCAGCCCCCCCCAAGGGTGGCCTTATGGCTACACCTTC	CASPPQGWPYGYTF	TRBV5-6	TRBJ1-2
TGTGCCAGCAGTAAGGAACACCCGGGACAGGGGTTCGGGGAGCTGTTTTTT	CASSKEHPGQGFGELFF	TRBV6-1	TRBJ2-2
TGCAGTGCGTGGCGGGCGCGGGATAGCAATCAGCCCCAGCATTTT	CSAWRARDSNQPQHF	TRBV20-1	TRBJ1-5
TGTGCCAGCAGCGCTCAAAGGGCGGTTGGCTACGAGCAGTACTTC	CASSAQRAVGYEQYF	TRBV7-9	TRBJ2-7
TGTGCCAGCAGCGGGGACCCCTCCTACGAGCAGTACTTC	CASSGDPSYEQYF	TRBV13	TRBJ2-7
TGTGCCAGCAGCCCGGCCCATATCAACTACGAGCAGTACTTC	CASSPAHINYEQYF	TRBV11-2	TRBJ2-7
TGTGCCACCAGTGATTTGGACATTAACTATGGCTACACCTTC	CATSDLDINYGYTF	TRBV24-1	TRBJ1-2
TGCAGTGCTAGACGGCCTATACTAGCGGAAGAGACCCAGTACTTC	CSARRPILAEETQYF	TRBV20-1	TRBJ2-5
TGTGCCAGCTCACCGTTACCACAGGGCACTGAAGCTTTCTTT	CASSPLPQGTEAFF	TRBV18	TRBJ1-1
TGTGCCATGGAGTTAACAGGGTTGACCGACTATGGCTACACCTTC	CAMELTGLTDYGYTF	TRBV10-3	TRBJ1-2
TGTGCCAGGGAGGGGGCTAGGCAAGAGACCCAGTACTTC	CAREGARQETQYF	TRBV13	TRBJ2-5
TGCGCCAGCAGTGGCGATGGGGCTGACAATGAGCAGTTCTTC	CASSGDGADNEQFF	TRBV10-1	TRBJ2-1
TGTGCCACCAGTCGGGGATTGGGTAGCAATCAGCCCCAGCATTTT	CATSRGLGSNQPQHF	TRBV24-1	TRBJ1-5
TGTGCCAGCAGCCAAGACATTGGGGGGCGGGAGGAAAGCTCCTACGAGCAGTACTTC	CASSQDIGGREESSYEQYF	TRBV3-1	TRBJ2-7
TGCAGCTGTTCCCCAGTGGACGTAGCGTTTGAAAAACTGTTTTTT	CSCSPVDVAFEKLFF	TRBV29-1	TRBJ1-4
TGTGCCAGCAGCCAAGATGACCAGCGTGCGGGAGCGATTACGACAGATACGCAGTATTTT	CASSQDDQRAGAITTDTQYF	TRBV14	TRBJ2-3
TGCAGCGCTCCGGAGGTCGTTCAGCCCCAGCATTTT	CSAPEVVQPQHF	TRBV29-1	TRBJ1-5
TGTGCCAGCAGTGACTCGTTCGGGGTCTATAACACTGAAGCTTTCTTT	CASSDSFGVYNTEAFF	TRBV6-4	TRBJ1-1
TGTGCCAGCTCGTTCCGGTCCCAGCGCTACGAGCAGTACTTC	CASSFRSQRYEQYF	TRBV28	TRBJ2-7
TGTGCCAGCAGTCTAGACAGGGCCAAAGGCTACACCTTC	CASSLDRAKGYTF	TRBV27	TRBJ1-2
TGTGCCAGGTTAAGAGGGGTCCACAGCTCCTACAATGAGCAGTTCTTC	CARLRGVHSSYNEQFF	TRBV7-3	TRBJ2-1
TGTGCCAGCAGTTTTCAGGGTAAAAGCTCCTATAATTCACCCCTCCACTTT	CASSFQGKSSYNSPLHF	TRBV27	TRBJ1-6
TGTGCCGTGGGGTCCAGGCTTACGCAGTATTTT	CAVGSRLTQYF	TRBV27	TRBJ2-3
TGCGCCAGCAGTGACGGAGATGAAAAACTGTTTTTT	CASSDGDEKLFF	TRBV10-1	TRBJ1-4
TGTGCCAGCAGTGAAGTCCGGGGGGGCGTGGCCTACGAGCAGTACTTC	CASSEVRGGVAYEQYF	TRBV6-1	TRBJ2-7
TGTGCCAGCAGCTTTAGGGCCCATCCGAACACCGGGGAGCTGTTTTTT	CASSFRAHPNTGELFF	TRBV11-2	TRBJ2-2
TGTGCCAGCAGCACTATAAAGTCGGTTGAGAACGAGCAGTACTTC	CASSTIKSVENEQYF	TRBV5-4	TRBJ2-7
TGTGCCAGCAGTTACGGGGGGCCTCCTGAGACCCAGTACTTC	CASSYGGPPETQYF	TRBV12-3	TRBJ2-5
TGTGCCGCCGGACTAGCGGGGGGCTGGGGCAGCTCCTACAATGAGCAGTTCTTC	CAAGLAGGWGSSYNEQFF	TRBV7-9	TRBJ2-1
TGTGCCAGCAGTGAAGGAGGGGGGGGCCCCTACGAGCAGTACTTC	CASSEGGGGPYEQYF	TRBV2	TRBJ2-7
TGTGCCAGCAGTTACCGACAGGGATGGAGCGGAAAGGACTTT	CASSYRQGWSGKDF	TRBV6-5	TRBJ1-1
TGCGCCAGCAGCCAAGCAAGTGAGCCCAAAGAGACCCAGTACTTC	CASSQASEPKETQYF	TRBV4-3	TRBJ2-5
TGTGCCAGCATTACTCACCGACTAGGGGCCTACAATGAGCAGTTCTTC	CASITHRLGAYNEQFF	TRBV6-5	TRBJ2-1
TGCAGTGCTAGTCTGCCAGGGGCTACCAGATGCTCTGGGGCCAACGTCCTGACTTTC	CSASLPGATRCSGANVLTF	TRBV20-1	TRBJ2-6
TGTGCCAGCAGCCAAGGGGAGGCGCAGAGGTGTAGGTTCTATGGCTACACCTTC	CASSQGEAQRCRFYGYTF	TRBV5-5	TRBJ1-2
TGTGCCGAACAGGGATTCTGGAACTCTGGGGCCAACGTCCTGACTTTC	CAEQGFWNSGANVLTF	TRBV24-1	TRBJ2-6
TGTGCCAGCAGTTACAGGCGGGACGCCGCCTACGAGCAGTACTTC	CASSYRRDAAYEQYF	TRBV6-8	TRBJ2-7
TGCGCCAGCAGCTTTGTTCGACTAGCGGGTGGAATTTCCTACGAGCAGTACTTC	CASSFVRLAGGISYEQYF	TRBV5-1	TRBJ2-7
TGTGCCAGCAGCTTGACAGGCCCCTTTAGAGTTACTAATGGCTACACCTTC	CASSLTGPFRVTNGYTF	TRBV7-3	TRBJ1-2
TGCGCCAGCAGCTACCAACCGGGGCTATCTACGCAGTATTTT	CASSYQPGLSTQYF	TRBV5-1	TRBJ2-3
TGTGCCAGCAGCAGATCCTACCGGAACTATGGCTACACCTTC	CASSRSYRNYGYTF	TRBV13	TRBJ1-2
TGCGCCAGCAGCTCCGGGACAGATGAAAAACTGTTTTTT	CASSSGTDEKLFF	TRBV5-1	TRBJ1-4
TGTGCCAGCAGCGTCCCGTGGGACTTCTTC	CASSVPWDFF	TRBV7-3	TRBJ2-1
TGTGCCAGTAACCCCCGCAGTAGTGAAGCTTTCTTT	CASNPRSSEAFF	TRBV19	TRBJ1-1
TGTGCCAGCAGCTTACCCAGCGGGACAGGGTCCGACGAGCAGTACTTC	CASSLPSGTGSDEQYF	TRBV7-4	TRBJ2-7
TGCGCCAGCAGCTCGATCCGGGAGGAAAGCGAGCAGTACTTC	CASSSIREESEQYF	TRBV5-1	TRBJ2-7
TGTGCCAGTACTAAGGGGCCCCTCCAGACTAGGAACAATGAGCAGTTCTTC	CASTKGPLQTRNNEQFF	TRBV19	TRBJ2-1
TGTGCCAGCAGCCCTCGACAGGGGTATGATGAGCAGTTCTTC	CASSPRQGYDEQFF	TRBV5-6	TRBJ2-1
TGTGCCAGCAGCCAAGGGGGACAGGGCAGTTTGTTTTGGAAAGCCTACGAGCAGTACTTC	CASSQGGQGSLFWKAYEQYF	TRBV14	TRBJ2-7
TGCGCCAGCAGCCAAGATCTTCTTCTGCCGAGTGCAAGGGGTCTGAACACTGAAGCTTTCTTT	CASSQDLLLPSARGLNTEAFF	TRBV4-1	TRBJ1-1
TGCAGTGCTAGAGAGGGGACAGGGGCTGCCGTCAATCAGCCCCAGCATTTT	CSAREGTGAAVNQPQHF	TRBV20-1	TRBJ1-5
TGTGCCAGCAGTTACTATGGTTTGGGACAGAGAGGCTCTGGAAACACCATATATTTT	CASSYYGLGQRGSGNTIYF	TRBV6-5	TRBJ1-3
TGTGCCAGCAGTTGTGCCCCGGGACAGGTCCTAGCTGAAGCTTTCTTT	CASSCAPGQVLAEAFF	TRBV28	TRBJ1-1
TGTGCCAGCAGTGCTCTCCACAAAATTGAAGGAGAAAAACTGTTTTTT	CASSALHKIEGEKLFF	TRBV27	TRBJ1-4
TGCGCCAGCAGCAAGATGAACACCGGGGAGCTGTTTTTT	CASSKMNTGELFF	TRBV5-1	TRBJ2-2
TGTGCCAGCAGTTACGGGACAGGGGGCAGATTTCAGCCCCAGCATTTT	CASSYGTGGRFQPQHF	TRBV6-5	TRBJ1-5
TGTAATCAGGGGACCAAGGTTCAGCCCCAGCATTTT	CNQGTKVQPQHF	TRBV6-5	TRBJ1-5
TGTGCCAGCAGCTGGTGGGCCCTTTACGAGCAGTACTTC	CASSWWALYEQYF	TRBV11-3	TRBJ2-7
TGTGCCAGCAGCTTAGGGGCACAGGGGGAAAATGAGCAGTTCTTC	CASSLGAQGENEQFF	TRBV7-2	TRBJ2-1
TGTGCCAGCAGCCCGGGACAGGGAGAGCAGTTCTTC	CASSPGQGEQFF	TRBV6-5	TRBJ2-1
TGTGCCATCAGGAATACCGGGACAATATACGAGCAGTACTTC	CAIRNTGTIYEQYF	TRBV10-3	TRBJ2-7
TGCAGTGCTATATGTGGGGGTGCACTCCACTTT	CSAICGGALHF	TRBV20-1	TRBJ1-6
TGTGCCAGCAGTTTACCCCCCACTAGCGGGTTGGCCTACAATGAGCAGTTCTTC	CASSLPPTSGLAYNEQFF	TRBV27	TRBJ2-1
TGCAGCTGGGAGGGTATGGGAGATACGCAGTATTTT	CSWEGMGDTQYF	TRBV29-1	TRBJ2-3
TGTGCCAGCAGAGGCCACGGTATGTTGCCCAACTTC	CASRGHGMLPNF	TRBV6-4	TRBJ2-7
TGTGCCAGCAAGATCGGTGCAGGGACGGACAAAAATGAGCAGTTCTTC	CASKIGAGTDKNEQFF	TRBV27	TRBJ2-1
TGCGCCAGCAGAAGAAGGGGACAGGGGAGTAACTATGGCTACACCTTC	CASRRRGQGSNYGYTF	TRBV10-2	TRBJ1-2
TGTGCCACCAGTGCCCAGCAGCCCGGGACCACCGGGGAGCTGTTTTTT	CATSAQQPGTTGELFF	TRBV24-1	TRBJ2-2
TGTGGCAGAGACGCCACTGAAGCTTTCTTT	CGRDATEAFF	TRBV27	TRBJ1-1
TGTGCCAGTAGTATAGTCCAACGGGTGGATAGCAATCAGCCCCAGCATTTT	CASSIVQRVDSNQPQHF	TRBV19	TRBJ1-5
TGTGCCAGCAGTACCCCCGAGGGAGAGAGCACAGATACGCAGTATTTT	CASSTPEGESTDTQYF	TRBV28	TRBJ2-3
TGTGCCAGCACACCTTGGGGGGGGCTTTGCGAGCAGTACTTC	CASTPWGGLCEQYF	TRBV14	TRBJ2-7
TGTGCCAGCAGCGTAGGTAGGCAGGGGTACCCTGGGGCCAACGTCCTGACTTTC	CASSVGRQGYPGANVLTF	TRBV9	TRBJ2-6
TGTGCCAGCTGTCCCTGGACCGGGACTAGAGGGGGATACGAGCAGTACTTC	CASCPWTGTRGGYEQYF	TRBV9	TRBJ2-7
TGTGCCAGCAGAAGACAGGGGTTGGGGGATAATGAAAAACTGTTTTTT	CASRRQGLGDNEKLFF	TRBV2	TRBJ1-4
TGCAGTGCTAGTTCCCAGGGGGACGAGCAGTACTTC	CSASSQGDEQYF	TRBV20-1	TRBJ2-7
TGTGCCAGCAGCCATGACACTGAAGCTTTCTTT	CASSHDTEAFF	TRBV5-5	TRBJ1-1
TGTGCCAGCAGTGAGACAGGGATCAGGATTGGTGCTCGCTATGGCTACACCTTC	CASSETGIRIGARYGYTF	TRBV2	TRBJ1-2
TGTGCCAGCAGCTTAGGAATTGTGGCTTCCGAGCAGTACTTC	CASSLGIVASEQYF	TRBV11-3	TRBJ2-7
TGCGCCAGCAGCCCTGGCCTAGCAGATACGCAGTATTTT	CASSPGLADTQYF	TRBV10-1	TRBJ2-3
TGTGCCACCGGGACAGGTGCCGGGAACTATGGCTACACCTTC	CATGTGAGNYGYTF	TRBV2	TRBJ1-2
TGTGCCAGCAAAGGACTAGCGGGTGTAACCTACGAGCAGTACTTC	CASKGLAGVTYEQYF	TRBV6-3	TRBJ2-7
TGTGCCATCAGTGAATTCAGGGGTTTCCATGAAAAACTGTTTTTT	CAISEFRGFHEKLFF	TRBV10-3	TRBJ1-4
TGTGCCAGACAGGGATCCTACGAGCAGTACTTC	CARQGSYEQYF	TRBV19	TRBJ2-7
TGTGCCAGCAGTGTGGGCACAGGCGAAGGGATCTACGAGCAGTACTTC	CASSVGTGEGIYEQYF	TRBV6-4	TRBJ2-7
TGCGCCAGCACGGACAGGGGGCAGGGGGGGGAGACCCAGTACTTC	CASTDRGQGGETQYF	TRBV10-1	TRBJ2-5
TGTGCCAGCAGTGACAGCATGAAGTATGGGGTTCAGTTATACGAGCAGTACTTC	CASSDSMKYGVQLYEQYF	TRBV27	TRBJ2-7
TGTGCTAGTGTACCTATCTATGGCTACACCTTC	CASVPIYGYTF	TRBV12-5	TRBJ1-2
TGCAGTGCTAGGTTAGAAGAAGAGACCCAGTACTTC	CSARLEEETQYF	TRBV20-1	TRBJ2-5
TGTGCCATAGCGGTAGTGAACACTGAAGCTTTCTTT	CAIAVVNTEAFF	TRBV28	TRBJ1-1
TGTGCCAGCATAGGCCTAGCATGTTACGAGCAGTACTTC	CASIGLACYEQYF	TRBV6-4	TRBJ2-7
TGCAGTGCTAGAGATCGAATACTGGTCTATGGCTACACCTTC	CSARDRILVYGYTF	TRBV20-1	TRBJ1-2
TGTGCCAGCACTCATGGGGAGCGAAACACTGAAGCTTTCTTT	CASTHGERNTEAFF	TRBV6-5	TRBJ1-1
TGTGCCAGAGACAGGGGGGCTGGGGCCAACGTCCTGACTTTC	CARDRGAGANVLTF	TRBV19	TRBJ2-6
TGTGCTAGTGGTTCCTCCCGCTTGGTAGCCAAAAACATTCAGTACTTC	CASGSSRLVAKNIQYF	TRBV12-5	TRBJ2-4
TGCAGTGCTAGAGAGCCCCGACTTATCAGGGGGACTGAAGCTTTCTTT	CSAREPRLIRGTEAFF	TRBV20-1	TRBJ1-1
TGTGCCAGCAGCCGGGACAGGGTTGGACAGGCCCACACCGGGGAGCTGTTTTTT	CASSRDRVGQAHTGELFF	TRBV6-4	TRBJ2-2
TGTGCCAGCAGCTGGACTACTAGCGGGCCTGAGCAGTTCTTC	CASSWTTSGPEQFF	TRBV7-3	TRBJ2-1
TGTGCCCCCGAAGCCCGGGATAGTAATCAGCCCCAGCATTTT	CAPEARDSNQPQHF	TRBV7-7	TRBJ1-5
TGTGCCAGCAGTGTTTACAGGGTGAACACCGGGGAGCTGTTTTTT	CASSVYRVNTGELFF	TRBV6-4	TRBJ2-2
TGTGCTAGTGAATCCCAGGGCTGCCACACTGAAGCTTTCTTT	CASESQGCHTEAFF	TRBV12-5	TRBJ1-1
TGTGCCAGCAGCAGCCAGACACAGGGGCGATACGAGCAGTACTTC	CASSSQTQGRYEQYF	TRBV7-2	TRBJ2-7
TGTGCCAGCAGCTGCGGACAGGGGAATGAGCAGTTCTTC	CASSCGQGNEQFF	TRBV7-2	TRBJ2-1
TGCAGCGTTGAAGATACCGGGACAGGGGGGTCCTACGAGCAGTACTTC	CSVEDTGTGGSYEQYF	TRBV29-1	TRBJ2-7
TGTGCCAGCAGTTTATCCCTTGGGGGGGGGGGAAGTGCCTACGAGCAGTACTTC	CASSLSLGGGGSAYEQYF	TRBV27	TRBJ2-7
TGTGCCTGGAGGTGGGACAGGGAGAACACTGAAGCTTTCTTT	CAWRWDRENTEAFF	TRBV30	TRBJ1-1
TGCGCCAGCAGCTCCGGGTCCGGCATGTATAATTCACCCCTCCACTTT	CASSSGSGMYNSPLHF	TRBV5-1	TRBJ1-6
TGTGCAGTCAGGGGCAATAACCTAGGGGGTAAAAACTATGGCTACACCTTC	CAVRGNNLGGKNYGYTF	TRBV9	TRBJ1-2
TGTGCCAGCAGTGACGGTCTCAGGAGTACTTGCTACGAGCAGTACTTC	CASSDGLRSTCYEQYF	TRBV6-4	TRBJ2-7
TGTGCCAGCAGCCCCATGAAACAGCCCCAGCATTTT	CASSPMKQPQHF	TRBV13	TRBJ1-5
TGTGCCAGCGCACAGAACACTGAAGCTTTCTTT	CASAQNTEAFF	TRBV12-4	TRBJ1-1
TGTGCCAGCACGTTCCGGGACAGGCTAGAGGGGGGGAACGACGAGAGCTCTGGAAACACCATATATTTT	CASTFRDRLEGGNDESSGNTIYF	TRBV6-5	TRBJ1-3
TGTGCCAGCAGCGTGGATGGACAGGGTATGAACACTGAAGCTTTCTTT	CASSVDGQGMNTEAFF	TRBV9	TRBJ1-1
TGTGCCAGCAGCTATTTCCGGAGGGACATGCGGTACGAGCAGTACTTC	CASSYFRRDMRYEQYF	TRBV7-7	TRBJ2-7
TGTGCCAGCAGTGATGCTAGCGGCCAAGAGACCCAGTACTTC	CASSDASGQETQYF	TRBV2	TRBJ2-5
TGTGCCAGCAGAGTGGGGATAGATAACGAGCAGTACTTC	CASRVGIDNEQYF	TRBV6-1	TRBJ2-7
TGCAGTGCTAGAGAGCTGCTAAAGCATTTT	CSARELLKHF	TRBV20-1	TRBJ1-5
TGTGCTAGTGGCCCCCGGTTTTTGATAAATCTTCACAACACCGGGGAGCTGTTTTTT	CASGPRFLINLHNTGELFF	TRBV12-5	TRBJ2-2
TGTGCCACCATCGGCGCTTGTAGCAATCAGCCCCAGCATTTT	CATIGACSNQPQHF	TRBV24-1	TRBJ1-5
TGTGCCAGCCTACAGGGGGGGAGGAGTAAGAATGAAGCTTTCTTT	CASLQGGRSKNEAFF	TRBV6-4	TRBJ1-1
TGTGCCAGCAGCCAAGTCGCCACCTCCGACAGGAGGACCGGGGAGCTGTTTTTT	CASSQVATSDRRTGELFF	TRBV4-2	TRBJ2-2
TGTGCCAGCACTGGGGGGGGAGGACAGGCCCTTCAGCCCCAGCATTTT	CASTGGGGQALQPQHF	TRBV27	TRBJ1-5
TGTGCCAGCCTGGTGGGCCTAAGCACTGAAGCTTTCTTT	CASLVGLSTEAFF	TRBV27	TRBJ1-1
TGTGCCAGCAGCCGACAGGAAGGACCCTACGAGCAGTACTTC	CASSRQEGPYEQYF	TRBV7-6	TRBJ2-7
TGCGCCAAAGGACAGTTCGGCTACACCTTC	CAKGQFGYTF	TRBV20-1	TRBJ1-2
TGTGCACAGGATTCAGCGGGAGGGCCCGCAGATACGCAGTATTTT	CAQDSAGGPADTQYF	TRBV6-2	TRBJ2-3
TGTGCCAGCAGCAGCTCACTTAGGGAGCAGTACTTC	CASSSSLREQYF	TRBV7-4	TRBJ2-7
TGTGCCAGTTCAAAACAGGGTACCTACGAGCAGTACTTC	CASSKQGTYEQYF	TRBV6-5	TRBJ2-7
TGCAGTGCTAGAGAGACGACGCAGGGCATAAAGGAAAAACTGTTTTTT	CSARETTQGIKEKLFF	TRBV20-1	TRBJ1-4
TGTGCCAGCAGCGCGGCGGACCGAAAGGTGTTATCGGATACGCAGTATTTT	CASSAADRKVLSDTQYF	TRBV7-3	TRBJ2-3
TGTGCCACCAGTGACGGCAGGAGGACTAGCGGGTCCCTCTCCTACAATGAGCAGTTCTTC	CATSDGRRTSGSLSYNEQFF	TRBV24-1	TRBJ2-1
TGTGCCACCAGTTGGACAGGGGGACAGCCCCAGCATTTT	CATSWTGGQPQHF	TRBV24-1	TRBJ1-5
TGTGCCAGCATCCGACGAGGCTCCTACAATGAGCAGTTCTTC	CASIRRGSYNEQFF	TRBV12-4	TRBJ2-1
TGTGCCAGCAGCACTTGGGACAGGGGGGCGACTTCCGAAACTAATGAAAAACTGTTTTTT	CASSTWDRGATSETNEKLFF	TRBV5-6	TRBJ1-4
TGTGCCAGCAGCTCCAAGACTAGGGTCAGCTCCTACAATGAGCAGTTCTTC	CASSSKTRVSSYNEQFF	TRBV13	TRBJ2-1
TGTGCCAGCAGCCCGGGGAGGGCGGGAACTAATGAAAAACTGTTTTTT	CASSPGRAGTNEKLFF	TRBV14	TRBJ1-4
TGTGCCAGCGTGGGGGGGAATGAGCAGTTCTTC	CASVGGNEQFF	TRBV27	TRBJ2-1
TGCGCCAGCGGGGACAGGGACACAGATACGCAGTATTTT	CASGDRDTDTQYF	TRBV10-1	TRBJ2-3
TGTGCCAGCAGCGTATGTGGGGGAGGGAACACCGGGGAGCTGTTTTTT	CASSVCGGGNTGELFF	TRBV9	TRBJ2-2
TGTGCCAGCAGTGCGCAGATGCCCTCCAACCGGGACACAGACACTGAAGCTTTCTTT	CASSAQMPSNRDTDTEAFF	TRBV6-1	TRBJ1-1
TGTGCCACTCTTAGGACAGGAAAAGAGACCCAGTACTTC	CATLRTGKETQYF	TRBV6-4	TRBJ2-5
TGTACTCCCAGGGGGCAGAGCTCTGGAAACACCATATATTTT	CTPRGQSSGNTIYF	TRBV6-5	TRBJ1-3
TGTGCCAGCAGCCCAGACTCAGCGGGAGTTACCACAGATACGCAGTATTTT	CASSPDSAGVTTDTQYF	TRBV7-7	TRBJ2-3
TGTGCCAGCAGCTTAAGGGGGGTCAGGGATACGCAGTATTTT	CASSLRGVRDTQYF	TRBV7-7	TRBJ2-3
TGCAGTGCTAGAAAGCGAAGAGACAGGGATGTGGACACTGAAGCTTTCTTT	CSARKRRDRDVDTEAFF	TRBV20-1	TRBJ1-1
TGTGCCACCAGTGATTTGAGGGGGGGAGAGACCCAGTACTTC	CATSDLRGGETQYF	TRBV24-1	TRBJ2-5
TGCGCCAGCAGTGAGCGTGCACTCTCCGGCTACACCTTC	CASSERALSGYTF	TRBV10-1	TRBJ1-2
TGTGCCAGCAGCCAAGCGTTAAGCGGGGCCGTTCTGTTTTTT	CASSQALSGAVLFF	TRBV14	TRBJ1-4
TGTGCCAGCAGCGGACAGGGGGCTAACTATGGCTACACCTTC	CASSGQGANYGYTF	TRBV11-3	TRBJ1-2
TGTGCCAGCAGTCAGGACAGGGCTTCCCGGAACACTGAAGCTTTCTTT	CASSQDRASRNTEAFF	TRBV27	TRBJ1-1
TGTGCCAGCAGCGCATTCCGGACAGGGGTTCCCTACGAGCAGTACTTC	CASSAFRTGVPYEQYF	TRBV13	TRBJ2-7
TGTGCCACCAGCAGGACTAGCTCTGGGGCCAACGTCCTGACTTTC	CATSRTSSGANVLTF	TRBV15	TRBJ2-6
TGCAGCGTTGAAGATCGGCCGGGGACAGGGGACACTGAAGCTTTCTTT	CSVEDRPGTGDTEAFF	TRBV29-1	TRBJ1-1
TGTGCCAGCAGCTTGGCCCGGGACAAGGGGTCCTACGAGCAGTACTTC	CASSLARDKGSYEQYF	TRBV6-1	TRBJ2-7
TGTGCCAGCAGCCTCGTCTCCGGGGTTGGCTCTGGGGCCAACGTCCTGACTTTC	CASSLVSGVGSGANVLTF	TRBV3-1	TRBJ2-6
TGTGCCAGCAGTTTCTTCCCACTGGGTCGGTATGGCTACACCTTC	CASSFFPLGRYGYTF	TRBV27	TRBJ1-2
TGTGCCAGCAGTGACTCAAGGGAGCTCCTTGGGACTAGCGGGGGGGAGACCCAGTACTTC	CASSDSRELLGTSGGETQYF	TRBV6-4	TRBJ2-5
TGTGCCAGCAGCTTGGGGGGGCTGGGCCATGAGCAGTTCTTC	CASSLGGLGHEQFF	TRBV5-6	TRBJ2-1
TGTGCCAGCAGTAAGCGGGACCCCCGCATGGGCACCGGGGAGCTGTTTTTT	CASSKRDPRMGTGELFF	TRBV25-1	TRBJ2-2
TGTGCCACCTGGGGGTACGGGGCCTACGAGCAGTACTTC	CATWGYGAYEQYF	TRBV24-1	TRBJ2-7
TGTGCCAGCAACACCCCCAGGGAAGTAATAAGGGGAAGCTCTGGAAACACCATATATTTT	CASNTPREVIRGSSGNTIYF	TRBV7-3	TRBJ1-3
TGTGCCAGCACCCCACCAGGCCCGAGTCAATACGAGCAGTACTTC	CASTPPGPSQYEQYF	TRBV7-9	TRBJ2-7
TGCGCCAGCAGCACCCCGTTGGGACCGCAAGAGACCCAGTACTTC	CASSTPLGPQETQYF	TRBV5-1	TRBJ2-5
TGTGCCAGCAGCATGGTGGACCCGGGTCTGGAAGAGACCCAGTACTTC	CASSMVDPGLEETQYF	TRBV5-6	TRBJ2-5
TGCAGTGCTAGCTTCCAAAGGTACGGTTTTCCGCAAGAGACCCAGTACTTC	CSASFQRYGFPQETQYF	TRBV20-1	TRBJ2-5
TGCGCCAGCAGCTTGGCCGGACGAGCTTTCTTT	CASSLAGRAFF	TRBV5-1	TRBJ1-1
TGTGCCAGCAGCCTGCGATATGCCGACAATGAGCAGTTCTTC	CASSLRYADNEQFF	TRBV7-3	TRBJ2-1
TGTGCCAGCAAAAAGGGTCGAGGGACAGGGGGCGGGGAGCTGTTTTTT	CASKKGRGTGGGELFF	TRBV5-6	TRBJ2-2
TGTGCCAGCAGAAACGTTCCCGTGGGGTTTGAAGCTTTCTTT	CASRNVPVGFEAFF	TRBV6-5	TRBJ1-1
TGTGCCAGCAGCCAATCAGGGGTCTTTGCGATCTATGGCTACACCTTC	CASSQSGVFAIYGYTF	TRBV3-1	TRBJ1-2
TGTGCCAGCAGTTATCACGGCCAGAGCTATGGCTACACCTTC	CASSYHGQSYGYTF	TRBV12-3	TRBJ1-2
TGTGCCAGCAGTTTAGCAGGCGAGCAGTACTTC	CASSLAGEQYF	TRBV27	TRBJ2-7
TGTGCCAGCTCACCACCCCCGTGTCTCCAGGGGGCGTTTAGTGGGGCCAACGTCCTGACTTTC	CASSPPPCLQGAFSGANVLTF	TRBV18	TRBJ2-6
TGTGCCAGCTCAGAAAACACTGAAGCTTTCTTT	CASSENTEAFF	TRBV18	TRBJ1-1
TGTGCCAGCAGACCATCCTATAATTCACCCCTCCACTTT	CASRPSYNSPLHF	TRBV27	TRBJ1-6
TGTGCCAGCAGTAGGGCGGGGGCCCTGGATGAGCAGTTCTTC	CASSRAGALDEQFF	TRBV6-1	TRBJ2-1
TGTGCCAGCAGTGAACAGAGGGCGTCACCCCTCCACTTT	CASSEQRASPLHF	TRBV6-1	TRBJ1-6
TGTGCCAGCAGCAGTCACACGGCCGGGGAGCTGTTTTTT	CASSSHTAGELFF	TRBV7-3	TRBJ2-2
TGTGCCAGCAGCCCCCCGACGGCCTACGAGCAGTACTTC	CASSPPTAYEQYF	TRBV7-9	TRBJ2-7
TGTGCCAGCAGTCCAAGCGGCCGGACAGGAGTTTATAGCAATCAGCCCCAGCATTTT	CASSPSGRTGVYSNQPQHF	TRBV6-5	TRBJ1-5
TGCGCCAGCCAGGTCTGGGGCGAGGCCTACGAGCAGTACTTC	CASQVWGEAYEQYF	TRBV5-1	TRBJ2-7
TGTGCCAGCAGCTTGGCACCCCACTACGAGCAGTACTTC	CASSLAPHYEQYF	TRBV7-9	TRBJ2-7
TGCAGTGCTAGAGCCCCGGAAGTACTGGCCAATGAGCAGTTCTTC	CSARAPEVLANEQFF	TRBV20-1	TRBJ2-1
TGCGCCAGCAGCTTGATTCCACGTGAGGAGCGGAGCAATGAGCAGTTCTTC	CASSLIPREERSNEQFF	TRBV5-1	TRBJ2-1
TGTGCCAGTCAGGGGGCGGTAGAGACCCAGTACTTC	CASQGAVETQYF	TRBV19	TRBJ2-5
TGTGCCAGTAGTCCAATCCCCCCTGGGGAGACTTGCGAGCAGTACTTC	CASSPIPPGETCEQYF	TRBV19	TRBJ2-7
TGTGCCAGGGGCACCGGGGAGCTGTTTTTT	CARGTGELFF	TRBV19	TRBJ2-2
TGTGCCAGCAGTTTATCTATGACAGGGGGGAACACTGAAGCTTTCTTT	CASSLSMTGGNTEAFF	TRBV28	TRBJ1-1
TGTGCCAGCAGCTTCCAGGGGATTTTGGAAGATACGCAGTATTTT	CASSFQGILEDTQYF	TRBV7-6	TRBJ2-3
TGTGCCAGCACAGGCCGTTCAAGGACTAGCGAACACGAGCAGTACTTC	CASTGRSRTSEHEQYF	TRBV2	TRBJ2-7
TGTGCCAGCGGCACAGAAGGACAAGAGACCCAGTACTTC	CASGTEGQETQYF	TRBV5-5	TRBJ2-5
TGTGCCAGCAGCTACCCCGGGACTAGCGAATCAGATACGCAGTATTTT	CASSYPGTSESDTQYF	TRBV5-8	TRBJ2-3
TGTGCCAGCAGCCCCTTAGGATATTTAATAAACAATGAGCAGTTCTTC	CASSPLGYLINNEQFF	TRBV13	TRBJ2-1
TGTGCCAGCAGCGGGATAAGGCCTGGGCTAAACTCCTACAATGAGCAGTTCTTC	CASSGIRPGLNSYNEQFF	TRBV7-9	TRBJ2-1
TGTGCCAGCAGCCGGGCTATGCGCTCTGGAAACACCATATATTTT	CASSRAMRSGNTIYF	TRBV7-3	TRBJ1-3
TGCGCCAGCCGATGGGGGCAAGGCAATCAGCCCCAGCATTTT	CASRWGQGNQPQHF	TRBV5-1	TRBJ1-5
TGTGCCACCCGGGCGGGACGGGAGGGTAACTATGGCTACACCTTC	CATRAGREGNYGYTF	TRBV6-4	TRBJ1-2
TGCGCCAGCAGCTTACCCGCCGGTGCTCTGGACTACAATGAGCAGTTCTTC	CASSLPAGALDYNEQFF	TRBV5-1	TRBJ2-1
TGTGCCAGCAGCGTAGTTCTGGACTGGCAGTACTTC	CASSVVLDWQYF	TRBV9	TRBJ2-7
TGTGCCACCAGCACCGGCTCAGATACGCAGTATTTT	CATSTGSDTQYF	TRBV15	TRBJ2-3
TGTGCCAGCTTGGGGAGTAATTCACCCCTCCACTTT	CASLGSNSPLHF	TRBV6-4	TRBJ1-6
TGTGCCAGCAGGCCTAACTGGGGGGCCAAAAACATTCAGTACTTC	CASRPNWGAKNIQYF	TRBV7-3	TRBJ2-4
TGCGCCAGCAGTGTTGAAGGGCCTTCCTATCAAGAGACCCAGTACTTC	CASSVEGPSYQETQYF	TRBV10-1	TRBJ2-5
TGTGCCAGCAGCTTGACCATAGGGGGGGCGGCGGCCTACAATGAGCAGTTCTTC	CASSLTIGGAAAYNEQFF	TRBV7-9	TRBJ2-1
TGTGCCATACCGGGACAGGGATACAATGAGCAGTTCTTC	CAIPGQGYNEQFF	TRBV24-1	TRBJ2-1
TGTGCCACCCTCCCCAAAGACAGGGGGCGCGGGACAGCCTACGAGCAGTACTTC	CATLPKDRGRGTAYEQYF	TRBV7-9	TRBJ2-7
TGTGCCAGCAGCAGGACTAGCGGGTTCGGCTACAATGAGCAGTTCTTC	CASSRTSGFGYNEQFF	TRBV5-4	TRBJ2-1
TGTGCCAGCAGTGACAGGGGCTACGAGCAGTACTTC	CASSDRGYEQYF	TRBV12-3	TRBJ2-7
TGTGCCAATACCCGGGGACAGGGGGCACTCCCTTACGAGCAGTACTTC	CANTRGQGALPYEQYF	TRBV6-5	TRBJ2-7
TGCAGTGCTAGCATGTCCAATCTGTGTATCGGGGCTTTCTTT	CSASMSNLCIGAFF	TRBV20-1	TRBJ1-1
TGCGCCAGCATTCATACTAGCGGGGGGGCCGTTCTCGAGCAGTACTTC	CASIHTSGGAVLEQYF	TRBV4-3	TRBJ2-7
TGCGCCAGCAGCTTACCGTGGGCCAAGAACACTGAAGCTTTCTTT	CASSLPWAKNTEAFF	TRBV5-1	TRBJ1-1
TGTGTCTGGGGGGGGAGCGGAACTGCCTACGAGCAGTACTTC	CVWGGSGTAYEQYF	TRBV3-1	TRBJ2-7
TGTGCCAGCAGCGTCCGACCCCAGTCAGCGATAACCGGGGAGCTGTTTTTT	CASSVRPQSAITGELFF	TRBV11-2	TRBJ2-2
TGCGCCAGCAGCCCCCCCGGGACAGGGTTAGGGGGATCCTACGAGCAGTACTTC	CASSPPGTGLGGSYEQYF	TRBV4-1	TRBJ2-7
TGCAGTGCAGTTTCCTGCACAGATACGCAGTATTTT	CSAVSCTDTQYF	TRBV20-1	TRBJ2-3
TGTGCCAGTAGTATGTTACCAGGGGGGGGCACAGATACGCAGTATTTT	CASSMLPGGGTDTQYF	TRBV19	TRBJ2-3
TGTGCCAGCAGCGGAAACGGATCGTACGGCTACACCTTC	CASSGNGSYGYTF	TRBV5-6	TRBJ1-2
TGTGCCAGCAGTGTATGTATTCATTGGAGGTCCCGCACAGATACGCAGTATTTT	CASSVCIHWRSRTDTQYF	TRBV2	TRBJ2-3
TGTGCCAGCAGCACTGGACCCAATCAGCCCCAGCATTTT	CASSTGPNQPQHF	TRBV5-6	TRBJ1-5
TGTGCCAGCAGTGATTCCCGGACCGGGCTTAGAAGGGAGCCCCAGCATTTT	CASSDSRTGLRREPQHF	TRBV25-1	TRBJ1-5
TGTGCCAGTAGTATGGACTACGAGCAGTACTTC	CASSMDYEQYF	TRBV19	TRBJ2-7
TGTGCCAGCAGCCTGCTCCGGGACAGGGTGTGGAAGAGCTCCTACAATGAGCAGTTCTTC	CASSLLRDRVWKSSYNEQFF	TRBV7-3	TRBJ2-1
TGTGCCAGCATGCGGGACAGGAGGAGCTCCTACAATGAGCAGTTCTTC	CASMRDRRSSYNEQFF	TRBV11-3	TRBJ2-1
TGTGCCAGCAGCCAAGATCCAATCCCCCTAGGGTACACCTTC	CASSQDPIPLGYTF	TRBV3-1	TRBJ1-2
TGTGCCACCAGTGAATTCCGGGACAGGCGGCAGTACTTC	CATSEFRDRRQYF	TRBV24-1	TRBJ2-7
TGCGCCAGCCCTCGGACAGGGGGACCCTCCTACGAGCAGTACTTC	CASPRTGGPSYEQYF	TRBV10-1	TRBJ2-7
TGTGCCAGCAGTGACCAGCCGGGACAGGGTTTCTCTGGAAACACCATATATTTT	CASSDQPGQGFSGNTIYF	TRBV6-1	TRBJ1-3
TGCAGTGCTAGAGGGGGGGGAGTGAGGAACACTGAAGCTTTCTTT	CSARGGGVRNTEAFF	TRBV20-1	TRBJ1-1
TGTGCCCGACACTCGGATCAGCCCCAGCATTTT	CARHSDQPQHF	TRBV5-6	TRBJ1-5
TGTGCCAGCAGTTGCGGCCTAGGCGGCGCGGAAAGCTCCTACGAGCAGTACTTC	CASSCGLGGAESSYEQYF	TRBV12-4	TRBJ2-7
TGTGCTAGCAGCGGAGGGGCGAGCTTC	CASSGGASF	TRBV7-7	TRBJ2-7
TGTGCCAGCAGCGTAGCGGGACAGAAAGAGACAGATACGCAGTATTTT	CASSVAGQKETDTQYF	TRBV9	TRBJ2-3
TGTGCCAGCAGCTTAGAAATATCAACCGGACACCAAGCTTTCTTT	CASSLEISTGHQAFF	TRBV11-3	TRBJ1-1
TGTGCCAGCAATCAGGGGGCGCCCCCCGGCTACGAGCAGTACTTC	CASNQGAPPGYEQYF	TRBV7-9	TRBJ2-7
TGCGCCAGCGGAGACAGGGTTAATTCTAGCACAGATACGCAGTATTTT	CASGDRVNSSTDTQYF	TRBV5-1	TRBJ2-3
TGCAGTGCTCCCTGGACAGGGGTTGGCAAGACCCAGTACTTC	CSAPWTGVGKTQYF	TRBV20-1	TRBJ2-5
TGTGCCAGCAGCCGGGCCCGACAGTTCTCCTACGAGCAGTACTTC	CASSRARQFSYEQYF	TRBV13	TRBJ2-7
TGTGCCAGCAGTGCCGGACAGGCAAGGCTTCAGCCCCAGCATTTT	CASSAGQARLQPQHF	TRBV6-1	TRBJ1-5
TGTGCCAGCAAAGGGGGGGGCGGCACTGAAGCTTTCTTT	CASKGGGGTEAFF	TRBV2	TRBJ1-1
TGTGCCAGCAGTTACAAGGGGACAGGAGCTGAAGCTTTCTTT	CASSYKGTGAEAFF	TRBV6-5	TRBJ1-1
TGTGCCAGCAGCGGTCCTAGCGGGGGGCAGAATGAGCAGTTCTTC	CASSGPSGGQNEQFF	TRBV9	TRBJ2-1
TGTGCCAGCAGCACTGAGAGGCGGGACAGCCTAAACTATGGCTACACCTTC	CASSTERRDSLNYGYTF	TRBV5-6	TRBJ1-2
TGTGCCAGCAGTGCCCCAGGGGGACACGGCTTGTGGGTAGATAATTCACCCCTCCACTTT	CASSAPGGHGLWVDNSPLHF	TRBV11-3	TRBJ1-6
TGCAGTGCTGGTACCCCGGGGACAGGGCATGAAATAGATACGCAGTATTTT	CSAGTPGTGHEIDTQYF	TRBV20-1	TRBJ2-3
TGCGCCAGCAGCCAAGGGCCTGACGACACTGAAGCTTTCTTT	CASSQGPDDTEAFF	TRBV4-1	TRBJ1-1
TGTGCCAGCACATTGGCGGGGGCTGGGGATTCACCCCTCCACTTT	CASTLAGAGDSPLHF	TRBV2	TRBJ1-6
TGTGCCAGCAGCTCATATTGGGGGCATCAGCCCCAGCATTTT	CASSSYWGHQPQHF	TRBV7-9	TRBJ1-5
TGTGCCAGCAGCGAAGGAGAGACCCTTAATCCGAACCCCTACGAGCAGTACTTC	CASSEGETLNPNPYEQYF	TRBV11-3	TRBJ2-7
TGCGCCAGCAGCCAAAAACCGGGACAGGGAGGCTCCTATAATTCACCCCTCCACTTT	CASSQKPGQGGSYNSPLHF	TRBV4-1	TRBJ1-6
TGCGCCAGCACACAGGAGGGCCTAGATCAGCCCCAGCATTTT	CASTQEGLDQPQHF	TRBV10-2	TRBJ1-5
TGTGCCAGCAGCTTAGCCACCCCCCGGGCAACCGAGAAAAACATTCAGTACTTC	CASSLATPRATEKNIQYF	TRBV7-4	TRBJ2-4
TGTGCCAGCAGCAGGGACACCAATCAGCCCCAGCATTTT	CASSRDTNQPQHF	TRBV7-3	TRBJ1-5
TGCAGTGCTAGAGATCGATGGGACAGGGTCGACCACCAAGAGACCCAGTACTTC	CSARDRWDRVDHQETQYF	TRBV20-1	TRBJ2-5
TGCGCCAGCAGCCAAAGGGGACAGACGTACCAAGAGACCCAGTACTTC	CASSQRGQTYQETQYF	TRBV4-1	TRBJ2-5
TGCGCCAGCCCAACGGACAGCCGTGGGCTCCACACTGAAGCTTTCTTT	CASPTDSRGLHTEAFF	TRBV5-1	TRBJ1-1
TGTGCCAGCAGCTTAATTGGGGGCTTTTTCGAGCAGTACTTC	CASSLIGGFFEQYF	TRBV11-2	TRBJ2-7
TGTGCCAGCAGCCATAGGGGGGCCGTCACAGATACGCAGTATTTT	CASSHRGAVTDTQYF	TRBV6-6	TRBJ2-3
TGTGCCAGCACCCCCACAGGGGGCGACGGCTACACCTTC	CASTPTGGDGYTF	TRBV7-9	TRBJ1-2
TGTGCCAGCAGCTTCCAGGGCACCAGGACGAACACTGAAGCTTTCTTT	CASSFQGTRTNTEAFF	TRBV5-5	TRBJ1-1
TGTGCCAGTAGTATAGCCGGGAGGGTTAAGCAAGAGACCCAGTACTTC	CASSIAGRVKQETQYF	TRBV19	TRBJ2-5
TGCGCCAGCAGCACAAATTCGCCAGGACAGGCTAGCTATGGCTACACCTTC	CASSTNSPGQASYGYTF	TRBV5-1	TRBJ1-2
TGTGCCAGCAGTGACTGTGAAGGAGATACGCAGTATTTT	CASSDCEGDTQYF	TRBV6-4	TRBJ2-3
TGTGCCAGCAGCTCCGGGGGAGGAGAAAACATTCAGTACTTC	CASSSGGGENIQYF	TRBV7-9	TRBJ2-4
TGCGCCAGCAGCTTGGCCCTTAGCGGGACAGGGGGCATCTTCTATGAGCAGTTCTTC	CASSLALSGTGGIFYEQFF	TRBV5-1	TRBJ2-1
TGTGCCAGCAGCACGCGACAGGGATATGCTACTAATGAAAAACTGTTTTTT	CASSTRQGYATNEKLFF	TRBV13	TRBJ1-4
TGCGCCAGCAGCGGGGGATCGAGCTCCTACGAGCAGTACTTC	CASSGGSSSYEQYF	TRBV5-1	TRBJ2-7
TGTGCCAGCCTTGGGGGCATGGCTGGCTCTGGAAACACCATATATTTT	CASLGGMAGSGNTIYF	TRBV7-9	TRBJ1-3
TGTGCCAGCAGCCATGGAGGCTTGGAGACCCAGTACTTC	CASSHGGLETQYF	TRBV7-3	TRBJ2-5
TGCAGTGCTAGTAGGGGTCTCGGCGCCGGACTAGCGGGCAATGAGCAGTTCTTC	CSASRGLGAGLAGNEQFF	TRBV20-1	TRBJ2-1
TGTGCCAGCAGCGTAGCACATCTGAACACTGAAGCTTTCTTT	CASSVAHLNTEAFF	TRBV9	TRBJ1-1
TGTGCCAGCAGCTTAGGTCTCGGGGGGAAGGCTAGCACAGATACGCAGTATTTT	CASSLGLGGKASTDTQYF	TRBV7-9	TRBJ2-3
TGTGCCAGCAGTCTCAGGAGTACGCAGTATTTT	CASSLRSTQYF	TRBV6-1	TRBJ2-3
TGCGCCAGCAGTGCTGGAGCGGGAAAGTACGAGCAGTACTTC	CASSAGAGKYEQYF	TRBV10-1	TRBJ2-7
TGTGCCAGCAGCGCTTACGGACTTGGAGACATTCAGTACTTC	CASSAYGLGDIQYF	TRBV13	TRBJ2-4
TGCAGTGCTAGAGCCCTAGCTTACGAGCAGTACTTC	CSARALAYEQYF	TRBV20-1	TRBJ2-7
TGCGCCAGCAGCCTAGGGGATGAGCAGTTCTTC	CASSLGDEQFF	TRBV5-1	TRBJ2-1
TGCGCCAGCAGCTTCCGCAGGGGGCGCAGCTCCTACAATGAGCAGTTCTTC	CASSFRRGRSSYNEQFF	TRBV5-1	TRBJ2-1
TGCGCCAGCAGTGAACACGGAGCGGGATGCCCGAGCTCCTACAATGAGCAGTTCTTC	CASSEHGAGCPSSYNEQFF	TRBV10-1	TRBJ2-1
TGTGCCACCACGCTGCATCAGCCCCAGCATTTT	CATTLHQPQHF	TRBV24-1	TRBJ1-5
TGCAGCGTTGACGCCGAGGTACCCTACGAGCAGTACTTC	CSVDAEVPYEQYF	TRBV29-1	TRBJ2-7
TGTGCCATCAGTGAGTGCCCACCTGTTTATAGGGGAGAGTACAATGAGCAGTTCTTC	CAISECPPVYRGEYNEQFF	TRBV10-3	TRBJ2-1
TGCGCCAGCAGTGGCAACCATCCAGCCAGCCCCGACGGAGGCACAGATACGCAGTATTTT	CASSGNHPASPDGGTDTQYF	TRBV10-1	TRBJ2-3
TGTGCCAGCAGCTTACTGCATGCGACAGGGTGGGGGAACACCGGGGAGCTGTTTTTT	CASSLLHATGWGNTGELFF	TRBV11-3	TRBJ2-2
TGTGCCAGCCGTACCGGGACAGGGCGAGTCGATCAGCCCCAGCATTTT	CASRTGTGRVDQPQHF	TRBV2	TRBJ1-5
TGCGCCAGCAGCCGCACTCGGACTAGCACAGATACGCAGTATTTT	CASSRTRTSTDTQYF	TRBV4-1	TRBJ2-3
TGTGCCATCAGTGAGAAGCGGGCAGCCTTTCCGGGCTACACCTTC	CAISEKRAAFPGYTF	TRBV10-3	TRBJ1-2
TGTGCCACCAGATTCACAGGGCAAACTGAAGCTTTCTTT	CATRFTGQTEAFF	TRBV24-1	TRBJ1-1
TGTGCCAGTGCATATTTTTGGACAGCCCCCGGGGCCTATGGCTACACCTTC	CASAYFWTAPGAYGYTF	TRBV3-1	TRBJ1-2
TGTGCCAGCAGCGGGCCCGGAGGCGCTTTCTTT	CASSGPGGAFF	TRBV13	TRBJ1-1
TGTGCCAGCAGTTACTCACCTGGAGGGGTCGATGGGGTCTGGATCAATCAGCCCCAGCATTTT	CASSYSPGGVDGVWINQPQHF	TRBV6-3	TRBJ1-5
TGCAGCGTTAGACGGGGCCAGTACTTC	CSVRRGQYF	TRBV29-1	TRBJ2-5
TGTGCCATCAGTGGCTGGCAAGGGGGGACTAGCGGGGAGCAGTACTTC	CAISGWQGGTSGEQYF	TRBV10-3	TRBJ2-7
TGTGCCAGCAGTAACCCCATGGGATCGGGGTACGAGCAGTACTTC	CASSNPMGSGYEQYF	TRBV6-5	TRBJ2-7
TGTGCCAGCAGTGAATTCGACAGGGGAGAGCGTTATGGCTACACCTTC	CASSEFDRGERYGYTF	TRBV27	TRBJ1-2
TGCGCCAGCAGCCAAGATCCGAGTCGTCTAGATGGGGCCTACGAGCAGTACTTC	CASSQDPSRLDGAYEQYF	TRBV4-1	TRBJ2-7
TGCAGTGCTAGAGCCATGGACAGGGCAGGGACGGATAGCAATCAGCCCCAGCATTTT	CSARAMDRAGTDSNQPQHF	TRBV20-1	TRBJ1-5
TGTGCCAGCAGCGGACAGGAAACCTACGAGCAGTACTTC	CASSGQETYEQYF	TRBV11-3	TRBJ2-7
TGTGCCAGCAGCAAAGGGAGGAATCCTCAGCTTGAGGCCTATGCAACTAATGAAAAACTGTTTTTT	CASSKGRNPQLEAYATNEKLFF	TRBV7-2	TRBJ1-4
TGTGCCTGGGCAGGGGGGGTGGTAGGGGCCTCCTACAATGAGCAGTTCTTC	CAWAGGVVGASYNEQFF	TRBV30	TRBJ2-1
TGTGCCAGCAAGTCTGGACAGGGCCACAATGAGCAGTTCTTC	CASKSGQGHNEQFF	TRBV27	TRBJ2-1
TGTGCCAGCAGCTTGGCCTTATGGGACAGAAGGGCCGGTAATTCACCCCTCCACTTT	CASSLALWDRRAGNSPLHF	TRBV5-5	TRBJ1-6
TGTGATGGGGGAGAAGATACGCAGTATTTT	CDGGEDTQYF	TRBV12-3	TRBJ2-3
TGCGCCAGCAGTGGGCATGGACTAGCGGAGACCCAGTACTTC	CASSGHGLAETQYF	TRBV10-2	TRBJ2-5
TGCAGTGCTAGAGGGTTCCGGGGGGGCTCCTACGAGCAGTACTTC	CSARGFRGGSYEQYF	TRBV20-1	TRBJ2-7
TGTGCCAGCAGGTTGCCCGGGGGTCAAGAGACCCAGTACTTC	CASRLPGGQETQYF	TRBV6-5	TRBJ2-5
TGTGCCAGCAGCCAAGGGGGGACCTCTTGGACAGATACGCAGTATTTT	CASSQGGTSWTDTQYF	TRBV4-2	TRBJ2-3
TGTGCCAGCAGCTTATGTTACTCCCAACAGCCTCTGGGTCTCTACACCTTC	CASSLCYSQQPLGLYTF	TRBV7-2	TRBJ1-2
TGTGCCAGCAGCCTGCCTCTCTGGGACAGCTCGTCCTACGAGCAGTACTTC	CASSLPLWDSSSYEQYF	TRBV7-3	TRBJ2-7
TGCGCCAGCAGGGGACTCTACAATGAGCAGTTCTTC	CASRGLYNEQFF	TRBV10-1	TRBJ2-1
TGCGCCAGCAGACGCGGGGGGGGTTGTCATGGCTACACCTTC	CASRRGGGCHGYTF	TRBV5-1	TRBJ1-2
TGCGCCAGCAGCCAAGGATGGACGAGGGGGTACTTC	CASSQGWTRGYF	TRBV4-1	TRBJ2-7
TGTGCCAGCAGCTTACTAACTAGCTCCTACAATGAGCAGTTCTTC	CASSLLTSSYNEQFF	TRBV11-3	TRBJ2-1
TGTGCCACCAGCTGTTTCCTCGGGGGTTTTTACTACGAGCAGTACTTC	CATSCFLGGFYYEQYF	TRBV15	TRBJ2-7
TGTGCCAGGGCGGGAGGGGGGGGGTTTAATGAAAAACTGTTTTTT	CARAGGGGFNEKLFF	TRBV2	TRBJ1-4
TGTGCCAGCAGTGTCACGACAGGAGACACCGGGGAGCTGTTTTTT	CASSVTTGDTGELFF	TRBV25-1	TRBJ2-2
TGTGCCAGCAGAGTAATGGTGTGGACAGGGGGGAATGGCTACACCTTC	CASRVMVWTGGNGYTF	TRBV5-5	TRBJ1-2
TGCAGTGATAGCAGGGTCCCGTATTTTTGCAATCAGCCCCAGCATTTT	CSDSRVPYFCNQPQHF	TRBV20-1	TRBJ1-5
TGTGCCAGCAGCTTGTCTGGACAAACGGGTAGGGGCTACACCTTC	CASSLSGQTGRGYTF	TRBV5-6	TRBJ1-2
TGCAGTGCTAGTGGAGCCCGGGCGGCCTACGAGCAGTACTTC	CSASGARAAYEQYF	TRBV20-1	TRBJ2-7
TGTGCCATCAGTGAGACGATCTCCCCAGGGATTTCCTATAATTCACCCCTCCACTTT	CAISETISPGISYNSPLHF	TRBV10-3	TRBJ1-6
TGTGCCAGCAGCCATAGAACAGGGTTGCTCGCGAACTATGGCTACACCTTC	CASSHRTGLLANYGYTF	TRBV14	TRBJ1-2
TGTGCCAGCAGTCCAGGACGCCATGAAAAACTGTTTTTT	CASSPGRHEKLFF	TRBV27	TRBJ1-4
TGTGCCATCAGTGAACGCGCCGTGGCAGCTACTAGCAATCAGCCCCAGCATTTT	CAISERAVAATSNQPQHF	TRBV10-3	TRBJ1-5
TGCAGTGCTGGGCGGGTCGGAGGAAATCAGCCCCAGCATTTT	CSAGRVGGNQPQHF	TRBV20-1	TRBJ1-5
TGTGCCAGCAGCGTAGACGATCCAAACCGGCGGAGGGGGGAAGACGAGCAGTACTTC	CASSVDDPNRRRGEDEQYF	TRBV9	TRBJ2-7
TGTGCCACCAGCAGGGGGACTAGCGGGAGCTACGTAAACATTCAGTACTTC	CATSRGTSGSYVNIQYF	TRBV15	TRBJ2-4
TGTGCCACAGGCCCGGGACAGGGGTCAAGGGGAAACACCATATATTTT	CATGPGQGSRGNTIYF	TRBV19	TRBJ1-3
TGTGCCAGCAGCTCTCAGACACTGGGGGCTGGGGCGGCCAACGTCCTGACTTTC	CASSSQTLGAGAANVLTF	TRBV7-9	TRBJ2-6
TGTGCCAGCAGCGGTGGGGTCGACGAGACCCAGTACTTC	CASSGGVDETQYF	TRBV13	TRBJ2-5
TGTGCCATCAGTGAGCCGAATGCGACAGGGCATGGCTACACCTTC	CAISEPNATGHGYTF	TRBV10-3	TRBJ1-2
TGTGCCAGCAGTGAAAGGACAGGGCGGGGGTACTACGAGCAGTACTTC	CASSERTGRGYYEQYF	TRBV2	TRBJ2-7
TGTGCCAGCAGCGTAGCAGCTGGGACTAGGGGCAAAAACATTCAGTACTTC	CASSVAAGTRGKNIQYF	TRBV9	TRBJ2-4
TGTGCCACCAGCAGAGTTATGGGGGGGGAGAACACTGAAGCTTTCTTT	CATSRVMGGENTEAFF	TRBV15	TRBJ1-1
TGTGCCAGCAGTAAATCGGCACATTCCTATAATTCACCCCTCCACTTT	CASSKSAHSYNSPLHF	TRBV27	TRBJ1-6
TGTGCCAGCAGTTACTCAACCAGGACAGTCGGTCTCATGGGTATACACGCCGGGGAGCTGTTTTTT	CASSYSTRTVGLMGIHAGELFF	TRBV6-3	TRBJ2-2
TGTGCCAGTAGTATGGGCCGGGACTACGAGCAGTACTTC	CASSMGRDYEQYF	TRBV19	TRBJ2-7
TGTGCCAGCAGCCTCTGGGGACTAGCGTGGTACTACAATGAGCAGTTCTTC	CASSLWGLAWYYNEQFF	TRBV7-6	TRBJ2-1
TGTGCCACCTCTAGCGGGTTATTTGACCGGGTCTCCTACAATGAGCAGTTCTTC	CATSSGLFDRVSYNEQFF	TRBV30	TRBJ2-1
TGCGCCAGCCCATGTGGGACAGGCAGTGACGAGCAGTACTTC	CASPCGTGSDEQYF	TRBV5-1	TRBJ2-7
TGTGCCAGCAGCCTACCCGGGCCTGGAGGGAGGAACACTGAAGCTTTCTTT	CASSLPGPGGRNTEAFF	TRBV5-6	TRBJ1-1
TGCGCCAGCAGCTCCGGGCGGTCCAGCCCGAATGATATGGCTAATGAAAAACTGTTTTTT	CASSSGRSSPNDMANEKLFF	TRBV5-1	TRBJ1-4
TGTGCCAGCAGTTCCATCAGGACAGCATGCTCTGGGGCCAACGTCCTGACTTTC	CASSSIRTACSGANVLTF	TRBV6-5	TRBJ2-6
TGTGCCAGCAGCAATCTGAGACAGGGGGCTGATGGCTACACCTTC	CASSNLRQGADGYTF	TRBV9	TRBJ1-2
TGTGCCAGCAGTGTGGGGGGGAGCTCCTACAATGAGCAGTTCTTC	CASSVGGSSYNEQFF	TRBV6-5	TRBJ2-1
TGTGCCAGCAGCCACCCCCGGGACAGGGGTGGGACTGAAGCTTTCTTT	CASSHPRDRGGTEAFF	TRBV27	TRBJ1-1
TGTGCCAGCAGACGCAGGGGAGGAGGAGAGACCCAGTACTTC	CASRRRGGGETQYF	TRBV6-4	TRBJ2-5
TGTGCCAGCAGTTACGGGCTGAAAACGACGTGCCGGCGCACAGATACGCAGTATTTT	CASSYGLKTTCRRTDTQYF	TRBV6-5	TRBJ2-3
TGCAGTGCTATGGAAGGGACTAGCTACGAGCAGTACTTC	CSAMEGTSYEQYF	TRBV20-1	TRBJ2-7
TGTGCCAGCAGTGAACCCGGGGAAAATGAAAAACTGTTTTTT	CASSEPGENEKLFF	TRBV6-1	TRBJ1-4
TGTGCCAGCAGCTTCCTAATGACTAGCGGGCGGAGTCGCCACGACAATGAGCAGTTCTTC	CASSFLMTSGRSRHDNEQFF	TRBV7-7	TRBJ2-1
TGTGCCAGCAGTCAGGTTGGCGGCAATCAGCCCCAGCATTTT	CASSQVGGNQPQHF	TRBV12-3	TRBJ1-5
TGCAGCGCTCAGGGGACAGATACGCAGTATTTT	CSAQGTDTQYF	TRBV29-1	TRBJ2-3
TGTGCCAGCAGCCCATGGAGGGACCAGGGGGAAGAAAAACTGTTTTTT	CASSPWRDQGEEKLFF	TRBV14	TRBJ1-4
TGTGCCAGCAGCCAAGATGACAGGGCGGACACCGGGGAGCTGTTTTTT	CASSQDDRADTGELFF	TRBV14	TRBJ2-2
TGTGCCAGCAGTGAAAGACTAGCGGCGTCCTACGAGCAGTACTTC	CASSERLAASYEQYF	TRBV2	TRBJ2-7
TGTGCCAGCAGCCATGACAGAGGACAATTCCAGCCCCAGCATTTT	CASSHDRGQFQPQHF	TRBV14	TRBJ1-5
TGTGCCAGCAGCGTAGCCATTCGTCCCCGGGACGGCCATGGCTACACCTTC	CASSVAIRPRDGHGYTF	TRBV9	TRBJ1-2
TGTGCCAGCAGGCAACCGGGACAGGGGGGCGAAAACACCATATATTTT	CASRQPGQGGENTIYF	TRBV12-4	TRBJ1-3
TGTGCCAGCAGCGGCCCCCTCGGGCTCTCCAAGAACACCGGGGAGCTGTTTTTT	CASSGPLGLSKNTGELFF	TRBV13	TRBJ2-2
TGTGCCAGCAGCCCAGTCTCTGGAAACACCATATATTTT	CASSPVSGNTIYF	TRBV12-3	TRBJ1-3
TGTGCCAGCAGCGACGGGACTAGCGGGTTGCGAGTCAATGAGCAGTTCTTC	CASSDGTSGLRVNEQFF	TRBV9	TRBJ2-1
TGTGCCAGCAGCTTAGCGGGCAATCAGCCCCAGCATTTT	CASSLAGNQPQHF	TRBV7-8	TRBJ1-5
TGTGCCAGCAGCCAAGGAACGACGGGCAGCTCCTACAATGAGCAGTTCTTC	CASSQGTTGSSYNEQFF	TRBV14	TRBJ2-1
TGTGCCAGCAGTGCAGGAGATGAGCAGTTCTTC	CASSAGDEQFF	TRBV7-9	TRBJ2-1
TGTGCCAGTAGTATCAAAACCCGGGGTTCGGGGCTCACAGATACGCAGTATTTT	CASSIKTRGSGLTDTQYF	TRBV19	TRBJ2-3
TGCAGCGTTAATTCGGGAGCTGGCTACGAGCAGTACTTC	CSVNSGAGYEQYF	TRBV29-1	TRBJ2-7
TGTGCCAGCAGCCGACAGAGTAACACTGAAGCTTTCTTT	CASSRQSNTEAFF	TRBV3-1	TRBJ1-1
TGTGCCAGCAGCCAAGCCCGCAGGGGGCTCTCGAACACTGAAGCTTTCTTT	CASSQARRGLSNTEAFF	TRBV14	TRBJ1-1
TGTGCCAGCAGCTTGGTACCCAAGGGGGGGGTGCCGGGTAACTACAATGAGCAGTTCTTC	CASSLVPKGGVPGNYNEQFF	TRBV5-4	TRBJ2-1
TGTGCCAGCAGCCAAGAAATGTGGGGGGAGCAGTACTTC	CASSQEMWGEQYF	TRBV14	TRBJ2-7
TGTGCCAGCAGTTTATGGCAACGCAGGGGACGCTCCTACGAGCAGTACTTC	CASSLWQRRGRSYEQYF	TRBV27	TRBJ2-7
TGTGCCAGCAGCCACGGCAGGGGGGCTGAGCAGTTCTTC	CASSHGRGAEQFF	TRBV14	TRBJ2-1
TGTGCCAGCAGCTTAGCGACCCCAGGGGGGAAACCCCTCCACTTT	CASSLATPGGKPLHF	TRBV7-2	TRBJ1-6
TGTGCCAGCAGCCGGATACGGGACTTCGGCTATGGCTACACCTTC	CASSRIRDFGYGYTF	TRBV7-4	TRBJ1-2
TGTGCCACCAGCCGGGCGGTACTAGCGGGAGGGTTAGCCAAAAACATTCAGTACTTC	CATSRAVLAGGLAKNIQYF	TRBV24-1	TRBJ2-4
TGCGCCAGCAGCCAAGTTCCCTGGAGCAATCAGCCCCAGCATTTT	CASSQVPWSNQPQHF	TRBV4-1	TRBJ1-5
TGCAGTGCTATAAGCAACCACGGGGCCGGAACTAATGAAAAACTGTTTTTT	CSAISNHGAGTNEKLFF	TRBV20-1	TRBJ1-4
TGTGCCAGCAGCTTGAGGGAGTGGGGGCGGACAGATACGCAGTATTTT	CASSLREWGRTDTQYF	TRBV5-6	TRBJ2-3
TGCGCCAGCAGCCGACTAGAAGATACGCAGTATTTT	CASSRLEDTQYF	TRBV5-1	TRBJ2-3
TGTGCCAGCACAAGGACAGGGGGCTTAGAACCCTACGAGCAGTACTTC	CASTRTGGLEPYEQYF	TRBV7-9	TRBJ2-7
TGTGCCAGTAGTATCCCACCGGGACAGGGCAAATGCGATCAGCCCCAGCATTTT	CASSIPPGQGKCDQPQHF	TRBV19	TRBJ1-5
TGCAGTGCTACCCGACTCTACAATGAGCAGTTCTTC	CSATRLYNEQFF	TRBV20-1	TRBJ2-1
TGCAGTGCGGGACCGGGCTTT	CSAGPGF	TRBV20-1	TRBJ1-1
TGTGCCAGCAACGGACATCCCCCTGGAAACACCATATATTTT	CASNGHPPGNTIYF	TRBV7-3	TRBJ1-3
TGTGCCAGGGGGGACAGAGACGATTACACTGAAGCTTTCTTT	CARGDRDDYTEAFF	TRBV6-6	TRBJ1-1
TGCGCCAGCAGCCAGGGACCCAGGGACACCTCTGGAAACACCATATATTTT	CASSQGPRDTSGNTIYF	TRBV4-3	TRBJ1-3
TGCAGTGCTCTTCCGGACAGGGGGCGCTCCTATAATTCACCCCTCCACTTT	CSALPDRGRSYNSPLHF	TRBV20-1	TRBJ1-6
TGTGCCAGCAGCTTGGCCCCCCGGGGCTTCGATACGCAGTATTTT	CASSLAPRGFDTQYF	TRBV5-4	TRBJ2-3
TGCGCCAGCAGCTTACGGAGTCCTGGCTACACCTTC	CASSLRSPGYTF	TRBV5-1	TRBJ1-2
TGTGCCAGCAGTGGGGGGGGGTTAGAGACCCAGTACTTC	CASSGGGLETQYF	TRBV28	TRBJ2-5
TGCAGCGTTGTGGGTGGTGGGGATCCTGGCTACACCTTC	CSVVGGGDPGYTF	TRBV29-1	TRBJ1-2
TGTGCCAGCAGTAGTATTACCCGGGACAATGGCTACACCTTC	CASSSITRDNGYTF	TRBV6-2	TRBJ1-2
TGTGCCAGCAGCCGACAGCTTACGGGCAATCAGCCCCAGCATTTT	CASSRQLTGNQPQHF	TRBV7-3	TRBJ1-5
TGTGCCAGTACGCTCAGGGGGAACACTGAAGCTTTCTTT	CASTLRGNTEAFF	TRBV19	TRBJ1-1
TGTGCCAGCAGTTACCGGGACTACAATGAGCAGTTCTTC	CASSYRDYNEQFF	TRBV6-5	TRBJ2-1
TGTGCTAGTGGTTTGGTACCTCGGTGGAAGAAGGGGGCTGGCTACACCTTC	CASGLVPRWKKGAGYTF	TRBV12-5	TRBJ1-2
TGCAGTGCTAGAGATATCGACAGCCGGTTTGGCTACACCTTC	CSARDIDSRFGYTF	TRBV20-1	TRBJ1-2
TGCAGTGCTAGAGATAGGTGGACAGATGAAAAACTGTTTTTT	CSARDRWTDEKLFF	TRBV20-1	TRBJ1-4
TGTGCCAACGGCAGAGACTCAACTGAAGCTTTCTTT	CANGRDSTEAFF	TRBV12-4	TRBJ1-1
TGTGCCAGCAGCGACAGGGTGCGCTATGGCTACACCTTC	CASSDRVRYGYTF	TRBV9	TRBJ1-2
TGTGCCAGCAGCTTAGCGCGTTCGAGGGGGGCCTACGAGCAGTACTTC	CASSLARSRGAYEQYF	TRBV7-9	TRBJ2-7
TGTGCCAGCAGCGACCGAAGGAGTACTGAAGCTTTCTTT	CASSDRRSTEAFF	TRBV7-9	TRBJ1-1
TGTGCCAGCAGTGGCTATAGCAATCAGCCCCAGCATTTT	CASSGYSNQPQHF	TRBV12-4	TRBJ1-5
TGCGCCAGCAGAATACAGGGGACTAACTATGGCTACACCTTC	CASRIQGTNYGYTF	TRBV10-1	TRBJ1-2
TGCGCCAGCAGCGTCCCGGGGCCGGGGACCGAAGCTTTCTTT	CASSVPGPGTEAFF	TRBV4-3	TRBJ1-1
TGCGCCGGGTTCCTAGTGAGTACAGAGACCCAGTACTTC	CAGFLVSTETQYF	TRBV10-2	TRBJ2-5
TGTGCTAGTGGTTCCCGGGACATATTCGAGCAGTACTTC	CASGSRDIFEQYF	TRBV12-5	TRBJ2-7
TGTGCCCGGGACAGGCTGAACTATGGCTACACCTTC	CARDRLNYGYTF	TRBV28	TRBJ1-2
TGCGCCAGCAGCCCCCTCCAGGGTGGTTCTTCGCTTAAGGCCTACGAGCAGTACTTC	CASSPLQGGSSLKAYEQYF	TRBV5-1	TRBJ2-7
TGTGCCACCAGCAGAGACCAGCCGGGACAGGGGTGGGGGGCAGATACGCAGTATTTT	CATSRDQPGQGWGADTQYF	TRBV15	TRBJ2-3
TGTGCCAGTAGTAGTGACTCACCACGACAGTTGGGAAAACTGTTTTTT	CASSSDSPRQLGKLFF	TRBV19	TRBJ1-4
TGCGCCAGCAGCTTGGGGGGGGGGGGCCTGGTCCCACGTCCCAGACCCTACGAGCAGTACTTC	CASSLGGGGLVPRPRPYEQYF	TRBV5-1	TRBJ2-7
TGTGCCAGCAGACTAGGACATCCAACCAAAAACATTCAGTACTTC	CASRLGHPTKNIQYF	TRBV28	TRBJ2-4
TGTGCCAGCAGATCTCAGCGGGACGACTACGAGCAGTACTTC	CASRSQRDDYEQYF	TRBV27	TRBJ2-7
TGTGCCAGCAGCTTAAGGGTAGAGGGAGTGCCTCTTCCCGGGGAGCTGTTTTTT	CASSLRVEGVPLPGELFF	TRBV7-3	TRBJ2-2
TGTGCCAGCAGCCAAGAACGTCTCCCCAGGGATAGCAATCAGCCCCAGCATTTT	CASSQERLPRDSNQPQHF	TRBV14	TRBJ1-5
TGTGCCAGCAGCCAAGGCCCCGGGCCCCGGGGCGCCATTCACTATGGCTACACCTTC	CASSQGPGPRGAIHYGYTF	TRBV3-1	TRBJ1-2
TGTGCCAGCAGCCAAGGTTTTGGGTGTCTACAGGATCAGCCCCAGCATTTT	CASSQGFGCLQDQPQHF	TRBV3-1	TRBJ1-5
TGTGCCAGTAGTTGGACAGGGGTGGGCTCCGAGCAGTACTTC	CASSWTGVGSEQYF	TRBV19	TRBJ2-7
TGTGCCATCAGGAGGGACTCGACAGGCGAGCAGTACTTC	CAIRRDSTGEQYF	TRBV10-3	TRBJ2-7
TGTGCCATCAGTGAGCCCTACAGGGGCTCGCCCCAGCATTTT	CAISEPYRGSPQHF	TRBV10-3	TRBJ1-5
TGCGCCAGGAGAACCGTTAGGGGGGGGGCCAGCAATCAGCCCCAGCATTTT	CARRTVRGGASNQPQHF	TRBV5-1	TRBJ1-5
TGTGCCAGCAGTCGAGCGCTCGAACCCTACGAGCAGTACTTC	CASSRALEPYEQYF	TRBV27	TRBJ2-7
TGTGCCAGCAGCTTTCCGACTAGCGGGTTAGATAGCACAGATACGCAGTATTTT	CASSFPTSGLDSTDTQYF	TRBV7-8	TRBJ2-3
TGTGCCAGCAGCGGTTCCGTATCACAGGGATATGGCTACACCTTC	CASSGSVSQGYGYTF	TRBV2	TRBJ1-2
TGTGCCACCAGTGTGACTGGACAGGGCAGGTATTCCTACAATGAGCAGTTCTTC	CATSVTGQGRYSYNEQFF	TRBV24-1	TRBJ2-1
TGCGCCAGCAGGCTATCACCCAGGGGCAACACTGAAGCTTTCTTT	CASRLSPRGNTEAFF	TRBV10-2	TRBJ1-1
TGTGCCAGTAGTATACGGGGGGGAACTGAAGCTTTCTTT	CASSIRGGTEAFF	TRBV19	TRBJ1-1
TGTGCCAGCAGCCCCCGAGACAGGAGGCGCTACGAGCAGTACTTC	CASSPRDRRRYEQYF	TRBV3-1	TRBJ2-7
TGTGCCAGCAGCGTCGGAGTGGAACGGAAGAGCAATCAGCCCCAGCATTTT	CASSVGVERKSNQPQHF	TRBV13	TRBJ1-5
TGCGCCAGCAGTACCCCTCGATGGAACAGACTGGGCTATAATGAAAAACTGTTTTTT	CASSTPRWNRLGYNEKLFF	TRBV10-1	TRBJ1-4
TGTGCCACCAGCCAGACAGGGGGGCCGGACACTGAAGCTTTCTTT	CATSQTGGPDTEAFF	TRBV24-1	TRBJ1-1
TGCAGTGCTAGCCACAAGGGGGGAGCCTTCTATGGCTACACCTTC	CSASHKGGAFYGYTF	TRBV20-1	TRBJ1-2
TGTGCCAGCATCCAGCACAGGGGGCGAGATACGCAGTATTTT	CASIQHRGRDTQYF	TRBV14	TRBJ2-3
TGCGCCAGCAGCGGCCCCAGAGCCACTCAGCCCCAGCATTTT	CASSGPRATQPQHF	TRBV10-1	TRBJ1-5
TGCGCCAGCAGCTTGGGCCGGAACCCGGGACAGGTAGCGAACACTGAAGCTTTCTTT	CASSLGRNPGQVANTEAFF	TRBV5-1	TRBJ1-1
TGTGCCACCAGTGATTTGCAGGCGACAGGGAGCACAGATACGCAGTATTTT	CATSDLQATGSTDTQYF	TRBV24-1	TRBJ2-3
TGCACCCATAGCGGGGCCCCTATGCTAGCCAAAAACATTCAGTACTTC	CTHSGAPMLAKNIQYF	TRBV20-1	TRBJ2-4
TGTGCCAGCAGCACTACGGCCACCGAATCACCCCTCCACTTT	CASSTTATESPLHF	TRBV7-3	TRBJ1-6
TGTGCCACCAGCAGTTGGGCCCACTCCCTTGGGGTAAGCACAGATACGCAGTATTTT	CATSSWAHSLGVSTDTQYF	TRBV15	TRBJ2-3
TGTGCTAGCAGCTTAGCTGGCGGGAGAGGTGGGAACACCGGGGAGCTGTTTTTT	CASSLAGGRGGNTGELFF	TRBV7-7	TRBJ2-2
TGTGCCAGCATATTGGGGGACAGGGGGCCCAGGATTTTCGAAGAGCAGTACTTC	CASILGDRGPRIFEEQYF	TRBV28	TRBJ2-7
TGTGCCAGCAGCTTAAAGATTAGAGACTTC	CASSLKIRDF	TRBV7-2	TRBJ2-7
TGTGCCAGCAGTTTAGTAATACCGGGACAGGGAACGGAGGACTCTGGAAACACCATATATTTT	CASSLVIPGQGTEDSGNTIYF	TRBV12-3	TRBJ1-3
TGTGCCAGCAGCGTAGCCTACAATGAGCAGTTCTTC	CASSVAYNEQFF	TRBV9	TRBJ2-1
TGTGCCAGCAGTGATCGATATGATCGAGATGAGCAGTTCTTC	CASSDRYDRDEQFF	TRBV6-4	TRBJ2-1
TGTGCCAGCAGTTTATCGCCCCTACCTAACTATGGCTACACCTTC	CASSLSPLPNYGYTF	TRBV27	TRBJ1-2
TGTGCCAGCAGATTTGGACGGTTGGACGGGGGAGCAACTAATGAAAAACTGTTTTTT	CASRFGRLDGGATNEKLFF	TRBV7-3	TRBJ1-4
TGTGCCATACCCACGGGGGGGGGCACCTACAATGAGCAGTTCTTC	CAIPTGGGTYNEQFF	TRBV6-1	TRBJ2-1
TGTGCCAGCAGCGGGGATTCCAGATATCAGCCCCAGCATTTT	CASSGDSRYQPQHF	TRBV7-3	TRBJ1-5
TGTGCCAGCAGCTTGCAGGGGGTGTACTTC	CASSLQGVYF	TRBV5-8	TRBJ2-5
TGTGCCAGCAGCCAAGATCAGGTGGCAGGCTACGAGCAGTACTTC	CASSQDQVAGYEQYF	TRBV14	TRBJ2-7
TGTGCCAGCAGCCAAGACATCGGACATACGCAGTATTTT	CASSQDIGHTQYF	TRBV3-1	TRBJ2-3
TGCAGCGTTGAAGACGGGGGCCCCAGAATCTACGAGCAGTACTTC	CSVEDGGPRIYEQYF	TRBV29-1	TRBJ2-7
TGCAGTGCTAGCCGGGGGGACAGAGGAAAGAACACCGGGGAGCTGTTTTTT	CSASRGDRGKNTGELFF	TRBV20-1	TRBJ2-2
TGCGCCAGCAGCCAAGCTGATACCTACAATGAGCAGTTCTTC	CASSQADTYNEQFF	TRBV4-3	TRBJ2-1
TGTGCCAGCAGTCGGGGGGACACTGAAGCTTTCTTT	CASSRGDTEAFF	TRBV6-5	TRBJ1-1
TGCAGTGCGGGGGGGCTGAGCGGGGAGCTGTTTTTT	CSAGGLSGELFF	TRBV20-1	TRBJ2-2
TGTGCCAGCAGCCTGAACAGGGGGCATCGTCGGGTCTATGGCTACACCTTC	CASSLNRGHRRVYGYTF	TRBV7-2	TRBJ1-2
TGTGCCAGCAGCTTATTTTTATCCCGGGATGGCAATCAGCCCCAGCATTTT	CASSLFLSRDGNQPQHF	TRBV7-6	TRBJ1-5
TGTGCCAGCAGTGGATTAGGGGGCGCAAGGGTCTACGAGCAGTACTTC	CASSGLGGARVYEQYF	TRBV6-4	TRBJ2-7
TGTGCCAGCAGCCGAAGGTTACAGGGGGATCAAAATCAGCCCCAGCATTTT	CASSRRLQGDQNQPQHF	TRBV11-1	TRBJ1-5
TGCGCCAGCAGCCAAGATACACTAGATCAGGGAGGCACTAGCACAGATACGCAGTATTTT	CASSQDTLDQGGTSTDTQYF	TRBV4-1	TRBJ2-3
TGCGCCAGCAGTGAAGCCGGGACAGGAACCCGAACCCAGTATTTT	CASSEAGTGTRTQYF	TRBV10-1	TRBJ2-3
TGTGCCAGCAGACGGGGGGCAGCTGAGCAGTTCTTC	CASRRGAAEQFF	TRBV7-9	TRBJ2-1
TGTGCCAGCAGCCACAAGGGGGCGGGGTCTAGCGAGACCCAGTACTTC	CASSHKGAGSSETQYF	TRBV9	TRBJ2-5
TGCGCCAGCAGTGAAGTGTCCGGGTCCGTCAGCTACGAGCAGTACTTC	CASSEVSGSVSYEQYF	TRBV10-1	TRBJ2-7
TGTGCCACCAGTGATAAGACAGATAATTCACCCCTCCACTTT	CATSDKTDNSPLHF	TRBV24-1	TRBJ1-6
TGTGCCAGCAGTTCCGGGGGAGACCTCGATTCAGATACGCAGTATTTT	CASSSGGDLDSDTQYF	TRBV6-9	TRBJ2-3
TGTGCCAGCAGCCAAGGGGCAACCGGGTACGAGCAGTACTTC	CASSQGATGYEQYF	TRBV14	TRBJ2-7
TGTGCCAGCAGTAAGCTGGGGGGGGGTCAAGGAGGGCTCTCCTACGAGCAGTACTTC	CASSKLGGGQGGLSYEQYF	TRBV6-1	TRBJ2-7
TGTGCCAGCAGCCCCGAGTTAAAAGAAATGGGACTAGCGGGCACCGGGGAGCTGTTTTTT	CASSPELKEMGLAGTGELFF	TRBV7-3	TRBJ2-2
TGTGCCAGCAGCCAAGTCCTAGAGGGACTAGCTCCAATTGGGGCCAACGTCCTGACTTTC	CASSQVLEGLAPIGANVLTF	TRBV4-2	TRBJ2-6
TGTGCCAGTAGTATAGACAGGGGGGGGTCTGGGGCCAACGTCCTGACTTTC	CASSIDRGGSGANVLTF	TRBV19	TRBJ2-6
TGTGCCAGCAGTCCTAGGGCCAGGCTAGCTCGGGGGGCCTACGAGCAGTACTTC	CASSPRARLARGAYEQYF	TRBV6-1	TRBJ2-7
TGTGCCACCAGTGCGGTAGCGGGTTCCACAGATACGCAGTATTTT	CATSAVAGSTDTQYF	TRBV24-1	TRBJ2-3
TGTGCCAGCAGTGAAGCTAGCGGGCACCGGGCCGAGCAGTACTTC	CASSEASGHRAEQYF	TRBV6-1	TRBJ2-7
TGCACCCCAGGAGAGTCGAGGAGGGCCAAAAACATTCAGTACTTC	CTPGESRRAKNIQYF	TRBV20-1	TRBJ2-4
TGCGCCAGCAGTGAGGCAGGGGGCGATGGAAACACCATATATTTT	CASSEAGGDGNTIYF	TRBV10-1	TRBJ1-3
TGCGCCAGCAGCCAAGAGACCCAGATCTCCTACGAGCAGTACTTC	CASSQETQISYEQYF	TRBV4-3	TRBJ2-7
TGTGCCAGCAGCTTAGGCAGTCAGGATAAAGTTAATGAGCAGTTCTTC	CASSLGSQDKVNEQFF	TRBV11-3	TRBJ2-1
TGTGCCAGCAGCCTCGGGGCTGGAAACACCATATATTTT	CASSLGAGNTIYF	TRBV13	TRBJ1-3
TGTGCCAGCTTAAACAGGGGGCTCGGCGCCACAGATACGCAGTATTTT	CASLNRGLGATDTQYF	TRBV6-4	TRBJ2-3
TGCGCCAGCCCTCAGTACGAGCAGTACTTC	CASPQYEQYF	TRBV5-1	TRBJ2-7
TGCGCCAGCAGCAAACGGCTGGGAGAGACCCAGTACTTC	CASSKRLGETQYF	TRBV5-1	TRBJ2-5
TGTGCCAGCAGCTTGCGGGAGTTCCAGCCCCAGCATTTT	CASSLREFQPQHF	TRBV5-6	TRBJ1-5
TGTGCCAGCAGCCAAGAGGGCCCCGGACTTATCTTAACGCAGTATTTT	CASSQEGPGLILTQYF	TRBV14	TRBJ2-3
TGTGCCAGCAGCTTAGTCAGGGGCCCGTCGAGCTCCTACAATGAGCAGTTCTTC	CASSLVRGPSSSYNEQFF	TRBV11-3	TRBJ2-1
TGTGCCAGCAGCTCTTCGCACGGGACAGCTAACGAGCAGTACTTC	CASSSSHGTANEQYF	TRBV9	TRBJ2-7
TGTGCCAGCAGTTTACCCGGGGAGGGTGCAGGTTCAAAAGACTACGAGCAGTACTTC	CASSLPGEGAGSKDYEQYF	TRBV27	TRBJ2-7
TGTGCCAGCAGCCAGGTATGGGGGCAAAAGGCCATATATTTT	CASSQVWGQKAIYF	TRBV9	TRBJ1-3
TGTGCCAGCAGTTCCCAGGGCGGGAGCAATCAGCCCCAGCATTTT	CASSSQGGSNQPQHF	TRBV6-5	TRBJ1-5
TGTGCCATCAGTGAAACGCCTGCCTCATGCGCCCTCCACTTT	CAISETPASCALHF	TRBV10-3	TRBJ1-6
TGTGCCAGCAACCCCGAGAAGAGGGGGGCTAGTTACCTAGAGACCCAGTACTTC	CASNPEKRGASYLETQYF	TRBV6-1	TRBJ2-5
TGTGCCAGCAGTTTGACCACTAGCGGGAGGTCCTCCTACGAGCAGTACTTC	CASSLTTSGRSSYEQYF	TRBV27	TRBJ2-7
TGTGCCAGCAGCCGGACTAGCGCCTACGAGCAGTACTTC	CASSRTSAYEQYF	TRBV11-3	TRBJ2-7
TGTGCCCTCCGACGGGACACAACTAATGAAAAACTGTTTTTT	CALRRDTTNEKLFF	TRBV3-1	TRBJ1-4
TGTGCCAGCAGAAACAGTAACTATGGCTACACCTTC	CASRNSNYGYTF	TRBV7-7	TRBJ1-2
TGCAGTGCCCCGCTAGTGTTGACCTACGAGCAGTACTTC	CSAPLVLTYEQYF	TRBV20-1	TRBJ2-7
TGCGCCAGCAGCTCTCCGGGACAGAGCCGCTCCTACGAGCAGTACTTC	CASSSPGQSRSYEQYF	TRBV5-1	TRBJ2-7
TGTGCCATCAGACGGGTCGGTAACAGGGCTCAGCCCCAGCATTTT	CAIRRVGNRAQPQHF	TRBV10-3	TRBJ1-5
TGTGCCAGCAGCATTCGGACTAGCGGGCCTTGCTACGAGCAGTACTTC	CASSIRTSGPCYEQYF	TRBV7-4	TRBJ2-7
TGTGCCAAAACCACTAGCGGGACCGGGGAGCTGTTTTTT	CAKTTSGTGELFF	TRBV6-4	TRBJ2-2
TGTGCCAGCAGTTTGGTAGCGGGCGGGGAGCTGTTTTTT	CASSLVAGGELFF	TRBV27	TRBJ2-2
TGTGCCAGCAGCCAAGATGGTCGACAGGGGGCGAGTGGCTACACCTTC	CASSQDGRQGASGYTF	TRBV14	TRBJ1-2
TGTGCCACCAGTGATTTGATCCGAGGGAGGCGTGAAGCTTTCTTT	CATSDLIRGRREAFF	TRBV24-1	TRBJ1-1
TGCAGCGTTGAACCCCTCATTTTACGGACAGGGGGCTCGCTGTTTTTT	CSVEPLILRTGGSLFF	TRBV29-1	TRBJ1-4
TGTGCCACCAGGGCGAACACTGAAGCTTTCTTT	CATRANTEAFF	TRBV6-2	TRBJ1-1
TGTGCCAGCAGCGTACCGATTAAGGACAGGGAAGACTATGGCTACACCTTC	CASSVPIKDREDYGYTF	TRBV9	TRBJ1-2
TGTGCCAGCAGTGGGGGCAATCAGCCCCAGCATTTT	CASSGGNQPQHF	TRBV6-1	TRBJ1-5
TGTGCCAGCAGCTGCCCACGGATAGTATACGAGCAGTACTTC	CASSCPRIVYEQYF	TRBV13	TRBJ2-7
TGTGCCAGCAGCGCACGAAACGCTGGAAACACCATATATTTT	CASSARNAGNTIYF	TRBV9	TRBJ1-3
TGTGCCAGCAGACGACTAGCGGGTCCCTACGAGCAGTACTTC	CASRRLAGPYEQYF	TRBV6-5	TRBJ2-7
TGCAGTGCTCCCCGGGACAGTGGTCAGCCCCAGCATTTT	CSAPRDSGQPQHF	TRBV20-1	TRBJ1-5
TGCAGTGCCGGGGGCATACCCATCGCTAGCACAGATACGCAGTATTTT	CSAGGIPIASTDTQYF	TRBV20-1	TRBJ2-3
TGTGCCAGCAGTCCGCTCCGTGGGGGGGTGGGGAGGGAGAGTGAGCAGTTCTTC	CASSPLRGGVGRESEQFF	TRBV6-5	TRBJ2-1
TGCGCCAGCAGGGCAAGGCGGAGGGTCAATCAGCCCCAGCATTTT	CASRARRRVNQPQHF	TRBV5-1	TRBJ1-5
TGTGCCAGCAGTTTATCAGGGGATGGCTACACCTTC	CASSLSGDGYTF	TRBV27	TRBJ1-2
TGTGCCACCAGTGATACTCAGGGGGCCCGCAATCAGCCCCAGCATTTT	CATSDTQGARNQPQHF	TRBV24-1	TRBJ1-5
TGCGCCAGCAGATATGCGGGAGAGCCCCAGCATTTT	CASRYAGEPQHF	TRBV10-1	TRBJ1-5
TGCGCCAGCAGCCAATCCAGAGGACAGTATAGTGGGAGCAATCAGCCCCAGCATTTT	CASSQSRGQYSGSNQPQHF	TRBV5-1	TRBJ1-5
TGTGCCAGCAGTGAGGACCCCGGACTAGCGGAGTTAGATACGCAGTATTTT	CASSEDPGLAELDTQYF	TRBV6-4	TRBJ2-3
TGTGCCAGCAGCCCCCACGGACAGCCTGCCAGTAATCTCGAGCAGTACTTC	CASSPHGQPASNLEQYF	TRBV13	TRBJ2-7
TGTGCCAGTAGTACTACAGGGGCCTACTATGGCTACACCTTC	CASSTTGAYYGYTF	TRBV19	TRBJ1-2
TGCAGTGCTAGATCCCTAGCTCTTACCACAGATACGCAGTATTTT	CSARSLALTTDTQYF	TRBV20-1	TRBJ2-3
TGTGCCAGCAGTGATGGTTTGTCTAGCGGGAATGAGCAGTTCTTC	CASSDGLSSGNEQFF	TRBV6-4	TRBJ2-1
TGTGCCAGCAGCGGAGGGGGGGAGACCCAGTACTTC	CASSGGGETQYF	TRBV7-6	TRBJ2-5
TGTGCCAGCTCACCTCGATACTGGTCAGATACGCAGTATTTT	CASSPRYWSDTQYF	TRBV18	TRBJ2-3
TGTGCCAGCAGCCAAGGCGTCCTCGCGATAGCGGGTAGCACAGATACGCAGTATTTT	CASSQGVLAIAGSTDTQYF	TRBV4-2	TRBJ2-3
TGTGCCAGCCCGAGAGGGGACAGTCCGGAGGCTAATTCACCCCTCCACTTT	CASPRGDSPEANSPLHF	TRBV7-4	TRBJ1-6
TGTGCCAGCAGCACCCCTCGGCCCTTAAGCTCCTACAATGAGCAGTTCTTC	CASSTPRPLSSYNEQFF	TRBV7-3	TRBJ2-1
TGCGCCAGCGTACGGCGGGACACTGAAGCTTTCTTT	CASVRRDTEAFF	TRBV5-1	TRBJ1-1
TGTGCCAGCAGCGCTCCCACAGGGCGTGAAGCTTTCTTT	CASSAPTGREAFF	TRBV7-9	TRBJ1-1
TGCAGTGCTCGGACTAGCGGGGGGGCCCACGAGCAGTACTTC	CSARTSGGAHEQYF	TRBV20-1	TRBJ2-7
TGTGCCAGTAGTATAGATCGCCCGCTCCCCACAGATACGCAGTATTTT	CASSIDRPLPTDTQYF	TRBV19	TRBJ2-3
TGTGCCAGCAGCGGACTCTACGAGCAGTACTTC	CASSGLYEQYF	TRBV11-3	TRBJ2-7
TGTGCCAGCAGCTTGGTGCCTTCTAGCGGGTTTTACAATGAGCAGTTCTTC	CASSLVPSSGFYNEQFF	TRBV5-4	TRBJ2-1
TGTGCCAGCGGGGGCGCCTACGAGCAGTACTTC	CASGGAYEQYF	TRBV2	TRBJ2-7
TGTGCCACCAGCAGAGATCTCCGAGACTCCTATGGCTACACCTTC	CATSRDLRDSYGYTF	TRBV15	TRBJ1-2
TGTGCCAGCAGCAACTTCATAGCGGGACGGTGGCACGAGACCCAGTACTTC	CASSNFIAGRWHETQYF	TRBV12-4	TRBJ2-5
TGTGCCAGCACGGTGACAGTGGCGGGTTCTGGAAACACCATATATTTT	CASTVTVAGSGNTIYF	TRBV5-6	TRBJ1-3
TGTGCCAGCATCATTTTCGGACAGGGTCGTGGCTACACCTTC	CASIIFGQGRGYTF	TRBV27	TRBJ1-2
TGCAGGGTGGGACTAGCGGGGGGGAGGTACAATGAGCAGTTCTTC	CRVGLAGGRYNEQFF	TRBV20-1	TRBJ2-1
TGTGCCAGCAGTCCACAGGGTTCAGATGGCTACACCTTC	CASSPQGSDGYTF	TRBV11-3	TRBJ1-2
TGTGCCTGGAGCTTGTCCTTGAACACTGAAGCTTTCTTT	CAWSLSLNTEAFF	TRBV30	TRBJ1-1
TGCAGCGAACTAGGGGTCACCGGGGAGCTGTTTTTT	CSELGVTGELFF	TRBV29-1	TRBJ2-2
TGTGCCAGCAGTTCAGCTCCTAGTGGCAGAGAGACCCAGTACTTC	CASSSAPSGRETQYF	TRBV6-9	TRBJ2-5
TGCAGTGCTAGAGATGGGGGCGCCGCCTACGAGCAGTACTTC	CSARDGGAAYEQYF	TRBV20-1	TRBJ2-7
TGTGCCACCAGTGGCCCGCTGGTCGACAGCAGCAATCAGCCCCAGCATTTT	CATSGPLVDSSNQPQHF	TRBV24-1	TRBJ1-5
TGCGCCAGCAGCCTGGCAGGGGCGTTGCCCCAGCATTTT	CASSLAGALPQHF	TRBV4-3	TRBJ1-5
TGTGCCAGCAGCTTATGGGCAAGCACAGATACGCAGTATTTT	CASSLWASTDTQYF	TRBV7-4	TRBJ2-3
TGTGCCAGCAGCTTAACCTGCAATGGCTACACCTTC	CASSLTCNGYTF	TRBV7-3	TRBJ1-2
TGCGCCAGCAGTGAGAAGGGGGGACAGGGCAGCTCCTATAATTCACCCCTCCACTTT	CASSEKGGQGSSYNSPLHF	TRBV10-1	TRBJ1-6
TGTGCCAGCAGCGCCGGGACAGGGGTATCTAGCTATGGCTACACCTTC	CASSAGTGVSSYGYTF	TRBV11-2	TRBJ1-2
TGTGCCAGCAGTTTGACGTTAGGCCCCTATGGCTACACCTTC	CASSLTLGPYGYTF	TRBV27	TRBJ1-2
TGTGCCCAATGGACAGGGTGGGGACAAGAGACCCAGTACTTC	CAQWTGWGQETQYF	TRBV10-3	TRBJ2-5
TGCAGTGCAAAAGGGAGGAAGCAGTACTTC	CSAKGRKQYF	TRBV20-1	TRBJ2-7
TGTGCCAGCAGCTACAGGTCTAGCAATCAGCCCCAGCATTTT	CASSYRSSNQPQHF	TRBV11-3	TRBJ1-5
TGTGCCAGCAGCTTGGGACCGTTTACCGAGACCCAGTACTTC	CASSLGPFTETQYF	TRBV5-6	TRBJ2-5
TGTGCGGTTTCTATCGTCGAGCAGTACTTC	CAVSIVEQYF	TRBV2	TRBJ2-7
TGTGCCAGCAGAGGTTCCTCACAGGAGGATTTGCTAGGCTACGAGCAGTACTTC	CASRGSSQEDLLGYEQYF	TRBV28	TRBJ2-7
TGTGCCAGCAGCTTGATATTAAGTCGGACAGGGGGGGAGAGCTCTGGGGCCAACGTCCTGACTTTC	CASSLILSRTGGESSGANVLTF	TRBV5-4	TRBJ2-6
TGCAGCGTTAGGACAGGTCTGAAGCGGTATCAGCCCCAGCATTTT	CSVRTGLKRYQPQHF	TRBV29-1	TRBJ1-5
TGCGCCAGCAGCACAACGGTTGGCCGCAATGAGCAGTTCTTC	CASSTTVGRNEQFF	TRBV5-1	TRBJ2-1
TGTGCCAGCAGTGGAGGGAACATGAACACTGAAGCTTTCTTT	CASSGGNMNTEAFF	TRBV7-9	TRBJ1-1
TGTGCCAGTAGTATGAGCAGGGTGGTTTCCTTATCACCCCTCCACTTT	CASSMSRVVSLSPLHF	TRBV19	TRBJ1-6
TGTGCCAGCAGCTGGTTCTTAGGTCGGACGAGCACAGATACGCAGTATTTT	CASSWFLGRTSTDTQYF	TRBV7-3	TRBJ2-3
TGTGCTGAAGACGTTTCGGGGACCGGGGAGCTGTTTTTT	CAEDVSGTGELFF	TRBV7-9	TRBJ2-2
TGCGCCAGCAGCTTGTTAGGGGGAGGCCGGGCCAAGAGCTCCTATAATTCACCCCTCCACTTT	CASSLLGGGRAKSSYNSPLHF	TRBV5-1	TRBJ1-6
TGTGCCAGCAGTGGGGACAAGACAATAGACAATGAGCAGTTCTTC	CASSGDKTIDNEQFF	TRBV6-4	TRBJ2-1
TGCGCCAGCAGCACCCACAGTCCTACGTCTGAAGCTTTCTTT	CASSTHSPTSEAFF	TRBV10-1	TRBJ1-1
TGTGCCAGCTCACCACGGGGGACAGGGGAGACCCAGTACTTC	CASSPRGTGETQYF	TRBV18	TRBJ2-5
TGTGCCAGCAGCCAAGAGAATTCTTCCGAGGGGGGGGGTTATTCCCTGTTTTTT	CASSQENSSEGGGYSLFF	TRBV3-1	TRBJ1-4
TGTGCCAGGCCGGAGGTAACTAACTATGGCTACACCTTC	CARPEVTNYGYTF	TRBV3-1	TRBJ1-2
TGTGCCAGCAGCTTAGCCCAGCCGGAAAAGCAGTACTTC	CASSLAQPEKQYF	TRBV7-9	TRBJ2-7
TGTGCCAGCTCTAGGGTTAACCGACAGGAGACCCAGTACTTC	CASSRVNRQETQYF	TRBV9	TRBJ2-5
TGTGCCAGCAGCTTGAGGGTGGACAGGTACTTC	CASSLRVDRYF	TRBV5-6	TRBJ2-4
TGTGCCTGGAGTGTAACAGGGGCGAACACTGAAGCTTTCTTT	CAWSVTGANTEAFF	TRBV30	TRBJ1-1
TGTGCCAGCAGCGTAGGACAGGACTACACCTTC	CASSVGQDYTF	TRBV9	TRBJ1-2
TGTGCCAGCAGTCGGGACAGAAGGAGGGCCAATCAGCCCCAGCATTTT	CASSRDRRRANQPQHF	TRBV27	TRBJ1-5
TGTGCCACCAGTGACCCGGGGGCTAACTATGGCTACACCTTC	CATSDPGANYGYTF	TRBV15	TRBJ1-2
TGTGCCAGGGCCCGGGGTCCGGGACAGGGCCCCTACGAGCAGTACTTC	CARARGPGQGPYEQYF	TRBV6-5	TRBJ2-7
TGTGCCAGCAGCAATACCAGGGGGCGAAGGACGGAATCCGGGGAGCTGTTTTTT	CASSNTRGRRTESGELFF	TRBV11-3	TRBJ2-2
TGTGCCAGCAGCTTGAACACAATCTTCGAGCAGTACTTC	CASSLNTIFEQYF	TRBV18	TRBJ2-7
TGCGCCAGCAGCTTGGCCACCCCCAGGACAGGGTCCCCCCTGCTAACCTACGAGCAGTACTTC	CASSLATPRTGSPLLTYEQYF	TRBV5-1	TRBJ2-7
TGTGCCAGCAGCATTAGATACGGCGGGGAGCTGTTTTTT	CASSIRYGGELFF	TRBV6-5	TRBJ2-2
TGTGCCTGGAGTGGACGTACCAAGACGGGGGGCTATGGCTACACCTTC	CAWSGRTKTGGYGYTF	TRBV30	TRBJ1-2
TGTGCCAGCAGCCGCGGACTGCTGTACGAGCAGTACTTC	CASSRGLLYEQYF	TRBV13	TRBJ2-7
TGTGCCAGCAGCCAACTAGGGGACAGGGGGTATGAAAAACTGTTTTTT	CASSQLGDRGYEKLFF	TRBV4-2	TRBJ1-4
TGCGCCAGCAGGACAGGCGGGACCTACGAGCAGTACTTC	CASRTGGTYEQYF	TRBV10-1	TRBJ2-7
TGTGCCAGCAGTTCCAGGGTTATTCCGGGTAGCTCCTACAATGAGCAGTTCTTC	CASSSRVIPGSSYNEQFF	TRBV27	TRBJ2-1
TGTGCCAGCAGCTTACCGGGGACAGGAACGCATCAGCCCCAGCATTTT	CASSLPGTGTHQPQHF	TRBV7-4	TRBJ1-5
TGTGCCAGCAGCCCGATAGTGTATGGCTACACCTTC	CASSPIVYGYTF	TRBV4-2	TRBJ1-2
TGTGCCTGGAGTGAGCAACAGGACGTCAAAAACATTCAGTACTTC	CAWSEQQDVKNIQYF	TRBV30	TRBJ2-4
TGCGCCAGCAGCTTGGGAATTAGGACGAAGGGAGGGGCCTACGAGCAGTACTTC	CASSLGIRTKGGAYEQYF	TRBV5-1	TRBJ2-7
TGTGCCAGCAGCCAAGAGCGGCAAGAAAGCACTGAAGCTTTCTTT	CASSQERQESTEAFF	TRBV3-1	TRBJ1-1
TGTGCCAGCAGCGACCAGAGGGCCGGGGGGACAGATCAGCCCCAGCATTTT	CASSDQRAGGTDQPQHF	TRBV7-4	TRBJ1-5
TGTGCCAGCAAATTAAAGAAGGGGGGAACGCAAGAGACCCAGTACTTC	CASKLKKGGTQETQYF	TRBV6-1	TRBJ2-5
TGCAGTGCTAGACGGACGGGAAATGAGCAGTTCTTC	CSARRTGNEQFF	TRBV20-1	TRBJ2-1
TGTGCCAGCTCACCAGGAGGGAGGACTGAAGCTTTCTTT	CASSPGGRTEAFF	TRBV18	TRBJ1-1
TGTGCCAGCAGTCAAGTCTGGCAGGCTGGAAACACCATATATTTT	CASSQVWQAGNTIYF	TRBV3-1	TRBJ1-3
TGTGCCAGCAGTACCTTGGCCCCGAACTATGGCTACACCTTC	CASSTLAPNYGYTF	TRBV28	TRBJ1-2
TGTGCCTGGAGAGGGACATCAAATGAAAAACTGTTTTTT	CAWRGTSNEKLFF	TRBV30	TRBJ1-4
TGTGCCAGCAGTAGGAAGAACCCGGCTTGCTACAATGAGCAGTTCTTC	CASSRKNPACYNEQFF	TRBV9	TRBJ2-1
TGTGCCAGCAGTGATATCGATCCACCGGGCACCGGGGAGCTGTTTTTT	CASSDIDPPGTGELFF	TRBV6-4	TRBJ2-2
TGTGCCACCGTCACACAGGGGGCCACTTGGCTCATGAACACTGAAGCTTTCTTT	CATVTQGATWLMNTEAFF	TRBV24-1	TRBJ1-1
TGTGCCCTCCGAGGATTTTACGAGCAGTACTTC	CALRGFYEQYF	TRBV27	TRBJ2-7
TGCGCCAGCAGCCAAGTCATCCCACTAGCGGGAGACGATCACGAGCAGTACTTC	CASSQVIPLAGDDHEQYF	TRBV4-3	TRBJ2-7
TGTGCCAGCAGCTTCCCTTTCCCGCCATTGGGACAGGGTAATGGCTACACCTTC	CASSFPFPPLGQGNGYTF	TRBV7-4	TRBJ1-2
TGCGCCAGCAAGAAAAGGAGGGAAAAACTGTTTTTT	CASKKRREKLFF	TRBV10-1	TRBJ1-4
TGCAGTGCTAGTCAATGCCCCGGGGGACATAATCAGCCCCAGCATTTT	CSASQCPGGHNQPQHF	TRBV20-1	TRBJ1-5
TGTGCCAGCAGCTTACCCCCCCCGAGGGAGGAGAACACTGAAGCTTTCTTT	CASSLPPPREENTEAFF	TRBV13	TRBJ1-1
TGTGCCAGCAGTGAACCTGAACCTGGGGCCACTGAAGCTTTCTTT	CASSEPEPGATEAFF	TRBV6-4	TRBJ1-1
TGTGCCAGTAGTATAAAGATCCAGGGGCTAAACTCCTACGAGCAGTACTTC	CASSIKIQGLNSYEQYF	TRBV19	TRBJ2-7
TGTGCCAGCAGCTTAGCCCAGGGGGTGGGTAGCAATCAGCCCCAGCATTTT	CASSLAQGVGSNQPQHF	TRBV11-3	TRBJ1-5
TGTGCCAGCAGCTCCTGTGGCAACCTCGTCTCTGGAAACACCATATATTTT	CASSSCGNLVSGNTIYF	TRBV11-2	TRBJ1-3
TGTGCCAGCAGTGACAGTATAGGGTATGGCTACACCTTC	CASSDSIGYGYTF	TRBV6-4	TRBJ1-2
TGTGCCAGCAGCAGCCCAGACGAAAAACTGTTTTTT	CASSSPDEKLFF	TRBV5-4	TRBJ1-4
TGTGCCAGCAGGTGTCTCGACGAGCAGTACTTC	CASRCLDEQYF	TRBV27	TRBJ2-7
TGTGCCACAAAGGACAGCGGGGAAGTATGTCATACGCAGTATTTT	CATKDSGEVCHTQYF	TRBV7-6	TRBJ2-3
TGCAGTGCCGGAACTTGCACAGATACGCAGTATTTT	CSAGTCTDTQYF	TRBV20-1	TRBJ2-3
TGTGCCAGCAGCTGGCTTTGGGTCTCCTACGAGCAGTACTTC	CASSWLWVSYEQYF	TRBV9	TRBJ2-7
TGTGCCAGCAGTAAGGGGGACCCCGAAGCTTTCTTT	CASSKGDPEAFF	TRBV6-5	TRBJ1-1
TGTGAGGCTACAGGTTTTCATGGCTACACCTTC	CEATGFHGYTF	TRBV9	TRBJ1-2
TGTGAAGCCATCTGGGACAGAGGAGAAGATTCCTACAATGAGCAGTTCTTC	CEAIWDRGEDSYNEQFF	TRBV7-9	TRBJ2-1
TGTGCCAGCAGCCAAACTAGCGGGAGGGGATACGAGCAGTACTTC	CASSQTSGRGYEQYF	TRBV12-3	TRBJ2-7
TGTGCCAGCAGGAATGCGGCCGGATTAGCTAACTATGGCTACACCTTC	CASRNAAGLANYGYTF	TRBV28	TRBJ1-2
TGCGCCAGCAGCAACTCGCGTCTCAAGCAAGAGACCCAGTACTTC	CASSNSRLKQETQYF	TRBV5-1	TRBJ2-5
TGCGCCAGCAGGAGTAGGGTTGCTGGAAACACTGAAGCTTTCTTT	CASRSRVAGNTEAFF	TRBV5-1	TRBJ1-1
TGTGCCAGCAGTTACTGCCAGCTTAGTTCCTACGAGCAGTACTTC	CASSYCQLSSYEQYF	TRBV6-2	TRBJ2-7
TGTGCCAGCAGCCAAGATGGGGGGGGGGGGGGGAGCTCCTACAATGAGCAGTTCTTC	CASSQDGGGGGSSYNEQFF	TRBV3-1	TRBJ2-1
TGTGCCAGCAGCCAAGTTGGTACAGGGAGACTCTTTAGCAATCAGCCCCAGCATTTT	CASSQVGTGRLFSNQPQHF	TRBV3-1	TRBJ1-5
TGCAGCGTTGAGCATAAAGGGGACGGGAGGAGCGAGCAGTACTTC	CSVEHKGDGRSEQYF	TRBV29-1	TRBJ2-7
TGTGCCAGCAGTTGGACGATTGGACAGGACCCTCTAAACATTCAGTACTTC	CASSWTIGQDPLNIQYF	TRBV27	TRBJ2-4
TGTGCCAGCAGCCAAGAGGACCCCGACTCCTGTCGGTACAATGAGCAGTTCTTC	CASSQEDPDSCRYNEQFF	TRBV3-1	TRBJ2-1
TGCGCCAGCAGTGCGTTTTATTGCTACGAGCAGTACTTC	CASSAFYCYEQYF	TRBV10-1	TRBJ2-7
TGTGCCAGCAGAATGGAGCCGGGACAGAGGAGCTCCTACGAGCAGTACTTC	CASRMEPGQRSSYEQYF	TRBV13	TRBJ2-7
TGTGCCAGCAGCCAAGAGGGGGCGTGGGGTAGTGGCTACACCTTC	CASSQEGAWGSGYTF	TRBV14	TRBJ1-2
TGCAGTGCACCCGGGACAGGGAACTACGAGCAGTACTTC	CSAPGTGNYEQYF	TRBV20-1	TRBJ2-7
TGTGCCAGCAGGACCGACAGCTCCTACGAGCAGTACTTC	CASRTDSSYEQYF	TRBV7-6	TRBJ2-7
TGTGCCAGCAGCTTAGCTAGGGATTGCTACGAGCAGTACTTC	CASSLARDCYEQYF	TRBV11-3	TRBJ2-7
TGTGCCAGTAGTATAGATGGGACAGGGCTGATGAACACTGAAGCTTTCTTT	CASSIDGTGLMNTEAFF	TRBV19	TRBJ1-1
TGTGCCAGCAGTTATTTCGATGAGGCTTACAATGAGCAGTTCTTC	CASSYFDEAYNEQFF	TRBV6-2	TRBJ2-1
TGTGCCAGCAGCTTGGAAATTGGGACAGGGGGCCTAAGGAATTACGAGCAGTACTTC	CASSLEIGTGGLRNYEQYF	TRBV5-4	TRBJ2-7
TGTGCCAGCAGTTACGGGCCCGGGGGGTACCAAGAGACCCAGTACTTC	CASSYGPGGYQETQYF	TRBV6-5	TRBJ2-5
TGTGCCAGCAGCTTGGAAGGGGCTGGGGCCAACGTCCTGACTTTC	CASSLEGAGANVLTF	TRBV5-4	TRBJ2-6
TGTGCCAGCAGCTTATGGAGGGGTACTGAAGCTTTCTTT	CASSLWRGTEAFF	TRBV7-9	TRBJ1-1
TGTGCCAGCAGCCGTTCCGAGACTAGCGGGAGAACCCAACCCGTCCTGACTTTC	CASSRSETSGRTQPVLTF	TRBV3-1	TRBJ2-6
TGTGCCAGCAGCGGGGGCACCAAAAACATTCAGTACTTC	CASSGGTKNIQYF	TRBV13	TRBJ2-4
TGTGCCAGCAGTCCCATAAGTAAGACCGCCAAAAACATTCAGTACTTC	CASSPISKTAKNIQYF	TRBV6-2	TRBJ2-4
TGCGCCAGCAGCCCAAAGAGGGAGGAGACCCAGTACTTC	CASSPKREETQYF	TRBV4-1	TRBJ2-5
TGCGCCAGCAGCCACGTGAGGTTAACACTCGATACGCAGTATTTT	CASSHVRLTLDTQYF	TRBV4-1	TRBJ2-3
TGCAGCGTTCCCCGAGACATCAGTGGTAGCGGGGGGTACTTC	CSVPRDISGSGGYF	TRBV29-1	TRBJ2-7
TGCAGCGTTGAGGGGGGATGGCGGTCGACAGAGGGCGCTTTCTTT	CSVEGGWRSTEGAFF	TRBV29-1	TRBJ1-1
TGTGCCAGCAGCGGATTAGACTCCAATCAGCCCCAGCATTTT	CASSGLDSNQPQHF	TRBV11-1	TRBJ1-5
TGTGCCAGCATTGCGAAGTTCGAGCAGTACTTC	CASIAKFEQYF	TRBV6-2	TRBJ2-7
TGTGCCAGCAGCTTGACCAACTCCTCTCCCTACAATGAGCAGTTCTTC	CASSLTNSSPYNEQFF	TRBV5-4	TRBJ2-1
TGTGCCAGTAGTATAGATGGGTCCTGGGGGGGGGACGGGACAGTCTACATTCAGTACTTC	CASSIDGSWGGDGTVYIQYF	TRBV19	TRBJ2-4
TGTGCCTGGAGTGAATGCTTTACTTCGTCGACAGGGAAGTCCTACGAGCAGTACTTC	CAWSECFTSSTGKSYEQYF	TRBV30	TRBJ2-7
TGTGCCAGCAGCTTAGAGGGGGACAGGGTCAACGCAAATTCACCCCTCCACTTT	CASSLEGDRVNANSPLHF	TRBV11-2	TRBJ1-6
TGTGCCTGGAGTCCGGAGATCGGTTCCACAGATACGCAGTATTTT	CAWSPEIGSTDTQYF	TRBV30	TRBJ2-3
TGCGCCAGCAGTGAGTTAGGGGGGCGTTCTGAGCAGTTCTTC	CASSELGGRSEQFF	TRBV10-1	TRBJ2-1
TGTGCCAGCAGTTACGGGGTGACGAGGGGGATGGGTTCCTATGGCTACACCTTC	CASSYGVTRGMGSYGYTF	TRBV6-6	TRBJ1-2
TGCGCCAGCAGTCCCTCACTAGCGGGAGGGAACGAGCAGTACTTC	CASSPSLAGGNEQYF	TRBV10-1	TRBJ2-7
TGCGCCTCGGGACAGGGTGAATATAGCAATCAGCCCCAGCATTTT	CASGQGEYSNQPQHF	TRBV4-3	TRBJ1-5
TGCGCCAAAAATGACAGGGGGCCGGTTATGCCTAATGAAAAACTGTTTTTT	CAKNDRGPVMPNEKLFF	TRBV10-1	TRBJ1-4
TGTGCCAGCAGTTTGTGGGGGGAAGCTAATGAAAAACTGTTTTTT	CASSLWGEANEKLFF	TRBV27	TRBJ1-4
TGCGCCAGCAGCTTGCGGCCGGGACTAGGGCCAGAGACCCAGTACTTC	CASSLRPGLGPETQYF	TRBV5-1	TRBJ2-5
TGTGCCAGTAGTATTCGAGCACGGTATGGCTACACCTTC	CASSIRARYGYTF	TRBV19	TRBJ1-2
TGTGCCAGCAGCGGAATCTCCTCGGAGATCACCTGTCAAGAGACCCAGTACTTC	CASSGISSEITCQETQYF	TRBV9	TRBJ2-5
TGTGCCAGCAGCTTTTCAGGACAGGTGTCCAAAAACATTCAGTACTTC	CASSFSGQVSKNIQYF	TRBV5-4	TRBJ2-4
TGCGCCAGCAGCTTGGGTATGGACAGTGGAGCGCAGCCCCAGCATTTT	CASSLGMDSGAQPQHF	TRBV5-1	TRBJ1-5
TGTGCCAGCAGTTACTCCCCGGTGACAGGGGGGTACGAGCAGTACTTC	CASSYSPVTGGYEQYF	TRBV6-6	TRBJ2-7
TGTGCCAGCAGCTTACTCCGTGAGCAGTTCTTC	CASSLLREQFF	TRBV13	TRBJ2-1
TGCGCCAGCAGCGGAATACGGATGAGCTGCACAGATACGCAGTATTTT	CASSGIRMSCTDTQYF	TRBV5-1	TRBJ2-3
TGTGCCAGCAGTGCCGGCCGGGACAGGGCAGATACGCAGTATTTT	CASSAGRDRADTQYF	TRBV6-4	TRBJ2-3
TGTGCCAGCAGCCAAGATCAGGGAGTTGGCTACACCTTC	CASSQDQGVGYTF	TRBV14	TRBJ1-2
TGCGCCAGCAGAGCTAGCGGGAGAGTCCCCTACAATGAGCAGTTCTTC	CASRASGRVPYNEQFF	TRBV4-1	TRBJ2-1
TGTGCCAGCAGCATGCGGACGGGGGGTGGCGAGCAGTACTTC	CASSMRTGGGEQYF	TRBV13	TRBJ2-7
TGTGCCAGGAGAGCCCGTAACTATGGCTACACCTTC	CARRARNYGYTF	TRBV19	TRBJ1-2
TGTGCCACCAGCACCCAGGGGTTTCAGCCCCAGCATTTT	CATSTQGFQPQHF	TRBV15	TRBJ1-5
TGTGCCAGCAGCCAGGGGAATCAGCCCCAGCATTTT	CASSQGNQPQHF	TRBV13	TRBJ1-5
TGCAGTGCCCTGGAAGGAAAACGGGACGGACTGAAAGAAGCTTTCTTT	CSALEGKRDGLKEAFF	TRBV20-1	TRBJ1-1
TGCGCCAGCAGCTTAGCCCCGGGACTAGCGGGGTGTACAGATACGCAGTATTTT	CASSLAPGLAGCTDTQYF	TRBV5-1	TRBJ2-3
TGTGCCAGCAGCCAAGATAGAATTCTAGAGGGGGACAACGAGCAGTACTTC	CASSQDRILEGDNEQYF	TRBV14	TRBJ2-7
TGTGCCAGCAGCGTAGGCGCAGTCAGCAGGTTCTTC	CASSVGAVSRFF	TRBV13	TRBJ2-7
TGTGCCACCAGGTGGACAGGGATGGCCTACGAGCAGTACTTC	CATRWTGMAYEQYF	TRBV24-1	TRBJ2-7
TGTGCCAGCAGCCAAGAGAGGCGGACAGGAAACCCCTCCTACAATGAGCAGTTCTTC	CASSQERRTGNPSYNEQFF	TRBV3-1	TRBJ2-1
TGTGCCTGGAGTGTACGAGGGATGGATACGCAGTATTTT	CAWSVRGMDTQYF	TRBV30	TRBJ2-3
TGTGCCAGCAGCACCGGCCACAGAGGCACAGATACGCAGTATTTT	CASSTGHRGTDTQYF	TRBV7-9	TRBJ2-3
TGCGCCAGCAGCGGTCCCTCAACAGATACGCAGTATTTT	CASSGPSTDTQYF	TRBV10-1	TRBJ2-3
TGTGCCAGCAGCCAAACGGACAGGAAGGTCAACTATGGCTACACCTTC	CASSQTDRKVNYGYTF	TRBV14	TRBJ1-2
TGTGCCACCGCCAAATGCACGAATCCCGGCTACACCTTC	CATAKCTNPGYTF	TRBV24-1	TRBJ1-2
TGTGCCAGAGGGACGGCTGGGGCCAACGTCCTGACTTTC	CARGTAGANVLTF	TRBV18	TRBJ2-6
TGTGCCAGCAGTTACACTGGACAGGGGAATGAGCAGTTCTTC	CASSYTGQGNEQFF	TRBV6-5	TRBJ2-1
TGTGCCAGCGACCGGGACAGTCATTGGGCCTCTGGGGCCAACGTCCTGACTTTC	CASDRDSHWASGANVLTF	TRBV9	TRBJ2-6
TGTGCCAGCAGCATGAGGGGACAGGGGCTTAGCAATCAGCCCCAGCATTTT	CASSMRGQGLSNQPQHF	TRBV13	TRBJ1-5
TGTGCCAGGAGGGGGCTTATTGGCATGAACACTGAAGCTTTCTTT	CARRGLIGMNTEAFF	TRBV28	TRBJ1-1
TGTGCCAGCAGTGACGTAAGGCGGGGCCTTGAGCAGTTCTTC	CASSDVRRGLEQFF	TRBV6-4	TRBJ2-1
TGTGCCAGCAAAGGCCCACTAGAGGGTTTGGATGACTACAATGAGCAGTTCTTC	CASKGPLEGLDDYNEQFF	TRBV11-3	TRBJ2-1
TGTGCCAGCAGCTCTGGACAGCGGGCTTATGGCTACACCTTC	CASSSGQRAYGYTF	TRBV7-3	TRBJ1-2
TGTGCCAGCAGCTTAAGGGGTACCAATCAGCCCCAGCATTTT	CASSLRGTNQPQHF	TRBV7-3	TRBJ1-5
TGCGCCAGCAGCCAGCTGAGGGACAGGGCCGGCAAAAGCTCCTATAATTCACCCCTCCACTTT	CASSQLRDRAGKSSYNSPLHF	TRBV10-1	TRBJ1-6
TGTGCCAGCAGCATCGACAGGGAGACCCAGTACTTC	CASSIDRETQYF	TRBV13	TRBJ2-5
TGTGCCAGCAGTCCAGACAGGAAGACCCAGTACTTC	CASSPDRKTQYF	TRBV28	TRBJ2-5
TGTGCCAGCAGCCCAACAGTGACTGAAGCTTTCTTT	CASSPTVTEAFF	TRBV5-6	TRBJ1-1
TGTGCCAGCACGGGACAGGATGAGCAGTTCTTC	CASTGQDEQFF	TRBV25-1	TRBJ2-1
TGTGCCAGTAAGGGTGGAACCTACGAGCAGTACTTC	CASKGGTYEQYF	TRBV19	TRBJ2-7
TGTGCCAGCAGTCGACCGGGACAGAAGAGGGGTGAGACCCAGTACTTC	CASSRPGQKRGETQYF	TRBV11-2	TRBJ2-5
TGCGCCAGCAGCCAACAAGGGCGGATTAGCTCCTACAATGAGCAGTTCTTC	CASSQQGRISSYNEQFF	TRBV4-3	TRBJ2-1
TGTGCCAGCAGCGGACAGGATAATTCACCCCTCCACTTT	CASSGQDNSPLHF	TRBV7-9	TRBJ1-6
TGTGCCAGCAGCGTAGCCTCTTGGGGGGGAACAGTTGAGCAGTTCTTC	CASSVASWGGTVEQFF	TRBV9	TRBJ2-1
TGTGCCAGCAGGCAAGCCGACAGGGTGGATGGCACCTCCTACGAGCAGTACTTC	CASRQADRVDGTSYEQYF	TRBV27	TRBJ2-7
TGTGCCACCAGTGCTGTCAAACGGGGAAGGGACAGGCCCTCTGGAAACACCATATATTTT	CATSAVKRGRDRPSGNTIYF	TRBV24-1	TRBJ1-3
TGTGCCTGGATCCTAGAGGGAACAAGGGGCCCCGGGGAGCTGTTTTTT	CAWILEGTRGPGELFF	TRBV30	TRBJ2-2
TGCAGTGCTTTTTGTTCGACAGGGGCCGGTGCCTACGAGCAGTACTTC	CSAFCSTGAGAYEQYF	TRBV20-1	TRBJ2-7
TGTGCCAGCAGCTTAGACCATGCCAGGGGTGCAATGGTCTACAATGAGCAGTTCTTC	CASSLDHARGAMVYNEQFF	TRBV5-4	TRBJ2-1
TGTGCCACCAGTGGGCAGGCCCGAGAAAAACTGTTTTTT	CATSGQAREKLFF	TRBV24-1	TRBJ1-4
TGTGCCAGCGAGGGGGGGACAGGGAGTCCGGCCTACGAGCAGTACTTC	CASEGGTGSPAYEQYF	TRBV6-3	TRBJ2-7
TGTGCCATCAGTGAGACGGGGGTGGGGACTAGTCCTTACGAGCAGTACTTC	CAISETGVGTSPYEQYF	TRBV10-3	TRBJ2-7
TGTGCCAGCAGCGTCGTAGGGACTGACAAACACCACGAGCAGTACTTC	CASSVVGTDKHHEQYF	TRBV9	TRBJ2-7
TGTGCCAGCAGTTGGACAGGGGACGCGAACACCGGGGAGCTGTTTTTT	CASSWTGDANTGELFF	TRBV27	TRBJ2-2
TGTGCCAGCAAAGGGGAGCCCCAGCATTTT	CASKGEPQHF	TRBV6-5	TRBJ1-5
TGTGCCAGCACAAAGTGGCTTGGGACAGAAACGGGCCATCAGCCCCAGCATTTT	CASTKWLGTETGHQPQHF	TRBV11-3	TRBJ1-5
TGTGCCAGCAGTGCGGGTGGGGGATCTGGAAACACCATATATTTT	CASSAGGGSGNTIYF	TRBV6-1	TRBJ1-3
TGTGCCAGCAGTGGCTACCCAAGGCGGCCAGATACGCAGTATTTT	CASSGYPRRPDTQYF	TRBV6-1	TRBJ2-3
TGTGCCAGCAGCCGGGTTAAAACTAAACAAGCTTTCTTT	CASSRVKTKQAFF	TRBV14	TRBJ1-1
TGTGCCAGCATCTGGGCATCAGGGTCTCTTCACTATGGCTACACCTTC	CASIWASGSLHYGYTF	TRBV6-2	TRBJ1-2
TGTGCCAGCAGCTTAGCAGTATTGGACAGGGGGAATCAGCCCCAGCATTTT	CASSLAVLDRGNQPQHF	TRBV7-8	TRBJ1-5
TGTGCCAGCCTATATGATGAGCTGGACAGGAGGGGGTTAGCCAAAAACATTCAGTACTTC	CASLYDELDRRGLAKNIQYF	TRBV25-1	TRBJ2-4
TGCAGTGCTAGAGAGGGTGGGGTACGGTGGGGCTACGAGCAGTACTTC	CSAREGGVRWGYEQYF	TRBV20-1	TRBJ2-7
TGTGCCAGCAGTGATAGACGTGGCTACACCTTC	CASSDRRGYTF	TRBV6-4	TRBJ1-2
TGTGCCAGCAGCAATCGCGGTTTTGGGAGGGCCAAGACCCAGTACTTC	CASSNRGFGRAKTQYF	TRBV7-4	TRBJ2-5
TGTGCCACCAAGGCCTACAGGGGGGATGGCTACACCTTC	CATKAYRGDGYTF	TRBV24-1	TRBJ1-2
TGTGCCAGCAGTGACTCCCTGAATTGGACGAATGAGCAGTTCTTC	CASSDSLNWTNEQFF	TRBV6-4	TRBJ2-1
TGTGCCAGCAAAAAACGACAGGAGGGCCCCGGACATGGGGCCAACGTCCTGACTTTC	CASKKRQEGPGHGANVLTF	TRBV6-6	TRBJ2-6
TGTGCCAGCAGTGACTCGACTGTCCGGGACAGGGTTCGAGAAGTTGCCCTCCACTTT	CASSDSTVRDRVREVALHF	TRBV6-4	TRBJ1-6
TGTGCGAAGGGACAGGGGGCCAATCAGCCCCAGCATTTT	CAKGQGANQPQHF	TRBV28	TRBJ1-5
TGTGCCAGCAGCGGGACTAGCGGGGGGGAGTTCGGGGAGCTGTTTTTT	CASSGTSGGEFGELFF	TRBV14	TRBJ2-2
TGCGCCAGCAGCCAAACCCGGGACAGGGCTCAAGCCTGGATCTATAATTCACCCCTCCACTTT	CASSQTRDRAQAWIYNSPLHF	TRBV4-3	TRBJ1-6
TGTGCCAGCACGACAGGTCGGGCCTACGAGCAGTACTTC	CASTTGRAYEQYF	TRBV2	TRBJ2-7
TGTGCCAGTAAACGAGGGGACACTGAAGCTTTCTTT	CASKRGDTEAFF	TRBV19	TRBJ1-1
TGCGCCAGCAAAACGGGGGGCCCACTTCCCCACAATGAGCAGTTCTTC	CASKTGGPLPHNEQFF	TRBV10-1	TRBJ2-1
TGTGCCAGCAGTTACAGTCAAGGCTATGGCTACACCTTC	CASSYSQGYGYTF	TRBV6-5	TRBJ1-2
TGTGCCAGCAGCAAAGGGGGGGGGACCGGGGAGCTGTTTTTT	CASSKGGGTGELFF	TRBV7-4	TRBJ2-2
TGTGCCACCCAGACAGGGAGCTACAATGAGCAGTTCTTC	CATQTGSYNEQFF	TRBV24-1	TRBJ2-1
TGCAGTGCTAGAGACCACGGGACTAGGTACAGCACAGATACGCAGTATTTT	CSARDHGTRYSTDTQYF	TRBV20-1	TRBJ2-3
TGTGCCAGCAGCCCCTCGGGGAGGGAGGGCCAGCCCCAGCATTTT	CASSPSGREGQPQHF	TRBV7-9	TRBJ1-5
TGTGCCATTCAACAGGGGGGGGGTTTTGGCTACACCTTC	CAIQQGGGFGYTF	TRBV2	TRBJ1-2
TGTGCCAGCCCGGCCGCAGATTGTCTTAGTGGCTACACCTTC	CASPAADCLSGYTF	TRBV7-9	TRBJ1-2
TGCGCCAGCAGTGAGTCTCCGGTTAGCGGCACAGATACGCAGTATTTT	CASSESPVSGTDTQYF	TRBV10-1	TRBJ2-3
TGCAGCGTAGAGTCCTACGAGCAGTACTTC	CSVESYEQYF	TRBV29-1	TRBJ2-7
TGTGCCAGCAGCCAAGGTTTTCCGGACACGGATGGCTACACCTTC	CASSQGFPDTDGYTF	TRBV11-2	TRBJ1-2
TGTGCCAGCAGTTTGTCCGGGCAGGGGTCACCCCTCCACTTT	CASSLSGQGSPLHF	TRBV28	TRBJ1-6
TGCAGCGCGGTGAGCGCTGAAGCTTTCTTT	CSAVSAEAFF	TRBV29-1	TRBJ1-1
TGTGCCAGCAGCTTAGGTTTTTTAGCCTGGTGGCGGGGGATACTCCCTTTGGTGACGGGCTACGAGCAGTACTTC	CASSLGFLAWWRGILPLVTGYEQYF	TRBV7-2	TRBJ2-7
TGTGCCAGTAGTACGGCGGGACAGAGTGGGTCCTACAATGAGCAGTTCTTC	CASSTAGQSGSYNEQFF	TRBV19	TRBJ2-1
TGTGCCAGCAGCGTAGGCTTCGGCGCACTTCAGCCCCAGCATTTT	CASSVGFGALQPQHF	TRBV9	TRBJ1-5
TGTGCCAGCATTCTCGGGCCCCATCCTCAGCCCCAGCATTTT	CASILGPHPQPQHF	TRBV6-2	TRBJ1-5
TGTGCCAGCAGTGTTAAGAACCGGGGGGGTCACGGAAGGGGGACAACCGGGGAGCTGTTTTTT	CASSVKNRGGHGRGTTGELFF	TRBV6-1	TRBJ2-2
TGTGGCTTAAAACCGACTAGCGCCTCTGGGGCCAACGTCCTGACTTTC	CGLKPTSASGANVLTF	TRBV10-3	TRBJ2-6
TGTGCCAGCAGGTTACTAGCGGGCCCTGGGAATGAGCAGTTCTTC	CASRLLAGPGNEQFF	TRBV6-5	TRBJ2-1
TGTGCCAGCAGGGTGGCCGGGACAGCCCCCTTC	CASRVAGTAPF	TRBV28	TRBJ1-2
TGTGCCAGCCCCCTAAGAGATACGCAGTATTTT	CASPLRDTQYF	TRBV27	TRBJ2-3
TGTGCCAGCAGTCTACCCGGGGGCCAGCCCCAGCATTTT	CASSLPGGQPQHF	TRBV27	TRBJ1-5
TGTGCCACCACCGCATCGAGGGGTAACGGACAGCCCCAGCATTTT	CATTASRGNGQPQHF	TRBV24-1	TRBJ1-5
TGTGCCATCAGTAAAAACCTTTCGCTAGCAACTAATGAAAAACTGTTTTTT	CAISKNLSLATNEKLFF	TRBV10-3	TRBJ1-4
TGTGCCACCAGTGACAGCAAACCCAGGGGGAAGGAGCAGTACTTC	CATSDSKPRGKEQYF	TRBV24-1	TRBJ2-7
TGTGCCGGGTCGGGACTTCGAGGTGGCTACACCTTC	CAGSGLRGGYTF	TRBV30	TRBJ1-2
TGTGCCAGCAGCCAAAGACTAGCGGGGGGGGAGCTGTTTTTT	CASSQRLAGGELFF	TRBV4-2	TRBJ2-2
TGTGCCAGCAGTGACCTATGGGGGCAATCGAACACTGAAGCTTTCTTT	CASSDLWGQSNTEAFF	TRBV6-4	TRBJ1-1
TGCGCCAGCAGCTTGGCCAGAATAAGCAGCGTGACTGATACGCAGTATTTT	CASSLARISSVTDTQYF	TRBV5-1	TRBJ2-3
TGTGCCAGCAGCAGAATCGGGACAGGTGTCCCCGATCAGCCCCAGCATTTT	CASSRIGTGVPDQPQHF	TRBV13	TRBJ1-5
TGTGCCAGTAGTATGAGGGGACTGACCGAGCAGTACTTC	CASSMRGLTEQYF	TRBV19	TRBJ2-7
TGTGCCAGCAGTGAGAGACAGGGCGTCAGACCCAACACTGAAGCTTTCTTT	CASSERQGVRPNTEAFF	TRBV6-1	TRBJ1-1
TGTGCCAGCAGCCAGTCCAGGGCTGAAGCTTTCTTT	CASSQSRAEAFF	TRBV14	TRBJ1-1
TGTGCCAGCAGCAGTGGCAGGGCATCCTACGAGCAGTACTTC	CASSSGRASYEQYF	TRBV3-1	TRBJ2-7
TGTGCCAGCAGAAAAAGCCTAGCGCGCACCGGGGAGCTGTTTTTT	CASRKSLARTGELFF	TRBV6-5	TRBJ2-2
TGTGCCAGCAGTAGGCGGGACACGGCGCCCCAGCATTTT	CASSRRDTAPQHF	TRBV25-1	TRBJ1-5
TGTGCCACCAGACGGACAGGGGTTACCTACAATGAGCAGTTCTTC	CATRRTGVTYNEQFF	TRBV24-1	TRBJ2-1
TGTGCCAGCAGCCTGGACCGGGACAGGAACACAGATACGCAGTATTTT	CASSLDRDRNTDTQYF	TRBV5-6	TRBJ2-3
TGTGCCAGCAGGAGGCAGGGAGAGAAGCCTTATGGCTACACCTTC	CASRRQGEKPYGYTF	TRBV6-4	TRBJ1-2
TGTGCCAGCAGTTTCGGCTCTGGAATGAACACTGAAGCTTTCTTT	CASSFGSGMNTEAFF	TRBV27	TRBJ1-1
TGCGCCAGCAGCAGCCTTCATGGAAACACCATATATTTT	CASSSLHGNTIYF	TRBV5-1	TRBJ1-3
TGTGCCAGCAGCTTGCGAGGCTACGAGCAGTACTTC	CASSLRGYEQYF	TRBV5-6	TRBJ2-7
TGTGCCACCAGTGATTTAATGGGGGTCGACAGGGCGCGTTACGAGCAGTACTTC	CATSDLMGVDRARYEQYF	TRBV24-1	TRBJ2-7
TGCAGTGCTAGAGATCGCCCGGTAGCGGAAAGCTCCTACAATGAGCAGTTCTTC	CSARDRPVAESSYNEQFF	TRBV20-1	TRBJ2-1
TGTGCCAGCAGTTTGGGACAGGGCTCCTACGAGCAGTACTTC	CASSLGQGSYEQYF	TRBV27	TRBJ2-7
TGTGCCAGCAGCCCCGGGGAAATTAGCACTGAAGCTTTCTTT	CASSPGEISTEAFF	TRBV6-4	TRBJ1-1
TGCGCCAGCAGGGGTTCGTATGTACCGTGGGGGACTAGCGGGTACGAGCAGTACTTC	CASRGSYVPWGTSGYEQYF	TRBV10-1	TRBJ2-7
TGCGCCAGCAGGGTTTCCTCACTAATCGTTTCGGAGACCCAGTACTTC	CASRVSSLIVSETQYF	TRBV5-1	TRBJ2-5
TGCAGCGTTAGCGGGTATGGCTACACCTTC	CSVSGYGYTF	TRBV29-1	TRBJ1-2
TGCGCCAGCAGCTTGGTTGCTTTAGCGGGCTGCTCGGATACGCAGTATTTT	CASSLVALAGCSDTQYF	TRBV5-1	TRBJ2-3
TGTGCCAGCAGCAACCCCGGGCACCAGTCCTTGACTGAAGCTTTCTTT	CASSNPGHQSLTEAFF	TRBV13	TRBJ1-1
TGTGCCAGCAGTTACAAGGCGGGGGGGAATTCACCCCTCCACTTT	CASSYKAGGNSPLHF	TRBV6-4	TRBJ1-6
TGCGCCAGCAGTAAAGGGGGCCCGTACCAAGAGACCCAGTACTTC	CASSKGGPYQETQYF	TRBV10-1	TRBJ2-5
TGTGCCAGCAGCTGGGAACTACAGGGGGGGTTGGAGACCCAGTACTTC	CASSWELQGGLETQYF	TRBV9	TRBJ2-5
TGTGCCAGCAGTCGAAGTGGGGGGGGTGGAGAGCAGTTCTTC	CASSRSGGGGEQFF	TRBV2	TRBJ2-1
TGTGCCAGCAGCGACAGGGGTGGCGAGACCCAGTACTTC	CASSDRGGETQYF	TRBV7-3	TRBJ2-5
TGTGCCTGGGGGCGGGTTATTGAGCAGTTCTTC	CAWGRVIEQFF	TRBV30	TRBJ2-1
TGTGCCAGCAGCGCTAGGCTAGTGCCCCAGCATTTT	CASSARLVPQHF	TRBV11-3	TRBJ1-5
TGTGCCAGCAGCTTGACTTGTTACCCGAGCACAGATACGCAGTATTTT	CASSLTCYPSTDTQYF	TRBV7-9	TRBJ2-3
TGTGCCAGCAGCAACCCGAGGCGGGACAGGGAACGACAGCCCCAGCATTTT	CASSNPRRDRERQPQHF	TRBV13	TRBJ1-5
TGTGCCACCACTATGGGACGGGACACCATATATTTT	CATTMGRDTIYF	TRBV5-4	TRBJ1-3
TGTGCCATGTGGGGACGAAATGAAAAACTGTTTTTT	CAMWGRNEKLFF	TRBV10-3	TRBJ1-4
TGTGCCACCAGTGATTCCCCGAATAGGACAGAGGCAGATACGCAGTATTTT	CATSDSPNRTEADTQYF	TRBV24-1	TRBJ2-3
TGTGCCACCAGTGGGGAGGGTGGAGGCTACACCTTC	CATSGEGGGYTF	TRBV24-1	TRBJ1-2
TGTGCCAGCAGTTACTCGGGAGGGACGTCCTTACACACTGAAGCTTTCTTT	CASSYSGGTSLHTEAFF	TRBV6-5	TRBJ1-1
TGTGCCACCCCGCATCGCGGAGAGAACACTGAAGCTTTCTTT	CATPHRGENTEAFF	TRBV24-1	TRBJ1-1
TGTGCCAGCAGCTTAGCGTCGGGAGACCGGTACGAGCAGTACTTC	CASSLASGDRYEQYF	TRBV7-9	TRBJ2-7
TGTGCCAGCAGCGCCTCGAGGGAGAGCTCCTACGAGCAGTACTTC	CASSASRESSYEQYF	TRBV9	TRBJ2-7
TGCGCCAGCAGCTTGCCGAACCAGGGTAATCCTACCGAGCATTCAGATACGCAGTATTTT	CASSLPNQGNPTEHSDTQYF	TRBV5-1	TRBJ2-3
TGTGCCAGCAGAGGACAGCAGAACTACGAGCAGTACTTC	CASRGQQNYEQYF	TRBV28	TRBJ2-7
TGTGCCAGCTTGAGGGACAGGGGTGCTTACGAGCAGTACTTC	CASLRDRGAYEQYF	TRBV25-1	TRBJ2-7
TGCGCCAGCAGCCACCCCGGGGAGGCTGAAGCTTTCTTT	CASSHPGEAEAFF	TRBV4-3	TRBJ1-1
TGTGCCAGCAGTGCCGGGACTAGCGGGATGGGCTACGAGCAGTACTTC	CASSAGTSGMGYEQYF	TRBV25-1	TRBJ2-7
TGTGCCAGCAGCCGGACTAGCGGGTACTTC	CASSRTSGYF	TRBV7-9	TRBJ2-5
TGTGCCAGCAGTGAAACGCGGCAGCCCCAGCATTTT	CASSETRQPQHF	TRBV6-1	TRBJ1-5
TGTGCCAGCAGTTGGCTAGCGGGTCACGGTTTAAACACCGGGGAGCTGTTTTTT	CASSWLAGHGLNTGELFF	TRBV28	TRBJ2-2
TGTGCCACCAGTGATCAGGGGAACACTGAAGCTTTCTTT	CATSDQGNTEAFF	TRBV24-1	TRBJ1-1
TGCAGTGCAAATATTAAGGGAAAGCAGCCCCAGCATTTT	CSANIKGKQPQHF	TRBV20-1	TRBJ1-5
TGTGCCAGAATCTTCAGGGGGTTGTCACCCCTCCACTTT	CARIFRGLSPLHF	TRBV6-5	TRBJ1-6
TGTGCCAGCAGTTACCGGGACAGATGTAGTCGCGAGCAGTACTTC	CASSYRDRCSREQYF	TRBV6-2	TRBJ2-7
TGTGCTAGTGGTTTGGTACCCTGGGAGTACATTCAGTACTTC	CASGLVPWEYIQYF	TRBV12-5	TRBJ2-4
TGCAGCGTGCAGGGTTTAGAGAACACTGAAGCTTTCTTT	CSVQGLENTEAFF	TRBV29-1	TRBJ1-1
TGTGCCAGCTTCCAGGCCTACGAGCAGTACTTC	CASFQAYEQYF	TRBV9	TRBJ2-7
TGTGCCAGCAGCGGTCAGAGGGAGACCCAGTACTTC	CASSGQRETQYF	TRBV13	TRBJ2-5
TGTGCCAGCAGCATGGAGGAAGAGACCCAGTACTTC	CASSMEEETQYF	TRBV2	TRBJ2-5
TGCGCCAGCCGGGACAGGGGGGTACTGAACACTGAAGCTTTCTTT	CASRDRGVLNTEAFF	TRBV10-1	TRBJ1-1
TGCGCCAGCAGTGTGACAGGGAGACAGAACACTGAAGCTTTCTTT	CASSVTGRQNTEAFF	TRBV10-1	TRBJ1-1
TGCAGTGCTAGAGCCCCAGGGGCCGGGGGGAACACTGAAGCTTTCTTT	CSARAPGAGGNTEAFF	TRBV20-1	TRBJ1-1
TGTGCCAGCAGTTTAGCGCCCGCCCAGACACTGAACACTGAAGCTTTCTTT	CASSLAPAQTLNTEAFF	TRBV12-4	TRBJ1-1
TGTGCCAGCAGTGACTCTCTGAGTTATCATGAGCAGTTCTTC	CASSDSLSYHEQFF	TRBV6-1	TRBJ2-1
TGTGCCCCGGAGGAGAGGGAACAAAACACCATATATTTT	CAPEEREQNTIYF	TRBV2	TRBJ1-3
TGTGCCAGCAGCAAAGCTAGCAATGAGCAGTTCTTC	CASSKASNEQFF	TRBV13	TRBJ2-1
TGTGCCAGCAAACAGGGAACGGTGGGAAAACTGTTTTTT	CASKQGTVGKLFF	TRBV6-2	TRBJ1-4
TGTGCCAGCAGGCTCGACAAAAACATTCAGTACTTC	CASRLDKNIQYF	TRBV6-6	TRBJ2-4
TGCGCCAGCAGCTTGCATCGGGGGGGGGCCTACGAGCAGTACTTC	CASSLHRGGAYEQYF	TRBV5-1	TRBJ2-7
TGTGCCAGCATAGGTCCGAAGGGGCCGAGGAGGAACACTGAAGCTTTCTTT	CASIGPKGPRRNTEAFF	TRBV11-2	TRBJ1-1
TGCAGTGCGAGGCGGACCGGCCGGGACAGGGCAAATCAGCCCCAGCATTTT	CSARRTGRDRANQPQHF	TRBV20-1	TRBJ1-5
TGTGCCAGCAGGGGGGGGAACGGGGCCAAAAACATTCAGTACTTC	CASRGGNGAKNIQYF	TRBV28	TRBJ2-4
TGTGCCAGCCTCAAGGACAGGGTCGGATATAGCAATCAGCCCCAGCATTTT	CASLKDRVGYSNQPQHF	TRBV5-6	TRBJ1-5
TGCGCCAGCAGCCAAGCAAGAAAAAACAATGAGCAGTTCTTC	CASSQARKNNEQFF	TRBV4-1	TRBJ2-1
TGTGCCAGCAGCTTCCCGTCCAGGGGTCCGCTCACCGAGCAGTACTTC	CASSFPSRGPLTEQYF	TRBV7-9	TRBJ2-7
TGTGCCACCAGTGATTTTCAGGGGGACTACGAGCAGTACTTC	CATSDFQGDYEQYF	TRBV24-1	TRBJ2-7
TGTGCCAGTAGTATAAAAGTTCAAGGACAGACCTACGAGCAGTACTTC	CASSIKVQGQTYEQYF	TRBV19	TRBJ2-7
TGTGCCAGCAGTGAGGTATCCTACGAGCAGTACTTC	CASSEVSYEQYF	TRBV7-4	TRBJ2-7
TGTGCCAGCAGCCCGGACAGGGGGGGGAACTATGGCTACACCTTC	CASSPDRGGNYGYTF	TRBV13	TRBJ1-2
TGCGCCAGCAGCTGTACAGTGGATTACGAGCAGTACTTC	CASSCTVDYEQYF	TRBV4-3	TRBJ2-7
TGTGCCAGCAGTTACGGGGGCACTCAGCCCCAGCATTTT	CASSYGGTQPQHF	TRBV6-3	TRBJ1-5
TGTGCCAGCACTCAGGGTACCTACGAGCAGTACTTC	CASTQGTYEQYF	TRBV7-3	TRBJ2-7
TGTGCCAGCAGCAAGCAGAATGAGCAGTTCTTC	CASSKQNEQFF	TRBV13	TRBJ2-1
TGTGCCAGCAGCTACGGGGCAGATGGCTACACCTTC	CASSYGADGYTF	TRBV7-9	TRBJ1-2
TGTGCCAGCAGCTTAGACATGACCCCGGGACAGGACGACCCCGGAGGCGAGCAGTACTTC	CASSLDMTPGQDDPGGEQYF	TRBV7-2	TRBJ2-7
TGTGCCACCAGTGAGACTAGCGGGATAACAGATACGCAGTATTTT	CATSETSGITDTQYF	TRBV24-1	TRBJ2-3
TGTGCCAGCAGTTTATCACAGGGGGTAATTAACAAAAACATTCAGTACTTC	CASSLSQGVINKNIQYF	TRBV27	TRBJ2-4
TGTGCCTGGGCAGGACTAGGAACCTACGAGCAGTACTTC	CAWAGLGTYEQYF	TRBV30	TRBJ2-7
TGTGCCAGCAGCCGATCCGGGCGTCACAGGGGCGAAAAGCCGGTTGAAGCTTTCTTT	CASSRSGRHRGEKPVEAFF	TRBV7-4	TRBJ1-1
TGTGCCAGCAGTTTATATGAAACTAGGAACACCGGGGAGCTGTTTTTT	CASSLYETRNTGELFF	TRBV28	TRBJ2-2
TGTGCCAGCAGTGGGACAAGAAGGGGCCCCTCAGGTAGCACAGATACGCAGTATTTT	CASSGTRRGPSGSTDTQYF	TRBV14	TRBJ2-3
TGTGCCAGCAGCGGACAGACTGAAGCTTTCTTT	CASSGQTEAFF	TRBV5-6	TRBJ1-1
TGTGCCAGCAATCGGGGGCCCTACGAGCAGTACTTC	CASNRGPYEQYF	TRBV28	TRBJ2-7
TGTGCCAGCAGCGAAAAGGAGAAAGGGGGTGGTATCGCTTATAGCTCCTACAATGAGCAGTTCTTC	CASSEKEKGGGIAYSSYNEQFF	TRBV13	TRBJ2-1
TGCAGTGCATGGGGGGAACATACGCAGTATTTT	CSAWGEHTQYF	TRBV20-1	TRBJ2-3
TGCGCCAGCGACGGACGCCAGCATTTT	CASDGRQHF	TRBV5-1	TRBJ1-5
TGTGCCACCACGGACAGGAACACTGAAGCTTTCTTT	CATTDRNTEAFF	TRBV24-1	TRBJ1-1
TGTGCTAGTGGTTTGAGGACAGGGGTCGCTAACTATGGCTACACCTTC	CASGLRTGVANYGYTF	TRBV12-5	TRBJ1-2
TGTGCCAGCAGCTTCTCCCCGACAGGCGAGGGGTCTGGAAACACCATATATTTT	CASSFSPTGEGSGNTIYF	TRBV11-3	TRBJ1-3
TGTGCTAGCAGCCCCATGGACAGGGGGCCGGAAAAACTGTTTTTT	CASSPMDRGPEKLFF	TRBV7-7	TRBJ1-4
TGTGCCACCCGAAGGGGCCAGGGCGACTACAATGAGCAGTTCTTC	CATRRGQGDYNEQFF	TRBV10-3	TRBJ2-1
TGTGCCACCAGTGAACCCGCCCCGGCGTTGCAGCGTCCGGCCTATGGCTACACCTTC	CATSEPAPALQRPAYGYTF	TRBV24-1	TRBJ1-2
TGTGCCAGCAGTAAGCAGTGGGGTCTTCAGCCCCAGCATTTT	CASSKQWGLQPQHF	TRBV6-5	TRBJ1-5
TGTGCCAGTAGTATAGGGACCTCCTACGAGCAGTACTTC	CASSIGTSYEQYF	TRBV19	TRBJ2-7
TGTGCCAGCAGCTCGACCGAGTGCGAGTGCAAAGAGACCCAGTACTTC	CASSSTECECKETQYF	TRBV7-2	TRBJ2-5
TGTGCCAGCAGCGGCGGGAGCTGGATTCTAGCCAAAAACATTCAGTACTTC	CASSGGSWILAKNIQYF	TRBV7-4	TRBJ2-4
TGTGCCAGCAGCCAAGAGGGGAGGAAATTAACAGGGGAGAAGTACACTGAAGCTTTCTTT	CASSQEGRKLTGEKYTEAFF	TRBV14	TRBJ1-1
TGCAGCGTGTCAGGATTACCCTATGGCTACACCTTC	CSVSGLPYGYTF	TRBV29-1	TRBJ1-2
TGCAGTGCTACCTTCAGAACTAACTATGGCTACACCTTC	CSATFRTNYGYTF	TRBV20-1	TRBJ1-2
TGTGCCAGCAGTTCCGGACAGGGGGGTCCCCGGACAGATACGCAGTATTTT	CASSSGQGGPRTDTQYF	TRBV28	TRBJ2-3
TGCACGGAACCCTATAATTCACCCCTCCACTTT	CTEPYNSPLHF	TRBV20-1	TRBJ1-6
TGTGCCAGCAGCCATGAATGCCGGAGGGGGGCTCCCTACGAGCAGTACTTC	CASSHECRRGAPYEQYF	TRBV3-1	TRBJ2-7
TGTGCCAGCAGGGGGGAACTAGGGGGAACAGAGACCCAGTACTTC	CASRGELGGTETQYF	TRBV13	TRBJ2-5
TGTGCCAGCAGTGGGGCGGGCCATACGCAGTATTTT	CASSGAGHTQYF	TRBV2	TRBJ2-3
TGTGCCAGCAGCTTGGGTAAGAGTCCGGACAATGAGCAGTTCTTC	CASSLGKSPDNEQFF	TRBV11-3	TRBJ2-1
TGTGCCAGCAGTTTGCCCACAGCCTACGAGCAGTACTTC	CASSLPTAYEQYF	TRBV27	TRBJ2-7
TGTGCCAGCAGCCTAGTATATCCGGTACAACCTAGGTGGAATGAGCAGTTCTTC	CASSLVYPVQPRWNEQFF	TRBV7-3	TRBJ2-1
TGTGCCAGCAAAACTCCTCTCCGGACTTACGAGCAGTACTTC	CASKTPLRTYEQYF	TRBV6-2	TRBJ2-7
TGTGCCACCAGTGAAGGTTTCACAGGGATCTCTAACTACGAGCAGTACTTC	CATSEGFTGISNYEQYF	TRBV24-1	TRBJ2-7
TGTGCCAGGTTGGGGGGGCTTGTCCTTTTAGCCAAAAACATTCAGTACTTC	CARLGGLVLLAKNIQYF	TRBV25-1	TRBJ2-4
TGTGCCAGTAGCAGGCCGGGCGGGTCCTACAATGAGCAGTTCTTC	CASSRPGGSYNEQFF	TRBV19	TRBJ2-1
TGTGCCAGCAGCGCCTGGGGCCTGCAGTATTTT	CASSAWGLQYF	TRBV11-2	TRBJ2-3
TGTGCCAGCAGCGTACGCCGAGGGGGAACTAATGAAAAACTGTTTTTT	CASSVRRGGTNEKLFF	TRBV9	TRBJ1-4
TGTGCCAGTAGTATAGAACGACGAAGACCTGAAGCTTTCTTT	CASSIERRRPEAFF	TRBV19	TRBJ1-1
TGCGCCACGGGGACAGAGGTAGACTCACCCCTCCACTTT	CATGTEVDSPLHF	TRBV4-1	TRBJ1-6
TGTGCCACCATCACGGGGAGTAACTATGGCTACACCTTC	CATITGSNYGYTF	TRBV24-1	TRBJ1-2
TGTGCCACCAGCAGAGATTGGGGGGTGTATTTT	CATSRDWGVYF	TRBV15	TRBJ2-3
TGTGCCGGGGGTAGGGGGTGCAATCAGCCCCAGCATTTT	CAGGRGCNQPQHF	TRBV7-6	TRBJ1-5
TGTGCCCTAGGGGGCCCCTCCTACGAGCAGTACTTC	CALGGPSYEQYF	TRBV6-6	TRBJ2-7
TGTGCCAGCAGTTACTCGACCGTAGGACAGCTTAGGGCTGGAAACACCATATATTTT	CASSYSTVGQLRAGNTIYF	TRBV6-6	TRBJ1-3
TGCGCCAGCAGTGACTTGACACCTAATAGCGAGCAGTACTTC	CASSDLTPNSEQYF	TRBV10-1	TRBJ2-7
TGTGCCACCAGTGGTTACACGACAGGGTTTGAAGCTTTCTTT	CATSGYTTGFEAFF	TRBV24-1	TRBJ1-1
TGCAGTGCTACGAGGGCCCGGGGAGGCCCTCAAAATTCACCCCTCCACTTT	CSATRARGGPQNSPLHF	TRBV20-1	TRBJ1-6
