TGTGGGGACAGGGGGTTTGAGGTATACGAGCAGTACTTC	CGDRGFEVYEQYF	TRBV14	TRBJ2-7
TGTGCCAGCAGGGTTCAGCCCTCCTACAATGAGCAGTTCTTC	CASRVQPSYNEQFF	TRBV6-1	TRBJ2-1
TGTGCCACGGTGGGGGGGCCCCGGCCTGTCTTC	CATVGGPRPVF	TRBV10-3	TRBJ2-1
TGTGCCAGCAGTTTATTTAGGAGCGGGAAAGGTGGGGCCAACGTCCTGACTTTC	CASSLFRSGKGGANVLTF	TRBV28	TRBJ2-6
TGTGCCAGCAGCACTCGTTTAGGGGGCGAAGAAGATGGCTACACCTTC	CASSTRLGGEEDGYTF	TRBV3-1	TRBJ1-2
TGTGCCAGCAGTTTACCATCACCGGAGGGGGAAAACATTCAGTACTTC	CASSLPSPEGENIQYF	TRBV27	TRBJ2-4
TGTGCCAGCAGCGGCCTAGCGGGGCAGTACTTC	CASSGLAGQYF	TRBV28	TRBJ2-7
TGTGCCAGCAGCTTGGACCTAATCGGACAGAACTATGGCTACACCTTC	CASSLDLIGQNYGYTF	TRBV5-8	TRBJ1-2
TGTGCCAGCAGCCAAGTGGACGGCTTGGAAAATCAGCCCCAGCATTTT	CASSQVDGLENQPQHF	TRBV3-1	TRBJ1-5
TGTGCCAGCAGCCGCACCGGGACTAGCGGGGATTCCTCCTACAATGAGCAGTTCTTC	CASSRTGTSGDSSYNEQFF	TRBV13	TRBJ2-1
TGTGCCAGCAGCTTCGTTGTACAGGACCTCCAAACTGAAGCTTTCTTT	CASSFVVQDLQTEAFF	TRBV5-6	TRBJ1-1
TGTGCCAGCGACAGGCCCATAGGGTACAATGAGCAGTTCTTC	CASDRPIGYNEQFF	TRBV7-9	TRBJ2-1
TGTGCCAGCAGCCCTTCGCGACAGGGGGCGCCCAATGAGCAGTTCTTC	CASSPSRQGAPNEQFF	TRBV5-8	TRBJ2-1
TGTGCCAGCAGCTTCAGACAGGGGGCCAATCAGCCCCAGCATTTT	CASSFRQGANQPQHF	TRBV9	TRBJ1-5
TGTGCCAGCCCGCGCAGTTACTTAGACACTGAAGCTTTCTTT	CASPRSYLDTEAFF	TRBV6-4	TRBJ1-1
TGTGCCAGCAGCTCGGGGGGGCGGAGCTCCTACGAGCAGTACTTC	CASSSGGRSSYEQYF	TRBV9	TRBJ2-7
TGCGCCAGCAGCGGGCACAGGGACGACGGGATAGGGTACAGGCCAGATACGCAGTATTTT	CASSGHRDDGIGYRPDTQYF	TRBV5-1	TRBJ2-3
TGTGCCAGCAGCTTATGCGGTGAAGCTTTCTTT	CASSLCGEAFF	TRBV7-9	TRBJ1-1
TGTGCCAGCAGCCAAGTTCGTTTTAAGGCTGAAGCTTTCTTT	CASSQVRFKAEAFF	TRBV4-2	TRBJ1-1
TGCAGTGCTAGAGCACCCACAGGGGCTAACTATGGCTACACCTTC	CSARAPTGANYGYTF	TRBV20-1	TRBJ1-2
TGTGCCAGCAGTGAGACCACCGGACAGGGCGAGCAGTACTTC	CASSETTGQGEQYF	TRBV25-1	TRBJ2-7
TGTGCCACCAGTGATAACCAACCCAGGCAAAGGGGGCCTTTTGGCTACACCTTC	CATSDNQPRQRGPFGYTF	TRBV24-1	TRBJ1-2
TGCGCCAGCAGCAAAACGAGGGACCGCGCCGCCCTTGAGCAGTTCTTC	CASSKTRDRAALEQFF	TRBV5-1	TRBJ2-1
TGTGCCAACTTCGGGACAGGGTCCAGCTATGGCTACACCTTC	CANFGTGSSYGYTF	TRBV7-9	TRBJ1-2
TGTGCCAGCAGCTTAGCCTATAAAGGCGGGGTGGGTAATGAAAAACTGTTTTTT	CASSLAYKGGVGNEKLFF	TRBV7-8	TRBJ1-4
TGCAGTGCGAGGAACACAAACCAGGAGCAGTACTTC	CSARNTNQEQYF	TRBV20-1	TRBJ2-7
TGCGCCAGCAGAAGGAGGGATCGGGAAAAACTGTTTTTT	CASRRRDREKLFF	TRBV5-1	TRBJ1-4
TGTGCCAGCAGCTTAAGGGGAGACAGTGGCACCATATATTTT	CASSLRGDSGTIYF	TRBV5-8	TRBJ1-3
TGTGCCAGCAGCGAGGGGGATACAGCCCAGCATTTT	CASSEGDTAQHF	TRBV14	TRBJ1-5
TGTGCCTGGAGTGTACCTGACGACAGACTCGGGGAGCTGTTTTTT	CAWSVPDDRLGELFF	TRBV30	TRBJ2-2
TGTGCCAGCAGTGACTCGATAGTCTGGTGCTCTGGAAACACCATATATTTT	CASSDSIVWCSGNTIYF	TRBV6-4	TRBJ1-3
TGTGCCAGTAGTATCAATCGGGGGGGCCCCTACGAGCAGTACTTC	CASSINRGGPYEQYF	TRBV19	TRBJ2-7
TGTGCCAGCAGTTTAGGGGACGCTAGCACAGATACGCAGTATTTT	CASSLGDASTDTQYF	TRBV6-3	TRBJ2-3
TGTGCCAGCAGTGACCCCAGGGGGGATTGGTCCTACGAGCAGTACTTC	CASSDPRGDWSYEQYF	TRBV6-4	TRBJ2-7
TGTGCCTGGAGCGTCCAGGGTGATCAGCCCCAGCATTTT	CAWSVQGDQPQHF	TRBV30	TRBJ1-5
TGTGCCAGCAGCCAAGATAAGGGGCCAGGAGGGAACTATGGCTACACCTTC	CASSQDKGPGGNYGYTF	TRBV14	TRBJ1-2
TGTGCCATCAGCCCGACAGCCACAACTAATGAAAAACTGTTTTTT	CAISPTATTNEKLFF	TRBV10-3	TRBJ1-4
TGTGCCAGCAGCACGCAGGCGGACTATGGCTACACCTTC	CASSTQADYGYTF	TRBV9	TRBJ1-2
TGTGCCAGCAGTTTAAGCGGAGGCTTTCGCGGCTACGAGCAGTACTTC	CASSLSGGFRGYEQYF	TRBV6-6	TRBJ2-7
TGCGCCAGCAGCCAAGGAGTCACGGGATGCAGAAGTTCCTACAATGAGCAGTTCTTC	CASSQGVTGCRSSYNEQFF	TRBV4-1	TRBJ2-1
TGCAGCGGGAAAGGGGGGGCCTCGGAGCAGTACTTC	CSGKGGASEQYF	TRBV29-1	TRBJ2-7
TGCAGTGCTAGAGTTCCTAGCGGGGGGCAAGATACGCAGTATTTT	CSARVPSGGQDTQYF	TRBV20-1	TRBJ2-3
TGTGCCAGCAGTTCCACAGGGGATTCGGGCTCTGGAAACACCATATATTTT	CASSSTGDSGSGNTIYF	TRBV14	TRBJ1-3
TGTGCCAGCAGTGGACGAGGGACAGGTAATGAAAAACTGTTTTTT	CASSGRGTGNEKLFF	TRBV6-1	TRBJ1-4
TGTGCTAGAGGCCACGACGGTGGTTCACCCCTCCACTTT	CARGHDGGSPLHF	TRBV7-7	TRBJ1-6
TGTGCCAGCATCCAGGGAGGGGGGTGCCATCAGCCCCAGCATTTT	CASIQGGGCHQPQHF	TRBV6-6	TRBJ1-5
TGTGCCAGCAGGGCAGACAACTATGGCTACACCTTC	CASRADNYGYTF	TRBV28	TRBJ1-2
TGTGCCAGCAGTAGCGCGAGGCAAGAGACCCAGTACTTC	CASSSARQETQYF	TRBV6-5	TRBJ2-5
TGCAGTGCTAGCGTTAAAAACAAGCACATTCAGTACTTC	CSASVKNKHIQYF	TRBV20-1	TRBJ2-4
TGTGCCAGCAGCTCTACTCGGGGTTACCCGGGTAATTCACCCCTCCACTTT	CASSSTRGYPGNSPLHF	TRBV5-6	TRBJ1-6
TGCGCCAGCAGTGAGTCCAACTGTGCGGGAGTCCGCAATGAGCAGTTCTTC	CASSESNCAGVRNEQFF	TRBV10-1	TRBJ2-1
TGCGCCTCTCTCAGGGGGGCGTGGGCCAACGTCCTGACTTTC	CASLRGAWANVLTF	TRBV5-1	TRBJ2-6
TGTGCCAGCTCACCACCATGCCGGGACAGGCAAGAGACCCAGTACTTC	CASSPPCRDRQETQYF	TRBV18	TRBJ2-5
TGTGCCAGCAGGCCGGACAGGGGAGCTTTCTTT	CASRPDRGAFF	TRBV27	TRBJ1-1
TGCGCCAGCAGTGCTAGCGCGGGTTGCACAGATACGCAGTATTTT	CASSASAGCTDTQYF	TRBV10-1	TRBJ2-3
TGTGCCAGTAGTATTGGGACTGATAGCAATCAGCCCCAGCATTTT	CASSIGTDSNQPQHF	TRBV19	TRBJ1-5
TGTGCCAGCAGTAGACGGGGGTGGTTGACGGCCTACGAGCAGTACTTC	CASSRRGWLTAYEQYF	TRBV27	TRBJ2-7
TGTGCCAGCAGGCAGGGGCCGGGACAGGGGCCCGCGAACACTGAAGCTTTCTTT	CASRQGPGQGPANTEAFF	TRBV6-1	TRBJ1-1
TGCAGTGAAGCACAGGGGGAACGCTATGGCTACACCTTC	CSEAQGERYGYTF	TRBV20-1	TRBJ1-2
TGCATGTTTGCGAGGGTTTTCAGGGACGAGCAGTACTTC	CMFARVFRDEQYF	TRBV20-1	TRBJ2-7
TGTGCCAGCAGCCTAACTGTCCTAACCTACGAGCAGTACTTC	CASSLTVLTYEQYF	TRBV14	TRBJ2-7
TGTGCCACCAGTGATCGAACAGAGCTGAGCAAAAACATTCAGTACTTC	CATSDRTELSKNIQYF	TRBV24-1	TRBJ2-4
TGTGCCAGCAGTTACGTGCGGGCCCCCTACAATGAGCAGTTCTTC	CASSYVRAPYNEQFF	TRBV6-5	TRBJ2-1
TGTGCCATCAGTGCCAAGGGCCCTAAGTACTTC	CAISAKGPKYF	TRBV10-3	TRBJ2-7
TGTGCCAGCAGTAATGCGGGGGACCATAGCAATCAGCCCCAGCATTTT	CASSNAGDHSNQPQHF	TRBV12-3	TRBJ1-5
TGCGCCAGCAGCCAAGACACCGGGGGCCCCCCCCATCAGCCCCAGCATTTT	CASSQDTGGPPHQPQHF	TRBV4-1	TRBJ1-5
TGCGCCAGCAGCCCTCGTACCGGGACTGCCTCCTACGAGCAGTACTTC	CASSPRTGTASYEQYF	TRBV5-1	TRBJ2-7
TGCAGTGCTAGAGGGTCTAGCGGGCTCTACGAGCAGTACTTC	CSARGSSGLYEQYF	TRBV20-1	TRBJ2-7
TGTGCCAGCAATTTAATTTCCTGTTTGCCCCAGCATTTT	CASNLISCLPQHF	TRBV6-5	TRBJ1-5
TGTGCCAGCAGCTTAGGGTGGACTAGCGGGGGAGCCTACAATGAGCAGTTCTTC	CASSLGWTSGGAYNEQFF	TRBV7-6	TRBJ2-1
TGTGCCAGCAGCACTAGCGGGAGGGCGGGAAGTAGCAATCAGCCCCAGCATTTT	CASSTSGRAGSSNQPQHF	TRBV7-6	TRBJ1-5
TGTGCCAGCAGCCAGGTCAGGGCCCGGAATGAGCAGTTCTTC	CASSQVRARNEQFF	TRBV3-1	TRBJ2-1
TGTGCCAGCTCACCACACCCATCTCGGGACGCGACTGGGGAGTATGAAGAGACCCAGTACTTC	CASSPHPSRDATGEYEETQYF	TRBV18	TRBJ2-5
TGTGCCACGGGAATGAAGGGGCAGCGGGAGGCTGGGGCCAACGTCCTGACTTTC	CATGMKGQREAGANVLTF	TRBV24-1	TRBJ2-6
TGTGCCAGCAGCCGTCCTAGGAGGGAATCCTACGAGCAGTACTTC	CASSRPRRESYEQYF	TRBV5-5	TRBJ2-7
TGTGCCATCAGTGTAACCGGGACGGGTCACTCTGGGGCCAACGTCCTGACTTTC	CAISVTGTGHSGANVLTF	TRBV10-3	TRBJ2-6
TGTGCCAGCACTTGCCGGGGAGCTTTCTTT	CASTCRGAFF	TRBV2	TRBJ1-1
TGTGCCAGTCGCGGTCGGGCCTATGGCTACACCTTC	CASRGRAYGYTF	TRBV19	TRBJ1-2
TGTGCCTGGAGTCCGACAGAGTATGGCTACACCTTC	CAWSPTEYGYTF	TRBV30	TRBJ1-2
TGTGCCAGCAAATTCCAAGAGGGCTATGGCTACACCTTC	CASKFQEGYGYTF	TRBV9	TRBJ1-2
TGTGCCAGCAGCCCGGCCCATAACTATGGCTACACCTTC	CASSPAHNYGYTF	TRBV6-5	TRBJ1-2
TGCGCCAGCAGCCCTCAGACAGGGGGAAGCAATCAGCCCCAGCATTTT	CASSPQTGGSNQPQHF	TRBV5-1	TRBJ1-5
TGTGCCAGCTCATCTCGGGTGGAAAAACTGTTTTTT	CASSSRVEKLFF	TRBV18	TRBJ1-4
TGTGCTAGTGCCCCTAGCGGGAGGAAAGAGACCCAGTACTTC	CASAPSGRKETQYF	TRBV12-5	TRBJ2-5
TGCGCCAGCGAACAGGGGTGGGTCACAGATACGCAGTATTTT	CASEQGWVTDTQYF	TRBV10-1	TRBJ2-3
TGTGCCAGCAGCTTTAGTAGATACGGGGAGCTGTTTTTT	CASSFSRYGELFF	TRBV7-8	TRBJ2-2
TGTGCCAGCGGGGCAAGGGTTAGGCTCTACAATGAGCAGTTCTTC	CASGARVRLYNEQFF	TRBV6-4	TRBJ2-1
TGCAGTGCTAGCTTGAGGGTGATCGGCTACACCTTC	CSASLRVIGYTF	TRBV20-1	TRBJ1-2
TGTGCCTGGAGTAGCCTTACCGGCGATCTAGCGGGACCGAATGAGCAGTTCTTC	CAWSSLTGDLAGPNEQFF	TRBV30	TRBJ2-1
TGTGCCAGCAACGCGCCAAGGACAGGAGGGTTGTGTGATCAGCCCCAGCATTTT	CASNAPRTGGLCDQPQHF	TRBV6-2	TRBJ1-5
TGTGCCAGCAGTTTAGGGGGGGTCTACAATGAGCAGTTCTTC	CASSLGGVYNEQFF	TRBV12-4	TRBJ2-1
TGTGCCAGCAGAAAATACGCCCGTTCCCGGGGCCAAGCTCAGCCCCAGCATTTT	CASRKYARSRGQAQPQHF	TRBV6-4	TRBJ1-5
TGCAGTGCTAGAGAGAGGTGGGGGGCGAACTACGAGCAGTACTTC	CSARERWGANYEQYF	TRBV20-1	TRBJ2-7
TGTGCCAGCAGTGACGCCATCTACGCGGTTCGCCTGGGGGAGGGGAACTACGAGCAGTACTTC	CASSDAIYAVRLGEGNYEQYF	TRBV6-4	TRBJ2-7
TGTGCCAGCAGTGATCGAAGGGGGTATAGCAATCAGCCCCAGCATTTT	CASSDRRGYSNQPQHF	TRBV6-4	TRBJ1-5
TGCAGTGCTGTGTCGACAGGAGGCAATCAGCCCCAGCATTTT	CSAVSTGGNQPQHF	TRBV20-1	TRBJ1-5
TGTGCCAGCAGTGTTTTACAGGTCCAAAGTGGTAACACTGAAGCTTTCTTT	CASSVLQVQSGNTEAFF	TRBV6-4	TRBJ1-1
TGTGCCAGCCGGACCGAGACCCAGTACTTC	CASRTETQYF	TRBV11-3	TRBJ2-5
TGCGCCAGCAGCTTGCTGGGACTAGCGGTCCCCGCCAAAAACATTCAGTACTTC	CASSLLGLAVPAKNIQYF	TRBV5-1	TRBJ2-4
TGTGCCAGCAGTTATCGGAGGTTCATGAACACTGAAGCTTTCTTT	CASSYRRFMNTEAFF	TRBV6-6	TRBJ1-1
TGTGCCACCAGTGATATCGAGGGGAGCTTCATGCATGGCTACACCTTC	CATSDIEGSFMHGYTF	TRBV24-1	TRBJ1-2
TGTGCCAGCAGCCCCCCCGATGGGACAGGGTGGAGGCCGTACGAGCAGTACTTC	CASSPPDGTGWRPYEQYF	TRBV13	TRBJ2-7
TGCGCCAGCAGCCAAGAAAAGGGATCCATCCTCACCTTC	CASSQEKGSILTF	TRBV4-3	TRBJ1-2
TGTGCCAGCAGATCGCCCCTGGCTGATAACTACGAGCAGTACTTC	CASRSPLADNYEQYF	TRBV27	TRBJ2-7
TGTGCCAGCAGCTTAAATGGGACCGGAGTTGAAGCTTTCTTT	CASSLNGTGVEAFF	TRBV3-1	TRBJ1-1
TGTGCCAGCAGCCATGTCCCGACTAGGGGTCACGAGCAGTACTTC	CASSHVPTRGHEQYF	TRBV28	TRBJ2-7
TGTGCCACCAGTGATCTCCGTACAGGGAGGGCCTTAAGCTATGGCTACACCTTC	CATSDLRTGRALSYGYTF	TRBV24-1	TRBJ1-2
TGTGCCAGCAGCTTGGAATTGCCCGGGCCACGTTATAAGAAAAACATTCAGTACTTC	CASSLELPGPRYKKNIQYF	TRBV5-6	TRBJ2-4
TGTGCCAGCAGGCGGACTAGGGGGAATGATACGCAGTATTTT	CASRRTRGNDTQYF	TRBV6-4	TRBJ2-3
TGTGCGTATATTGGACAGGAAGAATCTGAAGCTTTCTTT	CAYIGQEESEAFF	TRBV30	TRBJ1-1
TGTGCCAGCAGTTATTCGCCAGAGGGATATCAGCCCCAGCATTTT	CASSYSPEGYQPQHF	TRBV27	TRBJ1-5
TGTGCCAGCAGGGCGGGTAATCCCCCGGACAGTTTCCACACTGAAGCTTTCTTT	CASRAGNPPDSFHTEAFF	TRBV5-5	TRBJ1-1
TGTGCCAGCGGAAGACAGGGCCCCTACGAGCAGTACTTC	CASGRQGPYEQYF	TRBV13	TRBJ2-7
TGTGCCAGCAGCAAACCCCCCGGGGCCGGGACGAGCTCTGGAAACACCATATATTTT	CASSKPPGAGTSSGNTIYF	TRBV7-2	TRBJ1-3
TGCAGTGCTAGAGATGAGCAAAGAGGGGCCAACGTCCTGACTTTC	CSARDEQRGANVLTF	TRBV20-1	TRBJ2-6
TGTGCCAGCAGCTTATACGCTGAGCAGTTCTTC	CASSLYAEQFF	TRBV7-9	TRBJ2-1
TGTGCCAGGCAGGGCAATCAGCCCCAGCATTTT	CARQGNQPQHF	TRBV5-5	TRBJ1-5
TGTGCCAGCAGTACAGGGCAGTATAGCAATCAGCCCCAGCATTTT	CASSTGQYSNQPQHF	TRBV27	TRBJ1-5
TGTGCCAGCAGTTACCCTTCGGGGGAAGACTATGGCTACACCTTC	CASSYPSGEDYGYTF	TRBV6-3	TRBJ1-2
TGTGCCAGCAGCGTAGCTAGACGGAGAAGGACAGATACGCAGTATTTT	CASSVARRRRTDTQYF	TRBV9	TRBJ2-3
TGCGCCAGCAGCTTGATGCCGGTAAGGACAGGGTCCCACACTGAAGCTTTCTTT	CASSLMPVRTGSHTEAFF	TRBV5-1	TRBJ1-1
TGCGCCAGCAGTGGCCCGGGACTAGCGGAGACCCAGTACTTC	CASSGPGLAETQYF	TRBV10-1	TRBJ2-5
TGCGCCAGCAGCCTCAGACTGAACACTGAAGCTTTCTTT	CASSLRLNTEAFF	TRBV4-1	TRBJ1-1
TGTGCCAGCACGCGACAGTGGGTCTATGAGCAGTTCTTC	CASTRQWVYEQFF	TRBV5-4	TRBJ2-1
TGTGCCAGCTCGAACGGGGGCGGCTATGGCTACACCTTC	CASSNGGGYGYTF	TRBV28	TRBJ1-2
TGTGCCAGCAGCCGGTGGACTAGCGGGGAAATCGAGTACTTC	CASSRWTSGEIEYF	TRBV5-5	TRBJ2-7
TGTGCCTGGAACCCAACGGACAGGGGCCCCTATGGCTACACCTTC	CAWNPTDRGPYGYTF	TRBV30	TRBJ1-2
TGTGCCAGCAGAACATCCCTTCCCGGGACTAGCGGGAGGGGTCTGTCCAATGAGCAGTTCTTC	CASRTSLPGTSGRGLSNEQFF	TRBV6-4	TRBJ2-1
TGTGCCAGCAGCGTACCCACAGGGGCAACTAATGAAAAACTGTTTTTT	CASSVPTGATNEKLFF	TRBV13	TRBJ1-4
TGTGCCAGCAGGCCCACCTCTCAGCCCCAGCATTTT	CASRPTSQPQHF	TRBV6-5	TRBJ1-5
TGCAGTGCTAGACTCAAGGGGGGATTCTGCTACGAGCAGTACTTC	CSARLKGGFCYEQYF	TRBV20-1	TRBJ2-7
TGTGCCAACCCAAGCCCCACTGAAGCTTTCTTT	CANPSPTEAFF	TRBV6-2	TRBJ1-1
TGTGCCAGCAGCGGGTGGGACAGGGTTGAGGCCCTGAACACTGAAGCTTTCTTT	CASSGWDRVEALNTEAFF	TRBV13	TRBJ1-1
TGTGCCAGCAGATTTATGAGGGCCCACACCGGGGAGCTGTTTTTT	CASRFMRAHTGELFF	TRBV12-3	TRBJ2-2
TGTGCCTGGAAGGGGAGAGGCTGCAATCAGCCCCAGCATTTT	CAWKGRGCNQPQHF	TRBV30	TRBJ1-5
TGCAGTGCAGGGCTAGCGGGGGTTGAGCAGTTCTTC	CSAGLAGVEQFF	TRBV20-1	TRBJ2-1
TGTGCCAGCAGCTCATGGGGGGGGGGACTACGAAGGGTGATAGACGAGCAGTACTTC	CASSSWGGGLRRVIDEQYF	TRBV7-7	TRBJ2-7
TGTGCCAGCAGAGGCTCCAGGCGAGGGTGGGAGACCCAGTACTTC	CASRGSRRGWETQYF	TRBV6-5	TRBJ2-5
TGTGCCACGCAAAGCCCAGGGCGATTGGCGTACTTC	CATQSPGRLAYF	TRBV6-4	TRBJ2-7
TGCGCCAGCAGCTCGTGGGAAAGCTCAGTTCCTATGTCACCCCTCCACTTT	CASSSWESSVPMSPLHF	TRBV5-1	TRBJ1-6
TGTGCCAGCAGCTTTAGAGAAACTGAAGCTTTCTTT	CASSFRETEAFF	TRBV11-2	TRBJ1-1
TGTGCCAGCAGCGAAAACCCCCGCGTAAAGGGCCCGTTATCATTGCAAGAGACCCAGTACTTC	CASSENPRVKGPLSLQETQYF	TRBV9	TRBJ2-5
TGTGCCAGAGCCCCCAGAGCCAATCAGCCCCAGCATTTT	CARAPRANQPQHF	TRBV28	TRBJ1-5
TGTGCCATCAGTGAATACCGGGACGTTGGCACAGATACGCAGTATTTT	CAISEYRDVGTDTQYF	TRBV10-3	TRBJ2-3
TGTGCCAGCCTGTATCCCCGGACACCCCCCTCTATCCCAAGAAGCCCCTATAGCAATCAGCCCCAGCATTTT	CASLYPRTPPSIPRSPYSNQPQHF	TRBV7-2	TRBJ1-5
TGTGCTAGCAGCTTCAGGGTTATCCACAGGTGGTTCTATAATCAGCCCCAGCATTTT	CASSFRVIHRWFYNQPQHF	TRBV7-7	TRBJ1-5
TGTGCCAGCAGTTTATACATGCGGGAGGACGGCGTTGGGGCCAACGTCCTGACTTTC	CASSLYMREDGVGANVLTF	TRBV27	TRBJ2-6
TGTGCCACTAGCCCCCCGGCTCACGTCGAGCAGTACTTC	CATSPPAHVEQYF	TRBV24-1	TRBJ2-7
TGCAGTGCTCACGGGGGGTGGGAGACCCAGTACTTC	CSAHGGWETQYF	TRBV20-1	TRBJ2-5
TGTGCCAGCAGCTTCCGACTCCGGACAAACGAGCAGTACTTC	CASSFRLRTNEQYF	TRBV5-5	TRBJ2-7
TGTGCCAGAAACCGGGCCGCCTGGGGCTACACCTTC	CARNRAAWGYTF	TRBV7-3	TRBJ1-2
TGTGCCAGCAGGTATAGTTATCGAGGGGAGGGTGTGGGGCACTTCGTCTCTGGAAACACCATATATTTT	CASRYSYRGEGVGHFVSGNTIYF	TRBV6-4	TRBJ1-3
TGTGCCAGCAGGAGACAGGGGCTAGGTAGTGGCTACACCTTC	CASRRQGLGSGYTF	TRBV12-3	TRBJ1-2
TGTGCCAGCGGGGGATTAACCTACAATGAGCAGTTCTTC	CASGGLTYNEQFF	TRBV27	TRBJ2-1
TGTGCCAGCAGCCAAGATATCCAGGAGGGTACAGAGGAGCAAGAGACCCAGTACTTC	CASSQDIQEGTEEQETQYF	TRBV14	TRBJ2-5
TGTGCCAGCAGCGCTAGAGGGAGAAGCACAGATACGCAGTATTTT	CASSARGRSTDTQYF	TRBV7-9	TRBJ2-3
TGCGCCAGCAGCCCTCTCCCTACCGGGACACATGATAGCAATCAGCCCCAGCATTTT	CASSPLPTGTHDSNQPQHF	TRBV4-3	TRBJ1-5
TGCGCCAGCAGTAGGGAGGGCTTGCAGCCCCAGCATTTT	CASSREGLQPQHF	TRBV10-1	TRBJ1-5
TGTGCCAGCAGTTTTCCACAGGGGGCTTCCTACGAGCAGTACTTC	CASSFPQGASYEQYF	TRBV12-3	TRBJ2-7
TGTGCCAGCACTAGCAATGAGCAGTTCTTC	CASTSNEQFF	TRBV7-9	TRBJ2-1
TGTGCCAGCAGCTTCCCTATCAATGAGCAGTTCTTC	CASSFPINEQFF	TRBV3-1	TRBJ2-1
TGCAGCGTTGATCATCCCAACAGGGGCACCAGCTCTGGAAACACCATATATTTT	CSVDHPNRGTSSGNTIYF	TRBV29-1	TRBJ1-3
TGTGCCGGGGCGGACTACCTTGAAGCTTTCTTT	CAGADYLEAFF	TRBV5-4	TRBJ1-1
TGTGCCAGCAGCAGGGGGCATTTT	CASSRGHF	TRBV6-4	TRBJ1-5
TGTGCCAGCAGCCCTGTGTCAAATTCAGGGAGTGCCAAAAACATTCAGTACTTC	CASSPVSNSGSAKNIQYF	TRBV7-9	TRBJ2-4
TGTGCCAGCAGTGCGACAGGTTCAACCCAGTACTTC	CASSATGSTQYF	TRBV6-6	TRBJ2-5
TGTGCCAGCAGCCAACAAGCGGGAAGTGATACGCAGTATTTT	CASSQQAGSDTQYF	TRBV14	TRBJ2-3
TGTGCCATCAGTGAAGTTCGGGGCTCCGACACGCAAGAGACCCAGTACTTC	CAISEVRGSDTQETQYF	TRBV10-3	TRBJ2-5
TGCGCCAGCTCGCTGAGGTGGAGCTCCTACAATGAGCAGTTCTTC	CASSLRWSSYNEQFF	TRBV5-1	TRBJ2-1
TGTGCCAGCAGCGGTAGGGGGCCCCAAGATACGCAGTATTTT	CASSGRGPQDTQYF	TRBV13	TRBJ2-3
TGTGCCTGGGTCCGCCGGGACAGCGGCGGGGAGCTGTTTTTT	CAWVRRDSGGELFF	TRBV30	TRBJ2-2
TGTGCCAGCAGTGCCAGGGTCAATGAGCAGTTCTTC	CASSARVNEQFF	TRBV2	TRBJ2-1
TGTGCCAGCAGTAAAGGGAGGGGGTACAATGAGCAGTTCTTC	CASSKGRGYNEQFF	TRBV28	TRBJ2-1
TGTGCCAGCAGGGGGGGTTTGGACTCTGAAAAACTGTTTTTT	CASRGGLDSEKLFF	TRBV27	TRBJ1-4
TGCAGTGCGGGGGGGCACCGCTACGAGCAGTACTTC	CSAGGHRYEQYF	TRBV20-1	TRBJ2-7
TGTGCCAGCAGCCGGGACAGGTTCTTT	CASSRDRFF	TRBV28	TRBJ1-1
TGCGCCAGCGGGGGACGAACAGGGTCCGCTCGGTTTTACACCTTC	CASGGRTGSARFYTF	TRBV10-1	TRBJ1-2
TGTGCCAGCAGTTACTGCCGCCCCTCTAGGACAGCTCAAGAGACCCAGTACTTC	CASSYCRPSRTAQETQYF	TRBV6-4	TRBJ2-5
TGTGCCAGCAGCACGGGGGCTGGCTACACCTTC	CASSTGAGYTF	TRBV7-2	TRBJ1-2
TGTGCCAGCAGTTTGCGGGGGGCCACCTACGAGCAGTACTTC	CASSLRGATYEQYF	TRBV12-4	TRBJ2-7
TGTGCCAGCAGGACCGGGGACACTTTCCGGGGAAACACCATATATTTT	CASRTGDTFRGNTIYF	TRBV6-5	TRBJ1-3
TGTGCCAGCATTAGCGGCAAGTCAGAGACCCAGTACTTC	CASISGKSETQYF	TRBV6-4	TRBJ2-5
TGTGCCAGCAGTGAGCCACAGTTTAATCAGCCCCAGCATTTT	CASSEPQFNQPQHF	TRBV6-4	TRBJ1-5
TGTGCCAGCAGAGAGTTTAGGATACTGACGCAAGAGACCCAGTACTTC	CASREFRILTQETQYF	TRBV27	TRBJ2-5
TGTGCCAGCAGAGACGGGGGGTATGGCTACACCTTC	CASRDGGYGYTF	TRBV7-3	TRBJ1-2
TGTGCCAGCAGCTTCGGTTTGGCTAGCGGGATTTCGGGGCAAGAGACCCAGTACTTC	CASSFGLASGISGQETQYF	TRBV5-6	TRBJ2-5
TGTGCCAGCAGCTGGGGCTACACCTTC	CASSWGYTF	TRBV5-6	TRBJ1-2
TGCGCCAGCAGCTTGGCCCGGGACAGGGAAAACACCGGGGAGCTGTTTTTT	CASSLARDRENTGELFF	TRBV5-1	TRBJ2-2
TGTGCCAGTAGTACTAGCGGGAGGGCTTGGATTTATAGCAATCAGCCCCAGCATTTT	CASSTSGRAWIYSNQPQHF	TRBV19	TRBJ1-5
TGTGCCAGCAGTTTGGGACAGAGTGCGCAGAGCTCTGGAAACACCATATATTTT	CASSLGQSAQSSGNTIYF	TRBV27	TRBJ1-3
TGTGCCTGGAGTGTAGTCCTGTATTGGAGCTATGGCTACACCTTC	CAWSVVLYWSYGYTF	TRBV30	TRBJ1-2
TGTGCCAGCAGCTTAGCACCGGGACTAGGCTACACCGGGGAGCTGTTTTTT	CASSLAPGLGYTGELFF	TRBV7-2	TRBJ2-2
TGCGCCAGCAGCCAAGATTATTTTACCGGGGAGCTGTTTTTT	CASSQDYFTGELFF	TRBV4-1	TRBJ2-2
TGTGCCAGCAGCGCAGCGGGTCAGCCCCAGCATTTT	CASSAAGQPQHF	TRBV13	TRBJ1-5
TGTGCCAGCAGCCCATGCCTTTTGCGGGTTGTAGCCCGCACAGATACGCAGTATTTT	CASSPCLLRVVARTDTQYF	TRBV13	TRBJ2-3
TGCAGCGTTGGGGACGAGATAAATGAGCAGTTCTTC	CSVGDEINEQFF	TRBV29-1	TRBJ2-1
TGTGCCAGCAGCGCTCGACAGGGGAACACTGAAGCTTTCTTT	CASSARQGNTEAFF	TRBV11-3	TRBJ1-1
TGTGCCAGCAGCCAAGATAAGGGACAGGGGTGCAATGAGCAGTTCTTC	CASSQDKGQGCNEQFF	TRBV4-2	TRBJ2-1
TGCAGTGCTGAACGTCTCGGGAACCTCTACGAGCAGTACTTC	CSAERLGNLYEQYF	TRBV20-1	TRBJ2-7
TGCAAAAGATGGGGGCTCGAGGACAGCCATCAGCCCCAGCATTTT	CKRWGLEDSHQPQHF	TRBV20-1	TRBJ1-5
TGCAGTGCTACCCCCCAGCGGGACAGTGGCACTGAAGCTTTCTTT	CSATPQRDSGTEAFF	TRBV20-1	TRBJ1-1
TGTGCCAGCAGTGTGTTCCCGGGGGGCAGAGCTTTCTTT	CASSVFPGGRAFF	TRBV28	TRBJ1-1
TGCGCCAGCAGCCAAGATTGGGGGGGTGGGCTGACCCAGTACTTC	CASSQDWGGGLTQYF	TRBV4-3	TRBJ2-5
TGCGCCAGCAGTGAGCCAAGGCGGAGGACCGGGGAGCTGTTTTTT	CASSEPRRRTGELFF	TRBV10-1	TRBJ2-2
TGTGCCAGCAGCTTACCGAGACGGCCGGCCTACGAGCAGTACTTC	CASSLPRRPAYEQYF	TRBV7-3	TRBJ2-7
TGCGCCAGCAGCGGCCCAGATAGCTCCTATAATTCACCCCTCCACTTT	CASSGPDSSYNSPLHF	TRBV5-1	TRBJ1-6
TGTGCCAGCAGCTTATCCCGGGGGCCCCATGGCTACACCTTC	CASSLSRGPHGYTF	TRBV7-9	TRBJ1-2
TGCAGTGCTAAGTCAGGGATTTTAGTTGCTTCAGATACGCAGTATTTT	CSAKSGILVASDTQYF	TRBV20-1	TRBJ2-3
TGTGCCAGCAGGCAACTAATTGAGACCCAGTACTTC	CASRQLIETQYF	TRBV11-2	TRBJ2-5
TGTGCCAGCAGCTTAGCTAAGGTCTTGGTTTACTTTTCTCCTAGCACAGATACGCAGTATTTT	CASSLAKVLVYFSPSTDTQYF	TRBV11-3	TRBJ2-3
TGTGCCAGCAGCCTCGCGGCCAGCGACCAGGCTTACCACTTC	CASSLAASDQAYHF	TRBV7-9	TRBJ2-7
TGTGCTAGTGCCGGGGGGGGTTTAAACACTGAAGCTTTCTTT	CASAGGGLNTEAFF	TRBV12-5	TRBJ1-1
TGTGCCAGCAGTTACCGAGAAGTTGAGACCCAGTACTTC	CASSYREVETQYF	TRBV6-5	TRBJ2-5
TGTGCCAGCAGGCATCAAAAGGGTAGGGAGGGGAAACACGAGCAGTACTTC	CASRHQKGREGKHEQYF	TRBV7-2	TRBJ2-7
TGTGCCAGCAATGAGGAGGAGGAGATCGAGACCCAGTACTTC	CASNEEEEIETQYF	TRBV6-1	TRBJ2-5
TGTGCCAGTAGTATCAGAGTTCCCGGACAGAAGACCTACGAGCAGTACTTC	CASSIRVPGQKTYEQYF	TRBV19	TRBJ2-7
TGTGCCAGCAGTGCCCGCCTCGAGCAGTACTTC	CASSARLEQYF	TRBV6-1	TRBJ2-7
TGTGCCAGCAGTAGACTAGCGGGTTTGCAGTTCTTC	CASSRLAGLQFF	TRBV27	TRBJ2-1
TGTGCCAGCAGCTTGACCGGGACAGGGGGAGCGCAAGCTTTCTTT	CASSLTGTGGAQAFF	TRBV5-6	TRBJ1-1
TGTGCCAGCAGCTTACACGCTAGCGGGGATAACTGCTCCTACGAGCAGTACTTC	CASSLHASGDNCSYEQYF	TRBV7-2	TRBJ2-7
TGTGTAGACCTTGACAGGGGGCCACATAATTCACCCCTCCACTTT	CVDLDRGPHNSPLHF	TRBV25-1	TRBJ1-6
TGTGCCAGCAGTTTGAAGGGGAGAACCAAGGGGGTTTCCCGTGACGCTTTCTTT	CASSLKGRTKGVSRDAFF	TRBV27	TRBJ1-1
TGTGCCAGCAGCTTAGCCAACCGGGACAGGGATCAGCCCCAGCATTTT	CASSLANRDRDQPQHF	TRBV11-3	TRBJ1-5
TGTGCCAGCAGTGTGCGGGACTATTCAGAGACCCAGTACTTC	CASSVRDYSETQYF	TRBV25-1	TRBJ2-5
TGCGCCACGGTCCCCGGCCCCCAGCAAGAGACCCAGTACTTC	CATVPGPQQETQYF	TRBV4-3	TRBJ2-5
TGTGCCAGCAGCGGTCCAGGGGGGAAACATCAGCCCCAGCATTTT	CASSGPGGKHQPQHF	TRBV5-8	TRBJ1-5
TGTGCCAGCAGCCGGGACGAGCAGTTCTTC	CASSRDEQFF	TRBV13	TRBJ2-1
TGCGCCAGCAGCCGGCCTGGGGATTGCTCTGGAAACACCATATATTTT	CASSRPGDCSGNTIYF	TRBV4-1	TRBJ1-3
TGCGCCAGCTGGACAGGGAACACTGAAGCTTTCTTT	CASWTGNTEAFF	TRBV10-2	TRBJ1-1
TGTGCCAGCAGCCCCCCGGGGGGAGATAACACTGAAGCTTTCTTT	CASSPPGGDNTEAFF	TRBV7-6	TRBJ1-1
TGTGCCAGCAGCTTAGCGGATGGGGAGGGGGACTTTAATGAGCAGTTCTTC	CASSLADGEGDFNEQFF	TRBV7-4	TRBJ2-1
TGCGCCAGCACGAAAGGGGGGGCGGGGCCCCAGCATTTT	CASTKGGAGPQHF	TRBV10-1	TRBJ1-5
TGTGCCTGGAGTAGGGCCCCCCAAGGAATAGGAGCCTTTAGATATGGCTACACCTTC	CAWSRAPQGIGAFRYGYTF	TRBV30	TRBJ1-2
TGTGCCAGTAACGGGAACAGGGCACCTGAAGCTTTCTTT	CASNGNRAPEAFF	TRBV2	TRBJ1-1
TGTGCCAGCAGCGATATAGCGAACGATACGCAGTATTTT	CASSDIANDTQYF	TRBV7-3	TRBJ2-3
TGTGCCAGCAGCTTTTCCGCTTGCAGCAATCAGCCCCAGCATTTT	CASSFSACSNQPQHF	TRBV11-2	TRBJ1-5
TGTGCCAGCAGCTTACCGGCGGACAACTATCAGCCCCAGCATTTT	CASSLPADNYQPQHF	TRBV7-9	TRBJ1-5
TGCAGCGAAGGGTGGGGGGCCGGCTATAATTCACCCCTCCACTTT	CSEGWGAGYNSPLHF	TRBV29-1	TRBJ1-6
TGTGCCAGCAGCCATCGGTTAGGAGAAGCTTTCTTT	CASSHRLGEAFF	TRBV14	TRBJ1-1
TGCGCCAGCTGTCAGCTTCACACTGAAGCTTTCTTT	CASCQLHTEAFF	TRBV4-3	TRBJ1-1
TGTGCCAAGATCACAAGGGCCCACGAGAACACTGAAGCTTTCTTT	CAKITRAHENTEAFF	TRBV10-3	TRBJ1-1
TGTGCCAGTAGTATTGTAGGGGCTGGGACTGAAGCTTTCTTT	CASSIVGAGTEAFF	TRBV19	TRBJ1-1
TGTGCCAGCAGAATCCGGCATGATGCTGAAGCTTTCTTT	CASRIRHDAEAFF	TRBV27	TRBJ1-1
TGTGCCAGCAGCTTACTAGGTGGCTACAATGAGCAGTTCTTC	CASSLLGGYNEQFF	TRBV7-3	TRBJ2-1
TGTGCCAGCAGCTTAATCCAGGGTTCAGCCTATAATTCACCCCTCCACTTT	CASSLIQGSAYNSPLHF	TRBV7-3	TRBJ1-6
TGTGCCAGCAGTGCCCCGGGGGGCCGGCCACGGCGCTCCTACGAGCAGTACTTC	CASSAPGGRPRRSYEQYF	TRBV2	TRBJ2-7
TGTGCCAGCAGGGCACCGGGAGGGTATGGCTACACCTTC	CASRAPGGYGYTF	TRBV6-5	TRBJ1-2
TGCGCCAGCATCCGGACTAGCGGGAGGGAGCAGTACTTC	CASIRTSGREQYF	TRBV5-1	TRBJ2-7
TGTGCCAGCAGTTACTCCGTTGGGGGGGTCCTAGATCGAAATGAGCAGTTCTTC	CASSYSVGGVLDRNEQFF	TRBV6-6	TRBJ2-1
TGCAGTGCTAGAGATTGCGTCGGGGGATGGGAGGAGGCCTCCTACGAGCAGTACTTC	CSARDCVGGWEEASYEQYF	TRBV20-1	TRBJ2-7
TGTGCCAGCGTATCGAACACCGGGGAGCTGTTTTTT	CASVSNTGELFF	TRBV28	TRBJ2-2
TGTGCCAGCAGCTTATACGAGATAACCGACAATGAGCAGTTCTTC	CASSLYEITDNEQFF	TRBV7-3	TRBJ2-1
TGTGCCAGCAGTGCGCCCGCGGCTCATGGGAACACTGAAGCTTTCTTT	CASSAPAAHGNTEAFF	TRBV3-1	TRBJ1-1
TGTGCCACCAGTGATTCTATAACGGTGCTAAATGAGCAGTTCTTC	CATSDSITVLNEQFF	TRBV24-1	TRBJ2-1
TGCGCCAGCCAGTTAGAAAAACTGTTTTTT	CASQLEKLFF	TRBV5-1	TRBJ1-4
TGTGCCAGCAGCCAAGTGGGGCGCGAGCAGTACTTC	CASSQVGREQYF	TRBV14	TRBJ2-7
TGTGCCAGCAGCCAAGCTTTGACAAATGAGTACTATGGCTACACCTTC	CASSQALTNEYYGYTF	TRBV3-1	TRBJ1-2
TGTGCCAGCCTGACGGGGGTGTTGCCGTCCTACAATGAGCAGTTCTTC	CASLTGVLPSYNEQFF	TRBV9	TRBJ2-1
TGCGCCAGCAGCTTGCGCGGGAGGAACAATGAGCAGTTCTTC	CASSLRGRNNEQFF	TRBV5-1	TRBJ2-1
TGTGCCAGCAGGCGGGGACGGAACAATGAGCAGTTCTTC	CASRRGRNNEQFF	TRBV6-4	TRBJ2-1
TGCAGCGTTGAAGATCCGAAGGGGTGTAGGGTTGAGACCCAGTACTTC	CSVEDPKGCRVETQYF	TRBV29-1	TRBJ2-5
TGTGCCAGCAGGATACTAGCCAAAAACATTCAGTACTTC	CASRILAKNIQYF	TRBV7-2	TRBJ2-4
TGCGCCAGCAGAGTCGAAGAAGCCGAGCAGTTCTTC	CASRVEEAEQFF	TRBV10-1	TRBJ2-1
TGTGCTAATTGGGGGGGCAACCCAAACAATGAGCAGTTCTTC	CANWGGNPNNEQFF	TRBV7-7	TRBJ2-1
TGCGCCAGCCAAGAGGGCGCCACTGAAGCTTTCTTT	CASQEGATEAFF	TRBV10-1	TRBJ1-1
TGTGCCAGCAGGGCGGATTCGTCGGGGGGGGGGGTGGTCAAAGGGGAAGAGACCCAGTACTTC	CASRADSSGGGVVKGEETQYF	TRBV6-4	TRBJ2-5
TGCAGCGTTGAACCCAGACGGGGGGACGGGGGGGAGCTGTTTTTT	CSVEPRRGDGGELFF	TRBV29-1	TRBJ2-2
TGTGCCAGCAGCGGGTGCAACACTAGCGGGGGCCAAGAGACCCAGTACTTC	CASSGCNTSGGQETQYF	TRBV7-9	TRBJ2-5
TGTGCCAGCAGTGGCCTAGCGGGCTGTAACACCGGGGAGCTGTTTTTT	CASSGLAGCNTGELFF	TRBV25-1	TRBJ2-2
TGTGCCAGCAGCACAGGGTGGTACGAGCAGTACTTC	CASSTGWYEQYF	TRBV9	TRBJ2-7
TGTGCCAGCAGCCGGATCGGGGGGAACCCATACCAAGAGACCCAGTACTTC	CASSRIGGNPYQETQYF	TRBV7-9	TRBJ2-5
TGTGCCAGCAGTTGGAGGACTAGTGGGGAGAACTACTACGAGCAGTACTTC	CASSWRTSGENYYEQYF	TRBV6-6	TRBJ2-7
TGTGCCAGCAGCTTAGTTACGGCGTTGAGGGGGCTTTCGAGCAATCAGCCCCAGCATTTT	CASSLVTALRGLSSNQPQHF	TRBV7-6	TRBJ1-5
TGTGCCAGCAGCTGCCGCGTCGAGGGACAGGGGGATGGCTACACCTTC	CASSCRVEGQGDGYTF	TRBV7-6	TRBJ1-2
TGTGCCAGCAGCTTAGGCGCACAGGGTGAAAGGGGGGGGACCCAGTACTTC	CASSLGAQGERGGTQYF	TRBV11-2	TRBJ2-5
TGTGCCAGCAACCCGCGGACAGGGGTCCAACCCCCGGTATCCAACACTGAAGCTTTCTTT	CASNPRTGVQPPVSNTEAFF	TRBV7-9	TRBJ1-1
TGTGCCAGCAGAGGGGGTGACGAGCAGTACTTC	CASRGGDEQYF	TRBV6-2	TRBJ2-7
TGTGCCAGCAGGGATTGGCCGGGACTAGCGGGGGGGCTATCCCCGCTCGGGGAGCTGTTTTTT	CASRDWPGLAGGLSPLGELFF	TRBV6-3	TRBJ2-2
TGTGCCCCAGGACGTTACGAGCAGTACTTC	CAPGRYEQYF	TRBV7-9	TRBJ2-7
TGTGCCACCAGTGATTCCGGTCTTGGACTAGCGTGGAATGAGCAGTTCTTC	CATSDSGLGLAWNEQFF	TRBV24-1	TRBJ2-1
TGCGCCAGCAGCTTGGCCCCAACCGGGTCCCTTTCAACCGAGCAGTACTTC	CASSLAPTGSLSTEQYF	TRBV5-1	TRBJ2-7
TGTGCCACCAGTGATTTCGTTAAGGGGATCCTAACAGATACGCAGTATTTT	CATSDFVKGILTDTQYF	TRBV24-1	TRBJ2-3
TGTGCCAGTAGTATAAGGGAGGAAGGTCACACTGAAGCTTTCTTT	CASSIREEGHTEAFF	TRBV19	TRBJ1-1
TGTGCCAGCAGCTTGGGACAGGGGGCGATTACATATAATTCACCCCTCCACTTT	CASSLGQGAITYNSPLHF	TRBV7-2	TRBJ1-6
TGCGCCAGCAGCCCCCTCGTAAACTATGGCTACACCTTC	CASSPLVNYGYTF	TRBV5-1	TRBJ1-2
TGTGCCTGGAGTGACCTACCGGGACAGGGGAACGAGCAGTACTTC	CAWSDLPGQGNEQYF	TRBV30	TRBJ2-7
TGTGCCACCAGTTACGTGTACAGGGGAACCAATCAGCCCCAGCATTTT	CATSYVYRGTNQPQHF	TRBV24-1	TRBJ1-5
TGTGCCACCAGGCGGACGGCGGGGACAGGGGGGTTCGACTATGGCTACACCTTC	CATRRTAGTGGFDYGYTF	TRBV24-1	TRBJ1-2
TGCAGTGCTAGAGATAGTCTCGGACAGGGGTCGAACACTGAAGCTTTCTTT	CSARDSLGQGSNTEAFF	TRBV20-1	TRBJ1-1
TGTGCCAGCAGTCGGGACTCCCGGGCGGGCACAGATACGCAGTATTTT	CASSRDSRAGTDTQYF	TRBV7-3	TRBJ2-3
TGTGCCAGCAGCCATCGACCCGGCTACGAGCAGTACTTC	CASSHRPGYEQYF	TRBV14	TRBJ2-7
TGTGCCAGCAGCAGACAGGGCCCCGCCACAAACGAGCAGTACTTC	CASSRQGPATNEQYF	TRBV7-4	TRBJ2-7
TGCAGTGCGTTAGTAGGGAACGGCAGGAGCTCCTACGAGCAGTACTTC	CSALVGNGRSSYEQYF	TRBV20-1	TRBJ2-7
TGTGCCAGCAGCTGGGGGGTCAGGGTACCCTACGAGCAGTACTTC	CASSWGVRVPYEQYF	TRBV27	TRBJ2-7
TGTGCCAGCAGCCGGGACGCCTCCGATACGCAGTATTTT	CASSRDASDTQYF	TRBV14	TRBJ2-3
TGTGCCAGCAGCTTAGAGTCGGGGGGGGTCCTCTACGAGCAGTACTTC	CASSLESGGVLYEQYF	TRBV7-2	TRBJ2-7
TGTGCCAGCAGTGACACCGGGTCTGGGGGGAACACTGAAGCTTTCTTT	CASSDTGSGGNTEAFF	TRBV2	TRBJ1-1
TGTGCCAGCAGCCCTCGGGACAGCTATGGCTACACCTTC	CASSPRDSYGYTF	TRBV5-6	TRBJ1-2
TGTGCCAGTAGTATAGGGATCCAACCCCGGGACAGGGGTCAGCCCCAGCATTTT	CASSIGIQPRDRGQPQHF	TRBV19	TRBJ1-5
TGCGCCAGCAGCTCCCGACAGGGTAAAAGCACAGATACGCAGTATTTT	CASSSRQGKSTDTQYF	TRBV5-1	TRBJ2-3
TGTGCCACCAACAGCATGGGACAGTGTGGACAAGAGACCCAGTACTTC	CATNSMGQCGQETQYF	TRBV24-1	TRBJ2-5
TGTGGCCCCGGCGACGGGAGCTCCTACGAGCAGTACTTC	CGPGDGSSYEQYF	TRBV24-1	TRBJ2-7
TGTGCCAGCACCGGGACAGGGGGCACCTTTAATCAGCCCCAGCATTTT	CASTGTGGTFNQPQHF	TRBV3-1	TRBJ1-5
TGTGCCAGCAGCAAGGTTGACAGACAGGTGGCCCAGCATTTT	CASSKVDRQVAQHF	TRBV11-2	TRBJ1-5
TGTGCCAGCAGCCAAGATGGTGACAGGGGGCAGTCCTTCTACGAGCAGTACTTC	CASSQDGDRGQSFYEQYF	TRBV14	TRBJ2-7
TGTGCCAGCAGCGTACTTTTTGGGGTCCATATGAAACCCTCCTACGAGCAGTACTTC	CASSVLFGVHMKPSYEQYF	TRBV9	TRBJ2-7
TGTGCCAGCAAAGATGGACCCACAACTAATGAAAAACTGTTTTTT	CASKDGPTTNEKLFF	TRBV6-4	TRBJ1-4
TGTGCCAGCAGCTTAGCGAATTTTATCAGGGGCTCCTACGAGCAGTACTTC	CASSLANFIRGSYEQYF	TRBV7-9	TRBJ2-7
TGCGCCAGGGTCCTAAGAGGGACGTCCTACGAGCAGTACTTC	CARVLRGTSYEQYF	TRBV5-1	TRBJ2-7
TGTGCCAGCAGCTTAAACATTCAACGGACAGGGGGTTATAGCAATCAGCCCCAGCATTTT	CASSLNIQRTGGYSNQPQHF	TRBV7-3	TRBJ1-5
TGTGCCAGCAGTTCTACTCAGGATAGCAATCAGCCCCAGCATTTT	CASSSTQDSNQPQHF	TRBV7-3	TRBJ1-5
TGTGCCAGCAGTTGGACGAGGCGTCCGAACACTGAAGCTTTCTTT	CASSWTRRPNTEAFF	TRBV27	TRBJ1-1
TGTGCCACCAGCAGGGGAGTGAAGGATGGCTACACCTTC	CATSRGVKDGYTF	TRBV15	TRBJ1-2
TGTGCCAGCAGCCGGAATTTCGGTAGGGGGGGGGCCCCTTTCGAGCAGTACTTC	CASSRNFGRGGAPFEQYF	TRBV5-8	TRBJ2-7
TGTGCCACCAGTGTTTTGGGGATCCTCGGTAACTATGGCTACACCTTC	CATSVLGILGNYGYTF	TRBV24-1	TRBJ1-2
TGCGCCAGGACGGGACACGAGGTTTACAATGAGCAGTTCTTC	CARTGHEVYNEQFF	TRBV10-1	TRBJ2-1
TGTGCCAGCAGCACAACCCAGGGGGGGGGAGGGAGCACAGATACGCAGTATTTT	CASSTTQGGGGSTDTQYF	TRBV11-2	TRBJ2-3
TGCGCCAGCAGCCGACAGGGGAGAGAGACCCAGTACTTC	CASSRQGRETQYF	TRBV4-3	TRBJ2-5
TGTGCCATCAAAGACCAGGGCAATCTTAACTATGGCTACACCTTC	CAIKDQGNLNYGYTF	TRBV19	TRBJ1-2
TGTGCCAGCAGCCCTAGAACGGACTATGCCTATAATTCACCCCTCCACTTT	CASSPRTDYAYNSPLHF	TRBV9	TRBJ1-6
TGTGCCAGCACACCCAGAATCTCCTATAATTCACCCCTCCACTTT	CASTPRISYNSPLHF	TRBV6-5	TRBJ1-6
TGTGCCAGCAGCCGCCCGGGTTACGAGCAGTACTTC	CASSRPGYEQYF	TRBV13	TRBJ2-7
TGCGCCAGCAGCTTCCACCCCCAGGGGGACAGGGGATTGGGTAATCAGCCCCAGCATTTT	CASSFHPQGDRGLGNQPQHF	TRBV5-1	TRBJ1-5
TGTGCCAGCAGCTGTGCTACGGACCAGGGCAGCAATCAGCCCCAGCATTTT	CASSCATDQGSNQPQHF	TRBV7-9	TRBJ1-5
TGTGCCAGCAGTGCGGGACGACAGACTGCGACGATCTACGAGCAGTACTTC	CASSAGRQTATIYEQYF	TRBV2	TRBJ2-7
TGTGCCAGCAGCTGGGACAGGGGCTCGGAGGGAGAGACCCAGTACTTC	CASSWDRGSEGETQYF	TRBV13	TRBJ2-5
TGCGCCAGCAGCGGCCCCTCTAACGGTTGCCGGTGGTGCCTAGAGACCCAGTACTTC	CASSGPSNGCRWCLETQYF	TRBV5-1	TRBJ2-5
TGTGCCAGCAGCTTAGCTCTAGCGGGTTATGAGCAGTTCTTC	CASSLALAGYEQFF	TRBV7-9	TRBJ2-1
TGTGCCAGCAGCGGACAGGTCAACACAGATACGCAGTATTTT	CASSGQVNTDTQYF	TRBV5-6	TRBJ2-3
TGTGCCAGCAGCTTAGTTCTCCCCAGGGGGTATACGCAGTATTTT	CASSLVLPRGYTQYF	TRBV7-9	TRBJ2-3
TGTGCCAGCAGCTTCCAAGGACGACTAGCGGGTCCCGGGGAGCTGTTTTTT	CASSFQGRLAGPGELFF	TRBV5-6	TRBJ2-2
TGTGCCAGCAGGGCGGGGTCCACAGATACGCAGTATTTT	CASRAGSTDTQYF	TRBV6-2	TRBJ2-3
TGTGCCAGCAGCCGTGGGCCGGTCACAGATACGCAGTATTTT	CASSRGPVTDTQYF	TRBV11-3	TRBJ2-3
TGTGCCAGCAGTGACACCTTAAGTCGGCGGGACAAGGGAGGGGACGAGCAGTACTTC	CASSDTLSRRDKGGDEQYF	TRBV6-1	TRBJ2-7
TGTTTTGACAGGGGTGAGGAGTACACCTTC	CFDRGEEYTF	TRBV11-2	TRBJ1-2
TGTGCCAGCAGGCGGGGGGGGCGCTTCAATCAGCCCCAGCATTTT	CASRRGGRFNQPQHF	TRBV6-1	TRBJ1-5
TGTGCCAGCAGCTGCCGGGGGACCCAGTACTTC	CASSCRGTQYF	TRBV13	TRBJ2-5
TGTGCCAGCAGCCAGGGGGACAGGGTGGCTGAAGCTTTCTTT	CASSQGDRVAEAFF	TRBV14	TRBJ1-1
TGTGCCACCAGTGATAAATATCGGACATACGAGCAGTACTTC	CATSDKYRTYEQYF	TRBV24-1	TRBJ2-7
TGTGCCAGCAGTTACTCGATTCTAGCGGGCGTTGCCCCCGGGGAGCTGTTTTTT	CASSYSILAGVAPGELFF	TRBV6-5	TRBJ2-2
TGCAACCTAAGGGGGCATTCACCCCTCCACTTT	CNLRGHSPLHF	TRBV20-1	TRBJ1-6
TGTGCCAGCAGCCGGGATGGACAGGGGATGAACACTGAAGCTTTCTTT	CASSRDGQGMNTEAFF	TRBV14	TRBJ1-1
TGTGCCAGCAGTTTAGCTCGCCGGAGCTACGAGCAGTACTTC	CASSLARRSYEQYF	TRBV12-3	TRBJ2-7
TGTGCCAGCAGCCTCTTCAGCTCGGGAAGCTCCTACGAGCAGTACTTC	CASSLFSSGSSYEQYF	TRBV13	TRBJ2-7
TGTGCCAGCAGTCGACAGGGGACTTCAGGGGATCAGCCCCAGCATTTT	CASSRQGTSGDQPQHF	TRBV12-4	TRBJ1-5
TGCGCCAGCAGCCTTTGCGGGAGGACTGTACGGACAGATACGCAGTATTTT	CASSLCGRTVRTDTQYF	TRBV4-3	TRBJ2-3
TGTGCCAGCTCACCGCGGGGACCAGGTCAGCCCCAGCATTTT	CASSPRGPGQPQHF	TRBV18	TRBJ1-5
TGTGCCAGCAGTTTAGAGTATAGTAAACGGCGGGTTCACGAGCAGTACTTC	CASSLEYSKRRVHEQYF	TRBV27	TRBJ2-7
TGTGCCAGCTCACCACGGGCCGACCTTAGCTCCTACAATGAGCAGTTCTTC	CASSPRADLSSYNEQFF	TRBV18	TRBJ2-1
TGCAGTGCTAGAGATGGGTCTGCCAGACAGGCCGGCAACGAGCAGTACTTC	CSARDGSARQAGNEQYF	TRBV20-1	TRBJ2-7
TGCAGTGCTAGACGAGGGGAGGTTTACACTGAAGCTTTCTTT	CSARRGEVYTEAFF	TRBV20-1	TRBJ1-1
TGTGCCAGCCCCGACAGGGGTGGCTTTTTCCTACAAGAGACCCAGTACTTC	CASPDRGGFFLQETQYF	TRBV28	TRBJ2-5
TGCGCCAGCAGTGAGCGGGAGAGAACATACTATGGCTACACCTTC	CASSERERTYYGYTF	TRBV10-1	TRBJ1-2
TGTGCCAGCAGTTCCAGACAGGGGGCGATGAACTTC	CASSSRQGAMNF	TRBV27	TRBJ2-7
TGTGCCAGCAGAACCCATGACAGAATGGGCAATCAGCCCCAGCATTTT	CASRTHDRMGNQPQHF	TRBV7-9	TRBJ1-5
TGTGCCAGCAGCTTAGGCCTAGGGGGGGGTGTCACTGAAGCTTTCTTT	CASSLGLGGGVTEAFF	TRBV11-2	TRBJ1-1
TGTGCCAGCAGCTGGGGACAGATAAGCCCCGACCCCTACCAAGAGACCCAGTACTTC	CASSWGQISPDPYQETQYF	TRBV7-6	TRBJ2-5
TGTGCCAGCAGCTTAGATACCGGGACAGGGGCCGTCCGCGAGCAGTACTTC	CASSLDTGTGAVREQYF	TRBV7-8	TRBJ2-7
TGTGCCAGGTCTGGACAGGGGTCGGTCAGCAATCAGCCCCAGCATTTT	CARSGQGSVSNQPQHF	TRBV2	TRBJ1-5
TGCAACCGCCTGGGGCCCTACGAGCAGTACTTC	CNRLGPYEQYF	TRBV20-1	TRBJ2-7
TGTGCCAGCACGGGAAGAACCCCGGAAGGTGTCTACGAGCAGTACTTC	CASTGRTPEGVYEQYF	TRBV6-1	TRBJ2-7
TGTGCCAGCAGCCAGAATAATCAGCCCCAGCATTTT	CASSQNNQPQHF	TRBV5-8	TRBJ1-5
TGTGCCAGCAGCCAGGGGCGCGCAGGCTACACCTTC	CASSQGRAGYTF	TRBV11-2	TRBJ1-2
TGTGCCAGCAGTTACCCCCGACAGGGTCCGATCGCCGAAAAACTGTTTTTT	CASSYPRQGPIAEKLFF	TRBV6-3	TRBJ1-4
TGTGCCAGCAGAGAGGTTGGGATCTACGAGCAGTACTTC	CASREVGIYEQYF	TRBV6-1	TRBJ2-7
TGTGCCAGCAGGGACAGCTCCTATAATTCACCCCTCCACTTT	CASRDSSYNSPLHF	TRBV6-4	TRBJ1-6
TGTGCCAGCGGACTCGGGGTCGCCAATGGGGCCAACGTCCTGACTTTC	CASGLGVANGANVLTF	TRBV6-1	TRBJ2-6
TGTGCCAGCAGCGTAGTTGGCAGGGTCAGGCAAGAGACCCAGTACTTC	CASSVVGRVRQETQYF	TRBV9	TRBJ2-5
TGTGCCAGGGGGGGCGTTCGGGGCTATGGCTACACCTTC	CARGGVRGYGYTF	TRBV13	TRBJ1-2
TGTGCCAGCAGCCGGGTGGGACAGGAATACCTGAGGGAAAAACTGTTTTTT	CASSRVGQEYLREKLFF	TRBV9	TRBJ1-4
TGTGCCACCAGTGACCAGAAGCAGGCAGACAGGGGGGACAATGAGCAGTTCTTC	CATSDQKQADRGDNEQFF	TRBV24-1	TRBJ2-1
TGTGCCAGCAGCTGCCCTCCCCTGAACAGGGAAGAGGGCAATCAGCCCCAGCATTTT	CASSCPPLNREEGNQPQHF	TRBV7-3	TRBJ1-5
TGTGCCAGCACCCCTTTATCACAGTTAGTGAGCAATCAGCCCCAGCATTTT	CASTPLSQLVSNQPQHF	TRBV28	TRBJ1-5
TGTGCCAGCAGCCCAACGGACAGATCTTACAATGAGCAGTTCTTC	CASSPTDRSYNEQFF	TRBV13	TRBJ2-1
TGCGCCAGCAGCTACCGGACTAGCGGGTCTCTCGGGAAACATGAGCAGTTCTTC	CASSYRTSGSLGKHEQFF	TRBV4-3	TRBJ2-1
TGTGCCAGCAGTGTTGTGAGGGGTCAGCCCCAGCATTTT	CASSVVRGQPQHF	TRBV25-1	TRBJ1-5
TGCACACCGGGACTTGTCGCCGGGGAGCTGTTTTTT	CTPGLVAGELFF	TRBV20-1	TRBJ2-2
TGTGCATGGGGAGCGGGAAAGAGCTCCTACGAGCAGTACTTC	CAWGAGKSSYEQYF	TRBV6-4	TRBJ2-7
TGTGCCAGCAGCACCCCAAAGAGGGACCGACCCAACACAGATACGCAGTATTTT	CASSTPKRDRPNTDTQYF	TRBV6-5	TRBJ2-3
TGCAGCGTTGCTTTTGACACGAGGCAGCCCCAGCATTTT	CSVAFDTRQPQHF	TRBV29-1	TRBJ1-5
TGTGCCAGCAGTCCAGTTCCATCACTTGGGTGGCCAGAAGGACTAGCGGGTTGCAATGAGCAGTTCTTC	CASSPVPSLGWPEGLAGCNEQFF	TRBV6-4	TRBJ2-1
TGCGCCAGCAGTGATGAAGCGAGGAAGGACTTCAATGAGCAGTTCTTC	CASSDEARKDFNEQFF	TRBV10-1	TRBJ2-1
TGTGCCAGCAGCCCATTTGCAAGTGGGGCTCCCTACGAGCAGTACTTC	CASSPFASGAPYEQYF	TRBV7-8	TRBJ2-7
TGTGCCAGCAGTGATGGGGGCGGGGGGGACAACACTGAAGCTTTCTTT	CASSDGGGGDNTEAFF	TRBV25-1	TRBJ1-1
TGTGCCAGCAGTTCTGGACTAGATACGCAGTATTTT	CASSSGLDTQYF	TRBV5-5	TRBJ2-3
TGCGCCAGCAGTGGGGCGAGCAACTATGGCTACACCTTC	CASSGASNYGYTF	TRBV10-1	TRBJ1-2
TGTGCCACCAGACTTGCAGGGGGACAGAGCAATCAGCCCCAGCATTTT	CATRLAGGQSNQPQHF	TRBV24-1	TRBJ1-5
TGTGCCAGCAGAACCGGGACTAGCGGGAGGGGGATGAACACTGAAGCTTTCTTT	CASRTGTSGRGMNTEAFF	TRBV6-4	TRBJ1-1
TGTGCCAGCAGTACCCCCAGGGGGAGCACAGATACGCAGTATTTT	CASSTPRGSTDTQYF	TRBV27	TRBJ2-3
TGTGCCAGCAGCATGGAACACCCCCTCCGGGTCAGAAACTCTGGAAACACCATATATTTT	CASSMEHPLRVRNSGNTIYF	TRBV7-3	TRBJ1-3
TGTGCCAGCAGCCAAGTGGTTTTACAGGGAAGATCCTACGAGCAGTACTTC	CASSQVVLQGRSYEQYF	TRBV4-2	TRBJ2-7
TGTGCCAGCTATGACAGGCTTGATGAAAAACTGTTTTTT	CASYDRLDEKLFF	TRBV27	TRBJ1-4
TGTGCCAGCAGCATCGGGGCGGTTAACATTCAGTACTTC	CASSIGAVNIQYF	TRBV7-3	TRBJ2-4
TGCGCCAGCAGCTCACGACCCGGGGGACGGAGCACAGATACGCAGTATTTT	CASSSRPGGRSTDTQYF	TRBV5-1	TRBJ2-3
TGTGCCACCAGCAGCCTAGCGTGTCGAGGCAATCAGCCCCAGCATTTT	CATSSLACRGNQPQHF	TRBV15	TRBJ1-5
TGTGCCAGTAGTTCGGGTACTAGGGGGGACACCGGGGAGCTGTTTTTT	CASSSGTRGDTGELFF	TRBV19	TRBJ2-2
TGTGCCAGCAGCTTTGCGCCCCCAGGGGTAAGAGAGACCCAGTACTTC	CASSFAPPGVRETQYF	TRBV11-2	TRBJ2-5
TGCAGCGTTGCGGTTCGTACCCAGTACTTC	CSVAVRTQYF	TRBV29-1	TRBJ2-5
TGTGCCAGCAGTTTGGACCGGGACATGTCCTACCAACAGGGAATGAGCATGAACACTGAAGCTTTCTTT	CASSLDRDMSYQQGMSMNTEAFF	TRBV12-4	TRBJ1-1
TGCAGTGCCCCATCTTGCGGGAATTTTTTGTTGAATTCACCCCTCCACTTT	CSAPSCGNFLLNSPLHF	TRBV20-1	TRBJ1-6
TGTGCCAGCAGCTCACCCCCAGATGAAGGACAGATTAACTACGAGCAGTACTTC	CASSSPPDEGQINYEQYF	TRBV7-3	TRBJ2-7
TGTGCCAGCAGTTACGACAGGGTAGAGGCCAACATTCAGTACTTC	CASSYDRVEANIQYF	TRBV6-5	TRBJ2-4
TGCAGTGCTAGTCAGACAGGGGGCCACACCGGGGAGCTGTTTTTT	CSASQTGGHTGELFF	TRBV20-1	TRBJ2-2
TGTGCCAGCAGTTTAGCCGAGGACAGGACGGCTTATGGCTACACCTTC	CASSLAEDRTAYGYTF	TRBV12-3	TRBJ1-2
TGTGCCAGCAGCCAAGACCCGACGGTTTCCGGGGAGCTGTTTTTT	CASSQDPTVSGELFF	TRBV14	TRBJ2-2
TGTGCCTGGAGTGTAGAAAGTAGGCTAAATAACGGGGAGCTGTTTTTT	CAWSVESRLNNGELFF	TRBV30	TRBJ2-2
TGTGCCACCAGCTTGCAGGGGCTTACTGAAGCTTTCTTT	CATSLQGLTEAFF	TRBV24-1	TRBJ1-1
TGTGCCAGCAGTTACTCTATAGAGGGCTACGAGCAGTACTTC	CASSYSIEGYEQYF	TRBV6-5	TRBJ2-7
TGTGCCAGCAGCGTCCTCCTGCATAGGAGTTATGGCTACACCTTC	CASSVLLHRSYGYTF	TRBV6-3	TRBJ1-2
TGTGCCAGCAGCGTCGTTGCGAGGTCTTTGCTGTCTTACAAAGGACTAGCGGGGGGGCAAGAGACCCAGTACTTC	CASSVVARSLLSYKGLAGGQETQYF	TRBV7-4	TRBJ2-5
TGCGCCAGCGAGGCCCCGGAGGGACTAGCGGGGGGGCCTTATCGTCCCTACGAGCAGTACTTC	CASEAPEGLAGGPYRPYEQYF	TRBV10-1	TRBJ2-7
TGTGCCAGCAGCTTGGAAACAAAACTAGCGGGAGAAGGGAAAGTTGACACCGGGGAGCTGTTTTTT	CASSLETKLAGEGKVDTGELFF	TRBV5-5	TRBJ2-2
TGTGCCAGCAGCTTAACTCCGATAGGGGGCTACGAGCAGTACTTC	CASSLTPIGGYEQYF	TRBV11-2	TRBJ2-7
TGCGCCAGCAGCTTGGGACAGGGTTACCCATTGGATGGCTACACCTTC	CASSLGQGYPLDGYTF	TRBV5-1	TRBJ1-2
TGTGCCAGCAGTTTACCGTCAACAGGGCGGGGGTATCAGCCCCAGCATTTT	CASSLPSTGRGYQPQHF	TRBV28	TRBJ1-5
TGTGCCAGCAGGGCGGGACGGAACGAGCAGTACTTC	CASRAGRNEQYF	TRBV6-1	TRBJ2-7
TGTGCCAGCAGCGTAGGCCCGGGGGAGGAACACGATGAAAAACTGTTTTTT	CASSVGPGEEHDEKLFF	TRBV9	TRBJ1-4
TGTGCCTGGAGTCGGGGCGGCACAGATACGCAGTATTTT	CAWSRGGTDTQYF	TRBV30	TRBJ2-3
TGTGCCAGCAGCTTGAAGAAAGCGATGTACGAGCAGTACTTC	CASSLKKAMYEQYF	TRBV11-2	TRBJ2-7
TGTGCCAGCAGCAGAGAGGGGGCTTTGCGCCAAGAGACCCAGTACTTC	CASSREGALRQETQYF	TRBV7-3	TRBJ2-5
TGTGCCAGCAGTGACCCAGCGGGGGTAGGACCCTACGAGCAGTACTTC	CASSDPAGVGPYEQYF	TRBV6-1	TRBJ2-7
TGTGCCAGCAGAGGCAGGGGGCCGGTCAATTCACCCCTCCACTTT	CASRGRGPVNSPLHF	TRBV6-2	TRBJ1-6
TGTGCCAGCAGTGAATCTGAGGGGAACACTGAAGCTTTCTTT	CASSESEGNTEAFF	TRBV25-1	TRBJ1-1
TGTGCCAGCAGTTACTTCAGACTTTGCGAGCAGTACTTC	CASSYFRLCEQYF	TRBV6-6	TRBJ2-7
TGTGCCAGCAGTTGGAGCCGAGAGGGGAATGAGCAGTTCTTC	CASSWSREGNEQFF	TRBV28	TRBJ2-1
TGTGGAGTGACGGGACAAACCAGCACAGATACGCAGTATTTT	CGVTGQTSTDTQYF	TRBV5-4	TRBJ2-3
TGCGCCAGCAGCTTGGGGGCCCCAGATGAGCAGTTCTTC	CASSLGAPDEQFF	TRBV5-1	TRBJ2-1
TGCGCCAGCAGCTTGGCGACCCGGGACAGAAGGCCCTACAATGAGCAGTTCTTC	CASSLATRDRRPYNEQFF	TRBV5-1	TRBJ2-1
TGTGCCAGTATGGGGGGGGGTGGCTACACCTTC	CASMGGGGYTF	TRBV6-4	TRBJ1-2
TGTGCCTGGAGTGCTTTCCCTCGGTCGGGGGCCCTGAGCTACGAGCAGTACTTC	CAWSAFPRSGALSYEQYF	TRBV30	TRBJ2-7
TGCGCCAGCATACGTCGCACAGAGTCCTACGAGCAGTACTTC	CASIRRTESYEQYF	TRBV10-1	TRBJ2-7
TGTGCCAGCAGTATCGGACAGGGGGCGACGCAGTACTTC	CASSIGQGATQYF	TRBV27	TRBJ2-7
TGCAGTGCTAGCTGGGGTAGGGCACGGCGTACTGAAGCTTTCTTT	CSASWGRARRTEAFF	TRBV20-1	TRBJ1-1
TGTGCCAGTACAGGGGGGCACGAGCAGTACTTC	CASTGGHEQYF	TRBV19	TRBJ2-7
TGCGCCAGCAGCTTGATCAAGGGGGCGAGGGCAAAAAACACTGAAGCTTTCTTT	CASSLIKGARAKNTEAFF	TRBV5-1	TRBJ1-1
TGTGCCAGCAGTAAGGGTGGTAGGGCCCCCCAAGAGACCCAGTACTTC	CASSKGGRAPQETQYF	TRBV11-2	TRBJ2-5
TGTGCCACCAGTGATTTGGAGGAGGATGGGGGGGTGTACCAAGAGACCCAGTACTTC	CATSDLEEDGGVYQETQYF	TRBV24-1	TRBJ2-5
TGTGCCAGCAGCTCAGCAGGGGTCACGCAGTATTTT	CASSSAGVTQYF	TRBV7-9	TRBJ2-3
TGTGCCAGTAGTATACACCGGGCTGGTAATGAGCAGTTCTTC	CASSIHRAGNEQFF	TRBV19	TRBJ2-1
TGTGCCAGCAGCCATCTCTCGAGCGTTGCGGGAGGGGACGAAAAACTGTTTTTT	CASSHLSSVAGGDEKLFF	TRBV14	TRBJ1-4
TGTGCCAGCAGCTTATCACGCCGACCGAGGACAGGGGACTATGGCTACACCTTC	CASSLSRRPRTGDYGYTF	TRBV7-2	TRBJ1-2
TGTGCCAGCAGAAATGCCCGACAGGGGGCTGGAAACACCATATATTTT	CASRNARQGAGNTIYF	TRBV28	TRBJ1-3
TGTGCCAGCAGCGCAGGGACTTGTCGGGGGACTAATGAAAAACTGTTTTTT	CASSAGTCRGTNEKLFF	TRBV11-2	TRBJ1-4
TGTGCCAGCAGCTTGCCCCAGGGGATCGGCGAGCAGTACTTC	CASSLPQGIGEQYF	TRBV5-8	TRBJ2-7
TGTGCCAGCAGTTTAGATGGAGGCTGGGGTCTGTACGAGCAGTACTTC	CASSLDGGWGLYEQYF	TRBV27	TRBJ2-7
TGCGCCAGCAGTGCGACTACCCGGGACAGAAGCTCCTATAATTCACCCCTCCACTTT	CASSATTRDRSSYNSPLHF	TRBV10-1	TRBJ1-6
TGTGCCAGTAGTATCCGTCGGGACAGGGTAAGGAACACTGAAGCTTTCTTT	CASSIRRDRVRNTEAFF	TRBV19	TRBJ1-1
TGTGCCAGCAGTGACGGACAGGGTGAGCAGTACTTC	CASSDGQGEQYF	TRBV6-4	TRBJ2-7
TGTGCCAGCACGCCTCGCGAGGGGGCATGGACGAAAACAGATACGCAGTATTTT	CASTPREGAWTKTDTQYF	TRBV14	TRBJ2-3
TGTGCACAAGCCCCCTGGGGGGAGAACACCGGGGAGCTGTTTTTT	CAQAPWGENTGELFF	TRBV7-3	TRBJ2-2
TGCAGTTGGTCGCTCGAGGCCTACGAGCAGTACTTC	CSWSLEAYEQYF	TRBV20-1	TRBJ2-7
TGTGCCAGCAACCCGGGGGGATACGAGCAGTACTTC	CASNPGGYEQYF	TRBV3-1	TRBJ2-7
TGTGCCAGCAGCACCAGTCACCCGTCTAGCGGGGAAGGCCAAGAGACCCAGTACTTC	CASSTSHPSSGEGQETQYF	TRBV7-2	TRBJ2-5
TGTGCTAGTGGTTTGGAGGTTAAGAAGTCCTATAATTCACCCCTCCACTTT	CASGLEVKKSYNSPLHF	TRBV12-5	TRBJ1-6
TGCAGTGCTGGGGGAAGACAAGAGACCCAGTACTTC	CSAGGRQETQYF	TRBV20-1	TRBJ2-5
TGTGCCAGCAGCCGGGACTCGGACTCCTACGAGCAGTACTTC	CASSRDSDSYEQYF	TRBV27	TRBJ2-7
TGTGCCTGGGTTCCTACAACTAATGAAAAACTGTTTTTT	CAWVPTTNEKLFF	TRBV30	TRBJ1-4
TGTGCCAGCAGTTTCCGACAGGTCCCCTATGGCTACACCTTC	CASSFRQVPYGYTF	TRBV6-2	TRBJ1-2
TGTGCCAGCTTCCGCCCAGGACAGCTATCCCCTAATGAAAAACTGTTTTTT	CASFRPGQLSPNEKLFF	TRBV27	TRBJ1-4
TGTGCCAGCAGCTTCGGCAGTGACTCCTACGAGCAGTACTTC	CASSFGSDSYEQYF	TRBV5-6	TRBJ2-7
TGCAGTGCTAGCGGACGGGTGGTCTCCTATAATTCACCCCTCCACTTT	CSASGRVVSYNSPLHF	TRBV20-1	TRBJ1-6
TGTGCCAGCACTTGGGAGGGGGTTGAGCAGTTCTTC	CASTWEGVEQFF	TRBV27	TRBJ2-1
TGTGCCAGCAGCCAAGATCGGAACGACCCCCGGACGCATAGCAATCAGCCCCAGCATTTT	CASSQDRNDPRTHSNQPQHF	TRBV14	TRBJ1-5
TGTGCCAGCAGCCGTGGAGGGCAATGCACAGATACGCAGTATTTT	CASSRGGQCTDTQYF	TRBV7-8	TRBJ2-3
TGTGCCAGCATCAAGGGACAGCTTTACGAGCAGTACTTC	CASIKGQLYEQYF	TRBV2	TRBJ2-7
TGTGCCAGCTTTCCACCCCGGCGAGGACAGGGGGGTAACTATGGCTACACCTTC	CASFPPRRGQGGNYGYTF	TRBV6-1	TRBJ1-2
TGTGCCACCCGTATTTGGGGCAGGAAGGGCCAAGAGACCCAGTACTTC	CATRIWGRKGQETQYF	TRBV19	TRBJ2-5
TGCGCCAGCAGCGGGCACAAGGATCAGCCCCAGCATTTT	CASSGHKDQPQHF	TRBV5-1	TRBJ1-5
TGTGCCAGCAGACAGGGAAGTTTAATCTATGGCTACACCTTC	CASRQGSLIYGYTF	TRBV28	TRBJ1-2
TGTGCCAGCAGCTATTCGGGCCAGAATGAGCAGTTCTTC	CASSYSGQNEQFF	TRBV7-3	TRBJ2-1
TGTGCCAGCAGCCTTCGGGGGGGGCCGGGGATAGGGAGCACAGATACGCAGTATTTT	CASSLRGGPGIGSTDTQYF	TRBV13	TRBJ2-3
TGTGCCAGCAGCCAAGATACCTTCCGACAGGGTCACTACGAGCAGTACTTC	CASSQDTFRQGHYEQYF	TRBV3-1	TRBJ2-7
TGTGCCAGCAGCCCTAGGACAGGCACAGATACGCAGTATTTT	CASSPRTGTDTQYF	TRBV6-5	TRBJ2-3
TGTGCCAGCCGACAGGGGGCGGGGAACACCGGGGAGCTGTTTTTT	CASRQGAGNTGELFF	TRBV6-6	TRBJ2-2
TGTGCCAGCAGCCAAGATCGGCACGGGGACGAGCAGTACTTC	CASSQDRHGDEQYF	TRBV14	TRBJ2-7
TGTGCCAGCAGCTACCCTCAACCTTTCAGCCCGCGGGGCCAAGAGACCCAGTACTTC	CASSYPQPFSPRGQETQYF	TRBV5-6	TRBJ2-5
TGTGCCACCCCTCAGGGGGTTGCTTTCTTT	CATPQGVAFF	TRBV24-1	TRBJ1-1
TGCGCCAGCATCCTGGGGCCCCTAGCCAAAAACATTCAGTACTTC	CASILGPLAKNIQYF	TRBV5-1	TRBJ2-4
TGCAGCGTTGAAGAACTGGGGACAGGGGCCATCTCTGCGGGGCAGTATTTT	CSVEELGTGAISAGQYF	TRBV29-1	TRBJ2-3
TGTGCCAGCAACCCGACGGATGGCTACACCTTC	CASNPTDGYTF	TRBV25-1	TRBJ1-2
TGCAGTGCTATCGGCCTTTCCCTACGCAGGGAATTAGATACGCAGTATTTT	CSAIGLSLRRELDTQYF	TRBV20-1	TRBJ2-3
TGTGCCAGCAGCCTTTTGGCCTACGGGAGACAGGGCTACGAGCAGTACTTC	CASSLLAYGRQGYEQYF	TRBV13	TRBJ2-7
TGTGCCAGCAGTGGAGGGGGGTTTTATGGCTACACCTTC	CASSGGGFYGYTF	TRBV7-6	TRBJ1-2
TGTGCCAGCATCCACAGGGACGAGCAGTACTTC	CASIHRDEQYF	TRBV11-3	TRBJ2-7
TGCAGCGCAGGCGACAGGTCGGGCCCCAGGTCGGCTGAAGCTTTCTTT	CSAGDRSGPRSAEAFF	TRBV29-1	TRBJ1-1
TGTGCCAGCAGAACGCAACGTTTACCTCACGAGCAGTACTTC	CASRTQRLPHEQYF	TRBV7-9	TRBJ2-7
TGCAGTGCAAATTCCGGGGACAGGGACGTATCTACGAACACTGAAGCTTTCTTT	CSANSGDRDVSTNTEAFF	TRBV20-1	TRBJ1-1
TGTGCCAGCAGCCAGTCGGGGCTGTATGAGCAGTTCTTC	CASSQSGLYEQFF	TRBV7-8	TRBJ2-1
TGCATCGTTCGAAACAGGGGGCCCCAGCATTTT	CIVRNRGPQHF	TRBV20-1	TRBJ1-5
TGTGCCAGCACCACTGTCTTC	CASTTVF	TRBV6-5	TRBJ2-1
TGCTTGCGGGACAGGGGGTATGGCTACACCTTC	CLRDRGYGYTF	TRBV10-2	TRBJ1-2
TGTGCCACCCCGCCTGGGACAGGATTAGAGACCCAGTACTTC	CATPPGTGLETQYF	TRBV24-1	TRBJ2-5
TGCAGCGTTGTTAACAGCAAACATTATTTCCCAGATACGCAGTATTTT	CSVVNSKHYFPDTQYF	TRBV29-1	TRBJ2-3
TGCAGTGCTACCGGGACAGATGGCAACACTGAAGCTTTCTTT	CSATGTDGNTEAFF	TRBV20-1	TRBJ1-1
TGTGCCAGTAGTAAGACTAGCGGGAGAGAGGGGAACACTGAAGCTTTCTTT	CASSKTSGREGNTEAFF	TRBV19	TRBJ1-1
TGTGCCGCCCCCCGGGGGGACAATCTGGGTAGTGAGCAGTACTTC	CAAPRGDNLGSEQYF	TRBV10-3	TRBJ2-7
TGTGCTAGTGGTTTGCAAGGGGGACAGGGTCTAGAGACCCAGTACTTC	CASGLQGGQGLETQYF	TRBV12-5	TRBJ2-5
TGTGCCAGCAGTTACAGGACAGCCGGGGGCTCTGGAAACACCATATATTTT	CASSYRTAGGSGNTIYF	TRBV6-2	TRBJ1-3
TGCGCCAGCAGCCAAGTTCAATGGCTAAGGACAGATACGCAGTATTTT	CASSQVQWLRTDTQYF	TRBV4-3	TRBJ2-3
TGCGCCAGCAGTGCTAATAGTGGGGATGAAGATACGCAGTATTTT	CASSANSGDEDTQYF	TRBV10-1	TRBJ2-3
TGTGCCAGCAGGACAGGGACAGCACCTTCCCACTATGGCTACACCTTC	CASRTGTAPSHYGYTF	TRBV27	TRBJ1-2
TGTGCCAGCAAGGGACAGGTTCAGTACACCGGGGAGCTGTTTTTT	CASKGQVQYTGELFF	TRBV2	TRBJ2-2
TGTGCCAGCAGTTACATTTACCCGGGACTTAAAAGTGGGGGAGACGAGCAGTACTTC	CASSYIYPGLKSGGDEQYF	TRBV6-2	TRBJ2-7
TGTGCCAGCAGGGACCCAGGAGGCTCCTACGAGCAGTACTTC	CASRDPGGSYEQYF	TRBV28	TRBJ2-7
TGTGCCAGTAGGGGGGGGGGTCTGGATTGTGAAGCTTTCTTT	CASRGGGLDCEAFF	TRBV6-1	TRBJ1-1
TGTGCCAGCAGCGGACCGGTCGGGACTAGCAGCTCCTACAATGAGCAGTTCTTC	CASSGPVGTSSSYNEQFF	TRBV7-4	TRBJ2-1
TGTGCCAGTAGTGGAAAAGACAGGGTAGGCTACGAGCAGTACTTC	CASSGKDRVGYEQYF	TRBV19	TRBJ2-7
TGTGCCAGCAAAGACCCCGGGACTAGCGGGTCTAGTCGCTCCTACAATGAGCAGTTCTTC	CASKDPGTSGSSRSYNEQFF	TRBV2	TRBJ2-1
TGCAGTGCTAGAGATCCACGTAGGGAAGAGACCCAGTACTTC	CSARDPRREETQYF	TRBV20-1	TRBJ2-5
TGTGCCAGCAGTCGGGGACAGCGGGACGAGCAGTACTTC	CASSRGQRDEQYF	TRBV6-5	TRBJ2-7
TGTGCCAGCAGCAGTAGTTGGGACAGTTTAAGGCATGAGCAGTACTTC	CASSSSWDSLRHEQYF	TRBV4-2	TRBJ2-7
TGTGCCAGCAGTGAAGTAGGGCAAAACGAGCAGTACTTC	CASSEVGQNEQYF	TRBV6-1	TRBJ2-7
TGTGCCAGCAGCGCCAACCCGAGGAAGGGGGGCCCCTACGAGCAGTACTTC	CASSANPRKGGPYEQYF	TRBV9	TRBJ2-7
TGTGCCAGCAGCAATTTGGGGGGCAGTTTGTCCTACAATGAGCAGTTCTTC	CASSNLGGSLSYNEQFF	TRBV6-5	TRBJ2-1
TGTGCCAGCAGCCAAGATGCGAGAGGGCGCTCCCTCGGGATCGACGAGCAGTACTTC	CASSQDARGRSLGIDEQYF	TRBV4-2	TRBJ2-7
TGTGCCAGCAGCAAAGACAGGGGGCGTGGCTACACCTTC	CASSKDRGRGYTF	TRBV11-3	TRBJ1-2
TGTGCCATCAGCAGCAGGGGAGGCAATCAGCCCCAGCATTTT	CAISSRGGNQPQHF	TRBV10-3	TRBJ1-5
TGCAGCGGAAAGGGGGCGTGTGGAGGTAGGAGCTCTGGGGCCAACGTCCTGACTTTC	CSGKGACGGRSSGANVLTF	TRBV29-1	TRBJ2-6
TGTGCCCCCCTCGGCGACAGGGGCATCCCTGGAAACACCATATATTTT	CAPLGDRGIPGNTIYF	TRBV10-3	TRBJ1-3
TGCAGTGCTTGGTCTAGACCACTCAAACACACCGGGGAGCTGTTTTTT	CSAWSRPLKHTGELFF	TRBV20-1	TRBJ2-2
TGTGCCATCAGTGAGTGGGCCCCCGAAGGTGGCTACACCTTC	CAISEWAPEGGYTF	TRBV10-3	TRBJ1-2
TGTGCCAGCAGCGGGCGGGACAGCGTTCGAGACTACTATGGCTACACCTTC	CASSGRDSVRDYYGYTF	TRBV7-3	TRBJ1-2
TGTGCCAGCACAGGGACAGGGGCGATTGGCTATAGCAATCAGCCCCAGCATTTT	CASTGTGAIGYSNQPQHF	TRBV6-4	TRBJ1-5
TGTGCCAGCTCACCACGCCGGGGGAGACAAGAGACCCAGTACTTC	CASSPRRGRQETQYF	TRBV18	TRBJ2-5
TGTGCCAGTAGTATACATATCAACAAGGCCAAAAACATTCAGTACTTC	CASSIHINKAKNIQYF	TRBV19	TRBJ2-4
TGCGCCAGCAGACGCGGCCACACTGGCGAGCAGTACTTC	CASRRGHTGEQYF	TRBV5-1	TRBJ2-7
TGTGCCAGCAGTGGAACGGAGGGGATGAAGGAGCCCCAGCATTTT	CASSGTEGMKEPQHF	TRBV6-4	TRBJ1-5
TGCGCCAGCAGTACCGCGGGAGAAAGTAATGAGCAGTTCTTC	CASSTAGESNEQFF	TRBV10-1	TRBJ2-1
TGTGCCAGCAGCTTAGGGGTCCCTGAGCAGTTCTTC	CASSLGVPEQFF	TRBV5-8	TRBJ2-1
TGCGCCAGCAGTGAGGGTGGGACAGGCGGCATGAACACTGAAGCTTTCTTT	CASSEGGTGGMNTEAFF	TRBV10-1	TRBJ1-1
TGTGCCAGCAGTGCCCCCTGCCGTCCTAGTTCGTACTTC	CASSAPCRPSSYF	TRBV6-4	TRBJ2-5
TGTGCCAGCAGCTTAGCCCCCCCACCTAGCGGGGGACCTCCGAACACCGGGGAGCTGTTTTTT	CASSLAPPPSGGPPNTGELFF	TRBV7-4	TRBJ2-2
TGTGCCAGCAGCTTAGGGTCGAAGGAGGAATACAATGAGCAGTTCTTC	CASSLGSKEEYNEQFF	TRBV7-9	TRBJ2-1
TGTGCCAGCAGCTTGCAGGGGGACGGCTCTGGGGCCAACGTCCTGACTTTC	CASSLQGDGSGANVLTF	TRBV5-5	TRBJ2-6
TGTGCCAGCAGCGGTACAGGGGACCCTTTCTTT	CASSGTGDPFF	TRBV9	TRBJ1-1
TGTGCCACCAGTCCCGGCAGGTTCGAGCAGTACTTC	CATSPGRFEQYF	TRBV24-1	TRBJ2-7
TGTGCCAGCAGCGAGCAAGACGGGGGGCCCTATCAGCCCCAGCATTTT	CASSEQDGGPYQPQHF	TRBV11-3	TRBJ1-5
TGTGCCAGCAGTTATTGTCAGGTCGGTAGTACTGGGGCCAACGTCCTGACTTTC	CASSYCQVGSTGANVLTF	TRBV6-9	TRBJ2-6
TGTGCCAGCAGTTACTCAGGGGGCATCGGGGGGAACTACGAGCAGTACTTC	CASSYSGGIGGNYEQYF	TRBV27	TRBJ2-7
TGCGCCTGGGTAGGACCACCAGGGGTCAATGAGCAGTTCTTC	CAWVGPPGVNEQFF	TRBV10-1	TRBJ2-1
TGTGCCAGCAGCTTAGGGTACACTCCTGGGGACACAGATACGCAGTATTTT	CASSLGYTPGDTDTQYF	TRBV7-9	TRBJ2-3
TGTGCCAGCAGTGATACCCCGCAGGGGGGGGAGCAGTACTTC	CASSDTPQGGEQYF	TRBV6-4	TRBJ2-7
TGTGCCAGCAGTTTCATGAAGCCCGGGACTAGCGGCCGGGGCGAGTACTTC	CASSFMKPGTSGRGEYF	TRBV6-3	TRBJ2-5
TGTGCTAGCAGCTTACGGACAAGGGCGCACTCACCCCTCCACTTT	CASSLRTRAHSPLHF	TRBV7-7	TRBJ1-6
TGTGCCAGCAGCTGGTCCCCCGAGGGACAAAGGTCCTACGAGCAGTACTTC	CASSWSPEGQRSYEQYF	TRBV7-4	TRBJ2-7
TGTGCCGGAGAGCGCGGGGCGGGTTGGGCCACTGAAGCTTTCTTT	CAGERGAGWATEAFF	TRBV6-2	TRBJ1-1
TGCAGTGCTGAAAGGAGCACCGGGGAGCTGTTTTTT	CSAERSTGELFF	TRBV20-1	TRBJ2-2
TGTGCCAGCAGTAGGAGAGACAGTCTGTTTACAAGGTCCCCCGGTGAGCAGTTCTTC	CASSRRDSLFTRSPGEQFF	TRBV12-4	TRBJ2-1
TGTGCCAGCAGCCGCGCTCGGGGGGACAGTCGCCGGATGACCCAGTACTTC	CASSRARGDSRRMTQYF	TRBV3-1	TRBJ2-5
TGTGCCAGCAGCCCAAAAGACGGGTCCAGAGGCTATGGCTACACCTTC	CASSPKDGSRGYGYTF	TRBV27	TRBJ1-2
TGTGCCAGCAGCGTAGGTGTAAAAACCTACGAGCAGTACTTC	CASSVGVKTYEQYF	TRBV9	TRBJ2-7
TGTGCTAGTGGGGCTCTTAGCGGGGAAGAGACCCAGTACTTC	CASGALSGEETQYF	TRBV12-5	TRBJ2-5
TGTGCCAGCAGCTACACCGGACTAGCGGGTAACGAACTCGCGAACACCGGGGAGCTGTTTTTT	CASSYTGLAGNELANTGELFF	TRBV5-6	TRBJ2-2
TGCAGCGTTGAAGCAAGGGGGCTAATTACGGGGACAGATACGCAGTATTTT	CSVEARGLITGTDTQYF	TRBV29-1	TRBJ2-3
TGTGCCAGCAGCCGGCAGGGGGCTTGGGCGAACACTGAAGCTTTCTTT	CASSRQGAWANTEAFF	TRBV6-4	TRBJ1-1
TGCGCCAGGCTACACAGGAGTAAGCAGCCCCAGCATTTT	CARLHRSKQPQHF	TRBV5-1	TRBJ1-5
TGTGCCAGCAGCAGGGGACGGAATGAGCAGTTCTTC	CASSRGRNEQFF	TRBV6-8	TRBJ2-1
TGTGCCTGGAGTGTAGGGTGGACAGGGCCAAGGGAGCAGTACTTC	CAWSVGWTGPREQYF	TRBV30	TRBJ2-7
TGTGCCCCTCCTGACACTGAAGCTTTCTTT	CAPPDTEAFF	TRBV10-3	TRBJ1-1
TGTGCCAGCTCACCATGGATCAATAGACAGGACTATGGCTACACCTTC	CASSPWINRQDYGYTF	TRBV18	TRBJ1-2
TGTGCCTGGGGGGTCAGGGCTCATGGCTACACCTTC	CAWGVRAHGYTF	TRBV30	TRBJ1-2
TGTGCCAGCAGTTGCAGCTATAATTCACCCCTCCACTTT	CASSCSYNSPLHF	TRBV12-3	TRBJ1-6
TGTGCCAGCAGGGGGGACAGGAACAGGCGAAACACCATATATTTT	CASRGDRNRRNTIYF	TRBV28	TRBJ1-3
TGTGCCATGCCCAGGATGAACACTGAAGCTTTCTTT	CAMPRMNTEAFF	TRBV19	TRBJ1-1
TGCGCCAGCAGTGAAAAGACAGGAGATAAACTGTACGAGCAGTACTTC	CASSEKTGDKLYEQYF	TRBV10-1	TRBJ2-7
TGTGCCAGCAGCTCGGAGATACGAGGGCCTAATGAAAAACTGTTTTTT	CASSSEIRGPNEKLFF	TRBV9	TRBJ1-4
TGCAGTGCTTCCTGGACAGGGCAGGCTTTCTTT	CSASWTGQAFF	TRBV20-1	TRBJ1-1
TGTGCCAGCAGTGACTCTGGGCAGGGGTTCCCGAACACCGGGGAGCTGTTTTTT	CASSDSGQGFPNTGELFF	TRBV6-1	TRBJ2-2
TGCAGCGTTGAAGCTCTTGGCGGCTCGGTAGGGATATTCTACGAGCAGTACTTC	CSVEALGGSVGIFYEQYF	TRBV29-1	TRBJ2-7
TGTGCCAGCAGCTCCGGACTAGCGGGAATCTACAATGAGCAGTTCTTC	CASSSGLAGIYNEQFF	TRBV5-6	TRBJ2-1
TGTGCCAGCAGCCAGTTAGGGGAACGGGCGAATCAGCCCCAGCATTTT	CASSQLGERANQPQHF	TRBV4-2	TRBJ1-5
TGTGCCAGCTCATGTCGGGGCAGCACCGGGGAGCTGTTTTTT	CASSCRGSTGELFF	TRBV18	TRBJ2-2
TGCGCCAGCAGTCAGGTGCCTAGAAGTCCGGGTGAAGCTTTCTTT	CASSQVPRSPGEAFF	TRBV5-1	TRBJ1-1
TGTGCCAGCAGCGCCGAACCCGGTGGCCAGCTAGACACAGATACGCAGTATTTT	CASSAEPGGQLDTDTQYF	TRBV9	TRBJ2-3
TGTGCCACCCGTATGAGCGGGGAGCTGTTTTTT	CATRMSGELFF	TRBV24-1	TRBJ2-2
TGTGCCAGCAGCTATAGGGGGGGTGAGCAGTTCTTC	CASSYRGGEQFF	TRBV5-5	TRBJ2-1
TGCATAAGGGCCGGACAGTCGTATGGCTACACCTTC	CIRAGQSYGYTF	TRBV20-1	TRBJ1-2
TGCAGTGCTAGAGAGCCAGGGGGCTACGAGCAGTACTTC	CSAREPGGYEQYF	TRBV20-1	TRBJ2-7
TGTGCCACCAGGGGGGAAGCCTTAAGGGGCGAGACCCAGTACTTC	CATRGEALRGETQYF	TRBV24-1	TRBJ2-5
TGTGCCACAGAGTGCACAGATACGCAGTATTTT	CATECTDTQYF	TRBV4-2	TRBJ2-3
TGTGCCTGGAGTGTACCATCTATACCAGTTGGTCTCTACAATGAGCAGTTCTTC	CAWSVPSIPVGLYNEQFF	TRBV30	TRBJ2-1
TGTGCCAGCAGCAGAGCCCCGGGACTAGCGGGTAGGTACGAGCAGTACTTC	CASSRAPGLAGRYEQYF	TRBV5-4	TRBJ2-7
TGTGCCAGCACGACGTGGGTGGGCTACGAGCAGTACTTC	CASTTWVGYEQYF	TRBV7-8	TRBJ2-7
TGTGCCACCAGCATGGGAGCAGGGCACACTGAAGCTTTCTTT	CATSMGAGHTEAFF	TRBV15	TRBJ1-1
TGTGCCAGCACCACCCGGACAGGGTTTCCTGGAAACACCATATATTTT	CASTTRTGFPGNTIYF	TRBV2	TRBJ1-3
TGTGCCAGCACCCCAATGGGGAATCAGCCCCAGCATTTT	CASTPMGNQPQHF	TRBV28	TRBJ1-5
TGCGCAGGGGAAGAGACCCAGTACTTC	CAGEETQYF	TRBV20-1	TRBJ2-5
TGTGCCAGCAGTGAGTCTAGCGGGACCAATGAGCAGTTCTTC	CASSESSGTNEQFF	TRBV6-1	TRBJ2-1
TGTGCCAGCAGTTTTTTAGTATCGACAGGGGGAGTGGGAGGTAATGAAAAACTGTTTTTT	CASSFLVSTGGVGGNEKLFF	TRBV27	TRBJ1-4
TGTGCCAGCAGCTTAATTCCAGGGGACGTCTCCTACGAGCAGTACTTC	CASSLIPGDVSYEQYF	TRBV5-4	TRBJ2-7
TGTGCTAGTGGTTGCAGGGGGGAGGCAACTAATGAAAAACTGTTTTTT	CASGCRGEATNEKLFF	TRBV12-5	TRBJ1-4
TGTGCCAGCAGCGGTCGCCCTGGACTAGGTTCCTACGAGCAGTACTTC	CASSGRPGLGSYEQYF	TRBV9	TRBJ2-7
TGTGCCAGCAGTGGACCAGCGGGAGCTGAAGCTTTCTTT	CASSGPAGAEAFF	TRBV6-1	TRBJ1-1
TGTGCCAGCAGTTTGCGACTAGCGGGCCTAAACTACAATGAGCAGTTCTTC	CASSLRLAGLNYNEQFF	TRBV12-4	TRBJ2-1
TGTGCCAGCAGTGAAACCAGGCAGGGCTACACCTTC	CASSETRQGYTF	TRBV6-5	TRBJ1-2
TGTGCCAGCAGCTCTGTCCCGTATCGGTCCCCCACAGATACGCAGTATTTT	CASSSVPYRSPTDTQYF	TRBV7-2	TRBJ2-3
TGCAGCGTTGAGGTCCCGAAAAGGGGGTACAACAATGAAAAACTGTTTTTT	CSVEVPKRGYNNEKLFF	TRBV29-1	TRBJ1-4
TGTGCCAGCAGCTTAGTGCGCCAGACGGACTCTGGAAACACCATATATTTT	CASSLVRQTDSGNTIYF	TRBV7-6	TRBJ1-3
TGTGCCAGCAGCTTAGCCGGGACTAGTCACAATGAGCAGTTCTTC	CASSLAGTSHNEQFF	TRBV7-8	TRBJ2-1
TGCGCCAGCAGAGTATTGGCTAGCGGGGCCTACGAGCAGTACTTC	CASRVLASGAYEQYF	TRBV10-1	TRBJ2-7
TGTGCCAGCAGTTACTCGTCCGGACAGGGAAGGGATTCTCTCTACGAGCAGTACTTC	CASSYSSGQGRDSLYEQYF	TRBV6-5	TRBJ2-7
TGCAGTGCTAGAGTTTGCGGCCAGGGTAAGATTGATACGCAGTATTTT	CSARVCGQGKIDTQYF	TRBV20-1	TRBJ2-3
TGTGCCAGCAGTTACTCGACAGCAAAGAATAATGAAAAACTGTTTTTT	CASSYSTAKNNEKLFF	TRBV6-5	TRBJ1-4
TGTTTTTACCCCCCGGGACAGTCCCACTACGAGCAGTACTTC	CFYPPGQSHYEQYF	TRBV14	TRBJ2-7
TGTGCCATCAGTAGAGGCTACAATGAGCAGTTCTTC	CAISRGYNEQFF	TRBV10-3	TRBJ2-1
TGTGCCAGCAGTGACCGGGGGGCGGAAGTCAGAGATAGCTCTGGGGCCAACGTCCTGACTTTC	CASSDRGAEVRDSSGANVLTF	TRBV6-4	TRBJ2-6
TGTGCCAGCAGTTTACTGGCAGGGTTCCCCAAAAACATTCAGTACTTC	CASSLLAGFPKNIQYF	TRBV6-2	TRBJ2-4
TGTGCCAGCAGCTTGCCCTCGGGGGGAGCTGGCTACGAGCAGTACTTC	CASSLPSGGAGYEQYF	TRBV5-5	TRBJ2-7
TGTGCCATCAGTTCCGGGACTAGAGCCTACGAGCAGTACTTC	CAISSGTRAYEQYF	TRBV10-3	TRBJ2-7
TGCGCCAGTGACCCCCGGGACATATCGTACTTC	CASDPRDISYF	TRBV4-1	TRBJ2-5
TGTGCCAGCCGGGCCGGACAGGCAGGTCAGCCCCAGCATTTT	CASRAGQAGQPQHF	TRBV5-6	TRBJ1-5
TGCAGCGTTGCCTTGAATGGGGGGCGAAAAGAGACCCAGTACTTC	CSVALNGGRKETQYF	TRBV29-1	TRBJ2-5
TGTGCCAGCAGCCTAGCAGGACCCACCTACAATGAGCAGTTCTTC	CASSLAGPTYNEQFF	TRBV13	TRBJ2-1
TGTGCCAGTCTCCCTCGGCGACAGGGGGCCGATTACGAGCAGTACTTC	CASLPRRQGADYEQYF	TRBV6-4	TRBJ2-7
TGCGCCAGCAGTTCAGGCACGTTCCTAGGGGGAGAAGTTGGCTACACCTTC	CASSSGTFLGGEVGYTF	TRBV5-1	TRBJ1-2
TGTGCCACTAGGGGCTACGAGCAGTACTTC	CATRGYEQYF	TRBV5-4	TRBJ2-7
TGCGCCAGCAGTGAGATTGCCGGACAGGGGGCGACGTACACTGAAGCTTTCTTT	CASSEIAGQGATYTEAFF	TRBV10-1	TRBJ1-1
TGTGCCACAACAGAGTCTCCCCGGGGGACAGGGATTGACACCGGGGAGCTGTTTTTT	CATTESPRGTGIDTGELFF	TRBV24-1	TRBJ2-2
TGTGCCAGCAGGAGGGGGGCCTACTCCTACAATGAGCAGTTCTTC	CASRRGAYSYNEQFF	TRBV14	TRBJ2-1
TGCAGCGTTAGGGGGGGGCCTCGTTGCAGCTACAATGAGCAGTTCTTC	CSVRGGPRCSYNEQFF	TRBV29-1	TRBJ2-1
TGTGCTAGTGGTTTGGTACCGGATAATCAGCCCCAGCATTTT	CASGLVPDNQPQHF	TRBV12-5	TRBJ1-5
TGTGCCAGCAGCCCAGGGGGGGAATTCGCCTACGAGCAGTACTTC	CASSPGGEFAYEQYF	TRBV11-2	TRBJ2-7
TGTGCCAGCAGTCGCAACGATACAGGGGGCGGAGGGTACACTGAAGCTTTCTTT	CASSRNDTGGGGYTEAFF	TRBV28	TRBJ1-1
TGTGCCAGCAGCTCCCCCATCACAGGGGAATCCTACGAGCAGTACTTC	CASSSPITGESYEQYF	TRBV9	TRBJ2-7
TGTGCCAGCCGGATACCCACAGACGCAAGGGTCGAAAAACTGTTTTTT	CASRIPTDARVEKLFF	TRBV7-2	TRBJ1-4
TGCAGTGCTAATAGACAGGGGTTTGAGGCTGAAGCTTTCTTT	CSANRQGFEAEAFF	TRBV20-1	TRBJ1-1
TGCAGTGCTAGCCCTTCGGTAGGGAGCTCCTATAATTCACCCCTCCACTTT	CSASPSVGSSYNSPLHF	TRBV20-1	TRBJ1-6
TGTGCCACCAGTGATTTGCACGAGACAAATATCGAGCAGTACTTC	CATSDLHETNIEQYF	TRBV24-1	TRBJ2-7
TGTGCCAGCACTTTCATTGACAGGGGGCCCACCTACGAGCAGTACTTC	CASTFIDRGPTYEQYF	TRBV25-1	TRBJ2-7
TGCGCCAGCATCGAGGGACTCTCCTACGAGCAGTACTTC	CASIEGLSYEQYF	TRBV10-2	TRBJ2-7
TGCGCCAGCAGTGGGACTAGCGGGAGAGAAAACATTCAGTACTTC	CASSGTSGRENIQYF	TRBV10-1	TRBJ2-4
TGTGCCAGCAGCTTACGAGAGGGGACCTACAATGAGCAGTTCTTC	CASSLREGTYNEQFF	TRBV7-2	TRBJ2-1
TGTGCTAGTGTATCCGGGGAGCTGTTTTTT	CASVSGELFF	TRBV12-5	TRBJ2-2
TGTGCCAGCAGCGCACTTCCCTACAGGGGGGACTATGGCTACACCTTC	CASSALPYRGDYGYTF	TRBV7-3	TRBJ1-2
TGTGCCAGCAGCGGGGGGCTTGAGCGGGCTTTCTTT	CASSGGLERAFF	TRBV13	TRBJ1-1
TGTGCCAGCAGCGGCCGACAGGGGGCCAACGTCCTGACTTTC	CASSGRQGANVLTF	TRBV9	TRBJ2-6
TGCGCCAGCAGGGGGGCACATGAAGCTTTCTTT	CASRGAHEAFF	TRBV5-1	TRBJ1-1
TGTGCCAGCAGTTCCGTCACAGGGGGCATGATTAGAAACGAGCAGTACTTC	CASSSVTGGMIRNEQYF	TRBV12-3	TRBJ2-7
TGTGCCAGCAGCCAAGATCCTCCTTTAGCCGGGACAGGGGAGACCCAGTACTTC	CASSQDPPLAGTGETQYF	TRBV3-1	TRBJ2-5
TGTGCCAGCTCACCGTCTTGGACAGGGTTGAACGAGCAGTACTTC	CASSPSWTGLNEQYF	TRBV18	TRBJ2-7
TGTGCCAGCAGTTATGGAGGGGGGACAGGGGGAGGCTACGAGCAGTACTTC	CASSYGGGTGGGYEQYF	TRBV6-5	TRBJ2-7
TGCAGTGCTAGAGGGCAAGCCCCACAGGGGCACTACGAGCAGTACTTC	CSARGQAPQGHYEQYF	TRBV20-1	TRBJ2-7
TGTGCCAGCAGCCCCGGGACAGGGTCGTACGAGCAGTACTTC	CASSPGTGSYEQYF	TRBV6-8	TRBJ2-7
TGTGCCAGCAGCCTACCGCGGGAGGCGAATCAGCCCCAGCATTTT	CASSLPREANQPQHF	TRBV7-2	TRBJ1-5
TGTGCCAGCAGCTTACCTTCATCCTTCAGGCACAATCAGCCCCAGCATTTT	CASSLPSSFRHNQPQHF	TRBV7-9	TRBJ1-5
TGTGCCAGCTCACCTCAATTCGCAATAGGGGAGGAGGACGAGCAGTACTTC	CASSPQFAIGEEDEQYF	TRBV18	TRBJ2-7
TGTGCCTCCCCTGAGGGACAGGGGGCGAGGGCTGGGGCCAACGTCCTGACTTTC	CASPEGQGARAGANVLTF	TRBV27	TRBJ2-6
TGTGCCAGCAGCTTAGCCCCACGGGGAGTGAAGGATACGCAGTATTTT	CASSLAPRGVKDTQYF	TRBV11-3	TRBJ2-3
TGCGCCACAGGGCTAGGGGGAGCTAACTTC	CATGLGGANF	TRBV10-1	TRBJ2-7
TGTGCCAGCAGCGATTCCCGAGAGGGGGGATATTCACCCCTCCACTTT	CASSDSREGGYSPLHF	TRBV9	TRBJ1-6
TGTGCCAGCAGCCGGCTCCAGGGGGCGCCGAAGGTTTCCTACGAGCAGTACTTC	CASSRLQGAPKVSYEQYF	TRBV7-3	TRBJ2-7
TGTGCCAGCAGACACAGCGCTGAAGCTTTCTTT	CASRHSAEAFF	TRBV2	TRBJ1-1
TGCGCCAGCACAGTTCTCCGGGGCCAAGAGACCCAGTACTTC	CASTVLRGQETQYF	TRBV10-1	TRBJ2-5
TGTGCCAGCAGCTACGGGGATGAGCAGTTCTTC	CASSYGDEQFF	TRBV5-6	TRBJ2-1
TGTGCCGGACATAAACAGGGTCATCAGCCCCAGCATTTT	CAGHKQGHQPQHF	TRBV27	TRBJ1-5
TGCGCCAGCAGTGGAGTTTGGGGGCCTTATGGCTACGAGCAGTACTTC	CASSGVWGPYGYEQYF	TRBV10-1	TRBJ2-7
TGTGCCTGGTTACGGTTTAATCAGGGTCGGGCTTTCTTT	CAWLRFNQGRAFF	TRBV30	TRBJ1-1
TGCGCCAGCAGCTTGTCCACACAGCGCTACGAGCAGTACTTC	CASSLSTQRYEQYF	TRBV5-1	TRBJ2-7
TGTGCCTGGAGTGTCCTAACCGGGACAGGGCAGCCCCAGCATTTT	CAWSVLTGTGQPQHF	TRBV30	TRBJ1-5
TGTGCCAGCAGCTACTCGGCCCATAATCAGCCCCAGCATTTT	CASSYSAHNQPQHF	TRBV13	TRBJ1-5
TGTGCCAGCAGTTACTCAAAGAGAAGGGAGCAGCCCCAGCATTTT	CASSYSKRREQPQHF	TRBV6-2	TRBJ1-5
TGTGCCAGCAGTTCAGGCGGCTCTGGAAACACCATATATTTT	CASSSGGSGNTIYF	TRBV6-6	TRBJ1-3
TGTGCCAGCAGGGCGGACCCCACCCAGTACTTC	CASRADPTQYF	TRBV2	TRBJ2-5
TGTGCCAGCAGGCCTTGGACTGGTAGAGCCAAAAACATTCAGTACTTC	CASRPWTGRAKNIQYF	TRBV28	TRBJ2-4
TGTGCCAGCAGCCCGGCTCCTATACTGTTTTTT	CASSPAPILFF	TRBV6-4	TRBJ1-4
TGCGCCAGCAGCTCTCTCCACGGGATCTACACAGATACGCAGTATTTT	CASSSLHGIYTDTQYF	TRBV5-1	TRBJ2-3
TGTGCCAGCAGCTTACTTCGGAGCGTCTCGGCCCCCTCCTACGAGCAGTACTTC	CASSLLRSVSAPSYEQYF	TRBV7-4	TRBJ2-7
TGTGCCAAGGGTGGGGACACAAGCAATCAGCCCCAGCATTTT	CAKGGDTSNQPQHF	TRBV27	TRBJ1-5
TGCAGTGCGGAGCTGGACTCGGTCATCGATGGCTATGGCTACACCTTC	CSAELDSVIDGYGYTF	TRBV20-1	TRBJ1-2
TGTGCCAGCAGCTTAACCCGGGGGGGACTAGAAAATCCAGATACGCAGTATTTT	CASSLTRGGLENPDTQYF	TRBV7-3	TRBJ2-3
TGTGCCAGCAGTGCCGGGGCCCGTTTTAGATGTCAGCCCCAGCATTTT	CASSAGARFRCQPQHF	TRBV6-5	TRBJ1-5
TGTGCCACCGGTAGGGACAGAGGTATTCAGTACTTC	CATGRDRGIQYF	TRBV24-1	TRBJ2-4
TGTGCCAGCAGCAAAAAGGGACAGGGGGCCGTCACTGAAGCTTTCTTT	CASSKKGQGAVTEAFF	TRBV11-2	TRBJ1-1
TGTGCCAGCAGCCCAAGGGGCAGGGGCCAAGAGACCCAGTACTTC	CASSPRGRGQETQYF	TRBV3-1	TRBJ2-5
TGTGCCAGCAGAAATGACAGGCCTCATAGCAATCAGCCCCAGCATTTT	CASRNDRPHSNQPQHF	TRBV6-4	TRBJ1-5
TGTGCCAGCAACGGGGGCTACGAGCAGTACTTC	CASNGGYEQYF	TRBV7-7	TRBJ2-7
TGTGCCACCAGTCACTCGAGGGGGCGCGGCCCAGCCACTGAAGCTTTCTTT	CATSHSRGRGPATEAFF	TRBV24-1	TRBJ1-1
TGTGCCAGCAGCCTTGGGGACCCGGAGGGACCTGGGCAGTTCTTC	CASSLGDPEGPGQFF	TRBV9	TRBJ2-1
TGTGCCACAAGGAATCGGGGGGCCACCTTC	CATRNRGATF	TRBV28	TRBJ1-2
TGTGCTAGTGGTTTTCGGGAGAGAAGGAATGAGCAGTTCTTC	CASGFRERRNEQFF	TRBV12-5	TRBJ2-1
TGCGCCAGCACCACAGGATGGGATGGCTACACCTTC	CASTTGWDGYTF	TRBV5-1	TRBJ1-2
TGCGCCAGCAGTGAGCCCCGTACAAGGGCTCACGAGCAGTACTTC	CASSEPRTRAHEQYF	TRBV10-2	TRBJ2-7
TGTGCTAGCAGCCCCGACAGGGAGTTCTACGAGCAGTACTTC	CASSPDREFYEQYF	TRBV7-7	TRBJ2-7
TGTGCCAGCAGCAATTTAAAACATCCGTACGAGCAGTACTTC	CASSNLKHPYEQYF	TRBV7-3	TRBJ2-7
TGTGCCAGCAGCCGGGAGGGCCCCTCCTACAATGAGCAGTTCTTC	CASSREGPSYNEQFF	TRBV13	TRBJ2-1
TGTGCCAGCAGTTTTTCACAGAAAAGAGATGGCTACACCTTC	CASSFSQKRDGYTF	TRBV12-3	TRBJ1-2
TGCGCCAGCAGCCAGAGTACGTTTACTGGGGAGAGCTCCTACAATGAGCAGTTCTTC	CASSQSTFTGESSYNEQFF	TRBV4-1	TRBJ2-1
TGCAGTGCGAGTTATCGGGAACGGAACACCGGGGAGCTGTTTTTT	CSASYRERNTGELFF	TRBV20-1	TRBJ2-2
TGTGCCAGAGAACCCTTC	CAREPF	TRBV9	TRBJ2-7
TGTGCCAGCAGCAACCCCGCCGGACGTAACACCGGGGAGCTGTTTTTT	CASSNPAGRNTGELFF	TRBV14	TRBJ2-2
TGCGCCAGCAGCTGGAAGCTAGCCGGGGAGCTGTTTTTT	CASSWKLAGELFF	TRBV5-1	TRBJ2-2
TGTGCCAGCAACAGACTCAAGTCCACAGATACGCAGTATTTT	CASNRLKSTDTQYF	TRBV6-5	TRBJ2-3
TGTGCCACCAGTGATTTTACCCGGACGGGGACAGGGAACAATCAGCCCCAGCATTTT	CATSDFTRTGTGNNQPQHF	TRBV24-1	TRBJ1-5
TGTGCCAGCAGTTTAGTACTCGTGGAACCCTACGAGCAGTACTTC	CASSLVLVEPYEQYF	TRBV28	TRBJ2-7
TGTGCCAGCAGCTTAGAGCCGGGACAGGGGAGAGATAGCAATCAGCCCCAGCATTTT	CASSLEPGQGRDSNQPQHF	TRBV7-9	TRBJ1-5
TGTGCTAGTGGTTTGGTACCCTTCAGGGTCAGCAATCAGCCCCAGCATTTT	CASGLVPFRVSNQPQHF	TRBV12-5	TRBJ1-5
TGTGCCAGCAGCTTAATCCAGGACGCGGGGTTATTTTACACCGGGGAGCTGTTTTTT	CASSLIQDAGLFYTGELFF	TRBV7-6	TRBJ2-2
TGTGCCAGCACGGGAACCGGACTAGGGAATGAGCAGTTCTTC	CASTGTGLGNEQFF	TRBV6-5	TRBJ2-1
TGCGCCAGCAGTGAGTTTGGAAAGCGAGTCCCGAGGCGACAGGCAAGCGCTAACTATGGCTACACCTTC	CASSEFGKRVPRRQASANYGYTF	TRBV10-2	TRBJ1-2
TGTGCCAGCAGCGTAGAAAGGGGGCTAGGGAACTATGGCTACACCTTC	CASSVERGLGNYGYTF	TRBV9	TRBJ1-2
TGTGCCAGCAGCGTAGCCAGGGACTGGGGGGGCGACTCCGACACCGGGGAGCTGTTTTTT	CASSVARDWGGDSDTGELFF	TRBV9	TRBJ2-2
TGTGCCACCAGTGATCAGGGGCCGGGCAATCAGCCCCAGCATTTT	CATSDQGPGNQPQHF	TRBV24-1	TRBJ1-5
TGTGCCAGTAGACCCGGGACGCGCTGCGACAGCTCCTACGAGCAGTACTTC	CASRPGTRCDSSYEQYF	TRBV19	TRBJ2-7
TGTGCCAGCTCACCAAGCGGGAATCAGGCCGGGGAGCTGTTTTTT	CASSPSGNQAGELFF	TRBV18	TRBJ2-2
TGCGCCAGCAGTGACAGCCTCTACGAGCAGTACTTC	CASSDSLYEQYF	TRBV10-1	TRBJ2-7
TGTGCCAGCCCACGGGACAGGGGAGGGCAATTTGAGCAGTTCTTC	CASPRDRGGQFEQFF	TRBV2	TRBJ2-1
TGTGCCAGCAGTGAAGGGCGAACAGCTTTCTTT	CASSEGRTAFF	TRBV2	TRBJ1-1
TGTGCCAGCAGTTTACGTGGTGGGGGAGACAGCGGGTGCTCTGGAAACACCATATATTTT	CASSLRGGGDSGCSGNTIYF	TRBV12-3	TRBJ1-3
TGCGCCAGCAGCCAAGAACCCCCCCGGGACAGGGGAGGTTGCCCTTATGAGCAGTTCTTC	CASSQEPPRDRGGCPYEQFF	TRBV4-3	TRBJ2-1
TGTGCCAGCACGCTACAGGGAAGGGGCTACACCTTC	CASTLQGRGYTF	TRBV6-1	TRBJ1-2
TGTGCCAGCAGCCTAGCGTCAGGTCTTAATGCGGAGCAGTTCTTC	CASSLASGLNAEQFF	TRBV7-9	TRBJ2-1
TGTGCCAGCAGCTACGAGGCCCAAGAGACCCAGTACTTC	CASSYEAQETQYF	TRBV7-8	TRBJ2-5
TGTGCCAGCAGTTACAGGGAGGACAGGAATCAGCCCCAGCATTTT	CASSYREDRNQPQHF	TRBV6-6	TRBJ1-5
TGTGCCAGCAGCTTAAGGGGGGGGCCAGTCTTAGTCAAAGAGACCCAGTACTTC	CASSLRGGPVLVKETQYF	TRBV11-3	TRBJ2-5
TGTGCCCGAACAGGGGGTACTAATGAAAAACTGTTTTTT	CARTGGTNEKLFF	TRBV27	TRBJ1-4
TGCGCCAGCCCGTCTAAAAAAGAGACCCAGTACTTC	CASPSKKETQYF	TRBV4-1	TRBJ2-5
TGTGCCAGCAGTCGATACATCAGCCTAAGCAATCAGCCCCAGCATTTT	CASSRYISLSNQPQHF	TRBV12-3	TRBJ1-5
TGTGCCAGCAGTTACGGACGGGGCAGGGGTGCAACTAATGAAAAACTGTTTTTT	CASSYGRGRGATNEKLFF	TRBV6-5	TRBJ1-4
TGTGCCAGCAGCGCGGACGAGCAGTACTTC	CASSADEQYF	TRBV7-3	TRBJ2-7
TGTGCCAGCAGCCGATCCTTCCCGCAGGTGAACACTGAAGCTTTCTTT	CASSRSFPQVNTEAFF	TRBV7-2	TRBJ1-1
TGTGCCACCAGTGATTTGGGGAGTAAATCAGACTCTGGAAACACCATATATTTT	CATSDLGSKSDSGNTIYF	TRBV24-1	TRBJ1-3
TGTGCCAGCAGCATATACTGGGGGGGGAATAAGCTTCACGAGCAGTACTTC	CASSIYWGGNKLHEQYF	TRBV13	TRBJ2-7
TGCGCCAGCAGCTTCAGGGGCACAGATACGCAGTATTTT	CASSFRGTDTQYF	TRBV5-1	TRBJ2-3
TGCGCCATACTAGGCCGGGACGTCAGTGGAGGGTGGACTGAAGCTTTCTTT	CAILGRDVSGGWTEAFF	TRBV5-1	TRBJ1-1
TGTGCCAGCAGCTCCTTGACAGGCAAACAGCCCCAGCATTTT	CASSSLTGKQPQHF	TRBV5-8	TRBJ1-5
TGCAGTGCTAGAGACGGCGGAGGCCATAGCAATCAGCCCCAGCATTTT	CSARDGGGHSNQPQHF	TRBV20-1	TRBJ1-5
TGCAGCGCTAGCGACAGGGAGAATTACGAGCAGTACTTC	CSASDRENYEQYF	TRBV29-1	TRBJ2-7
TGTGCCAGCAGCCTTTGGCAGGGTGCTACTGAAGCTTTCTTT	CASSLWQGATEAFF	TRBV7-9	TRBJ1-1
TGTGCCAGCAGTGATGTGAGGGACAGGGACGAGCAGTACTTC	CASSDVRDRDEQYF	TRBV6-4	TRBJ2-7
TGCAGTGCTAGCCGGGGGGGGGGGGACACAGATACGCAGTATTTT	CSASRGGGDTDTQYF	TRBV20-1	TRBJ2-3
TGTGCCATTTGCCCTTTCGAGAATGAGCAGTTCTTC	CAICPFENEQFF	TRBV6-2	TRBJ2-1
TGTGCCAGCAGCCGGAGCGTCAGATCGTACGAGCAGTACTTC	CASSRSVRSYEQYF	TRBV7-2	TRBJ2-7
TGTGCCAGCAGTTTAGAGGGTCCAGGGGGCCTTGTCTTCTACGAGCAGTACTTC	CASSLEGPGGLVFYEQYF	TRBV12-3	TRBJ2-7
TGCAGCGTTGGAGCCAGCTCTGGGGCCAACGTCCTGACTTTC	CSVGASSGANVLTF	TRBV29-1	TRBJ2-6
TGTGCCGTTTGCGGGGACACCATAAAGACCCAGTACTTC	CAVCGDTIKTQYF	TRBV3-1	TRBJ2-5
TGTGCTAGTGGTCACCCGGGACAGGGAAATGGGAACACTGAAGCTTTCTTT	CASGHPGQGNGNTEAFF	TRBV12-5	TRBJ1-1
TGTGCCAGCAGGCGGGTAAATGACAGGGGGGACGGGAACACTGAAGCTTTCTTT	CASRRVNDRGDGNTEAFF	TRBV3-1	TRBJ1-1
TGCAGCGTGTCCGGGACTAGCGGGAGTCCCGGGGAGCTGTTTTTT	CSVSGTSGSPGELFF	TRBV29-1	TRBJ2-2
TGTGCCAGGTGGCTGCTGAAGGACAGTAACTACGAGCAGTACTTC	CARWLLKDSNYEQYF	TRBV7-9	TRBJ2-7
TGCGCCAGCAGTGAGGGGGGGGACTACGAGCAGTACTTC	CASSEGGDYEQYF	TRBV10-1	TRBJ2-7
TGTGCCAGCTCACCAAAAGGGGCGGTAACTGAGCAGTTCTTC	CASSPKGAVTEQFF	TRBV18	TRBJ2-1
TGCAGTGCTCCGGAAACTAGAGATGGGGAGCTGTTTTTT	CSAPETRDGELFF	TRBV20-1	TRBJ2-2
TGTGCCAGCAGCCGCCTAAGGACAGGGGGCTTGTCGGATTCACCCCTCCACTTT	CASSRLRTGGLSDSPLHF	TRBV13	TRBJ1-6
TGTGCCAGGGGGGGGCGGACTGAAGCTTTCTTT	CARGGRTEAFF	TRBV5-6	TRBJ1-1
TGCGCCAGCAGCTTTTGTGGGGGCGCGGCACAAGAGACCCAGTACTTC	CASSFCGGAAQETQYF	TRBV5-1	TRBJ2-5
TGTGCCAGCAGCTTAGTCCAGGGAGAGAACACTGAAGCTTTCTTT	CASSLVQGENTEAFF	TRBV7-9	TRBJ1-1
TGTGCCAGCATTCCGAGCTCCGGGAGTAATCAGCCCCAGCATTTT	CASIPSSGSNQPQHF	TRBV6-3	TRBJ1-5
TGCAGTGCTAGAGATACAGAGTCAGGGGTGATGGGGTGCTACGAGCAGTACTTC	CSARDTESGVMGCYEQYF	TRBV20-1	TRBJ2-7
TGTGCTAGTGGTTTGTCTTGTCCGGGACAGGGCGGAAAACAAGAGACCCAGTACTTC	CASGLSCPGQGGKQETQYF	TRBV12-5	TRBJ2-5
TGTGCCACCAGAGTCTCGGTTTCGGCATCCCAGTACTTC	CATRVSVSASQYF	TRBV24-1	TRBJ2-5
TGTGCCACCCACCGGGACAGGGGGTGCCGGACCGGGGAGCTGTTTTTT	CATHRDRGCRTGELFF	TRBV15	TRBJ2-2
TGCGCCAGCACTAAAGATGAGCAGTTCTTC	CASTKDEQFF	TRBV10-1	TRBJ2-1
TGTGCCAGCACAGCAGTGACTAATGAAAAACTGTTTTTT	CASTAVTNEKLFF	TRBV12-4	TRBJ1-4
TGTGCCATCAGTTGCCCCCCATGGGCCCGTGGTTTGGCTCAGCCCCAGCATTTT	CAISCPPWARGLAQPQHF	TRBV10-3	TRBJ1-5
TGTGCATCCATCCAGTCTCCTATAATAAAAAACATTCAGTACTTC	CASIQSPIIKNIQYF	TRBV28	TRBJ2-4
TGCAGTGCTAGGCCAGGGTCATTCCACTATGGCTACACCTTC	CSARPGSFHYGYTF	TRBV20-1	TRBJ1-2
TGCGCCAGCATGGGTTGGGGGGTCAATCAGCCCCAGCATTTT	CASMGWGVNQPQHF	TRBV4-3	TRBJ1-5
TGTGCCAGCAGCATATCCTACGAAAAACTGTTTTTT	CASSISYEKLFF	TRBV12-3	TRBJ1-4
TGTGCCAGCAGTTCCGGGCCGGCCTACGAGCAGTACTTC	CASSSGPAYEQYF	TRBV6-5	TRBJ2-7
TGTGCCTGGAGTTGTTCCGGGACAGCGGGGGCTGAAGCTTTCTTT	CAWSCSGTAGAEAFF	TRBV30	TRBJ1-1
TGTGCCAGCAGCAACACGTACCCTGGGGGGGAATACGAGCAGTACTTC	CASSNTYPGGEYEQYF	TRBV7-3	TRBJ2-7
TGTGCCAGCAGTTTATCGCCCTCCGAATCCCACTACGAGCAGTACTTC	CASSLSPSESHYEQYF	TRBV27	TRBJ2-7
TGCGCCAGGCTAGCGGGGGACAGCACAGATACGCAGTATTTT	CARLAGDSTDTQYF	TRBV5-1	TRBJ2-3
TGTGCCAGCAGCTTCTTCCAGATTGTCTACGAGCAGTACTTC	CASSFFQIVYEQYF	TRBV5-8	TRBJ2-7
TGTGCCAGCAGCCAATATAGAACCAGGAAGGTCACCCGGCCACCCCTCCACTTT	CASSQYRTRKVTRPPLHF	TRBV7-3	TRBJ1-6
TGTGCCGGCAGGGACCCCAACACCGGGGAGCTGTTTTTT	CAGRDPNTGELFF	TRBV10-3	TRBJ2-2
TGCGCCAGCAGCTATGTTATCAGGAGCCCCGGGACAGGGGGCTTAGGTTCTCATCAGCCCCAGCATTTT	CASSYVIRSPGTGGLGSHQPQHF	TRBV5-1	TRBJ1-5
TGCGCCAGCAGCTTTCCCCCTTGTGGGGGGGATACGCAGTATTTT	CASSFPPCGGDTQYF	TRBV5-1	TRBJ2-3
TGCAGTGCTCAAGGCAGGGGGTCTAACTATGGCTACACCTTC	CSAQGRGSNYGYTF	TRBV20-1	TRBJ1-2
TGCAGTGCTGACCACCGGGTGGGACAGGGGGCGCGCAGTTTTGAGACCCAGTACTTC	CSADHRVGQGARSFETQYF	TRBV20-1	TRBJ2-5
TGCAGTGCTAGCTGGGGGAAAGCTTTCTTT	CSASWGKAFF	TRBV20-1	TRBJ1-1
TGTGCCAGCAGTGAACTAGGTACGGAAGGGACACCTACCTATAATTCACCCCTCCACTTT	CASSELGTEGTPTYNSPLHF	TRBV6-1	TRBJ1-6
TGTGCCAGCAGGGTAAGAAGGGTTAATGCTCTAGAGACCCAGTACTTC	CASRVRRVNALETQYF	TRBV7-6	TRBJ2-5
TGTGCCACCAGCAGAGTCCTGGACGCCTACGAGCAGTACTTC	CATSRVLDAYEQYF	TRBV15	TRBJ2-7
TGCGCCAGCAGTGCACACAAAGGCTATGGCTACACCTTC	CASSAHKGYGYTF	TRBV10-1	TRBJ1-2
TGCGCCAGCAGCTTGGAGAATGAGAGCTCCTATAATTCACCCCTCCACTTT	CASSLENESSYNSPLHF	TRBV5-1	TRBJ1-6
TGCGCCAGCAGCCTTCGACAGGGGATATACGAGCAGTACTTC	CASSLRQGIYEQYF	TRBV4-1	TRBJ2-7
TGCGCCAGCAGCCAAGATGGACGGCAGAATCAGCCCCAGCATTTT	CASSQDGRQNQPQHF	TRBV5-1	TRBJ1-5
TGTGCCAGCAGTTCAGCACTAGGCTACGAGCAGTACTTC	CASSSALGYEQYF	TRBV27	TRBJ2-7
TGTGCCAGCAGCACCTTAACTGGACAGGGGGGGGAGGTGTATGGCTACACCTTC	CASSTLTGQGGEVYGYTF	TRBV6-4	TRBJ1-2
TGTGCCAGCTCACCACTTCCGGGACTGAGCACAGATACGCAGTATTTT	CASSPLPGLSTDTQYF	TRBV18	TRBJ2-3
TGTGCTAGTGGCAACCGACTGCTGGTACTATATGGCTACACCTTC	CASGNRLLVLYGYTF	TRBV12-5	TRBJ1-2
TGTGCCAGCAGCTTACTTGACAGGTGTCGCAAAAACATTCAGTACTTC	CASSLLDRCRKNIQYF	TRBV11-2	TRBJ2-4
TGCAGCGTTGAGGGCCAGAGGGGCCCTAACGAGCAGTACTTC	CSVEGQRGPNEQYF	TRBV29-1	TRBJ2-7
TGTGCCAGATATGGGACTAGCAAGACACCCACTGAAGAGACCCAGTACTTC	CARYGTSKTPTEETQYF	TRBV5-4	TRBJ2-5
TGTGCCAGCAGTTCCCTGGGACAGCGCTCCTACGAGCAGTACTTC	CASSSLGQRSYEQYF	TRBV27	TRBJ2-7
TGTGCCAGCAGCCAAGATTACACAGGGCTGGGTTTTGGAAACACCATATATTTT	CASSQDYTGLGFGNTIYF	TRBV14	TRBJ1-3
TGTGCCTGGCGGGCCAGGGGGCCGGGCTCACCCCTCCACTTT	CAWRARGPGSPLHF	TRBV6-5	TRBJ1-6
TGTGCCAGCACGGGCCAGTATGAAAAACTGTTTTTT	CASTGQYEKLFF	TRBV9	TRBJ1-4
TGTGCCAGCAGTGTACCGGGGAGGAAAGCAGATACGCAGTATTTT	CASSVPGRKADTQYF	TRBV6-1	TRBJ2-3
TGTGCCACCGAGCCCCGGGGCGGGAGGGCCAAGGGCTACGAGCAGTACTTC	CATEPRGGRAKGYEQYF	TRBV11-2	TRBJ2-7
TGTGCCAGCAGGCACCCCCCAGGGGGTCCCCAGCATTTT	CASRHPPGGPQHF	TRBV6-4	TRBJ1-5
TGTGCCACCACGGTCTTTGAAAGGGGGAGGACAGGGTATCGGAAAGTCGAGCAGTACTTC	CATTVFERGRTGYRKVEQYF	TRBV24-1	TRBJ2-7
TGTGCCAGCAGCCGACCGATAACAGGGACAGAGACCCAGTACTTC	CASSRPITGTETQYF	TRBV5-5	TRBJ2-5
TGCGCCAGCAGCCCAGGGAACAATGAGCAGTTCTTC	CASSPGNNEQFF	TRBV10-1	TRBJ2-1
TGTGCCAGCAGCCAAGAGGCTCCAGGGCTGGGGACCTATGGCTACACCTTC	CASSQEAPGLGTYGYTF	TRBV3-1	TRBJ1-2
TGTGCCAGTACTTGGGGGGGGGAACCTAGCACAGATACGCAGTATTTT	CASTWGGEPSTDTQYF	TRBV6-2	TRBJ2-3
TGTGCCAGTAGTGGAGACAGAGAAGGGGCCAACGTCCTGACTTTC	CASSGDREGANVLTF	TRBV19	TRBJ2-6
TGTGCCAGCAGTTTAGCGCAGGGACTAGGTCCTAATGGGTCACCCCTCCACTTT	CASSLAQGLGPNGSPLHF	TRBV12-4	TRBJ1-6
TGTGCCAGCAGCGGGCGGGACTGGAGGGGAAAGCCCCAGCATTTT	CASSGRDWRGKPQHF	TRBV7-3	TRBJ1-5
TGTGCCAGTACGGGGGGGCCCTCCTACGAGCAGTACTTC	CASTGGPSYEQYF	TRBV19	TRBJ2-7
TGCAGCGTTGGAGGGACCGAACCCAGGCGAAACTATGGCTACACCTTC	CSVGGTEPRRNYGYTF	TRBV29-1	TRBJ1-2
TGTGCCAGCAGCAGTCGACTGCACGTTCTTTCTGGCTACACCTTC	CASSSRLHVLSGYTF	TRBV6-4	TRBJ1-2
TGCGCCAGCAGCTTGTGGCTCACAGGGGGCTTTTTATCCTACAATGAGCAGTTCTTC	CASSLWLTGGFLSYNEQFF	TRBV5-1	TRBJ2-1
TGTGCCAGCAGCATCGGCTTTGTATCTGAACTCGGGGCAGATACGCAGTATTTT	CASSIGFVSELGADTQYF	TRBV7-2	TRBJ2-3
TGCGCCAGCAGCCTAGGAGGGAACTCGGAGTATGGCTACACCTTC	CASSLGGNSEYGYTF	TRBV5-1	TRBJ1-2
TGTGCCAGCAGCGGGGAGGGATACGAGCAGTACTTC	CASSGEGYEQYF	TRBV13	TRBJ2-7
TGTGCCACCAACAGCCCCCTGAGGGCCTACGAGCAGTACTTC	CATNSPLRAYEQYF	TRBV24-1	TRBJ2-7
TGTGCCAGCAGCTGGACTAGCGGGGGACCCGGTAGCTCCTACAATGAGCAGTTCTTC	CASSWTSGGPGSSYNEQFF	TRBV11-1	TRBJ2-1
TGTGCCAGCACGGACCCGGACAGCAATCAGCCCCAGCATTTT	CASTDPDSNQPQHF	TRBV6-8	TRBJ1-5
TGCGCCAGCAGCTGTCATAGCGGGGACCACGAGCAGTACTTC	CASSCHSGDHEQYF	TRBV5-1	TRBJ2-7
TGTGCCAGCAGCTTGCTGCTGTGGGGGACTCGGCACTCTATGAACACTGAAGCTTTCTTT	CASSLLLWGTRHSMNTEAFF	TRBV5-6	TRBJ1-1
TGTGCCAGCAGTGGCCCCCCCGGGACAGGGGAGTTCGAGCAGTACTTC	CASSGPPGTGEFEQYF	TRBV28	TRBJ2-7
TGCAGTGCTAACCTTGTACTAGCGGGAGAACCAGCCTACGAGCAGTACTTC	CSANLVLAGEPAYEQYF	TRBV20-1	TRBJ2-7
TGTGCCAGCAGCCAAGGTACCCACGGGGGTGGACGGCAAGAGACCCAGTACTTC	CASSQGTHGGGRQETQYF	TRBV3-1	TRBJ2-5
TGTGCCAGTAGTATGGCAGGGGTTAGCTACGAGCAGTACTTC	CASSMAGVSYEQYF	TRBV19	TRBJ2-7
TGCGCCAGCAGCTCCGGGGACTGCTATGGCTACACCTTC	CASSSGDCYGYTF	TRBV5-1	TRBJ1-2
TGCGCCAGCAGCCAAGCAGGGACAGGGGGGGGCTACACCTTC	CASSQAGTGGGYTF	TRBV4-1	TRBJ1-2
TGTGCCAGCAGGTTCTCGAACAGGGTAGAGGCATCACAGCCCCAGCATTTT	CASRFSNRVEASQPQHF	TRBV6-2	TRBJ1-5
TGCGCCAGCAGCTTTACTAGCGGGAGCGAATCTGGGGCCAACGTCCTGACTTTC	CASSFTSGSESGANVLTF	TRBV5-1	TRBJ2-6
TGTGCCAGCAGTGACCCGGGGGGCTACACCTTC	CASSDPGGYTF	TRBV25-1	TRBJ1-2
TGTGCCACCAGCAGAGAAAAACGAGGGGGCCGAGGCTACGAGCAGTACTTC	CATSREKRGGRGYEQYF	TRBV15	TRBJ2-7
TGTGCCAGCAGCTTGTGGACAGGGGTCACTGGGGAGCAGTACTTC	CASSLWTGVTGEQYF	TRBV5-6	TRBJ2-7
TGTGCCAGCAGTTTGCATCTGGCAGGATTGTATGAGCAGTTCTTC	CASSLHLAGLYEQFF	TRBV27	TRBJ2-1
TGTGCCAGCAGCGGGGAACCGGGACAGGGGGTTGGGGATGACAATGAGCAGTTCTTC	CASSGEPGQGVGDDNEQFF	TRBV7-3	TRBJ2-1
TGCGCCAGCAGGAGTCCACAGGGCGGGAGGCAGTACTTC	CASRSPQGGRQYF	TRBV10-1	TRBJ2-7
TGCGCCAGGGAACGGGGGGAAAGCTATGGCTACACCTTC	CARERGESYGYTF	TRBV10-1	TRBJ1-2
TGCAGTGCTAACTGGAGCTCCTACAATGAGCAGTTCTTC	CSANWSSYNEQFF	TRBV20-1	TRBJ2-1
TGTGCCAGCAGTTGGCATCCGGTTGAGCAGTACTTC	CASSWHPVEQYF	TRBV28	TRBJ2-7
TGTGCCAGCAGTCCGGGACAGAGAGGGTGCCGCGGGGAGCTGTTTTTT	CASSPGQRGCRGELFF	TRBV6-4	TRBJ2-2
TGTGCCAGCAGCGCAGACGGCTGGCTCACAGATACGCAGTATTTT	CASSADGWLTDTQYF	TRBV13	TRBJ2-3
TGCAGTGCTAGAGGACGACGGAGCTACAATGAGCAGTTCTTC	CSARGRRSYNEQFF	TRBV20-1	TRBJ2-1
TGTGCCAGCAGTGTCAGGGCAGATACGCAGTATTTT	CASSVRADTQYF	TRBV6-1	TRBJ2-3
TGTGCCAGCAGCCGTCGAATTATCAGTAAATTCAGCACAGATACGCAGTATTTT	CASSRRIISKFSTDTQYF	TRBV4-2	TRBJ2-3
TGTGCCTGGGGTCGGGATCCTCCCGCGCGGGAGAAGGCCAAAAACATTCAGTACTTC	CAWGRDPPAREKAKNIQYF	TRBV30	TRBJ2-4
TGTGCCAGCAGCGTAGCTCCGGGACTAGCCAATGAGCAGTTCTTC	CASSVAPGLANEQFF	TRBV9	TRBJ2-1
TGTGCCAGCAGCCCGACTTCAGGGCAAACCTACGAGCAGTACTTC	CASSPTSGQTYEQYF	TRBV7-9	TRBJ2-7
TGTGCCAGCATTAGGGGCGAGGGGAACTATGGCTACACCTTC	CASIRGEGNYGYTF	TRBV27	TRBJ1-2
TGTGCTAGTGGTTTGGTACAATATCGGACAGGGTTGAACACCGGGGAGCTGTTTTTT	CASGLVQYRTGLNTGELFF	TRBV12-5	TRBJ2-2
TGCAGTATCAATCCCGAGGGCCGATTGATTGAGCAGTACTTC	CSINPEGRLIEQYF	TRBV20-1	TRBJ2-7
TGCGCCAGCAGCTTGGGAGCTACGCAGTATTTT	CASSLGATQYF	TRBV5-1	TRBJ2-3
TGTGCCAGCAGCTTCGGGGGCGCTCAGCCCCAGCATTTT	CASSFGGAQPQHF	TRBV7-3	TRBJ1-5
TGCGCCAGCAGCCGACGCGGCATGAACACTGAAGCTTTCTTT	CASSRRGMNTEAFF	TRBV4-3	TRBJ1-1
TGTGCCAGCTCACAGACCCAGCCTAGCGGCAAGTACAATGAGCAGTTCTTC	CASSQTQPSGKYNEQFF	TRBV18	TRBJ2-1
TGCGCCAGCAGCGGGGCTCAGCCCCAGCATTTT	CASSGAQPQHF	TRBV5-1	TRBJ1-5
TGTGCCAGTAGTCGCAGGGTGGCGCTCTACGAGCAGTACTTC	CASSRRVALYEQYF	TRBV19	TRBJ2-7
TGTGCCTTACGCAGGGGGCGGAACACTGAAGCTTTCTTT	CALRRGRNTEAFF	TRBV10-3	TRBJ1-1
TGCGCCAGCAGTGATTTCGCGGGAGACGAGCAGTACTTC	CASSDFAGDEQYF	TRBV10-1	TRBJ2-7
TGTGCCACCTCTGGGAGGATCTACGAGCAGTACTTC	CATSGRIYEQYF	TRBV24-1	TRBJ2-7
TGTGCCAGCAGTTTGCTCCGCGGGAGGAGGGAAGGTGAGCAGTTCTTC	CASSLLRGRREGEQFF	TRBV28	TRBJ2-1
TGTGCCAGCAGCCTCGGGGGGGGCTATGGGCGGACAGATACGCAGTATTTT	CASSLGGGYGRTDTQYF	TRBV5-8	TRBJ2-3
TGCGCCAGCAGCCAAGAGGTAGGGAGGGGGGGTGAGGAGCAGTACTTC	CASSQEVGRGGEEQYF	TRBV4-1	TRBJ2-7
TGTGCCAGCAGCCCGGAAAGGGAACCCTACGAGCAGTACTTC	CASSPEREPYEQYF	TRBV7-9	TRBJ2-7
TGTGCCATCAGTGGCGGGGAGGGGGAAGCTTTCTTT	CAISGGEGEAFF	TRBV10-3	TRBJ1-1
TGTGCCAGCAGTTACCATAACAGGGGGCGCGGCTACACCTTC	CASSYHNRGRGYTF	TRBV6-2	TRBJ1-2
TGTGCCAGCAGCTGGACTAATGAAAAACTGTTTTTT	CASSWTNEKLFF	TRBV13	TRBJ1-4
TGCGCCAGCAGCTGTTCCCCAGATATCGATGGCTACACCTTC	CASSCSPDIDGYTF	TRBV5-1	TRBJ1-2
TGTGCCAGAGCGGTGGAGACCCAGTACTTC	CARAVETQYF	TRBV6-6	TRBJ2-5
TGCAGTGCCCATAGCGGGATCGAAGGCTGGAATTCCTACGAGCAGTACTTC	CSAHSGIEGWNSYEQYF	TRBV20-1	TRBJ2-7
TGTGCCACCAGTGATCACCATAGCGGGAGCGGAGACAATGAGCAGTTCTTC	CATSDHHSGSGDNEQFF	TRBV24-1	TRBJ2-1
TGTGCCAGCTGTCCCGGGACTGATCCAGGGTTGTCCTACGAGCAGTACTTC	CASCPGTDPGLSYEQYF	TRBV6-4	TRBJ2-7
TGCAGCGCCCTAAGAGAAAAACTGTTTTTT	CSALREKLFF	TRBV29-1	TRBJ1-4
TGTGCCAGCCTAGTTCCCGGGGAGCTGTTTTTT	CASLVPGELFF	TRBV18	TRBJ2-2
TGTGCCAGCAGCCAAGATCCCCCAGGGGCCCAAGAGACCCAGTACTTC	CASSQDPPGAQETQYF	TRBV14	TRBJ2-5
TGTGCCAGCAGATCGTCAGGGGGCGTCAAAGCTTTCTTT	CASRSSGGVKAFF	TRBV12-4	TRBJ1-1
TGTGCCAGCAGCGGGGAGCTGGGGGACAGGGGATGTCCAGCGACTCGGGGCTACACCTTC	CASSGELGDRGCPATRGYTF	TRBV7-3	TRBJ1-2
TGTGCCAGCAGGACAGGGGGAGACATATATTTT	CASRTGGDIYF	TRBV6-5	TRBJ1-3
TGCAGTGCTAGTCCCGGCATTGCCTACGAGCAGTACTTC	CSASPGIAYEQYF	TRBV20-1	TRBJ2-7
TGTGGGGTTGCGGACACCGAGGACTATGGCTACACCTTC	CGVADTEDYGYTF	TRBV28	TRBJ1-2
TGTGCCAGCAGCTTTGATCGTACGGAGGCGGGAGGCACAGATACGCAGTATTTT	CASSFDRTEAGGTDTQYF	TRBV7-2	TRBJ2-3
TGTGCCAGCAGACCGGGCATGACAGTGAATTACACTGAAGCTTTCTTT	CASRPGMTVNYTEAFF	TRBV6-5	TRBJ1-1
TGTGCCAGCAGGCAGGGGCACTCTGGAAACACCATATATTTT	CASRQGHSGNTIYF	TRBV5-6	TRBJ1-3
TGTGCCAGCAGTTCCCTTCCACCATTAGTTCGTGTGAGTAAGCCGGGAAACACCATATATTTT	CASSSLPPLVRVSKPGNTIYF	TRBV12-4	TRBJ1-3
TGCAGTGCTAGGACAGGGAACCAGACGAACACTGAAGCTTTCTTT	CSARTGNQTNTEAFF	TRBV20-1	TRBJ1-1
TGTGCCAGCAGCTTAGTTAGGACAGGGGGCGGGGGGGCCCAGCATTTT	CASSLVRTGGGGAQHF	TRBV7-9	TRBJ1-5
TGTGCCACCAGCAGAACCGGGGTGTTTGATGAAAAACTGTTTTTT	CATSRTGVFDEKLFF	TRBV15	TRBJ1-4
TGTGCCAGCAATCCCGACTACGAGCAGTACTTC	CASNPDYEQYF	TRBV6-1	TRBJ2-7
TGTGCCAGCAGTTTTGATTGCGGGGGGGCCTTCCTGGGAGAGACCCAGTACTTC	CASSFDCGGAFLGETQYF	TRBV27	TRBJ2-5
TGTGCCAGCAGCGTCCCAAGCGGGAGCCGCTATGGCTACACCTTC	CASSVPSGSRYGYTF	TRBV7-4	TRBJ1-2
TGTGCCAGCACGACCCGGGTACGGGGCTATGGCTACACCTTC	CASTTRVRGYGYTF	TRBV2	TRBJ1-2
TGTGCCAGCAGCGACTTCGGAGCCGAAGGGGGGCGCCGCAAGGAGACCTATGGCTACACCTTC	CASSDFGAEGGRRKETYGYTF	TRBV7-3	TRBJ1-2
TGTGCCAGCAGCAGGGTCCGCGCGGGGGACAATGAGCAGTTCTTC	CASSRVRAGDNEQFF	TRBV11-2	TRBJ2-1
TGTGCCAGCTTCAGCACGGGCGAGGGGGAGGGTTACGAGCAGTACTTC	CASFSTGEGEGYEQYF	TRBV6-1	TRBJ2-7
TGTGCCAGCAGCGTGGGGGAGGACAGGGGCGTCAACTATGGCTACACCTTC	CASSVGEDRGVNYGYTF	TRBV3-1	TRBJ1-2
TGTGCCAGCAGCAGACGTATTCGAAGGGCCGAGTATTTT	CASSRRIRRAEYF	TRBV3-1	TRBJ2-3
TGTGCCAGCAGTGCCAGCCCGGAAAAACTGTTTTTT	CASSASPEKLFF	TRBV6-1	TRBJ1-4
TGTGCCAGCAGGAAGGACAGTTCCTACGAGCAGTACTTC	CASRKDSSYEQYF	TRBV6-1	TRBJ2-7
TGTGCCAGCTCACGAGCCGGGACAGGGGCCGAGCAGTACTTC	CASSRAGTGAEQYF	TRBV18	TRBJ2-7
TGTGCCAGCAGCAGCGGGAGAGTGAACACTGAAGCTTTCTTT	CASSSGRVNTEAFF	TRBV9	TRBJ1-1
TGCGCCAGCAGTGAGAAACCGACAGGTTCCCTCCTAAATCAGCCCCAGCATTTT	CASSEKPTGSLLNQPQHF	TRBV10-1	TRBJ1-5
TGTGCCAGCAGCCTAAACATACGCTGTCCCAACACCGGGGAGCTGTTTTTT	CASSLNIRCPNTGELFF	TRBV7-3	TRBJ2-2
TGTGCCAGCAGTCCCGGGTTTACCGCCTACGAGCAGTACTTC	CASSPGFTAYEQYF	TRBV11-3	TRBJ2-7
TGTGCCAGCAGTTTGCCTCGGGGGATCCAGTGTGGCTACACCTTC	CASSLPRGIQCGYTF	TRBV27	TRBJ1-2
TGTGCCAGCAGTCCTGAGCAGGGGAACGAGCAGTACTTC	CASSPEQGNEQYF	TRBV27	TRBJ2-7
TGTGCCAGCAGCGAGGTGACGCGAAACTACGAGCAGTACTTC	CASSEVTRNYEQYF	TRBV7-3	TRBJ2-7
TGCAGCGTTGAATGGGGGGCCCCCTATGGCTACACCTTC	CSVEWGAPYGYTF	TRBV29-1	TRBJ1-2
TGTGCCAGCAGCTTAGGTGAGTACGAGCAGTACTTC	CASSLGEYEQYF	TRBV11-3	TRBJ2-7
TGTGCCAGCCCGAGGGACTCCGAGCAGTACTTC	CASPRDSEQYF	TRBV27	TRBJ2-7
TGCGCCAGGTGGGACAGGGGTAGTTACGAGCAGTACTTC	CARWDRGSYEQYF	TRBV10-1	TRBJ2-7
TGTGCCAGCAGCCCCTGGACAGGGGACAATGAGCAGTTCTTC	CASSPWTGDNEQFF	TRBV4-2	TRBJ2-1
TGTGCCAGCAGTGGCCGTAGGGGTAGGAATGAAAAACTGTTTTTT	CASSGRRGRNEKLFF	TRBV6-1	TRBJ1-4
TGTGCCACCAGTGTGGGGCTGATCAAAAACATTCAGTACTTC	CATSVGLIKNIQYF	TRBV24-1	TRBJ2-4
TGTGCCAGCAGCTTAGCGCAGACGGGGGGCTACGAGTACAATGAGCAGTTCTTC	CASSLAQTGGYEYNEQFF	TRBV7-8	TRBJ2-1
TGCAGTGCACTCCTCTATTGCTCCTACGAGCAGTACTTC	CSALLYCSYEQYF	TRBV20-1	TRBJ2-7
TGCGCCAGCCGCAAAGGGTGTGGGAACACCATATATTTT	CASRKGCGNTIYF	TRBV5-1	TRBJ1-3
TGTGCCAGCAACTCCCCGGGACAGGGGGCTCTTCAAGCTTTCTTT	CASNSPGQGALQAFF	TRBV12-3	TRBJ1-1
TGCGCCAGCAGCAAGGTGGGGGCGCCACGTAACTATGGCTACACCTTC	CASSKVGAPRNYGYTF	TRBV5-1	TRBJ1-2
TGTGCCAGCCGTATCGGAATCGGACATCATACAGATACGCAGTATTTT	CASRIGIGHHTDTQYF	TRBV6-4	TRBJ2-3
TGTGCCAGCAGTAGGCGGACAGGGGTTATGAACACTGAAGCTTTCTTT	CASSRRTGVMNTEAFF	TRBV6-1	TRBJ1-1
TGCGCCAGCAGCTTGGCCTTGGTGTCCGCAGCCAGTGGCTACGAGCAGTACTTC	CASSLALVSAASGYEQYF	TRBV5-1	TRBJ2-7
TGTGCCAGCAGCTACCACGATTCACCCCTCCACTTT	CASSYHDSPLHF	TRBV5-6	TRBJ1-6
TGTGCCAATGAGGCGGGGAATGAGCAGTTCTTC	CANEAGNEQFF	TRBV6-4	TRBJ2-1
TGCAGTGCTAGAGCCCGGGGTACGATCGGCACCGGGGAGCTGTTTTTT	CSARARGTIGTGELFF	TRBV20-1	TRBJ2-2
TGTGCCAGCAGCTTATTACTTAGGGCTTGCTATGGCTACACCTTC	CASSLLLRACYGYTF	TRBV7-6	TRBJ1-2
TGTGCCAGCATCCCAAGTGAATTCTTC	CASIPSEFF	TRBV7-9	TRBJ2-1
TGTGCCAGTAGTAGTCCCCCGCAGGGGGCGTTTGTACGGGTCGAAAAACTGTTTTTT	CASSSPPQGAFVRVEKLFF	TRBV19	TRBJ1-4
TGCGCCAGCCCTCGGGTGGACGAGCAGTACTTC	CASPRVDEQYF	TRBV5-1	TRBJ2-7
TGTGCCAGCAGTGAAGCGCGAGACAAGAGCCCTCCGGGACTAGGCATCTCCTACAATGAGCAGTTCTTC	CASSEARDKSPPGLGISYNEQFF	TRBV6-1	TRBJ2-1
TGTGCCAGCAGCTTACCATACAGAAGGTACGAGCAGTACTTC	CASSLPYRRYEQYF	TRBV7-3	TRBJ2-7
TGTGCCAGCAGGGGACAGGGGGCCCGCTATGGCTACACCTTC	CASRGQGARYGYTF	TRBV6-1	TRBJ1-2
TGTGCCAGCTGCTCCGGGACAGGGGGCTTGTCGGGCATGAACACTGAAGCTTTCTTT	CASCSGTGGLSGMNTEAFF	TRBV7-2	TRBJ1-1
TGTGCCAGCCCCCCGTACGGACCCGACGTAAACACTGAAGCTTTCTTT	CASPPYGPDVNTEAFF	TRBV6-1	TRBJ1-1
TGTGCCAGCAGCGTCGAGAGTCGGGGGCCCCAGGGGAAGGGACTTACGAACACCGGGGAGCTGTTTTTT	CASSVESRGPQGKGLTNTGELFF	TRBV7-2	TRBJ2-2
TGTGCCAGCAGTGAGCCCGCCTGGGGATCTAACTATGGCTACACCTTC	CASSEPAWGSNYGYTF	TRBV6-5	TRBJ1-2
TGCGCCACCCGGGATGGACAGGGCCGAGGCGTCGGAAATGAAAAACTGTTTTTT	CATRDGQGRGVGNEKLFF	TRBV5-1	TRBJ1-4
TGTGCCAGCAGGGTCGGTGAAGCTTTCTTT	CASRVGEAFF	TRBV6-1	TRBJ1-1
TGCAGTGCTACAGGCAATAATGAAAAACTGTTTTTT	CSATGNNEKLFF	TRBV20-1	TRBJ1-4
TGTGCCAGCAGTTACCCAAGGGGGACAGTCAACACCGGGGAGCTGTTTTTT	CASSYPRGTVNTGELFF	TRBV6-5	TRBJ2-2
TGTGCCAGCAGCTTGTCAGACTATCTCTACGAGCAGTACTTC	CASSLSDYLYEQYF	TRBV5-6	TRBJ2-7
TGTGCCAGCAGTTACTCCGGTCGTACTAGCGGGAGGAACTCCTACGAGCAGTACTTC	CASSYSGRTSGRNSYEQYF	TRBV6-5	TRBJ2-7
TGCAGTGCTAGTAACCAGGTTGGGGCCAACGTCCTGACTTTC	CSASNQVGANVLTF	TRBV20-1	TRBJ2-6
TGCGCCAGCAGCTATAGGCAGGGGAGGGACGCAGGCTCCGAGCAGTACTTC	CASSYRQGRDAGSEQYF	TRBV5-1	TRBJ2-7
TGTGCCAGCAGGAAACGGACCGGTGGCGAGGGAGGAATAGGTGGCTATGGCTACACCTTC	CASRKRTGGEGGIGGYGYTF	TRBV6-5	TRBJ1-2
TGTGCCACCAGAGGAGGGATCAATCAGCCCCAGCATTTT	CATRGGINQPQHF	TRBV24-1	TRBJ1-5
TGTGCCAGCAGCAATAGGATTAATGAAAAACTGTTTTTT	CASSNRINEKLFF	TRBV7-4	TRBJ1-4
TGTGCCAGCAGTTTCTACAGGGGGCGCGGGGAGCTGTTTTTT	CASSFYRGRGELFF	TRBV12-4	TRBJ2-2
TGTGCCAGCAGCAAGGGGGAGGAGAACACCGGGGAGCTGTTTTTT	CASSKGEENTGELFF	TRBV7-2	TRBJ2-2
TGTGCCAGCAGCCAAGAAGAAGGACAAGAGGCCTATGGCTACACCTTC	CASSQEEGQEAYGYTF	TRBV3-1	TRBJ1-2
TGTGCCAGCAGTTACACTACAGATGTCGGGACAATCACTGAAGCTTTCTTT	CASSYTTDVGTITEAFF	TRBV6-5	TRBJ1-1
TGCAGTGCTAGAGATCCGCAGAGGGACAGGGATTCACCCCTCCACTTT	CSARDPQRDRDSPLHF	TRBV20-1	TRBJ1-6
TGCCGAAAAGACTTC	CRKDF	TRBV20-1	TRBJ2-7
TGTGCCAGTACAGGGTTCTCCTACGAGCAGTACTTC	CASTGFSYEQYF	TRBV27	TRBJ2-7
TGTGCCAGCAGTTTACGGCGCCAGGGGATCGAAGTGACCACAGATACGCAGTATTTT	CASSLRRQGIEVTTDTQYF	TRBV12-4	TRBJ2-3
TGTGCCAGCAGCTGTCAGACAACCGGAAGGAATCAGCCCCAGCATTTT	CASSCQTTGRNQPQHF	TRBV7-7	TRBJ1-5
TGTGCCAGCAGTCCGCCGCCTTCACAGGGGGCTCAGCCCCAGCATTTT	CASSPPPSQGAQPQHF	TRBV11-3	TRBJ1-5
TGTGCCAGCTGGACAGAGGCTAACTATGGCTACACCTTC	CASWTEANYGYTF	TRBV6-1	TRBJ1-2
TGTGCCAGCAGTTGGTCAGGGGAGGTCTACGAGCAGTACTTC	CASSWSGEVYEQYF	TRBV28	TRBJ2-7
TGTGCCAGCAGCAGGTCCCCCGGACAGTATCAGCCCCAGCATTTT	CASSRSPGQYQPQHF	TRBV7-9	TRBJ1-5
TGCGCCAGCAGCGAGGGGGAAAAACTGTTTTTT	CASSEGEKLFF	TRBV5-1	TRBJ1-4
TGCAGTGCTAGAGATCCCAGAGACACCGGGGAGCTGTTTTTT	CSARDPRDTGELFF	TRBV20-1	TRBJ2-2
TGTGCCACCAGTGGCGTAGCGGGAGATATGGTGACCGGGGAGCTGTTTTTT	CATSGVAGDMVTGELFF	TRBV24-1	TRBJ2-2
TGTGCCAGCAGTTTATATATACCTAGGGGGCACTATGGCTACACCTTC	CASSLYIPRGHYGYTF	TRBV27	TRBJ1-2
TGTGCCAGCAGTTTTAGACCCTGCTACGAGCAGTACTTC	CASSFRPCYEQYF	TRBV28	TRBJ2-7
TGTGCCAGCAAGAGGGAGGGGGGTGTCCCGAACACCGGGGAGCTGTTTTTT	CASKREGGVPNTGELFF	TRBV6-3	TRBJ2-2
TGTGCCAGCAGCAAAAAGGGGTACAATCAGCCCCAGCATTTT	CASSKKGYNQPQHF	TRBV7-2	TRBJ1-5
TGTGCCAGCTGTATGTTTCCGGGACAGGGGGGGGATAATTCACCCCTCCACTTT	CASCMFPGQGGDNSPLHF	TRBV11-3	TRBJ1-6
TGTGCCAGTAGTCCCCCCCCTCGAGACAGCCCCTACTCTGGAAACACCATATATTTT	CASSPPPRDSPYSGNTIYF	TRBV19	TRBJ1-3
TGTGCCGCCAGGGCCTATAACTATGGCTACACCTTC	CAARAYNYGYTF	TRBV11-2	TRBJ1-2
TGTGCCAGCTCACCCCGGGACAGCGCCCTCCACTTT	CASSPRDSALHF	TRBV18	TRBJ1-6
TGCAGTGCTAGAGAGGCCCCGGCAAAGGACACTGAAGCTTTCTTT	CSAREAPAKDTEAFF	TRBV20-1	TRBJ1-1
TGTGCCATCAGTGGCGACAGGGGATGCAATCAGCCCCAGCATTTT	CAISGDRGCNQPQHF	TRBV10-3	TRBJ1-5
TGTGCCAGCAGTTACCACGTACAGGCGAGATACGGAGGGGACTTAAGAGAGACCCAGTACTTC	CASSYHVQARYGGDLRETQYF	TRBV6-5	TRBJ2-5
TGTGCCAGCAGCAGGATCAGGGAAGGGCCGGGCAACTATGGCTACACCTTC	CASSRIREGPGNYGYTF	TRBV13	TRBJ1-2
TGTGCCAGCAGTTACCGGCCCCTGGGACAGGGGCCCCCTAACTATGGCTACACCTTC	CASSYRPLGQGPPNYGYTF	TRBV6-6	TRBJ1-2
TGCAGTGCTAGAGACCTCACGAACACTGAAGCTTTCTTT	CSARDLTNTEAFF	TRBV20-1	TRBJ1-1
TGTGCCAGCAGTTTAGGTCGTTCGGTCTTCTGTGAGCAGTTCTTC	CASSLGRSVFCEQFF	TRBV12-4	TRBJ2-1
TGTGCCACCAGCAGAGAACCTGTCGGGGGGGGCTACGAGCAGTACTTC	CATSREPVGGGYEQYF	TRBV15	TRBJ2-7
TGTGCCAGCAGCTCCGGGACTAGACCAGATACGCAGTATTTT	CASSSGTRPDTQYF	TRBV13	TRBJ2-3
TGTGCCAGCAGCTTAACAGTTTCAAATGGAAACACCATATATTTT	CASSLTVSNGNTIYF	TRBV5-6	TRBJ1-3
TGTGCCAGCAGTACAGGGTGTATTAGCAATCAGCCCCAGCATTTT	CASSTGCISNQPQHF	TRBV12-4	TRBJ1-5
TGCAGTGCTAGAGAGTGGGTGGGTAGCGGGCCATGGCAAGAGACCCAGTACTTC	CSAREWVGSGPWQETQYF	TRBV20-1	TRBJ2-5
TGTGCCATTGGGTTTGCGTCCGAAACTAGCGGCTCCTACGAGCAGTACTTC	CAIGFASETSGSYEQYF	TRBV11-2	TRBJ2-7
TGTGCCACCAGTGTCTCAAACGGCCCTACTGGGGACGAGCAGTACTTC	CATSVSNGPTGDEQYF	TRBV24-1	TRBJ2-7
TGTGCCAGCAGCCTGGGGCCGGGGGCTGGGGAGTGCGAGCAGTACTTC	CASSLGPGAGECEQYF	TRBV13	TRBJ2-7
TGTGCCTCCCACAGGGGGGGCATGAACACTGAAGCTTTCTTT	CASHRGGMNTEAFF	TRBV7-3	TRBJ1-1
TGTGCCCAAGACAGGGGTGAATACGAGCAGTACTTC	CAQDRGEYEQYF	TRBV10-3	TRBJ2-7
TGTGCCAGCAAAAGCCGACCTAGGGGGCGCACAGATACGCAGTATTTT	CASKSRPRGRTDTQYF	TRBV28	TRBJ2-3
TGTGCCAGTAGTATACCCAGGGGCACAGATACGCAGTATTTT	CASSIPRGTDTQYF	TRBV19	TRBJ2-3
TGTGCCACCAGCAGTCCAGTTCGGGGGAATCAGCCCCAGCATTTT	CATSSPVRGNQPQHF	TRBV15	TRBJ1-5
TGTGCCACCAGTGGACCCGGAAGGCAGGGAAGGGAAAAACTGTTTTTT	CATSGPGRQGREKLFF	TRBV24-1	TRBJ1-4
TGTGCCAGCAGCCGACCGGGACAGGGGCCTAATGCAAACACTGAAGCTTTCTTT	CASSRPGQGPNANTEAFF	TRBV13	TRBJ1-1
TGTGCCAGCCCCCGAACGGGAGGGGTTAAGTTTAACAATGAGCAGTTCTTC	CASPRTGGVKFNNEQFF	TRBV19	TRBJ2-1
TGTGCCAGCAGCTTCCAGGAGAGGATCCAAGAGACCCAGTACTTC	CASSFQERIQETQYF	TRBV9	TRBJ2-5
TGTGCCACCAGTGTTCCAGACCCCCAATTTCGAGGGACCGGGGAGCTGTTTTTT	CATSVPDPQFRGTGELFF	TRBV24-1	TRBJ2-2
TGCAGCGTTGTGATAGGGACAGGCTGGGTGCTGTTTTTT	CSVVIGTGWVLFF	TRBV29-1	TRBJ2-2
TGTGCCAGCAGCTTGGTACTAGCGGGAGTCTCCTACGAGCAGTACTTC	CASSLVLAGVSYEQYF	TRBV5-4	TRBJ2-7
TGCGCCAGCAGCTTACTAACTAGCGGGGACTATGAGCAGTTCTTC	CASSLLTSGDYEQFF	TRBV5-1	TRBJ2-1
TGCAGTGCTAGAGATCAAGCCAGGCATAGGCACAATGAGCAGTTCTTC	CSARDQARHRHNEQFF	TRBV20-1	TRBJ2-1
TGTGCCAGCAAGGGGAGACAGTCACCCCTCCACTTT	CASKGRQSPLHF	TRBV25-1	TRBJ1-6
TGTGCCAGCAGCTTAGAGCAAACAGATACGCAGTATTTT	CASSLEQTDTQYF	TRBV7-9	TRBJ2-3
TGTGCCAGCAGCTTCGGCTGGCGGGACAGGGGGTATGAGCAGTTCTTC	CASSFGWRDRGYEQFF	TRBV5-6	TRBJ2-1
TGCGCCAGCAGCTTGTTTTGGGACAATGAAAAACTGTTTTTT	CASSLFWDNEKLFF	TRBV5-1	TRBJ1-4
TGCAGCGTTGAAATGCCCCGGGACAGGGCTCCGTACCAAGAGACCCAGTACTTC	CSVEMPRDRAPYQETQYF	TRBV29-1	TRBJ2-5
TGTGCCAGCAGTGACCATCCCCGGGACGTCTATGGCTACACCTTC	CASSDHPRDVYGYTF	TRBV6-4	TRBJ1-2
TGTGCCAGTAGTATGATTCCCCCCCCCCCAGGGAGCAATGGGCCCCAGCATTTT	CASSMIPPPPGSNGPQHF	TRBV19	TRBJ1-5
TGCAGTGCTTACCAGCTGGGGGCCGGCTATGGCTACACCTTC	CSAYQLGAGYGYTF	TRBV20-1	TRBJ1-2
TGTGCCCCCCAGGGTCGGTCCTACGAGCAGTACTTC	CAPQGRSYEQYF	TRBV12-5	TRBJ2-7
TGTGCCAGCAGTGACCGAAGCAGGGGGCCACCTGGAAACACCATATATTTT	CASSDRSRGPPGNTIYF	TRBV6-4	TRBJ1-3
TGTGCCAGCAGCGTTCCAATACCTAGGACCTACGAGCAGTACTTC	CASSVPIPRTYEQYF	TRBV7-4	TRBJ2-7
TGTGCCAGCAGCGGCCCAACTAGCGACCGCTACGAGCAGTACTTC	CASSGPTSDRYEQYF	TRBV7-3	TRBJ2-7
