TGTGCCAGCAGTCCCGTGTCGGGGGGGGACTGCAATCAGCCCCAGCATTTT	CASSPVSGGDCNQPQHF	TRBV6-4	TRBJ1-5
TGCGCCAGCAGCTTGTGGTTTGGGGGACGGGCCCTATACGAGCAGTACTTC	CASSLWFGGRALYEQYF	TRBV5-1	TRBJ2-7
TGTGCCAGCAGTGATCAGGGACAAAATGAAAAACTGTTTTTT	CASSDQGQNEKLFF	TRBV2	TRBJ1-4
TGTGCCAGCAGTCCGTTTACAGGGCTAACCTATGGCTACACCTTC	CASSPFTGLTYGYTF	TRBV6-1	TRBJ1-2
TGCGCCAGCAGAGTCCGCCAGGGCTTCTCCTACGAGCAGTACTTC	CASRVRQGFSYEQYF	TRBV5-1	TRBJ2-7
TGTGCCAGCAGCGCCGGGGGGGATAGCAATCAGCCCCAGCATTTT	CASSAGGDSNQPQHF	TRBV7-2	TRBJ1-5
TGTGCCACCCAGGCGGTAACAGCCCAGTACTTC	CATQAVTAQYF	TRBV24-1	TRBJ2-5
TGTGCCAGCCGGGCCACAACAAGCTCAAACATTCAGTACTTC	CASRATTSSNIQYF	TRBV13	TRBJ2-4
TGTGCCAGCAGTGACCTCCTAGACGAGCAGTACTTC	CASSDLLDEQYF	TRBV6-8	TRBJ2-7
TGTGCCACCAGTGATTTGCCCCTGACTAGCGGGTTAGGGACGCACAATGAGCAGTTCTTC	CATSDLPLTSGLGTHNEQFF	TRBV24-1	TRBJ2-1
TGCGCCAGCACTCGGGGCAGGCAAACCTACGAGCAGTACTTC	CASTRGRQTYEQYF	TRBV5-1	TRBJ2-7
TGTGCCAGCAGCGCCCGGGACCGTAACTATGGCTACACCTTC	CASSARDRNYGYTF	TRBV9	TRBJ1-2
TGTGCCAGCCGGACAGGGGGACCCCACACCGGGGAGCTGTTTTTT	CASRTGGPHTGELFF	TRBV6-6	TRBJ2-2
TGTGCCAGCAGCTTGCCCCGGTTGAGGGACTACGAGCAGTACTTC	CASSLPRLRDYEQYF	TRBV5-4	TRBJ2-7
TGTGCCAGCAAGTTACGCATGAGCTATGGCTACACCTTC	CASKLRMSYGYTF	TRBV2	TRBJ1-2
TGTGCCAGCAGCGAAACCGCCCGGGGGGGCCGACAAGAGACCCAGTACTTC	CASSETARGGRQETQYF	TRBV5-6	TRBJ2-5
TGTGCCAGCAGCTACCTGGGGGACACTGAAGCTTTCTTT	CASSYLGDTEAFF	TRBV5-6	TRBJ1-1
TGCAGTGCTAGAGATTTTTCAGGGGGGGGGAGCTATGGCTACACCTTC	CSARDFSGGGSYGYTF	TRBV20-1	TRBJ1-2
TGTGCCAGTAGTCAGCTTTTGAATCAGCCCCAGCATTTT	CASSQLLNQPQHF	TRBV19	TRBJ1-5
TGTGCCAGTATAGAGACCATCACAGATACGCAGTATTTT	CASIETITDTQYF	TRBV19	TRBJ2-3
TGTGCCCTGGGGGATCGAGGCGATCTTATAGTCTTT	CALGDRGDLIVF	TRBV2	TRBJ1-1
TGTGCCAGCAGTTACGGCAGGGGGAACACTGAAGCTTTCTTT	CASSYGRGNTEAFF	TRBV27	TRBJ1-1
TGTGCCAGCAGCGGGGGGGCTTCCTACAATGAGCAGTTCTTC	CASSGGASYNEQFF	TRBV9	TRBJ2-1
TGTGCCAGCCCGAACCGGGACTGCCTTAAAACAGATACGCAGTATTTT	CASPNRDCLKTDTQYF	TRBV27	TRBJ2-3
TGTGCCACCAGCAGAGTAATAACAGAGTGTAATGAAAAACTGTTTTTT	CATSRVITECNEKLFF	TRBV15	TRBJ1-4
TGCGCCAGCAGCTCAGATTCCGGGGCGGCCACAGATACGCAGTATTTT	CASSSDSGAATDTQYF	TRBV5-1	TRBJ2-3
TGTGCCAGCAGCCAAGGGACAGGGACCGGTAGCAATCAGCCCCAGCATTTT	CASSQGTGTGSNQPQHF	TRBV3-1	TRBJ1-5
TGCGCCAGCAGCTTGCCTCCAAGTCCTTACGAAGATACGCAGTATTTT	CASSLPPSPYEDTQYF	TRBV5-1	TRBJ2-3
TGCGCCAGCAGCTTAAGTGCTATACGGACAGTCGGGGGACAAGAGACCCAGTACTTC	CASSLSAIRTVGGQETQYF	TRBV5-1	TRBJ2-5
TGTGCCACGCGGATCCATGGGTTGGGCGGAGATACGCAGTATTTT	CATRIHGLGGDTQYF	TRBV6-5	TRBJ2-3
TGTGCCAGCAGTGGACAGGGGGCAGACCGAGCTAACTATGGCTACACCTTC	CASSGQGADRANYGYTF	TRBV27	TRBJ1-2
TGTGCCAGCATTGACAAGGGACTAGGGAGCAGAGATACGCAGTATTTT	CASIDKGLGSRDTQYF	TRBV19	TRBJ2-3
TGTGCCAGCAGCCAACCAGTTGGGACAGGGGACCCCTACGAGCAGTACTTC	CASSQPVGTGDPYEQYF	TRBV7-4	TRBJ2-7
TGTGCTAGTGGTTGTTTCGGGGACGACTACGAGCAGTACTTC	CASGCFGDDYEQYF	TRBV12-5	TRBJ2-7
TGTGCCAGCAGCCAAGCACCAGGCACCGGGGAGCTGTTTTTT	CASSQAPGTGELFF	TRBV4-2	TRBJ2-2
TGTGCCAGCAGTAAGACCACAAACCGGGGAGGTATCGGGCCCCAGCATTTT	CASSKTTNRGGIGPQHF	TRBV28	TRBJ1-5
TGCGCCAGCAGCTTGGAGGGACAGGGCCCCCAGCCCCAGCATTTT	CASSLEGQGPQPQHF	TRBV5-1	TRBJ1-5
TGTGCCAGCAGAAACAGGGGGGACCTAATGAGCTACAATGAGCAGTTCTTC	CASRNRGDLMSYNEQFF	TRBV6-4	TRBJ2-1
TGTGCCAGCAGCTTGGGGCAGGGGTACGAGCAGTACTTC	CASSLGQGYEQYF	TRBV7-9	TRBJ2-7
TGTGCCTGGAGTTCGCATGGGACAGCTTATCAGCCCCAGCATTTT	CAWSSHGTAYQPQHF	TRBV30	TRBJ1-5
TGTGCCAGCAGCTCAGGGGAAAAACTGTTTTTT	CASSSGEKLFF	TRBV7-3	TRBJ1-4
TGCGCCAGCAGCCAAGCGTACCCCACGACCTACGAGCAGTACTTC	CASSQAYPTTYEQYF	TRBV4-1	TRBJ2-7
TGCGCCAGCAGGTGGTTCGCGGACAGGGGGAGGGGCGGTATTGATCAGCCCCAGCATTTT	CASRWFADRGRGGIDQPQHF	TRBV5-1	TRBJ1-5
TGCGCCAGCAGCTTCGCAAACTGGACAGGGACAGATACGCAGTATTTT	CASSFANWTGTDTQYF	TRBV5-1	TRBJ2-3
TGCAGCGTTGAAGGGGGACAGGGCCAAGAGACCCAGTACTTC	CSVEGGQGQETQYF	TRBV29-1	TRBJ2-5
TGTGCCAGCAGCCCCCGGGACACTGAAGCTTTCTTT	CASSPRDTEAFF	TRBV13	TRBJ1-1
TGTGCCACCAGCAGTCAGAGGCCGGGACAATTGAAGCCAAGGTCGAGCAATCAGCCCCAGCATTTT	CATSSQRPGQLKPRSSNQPQHF	TRBV15	TRBJ1-5
TGTGCCAGCAGCTGGCAGAGGTCCTACGAGCAGTACTTC	CASSWQRSYEQYF	TRBV6-1	TRBJ2-7
TGTGCCAGCAGCCAGTGGACCCCCAGGCAACAATCAGATACGCAGTATTTT	CASSQWTPRQQSDTQYF	TRBV4-2	TRBJ2-3
TGTGCCAGCAGCGTCTGGGGAGTTAGTGAAGCTTTCTTT	CASSVWGVSEAFF	TRBV13	TRBJ1-1
TGTGCCACCCACGGACTACGGAGCAATCAGCCCCAGCATTTT	CATHGLRSNQPQHF	TRBV24-1	TRBJ1-5
TGTGCCAGCAGCCAAGATGAGGGGGACACTGAAGCTTTCTTT	CASSQDEGDTEAFF	TRBV3-1	TRBJ1-1
TGTGCCAGTAGTGGGACGCTATACAATGAGCAGTTCTTC	CASSGTLYNEQFF	TRBV19	TRBJ2-1
TGTGCCAGCAGTGATTCGCAGTTCTTC	CASSDSQFF	TRBV2	TRBJ2-1
TGTGCCAGTAGTAAGGGGACGCCGGGGTACGAGCAGTACTTC	CASSKGTPGYEQYF	TRBV19	TRBJ2-7
TGTGCCAGCAGTGCAGGAGCTCACACAGATACGCAGTATTTT	CASSAGAHTDTQYF	TRBV27	TRBJ2-3
TGTGCCAGTAGTATACTGAGCGGCGCTAAGTACTTC	CASSILSGAKYF	TRBV19	TRBJ2-7
TGCGCCAGCATAGTCAGAAAACTGTTTTTT	CASIVRKLFF	TRBV10-1	TRBJ1-4
TGCGCCAGCAGCTTATTGTCCGGACGATCAGTGGAGCAGTTCTTC	CASSLLSGRSVEQFF	TRBV5-1	TRBJ2-1
TGTGCCAGCAGTTACTCGACCCCCGAGGGTACTAATGAAAAACTGTTTTTT	CASSYSTPEGTNEKLFF	TRBV6-8	TRBJ1-4
TGCGCCAGCAGCTTCCCGGGGGTCACAGATACGCAGTATTTT	CASSFPGVTDTQYF	TRBV5-1	TRBJ2-3
TGTGCTAGTGGTTTGGTTAGAGAAAGCCCAGGGAATCAGCCCCAGCATTTT	CASGLVRESPGNQPQHF	TRBV12-5	TRBJ1-5
TGTGCCAGCCCGGACTACGAGCAGTACTTC	CASPDYEQYF	TRBV10-3	TRBJ2-7
TGTGCCAGCAGCTTCCTGCTGTGGCAGAGCGGGCTGTTTTTT	CASSFLLWQSGLFF	TRBV11-2	TRBJ1-4
TGCAGTGCTAGAGATCGATCACCGAGGGCTGAGACCCAGTACTTC	CSARDRSPRAETQYF	TRBV20-1	TRBJ2-5
TGTGCCAGCAGCTTAGGTCACTTTGTGACCCAGTACTTC	CASSLGHFVTQYF	TRBV7-9	TRBJ2-5
TGTGCCAGGCTGGACGGAGTACCGTCAGATACGCAGTATTTT	CARLDGVPSDTQYF	TRBV10-3	TRBJ2-3
TGTGCCGCTATGTGGGTTCCCAAGGGGTCTTATGGCTACACCTTC	CAAMWVPKGSYGYTF	TRBV11-2	TRBJ1-2
TGTGCCAGCAGCAAACAAGATGGCACTGAAGCTTTCTTT	CASSKQDGTEAFF	TRBV14	TRBJ1-1
TGTGCCAGCAGTCCTCCGTATACCTCCTACAATGAGCAGTTCTTC	CASSPPYTSYNEQFF	TRBV6-3	TRBJ2-1
TGTGCCAGCAGCCAAGATCCAAGGATCCGGCTGTTTTTT	CASSQDPRIRLFF	TRBV14	TRBJ1-4
TGCAGTGCTAGGCTTCCGGGACTAGCGGGAGGGGGGAACTATGGCTACACCTTC	CSARLPGLAGGGNYGYTF	TRBV20-1	TRBJ1-2
TGTGCCAGCAGCGCCGGGACAGACGAGCAGTACTTC	CASSAGTDEQYF	TRBV13	TRBJ2-7
TGCAGTGCTAGATCTAGCGGTGATACGCAGTATTTT	CSARSSGDTQYF	TRBV20-1	TRBJ2-3
TGTGCCAGCAGCTTATCAGCGGGAACTACGTATGAGCAGTTCTTC	CASSLSAGTTYEQFF	TRBV7-3	TRBJ2-1
TGTGCCAGCAGGGCGCTTTACTATGGCTACACCTTC	CASRALYYGYTF	TRBV12-4	TRBJ1-2
TGTGCCAGCAGCGTCGCCAACCTAAGGCCTCCGAACACCGGGGAGCTGTTTTTT	CASSVANLRPPNTGELFF	TRBV11-2	TRBJ2-2
TGTGCCAGCAGTGGTCTCGGTGTACGGACCGATACGCAGTATTTT	CASSGLGVRTDTQYF	TRBV27	TRBJ2-3
TGTGCCAGTAGTATAGGACAGGGGGCGCCGGTATATGGCTACACCTTC	CASSIGQGAPVYGYTF	TRBV19	TRBJ1-2
TGTGCCAGCAGTTTAGAGGCTCGGGCGTGGGGGCCAACTGAAGCTTTCTTT	CASSLEARAWGPTEAFF	TRBV27	TRBJ1-1
TGTGCCAGCAGTGAAGCCGGAGAGCCTCTAGGGCCCGGTCGGCCCCTAGCCAAAAACATTCAGTACTTC	CASSEAGEPLGPGRPLAKNIQYF	TRBV2	TRBJ2-4
TGCGCCAGCAAACTTAATGGACAGGGGGCTCGCTCTGAAAAACTGTTTTTT	CASKLNGQGARSEKLFF	TRBV5-1	TRBJ1-4
TGTGCCAGTAGTCAGTACAGGAGCTACAATGAGCAGTTCTTC	CASSQYRSYNEQFF	TRBV19	TRBJ2-1
TGCAGTGCGGTAGGGGGCCTCAGAACTGAAGCTTTCTTT	CSAVGGLRTEAFF	TRBV20-1	TRBJ1-1
TGTGCCAGCAGCCCGGGCCCCCTTCTGAATCAGCCCCAGCATTTT	CASSPGPLLNQPQHF	TRBV5-5	TRBJ1-5
TGTGCCAGCAGCCAAGAGAACTTAACTTACGAGCAGTACTTC	CASSQENLTYEQYF	TRBV3-1	TRBJ2-7
TGTGCCAGCAGCCAAGTCGCACGGGGAGACAATCAGCCCCAGCATTTT	CASSQVARGDNQPQHF	TRBV14	TRBJ1-5
TGTGCCAGCAGCCAAGATAGCGAACAGCGGATAGCTGAGCAGTTCTTC	CASSQDSEQRIAEQFF	TRBV14	TRBJ2-1
TGTGCCAGCAGCGGCCTCAGGATTGCAACTAATGAAAAACTGTTTTTT	CASSGLRIATNEKLFF	TRBV28	TRBJ1-4
TGTGCCAGCAGCTTATCACTAGCGGGAGCAGATACGCAGTATTTT	CASSLSLAGADTQYF	TRBV7-6	TRBJ2-3
TGTGCCAGTAGTATCTCCAGGGAAGACACTGAAGCTTTCTTT	CASSISREDTEAFF	TRBV19	TRBJ1-1
TGCAGTGCTAGAGATGAGGAGAGCGGGGCCAAAAACATTCAGTACTTC	CSARDEESGAKNIQYF	TRBV20-1	TRBJ2-4
TGTGCCAGCTCACCCGGGACAGGGGGGAGGTACGAGCAGTACTTC	CASSPGTGGRYEQYF	TRBV18	TRBJ2-7
TGTGCCAGCCGCGACAGGGGGCAATTACAAGAGACCCAGTACTTC	CASRDRGQLQETQYF	TRBV6-1	TRBJ2-5
TGCAGTGCGGGCTCCCGGGGGGTGGTCGGAAACACCATATATTTT	CSAGSRGVVGNTIYF	TRBV20-1	TRBJ1-3
TGTGCCAGCAGCGAAGACAGGGAGTACCAAGAGACCCAGTACTTC	CASSEDREYQETQYF	TRBV14	TRBJ2-5
TGTGCCAGTAGCTGGTTGACTTTAGGTTTATTCCAGCAAGCTTTCTTT	CASSWLTLGLFQQAFF	TRBV19	TRBJ1-1
TGTGCCAGGGCTAGCGGGACACAAGAGACCCAGTACTTC	CARASGTQETQYF	TRBV19	TRBJ2-5
TGCGCCAGCCCACCGGGACACTACGAGCAGTACTTC	CASPPGHYEQYF	TRBV10-2	TRBJ2-7
TGTGCCAGCACTCCAGAGGGCCCGGACGAGCAGTACTTC	CASTPEGPDEQYF	TRBV7-9	TRBJ2-7
TGCAGTGCGAGGCGGACAGAATTCAATCAGCCCCAGCATTTT	CSARRTEFNQPQHF	TRBV20-1	TRBJ1-5
TGTGCCAGCAGTCCCCGAGTTGAAGCTTTCTTT	CASSPRVEAFF	TRBV27	TRBJ1-1
TGTGCCAGCAGCTTACCCCAGGGAACCTACGAGCAGTACTTC	CASSLPQGTYEQYF	TRBV7-9	TRBJ2-7
TGTGCCAGCAGATGCGGGAGTTATCAGCCCCAGCATTTT	CASRCGSYQPQHF	TRBV3-1	TRBJ1-5
TGTGCCAGCAGCAAGGGACAGGGGGCTTTTAATTCACCCCTCCACTTT	CASSKGQGAFNSPLHF	TRBV7-3	TRBJ1-6
TGCGCCAGCAGCGTGTCAAAGGGGTTTTTCACCTTC	CASSVSKGFFTF	TRBV5-1	TRBJ1-2
TGTGCCAGCAGCTTCGGAGGACAGCTATACACTGAAGCTTTCTTT	CASSFGGQLYTEAFF	TRBV5-6	TRBJ1-1
TGTGCCAGCAGGCTACCTAACACCGGGGAGCTGTTTTTT	CASRLPNTGELFF	TRBV6-4	TRBJ2-2
TGTGCCAGCAGCCGGCGGAATAGCACAGATACGCAGTATTTT	CASSRRNSTDTQYF	TRBV6-1	TRBJ2-3
TGTGCCTGGTCACTCCGCGCCGACAGGGGCCCCACCAATCAGCCCCAGCATTTT	CAWSLRADRGPTNQPQHF	TRBV30	TRBJ1-5
TGCAGTGCTCGTGGCGAACCACAGTGTCCAGGGTTTACGAGTAATGAAAAACTGTTTTTT	CSARGEPQCPGFTSNEKLFF	TRBV20-1	TRBJ1-4
TGTGCCACCAGTGTAATCGGTATTTCCCCCCCGGGACAGGGTCGAAGGCAAGAGACCCAGTACTTC	CATSVIGISPPGQGRRQETQYF	TRBV24-1	TRBJ2-5
TGCAGTGCTAGGGGGAGGCGCCTTGTAGCAGGGTTACCATGTGAAGCTTTCTTT	CSARGRRLVAGLPCEAFF	TRBV20-1	TRBJ1-1
TGTGCCAGCAGTAGGCCCCGGGACAGGGAGAGAGATACGCAGTATTTT	CASSRPRDRERDTQYF	TRBV27	TRBJ2-3
TGTGCCAGAATAGCGGGAACGGTTGCAGATACGCAGTATTTT	CARIAGTVADTQYF	TRBV6-3	TRBJ2-3
TGTGCCAGCAGCTGTCGGTATTCGCTTAAGACCACTGAAGCTTTCTTT	CASSCRYSLKTTEAFF	TRBV7-3	TRBJ1-1
TGTGCCAGCAGCGGAATAGTGGGGGGTCGGGCTTATGAGCAGTTCTTC	CASSGIVGGRAYEQFF	TRBV7-8	TRBJ2-1
TGTGCCAGCAGTGGGGCCACAGGGCCCGGTGAAAACGTGTCGATCTCGTACTTC	CASSGATGPGENVSISYF	TRBV2	TRBJ2-7
TGTGCCACCAACCGCCTGGCCGGACAGCGGCGGGACACAGATACGCAGTATTTT	CATNRLAGQRRDTDTQYF	TRBV24-1	TRBJ2-3
TGCGCCAGCAGCCAAGATCGCCCGGAGGATCGGGCCTACGAGCAGTACTTC	CASSQDRPEDRAYEQYF	TRBV4-1	TRBJ2-7
TGTGCCAGCAGCTTGGATCGAAGAGACAATGAGCAGTTCTTC	CASSLDRRDNEQFF	TRBV5-6	TRBJ2-1
TGTGCCAGTCCCAGGTACGAGCAGTACTTC	CASPRYEQYF	TRBV19	TRBJ2-7
TGTGCCAGCAGTTTATCGATAATAGGGGGTGAAGCTTTCTTT	CASSLSIIGGEAFF	TRBV27	TRBJ1-1
TGTGCCAGCCGGGGAGCGCCTGATCGCGGGACCAGCTCCTACAATGAGCAGTTCTTC	CASRGAPDRGTSSYNEQFF	TRBV6-1	TRBJ2-1
TGCGCCAGCAGCTTGGTGAGGCCCGGGGACAGGAACATTCAGTACTTC	CASSLVRPGDRNIQYF	TRBV5-1	TRBJ2-4
TGTGCCAGATGTAAAGGGACTCTGTCAGTTACTGAAGCTTTCTTT	CARCKGTLSVTEAFF	TRBV7-6	TRBJ1-1
TGTGCCAGCAGCCGTACTAGCGGGAGGGCAGAGGACGAGCAGTACTTC	CASSRTSGRAEDEQYF	TRBV5-6	TRBJ2-7
TGCGCCAGCAGCTTTGAAGGCGGGGGAGTCGCTGAAAAACTGTTTTTT	CASSFEGGGVAEKLFF	TRBV5-1	TRBJ1-4
TGTGCCAGCAGCTTGTTGGGACAGGGGGGTCAGCCCCAGCATTTT	CASSLLGQGGQPQHF	TRBV7-9	TRBJ1-5
TGTGCCAGGGGAACGAAGGCACCCCTCCACTTT	CARGTKAPLHF	TRBV30	TRBJ1-6
TGTGCCAGCAGTGAAGGACAGGGTGGCTACACCTTC	CASSEGQGGYTF	TRBV6-1	TRBJ1-2
TGTGCCAGCAGTAGTGGACAGGGGGATGGTGGCTACACCTTC	CASSSGQGDGGYTF	TRBV6-4	TRBJ1-2
TGTGCCAGCAGCGGGACACAGGGGGACAGGATCAATGAAAAACTGTTTTTT	CASSGTQGDRINEKLFF	TRBV11-3	TRBJ1-4
TGTGCCAGCAGGGGGGCACAGGAATGCGAGACCCAGTACTTC	CASRGAQECETQYF	TRBV6-5	TRBJ2-5
TGTGCCACCAGCAGAGAGAGAGAGGGGGTAGCCAAAAACATTCAGTACTTC	CATSREREGVAKNIQYF	TRBV15	TRBJ2-4
TGTGCCAGCAGCTTATACAAAGTCTACGAATGGGACAGGTTCAACACCGGGGAGCTGTTTTTT	CASSLYKVYEWDRFNTGELFF	TRBV7-3	TRBJ2-2
TGTGCCAGCAGTGACCAAGGGGGGAAGAGCTCCTACGAGCAGTACTTC	CASSDQGGKSSYEQYF	TRBV6-4	TRBJ2-7
TGCGCCAGCAGTCTCCCTAAGACAGGGGCTTTCCCGCGCTACGAGCAGTACTTC	CASSLPKTGAFPRYEQYF	TRBV5-1	TRBJ2-7
TGTGGGGGACTAGCGGGAACCTACAATGAGCAGTTCTTC	CGGLAGTYNEQFF	TRBV7-2	TRBJ2-1
TGTGCCAGCAGTGACTCGAGTTGGTTCCAGGGGTGGACACCCAGTCTGGGCGGCCCGAGGTATTTT	CASSDSSWFQGWTPSLGGPRYF	TRBV6-4	TRBJ2-3
TGTGCCAGCAGTAATCGTAGTCGGAGGCTCTACGAGCAGTACTTC	CASSNRSRRLYEQYF	TRBV12-3	TRBJ2-7
TGCAGACTAGGACGGGCCCGGTTCAATCAGCCCCAGCATTTT	CRLGRARFNQPQHF	TRBV29-1	TRBJ1-5
TGCGCCAGCAGCTTGGGGCAGGGCCGAAACACCATATATTTT	CASSLGQGRNTIYF	TRBV5-1	TRBJ1-3
TGTGCCAGCAGCCAAGATGGTGTGTGGACAGGATATAATTCACCCCTCCACTTT	CASSQDGVWTGYNSPLHF	TRBV4-2	TRBJ1-6
TGCAGCGTGGGACGAGCCAAAAACATTCAGTACTTC	CSVGRAKNIQYF	TRBV29-1	TRBJ2-4
TGTGCCAGCAGCTTAGAATGCGGGACAGGAGGAATCTCAGGGGAGCTGTTTTTT	CASSLECGTGGISGELFF	TRBV11-2	TRBJ2-2
TGCAGCGTTACGGACTTCGGTCTTGATACGCAGTATTTT	CSVTDFGLDTQYF	TRBV29-1	TRBJ2-3
TGTGCCAGCAGCCCGGGGCCCTACGAATCTGGGGCCAACGTCCTGACTTTC	CASSPGPYESGANVLTF	TRBV12-3	TRBJ2-6
TGCGCCAGCACAGGGCCCTACGAGCAGTACTTC	CASTGPYEQYF	TRBV5-1	TRBJ2-7
TGCGCCAGCCTAGCGGGAGAGAGGGAGGATCAGCCCCAGCATTTT	CASLAGEREDQPQHF	TRBV5-1	TRBJ1-5
TGCAGCGTTGAGGTGGGGGGCTCGGGGTACAATGAGCAGTTCTTC	CSVEVGGSGYNEQFF	TRBV29-1	TRBJ2-1
TGTGCCATCACGAATACCGAGCAGTACTTC	CAITNTEQYF	TRBV10-3	TRBJ2-7
TGTGCCAGCAGCCACGGCACTCTACACTATGGCTACACCTTC	CASSHGTLHYGYTF	TRBV14	TRBJ1-2
TGTGCCAGCAGCGGCGATCAGGCTACAGATACGCAGTATTTT	CASSGDQATDTQYF	TRBV13	TRBJ2-3
TGTGCCAGCAGCTTCACACCCGTCGGAACGGGGCAACGAGGGCCCTACGAGCAGTACTTC	CASSFTPVGTGQRGPYEQYF	TRBV5-6	TRBJ2-7
TGTGCCAGCAGCTTTCTTTCCAAGGCTAGCGGGGTATACAATGAGCAGTTCTTC	CASSFLSKASGVYNEQFF	TRBV5-4	TRBJ2-1
TGTGCCAGCAGCGTAAGGGGCAGAGCGGAGTTTCAGCCCCAGCATTTT	CASSVRGRAEFQPQHF	TRBV9	TRBJ1-5
TGTGCCATCAGTGTCCGGGACAGGGGGTATGGCTACACCTTC	CAISVRDRGYGYTF	TRBV10-3	TRBJ1-2
TGCAGTGCCTTCCCGGGACAGGGTAGGTTAAATTCACCCCTCCACTTT	CSAFPGQGRLNSPLHF	TRBV20-1	TRBJ1-6
TGTGCCACCAGTGCCCCCCAGGGATCGCGTACCTACAATGAGCAGTTCTTC	CATSAPQGSRTYNEQFF	TRBV24-1	TRBJ2-1
TGTGCCAGCAGCGAGGGGGCTAACGAGCAGTACTTC	CASSEGANEQYF	TRBV9	TRBJ2-7
TGTGCCTGTGGGGCAGAGACCCAGTACTTC	CACGAETQYF	TRBV2	TRBJ2-5
TGTGCCAGCAGTAGGCAATCATCACCCCTCCACTTT	CASSRQSSPLHF	TRBV12-4	TRBJ1-6
TGTGCCACCAGTGATAGGCTAGCGGGGCAGTATTTT	CATSDRLAGQYF	TRBV24-1	TRBJ2-3
TGTGCCAGCAGGGGGTTTAAGCAATTTCAAAAAGCTTCTTTAGCTTTCTTT	CASRGFKQFQKASLAFF	TRBV7-9	TRBJ1-1
TGCGCCAGCAGCTTCGGGGGACAGAACTATGGCTACACCTTC	CASSFGGQNYGYTF	TRBV5-1	TRBJ1-2
TGTGCCAGCAGCTTCCACCTAGCGGGATTCGAGGTAGATACGCAGTATTTT	CASSFHLAGFEVDTQYF	TRBV7-9	TRBJ2-3
TGTGCCAGCAGGCAGGGGTACATGAACACTGAAGCTTTCTTT	CASRQGYMNTEAFF	TRBV12-4	TRBJ1-1
TGCAGCGAGGTAAGAAGGACCGGGGAGCTGTTTTTT	CSEVRRTGELFF	TRBV29-1	TRBJ2-2
TGCGCCAGCAGTGCTTCCCTGCCTCTCTATGAGCAGTTCTTC	CASSASLPLYEQFF	TRBV10-1	TRBJ2-1
TGTGCCAGCGACCGCAAATCGAACACCGGGGAGCTGTTTTTT	CASDRKSNTGELFF	TRBV12-3	TRBJ2-2
TGCGCCAGCAGCACTGACCCTCAGCAGGGGCATGGTCGCGCCTCACCCCTCCACTTT	CASSTDPQQGHGRASPLHF	TRBV5-1	TRBJ1-6
TGTGCCAGCAGTGAGGCCCAGTCGGCCCTCCACTTT	CASSEAQSALHF	TRBV25-1	TRBJ1-6
TGTGCCAGCAGCGTAGCCGAGCCCTTCCCCATCTTC	CASSVAEPFPIF	TRBV9	TRBJ2-1
TGTGCCAGTAGTAAAAGGATCTGGCAAGAGACCCAGTACTTC	CASSKRIWQETQYF	TRBV19	TRBJ2-5
TGTGCCGGACGTAAGGGGGGGATGAACACTGAAGCTTTCTTT	CAGRKGGMNTEAFF	TRBV10-3	TRBJ1-1
TGTGCCAGCAGCCAAGAGGCAGGGGGGTATGGTAGAAGTACTGAAGCTTTCTTT	CASSQEAGGYGRSTEAFF	TRBV3-1	TRBJ1-1
TGTGCCAGCTCACCCCCCAATGACTGGAACGGGGTGGGGTATGAGCAGTTCTTC	CASSPPNDWNGVGYEQFF	TRBV18	TRBJ2-1
TGTGCCAGCAGGCTTTTCTCCGACCCCTACCAAGAGACCCAGTACTTC	CASRLFSDPYQETQYF	TRBV12-3	TRBJ2-5
TGCGCCAGCAGCAAAACTAGGTCAACCGAGCAGTTCTTC	CASSKTRSTEQFF	TRBV5-1	TRBJ2-1
TGCGCCAGCAGCCAAGACGCAGGGGGGAACACTGAAGCTTTCTTT	CASSQDAGGNTEAFF	TRBV4-3	TRBJ1-1
TGTGCCAGCAGTTACCAACTGAGAGAAAAACTGTTTTTT	CASSYQLREKLFF	TRBV6-6	TRBJ1-4
TGTGCCAGCAAGAGGCCGGCTGAAGCTTTCTTT	CASKRPAEAFF	TRBV2	TRBJ1-1
TGCAGTGCCCCCACCCAGGGGTCTGAGCAGTTCTTC	CSAPTQGSEQFF	TRBV20-1	TRBJ2-1
TGTGCCAGCAGTGGGGGACCCTCCGCCTACGAGCAGTACTTC	CASSGGPSAYEQYF	TRBV6-4	TRBJ2-7
TGTGCCGGTTGGACTAGAGCCGGGGAGCTGTTTTTT	CAGWTRAGELFF	TRBV27	TRBJ2-2
TGCAGTGCCGCGCAGGGCTCTGGGGCCAACGTCCTGACTTTC	CSAAQGSGANVLTF	TRBV20-1	TRBJ2-6
TGTGCCAGCAGTATAGCGGGACGCCGACATTCACCCCTCCACTTT	CASSIAGRRHSPLHF	TRBV6-8	TRBJ1-6
TGTGCCAGCAGCAAGACCTACGAGCAGTACTTC	CASSKTYEQYF	TRBV14	TRBJ2-7
TGCAGTGCTAGAGTAATGGGGGACTTAGGTAATGAAAAACTGTTTTTT	CSARVMGDLGNEKLFF	TRBV20-1	TRBJ1-4
TGTGCCAGCAGCAGGTCGGCGAGCTACAATGAGCAGTTCTTC	CASSRSASYNEQFF	TRBV6-2	TRBJ2-1
TGTGCCACCAGTGGGCCCGGGACAGGGGTTAGGGCCTCCTACAATGAGCAGTTCTTC	CATSGPGTGVRASYNEQFF	TRBV24-1	TRBJ2-1
TGCAGCGTTGAAAAATCAGGGGGCAGGGAGACCCAGTACTTC	CSVEKSGGRETQYF	TRBV29-1	TRBJ2-5
TGTGCCAGCAGTACAGGGGTCCCTTGGCAGTACTTC	CASSTGVPWQYF	TRBV5-6	TRBJ2-7
TGTGCCAGCAGAAACGACAGGGACTACGAGCAGTACTTC	CASRNDRDYEQYF	TRBV6-6	TRBJ2-7
TGTGCCAGCAGGAGAAGGGAGGGCCCCAACATTCAGTACTTC	CASRRREGPNIQYF	TRBV6-2	TRBJ2-4
TGTGCCAGCAGCGGCGGGACAGGGGGCACAGATACGCAGTATTTT	CASSGGTGGTDTQYF	TRBV5-8	TRBJ2-3
TGCAGTGCGTCCCCGGCCGGGACAGGGGAAGAGACCCAGTACTTC	CSASPAGTGEETQYF	TRBV20-1	TRBJ2-5
TGTGCCAGCAAGAAAAGGACTAGCGGGTCGAGCCGATACAATGAGCAGTTCTTC	CASKKRTSGSSRYNEQFF	TRBV6-1	TRBJ2-1
TGTGCCAGCAGCTTAGATAAAGAGGTCCCGCGGGAGCGAGCAGGAGTGCGGAACACTGAAGCTTTCTTT	CASSLDKEVPRERAGVRNTEAFF	TRBV11-3	TRBJ1-1
TGTGCCAGCAGGGGAGGGACAGATACGCAGTATTTT	CASRGGTDTQYF	TRBV6-2	TRBJ2-3
TGCAGCGTTGAGTTTAAGGGAATCGAGCATCAGCCCCAGCATTTT	CSVEFKGIEHQPQHF	TRBV29-1	TRBJ1-5
TGCGCCAGCAGCCGCAAGGGTTACACTGAAGCTTTCTTT	CASSRKGYTEAFF	TRBV5-1	TRBJ1-1
TGTGCCAGCCTTTTCCTAGGGAATGAGCAGTTCTTC	CASLFLGNEQFF	TRBV6-2	TRBJ2-1
TGTGCCAGCAGCTTGGCTCCGGGTAGGGGGAGCTACGAGCAGTACTTC	CASSLAPGRGSYEQYF	TRBV5-5	TRBJ2-7
TGCAGTGCTAGAGGCGGGGGGGAGCTGTTTTTT	CSARGGGELFF	TRBV20-1	TRBJ2-2
TGTGCCAGCAAATTCCCCCAGGGGGCGCATCAGCCCCAGCATTTT	CASKFPQGAHQPQHF	TRBV5-4	TRBJ1-5
TGTGCCAGCAGAGACCATGGTATCCTGCCCTACGAGCAGTACTTC	CASRDHGILPYEQYF	TRBV28	TRBJ2-7
TGTGCCACCAGCAGAGATCACAGGGGCTATGGCTACACCTTC	CATSRDHRGYGYTF	TRBV15	TRBJ1-2
TGTAACAGGGGCAGGGGGCAGGTAGGCTACACCTTC	CNRGRGQVGYTF	TRBV20-1	TRBJ1-2
TGTGCCAGCAGCTTGCACCGTAGGGGTTTTCAGCCCCAGCATTTT	CASSLHRRGFQPQHF	TRBV7-4	TRBJ1-5
TGTGCCAGCAGTTTGACGGGACTAGCCAGAAACATTCAGTACTTC	CASSLTGLARNIQYF	TRBV27	TRBJ2-4
TGTGCCAGCAGCTTAGCTAGCGGTGGGTACGAGCAGTACTTC	CASSLASGGYEQYF	TRBV7-8	TRBJ2-7
TGTGCCAGCAGCCTTGAGAGACGAAACACCATATATTTT	CASSLERRNTIYF	TRBV13	TRBJ1-3
TGTGCCACCCGAACTAGCGGGTATTATACGCAGTATTTT	CATRTSGYYTQYF	TRBV24-1	TRBJ2-3
TGTGCCAGCAGTTACACCCGGCCGTTCCCACTCACAGATACGCAGTATTTT	CASSYTRPFPLTDTQYF	TRBV6-5	TRBJ2-3
TGTGCCAGCAGTTATCGGGCCGGGGGGCACAAGCGAGGTCAGCCCCAGCATTTT	CASSYRAGGHKRGQPQHF	TRBV6-3	TRBJ1-5
TGTGCCACCAGTGATGACCTAAGACTAGCGGGATGCCAAGAGACCCAGTACTTC	CATSDDLRLAGCQETQYF	TRBV24-1	TRBJ2-5
TGTGCCACCAAGAGGACAGGGGAGGGAGCTTTCTTT	CATKRTGEGAFF	TRBV24-1	TRBJ1-1
TGTGCCAGCAGTTTAGAGAGACAGGGGAACACTGAAGCTTTCTTT	CASSLERQGNTEAFF	TRBV12-4	TRBJ1-1
TGCAGCGCGGACCAGGACTATGGCTACACCTTC	CSADQDYGYTF	TRBV29-1	TRBJ1-2
TGTGCCAGCAGCCAAGGCCGGGACGTCGCGAACACCGGGGAGCTGTTTTTT	CASSQGRDVANTGELFF	TRBV14	TRBJ2-2
TGCAGCGTTGGAATCAGGGGGGCTAACACCGGGGAGCTGTTTTTT	CSVGIRGANTGELFF	TRBV29-1	TRBJ2-2
TGTGCCAGCTCGGCAGCTTTCTTT	CASSAAFF	TRBV18	TRBJ1-1
TGCGCCAGCAGCCCGTGGGGATTACTCGGATCCGAAGCTTTCTTT	CASSPWGLLGSEAFF	TRBV5-1	TRBJ1-1
TGTGCCAGCAGTGATCGGACTAGCGGGGGGTTGCGCAGCTCCTACGAGCAGTACTTC	CASSDRTSGGLRSSYEQYF	TRBV6-4	TRBJ2-7
TGTGCCAGCAGTGAAGGACAGGGCCGCTCTGGGGCCAACGTCCTGACTTTC	CASSEGQGRSGANVLTF	TRBV25-1	TRBJ2-6
TGCAGTGCTAGAGATCACGGAGGCGAGCATGAGCAGTTCTTC	CSARDHGGEHEQFF	TRBV20-1	TRBJ2-1
TGCGCCAGCAGCCGGGGGGGAGCTCAGCCCCAGCATTTT	CASSRGGAQPQHF	TRBV4-1	TRBJ1-5
TGTGCCAGCCAAGGAGGACTAGGCCGCTACAATGAGCAGTTCTTC	CASQGGLGRYNEQFF	TRBV5-6	TRBJ2-1
TGTGCCAGCAGCTTCCCCGGGCCGGGACAGGAAAAACTGTTTTTT	CASSFPGPGQEKLFF	TRBV7-2	TRBJ1-4
TGTGCCAGCAGTCGCCCGGGATCGCCGGGACAGGGAGTTCTTGAAGCTTTCTTT	CASSRPGSPGQGVLEAFF	TRBV28	TRBJ1-1
TGTGCCAGCAGCCAAGCCGGTGAGGACAGGTGTAGCATGAACACTGAAGCTTTCTTT	CASSQAGEDRCSMNTEAFF	TRBV3-1	TRBJ1-1
TGTGCCACCAGCAGAAAAATGACAGGGGGCAATCAGCCCCAGCATTTT	CATSRKMTGGNQPQHF	TRBV15	TRBJ1-5
TGCACGCGCAGCTTGTACTTC	CTRSLYF	TRBV20-1	TRBJ2-7
TGCGCCAGCAGCGTCGGGCCAGCGGGAGCTAACTATGGCTACACCTTC	CASSVGPAGANYGYTF	TRBV5-1	TRBJ1-2
TGTGCCAGCAGCGGGGGCGATCTGTTTTTT	CASSGGDLFF	TRBV13	TRBJ1-4
TGCGCCAGCAGTGACAGTCGGGGGGGGGCCGGGGAGCTGTTTTTT	CASSDSRGGAGELFF	TRBV10-1	TRBJ2-2
TGCGCCAGCAGCTTGGTCAGCCGACTAGCGGGGAAGAACTACAATGAGCAGTTCTTC	CASSLVSRLAGKNYNEQFF	TRBV5-1	TRBJ2-1
TGTGCCAGCAGTTCCCGGACAGGGCGAGCCAATGAGCAGTTCTTC	CASSSRTGRANEQFF	TRBV12-3	TRBJ2-1
TGTGCCAGCAGTTACATTAGCCGGGGGCGTTTGAACACTGAAGCTTTCTTT	CASSYISRGRLNTEAFF	TRBV6-5	TRBJ1-1
TGCAGCGTGGCGTTAGGCGGACTCTATGGCTACACCTTC	CSVALGGLYGYTF	TRBV29-1	TRBJ1-2
TGTGCCAGCAGCAATGGGACAGAACGTTCCTATAATTCACCCCTCCACTTT	CASSNGTERSYNSPLHF	TRBV7-2	TRBJ1-6
TGCAGTGCTACGGGGACCCACACAGATACGCAGTATTTT	CSATGTHTDTQYF	TRBV20-1	TRBJ2-3
TGTGCCAGCAGGATTAGCAGGGGGCAGACCTACGAGCAGTACTTC	CASRISRGQTYEQYF	TRBV2	TRBJ2-7
TGTGCCAGCAGCCATTTAGCTGTTTCACCCCAGCTAGCCAAAAACATTCAGTACTTC	CASSHLAVSPQLAKNIQYF	TRBV3-1	TRBJ2-4
TGTGCCAGTAGTATAGCCAAGTCGGATAACGGTAAGCAGTTCTTC	CASSIAKSDNGKQFF	TRBV19	TRBJ2-1
TGTGCCAGCAGCTCCCGGACAGGTTACCTAGATACGCAGTATTTT	CASSSRTGYLDTQYF	TRBV5-5	TRBJ2-3
TGTGCCTGGCCCCTAAGTAGACAGAGCATGCAAACTGAAGCTTTCTTT	CAWPLSRQSMQTEAFF	TRBV30	TRBJ1-1
TGTGCCAGCAGCAAGGGGGCCGGGAGCAATCAGCCCCAGCATTTT	CASSKGAGSNQPQHF	TRBV14	TRBJ1-5
TGTGCCAGCAGCTTGGCATGGGGGTCCAGCAATCAGCCCCAGCATTTT	CASSLAWGSSNQPQHF	TRBV5-8	TRBJ1-5
TGCGCCAGCAGCCAAAGCCGCAAATGGGCGGGACAGGCGTCTCAGCCCCAGCATTTT	CASSQSRKWAGQASQPQHF	TRBV4-1	TRBJ1-5
TGTGCCAGCAGTGCCCCTGGGGAGAGTGAAATGAACACTGAAGCTTTCTTT	CASSAPGESEMNTEAFF	TRBV6-1	TRBJ1-1
TGTGCCAGCAGTCCTAGTGACTCTAGCGGGGCTCCCCCCTCCAGCGGAGAGACCCAGTACTTC	CASSPSDSSGAPPSSGETQYF	TRBV6-8	TRBJ2-5
TGTGCCAGCAGCGTAGTAGGGGGGGATACGCAGTATTTT	CASSVVGGDTQYF	TRBV9	TRBJ2-3
TGTGCCAGCAGGGGAGGATGTCTAGCTCCTGGAAACACCATATATTTT	CASRGGCLAPGNTIYF	TRBV6-5	TRBJ1-3
TGTGCCAGCAGGGGGTCGGTGAGGTACGAGCAGTACTTC	CASRGSVRYEQYF	TRBV6-1	TRBJ2-7
TGTGCCAGCAGTACGGCATCGGCCGGGACAGCCTACGAGCAGTACTTC	CASSTASAGTAYEQYF	TRBV6-6	TRBJ2-7
TGTGCCAGCACTCACATCCGGGGTAGCAATCAGCCCCAGCATTTT	CASTHIRGSNQPQHF	TRBV25-1	TRBJ1-5
TGTGCCAGCAGAGGGCACGAGCAGTACTTC	CASRGHEQYF	TRBV6-4	TRBJ2-7
TGCGCCAGCAACCCAGCGGCAGACGGCTACGAGCAGTACTTC	CASNPAADGYEQYF	TRBV10-1	TRBJ2-7
TGTGCCAGCAGCTTAGGTTTCAGGGGGGCACCCGAGCAGTACTTC	CASSLGFRGAPEQYF	TRBV11-3	TRBJ2-7
TGTGCCAGCAGTTTAGAGCAGGGGGCTTCTAGGGCCGGGGAGCTGTTTTTT	CASSLEQGASRAGELFF	TRBV12-3	TRBJ2-2
TGTGCCAATTGTATCTGGGGGCGCCCCCCTGAGGAAGCTTTCTTT	CANCIWGRPPEEAFF	TRBV7-9	TRBJ1-1
TGTGCCAGCAGCTTACGGGGGGACAGACTTGAGCAGTTCTTC	CASSLRGDRLEQFF	TRBV11-3	TRBJ2-1
TGTGCCAGCAGCGTAGTGACAGGGGAAAAATGTAGCAATCAGCCCCAGCATTTT	CASSVVTGEKCSNQPQHF	TRBV9	TRBJ1-5
TGTGCCACCAGTGATAGACAGACTAATGAAAAACTGTTTTTT	CATSDRQTNEKLFF	TRBV24-1	TRBJ1-4
TGTGCCAGCAGGACAAGGACCCCTAACTATGGCTACACCTTC	CASRTRTPNYGYTF	TRBV7-8	TRBJ1-2
TGTGCCATCAGGGGACAGGGCACAGATACGCAGTATTTT	CAIRGQGTDTQYF	TRBV10-3	TRBJ2-3
TGTGCCAGCAGTATCGGGTCGACTAGGGACGACAATGAGCAGTTCTTC	CASSIGSTRDDNEQFF	TRBV6-3	TRBJ2-1
TGCAGCGGTTTCAAGGGCTCCTACGAGCAGTACTTC	CSGFKGSYEQYF	TRBV29-1	TRBJ2-7
TGTGCCAGTCCGGAAGGTAGCGGGCATTCGGAGGGAGTTGAGACAGATACGCAGTATTTT	CASPEGSGHSEGVETDTQYF	TRBV19	TRBJ2-3
TGTGCCAGCAGCAGTTGGACAGTTGGCTACACCTTC	CASSSWTVGYTF	TRBV13	TRBJ1-2
TGCAGTGCTAGAGATCAGGACAGGGACTTTGCTTACGAGCAGTACTTC	CSARDQDRDFAYEQYF	TRBV20-1	TRBJ2-7
TGTGCCAGCAGCTCACTAAGTGGGGGGCTGGTCACCGGGGAGCTGTTTTTT	CASSSLSGGLVTGELFF	TRBV6-2	TRBJ2-2
TGCAGTGCTAGAGGGCCACCGGGACAGGGGAAGATTAATCAGCCCCAGCATTTT	CSARGPPGQGKINQPQHF	TRBV20-1	TRBJ1-5
TGCAGTGCAACCCCCTTAGGACAAGATGGCTACACCTTC	CSATPLGQDGYTF	TRBV20-1	TRBJ1-2
TGTGCCATTACCCAGTTCTTGTGCGGTCCTCAGCCCCAGCATTTT	CAITQFLCGPQPQHF	TRBV27	TRBJ1-5
TGTGCCAGCAGAGCGGGGAGGGTTAGCACTGAAGCTTTCTTT	CASRAGRVSTEAFF	TRBV25-1	TRBJ1-1
TGTGCCACCAGTGATTTCCCGAGGGAGCCCCAGCATTTT	CATSDFPREPQHF	TRBV24-1	TRBJ1-5
TGTGCGTACAGGGTTGGGAACACTGAAGCTTTCTTT	CAYRVGNTEAFF	TRBV7-6	TRBJ1-1
TGCGCCAGCAGCCCAAGACAGGGGGCCCAGGGGAATCAGCCCCAGCATTTT	CASSPRQGAQGNQPQHF	TRBV5-1	TRBJ1-5
TGTGCCACCAGTGAACTGATCCGGGACAGCCCTGAAAAACTGTTTTTT	CATSELIRDSPEKLFF	TRBV24-1	TRBJ1-4
TGTGCCAGCTCACCAGACGGATTTCGGACCCAGTACTTC	CASSPDGFRTQYF	TRBV18	TRBJ2-5
TGTGCCAGCAGCCAAGGACTACACAGGTGGGAGCTGTTTTTT	CASSQGLHRWELFF	TRBV3-1	TRBJ2-2
TGTGCCAGCAGAGGGGGTGATGTAAATCAGCCCCAGCATTTT	CASRGGDVNQPQHF	TRBV12-3	TRBJ1-5
TGTGCCAGCAGCTTAGGTGGGCCGGGTCGGCCTAATGAAAAACTGTTTTTT	CASSLGGPGRPNEKLFF	TRBV13	TRBJ1-4
TGTGCCAGCAGCTTACTGAGGGAGCCCAGCACAGATACGCAGTATTTT	CASSLLREPSTDTQYF	TRBV7-2	TRBJ2-3
TGTGCCATCTCGAGGACTAAGGTAGACATTCAGTACTTC	CAISRTKVDIQYF	TRBV27	TRBJ2-4
TGTGCCAGCAGCATTGAGCAGTTCTTC	CASSIEQFF	TRBV7-9	TRBJ2-1
TGTGCCAGCAGCCATGGACAGGGCCACTTTGAAAAACTGTTTTTT	CASSHGQGHFEKLFF	TRBV4-2	TRBJ1-4
TGTGCCAGCAGCATAACAGGTGGGACCGGGGAGCTGTTTTTT	CASSITGGTGELFF	TRBV7-9	TRBJ2-2
TGTGCCAGCAGCATGGGGGGCGAGCAGTACTTC	CASSMGGEQYF	TRBV11-2	TRBJ2-7
TGTGCCAGCAGTTCTTGCAGGGGCTACGAGCAGTACTTC	CASSSCRGYEQYF	TRBV28	TRBJ2-7
TGTGCCAGTAGACTTGGCATTCAGTACTTC	CASRLGIQYF	TRBV19	TRBJ2-4
TGTGCCAGTAGTATAGTGTCCCGCGGGGGGGGCAATCAGCCCCAGCATTTT	CASSIVSRGGGNQPQHF	TRBV19	TRBJ1-5
TGTGCCAGCAGCTTACGTTGGTCACTACAGGAGGGGGCGTACAATGAGCAGTTCTTC	CASSLRWSLQEGAYNEQFF	TRBV7-4	TRBJ2-1
TGTGCCAGCAGCCAACAACAGGGCTACGAGCAGTACTTC	CASSQQQGYEQYF	TRBV14	TRBJ2-7
TGTGCCAGCAGCGTCGCCGGAGGGGGAGTGGCAACTAATGAAAAACTGTTTTTT	CASSVAGGGVATNEKLFF	TRBV9	TRBJ1-4
TGTGCCAGCAGCTCCGAAGAGGCCGGGCAGCCCCAGCATTTT	CASSSEEAGQPQHF	TRBV12-3	TRBJ1-5
TGTGCTAGTAGCCTCCTCGTCGATGAAAAACTGTTTTTT	CASSLLVDEKLFF	TRBV12-5	TRBJ1-4
TGTGCCAGCAGTTCAGGTGAAAAACTGTTTTTT	CASSSGEKLFF	TRBV28	TRBJ1-4
TGTGCCAGCAGCCACAAGGTCCCCGGGGTATATGGCTACACCTTC	CASSHKVPGVYGYTF	TRBV3-1	TRBJ1-2
TGTGCCAGCAGCTTACAGGTCTACGGGAGGTTGATCTCCTACAATGAGCAGTTCTTC	CASSLQVYGRLISYNEQFF	TRBV11-2	TRBJ2-1
TGTGCCAGCAGCCAAAGGGGGTCCGGTACCATATATTTT	CASSQRGSGTIYF	TRBV13	TRBJ1-3
TGTGCCAGTAGTTACCAAAGCCAGGGCCGCTATGGCTACACCTTC	CASSYQSQGRYGYTF	TRBV19	TRBJ1-2
TGCAGTGCTAGAGATCTTTCGGGGAATCCTGGACTGGCCAAAAACATTCAGTACTTC	CSARDLSGNPGLAKNIQYF	TRBV20-1	TRBJ2-4
TGTGCCAGCAGTTTATCGCCCCCGGAGGTGGACGGACGGAGAGAGACCCAGTACTTC	CASSLSPPEVDGRRETQYF	TRBV28	TRBJ2-5
TGCGCCAGCAGGGGGCCGGACAGGGTCCTGAACTCTGGAAACACCATATATTTT	CASRGPDRVLNSGNTIYF	TRBV4-1	TRBJ1-3
TGTGCCAGCAGTGAACCAGCCTACGAGCAGTACTTC	CASSEPAYEQYF	TRBV6-1	TRBJ2-7
TGTGCCTGGTTCCTCCCCAGGGGGCGCTCTGGCTACACCTTC	CAWFLPRGRSGYTF	TRBV30	TRBJ1-2
TGTGCCAGCAGCCCTTATGCCCACAGGGTCTTC	CASSPYAHRVF	TRBV7-2	TRBJ2-1
TGCGCCAGCAGCTTGAGTTTTTCCAAGGGACTAGCGGGGAGGGAACACACCGGGGAGCTGTTTTTT	CASSLSFSKGLAGREHTGELFF	TRBV5-1	TRBJ2-2
TGCGCCAGCAGCACTACGGCGCCGGGACTAGTAAATGAGCAGTTCTTC	CASSTTAPGLVNEQFF	TRBV5-1	TRBJ2-1
TGTGCCAGCAGCCGGGTCCGTAGGACTAGCGGTGTCTACGAGCAGTACTTC	CASSRVRRTSGVYEQYF	TRBV6-2	TRBJ2-7
TGTGCCAGCAGCCCTACGGGGTCCAGCAATCAGCCCCAGCATTTT	CASSPTGSSNQPQHF	TRBV13	TRBJ1-5
TGCGCCAGCAGTGTAGAAGACGACATTAAAGAGACCCAGTACTTC	CASSVEDDIKETQYF	TRBV10-1	TRBJ2-5
TGTGCCAGCTCACCACCGAACCCCCGACTTGCCTACGAGCAGTACTTC	CASSPPNPRLAYEQYF	TRBV18	TRBJ2-7
TGTGCCAGCGACAGGGGCTACGAGCAGTACTTC	CASDRGYEQYF	TRBV6-1	TRBJ2-7
TGTGCCAGCAGAGGCACTAGCGGGAGTAGAGACAATTCACCCCTCCACTTT	CASRGTSGSRDNSPLHF	TRBV6-5	TRBJ1-6
TGCGCCAGCAGCCAAGAACCTGGCAGCGTGGAAAAGGGGCGGGGAATGAACACTGAAGCTTTCTTT	CASSQEPGSVEKGRGMNTEAFF	TRBV4-1	TRBJ1-1
TGTGCCAGCAGGACGGACACGGCTACTGGGAAAGAGACCCAGTACTTC	CASRTDTATGKETQYF	TRBV6-4	TRBJ2-5
TGTGCCAGCAGTTACTCTACAGGCACAGATACGCAGTATTTT	CASSYSTGTDTQYF	TRBV6-3	TRBJ2-3
TGTGCCAGATCATGCGGGAGGACTGAGCAGTTCTTC	CARSCGRTEQFF	TRBV28	TRBJ2-1
TGTGCCAGCAGTTACCCCTCCGTTACGGGCGGACGGAACAATGAGCAGTTCTTC	CASSYPSVTGGRNNEQFF	TRBV6-3	TRBJ2-1
TGCGCCAGCAGCCAAGTTTCCGGGACAGACCTCGCCTATGGCTACACCTTC	CASSQVSGTDLAYGYTF	TRBV4-1	TRBJ1-2
TGTGGCTGCCGGGACAGGGGAAAGGAAAAACTGTTTTTT	CGCRDRGKEKLFF	TRBV7-9	TRBJ1-4
TGTGCCAGCAGTGACTCCCCCACAGGGGATTCCTACGAGCAGTACTTC	CASSDSPTGDSYEQYF	TRBV6-4	TRBJ2-7
TGCGCCAGCAGTGGCGCGCGGTGGCAGCAGTTCTTC	CASSGARWQQFF	TRBV10-1	TRBJ2-1
TGTGCCAGCGGACCGGGACAGTGCGCCTACAATGAGCAGTTCTTC	CASGPGQCAYNEQFF	TRBV27	TRBJ2-1
TGTGCCACCAGTGATGTAGGGACGCATCAGCCCCAGCATTTT	CATSDVGTHQPQHF	TRBV24-1	TRBJ1-5
TGTGCCAGCAGTTTAGTCCGGGGTAGGTACAATCAGCCCCAGCATTTT	CASSLVRGRYNQPQHF	TRBV12-3	TRBJ1-5
TGTGCCAGCAGCCGTGAGATCGGGGGGGGACCCACTGAAGCTTTCTTT	CASSREIGGGPTEAFF	TRBV9	TRBJ1-1
TGTGCCAGCAGCCAATACCCGGCCTACGAGCAGTACTTC	CASSQYPAYEQYF	TRBV3-1	TRBJ2-7
TGTGCCAGCAGCCGACAGGGATCAACCAATGGCTACACCTTC	CASSRQGSTNGYTF	TRBV3-1	TRBJ1-2
TGTGCCAGCAGTTTGAAGACAGGGGGCTTTACCTCCTACGAGCAGTACTTC	CASSLKTGGFTSYEQYF	TRBV2	TRBJ2-7
TGCAGCGTTGGTGGGGACTTAATTACGCAGTATTTT	CSVGGDLITQYF	TRBV29-1	TRBJ2-3
TGTGCCAGCATCCGGCCGCACTTCCACAGGCCTCGGGAGTTAAGTTTTAAACCAGCCTACGAGCAGTACTTC	CASIRPHFHRPRELSFKPAYEQYF	TRBV9	TRBJ2-7
TGTGCCAGCAGCCCCCCCCGTTCCCGGGACAGGGGTCAGACCTATCGCAACAATCAGCCCCAGCATTTT	CASSPPRSRDRGQTYRNNQPQHF	TRBV13	TRBJ1-5
TGTGCCGAGTTTCTTAATAACTATGGCTACACCTTC	CAEFLNNYGYTF	TRBV6-5	TRBJ1-2
TGTGCCAGCAGCCAAGTTGGGGCTGCCTACGAGCAGTACTTC	CASSQVGAAYEQYF	TRBV3-1	TRBJ2-7
TGCAGTGCTGCCGTGACAGGGGGGGCTGAAGCTTTCTTT	CSAAVTGGAEAFF	TRBV20-1	TRBJ1-1
TGTGCCAGCAGGGGACCCGGGGATATGGTTAATCAGCCCCAGCATTTT	CASRGPGDMVNQPQHF	TRBV25-1	TRBJ1-5
TGCGCCAGCAGCTCATCAGACGAGCAGTACTTC	CASSSSDEQYF	TRBV5-1	TRBJ2-7
TGTGCCAGCAGCCCTCCGGGGGGCGGTTACAATGAGCAGTTCTTC	CASSPPGGGYNEQFF	TRBV13	TRBJ2-1
TGTGCCAGCGCCACACCAGAGGGGGTGCCCCAGCATTTT	CASATPEGVPQHF	TRBV7-3	TRBJ1-5
TGTGCCAGCAGCGGGCCTAGCGGGAACGATAGCTCTGGGGCCAACGTCCTGACTTTC	CASSGPSGNDSSGANVLTF	TRBV3-1	TRBJ2-6
TGTGCCAGCAGATCGACAGCACAAGAGACCCAGTACTTC	CASRSTAQETQYF	TRBV11-2	TRBJ2-5
TGTGCCACCAGGAGATGGGGACAGGGGGAGACCTACGAGCAGTACTTC	CATRRWGQGETYEQYF	TRBV24-1	TRBJ2-7
TGTGCCAGCAGCACCCCGAGTGAATACGAGCAGTACTTC	CASSTPSEYEQYF	TRBV7-4	TRBJ2-7
TGTGCCAGCAGGGTTACTAGCGGGAGCGGGGAGAACACTGAAGCTTTCTTT	CASRVTSGSGENTEAFF	TRBV28	TRBJ1-1
TGTGCCAGCAGCTGGGCCGTAATCTCAGGGGGGGCCACCGGGGAGCTGTTTTTT	CASSWAVISGGATGELFF	TRBV7-3	TRBJ2-2
TGTGCCAGCAGCTTGAGCCTCAAGGGAAACTATGGCTACACCTTC	CASSLSLKGNYGYTF	TRBV9	TRBJ1-2
TGTGCCAGCAGCTTAACCCGGGACAGGGCCACCGGGGAGCTGTTTTTT	CASSLTRDRATGELFF	TRBV5-6	TRBJ2-2
TGTGCCAGCAGCCGAGGTTTCGGACTGGGATCCTACGAGCAGTACTTC	CASSRGFGLGSYEQYF	TRBV13	TRBJ2-7
TGTGCCAGTCCGGGAGAGGGACTAGCCTCAGAGACCCAGTACTTC	CASPGEGLASETQYF	TRBV14	TRBJ2-5
TGTGCCACCAGTGATTTGCCCCAAGTGGGACTAGCGGGGGATACGCAGTATTTT	CATSDLPQVGLAGDTQYF	TRBV24-1	TRBJ2-3
TGTGCCAGCTCACGCCTCAGGGACCGGGAAAGGAGGGAGGCTGAAGCTTTCTTT	CASSRLRDRERREAEAFF	TRBV18	TRBJ1-1
TGCAGTGCTAGAGATTCTGATACGCAGTATTTT	CSARDSDTQYF	TRBV20-1	TRBJ2-3
TGTGCCAGCAGCTCCAGAAAAGATGAGCAGTTCTTC	CASSSRKDEQFF	TRBV7-2	TRBJ2-1
TGCAGTATGGCTGTACATGGCTACACCTTC	CSMAVHGYTF	TRBV20-1	TRBJ1-2
TGTGCCAGCAGCCAAGAGAGAAAGCCGGGACTAGCGGGCGAGCAGTACTTC	CASSQERKPGLAGEQYF	TRBV14	TRBJ2-7
TGCAGTGCTAGAGATAGCCCAGACAAGGATTCCTACAATGAGCAGTTCTTC	CSARDSPDKDSYNEQFF	TRBV20-1	TRBJ2-1
TGTGCCAGCAGCGCCTTCAGGGCGGGGGAGCTGTTTTTT	CASSAFRAGELFF	TRBV9	TRBJ2-2
TGTGCCAGCAGTTTGGGGCTGGGGCTCTCAGATACGCAGTATTTT	CASSLGLGLSDTQYF	TRBV27	TRBJ2-3
TGTGCCAGCAGCTTGGGGGGGCCCTCCTACGAGCAGTACTTC	CASSLGGPSYEQYF	TRBV28	TRBJ2-7
TGTGCCAGCAGCCGGCGCCCCGAGGGACTTTTCAGCGCCAAAAACATTCAGTACTTC	CASSRRPEGLFSAKNIQYF	TRBV14	TRBJ2-4
TGTGCCAGCAGCGCCCTCAGCAATGAGCAGTTCTTC	CASSALSNEQFF	TRBV7-2	TRBJ2-1
TGCGCCAGCAGCCAAGATGGGGGGCAGGAGACCCAGTACTTC	CASSQDGGQETQYF	TRBV4-3	TRBJ2-5
TGCGCCAGCAGGCTAACCTCCGGGACTAGATCATACTACAATGAGCAGTTCTTC	CASRLTSGTRSYYNEQFF	TRBV10-1	TRBJ2-1
TGTGCCAGCAGTTTAGCGCAACGGGGGACTATAAATGGCTACACCTTC	CASSLAQRGTINGYTF	TRBV12-3	TRBJ1-2
TGCGCCAGCAGCTTGGAAAAGCGGACAGGGAGTTGCTCTGAAGCTTTCTTT	CASSLEKRTGSCSEAFF	TRBV5-1	TRBJ1-1
TGTGCCAGCAGTTTTCGTGAAGAAGAGCCGACAGGAGCTGAAGCTTTCTTT	CASSFREEEPTGAEAFF	TRBV27	TRBJ1-1
TGCGCCAGCAGCTTGCGAATCCCCAAGGACAGGGGCTACGAGCAGTACTTC	CASSLRIPKDRGYEQYF	TRBV5-1	TRBJ2-7
TGTGCCAGCAGCGCGCGGGGGGCGGGTGAAATTAATGAAAAACTGTTTTTT	CASSARGAGEINEKLFF	TRBV7-3	TRBJ1-4
TGTGCCAGCAGCTTAGTTGAAAAGGGGACAGGATTAGCTTTCTTT	CASSLVEKGTGLAFF	TRBV11-2	TRBJ1-1
TGTGCCAGCAGTTACATCAGAAATCCCCGCTGGGGCAGGGGGGACACTGAAGCTTTCTTT	CASSYIRNPRWGRGDTEAFF	TRBV6-8	TRBJ1-1
TGTGCCAATCAGAGGCCTGAGCTAGCCTACAATGAGCAGTTCTTC	CANQRPELAYNEQFF	TRBV19	TRBJ2-1
TGTGCCAGCAGTTACTCGCGTTCCACTAGGCTAGGGAATGAGCAGTTCTTC	CASSYSRSTRLGNEQFF	TRBV6-3	TRBJ2-1
TGTGCCACCCGGGAAGGCTCAGCCACTGAAGCTTTCTTT	CATREGSATEAFF	TRBV24-1	TRBJ1-1
TGTGCCAGCAGCTTGGGGACAAGTGATAGGATTTTTAACCTGAACACTGAAGCTTTCTTT	CASSLGTSDRIFNLNTEAFF	TRBV7-3	TRBJ1-1
TGTGCCATCAGCAGTGCCGTTTCCGGCTTATCCTACGAGCAGTACTTC	CAISSAVSGLSYEQYF	TRBV10-3	TRBJ2-7
TGTGCCACCAGTGAAGCCGGGACACCATTCTTC	CATSEAGTPFF	TRBV24-1	TRBJ2-1
TGCAGTGCAAAAGAGGAGACCCTGAACACTGAAGCTTTCTTT	CSAKEETLNTEAFF	TRBV20-1	TRBJ1-1
TGTGCCAGCAGTCTCCACGACAATGTGCGGCCGTACTCTGGCAATCAGCCCCAGCATTTT	CASSLHDNVRPYSGNQPQHF	TRBV6-3	TRBJ1-5
TGTGCCAGCAGTCCCGGAGGGATTAGCACAGATACGCAGTATTTT	CASSPGGISTDTQYF	TRBV6-4	TRBJ2-3
TGTCCTAACTCAGGGGGGGCCGGTCCTCTAGATACGCAGTATTTT	CPNSGGAGPLDTQYF	TRBV7-9	TRBJ2-3
TGTGCCAGCAGTCCGCACTGGACTAGCGCCCACAATGAGCAGTTCTTC	CASSPHWTSAHNEQFF	TRBV6-5	TRBJ2-1
TGTGCCAGCAGCCACAGGGGATGCAATCAGCCCCAGCATTTT	CASSHRGCNQPQHF	TRBV13	TRBJ1-5
TGTGCCAGCAGTCCGGGACAGGGTCTAGCTTTCTTT	CASSPGQGLAFF	TRBV6-2	TRBJ1-1
TGTGCCTTAGAGCGCGAGGGACAGGGCGGGGAGCTGTTTTTT	CALEREGQGGELFF	TRBV10-3	TRBJ2-2
TGCGCCAGCAGCTTGGAGGGGGGGCACAATGAGCAGTTCTTC	CASSLEGGHNEQFF	TRBV5-1	TRBJ2-1
TGTGCCACCAGTGATCAGCAGGAAATCCCGTTGTATAATGGCTACACCTTC	CATSDQQEIPLYNGYTF	TRBV24-1	TRBJ1-2
TGTGCCAGCAGCCGGGGGGGACTAGCGGGCTACGAGCAGTACTTC	CASSRGGLAGYEQYF	TRBV13	TRBJ2-7
TGCAGTGCTAACCCGGGCAGTCGAGAGACCCAGTACTTC	CSANPGSRETQYF	TRBV20-1	TRBJ2-5
TGTGCTAGTGGTTTGGTGTTCTTAACCTCGGGGTTGGCTGGAAACACCATATATTTT	CASGLVFLTSGLAGNTIYF	TRBV12-5	TRBJ1-3
TGTGCCACCAGTGATTGCCCCGACAGGGGCTACACCTTC	CATSDCPDRGYTF	TRBV24-1	TRBJ1-2
TGTGCCAGCAGTTGGGTAATAAAACAGGGCTCAAATGGGCCCAATGAGCAGTTCTTC	CASSWVIKQGSNGPNEQFF	TRBV27	TRBJ2-1
TGTGCCAGCAGCCGAGGAGGACTAGCGGGCGAATACTACGAGCAGTACTTC	CASSRGGLAGEYYEQYF	TRBV7-3	TRBJ2-7
TGTGCCAGCAGTTGGCGAAGACAGGGGGCTGAGACCCAGTACTTC	CASSWRRQGAETQYF	TRBV12-4	TRBJ2-5
TGTGCCAGCAGCCAAGATACTACCGTTGAAGTCAGGGGGAGCTCCTACGAGCAGTACTTC	CASSQDTTVEVRGSSYEQYF	TRBV14	TRBJ2-7
TGTGCCAGCAGCGTAGACAGTCAAGGACCGGGACCTAGGAACACCGGGGAGCTGTTTTTT	CASSVDSQGPGPRNTGELFF	TRBV9	TRBJ2-2
TGCAGTGCTAGAGATAGGGATACGACAGTTGGGGACTATGGCTACACCTTC	CSARDRDTTVGDYGYTF	TRBV20-1	TRBJ1-2
TGTGCCAGCAGCTTACGAAGACAGGGGCGCTATGGCTACACCTTC	CASSLRRQGRYGYTF	TRBV7-2	TRBJ1-2
TGTGCCAGCAGCGAAGCCGGGACTAGCGCGACAGATACGCAGTATTTT	CASSEAGTSATDTQYF	TRBV7-3	TRBJ2-3
TGTGCCTGGAGCTTCAATTGTACGACGTCTGAAGCTTTCTTT	CAWSFNCTTSEAFF	TRBV30	TRBJ1-1
TGTGCCAGCAGCAGCGCATGTACAGATACGCAGTATTTT	CASSSACTDTQYF	TRBV7-6	TRBJ2-3
TGCGCCAGCAGCTTGGGGAGGGTATCAGGAGATCAGCCCCAGCATTTT	CASSLGRVSGDQPQHF	TRBV5-1	TRBJ1-5
TGTCCCCCTAGATTAAAGGGCCATGAGCAGTTCTTC	CPPRLKGHEQFF	TRBV7-9	TRBJ2-1
TGTGCCAGCAGCTTATTTCTGGACAGGGGAGCGCTCTACGAGCAGTACTTC	CASSLFLDRGALYEQYF	TRBV5-8	TRBJ2-7
TGCGCCAGCAGCTTGTGGGACAGGGGGATCTATGGCTACACCTTC	CASSLWDRGIYGYTF	TRBV5-1	TRBJ1-2
TGCAGTGCTAGCCTAGCCAAGGGAGGGCCAGGGGGGGGCTACAATGAGCAGTTCTTC	CSASLAKGGPGGGYNEQFF	TRBV20-1	TRBJ2-1
TGTGCCAGCAGCCCAACAGGGCCTATTGAAAAACTGTTTTTT	CASSPTGPIEKLFF	TRBV4-2	TRBJ1-4
TGTGCCAGCAGTTTTCCCGGACAGGGTAAGAACCACTACGAGCAGTACTTC	CASSFPGQGKNHYEQYF	TRBV12-3	TRBJ2-7
TGTGCCAGCCACACAACGCCCTACGAGCAGTACTTC	CASHTTPYEQYF	TRBV9	TRBJ2-7
TGTGCCAGCAGTGAACTACCGACCCAGTACTTC	CASSELPTQYF	TRBV6-1	TRBJ2-5
TGCGCCAGCAGTAGGAGGGGACTTTGGGAGCAGTACTTC	CASSRRGLWEQYF	TRBV10-1	TRBJ2-7
TGTGCCAGCCCTCTGGCTAGCGGATACTTATGCACAGATACGCAGTATTTT	CASPLASGYLCTDTQYF	TRBV4-2	TRBJ2-3
TGTGCCAGCATGGGTCACAGGGGCAGCAGGGAGAGAGGAGCCTACGAGCAGTACTTC	CASMGHRGSRERGAYEQYF	TRBV13	TRBJ2-7
TGTGCCAGCAGCATGTTTTTGCTGACAGGTCCTCCCCGGTGGGGAGTCACCGGGGAGCTGTTTTTT	CASSMFLLTGPPRWGVTGELFF	TRBV5-6	TRBJ2-2
TGTGCCAGCAGTTACGGGGGACAGGGGGCGCCCCTACACTCCTATAATTCACCCCTCCACTTT	CASSYGGQGAPLHSYNSPLHF	TRBV6-6	TRBJ1-6
TGTGCCACCAGCCAGGGCTATGGCTACACCTTC	CATSQGYGYTF	TRBV24-1	TRBJ1-2
TGCGCCAGCAGCTTAGGAAGGGTCCCGTTATATCAGCCCCAGCATTTT	CASSLGRVPLYQPQHF	TRBV5-1	TRBJ1-5
TGTGCCAGCAGCTTAAGAACGGACTACGAGCAGTACTTC	CASSLRTDYEQYF	TRBV11-3	TRBJ2-7
TGTGCCAGCAGCGGGGTTGAGGGGGGATTGGAGGGGGAGCAGTACTTC	CASSGVEGGLEGEQYF	TRBV13	TRBJ2-7
TGTGCCAGCAGCGGGGGAAAGGTGGACGAGCAGTACTTC	CASSGGKVDEQYF	TRBV5-8	TRBJ2-7
TGCGCCAGCAGCTTGAGGACTAACACCGGGGAGCTGTTTTTT	CASSLRTNTGELFF	TRBV5-1	TRBJ2-2
TGTGCCAGCAGTTGTTATAAGGACAGGGGGTCGAATGAGCAGTTCTTC	CASSCYKDRGSNEQFF	TRBV25-1	TRBJ2-1
TGTGCCAGCCTGGGACACACTGAAGCTTTCTTT	CASLGHTEAFF	TRBV6-2	TRBJ1-1
TGTGCCATCAGTGAAAGGGGGGGTGAGCAGTTCTTC	CAISERGGEQFF	TRBV10-3	TRBJ2-1
TGTGCCAGCAGTTTCACTCTTTGGGGGGATGAGCAGTTCTTC	CASSFTLWGDEQFF	TRBV12-3	TRBJ2-1
TGCGCCAGCCAAACCCCGGGTTTAACAGATACGCAGTATTTT	CASQTPGLTDTQYF	TRBV10-1	TRBJ2-3
TGTGCCAGCAGCTTACCGGGACAGGGCGAGTTTCGAAACACTGAAGCTTTCTTT	CASSLPGQGEFRNTEAFF	TRBV7-6	TRBJ1-1
TGTGCCAGCAGCTTGGCGGGGTGCACTGAAGCTTTCTTT	CASSLAGCTEAFF	TRBV5-4	TRBJ1-1
TGTGCCAGCTCACGAGAGACTCCAGGGACTAGCGCCTACAATGAGCAGTTCTTC	CASSRETPGTSAYNEQFF	TRBV18	TRBJ2-1
TGCGCCAGCATCCGGACAGGGGGGGACCAGCCCCAGCATTTT	CASIRTGGDQPQHF	TRBV5-1	TRBJ1-5
TGCGCCTACAGGGGACAGGACACCGGGGAGCTGTTTTTT	CAYRGQDTGELFF	TRBV10-2	TRBJ2-2
TGCGCCAGCAGCTTCTCCACAGGGGCCCATAATTCACCCCTCCACTTT	CASSFSTGAHNSPLHF	TRBV5-1	TRBJ1-6
TGCGCCAGCAGCTTGGCCTACCCGGGGGACGTTGGTGGGTACGAGCAGTACTTC	CASSLAYPGDVGGYEQYF	TRBV5-1	TRBJ2-7
TGTGCCAGCAGCGGGGGTTATAATTCACCCCTCCACTTT	CASSGGYNSPLHF	TRBV7-2	TRBJ1-6
TGTGCCAGCGAGCCCGCCCCCACTAGCGGGGGGGAGCTGTTTTTT	CASEPAPTSGGELFF	TRBV27	TRBJ2-2
TGTGCCTGGAGCGCAGGGAGCGAGCAGTACTTC	CAWSAGSEQYF	TRBV30	TRBJ2-7
TGTGCCAGCAGTGAATTTTGGCGGGAGAAAGACACAGATACGCAGTATTTT	CASSEFWREKDTDTQYF	TRBV2	TRBJ2-3
TGCGCCAGCAGCTGTCCCCGTTTTGGACAGATTTACGAGCAGTACTTC	CASSCPRFGQIYEQYF	TRBV5-1	TRBJ2-7
TGTGCCAGCAGTCTTAGGAGTAGTCGGAAGGACGAGCAGTACTTC	CASSLRSSRKDEQYF	TRBV6-8	TRBJ2-7
TGTGCCAGCAGGGAAGTGAGGGGGGACAGCTATAATTCACCCCTCCACTTT	CASREVRGDSYNSPLHF	TRBV28	TRBJ1-6
TGCAGTGCTAGAGATAGCGGCGGCCGGGACAGGGCTTTCGGCTACACCTTC	CSARDSGGRDRAFGYTF	TRBV20-1	TRBJ1-2
TGTGCCAGTCATGTCCCCAGACAGGATAGCTCCTACGAGCAGTACTTC	CASHVPRQDSSYEQYF	TRBV19	TRBJ2-7
TGTGCCTGGAGTGTACATTCCCTCGGGGGGATGCACCAGTACGGTGAGAGGGCCTACAATGAGCAGTTCTTC	CAWSVHSLGGMHQYGERAYNEQFF	TRBV30	TRBJ2-1
TGTGCCACACAGGCTTTCTTT	CATQAFF	TRBV13	TRBJ1-1
TGCGCCAGCAGCTTGGGGGACTACGAGCAGTACTTC	CASSLGDYEQYF	TRBV5-1	TRBJ2-7
TGCGCCAGCAGCAATCGAGGGACAGGCCTTTGCTTATGGACTGAAGCTTTCTTT	CASSNRGTGLCLWTEAFF	TRBV4-1	TRBJ1-1
TGTGCCAGCAGCGTAGCCCAGGGTGGAACGGGTGGCTACACCTTC	CASSVAQGGTGGYTF	TRBV9	TRBJ1-2
TGTGCCAGCAGCTTCAAGGAAGTCGCAACTAATGAAAAACTGTTTTTT	CASSFKEVATNEKLFF	TRBV7-8	TRBJ1-4
TGCAGTGCTAGAGACGGGGCCCGGGATGGCTACACCTTC	CSARDGARDGYTF	TRBV20-1	TRBJ1-2
TGTGCCAGCAGCGAACAGGGGGCGATGAACACTGAAGCTTTCTTT	CASSEQGAMNTEAFF	TRBV13	TRBJ1-1
TGTGCCACTCCCTTAATCCCCCAGGGACATCTAGACAATGAGCAGTTCTTC	CATPLIPQGHLDNEQFF	TRBV6-5	TRBJ2-1
TGCGCCAGCAGCAATCCAGGTAGCGATAGCACAGATACGCAGTATTTT	CASSNPGSDSTDTQYF	TRBV5-1	TRBJ2-3
TGTGCCATCAGTGAGTGCGGGACAGGGGACCCCCAGACCAACACAGATACGCAGTATTTT	CAISECGTGDPQTNTDTQYF	TRBV10-3	TRBJ2-3
TGTGCCAGCAGCGTCGCCCCCCCAAAGGGACAGGGAGGGATCTACGAGCAGTACTTC	CASSVAPPKGQGGIYEQYF	TRBV7-3	TRBJ2-7
TGTGCCAGCAGCCCGGCGACTAGCGGGAGAGAGAACACTGAAGCTTTCTTT	CASSPATSGRENTEAFF	TRBV7-9	TRBJ1-1
TGTGCCAGCAGCATTGACAAGGCGACTAATGAAAAACTGTTTTTT	CASSIDKATNEKLFF	TRBV7-2	TRBJ1-4
TGTGCCAGCAGTGACGGGGTCTGGACATTGGGTCCGTATGGCTACACCTTC	CASSDGVWTLGPYGYTF	TRBV6-4	TRBJ1-2
TGTGCCAGCAAGCGGGAGGACAGGCTCCGCAAAAACATTCAGTACTTC	CASKREDRLRKNIQYF	TRBV9	TRBJ2-4
TGTGCCTATTCCGGGACATTTGAGACCCAGTACTTC	CAYSGTFETQYF	TRBV6-4	TRBJ2-5
TGCGCCAGCAGCCAAGCGGCCCCGGACAGGGACTTC	CASSQAAPDRDF	TRBV4-1	TRBJ2-7
TGCGCCAGCAGCCAAGAAAGCGATACGGAGCAGTACTTC	CASSQESDTEQYF	TRBV4-3	TRBJ2-7
TGTGCCACCAGTGACCTGGGACAGGCTGCCTACGAGCAGTACTTC	CATSDLGQAAYEQYF	TRBV24-1	TRBJ2-7
TGCGCCAGCAGCCAAGTTACGTCCATTCTGACCCAGTACTTC	CASSQVTSILTQYF	TRBV4-1	TRBJ2-5
TGTGCCAGCAGCCGGAGGGGGGGGGTTTACGAGCAGTACTTC	CASSRRGGVYEQYF	TRBV3-1	TRBJ2-7
TGTGCCAAGAACCAGGTAGGCTCTGGGGCCAACGTCCTGACTTTC	CAKNQVGSGANVLTF	TRBV6-3	TRBJ2-6
TGTGCCTGGAGGCCCGGCAATCAGCCCCAGCATTTT	CAWRPGNQPQHF	TRBV30	TRBJ1-5
TGTGCCAGCAGCTTACTCCAGGACAACGAGCAGTACTTC	CASSLLQDNEQYF	TRBV7-9	TRBJ2-7
TGTGCCAGCAGCCCGGGGACGGAAGAGACCCAGTACTTC	CASSPGTEETQYF	TRBV13	TRBJ2-5
TGTGCCAGTAGCCCCGGGACAGGGCGTCCCTACGAGCAGTACTTC	CASSPGTGRPYEQYF	TRBV19	TRBJ2-7
TGTGCCACCCCCCGACTAGAAAGCTCCTACAATGAGCAGTTCTTC	CATPRLESSYNEQFF	TRBV6-3	TRBJ2-1
TGTGCCAGCAGCCATTCCAGGGAGCAGGACTACGAGCAGTACTTC	CASSHSREQDYEQYF	TRBV3-1	TRBJ2-7
TGTGCCATCAGTGATTCTGACAGGGCTGGAGAGCAGTACTTC	CAISDSDRAGEQYF	TRBV10-3	TRBJ2-7
TGTGCCAGCAGTTACCAGGGAGGCCTTAATTCACCCCTCCACTTT	CASSYQGGLNSPLHF	TRBV6-5	TRBJ1-6
TGTGCCAGCAGCTTAGAACGGGACAGGGGGCTAGTAAAACTGTTTTTT	CASSLERDRGLVKLFF	TRBV11-3	TRBJ1-4
TGTGCCAGCAGCGTAAGTCCTTCTGGGGTGGGAGCAAATAATTCACCCCTCCACTTT	CASSVSPSGVGANNSPLHF	TRBV9	TRBJ1-6
TGCAGTGCATTGGACAGGGTTCAGCCCCAGCATTTT	CSALDRVQPQHF	TRBV20-1	TRBJ1-5
TGCGCCATGTGGACTAGCGGGGATCCTGAGCAGTTCTTC	CAMWTSGDPEQFF	TRBV5-1	TRBJ2-1
TGTGCCAGCAGTGAATATAAGGGGGTAGCCAAAAACATTCAGTACTTC	CASSEYKGVAKNIQYF	TRBV25-1	TRBJ2-4
TGTGCCATTTTAAGAAGCGACTCCTACGAGCAGTACTTC	CAILRSDSYEQYF	TRBV19	TRBJ2-7
TGTGCCACCAGTCTGGGGGAGTCAGAGACCCAGTACTTC	CATSLGESETQYF	TRBV24-1	TRBJ2-5
TGTGCCAGCAGCTTGGGGGGGGCAGATACGCAGTATTTT	CASSLGGADTQYF	TRBV5-4	TRBJ2-3
TGTGCCAGCAGCCAAGTCCAAAAGGGGCCGGGAAGGGTCAAACTGTTTTTT	CASSQVQKGPGRVKLFF	TRBV3-1	TRBJ1-4
TGCAGTGCTAGAGAACGGGCGGGAGAGTTCAACATTCAGTACTTC	CSARERAGEFNIQYF	TRBV20-1	TRBJ2-4
TGTGCCAACGACAGGGCCTACGAGCAGTACTTC	CANDRAYEQYF	TRBV5-6	TRBJ2-7
TGTGCCAGCAGCAAGGGGGGGGGATTTAACACTGAAGCTTTCTTT	CASSKGGGFNTEAFF	TRBV5-6	TRBJ1-1
TGTGCCAGCAGTCCCCGGAGTAAAAAAAGGTGGGGCTACACCTTC	CASSPRSKKRWGYTF	TRBV27	TRBJ1-2
TGTGCCAGCAGCCAAGTACAACTTACTGACGAGCAGTACTTC	CASSQVQLTDEQYF	TRBV3-1	TRBJ2-7
TGTGCCAGCAGCTTCCACCCCCGGAGCTCCTACGAGCAGTACTTC	CASSFHPRSSYEQYF	TRBV11-3	TRBJ2-7
TGTGCCAGCAGTTACACGGTGCCAACGAGGCCGGGGGTGGCACAAGAGACCCAGTACTTC	CASSYTVPTRPGVAQETQYF	TRBV6-3	TRBJ2-5
TGTGCCAGCAGCCATCGCGTACCAGAGAACACTGAAGCTTTCTTT	CASSHRVPENTEAFF	TRBV14	TRBJ1-1
TGTGCCAGCAGTGAAGAACGGGGCGACCAGCCCCAGCATTTT	CASSEERGDQPQHF	TRBV2	TRBJ1-5
TGCGCCAGCAGCTCACCGGGGAGGGGGTTGAACATTCAGTACTTC	CASSSPGRGLNIQYF	TRBV5-1	TRBJ2-4
TGTGCCAGCAGCTTAATCCGGGACAGGGGTCAGAATCAGCCCCAGCATTTT	CASSLIRDRGQNQPQHF	TRBV7-3	TRBJ1-5
TGTGCCAGCAGCCCGACGCCCAACGAGCAGTACTTC	CASSPTPNEQYF	TRBV7-2	TRBJ2-7
TGCAGTGCTGCGATACACAGGGGTTGGACTGAAGCTTTCTTT	CSAAIHRGWTEAFF	TRBV20-1	TRBJ1-1
TGTGCCTGGAGTGTACATAGCGGGGAGTACAATGAGCAGTTCTTC	CAWSVHSGEYNEQFF	TRBV30	TRBJ2-1
TGCGCCAGCAGCTTGACGCGGGACAGGGACCTAGCCAAAAACATTCAGTACTTC	CASSLTRDRDLAKNIQYF	TRBV5-1	TRBJ2-4
TGTGCCAGCAGCGAAAGGACTAATGAAAAACTGTTTTTT	CASSERTNEKLFF	TRBV11-3	TRBJ1-4
TGTGCCACCAGCAGAACTACACGGAGAAGGACTGAAGCTTTCTTT	CATSRTTRRRTEAFF	TRBV15	TRBJ1-1
TGCAGTGCTATGACGGGAGGGCCCTGTGGGGGCTACACCTTC	CSAMTGGPCGGYTF	TRBV20-1	TRBJ1-2
TGTGCCAGCAGCTTTCGAGAACGGGGGGCATCAGCGGGGAGTGGAAACACCATATATTTT	CASSFRERGASAGSGNTIYF	TRBV7-9	TRBJ1-3
TGCGCCAGCAGCCGAAGGGGCAATCAGCCCCAGCATTTT	CASSRRGNQPQHF	TRBV5-1	TRBJ1-5
TGTGCCAGCAGCTTAGACAAACTGGGCCAAAAGGACAGGAACAATAGCTCCTACGAGCAGTACTTC	CASSLDKLGQKDRNNSSYEQYF	TRBV13	TRBJ2-7
TGTGCCAGCAGCCCTGAGTCAACTAATGAAAAACTGTTTTTT	CASSPESTNEKLFF	TRBV7-3	TRBJ1-4
TGTGCCTGGAGAGTGACTACAGGGGAAGAGACCCAGTACTTC	CAWRVTTGEETQYF	TRBV30	TRBJ2-5
TGCAGCGAGATTAGGGGACATGGGGAGGAGCAGTACTTC	CSEIRGHGEEQYF	TRBV29-1	TRBJ2-7
TGTGCCAGCAGCTTATGCCCCCCCGGGACTAGCGGAGTCGAGCAGTTCTTC	CASSLCPPGTSGVEQFF	TRBV7-6	TRBJ2-1
TGTGCCAGCAGTTTACAGCCCTACGAGCAGTACTTC	CASSLQPYEQYF	TRBV27	TRBJ2-7
TGTGCCAGCAGCCAATCCCGGGACAGGGAATCTGGAAACACCATATATTTT	CASSQSRDRESGNTIYF	TRBV16	TRBJ1-3
TGTGCCAGCAGCCTGCTGGGGGGGACGTATTTT	CASSLLGGTYF	TRBV7-3	TRBJ2-3
TGTGCCAGCAGCTTACCGAGCAGGGGGGGCGACGAGCAGTACTTC	CASSLPSRGGDEQYF	TRBV7-3	TRBJ2-7
TGCGCCAGCAGCTTGCCTGACAGGGAGATCCGTTCACCCCTCCACTTT	CASSLPDREIRSPLHF	TRBV5-1	TRBJ1-6
TGTGCCAGCAGCGTAGATGTTGGACAGGGTAACTATGGCTACACCTTC	CASSVDVGQGNYGYTF	TRBV28	TRBJ1-2
TGTGCCAGCCCCGGGACCTACGAGCAGTACTTC	CASPGTYEQYF	TRBV6-1	TRBJ2-7
TGCAGTGGATTCATCTTCTGTCGGGCGAACACTGAAGCTTTCTTT	CSGFIFCRANTEAFF	TRBV20-1	TRBJ1-1
TGCGCCAGCAGCCAAGATCGGTGGGCCTACGAGCAGTACTTC	CASSQDRWAYEQYF	TRBV4-3	TRBJ2-7
TGTGCTAGCAGCAGCAGGGTGCTCGTGGGAGATCAGCCCCAGCATTTT	CASSSRVLVGDQPQHF	TRBV7-7	TRBJ1-5
TGTGCCAGCAGCCAAGATCCCACCAGGGGCGGAAGGCGGTGGGCCTACGAGCAGTACTTC	CASSQDPTRGGRRWAYEQYF	TRBV14	TRBJ2-7
TGTGCCAGCAGCCAATTAGTAAGCGGGATAGAATCTGGGGAGCTGTTTTTT	CASSQLVSGIESGELFF	TRBV13	TRBJ2-2
TGTGCCAGCAGCTCCGGGACAGCTGGCTACACCTTC	CASSSGTAGYTF	TRBV11-3	TRBJ1-2
TGTGCCAGCAGCGTAGCTCCCCAGGACAGTTTTAGCTATGGCTACACCTTC	CASSVAPQDSFSYGYTF	TRBV9	TRBJ1-2
TGTGCCAGCAGTTACTCGATCAGACAGGGAGAGACCCAGTACTTC	CASSYSIRQGETQYF	TRBV6-3	TRBJ2-5
TGTGCCAGCAGGAGACACTTTTACACTGAAGCTTTCTTT	CASRRHFYTEAFF	TRBV6-5	TRBJ1-1
TGTGCCAGCAGTGAAATCGTCAAGGGGGGAAATTCACCCCTCCACTTT	CASSEIVKGGNSPLHF	TRBV25-1	TRBJ1-6
TGCGCCAGCAGCTCGCTTCGGACAGGGCCGAATGAAAAACTGTTTTTT	CASSSLRTGPNEKLFF	TRBV5-1	TRBJ1-4
TGTGCCAGCAGTTTAGGGGTAACACGCGGGGGCTTAGCCCCACACAATGAGCAGTTCTTC	CASSLGVTRGGLAPHNEQFF	TRBV28	TRBJ2-1
TGCGCCAGTATCACTGTTCAGGGGAGGGAAGAGACCCAGTACTTC	CASITVQGREETQYF	TRBV5-1	TRBJ2-5
TGTGCCAGCAGGCCTCCAGCAAGATGGGGTAGTAATTCACCCCTCCACTTT	CASRPPARWGSNSPLHF	TRBV6-6	TRBJ1-6
TGTGCCAGCAGCTTTTACGCACGGGACGACGAGCAGTACTTC	CASSFYARDDEQYF	TRBV27	TRBJ2-7
TGCGCCAGCAGCCAAGACACCGACGAGGGAGGCTTTGCAACTAATGAAAAACTGTTTTTT	CASSQDTDEGGFATNEKLFF	TRBV4-3	TRBJ1-4
TGTGCCAAAGAAGGGGGGGCCAGGTACGAGCAGTACTTC	CAKEGGARYEQYF	TRBV28	TRBJ2-7
TGTGCCAGCAGCCAAGAGGCGGACCAGCTAGCGGGGGGGCCATTTCACCAAGCCTACGAGCAGTACTTC	CASSQEADQLAGGPFHQAYEQYF	TRBV4-2	TRBJ2-7
TGTGCCAGCATTGGGGTGCCGTACGAGCAGTACTTC	CASIGVPYEQYF	TRBV12-4	TRBJ2-7
TGTGCCAGCAGCCCCCAAAGAACCGGGACAGGATTAGACGAGCAGTACTTC	CASSPQRTGTGLDEQYF	TRBV7-3	TRBJ2-7
TGTGCCAGCGGGAACTACGAGCAGTACTTC	CASGNYEQYF	TRBV5-8	TRBJ2-7
TGCGCCAGCAGCCAAGGGTTTAAACCGGGACAGGATTACACCGGGGAGCTGTTTTTT	CASSQGFKPGQDYTGELFF	TRBV4-1	TRBJ2-2
TGTGCCATCCCCTTTCGCGGTTACGAGACCCAGTACTTC	CAIPFRGYETQYF	TRBV10-3	TRBJ2-5
TGTGCCACCCCTCATGGTGAGCAGTTCTTC	CATPHGEQFF	TRBV24-1	TRBJ2-1
TGTGCCAGCTCAGACAGGGCGGAGAAAGAGACCCAGTACTTC	CASSDRAEKETQYF	TRBV25-1	TRBJ2-5
TGCGCCAGCACGAACCCAGGATCGCGGACAGGGAGTGCCTATGGCTACACCTTC	CASTNPGSRTGSAYGYTF	TRBV5-1	TRBJ1-2
TGTGCCAGCAGCAATCCCACCGGGGGGAGGGGCGCCCTAGAAAAACTGTTTTTT	CASSNPTGGRGALEKLFF	TRBV7-4	TRBJ1-4
TGTGCCAGCAGAGGGCGGACAGGGCAAAGGCCCCAGCATTTT	CASRGRTGQRPQHF	TRBV12-4	TRBJ1-5
TGTGCCAGCAGTCGGACTTCTAGCAATCAGCCCCAGCATTTT	CASSRTSSNQPQHF	TRBV2	TRBJ1-5
TGTGCCAGCAGTCCAACAGCCGGGCCCGAGTTCGGTTACTACGAGCAGTACTTC	CASSPTAGPEFGYYEQYF	TRBV12-4	TRBJ2-7
TGTGCCAGCAGTCCAGGGGGCGAGACCTATGGCTACACCTTC	CASSPGGETYGYTF	TRBV7-2	TRBJ1-2
TGTGCCAGCAGTATAGTCGACAGATATGGCTACACCTTC	CASSIVDRYGYTF	TRBV4-2	TRBJ1-2
TGTGCCAGCAGCTTACATGAAAAACTGTTTTTT	CASSLHEKLFF	TRBV13	TRBJ1-4
TGTGCCAGCAGTTTATACAGGTGGGGGTACGAGCAGTACTTC	CASSLYRWGYEQYF	TRBV27	TRBJ2-7
TGTGCCAGGATGGACAGATCGGTGCTTGGAGCCCGTCAGCCCCAGCATTTT	CARMDRSVLGARQPQHF	TRBV9	TRBJ1-5
TGTGCCAGCAGAACGAGGACAGGGCTAGCCAAAAACATTCAGTACTTC	CASRTRTGLAKNIQYF	TRBV6-5	TRBJ2-4
TGTGCCAGCAGCTTAGGTAAGGGGGGTTCGGATTCACCCCTCCACTTT	CASSLGKGGSDSPLHF	TRBV7-8	TRBJ1-6
TGTGCCACCAGCAGAGATGTAAGAGGGGAGCAGTTCTTC	CATSRDVRGEQFF	TRBV15	TRBJ2-1
TGCGCCACCGCGCGGATCGGTAAACTGTTTTTT	CATARIGKLFF	TRBV5-1	TRBJ1-4
TGTGCCAGCAGCTTAGAGAAACTAGCGGGAGTGCAGCCCCAGCATTTT	CASSLEKLAGVQPQHF	TRBV7-4	TRBJ1-5
TGTGCCAGCAGCACGGGAGGGGGCATGGTTGATTATTACGAGCAGTACTTC	CASSTGGGMVDYYEQYF	TRBV7-8	TRBJ2-7
TGCGCCAGCAGCTTGTTCGAGCAGCTGACAACTAGGTTTGCCCAGCCCCAGCATTTT	CASSLFEQLTTRFAQPQHF	TRBV5-1	TRBJ1-5
TGTGCCAGCAGCGTATCGGGGGGGCCCGGCGATGAGCAGTTCTTC	CASSVSGGPGDEQFF	TRBV9	TRBJ2-1
TGTGCCAGCAGCCAGACCGAGCAGTACTTC	CASSQTEQYF	TRBV13	TRBJ2-7
TGTGCCAGCAGTGAAGACCCGGGACAGGGACGTGAGACCCAGTACTTC	CASSEDPGQGRETQYF	TRBV6-1	TRBJ2-5
TGTGCCAGCACCGACGACCATGAGCAGTTCTTC	CASTDDHEQFF	TRBV28	TRBJ2-1
TGTGCCAGCAGCTCCCCGAGGAATAGCAATCAGCCCCAGCATTTT	CASSSPRNSNQPQHF	TRBV7-9	TRBJ1-5
TGTGCCAGCAGCTTAATCGGGGGAAAAACCGGACAGGGGGCGGAGTATAGCAATCAGCCCCAGCATTTT	CASSLIGGKTGQGAEYSNQPQHF	TRBV11-2	TRBJ1-5
TGCGCCAGCAGTGAGCAGGGACTAGTTAACTCCTACGAGCAGTACTTC	CASSEQGLVNSYEQYF	TRBV10-1	TRBJ2-7
TGTGTTCACAGGGAGAGAAATTCACCCCTCCACTTT	CVHRERNSPLHF	TRBV27	TRBJ1-6
TGTGCCACCAGAGCTAAGGGGGTCTCTGGGGCCAACGTCCTGACTTTC	CATRAKGVSGANVLTF	TRBV24-1	TRBJ2-6
TGCAGCGGCCTGGGGTGGATCTACGAGCAGTACTTC	CSGLGWIYEQYF	TRBV29-1	TRBJ2-7
TGCGCCAGCCTGGGGCCCCAAGCCAGCTACGAGCAGTACTTC	CASLGPQASYEQYF	TRBV10-1	TRBJ2-7
TGCGCCACAAATCCGGAGGGCTCTGGTTCACCCCTCCACTTT	CATNPEGSGSPLHF	TRBV10-1	TRBJ1-6
TGTGCCAGCTCGGTCACCTACGAGCAGTACTTC	CASSVTYEQYF	TRBV27	TRBJ2-7
TGTGCCAGTCCGCTTACCAGGGACAAAAAACTGTTTTTT	CASPLTRDKKLFF	TRBV19	TRBJ1-4
TGCAGCGTTGACGCGGGAGCGGGGAATGAAAAACTGTTTTTT	CSVDAGAGNEKLFF	TRBV29-1	TRBJ1-4
TGTGCCTGGACTATCCGCAGGGGAGAGACTATTCAACTGTTTTTT	CAWTIRRGETIQLFF	TRBV30	TRBJ1-4
TGCGCCAGCAGCCTCGGGAGCGGGAGCTCCTACAATGAGCAGTTCTTC	CASSLGSGSSYNEQFF	TRBV5-1	TRBJ2-1
TGCAGCTTGGGGGGTCCCTCTGGGGCCAACGTCCTGACTTTC	CSLGGPSGANVLTF	TRBV29-1	TRBJ2-6
TGTGCCAGCAGCTGCGGGGTCGGGTATTCTTACGAGCAGTACTTC	CASSCGVGYSYEQYF	TRBV7-6	TRBJ2-7
TGTGCCAGCAGCGTGGGACATGCTTACGAGCAGTACTTC	CASSVGHAYEQYF	TRBV7-7	TRBJ2-7
TGTGCCAGCAGCCATCGGAGGGGCTCTAATTCACCCCTCCACTTT	CASSHRRGSNSPLHF	TRBV14	TRBJ1-6
TGTGCCAGCAGTTTACTCCTAGCGGGGATTCCAGATACGCAGTATTTT	CASSLLLAGIPDTQYF	TRBV27	TRBJ2-3
TGTGCCAGCAGCCAAGAAGACCTGTTACGGGACAGTTGGACCTACGAGCAGTACTTC	CASSQEDLLRDSWTYEQYF	TRBV14	TRBJ2-7
TGTGCCCACCGGGCGGGACAGGGGGCAAGCCCTAACTATGGCTACACCTTC	CAHRAGQGASPNYGYTF	TRBV30	TRBJ1-2
TGCAGTGCTCCCCCCTCTGGGGGGTGTGGCTACACCTTC	CSAPPSGGCGYTF	TRBV20-1	TRBJ1-2
TGTGCCAGCAGTCCCGGGACGTCCTACAATGAGCAGTTCTTC	CASSPGTSYNEQFF	TRBV28	TRBJ2-1
TGTGCCAGCAGCTCGCCCGGGACGGTTAACACCGGGGAGCTGTTTTTT	CASSSPGTVNTGELFF	TRBV5-6	TRBJ2-2
TGTGCCAGGGGACAGCATTGGGCCTACGAGCAGTACTTC	CARGQHWAYEQYF	TRBV12-3	TRBJ2-7
TGCGCCAAACGTGAAACCCCCGGGACAGGGGTCTCCCTAGCCAAAAACATTCAGTACTTC	CAKRETPGTGVSLAKNIQYF	TRBV10-1	TRBJ2-4
TGTGCCAGCCCAGCGGGAACCCTAATAGAGGCCTACGAGCAGTACTTC	CASPAGTLIEAYEQYF	TRBV6-8	TRBJ2-7
TGCAGTGCATGGCCGGGACAGGGGGGAGTAGATTCACCCCTCCACTTT	CSAWPGQGGVDSPLHF	TRBV20-1	TRBJ1-6
TGTGCCAGCAGCCGCGGACCGGGGGTGCAGTACGAGCAGTACTTC	CASSRGPGVQYEQYF	TRBV4-2	TRBJ2-7
TGTGCCAGCAGCGTAGAGAGGGGGGCAGGAACCGGGGAGCTGTTTTTT	CASSVERGAGTGELFF	TRBV9	TRBJ2-2
TGTGCCACCAGTCCGGGACTAAAAGGGGGATACGAGCAGTACTTC	CATSPGLKGGYEQYF	TRBV24-1	TRBJ2-7
TGTGCCAGCTCACCAACAAGACAGGGGGTGAGAACTAGCACAGATACGCAGTATTTT	CASSPTRQGVRTSTDTQYF	TRBV18	TRBJ2-3
TGTGCCAGCAGTGAAGGTTTAGGAGGGGGCCCGATCTCCTACGAGCAGTACTTC	CASSEGLGGGPISYEQYF	TRBV6-1	TRBJ2-7
TGTGCCAGCAGCTTAGCCGTCAGGGGGCGGGCGGGGCGAGCTAGTGAGAATTCACCCCTCCACTTT	CASSLAVRGRAGRASENSPLHF	TRBV7-6	TRBJ1-6
TGTGCCAGCAGCCACAAGGAATTCGGGGGGCAGAGCTCCTACGAGCAGTACTTC	CASSHKEFGGQSSYEQYF	TRBV14	TRBJ2-7
TGTGCCAGCACAATTTCTAAGGGGCCTGATGAGCAGTTCTTC	CASTISKGPDEQFF	TRBV6-5	TRBJ2-1
TGTGCCAGCAGCGTGGGTGTCGACAGGGCCAGCTCTGGAAACACCATATATTTT	CASSVGVDRASSGNTIYF	TRBV9	TRBJ1-3
TGCGCCAGCAGCCCTCCCCGGGGGAGAGTGATTCAGTACTTC	CASSPPRGRVIQYF	TRBV4-1	TRBJ2-4
TGTGCTAGCAGCGCCTCGTACGGCACAGATACGCAGTATTTT	CASSASYGTDTQYF	TRBV7-7	TRBJ2-3
TGCGCCAGCAGCCGGGCGGGGGATATTTGCTACGAGCAGTACTTC	CASSRAGDICYEQYF	TRBV4-1	TRBJ2-7
TGTGCCAGCAGTGGTCCTTCCACTAGCGGGAGGGCTTCCCAGCCCCAGCATTTT	CASSGPSTSGRASQPQHF	TRBV2	TRBJ1-5
TGCGCCAGCAGTGAGAAAGAAGGACTAGCGGGAGTATCCTACGAGCAGTACTTC	CASSEKEGLAGVSYEQYF	TRBV10-1	TRBJ2-7
TGTGCCACCAAGTGCGGGAGGAAGACTAATGAAAAACTGTTTTTT	CATKCGRKTNEKLFF	TRBV24-1	TRBJ1-4
TGTGCCAGCAGCTTTAAAGGACGGGATTCACCCCTCCACTTT	CASSFKGRDSPLHF	TRBV7-6	TRBJ1-6
TGTGCCAGCAGTGAAGGACTGGGGGCTTGGGGTAACACCGGGGAGCTGTTTTTT	CASSEGLGAWGNTGELFF	TRBV2	TRBJ2-2
TGTGCCAGCAGTCGTAGGGGGCGAGAAGAGACCCAGTACTTC	CASSRRGREETQYF	TRBV6-5	TRBJ2-5
TGTGCCAAAGTATCGTCGCGGGACAGTAACATTAGGGGGGAGGCTGGAAACACCATATATTTT	CAKVSSRDSNIRGEAGNTIYF	TRBV10-3	TRBJ1-3
TGTGCCAGCAGCCGACCTAACCAGGACTGCACAGATACGCAGTATTTT	CASSRPNQDCTDTQYF	TRBV3-1	TRBJ2-3
TGTGCCAGTAGTATTTCGTTTCCGGGGGGGTCCGGCAATGAAGCTTTCTTT	CASSISFPGGSGNEAFF	TRBV19	TRBJ1-1
TGTGCCAGCAGCCTCGATAGACAACTAGCGGGAGGATCAGATACGCAGTATTTT	CASSLDRQLAGGSDTQYF	TRBV4-2	TRBJ2-3
TGTGCCAGCAGTTGGGGGGGCTATGGCTACACCTTC	CASSWGGYGYTF	TRBV7-2	TRBJ1-2
TGTGCCAGCAGCTTAGCCGAATACGACAGGGGGTTGTACGAGCAGTACTTC	CASSLAEYDRGLYEQYF	TRBV7-8	TRBJ2-7
TGTGCCAGCTCACCATTTCCCCAGGGGGGGGGATGGCGCACCGGGGAGCTGTTTTTT	CASSPFPQGGGWRTGELFF	TRBV18	TRBJ2-2
TGTGCCTGGAGTGTACACAGGGTTCGCGGGGAGCAGTTCTTC	CAWSVHRVRGEQFF	TRBV30	TRBJ2-1
TGTGCCAGTAGTATACGACGGACTAGCGGGAGAGGGGTCTACAATGAGCAGTTCTTC	CASSIRRTSGRGVYNEQFF	TRBV19	TRBJ2-1
TGTGCCAGCAGTCCCCCCCAAACATACAGGGCCGTCTCTGGGGCCAACGTCCTGACTTTC	CASSPPQTYRAVSGANVLTF	TRBV2	TRBJ2-6
TGCAGTGCTAGAGATGAGGTCCCGGACATGGATCATCAGCCCCAGCATTTT	CSARDEVPDMDHQPQHF	TRBV20-1	TRBJ1-5
TGTGCCAGCAGCCCCAAGGACAGGGGGCAGGAGTCTAACTATGGCTACACCTTC	CASSPKDRGQESNYGYTF	TRBV14	TRBJ1-2
TGTGCCACCACACCATCTGGAAACACCATATATTTT	CATTPSGNTIYF	TRBV27	TRBJ1-3
TGTGCCACCTTGGACAGGGATGAGCAGTTCTTC	CATLDRDEQFF	TRBV24-1	TRBJ2-1
TGCAGTGCTAGTCCAACAGGTATCCTTGGCTACACCTTC	CSASPTGILGYTF	TRBV20-1	TRBJ1-2
TGTGCCAGCAGCCAAGTGCGGAGTAACTATGGCTACACCTTC	CASSQVRSNYGYTF	TRBV14	TRBJ1-2
TGTGCCATAATAACCATTAAAACTCCGGGACATTCCTGGCAGCCCCAGCATTTT	CAIITIKTPGHSWQPQHF	TRBV27	TRBJ1-5
TGCAGTGCTAGCCAGGGGTACGAGCAGTACTTC	CSASQGYEQYF	TRBV20-1	TRBJ2-7
TGTGCCAGTAGTATCCCTCAGCGGGAGGTAGCCGAGCAGTACTTC	CASSIPQREVAEQYF	TRBV19	TRBJ2-7
TGTGCCAGCAGTTCGGTGACTGGAAACACCATATATTTT	CASSSVTGNTIYF	TRBV12-3	TRBJ1-3
TGTGCCAGTAGTAACCCCTCACCGGCCCCTAATTCACCCCTCCACTTT	CASSNPSPAPNSPLHF	TRBV19	TRBJ1-6
TGTGCCAGCAGTTCGGCAGGGGGCGGCTCCTACGAGCAGTACTTC	CASSSAGGGSYEQYF	TRBV6-2	TRBJ2-7
TGTGCCAGTCAGCGAAAAGAAAACTATGGCTACACCTTC	CASQRKENYGYTF	TRBV19	TRBJ1-2
TGTGCCACCGTTTGGGATCCTAAAGTATATTCCTACAATGAGCAGTTCTTC	CATVWDPKVYSYNEQFF	TRBV24-1	TRBJ2-1
TGTGCCAGCAGCACCTCCAGCGGCTACACCTTC	CASSTSSGYTF	TRBV6-5	TRBJ1-2
TGTGCCAGCAGCCCAGGACAGGGGAACTATGGCTACACCTTC	CASSPGQGNYGYTF	TRBV9	TRBJ1-2
TGTGCCAGCACTTCAGGGGATACGCAGTATTTT	CASTSGDTQYF	TRBV6-1	TRBJ2-3
TGTGCCACCGGGACTAGGAACAATGAGCAGTTCTTC	CATGTRNNEQFF	TRBV24-1	TRBJ2-1
TGTGCCACCAGTGATACCAAGGGGAACGAGCAGTACTTC	CATSDTKGNEQYF	TRBV24-1	TRBJ2-7
TGTGCCAGCAGTTTAACCATCCGGTGTGACAGGGTGAGGGGTCAGCCCCAGCATTTT	CASSLTIRCDRVRGQPQHF	TRBV28	TRBJ1-5
TGTGCCAGCAGCGTTTACTGGCTATGGAATGAGCAGTTCTTC	CASSVYWLWNEQFF	TRBV9	TRBJ2-1
TGTGCCAGCAGTCTCGGGGGCCGGCTCGAGCAGTACTTC	CASSLGGRLEQYF	TRBV6-1	TRBJ2-7
TGCGCCAGCAGTGAACGTACCCAGGGGGTGAACACTGAAGCTTTCTTT	CASSERTQGVNTEAFF	TRBV10-1	TRBJ1-1
TGTGCCAGCCAAATTGGGACAGGGGGTAACTATGGCTACACCTTC	CASQIGTGGNYGYTF	TRBV6-1	TRBJ1-2
TGTGCCAGCAGTTTCTGGGCGGCTTATGGCTACACCTTC	CASSFWAAYGYTF	TRBV6-5	TRBJ1-2
TGCAGTGCTAGAGCTCGGCATAGCGGGCTTGAAGCCTACGAGCAGTACTTC	CSARARHSGLEAYEQYF	TRBV20-1	TRBJ2-7
TGTGCCAGCAGCCAAGAGGGGCCTCCGAACTATGGCTACACCTTC	CASSQEGPPNYGYTF	TRBV14	TRBJ1-2
TGTGCCAGCAGCCAACCGGAACTAGCGGGAGAAAGGGGGACCACAGATACGCAGTATTTT	CASSQPELAGERGTTDTQYF	TRBV14	TRBJ2-3
TGTGCCAGCAATTCTCCACAAGAGGTGGGAGACGGGTATAGCAATCAGCCCCAGCATTTT	CASNSPQEVGDGYSNQPQHF	TRBV2	TRBJ1-5
TGTGCCAGCAGCCAAGACCGGGACAGTCCTGGAAACACCATATATTTT	CASSQDRDSPGNTIYF	TRBV3-1	TRBJ1-3
TGCAGTGCCCCAGCCGGGGGACAGAGTTCTAACTATGGCTACACCTTC	CSAPAGGQSSNYGYTF	TRBV20-1	TRBJ1-2
TGCGCCAGCGCTTATGGACTAGCGAAGGAGACCCAGTACTTC	CASAYGLAKETQYF	TRBV5-1	TRBJ2-5
TGCAGTGCGGTCCAGATCCTGACTAGCGGGGTAAAAGAGACCCAGTACTTC	CSAVQILTSGVKETQYF	TRBV20-1	TRBJ2-5
TGTGCCAGCAGCCCACTTGGGGTGAGCTCCTATAATTCACCCCTCCACTTT	CASSPLGVSSYNSPLHF	TRBV5-6	TRBJ1-6
TGTGCCAGTAAACAACAAAGCAGGCGGTGCACAAAACCTGAATACGAGCAGTACTTC	CASKQQSRRCTKPEYEQYF	TRBV19	TRBJ2-7
TGCGCCAGCAGCCCCTCAGGACAGGGGGATAACTCTGGGGCCAACGTCCTGACTTTC	CASSPSGQGDNSGANVLTF	TRBV4-3	TRBJ2-6
TGTGCCAGCAGCAGTGATACCGGGACGCGCAGCAATCAGCCCCAGCATTTT	CASSSDTGTRSNQPQHF	TRBV9	TRBJ1-5
TGCAGTGCTAGCGGTAATGAAAAACTGTTTTTT	CSASGNEKLFF	TRBV20-1	TRBJ1-4
TGTGCCAGCAGCGAACCACAGGGCTCTGGAAACACCATATATTTT	CASSEPQGSGNTIYF	TRBV7-3	TRBJ1-3
TGTGCCAGCAGTTTCCCGTCTTCAGATGGGCAGCCCCAGCATTTT	CASSFPSSDGQPQHF	TRBV27	TRBJ1-5
TGCGCCAGCTTTGGAAGGGGCACCGGGGAGCTGTTTTTT	CASFGRGTGELFF	TRBV10-2	TRBJ2-2
TGCGCCAGCAGCTGGCCCTCGCGAGGGGGGGGTGGTTACAATGAGCAGTTCTTC	CASSWPSRGGGGYNEQFF	TRBV5-1	TRBJ2-1
TGCGCCAGCAGCCAAGAACGGACAGTCCAGGGGGAGCTGTTTTTT	CASSQERTVQGELFF	TRBV4-1	TRBJ2-2
TGTGCCAATCGACAAGCCGCCGGGGGGTACCGGGGGGAGCAGTACTTC	CANRQAAGGYRGEQYF	TRBV30	TRBJ2-7
TGTGCCAGCAATACTAGCGGGGCGGCCCAATGCACAGATACGCAGTATTTT	CASNTSGAAQCTDTQYF	TRBV3-1	TRBJ2-3
TGTGCCAGCAGTAGGCAGGGTTGTGGCTACACCTTC	CASSRQGCGYTF	TRBV12-3	TRBJ1-2
TGCGCCACCGGGGAGCGGGGTAATGGCTACACCTTC	CATGERGNGYTF	TRBV10-1	TRBJ1-2
TGCAGTGCTAGAGGGCGGTACGAGCAGTACTTC	CSARGRYEQYF	TRBV20-1	TRBJ2-7
TGTGCTAGCAGCTTAGCGCGGGGTAAACTCGGAGATACGCAGTATTTT	CASSLARGKLGDTQYF	TRBV7-7	TRBJ2-3
TGTGCCTGGAGTTCTCAGAACTGCACAGATACGCAGTATTTT	CAWSSQNCTDTQYF	TRBV30	TRBJ2-3
TGCGCCAGCAGCTTGGATGGCAGGGGGATCCTCCTAGCCAAAAACATTCAGTACTTC	CASSLDGRGILLAKNIQYF	TRBV5-1	TRBJ2-4
TGTGCCAGCAGTCCGACAGGTCATCAGCCCCAGCATTTT	CASSPTGHQPQHF	TRBV6-4	TRBJ1-5
TGCGCCAGCAGGGAATTAGCGGGGGCGTACGAGCAGTACTTC	CASRELAGAYEQYF	TRBV10-1	TRBJ2-7
TGTGCCAGCAGTGAATTGGAACCTAGCGGGTCGGATGAGAACACCGGGGAGCTGTTTTTT	CASSELEPSGSDENTGELFF	TRBV6-4	TRBJ2-2
TGCCGGGGGGAGCTCTACGAGCAGTACTTC	CRGELYEQYF	TRBV20-1	TRBJ2-7
TGTGCCAGCAGTGCCCCGGGACGTGGGATGAACACTGAAGCTTTCTTT	CASSAPGRGMNTEAFF	TRBV25-1	TRBJ1-1
TGCAGCGTTGCTCCGGTCGACCGTGGTCAGCCCCAGCATTTT	CSVAPVDRGQPQHF	TRBV29-1	TRBJ1-5
TGTGCCAGCAGTTATCCTCAGGCCACCACAGATACGCAGTATTTT	CASSYPQATTDTQYF	TRBV6-5	TRBJ2-3
TGTGCCAGCAGCGTAGGGACTAGCGGGGGGAGGGGCTACAATGAGCAGTTCTTC	CASSVGTSGGRGYNEQFF	TRBV9	TRBJ2-1
TGTGCCAGCAGTGAAGGAGATCTACGGAAGGACAGGCCGGCAACTAATGAAAAACTGTTTTTT	CASSEGDLRKDRPATNEKLFF	TRBV6-6	TRBJ1-4
TGTGCCAGCAGTTTTAGTCCCCACTCACCTAATGAAAAACTGTTTTTT	CASSFSPHSPNEKLFF	TRBV27	TRBJ1-4
TGTGCCAGCAGCGACAGGGGTTTATTGAATTCTGGCTACACCTTC	CASSDRGLLNSGYTF	TRBV9	TRBJ1-2
TGTGCCACCAGTGAGATCGGACTAGTCATCGTTATTACGCAGTATTTT	CATSEIGLVIVITQYF	TRBV24-1	TRBJ2-3
TGTGCCAGCAGCTTAATGTGGGGGCACGACGGGGGGGAAAAACTGTTTTTT	CASSLMWGHDGGEKLFF	TRBV7-3	TRBJ1-4
TGTGCCAGCAGTTTAATCCGTCCCTCTAGTTGCTACGAGCAGTACTTC	CASSLIRPSSCYEQYF	TRBV27	TRBJ2-7
TGTGCCAGACTAAGACGCACAGATACGCAGTATTTT	CARLRRTDTQYF	TRBV6-4	TRBJ2-3
TGTGCCACCAGTGATTGTTCGGGAGGGGGCTGGCCGTTCATGAACACTGAAGCTTTCTTT	CATSDCSGGGWPFMNTEAFF	TRBV24-1	TRBJ1-1
TGTGCCCGGACGGAACGTGCGAGGTTTGGGGAGCTGTTTTTT	CARTERARFGELFF	TRBV24-1	TRBJ2-2
TGCGCCAGCAGCGCCTCCGGACTTATGAACACCGGGGAGCTGTTTTTT	CASSASGLMNTGELFF	TRBV5-1	TRBJ2-2
TGTGCCAGCCGAAGCGGGACAGGAGCTCAGTACTTC	CASRSGTGAQYF	TRBV19	TRBJ2-7
TGTGCCAGCAGCCTCCACCCAGTCACTTTCCGCCTAGCGGGGAGGACCTACGAGCAGTACTTC	CASSLHPVTFRLAGRTYEQYF	TRBV6-5	TRBJ2-7
TGTGCCACCAGAGGGCGAAGATATGAAAAACTGTTTTTT	CATRGRRYEKLFF	TRBV24-1	TRBJ1-4
TGTGCCAGCGTCATGGGGTACTATGGCTACACCTTC	CASVMGYYGYTF	TRBV13	TRBJ1-2
TGTGCCAGCAGCGAATTACTGGGACAGCCTTCTGGATCTTACGAGCAGTACTTC	CASSELLGQPSGSYEQYF	TRBV7-9	TRBJ2-7
TGTGCCACCAAGGAGGGGGGATCTGGGGCCAACGTCCTGACTTTC	CATKEGGSGANVLTF	TRBV24-1	TRBJ2-6
TGTGCCAGCAGCAACGTGGTAACGGAATGCTACGAGCAGTACTTC	CASSNVVTECYEQYF	TRBV9	TRBJ2-7
TGCGCCAGCAGTGAGCGGGGCTTCCACACCGGGGAGCTGTTTTTT	CASSERGFHTGELFF	TRBV10-1	TRBJ2-2
TGTGCCAGCACCCAGGGTGAAGCTTTCTTT	CASTQGEAFF	TRBV6-4	TRBJ1-1
TGTTACCAAACAGTCCGACAGGGTGCGGACTCGTATGGCTACACCTTC	CYQTVRQGADSYGYTF	TRBV14	TRBJ1-2
TGCAGCGTTGAAGATCGACGGGCCATTTACACTGAAGCTTTCTTT	CSVEDRRAIYTEAFF	TRBV29-1	TRBJ1-1
TGTGCCAGCAGTAGATGGGGGGCATACAATGAGCAGTTCTTC	CASSRWGAYNEQFF	TRBV27	TRBJ2-1
TGTGCCAGCAGTTACAAGGGAGGTGGAGATACGCAGTATTTT	CASSYKGGGDTQYF	TRBV6-5	TRBJ2-3
TGTGCCAGCAGCCTGTTGGAGACGAGGCCCGGGACTAGCGGGGGAACGAACACCGGGGAGCTGTTTTTT	CASSLLETRPGTSGGTNTGELFF	TRBV7-3	TRBJ2-2
TGTGCCACCGGACAGGGGCCCCAGCATTTT	CATGQGPQHF	TRBV2	TRBJ1-5
TGTGCCAGCAACCTCCCGGCGGGAGACGAGCAGTACTTC	CASNLPAGDEQYF	TRBV11-3	TRBJ2-7
TGTGCCAGCAGTTGGAGGGCCTACGAGCAGTACTTC	CASSWRAYEQYF	TRBV28	TRBJ2-7
TGTGCCAGCAGTTTAGCAACCAGGGGGCAGGGCTACACCTTC	CASSLATRGQGYTF	TRBV12-4	TRBJ1-2
TGTGCCAGCAGCCGGGGCTCCGGACAGTACTTC	CASSRGSGQYF	TRBV7-9	TRBJ2-5
TGCAGCGGACGGGCGACAGGGAACGAAAAACTGTTTTTT	CSGRATGNEKLFF	TRBV29-1	TRBJ1-4
TGTGCCAGCAGTTACCGGGGGGCCGTAAAAGAGACCCAGTACTTC	CASSYRGAVKETQYF	TRBV27	TRBJ2-5
TGTGCCAGCAGGCTCAGTATTAACCGAAATCAGCCCCAGCATTTT	CASRLSINRNQPQHF	TRBV6-2	TRBJ1-5
TGTGCCAGCAGTAAGCGGACAGTGGGTCAGCCCCAGCATTTT	CASSKRTVGQPQHF	TRBV6-2	TRBJ1-5
TGTGCCAGCAGTTCCTACCAGTGGCACTACGAGCAGTACTTC	CASSSYQWHYEQYF	TRBV6-5	TRBJ2-7
TGTGCCAGCAGCCAAGAAACTCCAATCTCCTACGAGCAGTACTTC	CASSQETPISYEQYF	TRBV3-1	TRBJ2-7
TGTGCCAGTAGTATTGACCAACAGGGTTACGAGCAGTACTTC	CASSIDQQGYEQYF	TRBV19	TRBJ2-7
TGTGCCAGCAGCCGTCACAGTAGGGGTCACACCTTC	CASSRHSRGHTF	TRBV13	TRBJ1-2
TGTGCCCCGGGGGGGACGGCTGAAAAACTGTTTTTT	CAPGGTAEKLFF	TRBV5-6	TRBJ1-4
TGTGCCAGCAGGACACAGGGGGATCCCCCCGAAAAAGAGACCCAGTACTTC	CASRTQGDPPEKETQYF	TRBV6-6	TRBJ2-5
TGTGCCAGCAGTTTGACGGGGGACAGGGTAAGAAGGACCCACCTAAGCTCCTACGAGCAGTACTTC	CASSLTGDRVRRTHLSSYEQYF	TRBV2	TRBJ2-7
TGTGCCAGCAGCCAAGCCCGTTTTCCCACAACCCCGGTCACCTCCCGACAGGGTCAAAGGGAGCTGTTTTTT	CASSQARFPTTPVTSRQGQRELFF	TRBV14	TRBJ2-2
TGCAGTGCCCTCCGGCTGCCCTGGGAGCCCCAGCATTTT	CSALRLPWEPQHF	TRBV20-1	TRBJ1-5
TGTGCCAGCAGTTTAGGGGAAAAGTATCAGCCCCAGCATTTT	CASSLGEKYQPQHF	TRBV27	TRBJ1-5
TGTGCCAGCAGCTTCACAGCAGAGGGGATCTACGAGCAGTACTTC	CASSFTAEGIYEQYF	TRBV7-3	TRBJ2-7
TGTGCCAGCAGTAGGTTGTGGACAGGGGTAAAGTGTACGGCAGAGCAGTACTTC	CASSRLWTGVKCTAEQYF	TRBV6-5	TRBJ2-7
TGCGCCAGAACCAGGGTGGACAGGTGGGGAAAACCAGATACGCAGTATTTT	CARTRVDRWGKPDTQYF	TRBV10-1	TRBJ2-3
TGCCTTATGCCCAGACTAGCGGGAGGGCCCAGGACTGAAGCTTTCTTT	CLMPRLAGGPRTEAFF	TRBV20-1	TRBJ1-1
TGTGCCAGCAGTTACTCGGGAGTGGATAATGAAAAACTGTTTTTT	CASSYSGVDNEKLFF	TRBV6-3	TRBJ1-4
TGTGCCAGCAGATCCTCTAACGAGCAGTACTTC	CASRSSNEQYF	TRBV6-4	TRBJ2-7
TGTGCCAGCAGTGACTCGCTTCCGCTAACGGGACTAGACTCAGGAACCGGGGAGCTGTTTTTT	CASSDSLPLTGLDSGTGELFF	TRBV6-4	TRBJ2-2
TGTGCCAGCAGTTACCCGGAGCGGGGGGCAGATGAGCAGTTCTTC	CASSYPERGADEQFF	TRBV6-5	TRBJ2-1
TGTGCCAGCAGCTATGGGACTAGTGATGAGCAGTACTTC	CASSYGTSDEQYF	TRBV5-8	TRBJ2-7
TGTGCCAGCAGAAAGACAGGGAACTATGGCTACACCTTC	CASRKTGNYGYTF	TRBV6-2	TRBJ1-2
TGTGCCACCAGCAGATCCCACCGGACAGGGCACACCGGGGAGCTGTTTTTT	CATSRSHRTGHTGELFF	TRBV15	TRBJ2-2
TGTGCCAGCAGATACGGGGGCCCCGAGCAGTACTTC	CASRYGGPEQYF	TRBV6-4	TRBJ2-7
TGTGCCACCAGTGAGGTTCCCTTGACTAGCTCTGGGGGATACGAGCAGTACTTC	CATSEVPLTSSGGYEQYF	TRBV24-1	TRBJ2-7
TGTGCCAGCAGAGGGGTAAGCACTGAAGCTTTCTTT	CASRGVSTEAFF	TRBV27	TRBJ1-1
TGCAGTGCTCTCATTGAGGGGGTCGGGAATCAGCCCCAGCATTTT	CSALIEGVGNQPQHF	TRBV20-1	TRBJ1-5
TGCAGTGCTAGAGACCCCGACAGGGGACGCTCCTACGAGCAGTACTTC	CSARDPDRGRSYEQYF	TRBV20-1	TRBJ2-7
TGTGCCAGCAGGAGTGGAAGAAACAGGAGTAGTCCCGAGCAGTACTTC	CASRSGRNRSSPEQYF	TRBV27	TRBJ2-7
TGTGCCAGCAGCCAACCCCCACTAACAGTAGTCTGCTACGAGCAGTACTTC	CASSQPPLTVVCYEQYF	TRBV3-1	TRBJ2-7
TGTGCCAGCAGCCAGAAATGGGAGGGGGGCTACACCTTC	CASSQKWEGGYTF	TRBV3-1	TRBJ1-2
TGTGCCAGCAGCCGAGGGTGGGATAATTCACCCCTCCACTTT	CASSRGWDNSPLHF	TRBV7-2	TRBJ1-6
TGTGCCAGCAGGGGTAGCGGGATGAGCTCCTACAATGAGCAGTTCTTC	CASRGSGMSSYNEQFF	TRBV12-3	TRBJ2-1
TGTGCCAGCAGCCCGTCCGGGGGAATGACCACTGAAGCTTTCTTT	CASSPSGGMTTEAFF	TRBV9	TRBJ1-1
TGCGCCAGCAGCTTGGTGGCCGGACAGGAGAACACTGAAGCTTTCTTT	CASSLVAGQENTEAFF	TRBV5-1	TRBJ1-1
TGCGCCAGCAGTGATTGGGGGAGGACGGAACGCAATGAAAAACTGTTTTTT	CASSDWGRTERNEKLFF	TRBV10-1	TRBJ1-4
TGTGCCAGCAGTCGGACTCCCGGCAGGGGGGCCTACGAGCAGTACTTC	CASSRTPGRGAYEQYF	TRBV12-3	TRBJ2-7
TGTGCCAGCATACTAGCCGGACAGAAATACACCTTC	CASILAGQKYTF	TRBV6-4	TRBJ1-2
TGTGCCAGCACCACCGGCCTACAGGGGCTTAGAATATGGTCCGAAAAACTGTTTTTT	CASTTGLQGLRIWSEKLFF	TRBV6-2	TRBJ1-4
TGTGCCAGCAGCTTAATAGGAACTAGGTCCTACAATGAGCAGTTCTTC	CASSLIGTRSYNEQFF	TRBV7-3	TRBJ2-1
TGTGCCAGTAGCCGGACAGGGAAGAAAAGTGAAGCTTTCTTT	CASSRTGKKSEAFF	TRBV19	TRBJ1-1
TGTGCCAGAGACGGTATAGGGTTTAATCAGCCCCAGCATTTT	CARDGIGFNQPQHF	TRBV25-1	TRBJ1-5
TGTGCCAGCAGCCAAGATCTGCCGGGAATATCACCCACAGATACGCAGTATTTT	CASSQDLPGISPTDTQYF	TRBV14	TRBJ2-3
TGTGCCAGCAGTAGGGGGGATTGCAATCAGCCCCAGCATTTT	CASSRGDCNQPQHF	TRBV2	TRBJ1-5
TGCAGCGTTGAGGGAAACAGAAGAGGAAACACCATATATTTT	CSVEGNRRGNTIYF	TRBV29-1	TRBJ1-3
TGTGCCAGCAGTTACTCCACAGGGTGGTTCGAGCCCCAGCATTTT	CASSYSTGWFEPQHF	TRBV6-5	TRBJ1-5
TGTGCTAGTGGTCGCGCCGGACAGGAAACCAATCAGCCCCAGCATTTT	CASGRAGQETNQPQHF	TRBV12-5	TRBJ1-5
TGCAGTGCCTCCGAACAGGGCTCTGGAAACACCATATATTTT	CSASEQGSGNTIYF	TRBV20-1	TRBJ1-3
TGTGCCACCAGCAGAGCATCCCCAGGGCATACTACTGAAGCTTTCTTT	CATSRASPGHTTEAFF	TRBV15	TRBJ1-1
TGTCAGCGGTGTAACTATGGCTACACCTTC	CQRCNYGYTF	TRBV10-3	TRBJ1-2
TGTGCCAGCAGCTCACGGACTAGCGGGCAAGAGACCCAGTACTTC	CASSSRTSGQETQYF	TRBV7-4	TRBJ2-5
TGTGCCAAGGGGGCACCTCAAGGGACGGTCAAATACAATGAGCAGTTCTTC	CAKGAPQGTVKYNEQFF	TRBV13	TRBJ2-1
TGTGCCAGCAGCAAGGACGGCCAACTAGAGAACTATGGCTACACCTTC	CASSKDGQLENYGYTF	TRBV7-2	TRBJ1-2
TGTGCCAGCAGTTATTTAGGCGCCTCAGATACGCAGTATTTT	CASSYLGASDTQYF	TRBV6-9	TRBJ2-3
TGCGCCCAACAGGGGAGGTACAATGAGCAGTTCTTC	CAQQGRYNEQFF	TRBV10-1	TRBJ2-1
TGCGCCAGCAGCCAAGGCTCCGGGACAGCGGCGAATCAGCCCCAGCATTTT	CASSQGSGTAANQPQHF	TRBV4-3	TRBJ1-5
TGCGCCAGCAGCGTGAGGACAGGGGGGAATAACTATGGCTACACCTTC	CASSVRTGGNNYGYTF	TRBV5-1	TRBJ1-2
TGTGCCAGCACCTCCCGGCCGTACTTC	CASTSRPYF	TRBV27	TRBJ2-5
TGTGCCAGCAGCTGTCACCTCAAGCCAGCTTTCTTT	CASSCHLKPAFF	TRBV5-4	TRBJ1-1
TGTGCCAGCAGTTCCGTACGTAACTACGAGCAGTACTTC	CASSSVRNYEQYF	TRBV6-4	TRBJ2-7
TGTGCCAGTAACCGGGGGGGATACAATGAGCAGTTCTTC	CASNRGGYNEQFF	TRBV19	TRBJ2-1
TGCAGTGCTAGAGGGACCTACAATGAGCAGTTCTTC	CSARGTYNEQFF	TRBV20-1	TRBJ2-1
TGTGCCAGCAGCCCAACAGGGTGCTATGGCTACACCTTC	CASSPTGCYGYTF	TRBV9	TRBJ1-2
TGTGCCAGGATCGGGTTAAGGAATAGCAATCAGCCCCAGCATTTT	CARIGLRNSNQPQHF	TRBV28	TRBJ1-5
TGTGCCAGGTTAATTTATAGAAATACGGGCACCGGGGAGCTGTTTTTT	CARLIYRNTGTGELFF	TRBV6-5	TRBJ2-2
TGTGCCAGCAGCAACCCTATCACCGGGGAGCTGTTTTTT	CASSNPITGELFF	TRBV7-4	TRBJ2-2
TGTGCCTGGAGTGCCAGAGGGTGGGAACAATACGAGCAGTACTTC	CAWSARGWEQYEQYF	TRBV30	TRBJ2-7
TGTGCCAGCAGTGAAGCGCGCCCGGTAAAGCGGGGGAAGTCCTACGAGCAGTACTTC	CASSEARPVKRGKSYEQYF	TRBV2	TRBJ2-7
TGTGCCAGCAGCTTAACCCTTAGCTTAGGGGGCACAGATACGCAGTATTTT	CASSLTLSLGGTDTQYF	TRBV7-9	TRBJ2-3
TGTGCCAGCAGCTTGTTTTGTAGTTGGTCGCAAGAGACCCAGTACTTC	CASSLFCSWSQETQYF	TRBV11-1	TRBJ2-5
TGTGCCAGCAGCCAAGTTCCTAGCATTACCGCTCAGCGGTACAATGAGCAGTTCTTC	CASSQVPSITAQRYNEQFF	TRBV3-1	TRBJ2-1
TGTGCCAGCAGTGACAGGCGGAAAGAGACCCAGTACTTC	CASSDRRKETQYF	TRBV6-4	TRBJ2-5
TGTGCCAGCAGTTACCAGTCTAGGGCCTCCTACGAGCAGTACTTC	CASSYQSRASYEQYF	TRBV6-2	TRBJ2-7
TGTGCCAGCAGTGTAAGTACTCTAAGCTCCTACGAGCAGTACTTC	CASSVSTLSSYEQYF	TRBV6-1	TRBJ2-7
TGCGCCAGCAGCCATTCCACTGGACAGGCCCTCCACTTT	CASSHSTGQALHF	TRBV4-1	TRBJ1-6
TGTGCCACCAGTGTGCCGGGGAGCAGCATGAACACTGAAGCTTTCTTT	CATSVPGSSMNTEAFF	TRBV24-1	TRBJ1-1
TGTGCCTGGAGCTGGGGGGGGCATTCTGGAAACACCATATATTTT	CAWSWGGHSGNTIYF	TRBV30	TRBJ1-3
TGTGCCAGCTCATCAAAGAGGAGAGACTTATCCTACGAGCAGTACTTC	CASSSKRRDLSYEQYF	TRBV18	TRBJ2-7
TGTGCCAGCAGCAGGACAGGGGGCCCAGATACGCAGTATTTT	CASSRTGGPDTQYF	TRBV13	TRBJ2-3
TGTGCCAGCAAAAATGGGGGGGCTGAGCAGTTCTTC	CASKNGGAEQFF	TRBV27	TRBJ2-1
TGTGCCAGCAGCATCGTGGACCGCAAGAACGAGCAGTACTTC	CASSIVDRKNEQYF	TRBV11-3	TRBJ2-7
TGTGCTAGTGGCCGCTATTTAGTCAATGAGCAGTTCTTC	CASGRYLVNEQFF	TRBV12-5	TRBJ2-1
TGTGCCAGCAGCTTTTTGGGGGGGGGGGCGAACACCGGGGAGCTGTTTTTT	CASSFLGGGANTGELFF	TRBV11-2	TRBJ2-2
TGTGCCAGCAGCCAAGAAAAAGTGCAGGGGATGAAAACAGCTTTCTTT	CASSQEKVQGMKTAFF	TRBV4-2	TRBJ1-1
TGTGCTAGTGGTTTGGTAGACCTAGAGGGGCCTTCACCCCTCCACTTT	CASGLVDLEGPSPLHF	TRBV12-5	TRBJ1-6
TGTGCCAGCCAAAACCCGACTAGCGGAGAGCAGTACTTC	CASQNPTSGEQYF	TRBV19	TRBJ2-7
TGTGCCAGCATTGGGACAGGCATTCTCTACGAGCAGTACTTC	CASIGTGILYEQYF	TRBV5-4	TRBJ2-7
TGTGCCGGAGTCCTAGCGGGGACCCAGACGCAGTATTTT	CAGVLAGTQTQYF	TRBV24-1	TRBJ2-3
TGTGCCACCGCCCAGGCAAGGTACCAAGAGACCCAGTACTTC	CATAQARYQETQYF	TRBV24-1	TRBJ2-5
TGTGCCAGCAGCGTCCTTTTGGGCGGACAGGGGTGTGAAGCTTTCTTT	CASSVLLGGQGCEAFF	TRBV13	TRBJ1-1
TGTCGGGACAGGGTTTCCTACGAGCAGTACTTC	CRDRVSYEQYF	TRBV6-1	TRBJ2-7
TGTGCCTGGAGTCGGGGAGTGACTGAAGCTTTCTTT	CAWSRGVTEAFF	TRBV30	TRBJ1-1
TGCAGTGCTATACTTCCCGTACAGACGGATACGCAGTATTTT	CSAILPVQTDTQYF	TRBV20-1	TRBJ2-3
TGTGCCAGCAGTGACTCGATGGCGGCCCACGAGCAGTACTTC	CASSDSMAAHEQYF	TRBV6-4	TRBJ2-7
TGTGCCAGCAAAAGGACGGGGGATTCCTACGAGCAGTACTTC	CASKRTGDSYEQYF	TRBV12-3	TRBJ2-7
TGTGCCAGCACGGCTTTGTACAATGAGCAGTTCTTC	CASTALYNEQFF	TRBV25-1	TRBJ2-1
TGTGCTTCGGGGTACTTTGGCTACACCTTC	CASGYFGYTF	TRBV7-7	TRBJ1-2
TGTGCCAGCAGCACTTGTACCTTAGGATGGACTAGAAACGAGCAGTACTTC	CASSTCTLGWTRNEQYF	TRBV7-3	TRBJ2-7
TGTGCCAGCAGCTTCCAGGGCACGTACGAGCAGTACTTC	CASSFQGTYEQYF	TRBV7-9	TRBJ2-7
TGTGCCAGCAGTAGTTTACCTAACTACGAGCAGTACTTC	CASSSLPNYEQYF	TRBV6-5	TRBJ2-7
TGTGCCAGCAGCGGTTGGGACAGGGTTTGTGAAGCTTTCTTT	CASSGWDRVCEAFF	TRBV13	TRBJ1-1
TGCGCCAGCAGCCAAGATACGGCGGATGATGATACGCAGTATTTT	CASSQDTADDDTQYF	TRBV4-1	TRBJ2-3
TGTGCCAGCAAAGGGCGGAGGACATGGCGGGGGACTTGGAGCAGCAATCAGCCCCAGCATTTT	CASKGRRTWRGTWSSNQPQHF	TRBV6-4	TRBJ1-5
TGTGCCGACGCCCCTGGGGGGAAAAGCTCCTACAATGAGCAGTTCTTC	CADAPGGKSSYNEQFF	TRBV7-3	TRBJ2-1
TGTGCCAGCAGCCAGTACCGGACCGGGGAGCTGTTTTTT	CASSQYRTGELFF	TRBV9	TRBJ2-2
TGTGCCAGCAGCCAGCTTGAATGGAGAACCACAGATACGCAGTATTTT	CASSQLEWRTTDTQYF	TRBV13	TRBJ2-3
TGTGCCAGCAGTATAGGGGTTGAAAAACTGTTTTTT	CASSIGVEKLFF	TRBV5-6	TRBJ1-4
TGTGCCATCCCAGAGTATAATAACACAGATACGCAGTATTTT	CAIPEYNNTDTQYF	TRBV14	TRBJ2-3
TGTGCCAGCAGCTTAGAAATCCCTTCGGGAGTTGAGTATAGCAATCAGCCCCAGCATTTT	CASSLEIPSGVEYSNQPQHF	TRBV7-6	TRBJ1-5
TGTGCTAGTGGTTTGGGGATGGACAGGGGGCCCCATGGCTACACCTTC	CASGLGMDRGPHGYTF	TRBV12-5	TRBJ1-2
TGTGCCAGCAGCGTTCCGGGACAGGGAGAAAACTATGGCTACACCTTC	CASSVPGQGENYGYTF	TRBV11-2	TRBJ1-2
TGTGCCAGCAGCTTAGTTTACTTTACTAGCGGGAGGGCAACTCTGAGTTATAATCAGCCCCAGCATTTT	CASSLVYFTSGRATLSYNQPQHF	TRBV7-8	TRBJ1-5
TGCGCCAGCAGCTTCCTAGCGGGTGATTTAGAGCAGTTCTTC	CASSFLAGDLEQFF	TRBV5-1	TRBJ2-1
TGTGCCAGCAGCTTGAAGAAAGCGGGACTAAGTGGGGCCAAAAACATTCAGTACTTC	CASSLKKAGLSGAKNIQYF	TRBV5-4	TRBJ2-4
TGTGCCAGCAGTGACGTAGATTGGTACACTGAAGCTTTCTTT	CASSDVDWYTEAFF	TRBV2	TRBJ1-1
TGTGCCAGCAGCCCTCGGGCGGGCATGAACACTGAAGCTTTCTTT	CASSPRAGMNTEAFF	TRBV27	TRBJ1-1
TGTGCCAGCAGCGTACACGCCCAGGGAGGTGTCGGGGGAAACACCGGGGAGCTGTTTTTT	CASSVHAQGGVGGNTGELFF	TRBV9	TRBJ2-2
TGTGCCAGGGGGGCCTCGGGAAACATTCAGTACTTC	CARGASGNIQYF	TRBV6-1	TRBJ2-4
TGTGCCAGCAGTTTCGCCCTAGGGAGGCCCCTGGAAGCTTTCTTT	CASSFALGRPLEAFF	TRBV28	TRBJ1-1
TGTGCCAGCAGCCTCGTTTGGTCCGGGACAAAGAAAGAAAGGGCGGGCAACTATGGCTACACCTTC	CASSLVWSGTKKERAGNYGYTF	TRBV6-1	TRBJ1-2
TGTGCCAGCAGTAAACAGTATGGCTACACCTTC	CASSKQYGYTF	TRBV12-4	TRBJ1-2
TGTGCCAGTTGCAGGGGCTACGAGCAGTACTTC	CASCRGYEQYF	TRBV6-5	TRBJ2-7
TGTGCCAGCAGCCCGATTCCCCGGGACACCGGGGAGCTGTTTTTT	CASSPIPRDTGELFF	TRBV7-3	TRBJ2-2
TGTGCCAGCAGTATACTAGCGGGCCTATTTCCCGAGACCCAGTACTTC	CASSILAGLFPETQYF	TRBV6-4	TRBJ2-5
TGTGCCAGCAGTTACGACTACGACTCTGGAAACACCATATATTTT	CASSYDYDSGNTIYF	TRBV6-5	TRBJ1-3
TGTGCCACCAGTGAAACCCCATATCAGAGGTTTACCACTGAAGCTTTCTTT	CATSETPYQRFTTEAFF	TRBV24-1	TRBJ1-1
TGTGCCAGCAGTGACGTGATCCCGTCGACAGGGCGGACTGGGGTCACAGATACGCAGTATTTT	CASSDVIPSTGRTGVTDTQYF	TRBV6-4	TRBJ2-3
TGTGCCAGTCCCGTGTCAGGGGTCCAGCCCCAGCATTTT	CASPVSGVQPQHF	TRBV19	TRBJ1-5
TGTGCCAGCAGCCACATGGGACTAGCGGGCGGCACAGATACGCAGTATTTT	CASSHMGLAGGTDTQYF	TRBV14	TRBJ2-3
TGTGCCATCCCCCATGAGGGACGAGTCCGCTCCTACGAGCAGTACTTC	CAIPHEGRVRSYEQYF	TRBV10-3	TRBJ2-7
TGCAATCGGGCCCAGAGGGCCATTCAGTACTTC	CNRAQRAIQYF	TRBV10-2	TRBJ2-4
TGCGCCAGCAGCTTGGCTGTCCAATCGGGGATCTGGAGCGAGCAGTACTTC	CASSLAVQSGIWSEQYF	TRBV5-1	TRBJ2-7
TGTGCCAGCATGGGAGGGGTCTTC	CASMGGVF	TRBV11-3	TRBJ2-1
TGTGCCAGCAGCTATAAGGGAGCTGGGGCCAACGTCCTGACTTTC	CASSYKGAGANVLTF	TRBV5-4	TRBJ2-6
TGTGCCAGCAGTCGACTTTCGTCTTTTAGGAGGTCTGATAGCTCCTATAATTCACCCCTCCACTTT	CASSRLSSFRRSDSSYNSPLHF	TRBV6-2	TRBJ1-6
TGCAGCGTTGATCGGCGACTAGCGGGCGCGTATTTT	CSVDRRLAGAYF	TRBV29-1	TRBJ2-3
TGCAGTGGATCGGACAGGGTCCATCAGCCCCAGCATTTT	CSGSDRVHQPQHF	TRBV20-1	TRBJ1-5
TGTGCCAGCTCACCAAAATACCAGCATCAGCCCCAGCATTTT	CASSPKYQHQPQHF	TRBV18	TRBJ1-5
TGTGCCACCAGCAGAGGGGAAATGAATCAGCCCCAGCATTTT	CATSRGEMNQPQHF	TRBV15	TRBJ1-5
TGCAGCGTTAAGACCCACAGGGGGAACTATGGCTACACCTTC	CSVKTHRGNYGYTF	TRBV29-1	TRBJ1-2
TGTGCCTGGAGTGGGACAGGGCTGGTAGCCCTCCACTTT	CAWSGTGLVALHF	TRBV30	TRBJ1-6
TGCGCCAGCACTGAAAAGGGACAGGGAAGCTCCTACAATGAGCAGTTCTTC	CASTEKGQGSSYNEQFF	TRBV10-2	TRBJ2-1
TGTGCCAGTATGGCCCCAGACTACGAGCAGTACTTC	CASMAPDYEQYF	TRBV19	TRBJ2-7
TGCAGTGCCACCAGGGATGCGAACACCGGGGAGCTGTTTTTT	CSATRDANTGELFF	TRBV20-1	TRBJ2-2
TGCAGTGCTAGAGATACTCCTTCCGGGGGGCGCAATGAGCAGTTCTTC	CSARDTPSGGRNEQFF	TRBV20-1	TRBJ2-1
TGTGCCAGCAGCCAAGGGGGGGGGGGGACGGGCTACGAGCAGTACTTC	CASSQGGGGTGYEQYF	TRBV14	TRBJ2-7
TGTGCCAGTAGAGGACAGGGGGCCTACTATGGCTACACCTTC	CASRGQGAYYGYTF	TRBV19	TRBJ1-2
TGTGCCAGCCTCGGGGGGGCCTACAATGAGCAGTTCTTC	CASLGGAYNEQFF	TRBV2	TRBJ2-1
TGTGCCAGCAGAGGGACAGGGAAGGGGAGCACCATATATTTT	CASRGTGKGSTIYF	TRBV2	TRBJ1-3
TGCGCCAGCAGCCAAGATACCTACCTGAGGAAACACCACACTGAAGCTTTCTTT	CASSQDTYLRKHHTEAFF	TRBV4-1	TRBJ1-1
TGTGCCACCAGTGATTCCCCAACTGCGGGGGGAGAGCCCCAGCATTTT	CATSDSPTAGGEPQHF	TRBV24-1	TRBJ1-5
TGCAGTGCTAGAAATAGGACTAGCGGTCCCTACGAGCAGTACTTC	CSARNRTSGPYEQYF	TRBV20-1	TRBJ2-7
TGCGCCAGCACGGCTGGGGACTACGAGCAGTACTTC	CASTAGDYEQYF	TRBV5-1	TRBJ2-7
TGTGCCAGCAGCTCCAGGTGGACAGGGACTAATAGCACTGAAGCTTTCTTT	CASSSRWTGTNSTEAFF	TRBV7-3	TRBJ1-1
TGTGCCAGCAGCGGGGTAGACTGGCCACCATACTCCTACGAGCAGTACTTC	CASSGVDWPPYSYEQYF	TRBV7-4	TRBJ2-7
TGTGCCAGCAGCCACTTCCTAGCGGCCTTCTTC	CASSHFLAAFF	TRBV4-2	TRBJ2-1
TGCAGCCAACACGGCCAGCCCCAGCATTTT	CSQHGQPQHF	TRBV29-1	TRBJ1-5
TGTGCCAGTACCCCGGGACTAGCTGGCTACGAGCAGTACTTC	CASTPGLAGYEQYF	TRBV6-2	TRBJ2-7
TGTGCCAGCAGCTCAATTATAGCATTCAACAGGGCCAATGAGCAGTTCTTC	CASSSIIAFNRANEQFF	TRBV28	TRBJ2-1
TGTGCCAGCAGTTATTATAGCCGGCTCGCCGGGGAGCTGTTTTTT	CASSYYSRLAGELFF	TRBV6-5	TRBJ2-2
TGTGCCAGCACCCCCCGGGACTTCAATGGCTACACCTTC	CASTPRDFNGYTF	TRBV9	TRBJ1-2
TGTGCCAGCAGCCAAGAACCGGTATATACCTATGGCTACACCTTC	CASSQEPVYTYGYTF	TRBV3-1	TRBJ1-2
TGTGCCAGCAGCTTAGAAACGGACGCGATCTCCTACGAGCAGTACTTC	CASSLETDAISYEQYF	TRBV11-3	TRBJ2-7
TGCAGTGCTAGAGAACCCTACCCGGGACAGGGTTTGAATGGAAACACCATATATTTT	CSAREPYPGQGLNGNTIYF	TRBV20-1	TRBJ1-3
TGTGCCAGCAGTTTACGGGACAGGGTGTATTCCTACGAGCAGTACTTC	CASSLRDRVYSYEQYF	TRBV6-5	TRBJ2-7
TGTGCCACGCAGGCGTTAAATCAGCCCCAGCATTTT	CATQALNQPQHF	TRBV2	TRBJ1-5
TGTGCCTGGAAACTAGCGGGAGCCGCCGTCTCCTCCTACGAGCAGTACTTC	CAWKLAGAAVSSYEQYF	TRBV30	TRBJ2-7
TGTGCCAGCAGCGAGACGGGGGGTAGCAATCAGCCCCAGCATTTT	CASSETGGSNQPQHF	TRBV5-4	TRBJ1-5
TGTGCCAGCAGCTTGCCAAAACAGGGGCCTGCCGGGGAGCTGTTTTTT	CASSLPKQGPAGELFF	TRBV5-5	TRBJ2-2
TGTGCCAGCAGCCAAGACCCGTACGAGCAGTACTTC	CASSQDPYEQYF	TRBV3-1	TRBJ2-7
TGTGCCAGAAAGACAGGGAGAGGAATCTATAATTCACCCCTCCACTTT	CARKTGRGIYNSPLHF	TRBV12-3	TRBJ1-6
TGCGCCAGCAGCCGAAATCGCCGGGACAGGGCGATTGCCAAAAACATTCAGTACTTC	CASSRNRRDRAIAKNIQYF	TRBV4-1	TRBJ2-4
TGCAGCGTGCCGGGACAGGGCTGTTGGGAGGGTGGCTTTAGGACCCATTACACCTTC	CSVPGQGCWEGGFRTHYTF	TRBV29-1	TRBJ1-2
TGTGCCAGCAGCTATCTAAACTACCCCCGGGACTACGAGCAGTACTTC	CASSYLNYPRDYEQYF	TRBV13	TRBJ2-7
TGTGCCAGCAGTTGTTGGCCCCGGGAGGGGACAGCTAACTATGGCTACACCTTC	CASSCWPREGTANYGYTF	TRBV27	TRBJ1-2
TGCGCCAGCAGTGACTGTCAGGTCTCGAACACCGGGGAGCTGTTTTTT	CASSDCQVSNTGELFF	TRBV10-1	TRBJ2-2
TGTGCCAGCAGGCCAGGCGAGCAGTACTTC	CASRPGEQYF	TRBV6-4	TRBJ2-7
TGTGCCTGGAGTAGACAGGGGGCTCGGGAAAAACTGTTTTTT	CAWSRQGAREKLFF	TRBV30	TRBJ1-4
TGCAGTGCAAAGGGTCGGCACGTACAGCGCACAGATACGCAGTATTTT	CSAKGRHVQRTDTQYF	TRBV20-1	TRBJ2-3
TGTGCCATTAAACAGGCTCGGGTAGGGAACACTGAAGCTTTCTTT	CAIKQARVGNTEAFF	TRBV12-4	TRBJ1-1
TGCGCCAGCAGAACCGGGGGCGAGTACGAGCAGTACTTC	CASRTGGEYEQYF	TRBV5-1	TRBJ2-7
TGTGCCAACTCACGGGACATGGAGAACACTGAAGCTTTCTTT	CANSRDMENTEAFF	TRBV6-4	TRBJ1-1
TGTGCCAGCACAGGGCTGGTGAACACTGAAGCTTTCTTT	CASTGLVNTEAFF	TRBV5-4	TRBJ1-1
TGCGCCAGCCGCCGGGCCTCCTACTACAATGAGCAGTTCTTC	CASRRASYYNEQFF	TRBV10-1	TRBJ2-1
TGTGCCAGCTCACCACCCCTAGCGGGATCAGATACGCAGTATTTT	CASSPPLAGSDTQYF	TRBV18	TRBJ2-3
TGTGCCAGCAGCCGGGGCCGGGCTGGCTACGAGCAGTACTTC	CASSRGRAGYEQYF	TRBV7-2	TRBJ2-7
TGTGCCAGCAGCTTGGGGTTGATGGACACAGATACGCAGTATTTT	CASSLGLMDTDTQYF	TRBV7-3	TRBJ2-3
TGTGCCAGCAGTCCACCCGGGACCTATGGCTACACCTTC	CASSPPGTYGYTF	TRBV28	TRBJ1-2
TGTGCCTCTAAAAAACCAGGGAGTCGAAACACCATATATTTT	CASKKPGSRNTIYF	TRBV11-2	TRBJ1-3
TGTGCCAGTAGTCATAGCGGGCACGCCTACGAGCAGTACTTC	CASSHSGHAYEQYF	TRBV19	TRBJ2-7
TGTGCCACCAGTGATTTACACTATAATTCACCCCTCCACTTT	CATSDLHYNSPLHF	TRBV24-1	TRBJ1-6
TGTGCCAGCATAAGCGGGAATGGAGACACTGAAGCTTTCTTT	CASISGNGDTEAFF	TRBV6-5	TRBJ1-1
TGTGCCAGTAGTTCGGAGTCACAGGGGGCTGCGAACTCCTACGAGCAGTACTTC	CASSSESQGAANSYEQYF	TRBV19	TRBJ2-7
TGTGCCAGCAGCTGGGGGGGCTTCAACCAAGAGACCCAGTACTTC	CASSWGGFNQETQYF	TRBV7-9	TRBJ2-5
TGTGCCAGCAGCCTTAAGGTGGCAGGGGGCGAGATCCAGGAAAAACTGTTTTTT	CASSLKVAGGEIQEKLFF	TRBV13	TRBJ1-4
TGTGCCACCAGCAGAGTATGGGCGAGAAGCTCCTACGAGCAGTACTTC	CATSRVWARSSYEQYF	TRBV15	TRBJ2-7
TGTGCCAGCAGCGTGGGGACTAGCGGGCCCAATCCGCCTAGGACCCACGAGCAGTACTTC	CASSVGTSGPNPPRTHEQYF	TRBV7-9	TRBJ2-7
TGTGCCAGCAGTTACCCGGAGGCAAGGACGTGGCAAGAGACCCAGTACTTC	CASSYPEARTWQETQYF	TRBV6-5	TRBJ2-5
TGTGCCACCAGTGATTTGGACAGTAGGGACTATGGCTACACCTTC	CATSDLDSRDYGYTF	TRBV24-1	TRBJ1-2
TGTGCCAGCAGCAGTTCAGCAACTACAGGGGCTTTAGCTTTCTTT	CASSSSATTGALAFF	TRBV11-2	TRBJ1-1
TGCGCCAGCAGTGAGATGATAGAGACCCAGTACTTC	CASSEMIETQYF	TRBV10-1	TRBJ2-5
TGTGCCAGCAGCTTAGACTCGGGCCCGGCTGAGGCCAACTCCTACAATGAGCAGTTCTTC	CASSLDSGPAEANSYNEQFF	TRBV7-2	TRBJ2-1
TGCGCCAGACTGGAAAAACTGTTTTTT	CARLEKLFF	TRBV10-2	TRBJ1-4
TGTGCCAGCAGTTCTGCAGGGGGCAATCAGCCCCAGCATTTT	CASSSAGGNQPQHF	TRBV6-5	TRBJ1-5
TGCAGCGACGGTCCCGGGACAGGGGGCCCCGCGGGCTTACCCGGACATCAGCCCCAGCATTTT	CSDGPGTGGPAGLPGHQPQHF	TRBV29-1	TRBJ1-5
TGTGCCGACGGGGGGGGAAGAATCTCCTACGAGCAGTACTTC	CADGGGRISYEQYF	TRBV28	TRBJ2-7
TGCAGTGCTGGGAGCGGGACGGGAGCGGAGAGAAAGCCCCAGCATTTT	CSAGSGTGAERKPQHF	TRBV20-1	TRBJ1-5
TGTGCCCAGGGGAGCAGTGCAACTAATGAAAAACTGTTTTTT	CAQGSSATNEKLFF	TRBV28	TRBJ1-4
TGTGCCAGCAGGCCCATGGAGGGACAGGGTTCGGACTCTGGGGCCAACGTCCTGACTTTC	CASRPMEGQGSDSGANVLTF	TRBV6-5	TRBJ2-6
TGTGCCAGCACGCCACCAGTTTGGAGCGGTAATGGCTACACCTTC	CASTPPVWSGNGYTF	TRBV6-3	TRBJ1-2
TGTGCCAGCAGCTTGGTTCCGGACAGTTATGCCTACGAGCAGTACTTC	CASSLVPDSYAYEQYF	TRBV5-5	TRBJ2-7
TGCGCCAGCAGTGATCGGTGGCGCGCCAAAAACATTCAGTACTTC	CASSDRWRAKNIQYF	TRBV10-1	TRBJ2-4
TGTGCCAGCAGTTTACTTCTAGCGGCGTTCTTTGAGCAGTTCTTC	CASSLLLAAFFEQFF	TRBV28	TRBJ2-1
TGTGCCAGCAGTTACCTGGGGGAGAGGTGGGACTACGAGCAGTACTTC	CASSYLGERWDYEQYF	TRBV28	TRBJ2-7
TGTGCCAGCAGCCAAGCGGGGGAGGTCAGCCCTAGCACAGATACGCAGTATTTT	CASSQAGEVSPSTDTQYF	TRBV9	TRBJ2-3
TGCAGTGCTCAACTCCACAGGGCTTTAGCTTTCTTT	CSAQLHRALAFF	TRBV20-1	TRBJ1-1
TGTGCCAGCAGTGACCCCACCGGGACTAGCGGTCGGCAAGAGACCCAGTACTTC	CASSDPTGTSGRQETQYF	TRBV6-1	TRBJ2-5
TGTGCCAGCACCGCACAGGCAATGGATCAGCCCCAGCATTTT	CASTAQAMDQPQHF	TRBV27	TRBJ1-5
TGTGCCAGCAGCTTGGCACTCAGCACCGGGGAGCTGTTTTTT	CASSLALSTGELFF	TRBV7-3	TRBJ2-2
TGTGCCAGCAGTGAATCGGGGCTAGGATACAATGAGCAGTTCTTC	CASSESGLGYNEQFF	TRBV6-4	TRBJ2-1
TGTGCCAGCAGCGGAAAGGGGGCTGTAGGGTATGGCTACACCTTC	CASSGKGAVGYGYTF	TRBV6-4	TRBJ1-2
TGCGCCAGGGGACCTCATTCGAACACCGGGGAGCTGTTTTTT	CARGPHSNTGELFF	TRBV5-1	TRBJ2-2
TGTGCCAGCAGCCCCCGGGGAAGAGAGACTGAAGCTTTCTTT	CASSPRGRETEAFF	TRBV13	TRBJ1-1
TGCGCCAGCAGTAGCTTGATCGAAAGTTTAGGGGGAAATCAGCCCCAGCATTTT	CASSSLIESLGGNQPQHF	TRBV10-2	TRBJ1-5
TGTGCCAGTAGTATAGCCCGTCTACCCTCGGCCGGGGACAGGGGGCGCATCCCAACCTATTCACCCCTCCACTTT	CASSIARLPSAGDRGRIPTYSPLHF	TRBV19	TRBJ1-6
TGTGCCAGCAGCTCTCTGGTCGGGAGGACCGGGTGCCATGAGCAGTTCTTC	CASSSLVGRTGCHEQFF	TRBV4-2	TRBJ2-1
TGTGCCAGCAGCTTGCGACCCGGGACAGGGGGGAAGATTCAAACTGAAGCTTTCTTT	CASSLRPGTGGKIQTEAFF	TRBV5-6	TRBJ1-1
TGTGCCAGCAGCACCGCGCTACTAGCGGGAGATGAGCAGTTCTTC	CASSTALLAGDEQFF	TRBV7-9	TRBJ2-1
TGCAGTGCTAGAGATGGCGGACAGGGTAAGTCTGGGGCCAACGTCCTGACTTTC	CSARDGGQGKSGANVLTF	TRBV20-1	TRBJ2-6
TGTGCCAGCAGCCCAAGGGACGCCAAAAACATTCAGTACTTC	CASSPRDAKNIQYF	TRBV6-2	TRBJ2-4
TGTGCCAGCAGCAATGCTAGCGGGACGGAGCAGTACTTC	CASSNASGTEQYF	TRBV13	TRBJ2-7
TGCGCCAGCAAATCGAAAAGAGCCTACGAGCAGTACTTC	CASKSKRAYEQYF	TRBV10-1	TRBJ2-7
TGTGCCAGCAGCCTGGGGCGTTATGACCGGGACCAGGGCTACACCTTC	CASSLGRYDRDQGYTF	TRBV28	TRBJ1-2
TGTGCCAGCACGAAGACTAGCGACGGAGTCGCGAACACCGGGGAGCTGTTTTTT	CASTKTSDGVANTGELFF	TRBV11-3	TRBJ2-2
TGTGCCAGTAGGGGGTACCGCCATAACTATGGCTACACCTTC	CASRGYRHNYGYTF	TRBV6-5	TRBJ1-2
TGTGCCAGCAGCAGCACTAGCGGGAGGGCGCCGCCCGGCACAGATACGCAGTATTTT	CASSSTSGRAPPGTDTQYF	TRBV5-4	TRBJ2-3
TGTGCCAGCAGCGGCCCCCGCGGCGCCTACGAGCAGTACTTC	CASSGPRGAYEQYF	TRBV7-2	TRBJ2-7
TGCGCCAGCAGCTCTGATTTTTACGAGCAGTACTTC	CASSSDFYEQYF	TRBV10-1	TRBJ2-7
TGTGCCAGCAGTCGGGGATACGGCACAGATACGCAGTATTTT	CASSRGYGTDTQYF	TRBV27	TRBJ2-3
TGTGCCAGCAGCCCGCTAAGGGCCGGGACGCCAAACACCGGGGAGCTGTTTTTT	CASSPLRAGTPNTGELFF	TRBV14	TRBJ2-2
TGTGCCAGCATGCATAGCTCCTACGAGCAGTACTTC	CASMHSSYEQYF	TRBV12-3	TRBJ2-7
TGTGCCAGCAGTGTCTGCCGGGACAGGGACGAGCAGTACTTC	CASSVCRDRDEQYF	TRBV2	TRBJ2-7
TGTGCCAGCAGTGTAAGGACAGCCCTTTATCAGCCCCAGCATTTT	CASSVRTALYQPQHF	TRBV27	TRBJ1-5
TGTGCCAGCAGTAGGGAGGGCGTGGTGAACACTGAAGCTTTCTTT	CASSREGVVNTEAFF	TRBV28	TRBJ1-1
TGTGCCAGCAGCGTTGACAGGGTTCGAGGAGAGACCCAGTACTTC	CASSVDRVRGETQYF	TRBV27	TRBJ2-5
TGCGCCAGCAGCCACCGGGACAGGTTTCGGGGTGGAAACACCATATATTTT	CASSHRDRFRGGNTIYF	TRBV4-1	TRBJ1-3
TGTGCCAGCAGAGCCGGGGGCTACGAGCAGTACTTC	CASRAGGYEQYF	TRBV6-4	TRBJ2-7
TGTGCCTGGAGTAGCAGGCCGAGGTGGCTGAACGGCACTGAAGCTTTCTTT	CAWSSRPRWLNGTEAFF	TRBV30	TRBJ1-1
TGTGCCAGCAAGGCAGGGGGGGCTACTTACTTC	CASKAGGATYF	TRBV6-6	TRBJ2-4
TGTGCCAGCACCTGGACTAGCGGGTACGGGCAAGAGACCCAGTACTTC	CASTWTSGYGQETQYF	TRBV6-8	TRBJ2-5
TGTGCCAGCAGCATAAGGGAACATACTAGGGGGGAGCAGTACTTC	CASSIREHTRGEQYF	TRBV7-4	TRBJ2-7
TGTGCCAGCAGTTACGGCCGGGACGGTTTAGGAATAGGTAATCAGCCCCAGCATTTT	CASSYGRDGLGIGNQPQHF	TRBV6-2	TRBJ1-5
TGTGCCAGCAGAGTTAGCCGGGGCACAGATACGCAGTATTTT	CASRVSRGTDTQYF	TRBV25-1	TRBJ2-3
TGTGCCACGCCCGGGAGCCGAGATGAAAACATTCAGTACTTC	CATPGSRDENIQYF	TRBV10-3	TRBJ2-4
TGTGCCAGTAAGACAGGCATTCAGTACTTC	CASKTGIQYF	TRBV18	TRBJ2-4
TGCGCCAGCAGCTTCACCGCGGGAGGGAATTATGGCTACACCTTC	CASSFTAGGNYGYTF	TRBV5-1	TRBJ1-2
TGTGCCAGCAGCTGCGGGGGGCGGGATGAGACCCAGTACTTC	CASSCGGRDETQYF	TRBV11-3	TRBJ2-5
TGTGCCAGCAGCTTGGCAGAGGAAGTAAGCAATCAGCCCCAGCATTTT	CASSLAEEVSNQPQHF	TRBV9	TRBJ1-5
TGTGCCAGCAGCAGACAGGGGGATAGCAATCAGCCCCAGCATTTT	CASSRQGDSNQPQHF	TRBV7-3	TRBJ1-5
TGTGCTAGTGGTTTGGTTAGCGGGAACAGGAGCTCCTACGAGCAGTACTTC	CASGLVSGNRSSYEQYF	TRBV12-5	TRBJ2-7
TGTGCCAGCAGTTCGCCGGGGGCGGCCTACAATGAGCAGTTCTTC	CASSSPGAAYNEQFF	TRBV28	TRBJ2-1
TGCAGTGCTAGAAAGAGGACTAGAGGTAACTATGGCTACACCTTC	CSARKRTRGNYGYTF	TRBV20-1	TRBJ1-2
TGTGCCAGCAGGAACACTAGCGGGAGGGAGAACACTGAAGCTTTCTTT	CASRNTSGRENTEAFF	TRBV12-4	TRBJ1-1
TGTGCCAGCAGTTTAGCTATCACAGATACGCAGTATTTT	CASSLAITDTQYF	TRBV12-4	TRBJ2-3
TGCGCCAGCAGTCGGGACAGGGGTTCCGAGGAGGGACATCACACTGAAGCTTTCTTT	CASSRDRGSEEGHHTEAFF	TRBV10-1	TRBJ1-1
TGTGCCACGCGGAATTACAATGAGCAGTTCTTC	CATRNYNEQFF	TRBV27	TRBJ2-1
TGCGCCAGCCACCACTTCAAAAACATTCAGTACTTC	CASHHFKNIQYF	TRBV5-1	TRBJ2-4
TGTGCCAGCAGTTTATGGGCTAGCGGGGGCTCCTACGAGCAGTACTTC	CASSLWASGGSYEQYF	TRBV27	TRBJ2-7
TGCGCCAGCAGCGCAGACGGTGAAAAACTGTTTTTT	CASSADGEKLFF	TRBV5-1	TRBJ1-4
TGTGCCAGTAGTATTCCTAGTGACCTCTACGAGCAGTACTTC	CASSIPSDLYEQYF	TRBV19	TRBJ2-7
TGTGCCAGCAGCTTGGCCCTTTTCGAGAGCTCCTACAATGAGCAGTTCTTC	CASSLALFESSYNEQFF	TRBV5-5	TRBJ2-1
TGTGCCAGCAGCAAGAGTTCCGGGGAGCTGTTTTTT	CASSKSSGELFF	TRBV6-4	TRBJ2-2
TGTGCCAGCAGCACTAGTCATTTAGCGGTGGGGTACTTC	CASSTSHLAVGYF	TRBV5-6	TRBJ2-5
TGTGCCAGCAGTTTACCGGCGGGGGGCCTAAAACCCCAGCATTTT	CASSLPAGGLKPQHF	TRBV28	TRBJ1-5
TGTGCCAGCAGCGGGGGGGGGAGACGAATGAACACTGAAGCTTTCTTT	CASSGGGRRMNTEAFF	TRBV7-9	TRBJ1-1
TGTGCCAGCATGGGGGAAGCAGGACGTTTTATAGCCTCACCCCTCCACTTT	CASMGEAGRFIASPLHF	TRBV7-9	TRBJ1-6
TGTGCCAGCAGTTATAAGGGTTACAACAATCAGCCCCAGCATTTT	CASSYKGYNNQPQHF	TRBV6-2	TRBJ1-5
TGCAGCGTGGACCTACCCGGACAGGGACTGCCCTACGAGCAGTACTTC	CSVDLPGQGLPYEQYF	TRBV29-1	TRBJ2-7
TGCGCCAGCAGCTTGACAGGGGTAAAAGCTTTCTTT	CASSLTGVKAFF	TRBV5-1	TRBJ1-1
TGTGCCAGCAGTTTAGTCGGGGGCATAGGTGAGACCCAGTACTTC	CASSLVGGIGETQYF	TRBV12-3	TRBJ2-5
TGTGCCAGCAGCTTCGGGGGCCCCGTCGAGCAGTACTTC	CASSFGGPVEQYF	TRBV13	TRBJ2-7
TGTGCCAGCAGGGTGGGGACTAGCGGGGGGGCTGACGAGCAGTACTTC	CASRVGTSGGADEQYF	TRBV6-4	TRBJ2-7
TGTGCCGGAGCAGGGGAATATTCACCCCTCCACTTT	CAGAGEYSPLHF	TRBV3-1	TRBJ1-6
TGTGCCAGCACTCAATATAGCGGGCCCTCCACAGATACGCAGTATTTT	CASTQYSGPSTDTQYF	TRBV27	TRBJ2-3
TGCGCCAGCAGCTGGTGGGGATATAATGAAAAACTGTTTTTT	CASSWWGYNEKLFF	TRBV5-1	TRBJ1-4
TGTGCCAGCAGCAAAGGGCTTAAGGAGACCCAGTACTTC	CASSKGLKETQYF	TRBV11-2	TRBJ2-5
TGTGCCAGCAGCGGGGGGGATCTTGCGCAGTATTTT	CASSGGDLAQYF	TRBV7-9	TRBJ2-3
TGTGCCAGCAGCGGCCGGCGGGGACAGGGCCTATCAGAGACCCAGTACTTC	CASSGRRGQGLSETQYF	TRBV9	TRBJ2-5
TGCGCCAGCACCCAGGGGTCGGGTACCTCCTACGAGCAGTACTTC	CASTQGSGTSYEQYF	TRBV5-1	TRBJ2-7
