TGTGCCAGCAGCTTTGCCGGGGGCGCGAACCCCCGGTGCAATCAGCCCCAGCATTTT	CASSFAGGANPRCNQPQHF	TRBV7-4	TRBJ1-5
TGTGCCAGCACTAATTCAGGCGGGGGGGCGGACAATGAGCAGTTCTTC	CASTNSGGGADNEQFF	TRBV12-3	TRBJ2-1
TGTGCCTGGAGTACATACAGGGGGTTTCCGCAGCCCCAGCATTTT	CAWSTYRGFPQPQHF	TRBV30	TRBJ1-5
TGTGCCAGTAGTATAGTGGAACGGTTTCCGACAGGGGGGGGCATTGAAGAGAACACTGAAGCTTTCTTT	CASSIVERFPTGGGIEENTEAFF	TRBV19	TRBJ1-1
TGTGCCAGCAGCTGTCCGGGACAGCCCGTCGATAATTCACCCCTCCACTTT	CASSCPGQPVDNSPLHF	TRBV7-6	TRBJ1-6
TGTGCCAGCAGCTCAATAGCGGGACAGGGGAGTGGGGGGGGGGGCTACACCTTC	CASSSIAGQGSGGGGYTF	TRBV7-9	TRBJ1-2
TGTGCCAGCAGCTTTACCCGGGACAAAAGATTCTCTGGGGCCAACGTCCTGACTTTC	CASSFTRDKRFSGANVLTF	TRBV11-1	TRBJ2-6
TGTGCCAGCAGCCGGACAGGGGCCCTGGGGTACAATGAGCAGTTCTTC	CASSRTGALGYNEQFF	TRBV3-1	TRBJ2-1
TGTGCCAGCAGATTAATTGGCGGGGCCGGATATAATTCACCCCTCCACTTT	CASRLIGGAGYNSPLHF	TRBV7-2	TRBJ1-6
TGTGCCAGCAGCTTAACCACTGTTGCGGGGGCCGGCCAAGAGACCCAGTACTTC	CASSLTTVAGAGQETQYF	TRBV7-3	TRBJ2-5
TGTGCCAGCAGCAGGGATGGCTACACCTTC	CASSRDGYTF	TRBV2	TRBJ1-2
TGTGCCCAGGGGGGCGGGGAGCTGTTTTTT	CAQGGGELFF	TRBV28	TRBJ2-2
TGCAGTGCTAGGGGGACGTTGGTGAACACTGAAGCTTTCTTT	CSARGTLVNTEAFF	TRBV20-1	TRBJ1-1
TGTGCCAGCAGCCGCGGGAGTGAACGACTGGTAGGCGAAAAACTGTTTTTT	CASSRGSERLVGEKLFF	TRBV12-3	TRBJ1-4
TGCGCCAGCAGCCAAGATTGCGGGGACAGGGAGAGGGAAGAGACCCAGTACTTC	CASSQDCGDREREETQYF	TRBV4-1	TRBJ2-5
TGTGCCAGCAGTTACGCGAAATCGAAGACCAAGGGTTACGAGCAGTACTTC	CASSYAKSKTKGYEQYF	TRBV6-6	TRBJ2-7
TGTGCCAGCAGCCAACAGAGCGGGAGTAACTATGGCTACACCTTC	CASSQQSGSNYGYTF	TRBV4-2	TRBJ1-2
TGTGCCAGCACGGTATGTACTGGAGCTTTGGACACTGAAGCTTTCTTT	CASTVCTGALDTEAFF	TRBV27	TRBJ1-1
TGTGCCAGCAGAAGATCCGACGGACAGGGGGAGGCTGAAGCTTTCTTT	CASRRSDGQGEAEAFF	TRBV3-1	TRBJ1-1
TGTGCCATAAACAGGGGTGGAGAGACCCAGTACTTC	CAINRGGETQYF	TRBV5-4	TRBJ2-5
TGTGCCAGCAGGGACAGGGGCTACGAGCAGTACTTC	CASRDRGYEQYF	TRBV6-3	TRBJ2-7
TGTGCCAGCAGTGATCCTCCAAGTCCAGGGGGCTACAATGAGCAGTTCTTC	CASSDPPSPGGYNEQFF	TRBV6-1	TRBJ2-1
TGTGCCAGCAGCCCTCGGGAAACCACAGATACGCAGTATTTT	CASSPRETTDTQYF	TRBV7-6	TRBJ2-3
TGTGCCACCAGTGATTTGGAAGGCATGAACACTGAAGCTTTCTTT	CATSDLEGMNTEAFF	TRBV24-1	TRBJ1-1
TGTGCCAGGGTCCGGGACAGGGGAAAGGAAGTCTACGAGCAGTACTTC	CARVRDRGKEVYEQYF	TRBV27	TRBJ2-7
TGCGCCAGCAGCTGGGTCCACACCGGGGAGCTGTTTTTT	CASSWVHTGELFF	TRBV4-3	TRBJ2-2
TGTGCCAGCAGTGAGGGCTTCCAACTAGCGGGAGAGGTGATATGCAATCAGCCCCAGCATTTT	CASSEGFQLAGEVICNQPQHF	TRBV12-4	TRBJ1-5
TGCGCCAGCAGCTTGCCCTTGTTTGACAGAGTCGGCCTGAACACTGAAGCTTTCTTT	CASSLPLFDRVGLNTEAFF	TRBV5-1	TRBJ1-1
TGCAGTGGGACAGGAGAGGCAATTCAGCCCCAGCATTTT	CSGTGEAIQPQHF	TRBV20-1	TRBJ1-5
TGTGCCAGTAATCGGTTGGGCTATGGGGGACATGAGCAGTTCTTC	CASNRLGYGGHEQFF	TRBV19	TRBJ2-1
TGCGCCAGCAGCCAAGATAAGGGGGACGAGCAGTACTTC	CASSQDKGDEQYF	TRBV4-1	TRBJ2-7
TGTGCCAGCAGCGTAACCCCGCAGGTTCTCTTC	CASSVTPQVLF	TRBV9	TRBJ2-1
TGTGCCAGCAGCGAAGCGGGGTGTTCTCAGGAGGGGTATCAGCCCCAGCATTTT	CASSEAGCSQEGYQPQHF	TRBV7-9	TRBJ1-5
TGTGCCTGGAGTGATTGGGGGGCAGTGAATGAGCAGTTCTTC	CAWSDWGAVNEQFF	TRBV30	TRBJ2-1
TGTGCCAGCAGCTTGGTTTGGATTGGGGGGCTGCTTTATGAGCAGTTCTTC	CASSLVWIGGLLYEQFF	TRBV5-5	TRBJ2-1
TGTGCCGACGTACACAGGGGAGGTAGCACCGGGGAGCTGTTTTTT	CADVHRGGSTGELFF	TRBV28	TRBJ2-2
TGTGCCAGCAGCACAGGGGGGGCTGAAGCTTTCTTT	CASSTGGAEAFF	TRBV7-2	TRBJ1-1
TGTGCTAGTGGTTTGGTACCAACACGCCAGAACACTGAAGCTTTCTTT	CASGLVPTRQNTEAFF	TRBV12-5	TRBJ1-1
TGCAGTGCTAACGGGACTAGGGGCCCTACAGATACGCAGTATTTT	CSANGTRGPTDTQYF	TRBV20-1	TRBJ2-3
TGCGCCATTCGGCCGGCTAGCACAGATACGCAGTATTTT	CAIRPASTDTQYF	TRBV5-1	TRBJ2-3
TGTGCCAGCAGCTTCTGGACAGGGGGCTTAGAGACCCAGTACTTC	CASSFWTGGLETQYF	TRBV7-9	TRBJ2-5
TGCGCCACCCTGAACCTGCCTGAAGCTTTCTTT	CATLNLPEAFF	TRBV5-1	TRBJ1-1
TGTGCCAAAAGGGGGTATGAAGAGACCCAGTACTTC	CAKRGYEETQYF	TRBV14	TRBJ2-5
TGTGCTAGTGGTTTGATAACCGACAGCAAGACCCTGAACACTGAAGCTTTCTTT	CASGLITDSKTLNTEAFF	TRBV12-5	TRBJ1-1
TGTGCCAGCAGTTTGCCCCTGAGGGCCCGGATATGGAACACCGGGGAGCTGTTTTTT	CASSLPLRARIWNTGELFF	TRBV12-3	TRBJ2-2
TGCAATCGGGCCCGGGACGATTCTGGAAACACCATATATTTT	CNRARDDSGNTIYF	TRBV20-1	TRBJ1-3
TGCAGTGCGGGGGGGGTCCTAAACACTGAAGCTTTCTTT	CSAGGVLNTEAFF	TRBV20-1	TRBJ1-1
TGTGCCAGCAGCCATACCGACAGAATGAATGAAAAACTGTTTTTT	CASSHTDRMNEKLFF	TRBV7-3	TRBJ1-4
TGTGCCACCAGTGATGGGTCCTTGGGGCTAGAGCAGTTCTTC	CATSDGSLGLEQFF	TRBV24-1	TRBJ2-1
TGTGCCAGCAGTTTCTTTCGGTATCGAGAAATCTCATTCCCCTCCTACAATGAGCAGTTCTTC	CASSFFRYREISFPSYNEQFF	TRBV12-3	TRBJ2-1
TGTGCCAGCATAGTCCCACGTCCAGAGAGGGGACCTTTGGGGTACGAGCAGTACTTC	CASIVPRPERGPLGYEQYF	TRBV28	TRBJ2-7
TGTGCCAGCAGGGCTATCTTCCAAGAGACCCAGTACTTC	CASRAIFQETQYF	TRBV7-2	TRBJ2-5
TGTGCCAGCAGTGAGGACCCCGACCGGACAGGTTTTGGAAACACCATATATTTT	CASSEDPDRTGFGNTIYF	TRBV6-4	TRBJ1-3
TGTGCCAGCAGCCAAGTACCCTGGGGGGGGGGCTCCTACGAGCAGTACTTC	CASSQVPWGGGSYEQYF	TRBV4-2	TRBJ2-7
TGCAGCGCAATCGACAGGGCTCGGGAGCTGTTTTTT	CSAIDRARELFF	TRBV29-1	TRBJ2-2
TGTGCCACCAGTGAAAGTGAAGGGGGTGAACAAGAGAATCAGCCCCAGCATTTT	CATSESEGGEQENQPQHF	TRBV24-1	TRBJ1-5
TGCAGTGCTAGGGGTGACGGCGGGAGCACTAGGTATGGCTACACCTTC	CSARGDGGSTRYGYTF	TRBV20-1	TRBJ1-2
TGTGCCAGCAGGTGTGGGACAAATGGAAGCAATCAGCCCCAGCATTTT	CASRCGTNGSNQPQHF	TRBV6-4	TRBJ1-5
TGTGCCGGGGCGGGAGGTTCGTTCGAAAACATTCAGTACTTC	CAGAGGSFENIQYF	TRBV5-5	TRBJ2-4
TGTGCCAGGGGCGACAGGACTGAAGCTTTCTTT	CARGDRTEAFF	TRBV14	TRBJ1-1
TGTGCCAGCGCTCCCGGGACTAGCGCCGCAAATGAGCAGTTCTTC	CASAPGTSAANEQFF	TRBV11-3	TRBJ2-1
TGTGCCAGCAGTGAGGGGTCCGGAAACACCGGGGAGCTGTTTTTT	CASSEGSGNTGELFF	TRBV6-1	TRBJ2-2
TGTGCCAGCAGCAAGACAGGCGGCAATCAGCCCCAGCATTTT	CASSKTGGNQPQHF	TRBV14	TRBJ1-5
TGTGCCAGCAGCGGGGCCTATGGCTACACCTTC	CASSGAYGYTF	TRBV13	TRBJ1-2
TGTGCCAGCAAAGCTTACAGGGGCAACTATGGCTACACCTTC	CASKAYRGNYGYTF	TRBV6-5	TRBJ1-2
TGCAGTGCTAGAGAGCCAAAGTCAGCGTGGAATGAGCAGTTCTTC	CSAREPKSAWNEQFF	TRBV20-1	TRBJ2-1
TGCGCCAGCAGAGCCCCTCCCGGTCGGGCCCCCTACGAGCAGTACTTC	CASRAPPGRAPYEQYF	TRBV5-1	TRBJ2-7
TGTGCCAGCAGCTTGGGGGGACTAGCGGGCGCCTACAATGAGCAGTTCTTC	CASSLGGLAGAYNEQFF	TRBV5-6	TRBJ2-1
TGTGCCAGCAGCTTAATTCAGGGACAAATGGCAAAGAATTCACCCCTCCACTTT	CASSLIQGQMAKNSPLHF	TRBV7-2	TRBJ1-6
TGTGCCAGCAGAAACCCAAACGGAGGGGAAAAACTGTTTTTT	CASRNPNGGEKLFF	TRBV27	TRBJ1-4
TGTGCCAGCAGCTTAACTTCGCGGAAGGGGGGCCTAGGTGCTTCACCTTATGAGCAGTTCTTC	CASSLTSRKGGLGASPYEQFF	TRBV7-9	TRBJ2-1
TGTGCCAGCAGCGTAGCTGGGGGCAAAGAGTCCAGCTCCTATAATTCACCCCTCCACTTT	CASSVAGGKESSSYNSPLHF	TRBV9	TRBJ1-6
TGTGCCAGCTCACCACCCGTAGAATTAAGTCGATCTGAAGCTTTCTTT	CASSPPVELSRSEAFF	TRBV18	TRBJ1-1
TGTGCCAGCAGCCGGGACAGGGTGATGAACACTGAAGCTTTCTTT	CASSRDRVMNTEAFF	TRBV3-1	TRBJ1-1
TGCGCCAGCAGCCAAGTCAGGTTGCGGGAGCTGGATGAGCAGTTCTTC	CASSQVRLRELDEQFF	TRBV4-1	TRBJ2-1
TGTGCCAGCAGCCGAGCGGGGTACAGGGGTTCCTATAATTCACCCCTCCACTTT	CASSRAGYRGSYNSPLHF	TRBV7-7	TRBJ1-6
TGCGCCAGCAGCCGGACAGGGTCCGAGTACTTC	CASSRTGSEYF	TRBV4-1	TRBJ2-4
TGCAGCAATGGGGAGGCGGATACGCAGTATTTT	CSNGEADTQYF	TRBV29-1	TRBJ2-3
TGTGCCAGCAGCGACGTGCAAGCTTTCTTT	CASSDVQAFF	TRBV13	TRBJ1-1
TGTGCCAGCAGCCAAGGGAGTATGAGGAGGGGCTACACCTTC	CASSQGSMRRGYTF	TRBV3-1	TRBJ1-2
TGTGCCAGCATCCCCGCTATAGATGAGCAGTTCTTC	CASIPAIDEQFF	TRBV6-8	TRBJ2-1
TGTGCCAGCTCACCGTGCGACAGGGGTGGAACTAATGAAAAACTGTTTTTT	CASSPCDRGGTNEKLFF	TRBV18	TRBJ1-4
TGTGCCATCACCAATTGGAGGGGGGCACTAAGGAATCAGCCCCAGCATTTT	CAITNWRGALRNQPQHF	TRBV10-3	TRBJ1-5
TGTGCCAGCAGTGCGAGGAGGTTTGAGCAGTTCTTC	CASSARRFEQFF	TRBV25-1	TRBJ2-1
TGCGCCAGCAGCAAAGCGACGTACGAGCAGTACTTC	CASSKATYEQYF	TRBV5-1	TRBJ2-7
TGCGCCAGCAGCTTACGGGGGACCGTATCCAATGAGCAGTTCTTC	CASSLRGTVSNEQFF	TRBV5-1	TRBJ2-1
TGCAGTGCTAGAGATTGGGGCGAGAGAGTAGATACGCAGTATTTT	CSARDWGERVDTQYF	TRBV20-1	TRBJ2-3
TGTGCCACCAGCAGAAGGGCCGGTCGGGCGGGACAGGGTGACGGCTACGAGCAGTACTTC	CATSRRAGRAGQGDGYEQYF	TRBV15	TRBJ2-7
TGTGCCACCAGTGATTTGGCCCATATACTCGACAATGAGCAGTTCTTC	CATSDLAHILDNEQFF	TRBV24-1	TRBJ2-1
TGCGCCAGCAGTGACCCGCAACCCGGGGGGGCGGGCAGGAGCTCCTACGAGCAGTACTTC	CASSDPQPGGAGRSSYEQYF	TRBV10-1	TRBJ2-7
TGTGCCACCCGGACAGGGAGGACCGAGCAGTACTTC	CATRTGRTEQYF	TRBV24-1	TRBJ2-7
TGTGCCATCAGTGCTACCGTTGGTATCGACGGGAATCAGCCCCAGCATTTT	CAISATVGIDGNQPQHF	TRBV10-3	TRBJ1-5
TGTGCCAGCAGTTTAGGGGGGCGGTCAGGGGGCTTCAAGGAGCAGTACTTC	CASSLGGRSGGFKEQYF	TRBV27	TRBJ2-7
TGTGCCAGCAGGTCCGTCCGCTCGGGGGCTTACGAGCAGTACTTC	CASRSVRSGAYEQYF	TRBV6-4	TRBJ2-7
TGTGCCAGCAGCGCCCGGGACAGGGTTGAAAAACTGTTTTTT	CASSARDRVEKLFF	TRBV7-8	TRBJ1-4
TGTGCCAGCAGTCCGCAGGGGGGGGTGCAGCCCCAGCATTTT	CASSPQGGVQPQHF	TRBV12-4	TRBJ1-5
TGCGCCAGCAGAATGAGAGGACAGGGGTCCGGCATGAGCTCCTACGAGCAGTACTTC	CASRMRGQGSGMSSYEQYF	TRBV10-1	TRBJ2-7
TGTGCCAGCAGCTTGGCGGAGACAGGGGTTTCCGGGGAGCTGTTTTTT	CASSLAETGVSGELFF	TRBV5-6	TRBJ2-2
TGTGCCAGCCAGGACAGGTTAACGAACACTGAAGCTTTCTTT	CASQDRLTNTEAFF	TRBV6-4	TRBJ1-1
TGTGCCAGCACGGGGGTCGGTAGTGAGCAGTACTTC	CASTGVGSEQYF	TRBV27	TRBJ2-7
TGTGCCAGCAGCTTAGGTTCGTCCCGGTACAACTACGAGCAGTACTTC	CASSLGSSRYNYEQYF	TRBV11-3	TRBJ2-7
TGTGCCAGCAGTTCGGCGACTAGCGGGGGGGCGCAGAGCACAGATACGCAGTATTTT	CASSSATSGGAQSTDTQYF	TRBV6-5	TRBJ2-3
TGTGCCAGCAGTGAAACAGCCCGGGACCCGGACCAGCGGACTGGCCTTGAAAAACTGTTTTTT	CASSETARDPDQRTGLEKLFF	TRBV2	TRBJ1-4
TGTGCCAGCAGTTTGGGCATTATGAACACTGAAGCTTTCTTT	CASSLGIMNTEAFF	TRBV27	TRBJ1-1
TGCGCCAGCAGCTACAACTACCGGGACAGGGCCCGTCTGGAGATTCCCTACGAGCAGTACTTC	CASSYNYRDRARLEIPYEQYF	TRBV5-1	TRBJ2-7
TGTGCCAGCAGCGCCTGGGAACACTACACAGATACGCAGTATTTT	CASSAWEHYTDTQYF	TRBV5-6	TRBJ2-3
TGTGCCAGCAGCCCCCCCCCGGGACAGCAGCCCCAGCATTTT	CASSPPPGQQPQHF	TRBV7-3	TRBJ1-5
TGTGCCAGCAGTTACATTCGGGACAGTGAGACCTCCTACGAGCAGTACTTC	CASSYIRDSETSYEQYF	TRBV6-5	TRBJ2-7
TGTGCCAGCCTCCCAAACGCCCGGGACAGGGGGAAGTTGTGGAATCAGCCCCAGCATTTT	CASLPNARDRGKLWNQPQHF	TRBV27	TRBJ1-5
TGCGCCAGCAGCCCGGCCCCCTACGAGCAGTACTTC	CASSPAPYEQYF	TRBV10-1	TRBJ2-7
TGTGCCAGCATAGGACGATACATTCCTTGCAGGCGAGCAGTCGGGGCTGGCTGGCAGTTCTTC	CASIGRYIPCRRAVGAGWQFF	TRBV27	TRBJ2-1
TGTGCCAGCAGCCGCCCAGAAACCTACGAGCAGTACTTC	CASSRPETYEQYF	TRBV6-2	TRBJ2-7
TGTGCCAGCAGGACACTCGGCCTCTCCTACGAGCAGTACTTC	CASRTLGLSYEQYF	TRBV6-3	TRBJ2-7
TGTGCCAGCAGTTTAGTAGCCGGGACAGGGGTGTACGACTATGGCTACACCTTC	CASSLVAGTGVYDYGYTF	TRBV12-3	TRBJ1-2
TGTGCCAGCAGCCCTATTAAGAGCCCTAAAATCAGCGACGGCTCCTACGAGCAGTACTTC	CASSPIKSPKISDGSYEQYF	TRBV14	TRBJ2-7
TGTGCCAGCAGCCCCACAGGGCGGAGAAGAGGGGCCAACGTCCTGACTTTC	CASSPTGRRRGANVLTF	TRBV7-3	TRBJ2-6
TGTGCCAGCAGAAGGGGGGGGGACTATGGCTACACCTTC	CASRRGGDYGYTF	TRBV6-5	TRBJ1-2
TGCGCCAGTAATCGGAGGTATGAAAAACTGTTTTTT	CASNRRYEKLFF	TRBV5-1	TRBJ1-4
TGCAGTGCTAGAAAACACGGGCCGGGGCCCGCACCTTACGGGGAGCTGTTTTTT	CSARKHGPGPAPYGELFF	TRBV20-1	TRBJ2-2
TGTGCCAGCCGCCGGGGGTTCACAGATACGCAGTATTTT	CASRRGFTDTQYF	TRBV2	TRBJ2-3
TGCGCCAGCAGTCTCAGGACTAGCGGAAGTGAGCAGTTCTTC	CASSLRTSGSEQFF	TRBV10-1	TRBJ2-1
TGTGCCAGCAGGCAGGGGCCGACAGATACGCAGTATTTT	CASRQGPTDTQYF	TRBV28	TRBJ2-3
TGTGCCAGCAGCCCGAGGGGCCTGAACACTGAAGCTTTCTTT	CASSPRGLNTEAFF	TRBV27	TRBJ1-1
TGTGCCAGCAGCGCCCTAGTCTCCTACGAGCAGTACTTC	CASSALVSYEQYF	TRBV13	TRBJ2-7
TGTGCCAGCAGGGGGGGGCACTCGAACACCGGGGAGCTGTTTTTT	CASRGGHSNTGELFF	TRBV7-4	TRBJ2-2
TGTGCCAGCAAAGGACAAAACACTGAAGCTTTCTTT	CASKGQNTEAFF	TRBV6-5	TRBJ1-1
TGTGCCGTCCCGTCCGGGACTAGCGGGAGGGATACGCAGTATTTT	CAVPSGTSGRDTQYF	TRBV9	TRBJ2-3
TGTGCCAGCAGTTACTCTCGACCTTCGGGGAAAAGCTCCTACAATGAGCAGTTCTTC	CASSYSRPSGKSSYNEQFF	TRBV6-3	TRBJ2-1
TGTGCCATCAGTGAGCGCCGACAGGTCAAGAACACTGAAGCTTTCTTT	CAISERRQVKNTEAFF	TRBV10-3	TRBJ1-1
TGTGCCAGCAGTCTGACTAGCGGGCTGCTTGAGTACTTC	CASSLTSGLLEYF	TRBV27	TRBJ2-5
TGCAGTGCTAGAGATGTCGGAACGTACTGCTACAATGAGCAGTTCTTC	CSARDVGTYCYNEQFF	TRBV20-1	TRBJ2-1
TGTGCCTGGACATTGCGACTAGCGGGAGCTGGGGCCAACGTCCTGACTTTC	CAWTLRLAGAGANVLTF	TRBV30	TRBJ2-6
TGTGCCAGCAGCTTAGGGACTAGGTCAAACAATGAGCAGTTCTTC	CASSLGTRSNNEQFF	TRBV7-6	TRBJ2-1
TGTGCCAGCAGTTACGGAGTCGGGACGCTTTCTAACTATGGCTACACCTTC	CASSYGVGTLSNYGYTF	TRBV6-3	TRBJ1-2
TGTGCCAGCAACTTATGGGGAGACAGGGGTCGTGGCTACACCTTC	CASNLWGDRGRGYTF	TRBV27	TRBJ1-2
TGTGCCAGCAGCTCCGACAGGGACTATGGCTACACCTTC	CASSSDRDYGYTF	TRBV7-3	TRBJ1-2
TGTGCCATCAGTGAAATAGGGGCCGGCTATAATTCACCCCTCCACTTT	CAISEIGAGYNSPLHF	TRBV10-3	TRBJ1-6
TGTGCCAGCAGCGTCGTCATCATCAGCGCTAAAAGCACAGATACGCAGTATTTT	CASSVVIISAKSTDTQYF	TRBV7-8	TRBJ2-3
TGCGCCAATTCCTCCCGGACTAGCGGGAGGTTCTTAACAGATACGCAGTATTTT	CANSSRTSGRFLTDTQYF	TRBV10-2	TRBJ2-3
TGCAGTGCTCAAAACAGGGGGCGGAATCAGCCCCAGCATTTT	CSAQNRGRNQPQHF	TRBV20-1	TRBJ1-5
TGTGCCAGCAGCTTCGGGACTGGTAAGTACTTC	CASSFGTGKYF	TRBV7-9	TRBJ2-5
TGTGCCAGCAGAGCCTCGGGGACCGCTAATGAAAAACTGTTTTTT	CASRASGTANEKLFF	TRBV12-3	TRBJ1-4
TGTGCCAGCAGCTTAGCCGGAGGCAGGTGTTCTGAAGCTTTCTTT	CASSLAGGRCSEAFF	TRBV11-2	TRBJ1-1
TGTGCCAGCAGCTTGCAATTCCAGGGCCTAGACACTGAAGCTTTCTTT	CASSLQFQGLDTEAFF	TRBV5-4	TRBJ1-1
TGTGCCAGCAGTACGCGGGAGGCTCACGAGCAGTACTTC	CASSTREAHEQYF	TRBV12-3	TRBJ2-7
TGTGCCAGCATTGTCGGACAGGGGGATCCTAACGAGCAGTACTTC	CASIVGQGDPNEQYF	TRBV6-4	TRBJ2-7
TGTGCCAGGCAGGGACTAGCGGCGGAGAACACCGGGGAGCTGTTTTTT	CARQGLAAENTGELFF	TRBV14	TRBJ2-2
TGTGCTACAATATTCCGAAATGGAAAGTCCTACGAGCAGTACTTC	CATIFRNGKSYEQYF	TRBV12-5	TRBJ2-7
TGTGCCAGCAGCCCGGGACAGGGGCAGGAGACCCAGTACTTC	CASSPGQGQETQYF	TRBV5-5	TRBJ2-5
TGTGCCAGCAGCAGACAGGGGTGTAGGAGTGGGAACACTGAAGCTTTCTTT	CASSRQGCRSGNTEAFF	TRBV5-6	TRBJ1-1
TGTGCCAGCAGCTGTCGGGCGGGACTAGCGGGAGTTCGCTACGAGCAGTACTTC	CASSCRAGLAGVRYEQYF	TRBV7-8	TRBJ2-7
TGTGCCAGCAGCCAAGCTGTCTACACAGGGAGCAATCAGCCCCAGCATTTT	CASSQAVYTGSNQPQHF	TRBV3-1	TRBJ1-5
TGTGCCAGCAGCCAACCTTCGGCGAGGGCCCAGTACTTC	CASSQPSARAQYF	TRBV2	TRBJ2-5
TGTGCCAGGACATGGGGGGGAGAAGCCTACGAGCAGTACTTC	CARTWGGEAYEQYF	TRBV24-1	TRBJ2-7
TGTGCCAGCAGCTCGGTGCCGGGCCCCCCGCAGCCCCAGCATTTT	CASSSVPGPPQPQHF	TRBV5-6	TRBJ1-5
TGTGCCACCAGTGTTTCCCACGGCTACACCTTC	CATSVSHGYTF	TRBV24-1	TRBJ1-2
TGTGCCAGCAGCGCCGGGGGCCAGCAAGAGACCCAGTACTTC	CASSAGGQQETQYF	TRBV7-6	TRBJ2-5
TGTGCCAGCAGCCAGACACCACACAATGAGCAGTTCTTC	CASSQTPHNEQFF	TRBV14	TRBJ2-1
TGTGCCAGCAGCTTAGCCGGGGAAAGAGAGACCCAGTACTTC	CASSLAGERETQYF	TRBV7-2	TRBJ2-5
TGTGCCAGCAGCAGAACCGGGACAGATAGCAATCAGCCCCAGCATTTT	CASSRTGTDSNQPQHF	TRBV7-2	TRBJ1-5
TGCAGTGCTCCAGCCGAAACACTAGCGGGCACTGGGAAGAGTGAGCAGTTCTTC	CSAPAETLAGTGKSEQFF	TRBV20-1	TRBJ2-1
TGCGCCAGCAGCTCTAAAAGGGCCGACGCCTACAATGAGCAGTTCTTC	CASSSKRADAYNEQFF	TRBV5-1	TRBJ2-1
TGTGCCAGCAGCTTCTGGGGGGGCCAAGAGACCCAGTACTTC	CASSFWGGQETQYF	TRBV11-2	TRBJ2-5
TGCAGCGTTGAAGCCAAAAAAGGGACAGACCCATGCGCCGGGGAGCTGTTTTTT	CSVEAKKGTDPCAGELFF	TRBV29-1	TRBJ2-2
TGTGCCAGCAGTGAGGCCAGGTACAGGGGGCTGGGGACCGTCATCTCTGGAAACACCATATATTTT	CASSEARYRGLGTVISGNTIYF	TRBV6-4	TRBJ1-3
TGCAGCGTTGGCCGGGGCAGGGGAACGAGAGGTGCGCCTCAGCCCCAGCATTTT	CSVGRGRGTRGAPQPQHF	TRBV29-1	TRBJ1-5
TGCAGCGTTGGCCGGGGGACATTTCCAGATACGCAGTATTTT	CSVGRGTFPDTQYF	TRBV29-1	TRBJ2-3
TGTGCCACCTATACCGACAATGAGCAGTTCTTC	CATYTDNEQFF	TRBV6-1	TRBJ2-1
TGCAGTGCTAGGACCGGGGTTCATGCAACTAATGAAAAACTGTTTTTT	CSARTGVHATNEKLFF	TRBV20-1	TRBJ1-4
TGTGCCAGCAGTGTACGGGGGGGGAGCGAGCAGTACTTC	CASSVRGGSEQYF	TRBV6-5	TRBJ2-7
TGTGCCAGGGTATTTTCGGATCAGCCCCAGCATTTT	CARVFSDQPQHF	TRBV19	TRBJ1-5
TGTGCCAGCAGTCCCCCACCGGGACAGGGCAAAGGCAATCAGCCCCAGCATTTT	CASSPPPGQGKGNQPQHF	TRBV12-4	TRBJ1-5
TGCGCCAGCAGCTTGGTAACAGCCATGAGAAATGAAAAACTGTTTTTT	CASSLVTAMRNEKLFF	TRBV5-1	TRBJ1-4
TGTGCCAGCAGCTTAGCTATAGGGTGGGGGGAAAAAAGCAATCAGCCCCAGCATTTT	CASSLAIGWGEKSNQPQHF	TRBV7-8	TRBJ1-5
TGTGCTAGTGGTTTGGTACGGACAGGGCCGGGCTATGGCTACACCTTC	CASGLVRTGPGYGYTF	TRBV12-5	TRBJ1-2
TGTGCCAGCAGCTTAGGCAGAGCAATAATTTCCTACGAGCAGTACTTC	CASSLGRAIISYEQYF	TRBV7-6	TRBJ2-7
TGCGCCAGCAGCTTGGGGGTCCCGGGTTGCCCGTTGGGGTACTCACCCCTCCACTTT	CASSLGVPGCPLGYSPLHF	TRBV5-1	TRBJ1-6
TGTGCCAGCAGCGTAGAGGGGAATGAGATTGACGAGGGCTCCTACGAGCAGTACTTC	CASSVEGNEIDEGSYEQYF	TRBV9	TRBJ2-7
TGTGCCAGCAGCGACTCGGAACTAGAGACCCAGTACTTC	CASSDSELETQYF	TRBV13	TRBJ2-5
TGTGCCTGGAGCGAATGCAACTATGGCTACACCTTC	CAWSECNYGYTF	TRBV30	TRBJ1-2
TGTGCCAGCAGTGACTCAAGCGCCCACGGGGGACTAAGCCAAGAGACCCAGTACTTC	CASSDSSAHGGLSQETQYF	TRBV6-4	TRBJ2-5
TGTGCCAGCAGCGTAGGCCGGGACAGTTCCTACGAGCAGTACTTC	CASSVGRDSSYEQYF	TRBV9	TRBJ2-7
TGTGCCAGCAGCTTAAGGGGCATTACAGGGAGCAAGCCCCAGCATTTT	CASSLRGITGSKPQHF	TRBV7-3	TRBJ1-5
TGTGCCAGCAGTTACGGGGGGAACACCGGGGAGCTGTTTTTT	CASSYGGNTGELFF	TRBV6-5	TRBJ2-2
TGTGCCAGCAGTTATCCAAGTCCGGACAGGGAACCAAACCGCTATGGCTACACCTTC	CASSYPSPDREPNRYGYTF	TRBV6-6	TRBJ1-2
TGTGCCAGTAGTACGTGGGTGGGACTGGCCAAGCAGTTCTTC	CASSTWVGLAKQFF	TRBV19	TRBJ2-1
TGTGCCAGCAGCCCTAGCAGGGAAGCAGCCAAAAACATTCAGTACTTC	CASSPSREAAKNIQYF	TRBV5-6	TRBJ2-4
TGCAGTGCTTTGGGGATACTAGCGGGAGGAGGTTTAACCATGAACACTGAAGCTTTCTTT	CSALGILAGGGLTMNTEAFF	TRBV20-1	TRBJ1-1
TGCAGTGCTAGAAATGGGACAGGGCCGAGCCTTTGTAGCAATCAGCCCCAGCATTTT	CSARNGTGPSLCSNQPQHF	TRBV20-1	TRBJ1-5
TGTGCCAGCAGCCAAGAACGGTCAAATCAGCCCCAGCATTTT	CASSQERSNQPQHF	TRBV3-1	TRBJ1-5
TGTGCCAGCAGTTCTCCCCGGCGTAGGCAGCCCCAGCATTTT	CASSSPRRRQPQHF	TRBV6-8	TRBJ1-5
TGTGCCAGCAGCTTAGATCTTAAGGGTTTTACTCACACTGAAGCTTTCTTT	CASSLDLKGFTHTEAFF	TRBV11-2	TRBJ1-1
TGTGCCAGGCTGGACGGAGAGACCCAGTACTTC	CARLDGETQYF	TRBV28	TRBJ2-5
TGTGCCAGCAGCGTAGATAGGCCTGCCACTGAAGCTTTCTTT	CASSVDRPATEAFF	TRBV9	TRBJ1-1
TGCAGTGCTAGAGTGACAGGCTCTGGGGCCAACGTCCTGACTTTC	CSARVTGSGANVLTF	TRBV20-1	TRBJ2-6
TGTGCCAGCATCCCGACCAGAGACGACTACGAGCAGTACTTC	CASIPTRDDYEQYF	TRBV7-3	TRBJ2-7
TGTGCCAGCAGCAAACCACCAGGGGAAGGAGAAGCCTACGAGCAGTACTTC	CASSKPPGEGEAYEQYF	TRBV5-6	TRBJ2-7
TGTGCCAGCTCGTTCGGGGGCCGGAATGGAGGGCCTGAAAAACTGTTTTTT	CASSFGGRNGGPEKLFF	TRBV18	TRBJ1-4
TGCGCCAGCAGCCAAGAAACGAATACCGGACAGGGGCGCTCCTACGAGCAGTACTTC	CASSQETNTGQGRSYEQYF	TRBV4-3	TRBJ2-7
TGTGCCAGCAGCTTGGTGGACAGGGCGATATACAATGAGCAGTTCTTC	CASSLVDRAIYNEQFF	TRBV11-3	TRBJ2-1
TGCAGTGCTAGAGCGGGAGGGGGGCTAACTGAAGCTTTCTTT	CSARAGGGLTEAFF	TRBV20-1	TRBJ1-1
TGTGCCAGCAGTTCCAGGGCCAGGTCCTACGAGCAGTACTTC	CASSSRARSYEQYF	TRBV27	TRBJ2-7
TGCGCCAGCGGAGCGGTCAGAACAGATACGCAGTATTTT	CASGAVRTDTQYF	TRBV5-1	TRBJ2-3
TGTGCCAGCAGCCCCCCCCACAGGGTTAGGGAAGAGACCCAGTACTTC	CASSPPHRVREETQYF	TRBV11-3	TRBJ2-5
TGTGCCAGCAGCTCGGGACACTTTTACACTGAAGCTTTCTTT	CASSSGHFYTEAFF	TRBV5-4	TRBJ1-1
TGTGCCAGCTCCATGACAGGAAAGCATTTT	CASSMTGKHF	TRBV18	TRBJ1-5
TGCAGTGCTACTCAGGGGAGGTACAATGAGCAGTTCTTC	CSATQGRYNEQFF	TRBV20-1	TRBJ2-1
TGTGCCAACACAGGGGGAGACTATGGCTACACCTTC	CANTGGDYGYTF	TRBV27	TRBJ1-2
TGCAGTGCTACTTTACGGAACTATGGCTACACCTTC	CSATLRNYGYTF	TRBV20-1	TRBJ1-2
TGCAGTGCTAGATCCCGAGACCGAAAAGGGCCGTCCAGTAGCAATCAGCCCCAGCATTTT	CSARSRDRKGPSSSNQPQHF	TRBV20-1	TRBJ1-5
TGTGCCAGCAGCGTAGCCGGGAAATCAAAGGGGAATGAAAAACTGTTTTTT	CASSVAGKSKGNEKLFF	TRBV9	TRBJ1-4
TGTGCCAGCAGTCGAGCCGTGGCTGCCAAGACGCCCCAGCATTTT	CASSRAVAAKTPQHF	TRBV27	TRBJ1-5
TGTGCCAGCAGCAGGGGAACCACTGAAGCTTTCTTT	CASSRGTTEAFF	TRBV7-3	TRBJ1-1
TGTGCCAGCAGTGGGGGGCCACACACCGGGGAGCTGTTTTTT	CASSGGPHTGELFF	TRBV7-4	TRBJ2-2
TGTGCCAGCAGCGGACAGGGTCAGGCGAACACTGAAGCTTTCTTT	CASSGQGQANTEAFF	TRBV6-5	TRBJ1-1
TGTGCCAGCAACGCGGGTATGACCGGGGAGCTGTTTTTT	CASNAGMTGELFF	TRBV6-5	TRBJ2-2
TGTGCCAGCAGCTCTGGGGGGAACGACAACTATGGCTACACCTTC	CASSSGGNDNYGYTF	TRBV7-2	TRBJ1-2
TGTGCTAGTGGTTTGCCGGGGGACAGTGGAGTGGGGACTGAAGCTTTCTTT	CASGLPGDSGVGTEAFF	TRBV12-5	TRBJ1-1
TGTGCCAGCAGTACCTCTAGCGGGGGGTCCTACGAGCAGTACTTC	CASSTSSGGSYEQYF	TRBV12-3	TRBJ2-7
TGTGCCAGCAGCAAGATGGGGACCCCCTACGAGCAGTACTTC	CASSKMGTPYEQYF	TRBV11-3	TRBJ2-7
TGTGCCATTAACGGACAGGGGAGTCCTCCCGAGCAGTACTTC	CAINGQGSPPEQYF	TRBV24-1	TRBJ2-7
TGCGCCAGCAGCTCCCGACAGGGCCGCGGGGACGAGCAGTACTTC	CASSSRQGRGDEQYF	TRBV5-1	TRBJ2-7
TGTGCCAGTAGTCCCCCAGCAGTACTCCAAGAGACCCAGTACTTC	CASSPPAVLQETQYF	TRBV19	TRBJ2-5
TGTGCCAGACAGGGTTATTCACCCCTCCACTTT	CARQGYSPLHF	TRBV18	TRBJ1-6
TGTGCCAGCAGCTTAGTTCCAGGGACACATTGCACTGAAGCTTTCTTT	CASSLVPGTHCTEAFF	TRBV7-8	TRBJ1-1
TGTGCCAGCAGCTTACCGAGACAAAGGGGACAGGGAAATGGCTACACCTTC	CASSLPRQRGQGNGYTF	TRBV25-1	TRBJ1-2
TGTGCCAGCAGCTTGTACCCCGCAGGGGGCAAACGCTACAATGAGCAGTTCTTC	CASSLYPAGGKRYNEQFF	TRBV7-3	TRBJ2-1
TGTGCCAGCAAGTTCCCCCAGGGGGCGGGGAGATCACCCCTCCACTTT	CASKFPQGAGRSPLHF	TRBV6-5	TRBJ1-6
TGTGCCAGCAGTCGCCAGGGGTTCTGCTATGGCTACACCTTC	CASSRQGFCYGYTF	TRBV6-1	TRBJ1-2
TGTGCCAGCAGTGTGGCCTCGGCAAGCACTGAAGCTTTCTTT	CASSVASASTEAFF	TRBV6-5	TRBJ1-1
TGTGCCAGCAGCTTAGGTCAGTACGGGTACCTCTTGGGGGGCTACACCTTC	CASSLGQYGYLLGGYTF	TRBV7-6	TRBJ1-2
TGTGCCAGCAGTGGACAGGGAAACACCATATATTTT	CASSGQGNTIYF	TRBV25-1	TRBJ1-3
TGTGCCAGCTACCCCCCGAACCTGTTTTTT	CASYPPNLFF	TRBV27	TRBJ1-4
TGTGCCAGCAGTTTTCGGTTGACAGGGCCCTGGGGATTTAGCACAGATACGCAGTATTTT	CASSFRLTGPWGFSTDTQYF	TRBV2	TRBJ2-3
TGTGCTAGTGCCCCCGACAACACCGGGGAGCTGTTTTTT	CASAPDNTGELFF	TRBV12-5	TRBJ2-2
TGTGCCAGCAGCCAAGCCCTAGATGGTAGAGTTTGTGAGACCCAGTACTTC	CASSQALDGRVCETQYF	TRBV3-1	TRBJ2-5
TGCGCCAGCAGTGAAGGGCCGGGCCAGCCCCAGCATTTT	CASSEGPGQPQHF	TRBV10-1	TRBJ1-5
TGTGCCAGCAGTGTGGCGGCCGGGCGATATAGCAATCAGCCCCAGCATTTT	CASSVAAGRYSNQPQHF	TRBV25-1	TRBJ1-5
TGTGCCAGCAGTAGCCGGACAGGGAACACTGAAGCTTTCTTT	CASSSRTGNTEAFF	TRBV2	TRBJ1-1
TGTGCCAGCAGTTACCAGCGGGGGGCCACTGAAGCTTTCTTT	CASSYQRGATEAFF	TRBV6-2	TRBJ1-1
TGCAGTGGCTCGGGACTAGCGCGTGACGAGCAGTACTTC	CSGSGLARDEQYF	TRBV20-1	TRBJ2-7
TGTGCCAGCAGTTACCGGACAGGGGCCTACGAGCAGTACTTC	CASSYRTGAYEQYF	TRBV6-5	TRBJ2-7
TGTGCCAGCAGCTTAGTAGTCCGGGAACGGGGGAGGAGTGAGCAGTTCTTC	CASSLVVRERGRSEQFF	TRBV11-3	TRBJ2-1
TGTGCCAGTAGTATAGGGGGCCCTCGCCTTGGCTACACCTTC	CASSIGGPRLGYTF	TRBV19	TRBJ1-2
TGTGCCACCAGAGGGGGGGTGTTCTCTGGAAACACCATATATTTT	CATRGGVFSGNTIYF	TRBV24-1	TRBJ1-3
TGTGCCAGCAAGCCCAGGAAGGGCTACACCTTC	CASKPRKGYTF	TRBV6-4	TRBJ1-2
TGTGCCTTAGTCAGGGGGCCTCCCGAGCAGTACTTC	CALVRGPPEQYF	TRBV6-4	TRBJ2-7
TGTGCCAGCATATGCACAGGGGGCGCTTTCTCTGGGGCCAACGTCCTGACTTTC	CASICTGGAFSGANVLTF	TRBV6-5	TRBJ2-6
TGTGCCAGCAGCTTAGCCAGGACAGGGATTTTCTACGAGCAGTACTTC	CASSLARTGIFYEQYF	TRBV7-6	TRBJ2-7
TGTGCCAGCAGCTTAACCCCGACTGGGTCCAGTATGAATCAGCCCCAGCATTTT	CASSLTPTGSSMNQPQHF	TRBV11-3	TRBJ1-5
TGTGCCAGCAGTGGAAGGACATTGGGGGCGCTTTTAACCAAAAACATTCAGTACTTC	CASSGRTLGALLTKNIQYF	TRBV25-1	TRBJ2-4
TGTGCCAGCAGCAGGGAGATCAGGGCCTTCACAGATACGCAGTATTTT	CASSREIRAFTDTQYF	TRBV5-5	TRBJ2-3
TGTGCCAGACTAGGGCTCTGGTGGGATCAGCCCCAGCATTTT	CARLGLWWDQPQHF	TRBV19	TRBJ1-5
TGCGCCAGCAGCTACTGGGGGAGCTACGAGCAGTACTTC	CASSYWGSYEQYF	TRBV5-1	TRBJ2-7
TGTGCCAGCAGTTACAACCAGGGGGCCCTCGGGACCCAGTACTTC	CASSYNQGALGTQYF	TRBV6-5	TRBJ2-5
TGTGCCACCAGAAGGGAACATCAGCCCCAGCATTTT	CATRREHQPQHF	TRBV15	TRBJ1-5
TGTGCCAGCAGCTTCGGCGGACAGAACAGCACCTTC	CASSFGGQNSTF	TRBV11-2	TRBJ1-2
TGTGCCAGCAGCTTAGCTTCGGGGAAACGAGATTCACCCCTCCACTTT	CASSLASGKRDSPLHF	TRBV7-9	TRBJ1-6
TGTGCCAGCAGGGCTCCAACTAGGGAAGCAGATACGCAGTATTTT	CASRAPTREADTQYF	TRBV6-5	TRBJ2-3
TGTGCCAGCAGTGACAGGTTGGCATACAACACCGGGGAGCTGTTTTTT	CASSDRLAYNTGELFF	TRBV6-4	TRBJ2-2
TGTGCCAGTAGTGGACAGTCTAATGAAAAACTGTTTTTT	CASSGQSNEKLFF	TRBV19	TRBJ1-4
TGTGCCACCACAGGAATTTACTCTGGAAACACCATATATTTT	CATTGIYSGNTIYF	TRBV7-9	TRBJ1-3
TGCAGCGTCGGGCCCGGGGTTACGAACACCGGGGAGCTGTTTTTT	CSVGPGVTNTGELFF	TRBV29-1	TRBJ2-2
TGTGCGGTTAGCGGGGACTGGCTCACAGATACGCAGTATTTT	CAVSGDWLTDTQYF	TRBV25-1	TRBJ2-3
TGTGCCAGCGCGCCAGTCTGGACTATAACCCTCCAAGAGACCCAGTACTTC	CASAPVWTITLQETQYF	TRBV18	TRBJ2-5
TGTGCCAGCAGCGTCAGGGGCAGAAAGGACACTGAAGCTTTCTTT	CASSVRGRKDTEAFF	TRBV11-2	TRBJ1-1
TGTGCCAGCAGCTTAATCAGGGCCACTGAAGCTTTCTTT	CASSLIRATEAFF	TRBV11-2	TRBJ1-1
TGTGCCAGCAGTTTGACCGGGGACAGGGTGAGTCACACTGAAGCTTTCTTT	CASSLTGDRVSHTEAFF	TRBV27	TRBJ1-1
TGCAGCGGTCAGGGGCAGGGGAACGAAAAACTGTTTTTT	CSGQGQGNEKLFF	TRBV29-1	TRBJ1-4
TGCAGCGTTGACCCGGGACAGGGGTCGAGGTTGGCGAACACTGAAGCTTTCTTT	CSVDPGQGSRLANTEAFF	TRBV29-1	TRBJ1-1
TGTGCCACCAGCAGCCGGGCCTTAACAGATACGCAGTATTTT	CATSSRALTDTQYF	TRBV15	TRBJ2-3
TGTGCCGTACAGGGGGCGAACACTGAAGCTTTCTTT	CAVQGANTEAFF	TRBV27	TRBJ1-1
TGTGCCAGCAGCGAGGACAGGGATAATCAGCCCCAGCATTTT	CASSEDRDNQPQHF	TRBV9	TRBJ1-5
TGTGCCAGCAGTGACACTCTAGCGGGGTCCTACGAGCAGTACTTC	CASSDTLAGSYEQYF	TRBV6-4	TRBJ2-7
TGTGCCAGCAGCACGGGACATTACGAGCAGTACTTC	CASSTGHYEQYF	TRBV7-3	TRBJ2-7
TGCAGCTCATCCCCTAGCACGACTCCCCAAGAGACCCAGTACTTC	CSSSPSTTPQETQYF	TRBV29-1	TRBJ2-5
TGTGCCAGCAGCGTCGTGATTTCCTACGAGCAGTACTTC	CASSVVISYEQYF	TRBV12-3	TRBJ2-7
TGTGCCAGCAGTCAGCCTGGAAACACCATATATTTT	CASSQPGNTIYF	TRBV6-2	TRBJ1-3
TGTGCCAGCAGTTCCGGACAGCCAGGAAACACCATATATTTT	CASSSGQPGNTIYF	TRBV27	TRBJ1-3
TGTGCCAGCAGTAACGGGGAAGACTTGGGAGGCGAGCAGTACTTC	CASSNGEDLGGEQYF	TRBV2	TRBJ2-7
TGCGCCAGCTTGGTCCAGGGTGGGGGCTACACCTTC	CASLVQGGGYTF	TRBV10-1	TRBJ1-2
TGTGCCAGCAGCAGGGTAGCTTCCCCGGAGCTGTTTTTT	CASSRVASPELFF	TRBV5-5	TRBJ2-2
TGTGCCAGCAGGGGACAGAAGAGCCAAGAGACCCAGTACTTC	CASRGQKSQETQYF	TRBV6-6	TRBJ2-5
TGTGCCAGCACCCTAGGGGGGCGAGGCGCAGATACGCAGTATTTT	CASTLGGRGADTQYF	TRBV14	TRBJ2-3
TGTGCCACCCGTGGGGGACAGGGGGGTGGCTACACCTTC	CATRGGQGGGYTF	TRBV6-6	TRBJ1-2
TGTGCCACCAGTGATTCCGGGACAGGGGAAAAACTGTTTTTT	CATSDSGTGEKLFF	TRBV24-1	TRBJ1-4
TGTGCCAGCAGCCTGACCACCCGGGACAGGGACTCCTACGAGCAGTACTTC	CASSLTTRDRDSYEQYF	TRBV9	TRBJ2-7
TGTGCCAGCACGGCGAACAGGGGGACAGATATGGCCGGGGAGCTGTTTTTT	CASTANRGTDMAGELFF	TRBV2	TRBJ2-2
TGTGCCAGCCCTGACAGGGTTGGCACCCCCCACACCGGGGAGCTGTTTTTT	CASPDRVGTPHTGELFF	TRBV3-1	TRBJ2-2
TGTGCCAGCAGCTCCGAGGACTACGAGCAGTACTTC	CASSSEDYEQYF	TRBV5-4	TRBJ2-7
TGTGCCAGCAGCAGAGGGGCTGGAACCGGGGAGCTGTTTTTT	CASSRGAGTGELFF	TRBV7-9	TRBJ2-2
TGTGCCAGCATAATTGGGACAGGGGGGGATTCACCCCTCCACTTT	CASIIGTGGDSPLHF	TRBV6-1	TRBJ1-6
TGTGCCAGCAGCCAAGACCCTAGCGGGGGCGGGCAGCAGTTCTTC	CASSQDPSGGGQQFF	TRBV14	TRBJ2-1
TGTGCCAGCAGCGGACGTTGCTACGAGCAGTACTTC	CASSGRCYEQYF	TRBV7-7	TRBJ2-7
TGTGCCAGCAGCCGGGGGATCCTCACCTACGAGCAGTACTTC	CASSRGILTYEQYF	TRBV7-3	TRBJ2-7
TGTGCCAGCAGCGTAACTTGTTTCGACTATAGGGGAGTATGGGGCACAGATACGCAGTATTTT	CASSVTCFDYRGVWGTDTQYF	TRBV9	TRBJ2-3
TGTGCCAGCAGTTTATACCCTTCCTGGGGCCGGTATTTT	CASSLYPSWGRYF	TRBV27	TRBJ2-3
TGCAGTGCCTGGACAGTGTCCGAGCAGTTCTTC	CSAWTVSEQFF	TRBV20-1	TRBJ2-1
TGTGCCAGCAGCTTAGCCCCCGGGACTTTCCACCCTGAGCAGTACTTC	CASSLAPGTFHPEQYF	TRBV13	TRBJ2-7
TGTGCCAGCAGCCCACCACCAGTACATTATTGCTCCTATAATTCACCCCTCCACTTT	CASSPPPVHYCSYNSPLHF	TRBV5-6	TRBJ1-6
TGCGCCAGCAGTACAGGGAGATACGAGCAGTACTTC	CASSTGRYEQYF	TRBV10-2	TRBJ2-7
TGCGCCAGCAGCCAAGTGACATCTCCCCCGGGACTAGCGGGGGTTGTTAGGAGCACAGCCAAAAACATTCAGTACTTC	CASSQVTSPPGLAGVVRSTAKNIQYF	TRBV4-1	TRBJ2-4
TGTGCCAGCAGCCAAGATTGCCCCATTCCACGAACAAGGCCCAAAAACATTCAGTACTTC	CASSQDCPIPRTRPKNIQYF	TRBV3-1	TRBJ2-4
TGCAGTGCTAGAGAGAATCCAGGAAAGACAGGTTCCGCCAAAAACATTCAGTACTTC	CSARENPGKTGSAKNIQYF	TRBV20-1	TRBJ2-4
TGTGCCAGCAGCTTAATCGTCATCTCACCCCTCCACTTT	CASSLIVISPLHF	TRBV5-5	TRBJ1-6
TGTGCCACCAGTGATTTGCTCAGGCTCGGACAGGCAGCCGATGGCTACACCTTC	CATSDLLRLGQAADGYTF	TRBV24-1	TRBJ1-2
TGCAGCGTTCTTTACAGGGAAGCTTTCTTT	CSVLYREAFF	TRBV29-1	TRBJ1-1
TGTGCCAGGGCCAAGTACAGGGTTGGCTCCTACGAGCAGTACTTC	CARAKYRVGSYEQYF	TRBV10-3	TRBJ2-7
TGTGCCAGCAGCGTAGCACATGCTTTCTTT	CASSVAHAFF	TRBV9	TRBJ1-1
TGTGCCAGACCCCCGGACAGGGAGTGCCATGGCTACACCTTC	CARPPDRECHGYTF	TRBV19	TRBJ1-2
TGTGCCAGCAGCGGTGGAGCGGGACCCTTTGCCTACGAGCAGTACTTC	CASSGGAGPFAYEQYF	TRBV7-4	TRBJ2-7
TGTGCCAGCTCACCACTGTCTTTCAGGGGGGGTGGTAGCTCCTACGAGCAGTACTTC	CASSPLSFRGGGSSYEQYF	TRBV18	TRBJ2-7
TGCAGTGCTGGAGGTGAACAGGGAAATTCTGAAAAACTGTTTTTT	CSAGGEQGNSEKLFF	TRBV20-1	TRBJ1-4
TGTGCCAGCAGCCGGAGTAGGACAGGGGCCGAGACCCAGTACTTC	CASSRSRTGAETQYF	TRBV7-3	TRBJ2-5
TGTGCCAGCAGTTTATGTGGAAGGGACAGACCTGGAAACACCATATATTTT	CASSLCGRDRPGNTIYF	TRBV27	TRBJ1-3
TGTGCCAGCAGTTTGACGTTCAACCCCCGGTCGTCGGTCAGCTACGAGCAGTACTTC	CASSLTFNPRSSVSYEQYF	TRBV28	TRBJ2-7
TGTGCCAGCAGCTTCAGGGCGGCTGGGGCCAACGTCCTGACTTTC	CASSFRAAGANVLTF	TRBV7-6	TRBJ2-6
TGTGCCAGCAGTGCAGGGGGGAACACTGAAGCTTTCTTT	CASSAGGNTEAFF	TRBV6-1	TRBJ1-1
TGTGCTAGTGGTTTGGTACACTTCCGTTCTTCCAGGAGAACTGAAGCTTTCTTT	CASGLVHFRSSRRTEAFF	TRBV12-5	TRBJ1-1
TGTGCCAGCAGTTACCAGAGACAAAATGAGGTCGCCTACGAGCAGTACTTC	CASSYQRQNEVAYEQYF	TRBV6-6	TRBJ2-7
TGTGCCAGCAGCCGGGGGACAGGGGAACACACTGAAGCTTTCTTT	CASSRGTGEHTEAFF	TRBV4-2	TRBJ1-1
TGTGCCAGCCCGGAGTGCTTTGAAAAACTGTTTTTT	CASPECFEKLFF	TRBV2	TRBJ1-4
TGTGCCAGCAGTGCCGGGACAGGGAGTTCTCACTATGGCTACACCTTC	CASSAGTGSSHYGYTF	TRBV6-4	TRBJ1-2
TGCACCCTGCGGGCCCGTAAAAACATTCAGTACTTC	CTLRARKNIQYF	TRBV20-1	TRBJ2-4
TGTGCTAGTGGGACCGATGGCTACACCTTC	CASGTDGYTF	TRBV12-5	TRBJ1-2
TGTGCCAGCAGCCTTCGTCGCCCGAGACTAGCGTTGGACAATGAGCAGTTCTTC	CASSLRRPRLALDNEQFF	TRBV3-1	TRBJ2-1
TGTGCCAGCAGCCCTTCGAGCTCTGGGGCCAACGTCCTGACTTTC	CASSPSSSGANVLTF	TRBV6-2	TRBJ2-6
TGTGCCAGTAGTATCGCAGTTGGGGCTGATGAGCAGTTCTTC	CASSIAVGADEQFF	TRBV19	TRBJ2-1
TGCAGTGCTCCAGGGGGGCCTAATCAATTGGATACGCAGTATTTT	CSAPGGPNQLDTQYF	TRBV20-1	TRBJ2-3
TGCGCCAGCAGCTTGGAGATCTTCACCACTAGCGGTAAATCTGAGCAGTACTTC	CASSLEIFTTSGKSEQYF	TRBV5-1	TRBJ2-7
TGCAGTGCTAGAGATTCCATAGCCGGGACGGGATCCTCCTACGAGCAGTACTTC	CSARDSIAGTGSSYEQYF	TRBV20-1	TRBJ2-7
TGCGCCAGCTTAGGGACTATTTTGGCAGATACGCAGTATTTT	CASLGTILADTQYF	TRBV10-1	TRBJ2-3
TGTGCCAGTAGTATGTCCGACACCGAGCGATGCGGGGCCTCAGTTAGTCAGACTGAAGCTTTCTTT	CASSMSDTERCGASVSQTEAFF	TRBV19	TRBJ1-1
TGTGCCAGCAGCTGTAAGACAGGGGGCTCGTTAAGGGGGCAGTTCTTC	CASSCKTGGSLRGQFF	TRBV5-4	TRBJ2-1
TGTGCCAGCAGCGTAGCGTCAGGACAGCGGGAGACCCAGTACTTC	CASSVASGQRETQYF	TRBV9	TRBJ2-5
TGCGCCAGCAGAGGGGACAGGGGGAATCAGCCCCAGCATTTT	CASRGDRGNQPQHF	TRBV10-1	TRBJ1-5
TGCGCCAGCAGCTTGCCGGACTGCATGGCTAACGCCCCAACCGGGGAGCTGTTTTTT	CASSLPDCMANAPTGELFF	TRBV5-1	TRBJ2-2
TGTGCCAGCAGCCTGGGCCGGGACAGGGCGGACGAGCAGTACTTC	CASSLGRDRADEQYF	TRBV6-5	TRBJ2-7
TGTGCCAGCACGACAGGGGTTGACCTACAAGAGACCCAGTACTTC	CASTTGVDLQETQYF	TRBV27	TRBJ2-5
TGTGCCAGCAGTGAAAGGGCTAACCCCGCGTGGGGTGGGCATCAGCCCCAGCATTTT	CASSERANPAWGGHQPQHF	TRBV6-1	TRBJ1-5
TGTGCCAGCAGCTCCAGGGCCGGCGGGTCACCCCTCCACTTT	CASSSRAGGSPLHF	TRBV13	TRBJ1-6
TGTGCCACCAGCAGGGGGGGCAGCTGGAACACCGGGGAGCTGTTTTTT	CATSRGGSWNTGELFF	TRBV24-1	TRBJ2-2
TGTGCCAGCAGTTGCTGGGACAGCACTGAAGCTTTCTTT	CASSCWDSTEAFF	TRBV6-9	TRBJ1-1
TGTGCCAGCAGTGTCCCGGGAGGGAGTCGAAGAGAGACCCAGTACTTC	CASSVPGGSRRETQYF	TRBV25-1	TRBJ2-5
TGTGCCAGCAGCGTAGCTGGAAGACGCCCGGGACAGGGGAGGAACACTGAAGCTTTCTTT	CASSVAGRRPGQGRNTEAFF	TRBV9	TRBJ1-1
TGTGCCAGCAGCTTAAGAGACAGGAATGGCTACACCTTC	CASSLRDRNGYTF	TRBV7-6	TRBJ1-2
TGTGCCAGCAGCCTAGTCGGCTACACCTTC	CASSLVGYTF	TRBV27	TRBJ1-2
TGTGCCAGCAGTCAGGGGGGCAACGCTCGTGAGCAGTTCTTC	CASSQGGNAREQFF	TRBV6-5	TRBJ2-1
TGTGCCAGCAGCAAGGTACTAGTTGGAGGGTCCACAGATACGCAGTATTTT	CASSKVLVGGSTDTQYF	TRBV14	TRBJ2-3
TGTGCCAGCAGCTGTCCTGTTCCCGGGCTTTTTGTCACGTTCACCGGGGAGCTGTTTTTT	CASSCPVPGLFVTFTGELFF	TRBV11-3	TRBJ2-2
TGTGCTAGCAGCTTAGCGGGGCACCTAGGGGAGCTGTTTTTT	CASSLAGHLGELFF	TRBV7-7	TRBJ2-2
TGTGCCAGCAGCTTAGTAGGGCCCCTGAGCTCCTACGAGCAGTACTTC	CASSLVGPLSSYEQYF	TRBV7-2	TRBJ2-7
TGCAGTAAGGTCCCTCAACTGGACACGGGAGGGAGCTCCTACAATGAGCAGTTCTTC	CSKVPQLDTGGSSYNEQFF	TRBV20-1	TRBJ2-1
TGCAGCGTTGTCCCCAAAGGACAGGTGGGGACCGGGGAGCTGTTTTTT	CSVVPKGQVGTGELFF	TRBV29-1	TRBJ2-2
TGTGCCAGCAGGTATAGTGCGAGGCCCCGACGGGAGACCCAGTACTTC	CASRYSARPRRETQYF	TRBV7-3	TRBJ2-5
TGTGCCTGGAGTGTAGGAAGGACCCCCGATTCACCCCTCCACTTT	CAWSVGRTPDSPLHF	TRBV30	TRBJ1-6
TGTGCCAGCAGTTGTTTAGCGGCACCCCACTCCTACGAGCAGTACTTC	CASSCLAAPHSYEQYF	TRBV12-4	TRBJ2-7
TGTGCCAGCAGTTTCCCGGTCCCTAGCGGGAATGGAAATGAGCAGTTCTTC	CASSFPVPSGNGNEQFF	TRBV12-4	TRBJ2-1
TGCAGTGCTAGAGATCTAAAACAGGGCAGATACGAGCAGTACTTC	CSARDLKQGRYEQYF	TRBV20-1	TRBJ2-7
TGCAGTGCTAGACCAATCAGGGTAGACTACGAGCAGTACTTC	CSARPIRVDYEQYF	TRBV20-1	TRBJ2-7
TGTGCCAGCAGCCAACCGCGGATTTATAACACCGGGGAGCTGTTTTTT	CASSQPRIYNTGELFF	TRBV7-8	TRBJ2-2
TGTGCCAGCAGTGGCCGGAGATATTCACCCCTCCACTTT	CASSGRRYSPLHF	TRBV27	TRBJ1-6
TGTGCCAGCAGCCAAGGGGACAGGGTTAGGCATGAGCAGTTCTTC	CASSQGDRVRHEQFF	TRBV3-1	TRBJ2-1
TGCAGTGCAAACATAGCGGGATGGGGGGAGCAGTACTTC	CSANIAGWGEQYF	TRBV20-1	TRBJ2-7
TGTGCCAGCAGTCAGCTTGATGAGCAGTTCTTC	CASSQLDEQFF	TRBV6-1	TRBJ2-1
TGTCATTGTAGCCAAGAGACCCAGTACTTC	CHCSQETQYF	TRBV30	TRBJ2-5
TGCGCAGGAACAACCGGGACAGGGTATACTAACTATGGCTACACCTTC	CAGTTGTGYTNYGYTF	TRBV5-1	TRBJ1-2
TGTGCCAGCAGCCATTTCTGTGGGGCCAGGGTCTCTGGAAACACCATATATTTT	CASSHFCGARVSGNTIYF	TRBV7-9	TRBJ1-3
TGTGCCAGTAGCCGGGGCTGTAATGAAAAACTGTTTTTT	CASSRGCNEKLFF	TRBV19	TRBJ1-4
TGTGCCAGCAGCTTACTAAGTTACACCGGGGAGCTGTTTTTT	CASSLLSYTGELFF	TRBV5-8	TRBJ2-2
TGCATAGGACTAGCGGGAGTCAATCAGCCCCAGCATTTT	CIGLAGVNQPQHF	TRBV20-1	TRBJ1-5
TGCGCCAGCAGCTTGATTCAGACATTCAACTATGGCTACACCTTC	CASSLIQTFNYGYTF	TRBV5-1	TRBJ1-2
TGTGCCAGCAGCAAGACGGGGGGGGAAGAGACCCAGTACTTC	CASSKTGGEETQYF	TRBV13	TRBJ2-5
TGTGCCAGCAGTTACTCAGTTTTGAACACTGAAGCTTTCTTT	CASSYSVLNTEAFF	TRBV6-2	TRBJ1-1
TGTGCCACCAGTGATTTCCTCCGCCTAGACAGGGGTAATCAGCCCCAGCATTTT	CATSDFLRLDRGNQPQHF	TRBV24-1	TRBJ1-5
TGTGCCAGCCCCCTCCGGGGGGGAGGCACTGAAGCTTTCTTT	CASPLRGGGTEAFF	TRBV9	TRBJ1-1
TGTGCCAGCAGCGTAGTCGTGAGCGTAACACTCGATGGCTACACCTTC	CASSVVVSVTLDGYTF	TRBV9	TRBJ1-2
TGTGCCAGCAGAACTCCTGGGGGGGGCGAGCAGTACTTC	CASRTPGGGEQYF	TRBV6-4	TRBJ2-7
TGCGCCAGCAGTGACCGGGGCGTGGGGAATCAGCCCCAGCATTTT	CASSDRGVGNQPQHF	TRBV10-2	TRBJ1-5
TGTGCCACCAGAATAACTAGCGGGGGGCAGGGAACGCAGTATTTT	CATRITSGGQGTQYF	TRBV24-1	TRBJ2-3
TGCAGCGTTGCGAGAACTAGCGGGGGATCATCTAGCTCCTACAATGAGCAGTTCTTC	CSVARTSGGSSSSYNEQFF	TRBV29-1	TRBJ2-1
TGTGCCACCAGCAGATCGGACGAGCAGTACTTC	CATSRSDEQYF	TRBV15	TRBJ2-7
TGTGCCAGCAACCTTGTCCACGAGCAGTACTTC	CASNLVHEQYF	TRBV6-4	TRBJ2-7
TGCGCCAGCAGTGACCCCGTAAGACTAGCGGAACTCAATGAGCAGTTCTTC	CASSDPVRLAELNEQFF	TRBV10-1	TRBJ2-1
TGTGCCAGCAGCACGCGCGGGCCCTACGAGCAGTACTTC	CASSTRGPYEQYF	TRBV7-9	TRBJ2-7
TGTGCCAGCAGTTTCGACGTCGGGGCCAACGTCCTGACTTTC	CASSFDVGANVLTF	TRBV12-4	TRBJ2-6
TGTGCCAGCAGCTTGGGACAGGGCCGCGGTAATGAAAAACTGTTTTTT	CASSLGQGRGNEKLFF	TRBV5-6	TRBJ1-4
TGTGCCAGCAGCGTTAGATCAGGGGGGCGTGAAGCTTTCTTT	CASSVRSGGREAFF	TRBV9	TRBJ1-1
TGTGCCAGCAGCGAAGTAACGCTCTTGGCTTTCTTT	CASSEVTLLAFF	TRBV7-3	TRBJ1-1
TGTGCCAGCAGCAGGGCAGGGGGCGGTAATGAAAAACTGTTTTTT	CASSRAGGGNEKLFF	TRBV7-4	TRBJ1-4
TGCAGTGCTAGAGATTGCCCCCGGAGGGAGGGCGAGCAGTACTTC	CSARDCPRREGEQYF	TRBV20-1	TRBJ2-7
TGTGCCAGCAGGTCGGAGACTTCGAATGAGCAGTTCTTC	CASRSETSNEQFF	TRBV6-1	TRBJ2-1
TGTGCCAGCATAGGCTCCACCGGCACAGATACGCAGTATTTT	CASIGSTGTDTQYF	TRBV28	TRBJ2-3
TGTGCCACCAGTGAAGGGACAGGGGGGAACACTGAAGCTTTCTTT	CATSEGTGGNTEAFF	TRBV24-1	TRBJ1-1
TGTGCCAGCAGTGACTCATCCATTCTCTGGGGAGTCGTTGCCTACAATGAGCAGTTCTTC	CASSDSSILWGVVAYNEQFF	TRBV6-4	TRBJ2-1
TGTGCCAGCAGTGATCCGGGGCGCAACACCGGGGAGCTGTTTTTT	CASSDPGRNTGELFF	TRBV6-4	TRBJ2-2
TGCGCCAGCAGCCAAGATCCGACTAGGGGTCCCTACGAGCAGTACTTC	CASSQDPTRGPYEQYF	TRBV4-1	TRBJ2-7
TGTGCCAGCAGCCCACCTAGGGCAGATACGCAGTATTTT	CASSPPRADTQYF	TRBV13	TRBJ2-3
TGTGCCAGCAGCCTCAGCGGTGTCTTC	CASSLSGVF	TRBV7-6	TRBJ2-1
TGTGCCAGCAGCCGAGGGGTATCTAACTATGGCTACACCTTC	CASSRGVSNYGYTF	TRBV7-3	TRBJ1-2
TGCGCCAGCAGCCAAGAGAATAGACAGGTCCCAGTTGAGACCCAGTACTTC	CASSQENRQVPVETQYF	TRBV4-1	TRBJ2-5
TGTGCCAGCAGTGAGGAGCGACTAGCGGGGGGGACCAGGTCCTACAATGAGCAGTTCTTC	CASSEERLAGGTRSYNEQFF	TRBV6-5	TRBJ2-1
TGTGCCAGCAGCCGGGACGCCTACGAGCAGTACTTC	CASSRDAYEQYF	TRBV27	TRBJ2-7
TGTGCCAGCAGACGAGGCAGTATACGAAATGAAAAACTGTTTTTT	CASRRGSIRNEKLFF	TRBV7-2	TRBJ1-4
TGCAGTGCAGGAAGGGGGAACACAGATACGCAGTATTTT	CSAGRGNTDTQYF	TRBV20-1	TRBJ2-3
TGTGCCAGCAGCGTAGAGGGAGGGAAGGCGATACTCGGTCTAGCCTACGAGCAGTACTTC	CASSVEGGKAILGLAYEQYF	TRBV9	TRBJ2-7
TGTGCCAGCAGCTTAAATCTAGCCTACGAGCAGTACTTC	CASSLNLAYEQYF	TRBV7-9	TRBJ2-7
TGCGCCAGCCGAGGGGAGGGCTCCTACAATGAGCAGTTCTTC	CASRGEGSYNEQFF	TRBV4-1	TRBJ2-1
TGTGCCACAATAGAGACACTAGCCAAAAACATTCAGTACTTC	CATIETLAKNIQYF	TRBV6-5	TRBJ2-4
TGTGCCAGCAGCCCGGCCCAGACTAGGTTCACAGATACGCAGTATTTT	CASSPAQTRFTDTQYF	TRBV5-8	TRBJ2-3
TGTGCCACCAGTGATTTACAGGCTAATGAAAAACTGTTTTTT	CATSDLQANEKLFF	TRBV24-1	TRBJ1-4
TGTGCCAGCAGTTCCGACGAGAGCCTGTACGAGCAGTACTTC	CASSSDESLYEQYF	TRBV6-5	TRBJ2-7
TGTGCCAGCAGCGGTCTAGTAAGTCAGCCCCAGCATTTT	CASSGLVSQPQHF	TRBV7-4	TRBJ1-5
TGTGCCAGCAGCAATTTGAGGGTGGAAGAAAGGAACACTGAAGCTTTCTTT	CASSNLRVEERNTEAFF	TRBV5-6	TRBJ1-1
TGCGCCAGCAGTCCTAGGGGGCCAGATACGCAGTATTTT	CASSPRGPDTQYF	TRBV5-1	TRBJ2-3
TGCGCCAGCGTCGGACAGGGAGGAAGCAATCAGCCCCAGCATTTT	CASVGQGGSNQPQHF	TRBV10-2	TRBJ1-5
TGTGCCAGCAGCCTGATAAAGTCGGCTAGACATTGTGAAAAACTGTTTTTT	CASSLIKSARHCEKLFF	TRBV3-1	TRBJ1-4
TGTGCCAGCAGGGTTGTCGGCAGCTACGAGCAGTACTTC	CASRVVGSYEQYF	TRBV6-4	TRBJ2-7
TGTGCCAGCAGTGGCTACAGGGCGGGGAGGAGTTCACCCCTCCACTTT	CASSGYRAGRSSPLHF	TRBV25-1	TRBJ1-6
TGTGCCAGTAGTAACCTTCAGTTCGACACTGAAGCTTTCTTT	CASSNLQFDTEAFF	TRBV19	TRBJ1-1
TGCGCCAGCAGCTCTTGGGATAGGGGAGGAACCGGGGAGCTGTTTTTT	CASSSWDRGGTGELFF	TRBV5-1	TRBJ2-2
TGTGCCAGCAGCCCCTCCTACAATGAGCAGTTCTTC	CASSPSYNEQFF	TRBV7-8	TRBJ2-1
TGCAGTGCAGTAGCTCGAAACACCATATATTTT	CSAVARNTIYF	TRBV20-1	TRBJ1-3
TGTGCCAGCTACGGGACAGGGGGCTTTTTGTTTAACTATGGCTACACCTTC	CASYGTGGFLFNYGYTF	TRBV27	TRBJ1-2
TGTGCCAGGGTCTTTGGGGGGGCCGAGCAGTACTTC	CARVFGGAEQYF	TRBV6-6	TRBJ2-7
TGTGCCAGCAGCAAACCTTGGGGGGGTGACCGCACAGATACGCAGTATTTT	CASSKPWGGDRTDTQYF	TRBV7-9	TRBJ2-3
TGTGCCAGCAGCTTCCGCTCACTACAGGGGAATGAAAAACTGTTTTTT	CASSFRSLQGNEKLFF	TRBV5-8	TRBJ1-4
TGTGCCAGCAAAAATTCCGGGACAGGGGGCAGTTGGGATGGCTACACCTTC	CASKNSGTGGSWDGYTF	TRBV7-4	TRBJ1-2
TGTGCCAGCTCACGGATGAACAGAGGGATTGATACGCAGTATTTT	CASSRMNRGIDTQYF	TRBV18	TRBJ2-3
TGCGCCAGCAGCTGCTCGGGGCAGGGTGGCACAGATACGCAGTATTTT	CASSCSGQGGTDTQYF	TRBV5-1	TRBJ2-3
TGTGCCAGCAGCCGACGGGGTGAAGCTTTCTTT	CASSRRGEAFF	TRBV7-3	TRBJ1-1
TGTGCCAGCAGACCCGCAGGGACGGCTCCTAACTATGGCTACACCTTC	CASRPAGTAPNYGYTF	TRBV3-1	TRBJ1-2
TGTGCCAGCAGCCGAACGGACAGGGTCACTTATGGCTACACCTTC	CASSRTDRVTYGYTF	TRBV14	TRBJ1-2
TGTGCCAGCAGCTTAGAAATTGAATTGGGGGGTATGGCCCGTAGCATTTGGAATCAGCCCCAGCATTTT	CASSLEIELGGMARSIWNQPQHF	TRBV11-3	TRBJ1-5
TGTGCCAGCACGGCCGGTGGACCCCGGAACTATGGCTACACCTTC	CASTAGGPRNYGYTF	TRBV12-3	TRBJ1-2
TGTGCCAGCAGCTTAAGGATGTGGGACAGGGAAGGCCAAACGATGTATGGCTACACCTTC	CASSLRMWDREGQTMYGYTF	TRBV7-9	TRBJ1-2
TGTGCCAGCAGCCAAGATCCACTCCCCCCGGGACAGGGGTCACGCACAGATACGCAGTATTTT	CASSQDPLPPGQGSRTDTQYF	TRBV3-1	TRBJ2-3
TGCGCCAGCAGCACGAACCGACTGGTTTCTGAAGCTTTCTTT	CASSTNRLVSEAFF	TRBV4-1	TRBJ1-1
TGCGCCAGCAGTGAGTTAATTCAGAATGAAAAACTGTTTTTT	CASSELIQNEKLFF	TRBV10-1	TRBJ1-4
TGTGCCAGCAGGGACAGCAATCAGCCCCAGCATTTT	CASRDSNQPQHF	TRBV6-8	TRBJ1-5
TGTGCCAGCAGTGCGGGAGGGCCGGAGACCCAGTACTTC	CASSAGGPETQYF	TRBV6-1	TRBJ2-5
TGTGCCAGCAGTGTTCGATTGGAGACCCAGTACTTC	CASSVRLETQYF	TRBV12-3	TRBJ2-5
TGTGCCAGCACGGGCAGGGGGCCTGGGAACACTGAAGCTTTCTTT	CASTGRGPGNTEAFF	TRBV27	TRBJ1-1
TGTGCCACCAGTGATCCTGGGGATTTTTATGGCTACACCTTC	CATSDPGDFYGYTF	TRBV24-1	TRBJ1-2
TGTGCCAGCACTTGGGTAGGGCTTTATACTTCTGGGGCCAACGTCCTGACTTTC	CASTWVGLYTSGANVLTF	TRBV6-1	TRBJ2-6
TGTGCCAGCAGTTTCAAGAGGGGTCCTGAAGCTTTCTTT	CASSFKRGPEAFF	TRBV27	TRBJ1-1
TGTGCCAGCAGCTTACCTCCCGGGACACTAAAGTTCCTTTTCTCTGGAAACACCATATATTTT	CASSLPPGTLKFLFSGNTIYF	TRBV7-9	TRBJ1-3
TGTGCCAGCAGGAGAGGAGGCTCTCTGAACACTGAAGCTTTCTTT	CASRRGGSLNTEAFF	TRBV7-4	TRBJ1-1
TGTGCCACCAGCAGAGGGACCGAGAGGGGACAGAGCTCCTATAATTCACCCCTCCACTTT	CATSRGTERGQSSYNSPLHF	TRBV15	TRBJ1-6
TGTGCCAGCAGCGTAGAAACGGACAGGGACCATCAGCCCCAGCATTTT	CASSVETDRDHQPQHF	TRBV9	TRBJ1-5
TGTGCCAGCAGCCACAACGGACGAGGGCTAGGGCGCGAGCAGTACTTC	CASSHNGRGLGREQYF	TRBV4-2	TRBJ2-7
TGTGCCAGCAGCCAAGACGGAAATCCCCCAGACAGTTCACAGCCCCAGCATTTT	CASSQDGNPPDSSQPQHF	TRBV3-1	TRBJ1-5
TGTGCCAGCAGCTTACTAGGTGGGGGGCCCAACACCGGGGAGCTGTTTTTT	CASSLLGGGPNTGELFF	TRBV11-3	TRBJ2-2
TGCGCCAGCAGGGGGGAGGGAGAGACCCAGTACTTC	CASRGEGETQYF	TRBV10-1	TRBJ2-5
TGTGCCAGCAGTGGAGGGCCCGACAGGGGGCGAACTGAAGCTTTCTTT	CASSGGPDRGRTEAFF	TRBV27	TRBJ1-1
TGTGCCAGCAGCGAGTCGGGGACTAGGGAAAGCTGCACAGATACGCAGTATTTT	CASSESGTRESCTDTQYF	TRBV5-6	TRBJ2-3
TGTGCCAGCAGGAAGGTGAGGTCCTTTGACAATGAGCAGTTCTTC	CASRKVRSFDNEQFF	TRBV12-4	TRBJ2-1
TGTGCCAGCAGCTTAATGTGCCATATTGATGACAGGACCTCTGGAAACACCATATATTTT	CASSLMCHIDDRTSGNTIYF	TRBV7-3	TRBJ1-3
TGTGCCACCAGCAGTACTAGAAGATTCGCCTACGAGCAGTACTTC	CATSSTRRFAYEQYF	TRBV15	TRBJ2-7
TGTGCCAGCATTGCGGGACCGCGGAGCACAGATACGCAGTATTTT	CASIAGPRSTDTQYF	TRBV27	TRBJ2-3
TGTGCCAGCAGTGCAGCTACAGGGTTCCCGCAGTACTTC	CASSAATGFPQYF	TRBV6-5	TRBJ2-7
TGTGCCAGCGGGGTTACCGGGGAGCTGTTTTTT	CASGVTGELFF	TRBV18	TRBJ2-2
TGCAGCGTTGAACCACCCCTCCGGCGGGAGGGAAAGGAGGGGTTTACGCTATCACCCCTCCACTTT	CSVEPPLRREGKEGFTLSPLHF	TRBV29-1	TRBJ1-6
TGTGCAACGACAGAGGACACTGAAGCTTTCTTT	CATTEDTEAFF	TRBV7-7	TRBJ1-1
TGTGCCAGCAGCTCAGACGGCCGCACTGAAGCTTTCTTT	CASSSDGRTEAFF	TRBV7-3	TRBJ1-1
TGTGCCAGCAGCTTACCCGATGACCGGGACAGTCCCAGCCCCACCGGGGAGCTGTTTTTT	CASSLPDDRDSPSPTGELFF	TRBV7-3	TRBJ2-2
TGCAGCGTTGACTCCCAGCGGGAGAATAATTCACCCCTCCACTTT	CSVDSQRENNSPLHF	TRBV29-1	TRBJ1-6
TGTGCCACCACGTGGACAGCACACTACGAGCAGTACTTC	CATTWTAHYEQYF	TRBV24-1	TRBJ2-7
TGCGCCAGCAGCCTCACGGTATGGCTTGAGCAGTTCTTC	CASSLTVWLEQFF	TRBV4-3	TRBJ2-1
TGCAGCGCGTTGATTACCAGGGAACCCTATAATTCACCCCTCCACTTT	CSALITREPYNSPLHF	TRBV29-1	TRBJ1-6
TGTGCCAGCATAGACAGGGACGATTCACCCCTCCACTTT	CASIDRDDSPLHF	TRBV6-5	TRBJ1-6
TGTGCCAGCAGGGCGACAGCACGAGGAGAGACCCAGTACTTC	CASRATARGETQYF	TRBV6-5	TRBJ2-5
TGTGCTAGTGAGAGGGGGGGGAGGAGTTGGAAGGGCTACGAGCAGTACTTC	CASERGGRSWKGYEQYF	TRBV12-5	TRBJ2-7
TGCGCCAGCAGCCAAGACCCCGGTCGAAGGAGGGGGGGCCAAGAGACCCAGTACTTC	CASSQDPGRRRGGQETQYF	TRBV4-1	TRBJ2-5
TGTGCCACTCTTCCTCCCGGGACAGGAGAGACCCAGTACTTC	CATLPPGTGETQYF	TRBV24-1	TRBJ2-5
TGTGCCAGCAGCTTAGGGACAGGGGGCCCCTCAGCCTACGAGCAGTACTTC	CASSLGTGGPSAYEQYF	TRBV7-3	TRBJ2-7
TGTGCCAACCGCTCGGGACAGGGGGGGGGCCAAGAGACCCAGTACTTC	CANRSGQGGGQETQYF	TRBV12-4	TRBJ2-5
TGTGCCATCAGTGAAGCTCACGCGCCAAACACTGAAGCTTTCTTT	CAISEAHAPNTEAFF	TRBV10-3	TRBJ1-1
TGTGCCAGCAGCCCTATCTCCTACGAGCAGTACTTC	CASSPISYEQYF	TRBV7-4	TRBJ2-7
TGTGCCGGGACAGGTCAGCCCCAGCATTTT	CAGTGQPQHF	TRBV2	TRBJ1-5
TGTGCCAGCAGTGACCCACCTGGAGACTTCATTGAAAAACTGTTTTTT	CASSDPPGDFIEKLFF	TRBV6-4	TRBJ1-4
TGTGCCAGCAGTTTACCACGGAGTCAGGGGGGTACTGAAGCTTTCTTT	CASSLPRSQGGTEAFF	TRBV27	TRBJ1-1
TGTGCCAGCAGTGGCGAAGGCAGCTCCTACGAGCAGTACTTC	CASSGEGSSYEQYF	TRBV27	TRBJ2-7
TGTGCCAGCAGCCCAAGGGTGGGACAGGGGCGAAGCAATCAGCCCCAGCATTTT	CASSPRVGQGRSNQPQHF	TRBV11-2	TRBJ1-5
TGTGCCAGCAGCTTAATAAACGGGGGTGTCGGGAATGAGCAGTTCTTC	CASSLINGGVGNEQFF	TRBV7-8	TRBJ2-1
TGTGCCACCAGTGATTTCCAACCGACTTCTGGGGCCAACGTCCTGACTTTC	CATSDFQPTSGANVLTF	TRBV24-1	TRBJ2-6
TGCAGTGCTAGAATATTTGGGGGGAGCTCCTACAATGAGCAGTTCTTC	CSARIFGGSSYNEQFF	TRBV20-1	TRBJ2-1
TGTGCCAGCAGCGTAGGGGGGGTGGACTACACTGAAGCTTTCTTT	CASSVGGVDYTEAFF	TRBV5-5	TRBJ1-1
TGTGCCAGCAGCTATCGGCGCAGCGCCTACGAGCAGTACTTC	CASSYRRSAYEQYF	TRBV5-4	TRBJ2-7
TGCGCCAGCAGGTATGACTTGGGACGGGGACGCAATCAGCCCCAGCATTTT	CASRYDLGRGRNQPQHF	TRBV10-1	TRBJ1-5
TGTGCCAGCAGACTCAGGGGTTTAAGATCACCCCTCCACTTT	CASRLRGLRSPLHF	TRBV6-4	TRBJ1-6
TGTGCCATCATGAATCCCCTCAAGACTGGGCCCTACGAGCAGTACTTC	CAIMNPLKTGPYEQYF	TRBV10-3	TRBJ2-7
TGTGCCAGCAGTCATTGCACAGATACGCAGTATTTT	CASSHCTDTQYF	TRBV6-4	TRBJ2-3
TGTGCTAGCAGCTTAACCCCGTGCGGACAGGGAGCACCCCTCCACTTT	CASSLTPCGQGAPLHF	TRBV7-7	TRBJ1-6
TGTGCCAGCAGTTACTCCCCTGGTGATTTAGAGACCCAGTACTTC	CASSYSPGDLETQYF	TRBV6-3	TRBJ2-5
TGTGCTAGTGGTTTGCCGACCAACCCGGGGGAGCTGTTTTTT	CASGLPTNPGELFF	TRBV12-5	TRBJ2-2
TGTGCCATCACGGACCACAATGAGCAGTTCTTC	CAITDHNEQFF	TRBV27	TRBJ2-1
TGTGCCAGCAGTTTTCCGAAGGACTATAGCAATCAGCCCCAGCATTTT	CASSFPKDYSNQPQHF	TRBV12-3	TRBJ1-5
TGCGCCAGCAGCCAAGATTCCCCGTTAGACCGAGGGGCTAACTATGGCTACACCTTC	CASSQDSPLDRGANYGYTF	TRBV4-1	TRBJ1-2
TGTGCCAGCAGTCACTCAAAGGGACAGGCGACAGATACGCAGTATTTT	CASSHSKGQATDTQYF	TRBV6-5	TRBJ2-3
TGTGCCAGCAGCTTGGAGCGCAGGCATGAGCAGTTCTTC	CASSLERRHEQFF	TRBV7-3	TRBJ2-1
TGTGCCAGCAGTGATCACCAAACAAGGGGGAGCCGAGGTGAGACCCAGTACTTC	CASSDHQTRGSRGETQYF	TRBV6-4	TRBJ2-5
TGTGCCAGCACCGGGACCGACTACGAGCAGTACTTC	CASTGTDYEQYF	TRBV6-5	TRBJ2-7
TGTGCCAGCAGCACGGACAGGGCCTCCCATACGCAGTATTTT	CASSTDRASHTQYF	TRBV7-3	TRBJ2-3
TGTGCCAGCAGCCTCTGGACAGGGCGAGAAAAACTGTTTTTT	CASSLWTGREKLFF	TRBV28	TRBJ1-4
TGCAGCAAGAACCGGCCCGGAGAGACCCAGTACTTC	CSKNRPGETQYF	TRBV29-1	TRBJ2-5
TGTGCCAGCGGGAGCGGGACTCCCACGACCCAGTACTTC	CASGSGTPTTQYF	TRBV2	TRBJ2-5
TGTGCCAGCAGAAAAACAGGGTCAAGGACAGGGGGCTTAGAGAACACTGAAGCTTTCTTT	CASRKTGSRTGGLENTEAFF	TRBV9	TRBJ1-1
TGTGCCAGATTAGAGGAGGGACAGGGTCTCCGGATCTCTAAACTGTTTTTT	CARLEEGQGLRISKLFF	TRBV19	TRBJ1-4
TGTGCCCTAATTGGGACAGGGGGCCAACCTCCTGAAGCTTTCTTT	CALIGTGGQPPEAFF	TRBV7-9	TRBJ1-1
TGTGCCAGCAGCGGAAGTAGGGCAGGCTACACCTTC	CASSGSRAGYTF	TRBV9	TRBJ1-2
TGTGCCAGCAGAGACAGGGCCCATACTGAAGCTTTCTTT	CASRDRAHTEAFF	TRBV6-8	TRBJ1-1
TGTGCCAGCAGCTGTGGACTATGTCACACCATATATTTT	CASSCGLCHTIYF	TRBV13	TRBJ1-3
TGTGCCAGCAGTGACGGGGGGCCGCCATCTGGAAACACCATATATTTT	CASSDGGPPSGNTIYF	TRBV6-4	TRBJ1-3
TGCGCCAGCAGCCGAAGCCGACAGGACACTGAAGCTTTCTTT	CASSRSRQDTEAFF	TRBV4-1	TRBJ1-1
TGCAGTGCTAGAGCCGCGACCGGCACTGAAGCTTTCTTT	CSARAATGTEAFF	TRBV20-1	TRBJ1-1
TGTGCCAGCAGCGTAGGTATCCGACCTCTTGAAAAACTGTTTTTT	CASSVGIRPLEKLFF	TRBV9	TRBJ1-4
TGCGCCAGCAGCCTAGGGGGACCCTACGAGCAGTACTTC	CASSLGGPYEQYF	TRBV4-3	TRBJ2-7
TGTGCCACAGAATGTACCGGGACTAGCACCGGGGAGCTGTTTTTT	CATECTGTSTGELFF	TRBV24-1	TRBJ2-2
TGTGCCAGCAGCCCACCCAGGGGACTAAACTCTGGGGCCAACGTCCTGACTTTC	CASSPPRGLNSGANVLTF	TRBV13	TRBJ2-6
TGTGCCAGCAGCCATTTCCAGGGAGTATGCAATCAGCCCCAGCATTTT	CASSHFQGVCNQPQHF	TRBV7-3	TRBJ1-5
TGCGCCAGCAGTACAGGAGGCTATGGCTACACCTTC	CASSTGGYGYTF	TRBV10-1	TRBJ1-2
TGTGCCAGCAGCAATTCCCGCGGACAGTACGAGCAGTACTTC	CASSNSRGQYEQYF	TRBV7-3	TRBJ2-7
TGTGCCAGCAGTAAGGTCAGGGAAGTAGGAGACACTGAAGCTTTCTTT	CASSKVREVGDTEAFF	TRBV2	TRBJ1-1
TGTGCCAGCAGCAGGGAGGATACGCAGTATTTT	CASSREDTQYF	TRBV7-4	TRBJ2-3
TGCAGCGTCACTAGGGTAAGGGGCATGAACACTGAAGCTTTCTTT	CSVTRVRGMNTEAFF	TRBV29-1	TRBJ1-1
TGTGCCACCAGTGATCTAAATGCTTTTCCCCGGGACAGGGGTGAAAAACTGTTTTTT	CATSDLNAFPRDRGEKLFF	TRBV24-1	TRBJ1-4
TGTGCCAGCCGGACAGCCGTGACTGAAGCTTTCTTT	CASRTAVTEAFF	TRBV5-6	TRBJ1-1
TGTGCCAGTAGACTAGCTGCCAATGAGCAGTTCTTC	CASRLAANEQFF	TRBV2	TRBJ2-1
TGTGCCAGCAGCGCCCGGGACAGGGGACCAATAGATCAGCCCCAGCATTTT	CASSARDRGPIDQPQHF	TRBV7-9	TRBJ1-5
TGTGCCACCAGTGATCAACTTGCTAGCGGGGACCGCCCCAATGAGCAGTTCTTC	CATSDQLASGDRPNEQFF	TRBV24-1	TRBJ2-1
TGCGCCAGCAGCCAAGCCCTCAGGGGGACTGAAGCTTTCTTT	CASSQALRGTEAFF	TRBV4-1	TRBJ1-1
TGCAGTGCTAGAGACTCCCCAGGGGACTCCGAGCAGTACTTC	CSARDSPGDSEQYF	TRBV20-1	TRBJ2-7
TGTGCCAGCAGTTACATTGGGGAAGGGGTTAATCAGCCCCAGCATTTT	CASSYIGEGVNQPQHF	TRBV6-5	TRBJ1-5
TGCAGTGCTAGAGCCCATGGGCCCGCAGGGCCAGGTAGCAATCAGCCCCAGCATTTT	CSARAHGPAGPGSNQPQHF	TRBV20-1	TRBJ1-5
TGTGCCAGCAGCCAAGACCTTCTCCAGGGGGTCTATCAGCCCCAGCATTTT	CASSQDLLQGVYQPQHF	TRBV14	TRBJ1-5
TGTGCCAGCAGCAGTTCGGGGCTGGCGGACTACGAGCAGTACTTC	CASSSSGLADYEQYF	TRBV9	TRBJ2-7
TGTGCCAGCAGAGCCACTCCGGGTAGCAATCAGCCCCAGCATTTT	CASRATPGSNQPQHF	TRBV6-5	TRBJ1-5
TGTGCCAGCAGACTTGGCCTAATCACAGGGAATAATCAGCCCCAGCATTTT	CASRLGLITGNNQPQHF	TRBV27	TRBJ1-5
TGTGCCAGCAGTTTAAGGGACACAAACTACGAGCAGTACTTC	CASSLRDTNYEQYF	TRBV27	TRBJ2-7
TGCGCCAGCAGTGAGCCTAGGAGCACAGATACGCAGTATTTT	CASSEPRSTDTQYF	TRBV10-1	TRBJ2-3
TGTGCCAGCAAACTACGGTCTGAAGAGACCCAGTACTTC	CASKLRSEETQYF	TRBV27	TRBJ2-5
TGCGCCAGTAGGGGGCGGTCTCTAAACATTCAGTACTTC	CASRGRSLNIQYF	TRBV4-3	TRBJ2-4
TGTGCCAGCAGTCGTCGCGTGGGAGGGGGGCAGTACTTC	CASSRRVGGGQYF	TRBV27	TRBJ2-7
TGCGCCACTCAGGCCCGTGGGGAAGCTTTCTTT	CATQARGEAFF	TRBV10-1	TRBJ1-1
TGTGCCAGCAGCTTAAGACGGACAGGGTCTGGGGCCAACGTCCTGACTTTC	CASSLRRTGSGANVLTF	TRBV7-6	TRBJ2-6
TGTGCCAGCAGCAAAAGAGATCGAGGGTCCGAGACCCAGTACTTC	CASSKRDRGSETQYF	TRBV7-9	TRBJ2-5
TGTGCCAGCAGCGTGAGCCGGGCATTCGGGGAGCTGTTTTTT	CASSVSRAFGELFF	TRBV11-2	TRBJ2-2
TGTGCCAGCAGTGGCGGTAAGGCGCCTTTATACAATGAGCAGTTCTTC	CASSGGKAPLYNEQFF	TRBV6-1	TRBJ2-1
TGTGCCAGCAGTTTACACCAGAAAGGCTACGAGCAGTACTTC	CASSLHQKGYEQYF	TRBV27	TRBJ2-7
TGTGCCAGCACTAACTGGCTAGCCAAAAACATTCAGTACTTC	CASTNWLAKNIQYF	TRBV27	TRBJ2-4
TGTGCCACCGACGGGGCTAACTACAATGAGCAGTTCTTC	CATDGANYNEQFF	TRBV15	TRBJ2-1
TGCGCCAGCAGCGGGGGGGGGTATGAGCAGTTCTTC	CASSGGGYEQFF	TRBV5-1	TRBJ2-1
TGTGCCAGCAGCCGCACCCCCCAGGGGGTGCAAGAGACCCAGTACTTC	CASSRTPQGVQETQYF	TRBV9	TRBJ2-5
TGTGCCAGTAGTAGGGGGGAATGCAATCAGCCCCAGCATTTT	CASSRGECNQPQHF	TRBV19	TRBJ1-5
TGTGCCAGCAGCGTGCAATCTAGCGGGGGCTCTAGCACAGATACGCAGTATTTT	CASSVQSSGGSSTDTQYF	TRBV9	TRBJ2-3
TGTGCCAGTACCCGTCTTCTGGGCCACACTATTAGCGGGGGCCCCGGGGAGCTGTTTTTT	CASTRLLGHTISGGPGELFF	TRBV19	TRBJ2-2
TGTGCCAGCAGTCTGCAGGGCTCCTACAATGAGCAGTTCTTC	CASSLQGSYNEQFF	TRBV6-5	TRBJ2-1
TGTGCCAGCAGCGAGACCACCAGGCGGACAGGGTCAACCCAGGTAGGACCAGGGTGCGGTGCTTATGGCTACACCTTC	CASSETTRRTGSTQVGPGCGAYGYTF	TRBV7-3	TRBJ1-2
TGTGCCTGGGGCGGTGGGGGACCGGAAAAACTGTTTTTT	CAWGGGGPEKLFF	TRBV30	TRBJ1-4
TGTGCCATCTCCCATCTGAACACCGGGGAGCTGTTTTTT	CAISHLNTGELFF	TRBV10-3	TRBJ2-2
TGTGCCACGGGGGCCGGTAACTATGGCTACACCTTC	CATGAGNYGYTF	TRBV25-1	TRBJ1-2
TGTGCCAGCAGCTTCACGGTTTTGGGTCTAGCGGGGTTCTACAATGAGCAGTTCTTC	CASSFTVLGLAGFYNEQFF	TRBV11-3	TRBJ2-1
TGCGCCAGCAGCTTGGTGATCGGGGTAGAGGCGAACACTGAAGCTTTCTTT	CASSLVIGVEANTEAFF	TRBV5-1	TRBJ1-1
TGCAGTGCTAGAGATGGTATGACAGATACGCAGTATTTT	CSARDGMTDTQYF	TRBV20-1	TRBJ2-3
TGTGCCAGCAGTCCCAAAGTACACCTTTTTGACAGGGGGGTACCCCAGCCCCAGCATTTT	CASSPKVHLFDRGVPQPQHF	TRBV12-3	TRBJ1-5
TGCGCCAGCAGCTATTCGCGGGGGAACGGGTGTCCTGAAAAACTGTTTTTT	CASSYSRGNGCPEKLFF	TRBV5-1	TRBJ1-4
TGTGCCAGCAGCTTAGTAACCGTCGACAGGGGAGGTGGTCATCAGCCCCAGCATTTT	CASSLVTVDRGGGHQPQHF	TRBV7-4	TRBJ1-5
TGTGCCAGCAAGCTTGCCGGGACAGTGGGGATGAACACTGAAGCTTTCTTT	CASKLAGTVGMNTEAFF	TRBV2	TRBJ1-1
TGTGCCAGCAGCGTAGCCGGGCGCACGCAGTATAGCAATCAGCCCCAGCATTTT	CASSVAGRTQYSNQPQHF	TRBV9	TRBJ1-5
TGTGCCAGCAGTCCGGGACCCACATATCTGTATGGCTACACCTTC	CASSPGPTYLYGYTF	TRBV6-1	TRBJ1-2
TGCGCCAGCAGCCAAGGGCAGGGACTGGGTTACGAGCAGTACTTC	CASSQGQGLGYEQYF	TRBV4-1	TRBJ2-7
TGCAGTGCTAGCGCGGAGCGGGAGGGCTACGAGCAGTACTTC	CSASAEREGYEQYF	TRBV20-1	TRBJ2-7
TGCAGTGCTAGCCCAGGTTCTAACTATGGCTACACCTTC	CSASPGSNYGYTF	TRBV20-1	TRBJ1-2
TGTGCCAGCAGCCAATGGGAGACAGGATTGCGGGGCACTGAAGCTTTCTTT	CASSQWETGLRGTEAFF	TRBV3-1	TRBJ1-1
TGTGCCAGCAGCCAGCGACAATATGGCTACACCTTC	CASSQRQYGYTF	TRBV3-1	TRBJ1-2
TGTGCCACCAGCAGAGATTCCTATTCCACCGGGGAGCTGTTTTTT	CATSRDSYSTGELFF	TRBV15	TRBJ2-2
TGTGCCTTGGACGGGACGTGTGGCTGGGGCGGAAAATCTTTTCATAGCAATCAGCCCCAGCATTTT	CALDGTCGWGGKSFHSNQPQHF	TRBV6-5	TRBJ1-5
TGCAGTCCGAGGGTCTCGCTAAATTCACCCCTCCACTTT	CSPRVSLNSPLHF	TRBV20-1	TRBJ1-6
TGTGCCAGCAGCTTAGCGTGGGGGGGCTATGGCTACACCTTC	CASSLAWGGYGYTF	TRBV7-6	TRBJ1-2
TGCGCCATTAAAACTAGCGGGCAAATGGGAGAGACCCAGTACTTC	CAIKTSGQMGETQYF	TRBV10-1	TRBJ2-5
TGCGCCAGCAGCCAGATTTTTTGGGGCTCCCAATACGAGCAGTACTTC	CASSQIFWGSQYEQYF	TRBV10-1	TRBJ2-7
TGCGCCAGCAGTGAAGTCCCTAGAGATGACGAGCAGTACTTC	CASSEVPRDDEQYF	TRBV10-1	TRBJ2-7
TGTGCCAGCAGACCGGTCCGGCCCTCCAGCTACGCTTTCTTT	CASRPVRPSSYAFF	TRBV6-4	TRBJ1-1
TGTGCCAGCAAAAGGGACTGGGGGATAGAGACTAGCACAGATACGCAGTATTTT	CASKRDWGIETSTDTQYF	TRBV3-1	TRBJ2-3
TGTGCCAGTAATCTTCCGGGGACTAGCGGGAGACGTTTCTTC	CASNLPGTSGRRFF	TRBV19	TRBJ2-1
TGTGCCAGCAGCCCAGGGGCTCGACCTGGGGCCAACGTCCTGACTTTC	CASSPGARPGANVLTF	TRBV7-7	TRBJ2-6
TGTGCCAGCAGTTACTCCAGTAATCGGTGGACGTGGCAGCCCCAGCATTTT	CASSYSSNRWTWQPQHF	TRBV6-2	TRBJ1-5
TGCAGTGCTGCGTTCGGAACATTTCTAGAGACCCAGTACTTC	CSAAFGTFLETQYF	TRBV20-1	TRBJ2-5
TGTGCCAGTAGTAACCCGGGACAGAGCCAAGAGACCCAGTACTTC	CASSNPGQSQETQYF	TRBV19	TRBJ2-5
TGCGCCAGCAGCCAGTCAAAAGCGGACAGGGCGCCCGTTTACACTGAAGCTTTCTTT	CASSQSKADRAPVYTEAFF	TRBV4-1	TRBJ1-1
TGTGCCAGCAGCCAAGAGTCGGGGGCCTATTCTTATAGCAATCAGCCCCAGCATTTT	CASSQESGAYSYSNQPQHF	TRBV3-1	TRBJ1-5
TGTGCCAGTAGTATAGGGGGTAGGGTCGGCTACACCTTC	CASSIGGRVGYTF	TRBV19	TRBJ1-2
TGCAGTGCTAGAGATCCAATAGGGGGCAGATACAATGAGCAGTTCTTC	CSARDPIGGRYNEQFF	TRBV20-1	TRBJ2-1
TGCGCCAGCAGCGGTAGCCCTCAGGGGGCCCACTATGGCTACACCTTC	CASSGSPQGAHYGYTF	TRBV5-1	TRBJ1-2
TGTGCCAGCAGTTACGTGGACTACCGCAATCAGCCCCAGCATTTT	CASSYVDYRNQPQHF	TRBV6-6	TRBJ1-5
TGTGCCAGCAGTGAAGGACTGGGGATCCGGGCTCGAGAGAACTATGGCTACACCTTC	CASSEGLGIRARENYGYTF	TRBV2	TRBJ1-2
TGTGCCAGCAGTGTCGGGAGATTACGGGATAGCGGGTTCAACAGGGACGAGCAGTACTTC	CASSVGRLRDSGFNRDEQYF	TRBV6-4	TRBJ2-7
TGCGCCAGCAGCCTCAGGACAGGACCCGAGCAGTACTTC	CASSLRTGPEQYF	TRBV5-1	TRBJ2-7
TGTGCCAGCCTTAGCGGTGCCTACGAGCAGTACTTC	CASLSGAYEQYF	TRBV2	TRBJ2-7
TGTGCCACCAGTCAGTATTCTGGGGCCAACGTCCTGACTTTC	CATSQYSGANVLTF	TRBV24-1	TRBJ2-6
TGCGCCAGCAGCAGATCGATTTTAGGGGGCACAGATACGCAGTATTTT	CASSRSILGGTDTQYF	TRBV5-1	TRBJ2-3
TGTGCCAGCAGGACAGACCAGAACTCCTGTTCTACGCAGTATTTT	CASRTDQNSCSTQYF	TRBV6-5	TRBJ2-3
TGTGCCAGCAGCTTAGCGGACAGACTCAGGAGGAGAGGGAACACCGGGGAGCTGTTTTTT	CASSLADRLRRRGNTGELFF	TRBV11-3	TRBJ2-2
TGCAGTGCTCAGCCGGGGCCGGCCTATAGCAATCAGCCCCAGCATTTT	CSAQPGPAYSNQPQHF	TRBV20-1	TRBJ1-5
TGTGCCAGCAGAGAAGTCCCAAGGGGGGGGGGAATCAGCACAGATACGCAGTATTTT	CASREVPRGGGISTDTQYF	TRBV14	TRBJ2-3
TGTGCCAGCAGCAGACCGGACAGGGTGCATAGCAATCAGCCCCAGCATTTT	CASSRPDRVHSNQPQHF	TRBV9	TRBJ1-5
TGTGCCAGCAGCTTTCTCAAAAAGAGGGAGACCCAGTACTTC	CASSFLKKRETQYF	TRBV5-8	TRBJ2-5
TGTGCCAGCATTCTGGGCAAAGGATCGAACACCGGGGAGCTGTTTTTT	CASILGKGSNTGELFF	TRBV9	TRBJ2-2
TGTGCCAGCAGCTACCCGGGGGCCAAAAACATTCAGTACTTC	CASSYPGAKNIQYF	TRBV7-3	TRBJ2-4
TGTGCCAGTAGGGGTGGGGGACAATGGTACAATGAGCAGTTCTTC	CASRGGGQWYNEQFF	TRBV19	TRBJ2-1
TGTGCCAGAGCTCAGGTGGGATTCGCAATATGCTCCTACGAGCAGTACTTC	CARAQVGFAICSYEQYF	TRBV19	TRBJ2-7
TGTGCCAGCAGTTTCGAAGGGAGGGACTTCGTGTTGCATGGCTACACCTTC	CASSFEGRDFVLHGYTF	TRBV28	TRBJ1-2
TGTGCCAGTACATTCCGTGCGTATGGAACCCAGTACTTC	CASTFRAYGTQYF	TRBV19	TRBJ2-5
TGTGCCAGCAGCGCTCCAGCCGCCCCACAGGGGCACTCCTACAATGAGCAGTTCTTC	CASSAPAAPQGHSYNEQFF	TRBV11-3	TRBJ2-1
TGTGCTAGTGGGACTAGCGGGAGCTCCTACAATGAGCAGTTCTTC	CASGTSGSSYNEQFF	TRBV12-5	TRBJ2-1
TGTGCCAGCAGCCAAGATGAACTAGCGGGAAACACCGGGGAGCTGTTTTTT	CASSQDELAGNTGELFF	TRBV14	TRBJ2-2
TGTGCCAGCATCCTACAAACGGGGCGCACAGATACGCAGTATTTT	CASILQTGRTDTQYF	TRBV6-5	TRBJ2-3
TGTGCTAGCACTGGGACTAGGAGACCGGGGTACGAGCAGTACTTC	CASTGTRRPGYEQYF	TRBV7-7	TRBJ2-7
TGTGCCAGGCGGCACGAAAGCAATCAGCCCCAGCATTTT	CARRHESNQPQHF	TRBV19	TRBJ1-5
TGTGCCAGCAAAAACAAGAGACTAGCGGGGGCGACCGGGGAGCTGTTTTTT	CASKNKRLAGATGELFF	TRBV7-8	TRBJ2-2
TGTGCCAGCAGCTTTGGACAGATGTTCTATAATTCACCCCTCCACTTT	CASSFGQMFYNSPLHF	TRBV7-4	TRBJ1-6
TGTGCCAGCAGCGCGGGGAGCTCCTACAATGAGCAGTTCTTC	CASSAGSSYNEQFF	TRBV6-2	TRBJ2-1
TGTGCCAGCAGTTTAGGAAGGGGACATTCCTCCTACGAGCAGTACTTC	CASSLGRGHSSYEQYF	TRBV12-4	TRBJ2-7
TGTGCCAGCAGTTACGGAAGACAGGGGGCAATCTTC	CASSYGRQGAIF	TRBV6-5	TRBJ2-1
TGTGCCAGCAGCTTAGCACTTGGGACTTCAGTTCGGGATTTGAACACTGAAGCTTTCTTT	CASSLALGTSVRDLNTEAFF	TRBV7-4	TRBJ1-1
TGTGCCAGCGGACTAGCGGGAGCGAACACTGAAGCTTTCTTT	CASGLAGANTEAFF	TRBV18	TRBJ1-1
TGTGCCAGCAGCGGAAAGGGTATGGAAATGAACACCGGGGAGCTGTTTTTT	CASSGKGMEMNTGELFF	TRBV9	TRBJ2-2
TGTGCCAGCTCACTCCGGGACAGGGCACTCAACACTGAAGCTTTCTTT	CASSLRDRALNTEAFF	TRBV11-3	TRBJ1-1
TGTGCCAGCAGTGTGGGACAGGAAAAGGGGGAAGAGACCCAGTACTTC	CASSVGQEKGEETQYF	TRBV6-1	TRBJ2-5
TGCGCCAGCAGCTTGGAGGGACGCTCACATCAGCCCCAGCATTTT	CASSLEGRSHQPQHF	TRBV5-1	TRBJ1-5
TGTGCCAGCAGCTTAGAGGTAGCAAACTACAATGAGCAGTTCTTC	CASSLEVANYNEQFF	TRBV11-3	TRBJ2-1
TGTGCCAGCAACAGGAAACGCCCGCAAGCTTTCTTT	CASNRKRPQAFF	TRBV28	TRBJ1-1
TGCAGCGTTACGGGAGGATTCGAGACCCAGTACTTC	CSVTGGFETQYF	TRBV29-1	TRBJ2-5
TGTGCCATCCCGTTCGGAGCGGTCACAGATACGCAGTATTTT	CAIPFGAVTDTQYF	TRBV6-5	TRBJ2-3
TGTGCCAGCAGTTACTCGTGGGGCCCGGGAGGGTTTGGCTACACCTTC	CASSYSWGPGGFGYTF	TRBV6-8	TRBJ1-2
TGTGCCAGCAGTCGAAAGGGCAGAGCTAACTATGGCTACACCTTC	CASSRKGRANYGYTF	TRBV28	TRBJ1-2
TGTGCCAGCAGCTTAACCGGACATGCAGATACGCAGTATTTT	CASSLTGHADTQYF	TRBV7-2	TRBJ2-3
TGCAGTGCCTGGGCGACCAAAAACATTCAGTACTTC	CSAWATKNIQYF	TRBV20-1	TRBJ2-4
TGTGCCAGCAGTTTTATGACAGGGGAGCAGCCCCAGCATTTT	CASSFMTGEQPQHF	TRBV27	TRBJ1-5
TGTGCCAGCAGTCAACAGACAGGATTTCCGAGCACAGATACGCAGTATTTT	CASSQQTGFPSTDTQYF	TRBV6-5	TRBJ2-3
TGCAGCGTTGCGGGGACAGGTTTGGGCACAGATACGCAGTATTTT	CSVAGTGLGTDTQYF	TRBV29-1	TRBJ2-3
TGTGCCAGCAGCCCGGGACAAGGACACGAGCAGTACTTC	CASSPGQGHEQYF	TRBV13	TRBJ2-7
TGTGCCAGCAGGTTCAATAGCGGGAACCTAGCCAAAAACATTCAGTACTTC	CASRFNSGNLAKNIQYF	TRBV7-8	TRBJ2-4
TGTGCCAGCAGCTTGCTTCTCCGCCTTGGCTACACCTTC	CASSLLLRLGYTF	TRBV5-6	TRBJ1-2
TGTGCCAGCAGCGCGGGGAAGGGTTCTGAAAAACTGTTTTTT	CASSAGKGSEKLFF	TRBV28	TRBJ1-4
TGCGCCAGCAGCTGGCCCTCAAAGGGACTAGCGGATAGCTCCTACAATGAGCAGTTCTTC	CASSWPSKGLADSSYNEQFF	TRBV5-1	TRBJ2-1
TGCGCCAGCAGCCAAGAGCGGACAGGGCCCCTAAGTTCACCCCTCCACTTT	CASSQERTGPLSSPLHF	TRBV4-1	TRBJ1-6
TGTGCCAGCAGCTTAGTTTTGGAACAAAAGGGACACAATGAGCAGTTCTTC	CASSLVLEQKGHNEQFF	TRBV11-2	TRBJ2-1
TGTGCCAGCAGGAGAGGTGGGCAGTTCTTC	CASRRGGQFF	TRBV6-3	TRBJ2-1
TGTGCCATTCGACAGGGGGGGGGGTCATATGGCTACACCTTC	CAIRQGGGSYGYTF	TRBV19	TRBJ1-2
TGTGCCAGCAGAGTGCCAGGGGGGTGGGGCTACACCTTC	CASRVPGGWGYTF	TRBV12-3	TRBJ1-2
TGCGCCAGCAGCCAAGATCGCCAGGGGAGCAACGCGGGGAAACAGCCCCAGCATTTT	CASSQDRQGSNAGKQPQHF	TRBV4-1	TRBJ1-5
TGTGCCAGCAGCCTGCCTTCCGAAGGCGCCCAGGACTATGGCTACACCTTC	CASSLPSEGAQDYGYTF	TRBV4-2	TRBJ1-2
TGTGCCAGCATCAGGGCCCGGGATAATTCACCCCTCCACTTT	CASIRARDNSPLHF	TRBV6-8	TRBJ1-6
TGTGCCATCCCCAGCTTGACAGGGATTTCTGGAAACACCATATATTTT	CAIPSLTGISGNTIYF	TRBV7-9	TRBJ1-3
TGTGCCAGCAGCTTAACGCCTACCCCTTTAATCATAAATTCGGGGGCCCCCTACGAGCAGTACTTC	CASSLTPTPLIINSGAPYEQYF	TRBV7-3	TRBJ2-7
TGTGCCAGCAGCACACGGGGGTGGTTTCAGACTGAAGCTTTCTTT	CASSTRGWFQTEAFF	TRBV7-6	TRBJ1-1
TGCAGTGCTAGTTTCCTGGGGGGATGGTTAACTGCCACAGATACGCAGTATTTT	CSASFLGGWLTATDTQYF	TRBV20-1	TRBJ2-3
TGTGCCAGCAGCCTTCTAAAAAGCCAGCATGGAAACACCATATATTTT	CASSLLKSQHGNTIYF	TRBV7-9	TRBJ1-3
TGTGCCAAAGACGGGACAGGCACCTACGAGCAGTACTTC	CAKDGTGTYEQYF	TRBV6-1	TRBJ2-7
TGTGCCAGCAGTGAATATTTACGGGCAGGTGGGAATGAAAAACTGTTTTTT	CASSEYLRAGGNEKLFF	TRBV25-1	TRBJ1-4
TGTGCCAGCAGCCCGGCCGGGACAGGGGAGATCGTTACTAACACTGAAGCTTTCTTT	CASSPAGTGEIVTNTEAFF	TRBV27	TRBJ1-1
TGTGCCAGCAGTCTCAGAAAATCAGGGAGTTCTTTCTACGGCACTGAAGCTTTCTTT	CASSLRKSGSSFYGTEAFF	TRBV12-4	TRBJ1-1
TGCAGCGTTGACTGGGACAAGAAGTACTTC	CSVDWDKKYF	TRBV29-1	TRBJ2-5
TGTGCCAGCAAACTAAAACTGTTTTTT	CASKLKLFF	TRBV6-2	TRBJ1-4
TGTGCCAGCAGCCCGCGGGAGAAACCAGCGGAGATCGTCTACGAGCAGTACTTC	CASSPREKPAEIVYEQYF	TRBV14	TRBJ2-7
TGTGCCACCAGTGGACAGGGAGGAAACACTGAAGCTTTCTTT	CATSGQGGNTEAFF	TRBV24-1	TRBJ1-1
TGTGCCAGCAGCCCCTCAAACACCGGGGAGCTGTTTTTT	CASSPSNTGELFF	TRBV2	TRBJ2-2
TGTGCCAGCAGCTTAAGATTAGCGGGATTTGGTCCGACCCAGTACTTC	CASSLRLAGFGPTQYF	TRBV11-3	TRBJ2-5
TGTGCCAGCAGAGCACCCCCGACAGGGGGCTCATGTCGAGCAACCTTGCCCCAGCATTTT	CASRAPPTGGSCRATLPQHF	TRBV6-3	TRBJ1-5
TGCGCCAGCAGCCGTTTCGCGGGACTAGCGGGATTCGGCACAGATACGCAGTATTTT	CASSRFAGLAGFGTDTQYF	TRBV4-1	TRBJ2-3
TGTGCCAGCAGCTTAGCGTGCTATGCTCAGACAGGGAATAATACCAATCAGCCCCAGCATTTT	CASSLACYAQTGNNTNQPQHF	TRBV11-2	TRBJ1-5
TGCGCCAGCAGTCATTCCGACGGCGGGGGGTATAATTCACCCCTCCACTTT	CASSHSDGGGYNSPLHF	TRBV5-1	TRBJ1-6
TGTGCCAGCAGCAGGGGCTTGAAAGGCAGAGAGACCCAGTACTTC	CASSRGLKGRETQYF	TRBV13	TRBJ2-5
TGTGCCATTAGTAAGATTTTTAAACCCTACAATGAGCAGTTCTTC	CAISKIFKPYNEQFF	TRBV7-3	TRBJ2-1
TGTGCCAGCAGTGAACTCCGGGGAGTCCCACTCCGGAGAGCCAAAAACATTCAGTACTTC	CASSELRGVPLRRAKNIQYF	TRBV6-4	TRBJ2-4
TGCAGCGTTGAAGACAGCGGGGGACAGGGCTACACCTTC	CSVEDSGGQGYTF	TRBV29-1	TRBJ1-2
TGTGCCAGCGGGACAGGGTTTCGGAACTATGGCTACACCTTC	CASGTGFRNYGYTF	TRBV27	TRBJ1-2
TGCGCCAGCAGCCCAGGAGCTAACTATGGCTACACCTTC	CASSPGANYGYTF	TRBV4-1	TRBJ1-2
TGTGCCAGCAGCATTTTTCCACCCAGGATGGGGGAGGTGAGCGAGCAGTACTTC	CASSIFPPRMGEVSEQYF	TRBV7-3	TRBJ2-7
TGTGCCACCAGTGATTTTAAAGGGACTCAGCCCCAGCATTTT	CATSDFKGTQPQHF	TRBV24-1	TRBJ1-5
TGTGCCAGCACACCGGGGGAGGTGGGGCCCCAGCATTTT	CASTPGEVGPQHF	TRBV27	TRBJ1-5
TGTGCCAGCAGCTCTTCTTGGGAGGGCCTGAACACTGAAGCTTTCTTT	CASSSSWEGLNTEAFF	TRBV9	TRBJ1-1
TGCAGTGCTAGGCTCTTTTTCCGGGACAGCCGACTCTACGAGCAGTACTTC	CSARLFFRDSRLYEQYF	TRBV20-1	TRBJ2-7
TGTGCCAGCAGCGGGAACCCGGGCGCGAAAGCTTTCTTT	CASSGNPGAKAFF	TRBV9	TRBJ1-1
TGTGCCATCAGTGAGGCCAGGGTAATGGGAAACACCATATATTTT	CAISEARVMGNTIYF	TRBV10-3	TRBJ1-3
TGTGCCAGCAGCAACCTCGGGACAGGGGGCGGGAACACCGGGGAGCTGTTTTTT	CASSNLGTGGGNTGELFF	TRBV7-3	TRBJ2-2
TGTGCCAGCCGAAGCTGTAACACCGGGGAGCTGTTTTTT	CASRSCNTGELFF	TRBV6-5	TRBJ2-2
TGTGCCATCAGTGATAGGGACAGGAAAGAGCAGTTCTTC	CAISDRDRKEQFF	TRBV10-3	TRBJ2-1
TGCAGTGCTTCCTCCCGCGGGAGCAGGGAGCAGTACTTC	CSASSRGSREQYF	TRBV20-1	TRBJ2-7
TGTGCCAGCAGTGTAAGAGGACACACCATATATTTT	CASSVRGHTIYF	TRBV2	TRBJ1-3
TGCAGTGCTAGCCGGACAATGGGTCATGAGCAGTTCTTC	CSASRTMGHEQFF	TRBV20-1	TRBJ2-1
TGTGCCAGCAGCCCGAATCAAATAAACGAGCAGTACTTC	CASSPNQINEQYF	TRBV14	TRBJ2-7
TGTGCCAGCAGCTTATCCGGGACTTTCTCCTACAATGAGCAGTTCTTC	CASSLSGTFSYNEQFF	TRBV11-3	TRBJ2-1
TGTGCCAGCAGCTCCGGGGGGGCCTACCAAGAGACCCAGTACTTC	CASSSGGAYQETQYF	TRBV13	TRBJ2-5
TGTGCCAGCAGCCATCCCCCTAGACCCCGCACAGATACGCAGTATTTT	CASSHPPRPRTDTQYF	TRBV14	TRBJ2-3
TGTGCCTGGAGTGTGGTCAAGATCTATGGCTACACCTTC	CAWSVVKIYGYTF	TRBV30	TRBJ1-2
TGTGCCAGCAGCTTTCGCAGGACTTCCTCTGGGGCCAACGTCCTGACTTTC	CASSFRRTSSGANVLTF	TRBV7-2	TRBJ2-6
TGTGCCAGCAGCGTAACCGTTGTGAGTAATGAGCAGTTCTTC	CASSVTVVSNEQFF	TRBV9	TRBJ2-1
TGTGCCTGGAGTGCTGGAGACAGGGGCAGGGCAACTAATGAAAAACTGTTTTTT	CAWSAGDRGRATNEKLFF	TRBV30	TRBJ1-4
TGTGCCAGTAGCCCAGCGGCCGTTGGGAGCGGCACAGATACGCAGTATTTT	CASSPAAVGSGTDTQYF	TRBV19	TRBJ2-3
TGTGCCAGCGGGCACATGAACACTGAAGCTTTCTTT	CASGHMNTEAFF	TRBV9	TRBJ1-1
TGTGCCAGCAGCGACGTTAACAGGGGGCAGGAAGAGACCCAGTACTTC	CASSDVNRGQEETQYF	TRBV13	TRBJ2-5
TGTGCCAGCAGCGAGGGTGCTAAGCAGTACTTC	CASSEGAKQYF	TRBV9	TRBJ2-7
TGTGCCAGCAGCTTAGACACAGCCGTAGGACCGAACACCGGGGAGCTGTTTTTT	CASSLDTAVGPNTGELFF	TRBV11-2	TRBJ2-2
TGTGCCAGCAGTTGGGGGGGTTTTTATGGCTACACCTTC	CASSWGGFYGYTF	TRBV27	TRBJ1-2
TGTGCCATCAGTCCGCCCGCTGTGATTTGCTCGGGCAATGAGCAGTTCTTC	CAISPPAVICSGNEQFF	TRBV10-3	TRBJ2-1
TGTGCCAGCAGCCCAAGGTTTCTAGCGGGGAGGCAGTACTTC	CASSPRFLAGRQYF	TRBV7-9	TRBJ2-5
TGTGCCAGCAGTTTTCCCGGAGAGCAGTACTTC	CASSFPGEQYF	TRBV6-2	TRBJ2-7
TGCGCCAGCCCGGGACAGGGTTACGGCAATCAGCCCCAGCATTTT	CASPGQGYGNQPQHF	TRBV5-1	TRBJ1-5
TGTGCCAGCAGTGAAGCAGGGGGCGTTCGAAGCAATCAGCCCCAGCATTTT	CASSEAGGVRSNQPQHF	TRBV6-1	TRBJ1-5
TGCGCCAGCAGCTCATGGGACAGGGCGAGCTCTGGAAACACCATATATTTT	CASSSWDRASSGNTIYF	TRBV5-1	TRBJ1-3
TGTGGTAGCGGGATAGGAAGGTACAATGAGCAGTTCTTC	CGSGIGRYNEQFF	TRBV6-6	TRBJ2-1
TGTGCCAGCAGCTTAGCACCACCCGGGAGCAATCAGCCCCAGCATTTT	CASSLAPPGSNQPQHF	TRBV7-8	TRBJ1-5
TGCGCCAGCAGCTCCGTGGGGGGGGCCAGTCCCATCTTC	CASSSVGGASPIF	TRBV5-1	TRBJ2-1
TGTGCCAAGGGGACAGGGGGCAGGGCCTCCTACGAGCAGTACTTC	CAKGTGGRASYEQYF	TRBV6-4	TRBJ2-7
TGTGCCACCAGCAGAATCAAAAGGGCGCGGCACGAGTCGGACACTGAAGCTTTCTTT	CATSRIKRARHESDTEAFF	TRBV24-1	TRBJ1-1
TGTGCCATCAGTGAGTTCCGGCCGGGGGCTGGGGCTGGAAACACCATATATTTT	CAISEFRPGAGAGNTIYF	TRBV10-3	TRBJ1-3
TGTGCCAGCAGGGTCAAACTGTGGATTCCCGGGACAGTAAAGCCCCAGCATTTT	CASRVKLWIPGTVKPQHF	TRBV12-3	TRBJ1-5
TGTGCCAGCTCACCTCGGACAGGGTCTCATGGCTACACCTTC	CASSPRTGSHGYTF	TRBV18	TRBJ1-2
TGTGCCAGCTCACCTGAGGGGGGCGAAAAGTCCTACAATGAGCAGTTCTTC	CASSPEGGEKSYNEQFF	TRBV18	TRBJ2-1
TGCGCCAGCAGCGTCGATAACACCATTGCAACTAATGAAAAACTGTTTTTT	CASSVDNTIATNEKLFF	TRBV5-1	TRBJ1-4
TGTGCCAGCAGTTTAAGGTTCGGACAGGGCCCCGCTACCTACGAGCAGTACTTC	CASSLRFGQGPATYEQYF	TRBV28	TRBJ2-7
TGTGCCAGCACGGCTATCTCTCCGGGACAGGGGAGCTCTGGAAACACCATATATTTT	CASTAISPGQGSSGNTIYF	TRBV6-6	TRBJ1-3
TGTGCCAAAGATCCTAGCGTACCCTCCTACAATGAGCAGTTCTTC	CAKDPSVPSYNEQFF	TRBV12-3	TRBJ2-1
TGTGCCATCAGTGAGGAAGTTTCCGACGCAGGGGGAAACCGCAACTCTGGAAACACCATATATTTT	CAISEEVSDAGGNRNSGNTIYF	TRBV10-3	TRBJ1-3
TGTGCCAGCAGCGGGAGGGGACCGAACACTGAAGCTTTCTTT	CASSGRGPNTEAFF	TRBV6-4	TRBJ1-1
TGTGCCAGCAGTAAAGAGGGAAAGTATGGCTACACCTTC	CASSKEGKYGYTF	TRBV6-2	TRBJ1-2
TGTGCCAGCAGTGAAGCGGTCAGTCGGGACCTTAATGAGCAGTTCTTC	CASSEAVSRDLNEQFF	TRBV6-1	TRBJ2-1
TGTGCCAGCAGTCTCGGGACGGACGGCTACGAGCAGTACTTC	CASSLGTDGYEQYF	TRBV6-1	TRBJ2-7
TGTGCCAGCAGTGACCAGACTTCCACAGATACGCAGTATTTT	CASSDQTSTDTQYF	TRBV25-1	TRBJ2-3
TGTGCCAGCAGCGTCCCCCTAGCGGGGACCTACGAGCAGTACTTC	CASSVPLAGTYEQYF	TRBV5-4	TRBJ2-7
TGTGCCAGCAGCCCTAGCGGGAGCTCCTACAATGAGCAGTTCTTC	CASSPSGSSYNEQFF	TRBV4-2	TRBJ2-1
TGTGCCACCGAAAAGAGGGGCTCAGATACGCAGTATTTT	CATEKRGSDTQYF	TRBV6-1	TRBJ2-3
TGTGCCAGCAGCAGGAGCGATCGCACAGATACGCAGTATTTT	CASSRSDRTDTQYF	TRBV7-3	TRBJ2-3
TGTGCCAGCAGCCCCCGGGGCTTCCCAGATACGCAGTATTTT	CASSPRGFPDTQYF	TRBV5-6	TRBJ2-3
TGTGCCAGCAGGAAGAGAGACAAAGGAGGTGAAAAACTGTTTTTT	CASRKRDKGGEKLFF	TRBV6-6	TRBJ1-4
TGTGCCAGCAGTTTATCGCTAATCTCCGGGCGTTACGAGCAGTACTTC	CASSLSLISGRYEQYF	TRBV28	TRBJ2-7
TGCAGTGCTTTAGGGGACTTGCGCGAGCAGTACTTC	CSALGDLREQYF	TRBV20-1	TRBJ2-7
TGTGCCAGCAGTTTGGGGGGGGCCATCTGGGAGACCCAGTACTTC	CASSLGGAIWETQYF	TRBV27	TRBJ2-5
TGTGCCAGCAGCTGCCGGGACAGAAGTAACGAAGCTTTCTTT	CASSCRDRSNEAFF	TRBV7-6	TRBJ1-1
TGTGCCAGCAGTCCGGGGACTGAAGCTTTCTTT	CASSPGTEAFF	TRBV2	TRBJ1-1
TGCAGTGCTAGAGAACCAGGGCTCGGTGGTTACGAGCAGTACTTC	CSAREPGLGGYEQYF	TRBV20-1	TRBJ2-7
TGCGCCAGCCATGGACAGTCTCAGCCCCAGCATTTT	CASHGQSQPQHF	TRBV10-2	TRBJ1-5
TGCGCCAGCAGCTGGAGGGGAGTGAACACTGAAGCTTTCTTT	CASSWRGVNTEAFF	TRBV5-1	TRBJ1-1
TGTGCCAGCAGTTACGTAGGATACTTGAATACAGCTTTCTTT	CASSYVGYLNTAFF	TRBV6-5	TRBJ1-1
TGCAGTGCTAGTCGTAATTTTGACAGGGCCTACGAGCAGTACTTC	CSASRNFDRAYEQYF	TRBV20-1	TRBJ2-7
TGTGCCAGCAGCTCACCCCTCGGACGAGGCCAGTACTTC	CASSSPLGRGQYF	TRBV7-9	TRBJ2-5
TGTGCCAGCAGCCCTCCCGAAAAACTAGCGGTGCACTCCTACGAGCAGTACTTC	CASSPPEKLAVHSYEQYF	TRBV5-6	TRBJ2-7
TGTGCCAGCAGCCGGGGGCATCAGCCCCAGCATTTT	CASSRGHQPQHF	TRBV7-9	TRBJ1-5
TGCAGCGTTGGACAGCAGCATCAGCCCCAGCATTTT	CSVGQQHQPQHF	TRBV29-1	TRBJ1-5
TGTGCCAGCAGCACCCAGGGCCCCCAAGAGACCCAGTACTTC	CASSTQGPQETQYF	TRBV5-4	TRBJ2-5
TGTGCCAGCAGCGCCAACGGGACAGGGTATGGCTACACCTTC	CASSANGTGYGYTF	TRBV6-4	TRBJ1-2
TGTGCCACCAGCAGATCCGTTACTACTGATATGAACACTGAAGCTTTCTTT	CATSRSVTTDMNTEAFF	TRBV15	TRBJ1-1
TGTGCCAGCAGCCGGACAGGCCAGAAGGAAAGCTATGGCTACACCTTC	CASSRTGQKESYGYTF	TRBV14	TRBJ1-2
TGTGCCAGCAGCCGCAGGGGGGGCCCTGAGCAGTTCTTC	CASSRRGGPEQFF	TRBV7-9	TRBJ2-1
TGCGCCAGCAGCTTGAGGGGGAGGGGCGCCGGGCCCCTCCACTTT	CASSLRGRGAGPLHF	TRBV5-1	TRBJ1-6
TGCGCCAGCAGCCGGCCGGGACTTAGTCCGAACACTGAAGCTTTCTTT	CASSRPGLSPNTEAFF	TRBV4-1	TRBJ1-1
TGTGCCAGCAAACCGGGACAGGGGTACCAAGAGACCCAGTACTTC	CASKPGQGYQETQYF	TRBV9	TRBJ2-5
TGTGCCAGCAGCGCCACACCAGTGAGAGGACACTATGGCTACACCTTC	CASSATPVRGHYGYTF	TRBV7-3	TRBJ1-2
TGTGCCAGCAGTTTTATTTGCGGGAGCGAGCAGTACTTC	CASSFICGSEQYF	TRBV12-3	TRBJ2-7
TGTGCCAGCAGCGCCTCTACCACCAATGAGCAGTTCTTC	CASSASTTNEQFF	TRBV27	TRBJ2-1
TGCGCCAGCCACTCGTTGAGGGTTATCTACGAGCAGTACTTC	CASHSLRVIYEQYF	TRBV10-1	TRBJ2-7
TGCAGTGCCTCAGGAAACTCCTATAATTCACCCCTCCACTTT	CSASGNSYNSPLHF	TRBV20-1	TRBJ1-6
TGTGCCAGCAGTTCTAGCCAGGAGGGCAATCAGCCCCAGCATTTT	CASSSSQEGNQPQHF	TRBV27	TRBJ1-5
TGTGCCTGGATAATAGCGGGCTACGAGCAGTACTTC	CAWIIAGYEQYF	TRBV30	TRBJ2-7
TGCGCCAGCAGCCAATACGGCCCAGGGTCCACAGATACGCAGTATTTT	CASSQYGPGSTDTQYF	TRBV4-3	TRBJ2-3
TGTGCCAGCAGTTTTGGTCTCCGGTACACCGGGGAGCTGTTTTTT	CASSFGLRYTGELFF	TRBV27	TRBJ2-2
TGTGCCAGCACGGGGGACGGGGTATATAGCAATCAGCCCCAGCATTTT	CASTGDGVYSNQPQHF	TRBV7-9	TRBJ1-5
TGTGCCAGCAGTCGGAAAAGGCCGGGACAGACTAAAATCTTC	CASSRKRPGQTKIF	TRBV27	TRBJ2-1
TGCAGTGCAGACCCTACCAACCGGGACGCCCCCGACTATGGCTACACCTTC	CSADPTNRDAPDYGYTF	TRBV20-1	TRBJ1-2
TGTGCCAGCCACAGAGAGCAGGGGGCTGGAAACACCATATATTTT	CASHREQGAGNTIYF	TRBV2	TRBJ1-3
TGTGCCAGCATTCCCCGGGACAGGGACGAGACCCAGTACTTC	CASIPRDRDETQYF	TRBV6-5	TRBJ2-5
TGTGCCAGCAGCTTAACCCTAGCGTTGACCTACAATGAGCAGTTCTTC	CASSLTLALTYNEQFF	TRBV7-3	TRBJ2-1
TGTGCCAGCAGCCAACAGGGAAATGAAAAACTGTTTTTT	CASSQQGNEKLFF	TRBV11-2	TRBJ1-4
TGTGCCACCAGTGATTCCCGTTCGGGGCCCCAAGAGACCCAGTACTTC	CATSDSRSGPQETQYF	TRBV24-1	TRBJ2-5
TGTGCCATACCCACCCGGCAGAATGGCTACACCTTC	CAIPTRQNGYTF	TRBV27	TRBJ1-2
TGTGCCAGCAGCCACAGGTTTCAGAACACTGAAGCTTTCTTT	CASSHRFQNTEAFF	TRBV5-6	TRBJ1-1
TGTGCCAGCAGCTCCGTGGGCGCCCATGAGCAGTTCTTC	CASSSVGAHEQFF	TRBV7-7	TRBJ2-1
TGTGCCAGCAGTTCGTCGGTGAACACCGGGGAGCTGTTTTTT	CASSSSVNTGELFF	TRBV27	TRBJ2-2
TGTGCCAGCAGCTTACGGTTGGCCGGGACAGGGCCCTGCTACGAGCAGTACTTC	CASSLRLAGTGPCYEQYF	TRBV7-9	TRBJ2-7
TGTGCCAGCAGCTCCCACCGGACAGGCCCAAAACTGAACACCATATATTTT	CASSSHRTGPKLNTIYF	TRBV7-2	TRBJ1-3
TGTGCCAGCAGCTGGGAGGTGTATGAAGCTTTCTTT	CASSWEVYEAFF	TRBV7-2	TRBJ1-1
TGTGCTAGTGGTTTGGTACCGTCGTGGGAGTGGAGAGAGACCCAGTACTTC	CASGLVPSWEWRETQYF	TRBV12-5	TRBJ2-5
TGTGCCAGCTCACCAAGTGACCCAGCTTTCTTT	CASSPSDPAFF	TRBV18	TRBJ1-1
TGTGCCATAGAGGGTATGAACACTGAAGCTTTCTTT	CAIEGMNTEAFF	TRBV4-2	TRBJ1-1
TGCAGTGCTAGCCCGATGGACAGGGCGGCGCGGAACACTGAAGCTTTCTTT	CSASPMDRAARNTEAFF	TRBV20-1	TRBJ1-1
TGTGCCAGCAGTCCCCCCCCGGGGGCGGACTTC	CASSPPPGADF	TRBV6-5	TRBJ2-7
TGTGCCAGCAGCCGGGGGGGACGTTTTAACTATGGCTACACCTTC	CASSRGGRFNYGYTF	TRBV7-4	TRBJ1-2
TGTGCCAGCAAGTTACAGAGAGATACCTACGAGCAGTACTTC	CASKLQRDTYEQYF	TRBV6-5	TRBJ2-7
TGTGCCAGGCCCCGGGACAGCGGAGGCGTGCCCCAGCATTTT	CARPRDSGGVPQHF	TRBV6-3	TRBJ1-5
TGTGGGGGCCGGAGTGAAAAACTGTTTTTT	CGGRSEKLFF	TRBV19	TRBJ1-4
TGCGCCAGCAGGGTCTTTAGGGGGGCAGATACGCAGTATTTT	CASRVFRGADTQYF	TRBV10-1	TRBJ2-3
TGTGCCAGCTCACCCCACGCCAGGGGGGGGGGAACAGGTTACAATGAGCAGTTCTTC	CASSPHARGGGTGYNEQFF	TRBV18	TRBJ2-1
TGCAGTGCTAAACGTTTTCTAGGGACGCGAGATACGCAGTATTTT	CSAKRFLGTRDTQYF	TRBV20-1	TRBJ2-3
TGTGCCCACGGGACCTATGGCACCGGGGAGCTGTTTTTT	CAHGTYGTGELFF	TRBV19	TRBJ2-2
TGTGCCAGCAGTGTAAGGGGCGGAAGAGGAGCCCAGTACTTC	CASSVRGGRGAQYF	TRBV25-1	TRBJ2-5
TGCGCCAGCAGCTTGGAGGTGACTAGATGGCACATTCAGTACTTC	CASSLEVTRWHIQYF	TRBV5-1	TRBJ2-4
TGCAGTGCAATGGGGAAAAGTAATGGCTACACCTTC	CSAMGKSNGYTF	TRBV20-1	TRBJ1-2
TGCGCCGTCACCGGGACAGGGGATAGCTCCTACGAGCAGTACTTC	CAVTGTGDSSYEQYF	TRBV4-3	TRBJ2-7
TGTGCCAGCAGTTACTCGCCTGAACTAGCGACTTACTATGAGCAGTTCTTC	CASSYSPELATYYEQFF	TRBV6-6	TRBJ2-1
TGTGCCAGCAGCTTAGTAAAGCAGGTACGGCAGTACTTC	CASSLVKQVRQYF	TRBV11-2	TRBJ2-7
TGTGCCAGCAGGGGGCAAAATTACGAGCAGTACTTC	CASRGQNYEQYF	TRBV6-1	TRBJ2-7
TGTGCCAGCAGCGTAAAGAGACTAGGTCTCTACGAGCAGTACTTC	CASSVKRLGLYEQYF	TRBV9	TRBJ2-7
TGTGCCAGTACTAGCGGGAGGCGAGTGGAAACCTACAATGAGCAGTTCTTC	CASTSGRRVETYNEQFF	TRBV19	TRBJ2-1
TGTGCCAGTACTCCAGACAGGGCATATAGCAATCAGCCCCAGCATTTT	CASTPDRAYSNQPQHF	TRBV19	TRBJ1-5
TGTGCCAGCAGCCAAGTGTCCAGGGCCAACCTCCGTTCGACTGAAGCTTTCTTT	CASSQVSRANLRSTEAFF	TRBV4-2	TRBJ1-1
TGTGCCAGCAGCTCCCCCGGGACAACCGATACGCAGTATTTT	CASSSPGTTDTQYF	TRBV7-3	TRBJ2-3
TGCGCCAGCAGCCAAGTAGAGTCTGAAGGAGGGTTTCCCCGCAATCAGCCCCAGCATTTT	CASSQVESEGGFPRNQPQHF	TRBV4-3	TRBJ1-5
TGTGCCAGTGTGGACGGGGGAAGCAATCAGCCCCAGCATTTT	CASVDGGSNQPQHF	TRBV19	TRBJ1-5
TGCGCCAGCAGCTTGGTGGACCTCCCGGGACTAGCGGGGGGGCCTTGGAATGAGCAGTTCTTC	CASSLVDLPGLAGGPWNEQFF	TRBV5-1	TRBJ2-1
TGTGCCAGCAGCACTGGACTCCTCCTGGGTGAGCAGTTCTTC	CASSTGLLLGEQFF	TRBV11-3	TRBJ2-1
TGTGCCAGCAGCTTAGATCAGAGCACGAACACCGGGGAGCTGTTTTTT	CASSLDQSTNTGELFF	TRBV11-2	TRBJ2-2
TGTGCCAGCAGTTGCCTATCGAGACAGTTAAGTCCGGTTATAGAGGTCGAAGCTTTCTTT	CASSCLSRQLSPVIEVEAFF	TRBV27	TRBJ1-1
TGTGCCAGCAGCTTACCGGAGAACACCGGGGAGCTGTTTTTT	CASSLPENTGELFF	TRBV7-2	TRBJ2-2
TGTGCCAGCAGCGCAAGGACAGGAGATACGCAGTATTTT	CASSARTGDTQYF	TRBV7-9	TRBJ2-3
TGTGCCAGCAGTTACCCGGGCCCCGCTAGCACAGATACGCAGTATTTT	CASSYPGPASTDTQYF	TRBV6-9	TRBJ2-3
TGTGCCAGCAGTTGCACTACGCTTCGTGAGGGGGAGCTGTTTTTT	CASSCTTLREGELFF	TRBV12-4	TRBJ2-2
TGTGCCACCACGATGAGCGCGGGAGCCTCCCATGGCTACACCTTC	CATTMSAGASHGYTF	TRBV24-1	TRBJ1-2
TGTGCCAGCAGCTTCACCAACAGGGCGGACTCTGTAGGGCTAAACACTGAAGCTTTCTTT	CASSFTNRADSVGLNTEAFF	TRBV7-9	TRBJ1-1
TGTGCCAGCAGCGGGACCTACAATGAGCAGTTCTTC	CASSGTYNEQFF	TRBV11-2	TRBJ2-1
TGTGCCAGCAGCAGGAGGTCTTACACCTTC	CASSRRSYTF	TRBV7-2	TRBJ1-2
TGCGCCAGCAGCCACCCTGCCGGACCCACCCGGGCATGGGGTCAGCCCCAGCATTTT	CASSHPAGPTRAWGQPQHF	TRBV4-1	TRBJ1-5
TGTGCCAGAGTCGGGGGGGGTCAGCCCCAGCATTTT	CARVGGGQPQHF	TRBV6-8	TRBJ1-5
TGTGCCATCAGCCTTCTGACAGGGATCACCTACGAGCAGTACTTC	CAISLLTGITYEQYF	TRBV10-3	TRBJ2-7
TGTGCCAGCAGCGGGCCAAAAAAGACTGGCAATCAGCCCCAGCATTTT	CASSGPKKTGNQPQHF	TRBV7-9	TRBJ1-5
TGTGCCAGCAGCAAGCAGGAGGGACAGCGGATCGTCTATGGCTACACCTTC	CASSKQEGQRIVYGYTF	TRBV5-6	TRBJ1-2
TGTGCCAGCAGCCGAGGGGGTTTAGGTGGCTACACCTTC	CASSRGGLGGYTF	TRBV13	TRBJ1-2
TGTGCCAGCAGCTTACTGGGGGACAGGACCGGGGAGCTGTTTTTT	CASSLLGDRTGELFF	TRBV7-9	TRBJ2-2
TGTGCCAGCAGCTCTGCCTCCTGGGACAGGGGGTACAATGAGCAGTTCTTC	CASSSASWDRGYNEQFF	TRBV11-3	TRBJ2-1
TGTGCCAGCAGCGAGAACCGACAGGGTACCATATATTTT	CASSENRQGTIYF	TRBV11-2	TRBJ1-3
TGTGCCAGCAGCCGGCGGCCCTATGGCTACACCTTC	CASSRRPYGYTF	TRBV25-1	TRBJ1-2
TGTGCCAGCAGTAAGCACAATCAGCCCCAGCATTTT	CASSKHNQPQHF	TRBV27	TRBJ1-5
TGCGCCAGCAGCCGCTTCCGTGCCGGGACAGGGGATGAATGCAGGCTGTTTTTT	CASSRFRAGTGDECRLFF	TRBV4-1	TRBJ2-2
TGTGCCAGCAGCCAAGGTGGGACATGTCGTAACTATGGCTACACCTTC	CASSQGGTCRNYGYTF	TRBV3-1	TRBJ1-2
TGTGCCACCAGTGATGGGCCGACGACAGTCTACGAGCAGTACTTC	CATSDGPTTVYEQYF	TRBV24-1	TRBJ2-7
TGTGCCAGCCGTCGACAGGACAGTGAGCAGTTCTTC	CASRRQDSEQFF	TRBV7-9	TRBJ2-1
TGTGCTAGTGGTTGTTTAGCGGGGGGTATAGCCAAAAACATTCAGTACTTC	CASGCLAGGIAKNIQYF	TRBV12-5	TRBJ2-4
TGTGCCAGCAGTGAACAGGGTCACCAAGAGACCCAGTACTTC	CASSEQGHQETQYF	TRBV6-1	TRBJ2-5
TGTGCCAGCAGTTGGCCGGGGGAGTGCCAATTTAGCTCCTACGAGCAGTACTTC	CASSWPGECQFSSYEQYF	TRBV6-9	TRBJ2-7
TGCAGTGCCACAGGACACTTTACTGAAGCTTTCTTT	CSATGHFTEAFF	TRBV20-1	TRBJ1-1
TGTGCCACCAGTGATAAACCGCGGGGGAACGATACGCAGTATTTT	CATSDKPRGNDTQYF	TRBV24-1	TRBJ2-3
TGTGCCAGCAGCTTCCGGGGGAAGAATGAAAAACTGTTTTTT	CASSFRGKNEKLFF	TRBV11-3	TRBJ1-4
TGTGCCACCATCTTCTCGCACAATGAGCAGTTCTTC	CATIFSHNEQFF	TRBV24-1	TRBJ2-1
TGTGCGTTGAGGCCAGCGGTCTACGAGCAGTACTTC	CALRPAVYEQYF	TRBV6-4	TRBJ2-7
TGTGCCAGCAGCTTGTATGTTTATTATCTCGCCAATGAGCAGTTCTTC	CASSLYVYYLANEQFF	TRBV5-6	TRBJ2-1
TGTGCCAGCAGCGCAGGGGGGGCGGAAACTGAAGCTTTCTTT	CASSAGGAETEAFF	TRBV11-3	TRBJ1-1
TGTGCCAGCACAGAGCGGACTAGCGGGGATGAGCAGTTCTTC	CASTERTSGDEQFF	TRBV18	TRBJ2-1
TGTGCCAGCAGCACCTATCTCCTCACTAGCGGGAGCCCGTCCTACGAGCAGTACTTC	CASSTYLLTSGSPSYEQYF	TRBV13	TRBJ2-7
TGTGCCAGCAGAACAAGGACAGGGGCACACACCGGGGAGCTGTTTTTT	CASRTRTGAHTGELFF	TRBV3-1	TRBJ2-2
TGTGCCAGCAGCGTCCCCGCTAGGGGTAGTTCCCCCTCCTACGAGCAGTACTTC	CASSVPARGSSPSYEQYF	TRBV9	TRBJ2-7
TGTGCCAGCAGTTTGGGCCGGGACAGGCTCTATAGCAATCAGCCCCAGCATTTT	CASSLGRDRLYSNQPQHF	TRBV27	TRBJ1-5
TGCAGCGCCGGGACTCGGAGCTACGAGCAGTACTTC	CSAGTRSYEQYF	TRBV29-1	TRBJ2-7
TGCAGTGCTAGGCCACAGGGGGCCCGCTACGAGCAGTACTTC	CSARPQGARYEQYF	TRBV20-1	TRBJ2-7
TGTGCCAGCAGCACCCCAGGGGGGGGCAATCAGCCCCAGCATTTT	CASSTPGGGNQPQHF	TRBV11-3	TRBJ1-5
TGTGCCAGCAGGAGAGGGACAGGGATCCCGAACACTGAAGCTTTCTTT	CASRRGTGIPNTEAFF	TRBV28	TRBJ1-1
TGCAGTGGATTGGGGGCGTCACCCCTCCACTTT	CSGLGASPLHF	TRBV20-1	TRBJ1-6
TGTGCCAGCAGATACGGGAGTAGTCTTTCACCCCTCCACTTT	CASRYGSSLSPLHF	TRBV7-2	TRBJ1-6
TGTGCCAGCAGTTCGGGGGGGCGGTCGTACGAGCAGTACTTC	CASSSGGRSYEQYF	TRBV6-5	TRBJ2-7
TGTGCCAGCAGCTTAGCGTTAGGGACAGGGGGAAGCGAGCAGTACTTC	CASSLALGTGGSEQYF	TRBV7-2	TRBJ2-7
TGTGCCAGCAGCGGAAGGCAGGGGGGGGCCTACGAGCAGTACTTC	CASSGRQGGAYEQYF	TRBV13	TRBJ2-7
TGTGCCATCACTCGCGGGGACACCGGGGAGCTGTTTTTT	CAITRGDTGELFF	TRBV10-3	TRBJ2-2
TGTGCCAGCACCCGAATGTTCCGGGACAGGGGCCCAGATGAAAAACTGTTTTTT	CASTRMFRDRGPDEKLFF	TRBV28	TRBJ1-4
TGCAGTGGGTGGGCATACGAGCAGTACTTC	CSGWAYEQYF	TRBV20-1	TRBJ2-7
TGCAGCGTGTTTTTCTGGGGGGGTGGGAAAAGCACAGATACGCAGTATTTT	CSVFFWGGGKSTDTQYF	TRBV29-1	TRBJ2-3
TGCAGCGGGCGTGGCATCACAGATACGCAGTATTTT	CSGRGITDTQYF	TRBV29-1	TRBJ2-3
TGTGCCAGCAGGGCCTTCATAAGCAACCGATCTGGAAACACCATATATTTT	CASRAFISNRSGNTIYF	TRBV6-4	TRBJ1-3
TGCAACCGGGGGATCCCGGGGTGCTACTACGAGCAGTACTTC	CNRGIPGCYYEQYF	TRBV20-1	TRBJ2-7
TGTGCCAGCAGCCATCAACTCGGGGGAAACTGCTACGAGCAGTACTTC	CASSHQLGGNCYEQYF	TRBV3-1	TRBJ2-7
TGCAGTGCTAGCCAGACGTCCCGCCGGGACAGGTACGAGCAGTACTTC	CSASQTSRRDRYEQYF	TRBV20-1	TRBJ2-7
TGCGCCAGCAGTGAGGAATTAAAGGGGTGGACAATTGACTATGGCTACACCTTC	CASSEELKGWTIDYGYTF	TRBV10-1	TRBJ1-2
TGTGCCAGCAGCTTAGTTCGACAGGGGAACTATGGCTACACCTTC	CASSLVRQGNYGYTF	TRBV11-2	TRBJ1-2
TGCGCCACGGAAGGACAGGCCTCCTACGAGCAGTACTTC	CATEGQASYEQYF	TRBV10-1	TRBJ2-7
TGTGCCAGCAGCTTGTGGTGTCCCTTCTTC	CASSLWCPFF	TRBV5-6	TRBJ2-1
TGCAGTGTAGTGGGACGACGCAATCAGCCCCAGCATTTT	CSVVGRRNQPQHF	TRBV20-1	TRBJ1-5
TGTGCCAGCAGCCTACGACGTAAGTACACTGAAGCTTTCTTT	CASSLRRKYTEAFF	TRBV3-1	TRBJ1-1
TGTGCCAGCAGCGGCGGACAGGGTCGGAAATCCGGGAGTCAAGAGACCCAGTACTTC	CASSGGQGRKSGSQETQYF	TRBV11-3	TRBJ2-5
TGTGCCACAGGCGTGAAGCGGGAGCGCGAGCAGTACTTC	CATGVKREREQYF	TRBV2	TRBJ2-7
TGTGCCAGCAGCCAAGGGGGACGGGGGGCAGAGACCCAGTACTTC	CASSQGGRGAETQYF	TRBV14	TRBJ2-5
TGTTACCGGTTCTACGAGCAGTACTTC	CYRFYEQYF	TRBV11-2	TRBJ2-7
TGTGCCAGCAGTGAGCAGGACGGCGTCGGGGCCAACGTCCTGACTTTC	CASSEQDGVGANVLTF	TRBV2	TRBJ2-6
TGTGCCAGCAGCTCGGGGACCGTACGCCACTCCTACGAGCAGTACTTC	CASSSGTVRHSYEQYF	TRBV11-2	TRBJ2-7
TGTGCCAGCAGCTTAGATAAGACAGGGGAGGGCTTCTCAAGCAATCAGCCCCAGCATTTT	CASSLDKTGEGFSSNQPQHF	TRBV11-2	TRBJ1-5
TGTGCCAGCAATGTCGTAGGGGGGGCCCCAAACATTCAGTACTTC	CASNVVGGAPNIQYF	TRBV28	TRBJ2-4
TGTGCCAGCAGCGCCACTAGCGGCCGGGGGCAGTACTTC	CASSATSGRGQYF	TRBV7-4	TRBJ2-7
TGTGCCACCAGCCCGGGACAGCGCCAAGAGACCCAGTACTTC	CATSPGQRQETQYF	TRBV15	TRBJ2-5
TGTGCCAACTCAGCGGGCTCGTATGGCTACACCTTC	CANSAGSYGYTF	TRBV10-3	TRBJ1-2
TGTGCCAGCAGGGGGTCCACTGAAGCTTTCTTT	CASRGSTEAFF	TRBV7-2	TRBJ1-1
TGTGCCAGCAGTTACCTAACATCCCTGGCTTTCTTT	CASSYLTSLAFF	TRBV6-5	TRBJ1-1
TGTGCCAGCAGTGAAACAAGGGGCGGCTCCTACGAGCAGTACTTC	CASSETRGGSYEQYF	TRBV27	TRBJ2-7
TGCGCCAGGGTGGACGGCTACGAGCAGTACTTC	CARVDGYEQYF	TRBV10-1	TRBJ2-7
TGTGCCAGCAGTGAACCGGAACGCTTAGGGGTGTACTACGAGCAGTACTTC	CASSEPERLGVYYEQYF	TRBV6-1	TRBJ2-7
TGTGCCAGCAGCTTGGACAGCCCCTACAATGAGCAGTTCTTC	CASSLDSPYNEQFF	TRBV7-4	TRBJ2-1
TGCGCCAGCAGCTCCCTAGCCATATGTATAACTAATGAAAAACTGTTTTTT	CASSSLAICITNEKLFF	TRBV5-1	TRBJ1-4
TGCGCCAGATTTTCCCGGGACAGGGCGGGGAACACCGGGGAGCTGTTTTTT	CARFSRDRAGNTGELFF	TRBV5-1	TRBJ2-2
TGTGCCAGCAGGGAAAGCCCAGGGCGTAATGAAAAACTGTTTTTT	CASRESPGRNEKLFF	TRBV6-5	TRBJ1-4
TGCAGCGTTGAGGTCGGGGTGAGCCACGCCGAAAAACTGTTTTTT	CSVEVGVSHAEKLFF	TRBV29-1	TRBJ1-4
TGTGCCAGCAGCCTCCGGGACAGGGGGAATGCCTATAATTCACCCCTCCACTTT	CASSLRDRGNAYNSPLHF	TRBV7-3	TRBJ1-6
TGTGCCAGCCAGACTTCCTTTGAGCAGTTCTTC	CASQTSFEQFF	TRBV25-1	TRBJ2-1
TGTGCCAGCCCCAGGCGGGACAGGGATGAGCAGTTCTTC	CASPRRDRDEQFF	TRBV28	TRBJ2-1
TGTGCCAGCAGCAGGTGTCCAGACAGTTTATTGGAGACCCAGTACTTC	CASSRCPDSLLETQYF	TRBV7-3	TRBJ2-5
TGTGCCAGCAGCGGGCCCGGCATTTTGAGGCTCAAAAACATTCAGTACTTC	CASSGPGILRLKNIQYF	TRBV13	TRBJ2-4
TGTGCTAGTGGTTTGCCGAGCTCCGGGGGGGGGGCAGTAGCCAAAAACATTCAGTACTTC	CASGLPSSGGGAVAKNIQYF	TRBV12-5	TRBJ2-4
TGTGCCAGCAGTATCAACCCGCCGGGACTGGAGGAGGAAAAACTGTTTTTT	CASSINPPGLEEEKLFF	TRBV6-5	TRBJ1-4
TGTGCCAGCAGCCGCGAAGCAGCCCTAGCTAACTATGGCTACACCTTC	CASSREAALANYGYTF	TRBV3-1	TRBJ1-2
TGTGCCACCCTGCCAGCGGGAGGGGAGGCCTACGAGCAGTACTTC	CATLPAGGEAYEQYF	TRBV6-4	TRBJ2-7
TGTGCCAGCTCGGGGACTCTTCCCCCCTACAATGAGCAGTTCTTC	CASSGTLPPYNEQFF	TRBV6-4	TRBJ2-1
TGTGCCAGCAGCTTGGCCTGCGGGACGACTCGGAGCTATGGCTACACCTTC	CASSLACGTTRSYGYTF	TRBV5-4	TRBJ1-2
TGTGCCAGCAGCGGCTCCGGGACTAGCGGGAGTCGGGGCCCTTGGAACAACGAGCAGTACTTC	CASSGSGTSGSRGPWNNEQYF	TRBV11-2	TRBJ2-7
TGCGCCAGCAGCTTGGGTCCGAGTAAAAAAGAGGTCGTGCCCTACGAGCAGTACTTC	CASSLGPSKKEVVPYEQYF	TRBV5-1	TRBJ2-7
TGTGCCAGGACAGGGGGCGTGTGGGGCACCTACGAGCAGTACTTC	CARTGGVWGTYEQYF	TRBV28	TRBJ2-7
TGTGCCAGCAGCGTAGCTACCGGGACAGTATCGTATGGCTACACCTTC	CASSVATGTVSYGYTF	TRBV9	TRBJ1-2
TGTGCCAGCATTACCACTTCCTGGCGGACAGGGGGCCGGGGCTACACCTTC	CASITTSWRTGGRGYTF	TRBV5-6	TRBJ1-2
TGTGCCAGCAGCCCGAACTTGTCTACTAATGAGCAGTTCTTC	CASSPNLSTNEQFF	TRBV28	TRBJ2-1
TGCAGTGCTAGAGTCCAGGGCGGGAACACTGAAGCTTTCTTT	CSARVQGGNTEAFF	TRBV20-1	TRBJ1-1
TGTGCCAGCACCCCAATTTCCGGGGATGAGCAGTTCTTC	CASTPISGDEQFF	TRBV28	TRBJ2-1
TGTGCCACCGGGGGGGCCGATACGCAGTATTTT	CATGGADTQYF	TRBV15	TRBJ2-3
TGTGCCAGCAGGAGGGAACTGAGGCCTAGCGGGTTGGAGACCCAGTACTTC	CASRRELRPSGLETQYF	TRBV6-3	TRBJ2-5
TGTGCCAGCAGAGGGCCCAAGCGGGAGGGGTACACAGATACGCAGTATTTT	CASRGPKREGYTDTQYF	TRBV27	TRBJ2-3
TGTGCCAGTAGTATCTCCTCGGGCCGGAACACTGAAGCTTTCTTT	CASSISSGRNTEAFF	TRBV19	TRBJ1-1
TGTGCCAGCAAAGAACAGGTTGGCTACACCTTC	CASKEQVGYTF	TRBV6-1	TRBJ1-2
TGCGCCAGCAGTGGAAGGGGGGCCTCCGCCCAAGAGACCCAGTACTTC	CASSGRGASAQETQYF	TRBV5-1	TRBJ2-5
TGCGCCAGCAGCTTCTCCAGGGGGATCTACGAGCAGTACTTC	CASSFSRGIYEQYF	TRBV5-1	TRBJ2-7
TGCATTTCCTACGGGGGGCCATTCAATGAGCAGTTCTTC	CISYGGPFNEQFF	TRBV20-1	TRBJ2-1
TGTGCCAGCAGCTTACGGGACAGGGGGCGCCCTCACAATGAGCAGTTCTTC	CASSLRDRGRPHNEQFF	TRBV7-9	TRBJ2-1
TGTGCCAGCAGTTACAAGCAGACAGCTGGAAACACCATATATTTT	CASSYKQTAGNTIYF	TRBV6-2	TRBJ1-3
TGTGCCAGCAGCCTCCTGGGGTCAGACAGGGGTCTCTATGGCTACACCTTC	CASSLLGSDRGLYGYTF	TRBV11-3	TRBJ1-2
TGTGCCAGCAGGGGGGATGGACAGCCTAATTCACCCCTCCACTTT	CASRGDGQPNSPLHF	TRBV2	TRBJ1-6
TGCAGTGCTAACAAGCGGGAGGATTTGCCAAAGACCCAGTACTTC	CSANKREDLPKTQYF	TRBV20-1	TRBJ2-5
TGCGCCAGCAGCTTTGGTGGCCTAGCCCCCCGCACAGATACGCAGTATTTT	CASSFGGLAPRTDTQYF	TRBV5-1	TRBJ2-3
TGTGCCACCACGGGGACAGAGTGGGAGACCCAGTACTTC	CATTGTEWETQYF	TRBV15	TRBJ2-5
TGTGCCAGCAGTAGGGCTCGCGGTCGGCAGCACTACGAGCAGTACTTC	CASSRARGRQHYEQYF	TRBV13	TRBJ2-7
TGTGCCAGCAGGAAGGAACAAAGGGGGCGCGGGGGTGAAAAACTGTTTTTT	CASRKEQRGRGGEKLFF	TRBV12-3	TRBJ1-4
TGTGCCAGCAGCGGGTTTGGGGGGGCGCCGGGCGGCGAGCAGTACTTC	CASSGFGGAPGGEQYF	TRBV7-3	TRBJ2-7
TGTGCCAGCAGCCAAAGGGGGGGGGGCTGTTTCGGGATCACCGGGGAGCTGTTTTTT	CASSQRGGGCFGITGELFF	TRBV14	TRBJ2-2
TGTGCCAGCAGCTTGGGAGAATTTTGTCAGGGGGCATCCTACGAGCAGTACTTC	CASSLGEFCQGASYEQYF	TRBV5-6	TRBJ2-7
TGTGCCAGCAGCGGGCCTAACTATGGCTACACCTTC	CASSGPNYGYTF	TRBV12-3	TRBJ1-2
TGCGCCAGCAGCCAAGATAGACGGATAGAGGGGAGGGTCGGGGGCTACACCTTC	CASSQDRRIEGRVGGYTF	TRBV4-1	TRBJ1-2
TGTGCCAGCAGCTGTCTCGAGCAGTACTTC	CASSCLEQYF	TRBV25-1	TRBJ2-7
TGTGCCACCAGGTCCCGGGGGAATGTCTTCTACGAGCAGTACTTC	CATRSRGNVFYEQYF	TRBV24-1	TRBJ2-7
TGTGCCAGCAGCCGCACTAGCGGGTGGCCCCATACCTACGAGCAGTACTTC	CASSRTSGWPHTYEQYF	TRBV5-4	TRBJ2-7
TGTGCCAGCAGCCGTCGCAGCGAGAGCAATCAGCCCCAGCATTTT	CASSRRSESNQPQHF	TRBV9	TRBJ1-5
TGTGCCAGCAGTCGAGGCGAGCAGTACTTC	CASSRGEQYF	TRBV6-4	TRBJ2-7
TGTGCCACCAGTGTCCCTTTGGGACGGAGCAATCAGCCCCAGCATTTT	CATSVPLGRSNQPQHF	TRBV24-1	TRBJ1-5
TGTGCCAGCAGTTATATACCCCTGAGGGTGTACAATGAGCAGTTCTTC	CASSYIPLRVYNEQFF	TRBV6-2	TRBJ2-1
TGTGCCACCAGTGATTTACGCCCGGCACGGCACAGGGCGGATCAGCCCCAGCATTTT	CATSDLRPARHRADQPQHF	TRBV24-1	TRBJ1-5
TGTGCCATCAACAGGGGAGATGAAAAACTGTTTTTT	CAINRGDEKLFF	TRBV10-3	TRBJ1-4
TGCAGCGTGCGGGACTTCCAGTACTTC	CSVRDFQYF	TRBV29-1	TRBJ2-5
TGCGCCAGCAGCCAAGTGGGACCGGAGGTAAAAAACATTCAGTACTTC	CASSQVGPEVKNIQYF	TRBV4-1	TRBJ2-4
TGTGCCAGCAGCCTAGGTTTCCTACCCCCTCCGGGGGGGAGACCCTCCTACGAGCAGTACTTC	CASSLGFLPPPGGRPSYEQYF	TRBV14	TRBJ2-7
TGTGCCAGCTTCCGGGCGGAGCAGTTCTTC	CASFRAEQFF	TRBV2	TRBJ2-1
TGTGCCAGCAGCCGGGGACTAGCGGGTGCTCCCTACGAGCAGTACTTC	CASSRGLAGAPYEQYF	TRBV13	TRBJ2-7
TGTGCCAGCAGCAACCTAGGGACATTGATCACTGAAGCTTTCTTT	CASSNLGTLITEAFF	TRBV13	TRBJ1-1
TGTGCCAGCATACTGGTCGGACGACCCAATCAGCCCCAGCATTTT	CASILVGRPNQPQHF	TRBV3-1	TRBJ1-5
TGCATAAGCCCCGACGACAGGGGGGTTCCTTCCTACGAGCAGTACTTC	CISPDDRGVPSYEQYF	TRBV20-1	TRBJ2-7
TGTGCCAGCAGCGGGGGGGAGTGTCGCAATCAGCCCCAGCATTTT	CASSGGECRNQPQHF	TRBV7-2	TRBJ1-5
TGTGCTAGCAGCGGAGAGGAACGACAGGAGGGGGGGGGCTACACCTTC	CASSGEERQEGGGYTF	TRBV7-7	TRBJ1-2
TGTGCCAGCAGTAGGGGTGCTCACAATCAGCCCCAGCATTTT	CASSRGAHNQPQHF	TRBV2	TRBJ1-5
TGTGCCACCAGTGCGGGACGTGAGCAGTTCTTC	CATSAGREQFF	TRBV24-1	TRBJ2-1
TGTGCCAGCTTATGGACCACAACTAATGAAAAACTGTTTTTT	CASLWTTTNEKLFF	TRBV2	TRBJ1-4
TGCGCCAGCAGCTTGGGGTTGGACAGGGGGCATGGCTACACCTTC	CASSLGLDRGHGYTF	TRBV5-1	TRBJ1-2
TGCAGTGCTAGAACCAGGGTTCTACATGGCTACACCTTC	CSARTRVLHGYTF	TRBV20-1	TRBJ1-2
TGTGCCAGTGGCGGTGGGACATGCTGGTCGCATTTT	CASGGGTCWSHF	TRBV6-1	TRBJ1-5
TGTGCCACCAGCCGGGACAGGGGGGACTATGGCTACACCTTC	CATSRDRGDYGYTF	TRBV24-1	TRBJ1-2
TGTGCCAGCGGGAAGGAATGCGAGCAGTACTTC	CASGKECEQYF	TRBV10-3	TRBJ2-7
TGTGCCAGCAGCCAGCGAGGACAGGAACGCTCGACCCAGTACTTC	CASSQRGQERSTQYF	TRBV11-2	TRBJ2-5
TGTGCCAGCAGTCGCGGGACAGGCAGCTCCTACGAGCAGTACTTC	CASSRGTGSSYEQYF	TRBV6-4	TRBJ2-7
TGCGCCAGCAGCTTGGGGGGGGAGGCCTACGAGCAGTACTTC	CASSLGGEAYEQYF	TRBV5-1	TRBJ2-7
TGTGCCAGCAGCTTAGTAGAATACAGGGGGCCGAATGAAAAACTGTTTTTT	CASSLVEYRGPNEKLFF	TRBV7-2	TRBJ1-4
TGCGCCAGCAGCTTTCCAGGGCAGCCCCAGCATTTT	CASSFPGQPQHF	TRBV5-1	TRBJ1-5
TGTGCCAGCAGACGTTCTAATCAGGGGGCTACCTATGGCTACACCTTC	CASRRSNQGATYGYTF	TRBV11-2	TRBJ1-2
TGTGCCAGCAGTCCCGAGTTTGGATCCCAAGCAGATGAGCAGTTCTTC	CASSPEFGSQADEQFF	TRBV6-5	TRBJ2-1
TGTGCCGAAGCGGGTAGCGGGCGCAAGCAGTTCTTC	CAEAGSGRKQFF	TRBV30	TRBJ2-1
TGTGCCAGCAGAGGGGGGGGAAGCTCCTACGAGCAGTACTTC	CASRGGGSSYEQYF	TRBV11-2	TRBJ2-7
TGTGCCAGCAGCCAAGCCGGAGGGACCAGCTTT	CASSQAGGTSF	TRBV3-1	TRBJ1-1
TGTGCCAGCAGCGTCCGGGGGCCCCCGTCGGGTGGTGGAGGCGAGACCCAGTACTTC	CASSVRGPPSGGGGETQYF	TRBV7-2	TRBJ2-5
TGCGCCAGCAGCCAACGGGAGCAGGGGGTTCGAAACTATGGCTACACCTTC	CASSQREQGVRNYGYTF	TRBV4-1	TRBJ1-2
TGTGCCAGCAGTGACTCGCACCATGACGGGGCCAAAAACATTCAGTACTTC	CASSDSHHDGAKNIQYF	TRBV6-4	TRBJ2-4
TGTGCCACCAGCAGCTCCCGGGGGGGTTGGAACGAGCAGTACTTC	CATSSSRGGWNEQYF	TRBV15	TRBJ2-7
TGCGCCAGCAGCAATTTCGGACAGATCAGGCCCGGGAACACTGAAGCTTTCTTT	CASSNFGQIRPGNTEAFF	TRBV5-1	TRBJ1-1
TGTGCCAGCAGCTTGCGATGGGCCGGAACCTCCTACAATGAGCAGTTCTTC	CASSLRWAGTSYNEQFF	TRBV7-8	TRBJ2-1
TGTGCCAGCAGCTGCGTGAACGAGTATTGTGGAAACACCATATATTTT	CASSCVNEYCGNTIYF	TRBV11-3	TRBJ1-3
TGTGCCAGCAGCTCCACTGTGCCAGGGCGAGATGTCGTCTTTGACATGAACACTGAAGCTTTCTTT	CASSSTVPGRDVVFDMNTEAFF	TRBV7-9	TRBJ1-1
TGTGCCAGCAGTGCAACGCGAACGGACAGCCACACTGAAGCTTTCTTT	CASSATRTDSHTEAFF	TRBV25-1	TRBJ1-1
TGTGCCAGCAGCGCGAGTCAAGAGACCCAGTACTTC	CASSASQETQYF	TRBV12-3	TRBJ2-5
TGTGCCAGCAGTTTTCGAGAGGACTATGGGGAGCTGTTTTTT	CASSFREDYGELFF	TRBV27	TRBJ2-2
TGTGCCAGCAGCGTAGGGCACCCGGTCGGACTAGAAGCCACCTACGAGCAGTACTTC	CASSVGHPVGLEATYEQYF	TRBV9	TRBJ2-7
TGTGCCAGCAGCCGAACCCCGCCCAGGGGCTCCTACGAGCAGTACTTC	CASSRTPPRGSYEQYF	TRBV3-1	TRBJ2-7
TGTGCCAGTAGTCGTAGACATCACCGGGAAGCTTTCTTT	CASSRRHHREAFF	TRBV19	TRBJ1-1
TGTGCCAGCAGCCGGCCCCAGGGGGCGCGTTATGGCTACACCTTC	CASSRPQGARYGYTF	TRBV3-1	TRBJ1-2
TGCGCCAGCAGCTTGACCCGGCGCGGGAATGAGCAGTTCTTC	CASSLTRRGNEQFF	TRBV5-1	TRBJ2-1
TGTGCCACCAGCAGAGTCGGGCCGGGGCGAGGTGGTAATCAGCCCCAGCATTTT	CATSRVGPGRGGNQPQHF	TRBV15	TRBJ1-5
TGTGCCATCGCCAGGGCGGTCTCTGGGGCCAACGTCCTGACTTTC	CAIARAVSGANVLTF	TRBV10-3	TRBJ2-6
TGTGCCACCCGCCTCCCTTACAGGGGCTTTGCAACTAATGAAAAACTGTTTTTT	CATRLPYRGFATNEKLFF	TRBV19	TRBJ1-4
TGTGCCAGCAGCTATCGGGGTGGGAACACCGGGGAGCTGTTTTTT	CASSYRGGNTGELFF	TRBV7-9	TRBJ2-2
TGTGCCAGCCGACCGGGCTTACCGCAAGGTAACTATGGCTACACCTTC	CASRPGLPQGNYGYTF	TRBV6-5	TRBJ1-2
TGCGCCAGCAGCTTGGCCAGGATCAGGCGGGGCAGGGACGTCCCATTACTAGCCAAAAACATTCAGTACTTC	CASSLARIRRGRDVPLLAKNIQYF	TRBV5-1	TRBJ2-4
TGTGCCAGCAGCCAAGATTTGGACAGGAATACAGACCCGGGGGAGACCCAGTACTTC	CASSQDLDRNTDPGETQYF	TRBV3-1	TRBJ2-5
TGTGCCAGCAGAGGTCCTAGGCGTCAGGACCGGGATACGCAGTATTTT	CASRGPRRQDRDTQYF	TRBV5-4	TRBJ2-3
