TGCAGTGCTAGGACCCGACAGGGAGGGGAGACCCAGTACTTC	CSARTRQGGETQYF	TRBV20-1	TRBJ2-5
TGTGCCAGCAGAAAGAAGCCGTACGAGCAGTACTTC	CASRKKPYEQYF	TRBV6-5	TRBJ2-7
TGTGCCATCAAAGGGGATGTTGCCAGGAGAGGAAGTAATGAAAAACTGTTTTTT	CAIKGDVARRGSNEKLFF	TRBV10-3	TRBJ1-4
TGTGCCAGTTCCTTAAGTCAGGGTTTGGGTAACTATGGCTACACCTTC	CASSLSQGLGNYGYTF	TRBV19	TRBJ1-2
TGTGCCAGCGTGGAGTCGGAGCAGTACTTC	CASVESEQYF	TRBV6-5	TRBJ2-7
TGTGCCAGCAGCGAGGGTTCCAATCAGCCCCAGCATTTT	CASSEGSNQPQHF	TRBV7-3	TRBJ1-5
TGTGCCCCCTTCCTCTCCTTTGTTAACACTGAAGCTTTCTTT	CAPFLSFVNTEAFF	TRBV27	TRBJ1-1
TGCAGTGCCCATATTCCGACTAGCGGGCTTGGCTACGAGCAGTACTTC	CSAHIPTSGLGYEQYF	TRBV20-1	TRBJ2-7
TGTGCCAGCATCCCCGGGACTAGCGGACTAGAGCAGTACTTC	CASIPGTSGLEQYF	TRBV6-1	TRBJ2-7
TGTGCCAGCGAGGGGGGGTACTTC	CASEGGYF	TRBV28	TRBJ2-7
TGCGCCAGCAGCCAGGAAAACAGGCCGCCCCAGCATTTT	CASSQENRPPQHF	TRBV4-3	TRBJ1-5
TGCAGTGCTAGATTCGAAGGCGGGACAGGGCCCCAGTGCACCTACGAGCAGTACTTC	CSARFEGGTGPQCTYEQYF	TRBV20-1	TRBJ2-7
TGTGCCAGCTCACCACTTGGGACGGGACTGGATACGCAGTATTTT	CASSPLGTGLDTQYF	TRBV18	TRBJ2-3
TGCGCCAGCCCTTCGTGGGCCCGCAATCAGCCCCAGCATTTT	CASPSWARNQPQHF	TRBV10-1	TRBJ1-5
TGTGCCATCTCTAAGGGAACAGGGCTTATATCCTCTGGAAACACCATATATTTT	CAISKGTGLISSGNTIYF	TRBV18	TRBJ1-3
TGTGCCAGCAGGATTCATGACCGGCCAAAAGAGACCCAGTACTTC	CASRIHDRPKETQYF	TRBV12-3	TRBJ2-5
TGTGCCAGCAGTGGACTAGTGGGAGATGAGCAGTTCTTC	CASSGLVGDEQFF	TRBV6-4	TRBJ2-1
TGTGCCACCAGTGATTTGCAATCCTACAGACGGGGGCGACACGAGCAGTACTTC	CATSDLQSYRRGRHEQYF	TRBV24-1	TRBJ2-7
TGTGCCAGCAGTGGGGGAGTGGGCAATCAGCCCCAGCATTTT	CASSGGVGNQPQHF	TRBV6-4	TRBJ1-5
TGTGCCAGCAGAAGGAAGTTTCGGGGGGGTCGTGTTGAGGGGGTTGGCACAGATACGCAGTATTTT	CASRRKFRGGRVEGVGTDTQYF	TRBV6-1	TRBJ2-3
TGTGCCAGCGGGTCAGCCGGCTCTGGAAACACCATATATTTT	CASGSAGSGNTIYF	TRBV13	TRBJ1-3
TGCGCCAGCAGCTTGCCTGCGGGACTACGAATGAAGGAGACCCAGTACTTC	CASSLPAGLRMKETQYF	TRBV5-1	TRBJ2-5
TGTGCCAGCAGCTTAGGAAGGACAGGAGGAGCGTTCTACGAGCAGTACTTC	CASSLGRTGGAFYEQYF	TRBV7-9	TRBJ2-7
TGTGCCAGCAGCGCCCCTCATGAAAAACTGTTTTTT	CASSAPHEKLFF	TRBV7-2	TRBJ1-4
TGTGCCAGCAGTGACTCGGGAGGCCTCGCCTACGAGCAGTACTTC	CASSDSGGLAYEQYF	TRBV6-4	TRBJ2-7
TGTGCCAGCAGCCAGGGGGGTACTGAAGCTTTCTTT	CASSQGGTEAFF	TRBV7-2	TRBJ1-1
TGTGCCAGCAGTTCAATGGCAAACTTTTCGAATTCACCCCTCCACTTT	CASSSMANFSNSPLHF	TRBV6-5	TRBJ1-6
TGTGCCAGCAGTGAACAGAGAGACTCTGGGGCCAACGTCCTGACTTTC	CASSEQRDSGANVLTF	TRBV25-1	TRBJ2-6
TGTGCCAGCAGAATGGCCGCCCCCCGCCCCACAGGGGCCTCTGGGGCCAACGTCCTGACTTTC	CASRMAAPRPTGASGANVLTF	TRBV25-1	TRBJ2-6
TGCGCCAGCAGGGGGCCTCAGGGGATTAACACCGGGGAGCTGTTTTTT	CASRGPQGINTGELFF	TRBV10-1	TRBJ2-2
TGTGCCAGCAGTTTAGTTACGAGGACAGGGGGAGCAACTAATGAAAAACTGTTTTTT	CASSLVTRTGGATNEKLFF	TRBV28	TRBJ1-4
TGTGCCAGCAGTGAACAATGGCCTAGCGGGGTAAGCACAGATACGCAGTATTTT	CASSEQWPSGVSTDTQYF	TRBV2	TRBJ2-3
TGCAGTAAGCCGGGACTAGCGGGGGCCCGGAACACCGGGGAGCTGTTTTTT	CSKPGLAGARNTGELFF	TRBV20-1	TRBJ2-2
TGTGCCACCAGCAGGTGGACCAACGAGCAGTACTTC	CATSRWTNEQYF	TRBV15	TRBJ2-7
TGCGCCAGCAGCCTGACCCGGGACTCGCAGTTCTTC	CASSLTRDSQFF	TRBV4-3	TRBJ2-1
TGTGCCAGCAGCCCCCCTAGCGGGCACCAAACGTACAATGAGCAGTTCTTC	CASSPPSGHQTYNEQFF	TRBV13	TRBJ2-1
TGTGCCAGCAGCGTAGGTTCCGGGACGGAGGATGAGCAGTTCTTC	CASSVGSGTEDEQFF	TRBV9	TRBJ2-1
TGTGCCATCCCCCGTACATGGGAACTAGCGGGAGGATCCTACGAGCAGTACTTC	CAIPRTWELAGGSYEQYF	TRBV19	TRBJ2-7
TGCGCCAGCAGCTTGTTAGACGACACTGAAGCTTTCTTT	CASSLLDDTEAFF	TRBV5-1	TRBJ1-1
TGCGCCAGCAGCTCGGGGGACAGGTCCCCGGGTTATGGCTACACCTTC	CASSSGDRSPGYGYTF	TRBV5-1	TRBJ1-2
TGTGCCAGCAGCGTAGCCGGTCCGGGACAGGGGGGAAGCTCCTACAATGAGCAGTTCTTC	CASSVAGPGQGGSSYNEQFF	TRBV9	TRBJ2-1
TGCGCCAGCGTCTTGAGGACAGTCGGAAGCCGGGACGTTGGGTACGAGCAGTACTTC	CASVLRTVGSRDVGYEQYF	TRBV10-1	TRBJ2-7
TGTGCCAGCAGCCTTGAGGCAGGGCTCGTTGGGGCCAACGTCCTGACTTTC	CASSLEAGLVGANVLTF	TRBV14	TRBJ2-6
TGTGCCAGCAGCAGACAGGGGAGCAATCAGCCCCAGCATTTT	CASSRQGSNQPQHF	TRBV13	TRBJ1-5
TGTGCCAGCAGCCAAGCGGACAGATACGAGCAGTACTTC	CASSQADRYEQYF	TRBV14	TRBJ2-7
TGCGCCAGCAGCCCGGGGAATGGCACAGATACGCAGTATTTT	CASSPGNGTDTQYF	TRBV4-1	TRBJ2-3
TGTGCCAGAAAGGGGCGTGACCCCTTCAATAATGAAAAACTGTTTTTT	CARKGRDPFNNEKLFF	TRBV6-6	TRBJ1-4
TGTGCCTGGAGTTCAGATAGGGGGCAGGAAGGGCCCCAGCATTTT	CAWSSDRGQEGPQHF	TRBV30	TRBJ1-5
TGTGCCAGCAGCTTAGCGGGAACTGAAGCTTTCTTT	CASSLAGTEAFF	TRBV7-9	TRBJ1-1
TGTGCCAGCCAACGGGAGGCCTACGAGCAGTACTTC	CASQREAYEQYF	TRBV13	TRBJ2-7
TGTGCCAGCAGTGCCCCGGACAGGACCCCCACTGAAGCTTTCTTT	CASSAPDRTPTEAFF	TRBV2	TRBJ1-1
TGCGCCAGGGCAAAAGGACAGGGGGCACAGGGTATACGGCAGCCCCAGCATTTT	CARAKGQGAQGIRQPQHF	TRBV5-1	TRBJ1-5
TGTGCCAGCAGTTTGGGTGCTAGCTCCTACAATGAGCAGTTCTTC	CASSLGASSYNEQFF	TRBV28	TRBJ2-1
TGTGCCAGCAGTGATCCGAGGGAGCCCCCGGACTATGGCTACACCTTC	CASSDPREPPDYGYTF	TRBV25-1	TRBJ1-2
TGTGCCAGCAGCACAACGCTAGCGGGGGCCACCGAGCAGTACTTC	CASSTTLAGATEQYF	TRBV7-3	TRBJ2-7
TGTGCTAGTGGTGCGGGGGGATATAGCAATCAGCCCCAGCATTTT	CASGAGGYSNQPQHF	TRBV12-5	TRBJ1-5
TGTGCTAGTGGTTCGTGGAGGGACAGTTTAAATGAAAAACTGTTTTTT	CASGSWRDSLNEKLFF	TRBV12-5	TRBJ1-4
TGTGCCAGCAGCCTGGGACAGGGGGTTAGGGGGAACGAGCAGTACTTC	CASSLGQGVRGNEQYF	TRBV3-1	TRBJ2-7
TGTGCCGGTGGGTACCTTTTAAGTCATGGGGTAGAGACCCAGTACTTC	CAGGYLLSHGVETQYF	TRBV24-1	TRBJ2-5
TGTGCCAGGTCGACAGATACGCAGTATTTT	CARSTDTQYF	TRBV2	TRBJ2-3
TGCGCCAGCAGCTACTATTTAGGCACAGATACGCAGTATTTT	CASSYYLGTDTQYF	TRBV4-3	TRBJ2-3
TGTGCCAGCAGTTTTAACAGATGGCAAGCGGGTGAGACCCAGTACTTC	CASSFNRWQAGETQYF	TRBV27	TRBJ2-5
TGTGCCAGCACCTCTTCAGCCGTTTCCCAGCATTTT	CASTSSAVSQHF	TRBV6-4	TRBJ1-5
TGTGCCAGCAGTAATAAGGGGACCGGGGAGCTGTTTTTT	CASSNKGTGELFF	TRBV27	TRBJ2-2
TGCAGTGCTAGAAACCCTGCAGGCCTAAGGAACACTGAAGCTTTCTTT	CSARNPAGLRNTEAFF	TRBV20-1	TRBJ1-1
TGTGCCAGCACAGGGGGGCGCGGGCGGGTTGAAGGCTACACCTTC	CASTGGRGRVEGYTF	TRBV5-6	TRBJ1-2
TGTGCCATCAGTGAGTCTACTTCCACGTTAAAATGGGACAGGGGGGAAAAACTGTTTTTT	CAISESTSTLKWDRGEKLFF	TRBV10-3	TRBJ1-4
TGTGCCAGCTCACCGTTTCAAAATCCGGGACCCTCCTACGAGCAGTACTTC	CASSPFQNPGPSYEQYF	TRBV18	TRBJ2-7
TGTGCCAGCAACAGGGGTCGTACCGAAAAACTGTTTTTT	CASNRGRTEKLFF	TRBV12-3	TRBJ1-4
TGTGCCAGCAGCCAATCAAGGCGCGGGAGCTCTGGAAACACCATATATTTT	CASSQSRRGSSGNTIYF	TRBV3-1	TRBJ1-3
TGTGCCAGCAGCTTGAACCAGAATCAGCCCCAGCATTTT	CASSLNQNQPQHF	TRBV5-4	TRBJ1-5
TGTGCCAGCAGCATACACAGGGTTGGAAGAATCGATCAGCCCCAGCATTTT	CASSIHRVGRIDQPQHF	TRBV7-3	TRBJ1-5
TGTGCCAACGAGGGCCTTTCGCCCCACAATCAGCCCCAGCATTTT	CANEGLSPHNQPQHF	TRBV12-4	TRBJ1-5
TGTGCCAGCAGCCCGACAAAGGTTTCACCCCTCCACTTT	CASSPTKVSPLHF	TRBV7-3	TRBJ1-6
TGCAGCGTATGCACGAACACTGAAGCTTTCTTT	CSVCTNTEAFF	TRBV29-1	TRBJ1-1
TGTGCCAGCAGCTTAGATTGTGGGGGGTGCCGGATGAACACTGAAGCTTTCTTT	CASSLDCGGCRMNTEAFF	TRBV11-3	TRBJ1-1
TGTGCCAGGTGGGGACAGGGCTCGACCCAGCATTTT	CARWGQGSTQHF	TRBV19	TRBJ1-5
TGTGCCATCATCGGAGGAGGCTACACCTTC	CAIIGGGYTF	TRBV10-3	TRBJ1-2
TGTGCCAGCAGTTTAGGCGGGCGGGAGCGAAACAATGAGCAGTTCTTC	CASSLGGRERNNEQFF	TRBV28	TRBJ2-1
TGCGCCAGCAGCTTGGCCGAATCTAATTCAGCCCTCCACTTT	CASSLAESNSALHF	TRBV5-1	TRBJ1-6
TGTGCCAGCAGCTACCGTAGACGAGGTTGGTCCGAAAAACTGTTTTTT	CASSYRRRGWSEKLFF	TRBV11-3	TRBJ1-4
TGCGCCAAGAAGGGGGGTCCTGAAAAACTGTTTTTT	CAKKGGPEKLFF	TRBV10-1	TRBJ1-4
TGTGCCAGCAGGGGGGATAGTTTCGTCTTC	CASRGDSFVF	TRBV6-1	TRBJ2-1
TGTGCCAGCAGTTGGGGGAGCTCCTATAATTCACCCCTCCACTTT	CASSWGSSYNSPLHF	TRBV12-3	TRBJ1-6
TGTGCCAGCAGCTTAGATGTCCGGGGGGCGGACGAGCAGTACTTC	CASSLDVRGADEQYF	TRBV11-2	TRBJ2-7
TGCGCCAGCAGCTTGCTTAGGGTACATAGCAATCAGCCCCAGCATTTT	CASSLLRVHSNQPQHF	TRBV5-1	TRBJ1-5
TGTGCCAGCAGCTGTAGGACTAGCGGGCCCTACTTC	CASSCRTSGPYF	TRBV7-6	TRBJ2-4
TGCGCCAGCAGCCAAGATACAGGGTTGGGCTCCTACGAGCAGTACTTC	CASSQDTGLGSYEQYF	TRBV4-3	TRBJ2-7
TGCGCCAGCACGCAGGGAGGGAGGACCGGGGAGCTGTTTTTT	CASTQGGRTGELFF	TRBV10-2	TRBJ2-2
TGTGCCACGGGAGCCGACAGCGGCTCTGGGGCCAACGTCCTGACTTTC	CATGADSGSGANVLTF	TRBV6-5	TRBJ2-6
TGCGCCAGCAGCCCGCAAAACCCCGTGGTCCCAGGGGAAGGTCTAGCCAAAAACATTCAGTACTTC	CASSPQNPVVPGEGLAKNIQYF	TRBV5-1	TRBJ2-4
TGTGCCAGCAGCATCTCCCCGGGACAGGGAGATACGCAGTATTTT	CASSISPGQGDTQYF	TRBV5-8	TRBJ2-3
TGTGCCACCAGTGCCGGGGACAGGGGGTCACGCCATCAGCCCCAGCATTTT	CATSAGDRGSRHQPQHF	TRBV24-1	TRBJ1-5
TGTGCCAGCAGCAGGGCCATTACCAATTCACCCCTCCACTTT	CASSRAITNSPLHF	TRBV9	TRBJ1-6
TGTGCCGGAGACAGGACGGCCCACTATGGCTACACCTTC	CAGDRTAHYGYTF	TRBV10-3	TRBJ1-2
TGTGCCAGCAGCTTAGACGGGGGACTAGTACCCGGGGAGCTGTTTTTT	CASSLDGGLVPGELFF	TRBV11-3	TRBJ2-2
TGTGCCAGCAGCAAGTTTCGCTGTACGGGGAATCAGCCCCAGCATTTT	CASSKFRCTGNQPQHF	TRBV9	TRBJ1-5
TGCGCCAGCATGGGGGTCGTATGGATCGAAAAACTGTTTTTT	CASMGVVWIEKLFF	TRBV10-1	TRBJ1-4
TGTGCCAGTATGGTTCGGACAGGGTTCAGGCAGCCCCAGCATTTT	CASMVRTGFRQPQHF	TRBV19	TRBJ1-5
TGTGCCAGCAGCCAATCGCTTCTAGCGGGGGGGCCGTCCAGCACAGATACGCAGTATTTT	CASSQSLLAGGPSSTDTQYF	TRBV14	TRBJ2-3
TGTGCCAGCAGCTTAGAGCTCGGGGGACGGAGTTGGCCCCAGCATTTT	CASSLELGGRSWPQHF	TRBV7-4	TRBJ1-5
TGTGCCACCAGTGAAGTTGGTCCCGATAGCGGCGACAGGAATGAGCAGTTCTTC	CATSEVGPDSGDRNEQFF	TRBV24-1	TRBJ2-1
TGTGCCAGCAGTTTATCAGCGGGAGATGTTACGACTGAAATCTACGAGCAGTACTTC	CASSLSAGDVTTEIYEQYF	TRBV28	TRBJ2-7
TGTGCCAGCAGCTCCGGTCGGGGAAAGGGCTACCGCTATGGCTACACCTTC	CASSSGRGKGYRYGYTF	TRBV7-9	TRBJ1-2
TGCAGTGGTAGAATCTGGTGTCCGACCCAGTACTTC	CSGRIWCPTQYF	TRBV20-1	TRBJ2-5
TGTGCCAGCAGTGGTGCTGAAAGGCGCGAAGACACTGAAGCTTTCTTT	CASSGAERREDTEAFF	TRBV25-1	TRBJ1-1
TGCGCCAGCAGTGACCGGGACTCCTTGACTGAAGCTTTCTTT	CASSDRDSLTEAFF	TRBV10-1	TRBJ1-1
TGCGCCAGCAGCCAAGAAGGACAGACGGGTGAAAAACTGTTTTTT	CASSQEGQTGEKLFF	TRBV4-1	TRBJ1-4
TGTGCCACCAGTGATTTCCCGTACAGGGGGCAGTTCGAGCAGTACTTC	CATSDFPYRGQFEQYF	TRBV24-1	TRBJ2-7
TGTGCCAGCCCGGACAGGGGGCATAGTCATACGCAGTATTTT	CASPDRGHSHTQYF	TRBV27	TRBJ2-3
TGTGCCAGCAGTTCGCAGGGCAACAATGAGCAGTTCTTC	CASSSQGNNEQFF	TRBV5-4	TRBJ2-1
TGTGCCAGCAGTGACCGCCCGGGACAGGGGGGGAGTCAGCCCCAGCATTTT	CASSDRPGQGGSQPQHF	TRBV6-4	TRBJ1-5
TGTGCCAGCAGCCGCCGATTGTCCAGGTCCTACGAGCAGTACTTC	CASSRRLSRSYEQYF	TRBV27	TRBJ2-7
TGTGCCATCAGCAGACTTCCCCCGGACAGGGGGTCTGAAGCTTTCTTT	CAISRLPPDRGSEAFF	TRBV10-3	TRBJ1-1
TGTGCCAGCACAGGGGGGAAAGATCAGCCCCAGCATTTT	CASTGGKDQPQHF	TRBV25-1	TRBJ1-5
TGTGCCAGCAGTCTCCTTAGACAGCGTTGGGGAAACACCATATATTTT	CASSLLRQRWGNTIYF	TRBV27	TRBJ1-3
TGTGCCACCAGTGATCCGGGTCCAGGGGCTAACTATGGCTACACCTTC	CATSDPGPGANYGYTF	TRBV24-1	TRBJ1-2
TGTGCCAGCAGGGAACGGTATTACGAGCAGTACTTC	CASRERYYEQYF	TRBV6-1	TRBJ2-7
TGTGCCAGCAGCCAAGAAAGGTTGAACAATGAGCAGTTCTTC	CASSQERLNNEQFF	TRBV14	TRBJ2-1
TGTGCCAGCATGCAGTGTTGGGATCAGCCCCAGCATTTT	CASMQCWDQPQHF	TRBV14	TRBJ1-5
TGTGCTAGCAGCTTATGCTGTGATACGGTCTGGTGCACTGAAGCTTTCTTT	CASSLCCDTVWCTEAFF	TRBV7-7	TRBJ1-1
TGTGCCAGCAGCCCACAGGGCTATGGCTACACCTTC	CASSPQGYGYTF	TRBV7-3	TRBJ1-2
TGTGCCAGCAGTTTCAGGCTGTCTAGCACAGATACGCAGTATTTT	CASSFRLSSTDTQYF	TRBV27	TRBJ2-3
TGTGCCAGCAGCTTAAGGGGTAGCCCCTACGAGCAGTACTTC	CASSLRGSPYEQYF	TRBV11-3	TRBJ2-7
TGTGCCAGCAGCCACCCACAGGCGGTAAATTCACCCCTCCACTTT	CASSHPQAVNSPLHF	TRBV14	TRBJ1-6
TGCAGTGCTAGAGTGGCGACACTAGCCGAGCAGTACTTC	CSARVATLAEQYF	TRBV20-1	TRBJ2-7
TGTGCCAGCAGCAACCGACGAGGGAGGTCCGGGGAGCTGTTTTTT	CASSNRRGRSGELFF	TRBV7-9	TRBJ2-2
TGTGCCTGGAGTCAGGGACGACTAATGACCCAGTACTTC	CAWSQGRLMTQYF	TRBV30	TRBJ2-5
TGTGCCACCAGTGATCAGGGGGCTTTCTTT	CATSDQGAFF	TRBV24-1	TRBJ1-1
TGTGCCAGTAGTAGTGCACGACTAGCGGGCTGCTACAATGAGCAGTTCTTC	CASSSARLAGCYNEQFF	TRBV19	TRBJ2-1
TGTGCCAGCAGAAATCGGGGGGGAAATGAAAAACTGTTTTTT	CASRNRGGNEKLFF	TRBV12-4	TRBJ1-4
TGTGCCAGCAGCCCCGACACACAGGCGTCTCCTGAAGCTTTCTTT	CASSPDTQASPEAFF	TRBV7-6	TRBJ1-1
TGTGCCAGCAGCTCTGGCAGGGGTGTTGCCTACGAGCAGTACTTC	CASSSGRGVAYEQYF	TRBV11-2	TRBJ2-7
TGTGCCAGCAGGGGGGGACAGGGGGCCGGCAATCAGCCCCAGCATTTT	CASRGGQGAGNQPQHF	TRBV5-6	TRBJ1-5
TGTGCCAGCCCGGGACAGGGTGTAGGGTATGGCTACACCTTC	CASPGQGVGYGYTF	TRBV6-3	TRBJ1-2
TGTGCCTGGAGTGCGTCCCCTTTCGACAGGCAGCCCCAGCATTTT	CAWSASPFDRQPQHF	TRBV30	TRBJ1-5
TGTGCCAGCAGTTACGGGACAACTTTGTTGACCCAGTACTTC	CASSYGTTLLTQYF	TRBV6-5	TRBJ2-5
TGTGCCTGGAGCCGCTACCTAGCGGGAGGAGATGAGCAGTTCTTC	CAWSRYLAGGDEQFF	TRBV30	TRBJ2-1
TGTGCCAGCAGAGATCCCCCCCCGGGCGGCGAGCAGTACTTC	CASRDPPPGGEQYF	TRBV12-3	TRBJ2-7
TGTGCCAGCAGCTTCCCGGGACTAGCGGGGTCCTACAATGAGCAGTTCTTC	CASSFPGLAGSYNEQFF	TRBV5-8	TRBJ2-1
TGCGCCAGCAGCTTGAACCAAGGATACACAGATACGCAGTATTTT	CASSLNQGYTDTQYF	TRBV5-1	TRBJ2-3
TGTGCCAGCAGAACCCGGGACAACAAGGGCAATGAGCAGTTCTTC	CASRTRDNKGNEQFF	TRBV2	TRBJ2-1
TGTGCCAGCAGCTTCTTCCGGGACAGGGCGGGGAGCAATCAGCCCCAGCATTTT	CASSFFRDRAGSNQPQHF	TRBV5-4	TRBJ1-5
TGTGCCAGCAGCGATCAGGGGAGTTGCAATCAGCCCCAGCATTTT	CASSDQGSCNQPQHF	TRBV7-3	TRBJ1-5
TGTGCCAGCAGCTTACCGATACAGGGGAACACTGAAGCTTTCTTT	CASSLPIQGNTEAFF	TRBV7-2	TRBJ1-1
TGTGCCAGTAGTTTGCAGTGTGGCTACACCTTC	CASSLQCGYTF	TRBV19	TRBJ1-2
TGTGCCAGGTCCGGGGAGCCTACTCAGCCGGAGACCCAGTACTTC	CARSGEPTQPETQYF	TRBV25-1	TRBJ2-5
TGCAGTGCTCTGGGGACAGACTGCACAGATACGCAGTATTTT	CSALGTDCTDTQYF	TRBV20-1	TRBJ2-3
TGTGCCAGCAGTAGTCCATGGAGGGTCCCCCAAGAGACCCAGTACTTC	CASSSPWRVPQETQYF	TRBV6-6	TRBJ2-5
TGTGCCAGCATTGGACAGGGAGCTTTCTTT	CASIGQGAFF	TRBV12-3	TRBJ1-1
TGTGCCAGCAGCCGGCCGGGACTAGGTAGCTCCTACGAGCAGTACTTC	CASSRPGLGSSYEQYF	TRBV5-8	TRBJ2-7
TGTGCCAGCCTTCGTCAGAGGCCCGAAAATAGCAATCAGCCCCAGCATTTT	CASLRQRPENSNQPQHF	TRBV6-4	TRBJ1-5
TGTGCCAGCAGCTTAAAATCGGACAGGATGAACACTGAAGCTTTCTTT	CASSLKSDRMNTEAFF	TRBV7-3	TRBJ1-1
TGCGCCAGCAGCCAAGTTCCTTGTAGCGGGATGATATACTCCTACGAGCAGTACTTC	CASSQVPCSGMIYSYEQYF	TRBV4-3	TRBJ2-7
TGCGCCAGCAGCTTTGGGGGACAGAGCTCCTACGAGCAGTACTTC	CASSFGGQSSYEQYF	TRBV5-1	TRBJ2-7
TGTGCCAGCATAGGGACGCAAGAGACCCAGTACTTC	CASIGTQETQYF	TRBV12-3	TRBJ2-5
TGTGCCAGCAGCCTCGGGGTTAGTCTCTCTGGGGCCAACGTCCTGACTTTC	CASSLGVSLSGANVLTF	TRBV5-4	TRBJ2-6
TGTGCCAGCAGCCAGGACTACATCACTAGCCAAGGACGCTCCTACAATGAGCAGTTCTTC	CASSQDYITSQGRSYNEQFF	TRBV3-1	TRBJ2-1
TGTGCCACCAGTTTACGTGGACTCAGGGGGGTTTCTACTGGAAACACCATATATTTT	CATSLRGLRGVSTGNTIYF	TRBV24-1	TRBJ1-3
TGTGCCAGCAGTTACTCAGCACAGGGAGTATGGGGAAACACCATATATTTT	CASSYSAQGVWGNTIYF	TRBV6-5	TRBJ1-3
TGTGCCAGCAGTTACGTAGACGGCCCAGCCGGGGAGCTGTTTTTT	CASSYVDGPAGELFF	TRBV6-5	TRBJ2-2
TGTGCCAGCAGCGGGCCCTCCCGCACTGAAGCTTTCTTT	CASSGPSRTEAFF	TRBV13	TRBJ1-1
TGTGCTAGTGGTTTGCAAGGCATAGCTAACTATGGCTACACCTTC	CASGLQGIANYGYTF	TRBV12-5	TRBJ1-2
TGTGCCAGCAGCTTGAGGTCTCTTCACAGGGTAATAGGGAAATACACTAGAAAGGAGAACACTGAAGCTTTCTTT	CASSLRSLHRVIGKYTRKENTEAFF	TRBV5-6	TRBJ1-1
TGCGCCAGCAGCCATCTGACAGGGGCAACGAACACCGGGGAGCTGTTTTTT	CASSHLTGATNTGELFF	TRBV4-3	TRBJ2-2
TGCAGCGTTGAAGTCCGGGACAGGGGATTATATGGCTACACCTTC	CSVEVRDRGLYGYTF	TRBV29-1	TRBJ1-2
TGTGCCAGCAGTGAAGACTGTTCAGGGGGTTATAAAAGGAACACTGAAGCTTTCTTT	CASSEDCSGGYKRNTEAFF	TRBV6-1	TRBJ1-1
TGCAGCGTTGGGACAGACCCTAATGAAAAACTGTTTTTT	CSVGTDPNEKLFF	TRBV29-1	TRBJ1-4
TGCAGTGCTAGACGGGCGGGCTACACCTTC	CSARRAGYTF	TRBV20-1	TRBJ1-2
TGTGCCAGCAGCACGGGGTATGAGCAGTTCTTC	CASSTGYEQFF	TRBV7-4	TRBJ2-1
TGTGCCAGCAGTTTACGCAGGGGTCTTACCTACGAGCAGTACTTC	CASSLRRGLTYEQYF	TRBV28	TRBJ2-7
TGTGCCCGAGACGAGGCGTGCTCCTACGAGCAGTACTTC	CARDEACSYEQYF	TRBV10-3	TRBJ2-7
TGTGCCAGCAGCTCGTTCCCCCCTGGAGAGTCGAGCTCCTACGAGCAGTACTTC	CASSSFPPGESSSYEQYF	TRBV11-2	TRBJ2-7
TGTGCCAGCAGTTTAGAACGACAGGGGCCGGGTGCGAGCTCCTACGAGCAGTACTTC	CASSLERQGPGASSYEQYF	TRBV27	TRBJ2-7
TGTGCCAGCAGTTCCGAGGGTCACTCTGAGCAGTTCTTC	CASSSEGHSEQFF	TRBV27	TRBJ2-1
TGTGCCAGCAGCCAAGACCCCGGGGGGCCTGCATACAATGAGCAGTTCTTC	CASSQDPGGPAYNEQFF	TRBV3-1	TRBJ2-1
TGTGCCAGCAGCACCAGGGGGCCGGGACGGGGTTACTACGAGCAGTACTTC	CASSTRGPGRGYYEQYF	TRBV7-9	TRBJ2-7
TGCAGTGCTAGGCCTGGTTTGGGAGGGGGCCCGACTGAAGCTTTCTTT	CSARPGLGGGPTEAFF	TRBV20-1	TRBJ1-1
TGTGCCAGCAGCCAGGCGGGGGGGGCAAGCGAGCAGTACTTC	CASSQAGGASEQYF	TRBV14	TRBJ2-7
TGTGCCAGCGCCCCCGAACCAACAGGGGAAAATGAGCAGTTCTTC	CASAPEPTGENEQFF	TRBV12-4	TRBJ2-1
TGTGCCAGCAGTGGGACGGACAATACGCAGTATTTT	CASSGTDNTQYF	TRBV6-3	TRBJ2-3
TGCGCCAGCGACCGGACTGGTCCGTGGAACACTGAAGCTTTCTTT	CASDRTGPWNTEAFF	TRBV5-1	TRBJ1-1
TGTGCCTGGAGGGTGGACGCGTTTGCAACTAATGAAAAACTGTTTTTT	CAWRVDAFATNEKLFF	TRBV30	TRBJ1-4
TGCGCCAGCAGCCAAGGGCCCCGTCATCGGGACAGGGATAGCAATCAGCCCCAGCATTTT	CASSQGPRHRDRDSNQPQHF	TRBV4-1	TRBJ1-5
TGTGCCAGCAGCGCTAAGGGACATACCTATGGCTACACCTTC	CASSAKGHTYGYTF	TRBV12-4	TRBJ1-2
TGTGCCATCAGTGGAAGACAGGGGGCGGAGAGCAATCAGCCCCAGCATTTT	CAISGRQGAESNQPQHF	TRBV10-3	TRBJ1-5
TGTGCCAGCAGTGAAGACGATTCGGACAGAGACGAAGCTTTCTTT	CASSEDDSDRDEAFF	TRBV6-4	TRBJ1-1
TGTGCCAGCAGCCAAGATGGAAATGTGGGACACTACTATGGCTACACCTTC	CASSQDGNVGHYYGYTF	TRBV3-1	TRBJ1-2
TGTGCCAGCAGCTTAAGGCGCTGCGGGACAGTAGCCTATGAAAAACTGTTTTTT	CASSLRRCGTVAYEKLFF	TRBV7-3	TRBJ1-4
TGTGCCAGCAGCTTAGGACCCCCCATGCGGAATGCCTATGGCTACACCTTC	CASSLGPPMRNAYGYTF	TRBV11-2	TRBJ1-2
TGTGCCAGCAGCAGGTCCTGCAATCAGCCCCAGCATTTT	CASSRSCNQPQHF	TRBV7-7	TRBJ1-5
TGTGCCAGCAGTGACTCGACCTGGGACAGCCTTGAAGCTTTCTTT	CASSDSTWDSLEAFF	TRBV6-4	TRBJ1-1
TGTGCCAGCAGAACAGGGTCGCGCTACGAGCAGTACTTC	CASRTGSRYEQYF	TRBV6-5	TRBJ2-7
TGTGCCACCGGGGAAAGCGACAGTTTTCTAGAGCAGTACTTC	CATGESDSFLEQYF	TRBV15	TRBJ2-7
TGTGCCTTAAGGGGGGGCGAAGTCGAGACCCAGTACTTC	CALRGGEVETQYF	TRBV30	TRBJ2-5
TGTGCCAGCAGTTTAGCGGAATCAGATACGCAGTATTTT	CASSLAESDTQYF	TRBV27	TRBJ2-3
TGCGCCAGCAGCACAGGGCGCACAGATACGCAGTATTTT	CASSTGRTDTQYF	TRBV5-1	TRBJ2-3
TGTGCCAGCAGCACGAGGGGTCTGACCTACAATGAGCAGTTCTTC	CASSTRGLTYNEQFF	TRBV7-4	TRBJ2-1
TGTGCCAGCAGCTTAGCCTGGTCTAACTATGGCTACACCTTC	CASSLAWSNYGYTF	TRBV7-2	TRBJ1-2
TGCGCCAGCAGCCCCTTGTCCGGGACAGGCCTAGATTCACCCCTCCACTTT	CASSPLSGTGLDSPLHF	TRBV5-1	TRBJ1-6
TGTGCCTGGAGTCGCGGAGACACCAGCTCCTATAATTCACCCCTCCACTTT	CAWSRGDTSSYNSPLHF	TRBV30	TRBJ1-6
TGTGCCAGCAGCAAATCACTTTATGGCTACACCTTC	CASSKSLYGYTF	TRBV11-2	TRBJ1-2
TGTGCCAGCAGCGTCGGGACCCGGGACAGGGAAGAAGAGACCCAGTACTTC	CASSVGTRDREEETQYF	TRBV9	TRBJ2-5
TGCAGCGTTGAAAGGGAACAGGGGAGGGCAGATACGCAGTATTTT	CSVEREQGRADTQYF	TRBV29-1	TRBJ2-3
TGTGCCAGCAGCTTAGCGGAGGGGGACAGGGGAACCGGTAACTATGGCTACACCTTC	CASSLAEGDRGTGNYGYTF	TRBV7-8	TRBJ1-2
TGTGCCACAACGATGGGGGCCGGGGAGCTGTTTTTT	CATTMGAGELFF	TRBV24-1	TRBJ2-2
TGTGCCAGCAGCCAAGAAACAGGGGGCCCGACCTACGAGCAGTACTTC	CASSQETGGPTYEQYF	TRBV14	TRBJ2-7
TGCAGTGCCCATATTACGGCGAGTGAGCAGTTCTTC	CSAHITASEQFF	TRBV20-1	TRBJ2-1
TGCAGTGCTCAAAAGATGACGGGACTAGAGACAGAGCAGTACTTC	CSAQKMTGLETEQYF	TRBV20-1	TRBJ2-7
TGCGCCAGCAGCTCCCCTAGCGGGAAGAACATTCAGTACTTC	CASSSPSGKNIQYF	TRBV5-1	TRBJ2-4
TGTGCCAGCAGTGAGGGGGTAGGGACATTAAGCTCCTACAATGAGCAGTTCTTC	CASSEGVGTLSSYNEQFF	TRBV6-1	TRBJ2-1
TGTGCCAGCAGTGAGACGCAGTACTTC	CASSETQYF	TRBV6-4	TRBJ2-7
TGTGCCAGCAGCTTAGATGGGGGGACAGACACAGATACGCAGTATTTT	CASSLDGGTDTDTQYF	TRBV7-8	TRBJ2-3
TGTGCCAGCAGCTTAGAGGGGCGTAGGATTGGTAATGAAAAACTGTTTTTT	CASSLEGRRIGNEKLFF	TRBV11-3	TRBJ1-4
TGTGCCATCAGTGAGTTACTCCAAGTGCGGGAGGCTAATGAAAAACTGTTTTTT	CAISELLQVREANEKLFF	TRBV10-3	TRBJ1-4
TGTGCCAAGGACGTATATGGCTACACCTTC	CAKDVYGYTF	TRBV7-2	TRBJ1-2
TGTGCCAGCAGTTGGGAAAGCAGACAGGGGGCGGACGAGCAGTACTTC	CASSWESRQGADEQYF	TRBV7-9	TRBJ2-7
TGCGCCAGCAGCCATAAACAGGGCGGCAATCAGCCCCAGCATTTT	CASSHKQGGNQPQHF	TRBV4-1	TRBJ1-5
TGTGCCAGTAGTATCCCTTGGACGAGTTTGAAGTTCTACGAGCAGTACTTC	CASSIPWTSLKFYEQYF	TRBV19	TRBJ2-7
TGTGCCACGGACGACAGGGGCCATAGCAATCAGCCCCAGCATTTT	CATDDRGHSNQPQHF	TRBV24-1	TRBJ1-5
TGTGCCAGCAGTTTATGTGAAGGACACAACCCAGATGACACCGGGGAGCTGTTTTTT	CASSLCEGHNPDDTGELFF	TRBV27	TRBJ2-2
TGCAGTGCTAGGGGACAGGGCGACCCCCAGCCCCAGCATTTT	CSARGQGDPQPQHF	TRBV20-1	TRBJ1-5
TGTGCCAGCAGTGGCAGGCAGATAAGTAACTATGGCTACACCTTC	CASSGRQISNYGYTF	TRBV12-4	TRBJ1-2
TGCGCCAGCATCAGGGGCACTGAAGCTTTCTTT	CASIRGTEAFF	TRBV4-1	TRBJ1-1
TGTGCCAGCAGCCCGGTGAACGGGGACTATACTACATGTAGCAATCAGCCCCAGCATTTT	CASSPVNGDYTTCSNQPQHF	TRBV13	TRBJ1-5
TGTGCCAGCAGCTTGGCAATTAGATCGGGACAGCTAGAGACGAACACCGGGGAGCTGTTTTTT	CASSLAIRSGQLETNTGELFF	TRBV5-6	TRBJ2-2
TGTGCCTGGAGTGGAAGCAGGACACTTGGCTACACCTTC	CAWSGSRTLGYTF	TRBV30	TRBJ1-2
TGCGCCATCGCGACATCTGGAAACACCATATATTTT	CAIATSGNTIYF	TRBV10-2	TRBJ1-3
TGTGCTAGTGGAAAGGTGCCGGGAGGGGGGGTTGGCAATCAGCCCCAGCATTTT	CASGKVPGGGVGNQPQHF	TRBV12-5	TRBJ1-5
TGTGCCAGCAGCTCCCCGGGGGGGTGGAATGAGCAGTTCTTC	CASSSPGGWNEQFF	TRBV5-4	TRBJ2-1
TGCAGTGCTCCGCCCGTTATCACACAGGGCATCAGTGAAAAACTGTTTTTT	CSAPPVITQGISEKLFF	TRBV20-1	TRBJ1-4
TGTGCCACCAGCCCAGGTAGCGATACTGAAGCTTTCTTT	CATSPGSDTEAFF	TRBV24-1	TRBJ1-1
TGTGCCGGGGGAAAGCCCTACGAGCAGTACTTC	CAGGKPYEQYF	TRBV6-5	TRBJ2-7
TGTGCCAGCAGTTGCAGGCCGGGGCAAGAGACCCAGTACTTC	CASSCRPGQETQYF	TRBV6-2	TRBJ2-5
TGTGCCAGCAGCTTCAAGGCGGGGATGATGAACACTGAAGCTTTCTTT	CASSFKAGMMNTEAFF	TRBV5-4	TRBJ1-1
TGTGCCAGCAGCCCCCGGGGGCATCAGCCCCAGCATTTT	CASSPRGHQPQHF	TRBV11-2	TRBJ1-5
TGCGCCAGCAGCTTCCACAGCATGGGACAGGGCGCGGCCAAAAACATTCAGTACTTC	CASSFHSMGQGAAKNIQYF	TRBV5-1	TRBJ2-4
TGTGCCAGCCTTTGGAGGCGTGCATGGCGTGAGAACACCGGGGAGCTGTTTTTT	CASLWRRAWRENTGELFF	TRBV28	TRBJ2-2
TGTGCCAGCAGTTTGAAACGTTACTGGATCGTAGCCAAAAACATTCAGTACTTC	CASSLKRYWIVAKNIQYF	TRBV27	TRBJ2-4
TGTGCCAGCAGCCAAGGGACTGGAAACACCATATATTTT	CASSQGTGNTIYF	TRBV4-2	TRBJ1-3
TGTGCCAGCATTATTAGCGGGCGCTACGAGCAGTACTTC	CASIISGRYEQYF	TRBV28	TRBJ2-7
TGTGCCAGCAGCCCCTCGACGGGACTAGCGGTTGGCAGAGCCAATGAGCAGTTCTTC	CASSPSTGLAVGRANEQFF	TRBV7-3	TRBJ2-1
TGTGCCAGCAGGACCGGGACAGGGGGGGGCAATCAGCCCCAGCATTTT	CASRTGTGGGNQPQHF	TRBV5-6	TRBJ1-5
TGTGCCAGCAGCTGGGACGGGTCCTTAGGCAATCAGCCCCAGCATTTT	CASSWDGSLGNQPQHF	TRBV9	TRBJ1-5
TGTGCCAGCAGCTTACAGGGGGAGCAGTACTTC	CASSLQGEQYF	TRBV7-2	TRBJ2-7
TGTGCCAGCAGCTTCCTAACGGGGGGCGGTATCCACTATGGCTACACCTTC	CASSFLTGGGIHYGYTF	TRBV7-2	TRBJ1-2
TGTGCCAGCACGGACCGGGACAACTCCTACGAGCAGTACTTC	CASTDRDNSYEQYF	TRBV27	TRBJ2-7
TGCAGTGCTAGAGATTCGTGGGGGGGGACTAGCACAGATACGCAGTATTTT	CSARDSWGGTSTDTQYF	TRBV20-1	TRBJ2-3
TGCAGCGTTGAGCCGGAAAACCCAGGACTAGCGGGGACCGGGAACACCGGGGAGCTGTTTTTT	CSVEPENPGLAGTGNTGELFF	TRBV29-1	TRBJ2-2
TGTGCCAGCAGCCGACAGGGGGCCCGGGATTGGCTCTCTGGGGCCAACGTCCTGACTTTC	CASSRQGARDWLSGANVLTF	TRBV13	TRBJ2-6
TGTGCCTGGAGTATCCAGTTGAGAGGGCAGCCCCAGCATTTT	CAWSIQLRGQPQHF	TRBV30	TRBJ1-5
TGCGCCAGCAGCTTGGACCGAGAGGGAGGTGAGCAGTTCTTC	CASSLDREGGEQFF	TRBV5-1	TRBJ2-1
TGTGCCAAGCGGGACATAGGAAGTCAGCCCCAGCATTTT	CAKRDIGSQPQHF	TRBV6-5	TRBJ1-5
TGTGCCACCGCCTGTGGCTTC	CATACGF	TRBV24-1	TRBJ1-2
TGTGCCAGCAGCGTTGGGACTAGCGCTATCGGGCAGTACTTC	CASSVGTSAIGQYF	TRBV12-4	TRBJ2-7
TGCGCCAGCAGCCTCAGTTACTCTGGGGCCAACGTCCTGACTTTC	CASSLSYSGANVLTF	TRBV5-1	TRBJ2-6
TGCGCCAGCAGCTTGGGGAAGGGGGCTAACGAGCAGTACTTC	CASSLGKGANEQYF	TRBV5-1	TRBJ2-7
TGTGCCAGCAGACCCCCTCCAGACCGCTATGGCTACACCTTC	CASRPPPDRYGYTF	TRBV9	TRBJ1-2
TGCAGTGCTGTCAGACTGACAGATACGCAGTATTTT	CSAVRLTDTQYF	TRBV20-1	TRBJ2-3
TGTGCCACCAGCGGGTCATACACCTTC	CATSGSYTF	TRBV15	TRBJ1-2
TGCGCCAGCAGCTTGACAGGGACGGATGAGCAGTTCTTC	CASSLTGTDEQFF	TRBV5-1	TRBJ2-1
TGTGCCAGCGAGTTAGGGGAAGAGACCCAGTACTTC	CASELGEETQYF	TRBV6-4	TRBJ2-5
TGTGCCATACGGCCAGGGGGGGACTTGTCTGGGGCCAACGTCCTGACTTTC	CAIRPGGDLSGANVLTF	TRBV9	TRBJ2-6
TGTGCCATGAGGGAAACACCGGCCCCATTCCTTTACGAGCAGTACTTC	CAMRETPAPFLYEQYF	TRBV19	TRBJ2-7
TGCGCCACAGCCGGGACAGGGGGTACCATAGTATTAAATTCACCCCTCCACTTT	CATAGTGGTIVLNSPLHF	TRBV5-1	TRBJ1-6
TGCGCCAGCAGCTTGACCCAGGACAGGGGGCGAGAGACCCAGTACTTC	CASSLTQDRGRETQYF	TRBV5-1	TRBJ2-5
TGTGCCAGTAGTAGCCAGACAGGGTCACCCTACGAGCAGTACTTC	CASSSQTGSPYEQYF	TRBV19	TRBJ2-7
TGTGCCAGCGTGTTGGGACTAGCGGAGAAAATTCACACCGGGGAGCTGTTTTTT	CASVLGLAEKIHTGELFF	TRBV25-1	TRBJ2-2
TGTGCCAGCAGCTCTCACCCGGGGGGGCTGGGAAACTACAATGAGCAGTTCTTC	CASSSHPGGLGNYNEQFF	TRBV7-2	TRBJ2-1
TGTGCCAGCAGCGGGGAGCGGGGGCTCGATACGCAGTATTTT	CASSGERGLDTQYF	TRBV7-8	TRBJ2-3
TGTGCCAGCAGTCCTCCGGCCGGACCCGGGACAGCTTTGAACACTGAAGCTTTCTTT	CASSPPAGPGTALNTEAFF	TRBV6-1	TRBJ1-1
TGTGCCAGCATCCGGCCCGGGACAGGAACGGTCTTATTCTCCAATCAGCCCCAGCATTTT	CASIRPGTGTVLFSNQPQHF	TRBV7-6	TRBJ1-5
TGTGCCTGGAGTCTTACTGATGAGACCCAGTACTTC	CAWSLTDETQYF	TRBV30	TRBJ2-5
TGTGCCAGCAGTTACAACAGACAGGTCGATAATTCACCCCTCCACTTT	CASSYNRQVDNSPLHF	TRBV6-5	TRBJ1-6
TGCAGTGCTAGGCGGGGGCCCAGCTCCTACGAGCAGTACTTC	CSARRGPSSYEQYF	TRBV20-1	TRBJ2-7
TGTGCCAGCAGCCAAGAGTCCTGGACCAAAAGGGAGACCCAGTACTTC	CASSQESWTKRETQYF	TRBV4-2	TRBJ2-5
TGTGCCAGCAGCCAAGGAGGCCCCAGAGATGAAAAACTGTTTTTT	CASSQGGPRDEKLFF	TRBV3-1	TRBJ1-4
TGTGCCAGCAGCTCTGACAGGGGGGACGAGCAGTACTTC	CASSSDRGDEQYF	TRBV13	TRBJ2-7
TGTGCCAGCGGCCCGCGGGAGTTGTGCTATAATTCACCCCTCCACTTT	CASGPRELCYNSPLHF	TRBV6-1	TRBJ1-6
TGTGCCTGTAGACAGGGGCAGCTCAATTCACCCCTCCACTTT	CACRQGQLNSPLHF	TRBV15	TRBJ1-6
TGCGCCAGCAGCCGGCCCCGACGGACGGGACAGGGATGCGATAATTCACCCCTCCACTTT	CASSRPRRTGQGCDNSPLHF	TRBV4-1	TRBJ1-6
TGTGCCAGCGCCTATCCAGGCACTGAAGCTTTCTTT	CASAYPGTEAFF	TRBV2	TRBJ1-1
TGTGCCAGCAGTTTATTTCGTCCGAGGCGCAATCAGCCCCAGCATTTT	CASSLFRPRRNQPQHF	TRBV12-3	TRBJ1-5
TGCAGCGAGCAGGGAATCGGGATTGAGCAGTACTTC	CSEQGIGIEQYF	TRBV29-1	TRBJ2-7
TGCGCCAGCAGCTTGAGAACCCAGGGGTACACCGGGGAGCTGTTTTTT	CASSLRTQGYTGELFF	TRBV5-1	TRBJ2-2
TGCAGTGCTAAAAGTGGGGGCCTAGCTGAAGCTTTCTTT	CSAKSGGLAEAFF	TRBV20-1	TRBJ1-1
TGTGCCAGTAGTATCTTGTCTGAAAGGGACTTCCTCCACTTT	CASSILSERDFLHF	TRBV19	TRBJ1-6
TGTGCCAGCAGCCTGGGACACCAAACTAACTATGGCTACACCTTC	CASSLGHQTNYGYTF	TRBV5-6	TRBJ1-2
TGTGCCAGAACTGGGACAGGGAATCAGCCCCAGCATTTT	CARTGTGNQPQHF	TRBV19	TRBJ1-5
TGTGCCACCAGTGATTTAGTGGCTTCGCAGCCCCAGCATTTT	CATSDLVASQPQHF	TRBV24-1	TRBJ1-5
TGCAGCGTACCCGGACAGTGCACAGATACGCAGTATTTT	CSVPGQCTDTQYF	TRBV29-1	TRBJ2-3
TGTGCCACGGCGGGGGGCGGTAGCCAAGAGACCCAGTACTTC	CATAGGGSQETQYF	TRBV24-1	TRBJ2-5
TGTGCCAGCAGAAGCGCCAGCCTCTCCTACGAGCAGTACTTC	CASRSASLSYEQYF	TRBV2	TRBJ2-7
TGTGCCACTTCAATAGGACGGGGCACAGATACGCAGTATTTT	CATSIGRGTDTQYF	TRBV24-1	TRBJ2-3
TGCGCCAGCAGCGCTACCGGACGCCGGAGTGACCCCCTCCACTTT	CASSATGRRSDPLHF	TRBV5-1	TRBJ1-6
TGCGCCAGCAGCTTGGGGACAGGGGTTTCAGATGGCTACACCTTC	CASSLGTGVSDGYTF	TRBV5-1	TRBJ1-2
TGTGCCACCAGAGTTAGGGGGCGCACTGAAGCTTTCTTT	CATRVRGRTEAFF	TRBV24-1	TRBJ1-1
TGTGCCAGCAGCTTACCGGGACGGGTACGGTACGAGCAGTACTTC	CASSLPGRVRYEQYF	TRBV11-2	TRBJ2-7
TGCAGTGCTAGAGTTGGGGCGTCTAATGAAAAACTGTTTTTT	CSARVGASNEKLFF	TRBV20-1	TRBJ1-4
TGTGCCAGCAGCGGTCTCTATTTTGTGCCTAGCGGGCCTGAGTACGAGCAGTACTTC	CASSGLYFVPSGPEYEQYF	TRBV9	TRBJ2-7
TGTGCCAGCAGTAACTCCACAGGGGAAGGTTTGGATCTAAGCTCCTACGAGCAGTACTTC	CASSNSTGEGLDLSSYEQYF	TRBV27	TRBJ2-7
TGTGCCAGCAAGGGGGGGGGGTCTGGAAACACCATATATTTT	CASKGGGSGNTIYF	TRBV6-2	TRBJ1-3
TGTGCCAGCAGTCCGCCCGGACAGGCTGATAGCAATCAGCCCCAGCATTTT	CASSPPGQADSNQPQHF	TRBV27	TRBJ1-5
TGTGCCAGCAGCTTAGGGGGGCGGCAGAGTAGCTCCTACAATGAGCAGTTCTTC	CASSLGGRQSSSYNEQFF	TRBV11-2	TRBJ2-1
TGTGCCAGCAGCGTTACTCCCCTCAACACTGAAGCTTTCTTT	CASSVTPLNTEAFF	TRBV9	TRBJ1-1
TGTGCCAGCCCCGGACAATGTAATGAGCAGTTCTTC	CASPGQCNEQFF	TRBV9	TRBJ2-1
TGTGCCAGCAGAGGTATGGTCGGGAACACTGAAGCTTTCTTT	CASRGMVGNTEAFF	TRBV6-1	TRBJ1-1
TGTGCCAGTACCCTAACATACAACTGGCAGTTCTTC	CASTLTYNWQFF	TRBV19	TRBJ2-1
TGTGCCAGGCAACTTATAGCGGATGGAGAGACCCAGTACTTC	CARQLIADGETQYF	TRBV24-1	TRBJ2-5
TGTGCCAGCAGCCTTAGGTTTCATGGGGGGACCCAAGAGACCCAGTACTTC	CASSLRFHGGTQETQYF	TRBV6-4	TRBJ2-5
TGTGCCATGACAGGGGGGGGTAATGAAAAACTGTTTTTT	CAMTGGGNEKLFF	TRBV6-2	TRBJ1-4
TGTGCCAGCATGACAGGGGGCTACACCTTC	CASMTGGYTF	TRBV19	TRBJ1-2
TGCAGTGCTAGGGTCAGCGGTAGCACAGATACGCAGTATTTT	CSARVSGSTDTQYF	TRBV20-1	TRBJ2-3
TGTGCCAGCAGCCGTTTAGCCGACAGGAAGCTAAGCTACGAGCAGTACTTC	CASSRLADRKLSYEQYF	TRBV13	TRBJ2-7
TGTGCCAGCAGCTGTTCTCCGAAGCAGTACTTC	CASSCSPKQYF	TRBV13	TRBJ2-7
TGCGCCAGCAGCCAAGGGTTTCGACAGCAGAACACTGAAGCTTTCTTT	CASSQGFRQQNTEAFF	TRBV4-3	TRBJ1-1
TGTGCCAGCAGCTGTAGGTATCGGACAGACTACCCCTACGAGCAGTACTTC	CASSCRYRTDYPYEQYF	TRBV7-8	TRBJ2-7
TGCGCCCCGGACGGGGTTACCTCTGGAAACACCATATATTTT	CAPDGVTSGNTIYF	TRBV10-1	TRBJ1-3
TGTGCCACCAGTGATGCGTGTAAAAGCGAGCAGTACTTC	CATSDACKSEQYF	TRBV24-1	TRBJ2-7
TGTGCCACCAGTGATTTGCAAAGGACAGGGATTGCTCGCACTGAAGCTTTCTTT	CATSDLQRTGIARTEAFF	TRBV24-1	TRBJ1-1
TGTGCCAGCAGACCGCTAGCGGGGGAGTACAATGAGCAGTTCTTC	CASRPLAGEYNEQFF	TRBV5-4	TRBJ2-1
TGTGCCAGCAGCCACTTCCCAGGAAGCTGGAGGTCTGGGGCCAACGTCCTGACTTTC	CASSHFPGSWRSGANVLTF	TRBV6-4	TRBJ2-6
TGTGCCAGCTTTATCAGGGGCAATGAGCAGTTCTTC	CASFIRGNEQFF	TRBV6-5	TRBJ2-1
TGTGCCAGCAGCTCCCTCGAAGACCCCCAGTACTTC	CASSSLEDPQYF	TRBV7-3	TRBJ2-5
TGCAGCGTTGTGGTCATATGGGACAGGGGGAGCGAGCAGTACTTC	CSVVVIWDRGSEQYF	TRBV29-1	TRBJ2-7
TGCGCCAGCAGCTTGCTCCTAGCGGGTTTGATAGCCCAGTACTTC	CASSLLLAGLIAQYF	TRBV5-1	TRBJ2-5
TGCGCCAGCAGCTTGGCCGGGACTAGCTACGAGCAGTACTTC	CASSLAGTSYEQYF	TRBV5-1	TRBJ2-7
TGTGCCAGCAGCGCCCCTCGGCGGCTTTGTCTGGGCAATCAGCCCCAGCATTTT	CASSAPRRLCLGNQPQHF	TRBV9	TRBJ1-5
TGTGCCAGCAGTGACTCTGGAGACAGGGGAGCTAAAGCCTACGAGCAGTACTTC	CASSDSGDRGAKAYEQYF	TRBV6-4	TRBJ2-7
TGTGCCAGCAGCTTAGGCGAACCCAAGACACAAGAGACCCAGTACTTC	CASSLGEPKTQETQYF	TRBV7-4	TRBJ2-5
TGCAGTGCGCCCTTCCGGGGCCCTAGCAATCAGCCCCAGCATTTT	CSAPFRGPSNQPQHF	TRBV20-1	TRBJ1-5
TGTGCCAGCAGTCATCGATTGAGGAACACTGAAGCTTTCTTT	CASSHRLRNTEAFF	TRBV6-1	TRBJ1-1
TGCGCCAGCAGCCATTTGACAGGGAAGGAAGCTTTCTTT	CASSHLTGKEAFF	TRBV4-1	TRBJ1-1
TGTGCCACCAGTGATTTCCTATTAGAAGGGGATGAGCAGTTCTTC	CATSDFLLEGDEQFF	TRBV24-1	TRBJ2-1
TGTGCCAGCAGTTACCGAATTAGCGGGAACACCGGGGAGCTGTTTTTT	CASSYRISGNTGELFF	TRBV6-6	TRBJ2-2
TGTGCCAGCACCGGGGACAGGGCCCATTTAGAAAAACTGTTTTTT	CASTGDRAHLEKLFF	TRBV12-3	TRBJ1-4
TGTGCCAGCAGCCAAGACAGTAGACCCCTCCACTTT	CASSQDSRPLHF	TRBV3-1	TRBJ1-6
TGCAGCGCAACCACCTACACCTTC	CSATTYTF	TRBV29-1	TRBJ1-2
TGTGCCAAAGGGCTCACCGGGGAGCTGTTTTTT	CAKGLTGELFF	TRBV27	TRBJ2-2
TGTGCTAGTGGTATTCAGGTAGTTAGCAATCAGCCCCAGCATTTT	CASGIQVVSNQPQHF	TRBV12-5	TRBJ1-5
TGCGCCAGCAGTGAGGGTGCAAGGCCGCATTTT	CASSEGARPHF	TRBV10-1	TRBJ1-5
TGCAGTGTCCGGGACAGGGGGGGGAACACTGAAGCTTTCTTT	CSVRDRGGNTEAFF	TRBV20-1	TRBJ1-1
TGTGCCAGCTCACCAAGTTGGGCACGTAATTCACCCCTCCACTTT	CASSPSWARNSPLHF	TRBV18	TRBJ1-6
TGTGCCAGCAGCTGGGGAGGGGGGGCCGGGGAGCTGTTTTTT	CASSWGGGAGELFF	TRBV7-9	TRBJ2-2
TGCAGTGCTACGAAAACAACAGGGTTTAGGCGGAAGAACACCGGGGAGCTGTTTTTT	CSATKTTGFRRKNTGELFF	TRBV20-1	TRBJ2-2
TGTGCCAGCAGCTTACATGTGTTCCGCTACAATGAGCAGTTCTTC	CASSLHVFRYNEQFF	TRBV7-4	TRBJ2-1
TGTGCCAGCAGCACTGACCCCGGGACAGGGGGGAGCTCCTACAATGAGCAGTTCTTC	CASSTDPGTGGSSYNEQFF	TRBV11-3	TRBJ2-1
TGTGCCAGCAGCCCAGAAGGGGGACAGGGGGATGGCTACACCTTC	CASSPEGGQGDGYTF	TRBV14	TRBJ1-2
TGTGCCAGCAATTTCTTCCGAAAAGGGCCGGGAGCTTACGAGCAGTACTTC	CASNFFRKGPGAYEQYF	TRBV13	TRBJ2-7
TGTGCTAGCAGCTGCGGGGACAGGGAGAAATATGGCTACACCTTC	CASSCGDREKYGYTF	TRBV7-7	TRBJ1-2
TGTGCCAGTAGTATGGATACCCCACGAACCCTGGGTACAACTAATGAAAAACTGTTTTTT	CASSMDTPRTLGTTNEKLFF	TRBV19	TRBJ1-4
TGCGCCAGCAGTGACCTTACACTAGCGGGAGGGTTCGGCTACACCTTC	CASSDLTLAGGFGYTF	TRBV10-2	TRBJ1-2
TGTGCCACCAGTGGTGCTCCAGGGGGCGGGGGTCCCGGGGAGCTGTTTTTT	CATSGAPGGGGPGELFF	TRBV24-1	TRBJ2-2
TGTGCCACCCCCCAAATAGGGGATAATCAGCCCCAGCATTTT	CATPQIGDNQPQHF	TRBV24-1	TRBJ1-5
TGCGCCAGTCCTCCCAGCGGGAGGCTTTCCTACGAGCAGTACTTC	CASPPSGRLSYEQYF	TRBV5-1	TRBJ2-7
TGTGCCAGCAGCCAAGTCCCCGTCAGGGGGGCTGGGGCCAACGTCCTGACTTTC	CASSQVPVRGAGANVLTF	TRBV4-2	TRBJ2-6
TGTGCCAGCAGGACAGGCCTAGAGACCCAGTACTTC	CASRTGLETQYF	TRBV28	TRBJ2-5
TGTGCTAGAAGAGGGGGTCAAAGGTATAATTCACCCCTCCACTTT	CARRGGQRYNSPLHF	TRBV12-5	TRBJ1-6
TGCGCCAGCAGTGATATTCCCCAGTACGAGCAGTACTTC	CASSDIPQYEQYF	TRBV10-2	TRBJ2-7
TGCAGTGCTAGAGATATGCCTAGGGGGAATGCTTTCTTT	CSARDMPRGNAFF	TRBV20-1	TRBJ1-1
TGCAGTGCTAGAGATCGCCCGACAGGGTGGGGGGATCAGCCCCAGCATTTT	CSARDRPTGWGDQPQHF	TRBV20-1	TRBJ1-5
TGTGCCAGCAGCTGGTCCTCAGCTTTTCTAGGCGAGGGGAGCAATCAGCCCCAGCATTTT	CASSWSSAFLGEGSNQPQHF	TRBV7-2	TRBJ1-5
TGTGCCAGCAGTTATTTAGGGGGTACGCAGTATTTT	CASSYLGGTQYF	TRBV28	TRBJ2-3
TGTGCCAGCAGTTCCAAAGGACAGGGGCAGGGCACTGAAGCTTTCTTT	CASSSKGQGQGTEAFF	TRBV6-5	TRBJ1-1
TGTGCCTGGAGTGCACCCAGGCGCCTGAACACTGAAGCTTTCTTT	CAWSAPRRLNTEAFF	TRBV30	TRBJ1-1
TGTGCCACCGTTAGGGATGGGGATGCTGGAAACACCATATATTTT	CATVRDGDAGNTIYF	TRBV13	TRBJ1-3
TGTGCCAGCAGCCAAGCCGGGACAGATTCGGATTCACCCCTCCACTTT	CASSQAGTDSDSPLHF	TRBV4-2	TRBJ1-6
TGCGCCAGCAGTGAGACGCTGACAGAGCAAGGGACCATCCACATGAACACTGAAGCTTTCTTT	CASSETLTEQGTIHMNTEAFF	TRBV10-2	TRBJ1-1
TGTGCCAGCAGGGCAGGATTAAGGGGGGGAGCCCAGTACTTC	CASRAGLRGGAQYF	TRBV27	TRBJ2-5
TGTGCCAGCAGCTTGGGGGGACTAGCGGACGAGCAGTACTTC	CASSLGGLADEQYF	TRBV5-6	TRBJ2-7
TGTGCCAGCATGGGGGGGACTAGCGGGCCGATATACGAGCAGTACTTC	CASMGGTSGPIYEQYF	TRBV28	TRBJ2-7
TGTGCCAGCAGTGTATTCCAAACGACCGCAACTAATGAAAAACTGTTTTTT	CASSVFQTTATNEKLFF	TRBV25-1	TRBJ1-4
TGTGCCAGCAGCCAGAGCGGGAGCCTCACTGAAGCTTTCTTT	CASSQSGSLTEAFF	TRBV3-1	TRBJ1-1
TGTGCCAGCCCTTACCGAAGGGAGAATGAGCAGTTCTTC	CASPYRRENEQFF	TRBV9	TRBJ2-1
TGTGCCAGCAGCTTATATACCGGGGAGCTGTTTTTT	CASSLYTGELFF	TRBV7-9	TRBJ2-2
TGTGCCAGCAGCCCCATCCCTGTTAGCGGGAACACCGGGGAGCTGTTTTTT	CASSPIPVSGNTGELFF	TRBV4-2	TRBJ2-2
TGTGCCAGCAGCTACCCCCCCCGGCCGAGCTCCTACAATGAGCAGTTCTTC	CASSYPPRPSSYNEQFF	TRBV7-2	TRBJ2-1
TGTGCCAGCAGCCACGCCGGGACGACCTATGGCTACACCTTC	CASSHAGTTYGYTF	TRBV3-1	TRBJ1-2
TGTGCCAGTTTTAATCCGCACGGGGACACCGGGGAGCTGTTTTTT	CASFNPHGDTGELFF	TRBV10-3	TRBJ2-2
TGTGCCAGCAGTTACTCGAATGAACCAGAACCGAAACCAATTACCTTTAACACCGGGGAGCTGTTTTTT	CASSYSNEPEPKPITFNTGELFF	TRBV6-5	TRBJ2-2
TGTGCCACCAGTGATTTGCATTTCCCTAGGCACAATGAGCAGTTCTTC	CATSDLHFPRHNEQFF	TRBV24-1	TRBJ2-1
TGTGCCAGCAGCTTGACGAGCGAAGAGGACAGGGAACTAACTAGCAATCAGCCCCAGCATTTT	CASSLTSEEDRELTSNQPQHF	TRBV5-4	TRBJ1-5
TGTGCCAGCAGCCATTGGGGGGAATGTGAGCAGTTCTTC	CASSHWGECEQFF	TRBV4-2	TRBJ2-1
TGCAGTGGGGCTTTGCCCGGAATACTAGCGGGGGGGCGGGTGTGCACAGATACGCAGTATTTT	CSGALPGILAGGRVCTDTQYF	TRBV20-1	TRBJ2-3
TGCGCCAGCAGCCAAGGATCAGGGAGAGACTATGGCTACACCTTC	CASSQGSGRDYGYTF	TRBV4-1	TRBJ1-2
TGTGCCAGCAGCCGTGGCCTAGCGGGTGGGTACAATGAGCAGTTCTTC	CASSRGLAGGYNEQFF	TRBV27	TRBJ2-1
TGTGCCAGCAGTTACAGAGGGACGAGGACTGAAGCTTTCTTT	CASSYRGTRTEAFF	TRBV6-5	TRBJ1-1
TGCAGTGCTAGTACTAGCGGGAGGAGGGATGTCGAAGAGACCCAGTACTTC	CSASTSGRRDVEETQYF	TRBV20-1	TRBJ2-5
TGTGCCAGCAGCGATCATAACAGGGGATTTCTATGGTGCGAAGGAATACCGCCAGATACGCAGTATTTT	CASSDHNRGFLWCEGIPPDTQYF	TRBV9	TRBJ2-3
TGTGCCAGCAGTTTCCAGGTTCAAGGCCAAGAGACCCAGTACTTC	CASSFQVQGQETQYF	TRBV12-3	TRBJ2-5
TGTGCCAGCAGCTTCTATCCGGGAATCGGGGCCAACGTCCTGACTTTC	CASSFYPGIGANVLTF	TRBV5-4	TRBJ2-6
TGTGCTAGTGCCCAGGGGGCCTTATTCTCTGGGGCCAACGTCCTGACTTTC	CASAQGALFSGANVLTF	TRBV12-5	TRBJ2-6
TGTGCCAGCAGCATGAGCCGGGACAGGGAGGTATTCAATGAAAAACTGTTTTTT	CASSMSRDREVFNEKLFF	TRBV7-9	TRBJ1-4
TGTGCCAGCAGCTCCCCTCAGAGGAATCAGCCCCAGCATTTT	CASSSPQRNQPQHF	TRBV11-2	TRBJ1-5
TGTGCCAGCAGTAGGCAGAAGGAGCAGTACTTC	CASSRQKEQYF	TRBV6-1	TRBJ2-7
TGTGCCAGCAGACGGTCCTACGAGCAGTACTTC	CASRRSYEQYF	TRBV27	TRBJ2-7
TGCATGGTCAGGCGAAACACTGAAGCTTTCTTT	CMVRRNTEAFF	TRBV29-1	TRBJ1-1
TGTGCCAGCGTGGGGACAGGGGTACCACTTTCCGAGCAGTACTTC	CASVGTGVPLSEQYF	TRBV6-5	TRBJ2-7
TGTGCCAGCCTTTCGGAGAGGGTAGTACCGTCTGGGGCCAACGTCCTGACTTTC	CASLSERVVPSGANVLTF	TRBV18	TRBJ2-6
TGTGCCAGCAGCTTGCGCCGCGCTAATAGGGGACTAGCGGGCAGGAACACCGGGGAGCTGTTTTTT	CASSLRRANRGLAGRNTGELFF	TRBV5-4	TRBJ2-2
TGTGCCAGGTATGACAGGGTCGAGCGTGCAACTAATGAAAAACTGTTTTTT	CARYDRVERATNEKLFF	TRBV10-3	TRBJ1-4
TGCGCCAGCAGCCGGGGGACAGGGGGTAGCTCCTACAATGAGCAGTTCTTC	CASSRGTGGSSYNEQFF	TRBV4-1	TRBJ2-1
TGTGCCAGCTCACCCCAAGGACCGGGGGCCCTTAACTTC	CASSPQGPGALNF	TRBV18	TRBJ2-5
TGTGCCAGCAGTTTATGCGGGACAGGGGGCGCATGGGGGGATGGCTCCTACGAGCAGTACTTC	CASSLCGTGGAWGDGSYEQYF	TRBV27	TRBJ2-7
TGTGCCAGCTCACCAGATCCGTACGAGCAGTACTTC	CASSPDPYEQYF	TRBV18	TRBJ2-7
TGTGCCAGCAGTTACATATATGGACTAGCGGGAAACGAGCAGTACTTC	CASSYIYGLAGNEQYF	TRBV6-3	TRBJ2-7
TGTGCCAGCAGCTTAGAGGCTGAACCATGTCCCTATGGCTACACCTTC	CASSLEAEPCPYGYTF	TRBV11-2	TRBJ1-2
TGTGCCAGCAGCTTAGGACTAGGGCCGGAGACCCAGTACTTC	CASSLGLGPETQYF	TRBV7-6	TRBJ2-5
TGCAGCGATACTGGGGTCTACGAGCAGTACTTC	CSDTGVYEQYF	TRBV29-1	TRBJ2-7
TGCAGCGTTGAAGACTGGGGGGGCTACGAGCAGTACTTC	CSVEDWGGYEQYF	TRBV29-1	TRBJ2-7
TGCAGTGAGATACAGGAGGGCGCGGCCTACGAGCAGTACTTC	CSEIQEGAAYEQYF	TRBV20-1	TRBJ2-7
TGTGCCAGCGGAGGGACCTACAATGAGCAGTTCTTC	CASGGTYNEQFF	TRBV6-4	TRBJ2-1
TGTGCCAGCAGTTTATGGTGGGACAGAGGTAAAGAGACCCAGTACTTC	CASSLWWDRGKETQYF	TRBV27	TRBJ2-5
TGTGCCAGCAGTTTATCGAGGAGGACAGGGGGCAACTCCTACGAGCAGTACTTC	CASSLSRRTGGNSYEQYF	TRBV27	TRBJ2-7
TGTGCCAGCAGTTTTAACCGGGGACCAAGCAATCAGCCCCAGCATTTT	CASSFNRGPSNQPQHF	TRBV12-3	TRBJ1-5
TGTGCCAGCAGCTTAGTCCTCCGACTGTGCGGATGCTCCTACGAGCAGTACTTC	CASSLVLRLCGCSYEQYF	TRBV7-8	TRBJ2-7
TGTGCCAGCAGCGCCCTAGCGGGCCCGCCCAGCCCCGGGGAGCTGTTTTTT	CASSALAGPPSPGELFF	TRBV7-9	TRBJ2-2
TGCGCCAGCAGCCCCGGCGCGAGCAGGGGTCAGCCCCAGCATTTT	CASSPGASRGQPQHF	TRBV4-3	TRBJ1-5
TGCGCCAGCAGCCAAGAGGCCCCCCGACAGCCCCTCACTGAAGCTTTCTTT	CASSQEAPRQPLTEAFF	TRBV4-1	TRBJ1-1
TGTGCCAGCAGCCTAGACAGTAGCAATCAGCCCCAGCATTTT	CASSLDSSNQPQHF	TRBV9	TRBJ1-5
TGTGCCAGTAGTAGACAGGGGGGGGTGGAGGAGAATATGGGGTATAGCAATCAGCCCCAGCATTTT	CASSRQGGVEENMGYSNQPQHF	TRBV19	TRBJ1-5
TGTGTCGCAGGGGGCGGGAAAGAGACCCAGTACTTC	CVAGGGKETQYF	TRBV6-2	TRBJ2-5
TGTGCCAGCAGCTTCCCTCTTACCAGTGCTCAGCCCCAGCATTTT	CASSFPLTSAQPQHF	TRBV7-8	TRBJ1-5
TGTGCCAGCAGTGACTTTCCTAGACAGGGGAATGGCTACACCTTC	CASSDFPRQGNGYTF	TRBV6-4	TRBJ1-2
TGTGCCAGCATTCCGGGACAGGGGATGAACACTGAAGCTTTCTTT	CASIPGQGMNTEAFF	TRBV7-9	TRBJ1-1
TGTGCCAGCAGCGGGACAGGTGCTAACACTGAAGCTTTCTTT	CASSGTGANTEAFF	TRBV2	TRBJ1-1
TGTGCCAGCTGGGGACAGGGACTATATGGCTACACCTTC	CASWGQGLYGYTF	TRBV25-1	TRBJ1-2
TGCAGTGCTAGCCCGCACAGGGCTGGGGCCAACGTCCTGACTTTC	CSASPHRAGANVLTF	TRBV20-1	TRBJ2-6
TGTGCCAGCCGAGCCGGGGACAGGGCTAGTGGCTACACCTTC	CASRAGDRASGYTF	TRBV6-6	TRBJ1-2
TGTGCCAGCAGCCAGGGAATGAACTATGGCTACACCTTC	CASSQGMNYGYTF	TRBV11-2	TRBJ1-2
TGTGCCAGCAGGATAACTTCCACATACGAGCAGTACTTC	CASRITSTYEQYF	TRBV6-4	TRBJ2-7
TGTGCCAGCAGTTCCTGGACAGATGAAAAACTGTTTTTT	CASSSWTDEKLFF	TRBV6-4	TRBJ1-4
TGTGCCAGCAGTTACGACTACCATTCCTACAATGAGCAGTTCTTC	CASSYDYHSYNEQFF	TRBV6-2	TRBJ2-1
TGTGCCACCAGTAAAATGAGGAATACTAACTATGGCTACACCTTC	CATSKMRNTNYGYTF	TRBV24-1	TRBJ1-2
TGCAGCGTGGTTGCGGGGGAACTGGGGCCCGGGGAGCTGTTTTTT	CSVVAGELGPGELFF	TRBV29-1	TRBJ2-2
TGTGCCAGCAGCTTGGTCGTGGGACATCTAGCCTACGAGCAGTACTTC	CASSLVVGHLAYEQYF	TRBV5-8	TRBJ2-7
TGTGCCAGCAGTTCCCCCCATCTAGCGTTGTTAGACTACACAGATACGCAGTATTTT	CASSSPHLALLDYTDTQYF	TRBV28	TRBJ2-3
TGCAGCGTGAACTATGGCTACACCTTC	CSVNYGYTF	TRBV29-1	TRBJ1-2
TGTGCCAGCAGCTCCCTCGGGAGGGATCTTAGGGATATCGAGCAGTACTTC	CASSSLGRDLRDIEQYF	TRBV7-6	TRBJ2-7
TGTGCCAGCTCACCACCCCTTTGGGACAGGGGCCGGACTGGAAACACCATATATTTT	CASSPPLWDRGRTGNTIYF	TRBV18	TRBJ1-3
TGTGCCAGCAGCAGCGCCAGGCACAGGGGGAACACTGAAGCTTTCTTT	CASSSARHRGNTEAFF	TRBV5-6	TRBJ1-1
TGTGCCAGCATAGGGGAAGCTTTTAACACCGGGGAGCTGTTTTTT	CASIGEAFNTGELFF	TRBV6-2	TRBJ2-2
TGTGCCACCAGCAGAGTAGCGGGTGAGCAGTTCTTC	CATSRVAGEQFF	TRBV15	TRBJ2-1
TGCAGCACTGGGACAGACTTAGATTCCTACGAGCAGTACTTC	CSTGTDLDSYEQYF	TRBV29-1	TRBJ2-7
TGTGCCAGCAGTAACCCAAAAAGGGATCAAGGGGGGCACGGCTACACCTTC	CASSNPKRDQGGHGYTF	TRBV12-3	TRBJ1-2
TGTGCCAGCAGCTTATCTTCGTACGAGCAGTACTTC	CASSLSSYEQYF	TRBV7-3	TRBJ2-7
TGCGCCAGCAGCTGGAGAGGGAAAGGATGGCGGGAAGTAGAGAACTATGGCTACACCTTC	CASSWRGKGWREVENYGYTF	TRBV5-1	TRBJ1-2
TGTGCCCTAAGGACAGCCAGGGGTCAGCCCCAGCATTTT	CALRTARGQPQHF	TRBV12-3	TRBJ1-5
TGCAGTGCTAGAGGCGGTGAAAAACTGTTTTTT	CSARGGEKLFF	TRBV20-1	TRBJ1-4
TGTGCCAGCAGCAGAACTAGCGGGAGGGCCCAGAGAACGACAGATACGCAGTATTTT	CASSRTSGRAQRTTDTQYF	TRBV28	TRBJ2-3
TGTGCCAGCAGTGACTCTCTGAGAGGCAATGAGCAGTTCTTC	CASSDSLRGNEQFF	TRBV6-4	TRBJ2-1
TGTGCCAGTAGTATAGCCAGGGGGCACGGCAATCGGCAAGAGACCCAGTACTTC	CASSIARGHGNRQETQYF	TRBV19	TRBJ2-5
TGTGCCAGCAGGATTCCAAAGGCTCCGGAGTCCTACGAGCAGTACTTC	CASRIPKAPESYEQYF	TRBV7-4	TRBJ2-7
TGTGCCAGCAAAACCTCGGAAGGGGCAGGCACGAACACTGAAGCTTTCTTT	CASKTSEGAGTNTEAFF	TRBV6-8	TRBJ1-1
TGCAGCGTTAGCAGGGTCTACGAGCAGTACTTC	CSVSRVYEQYF	TRBV29-1	TRBJ2-7
TGTGCCACCAGTCTGGGGCCAACTAATGAAAAACTGTTTTTT	CATSLGPTNEKLFF	TRBV24-1	TRBJ1-4
TGCGCCAGCAGCCCAGGGTTGGTAACCTATGGCTACACCTTC	CASSPGLVTYGYTF	TRBV5-1	TRBJ1-2
TGTGCCAGCAGCTTACAATCAGACGGGTTTGAAAAACTGTTTTTT	CASSLQSDGFEKLFF	TRBV7-3	TRBJ1-4
TGTGCCAGCAGCTTAGATGGCCGGGACTCGTCAGCTGGAAACACCATATATTTT	CASSLDGRDSSAGNTIYF	TRBV7-2	TRBJ1-3
TGTGCCAGCAGTCAGGACAGTACTAGCGGGCCAAAGTCCTACAATGAGCAGTTCTTC	CASSQDSTSGPKSYNEQFF	TRBV6-8	TRBJ2-1
TGCAGTGCTAGAGAAAGCGGGACCTTCACAGATACGCAGTATTTT	CSARESGTFTDTQYF	TRBV20-1	TRBJ2-3
TGTGCCAGCAGTGAGGGACAGGTTAAGCATTTT	CASSEGQVKHF	TRBV6-4	TRBJ1-5
TGTGCCTATAGTGGGGGCGAGCAGTACTTC	CAYSGGEQYF	TRBV19	TRBJ2-7
TGTGCCTGGACGATGGGGGAAGAGACCCAGTACTTC	CAWTMGEETQYF	TRBV30	TRBJ2-5
TGCAGTGCTAGAGATCGAACCCCGGGGCACCTCCGCTATGGCTACACCTTC	CSARDRTPGHLRYGYTF	TRBV20-1	TRBJ1-2
TGTGCCAGCAGCCTGAGCGGGGGCAATGAGCAGTTCTTC	CASSLSGGNEQFF	TRBV13	TRBJ2-1
TGTGCCACCAGTGATTACCGCACCATCTATGGCTACACCTTC	CATSDYRTIYGYTF	TRBV24-1	TRBJ1-2
TGTGCCAGACCTAGGGAGGGAAACACCATATATTTT	CARPREGNTIYF	TRBV6-1	TRBJ1-3
TGTGCCACCAGTGATTTGATACCAACCGGGACAGGGGTACACGCGGCCAACGTCCTGACTTTC	CATSDLIPTGTGVHAANVLTF	TRBV24-1	TRBJ2-6
TGTGCCAGCAGTGACATTGGGACAGGGGGGCAGCCCCAGCATTTT	CASSDIGTGGQPQHF	TRBV6-1	TRBJ1-5
TGTGCCAGCAGTGATCATGAGGCCTTCTCCTACGAGCAGTACTTC	CASSDHEAFSYEQYF	TRBV6-4	TRBJ2-7
TGCGCCAGCAGCTTGGTCCGGGACAGGGTAAATCTGTTCGAGACCCAGTACTTC	CASSLVRDRVNLFETQYF	TRBV5-1	TRBJ2-5
TGTGCCAGCAGCTTAGAGGTGAGCGGTGCCCCCGGGGAGCTGTTTTTT	CASSLEVSGAPGELFF	TRBV7-8	TRBJ2-2
TGTGCCACCAGTCCGCCCCGGGACAGGGAAGTCAATCAGCCCCAGCATTTT	CATSPPRDREVNQPQHF	TRBV24-1	TRBJ1-5
TGCAGTGCTGGCACTGAACTCTACGAGCAGTACTTC	CSAGTELYEQYF	TRBV20-1	TRBJ2-7
TGTGCCAGCAGCCACCCCTTCCCCGGGACAGGGCTCAGCAATCAGCCCCAGCATTTT	CASSHPFPGTGLSNQPQHF	TRBV3-1	TRBJ1-5
TGTGCCAGCAGCCTCAGGGAAGTTCTGAGCCATAGCAATCAGCCCCAGCATTTT	CASSLREVLSHSNQPQHF	TRBV9	TRBJ1-5
TGTGCCAGCAGCGTAGTGGACAGCTCTGAAGCTTTCTTT	CASSVVDSSEAFF	TRBV9	TRBJ1-1
TGTGCCACCAGCAGAGATCCGTACAGGGGGCGATCCCAAGAGACCCAGTACTTC	CATSRDPYRGRSQETQYF	TRBV15	TRBJ2-5
TGTGCCAGCAGCTTACCTGGGACTGGCTACACCTTC	CASSLPGTGYTF	TRBV7-8	TRBJ1-2
TGCGCCAGCAGTGAGTCTTCCGAAAGGACGGATGAAAAACTGTTTTTT	CASSESSERTDEKLFF	TRBV10-1	TRBJ1-4
TGTGCCAGCAGCCAGGGGACTGAAGCTTTCTTT	CASSQGTEAFF	TRBV5-4	TRBJ1-1
TGTGCCAGCAGCTTAGAAGTGACGAGGTATAGCAATCAGCCCCAGCATTTT	CASSLEVTRYSNQPQHF	TRBV11-2	TRBJ1-5
TGTGCCTGGAGTGCAATGACGGGACAGGGGAAGTATCAGCCCCAGCATTTT	CAWSAMTGQGKYQPQHF	TRBV30	TRBJ1-5
TGTGCCAGCATGCCCGAGGGGGACCGCAATCAGCCCCAGCATTTT	CASMPEGDRNQPQHF	TRBV6-2	TRBJ1-5
TGTGCCAGCAGTGACTCGACTCCCAACGTCCACGAGCAGTACTTC	CASSDSTPNVHEQYF	TRBV6-4	TRBJ2-7
TGTGCCAGCAGCTTAGTGTGCACTGGGACGACCCAGTACTTC	CASSLVCTGTTQYF	TRBV7-2	TRBJ2-5
TGTGCCAGCAGCCCCCGTCAGGCGTGTTGCAATCAGCCCCAGCATTTT	CASSPRQACCNQPQHF	TRBV5-5	TRBJ1-5
TGTGCCAGCAGCTGCGACGGGGGGTCCTGGGGCTACACCTTC	CASSCDGGSWGYTF	TRBV7-7	TRBJ1-2
TGTGCCAGCAGCTTAGTACGAAATATGGACTACACAGATACGCAGTATTTT	CASSLVRNMDYTDTQYF	TRBV7-4	TRBJ2-3
TGTGCCGGTACTAAAAAAGATGAACGCTCTGGAAACACCATATATTTT	CAGTKKDERSGNTIYF	TRBV10-3	TRBJ1-3
TGTGCCAGTAGCGGCCCGGGACAGGGGGTAGGCACCATATATTTT	CASSGPGQGVGTIYF	TRBV19	TRBJ1-3
TGTGCTTCTAACGCTTTCTTT	CASNAFF	TRBV7-7	TRBJ1-1
TGTGCCAGCTCTGGACCCTATTCCTACAATGAGCAGTTCTTC	CASSGPYSYNEQFF	TRBV7-8	TRBJ2-1
TGCGCCAGCAGCCAAGCGGGAAGCTCGAACACCGGGGAGCTGTTTTTT	CASSQAGSSNTGELFF	TRBV5-1	TRBJ2-2
TGTGCCACCACAAAAGCGACAGGGCCGGCCGCGGAAAAACTGTTTTTT	CATTKATGPAAEKLFF	TRBV24-1	TRBJ1-4
TGTGCCAGCAGCTTAGAAAGACTGTTTTTT	CASSLERLFF	TRBV7-2	TRBJ1-4
TGTGCCAGCAGCCCGCCCACTAGCGGGAGTAATGAAAAACTGTTTTTT	CASSPPTSGSNEKLFF	TRBV5-6	TRBJ1-4
TGTGCCAGCAGTGAAGGGCTAGACGGGTCTGAGACCCAGTACTTC	CASSEGLDGSETQYF	TRBV6-1	TRBJ2-5
TGCGCCAGCAGCTTGATGCTAGCGGGATTGGGCGATACGCAGTATTTT	CASSLMLAGLGDTQYF	TRBV5-1	TRBJ2-3
TGTGCCAGCAGTGAAGGACTAGCGGGCGCAGGAGCTAGCACAGATACGCAGTATTTT	CASSEGLAGAGASTDTQYF	TRBV12-3	TRBJ2-3
TGTGCTAGTGGTCTGCAGGGTTATAAGGTCATGGAGAATCCTCGGGTTCCCTCCTACGAGCAGTACTTC	CASGLQGYKVMENPRVPSYEQYF	TRBV12-5	TRBJ2-7
TGTGCCAGCAGCTTATGGTGGGGACGGGGGGGGTATGATACGCAGTATTTT	CASSLWWGRGGYDTQYF	TRBV7-4	TRBJ2-3
TGTGCCAGCAGCTTAGCCCCCGGGACAGGGATTACGCAGTATTTT	CASSLAPGTGITQYF	TRBV11-1	TRBJ2-3
TGTGCCAGCAGCCACAAAGCTAGAAGTAGGGAAAACATTCAGTACTTC	CASSHKARSRENIQYF	TRBV3-1	TRBJ2-4
TGTGCCAGCAGCGATCCAATAGGGGATCAGCCCCAGCATTTT	CASSDPIGDQPQHF	TRBV13	TRBJ1-5
TGTGCCAGCAGAAGGACAGCCCTCGAGGCGGGATATGGCTACACCTTC	CASRRTALEAGYGYTF	TRBV6-4	TRBJ1-2
TGTGCCAGCAGCTCCACAATACCCCGGGATGGCTACACCTTC	CASSSTIPRDGYTF	TRBV9	TRBJ1-2
TGTGCCATCAGGTCGGGTAAGAAGACCCAGTACTTC	CAIRSGKKTQYF	TRBV10-3	TRBJ2-5
TGCAGCGTTGAAGGGCCCCGCACAGGGGCTTACTCTGGAAACACCATATATTTT	CSVEGPRTGAYSGNTIYF	TRBV29-1	TRBJ1-3
TGCAGTGCTCCTAGGGAAGGAGAGACCCAGTACTTC	CSAPREGETQYF	TRBV20-1	TRBJ2-5
TGTGCCAGCAGTTACAGGGTAAGGACTAGCGGGGGGGCTCAATCCTACGAGCAGTACTTC	CASSYRVRTSGGAQSYEQYF	TRBV6-5	TRBJ2-7
TGTGCCAGCCCCGGGACAGCGAGGGGACGCCCAGCTTTCTTT	CASPGTARGRPAFF	TRBV27	TRBJ1-1
TGTGCCAGTAGTTCAAGGACCACCGGGGAGCTGTTTTTT	CASSSRTTGELFF	TRBV19	TRBJ2-2
TGTGCCAGCAGCCGAGGAGAGGTAGAGACCCAGTACTTC	CASSRGEVETQYF	TRBV27	TRBJ2-5
TGTGCCAGCAGTTTCCCCCGGGAGTCCCGAGTGCACACTGAAGCTTTCTTT	CASSFPRESRVHTEAFF	TRBV27	TRBJ1-1
TGTGCCAGCAGCGAACCATTGAACACTGAAGCTTTCTTT	CASSEPLNTEAFF	TRBV13	TRBJ1-1
TGTGCCAGCAGCTTTGGCGCCCCAGGGGAACAGAATCAGCCCCAGCATTTT	CASSFGAPGEQNQPQHF	TRBV11-1	TRBJ1-5
TGTGCCAGCAGCCGGGTCGTTGCGGGTAATTCACCCCTCCACTTT	CASSRVVAGNSPLHF	TRBV4-2	TRBJ1-6
TGTGCCACCAGTTCAAGGGGGTCGGTATTAGGAAACACCATATATTTT	CATSSRGSVLGNTIYF	TRBV24-1	TRBJ1-3
TGTGCCAGCAGCTTGATGCCGGGGGACAGGCAGGGCCAAGAGACCCAGTACTTC	CASSLMPGDRQGQETQYF	TRBV5-6	TRBJ2-5
TGCGCCAGCAGCTTGGGGGGACAGGGCAAAGAGACCCAGTACTTC	CASSLGGQGKETQYF	TRBV5-1	TRBJ2-5
TGCAGTGCCCTACCGGCGACAGGGCTGGTAGATACGCAGTATTTT	CSALPATGLVDTQYF	TRBV20-1	TRBJ2-3
TGCGCCAGCAGCCTCAGGATCTCTGGAAACACCATATATTTT	CASSLRISGNTIYF	TRBV5-1	TRBJ1-3
TGTGCCAGCAGGGAACAAGTGAGACAGGGGAGCAATCAGCCCCAGCATTTT	CASREQVRQGSNQPQHF	TRBV6-2	TRBJ1-5
TGTGCCAGCAGTTACTCGGGAGGGTACAATGAGCAGTTCTTC	CASSYSGGYNEQFF	TRBV6-3	TRBJ2-1
TGCGGCACGGATAGCAATCAGCCCCAGCATTTT	CGTDSNQPQHF	TRBV20-1	TRBJ1-5
TGTGCCAGCAGCCAAAAAACCGGACAGATTGGGGAATGTCACTATGGCTACACCTTC	CASSQKTGQIGECHYGYTF	TRBV3-1	TRBJ1-2
TGTGCCAGCAGTTACGCCCCGGGGATCTACTCTGGAAACACCATATATTTT	CASSYAPGIYSGNTIYF	TRBV6-6	TRBJ1-3
TGTGCCAGCTCTCCCCGGCCCTTCCCGGGGGGGCCGCAAGAGACCCAGTACTTC	CASSPRPFPGGPQETQYF	TRBV2	TRBJ2-5
TGTGCCAGCAGCCCTGGAGGGACAGAGGGAGGTACTGAAGCTTTCTTT	CASSPGGTEGGTEAFF	TRBV11-2	TRBJ1-1
TGTGCCAGCAGCTTTACGCAGGGGGCCCCTGATTCCTACGAGCAGTACTTC	CASSFTQGAPDSYEQYF	TRBV7-7	TRBJ2-7
TGTGCCAGCAGCCCGAGGGAGAATTCACCCCTCCACTTT	CASSPRENSPLHF	TRBV7-9	TRBJ1-6
TGTGCCAGCAGCGAAATCCGACTAGATAGCTCCTACAATGAGCAGTTCTTC	CASSEIRLDSSYNEQFF	TRBV13	TRBJ2-1
TGCGCCAGCAGCCGGAGGGACAGACCTACTGACTTAACAGGGACAGGACCCAGAGGCAATCAGCCCCAGCATTTT	CASSRRDRPTDLTGTGPRGNQPQHF	TRBV4-3	TRBJ1-5
TGTGCCAGCAGCCTCACAACCAAGCCGCAGGGGGCCCAGCATTTT	CASSLTTKPQGAQHF	TRBV14	TRBJ1-5
TGTGCCAGCAGTAGCTTAGACTTTATCAGGGGGTGGGGCTATGGCTACACCTTC	CASSSLDFIRGWGYGYTF	TRBV6-1	TRBJ1-2
TGTGCCTGGAGTAGGGGGGCAGGCCAAGAGACCCAGTACTTC	CAWSRGAGQETQYF	TRBV30	TRBJ2-5
TGTGCTAGTGGCCGGGGAGGTACGCAGTATTTT	CASGRGGTQYF	TRBV12-5	TRBJ2-3
TGTGCCAGCAGCTGCTATACCGGGACTAGTACAGATACGCAGTATTTT	CASSCYTGTSTDTQYF	TRBV5-6	TRBJ2-3
TGTGCCAGCAGCTTCAGGATCCAGGGAACGCGGACGCAGTATTTT	CASSFRIQGTRTQYF	TRBV6-3	TRBJ2-3
TGTGCCAGCAGTCGTATGGGGAAGGACTTC	CASSRMGKDF	TRBV6-4	TRBJ2-5
TGTGCCAGCAGCGTAGGCACTAGCGGGAGGCCTCAGCCCCAGCATTTT	CASSVGTSGRPQPQHF	TRBV9	TRBJ1-5
TGTGCCAGCAGCCAAGCCGGGACAGGGCCGTGGGGGGCCAACGTCCTGACTTTC	CASSQAGTGPWGANVLTF	TRBV14	TRBJ2-6
TGTGCCAGCAGCCCAATGGAACCGGGACAGGGGCGCGACACCGGGGAGCTGTTTTTT	CASSPMEPGQGRDTGELFF	TRBV3-1	TRBJ2-2
TGTGCCAGCAGCTTAGATTGTCGCGACAGGTCAAGTCAGCCCCAGCATTTT	CASSLDCRDRSSQPQHF	TRBV11-3	TRBJ1-5
TGTGCCAGCAGGATTAATGGCGGGACAGGGATTAACACCGGGGAGCTGTTTTTT	CASRINGGTGINTGELFF	TRBV6-4	TRBJ2-2
TGTGCCAGCTCACTATTATCAGGACAGAGCGGCTATGGCTACACCTTC	CASSLLSGQSGYGYTF	TRBV18	TRBJ1-2
TGTGCCAGCAGGGGGGGGCCCCAACGTCCCTACGAGCAGTACTTC	CASRGGPQRPYEQYF	TRBV6-6	TRBJ2-7
TGCAGTGCCCTGGGGGGGGCCTCCTTACTTAAGCCCTTACAAGAGACCCAGTACTTC	CSALGGASLLKPLQETQYF	TRBV20-1	TRBJ2-5
TGTGCCAGCAGTGGGGGACGATGGTACGAGCAGTACTTC	CASSGGRWYEQYF	TRBV25-1	TRBJ2-7
TGTGCCAGCAGCTTAGAAACCCCCCTTGACTTCTGGGATCAGCCCCAGCATTTT	CASSLETPLDFWDQPQHF	TRBV7-8	TRBJ1-5
TGTGCCAGCCGGGGGGGCGGCCAAGAGACCCAGTACTTC	CASRGGGQETQYF	TRBV6-4	TRBJ2-5
TGTGCCAGCAGCTGGGAGAATGAGCAGTTCTTC	CASSWENEQFF	TRBV11-3	TRBJ2-1
TGTGCCACCAGTGCAGGACTAGCGGGGGGGCCATGCTACGAGCAGTACTTC	CATSAGLAGGPCYEQYF	TRBV24-1	TRBJ2-7
TGCAGTGCCCGGGCAGCTAGCGGGGCCGTGCAAGAGACCCAGTACTTC	CSARAASGAVQETQYF	TRBV20-1	TRBJ2-5
TGTGCCAGCAGCTTAGGTCTGACAGAGGGGTACAATGAGCAGTTCTTC	CASSLGLTEGYNEQFF	TRBV11-2	TRBJ2-1
TGCGCCAGCAGATTGGCTAGGCACAATGAGCAGTTCTTC	CASRLARHNEQFF	TRBV10-2	TRBJ2-1
TGTGCCAGCAGTGACTATGGAGGGTCTGGGGCCAACGTCCTGACTTTC	CASSDYGGSGANVLTF	TRBV25-1	TRBJ2-6
TGTGCCACCCCCGGGGGGCCCGGCGAAGGGGAGCAGTACTTC	CATPGGPGEGEQYF	TRBV24-1	TRBJ2-7
TGTGCCACAGGACTGGACAGGGGGATGGGAATAAACGAGCAGTACTTC	CATGLDRGMGINEQYF	TRBV6-6	TRBJ2-7
TGTGCCAGCACCCTCCGTACGACTAGCGGGGAGTCCTACGAGCAGTACTTC	CASTLRTTSGESYEQYF	TRBV12-4	TRBJ2-7
TGTGCCAGCAGCCCTACAGGGGTCACAGATACGCAGTATTTT	CASSPTGVTDTQYF	TRBV14	TRBJ2-3
TGTGCCAGCAGTTTGGCCCTTACCTACGAGCAGTACTTC	CASSLALTYEQYF	TRBV27	TRBJ2-7
TGTGCCAGCAGCAACAATACCTACGAGCAGTACTTC	CASSNNTYEQYF	TRBV7-2	TRBJ2-7
TGCGCCAGCAGCTCCCCACCTTCCCTAAATGGCTACACCTTC	CASSSPPSLNGYTF	TRBV5-1	TRBJ1-2
TGTGCCCGGGACAACCACAGCACCGGGGAGCTGTTTTTT	CARDNHSTGELFF	TRBV7-9	TRBJ2-2
TGTGCCAGCATGACTAGGGTCTACGAGCAGTACTTC	CASMTRVYEQYF	TRBV6-4	TRBJ2-7
TGTGCCAGTTACCGGGACAGGGCGGGCGACTCCTATAATTCACCCCTCCACTTT	CASYRDRAGDSYNSPLHF	TRBV2	TRBJ1-6
TGTGCCAGCAGCTTAGATCAGTCACAGATTAGGGATATACGATACGAGCAGTACTTC	CASSLDQSQIRDIRYEQYF	TRBV11-2	TRBJ2-7
TGTGCCAGCAGTAAGGACCAGACGCGCACAGATACGCAGTATTTT	CASSKDQTRTDTQYF	TRBV6-5	TRBJ2-3
TGCGCCAGCAGTGAGTCTCTGCTAGCTGGCTACGAGCAGTACTTC	CASSESLLAGYEQYF	TRBV10-1	TRBJ2-7
TGCAGTGCGACTTTGTGCTGGTCGGGCTGGATCTACGAGCAGTACTTC	CSATLCWSGWIYEQYF	TRBV20-1	TRBJ2-7
TGTGCCAGGTCGACGAAGGCACCTGAAGCTTTCTTT	CARSTKAPEAFF	TRBV19	TRBJ1-1
TGTGCCAGCAAGGAGACAGAGAACACTGAAGCTTTCTTT	CASKETENTEAFF	TRBV12-3	TRBJ1-1
TGTGCCAGCCGAGGGGGCCAAGCGGGTCACACTGAAGCTTTCTTT	CASRGGQAGHTEAFF	TRBV6-4	TRBJ1-1
TGTGCCAGCAGCCCACAAGGGGGCCACGAGACCCAGTACTTC	CASSPQGGHETQYF	TRBV7-3	TRBJ2-5
TGTGCCAGCAGCATTGCCGGGGGGAATCAGCCCCAGCATTTT	CASSIAGGNQPQHF	TRBV5-4	TRBJ1-5
TGTGCCAGCAGTAGGACTTTGCAGCCCCAGCATTTT	CASSRTLQPQHF	TRBV6-3	TRBJ1-5
TGTGCCAGCAGCTTAAGCCCCAGGGTCCTGGCCCAGCATTTT	CASSLSPRVLAQHF	TRBV7-3	TRBJ1-5
TGTGCCTTCAGAGATCAGCCCCAGCATTTT	CAFRDQPQHF	TRBV6-4	TRBJ1-5
TGTGCCAGCAGCTTGAGCGGTCGGGGACCCTCTGGAAACACCATATATTTT	CASSLSGRGPSGNTIYF	TRBV7-3	TRBJ1-3
TGCAGTGCTAGAGACAGCCGGGACGATGTAGAGGAAAAACTGTTTTTT	CSARDSRDDVEEKLFF	TRBV20-1	TRBJ1-4
TGCGCCAGCAGTGGACAGATCAGCTACGAGCAGTACTTC	CASSGQISYEQYF	TRBV10-1	TRBJ2-7
TGTGCCAACCCACAGGGGGCCTTAAATCAGCCCCAGCATTTT	CANPQGALNQPQHF	TRBV6-8	TRBJ1-5
TGTGCCAAAGGGGGACTAGCGGAATCACGGAGCACAGATACGCAGTATTTT	CAKGGLAESRSTDTQYF	TRBV6-2	TRBJ2-3
TGTGCCAGCAGTATCGCCGGGACAGGGAACCCTGACGAGCAGTACTTC	CASSIAGTGNPDEQYF	TRBV6-2	TRBJ2-7
TGTGCCAGCAGCCCTCCTGCTGGGGGGGCTGAAGAGACCCAGTACTTC	CASSPPAGGAEETQYF	TRBV9	TRBJ2-5
TGTGCCATCAGTGAATGGGGCTTTTATGAGCAGTTCTTC	CAISEWGFYEQFF	TRBV10-3	TRBJ2-1
TGTGCCAGCAGCTTACCCCAGGGGACAGAAAAACTGTTTTTT	CASSLPQGTEKLFF	TRBV7-9	TRBJ1-4
TGTGCCAGAGGCCCAGCAAATTACCAAGAGACCCAGTACTTC	CARGPANYQETQYF	TRBV28	TRBJ2-5
TGTGCCAGCAGGAATAACAAGGGGGGGGGCGACCTCTATGTCGAGCAGTACTTC	CASRNNKGGGDLYVEQYF	TRBV7-2	TRBJ2-7
TGTGCCAGCAGCTTCCTCAGGGGGACGGGGGCCAACGTCCTGACTTTC	CASSFLRGTGANVLTF	TRBV7-9	TRBJ2-6
TGCGCCAGCAGCCATCGTCAGGGTACCAAAAGGCATGGCTACACCTTC	CASSHRQGTKRHGYTF	TRBV4-1	TRBJ1-2
TGCAGTGACGTTATGGGACCCCCGGTCTACGAGCAGTACTTC	CSDVMGPPVYEQYF	TRBV20-1	TRBJ2-7
TGTGCCAGCAGCGCCGGATTTGGGGCCAACGTCCTGACTTTC	CASSAGFGANVLTF	TRBV7-8	TRBJ2-6
TGTGCCATCAATGAGAGCTTTAGCAATCAGCCCCAGCATTTT	CAINESFSNQPQHF	TRBV10-3	TRBJ1-5
TGTGCCACGGGGGGGGGGTTAGGGGACTCCTATAATTCACCCCTCCACTTT	CATGGGLGDSYNSPLHF	TRBV24-1	TRBJ1-6
TGTGCCATCAGTGAGTCGACTAGCGGTACGAACAGCTCCTACGAGCAGTACTTC	CAISESTSGTNSSYEQYF	TRBV10-3	TRBJ2-7
TGCAGTGCTAGTTCTAGCGTGCCGACGGGGTCCTACAATGAGCAGTTCTTC	CSASSSVPTGSYNEQFF	TRBV20-1	TRBJ2-1
TGCAGTGCTGGGTCGGGCGTCCCGGGGGCGGCGCTGTTTTTT	CSAGSGVPGAALFF	TRBV20-1	TRBJ1-4
TGTGCCAGCAGTTTAGGTGACTCAACCGGACTAGCGGGCGGAGAGACCCAGTACTTC	CASSLGDSTGLAGGETQYF	TRBV28	TRBJ2-5
TGTGCCAGCAGCTCCCGGGACAGGGGGCGCTGTAGCGCCGGGGATGGCTACACCTTC	CASSSRDRGRCSAGDGYTF	TRBV9	TRBJ1-2
TGTGCCAGCAGCGCGGTGTTGGCGACAGGGGGACGCATTCAGTACTTC	CASSAVLATGGRIQYF	TRBV7-3	TRBJ2-4
TGTGCCAGCAGCTTAGATAACCCGGGACTAGAATCAAACAATGAGCAGTTCTTC	CASSLDNPGLESNNEQFF	TRBV11-3	TRBJ2-1
TGCAGTGCTAGAGAAGCCGTACAAAATCTGAACACTGAAGCTTTCTTT	CSAREAVQNLNTEAFF	TRBV20-1	TRBJ1-1
TGTGCCAGCAGTGGGTCCTCCCATCCCAATCAGCCCCAGCATTTT	CASSGSSHPNQPQHF	TRBV6-3	TRBJ1-5
TGTGCCAGTAGTGTCCCGGGGGCTAAGGATGAAGCTTTCTTT	CASSVPGAKDEAFF	TRBV19	TRBJ1-1
TGTGCCAGCAGTCCATTCGTCTCCCCACCTAGGATCAACATTCAGTACTTC	CASSPFVSPPRINIQYF	TRBV12-4	TRBJ2-4
TGTGCCAGCAGCCACGCTCGGACAGCGATTTCCTGCAATCAGCCCCAGCATTTT	CASSHARTAISCNQPQHF	TRBV7-6	TRBJ1-5
TGTGCCACCAGCAGAGATAGGGCAGGGCGTGAAGCTTTCTTT	CATSRDRAGREAFF	TRBV15	TRBJ1-1
TGTGCCACGCCACACAGGGTCAAACCCACAGATACGCAGTATTTT	CATPHRVKPTDTQYF	TRBV6-2	TRBJ2-3
TGTGCCAGCAGGTCTCGGGAGGGTGATGAGCAGTTCTTC	CASRSREGDEQFF	TRBV6-5	TRBJ2-1
TGTGCCTGGAGTGTTGGACAGCCAAATAATTCACCCCTCCACTTT	CAWSVGQPNNSPLHF	TRBV30	TRBJ1-6
TGTGCCAGCAATGGGACAGGTCTTGAGGACACCGGGGAGCTGTTTTTT	CASNGTGLEDTGELFF	TRBV6-5	TRBJ2-2
TGTGCCAGTAGTAGGACCGGAGGACCCCCGCGCACTGAAGCTTTCTTT	CASSRTGGPPRTEAFF	TRBV19	TRBJ1-1
TGTGCCAGCAGCTTCCGGGACCAATCCTACGAGCAGTACTTC	CASSFRDQSYEQYF	TRBV7-9	TRBJ2-7
TGTGCCAGCAGTTACTCACACAGGGGAGACTATGGCTACACCTTC	CASSYSHRGDYGYTF	TRBV6-3	TRBJ1-2
TGTGCCAACCGACAGCAGGCGAACACTGAAGCTTTCTTT	CANRQQANTEAFF	TRBV28	TRBJ1-1
TGTGCCAGCAGCGTAGGGAGCCGGGACAGGGGATTCTATGGCTACACCTTC	CASSVGSRDRGFYGYTF	TRBV9	TRBJ1-2
TGCGCCAGCAGCATCAGCGCTCGGCCTTACGAGCAGTACTTC	CASSISARPYEQYF	TRBV10-1	TRBJ2-7
TGTGCCAGCAGTTTAAGGCAGGGGGAAACAGCCTACGAGCAGTACTTC	CASSLRQGETAYEQYF	TRBV28	TRBJ2-7
TGTGCCAGCAGTGAATATGCGATAGCGGGCTCGCAGTATTTT	CASSEYAIAGSQYF	TRBV25-1	TRBJ2-3
TGTGCCAGCAGCTTGGGTTCCGGGACCCCCTATAACACCGGGGAGCTGTTTTTT	CASSLGSGTPYNTGELFF	TRBV5-4	TRBJ2-2
TGTGCCAGCAGCCCACAGAGGCGTGGTCGAAAAGAGACCCAGTACTTC	CASSPQRRGRKETQYF	TRBV7-3	TRBJ2-5
TGTGCCAGCAGCCAAGATGAGGCATCCGGGGAGCTGTTTTTT	CASSQDEASGELFF	TRBV4-2	TRBJ2-2
TGTGCCAGCACGGACGGAACCTCCTACAATGAGCAGTTCTTC	CASTDGTSYNEQFF	TRBV6-2	TRBJ2-1
TGCAGCGTTCGACAGGGGAACACTGAAGCTTTCTTT	CSVRQGNTEAFF	TRBV29-1	TRBJ1-1
TGTGCCAACGTCCAGGCGAGGGGGCGAAGCAATCAGCCCCAGCATTTT	CANVQARGRSNQPQHF	TRBV2	TRBJ1-5
TGTGCCAGCAGCCAACACCGTAAGAGTCAGGTTCTCTCCTATAATTCACCCCTCCACTTT	CASSQHRKSQVLSYNSPLHF	TRBV3-1	TRBJ1-6
TGTGCCAGCAGCCCCGACAGGGCGGGGGAAGAGACCCAGTACTTC	CASSPDRAGEETQYF	TRBV7-3	TRBJ2-5
TGTGCCAGCAGTGAAAGCTCCGCCTCACTCAACCGCTACACCTTC	CASSESSASLNRYTF	TRBV2	TRBJ1-2
TGTGCCAGCAGCTTAGGCCGACAGGGACGGCAAGAGACCCAGTACTTC	CASSLGRQGRQETQYF	TRBV13	TRBJ2-5
TGTGCCAGCTCACCCTCTCCGGGACCCGTGTTCTCCTACGAGCAGTACTTC	CASSPSPGPVFSYEQYF	TRBV18	TRBJ2-7
TGCGCCAGCAGCTTGGGGGAAAACCCCGGAGAGACCCAGTACTTC	CASSLGENPGETQYF	TRBV5-1	TRBJ2-5
TGTCACCTACCTAGGACCCCGGGACTAGCGGGCAGGTACCAAGAGACCCAGTACTTC	CHLPRTPGLAGRYQETQYF	TRBV30	TRBJ2-5
TGCAGCGCACAGGGGACAGATACGCAGTATTTT	CSAQGTDTQYF	TRBV29-1	TRBJ2-3
TGTGCCACTGAAGCCCATAACGGGAGAGTCGAGCAGTACTTC	CATEAHNGRVEQYF	TRBV2	TRBJ2-7
TGTGCCAGCAGCCCCGGGGAGCCCCAGCATTTT	CASSPGEPQHF	TRBV3-1	TRBJ1-5
TGTGCCAGCAGCCAGCCCTACGAGCAGTACTTC	CASSQPYEQYF	TRBV13	TRBJ2-7
TGTGCCAGTAGTATGGTCCCGCGGGAGCTCCGGGGACATGAGCAGTTCTTC	CASSMVPRELRGHEQFF	TRBV19	TRBJ2-1
TGTGCCAGCAGTTTATACACGAGCTCTGGAAACACCATATATTTT	CASSLYTSSGNTIYF	TRBV27	TRBJ1-3
TGTGCCAGCAGCTTGGGTTGGCGGCGGAGACCGACTTCAGATACGCAGTATTTT	CASSLGWRRRPTSDTQYF	TRBV5-4	TRBJ2-3
TGTGCCAGCAGTAAATCCAGGGGGTCAGAAGCTTTCTTT	CASSKSRGSEAFF	TRBV6-5	TRBJ1-1
TGTGCCACCCCCCGGGGGGGGGGGGAAGATGAGCAGTTCTTC	CATPRGGGEDEQFF	TRBV28	TRBJ2-1
TGTGCCAGCAGCTTACCCGTCGAGGGGGGGCTAACTAGCACAGATACGCAGTATTTT	CASSLPVEGGLTSTDTQYF	TRBV7-9	TRBJ2-3
TGTGCCAGCATGGAGGAGGGGGGGGCGACCTTCCGCACAGATACGCAGTATTTT	CASMEEGGATFRTDTQYF	TRBV6-2	TRBJ2-3
TGTGCCAATCAGGGGGGACAAGAGACCCAGTACTTC	CANQGGQETQYF	TRBV6-5	TRBJ2-5
TGTGCCAGCAGTGAAAGGCCTCAGGGGTCCTACGAGCAGTACTTC	CASSERPQGSYEQYF	TRBV6-1	TRBJ2-7
TGCAGTGCTAGGCCCGACATGAACACTGAAGCTTTCTTT	CSARPDMNTEAFF	TRBV20-1	TRBJ1-1
TGCGCCAGCAGCCAAGATTACCAGCGGGACACAGATACGCAGTATTTT	CASSQDYQRDTDTQYF	TRBV4-1	TRBJ2-3
TGTGCCAGCAGCCCGATCAAGAGGGGTGGCTACACCTTC	CASSPIKRGGYTF	TRBV14	TRBJ1-2
TGCAGTGCTAGTTGGAATGACGACCGAACTCCTCCAGGGGGGACAGATACGCAGTATTTT	CSASWNDDRTPPGGTDTQYF	TRBV20-1	TRBJ2-3
TGTGCCAGTAGTATAGATCAATCCCGGGGACAGGGGACTAGGGCTAACTATGGCTACACCTTC	CASSIDQSRGQGTRANYGYTF	TRBV19	TRBJ1-2
TGTGCCAGCAGTGACGGGAGACCACAGGCCTCCAAAAACATTCAGTACTTC	CASSDGRPQASKNIQYF	TRBV6-4	TRBJ2-4
TGCGCCAGCAGCTTGGGGAGACAGCAGCGGAACACCGGGGAGCTGTTTTTT	CASSLGRQQRNTGELFF	TRBV5-1	TRBJ2-2
TGTGCCAGCCCACAGGGGCCCCCCTCGGAAAAACTGTTTTTT	CASPQGPPSEKLFF	TRBV6-1	TRBJ1-4
TGCAGTGGAGAACCTCCGGGTTCACGCGATACGCAGTATTTT	CSGEPPGSRDTQYF	TRBV20-1	TRBJ2-3
TGTGCCAGCAGCGGGATTATGATCCGACACCGGCTCTATGGCTACACCTTC	CASSGIMIRHRLYGYTF	TRBV13	TRBJ1-2
TGTGCTAGGGCCAGGGGGGGACGGGGCGGGGAGCTGTTTTTT	CARARGGRGGELFF	TRBV15	TRBJ2-2
TGTGCCACTCGGGTGGACAGGGGGCATCAAGCTTTCTTT	CATRVDRGHQAFF	TRBV7-3	TRBJ1-1
TGTGCCAGCGGGGGGGGCAGGGGTCGCGAAGGATACAATGAGCAGTTCTTC	CASGGGRGREGYNEQFF	TRBV7-6	TRBJ2-1
TGTGCTCCTGCTGCCAAAAACATTCAGTACTTC	CAPAAKNIQYF	TRBV6-5	TRBJ2-4
TGCGCCAGCAGCTTGGCCCAGTATAGCAATCAGCCCCAGCATTTT	CASSLAQYSNQPQHF	TRBV5-1	TRBJ1-5
TGTGCCAGCAGCAACGTCAGGGACAATGAGCAGTTCTTC	CASSNVRDNEQFF	TRBV13	TRBJ2-1
TGTGCCTCCCCTGGGGGGGGGAGTTTCGACTACGAGCAGTACTTC	CASPGGGSFDYEQYF	TRBV15	TRBJ2-7
TGTGCTAGCAGCTTCAACGCTGACGTCCCTCCTGGAAACACCATATATTTT	CASSFNADVPPGNTIYF	TRBV7-7	TRBJ1-3
TGTGCCAGCAGATTGTTTCGACATTCCAAAAACATTCAGTACTTC	CASRLFRHSKNIQYF	TRBV6-5	TRBJ2-4
TGCGCCAGCAGCTCGCGGGGACAGTCCAATTACGAGCAGTACTTC	CASSSRGQSNYEQYF	TRBV4-1	TRBJ2-7
TGTGCCAGCGCCTGCGGGACAGGGGTACTGTTTTTT	CASACGTGVLFF	TRBV11-3	TRBJ1-4
TGTGCCAGCAGCCGATATGGGACAGGTAGGATCCCTAATGAAAAACTGTTTTTT	CASSRYGTGRIPNEKLFF	TRBV3-1	TRBJ1-4
TGTGCCAGCACGCCTCCGGATGAGCAGTTCTTC	CASTPPDEQFF	TRBV6-5	TRBJ2-1
TGTGCCATCAGTGAGGCGGGACAGGGGACCTACAATGAGCAGTTCTTC	CAISEAGQGTYNEQFF	TRBV10-3	TRBJ2-1
TGCGCCAGCAGCTTGCCACACCGGGACAGGGGGTTGAACACTGAAGCTTTCTTT	CASSLPHRDRGLNTEAFF	TRBV5-1	TRBJ1-1
TGTGCCAGCAGTTACTCGATACAGGGGAGGGCATATGAAAAACTGTTTTTT	CASSYSIQGRAYEKLFF	TRBV6-6	TRBJ1-4
TGTGCCAGCAGCCGTAGACAGGACCTTGGCTTCCGGCCCCAGCATTTT	CASSRRQDLGFRPQHF	TRBV7-9	TRBJ1-5
TGTGCCAGCTCACACTCGGCGGGGGGGTCCGTCTTGGGATACAATGAGCAGTTCTTC	CASSHSAGGSVLGYNEQFF	TRBV18	TRBJ2-1
TGTAACCCCTCACAGGCGACTTATAGCAATCAGCCCCAGCATTTT	CNPSQATYSNQPQHF	TRBV7-9	TRBJ1-5
TGTGCCACCCAGGGGGGCTCTGGGGCCAACGTCCTGACTTTC	CATQGGSGANVLTF	TRBV24-1	TRBJ2-6
TGCATGTGGGACAGTCCCCCCGAGACCCAGTACTTC	CMWDSPPETQYF	TRBV20-1	TRBJ2-5
TGTGCCAGCAGCTTCCCTATGGCCGGCGGAGCTAACTATGGCTACACCTTC	CASSFPMAGGANYGYTF	TRBV5-4	TRBJ1-2
TGTGCCAGCAGCCATAGACAGGGGACGTATTTT	CASSHRQGTYF	TRBV9	TRBJ2-3
TGTGCCTGGCCTCAGGGACTAGCGCCCTCTTATTTT	CAWPQGLAPSYF	TRBV30	TRBJ2-3
TGTGGACCCCAGGAGAAGGCGGATTTAAACTATGGCTACACCTTC	CGPQEKADLNYGYTF	TRBV12-3	TRBJ1-2
TGCGCCAGCAGCTTGTTTCGGGACGGAAAAACAGATACGCAGTATTTT	CASSLFRDGKTDTQYF	TRBV5-1	TRBJ2-3
TGTGCCAGCAGAGATTTGGCGGCTAGGGGCAATCAGCCCCAGCATTTT	CASRDLAARGNQPQHF	TRBV6-3	TRBJ1-5
TGCGCCAGCAGCAAGGCGACTAGCGGCTGGGGCTCGAACACCGGGGAGCTGTTTTTT	CASSKATSGWGSNTGELFF	TRBV5-1	TRBJ2-2
TGTGCCAGCAGCCAAGACCGTCTCCACAGGGCGGCAGATACGCAGTATTTT	CASSQDRLHRAADTQYF	TRBV3-1	TRBJ2-3
TGTGCCAGCAGCTTTGCGGGAGCGGGACTAGCGGGGGGCTACGAGCAGTACTTC	CASSFAGAGLAGGYEQYF	TRBV5-4	TRBJ2-7
TGTGCCAGCAGGTGGACTAGCGGGGGTGAGACCCAGTACTTC	CASRWTSGGETQYF	TRBV6-4	TRBJ2-5
TGTGCCAGCACAGGGGGACTAGCGGTACGGGCAGATACGCAGTATTTT	CASTGGLAVRADTQYF	TRBV25-1	TRBJ2-3
TGTGCCAGCAGCCTCCCACTAGCGGGAGCCAGCTACGCAACCGAGCAGTACTTC	CASSLPLAGASYATEQYF	TRBV7-9	TRBJ2-7
TGTGCCAGCAGCGTAGCTAATGACGACAGGGGGCTGCATAGCAATCAGCCCCAGCATTTT	CASSVANDDRGLHSNQPQHF	TRBV9	TRBJ1-5
TGTGCCAGCAGTGAAACAGACTATGGCTACACCTTC	CASSETDYGYTF	TRBV6-4	TRBJ1-2
TGTGCCACCAGTGCAACGACAGAGGGCCCGCCCCAGCATTTT	CATSATTEGPPQHF	TRBV24-1	TRBJ1-5
TGTGCCAGCAGCCCGACTAGCGGGCCCATAACGGAGACCCAGTACTTC	CASSPTSGPITETQYF	TRBV7-9	TRBJ2-5
TGTGCCAGCAATTCCAGGCCCCAGCATTTT	CASNSRPQHF	TRBV6-1	TRBJ1-5
TGTGCCAGCAGCCAGGGGGGTGACCATCAGCCCCAGCATTTT	CASSQGGDHQPQHF	TRBV13	TRBJ1-5
TGCGCCAGCAGCCCCCAGTCCGGGACGAGGGTCTCTGGGGCCAACGTCCTGACTTTC	CASSPQSGTRVSGANVLTF	TRBV5-1	TRBJ2-6
TGTGCCAGCAGCTTGGCCCGGGGTCCCCCCCGCTGGGGAAGCCCCTACGAGCAGTACTTC	CASSLARGPPRWGSPYEQYF	TRBV5-4	TRBJ2-7
TGTGCCAGTAGTAAGAAACCGCCACGGGAGGGGACGAACACCGGGGAGCTGTTTTTT	CASSKKPPREGTNTGELFF	TRBV19	TRBJ2-2
TGCGCCAGCAGCTTGCGAACGGGTTTTTATGGCTACACCTTC	CASSLRTGFYGYTF	TRBV5-1	TRBJ1-2
TGTGCCAGCAGTGGGAAGAATAACCGGGACAGGGTAGGAGCTTTCTTT	CASSGKNNRDRVGAFF	TRBV28	TRBJ1-1
TGTGCCATCAGTGCCGGGACAGGGGGGAACACTGAAGCTTTCTTT	CAISAGTGGNTEAFF	TRBV10-3	TRBJ1-1
TGTGCCTGGAGTGAGAGGGACAGGGAAGAGACCCAGTACTTC	CAWSERDREETQYF	TRBV30	TRBJ2-5
TGTGCCAGCAGTGAAAGGGGGCCGCAAGAGACCCAGTACTTC	CASSERGPQETQYF	TRBV6-4	TRBJ2-5
TGCAGTGCTGTAAACGGTTATGGCTACACCTTC	CSAVNGYGYTF	TRBV20-1	TRBJ1-2
TGTGCCACCAGCAGGAAGGCTAGAAAGCCCTACAATGAGCAGTTCTTC	CATSRKARKPYNEQFF	TRBV15	TRBJ2-1
TGTGCCAGCAGCATCAGTAACCGATCAGAATTCGACACCGGGGAGCTGTTTTTT	CASSISNRSEFDTGELFF	TRBV5-6	TRBJ2-2
TGTGCCAGCAGACGTCAGACTGAATATGGCTACACCTTC	CASRRQTEYGYTF	TRBV28	TRBJ1-2
TGCGCCAGCAGCCAAGTTTGGGGGGGATACATTCAGTACTTC	CASSQVWGGYIQYF	TRBV4-1	TRBJ2-4
TGTGCCAGCCCCGACGGGGAGACCCAGTACTTC	CASPDGETQYF	TRBV7-6	TRBJ2-5
TGCGCCAGCCTATCCTGGGGGAAAGAGACCCAGTACTTC	CASLSWGKETQYF	TRBV5-1	TRBJ2-5
TGTGCTAGTGGTTTGGTATTCATCGGGATCGATACGCAGTATTTT	CASGLVFIGIDTQYF	TRBV12-5	TRBJ2-3
TGTGCCAGCAGCTTCGGGGGGGGGGAACCCCAGCATTTT	CASSFGGGEPQHF	TRBV11-3	TRBJ1-5
TGTGCCAGCAGAGGGGGGGGGCAGGGACTCCCCGCAGAGACCCAGTACTTC	CASRGGGQGLPAETQYF	TRBV6-5	TRBJ2-5
TGCGCCAGCACCCGCCGACAGCTTGATGGAGATACGCAGTATTTT	CASTRRQLDGDTQYF	TRBV10-2	TRBJ2-3
TGTGCCAGCAGCAAACCGGACCGGGGTACCTACGAGCAGTACTTC	CASSKPDRGTYEQYF	TRBV7-9	TRBJ2-7
TGTGCCAGCAGCTTCCAGGCATTTAATCAGCCCCAGCATTTT	CASSFQAFNQPQHF	TRBV13	TRBJ1-5
TGTGCCAGCAGCTTGAAAGCACTAGCGGGGGCCCCCAACAATGAGCAGTTCTTC	CASSLKALAGAPNNEQFF	TRBV7-3	TRBJ2-1
TGTGCCAGCAGTGGGGGACAGGAGTTCCAAGAGACCCAGTACTTC	CASSGGQEFQETQYF	TRBV27	TRBJ2-5
TGTGCCAGCAGCTTAGGGGGGCCGTCCTACAATGAGCAGTTCTTC	CASSLGGPSYNEQFF	TRBV7-3	TRBJ2-1
TGTGCCAGCAGCCTGCGGGAGTACCCGGACTACGAGCAGTACTTC	CASSLREYPDYEQYF	TRBV5-4	TRBJ2-7
TGTGCCAGCAGCTTAGAGAACAGACTAAGGGCTTTCTTT	CASSLENRLRAFF	TRBV11-2	TRBJ1-1
TGTGCCAGCAGCCCCATCAGACAGGTTATTTCTGAAGCTTTCTTT	CASSPIRQVISEAFF	TRBV7-2	TRBJ1-1
TGCGCCAGCAGGATGACACCGGCTCATCAGCCCCAGCATTTT	CASRMTPAHQPQHF	TRBV10-1	TRBJ1-5
TGTGCCAGCAGCTTGACACAGGGAATTAATCAGCCCCAGCATTTT	CASSLTQGINQPQHF	TRBV5-6	TRBJ1-5
TGTGCCAGCAGGCGGGGGACTAGCGGTTTTGGGACCCAGTACTTC	CASRRGTSGFGTQYF	TRBV6-6	TRBJ2-5
TGTGCCAGCAGTGACTCTTCAGACAGGTTAAGCAATCAGCCCCAGCATTTT	CASSDSSDRLSNQPQHF	TRBV6-4	TRBJ1-5
TGCAGCGTTGAAGATTCCTGTCAGGGGACCAGGGCAACTAATGAAAAACTGTTTTTT	CSVEDSCQGTRATNEKLFF	TRBV29-1	TRBJ1-4
TGTGCCAGCAGCCATATAGGGTCATCACCCCTCCACTTT	CASSHIGSSPLHF	TRBV14	TRBJ1-6
TGTGCCAGTTTTGTTACCCGGGACAGGGTGAACGAGCAGTACTTC	CASFVTRDRVNEQYF	TRBV19	TRBJ2-7
TGTGCCAGCTTCACTGGACAGGCGCTGAACACTGAAGCTTTCTTT	CASFTGQALNTEAFF	TRBV11-3	TRBJ1-1
TGTGCCGGTAACGCTAGCGGGGTCAATGAGCAGTTCTTC	CAGNASGVNEQFF	TRBV9	TRBJ2-1
TGTGCCACCAGTGATTCAGAGGAACACAGGGGGATAGCGAACACTGAAGCTTTCTTT	CATSDSEEHRGIANTEAFF	TRBV24-1	TRBJ1-1
TGTGCCAGCACCCCCCAGTTACCCCAGTACTTC	CASTPQLPQYF	TRBV2	TRBJ2-5
TGTGCCAGCAGCCATGGGACTAGCAGGTCCTACGAGCAGTACTTC	CASSHGTSRSYEQYF	TRBV7-9	TRBJ2-7
TGCAGCTTCCAAACAGGGTTAGAGACCCAGTACTTC	CSFQTGLETQYF	TRBV20-1	TRBJ2-5
TGTGCCAGCAGAAATCCTGGAAGGGACAGGGCTCAGAGCTCCTATAATTCACCCCTCCACTTT	CASRNPGRDRAQSSYNSPLHF	TRBV6-1	TRBJ1-6
TGTGCCTGGACCGGACAGGACTCCTACGAGCAGTACTTC	CAWTGQDSYEQYF	TRBV30	TRBJ2-7
TGTGCCAGCAGCCTGGGACTAGCGGGTTGGTACGAGCAGTACTTC	CASSLGLAGWYEQYF	TRBV5-4	TRBJ2-7
TGTGCCAGCAGTGACCGTTGGCATCAGGGGTCATACTATAGCAATCAGCCCCAGCATTTT	CASSDRWHQGSYYSNQPQHF	TRBV6-4	TRBJ1-5
TGCGCCAGCAGTGACAAGGCGTCACCCCTCCACTTT	CASSDKASPLHF	TRBV10-1	TRBJ1-6
TGTGCCAGCAGCCAAGCCCAGACGGGGGGGGATACGCAGTATTTT	CASSQAQTGGDTQYF	TRBV3-1	TRBJ2-3
TGTGCCAGCAGCGCGAGGGGGGGAATACTCGAGCAGTACTTC	CASSARGGILEQYF	TRBV5-6	TRBJ2-7
TGTGCCAGCCAGGGCTGGGGTGATTCGGATAATTCACCCCTCCACTTT	CASQGWGDSDNSPLHF	TRBV6-6	TRBJ1-6
TGTGCCAGCAGCTTGGGAGGTGAAGCTTTCTTT	CASSLGGEAFF	TRBV7-3	TRBJ1-1
TGTGCCAGCAGCAGGCACAGGGGACGGGCTCATAACATTCAGTACTTC	CASSRHRGRAHNIQYF	TRBV9	TRBJ2-4
TGTGCCAGCAGTCTTGGGACTAGTCCAGATACGCAGTATTTT	CASSLGTSPDTQYF	TRBV6-5	TRBJ2-3
TGCGCCAGCAGGCCACAGGGAAGGGAAAAACTGTTTTTT	CASRPQGREKLFF	TRBV10-2	TRBJ1-4
TGTGCCAGCAGGGCTGATAGCTGTGCCTACGAGCAGTACTTC	CASRADSCAYEQYF	TRBV9	TRBJ2-7
TGTGCCAGCGCCGGTTGGGCCCGGGTCACTGGAAACACCATATATTTT	CASAGWARVTGNTIYF	TRBV28	TRBJ1-3
TGCGCCAGCAGTAAATCCAGGGCCCCATCACCCCTCCACTTT	CASSKSRAPSPLHF	TRBV10-2	TRBJ1-6
TGCGCCAGCAGCCAAGCCGGTCAGAGGGCAGGAATTCACACTGAAGCTTTCTTT	CASSQAGQRAGIHTEAFF	TRBV4-1	TRBJ1-1
TGTGCCAGTAGTATAGATAAGCCGGGACACCTTATTACCATTCAGTACTTC	CASSIDKPGHLITIQYF	TRBV19	TRBJ2-4
TGTGCCAGCAGACGGCTAGTCGGGAGTGACGAGCAGTACTTC	CASRRLVGSDEQYF	TRBV6-3	TRBJ2-7
TGTGCCAGCAGGACAGGGAGTCTGAACACTGAAGCTTTCTTT	CASRTGSLNTEAFF	TRBV6-4	TRBJ1-1
TGTGCTAGCCTGACAGGGGGCTGGGCGACTAACTATGGCTACACCTTC	CASLTGGWATNYGYTF	TRBV12-5	TRBJ1-2
TGCGCCAGCAGTGATGGACCCCTAAACATTCAGTACTTC	CASSDGPLNIQYF	TRBV10-1	TRBJ2-4
TGTGCCAGCAGTGAACCCGGGGGGAGTGGAGAGCAGTACTTC	CASSEPGGSGEQYF	TRBV2	TRBJ2-7
TGTGCCAGCTCACCAGTGGTAGACAGGGACGCTGGAAACACCATATATTTT	CASSPVVDRDAGNTIYF	TRBV18	TRBJ1-3
TGTGCCAGCAGCAGGGGAACCGGACAGGGGTCCAGCTCCTACAATGAGCAGTTCTTC	CASSRGTGQGSSSYNEQFF	TRBV11-2	TRBJ2-1
TGCAGTGCTAGAGCGAGGACAGGGGGCGGCTACGAGCAGTACTTC	CSARARTGGGYEQYF	TRBV20-1	TRBJ2-7
TGTGCCAGCAGTACCCCAGGGGGAACGCCCCAGCATTTT	CASSTPGGTPQHF	TRBV12-4	TRBJ1-5
TGCAGTGCTGCCACTGCGGACAGAGCGAGGGACAATGAGCAGTTCTTC	CSAATADRARDNEQFF	TRBV20-1	TRBJ2-1
TGTGCCAGCAGCGGACGGAGAGGACTAGCAAATAGCGCCACCGGGGAGCTGTTTTTT	CASSGRRGLANSATGELFF	TRBV7-3	TRBJ2-2
TGTGCCAGCAGCGCCAGGGTCCCTGGAAACACCATATATTTT	CASSARVPGNTIYF	TRBV9	TRBJ1-3
TGTGCCAGCAGCGAAAGAGAGGGGGGGTGGAGGACCCAGTACTTC	CASSEREGGWRTQYF	TRBV9	TRBJ2-5
TGTGCCAGCAGCCAGGGGGCGGGCAATCAGCCCCAGCATTTT	CASSQGAGNQPQHF	TRBV13	TRBJ1-5
TGTGCCATTTTTGCAAGCGGGGAGCTGTTTTTT	CAIFASGELFF	TRBV18	TRBJ2-2
TGTGCCAGCAGGGGGGGGAGGCAAGAGACCCAGTACTTC	CASRGGRQETQYF	TRBV9	TRBJ2-5
TGTGCCAGTAGCGGGCCGGGGAGGTCTGGGGCCAACGTCCTGACTTTC	CASSGPGRSGANVLTF	TRBV19	TRBJ2-6
TGCGCCAGCAGCCAAGATGGGGGGGGCTCCTATAATTCACCCCTCCACTTT	CASSQDGGGSYNSPLHF	TRBV4-1	TRBJ1-6
TGTGCCAGCAGCCAATGGGGACTAGCGGGGCAGTTCTTC	CASSQWGLAGQFF	TRBV13	TRBJ2-1
TGTGCCAGCAGTGAAGGGTGTCCCGGGACTAGCGGGTCAGATGACACCGGGGAGCTGTTTTTT	CASSEGCPGTSGSDDTGELFF	TRBV2	TRBJ2-2
TGCGCCAAGAAGAGAGAAAAACTGTTTTTT	CAKKREKLFF	TRBV5-1	TRBJ1-4
TGTGCCAGCAGCGCGAGAGACAGGGGTAGCGAGCAGTACTTC	CASSARDRGSEQYF	TRBV9	TRBJ2-7
TGCAGTGCTAGAGCCCACTCAGTAGATGAAAAACTGTTTTTT	CSARAHSVDEKLFF	TRBV20-1	TRBJ1-4
TGTGCCATCCCCCCAGGGCGACATCAGCCCCAGCATTTT	CAIPPGRHQPQHF	TRBV9	TRBJ1-5
TGTGCCAGCAGCGTCGAACCTGGGGGGGGCCGGCATAGCGACTACGAGCAGTACTTC	CASSVEPGGGRHSDYEQYF	TRBV9	TRBJ2-7
TGCGCCAGCAGTGAGTCCTGGCCAGGGGGGTGGGTATCTGGCTACACCTTC	CASSESWPGGWVSGYTF	TRBV10-1	TRBJ1-2
TGTGCCAGCAGCTCTGGCAGGGGGGCCTATGGCTACACCTTC	CASSSGRGAYGYTF	TRBV7-3	TRBJ1-2
TGCGCCAGCAGCGTTTTAAGCGGACAAAGGGAGACCCAGTACTTC	CASSVLSGQRETQYF	TRBV5-1	TRBJ2-5
TGTGCCAGCAGCATGCAACAAGGGCAGAAAGGCACTGAAGCTTTCTTT	CASSMQQGQKGTEAFF	TRBV7-3	TRBJ1-1
TGTGCCAGCAGCGCCAGTGATCTGGCCCAAAGCTCCTACGAGCAGTACTTC	CASSASDLAQSSYEQYF	TRBV13	TRBJ2-7
TGTGCCAGCAGTTTACCCTGGGGACAACTCGGATACAATGAGCAGTTCTTC	CASSLPWGQLGYNEQFF	TRBV12-3	TRBJ2-1
TGCGCCAGCAGTGATAGGGGGGGAGACGAGCAGTACTTC	CASSDRGGDEQYF	TRBV10-1	TRBJ2-7
TGTGCCAGCTCACCGGGAGGGGGGTTCGAGCAGTACTTC	CASSPGGGFEQYF	TRBV18	TRBJ2-7
TGTGCCAGCAGTACCCATGAGACCCAGTACTTC	CASSTHETQYF	TRBV2	TRBJ2-5
TGTGCCAGCAGCGTGCGGGACAGGGGCTATGGCTACACCTTC	CASSVRDRGYGYTF	TRBV9	TRBJ1-2
TGTGCCTGGCCCAAGGCACGCAATCAGCCCCAGCATTTT	CAWPKARNQPQHF	TRBV30	TRBJ1-5
TGTGCCAGCAGCCATCCTACTTACTTGGGTGGCTCCTACGAGCAGTACTTC	CASSHPTYLGGSYEQYF	TRBV9	TRBJ2-7
TGTGCCACCAGTGATTTGAGTCTAGCGGGCGATTACGAGCAGTACTTC	CATSDLSLAGDYEQYF	TRBV24-1	TRBJ2-7
TGCGCCAGCATCCCGACTAGCGGGGGGGCAAATTTAACCTACGAGCAGTACTTC	CASIPTSGGANLTYEQYF	TRBV10-1	TRBJ2-7
TGTGCCGGGGGCAAAAGGGAAGGGGATACGCAGTATTTT	CAGGKREGDTQYF	TRBV30	TRBJ2-3
TGTGCCGCACAGGGGGATAACCGCACAGATACGCAGTATTTT	CAAQGDNRTDTQYF	TRBV24-1	TRBJ2-3
TGCGCCAGCAGCTTGTTTTCCACGGACGTGGGGACTGAAGCTTTCTTT	CASSLFSTDVGTEAFF	TRBV5-1	TRBJ1-1
TGTGCCAGCAGCCAAGATTACACAGGGGGGGACACCGGGGAGCTGTTTTTT	CASSQDYTGGDTGELFF	TRBV4-2	TRBJ2-2
TGCAGTGCTAGAGAAGCCTACTGGACAGGCATCTTTCGGGCAACTAATGAAAAACTGTTTTTT	CSAREAYWTGIFRATNEKLFF	TRBV20-1	TRBJ1-4
TGCGCCAGCAGGATACGGGAGGACCAGTACTTC	CASRIREDQYF	TRBV5-1	TRBJ2-5
TGTGCCAGCACCCCGAGCCGGGACAAGGGAGTTACTGAAGCTTTCTTT	CASTPSRDKGVTEAFF	TRBV12-3	TRBJ1-1
TGTGCCAGCAGTGACAACTGCGGGAGTTTCGAGACCCAGTACTTC	CASSDNCGSFETQYF	TRBV6-1	TRBJ2-5
TGCAGCGTTGGACAGGGCTATGGCTACACCTTC	CSVGQGYGYTF	TRBV29-1	TRBJ1-2
TGTGCACAACAGGGCTACGAGCAGTACTTC	CAQQGYEQYF	TRBV6-4	TRBJ2-7
TGTGCCAGCAGTGGCAGGACAGGGCTCGGACGTAGGGAGACCCAGTACTTC	CASSGRTGLGRRETQYF	TRBV6-4	TRBJ2-5
TGCGCCAGCAGCCTTCGGGGAATAGCGTGGGTCTTC	CASSLRGIAWVF	TRBV4-1	TRBJ2-1
TGTGCCGTCCTAGCGGGGTTAGGCACAGATACGCAGTATTTT	CAVLAGLGTDTQYF	TRBV7-9	TRBJ2-3
TGTGCCAGCAGCTGGGCGAAAGTGGACAGATGTGAGCAGTTCTTC	CASSWAKVDRCEQFF	TRBV5-5	TRBJ2-1
TGCAGTGCGCAAAAACAGGGGGACACCGGGGAGCTGTTTTTT	CSAQKQGDTGELFF	TRBV20-1	TRBJ2-2
TGTGCCAGCAGCGTAGTTCCAGGGGGACAATCCTACGAGCAGTACTTC	CASSVVPGGQSYEQYF	TRBV9	TRBJ2-7
TGTGCCAGCAGCTTCAGTTTAGCGGGACAGGCCGAGCCCCAGCATTTT	CASSFSLAGQAEPQHF	TRBV7-3	TRBJ1-5
TGCGCCAGCCTGAAAAGGGGACAGGAGTCCTACGAGCAGTACTTC	CASLKRGQESYEQYF	TRBV5-1	TRBJ2-7
TGTGCCAGCAGTTATACTCCGGCGACAGATTCACCTCAGCCCCAGCATTTT	CASSYTPATDSPQPQHF	TRBV27	TRBJ1-5
TGTGCCGAGGGGGCCCCCGAGCAGTACTTC	CAEGAPEQYF	TRBV27	TRBJ2-7
TGTGCCACCAGTCGAGTCAGGGGTTGGGATGGCTACACCTTC	CATSRVRGWDGYTF	TRBV24-1	TRBJ1-2
TGTGCCAGTAGTAACAGCGGTAATCCCTCTGGAAACACCATATATTTT	CASSNSGNPSGNTIYF	TRBV19	TRBJ1-3
TGTGCCAGCAAAAACTTAGGGCCCTCTGGAAACACCATATATTTT	CASKNLGPSGNTIYF	TRBV27	TRBJ1-3
TGTGCCAGCAGTCCGGGGGCAGGGGGCTCCTACGAGCAGTACTTC	CASSPGAGGSYEQYF	TRBV28	TRBJ2-7
TGTGCCTGGAGTGCCCACCACTATCTAGGGGACAATGAGCAGTTCTTC	CAWSAHHYLGDNEQFF	TRBV30	TRBJ2-1
TGTGCCAGTAGTATGGGCAGCGGCGAGGCGGTTGAGCAGTTCTTC	CASSMGSGEAVEQFF	TRBV19	TRBJ2-1
TGTGCCAGCAGCCTCGAGGACAGTCACACTGAAGCTTTCTTT	CASSLEDSHTEAFF	TRBV9	TRBJ1-1
TGCGCCAGCAGCCAAAGCGAGGGCCGGTGCGGCACCGATAGCAATCAGCCCCAGCATTTT	CASSQSEGRCGTDSNQPQHF	TRBV4-3	TRBJ1-5
TGTGCCAGCAGGGGAGGCTCTGGGGCCAACGTCCTGACTTTC	CASRGGSGANVLTF	TRBV9	TRBJ2-6
TGTGCCAGCAGTGACAAACCGAAAGCCGGGACGGGAGTCAAGTATAACTATGGCTACACCTTC	CASSDKPKAGTGVKYNYGYTF	TRBV6-1	TRBJ1-2
TGTGCCAGCAGTTTCTTTCGGGAGTGGGCCTACGAGCAGTACTTC	CASSFFREWAYEQYF	TRBV12-4	TRBJ2-7
TGTGCCAGCAGTTACTCGGGCCCGGGACAGGGAAGCTACGAGCAGTACTTC	CASSYSGPGQGSYEQYF	TRBV6-5	TRBJ2-7
TGTGCCAGTAAAAGGTTGCTAGCGGGGGTGAGATCCTACGAGCAGTACTTC	CASKRLLAGVRSYEQYF	TRBV19	TRBJ2-7
TGTGCCAGCAGCTTGGCCACCCCCCCCCGGGACAGGGCGCCCCGGAACACTGAAGCTTTCTTT	CASSLATPPRDRAPRNTEAFF	TRBV5-4	TRBJ1-1
TGTGCTAGTGGTTGTTCTGGTCGTAAGAACACTGAAGCTTTCTTT	CASGCSGRKNTEAFF	TRBV12-5	TRBJ1-1
TGTGCCAGCAGGGGGGGTATGACCTACGAGCAGTACTTC	CASRGGMTYEQYF	TRBV2	TRBJ2-7
TGCATAGGTCACGAGCAGTACTTC	CIGHEQYF	TRBV20-1	TRBJ2-7
TGTGCCAGCAGAAGACTAGCGGGGGGGCAAAAGGGCCAAGAGACCCAGTACTTC	CASRRLAGGQKGQETQYF	TRBV6-4	TRBJ2-5
TGTGCCAGCAGCCAAGAGGAGCGCGGGAGTTGCCCCGAGCAGTACTTC	CASSQEERGSCPEQYF	TRBV14	TRBJ2-7
TGTGCCATCAGTCTACCTCGGGACAGGGTTCGAAGCTACGAGCAGTACTTC	CAISLPRDRVRSYEQYF	TRBV10-3	TRBJ2-7
TGCGCCAGCAGGGCCCCCGTTGAACTTGCCGGGACAGGGAGAGGTCAGACCCGGGGAGAAAATCAGCCCCAGCATTTT	CASRAPVELAGTGRGQTRGENQPQHF	TRBV10-1	TRBJ1-5
TGTGCCAGCAGTTTATTCTCCCGTTGGTGTGAAGCTTTCTTT	CASSLFSRWCEAFF	TRBV28	TRBJ1-1
TGCGCCAGCAGCTTGATGATCGCCTCAAAGGGTGTCATATATTTT	CASSLMIASKGVIYF	TRBV5-1	TRBJ1-3
TGTGCCAGCAGCGCGGCCCGTACTCTATTAGAGGAGAATTCACCCCTCCACTTT	CASSAARTLLEENSPLHF	TRBV12-3	TRBJ1-6
TGTGCCACCAGCCCCTACGCAAGCTTATACAGGATGCAAGAGACCCAGTACTTC	CATSPYASLYRMQETQYF	TRBV15	TRBJ2-5
TGCAGTGCTAGACGCCAAGAGACCCAGTACTTC	CSARRQETQYF	TRBV20-1	TRBJ2-5
TGTGCCAGCGCCAACCGAGTGAACTATGGCTACACCTTC	CASANRVNYGYTF	TRBV7-9	TRBJ1-2
TGCAGTGCTAGAGTGGTGTTACCGGGATGGGGGGGGGAAAGGCAAGACAATGAGCAGTTCTTC	CSARVVLPGWGGERQDNEQFF	TRBV20-1	TRBJ2-1
TGTGCCACCAGTGATGGGTTGGGGAGGGGCACTGGAAACACCATATATTTT	CATSDGLGRGTGNTIYF	TRBV24-1	TRBJ1-3
TGTGCCAGCAGCGCGGCCTCTTCTAGTCTGCCCGACAATGAGCAGTTCTTC	CASSAASSSLPDNEQFF	TRBV9	TRBJ2-1
TGTGCCAGCATTGTGACTAGGTACGAGCAGTACTTC	CASIVTRYEQYF	TRBV12-3	TRBJ2-7
TGTGCCAGTACGGGGGCTGAAGCTTTCTTT	CASTGAEAFF	TRBV19	TRBJ1-1
TGCGCCAGCAGCCCACCAGACAGGGGTCCAACTAATGAAAAACTGTTTTTT	CASSPPDRGPTNEKLFF	TRBV5-1	TRBJ1-4
TGTGCCAGCAGTCTCCCGGGAGGGACCCAGCCCCAGCATTTT	CASSLPGGTQPQHF	TRBV27	TRBJ1-5
TGTGCCAGCAGTGACTCGATCCACAGGGATGATAGCAATCAGCCCCAGCATTTT	CASSDSIHRDDSNQPQHF	TRBV6-4	TRBJ1-5
TGTGCCAGCAGAAGGGCCCATGGGGGGGTAGGGAATGAGCAGTTCTTC	CASRRAHGGVGNEQFF	TRBV6-5	TRBJ2-1
TGTGCCAGCAGCTTAGAAAGGCCGACTAGAGAGACCCAGTACTTC	CASSLERPTRETQYF	TRBV11-2	TRBJ2-5
TGTGCCAGCAGGACTCCGCCCCAGCATTTT	CASRTPPQHF	TRBV5-6	TRBJ1-5
TGTGCCAGCAGCCAACCGGGGGGGCGGGTCAATCAGCCCCAGCATTTT	CASSQPGGRVNQPQHF	TRBV14	TRBJ1-5
TGCAGTGCGGAAAAGGGGTTTGATAGAAACACCATATATTTT	CSAEKGFDRNTIYF	TRBV20-1	TRBJ1-3
TGCAGCGTTGAAGATCTTAAGAGACAGGGGGTTGAGACCCAGTACTTC	CSVEDLKRQGVETQYF	TRBV29-1	TRBJ2-5
TGTGCCAGCAGCTTTGAGGAAGCTGAAGCTTTCTTT	CASSFEEAEAFF	TRBV5-5	TRBJ1-1
TGTGCCAGCAGCTGGGACAGGGGGAACTATGGCTACACCTTC	CASSWDRGNYGYTF	TRBV7-9	TRBJ1-2
TGTGCCAGCAGCTTAGATATGCGGGAGACGTCCCGGTATGGCTACACCTTC	CASSLDMRETSRYGYTF	TRBV7-6	TRBJ1-2
TGTGCCAGCTCACCACGGAGGTTGACAGGTTATGGCTACACCTTC	CASSPRRLTGYGYTF	TRBV18	TRBJ1-2
TGTGCCAGCAGCACCCACAGGGCCTATGGCTACACCTTC	CASSTHRAYGYTF	TRBV6-4	TRBJ1-2
TGTGCCAGCAGCCAAGAGGAAGGGGCAGGTGGCTACACCTTC	CASSQEEGAGGYTF	TRBV3-1	TRBJ1-2
TGTGCCAGCACCGGACAGGGAGGCTATGGCTACACCTTC	CASTGQGGYGYTF	TRBV9	TRBJ1-2
TGTGCCAGCAGCTTAGACGGCCGGGAGGATTGCACAGATACGCAGTATTTT	CASSLDGREDCTDTQYF	TRBV7-9	TRBJ2-3
TGTGCCAGCAGTGACATGCCCCTGGGACCCTGGGGTCAGCCCCAGCATTTT	CASSDMPLGPWGQPQHF	TRBV6-4	TRBJ1-5
TGTGCCAGCAGCCCCGAGCCAGGAGAATGTAGGGCGGGGCCCCAGCATTTT	CASSPEPGECRAGPQHF	TRBV7-9	TRBJ1-5
TGCGCCAGCAGCTTCAAGGAACAGGGGCTGGAGTACTTC	CASSFKEQGLEYF	TRBV5-1	TRBJ2-7
TGTGCCAGCAGTGAATATACGATCCACTATGGCTACACCTTC	CASSEYTIHYGYTF	TRBV25-1	TRBJ1-2
TGCAGTGCTAGGCATTCCCAAATTGTCTCTGGAAACACCATATATTTT	CSARHSQIVSGNTIYF	TRBV20-1	TRBJ1-3
TGTGCCAGCAGCAGCAGCATTGAGCAGACCTACGAGCAGTACTTC	CASSSSIEQTYEQYF	TRBV6-4	TRBJ2-7
TGCAGTGCTAGGCAACGTCTAGCGGGGGGCTACGAGCAGTACTTC	CSARQRLAGGYEQYF	TRBV20-1	TRBJ2-7
TGTGCCAGCAGCCGTACAGGGGGCTACACCTTC	CASSRTGGYTF	TRBV9	TRBJ1-2
TGTGCCAGCAGCCGCTGTACAGGTACGCAGTACTTC	CASSRCTGTQYF	TRBV5-4	TRBJ2-7
TGCAGTGCTCGGGGCAGGGGACAGGGGTCTCCCTATGGCTACACCTTC	CSARGRGQGSPYGYTF	TRBV20-1	TRBJ1-2
TGTGCCAGCAGCTCGGCCCAGGGGACTTTAGCTGGAAACACCATATATTTT	CASSSAQGTLAGNTIYF	TRBV9	TRBJ1-3
TGTGCCAGCAGCCATCTCGGCACATTCGAGGGCCCCTACGAGCAGTACTTC	CASSHLGTFEGPYEQYF	TRBV13	TRBJ2-7
TGTGCCAGCAGCCAAGCTATTCGGGAGACCCAGTACTTC	CASSQAIRETQYF	TRBV14	TRBJ2-5
TGTGCCAGCAGCCCCCTCCCTGGGAGGCGCTACGAGCAGTACTTC	CASSPLPGRRYEQYF	TRBV6-2	TRBJ2-7
TGTGCCATCAGAATCACGAACAATGAGCAGTTCTTC	CAIRITNNEQFF	TRBV10-3	TRBJ2-1
TGTGCCAGCAGCCCCAAGATGGGACTAGCGGGGGGGCTGACCACGGCCTACAATGAGCAGTTCTTC	CASSPKMGLAGGLTTAYNEQFF	TRBV11-3	TRBJ2-1
TGTGCCAGCATATCGGGAGGGAACACTGAAGCTTTCTTT	CASISGGNTEAFF	TRBV6-6	TRBJ1-1
TGTGCCAGCAGCCAAGAGGAGCCCGGGACAGTAGGGGCCTTC	CASSQEEPGTVGAF	TRBV3-1	TRBJ1-2
TGTGCCAGCTCACCGCCCCCCGGGACAGGGAAACATCAGCCCCAGCATTTT	CASSPPPGTGKHQPQHF	TRBV18	TRBJ1-5
TGTGCCAGCAGCTTATCCTTATCTCGGGACAGGGGGCAGCCTCGGACCGGGGAGCTGTTTTTT	CASSLSLSRDRGQPRTGELFF	TRBV7-2	TRBJ2-2
TGCAGTGCTAGCCGGGACAGGGCTAAGGGCATGGATCAGCCCCAGCATTTT	CSASRDRAKGMDQPQHF	TRBV20-1	TRBJ1-5
TGTGCCAGCGCCTCAAACAGGGGCCTATGGAACACCATATATTTT	CASASNRGLWNTIYF	TRBV19	TRBJ1-3
TGTGCCAGCAGACCGGGGGGTGTAGACCTCACTGAAGCTTTCTTT	CASRPGGVDLTEAFF	TRBV6-6	TRBJ1-1
TGTGCCAGTGGCGGGGACAGGGATTCACCCCTCCACTTT	CASGGDRDSPLHF	TRBV12-3	TRBJ1-6
TGTGCCAGCAGAGTCAGGGTTCCGACGAGGTTAAATGAGCAGTTCTTC	CASRVRVPTRLNEQFF	TRBV6-5	TRBJ2-1
TGTGCTACAGTCCTAGGCTCTTTTTTCCCCGGAAACACTGAAGCTTTCTTT	CATVLGSFFPGNTEAFF	TRBV12-5	TRBJ1-1
TGTGCCAGCCGTGGGGGCGAGGACGAGCAGTACTTC	CASRGGEDEQYF	TRBV6-5	TRBJ2-7
TGCGCCCCCGGGAGCCAGTCCCCAACTAATGAAAAACTGTTTTTT	CAPGSQSPTNEKLFF	TRBV10-1	TRBJ1-4
TGTGCCAGCAGTGGACGGAGGTCGCCCCAGCATTTT	CASSGRRSPQHF	TRBV25-1	TRBJ1-5
TGTGCCAGCGAGCCTCGTCCCCAGGAAAAACTGTTTTTT	CASEPRPQEKLFF	TRBV27	TRBJ1-4
TGCAGCGTTGACACAGGGGAAGCTTTCTTT	CSVDTGEAFF	TRBV29-1	TRBJ1-1
TGTGCCTTAGCACGGACTAGCGGGTTTCGATACAATGAGCAGTTCTTC	CALARTSGFRYNEQFF	TRBV9	TRBJ2-1
TGTGCCAGCAGCCAAGATCTTTGGGGGAAATCCTACGAGCAGTACTTC	CASSQDLWGKSYEQYF	TRBV14	TRBJ2-7
TGTGCCAGCAGCTTGGACGGGAGGCTAACGCCGGGAAGCACAGATACGCAGTATTTT	CASSLDGRLTPGSTDTQYF	TRBV5-6	TRBJ2-3
TGTGCCAGCGAAGTGCGGGGGAGCTGTGATGAGCAGTTCTTC	CASEVRGSCDEQFF	TRBV6-1	TRBJ2-1
TGTGCCAGCAGTAGATACCAGGATCTAGAAAAACTGTTTTTT	CASSRYQDLEKLFF	TRBV27	TRBJ1-4
TGTGCCAGCAGCTTGGCCGTCCCGGAGGGTCCAGATACGCAGTATTTT	CASSLAVPEGPDTQYF	TRBV5-4	TRBJ2-3
TGTGCTAGTGGTACAGGAGGGGGGTTGGGCACAGATACGCAGTATTTT	CASGTGGGLGTDTQYF	TRBV12-5	TRBJ2-3
TGTGCCATCAAGGAACCCGGGACTGAAGCTTTCTTT	CAIKEPGTEAFF	TRBV10-3	TRBJ1-1
TGTGCCAGCTCGGGACACATTCGTGAGCAGTACTTC	CASSGHIREQYF	TRBV27	TRBJ2-7
TGCTCGGGGGGAACTATGCGCCACACTGAAGCTTTCTTT	CSGGTMRHTEAFF	TRBV20-1	TRBJ1-1
TGTGCCAGCAGCTTAGGGACAGTAGGATCCTATAATTCACCCCTCCACTTT	CASSLGTVGSYNSPLHF	TRBV7-9	TRBJ1-6
TGTGCCAGCAGTGACGGGGGGGGAGTCTTAAACACAGATACGCAGTATTTT	CASSDGGGVLNTDTQYF	TRBV27	TRBJ2-3
TGTGCCAGCAGCTCCCCGGACAATCAGCCCCAGCATTTT	CASSSPDNQPQHF	TRBV7-9	TRBJ1-5
TGCAGTGCTAGAGACCTCGCCACGTTTCAAGCGGGGCAAGAGACCCAGTACTTC	CSARDLATFQAGQETQYF	TRBV20-1	TRBJ2-5
TGTGCCCGGTCGATGGACAGCTCTGGGGCCAACGTCCTGACTTTC	CARSMDSSGANVLTF	TRBV24-1	TRBJ2-6
TGTGCCAGCAGCAGGGGGCTAGACGGGAACACTGAAGCTTTCTTT	CASSRGLDGNTEAFF	TRBV9	TRBJ1-1
TGTGCCAGCAGCGGTAGACTAGCGGCGAGCAGCTCCTACAATGAGCAGTTCTTC	CASSGRLAASSSYNEQFF	TRBV5-4	TRBJ2-1
TGCAGTGCTGGACTAGCGGGATCGATCTACGAGCAGTACTTC	CSAGLAGSIYEQYF	TRBV20-1	TRBJ2-7
TGTGCCAGCCCTCTAGCCATTTCCTACAATGAGCAGTTCTTC	CASPLAISYNEQFF	TRBV6-4	TRBJ2-1
TGTGCCAGCAGCGCGGGAAAGGGGCACACTGAAGCTTTCTTT	CASSAGKGHTEAFF	TRBV9	TRBJ1-1
TGTGCCAAACGTCATTTGAGCTATGGCTACACCTTC	CAKRHLSYGYTF	TRBV9	TRBJ1-2
TGTGCCACCTTGCACAGGGGGATATACGCTTTCTTT	CATLHRGIYAFF	TRBV28	TRBJ1-1
TGTGCCAGCAGTTTATTGCGGCCATTCGGGAATGAGCAGTTCTTC	CASSLLRPFGNEQFF	TRBV12-3	TRBJ2-1
TGTGCCAGCACCTGGGGGACAGGGAGCTCCTACGAGCAGTACTTC	CASTWGTGSSYEQYF	TRBV12-3	TRBJ2-7
TGTGCTAGTGGTTTGGGTAGTCAGGGGGCCGGGGAGCTGTTTTTT	CASGLGSQGAGELFF	TRBV12-5	TRBJ2-2
TGCGCCAGCAGCCAAGAGGCCCAGGGGGCCAATCAGCCCCAGCATTTT	CASSQEAQGANQPQHF	TRBV4-3	TRBJ1-5
TGCAGTGCTACAAAAAACGGGGGGAACACCGGGGAGCTGTTTTTT	CSATKNGGNTGELFF	TRBV20-1	TRBJ2-2
TGTGCCAGCAGGCCTCCTCCCGGGACTAGCTCGGCCTACGAGCAGTACTTC	CASRPPPGTSSAYEQYF	TRBV9	TRBJ2-7
TGTGCCAGCGGTACTTATAGCAATCAGCCCCAGCATTTT	CASGTYSNQPQHF	TRBV7-6	TRBJ1-5
TGCACCGGGGACGCATATTTT	CTGDAYF	TRBV20-1	TRBJ1-3
TGTGCTAGCAGCTTCCTGAGCTTTGGGGGACTTGATGAGCAGTTCTTC	CASSFLSFGGLDEQFF	TRBV7-7	TRBJ2-1
TGTGCCAGCAGCTTGACTCGAGTTTCTGAAGCTTTCTTT	CASSLTRVSEAFF	TRBV5-6	TRBJ1-1
TGTGCCAGCAGACGAGCAGGTAACGAGCAGTACTTC	CASRRAGNEQYF	TRBV6-2	TRBJ2-7
TGTGCCAGCAAGCGGCGAAATGAGCAGTTCTTC	CASKRRNEQFF	TRBV12-3	TRBJ2-1
TGCGCCAGCAGCTTGCTGCCCAATGAGCAGTTCTTC	CASSLLPNEQFF	TRBV5-1	TRBJ2-1
TGTGCCAGCAGCTTATCATATCGGTATGAGCAGTTCTTC	CASSLSYRYEQFF	TRBV5-8	TRBJ2-1
TGTGCCAGCAGCTTGGATTCACAGGGTCAATCATTAGGGTATGGCTACACCTTC	CASSLDSQGQSLGYGYTF	TRBV7-2	TRBJ1-2
TGTGCCAGCAGCCAACCCACTAGTAATGAGCAGTTCTTC	CASSQPTSNEQFF	TRBV14	TRBJ2-1
TGTGCCAGCATTCCAGGCAGGCCAGAATCCTATAATTCACCCCTCCACTTT	CASIPGRPESYNSPLHF	TRBV7-2	TRBJ1-6
TGTGCCTGGAAGATCCGATGGAGAAGAGTAGACACTGAAGCTTTCTTT	CAWKIRWRRVDTEAFF	TRBV30	TRBJ1-1
TGTGCCAGCAGATGGAAAAGACGGGGCAATCAGCCCCAGCATTTT	CASRWKRRGNQPQHF	TRBV5-5	TRBJ1-5
TGTGCCAGCAGTTACGGGGACAGGGAAATGAACACTGAAGCTTTCTTT	CASSYGDREMNTEAFF	TRBV6-5	TRBJ1-1
TGTGCCAGTCCAGGGCTTAACACTGAAGCTTTCTTT	CASPGLNTEAFF	TRBV28	TRBJ1-1
TGTGCCACACCGGGACAGGGCTACGAGCAGTACTTC	CATPGQGYEQYF	TRBV6-2	TRBJ2-7
TGCAGCGGGACAAATGATCGGGGGGACGGCTACGAGCAGTACTTC	CSGTNDRGDGYEQYF	TRBV29-1	TRBJ2-7
TGCAGTGCTAGGGACGCGGGAGGGCCCTGGGCTTGGAACACCGGGGAGCTGTTTTTT	CSARDAGGPWAWNTGELFF	TRBV20-1	TRBJ2-2
TGCAGTGCTAGAGAGACTAGCGGGGACTACGAGCAGTACTTC	CSARETSGDYEQYF	TRBV20-1	TRBJ2-7
TGTGCCAGCAGTGCTAGCGGGGGGTCCCAAACCCAGTACTTC	CASSASGGSQTQYF	TRBV2	TRBJ2-5
TGTGCCAGCAGCGTGCATTCTGGACAGGGGTATCCTTCCTACGAGCAGTACTTC	CASSVHSGQGYPSYEQYF	TRBV9	TRBJ2-7
TGTGCCATCAGTGAAATTGGTGTCCTAGCGGGACCAGGTTCCTACGAGCAGTACTTC	CAISEIGVLAGPGSYEQYF	TRBV10-3	TRBJ2-7
TGCGCCAGCAGAAACCGGGACAGGCGTAATGAAAAACTGTTTTTT	CASRNRDRRNEKLFF	TRBV5-1	TRBJ1-4
TGTGCCAGCAGTGAGGAGACAGGGGCTGGCTACACCTTC	CASSEETGAGYTF	TRBV6-4	TRBJ1-2
TGTGCCAGCTCACCAACTGTACTAGCGGGAGGACCCGCCTACGAGCAGTACTTC	CASSPTVLAGGPAYEQYF	TRBV18	TRBJ2-7
TGTGCCAGCAGTGAATATGTCTGTCAGTGGCCCTACGAGCAGTACTTC	CASSEYVCQWPYEQYF	TRBV25-1	TRBJ2-7
TGCAGCTTTTTCATGAACACTGAAGCTTTCTTT	CSFFMNTEAFF	TRBV20-1	TRBJ1-1
TGTGCCAGCAGCTTGGATGGGGGGGCTCCGCGGCAGTTCTTC	CASSLDGGAPRQFF	TRBV5-4	TRBJ2-1
TGTGCCAGCAGTAAACCGGGACAGGGGGAGCCCGATGGCTACACCTTC	CASSKPGQGEPDGYTF	TRBV6-4	TRBJ1-2
TGTGCCAGCAGTAAGGGGGGGCCTGTAGGGGAGCAGTTCTTC	CASSKGGPVGEQFF	TRBV27	TRBJ2-1
TGCAGTGCTAGAGACGCAATGTACAATGAGCAGTTCTTC	CSARDAMYNEQFF	TRBV20-1	TRBJ2-1
TGTGCCAGCAGAGATCGTGGACAGGGCTATGGCTACACCTTC	CASRDRGQGYGYTF	TRBV6-1	TRBJ1-2
TGTGCCAGCAGCTTAGCGCAAAACCCCGGTCCGGGAATGACCCATGGCCCCTTGGCCTACGAGCAGTACTTC	CASSLAQNPGPGMTHGPLAYEQYF	TRBV7-9	TRBJ2-7
TGTGCCAGAGGGGACGTTGCGGGAGCCAGATATGGCTACACCTTC	CARGDVAGARYGYTF	TRBV19	TRBJ1-2
TGTGCCACCAGCAGAGTACTTCGGGGACTGGAGACCCAGTACTTC	CATSRVLRGLETQYF	TRBV15	TRBJ2-5
TGTGCCAGCAGCTTAGGGGGGGCTAACACCGGGGAGCTGTTTTTT	CASSLGGANTGELFF	TRBV11-3	TRBJ2-2
TGTGCCAGCAGCTCTCCCGAGCCTTCTGAGACCCAGTACTTC	CASSSPEPSETQYF	TRBV11-2	TRBJ2-5
TGTGCCCGGCGGGAGTTTAAAGTCGGGGAGCTGTTTTTT	CARREFKVGELFF	TRBV27	TRBJ2-2
TGCGCCAGCAGTCCGGACAGGAAAGAGACCCAGTACTTC	CASSPDRKETQYF	TRBV10-1	TRBJ2-5
TGTGCCGAAGGGGCCACCTTTGAAGCTTTCTTT	CAEGATFEAFF	TRBV9	TRBJ1-1
TGTGCCAGCAGCCAAGGACAGGTATCGCAGTACTTC	CASSQGQVSQYF	TRBV3-1	TRBJ2-7
TGTGCCAGCAGCAACCAACAAAGCGACGAGCAGTACTTC	CASSNQQSDEQYF	TRBV7-2	TRBJ2-7
TGTGCCACAAAGAACGCCGGGAACACTGAAGCTTTCTTT	CATKNAGNTEAFF	TRBV24-1	TRBJ1-1
TGTGCCAGCATCCGAAGGACAGGTGCGTACCAAGAGACCCAGTACTTC	CASIRRTGAYQETQYF	TRBV2	TRBJ2-5
TGTGCCAGCGATCGCTCATCCTGCAGGGACGAGCCCCAGCATTTT	CASDRSSCRDEPQHF	TRBV5-6	TRBJ1-5
TGCAGTGCTAGCTGGGGGGGCTTCTTAGATCAGCCCCAGCATTTT	CSASWGGFLDQPQHF	TRBV20-1	TRBJ1-5
TGCAGTGCTAGGACCGGCGGAGCCTACGAGCAGTACTTC	CSARTGGAYEQYF	TRBV20-1	TRBJ2-7
TGTGCCAGCAGTGGCGATGGGCAGGGCTACACCTTC	CASSGDGQGYTF	TRBV6-1	TRBJ1-2
TGTGCCAGCAGAGGGACAGGGAGTTGGAGTGACACCGGGGAGCTGTTTTTT	CASRGTGSWSDTGELFF	TRBV6-5	TRBJ2-2
TGCGCCAGCGGTGACAGGGTAAGGTTGGATACGCAGTATTTT	CASGDRVRLDTQYF	TRBV5-1	TRBJ2-3
TGTGCCAGCAGCTTGGCCTATGGGTCCACTGAAGCTTTCTTT	CASSLAYGSTEAFF	TRBV5-5	TRBJ1-1
TGTGCCACCAGTTGTGGGAGGGGGATCGATGAGCAGTTCTTC	CATSCGRGIDEQFF	TRBV24-1	TRBJ2-1
TGTGCCAGCAGTAAAGGGTTAGGAGCCTACGAGCAGTACTTC	CASSKGLGAYEQYF	TRBV6-1	TRBJ2-7
TGTGCCAGCACTGAGGAAGAACCCTCCTACGAGCAGTACTTC	CASTEEEPSYEQYF	TRBV3-1	TRBJ2-7
TGTGCCAGCAGTTTGACCCCCCTAGGAAAGTACAGGGACAATGAGCAGTTCTTC	CASSLTPLGKYRDNEQFF	TRBV12-4	TRBJ2-1
TGTGCCAGCAGTGACTGGCCACCGGGCTGGAATTCACCCCTCCACTTT	CASSDWPPGWNSPLHF	TRBV6-4	TRBJ1-6
TGTGCCAGCAGTGAACCCATACTAGCGGGAGAGGAAAAACTGTTTTTT	CASSEPILAGEEKLFF	TRBV6-1	TRBJ1-4
TGTGCCAGCAGCCAGGACCACGAGCAGTACTTC	CASSQDHEQYF	TRBV13	TRBJ2-7
TGCGCCAGCACGGGGGACAGGTACATTCAGTACTTC	CASTGDRYIQYF	TRBV5-1	TRBJ2-4
TGTGCCAGCAGTTCAATGACCTTCTACGAGCAGTACTTC	CASSSMTFYEQYF	TRBV27	TRBJ2-7
TGTGCTAGCAGCTTCTATCAACAGGACAGGGTCAGGCATGAGCAGTTCTTC	CASSFYQQDRVRHEQFF	TRBV7-7	TRBJ2-1
TGTGCCAGCAGCTCTGGGACAATTGAAGCTTTCTTT	CASSSGTIEAFF	TRBV11-2	TRBJ1-1
TGTGCCACCCTGGGGGCCTCGGGGTCCACTGAAGCTTTCTTT	CATLGASGSTEAFF	TRBV24-1	TRBJ1-1
TGTGCCAGCAGCTATGAGACTAGTGAGCAGTTCTTC	CASSYETSEQFF	TRBV7-3	TRBJ2-1
TGTGCCAGCATGTTTAAAGACAGGCACACTGAAGCTTTCTTT	CASMFKDRHTEAFF	TRBV6-8	TRBJ1-1
TGTGCCAGCGCGCAGGGTGAAGCTTTCTTT	CASAQGEAFF	TRBV28	TRBJ1-1
TGTGCCAGCAGACCCCACAGGGCGTACGAGCAGTACTTC	CASRPHRAYEQYF	TRBV12-3	TRBJ2-7
TGCGCCAGCAGTGGAGTCCAGCGAGACGGACAGGAGGAGCAGTACTTC	CASSGVQRDGQEEQYF	TRBV10-2	TRBJ2-7
TGTGCCAGCACGCCCCGGCCGGGACAGGGGAAGCGGGGTAGCTCACCCCTCCACTTT	CASTPRPGQGKRGSSPLHF	TRBV28	TRBJ1-6
TGTGCCAGCAGTTTATCGATCGGACTAGCGGGAGACCCCCAGTACTTC	CASSLSIGLAGDPQYF	TRBV27	TRBJ2-5
TGTGCCAGCACAGCCGCCAGTGTAGCTTCTAACTATGGCTACACCTTC	CASTAASVASNYGYTF	TRBV6-4	TRBJ1-2
TGTGCCAGCTGGGGTCCCAGGATTGTGCGTGAAAAACTGTTTTTT	CASWGPRIVREKLFF	TRBV7-9	TRBJ1-4
TGCGCCAGCAGCAGGGTCCTTAGCGGGAGAAACTGGGTCAATGAGCAGTTCTTC	CASSRVLSGRNWVNEQFF	TRBV5-1	TRBJ2-1
TGTGCCAGCAGTTACTCGTGCCCCCAGACGGCGGAGGGGGTCGCCTACGAGCAGTACTTC	CASSYSCPQTAEGVAYEQYF	TRBV6-2	TRBJ2-7
TGTGCCAGCAGCGCGGCGGGAGACGAGCAGTACTTC	CASSAAGDEQYF	TRBV13	TRBJ2-7
TGCAGTGCAAACCGGGGGGGCGAAGAGCAGTTCTTC	CSANRGGEEQFF	TRBV20-1	TRBJ2-1
TGTGCCAGCAGCCAACTGCCCGAGGGTCAGTACAATGAGCAGTTCTTC	CASSQLPEGQYNEQFF	TRBV14	TRBJ2-1
TGTCGCAGCCAGAAAGGTAAAGAGACCCAGTACTTC	CRSQKGKETQYF	TRBV7-9	TRBJ2-5
