TGTGCCAGCAGCGATTCCGAGCTCAAGAGCTCCTACAATGAGCAGTTCTTC	CASSDSELKSSYNEQFF	TRBV13	TRBJ2-1
TGTGCCAGCAGCAGGGGAGGGAGATCCTACGAGCAGTACTTC	CASSRGGRSYEQYF	TRBV6-4	TRBJ2-7
TGTGCCAGCAGCTTACAAGGGGGGTCGGTTGACAAGGGCACAGATACGCAGTATTTT	CASSLQGGSVDKGTDTQYF	TRBV5-6	TRBJ2-3
TGTGCCAGCAGCCCCACTAGCGGGAGGGCAGAAACTAATAGTCAGCCCCAGCATTTT	CASSPTSGRAETNSQPQHF	TRBV3-1	TRBJ1-5
TGTGCCACCAGTGATAAAACGGGACTTCGAGTTATACGGTGCACAGATACGCAGTATTTT	CATSDKTGLRVIRCTDTQYF	TRBV24-1	TRBJ2-3
TGCGCCAGCAGCCCCCCACAGGGTGGCTACACCTTC	CASSPPQGGYTF	TRBV5-1	TRBJ1-2
TGTGCCAGCAGTGGGAGGCCCAGGGAGGTGTCATATGGCTACACCTTC	CASSGRPREVSYGYTF	TRBV6-1	TRBJ1-2
TGCAGTGCTAGAGTGGGGGCAGGAAGACAGTATGGCTACACCTTC	CSARVGAGRQYGYTF	TRBV20-1	TRBJ1-2
TGTGCCTGGAGTGTAGGGTTGGGGCGATTTGAGCAGTTCTTC	CAWSVGLGRFEQFF	TRBV30	TRBJ2-1
TGTGCCAGCAGCCAAGATGGACAGGACGAGCAGTACTTC	CASSQDGQDEQYF	TRBV3-1	TRBJ2-7
TGTGCCAGTAATGCTCGGGGCCGCGACTACAATGAGCAGTTCTTC	CASNARGRDYNEQFF	TRBV19	TRBJ2-1
TGTGCCAGCAGCTCGGTTAGGGCACAGCCCCAGCATTTT	CASSSVRAQPQHF	TRBV7-3	TRBJ1-5
TGTGCCAGATCCCCGAGGGGGGTATATAGCAATCAGCCCCAGCATTTT	CARSPRGVYSNQPQHF	TRBV5-6	TRBJ1-5
TGTGCCAGCAGCCGGAAAAGGCATTCCGGGACGAATAATGAGCAGTTCTTC	CASSRKRHSGTNNEQFF	TRBV11-3	TRBJ2-1
TGTGCCAGCAGCTTGGAGGGGAGGGACGAGACCCAGTACTTC	CASSLEGRDETQYF	TRBV9	TRBJ2-5
TGTGCCAGCAGCGTAGGGTCCGGGACAGACTGCGAGCAGTACTTC	CASSVGSGTDCEQYF	TRBV9	TRBJ2-7
TGTGCCAGCAGCTTGGGGGTTTCCCGACAGGGGCTTCCCTCCTACGAGCAGTACTTC	CASSLGVSRQGLPSYEQYF	TRBV7-4	TRBJ2-7
TGTGCCAGTCCTAGGCTCACCGATAGCAATCAGCCCCAGCATTTT	CASPRLTDSNQPQHF	TRBV19	TRBJ1-5
TGCAGTGCCCACAGGGGCGGCTACACCTTC	CSAHRGGYTF	TRBV20-1	TRBJ1-2
TGCGCCAGCAGCTTGAGAGGAAGAGAAACGCAGTATTTT	CASSLRGRETQYF	TRBV5-1	TRBJ2-3
TGTGCCAGCAGCTTAGGTAACCGTGGCATAGCGGGCCACAATGAGCAGTTCTTC	CASSLGNRGIAGHNEQFF	TRBV7-6	TRBJ2-1
TGCGCCAGCAGCTTGGAGAGTCTTCTTGGGTCGGGAATTTCCTCCTACAATGAGCAGTTCTTC	CASSLESLLGSGISSYNEQFF	TRBV5-1	TRBJ2-1
TGTGCCAGCAGTTACTCTCCCATTTCGGCAGAGCTCGGGGCCAACGTCCTGACTTTC	CASSYSPISAELGANVLTF	TRBV6-5	TRBJ2-6
TGTGCCAGCAGCTTAGCGAAAAGCGCGTCCGGGGGGGGGCCGACTGGGGACGCAGATACGCAGTATTTT	CASSLAKSASGGGPTGDADTQYF	TRBV7-6	TRBJ2-3
TGTGCCAGCAGCTCCCGAACTGGACAGCCTTCTGAAGCTTTCTTT	CASSSRTGQPSEAFF	TRBV7-7	TRBJ1-1
TGTGCCATCCCGGTAACAGGGGGGTTTCTTGAAGCTTTCTTT	CAIPVTGGFLEAFF	TRBV28	TRBJ1-1
TGCGCCAGCAGCTTGGCCTCGACAGGGGGCACCGGGGAGCTGTTTTTT	CASSLASTGGTGELFF	TRBV5-1	TRBJ2-2
TGTGCCAGCACCGCCCCCCATGCGGGGATCCGGGGCTACGAGCAGTACTTC	CASTAPHAGIRGYEQYF	TRBV7-9	TRBJ2-7
TGTGCGCTACGGGGACAGGGACAGGGGTGCGGGGAGACCCAGTACTTC	CALRGQGQGCGETQYF	TRBV11-3	TRBJ2-5
TGTGCCACCTCAGGCTTCGGCACAGATACGCAGTATTTT	CATSGFGTDTQYF	TRBV24-1	TRBJ2-3
TGCAGTGCTAGCCAGCGGGACATGTTTAACTATGGCTACACCTTC	CSASQRDMFNYGYTF	TRBV20-1	TRBJ1-2
TGTGCCAGCTCCATTCCGGTGACAGGCTACACCTTC	CASSIPVTGYTF	TRBV18	TRBJ1-2
TGTGCCAGCAGTGACTCGAGGGGGGCGAAAACTAATAATGAAAAACTGTTTTTT	CASSDSRGAKTNNEKLFF	TRBV6-4	TRBJ1-4
TGTGCCTGGGAGCGGTGGGGGGGAAGAGGGGTCAACAATGAGCAGTTCTTC	CAWERWGGRGVNNEQFF	TRBV30	TRBJ2-1
TGTGCCAGCAGTGAGGTACGACTGCTTTACGAGCAGTACTTC	CASSEVRLLYEQYF	TRBV6-1	TRBJ2-7
TGTGCCGACCCGCGGGAGTTCAATGAGCAGTTCTTC	CADPREFNEQFF	TRBV6-2	TRBJ2-1
TGTGCCAGTAGTGATCATACGGGAAGCTCTGGAAACACCATATATTTT	CASSDHTGSSGNTIYF	TRBV19	TRBJ1-3
TGCGCCAGCAGTGACCCCCACCCCGGGACCCGGTCACTAGGCAATCAGCCCCAGCATTTT	CASSDPHPGTRSLGNQPQHF	TRBV10-1	TRBJ1-5
TGTGCCAGTATCGGGGGCTGGGGGACCGGCTCTAACTATGGCTACACCTTC	CASIGGWGTGSNYGYTF	TRBV19	TRBJ1-2
TGTGCCATCAGTGAGTCACAACTAGGTCCTGAGACCCAGTACTTC	CAISESQLGPETQYF	TRBV10-3	TRBJ2-5
TGCAGTGCTCCTGGGGCCGGGATTAACTACGAGCAGTACTTC	CSAPGAGINYEQYF	TRBV20-1	TRBJ2-7
TGTGCCAGCAGCTTCCCCCGACTAGCCTACAATGAGCAGTTCTTC	CASSFPRLAYNEQFF	TRBV5-4	TRBJ2-1
TGTGCCAGCAGTTACTCGAGGACAGGGCGGACTGAAGCTTTCTTT	CASSYSRTGRTEAFF	TRBV6-5	TRBJ1-1
TGCAGTGCGTCCACATTACAGCCCCAGCATTTT	CSASTLQPQHF	TRBV20-1	TRBJ1-5
TGCGCCAGCAGCGATAGGGAGGACTTC	CASSDREDF	TRBV5-1	TRBJ2-7
TGCGCCAGCATAGAGACCTTGTTGACAGGGACCCAGTACTTC	CASIETLLTGTQYF	TRBV4-3	TRBJ2-5
TGCGCCAACCAAAACGGGAACACTGAAGCTTTCTTT	CANQNGNTEAFF	TRBV4-3	TRBJ1-1
TGTGCCAGCAGTTTAGATGACCTGCTGAACACTGAAGCTTTCTTT	CASSLDDLLNTEAFF	TRBV12-4	TRBJ1-1
TGTGCCAGCAGCTTGACGCGGAGAGATAATGGCTACACCTTC	CASSLTRRDNGYTF	TRBV5-5	TRBJ1-2
TGTGCCAGCAGGGAGGTGGAGAACACTGAAGCTTTCTTT	CASREVENTEAFF	TRBV28	TRBJ1-1
TGTGCCAGCAAGCGTCCCCGCGGGACAGGGTTGGCGATGTGGCAGCAGTACTTC	CASKRPRGTGLAMWQQYF	TRBV9	TRBJ2-7
TGTGCCAGCAAACTGCCTGGGGGGGCGCACGGGGAGCTGTTTTTT	CASKLPGGAHGELFF	TRBV7-9	TRBJ2-2
TGTGCCAGCAGCTTACCGACAGGCGACGAGCAGTACTTC	CASSLPTGDEQYF	TRBV7-3	TRBJ2-7
TGTGCTAGTGGTTCAAGGACGGCGAGGGGAGAACCCCTCCACTTT	CASGSRTARGEPLHF	TRBV12-5	TRBJ1-6
TGTGCCAGCAGCTTTAGGACGAGCAATCAGCCCCAGCATTTT	CASSFRTSNQPQHF	TRBV5-6	TRBJ1-5
TGTGCCAGCAGCGGCGGCCGAGAAGCTTTCTTT	CASSGGREAFF	TRBV13	TRBJ1-1
TGTGCCAGCAGTGCAGGCGGAGGCTACGAGCAGTACTTC	CASSAGGGYEQYF	TRBV28	TRBJ2-7
TGTGCCAGCAGTTACTCGAGCAGAGTCGAGACCCAGTACTTC	CASSYSSRVETQYF	TRBV6-6	TRBJ2-5
TGTGCCAGCAAGGATCCCAGATCTAATGAAAAACTGTTTTTT	CASKDPRSNEKLFF	TRBV7-9	TRBJ1-4
TGTGCCCCGGGGTTTGGCTACACCTTC	CAPGFGYTF	TRBV7-8	TRBJ1-2
TGTGCCAGCAGTTTTCGGGGTAGCCTAGTTGAGCAGTTCTTC	CASSFRGSLVEQFF	TRBV7-9	TRBJ2-1
TGTGCCAGCAGAGGGACAGGGGGGGGAAAAGAGACCCAGTACTTC	CASRGTGGGKETQYF	TRBV27	TRBJ2-5
TGTGCCAGCAGTGAACTCAGGGGAGAGAACACCGGGGAGCTGTTTTTT	CASSELRGENTGELFF	TRBV6-5	TRBJ2-2
TGTGCCAGCAGTATAATTTTCATCGACGAGCAGTACTTC	CASSIIFIDEQYF	TRBV14	TRBJ2-7
TGTGCCACCAGCAGAGAGTCCTGGGGGGGCAAGACGGCCACCGGGGAGCTGTTTTTT	CATSRESWGGKTATGELFF	TRBV15	TRBJ2-2
TGTGCCAGCAGGGGGCTAGCGGCATACGAGCAGTACTTC	CASRGLAAYEQYF	TRBV7-9	TRBJ2-7
TGTGCCAGCGGGGACAGGGTGAACACTGAAGCTTTCTTT	CASGDRVNTEAFF	TRBV3-1	TRBJ1-1
TGTGTACGCAGGGTTAGCAGATCAGAAAAACTGTTTTTT	CVRRVSRSEKLFF	TRBV27	TRBJ1-4
TGTGCCAGCAGCGGCGGGACAGGGGCCTATGGCTACACCTTC	CASSGGTGAYGYTF	TRBV13	TRBJ1-2
TGTGCCAGGGCAGGGGGGCCCCAGCATTTT	CARAGGPQHF	TRBV6-6	TRBJ1-5
TGTGCCAGCAGGTCGTCCGACAGGGGTAAGGATAGCAATCAGCCCCAGCATTTT	CASRSSDRGKDSNQPQHF	TRBV28	TRBJ1-5
TGTGCCAGCAGGGGGGTGGGGTACAATGAGCAGTTCTTC	CASRGVGYNEQFF	TRBV6-3	TRBJ2-1
TGTGCCAGTGGGGACAGGGATATGAACACTGAAGCTTTCTTT	CASGDRDMNTEAFF	TRBV19	TRBJ1-1
TGTGCCAGCAGCCAAGACATTAATGCCCGGGACGGACGACAGCCCCAGCATTTT	CASSQDINARDGRQPQHF	TRBV4-2	TRBJ1-5
TGTGCCAGCAGCGTCCGCCGGGGGATGGGATCAACTGAGTACTTC	CASSVRRGMGSTEYF	TRBV9	TRBJ2-5
TGTGCCAGCAGCTTACGCCGGGGACGGGAAGCTTTCTTT	CASSLRRGREAFF	TRBV7-9	TRBJ1-1
TGTGCCAGCAGCCAGTTCCTAGCGGGCACACGACGCCCAGATACGCAGTATTTT	CASSQFLAGTRRPDTQYF	TRBV4-2	TRBJ2-3
TGTGCCAGCAGCTCGGGTCGGGGTTCGTCTGAGACCCAGTACTTC	CASSSGRGSSETQYF	TRBV7-9	TRBJ2-5
TGTGCCAGCAGCTTAGGGGGCGAAGAGACCCAGTACTTC	CASSLGGEETQYF	TRBV7-2	TRBJ2-5
TGTGCCAGCTCACCCCCGGCTCGGCCGACGTTGCATGGCTACACCTTC	CASSPPARPTLHGYTF	TRBV18	TRBJ1-2
TGCAGTGCTAGAGATGCCCCGCCACACCAGGGGAGGGAGCAGTACTTC	CSARDAPPHQGREQYF	TRBV20-1	TRBJ2-7
TGCAGTGCCCGGGCGGGCTACACCTTC	CSARAGYTF	TRBV20-1	TRBJ1-2
TGCGCCAGCAGCCAAGGGGCCCAAGGGCTTCCATATAGCAATCAGCCCCAGCATTTT	CASSQGAQGLPYSNQPQHF	TRBV4-1	TRBJ1-5
TGTGCCAGCAGTGGGGGCGGGACGACCAGCAATCAGCCCCAGCATTTT	CASSGGGTTSNQPQHF	TRBV6-4	TRBJ1-5
TGTGCCAGCAGCCAAGCAACAGATTCGAGCAGGGGGTGTTACACTGAAGCTTTCTTT	CASSQATDSSRGCYTEAFF	TRBV3-1	TRBJ1-1
TGTGCCCGTCGAAGGGGGGGAAGGACCCAGTACTTC	CARRRGGRTQYF	TRBV24-1	TRBJ2-5
TGTGCCAGCAGTGACTTCGGGCGTGACGAGCAGTACTTC	CASSDFGRDEQYF	TRBV6-4	TRBJ2-7
TGTGCCAGCAGTCCAATGCAGGAGGGCACAGATACGCAGTATTTT	CASSPMQEGTDTQYF	TRBV28	TRBJ2-3
TGTGCCAGCAGTGGCCCAGGCGCGGGACAGGGAAGAACTGAAGCTTTCTTT	CASSGPGAGQGRTEAFF	TRBV6-4	TRBJ1-1
TGTGCCAGGAGGGATAGCTCTCGCAAGAACACTGAAGCTTTCTTT	CARRDSSRKNTEAFF	TRBV27	TRBJ1-1
TGTGCCAGCAGTTTGAGAGGTGAGCTAGGGGGGGATGATGGCTACACCTTC	CASSLRGELGGDDGYTF	TRBV27	TRBJ1-2
TGTGCCAAACCCAGGGGAAATCATGAGCAGTTCTTC	CAKPRGNHEQFF	TRBV6-5	TRBJ2-1
TGCGCCAGCAGCTTCCAGGTCCAGGGGAGCTCTGGGGCCAACGTCCTGACTTTC	CASSFQVQGSSGANVLTF	TRBV5-1	TRBJ2-6
TGTGCCAGCAGCTTACCAGGGGGGTCCTCTAACTATGGCTACACCTTC	CASSLPGGSSNYGYTF	TRBV7-9	TRBJ1-2
TGTGCCATCAGTGAACGACAGCCACCCAAGGAAGGCCGGAGCAATCAGCCCCAGCATTTT	CAISERQPPKEGRSNQPQHF	TRBV10-3	TRBJ1-5
TGTGCCAGCAGTGAGGGGGGTTATTCACCCCTCCACTTT	CASSEGGYSPLHF	TRBV25-1	TRBJ1-6
TGTGTTAAGGCGGAGTACGAGCAGTACTTC	CVKAEYEQYF	TRBV28	TRBJ2-7
TGTGCTAGTGGTTGGTCTCTAGGGGTATTGGACTATGGCTACACCTTC	CASGWSLGVLDYGYTF	TRBV12-5	TRBJ1-2
TGTGCCAGCAGCTTGTCGTTGACCCGGGGCCGCCCTCCCTCTGGGGCCAACGTCCTGACTTTC	CASSLSLTRGRPPSGANVLTF	TRBV5-5	TRBJ2-6
TGCGCCAGCAGATGCAGGCCCCGGGACCCCGCCCGCTATGGCTACACCTTC	CASRCRPRDPARYGYTF	TRBV5-1	TRBJ1-2
TGTGCCAGCAGCCTAAGGGGGCTTTCTGAGCAGTTCTTC	CASSLRGLSEQFF	TRBV9	TRBJ2-1
TGTGCCACCCCACTAGCGGGAGCAAACACCGGGGAGCTGTTTTTT	CATPLAGANTGELFF	TRBV7-3	TRBJ2-2
TGTGCCAAAGCAGAATACATAGGACCCCTCCACTTT	CAKAEYIGPLHF	TRBV6-1	TRBJ1-6
TGTGCCTGGAATCGACTAGAATACTCCTACGAGCAGTACTTC	CAWNRLEYSYEQYF	TRBV30	TRBJ2-7
TGCGCCAGCAGCCAAGATGGCCACGTTCTACAGGCGGTCCGACGGTCACCCCTCCACTTT	CASSQDGHVLQAVRRSPLHF	TRBV4-3	TRBJ1-6
TGTGCCAGCAGCCGAGAGCCGAGAGCCTACAATGAGCAGTTCTTC	CASSREPRAYNEQFF	TRBV13	TRBJ2-1
TGTGCCAGCGAAGCGAACCCCGAGGACGAGCAGTACTTC	CASEANPEDEQYF	TRBV28	TRBJ2-7
TGTGCCACCAGTGATTTGGCAGGGGGGTCCGGGGAGCTGTTTTTT	CATSDLAGGSGELFF	TRBV24-1	TRBJ2-2
TGTGCCAGCAGCCGTGCCCGTCTCGGGGGACGGGCGTTCGGCACTGAAGCTTTCTTT	CASSRARLGGRAFGTEAFF	TRBV7-3	TRBJ1-1
TGTGCCAGCAGCGGGGGGTTACTTAACTATGGCTACACCTTC	CASSGGLLNYGYTF	TRBV7-2	TRBJ1-2
TGTGCCAGCAGTTTAAAAATGACCCTCGGTTACAGGGCTGGAAACACCATATATTTT	CASSLKMTLGYRAGNTIYF	TRBV12-4	TRBJ1-3
TGCGCCAGCAGGGCAGCGGCGACCCAGTACTTC	CASRAAATQYF	TRBV10-1	TRBJ2-5
TGTGCCAGCTCACCACCTTTGGGACAGGGGGCTGGCTATGGCTACACCTTC	CASSPPLGQGAGYGYTF	TRBV18	TRBJ1-2
TGTGCCAGCAGTTACCCCGCCAGGGCCCCCTCTGGAAACACCATATATTTT	CASSYPARAPSGNTIYF	TRBV6-5	TRBJ1-3
TGTGCCAGCAGCGGTGGGGACGATGGCTACACCTTC	CASSGGDDGYTF	TRBV7-9	TRBJ1-2
TGCGCCAGCAGCGTCCCGATAGACGAGCAGTACTTC	CASSVPIDEQYF	TRBV5-1	TRBJ2-7
TGTGCCAGCAGGGCCGGGACAGTATATAACTATGGCTACACCTTC	CASRAGTVYNYGYTF	TRBV6-4	TRBJ1-2
TGTGCCTGGAGACTCTGTTCGGGACAGGGCACCGAGCAGTACTTC	CAWRLCSGQGTEQYF	TRBV30	TRBJ2-7
TGTGCCAGCAGTAACGGGAACGTCAGGGGGACTGAAAAACTGTTTTTT	CASSNGNVRGTEKLFF	TRBV6-4	TRBJ1-4
TGCAGTGCTAGATGGAAGACAGAGAACTACGAGCAGTACTTC	CSARWKTENYEQYF	TRBV20-1	TRBJ2-7
TGTGCCAGCAGGGGACAGGCGGCGGCTAACTATGGCTACACCTTC	CASRGQAAANYGYTF	TRBV25-1	TRBJ1-2
TGTGCCAGCAGCCAAGACATAGGGGGGCCTAAGGATCGTACTAGCACAGATACGCAGTATTTT	CASSQDIGGPKDRTSTDTQYF	TRBV4-2	TRBJ2-3
TGCGCCAGTTGGGGACAGGCCCCCAATAGCAATCAGCCCCAGCATTTT	CASWGQAPNSNQPQHF	TRBV10-1	TRBJ1-5
TGTGCCAGCAGCAGGCCTCCCGCACCTGGGGGGAGTAACTATGGCTACACCTTC	CASSRPPAPGGSNYGYTF	TRBV5-5	TRBJ1-2
TGCAGCGTTAGTTTAGGGGATCGGTCCTACGAGCAGTACTTC	CSVSLGDRSYEQYF	TRBV29-1	TRBJ2-7
TGTGCCAGCAGTTACTCGAGGGCTTTAGAAAAACTGTTTTTT	CASSYSRALEKLFF	TRBV6-5	TRBJ1-4
TGTGCCAGCAGGGACAGGGCTCGGGAAGCTTTCTTT	CASRDRAREAFF	TRBV7-9	TRBJ1-1
TGCAGCGTTGACGGACAAGAAAACTATGGCTACACCTTC	CSVDGQENYGYTF	TRBV29-1	TRBJ1-2
TGTGCCAGCAGCCAGGTAGTTATCTTC	CASSQVVIF	TRBV14	TRBJ2-1
TGTGCCAGCAGCTTAGCGAAAGGCAGGTATAATCAGCCCCAGCATTTT	CASSLAKGRYNQPQHF	TRBV7-9	TRBJ1-5
TGCGCCAGCAGCGGAAGGCAGCGGAATTCACCCCTCCACTTT	CASSGRQRNSPLHF	TRBV5-1	TRBJ1-6
TGTGCCAGCAGCCGAGGAACGCCTCACTACGAGCAGTACTTC	CASSRGTPHYEQYF	TRBV11-2	TRBJ2-7
TGTGCCAGCAGCCCTATCGAGCAGTACTTC	CASSPIEQYF	TRBV7-3	TRBJ2-7
TGTGCCAGCAGCCAAGACCCGTTGGCACGAACCAGTAACTATGGCTACACCTTC	CASSQDPLARTSNYGYTF	TRBV3-1	TRBJ1-2
TGTGCCAGCAGCGGGGGCCGATCCTACAATGAGCAGTTCTTC	CASSGGRSYNEQFF	TRBV6-6	TRBJ2-1
TGCGCCAGCAGCCAATTAACTTGCTCCACAGATACGCAGTATTTT	CASSQLTCSTDTQYF	TRBV4-3	TRBJ2-3
TGCGCCAGCAGCTGGTGTCCCGGGACAGGGGAAACCTACGAGCAGTACTTC	CASSWCPGTGETYEQYF	TRBV5-1	TRBJ2-7
TGTGCCAGCAGCGTAACCTGGGACACGGGCACAGATACGCAGTATTTT	CASSVTWDTGTDTQYF	TRBV9	TRBJ2-3
TGTGCCCCGGGGGGGGGACCATCCTACGAGCAGTACTTC	CAPGGGPSYEQYF	TRBV9	TRBJ2-7
TGCGCCAGCAGCTTGGATAGAAGGACGGGGGCCTACGAGCAGTACTTC	CASSLDRRTGAYEQYF	TRBV5-1	TRBJ2-7
TGTGCCAGCAGTTTACTGGACGGACAGGTCTCAAATAACTATGGCTACACCTTC	CASSLLDGQVSNNYGYTF	TRBV28	TRBJ1-2
TGTGCCAGCAGCATACCCTATAGTGTGGACCGGGACAGGGGGGGTTGGGTGAACAAAAGGTCACCCCTCCACTTT	CASSIPYSVDRDRGGWVNKRSPLHF	TRBV13	TRBJ1-6
TGCGCCAGCAGCCAAGGTACCGGGACAGGGCATCCCAATCAGCCCCAGCATTTT	CASSQGTGTGHPNQPQHF	TRBV4-1	TRBJ1-5
TGTGCCAGCTCCTGGACTAGCGGAGTCGGGGAGCTGTTTTTT	CASSWTSGVGELFF	TRBV6-6	TRBJ2-2
TGTGCCAGCATAGGGACTAGCGGGCTCAAAAACATTCAGTACTTC	CASIGTSGLKNIQYF	TRBV7-3	TRBJ2-4
TGCAGTGCAGCTCGGCTCGGAGTACCCAAAAACATTCAGTACTTC	CSAARLGVPKNIQYF	TRBV20-1	TRBJ2-4
TGTGCCTGGATGGCCACAGAGGAGAGCTCCTATAATTCACCCCTCCACTTT	CAWMATEESSYNSPLHF	TRBV30	TRBJ1-6
TGTGCCAGCAGCTTGCGTCCCCGGGGCCCGACAGGGACCTACGAGCAGTACTTC	CASSLRPRGPTGTYEQYF	TRBV5-5	TRBJ2-7
TGCGCCAGCAGCTTAGGGGGCGCCCCGCGCGAGCAGTACTTC	CASSLGGAPREQYF	TRBV5-1	TRBJ2-7
TGTGCCAGCAGTTGCGAGAGGGCGGGAGAGACAACTAATGAAAAACTGTTTTTT	CASSCERAGETTNEKLFF	TRBV6-1	TRBJ1-4
TGTGCCAGCAGCCATGTACCGGGGAACACAGATACGCAGTATTTT	CASSHVPGNTDTQYF	TRBV14	TRBJ2-3
TGTGCCAGCAGCCATAGCCTACTAGCGGGAGGGAGGAATGGAAACACCATATATTTT	CASSHSLLAGGRNGNTIYF	TRBV13	TRBJ1-3
TGCGCCAGCAGCACAGGGGGTATCCACGGGGAGCTGTTTTTT	CASSTGGIHGELFF	TRBV5-1	TRBJ2-2
TGCGCCAGCAGTTCGGAGGGCACAGATACGCAGTATTTT	CASSSEGTDTQYF	TRBV10-1	TRBJ2-3
TGTGAAAAACCCCTGGGGGACAACACTGAAGCTTTCTTT	CEKPLGDNTEAFF	TRBV28	TRBJ1-1
TGTGCCAGCAGTCGGGCCTTCGGGGGATGGACCAGGTACACCGGGGAGCTGTTTTTT	CASSRAFGGWTRYTGELFF	TRBV6-6	TRBJ2-2
TGTGCCAGCTCGCGCCAGGGGGGGAATGAGCAGTTCTTC	CASSRQGGNEQFF	TRBV27	TRBJ2-1
TGTGCCAGTAGTATAGAAGGACAGGGAGGGGTAGGATGCAATCAGCCCCAGCATTTT	CASSIEGQGGVGCNQPQHF	TRBV19	TRBJ1-5
TGTGCCAGCAGTGAATGTGGGAGGGAGTACTTC	CASSECGREYF	TRBV6-1	TRBJ2-7
TGTGCCAGCAGCTTGGGTACTAGCGGGGGAAACTCCTACAATGAGCAGTTCTTC	CASSLGTSGGNSYNEQFF	TRBV5-5	TRBJ2-1
TGTGCCAGCAGCCAAGTAGAGTCTCTCCCCGAGGGATCGACAGCTCTAGGGGAGACCCAGTACTTC	CASSQVESLPEGSTALGETQYF	TRBV14	TRBJ2-5
TGCAGCGTTGGAAGGGACAGGCTTAGCAATCAGCCCCAGCATTTT	CSVGRDRLSNQPQHF	TRBV29-1	TRBJ1-5
TGTGCCAGATCGAGACAGGGCGAGACCCACACCATATATTTT	CARSRQGETHTIYF	TRBV30	TRBJ1-3
TGTGCCAGCAGTTACGGGCGGGGAAGAGTAATTAAAAACATTCAGTACTTC	CASSYGRGRVIKNIQYF	TRBV6-2	TRBJ2-4
TGTGCTAGTGTTCGTCGGGCAGATACGCAGTATTTT	CASVRRADTQYF	TRBV12-5	TRBJ2-3
TGCGCCAGCAGCCAAGACTCCCCAGGGAGGCGCTACGAGCAGTACTTC	CASSQDSPGRRYEQYF	TRBV4-3	TRBJ2-7
TGTGCCTGGATATCCGCCCGGGACCGGCATTTT	CAWISARDRHF	TRBV30	TRBJ1-5
TGCAGTGCTAGAGTACAGGGCTATGGCTACACCTTC	CSARVQGYGYTF	TRBV20-1	TRBJ1-2
TGCAGTGCTTATTCGAAGGGGAGGCATGGCTACACCTTC	CSAYSKGRHGYTF	TRBV20-1	TRBJ1-2
TGTGCCAGCAGTCGTTCCCGATCTAGCTCCTACGAGCAGTACTTC	CASSRSRSSSYEQYF	TRBV27	TRBJ2-7
TGCGCCAGCAGCTTGGTCGGGGGGCGGTACGAGCAGTACTTC	CASSLVGGRYEQYF	TRBV5-1	TRBJ2-7
TGCATTCGGAGGACGTCCGGGGCCTACGAGCAGTACTTC	CIRRTSGAYEQYF	TRBV20-1	TRBJ2-7
TGCGCCAGCAGCTTGGCCCTCCAGGGGCGTTCACCCCTCCACTTT	CASSLALQGRSPLHF	TRBV5-1	TRBJ1-6
TGTGCCAGCAGCTTGGCCGGACACCCCGGGACAGGCGAAAAACTGTTTTTT	CASSLAGHPGTGEKLFF	TRBV5-6	TRBJ1-4
TGCAGTGCTAAGAGAGGGGAAGATACGCAGTATTTT	CSAKRGEDTQYF	TRBV20-1	TRBJ2-3
TGTGCCAGCAGCCAAGGGGCCGCCGAAAACAACACCGGGGAGCTGTTTTTT	CASSQGAAENNTGELFF	TRBV14	TRBJ2-2
TGTGCCAGCAGCTTGGCCGGGGGTTCTAGGGTGGTGGACTGTTATTTT	CASSLAGGSRVVDCYF	TRBV5-4	TRBJ1-3
TGTGCCACCAGTGAATGCCGGGCCTATGGCTACACCTTC	CATSECRAYGYTF	TRBV24-1	TRBJ1-2
TGTGCCAGCGGGGTAGAAAAACTGTTTTTT	CASGVEKLFF	TRBV9	TRBJ1-4
TGTGCCAGCAGCTTCCCTATCCTCAGGGGGCCCCACAACTATGGCTACACCTTC	CASSFPILRGPHNYGYTF	TRBV7-3	TRBJ1-2
TGTGCCACCAGTGATTTGAAATCCCCCATCGCTTCGAACACCGGGGAGCTGTTTTTT	CATSDLKSPIASNTGELFF	TRBV24-1	TRBJ2-2
TGTGCCAGCAGCTTCGGGAGGGTGGGGTACGAGCAGTACTTC	CASSFGRVGYEQYF	TRBV7-9	TRBJ2-7
TGCAGTGCTAGGGCCGGGACAGGGGCCTACGAGCAGTACTTC	CSARAGTGAYEQYF	TRBV20-1	TRBJ2-7
TGTGCCAGCATACGAGTCCCTTCTACCACAGATACGCAGTATTTT	CASIRVPSTTDTQYF	TRBV7-3	TRBJ2-3
TGTGCCAGCAGTGTACCGGGACTAGGGGGATCCGACTCCTACGAGCAGTACTTC	CASSVPGLGGSDSYEQYF	TRBV6-1	TRBJ2-7
TGTGCCAGCAGCTTCTGTGTGAACACAGGGGATCAGCCCCAGCATTTT	CASSFCVNTGDQPQHF	TRBV5-4	TRBJ1-5
TGCAGTGCTAGACTGACCCCTATAGCAGATACGCAGTATTTT	CSARLTPIADTQYF	TRBV20-1	TRBJ2-3
TGTGCCAGCAGTTCTGTTATAGCCAAAAACATTCAGTACTTC	CASSSVIAKNIQYF	TRBV5-6	TRBJ2-4
TGTGCCTGGACGGGGCTTCCCAATGAAAAACTGTTTTTT	CAWTGLPNEKLFF	TRBV30	TRBJ1-4
TGTGCCAGCAGCTCCCGGGGTCTAAAAGGCAATCAGCCCCAGCATTTT	CASSSRGLKGNQPQHF	TRBV5-4	TRBJ1-5
TGTGCCAGCAGCCTTAGCCGGACTAGACTAAGGTACAATGAGCAGTTCTTC	CASSLSRTRLRYNEQFF	TRBV13	TRBJ2-1
TGTGCCCAGGTGGGGGCCGGTATGCAAGAGACCCAGTACTTC	CAQVGAGMQETQYF	TRBV27	TRBJ2-5
TGTGCCAGTAGTATATCCTCTGCTGTTAGCGGGAGGAGGGGGGACACGAACACCGGGGAGCTGTTTTTT	CASSISSAVSGRRGDTNTGELFF	TRBV19	TRBJ2-2
TGTGCCAGCAGCTTAGGGGGGCCTCCCCTTAATCAGCCCCAGCATTTT	CASSLGGPPLNQPQHF	TRBV7-6	TRBJ1-5
TGTGCCTGGATCGGAAGCTCCTACGAGCAGTACTTC	CAWIGSSYEQYF	TRBV30	TRBJ2-7
TGTGCCAGCAGCCACCCGGGACTAGCGGGGGGGAGGGGGGTCTTC	CASSHPGLAGGRGVF	TRBV5-4	TRBJ2-1
TGCAGCGTTGAAGCTAGACACATAGCGGGGGGGGAGACCCAGTACTTC	CSVEARHIAGGETQYF	TRBV29-1	TRBJ2-5
TGTGCCAGCAGTTTAGGGCGGGACGGGGACAATGAGCAGTTCTTC	CASSLGRDGDNEQFF	TRBV27	TRBJ2-1
TGTGCCAGCAGTGACTCGACCATACGGGGTGAGCCGAAAAGGGGCGCGAACACCGGGGAGCTGTTTTTT	CASSDSTIRGEPKRGANTGELFF	TRBV6-4	TRBJ2-2
TGCGCCAGCAGTGACCGGCGGGGCCTAGGCTATGGCTACACCTTC	CASSDRRGLGYGYTF	TRBV10-1	TRBJ1-2
TGTGCCAGCAGTTACCAGCCGGGACTTTTCCAAAGCTCCTACAATGAGCAGTTCTTC	CASSYQPGLFQSSYNEQFF	TRBV6-5	TRBJ2-1
TGTGCCAGCAGTGAACCCGGTGGGGGGGCGTACGCGCCCAATGAGCAGTTCTTC	CASSEPGGGAYAPNEQFF	TRBV2	TRBJ2-1
TGTGCCAGCAGCTTAAGTGAGGAGCAGTTCTTC	CASSLSEEQFF	TRBV7-3	TRBJ2-1
TGTGCCAGCAGTAAGACTCCCCCGGCCGGGACAGGAGGACAGCCCCAGCATTTT	CASSKTPPAGTGGQPQHF	TRBV27	TRBJ1-5
TGTGCCAGCACGGAGAAGCTCGCGCCTAGCGGGGGCAATGAGCAGTTCTTC	CASTEKLAPSGGNEQFF	TRBV27	TRBJ2-1
TGTGCCAGCAGCATTTTTCCCGGGGGGCACGAGCAGTACTTC	CASSIFPGGHEQYF	TRBV7-4	TRBJ2-7
TGTGCCAGTAGTACCTCAGGGGTGGGGGAGACCCAGTACTTC	CASSTSGVGETQYF	TRBV19	TRBJ2-5
TGTGCCACCAGTGATTTTTGGGGAGGAAGACGGAACACTGAAGCTTTCTTT	CATSDFWGGRRNTEAFF	TRBV24-1	TRBJ1-1
TGTGCCAGAAAGTTGGACAGGGGTTGGACCTACGAGCAGTACTTC	CARKLDRGWTYEQYF	TRBV3-1	TRBJ2-7
TGTGCCAGCAGCCCCGGACACGACCCCTATAGCAATCAGCCCCAGCATTTT	CASSPGHDPYSNQPQHF	TRBV14	TRBJ1-5
TGTGCCAGCAGTGATCCCCCGGGAGGCCATGGTTGCTACAATGAGCAGTTCTTC	CASSDPPGGHGCYNEQFF	TRBV6-4	TRBJ2-1
TGTGCCAGCAGCAACGGAGTTTGGCCTAGCGGGTCGGAGCAGTACTTC	CASSNGVWPSGSEQYF	TRBV13	TRBJ2-7
TGTGCCAGCAGCTTGGCCCCCGACGGAACTGAAGCTTTCTTT	CASSLAPDGTEAFF	TRBV5-6	TRBJ1-1
TGTGCCAGCAGCACTGAGAGGGACAATGAGCAGTTCTTC	CASSTERDNEQFF	TRBV7-3	TRBJ2-1
TGTGCCAGCAGCAACCGGGCCGAAGGACAGGGCCGCTACGAGCAGTACTTC	CASSNRAEGQGRYEQYF	TRBV13	TRBJ2-7
TGTGCCAGCAGTGAGAACTTCTATGAGCAGTTCTTC	CASSENFYEQFF	TRBV6-1	TRBJ2-1
TGTGCCAGCCAGGACAGGGGGGGGGACTACGAGCAGTACTTC	CASQDRGGDYEQYF	TRBV6-2	TRBJ2-7
TGTGCCACCAGCTTTCCCCGGGACATAAATGAGCAGTTCTTC	CATSFPRDINEQFF	TRBV15	TRBJ2-1
TGTGCCAGCAGCTTCCCTACCCTGAGGGGCGAACCCGCAGATACGCAGTATTTT	CASSFPTLRGEPADTQYF	TRBV7-2	TRBJ2-3
TGTGCCACCAGGGAGGGGGGTAATGAGCAGTTCTTC	CATREGGNEQFF	TRBV15	TRBJ2-1
TGTGCCATCAGTGAGGGTGGCACTGAAGCTTTCTTT	CAISEGGTEAFF	TRBV10-3	TRBJ1-1
TGTGCCAGCAGTTTGACGGAGGCGGGGTCGGCCGAAGCTTTCTTT	CASSLTEAGSAEAFF	TRBV28	TRBJ1-1
TGCGCCAGCAGTAAGAGTTACGGGGGGCATGGCAATCAGCCCCAGCATTTT	CASSKSYGGHGNQPQHF	TRBV10-1	TRBJ1-5
TGTGCCAGCAGTTTATGGGGGACAGAAGCTTTCTTT	CASSLWGTEAFF	TRBV28	TRBJ1-1
TGTGCCAGCAGCCAAGATTCAGGAGGGTCAAAACTGTTTTTT	CASSQDSGGSKLFF	TRBV14	TRBJ1-4
TGTCTACACCTAGCGGGGGTGGGCAATGAGCAGTTCTTC	CLHLAGVGNEQFF	TRBV7-9	TRBJ2-1
TGTGCCAGCAGCCATATACGATGCACTGAAGCTTTCTTT	CASSHIRCTEAFF	TRBV3-1	TRBJ1-1
TGTGCCAGCAGCAAGGGGCGGGACAATTGTGATACGCAGTATTTT	CASSKGRDNCDTQYF	TRBV7-3	TRBJ2-3
TGTGCCAGCAGCTCGCCCGCATCAGACGGGGAGCTGTTTTTT	CASSSPASDGELFF	TRBV7-9	TRBJ2-2
TGTGCCAGCAGGGGAGAGTGCGGGGAGCTGTTTTTT	CASRGECGELFF	TRBV6-4	TRBJ2-2
TGCAGCGCCAGGTGGGGGCTAAAGCCAGTCTACAATGAGCAGTTCTTC	CSARWGLKPVYNEQFF	TRBV29-1	TRBJ2-1
TGTGCCAGCAGCCTTCCCGAGGAGACAGAGCAGTACTTC	CASSLPEETEQYF	TRBV9	TRBJ2-7
TGCAGCGTTACGGGCTTCGAACCGAGGGAATCGGGGTACGAGCAGTACTTC	CSVTGFEPRESGYEQYF	TRBV29-1	TRBJ2-7
TGCAGTGCTAGAACAAGGACGGCGTGCACCGGGGAGCTGTTTTTT	CSARTRTACTGELFF	TRBV20-1	TRBJ2-2
TGTGCCAGCAGTTTGTCGGGACAGAACGCAACTAATGAAAAACTGTTTTTT	CASSLSGQNATNEKLFF	TRBV27	TRBJ1-4
TGTGCCAGCAGTATCTTCTCGACAGTGGAAGAGAGCAATCAGCCCCAGCATTTT	CASSIFSTVEESNQPQHF	TRBV6-5	TRBJ1-5
TGCGCCAGCAGAACAGGCAGGGCTGAAGCTTTCTTT	CASRTGRAEAFF	TRBV10-1	TRBJ1-1
TGTGCCACCAGCAGAGGGGGGTCTCCCGAAAAACTGTTTTTT	CATSRGGSPEKLFF	TRBV15	TRBJ1-4
TGTGCCAGCAGTGACTCCAATGGGGGACAGGGGGTTGGCTACACCTTC	CASSDSNGGQGVGYTF	TRBV6-4	TRBJ1-2
TGCAGTGCTAGGTCCACGGGCGAGGGGTATAGCAATCAGCCCCAGCATTTT	CSARSTGEGYSNQPQHF	TRBV20-1	TRBJ1-5
TGTGCCGGGGACAATGAGCAGTTCTTC	CAGDNEQFF	TRBV24-1	TRBJ2-1
TGTGCCACCAGCCTACGGATTCCTCCCTATCAGCCCCAGCATTTT	CATSLRIPPYQPQHF	TRBV15	TRBJ1-5
TGTGCCACCATCTACCCTAGGGAGGGGGGTTCACCCCTCCACTTT	CATIYPREGGSPLHF	TRBV24-1	TRBJ1-6
TGTGCCAGTAGCCGGACAGGGGGTGGCGGCTCCTACGAGCAGTACTTC	CASSRTGGGGSYEQYF	TRBV19	TRBJ2-7
TGTGCCAGCAGCAAGGCGTCGAGGGACAGGGGCTCTGGAAACACCATATATTTT	CASSKASRDRGSGNTIYF	TRBV9	TRBJ1-3
TGTGCCAGCAGTTCCCACCTCCGACCGGGAAGGAACGAGCAGTACTTC	CASSSHLRPGRNEQYF	TRBV28	TRBJ2-7
TGTGATAATCATGGCCTTGAAGCTTTCTTT	CDNHGLEAFF	TRBV24-1	TRBJ1-1
TGTGCCACCAGCAGAGGAAGGGACAGTAACTATGGCTACACCTTC	CATSRGRDSNYGYTF	TRBV15	TRBJ1-2
TGTGCCAGCAATTTCCTATACGTACAAGGTCGAGATCAGCCCCAGCATTTT	CASNFLYVQGRDQPQHF	TRBV27	TRBJ1-5
TGTGCCAAAGCAAGTATGGGGGCTTATCTCCGCTTTTACGAGCAGTACTTC	CAKASMGAYLRFYEQYF	TRBV6-3	TRBJ2-7
TGTGCCAGCAGCTTAGGCGGGGGAACAGGCTACACCTTC	CASSLGGGTGYTF	TRBV7-6	TRBJ1-2
TGTGCCAGCAGCGTAGAGGCCATCCCGGGTAACTATGGCTACACCTTC	CASSVEAIPGNYGYTF	TRBV9	TRBJ1-2
TGCGCCAGCAGCGACCCCCAGCGGGAGAATGCCAAAAACATTCAGTACTTC	CASSDPQRENAKNIQYF	TRBV5-1	TRBJ2-4
TGTGCCAGCAGCAAGGGACTCAAGAGCTCCTACGAGCAGTACTTC	CASSKGLKSSYEQYF	TRBV9	TRBJ2-7
TGCGCCAGCAGCCAAGATGGGCCGGGGGGTCTGCCTCAGTACTTC	CASSQDGPGGLPQYF	TRBV4-1	TRBJ2-5
TGTGCCCCTTCCAGGGTGTCTGCCGGGGAGCTGTTTTTT	CAPSRVSAGELFF	TRBV24-1	TRBJ2-2
TGTGCCAGTGGGGGGGGCCTGGGGCAGTACTTC	CASGGGLGQYF	TRBV19	TRBJ2-7
TGTGCCAGCAGCTTAGATTGCCCCGGGCTAAATCAGCCCCAGCATTTT	CASSLDCPGLNQPQHF	TRBV11-3	TRBJ1-5
TGTGCCAGCAGCACAATGCATGGCTACACCTTC	CASSTMHGYTF	TRBV7-9	TRBJ1-2
TGTGCCAGCAGCTTACGCCGGGGACCCCAAGGCTACGAGCAGTACTTC	CASSLRRGPQGYEQYF	TRBV7-9	TRBJ2-7
TGTGCCAGCAGGCAAACGGACCCCCTAGCGGGAAAGTGCGAGCAGTACTTC	CASRQTDPLAGKCEQYF	TRBV27	TRBJ2-7
TGTGCCAGCAGGCCTAGCGGGGCGGACACCGGGGAGCTGTTTTTT	CASRPSGADTGELFF	TRBV12-3	TRBJ2-2
TGTGCCAGCAGCTTCACCTCCGACCGACAGACCCAGCATTTT	CASSFTSDRQTQHF	TRBV7-9	TRBJ1-5
TGTGCCAGCAGCCTGGCCAGGGCGAAGTCACCCCTCCACTTT	CASSLARAKSPLHF	TRBV9	TRBJ1-6
TGTGCCAGCAGTTTATTAGAGGACCCCTTTGGCTACACCTTC	CASSLLEDPFGYTF	TRBV27	TRBJ1-2
TGTGCCAGCAGTTGTCCGACTCGTCACAGGGTTGGGTATCAGCCCCAGCATTTT	CASSCPTRHRVGYQPQHF	TRBV28	TRBJ1-5
TGTGCCAGCAGCGTAGGGGCGGACAGGAGGGGTGAAGCTTTCTTT	CASSVGADRRGEAFF	TRBV9	TRBJ1-1
TGTGCCAGCAGTTCCTCCCTAGACAGGTCGGATTACGAGCAGTACTTC	CASSSSLDRSDYEQYF	TRBV27	TRBJ2-7
TGTGCCAGCAGTTTGCAGGCCCAGTACGAGCAGTACTTC	CASSLQAQYEQYF	TRBV28	TRBJ2-7
TGTGCCAGCAGCTTACCCTCATCATCCAGGGTCTTCCTAACTAATGAAAAACTGTTTTTT	CASSLPSSSRVFLTNEKLFF	TRBV7-4	TRBJ1-4
TGTGCCAGCAGCCAAGGGCTGGCGAACACCGGGGAGCTGTTTTTT	CASSQGLANTGELFF	TRBV3-1	TRBJ2-2
TGTGCTAGCAGCTTAGCGATCCCCAGTGTGACAGGCTACGAGCAGTACTTC	CASSLAIPSVTGYEQYF	TRBV7-7	TRBJ2-7
TGTGCCAGTAAACCACAGGGGGGGGGTAGCAATCAGCCCCAGCATTTT	CASKPQGGGSNQPQHF	TRBV19	TRBJ1-5
TGTGCCAGCAGCGGGGGGCATTACGGGGAGCTGTTTTTT	CASSGGHYGELFF	TRBV7-9	TRBJ2-2
TGTGCCACCAGTGATTCCGTAACGAGGGGTCGTTTCTCTGGGGCCAACGTCCTGACTTTC	CATSDSVTRGRFSGANVLTF	TRBV24-1	TRBJ2-6
TGTGCCAGCTCACCACTTGGCAACGCTTGCCTCACAGATACGCAGTATTTT	CASSPLGNACLTDTQYF	TRBV18	TRBJ2-3
TGTGCCAGCAGGAAAGTAACTAGCGGGAGTAATTCACCCCTCCACTTT	CASRKVTSGSNSPLHF	TRBV27	TRBJ1-6
TGCGCCAGCAGCTTGGGGGATGGATACGAGCAGTACTTC	CASSLGDGYEQYF	TRBV5-1	TRBJ2-7
TGCGCCAGCGGCACCGGGACAGGGAAGGGCAATCAGCCCCAGCATTTT	CASGTGTGKGNQPQHF	TRBV5-1	TRBJ1-5
TGTGCCAGCAGCATGCGAGGAAGAGCCATAAATGAGCAGTTCTTC	CASSMRGRAINEQFF	TRBV5-5	TRBJ2-1
TGCAGTGCTCGGGCGGTGCTCTTC	CSARAVLF	TRBV20-1	TRBJ2-1
TGTGCCACCAGCAGAGATCCAAACCCAGGGGGGATGATGAACACTGAAGCTTTCTTT	CATSRDPNPGGMMNTEAFF	TRBV15	TRBJ1-1
TGTGCCAGCAGTTTGAGGGACAGTCCGAATCAGCCCCAGCATTTT	CASSLRDSPNQPQHF	TRBV28	TRBJ1-5
TGTGCCAGCATAGCGGGAGAGACCCAGTACTTC	CASIAGETQYF	TRBV6-2	TRBJ2-5
TGTGCCAGCAGCCGCCGGGAGGCCTTTGGGAACACCGGGGAGCTGTTTTTT	CASSRREAFGNTGELFF	TRBV6-4	TRBJ2-2
TGTGCCAGTAGTGGGCCTGTCGACGAGCAGTACTTC	CASSGPVDEQYF	TRBV19	TRBJ2-7
TGTGCCAGCAGCCGGAGCAGGGTCCAAGAGACCCAGTACTTC	CASSRSRVQETQYF	TRBV12-3	TRBJ2-5
TGTGCCAGCAGCCAAGATCTGAGGGCCGGTGGCACTGAAGCTTTCTTT	CASSQDLRAGGTEAFF	TRBV4-2	TRBJ1-1
TGTGCCAGCAGTTTTCCGGGGTCACCCCACTCCTACGAGCAGTACTTC	CASSFPGSPHSYEQYF	TRBV27	TRBJ2-7
TGCGCCAGCAGGCCAGTCCCAGGCTATGGCTACACCTTC	CASRPVPGYGYTF	TRBV10-1	TRBJ1-2
TGTGCCACCAGTGATTTGCTTCACCGACTTGGGGACTCGGTGGCCAACGTCCTGACTTTC	CATSDLLHRLGDSVANVLTF	TRBV24-1	TRBJ2-6
TGTGCCAGCAGCCAAGAACTCCCCATTGCTGGGACTAATTCACCCCTCCACTTT	CASSQELPIAGTNSPLHF	TRBV3-1	TRBJ1-6
TGTGCCAGCACAGACATGAAGCTTAGCAATCAGCCCCAGCATTTT	CASTDMKLSNQPQHF	TRBV6-3	TRBJ1-5
TGTGCTAGTGGTAGAACTCCAGATTCACCCCTCCACTTT	CASGRTPDSPLHF	TRBV12-5	TRBJ1-6
TGCAGCGTTGAAGGACCTCAACCGGGACTAGGCGTTGAGACCCAGTACTTC	CSVEGPQPGLGVETQYF	TRBV29-1	TRBJ2-5
TGTGCCAGCAGTGAATATATGGTGGGGCCTCGGAGGGGGGACATTCAGTACTTC	CASSEYMVGPRRGDIQYF	TRBV25-1	TRBJ2-4
TGTGCCAGCAGCGGCCGGGCTCGCCGGGGATACAATGAGCAGTTCTTC	CASSGRARRGYNEQFF	TRBV11-2	TRBJ2-1
TGCAGTGCTCAGGAGGCCGGGACGGAGACCCAGTACTTC	CSAQEAGTETQYF	TRBV20-1	TRBJ2-5
TGTGCCAGCAGTGAAGGGGGACGAAACACCATATATTTT	CASSEGGRNTIYF	TRBV25-1	TRBJ1-3
TGTGCCAGCAGCGAAGGCAGGGAAACTAATTCACCCCTCCACTTT	CASSEGRETNSPLHF	TRBV13	TRBJ1-6
TGTGCCAGCAGTGAAGCGCGGGACAAGTTGAACACTGAAGCTTTCTTT	CASSEARDKLNTEAFF	TRBV2	TRBJ1-1
TGTGCCAGCAGTGAGAGATTATCCTCCTACGAGCAGTACTTC	CASSERLSSYEQYF	TRBV6-4	TRBJ2-7
TGTGCCAGCAGCGGGAACACCGGGGAGCTGTTTTTT	CASSGNTGELFF	TRBV7-3	TRBJ2-2
TGTGCCAGCAGCTTGTGCTCTCCCGAGTCTGAGCAGTTCTTC	CASSLCSPESEQFF	TRBV5-6	TRBJ2-1
TGTGCCAGCAGCTTATCCCCGGGACAGAGTTGCATGAACACTGAAGCTTTCTTT	CASSLSPGQSCMNTEAFF	TRBV7-2	TRBJ1-1
TGTGCCAGTAGTCCTGGCAGGGGCCTGAATGAGCAGTTCTTC	CASSPGRGLNEQFF	TRBV19	TRBJ2-1
TGCGCCAGCAGCCCCGGCGGACAGGGTGGGCAGTTCTTC	CASSPGGQGGQFF	TRBV4-3	TRBJ2-1
TGTGCCAGCAGCCAAGAGAGCCTGGGGGGTAAGGAGACCCAGTACTTC	CASSQESLGGKETQYF	TRBV3-1	TRBJ2-5
TGCAGTGCTAGAGGGGGGCGCGGGACAGCAGCTTTCTTT	CSARGGRGTAAFF	TRBV20-1	TRBJ1-1
TGTGCCAGCAGAGATAAGGGGGGGCAGTACTTC	CASRDKGGQYF	TRBV6-6	TRBJ2-7
TGTGCCAGCAGCGCGTTCTCGAGGGGAAACTACGAGCAGTACTTC	CASSAFSRGNYEQYF	TRBV7-2	TRBJ2-7
TGTGCCAGCAGCTTACCGGGGGACTATGGCTACACCTTC	CASSLPGDYGYTF	TRBV5-4	TRBJ1-2
TGTGCCAGTAGTCTACGGGCGCCCCTAAGCGACCCGGACGGTATGAACACTGAAGCTTTCTTT	CASSLRAPLSDPDGMNTEAFF	TRBV19	TRBJ1-1
TGTGCCAGCAGCCTGCGGAGGTTATCCTCTGGGGCCAACGTCCTGACTTTC	CASSLRRLSSGANVLTF	TRBV27	TRBJ2-6
TGCGCCAGCAGCGAGGACCACGGAAATGAAAAACTGTTTTTT	CASSEDHGNEKLFF	TRBV5-1	TRBJ1-4
TGTGCCCCTATACAGGGGGGGGCGGCTGGAAACACCATATATTTT	CAPIQGGAAGNTIYF	TRBV19	TRBJ1-3
TGTGCCAGCAGTTTGACAGCTCAAGAGACCCAGTACTTC	CASSLTAQETQYF	TRBV27	TRBJ2-5
TGTGCCAGCAGCATTTTACCAAGTCCAGGACAGGATCAGCCCCAGCATTTT	CASSILPSPGQDQPQHF	TRBV11-2	TRBJ1-5
TGTGCCTGGTCGGGGGGGCCAGTCATGAACACTGAAGCTTTCTTT	CAWSGGPVMNTEAFF	TRBV30	TRBJ1-1
TGTGCCACCAGCTTTTCAGGGAGCTCCCCAATCCGCTACTATGGCTACACCTTC	CATSFSGSSPIRYYGYTF	TRBV15	TRBJ1-2
TGTGCCATCAGTGAGGGGACTAGCGGGAGCAAAAACATTCAGTACTTC	CAISEGTSGSKNIQYF	TRBV10-3	TRBJ2-4
TGTGCCACCAGTGTTCACGCTTTATGCTACGAGCAGTACTTC	CATSVHALCYEQYF	TRBV24-1	TRBJ2-7
TGTGCCAGCAGCCCCGCCGGGACTAGGGGGGGTAAAGACAATGAGCAGTTCTTC	CASSPAGTRGGKDNEQFF	TRBV7-2	TRBJ2-1
TGCAGCCAGGCAGGGGGGAGCTCCTACGAGCAGTACTTC	CSQAGGSSYEQYF	TRBV29-1	TRBJ2-7
TGCAGTGCTAGACATGCCTCGGGACAGAACTACGAGCAGTACTTC	CSARHASGQNYEQYF	TRBV20-1	TRBJ2-7
TGTGCCAGCAAGCCATCGCGGAGCACAGATACGCAGTATTTT	CASKPSRSTDTQYF	TRBV7-9	TRBJ2-3
TGCGCCAGCAGTGAGCCCACTAGGGCCGGCAATCAGCCCCAGCATTTT	CASSEPTRAGNQPQHF	TRBV10-1	TRBJ1-5
TGTGCCAGCAGCCCCCTTGCCCGGACTAGCGGGCCAAACTCCTACAATGAGCAGTTCTTC	CASSPLARTSGPNSYNEQFF	TRBV13	TRBJ2-1
TGTGCCAGCAGCTATGACTACGCTGAGCAGTTCTTC	CASSYDYAEQFF	TRBV7-9	TRBJ2-1
TGTGCCAGCAGTATAGAAAAAGGGCGGGATTACGAGCAGTACTTC	CASSIEKGRDYEQYF	TRBV6-4	TRBJ2-7
TGTGCCAGTACAGGGGGCAGAACCACAGATACGCAGTATTTT	CASTGGRTTDTQYF	TRBV19	TRBJ2-3
TGTGCCAGCAGCTTGTGCGACCCGGAGCAGTTCTTC	CASSLCDPEQFF	TRBV5-6	TRBJ2-1
TGTGCCAGCAGCATAGCTAACGGGATTTATGGCTACACCTTC	CASSIANGIYGYTF	TRBV14	TRBJ1-2
TGTGCCAGCAGTGAGACCGGGACAGGGGGCGTCAATTCACCCCTCCACTTT	CASSETGTGGVNSPLHF	TRBV25-1	TRBJ1-6
TGTGCCAGCAGCTTAATCCGGGACATCGTTCTTAACTATGGCTACACCTTC	CASSLIRDIVLNYGYTF	TRBV7-8	TRBJ1-2
TGTGCTAGTGGTTTGCCATACCTTTACGAGCAGTACTTC	CASGLPYLYEQYF	TRBV12-5	TRBJ2-7
TGTGCTAGCAGCTTACCCCAGTGGGAAGAGACCCAGTACTTC	CASSLPQWEETQYF	TRBV7-7	TRBJ2-5
TGCGCCAGCAGCCAAGAAACGGACAGCCGAAGTGGCTACACCTTC	CASSQETDSRSGYTF	TRBV4-1	TRBJ1-2
TGCAGTGCTAGAACAAGGACAGGGGGCAGCAATCAGCCCCAGCATTTT	CSARTRTGGSNQPQHF	TRBV20-1	TRBJ1-5
TGTGCCAGCAGCTTAGGGGGACAGAGAAAAAATGAAAAACTGTTTTTT	CASSLGGQRKNEKLFF	TRBV7-7	TRBJ1-4
TGTGCCACCAGTGATAGGCCCTATACTTACGGTAATGAAAAACTGTTTTTT	CATSDRPYTYGNEKLFF	TRBV24-1	TRBJ1-4
TGCAGCGGAGGCGAGGGGCTTGACGAGCAGTACTTC	CSGGEGLDEQYF	TRBV29-1	TRBJ2-7
TGCGCCAGCAGCCAAGGAGGCGGAAAAGATGAGAAGACAGGGGTCCCCTCCTACGAGCAGTACTTC	CASSQGGGKDEKTGVPSYEQYF	TRBV4-3	TRBJ2-7
TGCAGTGCTCCCGCAGGGGCACCTAATCAGCCCCAGCATTTT	CSAPAGAPNQPQHF	TRBV20-1	TRBJ1-5
TGCAGTGCTCAACCTGGTACGTCCGGGACTTACCTAGATACGCAGTATTTT	CSAQPGTSGTYLDTQYF	TRBV20-1	TRBJ2-3
TGCGCCAGCAGCCGATTGTGGCCTATGCTAGAAACTCACGAGCAGTACTTC	CASSRLWPMLETHEQYF	TRBV5-1	TRBJ2-7
TGTGCCACCAGTGACAGGGACAGGGGGCCGCCATCCTACGAGCAGTACTTC	CATSDRDRGPPSYEQYF	TRBV24-1	TRBJ2-7
TGTGCCAGCAGCCAAGTGATGTGTAAAAGCTCCTACAATGAGCAGTTCTTC	CASSQVMCKSSYNEQFF	TRBV4-2	TRBJ2-1
TGTGCCAGCAGGCGTATCCCGCAGGGTGGTGGCTACACCTTC	CASRRIPQGGGYTF	TRBV6-1	TRBJ1-2
TGTGCCAGCAGCAGTCCCAGGGTAAGCACTGAAGCTTTCTTT	CASSSPRVSTEAFF	TRBV7-9	TRBJ1-1
TGTGCCAGACCCAGGGAAAAACTGTTTTTT	CARPREKLFF	TRBV12-3	TRBJ1-4
TGTGCCAGCAAGAAGCGGGAGTACCAAGAGACCCAGTACTTC	CASKKREYQETQYF	TRBV7-3	TRBJ2-5
TGTGCCAGCAGCGAACGGTGTTGTAGCAATCAGCCCCAGCATTTT	CASSERCCSNQPQHF	TRBV13	TRBJ1-5
TGCGCCAGCACAAAAAGACGTTATGAAAAACTGTTTTTT	CASTKRRYEKLFF	TRBV10-2	TRBJ1-4
TGCGCCAGCAGCCATTCGACGCGAGAGCAGTACTTC	CASSHSTREQYF	TRBV4-3	TRBJ2-7
TGTGCCAGCAGTTTATGGAAGGGGGGACCAGAGACCCAGTACTTC	CASSLWKGGPETQYF	TRBV27	TRBJ2-5
TGCGCCATCGGGAGCTACGAGCAGTACTTC	CAIGSYEQYF	TRBV10-2	TRBJ2-7
TGTGCCAGCAGCTGGAATCCTTGGGACAGGGAGAATGGTCAGCCCCAGCATTTT	CASSWNPWDRENGQPQHF	TRBV9	TRBJ1-5
TGCAGCGGGGTTGCGGGAGGCTCCTACGAGCAGTACTTC	CSGVAGGSYEQYF	TRBV29-1	TRBJ2-7
TGTGCCAGCAGCTATTACAGGGAGGATAGCTCCTACGAGCAGTACTTC	CASSYYREDSSYEQYF	TRBV13	TRBJ2-7
TGTGCCAGCAAACGGAAGTATGGCTACACCTTC	CASKRKYGYTF	TRBV2	TRBJ1-2
TGTGCCAAAAAAACAGGGGTCGACCAAGAGACCCAGTACTTC	CAKKTGVDQETQYF	TRBV6-5	TRBJ2-5
TGTGCCAGCAGTTTCGCAGGGGTGGGCAATCAGCCCCAGCATTTT	CASSFAGVGNQPQHF	TRBV12-3	TRBJ1-5
TGTGCCAGCAGCCAAGAACTCAGCAAACCCTACGAGCAGTACTTC	CASSQELSKPYEQYF	TRBV14	TRBJ2-7
TGTGCCAGCAGCCAAGCCCGATACCAAGAGACCCAGTACTTC	CASSQARYQETQYF	TRBV14	TRBJ2-5
TGTGCCATCAGCGGACAGGGGCCCGGGGCCAACGTCCTGACTTTC	CAISGQGPGANVLTF	TRBV10-3	TRBJ2-6
TGCAGTGCATGGACTAGTGAAAAACTGTTTTTT	CSAWTSEKLFF	TRBV20-1	TRBJ1-4
TGCAGCGTTGAAGGGGGGGGTACGTATGGCTACACCTTC	CSVEGGGTYGYTF	TRBV29-1	TRBJ1-2
TGTGCCAGCAGCCCGAGGGGCGCACCTGAAGCTTTCTTT	CASSPRGAPEAFF	TRBV14	TRBJ1-1
TGTGCCATTCTCGCCGGTACCGGGGAGCTGTTTTTT	CAILAGTGELFF	TRBV6-5	TRBJ2-2
TGTGCCAGTAGTATCCGACCGATCCCCCCGCCCCAGCATTTT	CASSIRPIPPPQHF	TRBV19	TRBJ1-5
TGTGCCAGCAAATCGTACCCAGGGGATATGAACACTGAAGCTTTCTTT	CASKSYPGDMNTEAFF	TRBV7-9	TRBJ1-1
TGTGCCAGCAGCCTTCCCACAGGGGGTTCTGAAGCTTTCTTT	CASSLPTGGSEAFF	TRBV7-3	TRBJ1-1
TGTGCCCGTCCCGGGACTAGCGGGAGGTCATCCGAGGGACCCTACGAGCAGTACTTC	CARPGTSGRSSEGPYEQYF	TRBV6-2	TRBJ2-7
TGTGCCTGGACGAAAAACGGGCGGGAGCAGTACTTC	CAWTKNGREQYF	TRBV30	TRBJ2-7
TGTGCCAGCAGCCCCCGACAGGAACCGGGTGGCTACACCTTC	CASSPRQEPGGYTF	TRBV3-1	TRBJ1-2
TGCAGTGCTAGCAGGATTCTCGAAACAGGGGGCAGCTCCTACGAGCAGTACTTC	CSASRILETGGSSYEQYF	TRBV20-1	TRBJ2-7
TGTGCCAGCTCACCCCCAGTCCCACCGGGGAGTTACGATCAGCCCCAGCATTTT	CASSPPVPPGSYDQPQHF	TRBV18	TRBJ1-5
TGTGCCAGCAGCACCCCACGGAAGTACGAGCAGTACTTC	CASSTPRKYEQYF	TRBV9	TRBJ2-7
TGTGCCACACAAGGGGTTAGCTCCTATAATTCACCCCTCCACTTT	CATQGVSSYNSPLHF	TRBV7-9	TRBJ1-6
TGTGCCAGCGGGACAGGGGAAGTCTCCTACGAGCAGTACTTC	CASGTGEVSYEQYF	TRBV9	TRBJ2-7
TGTGCCAGCAGCGGAAGGGGATTCCGGCCCCAGCATTTT	CASSGRGFRPQHF	TRBV9	TRBJ1-5
TGCGCCCAGACAGGAAACACCATATATTTT	CAQTGNTIYF	TRBV5-1	TRBJ1-3
TGTGCCAGCAGTTTAGAGGGACAGGGATTTTACCCTGCAACTAATGAAAAACTGTTTTTT	CASSLEGQGFYPATNEKLFF	TRBV27	TRBJ1-4
TGTGCCAGCAGCTTGGGAGGCAATGAGCAGTTCTTC	CASSLGGNEQFF	TRBV7-3	TRBJ2-1
TGTGCCAGCAGCTTACGCGTTTGGGGGGTGTGGTACTTC	CASSLRVWGVWYF	TRBV7-2	TRBJ2-7
TGTGCCAGCACGCCCTTACAAACTCTTCGTGAAGCTTTCTTT	CASTPLQTLREAFF	TRBV12-3	TRBJ1-1
TGTGCCAGCAGTTTATTCTCCCCGGGACTAGCGGGAGGCCTGACCGGGGAGCTGTTTTTT	CASSLFSPGLAGGLTGELFF	TRBV27	TRBJ2-2
TGTGCCAGAGAAGCTAGCGGAGAGCAGTACTTC	CAREASGEQYF	TRBV9	TRBJ2-7
TGTGCCAGCAGTTTATGGGACCTGCTGGGGCTTGGTCCCTATGGCTACACCTTC	CASSLWDLLGLGPYGYTF	TRBV28	TRBJ1-2
TGCGCCAGCAGTGAGCGTTCCTACCGGACTCATGATCAGCCCCAGCATTTT	CASSERSYRTHDQPQHF	TRBV10-1	TRBJ1-5
TGTGCCAGCAGTTTACTACCATGGAACACCGGGGAGCTGTTTTTT	CASSLLPWNTGELFF	TRBV12-3	TRBJ2-2
TGCGCCAGCAGTGAGATAAGGGACAGTCCAACTAATGAAAAACTGTTTTTT	CASSEIRDSPTNEKLFF	TRBV10-2	TRBJ1-4
TGTGCCAGCAGCTTAGTCCTCTCTGGACTAGCGGGTCTTTATGAGCAGTTCTTC	CASSLVLSGLAGLYEQFF	TRBV7-2	TRBJ2-1
TGTGCCAGCAGCGTCCACGGATGGGGGTGGAATGAGCAGTTCTTC	CASSVHGWGWNEQFF	TRBV6-5	TRBJ2-1
TGTGCCAGCAGTGGCCCTCCCTGGACAGGGTTGTCGAATCAGTACTTC	CASSGPPWTGLSNQYF	TRBV6-4	TRBJ2-7
TGTGCCAGCAGGACGGGGCCATGGGGTTCAGACAGCAATCAGCCCCAGCATTTT	CASRTGPWGSDSNQPQHF	TRBV27	TRBJ1-5
TGTGCCAGCAGTTGGGCAGGCGCAACTAATGAAAAACTGTTTTTT	CASSWAGATNEKLFF	TRBV12-3	TRBJ1-4
TGTGCCAGCCCCGAACGGTCAGACAATGAGCAGTTCTTC	CASPERSDNEQFF	TRBV6-5	TRBJ2-1
TGTGCCAGCAGTTACAGTGCCGGGACAGTTAAGTGCGAGCAGTACTTC	CASSYSAGTVKCEQYF	TRBV6-8	TRBJ2-7
TGTGCCATCAGACTCCCAGGGGGACCGGTAGGTAATGAGCAGTTCTTC	CAIRLPGGPVGNEQFF	TRBV10-3	TRBJ2-1
TGTGCCAGCACCCATGGAGGGGGGGAGCTGTTTTTT	CASTHGGGELFF	TRBV11-3	TRBJ2-2
TGTGCCAGCAGCTTGCGGGGGGACTTGGCCTTTAACTATGGCTACACCTTC	CASSLRGDLAFNYGYTF	TRBV7-9	TRBJ1-2
TGTGCCAGCAGCCACCTTGGGAAGGTCCGCGGTGGATCAGAGACCCAGTACTTC	CASSHLGKVRGGSETQYF	TRBV14	TRBJ2-5
TGTGCCAGCAGCAAGGGGGGGCCCGTGGCCGAGCAGTACTTC	CASSKGGPVAEQYF	TRBV11-3	TRBJ2-7
TGTGCCAGCAGCTTAGGGAGGACCAGCTCCTATAATTCACCCCTCCACTTT	CASSLGRTSSYNSPLHF	TRBV7-6	TRBJ1-6
TGCGCCAGCGGGACTCCCTACGAGCAGTACTTC	CASGTPYEQYF	TRBV10-1	TRBJ2-7
TGTGCCATGGGCACAGATACGCAGTATTTT	CAMGTDTQYF	TRBV12-3	TRBJ2-3
TGTGCCAGCAGTTCCAGATTGACAGCGAAGAGGCCCCAGCATTTT	CASSSRLTAKRPQHF	TRBV28	TRBJ1-5
TGTGCCAGCACTGGCTACACCTTC	CASTGYTF	TRBV28	TRBJ1-2
TGTGCCAGCAGCCAAGGGGGGGGGGAAATTCAAGAGACCCAGTACTTC	CASSQGGGEIQETQYF	TRBV13	TRBJ2-5
TGTGCCAGCAGACCTCCTGGAGGGAGGGGCTCCTATAATTCACCCCTCCACTTT	CASRPPGGRGSYNSPLHF	TRBV12-3	TRBJ1-6
TGCGCCAGCAGCCAAGGGGATCTCCCGGGGAAAGATACGCAGTATTTT	CASSQGDLPGKDTQYF	TRBV4-1	TRBJ2-3
TGTGCCAGCAGTTTCCCAGAACTAGCGGGAGTTAATGGCTACACCTTC	CASSFPELAGVNGYTF	TRBV27	TRBJ1-2
TGTGCCAGCAGTGACGCTTTGAAAGATGTTTACGAGCAGTACTTC	CASSDALKDVYEQYF	TRBV6-1	TRBJ2-7
TGTGCCAGCAGCTCTGGCGCTGGACTGTACGAGCAGTACTTC	CASSSGAGLYEQYF	TRBV11-2	TRBJ2-7
TGTGCCAGCAACCCCCATGGACAAAATCAGCCCCAGCATTTT	CASNPHGQNQPQHF	TRBV6-5	TRBJ1-5
TGTGCCAGCCCCGGACTAGCGGGAGCCAAAAACATTCAGTACTTC	CASPGLAGAKNIQYF	TRBV7-3	TRBJ2-4
TGTGCCATCAGTGTGCCCCCCTACGACATTAAGACGAAGAACACCGGGGAGCTGTTTTTT	CAISVPPYDIKTKNTGELFF	TRBV10-3	TRBJ2-2
TGTGCCAGCAGTTGGACAGGGACCCAGCCCCAGCATTTT	CASSWTGTQPQHF	TRBV25-1	TRBJ1-5
TGTGCCAGCAGTTCTACTCGGCATCAGCCCCAGCATTTT	CASSSTRHQPQHF	TRBV6-2	TRBJ1-5
TGTGCCAGCAGCGGGGGGCTTATGAACACTGAAGCTTTCTTT	CASSGGLMNTEAFF	TRBV6-1	TRBJ1-1
TGCGCCAACAGTAATTCGGGACTGGAGACCCAGTACTTC	CANSNSGLETQYF	TRBV10-1	TRBJ2-5
TGTGCCAGCAGCACAGGGTACGTGAACACTGAAGCTTTCTTT	CASSTGYVNTEAFF	TRBV7-3	TRBJ1-1
TGCGCCAGCAGCAAAACAGGCGGGGGTAAGCCCCAGCATTTT	CASSKTGGGKPQHF	TRBV5-1	TRBJ1-5
TGTGCCAGCTCCGGGACAGTAAGTTTTGGAGACGAGCAGTACTTC	CASSGTVSFGDEQYF	TRBV18	TRBJ2-7
TGTGCCAGCAGTTACTTCCCGGGGCGTCGCGGGTATTCACCCCTCCACTTT	CASSYFPGRRGYSPLHF	TRBV6-3	TRBJ1-6
TGTGCCACCCGTCCTAGCGGCTCCTACAATGAGCAGTTCTTC	CATRPSGSYNEQFF	TRBV24-1	TRBJ2-1
TGTGCCAGCAGCAACAGGGGGATAGTAGATAACCAGCCCCAGCATTTT	CASSNRGIVDNQPQHF	TRBV13	TRBJ1-5
TGTGCCAGCAGCCAAGTGTTTGGCAAACCGGGACTATATGGCTACACCTTC	CASSQVFGKPGLYGYTF	TRBV14	TRBJ1-2
TGTGCCACTAGTTACCGGGATTTACCCTCCTACGAGCAGTACTTC	CATSYRDLPSYEQYF	TRBV13	TRBJ2-7
TGTGCCAGCAGTCCCCAGCCGCTAGCGGGCCGAGAGCAGTTCTTC	CASSPQPLAGREQFF	TRBV6-5	TRBJ2-1
TGCGCCAGCAGCCACGTACCCAGGAGAGTCTCTGGGGCCAACGTCCTGACTTTC	CASSHVPRRVSGANVLTF	TRBV4-1	TRBJ2-6
TGTGCCAGCAGTGCCGGGACAGAGAAGGAGAACACTGAAGCTTTCTTT	CASSAGTEKENTEAFF	TRBV6-4	TRBJ1-1
TGTGCCAGCAGCTTAGGAATATCTCGGACAGGGTCCGCTTTCTTT	CASSLGISRTGSAFF	TRBV7-6	TRBJ1-1
TGTGCCAGCAGTCCCGGGGCCCCCGGGGAGCTGTTTTTT	CASSPGAPGELFF	TRBV28	TRBJ2-2
TGTGCCAGCAGGGGACTAGCGGTGGTTCTCTCCTACAATGAGCAGTTCTTC	CASRGLAVVLSYNEQFF	TRBV5-6	TRBJ2-1
TGTGCCAGCAGTGATCACAGGGGGAACACTGAAGCTTTCTTT	CASSDHRGNTEAFF	TRBV2	TRBJ1-1
TGCGCCAGCATACGGGACAGAGACAATGAGCAGTTCTTC	CASIRDRDNEQFF	TRBV5-1	TRBJ2-1
TGTGCCAGCAGTTTATGTTTAGACAGGGACTTCACTGAAGCTTTCTTT	CASSLCLDRDFTEAFF	TRBV27	TRBJ1-1
TGTGCCAGCAGTTTATCGGGACAGGGAGTGGTAGGCAATCAGCCCCAGCATTTT	CASSLSGQGVVGNQPQHF	TRBV27	TRBJ1-5
TGTGCCAGCAGTTCACACCAGGGGGGGGGCTACACCTTC	CASSSHQGGGYTF	TRBV6-5	TRBJ1-2
TGCAGTGCTAGAAGGGCCCTCTACAATGAGCAGTTCTTC	CSARRALYNEQFF	TRBV20-1	TRBJ2-1
TGTGCCAGCAGCGTCACGGGGGGACTGGGCTACGAGCAGTACTTC	CASSVTGGLGYEQYF	TRBV11-2	TRBJ2-7
TGCAGCGTCCGCTCGGACAGGGTCGGGGGAGAGTCTGGGGCCAACGTCCTGACTTTC	CSVRSDRVGGESGANVLTF	TRBV29-1	TRBJ2-6
TGTGCCAGCAGCTTAGCGGTGGGACGGGTCTACAATGAGCAGTTCTTC	CASSLAVGRVYNEQFF	TRBV7-9	TRBJ2-1
TGTGCCAGCAGCTTGCGGCCCGGGAGCCACACTGAAGCTTTCTTT	CASSLRPGSHTEAFF	TRBV11-3	TRBJ1-1
TGTGCCAGCAGCTTATTTAGGGGAGGTAACTATGGCTACACCTTC	CASSLFRGGNYGYTF	TRBV7-9	TRBJ1-2
TGTGCCAGCAGTTTAGTTCCAGCTAAGTACGAGCAGTACTTC	CASSLVPAKYEQYF	TRBV12-3	TRBJ2-7
TGTGCTAGTGGGTATTCATACCGTAGCGGGAGGCCAGGGACTAACACTGAAGCTTTCTTT	CASGYSYRSGRPGTNTEAFF	TRBV12-5	TRBJ1-1
TGTGCCAGCAGCTTAGATCGTCCCCCAGGATTGGCCACCTTC	CASSLDRPPGLATF	TRBV11-2	TRBJ1-2
TGTGCCAGCAGTGAAGGGGGGAGGTTAGAGTCCTACGAGCAGTACTTC	CASSEGGRLESYEQYF	TRBV2	TRBJ2-7
TGCGCCAGCAGCCAACTTGTCACTGAAGCTTTCTTT	CASSQLVTEAFF	TRBV4-1	TRBJ1-1
TGTGCCAGCAGTTTGGCCCGGGACCAAGAGACCCAGTACTTC	CASSLARDQETQYF	TRBV12-4	TRBJ2-5
TGTGCCAGCAGGGCCGGACAGGGACCTGGAAACACCATATATTTT	CASRAGQGPGNTIYF	TRBV27	TRBJ1-3
TGTGCCAGCAGTTTGGAAAAGGGGAACAATGAGCAGTTCTTC	CASSLEKGNNEQFF	TRBV12-3	TRBJ2-1
TGCAGTGCGGAGGGAGGACAGCCCCAGCATTTT	CSAEGGQPQHF	TRBV20-1	TRBJ1-5
TGTGCCAGCAGACTAAGGGGCGTGACGAACACCGGGGAGCTGTTTTTT	CASRLRGVTNTGELFF	TRBV6-4	TRBJ2-2
TGTGCCAGCAGTGACTCAGTAATTGAAAAACTGTTTTTT	CASSDSVIEKLFF	TRBV6-4	TRBJ1-4
TGTGCCAGCAGCAAACCTCAGGTTGCTTACGAGCAGTACTTC	CASSKPQVAYEQYF	TRBV6-4	TRBJ2-7
TGTGCCAGCAGCTTGAATCGACTTAACTATGGCTACACCTTC	CASSLNRLNYGYTF	TRBV5-4	TRBJ1-2
TGTGCCACTCAGGAGGGAAGATGGGTCATCGAGCAGTACTTC	CATQEGRWVIEQYF	TRBV24-1	TRBJ2-7
TGCAGCGTCCCCTTCCGGACTACAGATACGCAGTATTTT	CSVPFRTTDTQYF	TRBV29-1	TRBJ2-3
TGTGCCAGCAGTTTGGGACGGACTAGCGGGAGAGGGGTAAATGAGCAGTTCTTC	CASSLGRTSGRGVNEQFF	TRBV28	TRBJ2-1
TGTGCCAGCAGTGAGGGTGAGGGGGCGCTAATTCAGGTCAAAAACACTGAAGCTTTCTTT	CASSEGEGALIQVKNTEAFF	TRBV12-4	TRBJ1-1
TGCAGCGTTCCGGACAGGGTGAGCTACGAGCAGTACTTC	CSVPDRVSYEQYF	TRBV29-1	TRBJ2-7
TGTGCCAGGAACCTAGGCCAGGGGGGATCCTACGAGCAGTACTTC	CARNLGQGGSYEQYF	TRBV19	TRBJ2-7
TGTGCCAGCACCAGGGGGAAGTCCTACGAGCAGTACTTC	CASTRGKSYEQYF	TRBV6-1	TRBJ2-7
TGTGCCAGCAGTTACTCGGTCAGGGGTGGCTACGAGCAGTACTTC	CASSYSVRGGYEQYF	TRBV6-5	TRBJ2-7
TGTGCCAGCAGTTTAAAAAAGCGGGACGGGCCCTACGAGCAGTACTTC	CASSLKKRDGPYEQYF	TRBV27	TRBJ2-7
TGTGCCAGCAGTTACAAGGGGGGATTAGCTGAAGCTTTCTTT	CASSYKGGLAEAFF	TRBV6-2	TRBJ1-1
TGTGCCACCAATCTTGCCCCCTGCGGGAGACCGACTAATGAAAAACTGTTTTTT	CATNLAPCGRPTNEKLFF	TRBV24-1	TRBJ1-4
TGTGCCACCAGTGGCGGGACGGGGTGCGAGCAGTACTTC	CATSGGTGCEQYF	TRBV24-1	TRBJ2-7
TGTGCCAGCAGCGGGGGGGCAGGCGCGGAGACCCAGTACTTC	CASSGGAGAETQYF	TRBV7-2	TRBJ2-5
TGTGCTAGCACCACTAAATTCGTCCGCCCAGATACGCAGTATTTT	CASTTKFVRPDTQYF	TRBV7-7	TRBJ2-3
TGTGCCAGCAGCCCTACCGGTTTTCAGTATGGCTACACCTTC	CASSPTGFQYGYTF	TRBV7-4	TRBJ1-2
TGTGCCAGCAGCTTCTGCGTCCTAGACGGGAGAACAGATACGCAGTATTTT	CASSFCVLDGRTDTQYF	TRBV5-4	TRBJ2-3
TGTGCCAGCAGCCAAGATCTCAGCCCCCCAATGGACGAGCAGTACTTC	CASSQDLSPPMDEQYF	TRBV4-2	TRBJ2-7
TGTGCCATCAGTGTTTCTAGCCGTCACGAGGGGTGCACAGATACGCAGTATTTT	CAISVSSRHEGCTDTQYF	TRBV10-3	TRBJ2-3
TGTGCCAGGGCTGGCAGGGTAACTGGTTTTTTCATGAACACTGAAGCTTTCTTT	CARAGRVTGFFMNTEAFF	TRBV5-4	TRBJ1-1
TGTGCCAGCAGCTTCCCTAAGGCGTTAAACGAGCAGTACTTC	CASSFPKALNEQYF	TRBV5-4	TRBJ2-7
TGTGCCAGCAGCAGTCGAGGGGGGGTCGAGCAGTACTTC	CASSSRGGVEQYF	TRBV13	TRBJ2-7
TGTGCCAGCAGTCCAGGACCCCTTCTCTCCTACGAGCAGTACTTC	CASSPGPLLSYEQYF	TRBV27	TRBJ2-7
TGTGCCACCAGTGATTTGAATAGCGGGTACCAAGAGACCCAGTACTTC	CATSDLNSGYQETQYF	TRBV24-1	TRBJ2-5
TGTGCCATCAGTGCGGGAAAAATCTCTTTAGCCAAAAACATTCAGTACTTC	CAISAGKISLAKNIQYF	TRBV10-3	TRBJ2-4
TGTGCCAGCAGCTTAGATCACCGGGACTTTAGAAATAATTCACCCCTCCACTTT	CASSLDHRDFRNNSPLHF	TRBV11-2	TRBJ1-6
TGCGCCAGCAGCTCACTCCGACAGGGACTAATTCAGCCCCAGCATTTT	CASSSLRQGLIQPQHF	TRBV5-1	TRBJ1-5
TGCAGTGCTAGGAGGTCAGGGAGGGTGACCCAGTACTTC	CSARRSGRVTQYF	TRBV20-1	TRBJ2-5
TGTGCCAGTAGTGATTTCCAGATAAGTACGACCCAGTACTTC	CASSDFQISTTQYF	TRBV19	TRBJ2-5
TGCGCCAGCAGCTTGGTCGGGCGGTTCTATGGCTACACCTTC	CASSLVGRFYGYTF	TRBV5-1	TRBJ1-2
TGCGCCAGCAGCTGCAGGACCTTGCACGAGCAGTACTTC	CASSCRTLHEQYF	TRBV5-1	TRBJ2-7
TGTGCCAGCATGCACGGCTATGGCTACACCTTC	CASMHGYGYTF	TRBV5-4	TRBJ1-2
TGTGCCTGGAGTGTACCGCTAGCGGGCGGGGCCTCCTACAATGAGCAGTTCTTC	CAWSVPLAGGASYNEQFF	TRBV30	TRBJ2-1
TGTGCCAGCAGTGAACGAGCAACTAGCGGGCTCCCAGATACGCAGTATTTT	CASSERATSGLPDTQYF	TRBV25-1	TRBJ2-3
TGTGCCAGCAGTTACGCAGGGGTTTCCAGGAGTCAGCCCCAGCATTTT	CASSYAGVSRSQPQHF	TRBV6-6	TRBJ1-5
TGCGCCAGCAGCCCCAGCTCTGGAAACACCATATATTTT	CASSPSSGNTIYF	TRBV5-1	TRBJ1-3
TGTGCCAGCAGCACGAGAAACGGGACAGGGCGGGGAATCCTTCATGGCTACACCTTC	CASSTRNGTGRGILHGYTF	TRBV7-3	TRBJ1-2
TGTGCCAGCAGTTCCAGGCCTCTAAGTTCACCCCTCCACTTT	CASSSRPLSSPLHF	TRBV6-1	TRBJ1-6
TGTGCCAGCAGGGGGTCAACCCAGCCCCAGCATTTT	CASRGSTQPQHF	TRBV5-6	TRBJ1-5
TGTGCCAGTAGTCCCGAACCAAGTTTCTTCAGGTCCTGCCGGGACAGGTGCCAGCAAGAGACCCAGTACTTC	CASSPEPSFFRSCRDRCQQETQYF	TRBV19	TRBJ2-5
TGTGCCACCAGCGTAGGGGATCAGCCCCAGCATTTT	CATSVGDQPQHF	TRBV24-1	TRBJ1-5
TGTGCCAGCAGCCGATTTAGACCGCCACCGGGACAACGCACAGATACGCAGTATTTT	CASSRFRPPPGQRTDTQYF	TRBV6-5	TRBJ2-3
TGTGCCAGCAGCTTGGCCTGGGACAGGGCCGAGAACACTGAAGCTTTCTTT	CASSLAWDRAENTEAFF	TRBV5-4	TRBJ1-1
TGTGCCAGCAGAACCTTGGGGGGGCCGCGGAAAAGCTCCTACAATGAGCAGTTCTTC	CASRTLGGPRKSSYNEQFF	TRBV12-4	TRBJ2-1
TGCAGTGCTAGAGAGGAATCGGGGAGTTTTTCACCCCTCCACTTT	CSAREESGSFSPLHF	TRBV20-1	TRBJ1-6
TGCGCCAGCAGCTTGGTTGGGTCTCTGGGGCGGAACACCATATATTTT	CASSLVGSLGRNTIYF	TRBV5-1	TRBJ1-3
TGTGCCAGCACCCAATCCACAGGGGGATTACCCTTC	CASTQSTGGLPF	TRBV27	TRBJ1-2
TGTGCCAGCAGCCGAAACCGGACGAGCTCCTACGAGCAGTACTTC	CASSRNRTSSYEQYF	TRBV3-1	TRBJ2-7
TGCGCCAGCAGCCACCCGGGACACGATACGCAGTATTTT	CASSHPGHDTQYF	TRBV4-3	TRBJ2-3
TGTGCTAGCAGCACGTACACGACAGGAGGCTACGAGCAGTACTTC	CASSTYTTGGYEQYF	TRBV7-7	TRBJ2-7
TGTGCCTGGAGTTCAGGGGGCGCGGGACCCCGCAATCAGCCCCAGCATTTT	CAWSSGGAGPRNQPQHF	TRBV30	TRBJ1-5
TGCGCCAGGGACCGGACAGGGTTCAGCAATCAGCCCCAGCATTTT	CARDRTGFSNQPQHF	TRBV5-1	TRBJ1-5
TGTGCCAGCAGCGACGGGAAGGGGGCGAGGCCTAATGAAAAACTGTTTTTT	CASSDGKGARPNEKLFF	TRBV11-2	TRBJ1-4
TGTGCCAGTAGTCACTCTAGCGGGCTCCCTTACGAGCAGTACTTC	CASSHSSGLPYEQYF	TRBV19	TRBJ2-7
TGTGCCATGGGGAGTGGACAGGGGCGCTACGAGCAGTACTTC	CAMGSGQGRYEQYF	TRBV19	TRBJ2-7
TGCGCCAGCAGCTTGGGGCCAGAACCCTACGAGCAGTACTTC	CASSLGPEPYEQYF	TRBV5-1	TRBJ2-7
TGCGCCAGCAGTGTGGACCGAGGGGGCGGGACTAATGAAAAACTGTTTTTT	CASSVDRGGGTNEKLFF	TRBV5-1	TRBJ1-4
TGCAGTGCTAAAACCCCGAATGCGGGTTCCGAAGAGACCCAGTACTTC	CSAKTPNAGSEETQYF	TRBV20-1	TRBJ2-5
TGTGCCAGCAGCATCGCCTACCGGGACAGGGCTTACGAGCAGTACTTC	CASSIAYRDRAYEQYF	TRBV7-3	TRBJ2-7
TGTGCCAGCAGTTACTTCCCCGGACTAGCGGGCCGCGCCCAGTACTTC	CASSYFPGLAGRAQYF	TRBV6-5	TRBJ2-5
TGCGCCAGCAGCCAAGAGGAGGAAGACGACATTCAAGAGACCCAGTACTTC	CASSQEEEDDIQETQYF	TRBV4-3	TRBJ2-5
TGTGCCAGTAGTACTCCATATAGCGGGGCTCCGACTTTCTTT	CASSTPYSGAPTFF	TRBV19	TRBJ1-1
TGTGCCAGCAGTCTAACGAGGACTAGCGGGATCTACGAGCAGTACTTC	CASSLTRTSGIYEQYF	TRBV6-3	TRBJ2-7
TGTGGGGCCAGAAATAGCAATCAGCCCCAGCATTTT	CGARNSNQPQHF	TRBV3-1	TRBJ1-5
TGCAGTGCTAGGTGGGGCCACAGGGCCCGTGGAAACCCCAACGAGCAGTACTTC	CSARWGHRARGNPNEQYF	TRBV20-1	TRBJ2-7
TGTGCCACCAGTGATACAGGACTAGCGGGCTCCTACGAGCAGTACTTC	CATSDTGLAGSYEQYF	TRBV24-1	TRBJ2-7
TGTGCCAGCAGCCTAGAAGGGAGGGGGAGGTTGAGCAATCAGCCCCAGCATTTT	CASSLEGRGRLSNQPQHF	TRBV7-3	TRBJ1-5
TGTGCTAGTGGGTCGGGGGTGTACGAGCAGTACTTC	CASGSGVYEQYF	TRBV12-5	TRBJ2-7
TGTGCCACCAGCAGAGCTAAGAGGCCTAGGAGCTTCGATAACACTGAAGCTTTCTTT	CATSRAKRPRSFDNTEAFF	TRBV15	TRBJ1-1
TGCAGTGCGACTCCAGGAAACACCATATATTTT	CSATPGNTIYF	TRBV20-1	TRBJ1-3
TGTGCCAGCAGCGGTCGGAGGATTCAGCCCCAGCATTTT	CASSGRRIQPQHF	TRBV11-3	TRBJ1-5
TGTGCCAGCAGCTTGAATGAGCAGTTCTTC	CASSLNEQFF	TRBV7-9	TRBJ2-1
TGTGCCAGCAGCAAAATGCAACATACGCAGTATTTT	CASSKMQHTQYF	TRBV13	TRBJ2-3
TGTGCCAGCAGCCGAGCTACGGATACGACGGAAGAGGAAAAACTGTTTTTT	CASSRATDTTEEEKLFF	TRBV14	TRBJ1-4
TGCGCCAGCAGCTTGGTCGACCGGGACAGTATTGCTTTCTTT	CASSLVDRDSIAFF	TRBV5-1	TRBJ1-1
TGTGCCAGCAGTGAAGCGGGGACAGGGACTGCTGGAAACACCATATATTTT	CASSEAGTGTAGNTIYF	TRBV6-1	TRBJ1-3
TGTGCCAGCAGTCCGTACGACCATGAGCAGTTCTTC	CASSPYDHEQFF	TRBV12-3	TRBJ2-1
TGTGCCACAGCAGGGATCGCTAGTTATAGCAATCAGCCCCAGCATTTT	CATAGIASYSNQPQHF	TRBV28	TRBJ1-5
TGTGCCAGCAGCTCCCGGGACAGGGCCCCGAACACCGGGGAGCTGTTTTTT	CASSSRDRAPNTGELFF	TRBV7-9	TRBJ2-2
TGTGCCACCAGCTCTACCATCCGGGGTGGCGAGCAGTACTTC	CATSSTIRGGEQYF	TRBV15	TRBJ2-7
TGTGCCAGCAGTCCCGGGCCTTTAGGGGGAACTAATGAAAAACTGTTTTTT	CASSPGPLGGTNEKLFF	TRBV6-5	TRBJ1-4
TGCAGTGCTCGGGACAGGGGGGGCTCCTACGAGCAGTACTTC	CSARDRGGSYEQYF	TRBV20-1	TRBJ2-7
TGCGCCAGCAGCCAAGGAGGCCTAGGGTTACACGAGCAGTACTTC	CASSQGGLGLHEQYF	TRBV4-1	TRBJ2-7
TGTGCCAGCAGCGTAGTTTGTGCGACAGGGGGCGGCTACGAGCAGTACTTC	CASSVVCATGGGYEQYF	TRBV9	TRBJ2-7
TGTGCCAGCAGCGAAGGGACAGACTGGGCGGGTAATTCACCCCTCCACTTT	CASSEGTDWAGNSPLHF	TRBV7-2	TRBJ1-6
TGTGCCAGCAGCTTGGAATCTGGTATAGCTGAAAAACTGTTTTTT	CASSLESGIAEKLFF	TRBV5-4	TRBJ1-4
TGTGCCAGGGTAGGAGGACAGGGGGGTTCTGCCTACGAGCAGTACTTC	CARVGGQGGSAYEQYF	TRBV27	TRBJ2-7
TGTGCCACCAGTGCCCGGAGAGGAGTGGAGACCCAGTACTTC	CATSARRGVETQYF	TRBV24-1	TRBJ2-5
TGTGCCAGCAGAACCCAGGAGAAACTGTTTTTT	CASRTQEKLFF	TRBV7-6	TRBJ1-4
TGTGCCAGCAGCCTAGCGGGCATTCGGAACACCGGGGAGCTGTTTTTT	CASSLAGIRNTGELFF	TRBV28	TRBJ2-2
TGCGCCAGCAGCCAAGCCCGTACGGGGGAGCTGTTTTTT	CASSQARTGELFF	TRBV4-1	TRBJ2-2
TGTGCCAGCAAGCCGGGGTCACATAATTCACCCCTCCACTTT	CASKPGSHNSPLHF	TRBV6-1	TRBJ1-6
TGTGCCAGCAGTGGGAGGGAGACCCAGTACTTC	CASSGRETQYF	TRBV6-1	TRBJ2-5
TGTGCCAGCAGTTCGACGAGCGGGATTGGTACCTACGAGCAGTACTTC	CASSSTSGIGTYEQYF	TRBV6-3	TRBJ2-7
TGTGCCAGCAGCAGCAGGGGCCAGACTTACGAGCAGTACTTC	CASSSRGQTYEQYF	TRBV7-4	TRBJ2-7
TGCGCCAGCAGCCCAGACAGGGAGTACTTC	CASSPDREYF	TRBV5-1	TRBJ2-7
TGTGCCAGCAGCTTCCCGATAGCGGACGAGGCCTACGAGCAGTACTTC	CASSFPIADEAYEQYF	TRBV5-6	TRBJ2-7
TGTGCCACAGGGCCTCGAATCCGGGACAGGGATACTAACTATGGCTACACCTTC	CATGPRIRDRDTNYGYTF	TRBV24-1	TRBJ1-2
TGTGCCAGCAGCTTGGGGTTGGGTTCTCCGGCCACCGGGGAGCTGTTTTTT	CASSLGLGSPATGELFF	TRBV11-2	TRBJ2-2
TGTGCCAGCAGCTTAGTGCAGGGTATTGGTGATCAGCCCCAGCATTTT	CASSLVQGIGDQPQHF	TRBV11-3	TRBJ1-5
TGTGCCAGCAGTTTAGCGAACCGGCCCCCAGGGAAGGTAGATCAGCCCCAGCATTTT	CASSLANRPPGKVDQPQHF	TRBV28	TRBJ1-5
TGCGCCAGCATGGTCGGAGGACAGGGGCCGAGTCGGAACTCTGGGGCCAACGTCCTGACTTTC	CASMVGGQGPSRNSGANVLTF	TRBV10-1	TRBJ2-6
TGCGCCAGCAGCTTGGCGAACCACTGCATATATAGCAATCAGCCCCAGCATTTT	CASSLANHCIYSNQPQHF	TRBV5-1	TRBJ1-5
TGTGCCAGCAGCTTAGTCCCTCTCCTAGCCTCGAACACCGGGGAGCTGTTTTTT	CASSLVPLLASNTGELFF	TRBV7-8	TRBJ2-2
TGCAGCGTTGACGCCAGGGGGCATTACGAGCAGTACTTC	CSVDARGHYEQYF	TRBV29-1	TRBJ2-7
TGTGCCAGCAGCGAGAAAGGGCGGGACTATGGCTACACCTTC	CASSEKGRDYGYTF	TRBV13	TRBJ1-2
TGTGCCAGCAGCCAGCCCCGACAGGGAGGACCCTCTGAAGCTTTCTTT	CASSQPRQGGPSEAFF	TRBV14	TRBJ1-1
TGTGCCAGCAGCAGAGGGCCGGAGGACGAGCAGTACTTC	CASSRGPEDEQYF	TRBV13	TRBJ2-7
TGTGCCAGTAGTCCGGCCGGACAGGGGGCGGATCAGCCCCAGCATTTT	CASSPAGQGADQPQHF	TRBV19	TRBJ1-5
TGTGCCAGCAGAGGTGGGACCGAAGGTGAGCAGTACTTC	CASRGGTEGEQYF	TRBV25-1	TRBJ2-7
TGTGCCAGCACCCGGCAGAGGTACAATGAGCAGTTCTTC	CASTRQRYNEQFF	TRBV27	TRBJ2-1
TGTGCCAGCAGTTCTCCAGGGAATGGAAACACCATATATTTT	CASSSPGNGNTIYF	TRBV6-5	TRBJ1-3
TGCAGTGCTAGATCGTCCTCGGCGGACCAGGCTAATGAAAAACTGTTTTTT	CSARSSSADQANEKLFF	TRBV20-1	TRBJ1-4
TGCGCCAGCAGTGAGCTGGACAGACTGTTTTTT	CASSELDRLFF	TRBV10-2	TRBJ1-4
TGTGCCACCAGTGAGGGGGGGAAAGCCAATAATTCTGGAAACACCATATATTTT	CATSEGGKANNSGNTIYF	TRBV24-1	TRBJ1-3
TGCGCCAGCGAGGGGACAGGGGGCGACGAGCAGTACTTC	CASEGTGGDEQYF	TRBV5-1	TRBJ2-7
TGCACGCACAGGTCGGAGACCCAGTACTTC	CTHRSETQYF	TRBV20-1	TRBJ2-5
TGTGCCAGCAGCAGCCCTGGCTACCCTCCCTCTGGAAACACCATATATTTT	CASSSPGYPPSGNTIYF	TRBV7-3	TRBJ1-3
TGTGCCAGCATAGAGAAGTCACCCCGGGCGCGAAAATCCTACGAGCAGTACTTC	CASIEKSPRARKSYEQYF	TRBV6-4	TRBJ2-7
TGTGCCAGCAGCTCATCTTGGGACAGGGGAGGCTATGGCTACACCTTC	CASSSSWDRGGYGYTF	TRBV11-2	TRBJ1-2
TGCGCCAGCCAGCGGGGACACCGCACAGATACGCAGTATTTT	CASQRGHRTDTQYF	TRBV10-1	TRBJ2-3
TGTGCCAGCATTTCTAGACGTATTACCCAGTACTTC	CASISRRITQYF	TRBV6-6	TRBJ2-5
TGTGCCAGCAGTTGGGGACAGGGGCCCCAGCATTTT	CASSWGQGPQHF	TRBV6-3	TRBJ1-5
TGTGCCAGCAGTGAAGCGCTTGCCCAGGGCACTGAAGCTTTCTTT	CASSEALAQGTEAFF	TRBV6-1	TRBJ1-1
TGTGCCAGCAGCAGGGGACTAGCGGGTACGCAGTATTTT	CASSRGLAGTQYF	TRBV5-4	TRBJ2-3
TGTGCCAGAAGACAGGGTGATACCGGGGAGCTGTTTTTT	CARRQGDTGELFF	TRBV6-6	TRBJ2-2
TGTGCCAGCAGTGTGACAGGGATCTACGGCAAAAACATTCAGTACTTC	CASSVTGIYGKNIQYF	TRBV6-5	TRBJ2-4
TGTGCCAGCAGCCAGGGACAGGGGGGAGTTCTAGCCAAAAACATTCAGTACTTC	CASSQGQGGVLAKNIQYF	TRBV7-2	TRBJ2-4
TGTGCCAGCAGCTTAGCGCCGCTCAAGAGTGAGGGGAAAGAGACCCAGTACTTC	CASSLAPLKSEGKETQYF	TRBV7-6	TRBJ2-5
TGTGCCAGCACCGAGGCGGGAGCCTTCCCGGAGCTGTTTTTT	CASTEAGAFPELFF	TRBV6-5	TRBJ2-2
TGCGCCAGCAGCCTTGGGGACCATAGAAATGAGACCCAGTACTTC	CASSLGDHRNETQYF	TRBV4-3	TRBJ2-5
TGTGCCACCAGTGATTTGCAGACAGGCAACTATGGCTACACCTTC	CATSDLQTGNYGYTF	TRBV24-1	TRBJ1-2
TGTGCCAGCAGCGTAGGAATACCGCGACTAGCGGGAACGCAGTTCTTC	CASSVGIPRLAGTQFF	TRBV9	TRBJ2-1
TGTGCCAGCAGCCAAGGGATATTCCAGGGCGAGGCTATAAAAGGGACATGGAACACTGAAGCTTTCTTT	CASSQGIFQGEAIKGTWNTEAFF	TRBV3-1	TRBJ1-1
TGCGCCAGCAGTGAGTCATACACTAGCGGGAGGGCGGACGACTATGGCTACACCTTC	CASSESYTSGRADDYGYTF	TRBV10-2	TRBJ1-2
TGTGCCAGCAGCTTAGACCAAGGGCTCCAGCCCCAGCATTTT	CASSLDQGLQPQHF	TRBV13	TRBJ1-5
TGTGCCAGCAGCTTAGGGTTTTTTTATAGCAATCAGCCCCAGCATTTT	CASSLGFFYSNQPQHF	TRBV7-2	TRBJ1-5
TGTGCCAGCAGCAAGGCGGTAGGCACTGAAGCTTTCTTT	CASSKAVGTEAFF	TRBV6-3	TRBJ1-1
TGTGGGAAGAGCGGGCTAGAAAACACCGGGGAGCTGTTTTTT	CGKSGLENTGELFF	TRBV6-4	TRBJ2-2
TGTGCCAGCAGTTTAGCCATGGGGGGTGAAAAACTGTTTTTT	CASSLAMGGEKLFF	TRBV12-3	TRBJ1-4
TGTGCCACCAGTGATTTGAGCGGACCCTACGAGCAGTACTTC	CATSDLSGPYEQYF	TRBV24-1	TRBJ2-7
TGTGCCAGCAGAGAGTCTTTTGGGGGCAAGTCTAATGAGCAGTTCTTC	CASRESFGGKSNEQFF	TRBV2	TRBJ2-1
TGCAGTGCTTCACGGTCAGGGTTGAACACTGAAGCTTTCTTT	CSASRSGLNTEAFF	TRBV20-1	TRBJ1-1
TGTGCCAGCAGTGCGTGGGGGCATGGGGGCCCACTCTCCTACGAGCAGTACTTC	CASSAWGHGGPLSYEQYF	TRBV6-6	TRBJ2-7
TGTGCCAGCAGCTTACTTCCCCCAGGGATGGCTGAAGCTTTCTTT	CASSLLPPGMAEAFF	TRBV7-8	TRBJ1-1
TGTGCCAGCAGACCGACTAGGAGCAATGAGCAGTTCTTC	CASRPTRSNEQFF	TRBV6-2	TRBJ2-1
TGTGCCAGCCCTACTGTCGGGGGCAGCGACACTGAAGCTTTCTTT	CASPTVGGSDTEAFF	TRBV27	TRBJ1-1
TGTGCCAGCAGTGCCCAGCGAGGTTCAGATACGCAGTATTTT	CASSAQRGSDTQYF	TRBV6-4	TRBJ2-3
TGTGCCAGTTCCGGTGGGATCGACAGGTTTACATCTGGAAACACCATATATTTT	CASSGGIDRFTSGNTIYF	TRBV19	TRBJ1-3
TGCGCCAGCAGCCAAGGTCCCCGGGACGGTACTGGTTATGAGCAGTTCTTC	CASSQGPRDGTGYEQFF	TRBV4-1	TRBJ2-1
TGCGCCAGCAGGGTGACAAGGGAGACGATGGCGTCCTACAATGAGCAGTTCTTC	CASRVTRETMASYNEQFF	TRBV10-1	TRBJ2-1
TGTGCCAGCAGCCAACGGAGGCCGCGTGGCTACACCTTC	CASSQRRPRGYTF	TRBV6-1	TRBJ1-2
TGTGCCAGCAGTGCTGTAGCGGCCGGCCCCTGGTTCAATGAGCAGTTCTTC	CASSAVAAGPWFNEQFF	TRBV6-4	TRBJ2-1
TGTGCCAACTTAGACCCCTACGAGCAGTACTTC	CANLDPYEQYF	TRBV27	TRBJ2-7
TGTGCCAGCAGTTACTCGACCTGGAGCCAGTCCGCTGGCTACACCTTC	CASSYSTWSQSAGYTF	TRBV6-5	TRBJ1-2
TGTGCCAGCAGCCAAATCAAGACTAGCGGGGAGCAGTACTTC	CASSQIKTSGEQYF	TRBV4-2	TRBJ2-7
TGTGCCAGCAGGGCGTTCCCCAAACATCAGCCCCAGCATTTT	CASRAFPKHQPQHF	TRBV6-5	TRBJ1-5
TGTGCCATCAGTGATTCAGGCGGGGACGGGAACGAGCAGTACTTC	CAISDSGGDGNEQYF	TRBV10-3	TRBJ2-7
TGTGCCACCCAGCCGGGGGTCTTCCCGCAGGTTGAAGCTTTCTTT	CATQPGVFPQVEAFF	TRBV24-1	TRBJ1-1
TGTGCCAGCAGCCAAGATGTATGGGACAGGACGAAGGACCCCGCCTTC	CASSQDVWDRTKDPAF	TRBV14	TRBJ2-7
TGTGCCAGCAGCTCCGACATCTACAATGAGCAGTTCTTC	CASSSDIYNEQFF	TRBV7-9	TRBJ2-1
TGTGCCAGCAGCTCGGGAGGGAAATGTAATTCACCCCTCCACTTT	CASSSGGKCNSPLHF	TRBV7-2	TRBJ1-6
TGTGCCAGCAGCTTCCGCAGCTATATGGTTTCCTACGAGCAGTACTTC	CASSFRSYMVSYEQYF	TRBV5-8	TRBJ2-7
TGTGCCAGCAGCGAGCTAGGGACTCAGCCCCAGCATTTT	CASSELGTQPQHF	TRBV6-5	TRBJ1-5
TGTGCCAGCTTCAGATCCCGACGCGACAGGGGATCGAGCTCCTACGAGCAGTACTTC	CASFRSRRDRGSSSYEQYF	TRBV7-9	TRBJ2-7
TGTGCCAGCAGACTACAGGGTGACACTGAAGCTTTCTTT	CASRLQGDTEAFF	TRBV28	TRBJ1-1
TGTGCCAGCAGCGGGACTAGCGACACAGATACGCAGTATTTT	CASSGTSDTDTQYF	TRBV7-9	TRBJ2-3
TGTGCCAGCAGTAGGGCGCTAGGAAGATTAGAAGATGGCTACACCTTC	CASSRALGRLEDGYTF	TRBV6-4	TRBJ1-2
TGTGCCAGCAGTCAGCGGGAGTACGAGCAGTACTTC	CASSQREYEQYF	TRBV6-8	TRBJ2-7
TGTGCCAGCAGCCATTCAGGGGGGAGCTCCTCCTACAATGAGCAGTTCTTC	CASSHSGGSSSYNEQFF	TRBV7-9	TRBJ2-1
TGTGCCACCAGTCCCCCGGGACAGGGGATTAGTGGGGAGCTGTTTTTT	CATSPPGQGISGELFF	TRBV24-1	TRBJ2-2
TGTGCCAGCAGGATTGCATTGACAAGCACTGAAGCTTTCTTT	CASRIALTSTEAFF	TRBV6-5	TRBJ1-1
TGTGCCAGCAGCAACTGGACAGGGGGCGGAAATCAGCCCCAGCATTTT	CASSNWTGGGNQPQHF	TRBV9	TRBJ1-5
TGTGCCAGCAGTGGTTTAACTACCCTGGAAGCTTTCTTT	CASSGLTTLEAFF	TRBV28	TRBJ1-1
TGTGCCAGCACCCGCGGAGCGGGGGACAATGAGCAGTTCTTC	CASTRGAGDNEQFF	TRBV6-2	TRBJ2-1
TGCGCCAGCAGTTTCCCCGGGACTAGAGATCGTCGCGGGGAGCTGTTTTTT	CASSFPGTRDRRGELFF	TRBV10-1	TRBJ2-2
TGCGCCAGCCCCCTTCGCGGAACCTATAGCGCTGGAAACACCATATATTTT	CASPLRGTYSAGNTIYF	TRBV4-3	TRBJ1-3
TGTGCCAGCAGCGTAGATTTACACAGGGGGCAGTTCTTC	CASSVDLHRGQFF	TRBV9	TRBJ2-1
TGTGCCACCAGTGATATCTTGATTGCCGGGACAGGGTGCTACGAGCAGTACTTC	CATSDILIAGTGCYEQYF	TRBV24-1	TRBJ2-7
TGCGCCAGCAGCTTGAGTAGGGGAGACAATAGCAATCAGCCCCAGCATTTT	CASSLSRGDNSNQPQHF	TRBV5-1	TRBJ1-5
TGCAGCGTAGAACCGGGACTAGCGGGGATCACAGATACGCAGTATTTT	CSVEPGLAGITDTQYF	TRBV29-1	TRBJ2-3
TGTGCCAGCAGCAGGACAGGTATCAACTCCACCGGGGAGCTGTTTTTT	CASSRTGINSTGELFF	TRBV7-3	TRBJ2-2
TGTGCCAGCAGCCTGGCGGCCGGGACATGGGGGGAATTGTACAATGAGCAGTTCTTC	CASSLAAGTWGELYNEQFF	TRBV13	TRBJ2-1
TGTGCCAGCAGCTTATCCGGGTATTTGGGAGGTAGGTCCGAGGATACGCAGTATTTT	CASSLSGYLGGRSEDTQYF	TRBV11-1	TRBJ2-3
TGTGCCAGCAGCTACTCACCGGACAGGGTCGGGACCGGGGAGCTGTTTTTT	CASSYSPDRVGTGELFF	TRBV5-6	TRBJ2-2
TGTGCCAGCAGGTGGCCGGAGGGATGCTCCTACGAGCAGTACTTC	CASRWPEGCSYEQYF	TRBV27	TRBJ2-7
TGTGCCAGCAGTAGATGGAGGACATTTTTGAACACTGAAGCTTTCTTT	CASSRWRTFLNTEAFF	TRBV6-1	TRBJ1-1
TGTGCCAGCAGTGGGCGCCTTATACGGGGAGTCGACCTGCAGTACTTC	CASSGRLIRGVDLQYF	TRBV2	TRBJ2-7
TGTGCCAGCAGCTTACCCCTTTGGACAGGGCAAGAGACCCAGTACTTC	CASSLPLWTGQETQYF	TRBV11-3	TRBJ2-5
TGCAGTGCTCCCCAACCGGGACTAGCGGGAGGGGGCTATGGCTACACCTTC	CSAPQPGLAGGGYGYTF	TRBV20-1	TRBJ1-2
TGTGCCAGCAGCGTCAGGGGGTCAGATACGCAGTATTTT	CASSVRGSDTQYF	TRBV5-6	TRBJ2-3
TGTGCCAGCAGCTCCCGGCCCTTAGCCAAAAACATTCAGTACTTC	CASSSRPLAKNIQYF	TRBV7-4	TRBJ2-4
TGTGCCAGCAGTTACCGAAACCTGCTTTTAGCGGGCTCCATGTGGAGATCCTACGAGCAGTACTTC	CASSYRNLLLAGSMWRSYEQYF	TRBV6-2	TRBJ2-7
TGCAGCGCTGGACAGGGACAAAAACTGTTTTTT	CSAGQGQKLFF	TRBV29-1	TRBJ1-4
TGCGCCAGCAGCTGGGCGGCCGGGGTAATTCACACTGAAGCTTTCTTT	CASSWAAGVIHTEAFF	TRBV5-1	TRBJ1-1
TGTGCCGACGGGGGCGACCTCCAGAACACTGAAGCTTTCTTT	CADGGDLQNTEAFF	TRBV12-4	TRBJ1-1
TGTGCCAGCAGCACCAGGGGCCGAGATGGCTACACCTTC	CASSTRGRDGYTF	TRBV5-6	TRBJ1-2
TGTGCCACCAGTGATTTTTTGGATAGAAGGGGCACAGATACGCAGTATTTT	CATSDFLDRRGTDTQYF	TRBV24-1	TRBJ2-3
TGTGCCAGCAGTGACCAGACAACTAATGAAAAACTGTTTTTT	CASSDQTTNEKLFF	TRBV6-1	TRBJ1-4
TGTGCCAGCAGCTGGAGACTAGCCCGTGAGACCCAGTACTTC	CASSWRLARETQYF	TRBV11-3	TRBJ2-5
TGTGCCAGCAGACCGGTTCAAAGCGAGCAGTACTTC	CASRPVQSEQYF	TRBV2	TRBJ2-7
TGTGCCAGCAAAGCGGGGACAGGGGTGTATCTCCAAGAGACCCAGTACTTC	CASKAGTGVYLQETQYF	TRBV6-4	TRBJ2-5
TGTGCCAGCAGCCCCCCCAGGCTCGGGGGATTAGAGACCCAGTACTTC	CASSPPRLGGLETQYF	TRBV7-2	TRBJ2-5
TGTGCCAGCACACGGACTAGAACAGATACGCAGTATTTT	CASTRTRTDTQYF	TRBV3-1	TRBJ2-3
TGTGCCAGCAGCCAAGCCAGACAGGGGGCGCAAGATCAGCCCCAGCATTTT	CASSQARQGAQDQPQHF	TRBV4-2	TRBJ1-5
TGTGCCAGCAGTTTATATGGCCGGGACAGGGCTGAAGCTTTCTTT	CASSLYGRDRAEAFF	TRBV28	TRBJ1-1
TGTGCCAGCAGTCCCGGGGTCTTCTGCAATCAGCCCCAGCATTTT	CASSPGVFCNQPQHF	TRBV27	TRBJ1-5
TGTGCCAGCAGGGGTGCGGGGGAACACTACGAGCAGTACTTC	CASRGAGEHYEQYF	TRBV7-8	TRBJ2-7
TGTGCCAGCAGCTTAGTCGCAGGGTTGGGAGATACGCAGTATTTT	CASSLVAGLGDTQYF	TRBV11-2	TRBJ2-3
TGTGCCAGCAGCATCCCTGTCAGGGGGCGCTTCCCACCGGGCGAGCAGTACTTC	CASSIPVRGRFPPGEQYF	TRBV5-5	TRBJ2-7
TGTGCCACCCTGCCCCCTATTACCCCTGAACGCCACCCGGGAATCACAGATACGCAGTATTTT	CATLPPITPERHPGITDTQYF	TRBV24-1	TRBJ2-3
TGCGCCAGCAGCCGGCGGGGTACGGATCAGCCCCAGCATTTT	CASSRRGTDQPQHF	TRBV5-1	TRBJ1-5
TGTGCCAGCAGCCCGGGGGCGGAGGGACAAGATACGCAGTATTTT	CASSPGAEGQDTQYF	TRBV7-3	TRBJ2-3
TGTGCCAGCAGTTATCTCAGGCGGGCCCCCGGCTACACCTTC	CASSYLRRAPGYTF	TRBV6-3	TRBJ1-2
TGCGCCAGCAGCGACGGGATTGGGGATTCACCCCTCCACTTT	CASSDGIGDSPLHF	TRBV5-1	TRBJ1-6
TGTGCCCGCTTTTCAGTAGTGAATCAGCCCCAGCATTTT	CARFSVVNQPQHF	TRBV10-3	TRBJ1-5
TGTGCCAGCAGCTTAACCCAAGTCGACAGGATGAATCAGCCCCAGCATTTT	CASSLTQVDRMNQPQHF	TRBV7-6	TRBJ1-5
TGTGCTAGTGTAGGATGCCACGCTAGGCAAGGCTACGAGCAGTACTTC	CASVGCHARQGYEQYF	TRBV12-5	TRBJ2-7
TGTGCCAGCAGTCAGGTAACTGAAGCTTTCTTT	CASSQVTEAFF	TRBV27	TRBJ1-1
TGCAGCGGGAGGGGGACTAGCGGGTACCGAAATGAGCAGTTCTTC	CSGRGTSGYRNEQFF	TRBV29-1	TRBJ2-1
TGCAGTGCGAACTATCATCTAGAGACCCAGTACTTC	CSANYHLETQYF	TRBV20-1	TRBJ2-5
TGTGCCATCAAACACCGGGGCTTCGGGGAGCTGTTTTTT	CAIKHRGFGELFF	TRBV10-3	TRBJ2-2
TGTGCCAGCAGTATGGATCGGCCCAGGGGGACCTCCCCCTACGAGCAGTACTTC	CASSMDRPRGTSPYEQYF	TRBV6-4	TRBJ2-7
TGCAGTGCTAGAGCCCTAGATAGGACCGAACCCGGGGAGCTGTTTTTT	CSARALDRTEPGELFF	TRBV20-1	TRBJ2-2
TGTGCCAGCAGTAACTGCTCACCCGACACAGATACGCAGTATTTT	CASSNCSPDTDTQYF	TRBV6-4	TRBJ2-3
TGTGCCAGCAGCCACAACAGGGGAATCCATAGCAATCAGCCCCAGCATTTT	CASSHNRGIHSNQPQHF	TRBV3-1	TRBJ1-5
TGTGCCAGCCCTGGGGGACAGGGGAGTCATCAGCCCCAGCATTTT	CASPGGQGSHQPQHF	TRBV3-1	TRBJ1-5
TGTGCCAGAGAACCTCACCAGGGGGCGGGGACTAATGAAAAACTGTTTTTT	CAREPHQGAGTNEKLFF	TRBV6-3	TRBJ1-4
TGTGCCTGGCTTAGAGCTAAATTAGCTAACTATGGCTACACCTTC	CAWLRAKLANYGYTF	TRBV30	TRBJ1-2
TGTGCCAGCAGTTTATACCCGGGACAGGGGGGAGCTCGCATGAACACTGAAGCTTTCTTT	CASSLYPGQGGARMNTEAFF	TRBV27	TRBJ1-1
TGTGCCAGCAGCGTTCACACAGGGGACCCAGCTTTCTTT	CASSVHTGDPAFF	TRBV9	TRBJ1-1
TGTGCCAGCAGCCAAGAGAAGGGATACCGCAATCAGCCCCAGCATTTT	CASSQEKGYRNQPQHF	TRBV14	TRBJ1-5
TGTGCCAGCAGCCAAGATGGAAGGGCCCTTGTCTCTGGAAACACCATATATTTT	CASSQDGRALVSGNTIYF	TRBV14	TRBJ1-3
TGTGCCAGCAGCTTCCCTCCTCATGGGGCGAAGGCTGACTCCTACAATGAGCAGTTCTTC	CASSFPPHGAKADSYNEQFF	TRBV5-6	TRBJ2-1
TGCGCCAGCAGCCAGTCGGGCCTCGATTCACCCCTCCACTTT	CASSQSGLDSPLHF	TRBV4-3	TRBJ1-6
TGTGCCAGCAGCAGTAGAGGGGGACCGCCCCAGCATTTT	CASSSRGGPPQHF	TRBV7-2	TRBJ1-5
TGTGCCTGGTCACTTTTGATCGGAGAGAGTTCTGGAAACACCATATATTTT	CAWSLLIGESSGNTIYF	TRBV30	TRBJ1-3
TGTGCCAGCAGCACCAGACAGGGGGCAGGGAGCCAGGTGAACACTGAAGCTTTCTTT	CASSTRQGAGSQVNTEAFF	TRBV11-3	TRBJ1-1
TGTGCCAGCAGTTGTAAAAAAAAGCTATGGGAAGCTTTCTTT	CASSCKKKLWEAFF	TRBV28	TRBJ1-1
TGTGCCAGCTCACCTTTGGCAGGGGCCTACGAGCAGTACTTC	CASSPLAGAYEQYF	TRBV18	TRBJ2-7
TGTGCCAGCAGCGCGATGGACAGGACTACAGAGACCCAGTACTTC	CASSAMDRTTETQYF	TRBV7-3	TRBJ2-5
TGTGCCAGCAGGGAGAGGGGACAGGGGATGAACACTGAAGCTTTCTTT	CASRERGQGMNTEAFF	TRBV7-9	TRBJ1-1
TGTGCCAGCAGCTTCCCCCCCACAGGCACTACGACCGGGGAGCTGTTTTTT	CASSFPPTGTTTGELFF	TRBV7-8	TRBJ2-2
TGCAGTGCTGGACGTTCCCGTGACCCTTTCTACAGGGCATCGAATCAGCCCCAGCATTTT	CSAGRSRDPFYRASNQPQHF	TRBV20-1	TRBJ1-5
TGTGCCAGGACCACCCTAGCTACTGAAGCTTTCTTT	CARTTLATEAFF	TRBV5-6	TRBJ1-1
TGTGCCAGCAGCTTCGACAATCCCCAGTACTTC	CASSFDNPQYF	TRBV5-6	TRBJ2-5
TGTGCCAGCAGCGGGACAGGGGGTAGAGAAATCGAGCAGTACTTC	CASSGTGGREIEQYF	TRBV7-9	TRBJ2-7
TGCAGTGCTAAAATGGCTAGCGGGGGGGCCCCTTTCTACGAGCAGTACTTC	CSAKMASGGAPFYEQYF	TRBV20-1	TRBJ2-7
TGTGCCAGCAGCTTGGGAACGCACAGACCGGGCAATTCCTACGAGCAGTACTTC	CASSLGTHRPGNSYEQYF	TRBV5-6	TRBJ2-7
TGTGCCAGTAGGTACGCAGATACGCAGTATTTT	CASRYADTQYF	TRBV19	TRBJ2-3
TGTGCCAGTAGTATAGCCCAGACTAGCGGTGGCGAGCAGTACTTC	CASSIAQTSGGEQYF	TRBV19	TRBJ2-7
TGCAGTGCTATCAGGGGCGATGGCTACACCTTC	CSAIRGDGYTF	TRBV20-1	TRBJ1-2
TGCGCCAGCAGTGAGGGCAAACCCTTACCCTACGAGCAGTACTTC	CASSEGKPLPYEQYF	TRBV10-1	TRBJ2-7
TGTGCCAGCAGCTACCGCGTAAATGGGGGCGGCGGCGGCTACGAGCAGTACTTC	CASSYRVNGGGGGYEQYF	TRBV7-8	TRBJ2-7
TGTGCCAGCAGTCGTACTCCACAGGGGCGCTTATACTACGAGCAGTACTTC	CASSRTPQGRLYYEQYF	TRBV6-1	TRBJ2-7
TGCGCCAGCAGCCAAGAGTCACCGGGACAGGGGGACGAGCAGTACTTC	CASSQESPGQGDEQYF	TRBV4-3	TRBJ2-7
TGCGCCAGCAGCTGGGCTACTCCAGAGAGGAACACCGGGGAGCTGTTTTTT	CASSWATPERNTGELFF	TRBV5-1	TRBJ2-2
TGTGCCAGCAGCGTAGAGGCGATTATTACCTACGAGCAGTACTTC	CASSVEAIITYEQYF	TRBV9	TRBJ2-7
TGTGCCACCAGCAGAGCCGAACATGGAGTCCCCGGAAGCACCGGGGAGCTGTTTTTT	CATSRAEHGVPGSTGELFF	TRBV15	TRBJ2-2
TGTGCCATCCGGGCGAGCTACAATGAGCAGTTCTTC	CAIRASYNEQFF	TRBV10-3	TRBJ2-1
TGTGCCAGTAGTGTCTGGCCGGGACAGGGGTCTGAAGAGACCCAGTACTTC	CASSVWPGQGSEETQYF	TRBV19	TRBJ2-5
TGTGCCAGCAGCACAGGGTTGAACACTGAAGCTTTCTTT	CASSTGLNTEAFF	TRBV13	TRBJ1-1
TGTGCCAGCAGTTACCCTAGCGGGGGGGCCGGTTTCGGAGATACGCAGTATTTT	CASSYPSGGAGFGDTQYF	TRBV6-2	TRBJ2-3
TGTGCCCGCAGGGGGCTAGGAAACACCATATATTTT	CARRGLGNTIYF	TRBV11-3	TRBJ1-3
TGTGCCAGCTCAGAGGTTATAGTTATCACAGATACGCAGTATTTT	CASSEVIVITDTQYF	TRBV18	TRBJ2-3
TGTGCCAGCAGTGAATACGCTAGCGGTACCGGCGAGACCCAGTACTTC	CASSEYASGTGETQYF	TRBV25-1	TRBJ2-5
TGCGCCAGCAGCTTGGAGGGCCCCGGGGAGCTGTTTTTT	CASSLEGPGELFF	TRBV5-1	TRBJ2-2
TGTGCCAGCAGTTACACCCCAAAAGGGGCGGAATACAGCAATCAGCCCCAGCATTTT	CASSYTPKGAEYSNQPQHF	TRBV6-2	TRBJ1-5
TGCAGCACATTAGGGGGCTCTGGGGCCAACGTCCTGACTTTC	CSTLGGSGANVLTF	TRBV29-1	TRBJ2-6
TGTGCCAGCAGGGGGGCGGCCAGCCCCTACGAGCAGTACTTC	CASRGAASPYEQYF	TRBV11-2	TRBJ2-7
TGTGCCAGCAGCTTGGGTAAAAGCTCAGATACGCAGTATTTT	CASSLGKSSDTQYF	TRBV7-2	TRBJ2-3
TGTGCCAGCAGTGGCGCAGAAGCTTTCTTT	CASSGAEAFF	TRBV12-4	TRBJ1-1
TGCAGCGTGATTGGGGATAGCAATCAGCCCCAGCATTTT	CSVIGDSNQPQHF	TRBV29-1	TRBJ1-5
TGCAGCAGGCAAGAGCGGGACCGGACTAATGAAAAACTGTTTTTT	CSRQERDRTNEKLFF	TRBV29-1	TRBJ1-4
TGTGCCAGCAGCTTGGGATGCGGACTAGGACAAGAGACCCAGTACTTC	CASSLGCGLGQETQYF	TRBV5-5	TRBJ2-5
TGTGCCAGCAGGCCCAGGGTCGGAGATACGCAGTATTTT	CASRPRVGDTQYF	TRBV6-3	TRBJ2-3
TGTGCCAGCAGTTACATATCGGTTCTCTCCGGGACAGGGAGCAATCAGCCCCAGCATTTT	CASSYISVLSGTGSNQPQHF	TRBV6-5	TRBJ1-5
TGTGCCAGCAGAAAGACTACTGAAGCTTTCTTT	CASRKTTEAFF	TRBV5-6	TRBJ1-1
TGTGCCACCAGTGCAAGACAGGGGGATAAATTGAAGTCCTATAATTCACCCCTCCACTTT	CATSARQGDKLKSYNSPLHF	TRBV24-1	TRBJ1-6
TGTGCCACCGTGGGTCAGGCTGAAGCTTTCTTT	CATVGQAEAFF	TRBV6-4	TRBJ1-1
TGTGCCAGCCGAGACTTTTCCGGGGTATGTAAACTGTTTTTT	CASRDFSGVCKLFF	TRBV9	TRBJ1-4
TGTGCCAGCAGCACCCACGGGGGGGTCGAGCAGTACTTC	CASSTHGGVEQYF	TRBV11-2	TRBJ2-7
TGCAGCGTTGACGAAAGATGGGACACGATGAACACTGAAGCTTTCTTT	CSVDERWDTMNTEAFF	TRBV29-1	TRBJ1-1
TGTGCCAGCTCACTTGCCAGAGACTATGGCTACACCTTC	CASSLARDYGYTF	TRBV18	TRBJ1-2
TGTGCCACCAGCAGAGATTTACTAGGAGTAGGAAATCAGCCCCAGCATTTT	CATSRDLLGVGNQPQHF	TRBV15	TRBJ1-5
TGTGCCAGCTCACCGGGGGGCGTCTCAACTAATGAAAAACTGTTTTTT	CASSPGGVSTNEKLFF	TRBV18	TRBJ1-4
TGTGCCAGCAGTTACAGGGCCCCTATACACGAGCAGTACTTC	CASSYRAPIHEQYF	TRBV6-3	TRBJ2-7
TGTGCCAGCAGGAGACATTCAAACAATCAGCCCCAGCATTTT	CASRRHSNNQPQHF	TRBV3-1	TRBJ1-5
TGTGCCAGCAGCTTGAGCTGTGAAGCTTTCTTT	CASSLSCEAFF	TRBV7-8	TRBJ1-1
TGTGCCAGCAGGGATGAGCAGTTCTTC	CASRDEQFF	TRBV6-4	TRBJ2-1
TGTGCCAGCAGCCGCCTACCCGGAGTGCACGAGCAGTACTTC	CASSRLPGVHEQYF	TRBV7-4	TRBJ2-7
TGTGCCAGCAGCGCGGGGACGGGACTAGCGGGCGCCCCCCAGCCGATCAATGAGCAGTTCTTC	CASSAGTGLAGAPQPINEQFF	TRBV9	TRBJ2-1
TGCGCCAGCAGCAGAGGGTACGAGCAGTACTTC	CASSRGYEQYF	TRBV5-1	TRBJ2-7
TGCAGTGCTAGAGATTCACCTAGGGGGCCCGGCAACTATGGCTACACCTTC	CSARDSPRGPGNYGYTF	TRBV20-1	TRBJ1-2
TGTGCCAGCAGCTTGAAAGACAGCGTATTTACCTACGAGCAGTACTTC	CASSLKDSVFTYEQYF	TRBV5-6	TRBJ2-7
TGTGCCATCCGTAGCGGGATCGGAAACACCATATATTTT	CAIRSGIGNTIYF	TRBV10-3	TRBJ1-3
TGTGCCTGGTTTCGGTACTTC	CAWFRYF	TRBV30	TRBJ2-5
TGTGCCAGCAGCTTGGGCGCACTAGACAGTACATATCAGCCCCAGCATTTT	CASSLGALDSTYQPQHF	TRBV5-5	TRBJ1-5
TGTGCCAGCAGTGGAGGTGGACTAGCGTTCCCCAACTACGAGCAGTACTTC	CASSGGGLAFPNYEQYF	TRBV6-4	TRBJ2-7
TGTGCCACCAGTGATTTTTCGCCGCAGGGGGCAGGGAACACTGAAGCTTTCTTT	CATSDFSPQGAGNTEAFF	TRBV24-1	TRBJ1-1
TGCAGCGAAAAGTTGGGGCGTCGGTACGAGCAGTACTTC	CSEKLGRRYEQYF	TRBV29-1	TRBJ2-7
TGTGCCTCCAACGGGGGGCATAAAGGATATAGCAATCAGCCCCAGCATTTT	CASNGGHKGYSNQPQHF	TRBV30	TRBJ1-5
TGTGCCAGCAGGGGAGGGGCCTACACCGGGGAGCTGTTTTTT	CASRGGAYTGELFF	TRBV6-1	TRBJ2-2
TGTGGCGAAACTTACCAGGGCTGGACCCAGTACTTC	CGETYQGWTQYF	TRBV6-2	TRBJ2-5
TGTGCCAGCGGAAAACAGGACCCTGGGTCTGTGGCTGAAGCTTTCTTT	CASGKQDPGSVAEAFF	TRBV27	TRBJ1-1
TGTGCCAGTAGTACGGGAGCGGGAGAGACCCAGTACTTC	CASSTGAGETQYF	TRBV19	TRBJ2-5
TGTGCCAGCAGCTTCCAGAGTCCTCCGGCCTTTCAGCCCCAGCATTTT	CASSFQSPPAFQPQHF	TRBV7-6	TRBJ1-5
TGCAGTGCTTGGACAGGGGGAGATGGCTACACCTTC	CSAWTGGDGYTF	TRBV20-1	TRBJ1-2
TGCGCCACGCCGGGACAGGGGAGAACTAACTATGGCTACACCTTC	CATPGQGRTNYGYTF	TRBV10-1	TRBJ1-2
TGCGCCAGCTACCGACAGCGTCAGCCCCAGCATTTT	CASYRQRQPQHF	TRBV10-2	TRBJ1-5
TGTGCCACCAGGATGAGGGCCCGGGCCCCAAACGAGCAGTACTTC	CATRMRARAPNEQYF	TRBV24-1	TRBJ2-7
TGTGCCACCACGAAGGGACAGGGGGCAATAGGCTACACCTTC	CATTKGQGAIGYTF	TRBV24-1	TRBJ1-2
TGTGCCAGCAGTGACGGACAGGGGACGAGTAGCACAGATACGCAGTATTTT	CASSDGQGTSSTDTQYF	TRBV12-4	TRBJ2-3
TGTGCCACTAGTACCGTCACCATATATTTT	CATSTVTIYF	TRBV6-4	TRBJ1-3
TGTGCCTGGGAAGGGGCAAGAAGTAATCAGCCCCAGCATTTT	CAWEGARSNQPQHF	TRBV30	TRBJ1-5
TGTGCCAGCAGCTTTAGGCCGACATATGGCTACACCTTC	CASSFRPTYGYTF	TRBV11-2	TRBJ1-2
TGTGCCAATGCCCGCGAGGTTTCTACCGGGTTACGCTACAATGAGCAGTTCTTC	CANAREVSTGLRYNEQFF	TRBV12-3	TRBJ2-1
TGCGCCAGCCAAAAGGGACAGGGCCGAGGACCGCAGTACTTC	CASQKGQGRGPQYF	TRBV10-1	TRBJ2-7
TGCGCCAGCAGCCGGGGGGGGGGCGCCGATGAGCAGTTCTTC	CASSRGGGADEQFF	TRBV5-1	TRBJ2-1
TGCAGTGCTAGAAAATATATCTTAGGGCATCCCTACGAGCAGTACTTC	CSARKYILGHPYEQYF	TRBV20-1	TRBJ2-7
TGCGCCAACCGGGGGAAATGGGAGAAAGGCTACACCTTC	CANRGKWEKGYTF	TRBV10-1	TRBJ1-2
TGTGCCAGCAGTAAACCCCGGGGGGGCCCGCCCCCCGGGGAGCTGTTTTTT	CASSKPRGGPPPGELFF	TRBV27	TRBJ2-2
TGTGTTCACCTAGCCTTCTATGGCTACACCTTC	CVHLAFYGYTF	TRBV3-1	TRBJ1-2
TGTGCCAGTGGACAGGGGGCGCGATATCTATCCTACAATGAGCAGTTCTTC	CASGQGARYLSYNEQFF	TRBV19	TRBJ2-1
TGTGCCTTGTATACTGAAGCTTTCTTT	CALYTEAFF	TRBV27	TRBJ1-1
TGCGCCAGCAGCAACCCAGCGGGTAACGGGGGGGAAATCGATTACGAGCAGTACTTC	CASSNPAGNGGEIDYEQYF	TRBV5-1	TRBJ2-7
TGTGCCAGCAGCAGACAGGCTAGTCTGGAGTACTTC	CASSRQASLEYF	TRBV7-3	TRBJ2-5
TGCGCCAGCAGTGAGACCCCAAAAGGGGGCCTGGGATCCATGAACACTGAAGCTTTCTTT	CASSETPKGGLGSMNTEAFF	TRBV10-1	TRBJ1-1
TGTGCCAGCAGTTTATCGAGGGACAGGGGTAATGAAAAACTGTTTTTT	CASSLSRDRGNEKLFF	TRBV27	TRBJ1-4
TGTGCCAGCAGTTCAGTGGACCGGGAGACAGGGGGCAATCAGCCCCAGCATTTT	CASSSVDRETGGNQPQHF	TRBV6-1	TRBJ1-5
TGTGCCAGCAGCCAAGAGGGTTCGGCCGGGACTGAAAAACTGTTTTTT	CASSQEGSAGTEKLFF	TRBV14	TRBJ1-4
TGTGCCACCAGTGAGCGGGAAAGGGATGGCTACACCTTC	CATSERERDGYTF	TRBV24-1	TRBJ1-2
TGTGCCAGCAGCTCGGACAGGGTCGCACCCAACGCTAACTATGGCTACACCTTC	CASSSDRVAPNANYGYTF	TRBV7-9	TRBJ1-2
TGCAGTGCTAGAGGGGGGCCTTTCTCCTACGAGCAGTACTTC	CSARGGPFSYEQYF	TRBV20-1	TRBJ2-7
TGTGCCAGCAGTGCATTCTGTCCAGGAAGAGGCAATCAGCCCCAGCATTTT	CASSAFCPGRGNQPQHF	TRBV6-2	TRBJ1-5
TGTGCCAGCAGTCCACAGCACCATACCTCCTACGAGCAGTACTTC	CASSPQHHTSYEQYF	TRBV6-5	TRBJ2-7
TGTGCCAGCAGCCAGGCAGGGGAGGGGGATCGCATTGCGCCCCAGCATTTT	CASSQAGEGDRIAPQHF	TRBV12-3	TRBJ1-5
TGTGCCAGCATAGGCCAAGAGACCCAGTACTTC	CASIGQETQYF	TRBV6-4	TRBJ2-5
TGTGCCAGTAACCGGGACAGGGGGGTTCGGCCTAACTATGGCTACACCTTC	CASNRDRGVRPNYGYTF	TRBV27	TRBJ1-2
TGTGCCAGCAGTTCAGGGGGGAGCAATGAGCAGTTCTTC	CASSSGGSNEQFF	TRBV6-5	TRBJ2-1
TGTGCCTGGAAGTGGCAGGGGGCAACGTATGGCTACACCTTC	CAWKWQGATYGYTF	TRBV30	TRBJ1-2
TGTGCCCGGTGGAAGACCTACGAGCAGTACTTC	CARWKTYEQYF	TRBV28	TRBJ2-7
TGCGCCAAGTGTGTGCGGGACGACACCGGGGAGCTGTTTTTT	CAKCVRDDTGELFF	TRBV5-1	TRBJ2-2
TGTGCCGCGGGGAATAGGTGCGGGGAGCTGTTTTTT	CAAGNRCGELFF	TRBV24-1	TRBJ2-2
TGTGCTAGTGGTAATAAGCCGGGACTTCCCTACGAGCAGTACTTC	CASGNKPGLPYEQYF	TRBV12-5	TRBJ2-7
TGTGCCAGCAGCTACAGGGACAATCAGCCCCAGCATTTT	CASSYRDNQPQHF	TRBV7-9	TRBJ1-5
TGCGCCAGCAGCCCTGCCAGGGGGATCTCTGGAAACACCATATATTTT	CASSPARGISGNTIYF	TRBV4-1	TRBJ1-3
TGTGCCAGCAGCAGGGCAACGACCGATCAGCCCCAGCATTTT	CASSRATTDQPQHF	TRBV14	TRBJ1-5
TGTGCCAGCAATCATCTGGGAGTCTTC	CASNHLGVF	TRBV9	TRBJ2-1
TGTGCCAGTGTAGTCTCAGGACCTGGAAACACCATATATTTT	CASVVSGPGNTIYF	TRBV27	TRBJ1-3
TGTGCCAGTAGTATGCCCCTGCCGGGACAGGGGACCGGAGGTCAGCCCCAGCATTTT	CASSMPLPGQGTGGQPQHF	TRBV19	TRBJ1-5
TGTGCCAGCAGTTACTCGACGAGGGCGTCTGGCGAGACCCAGTACTTC	CASSYSTRASGETQYF	TRBV6-5	TRBJ2-5
TGCGCCAGCATGTCGGGACAGCCCTTCATCTACACCGGGGAGCTGTTTTTT	CASMSGQPFIYTGELFF	TRBV10-1	TRBJ2-2
TGCGCCAGCAGCAACCGGGACAGGGGTTACAATGAGCAGTTCTTC	CASSNRDRGYNEQFF	TRBV5-1	TRBJ2-1
TGTGCTACCCGCAGGGGTACTAACTATGGCTACACCTTC	CATRRGTNYGYTF	TRBV12-5	TRBJ1-2
TGTGCCAGCATTGGGAACATTGGCTGGACTGAAGCTTTCTTT	CASIGNIGWTEAFF	TRBV12-3	TRBJ1-1
TGCGCCAGCAGCCCTCCGGGGCCTGCGGACTACGAGCAGTACTTC	CASSPPGPADYEQYF	TRBV5-1	TRBJ2-7
TGTGCCAGCAGCTATAGAGATACGCAGTATTTT	CASSYRDTQYF	TRBV9	TRBJ2-3
TGTGCCAGCAGCTTACTGAATGGCGGGACCTACGAGCAGTACTTC	CASSLLNGGTYEQYF	TRBV11-2	TRBJ2-7
TGCAGCAGATTGGGGCAGCCCCAGCATTTT	CSRLGQPQHF	TRBV29-1	TRBJ1-5
TGTGCCAGCAGGCCGGGACAGGGGGCTCCGATTACAGATACGCAGTATTTT	CASRPGQGAPITDTQYF	TRBV6-5	TRBJ2-3
TGTGCCAGCAGCCAAGTTAGGGGTTGCCCCGTGCAGGGCCCCAATGAAAAACTGTTTTTT	CASSQVRGCPVQGPNEKLFF	TRBV3-1	TRBJ1-4
TGCGCCAGCAGTGAGTTTGTCCCTTTCGGACAGGAGGGGCCGCCCCAGCATTTT	CASSEFVPFGQEGPPQHF	TRBV10-2	TRBJ1-5
TGTGCCAGCAGCTTAGACCTATTAAGCGAATACAATGAGCAGTTCTTC	CASSLDLLSEYNEQFF	TRBV7-6	TRBJ2-1
TGCAGCGAGTACCCCCCTAGGGACTATGGCTACACCTTC	CSEYPPRDYGYTF	TRBV29-1	TRBJ1-2
TGTGCCAGCAGCTTTCTCAGGACTAGCGGGGGAAATGAGCAGTTCTTC	CASSFLRTSGGNEQFF	TRBV7-9	TRBJ2-1
TGTGGCAGGTCAGGGGGAGGGTCCGAGCACAATGAGCAGTTCTTC	CGRSGGGSEHNEQFF	TRBV27	TRBJ2-1
TGTGCCAGCAGCTTGCCCCGGGGGGGGCGAGCCTACAATGAGCAGTTCTTC	CASSLPRGGRAYNEQFF	TRBV5-4	TRBJ2-1
TGCGCCAGCAGCTTGGAACCGAGGACAGGGGGCCGCAATCAGCCCCAGCATTTT	CASSLEPRTGGRNQPQHF	TRBV5-1	TRBJ1-5
TGTGCCAGCAGCGTGCGTAAGTGGTACGTC	CASSVRKWYV	TRBV5-4	TRBJ2-7
TGTGCCAGCAGCATCAGGGAGTATAGCAATCAGCCCCAGCATTTT	CASSIREYSNQPQHF	TRBV7-2	TRBJ1-5
TGTGCCAGCAGGCTCACAGGTTGTGGCTACACCTTC	CASRLTGCGYTF	TRBV28	TRBJ1-2
TGTGCCAGCAGTTACCAGGGAGCGGAGACCCAGTACTTC	CASSYQGAETQYF	TRBV6-5	TRBJ2-5
TGTGGGCCGGCGTTCTTAAAGAGCAATCAGCCCCAGCATTTT	CGPAFLKSNQPQHF	TRBV6-2	TRBJ1-5
TGTGCCAGCAGCGGGCGAGGGAGGGGAAACTATGGCTACACCTTC	CASSGRGRGNYGYTF	TRBV7-8	TRBJ1-2
TGTGCCAGCAGTTACTCTTCACAGGGGGATACGCAGTATTTT	CASSYSSQGDTQYF	TRBV6-6	TRBJ2-3
TGTGCCAGCAGCCAAGGGACAGGGGGAGGGACCCGTAACTATGGCTACACCTTC	CASSQGTGGGTRNYGYTF	TRBV4-2	TRBJ1-2
TGTGCCAGCAGCGTAAAGGACAGTCCGAACTATGGCTACACCTTC	CASSVKDSPNYGYTF	TRBV9	TRBJ1-2
TGTGCCAGCCTCTCTAGGACAGTAGAGACCCAGTACTTC	CASLSRTVETQYF	TRBV27	TRBJ2-5
TGTGCCAGCGCGGAACAGGTGAGGGTAGAGACCCAGTACTTC	CASAEQVRVETQYF	TRBV6-2	TRBJ2-5
TGTGCCAGCAGTGAATACCGAAACCGACTAGGATGTGCAGATACGCAGTATTTT	CASSEYRNRLGCADTQYF	TRBV25-1	TRBJ2-3
TGTGCCAGCACGAGGCGGTGGTGGACGCAGTATTTT	CASTRRWWTQYF	TRBV25-1	TRBJ2-3
TGTGCCAGCAGCTTAGGTTCCATAGTGACCTACGAGCAGTACTTC	CASSLGSIVTYEQYF	TRBV11-1	TRBJ2-7
TGTGCCAGCAGACTAGCGGGAGGAGTTAGCACAGATACGCAGTATTTT	CASRLAGGVSTDTQYF	TRBV7-3	TRBJ2-3
TGCAGCGTGGGGGATTCAGGATCCTACGAGCAGTACTTC	CSVGDSGSYEQYF	TRBV29-1	TRBJ2-7
TGTGCCAGCAGTTGCGGACTAGCGGGCAGGGCCTACAATGAGCAGTTCTTC	CASSCGLAGRAYNEQFF	TRBV28	TRBJ2-1
TGCGCCAGCAGCTCGCTGTCGACTAGCGGGAGCTCTGGAAACACCATATATTTT	CASSSLSTSGSSGNTIYF	TRBV5-1	TRBJ1-3
TGCGCCAGCAGCCAAGCTGAAGATACGCAGTATTTT	CASSQAEDTQYF	TRBV4-1	TRBJ2-3
TGTGCCAGCAGTTTATCCAAAGTATATCCCGGGACTAGCGGGAGTGGGTCCAACTCCTACGAGCAGTACTTC	CASSLSKVYPGTSGSGSNSYEQYF	TRBV27	TRBJ2-7
TGTGCCAGCAGCGTGGGGTACTACATACCCACCTCTGGAAACACCATATATTTT	CASSVGYYIPTSGNTIYF	TRBV11-2	TRBJ1-3
TGTGCCAGCAGGTCGACTAGCCGGATCGACCAGTACTTC	CASRSTSRIDQYF	TRBV16	TRBJ2-5
TGTGCTAGTGGTTTGGTAAAAACTAGCGGCAATGAGCAGTTCTTC	CASGLVKTSGNEQFF	TRBV12-5	TRBJ2-1
TGTGCCAGCAGTGGGACAGCAAAGGGGCTCTGGAGCTCCTATAATTCACCCCTCCACTTT	CASSGTAKGLWSSYNSPLHF	TRBV25-1	TRBJ1-6
TGTGCCTTCGACAGGGGAGTAGGCAGCAATCAGCCCCAGCATTTT	CAFDRGVGSNQPQHF	TRBV19	TRBJ1-5
TGTGCCAGCATCCCGGGACTAGTACATGAGCAGTTCTTC	CASIPGLVHEQFF	TRBV7-9	TRBJ2-1
TGTGCCAGCACCAATAGAGTGGGAGAGACCCAGTACTTC	CASTNRVGETQYF	TRBV7-2	TRBJ2-5
TGTGCCAGCAGCTTGGTGGTCTTTACTAGCGGGAGACTCGTCTCCTACGAGCAGTACTTC	CASSLVVFTSGRLVSYEQYF	TRBV5-6	TRBJ2-7
TGTGCCAGCAGCTTGGGATGTAGTCGGTACGAGCAGTACTTC	CASSLGCSRYEQYF	TRBV5-6	TRBJ2-7
TGCGCCAGCAGCTCCCCACACCCCGGTTCCGGGGGAACCGGGGAGCTGTTTTTT	CASSSPHPGSGGTGELFF	TRBV5-1	TRBJ2-2
TGTGCCACCAGCAGAGGCTCTCAGAGCAATCAGCCCCAGCATTTT	CATSRGSQSNQPQHF	TRBV15	TRBJ1-5
TGTGCCAGCAGCGGGTGTTCAGGGGGGCAGCCCCAGCATTTT	CASSGCSGGQPQHF	TRBV13	TRBJ1-5
TGTGCCAGCAGCCTGCTGCTTGTCGGGACCGGGGAGCTGTTTTTT	CASSLLLVGTGELFF	TRBV5-6	TRBJ2-2
TGTGCCAGCAGCGAGGCATCCCAAGAGACCCAGTACTTC	CASSEASQETQYF	TRBV9	TRBJ2-5
TGTGCCAGCAGCGTAGGGGGGCGGCAAGAGACCCAGTACTTC	CASSVGGRQETQYF	TRBV13	TRBJ2-5
TGTGCCACCACGGAGCGACTAGCGGGTCCCGAGCAGTACTTC	CATTERLAGPEQYF	TRBV24-1	TRBJ2-7
TGTGCCAGCAGTTATTGGAAGCGAGGACAAAGGACCCAGTACTTC	CASSYWKRGQRTQYF	TRBV6-9	TRBJ2-5
TGTGCCAGCAGCCCAACCCAAGCCAGAAAAGAGGGAGCTGGGGAGCTGTTTTTT	CASSPTQARKEGAGELFF	TRBV7-9	TRBJ2-2
TGTGCCAGCACTGACCTAAGCCTCGGTACAGGGTCCAATTCACCCCTCCACTTT	CASTDLSLGTGSNSPLHF	TRBV6-4	TRBJ1-6
TGTGCCAGCAGCGTCCCCCCAGCGAATGAGCAGTACTTC	CASSVPPANEQYF	TRBV7-9	TRBJ2-7
TGTGCCAGCAGTGGTGGGGGGTACGAGCAGTACTTC	CASSGGGYEQYF	TRBV6-1	TRBJ2-7
TGTGCCAGCAGCCCTCAGGGCTGGTTTAGAGAAAAACTGTTTTTT	CASSPQGWFREKLFF	TRBV7-3	TRBJ1-4
TGTGCCAGCAGTGAATGTTGGTGGGACAGTGCCTCTGGAAACACCATATATTTT	CASSECWWDSASGNTIYF	TRBV12-4	TRBJ1-3
TGTGCCAGCACCTTCCCGGAGCAGTACTTC	CASTFPEQYF	TRBV6-5	TRBJ2-7
TGCAGTGCTAGAGCGAAATCACCCTCAAGCTCCTATAATTCACCCCTCCACTTT	CSARAKSPSSSYNSPLHF	TRBV20-1	TRBJ1-6
TGCAGTGCTAGAGATTGGGCAGCCGGCTACACCTTC	CSARDWAAGYTF	TRBV20-1	TRBJ1-2
TGTGCCAGCAGCTTAAGACAGCGAGTTTCTGGCTACACCTTC	CASSLRQRVSGYTF	TRBV11-2	TRBJ1-2
TGTGCCAGTCTGACGAACGAGCAGTACTTC	CASLTNEQYF	TRBV2	TRBJ2-7
TGTGCCACCCCTCGACAGGGGGAAGGCTACACCTTC	CATPRQGEGYTF	TRBV24-1	TRBJ1-2
TGTGCCAGCAGTGAAGGGGGGAATGGCTACACCTTC	CASSEGGNGYTF	TRBV2	TRBJ1-2
TGCGCCAGCAGGGACCTTTACCTGAGGGTTAGGACGAATTCACCCCTCCACTTT	CASRDLYLRVRTNSPLHF	TRBV5-1	TRBJ1-6
TGTGCCGGGCCCGGGGCCCATAATCAGCCCCAGCATTTT	CAGPGAHNQPQHF	TRBV6-5	TRBJ1-5
TGTGCCAGCAGCTTAACCCCGGGACAGGGAATACGAGGCTACACCTTC	CASSLTPGQGIRGYTF	TRBV7-3	TRBJ1-2
TGCAGTAATTGGACTAGCGGGTCCTACGAGCAGTACTTC	CSNWTSGSYEQYF	TRBV20-1	TRBJ2-7
TGTGCCAGCAGCTTAACTAGCGGGCCACCAACCTACGAGCAGTACTTC	CASSLTSGPPTYEQYF	TRBV5-5	TRBJ2-7
TGCGCCAGCTACCTGGAAGAGCAGTTCTTC	CASYLEEQFF	TRBV10-1	TRBJ2-1
TGTGCCAGCATGGCAGGGGACTATAACCCCAATCAGCCCCAGCATTTT	CASMAGDYNPNQPQHF	TRBV14	TRBJ1-5
TGTGCCAGCAGCCGCCCCGAGGCCGGGACAGCGTGGGCCTACAATGAGCAGTTCTTC	CASSRPEAGTAWAYNEQFF	TRBV7-9	TRBJ2-1
TGTGCCAGCCGGCTGAGGGATGGAAACACCATATATTTT	CASRLRDGNTIYF	TRBV3-1	TRBJ1-3
TGTGCCAGCAGCCCCCAGATGACTAGCGGGAGAGGGGGGGTTAAAGTCATGAACACTGAAGCTTTCTTT	CASSPQMTSGRGGVKVMNTEAFF	TRBV7-2	TRBJ1-1
TGTGCCAGCAGCCAAGATTCAGGAAGGAAAGGGTACGAGCAGTACTTC	CASSQDSGRKGYEQYF	TRBV3-1	TRBJ2-7
TGTGCCAGCAGCGATTATTCGACTAGCGGGAGGAACACCGGGGAGCTGTTTTTT	CASSDYSTSGRNTGELFF	TRBV13	TRBJ2-2
TGTGCCGTAGCCTATCCAGGGGGCATTTATGGCTACACCTTC	CAVAYPGGIYGYTF	TRBV19	TRBJ1-2
TGCAGTGCTAAACTTCGGGGGCTGGAGCTGTTTTTT	CSAKLRGLELFF	TRBV20-1	TRBJ2-2
TGTGCCAGCAGCTTCCCTGCCCCAGGACGGAACACCGGGGAGCTGTTTTTT	CASSFPAPGRNTGELFF	TRBV5-6	TRBJ2-2
TGTGCCAGCAGCTTAATCAGGACTAGCGGGAGCGGGGGGTACAATGAGCAGTTCTTC	CASSLIRTSGSGGYNEQFF	TRBV7-9	TRBJ2-1
TGTGCCAGCAGCCACGCCGGGACAGGAGGAAGCATTCAGTACTTC	CASSHAGTGGSIQYF	TRBV3-1	TRBJ2-4
TGTGCCAGCAGTTCAGCGGGGCGGTTTGGAGAGACCCAGTACTTC	CASSSAGRFGETQYF	TRBV28	TRBJ2-5
TGCAGTGCTAGAGTAGGACACAATGAGCAGTTCTTC	CSARVGHNEQFF	TRBV20-1	TRBJ2-1
TGTGCCAGCAGCCAGCTACTAGCGGTCTACGAGCAGTACTTC	CASSQLLAVYEQYF	TRBV14	TRBJ2-7
TGCGCCAAACACAGGAAGCCCTACGAGCAGTACTTC	CAKHRKPYEQYF	TRBV5-1	TRBJ2-7
TGTGCCAGCATTCGGGGAGGGGAGACCCAGTACTTC	CASIRGGETQYF	TRBV7-2	TRBJ2-5
TGTGCCAGCATCCCCTCGGGTGGGGCCAACGTCCTGACTTTC	CASIPSGGANVLTF	TRBV6-1	TRBJ2-6
TGTGCCAGCAGCCCCCCCGCGGACTTTTCCGAGCAGTACTTC	CASSPPADFSEQYF	TRBV13	TRBJ2-7
TGTGCCAGCAGCCAAGATGGTACGAACAGGGCGTGTACCAACACTGAAGCTTTCTTT	CASSQDGTNRACTNTEAFF	TRBV14	TRBJ1-1
TGTGCCACCACCGGGGGCGGGAATACGCAGTATTTT	CATTGGGNTQYF	TRBV24-1	TRBJ2-3
TGCAGTGCTGATGTAACAGGGGGCTCCAAGTATGGCTACACCTTC	CSADVTGGSKYGYTF	TRBV20-1	TRBJ1-2
TGTGCCAGCTTCGGACTAGCGGGCTGGTTCAAGACGGGGTCCTACGAGCAGTACTTC	CASFGLAGWFKTGSYEQYF	TRBV9	TRBJ2-7
TGTGCCAGTAGTATACACAATGGGGAATGGGGCACAGATACGCAGTATTTT	CASSIHNGEWGTDTQYF	TRBV19	TRBJ2-3
TGTGCCAGCTCACCACATTCCCCGGGGTGTGGCGAGCAGTACTTC	CASSPHSPGCGEQYF	TRBV18	TRBJ2-7
TGCAGTGCTAGAAAATGGACCCATAGGGGGCTCTCCAAAGCTTTCTTT	CSARKWTHRGLSKAFF	TRBV20-1	TRBJ1-1
TGTGCCAGCAGCTTACGGACAGTAGAAGAGAACTTGATGGGCTACACCTTC	CASSLRTVEENLMGYTF	TRBV7-7	TRBJ1-2
TGCGCCAGCAGCTTGGAAACACGACAGGGCCTTCAGCCCCAGCATTTT	CASSLETRQGLQPQHF	TRBV5-1	TRBJ1-5
TGTGCCAGTAGGGCGGGAGTTGTGAACTATGGCTACACCTTC	CASRAGVVNYGYTF	TRBV19	TRBJ1-2
TGTGCCAGCAGCAGGCCCCGGGGGGAGAACTATGGCTACACCTTC	CASSRPRGENYGYTF	TRBV5-4	TRBJ1-2
TGTGCCAGCAGCGAGGTGGACACTAGCGGGAGGACCTATGGCTACACCTTC	CASSEVDTSGRTYGYTF	TRBV9	TRBJ1-2
TGTGCCAGCAGAACGGGGGACTCAGGCTACACCTTC	CASRTGDSGYTF	TRBV6-2	TRBJ1-2
TGTGCCAGCAGCCAAGATGCTAGCGGGAAGGCAACCGGGGAGCTGTTTTTT	CASSQDASGKATGELFF	TRBV3-1	TRBJ2-2
TGTGCCAGCAGTTTAAAGAGAGGGACAGGGCGATACGAGCAGTACTTC	CASSLKRGTGRYEQYF	TRBV12-4	TRBJ2-7
TGTGCCAGCAGTTTGGTGAGGGTTTCTACTGGCTACACCTTC	CASSLVRVSTGYTF	TRBV6-8	TRBJ1-2
TGTGCCAGCAGCGAGTTGTGGGGCATTGGGGGGAACACTGAAGCTTTCTTT	CASSELWGIGGNTEAFF	TRBV7-3	TRBJ1-1
TGTGCCAGTAGCTTCGGCACCGGGGAGCTGTTTTTT	CASSFGTGELFF	TRBV19	TRBJ2-2
TGCAGTGCTTACCGGACTAGTGAGACCCAGTACTTC	CSAYRTSETQYF	TRBV20-1	TRBJ2-5
TGTGCCAGCAGCCCGAGGGCCATGGATGGACAGAGAAGAAACACTGAAGCTTTCTTT	CASSPRAMDGQRRNTEAFF	TRBV4-2	TRBJ1-1
TGTGCTAGTGGTTTATGCGCTTCGGGGGACTCCTACGAGCAGTACTTC	CASGLCASGDSYEQYF	TRBV12-5	TRBJ2-7
TGTGCCCCTCACCCCCCAAGGACTCAAGAGACCCAGTACTTC	CAPHPPRTQETQYF	TRBV25-1	TRBJ2-5
TGCGCCAGCAGCCAAGTGGTAGATAGCTACGAGCAGTACTTC	CASSQVVDSYEQYF	TRBV4-1	TRBJ2-7
TGTGCCAGCAGTGACCCAGAAAAACTGTTTTTT	CASSDPEKLFF	TRBV25-1	TRBJ1-4
TGTGCCAGCAGCGGGAATTTCAGCAGGGGCTGTTTAACCCATCAGCCCCAGCATTTT	CASSGNFSRGCLTHQPQHF	TRBV13	TRBJ1-5
TGTGCCAGCAGTGGGTTCCAGGGGGACAGGCACCACACTGAAGCTTTCTTT	CASSGFQGDRHHTEAFF	TRBV7-3	TRBJ1-1
TGCGCCAGCAGCCAATTCGGACAGGGGGGCTTGGACGAGCAGTACTTC	CASSQFGQGGLDEQYF	TRBV4-1	TRBJ2-7
TGTGCCAAAGTGTTGGGGGCCAATCAGCCCCAGCATTTT	CAKVLGANQPQHF	TRBV2	TRBJ1-5
TGTGCCAGCAGCTTAGGACGGGGAGAGCAGTACTTC	CASSLGRGEQYF	TRBV7-3	TRBJ2-7
TGTGCCAGCAGCTCTGGTTCGAACACTGAAGCTTTCTTT	CASSSGSNTEAFF	TRBV7-3	TRBJ1-1
TGTGCCAGCAGCCAAGATCGAGAGATTGGACAGCCCTACGAGCAGTACTTC	CASSQDREIGQPYEQYF	TRBV3-1	TRBJ2-7
TGTGCCAGCAGAGCTAGCGGGTACGAGCAGTACTTC	CASRASGYEQYF	TRBV6-4	TRBJ2-7
TGTGCCAGCAGCCAAAGGCTCCGGGACAGTTGGGTGACCTACGAGCAGTACTTC	CASSQRLRDSWVTYEQYF	TRBV3-1	TRBJ2-7
TGTGCCCGGCGGAGGGGAGAGGAGCTGTTTTTT	CARRRGEELFF	TRBV9	TRBJ2-2
TGTGCCAGCTTCTTCCCCGGGACAGGGGGGACTCATAGCAATCAGCCCCAGCATTTT	CASFFPGTGGTHSNQPQHF	TRBV28	TRBJ1-5
TGTGCCAGCAGCCCCGCAACCAAGGGACAGGGGAAGGACGAGCAGTACTTC	CASSPATKGQGKDEQYF	TRBV3-1	TRBJ2-7
TGTGCCAGCAGGGTTCCCCCCACCCTGGGCAGTAGCAGGTTTTTAGGTAGCAATCAGCCCCAGCATTTT	CASRVPPTLGSSRFLGSNQPQHF	TRBV6-2	TRBJ1-5
TGTGCCAGCAGACGAAGGGGGACAGAGGGCGAGCAGTACTTC	CASRRRGTEGEQYF	TRBV12-4	TRBJ2-7
TGTGCCAGCAGCTTCACCCACGGGGACAGGGGAATATCAGCTTTCTTT	CASSFTHGDRGISAFF	TRBV7-9	TRBJ1-1
TGTGCCAGGGATAGGACGGACGGCCGACCCCTCCACTTT	CARDRTDGRPLHF	TRBV11-3	TRBJ1-6
TGTGCCAGCACCGCCGGACAGGGGCTTTCCCGCGAGCAGTACTTC	CASTAGQGLSREQYF	TRBV7-4	TRBJ2-7
TGTGCCACCAGCAGAGGAGGGTTTCAGAACACTGAAGCTTTCTTT	CATSRGGFQNTEAFF	TRBV15	TRBJ1-1
TGTGCCAGCAGTGACTCCGGGGGGGCGGTCGCTTTCTACGAGCAGTACTTC	CASSDSGGAVAFYEQYF	TRBV6-4	TRBJ2-7
TGTGCCAGCAGTTTCGCTAACTACGAGCAGTACTTC	CASSFANYEQYF	TRBV27	TRBJ2-7
TGTGCCACCAGCCGGGACAGTACCCCCCTGGACAGTAACACTGAAGCTTTCTTT	CATSRDSTPLDSNTEAFF	TRBV24-1	TRBJ1-1
TGTGCCAGCAGCCCGACTAGCCAAGAGACCCAGTACTTC	CASSPTSQETQYF	TRBV7-9	TRBJ2-5
TGCGCCAGCAGTCTTTGTGGACTAGCGGGGGGGGACACCGGGGAGCTGTTTTTT	CASSLCGLAGGDTGELFF	TRBV5-1	TRBJ2-2
TGTGCCAGCAGCTTACGGGACAGGGTTCGCGAAAAACTGTTTTTT	CASSLRDRVREKLFF	TRBV11-2	TRBJ1-4
TGTGCCAGCTTAGATAGGGTCGGAAACACCATATATTTT	CASLDRVGNTIYF	TRBV18	TRBJ1-3
TGCGCCAGCAGCTTGACGGGCAAGGGGACAGCGTCACCCCTCCACTTT	CASSLTGKGTASPLHF	TRBV5-1	TRBJ1-6
TGTGCCAGCAGTTCCAGACAGGTACGAATCGCTGGGGCCAACGTCCTGACTTTC	CASSSRQVRIAGANVLTF	TRBV6-4	TRBJ2-6
TGTGCCAGTAGTATAGGAGCCGGGACAGGGCCTTACGAGCAGTACTTC	CASSIGAGTGPYEQYF	TRBV19	TRBJ2-7
TGCGCCAGCAGCCAAGGCCATAAGACTGCGTCCTACGAGCAGTACTTC	CASSQGHKTASYEQYF	TRBV4-1	TRBJ2-7
TGTGCCAGCAGCGGGGGGTCCGGGACAGGGGTCCGTTTCTACACCGGGGAGCTGTTTTTT	CASSGGSGTGVRFYTGELFF	TRBV7-9	TRBJ2-2
TGTGCCAGCAGCAATAGACTAGCGGGGGACACAGATACGCAGTATTTT	CASSNRLAGDTDTQYF	TRBV11-3	TRBJ2-3
TGTGCCAGCAGTTTCCTGACAGGGGGAAACACCATATATTTT	CASSFLTGGNTIYF	TRBV12-3	TRBJ1-3
TGCAGTGCTGGACAGGGGTGGGGGAGCTACGAGCAGTACTTC	CSAGQGWGSYEQYF	TRBV20-1	TRBJ2-7
TGTGCCAGCAGTTTAGCAGGGGGGGGCTCTGGAAACACCATATATTTT	CASSLAGGGSGNTIYF	TRBV12-4	TRBJ1-3
TGTGCCAGTACCAGGGACAGAGGGAAGGGGGGGGATGGCTACACCTTC	CASTRDRGKGGDGYTF	TRBV19	TRBJ1-2
TGTGCCAGCAGCAATCGGGACACAGATACGCAGTATTTT	CASSNRDTDTQYF	TRBV7-2	TRBJ2-3
TGTGCCAGCAAGGACAGGAGCCGCAGAGCTGAAGCTTTCTTT	CASKDRSRRAEAFF	TRBV7-6	TRBJ1-1
TGTGCCAGCAGCCAAGAAACGACTAGCGGGGGGAGTCCCTACAATGAGCAGTTCTTC	CASSQETTSGGSPYNEQFF	TRBV3-1	TRBJ2-1
TGCAGCGGCTCAGGGCTATACAATGAGCAGTTCTTC	CSGSGLYNEQFF	TRBV29-1	TRBJ2-1
TGTGCCAGCAGTCTCGGGGCGTTTCCTTCTGAAGCTTTCTTT	CASSLGAFPSEAFF	TRBV27	TRBJ1-1
TGCAGTGCTAGAGTCTTAGGACTACTAGGCAAATCCTACAATGAGCAGTTCTTC	CSARVLGLLGKSYNEQFF	TRBV20-1	TRBJ2-1
TGTGCCAGCAGCGGTAGGGCAGTAGATACGCAGTATTTT	CASSGRAVDTQYF	TRBV9	TRBJ2-3
TGTGCCAGCCCGAACTTCGTGTCCCTCAATGAGCAGTTCTTC	CASPNFVSLNEQFF	TRBV28	TRBJ2-1
TGTGCCAGCAGTAGCCCACCCATCCTAAGCACCCCGAACCAGGAACCTAGCTACGAGCAGTACTTC	CASSSPPILSTPNQEPSYEQYF	TRBV2	TRBJ2-7
TGCAGTGCTCAGGGTTGGGTGGGGACCCGGGATGGCTACACCTTC	CSAQGWVGTRDGYTF	TRBV20-1	TRBJ1-2
TGCGCCAGCGGCTGTACAAACATTCAGTACTTC	CASGCTNIQYF	TRBV10-2	TRBJ2-4
TGTGCCACCAGTGTCCGGGGCGTCCTCTTC	CATSVRGVLF	TRBV24-1	TRBJ2-1
TGTGCCAAACGCTCTGGTGGTGAGCAGTTCTTC	CAKRSGGEQFF	TRBV3-1	TRBJ2-1
TGCGCCAGCATCAATATGGGACAAGGTGGCTACACCTTC	CASINMGQGGYTF	TRBV5-1	TRBJ1-2
TGTGCCAGCAGCTTAGGTGGCCCTACCAAAACAGATACGCAGTATTTT	CASSLGGPTKTDTQYF	TRBV7-9	TRBJ2-3
TGTGCCAGCAGTGACACCGGGACAGGGCGACCACTTGAAGCTTTCTTT	CASSDTGTGRPLEAFF	TRBV6-4	TRBJ1-1
TGTGCCATCGAATCCCGGGCAAAACTGTTTTTT	CAIESRAKLFF	TRBV10-3	TRBJ1-4
TGCGCCAGCAGCTACGGGGGGAGGTACTCTGAAGCTTTCTTT	CASSYGGRYSEAFF	TRBV5-1	TRBJ1-1
TGTGCCACCAGCCTTGAGGGGCCAGGCAATCAGCCCCAGCATTTT	CATSLEGPGNQPQHF	TRBV24-1	TRBJ1-5
TGTGCCTGGTGTCAAGAGACCCAGTACTTC	CAWCQETQYF	TRBV30	TRBJ2-5
TGCGCCAGCAGCTTGAAAACTTCAGAGGGAGATACGCAGTATTTT	CASSLKTSEGDTQYF	TRBV5-1	TRBJ2-3
TGCGCCAGCAGCCCTAGTCTTGGAGAGGTCTCCTACGAGCAGTACTTC	CASSPSLGEVSYEQYF	TRBV4-1	TRBJ2-7
TGCAGTGCTAGATCGTCCTCAGGAAAGCCCTACAATGAGCAGTTCTTC	CSARSSSGKPYNEQFF	TRBV20-1	TRBJ2-1
TGTGCCAGCAGACAGGGCGGTGGCTACACCTTC	CASRQGGGYTF	TRBV7-9	TRBJ1-2
TGTGCCAGCAGCCCAGCACGGGACATCGCGAACACTGAAGCTTTCTTT	CASSPARDIANTEAFF	TRBV7-2	TRBJ1-1
TGTGCCAGCAGCCAAGCCCCCCGGGACAAAGAGACCCAGTACTTC	CASSQAPRDKETQYF	TRBV14	TRBJ2-5
TGTGCCAGCAGCGCTGACAGGGGCTGGGGATGTCGCTCTGGAAACACCATATATTTT	CASSADRGWGCRSGNTIYF	TRBV9	TRBJ1-3
TGTGCCAGCAGCGTAGCGCTTGGATGGACAGGGAACGGCTACCCGGAGCTGTTTTTT	CASSVALGWTGNGYPELFF	TRBV9	TRBJ2-2
TGTGAGAAGGCCCGGGACAACCATGGCTACACCTTC	CEKARDNHGYTF	TRBV25-1	TRBJ1-2
TGTGCCAGCAGCTTAGAGGGGTGTTCCGACAGGGTCGCCAATTACGAGCAGTACTTC	CASSLEGCSDRVANYEQYF	TRBV11-3	TRBJ2-7
TGTGCCAGCAGTTACGCGGAGGTTTGGGAATGTGAAGCTTTCTTT	CASSYAEVWECEAFF	TRBV6-5	TRBJ1-1
TGTGCCAGCAGTCCCAGGGCTGGCTCTGAAGCTTTCTTT	CASSPRAGSEAFF	TRBV6-4	TRBJ1-1
TGTGCCAACTCGAGGCTCCAAGAGACCCAGTACTTC	CANSRLQETQYF	TRBV24-1	TRBJ2-5
TGTGCCAGCAGTTTACGGGCCGGGACAGAGGAGGCCGGGGAGCTGTTTTTT	CASSLRAGTEEAGELFF	TRBV28	TRBJ2-2
TGTAAGGAGCTCGAGGAACGGACCGGGCACAGGTCTGGAAACACCATATATTTT	CKELEERTGHRSGNTIYF	TRBV6-5	TRBJ1-3
TGTGCCAGCAGCACCCTCAGGTATCCTACTGAAGCTTTCTTT	CASSTLRYPTEAFF	TRBV11-3	TRBJ1-1
TGTGCCAGCAGCGGGGGGGGTAACTATGGCTACACCTTC	CASSGGGNYGYTF	TRBV7-6	TRBJ1-2
TGTGCCAGCAGTGAAAAAGATGAAAAACTGTTTTTT	CASSEKDEKLFF	TRBV6-1	TRBJ1-4
