TGTGCCTGGATACGAGCAGGGGGGCTTTTTACAGATACGCAGTATTTT	CAWIRAGGLFTDTQYF	TRBV30	TRBJ2-3
TGTGCCGCCCCCCGAAGGGGAACTGCTAATACTAATGAAAAACTGTTTTTT	CAAPRRGTANTNEKLFF	TRBV28	TRBJ1-4
TGTGCCACCAGAAACCGGGGGGCCGCCCCCGCCAAAAACATTCAGTACTTC	CATRNRGAAPAKNIQYF	TRBV24-1	TRBJ2-4
TGTGCCAGCAGCGACGCAGGGGGCCCAACTAATGAAAAACTGTTTTTT	CASSDAGGPTNEKLFF	TRBV7-9	TRBJ1-4
TGTGCCAGCAGCGAATCGAGGCTCTCTGGAAACACCATATATTTT	CASSESRLSGNTIYF	TRBV13	TRBJ1-3
TGTGCCAGCAGTTCACAGGGGCGGACTGAAGCTTTCTTT	CASSSQGRTEAFF	TRBV12-4	TRBJ1-1
TGTGCCAGCAGGGGGTTACAGGGGGGGAGCAATCAGCCCCAGCATTTT	CASRGLQGGSNQPQHF	TRBV6-2	TRBJ1-5
TGCGCCAGCAGATGTCCGAGGGGGGAGACCCAGTACTTC	CASRCPRGETQYF	TRBV10-1	TRBJ2-5
TGTGCCAGCAGCGTAGCCGCGGGAAGAGAGACCCAGTACTTC	CASSVAAGRETQYF	TRBV9	TRBJ2-5
TGTGCCAGCAGCGTAAAAGGGACCGTTAACCCCTACGAGCAGTACTTC	CASSVKGTVNPYEQYF	TRBV9	TRBJ2-7
TGTGCCACCAGTGATTTTCCGGTCGACAGGGGGCCCAAAGCTTCACCCCTCCACTTT	CATSDFPVDRGPKASPLHF	TRBV24-1	TRBJ1-6
TGTGCCAGCAGCCAAGAACTAAGCGCCCGGTACACCGGGGAGCTGTTTTTT	CASSQELSARYTGELFF	TRBV3-1	TRBJ2-2
TGTGCCAGCAGCTTCCCCAATTACACAGGCTACACCTTC	CASSFPNYTGYTF	TRBV7-4	TRBJ1-2
TGTGCCGGATACAATGGGACTACCGCCGAAAATTCACCCCTCCACTTT	CAGYNGTTAENSPLHF	TRBV5-5	TRBJ1-6
TGTGCCACCAGCAGAGCGTGTTCCGTAGGCTACGAGCAGTACTTC	CATSRACSVGYEQYF	TRBV15	TRBJ2-7
TGTGCCAGTAGTATAATCAGACTAGGACTAACCAGCTCCTACAATGAGCAGTTCTTC	CASSIIRLGLTSSYNEQFF	TRBV19	TRBJ2-1
TGTGCCAGCAGTTTTGGACTAGCGGGAAAGCAGTACTTC	CASSFGLAGKQYF	TRBV27	TRBJ2-7
TGTGCCAGCAGCCAAGCCACGATCAGGACGAGGGTTAGGGAAGCCTATGGCTACACCTTC	CASSQATIRTRVREAYGYTF	TRBV4-2	TRBJ1-2
TGTGCCAGTCCCGACAGGGCGCAACAACAGCCCCAGCATTTT	CASPDRAQQQPQHF	TRBV19	TRBJ1-5
TGTGCCAGCAGCCTGCGGGCCCCTGGAAACACCATATATTTT	CASSLRAPGNTIYF	TRBV11-3	TRBJ1-3
TGTGCTAGTGGTTTGGTGGAAAAGGGTAGTTTTAGCAATCAGCCCCAGCATTTT	CASGLVEKGSFSNQPQHF	TRBV12-5	TRBJ1-5
TGTGCCACCAGCTCGCCCTACGAGCAGTACTTC	CATSSPYEQYF	TRBV24-1	TRBJ2-7
TGCATTACGACAGGGGTATACACTGAAGCTTTCTTT	CITTGVYTEAFF	TRBV20-1	TRBJ1-1
TGTGCCAGCAGCTTAAGGGGGCGGTCTAACTATGGCTACACCTTC	CASSLRGRSNYGYTF	TRBV7-3	TRBJ1-2
TGTGCCAGGGGGGGGGGAGGAAACACCATATATTTT	CARGGGGNTIYF	TRBV6-1	TRBJ1-3
TGTGCTAGTGGAGGCAGGGCTAACTATGGCTACACCTTC	CASGGRANYGYTF	TRBV12-5	TRBJ1-2
TGTGCCAGCAGCGGGGGCCGCATTCCGCATGGCTACACCTTC	CASSGGRIPHGYTF	TRBV7-3	TRBJ1-2
TGTGCCAGCAGCTTAGCCCAGGGCACTGAAGCTTTCTTT	CASSLAQGTEAFF	TRBV7-7	TRBJ1-1
TGTGCCAGCAGTTATTTTCGTAGGGAGAAGTTTAGTTGTGGGAGCACAGATACGCAGTATTTT	CASSYFRREKFSCGSTDTQYF	TRBV6-5	TRBJ2-3
TGTGCTAGTGGCCGGAGGGGGGTGCTGTTTTTT	CASGRRGVLFF	TRBV12-5	TRBJ1-4
TGTGCCAGCAGCTTACCCACCGACAGGGGCTACACCTTC	CASSLPTDRGYTF	TRBV7-3	TRBJ1-2
TGTGCCAGCAGTGAAACCGGGGGAGGGAACACTGAAGCTTTCTTT	CASSETGGGNTEAFF	TRBV6-4	TRBJ1-1
TGCAGTGTAGGGGGAGGTCTCCTCGGAGCTAACTATGGCTACACCTTC	CSVGGGLLGANYGYTF	TRBV20-1	TRBJ1-2
TGTGCCAGCAGTTTTCCCCGCGGGAGTTCCTACGAGCAGTACTTC	CASSFPRGSSYEQYF	TRBV12-4	TRBJ2-7
TGTGCCAGCAGCTATCCGGACGCCCTTCACAATGAGCAGTTCTTC	CASSYPDALHNEQFF	TRBV7-4	TRBJ2-1
TGTGCCAGCCTTGGACAGGGCGTGCACGAGCAGTACTTC	CASLGQGVHEQYF	TRBV7-3	TRBJ2-7
TGTGCCAGCAGTTACAGGGGGGAACCCAATCAGCCCCAGCATTTT	CASSYRGEPNQPQHF	TRBV6-5	TRBJ1-5
TGTGCCACCAGTGGGTCCCACCGGGACATGATCTCCTACGAGCAGTACTTC	CATSGSHRDMISYEQYF	TRBV24-1	TRBJ2-7
TGTGCCACCAGTGAGGGCTGGAGGGGAGTAGAGACCCAGTACTTC	CATSEGWRGVETQYF	TRBV24-1	TRBJ2-5
TGCAGTCCCCCGCGGGGCTCCTACGAGCAGTACTTC	CSPPRGSYEQYF	TRBV20-1	TRBJ2-7
TGTGCCTGGAGTGTACGGCCCGGGGAACGGGATGACTATGGCTACACCTTC	CAWSVRPGERDDYGYTF	TRBV30	TRBJ1-2
TGTGCCAGTAGTATTGTGAAGGGTACACAAGAGACCCAGTACTTC	CASSIVKGTQETQYF	TRBV19	TRBJ2-5
TGTGCCAGCAGCTTGGACACCCGGGGGGAGGTCCTAGACTACACTGAAGCTTTCTTT	CASSLDTRGEVLDYTEAFF	TRBV5-6	TRBJ1-1
TGTGCCAGGAAAAACGGACTTGTCCGGAACTATGGCTACACCTTC	CARKNGLVRNYGYTF	TRBV19	TRBJ1-2
TGCGCCAGCAGTACTAGCCGGGACAGACAGCCCCAGCATTTT	CASSTSRDRQPQHF	TRBV10-2	TRBJ1-5
TGTGCCACCAGCAGTGTATTTAGGATTTCCGCAGATCGACATCAGCCCCAGCATTTT	CATSSVFRISADRHQPQHF	TRBV15	TRBJ1-5
TGTGCCAGCGGCCCCGGGGTGGGAAGGGAGACCCAGTACTTC	CASGPGVGRETQYF	TRBV6-4	TRBJ2-5
TGTGCCAGCAGTGGCGGGAGGCCGGTGCCCCAGCATTTT	CASSGGRPVPQHF	TRBV6-2	TRBJ1-5
TGTGCCAGCAGCGTAGCCGGAAGGGCGCGGGGGAGGGCCTACGAGCAGTACTTC	CASSVAGRARGRAYEQYF	TRBV9	TRBJ2-7
TGTGCCAGCAGCCAAGAGCTAGCGGGCAACACAGATACGCAGTATTTT	CASSQELAGNTDTQYF	TRBV7-2	TRBJ2-3
TGTGCCAGCAGCTTCGTTAGGTTTCAGCCCCAGCATTTT	CASSFVRFQPQHF	TRBV7-9	TRBJ1-5
TGTGCCAGCACCCGGGACAGGGGTACATGGGCTGAAGCTTTCTTT	CASTRDRGTWAEAFF	TRBV6-1	TRBJ1-1
TGTGCTAGCAGCTTCTCCAGAGGGGAAGAGACCCAGTACTTC	CASSFSRGEETQYF	TRBV7-7	TRBJ2-5
TGCGCCAGCAGCTCCCAGAGGGGGGGCTACGAGCAGTACTTC	CASSSQRGGYEQYF	TRBV5-1	TRBJ2-7
TGTGCCAGCGAAGGGACAGCCTACGAGCAGTACTTC	CASEGTAYEQYF	TRBV6-4	TRBJ2-7
TGTGCCAGCAGTTACTCGGGTGCAAGCAAGGTCGAGCAGTACTTC	CASSYSGASKVEQYF	TRBV6-2	TRBJ2-7
TGTGCCAGCAGAACCGGGACTAGCGGGCGAAATGAGCAGTTCTTC	CASRTGTSGRNEQFF	TRBV6-1	TRBJ2-1
TGCAGCGTTGAGCACATCAGGGCAGGCGAGCAGTACTTC	CSVEHIRAGEQYF	TRBV29-1	TRBJ2-7
TGTGCCATTCAAGAGGGACAGGAGCCCCAGCATTTT	CAIQEGQEPQHF	TRBV13	TRBJ1-5
TGCGCCAGCAGCTTGTATGGGAAGATGGATAGCAATCAGCCCCAGCATTTT	CASSLYGKMDSNQPQHF	TRBV5-1	TRBJ1-5
TGCGCCAGCAGCTTGGGGACGATAGACGGGGGAACTGAAGCTTTCTTT	CASSLGTIDGGTEAFF	TRBV5-1	TRBJ1-1
TGTGCCAGCAGCTTTTCGGGGGCTATGTGGGATACTGAAGCTTTCTTT	CASSFSGAMWDTEAFF	TRBV11-3	TRBJ1-1
TGTGCCATCGGCGTTGACAGGCCGGGGGGCACAGATACGCAGTATTTT	CAIGVDRPGGTDTQYF	TRBV10-3	TRBJ2-3
TGCAGCGTTGAGAGAGGACGGGGTCCCCGAGATTCACCCCTCCACTTT	CSVERGRGPRDSPLHF	TRBV29-1	TRBJ1-6
TGTGCCAGCAGTGGGCCGGGTGGAAGGAGAGCGCAGTATTTT	CASSGPGGRRAQYF	TRBV2	TRBJ2-3
TGCGCCAGCAGCACTTACAGGGGGGGGTTCTCTGGGGCCAACGTCCTGACTTTC	CASSTYRGGFSGANVLTF	TRBV5-1	TRBJ2-6
TGTGCCAGCACGAGGAGGGGGATTGTGTCTGGAAACACCATATATTTT	CASTRRGIVSGNTIYF	TRBV27	TRBJ1-3
TGTGCCAGCAGCTTGAGACAAAAGAACAATGAGCAGTTCTTC	CASSLRQKNNEQFF	TRBV7-9	TRBJ2-1
TGTGCCAGCAGTGAAGTTGAAGATACGCAGTATTTT	CASSEVEDTQYF	TRBV28	TRBJ2-3
TGTGCCACCAACCAGGTCCTTCAGCCCCAGCATTTT	CATNQVLQPQHF	TRBV24-1	TRBJ1-5
TGTGCCAGCAGTTTCGACGAAAAGAGGGTGGAGGCCTACGAGCAGTACTTC	CASSFDEKRVEAYEQYF	TRBV12-4	TRBJ2-7
TGTGCCAGCAGCTTAGATCCAGAATCCATTTACTCCTACGAGCAGTACTTC	CASSLDPESIYSYEQYF	TRBV11-2	TRBJ2-7
TGTGCCAGCAGCGCGGGGCGGGGACTAGCGGGCTACGAGCAGTACTTC	CASSAGRGLAGYEQYF	TRBV7-3	TRBJ2-7
TGTGCCAGCAGCCCGGGAGGGAGGGCAACTGAAGCTTTCTTT	CASSPGGRATEAFF	TRBV13	TRBJ1-1
TGTGCCAGCAGCTCAAACGGGAAGACGAGTAGCAATCAGCCCCAGCATTTT	CASSSNGKTSSNQPQHF	TRBV7-9	TRBJ1-5
TGCAGTGCTCCCATTGAGTATTTT	CSAPIEYF	TRBV20-1	TRBJ2-3
TGTGCCAGCAGCCAAATCCCGGGACAGCAGCCCCAGCATTTT	CASSQIPGQQPQHF	TRBV14	TRBJ1-5
TGTGTATGGACTAGCGGGTGTGGCTACAATGAGCAGTTCTTC	CVWTSGCGYNEQFF	TRBV2	TRBJ2-1
TGTGCCAGCAGCAGGGATATCGGGACAGGTACTACTATGAACACTGAAGCTTTCTTT	CASSRDIGTGTTMNTEAFF	TRBV7-3	TRBJ1-1
TGTGCCAGTAGTATTCCACTGGCCGGGACACCTAACGAGCAGTACTTC	CASSIPLAGTPNEQYF	TRBV19	TRBJ2-7
TGTGCCAGGAATCAGGCTCTCTCTGGAAACACCATATATTTT	CARNQALSGNTIYF	TRBV27	TRBJ1-3
TGTGCCAGTAGTATAACGCCTTTCCCTAGCGGGAATTACAATGAGCAGTTCTTC	CASSITPFPSGNYNEQFF	TRBV19	TRBJ2-1
TGTGCCAGCAGTGGCCGGACTAGCCTCAGCAATGAGCAGTTCTTC	CASSGRTSLSNEQFF	TRBV28	TRBJ2-1
TGTGCCAGCAGCCCGGGACGGGCTAATTACGAGCAGTACTTC	CASSPGRANYEQYF	TRBV9	TRBJ2-7
TGTGCCATCCTGCTAGTCGAGCAGTACTTC	CAILLVEQYF	TRBV6-5	TRBJ2-7
TGTGCCAGCACGGGAATTTTCAGACCCGGGACTAGCGGGAGCCAAGAGACCCAGTACTTC	CASTGIFRPGTSGSQETQYF	TRBV6-5	TRBJ2-5
TGTGCCAGCAGTCCGGGACTCTGGCTTAGATCTAGCGGGGTAGAGGAGACCCAGTACTTC	CASSPGLWLRSSGVEETQYF	TRBV12-3	TRBJ2-5
TGTGCCAGCAGCGGAAGGGATCCCGCACCACTGGGCTACACCTTC	CASSGRDPAPLGYTF	TRBV5-6	TRBJ1-2
TGTGCCAGCTCACCAGGGACCCGGGACCCTGGGAAAACCTACGAGCAGTACTTC	CASSPGTRDPGKTYEQYF	TRBV18	TRBJ2-7
TGTGCCATGGGGGTGGCCCCCCCTCGACAGGTGGAAAGCAATCAGCCCCAGCATTTT	CAMGVAPPRQVESNQPQHF	TRBV5-4	TRBJ1-5
TGTGCCATCACCCTGCAGGAAAGGAATGAAAAACTGTTTTTT	CAITLQERNEKLFF	TRBV10-3	TRBJ1-4
TGTGCCAGCAGTTGTTCCCCTTTATGGCGGGGTTCCTCCTATAATTCACCCCTCCACTTT	CASSCSPLWRGSSYNSPLHF	TRBV6-9	TRBJ1-6
TGTGCCAGCTCACCATGTGACAGTAATTCACCCCTCCACTTT	CASSPCDSNSPLHF	TRBV18	TRBJ1-6
TGTGCCAGTAAGCCTACAGGGATTCCGGAAAATCAGCCCCAGCATTTT	CASKPTGIPENQPQHF	TRBV19	TRBJ1-5
TGCGCCAGCAGCTTGTGCAGGAAGGAGCCCCAGCATTTT	CASSLCRKEPQHF	TRBV5-1	TRBJ1-5
TGTGCCAGTAGTATGCTAGTTGGTGGGGATTCCAGACCAGATACGCAGTATTTT	CASSMLVGGDSRPDTQYF	TRBV19	TRBJ2-3
TGTGCCAGCAGTGAACCGGGACAGGGGGGCTATAATTCACCCCTCCACTTT	CASSEPGQGGYNSPLHF	TRBV6-1	TRBJ1-6
TGTGCCAGCAGCCCGGGGGCTTACTATGGCTACACCTTC	CASSPGAYYGYTF	TRBV14	TRBJ1-2
TGTGCCAGCAGCCAAGAGCGCTATCCCGGGACTAGGCACCCGACCCAGTACTTC	CASSQERYPGTRHPTQYF	TRBV7-9	TRBJ2-5
TGTGCCAGCAGGAAGGGGGGCACAGATACGCAGTATTTT	CASRKGGTDTQYF	TRBV6-5	TRBJ2-3
TGCGCCAGCAGCTTGGAGCTGGGGGCGGGTCGGTACTACAATGAGCAGTTCTTC	CASSLELGAGRYYNEQFF	TRBV5-1	TRBJ2-1
TGTGCCAGCAGCTTGACAGGGGGTCGCGAGCAGTTCTTC	CASSLTGGREQFF	TRBV6-2	TRBJ2-1
TGTGCCAGTAACGCCGGCACAGATACGCAGTATTTT	CASNAGTDTQYF	TRBV19	TRBJ2-3
TGTGCCGACCCTAGCAAGACAGATACGCAGTATTTT	CADPSKTDTQYF	TRBV6-4	TRBJ2-3
TGTGCCAGCAGCCAGGAATGGGGGGGAAACACTGAAGCTTTCTTT	CASSQEWGGNTEAFF	TRBV7-3	TRBJ1-1
TGTGCCAGCTCACCGATAGTAGACGGGGAAACAAATGAGCAGTTCTTC	CASSPIVDGETNEQFF	TRBV18	TRBJ2-1
TGTGATGAATTGTTATGGGAGGGTGGTCCTGAAACCCATCAGCCCCAGCATTTT	CDELLWEGGPETHQPQHF	TRBV7-3	TRBJ1-5
TGTGCCAGCAGCCAAGAGCTAACTCCACGGGGTAGCAATCAGCCCCAGCATTTT	CASSQELTPRGSNQPQHF	TRBV14	TRBJ1-5
TGTGCCAGCAGCCAAGTAGCGGGTTCGTTCGGCAATGAGCAGTTCTTC	CASSQVAGSFGNEQFF	TRBV14	TRBJ2-1
TGTGCCAGCAGCGAAACCGGGACTACGACCTACAATGAGCAGTTCTTC	CASSETGTTTYNEQFF	TRBV13	TRBJ2-1
TGTGCCAGCAGTGAAGGCGGGACAGGGGCCTACGAGCAGTACTTC	CASSEGGTGAYEQYF	TRBV6-1	TRBJ2-7
TGTGCCAGCAGGTCAGGCGGCACCGGGGAGCTGTTTTTT	CASRSGGTGELFF	TRBV12-3	TRBJ2-2
TGTGCCATGCCACTACAGGGTCAGCCCCAGCATTTT	CAMPLQGQPQHF	TRBV11-3	TRBJ1-5
TGTGCCACCAGTGATTTAACGAGGGGGCGCGCCTCCTACGAGCAGTACTTC	CATSDLTRGRASYEQYF	TRBV24-1	TRBJ2-7
TGTGCCAGCAGGACAGGGGGGTTTAGGACCGCTGAGACCCAGTACTTC	CASRTGGFRTAETQYF	TRBV28	TRBJ2-5
TGTGCCAGCAGCGCGGCGGTAAGTCCCCAGCATTTT	CASSAAVSPQHF	TRBV7-3	TRBJ1-5
TGTGCCAGCAGCTTACAACCATCCAGGACTAGTATGGACTCTCCAGTGACAGATACGCAGTATTTT	CASSLQPSRTSMDSPVTDTQYF	TRBV7-3	TRBJ2-3
TGTGCCAGCAGTACCCCAGATTTTGAAGCTTTCTTT	CASSTPDFEAFF	TRBV5-6	TRBJ1-1
TGTGCCAGCAGTGACACAAATTCACCCCTCCACTTT	CASSDTNSPLHF	TRBV6-8	TRBJ1-6
TGTGCCAGCCTCGCAGGCATGAACACTGAAGCTTTCTTT	CASLAGMNTEAFF	TRBV11-3	TRBJ1-1
TGTGCCAGCAGTTTATGTGTAGCGGGGAACAATGAGCAGTTCTTC	CASSLCVAGNNEQFF	TRBV28	TRBJ2-1
TGTGCCAGCAGCACTATCCTAGTCCAAGCGGGAAACTACAATGAGCAGTTCTTC	CASSTILVQAGNYNEQFF	TRBV13	TRBJ2-1
TGTGCCAGCAGAACTGGGGTGTTGGAGTTTGAAGCTTTCTTT	CASRTGVLEFEAFF	TRBV7-2	TRBJ1-1
TGTGCCAGCAGCTGGGTCGATAATGAAAAACTGTTTTTT	CASSWVDNEKLFF	TRBV5-5	TRBJ1-4
TGTGCCAGCAGCTCAGAGGGAGGGGAAACCACTGAAGCTTTCTTT	CASSSEGGETTEAFF	TRBV7-9	TRBJ1-1
TGTGCCAGCTGTCGACAGCCCCACGAGCAGTACTTC	CASCRQPHEQYF	TRBV2	TRBJ2-7
TGTGCCAGCAGGGGCCGGAACGATACGCAGTATTTT	CASRGRNDTQYF	TRBV28	TRBJ2-3
TGTGCCAGCAGCTTGCCGGAAGGACAGGGGGGGCGAGAGACCCAGTACTTC	CASSLPEGQGGRETQYF	TRBV5-4	TRBJ2-5
TGTGCCAGCAGTCAGGAGCAGTACTTC	CASSQEQYF	TRBV12-3	TRBJ2-7
TGTGCCAGCAGCTTGTCTAGGGGAGAACGCTACGAGCAGTACTTC	CASSLSRGERYEQYF	TRBV5-6	TRBJ2-7
TGTGCCAGCAGCTTAGACCTTCAGAACCTGGAGCACTATGGCTACACCTTC	CASSLDLQNLEHYGYTF	TRBV7-2	TRBJ1-2
TGTGCCAGCAGCTTGGGAAAGGTAGGTCCCTACGAGCAGTACTTC	CASSLGKVGPYEQYF	TRBV7-3	TRBJ2-7
TGTGCCAGCAGCTTGTTTTTCAGGGCTAATCAGCCCCAGCATTTT	CASSLFFRANQPQHF	TRBV7-3	TRBJ1-5
TGTGCCAAAGGACAGGCCCGTGGAAACACCATATATTTT	CAKGQARGNTIYF	TRBV24-1	TRBJ1-3
TGTGCCACCAGTGAGGCGGGCCTTCCAGATACGCAGTATTTT	CATSEAGLPDTQYF	TRBV24-1	TRBJ2-3
TGTGCCATCATCCGCCCTTACAATGAGCAGTTCTTC	CAIIRPYNEQFF	TRBV10-3	TRBJ2-1
TGTGCCAGCAGCGCAAAGAACACTGAAGCTTTCTTT	CASSAKNTEAFF	TRBV7-4	TRBJ1-1
TGCAGCGGTATAGATAAGGAGACCCAGTACTTC	CSGIDKETQYF	TRBV29-1	TRBJ2-5
TGTGCCAGTAGGGGGGGCTCTGGAGGACACAATGAGCAGTTCTTC	CASRGGSGGHNEQFF	TRBV19	TRBJ2-1
TGTGCCAGCAGCGAGGGGGGGACAGTGACTTGGGGATCCACCGGGGAGCTGTTTTTT	CASSEGGTVTWGSTGELFF	TRBV7-3	TRBJ2-2
TGTGCCAGCAGCTCTTTAGCGGGAGCAGATACGCAGTATTTT	CASSSLAGADTQYF	TRBV7-2	TRBJ2-3
TGCAGCGGCCTATTACAACCTGATTCACCCCTCCACTTT	CSGLLQPDSPLHF	TRBV29-1	TRBJ1-6
TGTGCCAGCAGCGGGACAGGGCACTACGAGCAGTACTTC	CASSGTGHYEQYF	TRBV13	TRBJ2-7
TGTGCCAGCAGGTTACTAGAGAACGATACGCAGTATTTT	CASRLLENDTQYF	TRBV12-4	TRBJ2-3
TGTGCCAGCCTCAGGGGAAACGAGCAGTACTTC	CASLRGNEQYF	TRBV9	TRBJ2-7
TGTGCCAGCAGCTTCACAAAAGAGACCAGCTCCTACAATGAGCAGTTCTTC	CASSFTKETSSYNEQFF	TRBV13	TRBJ2-1
TGTGCCAGCAGCTTCTATGAGGGACAGGGGTCTGGACCCAAAAACATTCAGTACTTC	CASSFYEGQGSGPKNIQYF	TRBV7-9	TRBJ2-4
TGTGCCAGCAGCAAAAGACAGGACACCGGGGAGCTGTTTTTT	CASSKRQDTGELFF	TRBV7-9	TRBJ2-2
TGCGCCAGCAGTGGGTGGGGGGTTTTCTACGAGCAGTACTTC	CASSGWGVFYEQYF	TRBV10-1	TRBJ2-7
TGTGCCTGGAGTGATCTAAGGGGGGGGACCTTAAATGAGCAGTTCTTC	CAWSDLRGGTLNEQFF	TRBV30	TRBJ2-1
TGCGCCAGCACGCTGACCCTGGGACAGGGGTCCTACGAGCAGTACTTC	CASTLTLGQGSYEQYF	TRBV5-1	TRBJ2-7
TGTGCCACGCCTGCAGGGGCGCAAGAGACCCAGTACTTC	CATPAGAQETQYF	TRBV24-1	TRBJ2-5
TGTGCCGATCACGGGAGGGTTCACGAGCAGTACTTC	CADHGRVHEQYF	TRBV25-1	TRBJ2-7
TGTGCCAGCAGCCAAGATGGCTGTTTAGGCTACACCTTC	CASSQDGCLGYTF	TRBV14	TRBJ1-2
TGTGCCAGCAGCCTACCTTGGTCCGGGGGCCGTAACTATGGCTACACCTTC	CASSLPWSGGRNYGYTF	TRBV7-8	TRBJ1-2
TGCGCCAGCAGTAGGAGATGGGCTTTCTTT	CASSRRWAFF	TRBV10-1	TRBJ1-1
TGTGCCTGGAGGTTACCTACAGGGGAGACCCAGTACTTC	CAWRLPTGETQYF	TRBV30	TRBJ2-5
TGTGCCAGCAGCCCGACAGGGGGAGGAAACACCATATATTTT	CASSPTGGGNTIYF	TRBV11-2	TRBJ1-3
TGTGCCAGCAGCTTTCTCCCAGGGGCCGCCTACGAGCAGTACTTC	CASSFLPGAAYEQYF	TRBV7-3	TRBJ2-7
TGTGCCAGCAGCATGGGGGAGACTGGGATGGGGTTACCAACGGACTATGGCTACACCTTC	CASSMGETGMGLPTDYGYTF	TRBV7-2	TRBJ1-2
TGTGCCAGCAGTTTTCAGGGTAATGAAAAACTGTTTTTT	CASSFQGNEKLFF	TRBV27	TRBJ1-4
TGTGCCACCAGTGCTCGGGGGGTCAGCTCCTACGAGCAGTACTTC	CATSARGVSSYEQYF	TRBV24-1	TRBJ2-7
TGTGCCAGCAGCTCCGGGACAGGGCCCTCTGTGGGGTCTGGGGCCAACGTCCTGACTTTC	CASSSGTGPSVGSGANVLTF	TRBV7-4	TRBJ2-6
TGTGCCAGCAGTGTCCATATAGGGACAGGGCCCTATGGCTACACCTTC	CASSVHIGTGPYGYTF	TRBV25-1	TRBJ1-2
TGCAGCGTTGAAGAACTGAGGGAGCAGTACTTC	CSVEELREQYF	TRBV29-1	TRBJ2-7
TGTGCCAGCACAGGGGCGGATACGCTAGCCAAAAACATTCAGTACTTC	CASTGADTLAKNIQYF	TRBV2	TRBJ2-4
TGCGCCAGCAGGGAGCCCACCGAGCATACGCAGTATTTT	CASREPTEHTQYF	TRBV10-1	TRBJ2-3
TGTGCCCCCGGCGGGGGTGACTACGAGCAGTACTTC	CAPGGGDYEQYF	TRBV24-1	TRBJ2-7
TGCGCCAGCAGCTTCAGACTAGCGGGGGAACCTAATTACAATGAGCAGTTCTTC	CASSFRLAGEPNYNEQFF	TRBV5-1	TRBJ2-1
TGTGCCAGCAGCCAAGATGTTGAAGAGGGGGGCTACGAGCAGTACTTC	CASSQDVEEGGYEQYF	TRBV4-2	TRBJ2-7
TGTGCCAGCAGAGGCGGGGACAGGGGTTATTGGTTTGAAGCTTTCTTT	CASRGGDRGYWFEAFF	TRBV6-5	TRBJ1-1
TGTGCCAGCAGTTTAGTAAGGGACAGGGGACACACTGAAGCTTTCTTT	CASSLVRDRGHTEAFF	TRBV27	TRBJ1-1
TGTGCCAGCAGCGGGACCGCGGCCTACGAGCAGTACTTC	CASSGTAAYEQYF	TRBV9	TRBJ2-7
TGTGCCAGCAGCCTTTCTCCGGGACGGGGGGTGCTGGATCAGCCCCAGCATTTT	CASSLSPGRGVLDQPQHF	TRBV13	TRBJ1-5
TGTGCCAGCGAAGGGAGCTACGAGCAGTACTTC	CASEGSYEQYF	TRBV7-3	TRBJ2-7
TGTGCCAGCAGCGTAGGGGGTAACGGGGGGGCAACCTACGAGCAGTACTTC	CASSVGGNGGATYEQYF	TRBV9	TRBJ2-7
TGTGCCAGTAGTCAGGGTGAAGCTTTCTTT	CASSQGEAFF	TRBV19	TRBJ1-1
TGTGCTAGTTTATGGACAGTTAATGAAAAACTGTTTTTT	CASLWTVNEKLFF	TRBV12-5	TRBJ1-4
TGTGCCAGCAGCCGGAGCACAGATACGCAGTATTTT	CASSRSTDTQYF	TRBV3-1	TRBJ2-3
TGTGCCACCAGTGATCTGGTTCCGGGGGGCCCCAGCAATGAGCAGTTCTTC	CATSDLVPGGPSNEQFF	TRBV24-1	TRBJ2-1
TGCAGCGTGGGCGGACAGTCGACGGACACTGAAGCTTTCTTT	CSVGGQSTDTEAFF	TRBV29-1	TRBJ1-1
TGTGCCAGCAGTGAAGGGAGACAGGAGGCAGCGGGCGGGGAGCTGTTTTTT	CASSEGRQEAAGGELFF	TRBV2	TRBJ2-2
TGTGCCAGCAGCCCCCGGCAGGCAAGTGGCTACACCTTC	CASSPRQASGYTF	TRBV6-5	TRBJ1-2
TGTGCCAGTATCCCAAGTAGGGGGCGGGCTGGAAACACCATATATTTT	CASIPSRGRAGNTIYF	TRBV19	TRBJ1-3
TGCGCCAGCAGTGAAGTGGCCAGAACCACAGATACGCAGTATTTT	CASSEVARTTDTQYF	TRBV10-1	TRBJ2-3
TGTGCCAGCAGCCTAGCGGGACACAATGAGCAGTTCTTC	CASSLAGHNEQFF	TRBV7-9	TRBJ2-1
TGTGCCAGCAGCAGAAGGATCAGACCCCGAACCAAAAACATTCAGTACTTC	CASSRRIRPRTKNIQYF	TRBV7-6	TRBJ2-4
TGCGCCAGCAGCTGTCTGAGACCTGAGACCCAGTACTTC	CASSCLRPETQYF	TRBV5-1	TRBJ2-5
TGTGCCAGCTGGGGGGGGGGGGCCGGATCTGAGACCCAGTACTTC	CASWGGGAGSETQYF	TRBV6-6	TRBJ2-5
TGTGCCAGCAGCTTGGGCAAGATACCGGGACAGGGCGGACCTAATGAAAAACTGTTTTTT	CASSLGKIPGQGGPNEKLFF	TRBV5-6	TRBJ1-4
TGTGCCAGCAGCCCACTCGATCGTCCGCAAGAGACCCAGTACTTC	CASSPLDRPQETQYF	TRBV9	TRBJ2-5
TGTGCCAGCAGCTTAGTCATCAACCGTTGCGGGGTGGGCTACAATGAGCAGTTCTTC	CASSLVINRCGVGYNEQFF	TRBV7-6	TRBJ2-1
TGCAGTGCTAGAGATGAAGTCCCGACAGGGTATATCTACGAGCAGTACTTC	CSARDEVPTGYIYEQYF	TRBV20-1	TRBJ2-7
TGTGCCAGCAGCGTGGGGACTAGCACCGGGGAGCTGTTTTTT	CASSVGTSTGELFF	TRBV9	TRBJ2-2
TGCGCCAGCAACCCTGTCCTCCGGAGCGGGAAGGGGGGTAATGAAAAACTGTTTTTT	CASNPVLRSGKGGNEKLFF	TRBV10-2	TRBJ1-4
TGTGCCAGCAGTCCGACTAGCGGGAGAGTGGGCTACACCTTC	CASSPTSGRVGYTF	TRBV5-4	TRBJ1-2
TGTGCCAGTAGGGGGGCCGGAGAGAACACCGGGGAGCTGTTTTTT	CASRGAGENTGELFF	TRBV19	TRBJ2-2
TGTGCCAGCAGTTACTGGGGGCCGGGACTAGCGGGGGGGCCCGGGGAGCTGTTTTTT	CASSYWGPGLAGGPGELFF	TRBV6-5	TRBJ2-2
TGTGCCAGCAGCCGAACCACCCACATGAACACTGAAGCTTTCTTT	CASSRTTHMNTEAFF	TRBV28	TRBJ1-1
TGTGCCAGCAGCTGGGGGACAGCCTACGAGCAGTACTTC	CASSWGTAYEQYF	TRBV9	TRBJ2-7
TGCAGCGTTCCCCAGGGGGGCGCCGGCTACACCTTC	CSVPQGGAGYTF	TRBV29-1	TRBJ1-2
TGCAGCGTTGAAGCTGGTAGCCACAGGGGGGCGGGGGGTGGAAACACCATATATTTT	CSVEAGSHRGAGGGNTIYF	TRBV29-1	TRBJ1-3
TGTGCCAGCAGCCCGGGGCCGAACACCGGGGAGCTGTTTTTT	CASSPGPNTGELFF	TRBV7-9	TRBJ2-2
TGTGCCAGCAGGGGGAACGAGCAGTACTTC	CASRGNEQYF	TRBV6-1	TRBJ2-7
TGTGCCAGCAGTTATACGACAGGGGGAAACACCATATATTTT	CASSYTTGGNTIYF	TRBV6-3	TRBJ1-3
TGCGCCACCACAGGGCGCAATCAGCCCCAGCATTTT	CATTGRNQPQHF	TRBV10-2	TRBJ1-5
TGTGCCAGCAGTTTATCTTCCGGGACCGCCTACGAGCAGTACTTC	CASSLSSGTAYEQYF	TRBV27	TRBJ2-7
TGTGCCAGCAGCGTAGGCCCATTCTCAGGTTATGAAAAACTGTTTTTT	CASSVGPFSGYEKLFF	TRBV9	TRBJ1-4
TGTGCCAGCAGCAGTTCGGGACAGTACGTCCGTGAGCAGTTCTTC	CASSSSGQYVREQFF	TRBV7-7	TRBJ2-1
TGTGCCAGCAGCCAAGAATCCCACGACCGATTCCTGGAGGCTTTCTTT	CASSQESHDRFLEAFF	TRBV4-2	TRBJ1-1
TGTGCCAGCAGCTTAGCCCCTGGACAGGGGTACAATGAGCAGTTCTTC	CASSLAPGQGYNEQFF	TRBV7-9	TRBJ2-1
TGTGCCAGCAGCTGGCTTAAGACAGGGGGCGGGACGTGGAACACTGAAGCTTTCTTT	CASSWLKTGGGTWNTEAFF	TRBV7-3	TRBJ1-1
TGTGCCAGCAGTTGGAATCAAGCGGGATTGGCCTCTGGAAACACCATATATTTT	CASSWNQAGLASGNTIYF	TRBV6-5	TRBJ1-3
TGTGCCTTTTATTTCTACAATGAGCAGTTCTTC	CAFYFYNEQFF	TRBV7-2	TRBJ2-1
TGTGCCAGCAAAAGAAAGAATCCCACAGGGGGAGGCTATGGCTACACCTTC	CASKRKNPTGGGYGYTF	TRBV6-1	TRBJ1-2
TGTGCTAGTGGTACAAACCTCCGTGGACAGGGGGGACACACTGAAGCTTTCTTT	CASGTNLRGQGGHTEAFF	TRBV12-5	TRBJ1-1
TGCGCCAGCAGCATCGCCCGGGGGACAGCGAGCAATCAGCCCCAGCATTTT	CASSIARGTASNQPQHF	TRBV4-3	TRBJ1-5
TGTGCCAGCAGCCAAGGGGGGGCGTCGGAGCCGGGTTTATTCACCGGGGAGCTGTTTTTT	CASSQGGASEPGLFTGELFF	TRBV3-1	TRBJ2-2
TGCAGTGCTAGAGATATCAAGTCACCCCTCCACTTT	CSARDIKSPLHF	TRBV20-1	TRBJ1-6
TGTGCCAGCAGCAGCAAAGTCGGGGGGCAGGACTATAATTCACCCCTCCACTTT	CASSSKVGGQDYNSPLHF	TRBV7-2	TRBJ1-6
TGTGCCAGCAGCAAGGGACACTATAAACCGTACTTC	CASSKGHYKPYF	TRBV5-4	TRBJ2-7
TGTGCCAGCAGCCGCGGGGGGGGATCGCATCAGCCCCAGCATTTT	CASSRGGGSHQPQHF	TRBV7-3	TRBJ1-5
TGTGCCAGTAGTCCCCCGGGAGTCACAGATACGCAGTATTTT	CASSPPGVTDTQYF	TRBV19	TRBJ2-3
TGCGCCAGCACGGGTCCTAGCGGGGAATTTGCCTACAATGAGCAGTTCTTC	CASTGPSGEFAYNEQFF	TRBV5-1	TRBJ2-1
TGTGCCAGGGTCGTTGGAATAGCGGGGAAGAACACCGGGGAGCTGTTTTTT	CARVVGIAGKNTGELFF	TRBV2	TRBJ2-2
TGTGCCAGTAGTATCCAGGACGGGGCCCATCAGCCCCAGCATTTT	CASSIQDGAHQPQHF	TRBV19	TRBJ1-5
TGCAGTGCTAGAGGGCCTCCGGGACAGGGAACTGGAAACACCATATATTTT	CSARGPPGQGTGNTIYF	TRBV20-1	TRBJ1-3
TGTGCCAGCAGCCACGACAGGGGGCCTAACGAGCAGTACTTC	CASSHDRGPNEQYF	TRBV7-3	TRBJ2-7
TGTGCCAGCAGTGACTCGACCCCGGGACTAGGCCTCTACGAGCAGTACTTC	CASSDSTPGLGLYEQYF	TRBV6-4	TRBJ2-7
TGTGCCAGCAGTTTGCCCACCCCACGGGATACTGAAGCTTTCTTT	CASSLPTPRDTEAFF	TRBV28	TRBJ1-1
TGCGCCAGCAGCTTGTACAGGGGGAGTTGGATGGAAGTTACCCACGAGCAGTACTTC	CASSLYRGSWMEVTHEQYF	TRBV5-1	TRBJ2-7
TGTGCCTGGATTATTCTGGACAGGGGCACCGGGGAGCTGTTTTTT	CAWIILDRGTGELFF	TRBV30	TRBJ2-2
TGTGCCAGCAGTTACATGCGGGAGGGGAACCGCTACGAGCAGTACTTC	CASSYMREGNRYEQYF	TRBV6-2	TRBJ2-7
TGTGCCAGCACACTGAAGCCCCAGCATTTT	CASTLKPQHF	TRBV12-4	TRBJ1-5
TGTGCCAGCATAGAGGGGGGAAGTAATGAGCAGTTCTTC	CASIEGGSNEQFF	TRBV7-8	TRBJ2-1
TGTGCCAGCAGCATCCCCTGGGCAACTAGCGGGAGAAGTACTGGAAACACCATATATTTT	CASSIPWATSGRSTGNTIYF	TRBV28	TRBJ1-3
TGTGCCAGCACCCGGGACACGCATCCCCAAGAGACCCAGTACTTC	CASTRDTHPQETQYF	TRBV7-9	TRBJ2-5
TGTGCCAGCAGCCGCCCGGGGGGCAGGGGAGACAATGAGCAGTTCTTC	CASSRPGGRGDNEQFF	TRBV3-1	TRBJ2-1
TGTGCCAGCAGTGACTCACAGGACTATGGCTACACCTTC	CASSDSQDYGYTF	TRBV6-4	TRBJ1-2
TGTGCCAGCAGCTTAGTCAGGGGACCGGAGTATAATTCACCCCTCCACTTT	CASSLVRGPEYNSPLHF	TRBV11-3	TRBJ1-6
TGTGCCAGCAGCCTAATCACTCCGCCCCAGGGGCCCAATCAGCCCCAGCATTTT	CASSLITPPQGPNQPQHF	TRBV13	TRBJ1-5
TGTGGGGGGATTACCGGGACAGGGAAGTTTAGCTACAATGAGCAGTTCTTC	CGGITGTGKFSYNEQFF	TRBV28	TRBJ2-1
TGTGCCAGCAGCTTGACCAGGGGGAAGGGAAACTATGGCTACACCTTC	CASSLTRGKGNYGYTF	TRBV5-4	TRBJ1-2
TGCGCCAGCAGCCCCCCAACCGGGACAGGCCCACGCACAGATACGCAGTATTTT	CASSPPTGTGPRTDTQYF	TRBV5-1	TRBJ2-3
TGTGCCAGTAGTAAGAAGACAGATGATCAGCCCCAGCATTTT	CASSKKTDDQPQHF	TRBV19	TRBJ1-5
TGTGCCAGCAGTGACTCGCATCCCGGGAATACAAACTATGGCTACACCTTC	CASSDSHPGNTNYGYTF	TRBV6-4	TRBJ1-2
TGTGCCAGCAGCCTAACCCCGGAAAGCTCCTACAATGAGCAGTTCTTC	CASSLTPESSYNEQFF	TRBV13	TRBJ2-1
TGTGCCAGCAGTGATTCCATCGGGACAGCGGGACGCTCCTACGAGCAGTACTTC	CASSDSIGTAGRSYEQYF	TRBV6-1	TRBJ2-7
TGTGCCAGCCCCGCTAGCGGCTACGAGCAGTACTTC	CASPASGYEQYF	TRBV13	TRBJ2-7
TGTGCCAGCAGCGGACTAGCGGGGAACAATGAGCAGTTCTTC	CASSGLAGNNEQFF	TRBV6-5	TRBJ2-1
TGCGCCAGCAGCGAGTGGACAGGGTTAATCTCTGGGGCCAACGTCCTGACTTTC	CASSEWTGLISGANVLTF	TRBV5-1	TRBJ2-6
TGTGCCAGCAGTGACAATAGCGGGGGCTACGAGCAGTACTTC	CASSDNSGGYEQYF	TRBV25-1	TRBJ2-7
TGTGCCAGCAGCTCCTCGGGACATCACGAGACCCAGTACTTC	CASSSSGHHETQYF	TRBV11-2	TRBJ2-5
TGTGCCAGCAGCAGAACCGGGCCGAGAAACAATTCACCCCTCCACTTT	CASSRTGPRNNSPLHF	TRBV5-5	TRBJ1-6
TGTGCCAGCAGCCAAGATACTCCGGGTGGACTCGAGCAGTACTTC	CASSQDTPGGLEQYF	TRBV4-2	TRBJ2-7
TGTGCCATAAATGAGACCCAGTACTTC	CAINETQYF	TRBV10-3	TRBJ2-5
TGCGCCAGCAGCTACCTTCGGCTAGCCTACGAGCAGTACTTC	CASSYLRLAYEQYF	TRBV5-1	TRBJ2-7
TGTGCCACCAGTGTCGTCGGGATACTAGGGGCCAAAAACATTCAGTACTTC	CATSVVGILGAKNIQYF	TRBV24-1	TRBJ2-4
TGCAGTGCTAGAAGGGGAGCGGGACGCGCTGATAGAGGGTATAGCAATCAGCCCCAGCATTTT	CSARRGAGRADRGYSNQPQHF	TRBV20-1	TRBJ1-5
TGTGCTCCGGGGGAAACATACGAGCAGTACTTC	CAPGETYEQYF	TRBV15	TRBJ2-7
TGTGCCAGCAGAGGACTAGCGGATAGGTCGGAGACCCAGTACTTC	CASRGLADRSETQYF	TRBV12-3	TRBJ2-5
TGCAGTGCTAGAGAAGGACGTTACGACGAGCAGTACTTC	CSAREGRYDEQYF	TRBV20-1	TRBJ2-7
TGCGCCAGCAGGGTGGACCCCTTTGAGCAGTACTTC	CASRVDPFEQYF	TRBV10-1	TRBJ2-7
TGTGCCAGCAGCGCAGAGGGGGGGCATGGCTCCTACGAGCAGTACTTC	CASSAEGGHGSYEQYF	TRBV7-9	TRBJ2-7
TGTGCCAGCAGCTTAGTTGGGGTTAATGGCTCACCCCTCCACTTT	CASSLVGVNGSPLHF	TRBV7-2	TRBJ1-6
TGCGCCAGCAGGGCCGGCGAGACCCAGTACTTC	CASRAGETQYF	TRBV10-1	TRBJ2-5
TGTGCCAGCAGCAACTCTTACCTGAACACCGGGGAGCTGTTTTTT	CASSNSYLNTGELFF	TRBV7-3	TRBJ2-2
TGTGCCAGCATCAGTATCGCAGCGGAGGGCAATCAGCCCCAGCATTTT	CASISIAAEGNQPQHF	TRBV27	TRBJ1-5
TGTGCCAAACCCAGGGGGCATTCTGGAAACACCATATATTTT	CAKPRGHSGNTIYF	TRBV6-6	TRBJ1-3
TGTGCCAGCAGCAAACCCCACGGACAGGGGGCCTACGAGCAGTACTTC	CASSKPHGQGAYEQYF	TRBV13	TRBJ2-7
TGTGCCAGCAGCCTAAGGGTGGTCTCCTACGAGCAGTACTTC	CASSLRVVSYEQYF	TRBV25-1	TRBJ2-7
TGTGCCAGCAGTCCAGGCCGGCCGGGACAGATACAGGCTAATGAAAAACTGTTTTTT	CASSPGRPGQIQANEKLFF	TRBV6-2	TRBJ1-4
TGTGCCAGCAGCTTCCGCAAGCACAGGGGAAGTTCAGGGTACGAGCAGTACTTC	CASSFRKHRGSSGYEQYF	TRBV11-3	TRBJ2-7
TGTGCCAGCAGTGCCCCCTTAAGCGCCAAAAACATTCAGTACTTC	CASSAPLSAKNIQYF	TRBV27	TRBJ2-4
TGTGCCTACCGAGCCGGGACAGGGGGCGGCTACGAGCAGTACTTC	CAYRAGTGGGYEQYF	TRBV11-3	TRBJ2-7
TGCAGTGCGTTCGGGACAGGGGGACCAAATGGCTACACCTTC	CSAFGTGGPNGYTF	TRBV20-1	TRBJ1-2
TGTGCCAGCAGCTGCATTTTCCCCCTGGCCCAAGAGACCCAGTACTTC	CASSCIFPLAQETQYF	TRBV7-3	TRBJ2-5
TGCGCCAGCAGCCAAGTTCGGGGGCTTTATGCTTCCTACGAGCAGTACTTC	CASSQVRGLYASYEQYF	TRBV4-1	TRBJ2-7
TGCGCCAGCAGCTTGCGTACGAGGGCGGTCTTC	CASSLRTRAVF	TRBV5-1	TRBJ2-1
TGTGCCAGCAGCTTGGCATTGGGACACTTC	CASSLALGHF	TRBV5-4	TRBJ2-7
TGCAGCGTGCTTCTAGGCCACAGGAGCTCCTACGAGCAGTACTTC	CSVLLGHRSSYEQYF	TRBV29-1	TRBJ2-7
TGTGCCATCAGTGAGTCGGACCTCCCGGGACGGAACACTGAAGCTTTCTTT	CAISESDLPGRNTEAFF	TRBV10-3	TRBJ1-1
TGTGCCAGCAGTGACATTGACGCGGTGACAGATACGCAGTATTTT	CASSDIDAVTDTQYF	TRBV6-4	TRBJ2-3
TGCGCCAGCACAATTAAGGGAGGGGCTATGACTGAAGCTTTCTTT	CASTIKGGAMTEAFF	TRBV10-1	TRBJ1-1
TGTGCCAGTAGTTCGGGACATGGACAGGTGAGTGACTATGGCTACACCTTC	CASSSGHGQVSDYGYTF	TRBV19	TRBJ1-2
TGTGCCAGCAGCTCGTGGGGCTATGGCTACACCTTC	CASSSWGYGYTF	TRBV7-3	TRBJ1-2
TGTGCCACCAGTGACCAGGATTTACTAGCGGGAGTGATTGCCTACGAGCAGTACTTC	CATSDQDLLAGVIAYEQYF	TRBV24-1	TRBJ2-7
TGTGCCAGCAGCCGGTACATCGGGGTCGAGCAGTACTTC	CASSRYIGVEQYF	TRBV9	TRBJ2-7
TGTGCCAGCAGCACCCCCGGGAAGAGGAGTACTACGCAGTATTTT	CASSTPGKRSTTQYF	TRBV5-6	TRBJ2-3
TGTGCCACCAGTGATATGGACTTAGCGAGAGCCAAAAACATTCAGTACTTC	CATSDMDLARAKNIQYF	TRBV24-1	TRBJ2-4
TGTGCCAGCAGCTTTCAGAAAACTCCGTGCTGGGGAATAGAGACCCAGTACTTC	CASSFQKTPCWGIETQYF	TRBV7-9	TRBJ2-5
TGCGCCAGTCAACAGGGACGGAAATATAGCAATCAGCCCCAGCATTTT	CASQQGRKYSNQPQHF	TRBV5-1	TRBJ1-5
TGTGCCAGCAGCCAAGCCAGCCTTCCCCGACGAATTTGCTACACCTTC	CASSQASLPRRICYTF	TRBV4-2	TRBJ1-2
TGTGCACAGTGGTCGGGGGGCCTTCAGGCCAACGTCCTGACTTTC	CAQWSGGLQANVLTF	TRBV6-4	TRBJ2-6
TGTGCCAGCAGTTACGGGACAGGGCAAGAAAAACTGTTTTTT	CASSYGTGQEKLFF	TRBV6-5	TRBJ1-4
TGTGCCAGCAGTGACCGGGACAAGTTGAAAGAGACCCAGTACTTC	CASSDRDKLKETQYF	TRBV6-1	TRBJ2-5
TGTGCCAGCAGCGGGGGCGACAGGGGGCCTACCAGTTACAATGAGCAGTTCTTC	CASSGGDRGPTSYNEQFF	TRBV9	TRBJ2-1
TGTGCCAGCGGACAGTGTCCGTCGCAGCCCCAGCATTTT	CASGQCPSQPQHF	TRBV27	TRBJ1-5
TGTGCCAGCATAGATGCATACGAGCAGTACTTC	CASIDAYEQYF	TRBV28	TRBJ2-7
TGCAGTGCTAGCAAACTAGTAAATTGGGGCACAGATACGCAGTATTTT	CSASKLVNWGTDTQYF	TRBV20-1	TRBJ2-3
TGTGCCAGCAGCGTAGCCGGGAGCAATCAGCCCCAGCATTTT	CASSVAGSNQPQHF	TRBV9	TRBJ1-5
TGTGGGGGACAGGTGACTGAAGCTTTCTTT	CGGQVTEAFF	TRBV6-5	TRBJ1-1
TGTGCCAGCAGTTGTATATGCTTTGAAGAGCAGTACTTC	CASSCICFEEQYF	TRBV27	TRBJ2-7
TGTGCCAGCAGCTGGCTACAGGGTCCGTATGAGACCCAGTACTTC	CASSWLQGPYETQYF	TRBV7-2	TRBJ2-5
TGTGCCACCAGCAGAGCTAGGAAAGTTGAGCAGTACTTC	CATSRARKVEQYF	TRBV15	TRBJ2-7
TGTGCCAGCAGCCCCCCGGACCCCCGGCTTGGCCCATACGAGCAGTACTTC	CASSPPDPRLGPYEQYF	TRBV13	TRBJ2-7
TGCGCCAGCAGCCGGCCTCGACAGGATCACGAGCAGTACTTC	CASSRPRQDHEQYF	TRBV4-1	TRBJ2-7
TGTGCCAGCAGTTGCGCGGACAGGGACAATGAGCAGTTCTTC	CASSCADRDNEQFF	TRBV6-2	TRBJ2-1
TGTGCCAGCAGCCCTGGGGGGTTGATTTCACCCCTCCACTTT	CASSPGGLISPLHF	TRBV9	TRBJ1-6
TGTGCCAGCAGCACCGACTCACCGGGACAGGAAGTAGGGACTGAGCAGTTCTTC	CASSTDSPGQEVGTEQFF	TRBV7-2	TRBJ2-1
TGTGCCAGCAGGCAGGGGGGACCACGGACCCAGTACTTC	CASRQGGPRTQYF	TRBV2	TRBJ2-5
TGTGCCAGCAGCGGTCCCCAGGACAGGGAAGAGACCCAGTACTTC	CASSGPQDREETQYF	TRBV11-2	TRBJ2-5
TGTGCCACCAGCCTTGAGGGGGCCGGGGCCCTACCTAGCACAGATACGCAGTATTTT	CATSLEGAGALPSTDTQYF	TRBV24-1	TRBJ2-3
TGTGCCAGCAGGTCGCGGCCAGCGGGTGAAGCTTTCTTT	CASRSRPAGEAFF	TRBV27	TRBJ1-1
TGCAGTGCTAGAGTGGATCCCCACAGGGTTCATCAGCCCCAGCATTTT	CSARVDPHRVHQPQHF	TRBV20-1	TRBJ1-5
TGTGCCAGCAGTCACCCGGGGGCACAGAGTGAAAAACTGTTTTTT	CASSHPGAQSEKLFF	TRBV27	TRBJ1-4
TGTGCCAGCAGTTCCCCGGGACCCACCTATGGCTACACCTTC	CASSSPGPTYGYTF	TRBV2	TRBJ1-2
TGTGCCTGGAGTGGGGGGGTCAGAGACACCGGGGAGCTGTTTTTT	CAWSGGVRDTGELFF	TRBV30	TRBJ2-2
TGCGCCAGCAGCTGGTTGGCCTACAATGAGCAGTTCTTC	CASSWLAYNEQFF	TRBV5-1	TRBJ2-1
TGTGCCAGCAGCTTGCCCCGGGGAACTAGCACAGATACGCAGTATTTT	CASSLPRGTSTDTQYF	TRBV5-6	TRBJ2-3
TGCAGTGCTAGTCGACCGGGCATCAGGGAGGCTTCCTACAATGAGCAGTTCTTC	CSASRPGIREASYNEQFF	TRBV20-1	TRBJ2-1
TGTGCCAGCAGCACACTAAGATCTACGAACACCATATATTTT	CASSTLRSTNTIYF	TRBV11-3	TRBJ1-3
TGTGCCAGTAGTAATGGGAAGGGGGGGAACTATGGGAGCAATCAGCCCCAGCATTTT	CASSNGKGGNYGSNQPQHF	TRBV19	TRBJ1-5
TGTGCCAGCCCGTTGTGGACGGGAAACACCATATATTTT	CASPLWTGNTIYF	TRBV19	TRBJ1-3
TGTGCCAGCAGCGGGCCCATCCTGAACACTGAAGCTTTCTTT	CASSGPILNTEAFF	TRBV3-1	TRBJ1-1
TGTGCCAGCAGCTTCCTTCCACCAGAAAGTCAGCCCCAGCATTTT	CASSFLPPESQPQHF	TRBV7-4	TRBJ1-5
TGTGCCAGCAGCCGTCTTGACAAAGATACGCAGTATTTT	CASSRLDKDTQYF	TRBV11-3	TRBJ2-3
TGCGCCAGCAGCCCAGCACCTCCGGCCTCCTACGAGCAGTACTTC	CASSPAPPASYEQYF	TRBV10-1	TRBJ2-7
TGTGCCAGCAGACCTAGGCCCTCCGATCTCAACTATGGCTACACCTTC	CASRPRPSDLNYGYTF	TRBV2	TRBJ1-2
TGCAGTGCTGTTTTAAGAAAGCCCCAGCATTTT	CSAVLRKPQHF	TRBV20-1	TRBJ1-5
TGTGCCAGTACAGGGACCATCAATCAGCCCCAGCATTTT	CASTGTINQPQHF	TRBV28	TRBJ1-5
TGCGCCAGGCGAAGTCGCTCATATAGCAATCAGCCCCAGCATTTT	CARRSRSYSNQPQHF	TRBV5-1	TRBJ1-5
TGTGCCAGCATCGAGGACACTAACTATGGCTACACCTTC	CASIEDTNYGYTF	TRBV2	TRBJ1-2
TGTGCCAGCAGATTACCGCCAGAAGTCCGCTCCTACGAGCAGTACTTC	CASRLPPEVRSYEQYF	TRBV7-8	TRBJ2-7
TGTGCCAGCAGTCCCTCTTACTCGAACTACGAGCAGTACTTC	CASSPSYSNYEQYF	TRBV6-5	TRBJ2-7
TGCGGAATTTACCCTCCGGGACGGAGGTACTACGAGCAGTACTTC	CGIYPPGRRYYEQYF	TRBV10-1	TRBJ2-7
TGCAGTGCTTCCCCCGGTGGCAAGGGGGCGGGTAACACTGAAGCTTTCTTT	CSASPGGKGAGNTEAFF	TRBV20-1	TRBJ1-1
TGTGCCAGCAGCCAACCGTTTCCCATCTCTGGAGCTCATAGCAATCAGCCCCAGCATTTT	CASSQPFPISGAHSNQPQHF	TRBV14	TRBJ1-5
TGTGCCACCAGCAGGAACCTAGCTCCAGGGTGTCCCTATGGCTACACCTTC	CATSRNLAPGCPYGYTF	TRBV15	TRBJ1-2
TGTGCCACCAGTGATTTGCACGAACTTCCAAACAGGGGGACTGGAAACACCATATATTTT	CATSDLHELPNRGTGNTIYF	TRBV24-1	TRBJ1-3
TGCGCCAGGCGTAGCCATTCCGTCAAACTTAATGAGCAGTTCTTC	CARRSHSVKLNEQFF	TRBV5-1	TRBJ2-1
TGTGCCAGCAAACGACTTTCACCCCTCCACTTT	CASKRLSPLHF	TRBV6-2	TRBJ1-6
TGTGCCAGCAGCTTCCTCGGGGATGCCGGGGAGCTGTTTTTT	CASSFLGDAGELFF	TRBV11-2	TRBJ2-2
TGCGCCAGCAGAGGGTGGGGGGAGAGCAATGAGCAGTTCTTC	CASRGWGESNEQFF	TRBV10-1	TRBJ2-1
TGTGCCAGCAGGGGACGAGCGGGGAGGGGCAATCAGCCCCAGCATTTT	CASRGRAGRGNQPQHF	TRBV13	TRBJ1-5
TGTGCCAGCAGCAAGGCGGAACTAGCTTTCTTT	CASSKAELAFF	TRBV13	TRBJ1-1
TGTGCCAGCAGGTCAGGGGACGAGCAGTACTTC	CASRSGDEQYF	TRBV6-1	TRBJ2-7
TGTGCCAGCAGCCACGACGGGACTAGTAGTTGCTCCTACAATGAGCAGTTCTTC	CASSHDGTSSCSYNEQFF	TRBV7-3	TRBJ2-1
TGTGCCAGCAAATACAGGGTTGGTAATCAGCCCCAGCATTTT	CASKYRVGNQPQHF	TRBV11-3	TRBJ1-5
TGTGCCAGCAGCCAAGATTTCAGGGGGGACTACGAGCAGTACTTC	CASSQDFRGDYEQYF	TRBV14	TRBJ2-7
TGTGCCAGCAACCCGACTAGCGGGACGTTAGGGGGCACAGATACGCAGTATTTT	CASNPTSGTLGGTDTQYF	TRBV28	TRBJ2-3
TGTGCCAGCAGTGTCCGACCCAGGGGGGGGAATGAAAAACTGTTTTTT	CASSVRPRGGNEKLFF	TRBV2	TRBJ1-4
TGTGCCAGCAGTTGCCTACGCACGGAATCTGGAAACACCATATATTTT	CASSCLRTESGNTIYF	TRBV6-2	TRBJ1-3
TGTGCCAGCAGTTACAAATACGGAGCCTTGAACACCGGGGAGCTGTTTTTT	CASSYKYGALNTGELFF	TRBV6-5	TRBJ2-2
TGTGCCTGGAGTCCCACAGCCACGACTATAGATGAAAAACTGTTTTTT	CAWSPTATTIDEKLFF	TRBV30	TRBJ1-4
TGTGCCACCAGTGAAGCTTACTGGGGGGGAGAGGAGACAGATACGCAGTATTTT	CATSEAYWGGEETDTQYF	TRBV24-1	TRBJ2-3
TGTGCCAGCAGTTACTTTACCGAGCCTAACTATGGCTACACCTTC	CASSYFTEPNYGYTF	TRBV6-5	TRBJ1-2
TGTGCCAGCAGCTATCCTGGGGGCTGGGAGCTAGCCAAAAACATTCAGTACTTC	CASSYPGGWELAKNIQYF	TRBV11-3	TRBJ2-4
TGTGCCAGCCGGGCCAAACAGGCTATGAACACTGAAGCTTTCTTT	CASRAKQAMNTEAFF	TRBV6-5	TRBJ1-1
TGTGCCAGCAGCTTGGGGACAGGGGCACCCGGGAGGATACGTGAGTCGAACACTGAAGCTTTCTTT	CASSLGTGAPGRIRESNTEAFF	TRBV5-6	TRBJ1-1
TGCGCCAGCACCACAGGGGCCGGCTATGGCTACACCTTC	CASTTGAGYGYTF	TRBV5-1	TRBJ1-2
TGTGCCACCAGTGATTTGGGAACGGGAAGGTGGGGGAATACGCAGTATTTT	CATSDLGTGRWGNTQYF	TRBV24-1	TRBJ2-3
TGTGCCAGTTCAGTGGACTCTGGAAACACCATATATTTT	CASSVDSGNTIYF	TRBV19	TRBJ1-3
TGTGCCAGCAGTGTCACGGGGGGCTGGGGCGCGTCCCCCAATGAAAAACTGTTTTTT	CASSVTGGWGASPNEKLFF	TRBV6-4	TRBJ1-4
TGCGCCAGCATGGACGACACAGGGAAAGCTGGGGCCAACGTCCTGACTTTC	CASMDDTGKAGANVLTF	TRBV5-1	TRBJ2-6
TGTGCCAGCAGCGACGGAGGGCATCAGCCCCAGCATTTT	CASSDGGHQPQHF	TRBV13	TRBJ1-5
TGTGCCAGCAGCGTTTTCTGTGTTCTACAGGGGAGGGGGAACACTGAAGCTTTCTTT	CASSVFCVLQGRGNTEAFF	TRBV9	TRBJ1-1
TGTGCCACCATACCCATTCTTGCTTTCTTT	CATIPILAFF	TRBV24-1	TRBJ1-1
TGTGCCATAGAAGCGGATAGCGGGAACACCGGGGAGCTGTTTTTT	CAIEADSGNTGELFF	TRBV6-3	TRBJ2-2
TGTGCCAGCAGCCTGTTCCCAGGGGGGCGCCCAGCTGAAGCTTTCTTT	CASSLFPGGRPAEAFF	TRBV3-1	TRBJ1-1
TGTGCCAGCAGCCCTGACAGGGGAACAGATACGCAGTATTTT	CASSPDRGTDTQYF	TRBV7-2	TRBJ2-3
TGTGCCAACAGGGATTCCTACGAGCAGTACTTC	CANRDSYEQYF	TRBV18	TRBJ2-7
TGTGCCAGCAGTCGAGATAAAAACATTCAGTACTTC	CASSRDKNIQYF	TRBV6-1	TRBJ2-4
TGTGCCAGCCCCGAGGACAGGGGCCCGGTCGAAGCTTTCTTT	CASPEDRGPVEAFF	TRBV27	TRBJ1-1
TGCGCCAGCACCATGAGGCGGCAGCCCCAGCATTTT	CASTMRRQPQHF	TRBV10-1	TRBJ1-5
TGTGCCAGCAGCTGGACCGAGGGGTTTGAGCAGTTCTTC	CASSWTEGFEQFF	TRBV5-4	TRBJ2-1
TGTGCCGGGCACTACGAGCAGTACTTC	CAGHYEQYF	TRBV19	TRBJ2-7
TGTGCCAGCAGTGACTCCCTTCGGAGTCAGCCCCAGCATTTT	CASSDSLRSQPQHF	TRBV6-4	TRBJ1-5
TGTGCCAGCATATCGGCATTCAATGAGCAGTTCTTC	CASISAFNEQFF	TRBV6-1	TRBJ2-1
TGTGCCATCACCGGCGGGAGCCTGAACACTGAAGCTTTCTTT	CAITGGSLNTEAFF	TRBV10-3	TRBJ1-1
TGTGCCAGCAGTGGAATATTTGGGAGGATGGATACGCAGTATTTT	CASSGIFGRMDTQYF	TRBV6-2	TRBJ2-3
TGTGCCAGCAGCTGGGCGGGAAGTAACATTCAGTACTTC	CASSWAGSNIQYF	TRBV7-2	TRBJ2-4
TGTGCCAGCAGCAAAGGGGGACAGGGGACTGCCTACGAGCAGTACTTC	CASSKGGQGTAYEQYF	TRBV13	TRBJ2-7
TGTGCCAGCAGCCCTCTCCACGGGACTTTCTTT	CASSPLHGTFF	TRBV4-2	TRBJ1-1
TGTGCCAGCAGCCTCGCACCAGGACTAGCGGGGAATCAAGAGACCCAGTACTTC	CASSLAPGLAGNQETQYF	TRBV7-3	TRBJ2-5
TGTGCCAGCAGCCGGAGGACAGGGGACACAGATACGCAGTATTTT	CASSRRTGDTDTQYF	TRBV3-1	TRBJ2-3
TGTGCCAGCAGCAGTCGAGGACAGCCCTCCTACAATGAGCAGTTCTTC	CASSSRGQPSYNEQFF	TRBV7-3	TRBJ2-1
TGTGCCAGCAGGTGTCACCGGGGCCCTGGCTACACCTTC	CASRCHRGPGYTF	TRBV2	TRBJ1-2
TGTGCCAGCAGCGGCTTCGGGGAGCACACTGAAGCTTTCTTT	CASSGFGEHTEAFF	TRBV9	TRBJ1-1
TGTGCCAGCAGCAGGACAAACGCAGGGGATGGCTACACCTTC	CASSRTNAGDGYTF	TRBV5-4	TRBJ1-2
TGTGCCAGCAGCCACCGTGGGGGGGGCGGCTACAATGAGCAGTTCTTC	CASSHRGGGGYNEQFF	TRBV4-2	TRBJ2-1
TGTGCCAGCAGCTTGCGACAGCGCTCTAAGTGTGGATGGACCCAGTACTTC	CASSLRQRSKCGWTQYF	TRBV13	TRBJ2-5
TGCAGTGCAGCCGCCGGGACATTACCTCGGGGGGTCTTC	CSAAAGTLPRGVF	TRBV20-1	TRBJ2-1
TGTGCCAGCAGCCAACGCAGCAGGGGAGGGGCCGACTATGGCTACACCTTC	CASSQRSRGGADYGYTF	TRBV7-9	TRBJ1-2
TGCGCCAGCAGCTCGGGACTAGCATGCTCCTACGAGCAGTACTTC	CASSSGLACSYEQYF	TRBV5-1	TRBJ2-7
TGCGCCAGCAGCCAAGAGTCACGGCGGTACGAGCAGTACTTC	CASSQESRRYEQYF	TRBV4-1	TRBJ2-7
TGCGCCGACAGGGGGCCCCGCACTGAAGCTTTCTTT	CADRGPRTEAFF	TRBV4-1	TRBJ1-1
TGTGCCAGCAGTAACCCCCCCGAGGCCCCTCAAGCTAATGAAAAACTGTTTTTT	CASSNPPEAPQANEKLFF	TRBV12-3	TRBJ1-4
TGTGCCAGCAGCACCCGGAGGGGTGTATCCTACGAGCAGTACTTC	CASSTRRGVSYEQYF	TRBV11-2	TRBJ2-7
TGTGCCAGCAGCGTTATTCCATCGGATGGCTACACCTTC	CASSVIPSDGYTF	TRBV13	TRBJ1-2
TGTGCCAGCAGTGAGAGCCTAGCGGACGAGCAGTACTTC	CASSESLADEQYF	TRBV25-1	TRBJ2-7
TGCGCCAGCAGCTTGGACGGGGACAGGGGAAGGGATCAGCCCCAGCATTTT	CASSLDGDRGRDQPQHF	TRBV5-1	TRBJ1-5
TGTGCCAGTAGCGGACTGCTGATCAGCAATCAGCCCCAGCATTTT	CASSGLLISNQPQHF	TRBV19	TRBJ1-5
TGTGCCAGCAGTTACTCGGACAGGGGACTCTACGAGCAGTACTTC	CASSYSDRGLYEQYF	TRBV6-3	TRBJ2-7
TGTGCCAGCAGCTTGTCCGGGCACAGGGTGGAGTACAATGAGCAGTTCTTC	CASSLSGHRVEYNEQFF	TRBV11-2	TRBJ2-1
TGTGCCTGGAGTGTAGGGAGTTACACGGTGGAGACCCAGTACTTC	CAWSVGSYTVETQYF	TRBV30	TRBJ2-5
TGTGCCAGCAGTGACCCGGGGGGGTCCTACGAGCAGTACTTC	CASSDPGGSYEQYF	TRBV2	TRBJ2-7
TGCGCCAGCAGCTTGCCTAGGACTACTCGTGAGACCCAGTACTTC	CASSLPRTTRETQYF	TRBV5-1	TRBJ2-5
TGTGCCAGCAGTTCCCAGGTCCAGGAAAAGGGTGAGCAGTTCTTC	CASSSQVQEKGEQFF	TRBV6-6	TRBJ2-1
TGTGCCAGCAGTGACAAACCCCGGACTAGCCCAAAAAACATTCAGTACTTC	CASSDKPRTSPKNIQYF	TRBV6-4	TRBJ2-4
TGTGCCATCATAAACTTAAGGATACAGGCAAAATACGAGCAGTACTTC	CAIINLRIQAKYEQYF	TRBV10-3	TRBJ2-7
TGTGCCAGCAGTGACCCCTCCCTCGGGCCCAATCAGCCCCAGCATTTT	CASSDPSLGPNQPQHF	TRBV6-4	TRBJ1-5
TGCGCCAGCAGCTGGGCGAGGCGGAACACTGAAGCTTTCTTT	CASSWARRNTEAFF	TRBV5-1	TRBJ1-1
TGCGCCAGCAGGGTCGGGACTAGCGGTCGGCACACAGATACGCAGTATTTT	CASRVGTSGRHTDTQYF	TRBV5-1	TRBJ2-3
TGCGCCAGCAGCTTAGATCGGGCGACTAGCGGGATGGAGACCAATGAGCAGTTCTTC	CASSLDRATSGMETNEQFF	TRBV5-1	TRBJ2-1
TGTGCCAGCAACGACAGGGTTCCCTATGGCTACACCTTC	CASNDRVPYGYTF	TRBV11-2	TRBJ1-2
TGCGCCAGCCGGGGGGGGGAAGGGCTGGGGAGCTCCTACAATGAGCAGTTCTTC	CASRGGEGLGSSYNEQFF	TRBV10-1	TRBJ2-1
TGTGCCGCTAATGCGGGAATTCGACTGGCCAGTAGCTTC	CAANAGIRLASSF	TRBV7-8	TRBJ1-2
TGCGCCAGCAGCCCCCCGGGACAGGGTGGGTCGAACTATGGCTACACCTTC	CASSPPGQGGSNYGYTF	TRBV4-1	TRBJ1-2
TGTGCCAGCAGTTCAGGCAATTCGGCTAGCAATCAGCCCCAGCATTTT	CASSSGNSASNQPQHF	TRBV6-9	TRBJ1-5
TGTGCCAGCAGGAGGCGATTGTCCGGGACAGGCTGCAATCAGCCCCAGCATTTT	CASRRRLSGTGCNQPQHF	TRBV6-4	TRBJ1-5
TGTGCCAGCAGCCAAGATGCTCAGCAGGGATCCACAGATACGCAGTATTTT	CASSQDAQQGSTDTQYF	TRBV3-1	TRBJ2-3
TGTGCCAGCAGTTTAACCGGGACAGGGTGTGGGGTAGTTGAAGCTTTCTTT	CASSLTGTGCGVVEAFF	TRBV27	TRBJ1-1
TGTGCCAGCAGTTTAGAAGTCTGGACTAGCGGGGGCGACCCACGCACAGATACGCAGTATTTT	CASSLEVWTSGGDPRTDTQYF	TRBV28	TRBJ2-3
TGTGCCAGCAGTGAAAGACTTCAGGACCTAGACGAGCAGTACTTC	CASSERLQDLDEQYF	TRBV6-1	TRBJ2-7
TGCGCCAGCAGTGAGCGCACCGGGACAGGGAGTGGCCCAGATACGCAGTATTTT	CASSERTGTGSGPDTQYF	TRBV10-1	TRBJ2-3
TGTGCCAGCAGTTGGCACAGGGGGCGAAGGAGGGACTATGGCTACACCTTC	CASSWHRGRRRDYGYTF	TRBV27	TRBJ1-2
TGTGCCAGCAGCTCCCCGACAGCCGAGACCCAGTACTTC	CASSSPTAETQYF	TRBV7-9	TRBJ2-5
TGCAGTGCTAGAGATCGCGGGGGCACCGGGGAGCTGTTTTTT	CSARDRGGTGELFF	TRBV20-1	TRBJ2-2
TGTGCCAGCAGCATCCGGGACAGAGGGGAAGCTTTCTTT	CASSIRDRGEAFF	TRBV7-4	TRBJ1-1
TGTGCCAGCAGTGGAAATCTAGCGGACACCCAATTAAATGAGCAGTTCTTC	CASSGNLADTQLNEQFF	TRBV6-3	TRBJ2-1
TGTGCCACCCGGGGCACTGAAGCTTTCTTT	CATRGTEAFF	TRBV30	TRBJ1-1
TGCGCCAGCACCCCGGGACAGGGGGCCCCCTACGAGCAGTACTTC	CASTPGQGAPYEQYF	TRBV10-1	TRBJ2-7
TGTGCCACCAGTACTAGCGGGAGCCGAAATGAGCAGTTCTTC	CATSTSGSRNEQFF	TRBV24-1	TRBJ2-1
TGCAGCGTTGACTTTGGTCCGAGCAATCAGCCCCAGCATTTT	CSVDFGPSNQPQHF	TRBV29-1	TRBJ1-5
TGTGCCAGCAGCCAACTAGTCCGGACAGTCAATGCAACTAATGAAAAACTGTTTTTT	CASSQLVRTVNATNEKLFF	TRBV3-1	TRBJ1-4
TGCGCCAGCAGTGGGAGGGGGATAGACTGCGAGCAGTACTTC	CASSGRGIDCEQYF	TRBV10-1	TRBJ2-7
TGTGCCAGCAGTTACCCGACTAGGGGAGACGAGCAGTACTTC	CASSYPTRGDEQYF	TRBV6-3	TRBJ2-7
TGTGCCAGCAGCAACACTAGCGGGAGGGCCGGGGGGAACACTGAAGCTTTCTTT	CASSNTSGRAGGNTEAFF	TRBV13	TRBJ1-1
TGTGCTAGTGGTTACTTATATAGCACAGATACGCAGTATTTT	CASGYLYSTDTQYF	TRBV12-5	TRBJ2-3
TGTGCCGGGTCCTACTATGGCTACACCTTC	CAGSYYGYTF	TRBV2	TRBJ1-2
TGTGCCTGGAAAGGTGGGGGGCGAAAGCAGCCCCAGCATTTT	CAWKGGGRKQPQHF	TRBV30	TRBJ1-5
TGTGCCAGCAGCGTAGTTCCTGGGGGCGGATCTTGCGAGACCCAGTACTTC	CASSVVPGGGSCETQYF	TRBV9	TRBJ2-5
TGTGCCAGCAGCACTCTTCCGGGACTAGCGGGCCCAGTCTACGAGCAGTACTTC	CASSTLPGLAGPVYEQYF	TRBV7-8	TRBJ2-7
TGCGCCAGCAGTGAATCACACCCAGATACGCAGTATTTT	CASSESHPDTQYF	TRBV10-2	TRBJ2-3
TGTGCCACCAGCAGCCGCGGAATTGTAGTTCGGCACAATGAGCAGTTCTTC	CATSSRGIVVRHNEQFF	TRBV15	TRBJ2-1
TGTGCCAGCAGCTGCAGACGACCTGGCTACACCTTC	CASSCRRPGYTF	TRBV5-4	TRBJ1-2
TGTGCCAGCACGGGGGTGGCTGAAGCTTTCTTT	CASTGVAEAFF	TRBV28	TRBJ1-1
TGCGCCAGCAGCTTGCCCTCAGGGCCACCCATCTACGAGCAGTACTTC	CASSLPSGPPIYEQYF	TRBV5-1	TRBJ2-7
TGTGCCAGCAGCTCTGGGGGGGCGGAAGAGACCCAGTACTTC	CASSSGGAEETQYF	TRBV9	TRBJ2-5
TGTGCCACCAGTGATTGGAGAGGGCGTGAGAACACTGAAGCTTTCTTT	CATSDWRGRENTEAFF	TRBV24-1	TRBJ1-1
TGTGCCAGCAGCTTAGGCCGACCCTATGGCTACACCTTC	CASSLGRPYGYTF	TRBV11-3	TRBJ1-2
TGCAGTGCTAGAGGGACAGGGAGATGCTACGAGCAGTACTTC	CSARGTGRCYEQYF	TRBV20-1	TRBJ2-7
TGTGCCAGCAGCGTTTGGGACGGAAGGGCCAAAAACATTCAGTACTTC	CASSVWDGRAKNIQYF	TRBV7-9	TRBJ2-4
TGTGCCAGCAGTCTAGCGATGGATGGTTCTGAGCAGTTCTTC	CASSLAMDGSEQFF	TRBV25-1	TRBJ2-1
TGTGCCAGTGCTCGACGAATAGAGACCCAGTACTTC	CASARRIETQYF	TRBV19	TRBJ2-5
TGCAGCGTTGTCTTAAAGGGTGACGAACCCAAAAACATTCAGTACTTC	CSVVLKGDEPKNIQYF	TRBV29-1	TRBJ2-4
TGTGCCAGCACGGGCGGACAGGGAAGAAATCAGCCCCAGCATTTT	CASTGGQGRNQPQHF	TRBV6-4	TRBJ1-5
TGTGCCAGCAGATTAGAAGGGGGGAGGCCTGGCGACAGGGGCTACGAGCAGTACTTC	CASRLEGGRPGDRGYEQYF	TRBV6-1	TRBJ2-7
TGTGCCAGCAGCGTAGCTCCGGGGGCCATTTACTATGGCTACACCTTC	CASSVAPGAIYYGYTF	TRBV9	TRBJ1-2
TGTGCCAGCAGCCAAGTGGGCAGGGGGCGGTATAGCAATCAGCCCCAGCATTTT	CASSQVGRGRYSNQPQHF	TRBV3-1	TRBJ1-5
TGCAGTGCTAGACCAGGAGCGTATGAGCAGTTCTTC	CSARPGAYEQFF	TRBV20-1	TRBJ2-1
TGCGCCAGCAGCCCAGAGGGACAGGGAAACATAGGAAACACCATATATTTT	CASSPEGQGNIGNTIYF	TRBV5-1	TRBJ1-3
TGTGCCGGAGGGGACTTTTCCTACGAGCAGTACTTC	CAGGDFSYEQYF	TRBV7-9	TRBJ2-7
TGTGCCAGCAGCGACGGGAACTCCCCCGGACAGGGGAGTATGAACACTGAAGCTTTCTTT	CASSDGNSPGQGSMNTEAFF	TRBV11-3	TRBJ1-1
TGCGCCAGCAGCTTGTTTTCAGACGAGCAGTACTTC	CASSLFSDEQYF	TRBV5-1	TRBJ2-7
TGCAGTGCTAGCCAAACCGGCCCAGCTGGCGAGCAGTACTTC	CSASQTGPAGEQYF	TRBV20-1	TRBJ2-7
TGTGCCACCGGGGGGACAGGAGTGGAAGATAGCAATCAGCCCCAGCATTTT	CATGGTGVEDSNQPQHF	TRBV24-1	TRBJ1-5
TGTGCCAGCATACGGAGGTCTGGAAACACCATATATTTT	CASIRRSGNTIYF	TRBV6-1	TRBJ1-3
TGCGCCAGCAGCTGGCAGCCGACAGGGGGCTACTACTACGAGCAGTACTTC	CASSWQPTGGYYYEQYF	TRBV5-1	TRBJ2-7
TGTGCCAGCAACCGAGGGGGGGAATCACCCCTCCACTTT	CASNRGGESPLHF	TRBV6-4	TRBJ1-6
TGTGCCAGCAGCGTACCTCACGTGAACACTGAAGCTTTCTTT	CASSVPHVNTEAFF	TRBV13	TRBJ1-1
TGTGCCACCATTACCTCCACGCCGTGGGCCAGGCAGTTCTTC	CATITSTPWARQFF	TRBV24-1	TRBJ2-1
TGTGCCAGCAGTTTAGGGGCGCCCTATGGCTACACCTTC	CASSLGAPYGYTF	TRBV27	TRBJ1-2
TGTGCCAGCAGTTTATCGCGGGAGCCCTCATCCTACAATGAGCAGTTCTTC	CASSLSREPSSYNEQFF	TRBV12-4	TRBJ2-1
TGTGCCAGCAGCAGACAGGGGGCTTCCATATATTCACCCCTCCACTTT	CASSRQGASIYSPLHF	TRBV6-1	TRBJ1-6
TGTGCCAGCAGCCACCTGCACGGAGACATAGACTACGAGCAGTACTTC	CASSHLHGDIDYEQYF	TRBV4-2	TRBJ2-7
TGTGCCAGCAGCGGACTCCTTGGGACTAGCGGCCCTAGCACAGATACGCAGTATTTT	CASSGLLGTSGPSTDTQYF	TRBV5-6	TRBJ2-3
TGTGCCAGCAGTCTGGGGGCGGGTTTCTATGGCTACACCTTC	CASSLGAGFYGYTF	TRBV2	TRBJ1-2
TGTGCCAGCAGCTTGGGTAGGGTCCAGGGGGCCCTTAATGAAAAACTGTTTTTT	CASSLGRVQGALNEKLFF	TRBV7-8	TRBJ1-4
TGTGCCAGCAGCTATATACGAGGGGGGATTCAGCCCCAGCATTTT	CASSYIRGGIQPQHF	TRBV11-2	TRBJ1-5
TGTGCTAGTGGTTCGGGGCCTATTGAAAAACTGTTTTTT	CASGSGPIEKLFF	TRBV12-5	TRBJ1-4
TGTGCCAGCAGTTTGAGCGGGAGGGATGGCTATGGCTACACCTTC	CASSLSGRDGYGYTF	TRBV27	TRBJ1-2
TGCAGTGCTCCAGACAGGTTTCCCCGGGCTAACTATGGCTACACCTTC	CSAPDRFPRANYGYTF	TRBV20-1	TRBJ1-2
TGCAGTGCTAGCGGAATTACTAGCGGGAGTTACAATGAGCAGTTCTTC	CSASGITSGSYNEQFF	TRBV20-1	TRBJ2-1
TGTGCCAGCACTCCGCAGGCTACAGATACGCAGTATTTT	CASTPQATDTQYF	TRBV6-1	TRBJ2-3
TGTGCCAGCAGTGACTCGACCCTCACAGGGGGGGAGTTCCCCTATAATTCACCCCTCCACTTT	CASSDSTLTGGEFPYNSPLHF	TRBV6-4	TRBJ1-6
TGTGCCAGCAGTTCTGGACTAGCGGGGGGGCGGCTAGAGACCCAGTACTTC	CASSSGLAGGRLETQYF	TRBV6-4	TRBJ2-5
TGTGCCAGCAGTGGGATAAAGGGCGAAGGCCCGGGACACGAGACCCAGTACTTC	CASSGIKGEGPGHETQYF	TRBV6-4	TRBJ2-5
TGTGCCAGCAGTGAGGTGACACCAAACACCATATATTTT	CASSEVTPNTIYF	TRBV6-1	TRBJ1-3
TGTGCCGAATTATTAGAGCAGTACTTC	CAELLEQYF	TRBV10-3	TRBJ2-7
TGTGCCAGCAGCCAAGAATGTCGACAGGACGGATTAGAAGCTTTCTTT	CASSQECRQDGLEAFF	TRBV14	TRBJ1-1
TGTGCCAGCGTGGCGGGAGACACCGGGGAGCTGTTTTTT	CASVAGDTGELFF	TRBV27	TRBJ2-2
TGTGCCAGCAGTTACGAACCGATGCCACCTTTATTCCAGAAAGAGACCCAGTACTTC	CASSYEPMPPLFQKETQYF	TRBV6-5	TRBJ2-5
TGTGCCAGCAGCCAAGAGCTTACAGGGGGCCTCTCCTATAATTCACCCCTCCACTTT	CASSQELTGGLSYNSPLHF	TRBV14	TRBJ1-6
TGTGCCAGCATCGCAGGCAGAAAGGGGATGCCCGGGGAGCTGTTTTTT	CASIAGRKGMPGELFF	TRBV27	TRBJ2-2
TGTGCTCAGGGTGGGAACACTGAAGCTTTCTTT	CAQGGNTEAFF	TRBV30	TRBJ1-1
TGTGCCAGCTCATGGGCGGGAGAACTGAACACTGAAGCTTTCTTT	CASSWAGELNTEAFF	TRBV18	TRBJ1-1
TGTGCCAGCAGTGGGGGGCCGCAAGAGACCCAGTACTTC	CASSGGPQETQYF	TRBV6-4	TRBJ2-5
TGTGCCAGCACTCCAAGACAGCGGATCCGCAATCAGCCCCAGCATTTT	CASTPRQRIRNQPQHF	TRBV6-3	TRBJ1-5
TGTGCCAGCATTCCAGGGACAATACTGGTTTCACAGCCCCAGCATTTT	CASIPGTILVSQPQHF	TRBV5-6	TRBJ1-5
TGTGCCAGCAGCATCAAGGGGGGGGGGTATGATGGCTACACCTTC	CASSIKGGGYDGYTF	TRBV11-2	TRBJ1-2
TGTGCCAGCAGTGAAGGACCCAGGGAGGGCAATGAGCAGTTCTTC	CASSEGPREGNEQFF	TRBV6-1	TRBJ2-1
TGTGCCAGCAGCTTGCTTTTAGCCGGGACAGGGGGCCAGATTGACCAAGAGACCCAGTACTTC	CASSLLLAGTGGQIDQETQYF	TRBV5-5	TRBJ2-5
TGTGCCAGCAGCCGCATTAATCCAGGCTATCTAACAGATACGCAGTATTTT	CASSRINPGYLTDTQYF	TRBV7-4	TRBJ2-3
TGCGCCAGCAGCTTGGCGTGGGACAGCTACGAGCAGTACTTC	CASSLAWDSYEQYF	TRBV5-1	TRBJ2-7
TGCAGTGCTATAGCGGGAGGGATCGAGCAGTACTTC	CSAIAGGIEQYF	TRBV20-1	TRBJ2-7
TGTGCCAGCAGCTTACGGGACAGGGGGCCCCAGTATTTT	CASSLRDRGPQYF	TRBV11-1	TRBJ2-3
TGTGCTAGTGGTTTGGTACCCCCTTCGCAGGGACAGGGTTCCCCCGGGTTTATGGATGGGGCCAACGTCCTGACTTTC	CASGLVPPSQGQGSPGFMDGANVLTF	TRBV12-5	TRBJ2-6
TGTGCCAGCAGCTCTTCTCAGGGGGTCCAGCCCCAGCATTTT	CASSSSQGVQPQHF	TRBV5-6	TRBJ1-5
TGTGCCAGCAGCAGAGTAGCGGGGGGGGAAGCCTACGAGCAGTACTTC	CASSRVAGGEAYEQYF	TRBV7-6	TRBJ2-7
TGCAGTGCTAAACTTACAGGTAGCAATCAGCCCCAGCATTTT	CSAKLTGSNQPQHF	TRBV20-1	TRBJ1-5
TGTGCCAGCAGCTTCAGCGGGAAGAAGGGGAATCAGCCCCAGCATTTT	CASSFSGKKGNQPQHF	TRBV14	TRBJ1-5
TGTGCCACCAGGGGTTACAGGGGGCGCGACAATCAGCCCCAGCATTTT	CATRGYRGRDNQPQHF	TRBV24-1	TRBJ1-5
TGTGCCAGCAGCTTGGTTATAGGGAAAAATGTTGGCTACACCTTC	CASSLVIGKNVGYTF	TRBV5-6	TRBJ1-2
TGTGCCAGCACCAGGGGGGAAAGCTCACCCCTCCACTTT	CASTRGESSPLHF	TRBV27	TRBJ1-6
TGTGCCAGCAGCTTGTGGGGAGGAAGGAGCAATCAGCCCCAGCATTTT	CASSLWGGRSNQPQHF	TRBV7-4	TRBJ1-5
TGCGCCAGCAGCTTGGAATACTCAGAACAGGGGGCGGGTGGCTCTGGAAACACCATATATTTT	CASSLEYSEQGAGGSGNTIYF	TRBV5-1	TRBJ1-3
TGTGCCAGCGAACTCTCCTACAATGAGCAGTTCTTC	CASELSYNEQFF	TRBV9	TRBJ2-1
TGTGCCAGCAGTGTCATGGACATCGGGGAGTCGGGCACTGAAGCTTTCTTT	CASSVMDIGESGTEAFF	TRBV2	TRBJ1-1
TGTGCCACCAGTGATTTTTCCCTCCAGACCTACGAGCAGTACTTC	CATSDFSLQTYEQYF	TRBV24-1	TRBJ2-7
TGTGCCAGCAAGGGGGCACTCACCGGGGAGCTGTTTTTT	CASKGALTGELFF	TRBV6-1	TRBJ2-2
TGTGCCAGTAGTATAGACCTGGGCCCTTACTACCAAGAGACCCAGTACTTC	CASSIDLGPYYQETQYF	TRBV19	TRBJ2-5
TGTGCCAGCAGTGAAGCGCGTTGGGAAACTGAAGCTTTCTTT	CASSEARWETEAFF	TRBV6-1	TRBJ1-1
TGTGCCAGCAGGACTAGCGGGGACGAGCAGTACTTC	CASRTSGDEQYF	TRBV7-9	TRBJ2-7
TGTGCCAGCAGCTGCCCCCTGGGGGGGACTTTTGAGCAGTTCTTC	CASSCPLGGTFEQFF	TRBV7-9	TRBJ2-1
TGTGCCAGCAGCTATTTTGGACAGGGGAAACAGTACAGGGGGGGCTCTGGGGCCAACGTCCTGACTTTC	CASSYFGQGKQYRGGSGANVLTF	TRBV11-2	TRBJ2-6
TGCGCCAGCAGCTCCGGACAGGGGGCCATGGGATTATCCTACAATGAGCAGTTCTTC	CASSSGQGAMGLSYNEQFF	TRBV5-1	TRBJ2-1
TGTGCCTGGAGTGTACGGTCTGTCACGGGGGGTACAGATACGCAGTATTTT	CAWSVRSVTGGTDTQYF	TRBV30	TRBJ2-3
TGTGCCAGCAGCGACCCCCGGGACAGGGATAACCCATATAGCAATCAGCCCCAGCATTTT	CASSDPRDRDNPYSNQPQHF	TRBV13	TRBJ1-5
TGTGCCACCAGTGAGATCCCGGGGCTTCTCTACGAGCAGTACTTC	CATSEIPGLLYEQYF	TRBV24-1	TRBJ2-7
TGTGCCAGCAGTTACTCGAGATCGGGGGGGGGCTCCTACGAGCAGTACTTC	CASSYSRSGGGSYEQYF	TRBV6-5	TRBJ2-7
TGTGCCAGCAGCTTTCAGGGAGAGCAGCCCCAGCATTTT	CASSFQGEQPQHF	TRBV7-4	TRBJ1-5
TGTGCCAGCAGTGACTCCCCCTTGCGGCGCGATCAGGCTATAACTAACTATGGCTACACCTTC	CASSDSPLRRDQAITNYGYTF	TRBV6-4	TRBJ1-2
TGTGCCTTCCCATTGGGGCATGGCTACACCTTC	CAFPLGHGYTF	TRBV24-1	TRBJ1-2
TGTGCCAGCAGCTTAGCCGTATGGCGGGAGCGTGAGACCCAGTACTTC	CASSLAVWRERETQYF	TRBV7-9	TRBJ2-5
TGTGCCAGCAGTTTGGCTAGGGCGTATACCAGCAATCAGCCCCAGCATTTT	CASSLARAYTSNQPQHF	TRBV12-4	TRBJ1-5
TGTGCCAGCAGCTTCCGAGGGGGGCCCAGTAATGAAAAACTGTTTTTT	CASSFRGGPSNEKLFF	TRBV7-2	TRBJ1-4
TGTGCCAGCAGCTTACATCCCGGAGGGGGGGCAGACGAGCAGTACTTC	CASSLHPGGGADEQYF	TRBV7-2	TRBJ2-7
TGTGCCAGTAGTATTAGCATGGCTAGTCCGGGACTAGCGGTGTTTGGGGCCAACGTCCTGACTTTC	CASSISMASPGLAVFGANVLTF	TRBV19	TRBJ2-6
TGTGCCAGCAGAATCCGGAGCTACTATGGCTACACCTTC	CASRIRSYYGYTF	TRBV7-3	TRBJ1-2
TGTGCCTGGCTTTTTGAACGGAGCTCCTACGAGCAGTACTTC	CAWLFERSSYEQYF	TRBV30	TRBJ2-7
TGTGCTAGTGGTATAACGGGGGGGAACGAGCAGTACTTC	CASGITGGNEQYF	TRBV12-5	TRBJ2-7
TGTGCTAGTGGTGCGCACAGGAGGACCGGGGAGCTGTTTTTT	CASGAHRRTGELFF	TRBV12-5	TRBJ2-2
TGCGCCAGCAAACGGGGCGCTCTCGTTTCACCCCTCCACTTT	CASKRGALVSPLHF	TRBV10-1	TRBJ1-6
TGTTGGGGGCCTTGTGAAGCTTTCTTT	CWGPCEAFF	TRBV6-6	TRBJ1-1
TGTGTAATTGGCCCCAATGAAAAACTGTTTTTT	CVIGPNEKLFF	TRBV4-2	TRBJ1-4
TGTGCCAGCAGCCAAGGATCCTTGCAGCCCCAGCATTTT	CASSQGSLQPQHF	TRBV14	TRBJ1-5
TGTGCCAGCAGTGGACGAGACACATACGAGCAGTACTTC	CASSGRDTYEQYF	TRBV6-6	TRBJ2-7
TGTGCCAGCAGCTATTCCCGGGTAGATGAGCAGTTCTTC	CASSYSRVDEQFF	TRBV7-3	TRBJ2-1
TGTGCCAGCAGCCACCGTGGGACAGGGGGCTTTACCTACACTGAAGCTTTCTTT	CASSHRGTGGFTYTEAFF	TRBV3-1	TRBJ1-1
TGTGCCACCAGTGATTACCGGGACAGGGAGCATGGCTACACCTTC	CATSDYRDREHGYTF	TRBV24-1	TRBJ1-2
TGCGCCAGCAGCTTGGACGGGGACAGGGCGGCCTACAATGAGCAGTTCTTC	CASSLDGDRAAYNEQFF	TRBV5-1	TRBJ2-1
TGTGCTAGTGGTTTGGTACCCGCAGGGGGAGGCTACACCTTC	CASGLVPAGGGYTF	TRBV12-5	TRBJ1-2
TGTGCCAGCTCACCACAGTCCCCCGGGACTAGGAGCAGAACCTACAATGAGCAGTTCTTC	CASSPQSPGTRSRTYNEQFF	TRBV18	TRBJ2-1
TGTGCCAGCAGCACCTACGAGCAGTACTTC	CASSTYEQYF	TRBV6-5	TRBJ2-7
TGCAGTGCTAGTCCCGGGACGGGTCCACGTGGCTACACCTTC	CSASPGTGPRGYTF	TRBV20-1	TRBJ1-2
TGCGCCAGCCTGACAGGGACAGCGGACTATGGCTACACCTTC	CASLTGTADYGYTF	TRBV4-1	TRBJ1-2
TGTGCCAGCGGAGTCAAGGGGGGGATTAAGAATTCACCCCTCCACTTT	CASGVKGGIKNSPLHF	TRBV27	TRBJ1-6
TGTGCCAGCCTTCGGCGGAACACAGATACGCAGTATTTT	CASLRRNTDTQYF	TRBV6-2	TRBJ2-3
TGTGCCAGCAGTCTCGGCGGACTAGCGGGATACAATGAGCAGTTCTTC	CASSLGGLAGYNEQFF	TRBV6-1	TRBJ2-1
TGTGCCAGCAAACTTGGGCCAGGGGCCGAATACAATGAGCAGTTCTTC	CASKLGPGAEYNEQFF	TRBV27	TRBJ2-1
TGTGCCAGCAGTTTAGTTACCCGGTTCGGGGGCTACACCTTC	CASSLVTRFGGYTF	TRBV28	TRBJ1-2
TGTGCCAAAACTCGAGGGAAAACAGATACGCAGTATTTT	CAKTRGKTDTQYF	TRBV28	TRBJ2-3
TGCGCCACCGGACGGAGCAATCAGCCCCAGCATTTT	CATGRSNQPQHF	TRBV10-1	TRBJ1-5
TGTGCCAGCAGCCACCTTGGACTTCCGAGTAATTCACCCCTCCACTTT	CASSHLGLPSNSPLHF	TRBV5-4	TRBJ1-6
TGTGCCAGCACTATCAGGACTGATAATTCACCCCTCCACTTT	CASTIRTDNSPLHF	TRBV5-6	TRBJ1-6
TGTGCCAGCAGGTTGGGGGTGACAGATACGCAGTATTTT	CASRLGVTDTQYF	TRBV12-4	TRBJ2-3
TGTGCCAGCAGCGTACCTCGGACAGGGAGGTTATTTCAGGACGAGCAGTACTTC	CASSVPRTGRLFQDEQYF	TRBV9	TRBJ2-7
TGTGCCATGACCCCCAGAGACAATGAGCAGTTCTTC	CAMTPRDNEQFF	TRBV2	TRBJ2-1
TGTGCCAGCAGCACCTTGGGGGGCCATGGGAACACCGGGGAGCTGTTTTTT	CASSTLGGHGNTGELFF	TRBV9	TRBJ2-2
TGTGCCAGCAGCCATGAGCTGAACCCAGGGGGTTACGAGCAGTACTTC	CASSHELNPGGYEQYF	TRBV3-1	TRBJ2-7
TGTGCCAGCGAAACAGTCAGGGGGGGAACCGATAGCACAGATACGCAGTATTTT	CASETVRGGTDSTDTQYF	TRBV6-2	TRBJ2-3
TGCGCCAGCAGCCAACGAGCGGGACGGGACAATGAGCAGTTCTTC	CASSQRAGRDNEQFF	TRBV4-1	TRBJ2-1
TGTGCCAGCAGCTACCCCCGGGGCTACAATGAGCAGTTCTTC	CASSYPRGYNEQFF	TRBV5-4	TRBJ2-1
TGTGCCAGCAGCTTAGCCCTTGCTGGAACATGGGCTAACACTGAAGCTTTCTTT	CASSLALAGTWANTEAFF	TRBV7-6	TRBJ1-1
TGTGCTAGTGGTTTAGGTAATATGGGACAGGAGCAGTACTTC	CASGLGNMGQEQYF	TRBV12-5	TRBJ2-7
TGTGCCAGCAGCGCTTACGAACCCGAGGGACCCAGCTCCTATAATTCACCCCTCCACTTT	CASSAYEPEGPSSYNSPLHF	TRBV13	TRBJ1-6
TGTGCCACCAGCCCTCCCGGGACAGGAGGAGACGAGCAGTACTTC	CATSPPGTGGDEQYF	TRBV15	TRBJ2-7
TGTGCCAGCAGTGATCCTACGACAGGGGGCTATGGCTACACCTTC	CASSDPTTGGYGYTF	TRBV2	TRBJ1-2
TGTGCCAGCAGTTACTTTCAGGGGCTCTCCTACGAGCAGTACTTC	CASSYFQGLSYEQYF	TRBV6-5	TRBJ2-7
TGTGCCAGCAGCTTTTGTAGGGGGGCCAGTGGGGATGAGCAGTTCTTC	CASSFCRGASGDEQFF	TRBV27	TRBJ2-1
TGTGCCAGCAGAACAACGCGGGAAACTGGATATAGCAATCAGCCCCAGCATTTT	CASRTTRETGYSNQPQHF	TRBV11-3	TRBJ1-5
TGTGCCAGTAGTATAGAAACGTGGAGTCCCTACGAGCAGTACTTC	CASSIETWSPYEQYF	TRBV19	TRBJ2-7
TGCGGCCGGGGACTAGCGGCTGGGGCCAACGTCCTGACTTTC	CGRGLAAGANVLTF	TRBV10-1	TRBJ2-6
TGTGCCTGGAGCGGAAGGATCTACGAGCAGTACTTC	CAWSGRIYEQYF	TRBV30	TRBJ2-7
TGTGCCAGCAGCCGGTGGACAGGGTCCGGCCTGACAGAGACCCAGTACTTC	CASSRWTGSGLTETQYF	TRBV3-1	TRBJ2-5
TGTGCCAGTAGTCCGACAGGGGCCACTGAAGCTTTCTTT	CASSPTGATEAFF	TRBV19	TRBJ1-1
TGCGCCAGCAGTGCAGGGGGACAGGATGAGACCCAGTACTTC	CASSAGGQDETQYF	TRBV10-1	TRBJ2-5
TGTGCCAGCAGTTTACCAGGACTAGCGGGTGAGTGGAGACCCGGGACATCTGAAGGGGAAGAGACCCAGTACTTC	CASSLPGLAGEWRPGTSEGEETQYF	TRBV12-3	TRBJ2-5
TGTGCCAGCAGCCAAGATGCCCCGGGACGGGGAGAGACCCAGTACTTC	CASSQDAPGRGETQYF	TRBV14	TRBJ2-5
TGTGCCAGCAGCTTACAACCGACTAGAATTACAGCGAACACCGGGGAGCTGTTTTTT	CASSLQPTRITANTGELFF	TRBV11-3	TRBJ2-2
TGTGCCAGCAGCGATCTTTGGAGAACTAACTATGGCTACACCTTC	CASSDLWRTNYGYTF	TRBV7-3	TRBJ1-2
TGTGCCAGCAGAGGGCAGGGGGAGCAGTACTTC	CASRGQGEQYF	TRBV6-3	TRBJ2-7
TGTGCCAGCAGCTCAGGGACCGCACCCAATGAGCAGTTCTTC	CASSSGTAPNEQFF	TRBV7-2	TRBJ2-1
TGTGCCAGCAGCGAAAGGGGGCATCGTAGCACAGATACGCAGTATTTT	CASSERGHRSTDTQYF	TRBV9	TRBJ2-3
TGTGCCAGCAGTCCCTCCGTCCAGAATTACGAGCAGTACTTC	CASSPSVQNYEQYF	TRBV27	TRBJ2-7
TGTGCTAGCAGCTGTGGACAGGGGCGGGCTTTCTTT	CASSCGQGRAFF	TRBV7-7	TRBJ1-1
TGCAGCGTCCCCCCCAGGGCTTCCTACGAGCAGTACTTC	CSVPPRASYEQYF	TRBV29-1	TRBJ2-7
TGCGCCAGCAGCTTGGCCCCGACGGAGACGAGCACAGATACGCAGTATTTT	CASSLAPTETSTDTQYF	TRBV5-1	TRBJ2-3
TGCGCCAGCAGCCCTCGAAAGAGGGGGAGTAGGATCCAGTACTTC	CASSPRKRGSRIQYF	TRBV4-1	TRBJ2-5
TGTGCCAGCAGCCGAAGGGGATCATACGAGCAGTACTTC	CASSRRGSYEQYF	TRBV13	TRBJ2-7
TGTGCCAGCAGTGAGCTCGGACGAGGCCGTTACGAGCAGTACTTC	CASSELGRGRYEQYF	TRBV6-4	TRBJ2-7
TGTGCCAGCAGTTTTCCCGGGTTCTACGAGCAGTACTTC	CASSFPGFYEQYF	TRBV27	TRBJ2-7
TGTGCCAGCAGTGATCCCTGGGCCCCACTCGAGCAGTACTTC	CASSDPWAPLEQYF	TRBV6-1	TRBJ2-7
TGTGCCAGCACCAACAGGGCTCCTGAAGCTTTCTTT	CASTNRAPEAFF	TRBV28	TRBJ1-1
TGTGCCTATTGGTCCAGTCTCGAAAGAGGCTCCTACGAGCAGTACTTC	CAYWSSLERGSYEQYF	TRBV28	TRBJ2-7
TGTGCCAGCAGCTTTGGACGTCAGCCCCAGCATTTT	CASSFGRQPQHF	TRBV7-6	TRBJ1-5
TGTGCCAGCAGCGTCCGGCGGTCCTATGGCTACACCTTC	CASSVRRSYGYTF	TRBV2	TRBJ1-2
TGTGCCAGTAGTATGCCGAGGACTACGGAGCAGTACTTC	CASSMPRTTEQYF	TRBV19	TRBJ2-7
TGTGCCAGCAGTTACCAACCTAAAAGGGGCTATGGCTACACCTTC	CASSYQPKRGYGYTF	TRBV6-2	TRBJ1-2
TGTGCCAGCAGAGGCGACAGGGGGCATAGGAACGAGCAGTACTTC	CASRGDRGHRNEQYF	TRBV11-3	TRBJ2-7
TGTGCCAGCAGTCCAGCTCTTATTACATTATCGCACAGGGGGGCCTATAATTCACCCCTCCACTTT	CASSPALITLSHRGAYNSPLHF	TRBV6-5	TRBJ1-6
TGTGCCAGCAGCCCCGCGGGAAGAGTGGATCAGCCCCAGCATTTT	CASSPAGRVDQPQHF	TRBV5-5	TRBJ1-5
TGCAGCGGGACAGGAGGGATTCAGCCCCAGCATTTT	CSGTGGIQPQHF	TRBV29-1	TRBJ1-5
TGTGCCAGCAGGGAACCACTAGCGGGAGGGCGGAGCTCCTACGAGCAGTACTTC	CASREPLAGGRSSYEQYF	TRBV27	TRBJ2-7
TGTGCCAGCAGCGTACCGATCACTGAAGCTTTCTTT	CASSVPITEAFF	TRBV9	TRBJ1-1
TGTGCCAGCAGCGTGACCAGCTGCCAAGTCTCGGACAGGGCGCGAGCGGGCAATCAGCCCCAGCATTTT	CASSVTSCQVSDRARAGNQPQHF	TRBV13	TRBJ1-5
TGTGCCAGCAGTCTCTGGACAGGTCCGGATGAAGCTTTCTTT	CASSLWTGPDEAFF	TRBV6-4	TRBJ1-1
TGTGCCAGCAGTCGACTAGCGGGAGGGTCCTACGAGCAGTACTTC	CASSRLAGGSYEQYF	TRBV6-5	TRBJ2-7
TGTGCCAGCAGTCTCCGGGACGGGGTTAGGTTGTACTTC	CASSLRDGVRLYF	TRBV27	TRBJ2-7
TGTGCCAGCAGCCGGACGCCCGGGACAGCCAAAAACATTCAGTACTTC	CASSRTPGTAKNIQYF	TRBV14	TRBJ2-4
TGTGCCAGCAGCTTAGGTCGGCGACTGTACGAGCAGTACTTC	CASSLGRRLYEQYF	TRBV7-9	TRBJ2-7
TGTGCCACCAGTAAAATGGGGCGTTCCTACGAGCAGTACTTC	CATSKMGRSYEQYF	TRBV24-1	TRBJ2-7
TGTGCCAGCAGCTTAGTGGGCCCAGCGGGGCGGAGGTTCTCCTACGAGCAGTACTTC	CASSLVGPAGRRFSYEQYF	TRBV7-6	TRBJ2-7
TGTGCCAGCAGCTTAGCCGGGGGGACAGATACGCAGTATTTT	CASSLAGGTDTQYF	TRBV13	TRBJ2-3
TGTGCCAGCAGCGTATTTGGGACTCGGGGACTAGCGGGCGGCGTTGGGGGTGAGCAGTTCTTC	CASSVFGTRGLAGGVGGEQFF	TRBV13	TRBJ2-1
TGTGCCAGCTCACCACCGAACAGGGCCGAATCCGGGGAGCTGTTTTTT	CASSPPNRAESGELFF	TRBV18	TRBJ2-2
TGTGCTAGTGCTCAACTTACGACAGGGGAGACCTACGAGCAGTACTTC	CASAQLTTGETYEQYF	TRBV12-5	TRBJ2-7
TGTGCCTGGGGCTATCAGCTAAGCTCCTACAATGAGCAGTTCTTC	CAWGYQLSSYNEQFF	TRBV30	TRBJ2-1
TGCGCCAGCAGCTCCAGCGCACAGGGTGGCCCTCGGGGTGAAAAACTGTTTTTT	CASSSSAQGGPRGEKLFF	TRBV5-1	TRBJ1-4
TGTGCCAGCAGAGGGCATGGGGGGGTCGCCGGGGAGCTGTTTTTT	CASRGHGGVAGELFF	TRBV11-2	TRBJ2-2
TGTGCCAGCGGGGCAGGGGACAGGGTTCAGCCCCAGCATTTT	CASGAGDRVQPQHF	TRBV28	TRBJ1-5
TGTGCCAGCAGCCAAGTCGCGAGGTCGAAGGGCGAGCAGTACTTC	CASSQVARSKGEQYF	TRBV3-1	TRBJ2-7
TGTGCCAGCAGTCGGCCCACTGAAGCTTTCTTT	CASSRPTEAFF	TRBV6-4	TRBJ1-1
TGTGCCAGCAGCAGTTGGGACAGGGCTCAGCCCCAGCATTTT	CASSSWDRAQPQHF	TRBV9	TRBJ1-5
TGCGCCAGCAGGGTGACTAGCAAGGTCAATGAGCAGTTCTTC	CASRVTSKVNEQFF	TRBV4-1	TRBJ2-1
TGTGCCAGCAGAGTTCTCCCCGACAGCCGGTTAGATACGCAGTATTTT	CASRVLPDSRLDTQYF	TRBV6-1	TRBJ2-3
TGTGCCAGCTGCCGGGACAGGGGGCACAGCTACGAGCAGTACTTC	CASCRDRGHSYEQYF	TRBV7-2	TRBJ2-7
TGCGTGTCCCCTGTGCTAGATGTGGAGACCCAGTACTTC	CVSPVLDVETQYF	TRBV29-1	TRBJ2-5
TGTGCCAGCAGCAGTCGCAGGGGGCAAAGCTATGGCTACACCTTC	CASSSRRGQSYGYTF	TRBV5-6	TRBJ1-2
TGTGCCAGCAGCCCGGGGAAAGGAGGCGAGCAGTACTTC	CASSPGKGGEQYF	TRBV7-6	TRBJ2-7
TGCGCCAGCAGCTTGGTTCCCCTTGGGGGGGACTATGGCTACACCTTC	CASSLVPLGGDYGYTF	TRBV5-1	TRBJ1-2
TGTGCCAGCAGCCCTCCCCGGGATCCCCCCCCTTCATCAGGGGGACCGCCTCGCCGCTTCATAAAGTACGAGCAGTACTTC	CASSPPRDPPPSSGGPPRRFIKYEQYF	TRBV6-4	TRBJ2-7
TGTGCCAGCAGCAAAGGACTAATAAGCACAGATACGCAGTATTTT	CASSKGLISTDTQYF	TRBV13	TRBJ2-3
TGTGCCAGTTGGACAGGGCCTGAGGGTGAAAAACTGTTTTTT	CASWTGPEGEKLFF	TRBV6-4	TRBJ1-4
TGTGCCAGCAGTATGGCGGGGACTAGCGGCGCCGGGCAGTACTTC	CASSMAGTSGAGQYF	TRBV6-5	TRBJ2-7
TGTGCCAGCAGCCACTCACCACTAGGCGGCACCGGGGAGCTGTTTTTT	CASSHSPLGGTGELFF	TRBV3-1	TRBJ2-2
TGTGCCATCACCCCTGCGGTCAACTACGAGCAGTACTTC	CAITPAVNYEQYF	TRBV10-3	TRBJ2-7
TGTGCCAGCAGTTTCCAGGTTAGGGGAGGGCCCTATGGCTACACCTTC	CASSFQVRGGPYGYTF	TRBV12-4	TRBJ1-2
TGTGCCACCAGCAGAGAACGAGGGACAGGGTATGGCTACACCTTC	CATSRERGTGYGYTF	TRBV15	TRBJ1-2
TGTGCCAGCAGTGTCGGGACTAGCGGGAGCGGTCCCCTCAATTCACCCCTCCACTTT	CASSVGTSGSGPLNSPLHF	TRBV27	TRBJ1-6
TGTGCTAGCAGCTTACTAACCCTAACCAGGAGGGGGTACCGAGGTGGCTACACCTTC	CASSLLTLTRRGYRGGYTF	TRBV7-7	TRBJ1-2
TGCGCCAGCAGTTCTACATACAGGATAATGAGCTCCTATAATTCACCCCTCCACTTT	CASSSTYRIMSSYNSPLHF	TRBV10-1	TRBJ1-6
TGTGCCAGCAGTGACTCTCCCCCACCGGACACTAATGAAAAACTGTTTTTT	CASSDSPPPDTNEKLFF	TRBV6-4	TRBJ1-4
TGTGCCACCAGTACAGCGGTGACGCAGTATTTT	CATSTAVTQYF	TRBV24-1	TRBJ2-3
TGTGCCAGCAGTGAAGGGACCGCAGGGGTCGATGAAAAACTGTTTTTT	CASSEGTAGVDEKLFF	TRBV6-1	TRBJ1-4
TGTGCCAGCAGCCACCCTAGCGGGTCAAGCTCCTACAATGAGCAGTTCTTC	CASSHPSGSSSYNEQFF	TRBV4-2	TRBJ2-1
TGTGCCAGCAGCTTAGACCTCCCCCTTCTAGCGGCTACTGTCAAAACCTACAATGAGCAGTTCTTC	CASSLDLPLLAATVKTYNEQFF	TRBV11-2	TRBJ2-1
TGCGCCAGCAGCTTGGGGGTTGGGACTAGGAGGTACAATGAGCAGTTCTTC	CASSLGVGTRRYNEQFF	TRBV5-1	TRBJ2-1
TGTGCCAGCAGTTACGGTCTAACACACCGGGGGGCCCGAAACATTCAGTACTTC	CASSYGLTHRGARNIQYF	TRBV6-3	TRBJ2-4
TGTGCCACCATTTTACCCCAGAAACATGGCTGGAGCCGGGACCCCGCCTCAAGCTATGGCTACACCTTC	CATILPQKHGWSRDPASSYGYTF	TRBV24-1	TRBJ1-2
TGTGCCAGCATGTTGCCGCGGGTCTTGGAAGCCAAAAACATTCAGTACTTC	CASMLPRVLEAKNIQYF	TRBV9	TRBJ2-4
TGTGCCTGGGTAGAACACGGGACTAGCGGGGGGCTGGGGGACACCAATGAGCAGTTCTTC	CAWVEHGTSGGLGDTNEQFF	TRBV30	TRBJ2-1
TGCGCCAGCAGCCTAGACAGGGGGCAAAGTAATGAAAAACTGTTTTTT	CASSLDRGQSNEKLFF	TRBV4-3	TRBJ1-4
TGTGCCAGCAGTGGGGGCCCGCCGACAGGGTCCTCTGGAAACACCATATATTTT	CASSGGPPTGSSGNTIYF	TRBV6-4	TRBJ1-3
TGCGCCAGCGGACAGGGGAACAGCTCCTACGAGCAGTACTTC	CASGQGNSSYEQYF	TRBV10-1	TRBJ2-7
TGTGCCAGCAGTTTAAAAGACAGGGGGGTCCAGAGCTATGGCTACACCTTC	CASSLKDRGVQSYGYTF	TRBV27	TRBJ1-2
TGTGCCAGCAGTTCTAGAGGGGACACCGGGGAGCTGTTTTTT	CASSSRGDTGELFF	TRBV7-2	TRBJ2-2
TGTGCCAGCAGAAGTAAACAGTATAGGCGTGTCTGGACTGGCTACACCTTC	CASRSKQYRRVWTGYTF	TRBV7-9	TRBJ1-2
TGTGCCAGCAGTGACTCCCCAGCATCCAATGAGCAGTTCTTC	CASSDSPASNEQFF	TRBV6-4	TRBJ2-1
TGCGCCAGCAGCTTTGGGACAAGCTACGAGCAGTACTTC	CASSFGTSYEQYF	TRBV5-1	TRBJ2-7
TGTGCCAGCAGCTCCGGGACAGGGGATCGGACCCAGTACTTC	CASSSGTGDRTQYF	TRBV11-2	TRBJ2-5
TGTGCTAGTGGTCCCCTGGGGATCTTGACAGGGGCTTCCACGAACACTGAAGCTTTCTTT	CASGPLGILTGASTNTEAFF	TRBV12-5	TRBJ1-1
TGTGCCAGCAGTGAAGTTGGGGACAGGGGAGTTAACACTGAAGCTTTCTTT	CASSEVGDRGVNTEAFF	TRBV6-1	TRBJ1-1
TGTGCCAGCAGCCTGGGGGGACAGGGATATCAGCCCCAGCATTTT	CASSLGGQGYQPQHF	TRBV9	TRBJ1-5
TGTGCCAGTAGTATTCAAAATGCCAGTTGTGTCACGGATTTCGGGGAGCTGTTTTTT	CASSIQNASCVTDFGELFF	TRBV19	TRBJ2-2
TGCGCCAGCAATGCGGGCAATACCTACAATGAGCAGTTCTTC	CASNAGNTYNEQFF	TRBV10-1	TRBJ2-1
TGTGCCAGCAGTGGCGGCTGTCTCAGACGGTATAGCAATCAGCCCCAGCATTTT	CASSGGCLRRYSNQPQHF	TRBV6-1	TRBJ1-5
TGCAGCGTTGATAGACGACTGTGCGAGCAGTACTTC	CSVDRRLCEQYF	TRBV29-1	TRBJ2-7
TGTGCCAGCGCCGCGGGGGATGAGCAGTTCTTC	CASAAGDEQFF	TRBV6-8	TRBJ2-1
TGCGCCAGCAGCGACGTACAGCCCCAGCATTTT	CASSDVQPQHF	TRBV10-1	TRBJ1-5
TGTGCCAGCAGTGATTGGGGGGCACGGGGTGGCTCTGGGGCCAACGTCCTGACTTTC	CASSDWGARGGSGANVLTF	TRBV6-4	TRBJ2-6
TGTGCCAGCAGCGCGCTCCAACGAAGAGACCAAGAGACCCAGTACTTC	CASSALQRRDQETQYF	TRBV11-3	TRBJ2-5
TGTGCCATTACGACTAGGCAGGCCTACGAGCAGTACTTC	CAITTRQAYEQYF	TRBV6-2	TRBJ2-7
TGTGCCAGCAGTTCAACAGGGGATGCACTTAGGGACACCGGGGAGCTGTTTTTT	CASSSTGDALRDTGELFF	TRBV27	TRBJ2-2
TGTGCCAGCAGCAAAGAGTCTTTGGTGCAGGGTGGGGGCTATAATTCACCCCTCCACTTT	CASSKESLVQGGGYNSPLHF	TRBV7-3	TRBJ1-6
TGTGCCAGCAGCTTGTCCCGGGACAGGGGGCAGGCCTACGAGCAGTACTTC	CASSLSRDRGQAYEQYF	TRBV7-9	TRBJ2-7
TGTGCCAGCAGAAACTGGACAGGGGCCACTGGAAACACCATATATTTT	CASRNWTGATGNTIYF	TRBV11-3	TRBJ1-3
TGTGCCAGCAGCTTGGACCCACCCGGACTAGCGGGCGCCTACGAGCAGTACTTC	CASSLDPPGLAGAYEQYF	TRBV5-6	TRBJ2-7
TGTGCCAGCAGGGGGACAGGGTACACCTTC	CASRGTGYTF	TRBV11-2	TRBJ1-2
TGCGCCAGCACGAGGGGGGGCCCGCAGCCCCAGCATTTT	CASTRGGPQPQHF	TRBV10-2	TRBJ1-5
TGTGCCACCAGTGCAACTAGCGGGCGGGACGAGACCCAGTACTTC	CATSATSGRDETQYF	TRBV24-1	TRBJ2-5
TGTGCCAGTAGTAGGGACGGTAGCAATCAGCCCCAGCATTTT	CASSRDGSNQPQHF	TRBV19	TRBJ1-5
TGTGCCAGTTTTTTTAGGCTGGACACAGACGAGCAGTACTTC	CASFFRLDTDEQYF	TRBV28	TRBJ2-7
TGTGCCACCAGCAGACGGAGCGTGGGTAACACTGAAGCTTTCTTT	CATSRRSVGNTEAFF	TRBV15	TRBJ1-1
TGTGCCAGCAGCTCCGATCCGGGAGGCTCCTATAATTCACCCCTCCACTTT	CASSSDPGGSYNSPLHF	TRBV13	TRBJ1-6
TGCAGTGCTAGGAAAGGACAGGGGGAAGCAACTAATGAAAAACTGTTTTTT	CSARKGQGEATNEKLFF	TRBV20-1	TRBJ1-4
TGTGCCAGCAGCCCGACAGGGTCACTCGGCTACACCTTC	CASSPTGSLGYTF	TRBV13	TRBJ1-2
TGTGCCAGCTCGACACAATCCGGGGAGCTGTTTTTT	CASSTQSGELFF	TRBV5-6	TRBJ2-2
TGTGCCAGCTCACCGGGGGCTGAAGCTTTCTTT	CASSPGAEAFF	TRBV18	TRBJ1-1
TGTGCCAGCAGCGAGGGGACTAACAAGGCCCCCCAAGAGACCCAGTACTTC	CASSEGTNKAPQETQYF	TRBV7-2	TRBJ2-5
TGTGCCAGGGGGGGGAAGACCCAGTACTTC	CARGGKTQYF	TRBV9	TRBJ2-5
TGTGCCAGCAAAACTTGGGGGGATCACACCGGGGAGCTGTTTTTT	CASKTWGDHTGELFF	TRBV6-1	TRBJ2-2
TGTGCCAGCAGGCCAGGGAGGGTGGGGAATGAGCAGTTCTTC	CASRPGRVGNEQFF	TRBV6-6	TRBJ2-1
TGTGCCAGCACTTACAGGGGCCGCATCACCGGGGAGCTGTTTTTT	CASTYRGRITGELFF	TRBV27	TRBJ2-2
TGCAGCGAGAGGGACAGGCACAGCTCCTACGAGCAGTACTTC	CSERDRHSSYEQYF	TRBV29-1	TRBJ2-7
TGTGCCAGCAGTCTCTCGAACAAGACAAGGGTAAAACTTTCACCCCTCCACTTT	CASSLSNKTRVKLSPLHF	TRBV27	TRBJ1-6
TGTGCCAGCAGCGGGCGGGGACAGTATAATTCACCCCTCCACTTT	CASSGRGQYNSPLHF	TRBV7-3	TRBJ1-6
TGTGCTAGTGGACCAAGTACGGGTCACGAGCAGTACTTC	CASGPSTGHEQYF	TRBV12-5	TRBJ2-7
TGTGCCAGCAGTGTTCAAGGGAGGTGGAACACTGAAGCTTTCTTT	CASSVQGRWNTEAFF	TRBV6-1	TRBJ1-1
TGTGCCAGCAGCGGCCCAGCGGAGCAGTACTTC	CASSGPAEQYF	TRBV11-3	TRBJ2-7
TGTGCCATCGGGCGGAACAATCAGCCCCAGCATTTT	CAIGRNNQPQHF	TRBV10-3	TRBJ1-5
TGCGCCAGCAGCTTGGAATCAGCGGGGGGACGCGAGCAGTACTTC	CASSLESAGGREQYF	TRBV5-1	TRBJ2-7
TGTGCCACCAGTGATTTGCGCGGGGAAAAACTGTTTTTT	CATSDLRGEKLFF	TRBV24-1	TRBJ1-4
TGTGCCAGCAGAAGCGGGGGGGAGTGCACAGATACGCAGTATTTT	CASRSGGECTDTQYF	TRBV27	TRBJ2-3
TGTGCCAGCAGCTGCAGGGGCTCGGATAATCAGCCCCAGCATTTT	CASSCRGSDNQPQHF	TRBV6-5	TRBJ1-5
TGCGCCAGCAGCTTGCCCCGAGGGAGCTACGAGCAGTACTTC	CASSLPRGSYEQYF	TRBV5-1	TRBJ2-7
TGTGCCAGCAGCTTAGGGGGGGCCTACAATGAGCAGTTCTTC	CASSLGGAYNEQFF	TRBV7-2	TRBJ2-1
TGTGCCAGCAGCTCGGGCAGGGGACGTAGCTTTGGGCTTGAAGCTTTCTTT	CASSSGRGRSFGLEAFF	TRBV5-4	TRBJ1-1
TGTGCCTGGAAAAACGGGGGGATTATTCAGCCCCAGCATTTT	CAWKNGGIIQPQHF	TRBV30	TRBJ1-5
TGTGCCAGCAGCGTAGCTCGGGGGGGGGTGACCGGGGAGCTGTTTTTT	CASSVARGGVTGELFF	TRBV9	TRBJ2-2
TGTGCCAGTAGTATTCGGCAGTGTACCGGGGAGCTGTTTTTT	CASSIRQCTGELFF	TRBV19	TRBJ2-2
TGTGCCAGCAGCTACGAGGGTGGGGGGAATAATTCACCCCTCCACTTT	CASSYEGGGNNSPLHF	TRBV7-3	TRBJ1-6
TGTGCCCGGCAGGGACGTGGGCGCTATGGCTACACCTTC	CARQGRGRYGYTF	TRBV30	TRBJ1-2
TGTGCCAGCAGCCGGGGGGGGGGGGGGTACGGGGAGCTGTTTTTT	CASSRGGGGYGELFF	TRBV6-1	TRBJ2-2
TGTGCCAGCAGTTTCCGCCGGGTCCGGTACAATGAGCAGTTCTTC	CASSFRRVRYNEQFF	TRBV27	TRBJ2-1
TGTGCCAGCAGCGTAGCTGTGGAGGGTGGGAATGAAAAACTGTTTTTT	CASSVAVEGGNEKLFF	TRBV9	TRBJ1-4
TGTGCCAGCAGCTCCCTGGGGAGGGGCAGGAGGGACGAGCAGTACTTC	CASSSLGRGRRDEQYF	TRBV5-6	TRBJ2-7
TGTGCCAGCAGTTGGGACAGAGCTGGGGCCAACGTCCTGACTTTC	CASSWDRAGANVLTF	TRBV28	TRBJ2-6
TGTGCCAGCAGCTCCCGGGACAGGGGGCATCTCACAGATACGCAGTATTTT	CASSSRDRGHLTDTQYF	TRBV13	TRBJ2-3
TGTGCCAGCAGCTTGGGACTAGCGGGGGGATTAGACAATGAGCAGTTCTTC	CASSLGLAGGLDNEQFF	TRBV7-9	TRBJ2-1
TGTGCCAGCAGTTTAGCTTATCAGGACAGGGGGACCTACGAGCAGTACTTC	CASSLAYQDRGTYEQYF	TRBV12-4	TRBJ2-7
TGTGCCAGCAGTTACGTGGGGGGGCCCCCTTGGACACAGTACAATGAGCAGTTCTTC	CASSYVGGPPWTQYNEQFF	TRBV6-6	TRBJ2-1
TGTGCCAGCAGTGAGGTGACAGGGAGCACTGAAGCTTTCTTT	CASSEVTGSTEAFF	TRBV25-1	TRBJ1-1
TGCGCCAGCAGCCTCAGGGGGGCGACTTACACCGGGGAGCTGTTTTTT	CASSLRGATYTGELFF	TRBV4-1	TRBJ2-2
TGCGCCAGCGACCATCAGACTCCTAACTATGGCTACACCTTC	CASDHQTPNYGYTF	TRBV5-1	TRBJ1-2
TGTGCCAGCAGTGCGGGACTAGCGGGTTACTCTGGGGCCAACGTCCTGACTTTC	CASSAGLAGYSGANVLTF	TRBV6-5	TRBJ2-6
TGTGCCAGTAGTAACGGGGGGTGTACGGACAGGGGACCGTACGAGCAGTACTTC	CASSNGGCTDRGPYEQYF	TRBV19	TRBJ2-7
TGTGCCAGCAGTCCAGGTGGACAGCATCGCTCAACCGGGGAGCTGTTTTTT	CASSPGGQHRSTGELFF	TRBV2	TRBJ2-2
TGCGCCAGCAAGTACAAAGAGACCCAGTACTTC	CASKYKETQYF	TRBV10-1	TRBJ2-5
TGTGCCTGGAGCCCCCCGGGACAGAGCTCTGGAAACACCATATATTTT	CAWSPPGQSSGNTIYF	TRBV30	TRBJ1-3
TGTGCCAGCAGCTCGGGGTGGGTAGATGGCTACACCTTC	CASSSGWVDGYTF	TRBV9	TRBJ1-2
TGCGCCAGCACCCAATGGGGGGGTAGCTCCTATAATTCACCCCTCCACTTT	CASTQWGGSSYNSPLHF	TRBV10-1	TRBJ1-6
TGCGCCAGCAGCTCCAGACAGACGGGACAGGAAGAAAATAGCAATCAGCCCCAGCATTTT	CASSSRQTGQEENSNQPQHF	TRBV5-1	TRBJ1-5
TGTGCCACCAGTGATCCCCTCCCAAGGGGAATGAACACTGAAGCTTTCTTT	CATSDPLPRGMNTEAFF	TRBV24-1	TRBJ1-1
TGCAGTGCTAGAGATGTTCCGGGACAGGGCCTGATTATCAGCACCGGGGAGCTGTTTTTT	CSARDVPGQGLIISTGELFF	TRBV20-1	TRBJ2-2
TGCAGTGCTCCCCCCGCAGTCAATCAGCCCCAGCATTTT	CSAPPAVNQPQHF	TRBV20-1	TRBJ1-5
TGCGCCAGCAGTGAGTCCGGGGGACAGGGGGGCTCCTACGAGCAGTACTTC	CASSESGGQGGSYEQYF	TRBV10-1	TRBJ2-7
TGTGCCAGCAGCATTGGGACTAGCGGGAGAATCGGCAATGAGCAGTTCTTC	CASSIGTSGRIGNEQFF	TRBV11-2	TRBJ2-1
TGTGCCAGCAGCCAAGCTCCGTCAATGGGGGGCCCGATCTCCTACAATGAGCAGTTCTTC	CASSQAPSMGGPISYNEQFF	TRBV3-1	TRBJ2-1
TGTGCCAGCAGTTATAGACTAGCGGGCTACGAGCAGTACTTC	CASSYRLAGYEQYF	TRBV27	TRBJ2-7
TGCAGTGCTTTGGGACGACGTCACAATGAGCAGTTCTTC	CSALGRRHNEQFF	TRBV20-1	TRBJ2-1
TGTGCCAGCAGAGACCGGGACAGGGGTGCATACGAGCAGTACTTC	CASRDRDRGAYEQYF	TRBV7-7	TRBJ2-7
TGTGCCAGCAGTTACTTAAAGTTACCGGGCCGGGTTATTAGCTCCTACGAGCAGTACTTC	CASSYLKLPGRVISSYEQYF	TRBV6-6	TRBJ2-7
TGTGCCAGCCTCGGGGCCCCGGAGCTCGGGGAGCTGTTTTTT	CASLGAPELGELFF	TRBV27	TRBJ2-2
TGTGCCAGCAGCAGGGGGGCCCCGGCCTCTGGGGCCAACGTCCTGACTTTC	CASSRGAPASGANVLTF	TRBV13	TRBJ2-6
TGTGCCAGCAGTTTACTTGAACCAGGGGATACCTATAATTCACCCCTCCACTTT	CASSLLEPGDTYNSPLHF	TRBV12-3	TRBJ1-6
TGTGCCAGCAGCTTTTCGAGGGACGAAAAACTGTTTTTT	CASSFSRDEKLFF	TRBV7-8	TRBJ1-4
TGTGCCACCTTGGGAGAAGACAGGGGGAACACTGAAGCTTTCTTT	CATLGEDRGNTEAFF	TRBV15	TRBJ1-1
TGTGCCAGTAGAATTAAATCCCTCCGGGACAGGAATGAAAAACTGTTTTTT	CASRIKSLRDRNEKLFF	TRBV19	TRBJ1-4
TGCAGTGCTAGAGTCGATAAAGACAGGGGGCCTGTTGACAATCAGCCCCAGCATTTT	CSARVDKDRGPVDNQPQHF	TRBV20-1	TRBJ1-5
TGTGCCAGCAGCCGCCGACTAGCGGGGCACAATGAGCAGTTCTTC	CASSRRLAGHNEQFF	TRBV3-1	TRBJ2-1
TGTGCCAGCAGCTCGGGAAGGAATGGCTACACCTTC	CASSSGRNGYTF	TRBV7-4	TRBJ1-2
TGTGCCAGCAGTGAATACAGGGTCAATGAAAAACTGTTTTTT	CASSEYRVNEKLFF	TRBV6-1	TRBJ1-4
TGTGCCAGCAGTTTATGTTTATGTAATTCACCCCTCCACTTT	CASSLCLCNSPLHF	TRBV27	TRBJ1-6
TGTGCCAGCAGCCGTCATCGGACAGGGGTGAACACTGAAGCTTTCTTT	CASSRHRTGVNTEAFF	TRBV7-3	TRBJ1-1
TGTGCCAGCAGTCCGGGGGGCCGGTCCTACGAGCAGTACTTC	CASSPGGRSYEQYF	TRBV6-5	TRBJ2-7
TGTGCCAGCAGCTTCTCGAAGACGTCCGGGACAGGAGAAGACTATGGCTACACCTTC	CASSFSKTSGTGEDYGYTF	TRBV5-8	TRBJ1-2
TGTGCCAACATGGGACAGGGGTCACCCCTCCACTTT	CANMGQGSPLHF	TRBV10-3	TRBJ1-6
TGTGCCAGCAGTTTTAAAACAGGGGGCCTAAGCTACGAGCAGTACTTC	CASSFKTGGLSYEQYF	TRBV27	TRBJ2-7
TGCGCCAGCAGCTGGGACGGTGAGACCCAGTACTTC	CASSWDGETQYF	TRBV5-1	TRBJ2-5
TGTGCCATGGGGCTTCGGCTTTGGATGGGGGGCGTCTACGAGCAGTACTTC	CAMGLRLWMGGVYEQYF	TRBV27	TRBJ2-7
TGTGCCAGCAGCTCGGAGCCTGAAAAGGGACAGGGTTTATATAGCAATCAGCCCCAGCATTTT	CASSSEPEKGQGLYSNQPQHF	TRBV11-3	TRBJ1-5
TGTGCCAGCGACGCCATAAACACCGGGGAGCTGTTTTTT	CASDAINTGELFF	TRBV7-3	TRBJ2-2
TGTGCCACCACGGGACAGGGATTAGCCAAAAACATTCAGTACTTC	CATTGQGLAKNIQYF	TRBV24-1	TRBJ2-4
TGTGCCAGCAGTTTGGCCGATAGGTACGAGCAGTACTTC	CASSLADRYEQYF	TRBV6-3	TRBJ2-7
TGTGCCAGCAGCTTGAAATTCAGGACAGGGGGCCACGAGCAGTACTTC	CASSLKFRTGGHEQYF	TRBV7-3	TRBJ2-7
TGTGCCAGCAGCTTAGCGGGACAGCGCGGATACAATGAGCAGTTCTTC	CASSLAGQRGYNEQFF	TRBV7-2	TRBJ2-1
TGTGCCAGCAGTGATACTAATCTGAGGATCCTTAATCAGCCCCAGCATTTT	CASSDTNLRILNQPQHF	TRBV6-1	TRBJ1-5
TGCAGTGCTGTGGACAGAGCTACTGAAGCTTTCTTT	CSAVDRATEAFF	TRBV20-1	TRBJ1-1
TGTGCCAGCAGCTTTTTGTGGACAGGAAACGACCGTTCACCCCTCCACTTT	CASSFLWTGNDRSPLHF	TRBV11-2	TRBJ1-6
TGTGCCAGCAGCCACAGGGCCCCTGAGGCCTATGGCTACACCTTC	CASSHRAPEAYGYTF	TRBV7-9	TRBJ1-2
TGTGCCAGCAGTTTCTCCCCGTCAGCTACAGCCCTTCAGCCCCAGCATTTT	CASSFSPSATALQPQHF	TRBV28	TRBJ1-5
TGTGCCAGCAGTAACTACAGGGATTCTGCTGGGGCCAACGTCCTGACTTTC	CASSNYRDSAGANVLTF	TRBV6-3	TRBJ2-6
TGTGCCAGCAGTTTACAGGGCTCTGGAAACACCATATATTTT	CASSLQGSGNTIYF	TRBV28	TRBJ1-3
TGTGCCAGCAGCACATGGGACAGGGGTGCAGATACGCAGTATTTT	CASSTWDRGADTQYF	TRBV5-5	TRBJ2-3
TGTGCCAGCAGCTTGTACGAAGGACAGGTTGGCTCTTCCTATAATTCACCCCTCCACTTT	CASSLYEGQVGSSYNSPLHF	TRBV11-2	TRBJ1-6
TGTGCCAGCAGTTACGTACTCGCGGCCCCCTCCCAGTACTTC	CASSYVLAAPSQYF	TRBV27	TRBJ2-5
TGTGCCAGCACTAAGGGGGAAAGCTCCTACAATGAGCAGTTCTTC	CASTKGESSYNEQFF	TRBV6-1	TRBJ2-1
TGTGCCAGCAGCCAACAGCGGAGGTATAGCAATCAGCCCCAGCATTTT	CASSQQRRYSNQPQHF	TRBV3-1	TRBJ1-5
TGTGCCAGCAGGGTCCCTACCGGGGGGAGAAACACCATATATTTT	CASRVPTGGRNTIYF	TRBV12-3	TRBJ1-3
TGTGCCAGCAGCACATGGACAGATGGTAATGAAAAACTGTTTTTT	CASSTWTDGNEKLFF	TRBV7-9	TRBJ1-4
TGTGCCAGCAGCCAAGCCCATCGTCGACATAGCAATCAGCCCCAGCATTTT	CASSQAHRRHSNQPQHF	TRBV4-2	TRBJ1-5
TGTGCCAGCAGCTCGAACGACCGACGAGACACCGGGGAGCTGTTTTTT	CASSSNDRRDTGELFF	TRBV7-2	TRBJ2-2
TGTGCCAGCAGCGTAGCCGGGGGTGGCTACGAGCAGTACTTC	CASSVAGGGYEQYF	TRBV9	TRBJ2-7
TGTGCCAGCAGCGGACCCGCGGGAGAGTTAAGACCCACAGATACGCAGTATTTT	CASSGPAGELRPTDTQYF	TRBV11-2	TRBJ2-3
TGTGCCAGCAGCCAAGAATGGGGGAATGAGCAGTTCTTC	CASSQEWGNEQFF	TRBV14	TRBJ2-1
TGTGCCAGCTGGACAGTACTTCAGCCCCAGCATTTT	CASWTVLQPQHF	TRBV7-2	TRBJ1-5
TGTGCCAGCAGTTACGCGATTAATGGGACCAGGCCAGATACGCAGTATTTT	CASSYAINGTRPDTQYF	TRBV6-3	TRBJ2-3
TGTGCCAGCAGCCAAGATATGGCCGGCGAGCAGTACTTC	CASSQDMAGEQYF	TRBV3-1	TRBJ2-7
TGCAGCGTTGAAGATCGGTTCAGGGCACAGGGGACAACGGAGACCCAGTACTTC	CSVEDRFRAQGTTETQYF	TRBV29-1	TRBJ2-5
TGTGCCAGCAGCTTGGGGTACGTTGCGTACGAGCAGTACTTC	CASSLGYVAYEQYF	TRBV7-2	TRBJ2-7
TGTGCCAGCAGCCACCCGTCCAGGGCGGTCCTCCCTGAAGCTTTCTTT	CASSHPSRAVLPEAFF	TRBV14	TRBJ1-1
TGTGCCAGCAGTGCAGCAGGGCAGCCCCAGCATTTT	CASSAAGQPQHF	TRBV6-4	TRBJ1-5
TGCGCCAGCAGCTTCCCTGGGGCATGCCCCCGATCCTACGAGCAGTACTTC	CASSFPGACPRSYEQYF	TRBV5-1	TRBJ2-7
TGTGCCAGCAGCGGACAGTCTGGGGCCAACGTCCTGACTTTC	CASSGQSGANVLTF	TRBV6-3	TRBJ2-6
TGTGCCAGCAGCGCGGACACGAACTATGGCTACACCTTC	CASSADTNYGYTF	TRBV7-4	TRBJ1-2
TGTGCCAGCAGTCCAGGGACAGTAAGGCTACGGAACACTGAAGCTTTCTTT	CASSPGTVRLRNTEAFF	TRBV6-1	TRBJ1-1
TGTGCCAGCAGGGGAAGGGGGGATGAGCAGTTCTTC	CASRGRGDEQFF	TRBV13	TRBJ2-1
TGCGCCAGCAGCGGGGGATCGCTAGAATCCGCCGCTGGAAACACCATATATTTT	CASSGGSLESAAGNTIYF	TRBV5-1	TRBJ1-3
TGTGCCAGCAGCGTAGCGGGTTGGAGCTCCTACAATGAGCAGTTCTTC	CASSVAGWSSYNEQFF	TRBV9	TRBJ2-1
TGTGCCAGCAGTTTCTCCGGGACTAGCGGGAGGAAGGGCACAGATACGCAGTATTTT	CASSFSGTSGRKGTDTQYF	TRBV6-6	TRBJ2-3
TGTGCCAGCAGTGAATGGAAACTAGCTTGGGTGGAGACATACGAGCAGTACTTC	CASSEWKLAWVETYEQYF	TRBV25-1	TRBJ2-7
TGTGCCATCAGGAGGTGGCGCCCGGGACAGGGGGGCGGCTCCTACGAGCAGTACTTC	CAIRRWRPGQGGGSYEQYF	TRBV10-3	TRBJ2-7
TGTGCCAGCAGCCAGTACTCTCACGGGGAGCTGTTTTTT	CASSQYSHGELFF	TRBV13	TRBJ2-2
TGTGCCAGCAGTGGGCATGGGGGGGTGAAGGAAAAACTGTTTTTT	CASSGHGGVKEKLFF	TRBV6-4	TRBJ1-4
TGTGCCAGCAGCCAAGACGGGGTCTGGTGCTCGGAGCAGTACTTC	CASSQDGVWCSEQYF	TRBV3-1	TRBJ2-7
TGTGCCTGGAGTTCCCAGTATGGCACCGGGGGTGATACGCAGTATTTT	CAWSSQYGTGGDTQYF	TRBV30	TRBJ2-3
TGTGCCACCAGTGGCGGGGGGTTCAACACCGGGGAGCTGTTTTTT	CATSGGGFNTGELFF	TRBV24-1	TRBJ2-2
TGTGCCAGCAGTGACCAAGACCCCGGGACAGGGGGTGGCAATCAGCCCCAGCATTTT	CASSDQDPGTGGGNQPQHF	TRBV6-4	TRBJ1-5
TGTGCCAGCAGCTTGAACTCTTGGACGAGATTCCAGACCGGGGAGCTGTTTTTT	CASSLNSWTRFQTGELFF	TRBV5-6	TRBJ2-2
TGTGCCAGCAGTATTGGAGGAGACAGTAGGAACACTGAAGCTTTCTTT	CASSIGGDSRNTEAFF	TRBV6-5	TRBJ1-1
TGTGCCAGCAGAGTAAAATCCGGTGGACAACTCAGCACTGAAGCTTTCTTT	CASRVKSGGQLSTEAFF	TRBV12-4	TRBJ1-1
TGTGCCAGCAGCTACCCTTCGGGACTTGGTGAAGCTTTCTTT	CASSYPSGLGEAFF	TRBV13	TRBJ1-1
TGTGCCACCAGTGATTTTCGGGGCTCCCATCCATATCAGCCCCAGCATTTT	CATSDFRGSHPYQPQHF	TRBV24-1	TRBJ1-5
TGTGCCAGCAGCGGGCCTGGGGGGTGGCAGCCCCAGCATTTT	CASSGPGGWQPQHF	TRBV7-3	TRBJ1-5
TGTGCCAGCAGCGCCCGACAGGTCGCCTACGAGCAGTACTTC	CASSARQVAYEQYF	TRBV5-5	TRBJ2-7
TGCAGTGCTACCCTTCCAACCTATAATTCACCCCTCCACTTT	CSATLPTYNSPLHF	TRBV20-1	TRBJ1-6
TGTGCCAGCAGTTTAAGACTAGCGGGGGGGAGGGGACCTTCCTACGAGCAGTACTTC	CASSLRLAGGRGPSYEQYF	TRBV12-4	TRBJ2-7
TGTGCCACCAGTGATCAAGCGGGAGGGGGTCATGAAAAACTGTTTTTT	CATSDQAGGGHEKLFF	TRBV24-1	TRBJ1-4
TGTGCCCCCACAGGGGACGTTTACACCTTC	CAPTGDVYTF	TRBV24-1	TRBJ1-2
TGTGCCAGCAGCAGTCCACAGGCTACTCACACAGATACGCAGTATTTT	CASSSPQATHTDTQYF	TRBV11-3	TRBJ2-3
TGCAGTGCAGGGGAGCGAGGTAATTCACCCCTCCACTTT	CSAGERGNSPLHF	TRBV20-1	TRBJ1-6
TGTGCCAGCAGTGAATGGGGGTTCACTTACAATGAGCAGTTCTTC	CASSEWGFTYNEQFF	TRBV25-1	TRBJ2-1
TGTGCCGCTCCGGGGACAGGGTCGGAACCAGATACGCAGTATTTT	CAAPGTGSEPDTQYF	TRBV24-1	TRBJ2-3
TGTGCCTGGTCTTCAGATACGCAGTATTTT	CAWSSDTQYF	TRBV30	TRBJ2-3
TGCAGTGCCTTCGGGTCACGGGGACTCCACTACGAGCAGTACTTC	CSAFGSRGLHYEQYF	TRBV20-1	TRBJ2-7
TGTGCCAGCAGCATCAGGGGGGAGTTAAGCTCCTACGAGCAGTACTTC	CASSIRGELSSYEQYF	TRBV7-9	TRBJ2-7
TGTGCCAGTAGCGACGTGGGCCCACACACTGAAGCTTTCTTT	CASSDVGPHTEAFF	TRBV19	TRBJ1-1
TGTGCCACAGGATTAGGAGAGTCAGGGTACGAGCAGTACTTC	CATGLGESGYEQYF	TRBV7-9	TRBJ2-7
TGTGCCAGCAGTTACCATGACAGGGGCAATCAGCCCCAGCATTTT	CASSYHDRGNQPQHF	TRBV6-3	TRBJ1-5
TGCAGTGCTGATACCCCCCCCCCCGACCCCCACTACGAGCAGTACTTC	CSADTPPPDPHYEQYF	TRBV20-1	TRBJ2-7
TGTGCCAGCAGCCAAGCGGGGTCCGGGACAGGCCCGAACACTGAAGCTTTCTTT	CASSQAGSGTGPNTEAFF	TRBV3-1	TRBJ1-1
TGTGCCAGCAGGCTAGGGACAGGGGCTTTCTTT	CASRLGTGAFF	TRBV6-2	TRBJ1-1
TGTGCTAGTGGTTGGTTACTGCCTTCCCGGGACACCGGGGAGCTGTTTTTT	CASGWLLPSRDTGELFF	TRBV12-5	TRBJ2-2
TGTGCCAGCAGCGGGGGACAGGGAATAGGCTACACCTTC	CASSGGQGIGYTF	TRBV7-4	TRBJ1-2
TGTGCCCACGTTTGCTATGGCTACACCTTC	CAHVCYGYTF	TRBV6-4	TRBJ1-2
TGTGCCAGACGTCCAGGGAAATACGAGCAGTACTTC	CARRPGKYEQYF	TRBV7-9	TRBJ2-7
TGTGCCAGCAGTTACTCTCCCAGGGGGCGGGGGAAGCCCCAGCATTTT	CASSYSPRGRGKPQHF	TRBV6-6	TRBJ1-5
TGTGCCAGCAGCTTAGGGAGGCGGGGGGGCTACAATGAGCAGTTCTTC	CASSLGRRGGYNEQFF	TRBV7-7	TRBJ2-1
TGTGCCAGCAGCGCGCTCGTTCAAGGGGGCCGGGGCCCCGGGGAGCTGTTTTTT	CASSALVQGGRGPGELFF	TRBV5-6	TRBJ2-2
TGTGCCACCTTAACGGGAGATTACTCCTACGAGCAGTACTTC	CATLTGDYSYEQYF	TRBV24-1	TRBJ2-7
TGCAGTGCCCCTATAGACAGGGCTGAGGGCTACGAGCAGTACTTC	CSAPIDRAEGYEQYF	TRBV20-1	TRBJ2-7
TGTGCCAGCAGCTGGTGGGAGGCAGGGAATGAGCAGTTCTTC	CASSWWEAGNEQFF	TRBV7-6	TRBJ2-1
TGTGCCAGCAGCCAAGGGGGACGTGGTGAGCAGTTCTTC	CASSQGGRGEQFF	TRBV3-1	TRBJ2-1
TGTGCCACCAGTGATTTGCCTGGGCCTAAAGGGGGTGTCGTCCCCTACGAGCAGTACTTC	CATSDLPGPKGGVVPYEQYF	TRBV24-1	TRBJ2-7
TGTGGGAGGTGGACAGGGGGCGGCGGTGTAAGATCACCCCTCCACTTT	CGRWTGGGGVRSPLHF	TRBV7-9	TRBJ1-6
TGCAGTGCACAAACTAGCGGGGCTTACTCCTACGAGCAGTACTTC	CSAQTSGAYSYEQYF	TRBV20-1	TRBJ2-7
TGTGCCAGCAGAAAAGGGACAGGGTGTAGTGCTTTCTTT	CASRKGTGCSAFF	TRBV6-5	TRBJ1-1
TGTGCCAGCAGCTCCTCAGGAAGAAAGGGGTATGAGCAGTATTTT	CASSSSGRKGYEQYF	TRBV7-6	TRBJ2-3
TGTGCCAGCAGCGTCCTACAATTAGGCAGGGTGGCGATGGCGGGGAAGACCCTCCACTTT	CASSVLQLGRVAMAGKTLHF	TRBV9	TRBJ1-6
TGTGCCAGCAGTTCACTAGCGGGAGGGCTACTCAATGAGCAGTTCTTC	CASSSLAGGLLNEQFF	TRBV6-5	TRBJ2-1
TGCAGTGCTAGAGAGGGGACAGCATTCGAGCAGTACTTC	CSAREGTAFEQYF	TRBV20-1	TRBJ2-7
TGCAGTGATCAGTCACCGAATCAGCCCCAGCATTTT	CSDQSPNQPQHF	TRBV20-1	TRBJ1-5
TGCGCCAGCAGAGGAACCATTTTGCCGGAAGGGAACACTGAAGCTTTCTTT	CASRGTILPEGNTEAFF	TRBV10-1	TRBJ1-1
TGTGCCAGCAGTTATCCGGACAGGGATGCCGGTAGCAATCAGCCCCAGCATTTT	CASSYPDRDAGSNQPQHF	TRBV27	TRBJ1-5
TGTGCCAGCAGCAACATTACAGGGAGGTACTATGGCTACACCTTC	CASSNITGRYYGYTF	TRBV7-4	TRBJ1-2
TGTGCCAGCAGCCGGACTAGCGGAGCTAATGAGCAGTTCTTC	CASSRTSGANEQFF	TRBV7-9	TRBJ2-1
TGTGCCGGGCATAGGGAGCTCGTTACAGATACGCAGTATTTT	CAGHRELVTDTQYF	TRBV24-1	TRBJ2-3
TGTGCCAGCAGTTTCCGGGTCGGAAGAATCTATGGCTACACCTTC	CASSFRVGRIYGYTF	TRBV27	TRBJ1-2
TGTGCCAGCAGCTGTCTATTCACAGATACGCAGTATTTT	CASSCLFTDTQYF	TRBV5-5	TRBJ2-3
TGTGCCAGCAGCCAAGGGGTAGGGCCGGAGTATGAGCAGTTCTTC	CASSQGVGPEYEQFF	TRBV3-1	TRBJ2-1
TGTGCCAGCAGTGGACTAGCGGGAGGGGGCCTCTCCTACGAGCAGTACTTC	CASSGLAGGGLSYEQYF	TRBV6-1	TRBJ2-7
TGCAGTGCTAGACCACCGAAATTGACAGGGGCCTTGAACACTGAAGCTTTCTTT	CSARPPKLTGALNTEAFF	TRBV20-1	TRBJ1-1
TGTGCCAGCAGCGACCGGGGACAGACTTGGAATAGCAATCAGCCCCAGCATTTT	CASSDRGQTWNSNQPQHF	TRBV13	TRBJ1-5
TGTGCCAGCAGCCCAGGGGAGCCCCAGCATTTT	CASSPGEPQHF	TRBV13	TRBJ1-5
TGTGCCAGCAGCATGGGACTCAATGAGCAGTTCTTC	CASSMGLNEQFF	TRBV5-6	TRBJ2-1
TGTGCCACCACCGAGGGGGCCTCCACTGAAGCTTTCTTT	CATTEGASTEAFF	TRBV24-1	TRBJ1-1
TGTGCCAGCATAGGGGGGAACTACGAGCAGTACTTC	CASIGGNYEQYF	TRBV7-6	TRBJ2-7
TGTGCCAGCAGTGCTGGGCCTTTCTTT	CASSAGPFF	TRBV27	TRBJ1-1
TGCCAAAGACTCGAAAAACTGTTTTTT	CQRLEKLFF	TRBV20-1	TRBJ1-4
TGCGCCAGCAGCCTCAGGGCTAGCACAGATACGCAGTATTTT	CASSLRASTDTQYF	TRBV5-1	TRBJ2-3
TGTGCCAGCAGCATCACAGGAAATGATGAGCAGTTCTTC	CASSITGNDEQFF	TRBV5-6	TRBJ2-1
TGTGGACACACAGGGAGGGCTCCGGAGCAGTACTTC	CGHTGRAPEQYF	TRBV6-1	TRBJ2-7
TGTGCCAGCAGCTGGACAGCAGCCTTC	CASSWTAAF	TRBV7-9	TRBJ1-2
TGTGCCAGCAGCCAAGGAATAATTCTGAACACTGAAGCTTTCTTT	CASSQGIILNTEAFF	TRBV3-1	TRBJ1-1
TGTGCCAGCAGCTTGGAGACAGGGTGGGGGCAGAACACTGAAGCTTTCTTT	CASSLETGWGQNTEAFF	TRBV11-2	TRBJ1-1
TGTGCCAGCAGTTATCGACCGGGACAGGGAATCACTGAAGCTTTCTTT	CASSYRPGQGITEAFF	TRBV6-5	TRBJ1-1
TGTGCCAGCAGCTTTGTCCGTTCTGGAAACACCATATATTTT	CASSFVRSGNTIYF	TRBV28	TRBJ1-3
TGTGCCAGCAGCGGGACAGTCATCTCTGGAAACACCATATATTTT	CASSGTVISGNTIYF	TRBV7-3	TRBJ1-3
TGTGCCAGCAGCACGTGGACGGGCTATGGCTACACCTTC	CASSTWTGYGYTF	TRBV25-1	TRBJ1-2
TGTGCCAGCAGTTACGACACGCCGGGACAGGGTGAGCGATACACCTTC	CASSYDTPGQGERYTF	TRBV6-5	TRBJ1-2
TGCAGTGCTAGGGACAGGGCCGAGGACTATGGCTACACCTTC	CSARDRAEDYGYTF	TRBV20-1	TRBJ1-2
TGTGCCAGCAGTGCCGGACCGGGACTAGAGACCCAGTACTTC	CASSAGPGLETQYF	TRBV9	TRBJ2-5
TGCAGTGCTAGCCTGACTAGCTACGAGCAGTACTTC	CSASLTSYEQYF	TRBV20-1	TRBJ2-7
TGTGCCAGCAGCGATGGCGACCCCAGGAAACCCCTCCACTTT	CASSDGDPRKPLHF	TRBV7-2	TRBJ1-6
TGTGCCAGCAAGAGCTTGACTAACTATGGCTACACCTTC	CASKSLTNYGYTF	TRBV11-3	TRBJ1-2
TGTGCCAGCAGCTTTAAGGGGTACAGGGTCTCAGTGAACACTGAAGCTTTCTTT	CASSFKGYRVSVNTEAFF	TRBV11-2	TRBJ1-1
TGTGCTAGTGGTTTGCCACAGACAATGGGGTATGAGCAGTTCTTC	CASGLPQTMGYEQFF	TRBV12-5	TRBJ2-1
TGTGCCAGCAGCGAGGGTGGACAACCGTTAATGAACACTGAAGCTTTCTTT	CASSEGGQPLMNTEAFF	TRBV7-2	TRBJ1-1
TGCGCCAGCAGTGAGCATCCCCTCGGGGAGCTGTTTTTT	CASSEHPLGELFF	TRBV10-2	TRBJ2-2
TGTGCCAGCAGCCAAGCCCAGGGCCTTAACACTGAAGCTTTCTTT	CASSQAQGLNTEAFF	TRBV3-1	TRBJ1-1
TGTAGTGGGGAGACTTCACCCCTCCACTTT	CSGETSPLHF	TRBV10-3	TRBJ1-6
TGTGCCAGCAGCGTGATCAGCGGGACTAGCGGGTGCAACAATGAGCAGTTCTTC	CASSVISGTSGCNNEQFF	TRBV9	TRBJ2-1
TGCAGTGCTAGCTTGGACCCGTTGTTCGCCGAGCAGTACTTC	CSASLDPLFAEQYF	TRBV20-1	TRBJ2-7
TGTGCCAGCAGAAGAGCCCATGGCTACACCTTC	CASRRAHGYTF	TRBV27	TRBJ1-2
TGTGCCAGCAGCCAAGATCACCCTGCAACTAATGAAAAACTGTTTTTT	CASSQDHPATNEKLFF	TRBV14	TRBJ1-4
TGTGCCAGCACCTGGACCCTAAGTTCACCCCTCCACTTT	CASTWTLSSPLHF	TRBV6-5	TRBJ1-6
TGTGCCAGCCTAGTACTAGCGGGAGGGCGGATGAACACTGAAGCTTTCTTT	CASLVLAGGRMNTEAFF	TRBV7-3	TRBJ1-1
TGTGCCAGCAGTTTAACGGACAGGGTGCGAAGCAATCAGCCCCAGCATTTT	CASSLTDRVRSNQPQHF	TRBV27	TRBJ1-5
TGCGCCACAGACCCACTAGCGGGAGCCCCCTATGGCTACACCTTC	CATDPLAGAPYGYTF	TRBV10-1	TRBJ1-2
TGTGCCAGCAGTTTTTGGGGTAGAGAGACCCAGTACTTC	CASSFWGRETQYF	TRBV12-3	TRBJ2-5
TGCGCCAGCAGTGAGATCCGGGACAGGGGAGTGCGCCAGCATTTT	CASSEIRDRGVRQHF	TRBV10-1	TRBJ1-5
TGTGCCAGCTCACCACTCGACAGGGGCTTTGAGCAGTACTTC	CASSPLDRGFEQYF	TRBV18	TRBJ2-7
TGTGCCAGCACCGTTGGAGACACCGTGCAAGAGACCCAGTACTTC	CASTVGDTVQETQYF	TRBV7-9	TRBJ2-5
TGTGCCAGCAGGCAATCCCCAAGGGACAGGGGAAATACTATGAACACTGAAGCTTTCTTT	CASRQSPRDRGNTMNTEAFF	TRBV28	TRBJ1-1
TGTGCCAGCAGCTTAGCACAAAAGGGGGAAACCTACAATGAGCAGTTCTTC	CASSLAQKGETYNEQFF	TRBV7-9	TRBJ2-1
TGTGCCAGCGCAAGGGCAGGCTCTGGGGCCAACGTCCTGACTTTC	CASARAGSGANVLTF	TRBV2	TRBJ2-6
TGTGCCAGCAGCCAAGACTCCATCGGGGGTCTTCGTCCTAATGAAAAACTGTTTTTT	CASSQDSIGGLRPNEKLFF	TRBV4-2	TRBJ1-4
TGTGCCAGCAGCCGCAGGGGAACGAGGCAGCCCCAGCATTTT	CASSRRGTRQPQHF	TRBV3-1	TRBJ1-5
TGTGCCGGGACAGGGAGAAGCAATCAGCCCCAGCATTTT	CAGTGRSNQPQHF	TRBV30	TRBJ1-5
TGTGCCAGCAGGATGGATGACAGGGGCAATCAGCCCCAGCATTTT	CASRMDDRGNQPQHF	TRBV6-1	TRBJ1-5
TGTGCTAGTGGTTTGCAGACAGGTTGGTACACTGAAGCTTTCTTT	CASGLQTGWYTEAFF	TRBV12-5	TRBJ1-1
TGTGCCAGCAATAGGGACACTACTGAAGCTTTCTTT	CASNRDTTEAFF	TRBV28	TRBJ1-1
TGTGCCAGCAGTTCCACTAGCGGGAGCGGCGAGCAGTACTTC	CASSSTSGSGEQYF	TRBV6-5	TRBJ2-7
TGCGCCAGCAGCTTCAGGTCCATAGATACGCAGTATTTT	CASSFRSIDTQYF	TRBV5-1	TRBJ2-3
TGTGCCAGCAGCCGTCGGGCAAGAATCGAGCAGTACTTC	CASSRRARIEQYF	TRBV5-4	TRBJ2-7
TGTGCCAGCAGCTTAGGGAACGGGGCGTACCAAGAGACCCAGTACTTC	CASSLGNGAYQETQYF	TRBV11-2	TRBJ2-5
TGTCCCGACAGGCTTTCTGAAGCTTTCTTT	CPDRLSEAFF	TRBV29-1	TRBJ1-1
TGCGCCAGCAGCTTGGTAGGGGTTTGGGGGGGAGCTGATACGCAGTATTTT	CASSLVGVWGGADTQYF	TRBV10-1	TRBJ2-3
TGTGCCAGCAGCTTGAAAATGGAAGGGGGCCCCCAGCATTTT	CASSLKMEGGPQHF	TRBV7-9	TRBJ1-5
TGTGCCAGCAGCACAGCAGGGCATGGGGACTCTGGAAACACCATATATTTT	CASSTAGHGDSGNTIYF	TRBV7-9	TRBJ1-3
TGTGCCATCAGTGCGGGGACTTACGAGCAGTACTTC	CAISAGTYEQYF	TRBV10-3	TRBJ2-7
TGTGCCAGCAGCTTAGCGGGGCGACAGGGGTATGGCTACACCTTC	CASSLAGRQGYGYTF	TRBV7-6	TRBJ1-2
TGTGCCAGTTTTCCCTCTGGGGGCAATGAGCAGTTCTTC	CASFPSGGNEQFF	TRBV6-1	TRBJ2-1
TGTGCCACCAGTGAAGTCGGACAGGGAGGAGGGCAGCTGTTTTTT	CATSEVGQGGGQLFF	TRBV24-1	TRBJ2-2
TGCAGTGCTCAGTCGACAGGCGCTAACTATGGCTACACCTTC	CSAQSTGANYGYTF	TRBV20-1	TRBJ1-2
TGTGCCATCAATACAGGTAGGAATCAGCCCCAGCATTTT	CAINTGRNQPQHF	TRBV10-3	TRBJ1-5
TGCGCCAGCAGCCACTTGCCGGGACTAGTAGAGCAGTACTTC	CASSHLPGLVEQYF	TRBV4-1	TRBJ2-7
TGCAGTGCTAGAGTACCCAGAGGCTACACCTTC	CSARVPRGYTF	TRBV20-1	TRBJ1-2
TGTGCCAGCCCCCATAGTTTAGGACTAAATTCACCCCTCCACTTT	CASPHSLGLNSPLHF	TRBV27	TRBJ1-6
TGTGCCAGCAGCACTGTGGGACAGGAATTTAGCGAGCAGTACTTC	CASSTVGQEFSEQYF	TRBV9	TRBJ2-7
TGTGCCAGCAGGGGTGTGGGGAGTGGGTCACCCCTCCACTTT	CASRGVGSGSPLHF	TRBV6-5	TRBJ1-6
TGTGCCATCAGTGAACTAGCGGGAGGGCGTCACAATGAGCAGTTCTTC	CAISELAGGRHNEQFF	TRBV10-3	TRBJ2-1
TGTGCCAGTAGTAATCGGCAGGGGGCTCATTTCATGAACACTGAAGCTTTCTTT	CASSNRQGAHFMNTEAFF	TRBV19	TRBJ1-1
TGTGCCAGCAGCTTACAGGGAGAAAAACTGTTTTTT	CASSLQGEKLFF	TRBV5-6	TRBJ1-4
TGTGCCAGCAGCCGCCCTTTCCGACTAGCGGGTAGGTACTACGAGCAGTACTTC	CASSRPFRLAGRYYEQYF	TRBV7-8	TRBJ2-7
TGCGCCAGCAGCCGGAAGAAACCGAGGAACTCTGGGGCCAACGTCCTGACTTTC	CASSRKKPRNSGANVLTF	TRBV4-3	TRBJ2-6
TGTGCCTGGAGGGCGGGAGTAGTTTGTGGACATGAGCAGTTCTTC	CAWRAGVVCGHEQFF	TRBV30	TRBJ2-1
TGTGCCACCAGCAGAGTCAGGGGACAGAGGAGCTCCTACGAGCAGTACTTC	CATSRVRGQRSSYEQYF	TRBV15	TRBJ2-7
TGTGCCAGCAGCTTGGCCCGGTTCAACGGGGGGGCTGGAAACACCATATATTTT	CASSLARFNGGAGNTIYF	TRBV5-5	TRBJ1-3
TGTGCCAGCAGCTCTAGAGCCCAGTCGTACGAGCAGTACTTC	CASSSRAQSYEQYF	TRBV7-3	TRBJ2-7
TGTGCCAGCAGTGGGGAGGAGGACAGGGCGAAACTCAGACTTACTGAAGCTTTCTTT	CASSGEEDRAKLRLTEAFF	TRBV6-4	TRBJ1-1
TGTGCCAGCAGCCCGGGACATGCTAACCCGATCTTC	CASSPGHANPIF	TRBV7-3	TRBJ2-1
TGTGCCAGCAGCTTAGACGGGACAGGTTTCGGCTCTGGAAACACCATATATTTT	CASSLDGTGFGSGNTIYF	TRBV7-3	TRBJ1-3
TGTGCCAGCAGTTCGCGGGGGGGGGTGAACTCTGGGGCCAACGTCCTGACTTTC	CASSSRGGVNSGANVLTF	TRBV25-1	TRBJ2-6
TGTGCCAGCAGCGAGAACACTGAAGCTTTCTTT	CASSENTEAFF	TRBV7-3	TRBJ1-1
TGTGCCAGCAGCTCTACGAGGGGGATAAGGGAAGCTTTCTTT	CASSSTRGIREAFF	TRBV7-9	TRBJ1-1
TGTGCCAGCAGCACCGGGACAGGGTTTTATGAAAAACTGTTTTTT	CASSTGTGFYEKLFF	TRBV5-5	TRBJ1-4
TGTGCCAGCATATTAAACAGGGTAAGGGAAAATGAAAAACTGTTTTTT	CASILNRVRENEKLFF	TRBV6-3	TRBJ1-4
TGTGCCAGCAGCACGGGGGGCCACCTAAGGTACATTCAGTACTTC	CASSTGGHLRYIQYF	TRBV5-6	TRBJ2-4
TGTGCCAGCTCACCAGGTGACAGGGCACAAGAGACCCAGTACTTC	CASSPGDRAQETQYF	TRBV18	TRBJ2-5
TGTGCCAGCAGCGTTTTCCCCGCGCCAAACGGGACAGGGGAAGAGTACTTC	CASSVFPAPNGTGEEYF	TRBV9	TRBJ2-7
TGCAGTGCTAGGACAGATACGCAGTATTTT	CSARTDTQYF	TRBV20-1	TRBJ2-3
TGTGCCAGCAGCGACAGGGGGGTGGCCTACGAGCAGTACTTC	CASSDRGVAYEQYF	TRBV13	TRBJ2-7
TGTGCCATCAGTGAGGGGACAGTGAGGTGGGATTACACTGAAGCTTTCTTT	CAISEGTVRWDYTEAFF	TRBV10-3	TRBJ1-1
TGTGCCAGCTCACCGACAGGGCCCGGAAACACCATATATTTT	CASSPTGPGNTIYF	TRBV18	TRBJ1-3
TGTGCCAGGCCGGGCATGAACACTGAAGCTTTCTTT	CARPGMNTEAFF	TRBV7-2	TRBJ1-1
TGTGCCAGCAGTGAAATGATAGACAATGAGCAGTTCTTC	CASSEMIDNEQFF	TRBV6-4	TRBJ2-1
TGTGCCAGCAGCCCCCGATCAACTAAGCCAAATGAAAAACTGTTTTTT	CASSPRSTKPNEKLFF	TRBV7-4	TRBJ1-4
TGTGCCAGCAGCCAAGATAACTTCTCGACAGGCTACACAGATACGCAGTATTTT	CASSQDNFSTGYTDTQYF	TRBV3-1	TRBJ2-3
TGTGCCAGCAGCGGCCCGGCGCCCGGACAGTCGGAATATGAAAAACTGTTTTTT	CASSGPAPGQSEYEKLFF	TRBV3-1	TRBJ1-4
TGCGCCAGCAGCTTGGGGCCCAGGAATAACTCCTACAATGAGCAGTTCTTC	CASSLGPRNNSYNEQFF	TRBV5-1	TRBJ2-1
TGTGCCAGCAGCGTCAACGGGAACAATGAGCAGTTCTTC	CASSVNGNNEQFF	TRBV6-5	TRBJ2-1
TGCGCCAGCAGGGGGGTGGACTATGGCTACACCTTC	CASRGVDYGYTF	TRBV10-2	TRBJ1-2
TGTGCCACACGCCGGAGGGGGCGCAATCAGCCCCAGCATTTT	CATRRRGRNQPQHF	TRBV24-1	TRBJ1-5
TGCGCCAGCAACACAGGGGCCTACGAGCAGTACTTC	CASNTGAYEQYF	TRBV10-1	TRBJ2-7
TGTGCCACCAGTGATTGGAGACAGGGGGCGGATAATGAAAAACTGTTTTTT	CATSDWRQGADNEKLFF	TRBV24-1	TRBJ1-4
TGCAGTGCTAGCCCAGGGACTGCCACAGATACGCAGTATTTT	CSASPGTATDTQYF	TRBV20-1	TRBJ2-3
TGCGCCAGCAGTGAGTCCCGGTACCGGACAGAGAGACAGCCCCAGCATTTT	CASSESRYRTERQPQHF	TRBV10-1	TRBJ1-5
TGTGCCACCAGTAACCGTGGAGCAGGCACTGAAGCTTTCTTT	CATSNRGAGTEAFF	TRBV24-1	TRBJ1-1
TGTGCCAGCATAGAAGGTGACAGAGGTGAGCAGTACTTC	CASIEGDRGEQYF	TRBV7-9	TRBJ2-7
TGTGCCAGCAGCAATCGGTTCCCGGACAGGCCCCCAGAGACCCAGTACTTC	CASSNRFPDRPPETQYF	TRBV13	TRBJ2-5
TGTGCCAGCAGCTTGAAAAGTGTGCGGGCCGATACGCAGTATTTT	CASSLKSVRADTQYF	TRBV5-4	TRBJ2-3
TGTGCCTGGAGTGTATCCAAAGCCCTTTCCTTTCTAGAGCAGTTCTTC	CAWSVSKALSFLEQFF	TRBV30	TRBJ2-1
TGCAGCGTTGCGTCTCTCCGGGGCGCTCCAAGCTATGGCTACACCTTC	CSVASLRGAPSYGYTF	TRBV29-1	TRBJ1-2
TGTGCTAGTGGTTTGACGGGGACAAGCAATCAGCCCCAGCATTTT	CASGLTGTSNQPQHF	TRBV12-5	TRBJ1-5
TGCAGCGTTTCCCAGCTAGGTACTCCAGAGACCCAGTACTTC	CSVSQLGTPETQYF	TRBV29-1	TRBJ2-5
TGCGCCAGCAGCATCCGCGGACAGGGTAATACGCAGTATTTT	CASSIRGQGNTQYF	TRBV4-1	TRBJ2-3
TGTGCCAGCAGCTTGGTCGCGACCAGCTCCTACAATGAGCAGTTCTTC	CASSLVATSSYNEQFF	TRBV5-6	TRBJ2-1
TGTGCCACAGGGGAAAACTCTGGAAACACCATATATTTT	CATGENSGNTIYF	TRBV24-1	TRBJ1-3
TGTGCCAGCAGCCGGGGACAGGGGGCGGGGGAACCTGAAGCTTTCTTT	CASSRGQGAGEPEAFF	TRBV7-3	TRBJ1-1
TGTGCCAGCAGTAAGATGGGACAGGGGACGCCCCTCCACTTT	CASSKMGQGTPLHF	TRBV27	TRBJ1-6
TGCGCCAGCAGTGTCCCCTCGCAGGTTAGCACAGATACGCAGTATTTT	CASSVPSQVSTDTQYF	TRBV10-1	TRBJ2-3
TGTGCCAGCAGCTTAACGGAGGCCTCCTACGAGCAGTACTTC	CASSLTEASYEQYF	TRBV7-6	TRBJ2-7
TGTGCCAGCAGCGGGCCGTCTGGCCGGGACAGGTGGAATCAGCCCCAGCATTTT	CASSGPSGRDRWNQPQHF	TRBV13	TRBJ1-5
TGTGCCAGCAGCAGATTGGACAGGGTGTTTGAGCAGTACTTC	CASSRLDRVFEQYF	TRBV13	TRBJ2-7
TGTGCCAGCAACCAGAGGGGTCCATGGGACACCGGGGAGCTGTTTTTT	CASNQRGPWDTGELFF	TRBV12-3	TRBJ2-2
TGTGCCAGCAGTTTCGAACGGGGAGAGACCCAGTACTTC	CASSFERGETQYF	TRBV27	TRBJ2-5
