TGCGCCGGCCCCCCCCATGCCCGTCTAGCGGGCGTTTCCTACAATGAGCAGTTCTTC	CAGPPHARLAGVSYNEQFF	TRBV10-1	TRBJ2-1
TGTGCCAGCAGTCCGGGACTAGCGGGAGTCACCCCGGCACAGGGGACCAAAAACATTCAGTACTTC	CASSPGLAGVTPAQGTKNIQYF	TRBV27	TRBJ2-4
TGTGCCAGCAGTGAGTACCCCAAAGCGGCGAATTACAATGAGCAGTTCTTC	CASSEYPKAANYNEQFF	TRBV6-4	TRBJ2-1
TGTGCCAGCAGTTACTCGACAGGGGACAGGGGATTTAATCAGCCCCAGCATTTT	CASSYSTGDRGFNQPQHF	TRBV6-5	TRBJ1-5
TGTGCCAGCAGCCCGGGGACTACGAGATCTTACAATGAGCAGTTCTTC	CASSPGTTRSYNEQFF	TRBV6-2	TRBJ2-1
TGCGCCAGCAGCCGAGGGGCGGGACAGAAGGGATATACGCAGTATTTT	CASSRGAGQKGYTQYF	TRBV4-1	TRBJ2-3
TGTGCCAGTAGTCCCGGGGACCGTTTCGAGCAGTACTTC	CASSPGDRFEQYF	TRBV19	TRBJ2-7
TGTGCCAGCAGCTCCCAGGGGGCTGGCACTGAAGCTTTCTTT	CASSSQGAGTEAFF	TRBV13	TRBJ1-1
TGCGCCAGCAGCCACGCCAGGCCTGGCTACACCTTC	CASSHARPGYTF	TRBV5-1	TRBJ1-2
TGTGCCAGCAGTGTTGACAGGGGCCCGGGCGCCAAAAACATTCAGTACTTC	CASSVDRGPGAKNIQYF	TRBV6-5	TRBJ2-4
TGCAGTGCTAGAGAGGCTCGGCCCAAACAGCCCCGGAATGAGCAGTTCTTC	CSAREARPKQPRNEQFF	TRBV20-1	TRBJ2-1
TGCAGTGGGACTAGCGGACCGGGGCAGTTCTTC	CSGTSGPGQFF	TRBV20-1	TRBJ2-1
TGTGCCAGCAGCTCGGGGTCCATCTTT	CASSSGSIF	TRBV27	TRBJ1-1
TGTGCCAGCAGTGACAACGTGGGCACAGATACGCAGTATTTT	CASSDNVGTDTQYF	TRBV6-4	TRBJ2-3
TGTGCCAGTAGTCCGCTGGGGGGGGAAGAGACCCAGTACTTC	CASSPLGGEETQYF	TRBV19	TRBJ2-5
TGTGCCAGCAGCCCGGCAGGGGGTGACATGAACACTGAAGCTTTCTTT	CASSPAGGDMNTEAFF	TRBV13	TRBJ1-1
TGTGCCAGCAGCAGGGGGAACCTCGGGGACAGTAAAAACTCCACAGATACGCAGTATTTT	CASSRGNLGDSKNSTDTQYF	TRBV7-3	TRBJ2-3
TGTGCCAGCAGGGGTCAGGAGCAGCCCCAGCATTTT	CASRGQEQPQHF	TRBV6-4	TRBJ1-5
TGTGCCAGCAGTTTGGGCATCCAGGGGGCCAAGAGTGCATACAATGAGCAGTTCTTC	CASSLGIQGAKSAYNEQFF	TRBV27	TRBJ2-1
TGTGCTAGTGTGACAGGGGTTAACACCGGGGAGCTGTTTTTT	CASVTGVNTGELFF	TRBV12-5	TRBJ2-2
TGCGCCAGCAGTGAGGCAGGGACCGGGGAGCTGTTTTTT	CASSEAGTGELFF	TRBV10-1	TRBJ2-2
TGCGCCAGCAGTGGAACTCGGGGGCAAGACTACGAGCAGTACTTC	CASSGTRGQDYEQYF	TRBV10-2	TRBJ2-7
TGTGCCAGCAGGACCGGGACAGGTTTAAAAGTAAGAGAAGAGACCCAGTACTTC	CASRTGTGLKVREETQYF	TRBV12-3	TRBJ2-5
TGTGCCACATTACAGGGTGGTAATGAAAAACTGTTTTTT	CATLQGGNEKLFF	TRBV24-1	TRBJ1-4
TGTGCCAGCGCAGGCTTGACGGGCGATTCACCCCTCCACTTT	CASAGLTGDSPLHF	TRBV11-2	TRBJ1-6
TGTGCCAGCAGCTTAGGGCCCTGGGCCGGGGAGCTGTTTTTT	CASSLGPWAGELFF	TRBV7-2	TRBJ2-2
TGTGCCAGCAGCCTGAGAACGACCGGGGCTGATGAGCAGTTCTTC	CASSLRTTGADEQFF	TRBV3-1	TRBJ2-1
TGTGCCAGCAGCTTCCTAGGGAGCTCCTACAATGAGCAGTTCTTC	CASSFLGSSYNEQFF	TRBV5-8	TRBJ2-1
TGTGCCAGCAGCTTGGCAGGGGATTGGACCTACGAGCAGTACTTC	CASSLAGDWTYEQYF	TRBV5-5	TRBJ2-7
TGTGCCAGCAGCTTAAAAACCCCGGGGGGGGGGCAGATGTATAGCAATCAGCCCCAGCATTTT	CASSLKTPGGGQMYSNQPQHF	TRBV7-8	TRBJ1-5
TGTGCCAGCAGCCATAGCGGAAATGAGCAGTTCTTC	CASSHSGNEQFF	TRBV3-1	TRBJ2-1
TGTGCCAGCAGCTCAGGGTACGAGCAGTACTTC	CASSSGYEQYF	TRBV5-4	TRBJ2-7
TGCGCCAGCAGTTGGCTAGACTGGTACAATGAGCAGTTCTTC	CASSWLDWYNEQFF	TRBV10-1	TRBJ2-1
TGTGCCAGCAGCTTACCAAGATTAATGGGGTTCAGTGAAACCCAGTACTTC	CASSLPRLMGFSETQYF	TRBV7-9	TRBJ2-5
TGTGCCAGTTTAGCCTACAATGAGCAGTTCTTC	CASLAYNEQFF	TRBV2	TRBJ2-1
TGTGCCAGCAGTGATCGCCCGCCGGGAGGGTCGCCACCCCTCCACTTT	CASSDRPPGGSPPLHF	TRBV6-4	TRBJ1-6
TGTGCCAGCAGTGAACCCCGAGGCAAGACAGATACGCAGTATTTT	CASSEPRGKTDTQYF	TRBV6-1	TRBJ2-3
TGCAGTGCGACCGGACTAGGGCACACCGGGGAGCTGTTTTTT	CSATGLGHTGELFF	TRBV20-1	TRBJ2-2
TGTGCCCTATCCGGCAGGAAATACAATGAGCAGTTCTTC	CALSGRKYNEQFF	TRBV6-4	TRBJ2-1
TGTGCCAGCAGCTTAGTAGGGAGCTTGACAGGGGGGGGGCCGACCCAGTACTTC	CASSLVGSLTGGGPTQYF	TRBV7-8	TRBJ2-5
TGCAGTGCTAGAGATACCCCCGGGACTAGCGGGGGGCTATACTACGAGCAGTACTTC	CSARDTPGTSGGLYYEQYF	TRBV20-1	TRBJ2-7
TGTGCCAGCAGCCAAGCCAGGGGATTCCCGGGCTACGAGCAGTACTTC	CASSQARGFPGYEQYF	TRBV3-1	TRBJ2-7
TGCAGCGTTGTTTGGCCCCCGGGAGGGCTGATTTGGCCTAACTATGGCTACACCTTC	CSVVWPPGGLIWPNYGYTF	TRBV29-1	TRBJ1-2
TGTGCCAGCAGCTTAGGTCCCCGTACGGGGGGCCGACCCTACGAGCAGTACTTC	CASSLGPRTGGRPYEQYF	TRBV7-2	TRBJ2-7
TGCGCCAGCAGCTTGATGGAGGCGGGCTCCTACGAGCAGTACTTC	CASSLMEAGSYEQYF	TRBV5-1	TRBJ2-7
TGTGCCAGCAGCAGTGTGAGGCGGTCCTCTGGGGCCAACGTCCTGACTTTC	CASSSVRRSSGANVLTF	TRBV13	TRBJ2-6
TGCGCCCACGGGGCAGAGACCCAGTACTTC	CAHGAETQYF	TRBV5-1	TRBJ2-5
TGTGCCAGCAGTTACGTCTCGGAGCAGTACTTC	CASSYVSEQYF	TRBV6-2	TRBJ2-7
TGTGCCAGCAGAGACGGACAGGGTAATAGCAATCAGCCCCAGCATTTT	CASRDGQGNSNQPQHF	TRBV6-2	TRBJ1-5
TGTGCCAGCAGCGGACCTCCGGGACTAGCGGGAATCGTATACAATGAGCAGTTCTTC	CASSGPPGLAGIVYNEQFF	TRBV9	TRBJ2-1
TGCAGCGTCGGGCCGGATAGCGAGCAGTACTTC	CSVGPDSEQYF	TRBV29-1	TRBJ2-7
TGTGCCAGCAGCGAACAAGGGAACGGACAGGGGGGGGCCTACGAGCAGTACTTC	CASSEQGNGQGGAYEQYF	TRBV13	TRBJ2-7
TGTGCCAGCCTCCCGTTAGGCTACACCTTC	CASLPLGYTF	TRBV9	TRBJ1-2
TGCGCCAGCGAAGGAGAAGACAGGGGGGAGGATACCGGGGAGCTGTTTTTT	CASEGEDRGEDTGELFF	TRBV10-1	TRBJ2-2
TGTGCCAGCAGCATCACAGGGGATGGGGCCTACGAGCAGTACTTC	CASSITGDGAYEQYF	TRBV9	TRBJ2-7
TGCGCCAGCAGCCAAGAAGGTCCCAGAGCCTTCTTAAGTTTGGCAGATACGCAGTATTTT	CASSQEGPRAFLSLADTQYF	TRBV4-1	TRBJ2-3
TGTGCCAGCAGTTTATCGCTACCAGGGGTCCACTTC	CASSLSLPGVHF	TRBV27	TRBJ2-7
TGTGCCAGCTCACCAACCGGGGAGGATCAGCCCCAGCATTTT	CASSPTGEDQPQHF	TRBV18	TRBJ1-5
TGTGCCAGCAGTACCGAGGTTACCGGGGAGCTGTTTTTT	CASSTEVTGELFF	TRBV6-1	TRBJ2-2
TGTGCCAGCGCACTGCCACAGCGGGAGAAACCCTACGAGCAGTACTTC	CASALPQREKPYEQYF	TRBV2	TRBJ2-7
TGTGCCAGCAGCCGAATGGGGGCCCCGATTCCAGCAATTAAAGCAGATACGCAGTATTTT	CASSRMGAPIPAIKADTQYF	TRBV9	TRBJ2-3
TGCAGTGCTAGGGGGGGGTATTTTACCGGGGAGCTGTTTTTT	CSARGGYFTGELFF	TRBV20-1	TRBJ2-2
TGCAGTGCTAGCCACGGGTGGGGAGCGAACTACGAGCAGTACTTC	CSASHGWGANYEQYF	TRBV20-1	TRBJ2-7
TGTGCCAGCAGATGTTCAGGAAACACCATATATTTT	CASRCSGNTIYF	TRBV6-6	TRBJ1-3
TGCAGTGCTATCGGCCGGAGACGCGGACTCTACGAGCAGTACTTC	CSAIGRRRGLYEQYF	TRBV20-1	TRBJ2-7
TGTGCCAGCAAACTTATTACCTCCGTGAACACTGAAGCTTTCTTT	CASKLITSVNTEAFF	TRBV6-3	TRBJ1-1
TGTGCCAGCAGAACGCTCCCAAGTACCTTCGTCTCTGGAAACACCATATATTTT	CASRTLPSTFVSGNTIYF	TRBV6-4	TRBJ1-3
TGTGCCAGCAGTTTTTCGAAGCGTATCGTCGGAAACGCCGCAGATACGCAGTATTTT	CASSFSKRIVGNAADTQYF	TRBV12-3	TRBJ2-3
TGTGCCAGCAGTTACGAGGAGGGGAGCACAGATACGCAGTATTTT	CASSYEEGSTDTQYF	TRBV6-5	TRBJ2-3
TGCGCCAGCAGCTTGGGAGGGACAGAATTACACAATGAGCAGTTCTTC	CASSLGGTELHNEQFF	TRBV5-1	TRBJ2-1
TGTGCCAGCAAAGAATACGGGGAGGCTTTCTTT	CASKEYGEAFF	TRBV7-8	TRBJ1-1
TGTGCCAGCAGCTTAAGTAGGCGTACCGTCCAAGAGACCCAGTACTTC	CASSLSRRTVQETQYF	TRBV11-1	TRBJ2-5
TGTGCCAGCAGTTTCAACCGGGACAGGTCTATGTCTGAAGCTTTCTTT	CASSFNRDRSMSEAFF	TRBV27	TRBJ1-1
TGTGCCAGCAGTTTATTATTCGACAGGGGCGCCCCCCCGATTTCAACTAATGAAAAACTGTTTTTT	CASSLLFDRGAPPISTNEKLFF	TRBV28	TRBJ1-4
TGTGCCAGCTCCAGGACGGGCTATGGCTACACCTTC	CASSRTGYGYTF	TRBV4-2	TRBJ1-2
TGTGCCAGTATCCCCAGGGGCCCCACTGAAGCTTTCTTT	CASIPRGPTEAFF	TRBV19	TRBJ1-1
TGTGCCAGCAGTGCCGGGACAGTTCTAGAACGGACAGATACGCAGTATTTT	CASSAGTVLERTDTQYF	TRBV6-6	TRBJ2-3
TGTGCCATGCCTGCACTAGCGGGGGGGCGAGCAGATACGCAGTATTTT	CAMPALAGGRADTQYF	TRBV6-5	TRBJ2-3
TGTGCCACCTACAGGGGATGGCACGAGCAGTACTTC	CATYRGWHEQYF	TRBV24-1	TRBJ2-7
TGTGCCACCAGTGAACCCGGAAGGGGTGGAAACACCATATATTTT	CATSEPGRGGNTIYF	TRBV24-1	TRBJ1-3
TGTGCCACCAAGGGTGGGACTGAAGCTTTCTTT	CATKGGTEAFF	TRBV24-1	TRBJ1-1
TGTGCCTGGAGTGTAAGAGTTTCGGCCAACGGGACAGGGGGCTTAAGGGGCTACACCTTC	CAWSVRVSANGTGGLRGYTF	TRBV30	TRBJ1-2
TGTGCCACCAGTGTTCGGAGCGGGACAGCCGTTGCCGCCTACGAGCAGTACTTC	CATSVRSGTAVAAYEQYF	TRBV24-1	TRBJ2-7
TGTGCCAGCAGCAGGACTAGCGGGGGGGCTCCTTCAGATACGCAGTATTTT	CASSRTSGGAPSDTQYF	TRBV11-3	TRBJ2-3
TGTGCCAGCAGGGGGGATACCTACGAGCAGTACTTC	CASRGDTYEQYF	TRBV27	TRBJ2-7
TGTGCCAGCGGTCAATACGACAGAAGTGGAAACACCATATATTTT	CASGQYDRSGNTIYF	TRBV6-4	TRBJ1-3
TGTGCCAGCAGGGGGAAAAGTGCTGGGGCCAACGTCCTGACTTTC	CASRGKSAGANVLTF	TRBV12-4	TRBJ2-6
TGTGCCAGCAGTGACTCTCATCGGTCTTCGAACACCGGGGAGCTGTTTTTT	CASSDSHRSSNTGELFF	TRBV6-4	TRBJ2-2
TGTGCCAGCAGTTTATGGACTAGAGGGGATACGCAGTATTTT	CASSLWTRGDTQYF	TRBV28	TRBJ2-3
TGTGCCTCGGCAGATACGCAGTATTTT	CASADTQYF	TRBV30	TRBJ2-3
TGTGCCAGCAGCCCGCCTTGGGTAATCCAGGGGGCCTACGAGCAGTACTTC	CASSPPWVIQGAYEQYF	TRBV7-9	TRBJ2-7
TGTGCCAGCAGTGCTCCGACGCACGGGAGGGGCACAGATACGCAGTATTTT	CASSAPTHGRGTDTQYF	TRBV25-1	TRBJ2-3
TGTGCCAGCAGCACATATCAGAGGGAGATAAACTCCTACAATGAGCAGTTCTTC	CASSTYQREINSYNEQFF	TRBV9	TRBJ2-1
TGCGCCAGCAGCTTGCTGGGGCATACTAATGAAAAACTGTTTTTT	CASSLLGHTNEKLFF	TRBV5-1	TRBJ1-4
TGTGCCAGCAGCCAAGTAGCAGGGACAGAGAGCTATGGCTACACCTTC	CASSQVAGTESYGYTF	TRBV14	TRBJ1-2
TGCGCCAGCAGCTTGGAGCAGAATCCGGGGAATGAAAAACTGTTTTTT	CASSLEQNPGNEKLFF	TRBV5-1	TRBJ1-4
TGTGCCAGCAGTTGTATCGACCGCAGGGGGCGCAGTTACGAGCAGTACTTC	CASSCIDRRGRSYEQYF	TRBV27	TRBJ2-7
TGCGCCAGTCCGGGGGGGAGAGTCGATGAGCAGTTCTTC	CASPGGRVDEQFF	TRBV4-1	TRBJ2-1
TGTGCCATCATGACTAGCGGATCGGGACTTAAAAACTCCTACGAGCAGTACTTC	CAIMTSGSGLKNSYEQYF	TRBV10-3	TRBJ2-7
TGCGCCAGCAGCGGCCCCGCAGCGGGTGAAAAACTGTTTTTT	CASSGPAAGEKLFF	TRBV5-1	TRBJ1-4
TGTGCCAGCTTAGACAGGGGTGGAGAGAACTATGGCTACACCTTC	CASLDRGGENYGYTF	TRBV9	TRBJ1-2
TGTGCCAGTAGTATAAGCGTAATACCTCTGACAGGGTACGAGCAGTACTTC	CASSISVIPLTGYEQYF	TRBV19	TRBJ2-7
TGCAGTGCTACTAAGCAGGGAAACATTCAGTACTTC	CSATKQGNIQYF	TRBV20-1	TRBJ2-4
TGCAGTTACTCCACAGATACGCAGTATTTT	CSYSTDTQYF	TRBV29-1	TRBJ2-3
TGTGCCAGCAGGCCGCTAACGCCAGATACGCAGTATTTT	CASRPLTPDTQYF	TRBV9	TRBJ2-3
TGCGCCAGCAGCTTGCGGGAAAATTCCCCGGGACAGGGGGGAAGAGGGGCAGATACGCAGTATTTT	CASSLRENSPGQGGRGADTQYF	TRBV5-1	TRBJ2-3
TGTGCCAGCAGCGGCCTAGACAGGGGTCCCAGCACCATATATTTT	CASSGLDRGPSTIYF	TRBV11-2	TRBJ1-3
TGTGCCAGCAGTTTCACCAGGGCTGAAGGAAACACCATATATTTT	CASSFTRAEGNTIYF	TRBV27	TRBJ1-3
TGTGCCAGTTTAGGACTAGCGGGCCCGTTTAATGAGCAGTTCTTC	CASLGLAGPFNEQFF	TRBV11-2	TRBJ2-1
TGTGCCAGCAGCCCCCCGGGACAGGGGCGCTACGAGCAGTACTTC	CASSPPGQGRYEQYF	TRBV9	TRBJ2-7
TGCAGTGCTTCTCTTCCCCACAGGAGGTGGTATAGCAATCAGCCCCAGCATTTT	CSASLPHRRWYSNQPQHF	TRBV20-1	TRBJ1-5
TGCGCCAGCAGTGAGTCGGGACTCCCGGGACAGGGGTATGGCTACACCTTC	CASSESGLPGQGYGYTF	TRBV10-1	TRBJ1-2
TGTGCCAGCAAAAGGCGACAGTATGGGTTTCCCGAGCAGTACTTC	CASKRRQYGFPEQYF	TRBV27	TRBJ2-7
TGCAGTGCTAGAGATCCCCGGGAGGGGGAGACCCAGTACTTC	CSARDPREGETQYF	TRBV20-1	TRBJ2-5
TGTGCCAGCAGTTACCCAGGGAATGAGGGGGGCTCACCCGGTCGACCGGCCTATGGCTACACCTTC	CASSYPGNEGGSPGRPAYGYTF	TRBV6-3	TRBJ1-2
TGTGCCAGCAGCGGACAGGGTGGGAACACTGAAGCTTTCTTT	CASSGQGGNTEAFF	TRBV7-8	TRBJ1-1
TGTGCCAGCACAGGCGGACGCTCAAACACCATATATTTT	CASTGGRSNTIYF	TRBV27	TRBJ1-3
TGTGCCACCAGCAGATCGCTCACACGTTTTCAGCCCCAGCATTTT	CATSRSLTRFQPQHF	TRBV15	TRBJ1-5
TGTGCCAGCAGCCCCCCAACGGAATTTTGGTACAATGAGCAGTTCTTC	CASSPPTEFWYNEQFF	TRBV9	TRBJ2-1
TGCAGTGCTAGAGCATCCGCGGGGGGGTTATGGGGAGATACGCAGTATTTT	CSARASAGGLWGDTQYF	TRBV20-1	TRBJ2-3
TGTGCCAGCAGCGGGGACTTTAACCCAGCAGATACGCAGTATTTT	CASSGDFNPADTQYF	TRBV11-3	TRBJ2-3
TGTGCCAGCAGCATTCAGATTGTAGTAAGCACAGATACGCAGTATTTT	CASSIQIVVSTDTQYF	TRBV7-3	TRBJ2-3
TGTGCCAGTAGTATAGGAACGGCCCCTCTCTCCTACGAGCAGTACTTC	CASSIGTAPLSYEQYF	TRBV19	TRBJ2-7
TGCGCCAGCAGCCCCCATGACCTCGAAACCTTGAATGGCTACACCTTC	CASSPHDLETLNGYTF	TRBV4-3	TRBJ1-2
TGTGCTAGTGGTCTGGGGGCTGACCAAGAGACCCAGTACTTC	CASGLGADQETQYF	TRBV12-5	TRBJ2-5
TGTGCCAGCAGTAGGAGACAGAACACCATATATTTT	CASSRRQNTIYF	TRBV11-3	TRBJ1-3
TGTGCCAGCAGCCCGCATGGGACAGCTAGCACCGGGGAGCTGTTTTTT	CASSPHGTASTGELFF	TRBV13	TRBJ2-2
TGTGCCAGCAGCTCCGGCCGCTCCTCTAGCAATCAGCCCCAGCATTTT	CASSSGRSSSNQPQHF	TRBV9	TRBJ1-5
TGTGCCCGATCTCACAGGGGCCAGCCCCAGCATTTT	CARSHRGQPQHF	TRBV10-3	TRBJ1-5
TGTGCCAGCAGTTACTCGAGAGCGGTAGGACAGGCTAAGGGGGACCTCATGAACACTGAAGCTTTCTTT	CASSYSRAVGQAKGDLMNTEAFF	TRBV6-6	TRBJ1-1
TGTGCCAGCAGCCGGGAGGAGCAGTACTTC	CASSREEQYF	TRBV6-4	TRBJ2-7
TGCGCCAGCAGCTTGGTGGCCGGGACGACAACCGGGGAGCTGTTTTTT	CASSLVAGTTTGELFF	TRBV5-1	TRBJ2-2
TGCGCCAGCAGCTTACCCCACGAAATGGGGGCCTTCAATGAGCAGTTCTTC	CASSLPHEMGAFNEQFF	TRBV5-1	TRBJ2-1
TGTGCCTGGAGCGGGAAGGTATTCGAAAAACTGTTTTTT	CAWSGKVFEKLFF	TRBV30	TRBJ1-4
TGCAGTGCTAGAGACCTATCCGGGACACGGAACACTGAAGCTTTCTTT	CSARDLSGTRNTEAFF	TRBV20-1	TRBJ1-1
TGTGCCAGCAGCACGGGGCGGTCAGGTAACTATGGCTACACCTTC	CASSTGRSGNYGYTF	TRBV7-9	TRBJ1-2
TGTGCCAGCAGGTCTAGTACAGGGGGCTTCACTGAAGCTTTCTTT	CASRSSTGGFTEAFF	TRBV11-1	TRBJ1-1
TGTGCCAGCAGGGAAGAGTTTCAGAAAGAGACCCAGTACTTC	CASREEFQKETQYF	TRBV6-5	TRBJ2-5
TGTGCCAGCCACCCCCCGGGACTCTGTTATAGCAATCAGCCCCAGCATTTT	CASHPPGLCYSNQPQHF	TRBV27	TRBJ1-5
TGTGCCTGGATATATAGGGAGGAAGCTTTCTTT	CAWIYREEAFF	TRBV30	TRBJ1-1
TGTGCCAGCAGCTGCGTTGAGAGACAGGTACAAGAGACCCAGTACTTC	CASSCVERQVQETQYF	TRBV5-6	TRBJ2-5
TGTGCCAGCACTCCTGAGGGAGTGAGGAGCCCCCCCTGCGGGACCCGTCAGCCCCAGCATTTT	CASTPEGVRSPPCGTRQPQHF	TRBV7-9	TRBJ1-5
TGTGCCAGCAGTGTCGGGGAAAGGTTCGCCACTGAAGCTTTCTTT	CASSVGERFATEAFF	TRBV6-2	TRBJ1-1
TGTGCCAGCAGTAGACAGAGCCAAAACATTCAGTACTTC	CASSRQSQNIQYF	TRBV6-5	TRBJ2-4
TGTGCCAGAAGAGGGGACAGTTCGGGACAGTACTATGGCTACACCTTC	CARRGDSSGQYYGYTF	TRBV6-3	TRBJ1-2
TGTGCCTGTGGTCAGCCCGTACAAAACATTCAGTACTTC	CACGQPVQNIQYF	TRBV30	TRBJ2-4
TGTGCCAGCAGCCCGACCAGGGGGCTACCGGTTGCAACTAATGAAAAACTGTTTTTT	CASSPTRGLPVATNEKLFF	TRBV13	TRBJ1-4
TGTGCCAGCAGTTCTCAGGGACAGTCTGGAAACACCATATATTTT	CASSSQGQSGNTIYF	TRBV28	TRBJ1-3
TGTGCCAGTAGGGAAAGCGATAACTATGGCTACACCTTC	CASRESDNYGYTF	TRBV19	TRBJ1-2
TGTGCCAGCAGTGGCCCCACAAGGGGAACTAACACCATATATTTT	CASSGPTRGTNTIYF	TRBV27	TRBJ1-3
TGTGCCACCGGGTATCCCCCCGGGGGGGCCAAAAACATTCAGTACTTC	CATGYPPGGAKNIQYF	TRBV27	TRBJ2-4
TGTGCCAGCAGTCAACCAGGGGATCTAGTTGACAATGAGCAGTTCTTC	CASSQPGDLVDNEQFF	TRBV7-9	TRBJ2-1
TGTGCCAGCAGCTCAGGGCTCTCTGGAAACACCATATATTTT	CASSSGLSGNTIYF	TRBV7-2	TRBJ1-3
TGTGCCAGCAGCTTGCGTTCCGGGACTAGCGGGGGGGCTCAATACAATGAGCAGTTCTTC	CASSLRSGTSGGAQYNEQFF	TRBV5-6	TRBJ2-1
TGTGCCAGCAGCGGTCAAGGACTAGCGGGAGCTTCGCACAATGAGCAGTTCTTC	CASSGQGLAGASHNEQFF	TRBV7-9	TRBJ2-1
TGTGCCAGTCCGTGGGGGGTTTGCACAGATACGCAGTATTTT	CASPWGVCTDTQYF	TRBV2	TRBJ2-3
TGTGCCAGCAGTTACCTGGGACAGGGACCTTCTAATGAAAAACTGTTTTTT	CASSYLGQGPSNEKLFF	TRBV6-5	TRBJ1-4
TGTGCCAGCAGTACATGTACAGTGGCTTGTAATCAGCCCCAGCATTTT	CASSTCTVACNQPQHF	TRBV28	TRBJ1-5
TGTGCCAGCAGTTTTTGCCAGGTTCAACGTTTGGCAGATACGCAGTATTTT	CASSFCQVQRLADTQYF	TRBV27	TRBJ2-3
TGTGCCAGCAGTTTTCCTGCGGGCGGAAAGAATCAGCCCCAGCATTTT	CASSFPAGGKNQPQHF	TRBV6-2	TRBJ1-5
TGTGCCAGCAGTGCTTACACGGGACTAGCGGGCCAATACGAGCAGTACTTC	CASSAYTGLAGQYEQYF	TRBV6-4	TRBJ2-7
TGTGCCAGCAGCAGTTTCCATCGGGGGCACTACGAGCAGTACTTC	CASSSFHRGHYEQYF	TRBV6-5	TRBJ2-7
TGTGCCAGCATCCGGGGGTTCTACGAGCAGTACTTC	CASIRGFYEQYF	TRBV27	TRBJ2-7
TGTGCCAGCAGCGATCCGCGGACAGGGGGCGGATCACCCCTCCACTTT	CASSDPRTGGGSPLHF	TRBV5-8	TRBJ1-6
TGCGCCAGCAGCTTGGCCTTAGCGCAGCGGGATTGCTACGAGCAGTACTTC	CASSLALAQRDCYEQYF	TRBV5-1	TRBJ2-7
TGCGCCAGCAGCGATAGTCCTCAGGGGATTAATGAAAAACTGTTTTTT	CASSDSPQGINEKLFF	TRBV5-1	TRBJ1-4
TGTGCCAGCAGGGGGGGTGATGAGCAGTTCTTC	CASRGGDEQFF	TRBV27	TRBJ2-1
TGTGCCAGCAAGCCCGAATGCAGGACCTACGAGCAGTACTTC	CASKPECRTYEQYF	TRBV27	TRBJ2-7
TGCAGTGCTAGGTGGGGGGGGGGCGTGTACCAAGAGACCCAGTACTTC	CSARWGGGVYQETQYF	TRBV20-1	TRBJ2-5
TGTGCCACCCTCTCTGTGAGACAGGGTTCGGTTTTGAACACTGAAGCTTTCTTT	CATLSVRQGSVLNTEAFF	TRBV24-1	TRBJ1-1
TGCGCCAGCAGAGGGGGCGATACTTCCTCTGGGGCCAACGTCCTGACTTTC	CASRGGDTSSGANVLTF	TRBV5-1	TRBJ2-6
TGTGCCAGCAGATCCCATTTCAATCAGCCCCAGCATTTT	CASRSHFNQPQHF	TRBV11-3	TRBJ1-5
TGTGCCACCGGTTCCCAGGGCTTGGTGTTTGGCTACACCTTC	CATGSQGLVFGYTF	TRBV24-1	TRBJ1-2
TGTGCCAGCGGTAAGGAGGGAACCGGGGAGCTGTTTTTT	CASGKEGTGELFF	TRBV7-3	TRBJ2-2
TGTGCCAGCAGCTTACGAGGGGAACTAGCGGGCGAGAGCACAGATACGCAGTATTTT	CASSLRGELAGESTDTQYF	TRBV13	TRBJ2-3
TGTGCCAGCAGCTTCCGACCCGGGCCGGAAATCTACGAGCAGTACTTC	CASSFRPGPEIYEQYF	TRBV5-4	TRBJ2-7
TGTGCCAGCGTTTGTGAGGCCTACAGGGGGCCCGTAGAGCAGTTCTTC	CASVCEAYRGPVEQFF	TRBV6-6	TRBJ2-1
TGTGCCAGCAGTTTTTCACAGCGGGTTTGTGCGACTGAAGCTTTCTTT	CASSFSQRVCATEAFF	TRBV28	TRBJ1-1
TGTGCCAGCAGCCCAGTGGGGATAATGAACACTGAAGCTTTCTTT	CASSPVGIMNTEAFF	TRBV11-3	TRBJ1-1
TGCAGTGCTCTGGTCCCCCGGCGAACGGGCTCTGGGGCCAACGTCCTGACTTTC	CSALVPRRTGSGANVLTF	TRBV20-1	TRBJ2-6
TGTGCCAGCTTCTGGGACAGGTATGGCTACACCTTC	CASFWDRYGYTF	TRBV27	TRBJ1-2
TGTGCCAGCAGCCCACCAGGGGAAAAGGGAAGAACCGGGGAGCTGTTTTTT	CASSPPGEKGRTGELFF	TRBV7-3	TRBJ2-2
TGCGCCAGCAGTGAGTCGGGGCTTCTTAGTATCTACGAGCAGTACTTC	CASSESGLLSIYEQYF	TRBV10-1	TRBJ2-7
TGTGCCAGCAGCTTACCCCCGGGGCCCTACGAGCAGTACTTC	CASSLPPGPYEQYF	TRBV7-4	TRBJ2-7
TGTGCCACCAGTGATTTGCCCAAGAACAGGCGGCGCTCCTACAATGAGCAGTTCTTC	CATSDLPKNRRRSYNEQFF	TRBV24-1	TRBJ2-1
TGTGCTAGTGGTTTGTTCCCCTCCCGAACTGCTGCGTTTCCGGGGTTTTATGGCTACACCTTC	CASGLFPSRTAAFPGFYGYTF	TRBV12-5	TRBJ1-2
TGTGCCAGCAGCCCTTCCCTCGCGCAGGGTACTAACTATGGCTACACCTTC	CASSPSLAQGTNYGYTF	TRBV7-2	TRBJ1-2
TGTGCCAGCAGATGGGGGTTCAGCCGCGGGGAGCTGTTTTTT	CASRWGFSRGELFF	TRBV6-6	TRBJ2-2
TGCGCCAGCATATTAACTAGCGGGAGTACGGCACGGCAGTACTTC	CASILTSGSTARQYF	TRBV5-1	TRBJ2-7
TGTGCTAGTGGTTTCCCCAAGCGCCGTCACGAGACCCAGTACTTC	CASGFPKRRHETQYF	TRBV12-5	TRBJ2-5
TGTGCCAGCAGCCGCTCGGCACATGAGACCCAGTACTTC	CASSRSAHETQYF	TRBV7-3	TRBJ2-5
TGCGCCAGCAGCTTGGGGGAGGACAGGGGGCGCAATCAGCCCCAGCATTTT	CASSLGEDRGRNQPQHF	TRBV5-1	TRBJ1-5
TGTGCCAGCGGCCCAGCGAGACTGAACACTGAAGCTTTCTTT	CASGPARLNTEAFF	TRBV28	TRBJ1-1
TGTGCCAGGCCGGGGCACACTGAAGCTTTCTTT	CARPGHTEAFF	TRBV27	TRBJ1-1
TGTGCCAGCAGCGTATTACCCACTACAAGCACTGAAGCTTTCTTT	CASSVLPTTSTEAFF	TRBV9	TRBJ1-1
TGCAGCGGGTCCGGGGACAGGACAAATCAGCCCCAGCATTTT	CSGSGDRTNQPQHF	TRBV29-1	TRBJ1-5
TGTGCCAGCAGTGAACAGGGCACCCTATTGGTCTACAATGAGCAGTTCTTC	CASSEQGTLLVYNEQFF	TRBV6-4	TRBJ2-1
TGTGCCAGCAGCCGAGTGACCGGGGAGCTGTTTTTT	CASSRVTGELFF	TRBV28	TRBJ2-2
TGTGCCACCAGTGATGGGACATGGGGGGGCTCCTACGAGCAGTACTTC	CATSDGTWGGSYEQYF	TRBV24-1	TRBJ2-7
TGTGCCAGCACCGCAGCGGTTGAGCAGTTCTTC	CASTAAVEQFF	TRBV28	TRBJ2-1
TGTGCCAGCAGTTTTGACACAGGTCCTGATACGCAGTATTTT	CASSFDTGPDTQYF	TRBV7-3	TRBJ2-3
TGTGCCAGCAGCTTTCCAATGGACAGGGGTCAAGAAGACGAGCAGTACTTC	CASSFPMDRGQEDEQYF	TRBV11-2	TRBJ2-7
TGTGCCAGCAGCCAGGGGGCGCTTAACTATGGCTACACCTTC	CASSQGALNYGYTF	TRBV11-3	TRBJ1-2
TGTGCCAGCAGTGACTCGAGGACCCAGGGTAAAAACCGAACAATCTACGAGCAGTACTTC	CASSDSRTQGKNRTIYEQYF	TRBV6-4	TRBJ2-7
TGTGCCATCAGTGATTTGGCGGGAGGGGTAAAGTACAATGAGCAGTTCTTC	CAISDLAGGVKYNEQFF	TRBV10-3	TRBJ2-1
TGCGCCAGCAGTGGTATATTGAACACTGAAGCTTTCTTT	CASSGILNTEAFF	TRBV10-1	TRBJ1-1
TGCAGTGCGAGACCGATCGTCGACGAAGCTTTCTTT	CSARPIVDEAFF	TRBV20-1	TRBJ1-1
TGCGCCAGCAGCCAAGATGGAGTCAGAATGGAGCCCTTC	CASSQDGVRMEPF	TRBV4-1	TRBJ1-2
TGCAGCGTTGAAGGGACGTCTGGAAACACCATATATTTT	CSVEGTSGNTIYF	TRBV29-1	TRBJ1-3
TGTGCCAGCAGCGTCCAATATTCCCCAACTAGCGGGAGCCAGGAAAACATTCAGTACTTC	CASSVQYSPTSGSQENIQYF	TRBV9	TRBJ2-4
TGTGCCAGCAGCTTAGAACCGGGACAGGGGGGTGAGAGCACTGAAGCTTTCTTT	CASSLEPGQGGESTEAFF	TRBV7-9	TRBJ1-1
TGTGCCAGCAGCCCGGGACAGGGGAACAATCAGCCCCAGCATTTT	CASSPGQGNNQPQHF	TRBV11-2	TRBJ1-5
TGTGCTAGCAAGAGAACGGGGGGCTACACCTTC	CASKRTGGYTF	TRBV7-7	TRBJ1-2
TGTGCCAGCAGCCCCAATCCTAGGTGGGGAGTACCAGGAATGCGAAACACCATATATTTT	CASSPNPRWGVPGMRNTIYF	TRBV13	TRBJ1-3
TGTGCCTCCGGTCCCTCCTGTGCTACTGATGAGCAGTTCTTC	CASGPSCATDEQFF	TRBV30	TRBJ2-1
TGTGCCAGCAGTGAGTTCCCTTCTGGCTACACCTTC	CASSEFPSGYTF	TRBV6-4	TRBJ1-2
TGTGCCAGCAGCCTCGGGCCCTCTCAGCCCCAGCATTTT	CASSLGPSQPQHF	TRBV14	TRBJ1-5
TGTGCCAGCAGCGGGGGGACAGGGGCCGGAGAGCCCTACGAGCAGTACTTC	CASSGGTGAGEPYEQYF	TRBV9	TRBJ2-7
TGCAGTGCTAGTATCCGCGGCCGGGACACCTTC	CSASIRGRDTF	TRBV20-1	TRBJ1-2
TGTGCCAGCAGTTTATCGAAGGGGGATGAAAAACTGTTTTTT	CASSLSKGDEKLFF	TRBV27	TRBJ1-4
TGTGCCAGCAGCGACAGGCACGAGCAGTACTTC	CASSDRHEQYF	TRBV13	TRBJ2-7
TGTGCCAGCAGCTACGACAGGGCCTATAGCAATCAGCCCCAGCATTTT	CASSYDRAYSNQPQHF	TRBV5-4	TRBJ1-5
TGTGCCAGCAGCAACGTGGACTCCTACAATGAGCAGTTCTTC	CASSNVDSYNEQFF	TRBV7-3	TRBJ2-1
TGTGCCAGCAGCCCAGAGCCGGACCGGACCCCTGAAGCTTTCTTT	CASSPEPDRTPEAFF	TRBV14	TRBJ1-1
TGTGCCAGCAGCTTAGCTAGCGGGGGGGCCGGTGAGCAGTTCTTC	CASSLASGGAGEQFF	TRBV7-6	TRBJ2-1
TGCGCCAGCAGTGCGAGAGGGGGGAATGGAAACACCATATATTTT	CASSARGGNGNTIYF	TRBV10-1	TRBJ1-3
TGTGCCAGCAGCTTAGCTGACAGTTCGGAGCGGGAGACCCAGTACTTC	CASSLADSSERETQYF	TRBV7-4	TRBJ2-5
TGTGCCACCCCTCGGGAGACCGGCACTGAAGCTTTCTTT	CATPRETGTEAFF	TRBV15	TRBJ1-1
TGCAGTGTCATCTATCCGAGGGATAACTGGTTCAATCAGCCCCAGCATTTT	CSVIYPRDNWFNQPQHF	TRBV20-1	TRBJ1-5
TGTGCCAGCAGCGAGCCCAGGCTTCGGAGGAACACTGAAGCTTTCTTT	CASSEPRLRRNTEAFF	TRBV6-1	TRBJ1-1
TGCAGCGTTTCGAGCGCTGAAGCTTTCTTT	CSVSSAEAFF	TRBV29-1	TRBJ1-1
TGTGCAGGCGAGAGTTACAGGGGCAAAAACATTCAGTACTTC	CAGESYRGKNIQYF	TRBV7-3	TRBJ2-4
TGTGCCAGCAGTTGCAGTTACAGGGGGAACCATGAGCAGTTCTTC	CASSCSYRGNHEQFF	TRBV27	TRBJ2-1
TGTGCCACCAGCCTAGCGGGTAGCTCCTACGAGCAGTACTTC	CATSLAGSSYEQYF	TRBV24-1	TRBJ2-7
TGTGCCAGCCAACAGGGGGCACGGGAGGAACAGTACTATGGCTACACCTTC	CASQQGAREEQYYGYTF	TRBV4-2	TRBJ1-2
TGTGCCAGCAGCCGAACTAGTGTAAACACAGATACGCAGTATTTT	CASSRTSVNTDTQYF	TRBV14	TRBJ2-3
TGTGCCTCGCCCAGACCTGACAACTATGGCTACACCTTC	CASPRPDNYGYTF	TRBV30	TRBJ1-2
TGTGCCATCAAGCGGGAGAGGGGTACCAATGGCAATCAGCCCCAGCATTTT	CAIKRERGTNGNQPQHF	TRBV10-3	TRBJ1-5
TGTGCCAGCAGCCAGAACGTGGGGGAGGGGACTAATGAAAAACTGTTTTTT	CASSQNVGEGTNEKLFF	TRBV9	TRBJ1-4
TGTGCCAGCAGCGTAGGGAGGGGGGAGGGGTACAATGAGCAGTTCTTC	CASSVGRGEGYNEQFF	TRBV9	TRBJ2-1
TGTGCCAGCAGCGGAGCTAAGACAGGGACAGATACGCAGTATTTT	CASSGAKTGTDTQYF	TRBV7-3	TRBJ2-3
TGTGCCAGCAGCTTGCGCCCAGAAGAGCAGTACTTC	CASSLRPEEQYF	TRBV7-9	TRBJ2-7
TGTGCCAGGAAGGGGGGGCGAGGGGAGACCCAGTACTTC	CARKGGRGETQYF	TRBV7-2	TRBJ2-5
TGCAGTGCACAACATTATAGCAATCAGCCCCAGCATTTT	CSAQHYSNQPQHF	TRBV20-1	TRBJ1-5
TGCAGTGCTAGAGATATCAAAGACATCTCGGGATCCTACAATGAGCAGTTCTTC	CSARDIKDISGSYNEQFF	TRBV20-1	TRBJ2-1
TGCGCCAGCTCCCTCCCTAGGACAGGGGGTGGAGAGCCCCAGCATTTT	CASSLPRTGGGEPQHF	TRBV4-1	TRBJ1-5
TGTGCCAGCAGCTTGCCCTGGGGGGAATCCTACAATGAGCAGTTCTTC	CASSLPWGESYNEQFF	TRBV5-5	TRBJ2-1
TGTGCCAGCAGCCCGGGACGGCGTAACTATGGCTACACCTTC	CASSPGRRNYGYTF	TRBV7-4	TRBJ1-2
TGTGCCAGCGACAGGGCTCGCTATGGCTACACCTTC	CASDRARYGYTF	TRBV13	TRBJ1-2
TGTGCCAGCAGCCGGGGGAGTTACGAGCAGTACTTC	CASSRGSYEQYF	TRBV13	TRBJ2-7
TGTGCCAGCAGCAAAGTCACCCTGAATGTAGTCGTCTACGAGCAGTACTTC	CASSKVTLNVVVYEQYF	TRBV5-4	TRBJ2-7
TGCGCCAGCAGCGGAGGGCAACTGGATTCACCCCTCCACTTT	CASSGGQLDSPLHF	TRBV10-1	TRBJ1-6
TGTGCCAGCAGCTTATACCTGAGGAGCAATCAGCCCCAGCATTTT	CASSLYLRSNQPQHF	TRBV11-2	TRBJ1-5
TGCGCCAGCAGCCCTAGCACAGATACGCAGTATTTT	CASSPSTDTQYF	TRBV4-3	TRBJ2-3
TGCGCCAGCAGCTTGGCCCCCCTAGCGGGTAACAATGAGCAGTTCTTC	CASSLAPLAGNNEQFF	TRBV5-1	TRBJ2-1
TGTGCCTGGCAATCTGAGACCCAGTACTTC	CAWQSETQYF	TRBV30	TRBJ2-5
TGTGCCCCCAGGACAGGACTTGAGCAGTACTTC	CAPRTGLEQYF	TRBV6-4	TRBJ2-7
TGTGCCACCAGTGATGCGGGACTAGCGGTACTCTCCTACAATGAGCAGTTCTTC	CATSDAGLAVLSYNEQFF	TRBV24-1	TRBJ2-1
TGTGCCAGCAGCTTGCGGACGGGGGTGAGGGGCCAAAGCTCCTACGAGCAGTACTTC	CASSLRTGVRGQSSYEQYF	TRBV5-4	TRBJ2-7
TGTGCCACCAGTTCGGGGTCTTCGGGGCCTGGGGCCAACGTCCTGACTTTC	CATSSGSSGPGANVLTF	TRBV24-1	TRBJ2-6
TGTGCCAGCAGTTTACTAGCGGGAGAAAATGAGCAGTTCTTC	CASSLLAGENEQFF	TRBV6-1	TRBJ2-1
TGTCGGTATAAGTCAGAAGAGACCCAGTACTTC	CRYKSEETQYF	TRBV14	TRBJ2-5
TGTGATAGACAGGGGTGCTGGAACAACTATGGCTACACCTTC	CDRQGCWNNYGYTF	TRBV7-9	TRBJ1-2
TGTGCCAGCAGCCCAGGGATTTATCAGCCCCAGCATTTT	CASSPGIYQPQHF	TRBV13	TRBJ1-5
TGCAGTGCTGTTTCGACTAGCAGCTCCTACGAGCAGTACTTC	CSAVSTSSSYEQYF	TRBV20-1	TRBJ2-7
TGTGCCAGCAGTTCTCCTCCCTCGAGCGGGGTCTCCTACAATGAGCAGTTCTTC	CASSSPPSSGVSYNEQFF	TRBV27	TRBJ2-1
TGTGCCAGCAGGCACTCGGGCAATCAGCCCCAGCATTTT	CASRHSGNQPQHF	TRBV6-6	TRBJ1-5
TGTGCCACGGAGACAGGGATCTCCTATAATTCACCCCTCCACTTT	CATETGISYNSPLHF	TRBV24-1	TRBJ1-6
TGTGCCAGCAGCTTAGCGATGGAGGACACTGAAGCTTTCTTT	CASSLAMEDTEAFF	TRBV7-9	TRBJ1-1
TGTGCCAGCAGTTCGTACTCGGACTACGCAGATACGCAGTATTTT	CASSSYSDYADTQYF	TRBV27	TRBJ2-3
TGTGCCAGCAGCTTGACCGGACGGGGTTGGAAATACAATGAGCAGTTCTTC	CASSLTGRGWKYNEQFF	TRBV7-6	TRBJ2-1
TGTGCTAGCGGCCCGGGACGAGAAGCTTTCTTT	CASGPGREAFF	TRBV7-7	TRBJ1-1
TGTGCTAGCAGCTTAGCGATCAGGGGGCGCGACGCCACTGAAGCTTTCTTT	CASSLAIRGRDATEAFF	TRBV7-7	TRBJ1-1
TGTGCCAGCAGCGTTGTAGAAAAAAACGAGCAGTACTTC	CASSVVEKNEQYF	TRBV13	TRBJ2-7
TGTGCCAGTACCCGGGACAGCCAACCTGGCTACACCTTC	CASTRDSQPGYTF	TRBV6-4	TRBJ1-2
TGTGCCACCAGCAGAGGTGCGGGGGCAGATACGCAGTATTTT	CATSRGAGADTQYF	TRBV15	TRBJ2-3
TGTGCCAGCAGTCAAGGTCGAGAGCAGTACTTC	CASSQGREQYF	TRBV27	TRBJ2-7
TGTGCCAGCAGCAAAGCAGGGCGTCACACCATATATTTT	CASSKAGRHTIYF	TRBV6-2	TRBJ1-3
TGTGCCAGCAGCCCTGCAGGCGGACAGGAGACCCAGTACTTC	CASSPAGGQETQYF	TRBV5-4	TRBJ2-5
TGTGCCACCTACGGCCAACTAGCGGGGGGGCCGCCGTACTTGACCAGCTACAATGAGCAGTTCTTC	CATYGQLAGGPPYLTSYNEQFF	TRBV15	TRBJ2-1
TGCAGTGCTCCAGGACCGGGACTAGCACACGAGCAGTACTTC	CSAPGPGLAHEQYF	TRBV20-1	TRBJ2-7
TGTGCCAGCAGCCTGGGGCCAGCTCGGCCCTACGAGCAGTACTTC	CASSLGPARPYEQYF	TRBV5-4	TRBJ2-7
TGCAGTGCTAGACTCTCAGGGCAATACAATGAGCAGTTCTTC	CSARLSGQYNEQFF	TRBV20-1	TRBJ2-1
TGTGCCACCAGTGATAGGGTCCTCTGGAACCGTCCCTGGGGGGTTGGAAACACCATATATTTT	CATSDRVLWNRPWGVGNTIYF	TRBV24-1	TRBJ1-3
TGTGCCAGCAGTTCCCTAGCGGGGCGTAATACGCAGTATTTT	CASSSLAGRNTQYF	TRBV27	TRBJ2-3
TGTGCCAGCAGTTCACAGCCGGGGGCTGCGTACGAGCAGTACTTC	CASSSQPGAAYEQYF	TRBV6-3	TRBJ2-7
TGCGCCAGCAGTCCAGTCAGGAGGCTCACCAACAATGAGCAGTTCTTC	CASSPVRRLTNNEQFF	TRBV5-1	TRBJ2-1
TGCAAACGGGGACTAGCGGGGGGTTTACCAGACACCGGGGAGCTGTTTTTT	CKRGLAGGLPDTGELFF	TRBV20-1	TRBJ2-2
TGCGCCAGCAGCTTGTCTACACCATCCTCCTACGAGCAGTACTTC	CASSLSTPSSYEQYF	TRBV5-1	TRBJ2-7
TGCAGCGTTTCGCTTACAGGGGAGGTCGTTGACGAGCAGTACTTC	CSVSLTGEVVDEQYF	TRBV29-1	TRBJ2-7
TGTGCCAGCAGAATTCCGGACAGTGCGAGGAACACTGAAGCTTTCTTT	CASRIPDSARNTEAFF	TRBV27	TRBJ1-1
TGTGCCAGCAGCTCAGGGGGAATAGCTTTCTTT	CASSSGGIAFF	TRBV5-6	TRBJ1-1
TGTGCCAGCACCCCCGGGACTAGCGGGAGCAGGAAAGGAGGCGAGCAGTACTTC	CASTPGTSGSRKGGEQYF	TRBV7-3	TRBJ2-7
TGTGCCAGCAGTGACCCCCGGGAAGTCAATCAGCCCCAGCATTTT	CASSDPREVNQPQHF	TRBV6-1	TRBJ1-5
TGTGCCAGCAGATTGGTGGTATGGTTCATGCGTGAATCCTACAATGAGCAGTTCTTC	CASRLVVWFMRESYNEQFF	TRBV6-2	TRBJ2-1
TGTGCCTGGATGAGGGGACTAGAGTGGGTACACGCCTACGAGCAGTACTTC	CAWMRGLEWVHAYEQYF	TRBV30	TRBJ2-7
TGTGCCAGCAGCCAAGATCCCCTCACTCCCTCTGGAAACACCATATATTTT	CASSQDPLTPSGNTIYF	TRBV3-1	TRBJ1-3
TGTGCCACCAGTGCTCCCCGGACGAGGGTATTAGATACGCAGTATTTT	CATSAPRTRVLDTQYF	TRBV24-1	TRBJ2-3
TGTGCCAGCAGCCTTCAAGGTACCAGCTCTGGGGCCAACGTCCTGACTTTC	CASSLQGTSSGANVLTF	TRBV4-2	TRBJ2-6
TGTGCCAGCAGCTTGTACCTAGCGGGGGGGCCTGGACAACCCTCCTACGAGCAGTACTTC	CASSLYLAGGPGQPSYEQYF	TRBV7-6	TRBJ2-7
TGTGCCTGGACGGGTGGCCCGGGACAGGTCCAAGAGACCCAGTACTTC	CAWTGGPGQVQETQYF	TRBV30	TRBJ2-5
TGTGCCAGCAGTTTATTTTCCCGGGCACAGGGACATAGCAATCAGCCCCAGCATTTT	CASSLFSRAQGHSNQPQHF	TRBV12-4	TRBJ1-5
TGTGCCAGCAGCGTAGGTACCGGAGGGCGGCAGTACTTC	CASSVGTGGRQYF	TRBV9	TRBJ2-7
TGCGCCAGCAGCCAAGCTTCGTGGACAGGGAAAACCGGGGAGCTGTTTTTT	CASSQASWTGKTGELFF	TRBV4-1	TRBJ2-2
TGTGCCAGCAGTTTACCCCGGGGGGAAAACACCGGGGAGCTGTTTTTT	CASSLPRGENTGELFF	TRBV28	TRBJ2-2
TGTGCCAGCAGGGTTAAGATCCGGGACAGTCCGCAGTACTTC	CASRVKIRDSPQYF	TRBV3-1	TRBJ2-5
TGTGCCAGCAGCCAAGATTCACATTCCGGGACAGGGCTAGGCTACACCTTC	CASSQDSHSGTGLGYTF	TRBV4-2	TRBJ1-2
TGTGCCAGCAGTTTTTGGCAGGACAGGTGCCAAGAGACCCAGTACTTC	CASSFWQDRCQETQYF	TRBV27	TRBJ2-5
TGTGCCAGCAGAACCCGGGGGGGTCTCTTC	CASRTRGGLF	TRBV6-1	TRBJ2-1
TGTGCCAGCAGCTTGAAGCGGGCCGGCAATCAGCCCCAGCATTTT	CASSLKRAGNQPQHF	TRBV5-4	TRBJ1-5
TGTGCCAGCAGCTTGGCCTGGGGAGTTTATGGCTACACCTTC	CASSLAWGVYGYTF	TRBV5-4	TRBJ1-2
TGTGCCAGCAGCGGGGCGGGGAGCACAGATACGCAGTATTTT	CASSGAGSTDTQYF	TRBV9	TRBJ2-3
TGTGCCACCAGCAGGGGAGGCCCCGGGACTAGGAGGACCTACGAGCAGTACTTC	CATSRGGPGTRRTYEQYF	TRBV15	TRBJ2-7
TGTGCCAGGGGAAGGGGGTGCTACAATGAGCAGTTCTTC	CARGRGCYNEQFF	TRBV27	TRBJ2-1
TGTGCCAGCAGCAGGGGCGATGAAAAACTGTTTTTT	CASSRGDEKLFF	TRBV5-4	TRBJ1-4
TGTGCCAGCAGCTTGGAACAGATCCCAAGAACCGGGGAGCTGTTTTTT	CASSLEQIPRTGELFF	TRBV5-4	TRBJ2-2
TGTGCCAGCAGCGTGACTCAGGGCTTGTGTTCGGCCGAGACCCAGTACTTC	CASSVTQGLCSAETQYF	TRBV9	TRBJ2-5
TGCGCCAGCAGCTGGTCGACTAAATACATCTACGAGCAGTACTTC	CASSWSTKYIYEQYF	TRBV10-1	TRBJ2-7
TGTGCCAGCAGCTTGGACGGAAGGGACAGGGGTCCCAACACTGAAGCTTTCTTT	CASSLDGRDRGPNTEAFF	TRBV5-6	TRBJ1-1
TGTGCCAGCAGCCAAGACCGTCCAACAGGGTCCCCAAAAGAGACCCAGTACTTC	CASSQDRPTGSPKETQYF	TRBV14	TRBJ2-5
TGTGCCAGCAGTTTCCCCCAGGGTTTGTCTGGGGCCAACGTCCTGACTTTC	CASSFPQGLSGANVLTF	TRBV12-4	TRBJ2-6
TGCGCCAGCAGCTGTTTGAAAATATTGAAAAGGTATTATCAGCCCCAGCATTTT	CASSCLKILKRYYQPQHF	TRBV5-1	TRBJ1-5
TGTGCCAGCAGTGGAACCGGGTATGGCTACACCTTC	CASSGTGYGYTF	TRBV25-1	TRBJ1-2
TGCAGTGCTAGCCCCCGATACTACGAGCAGTACTTC	CSASPRYYEQYF	TRBV20-1	TRBJ2-7
TGTGCCAGCGGGGGGGTTGGCATCGAGCAGTACTTC	CASGGVGIEQYF	TRBV6-8	TRBJ2-7
TGTGCCAGCAGCTTAGAGTGGCAGGGAGACCCTGGAAACACCATATATTTT	CASSLEWQGDPGNTIYF	TRBV11-1	TRBJ1-3
TGTGCCAGCAGCCAAGATCTAGGACGGGGGGTTACCTACGAGCAGTACTTC	CASSQDLGRGVTYEQYF	TRBV3-1	TRBJ2-7
TGTGCCAGCAGCTATGATTCGGGGGACACTAACTATGGCTACACCTTC	CASSYDSGDTNYGYTF	TRBV5-6	TRBJ1-2
TGTGCCAGCAGTGTTAGGACATGGCTCTCCTATAATTCACCCCTCCACTTT	CASSVRTWLSYNSPLHF	TRBV25-1	TRBJ1-6
TGTGCCAGCAGCCAAGATCTAACTAGCGGGAATCTTCCAGTGTACAATGAGCAGTTCTTC	CASSQDLTSGNLPVYNEQFF	TRBV14	TRBJ2-1
TGTGCCAGCTCACCGGGGACTCGGAACACTGAAGCTTTCTTT	CASSPGTRNTEAFF	TRBV18	TRBJ1-1
TGTGCCAGCAGGCCAGTCCCGACTAGTCTAGATACGCAGTATTTT	CASRPVPTSLDTQYF	TRBV6-1	TRBJ2-3
TGTGCCAGCAGCGGGGCCGGGACTAGCCACTCCTACGAGCAGTACTTC	CASSGAGTSHSYEQYF	TRBV5-6	TRBJ2-7
TGTGCCAGCAGCGTAGGAACAGGGTTTAGCGTCCTGACTTTC	CASSVGTGFSVLTF	TRBV9	TRBJ2-6
TGTGCCAGCAGCCCCCAATGGGGGCACAATGAGCAGTTCTTC	CASSPQWGHNEQFF	TRBV28	TRBJ2-1
TGTGCCAGCAGCAGAACGTCAGGGATCAACACTGAAGCTTTCTTT	CASSRTSGINTEAFF	TRBV7-9	TRBJ1-1
TGTGCCAGCAGGGGCGGATTCGAAGCCTATGGCTACACCTTC	CASRGGFEAYGYTF	TRBV5-4	TRBJ1-2
TGTGCCAGCAGTGAGTGTGTGGGAGAGAGCGAGCAGTACTTC	CASSECVGESEQYF	TRBV6-4	TRBJ2-7
TGTGCCAGCAGCTTCCCAGAGGCCAGCGAGCAGTACTTC	CASSFPEASEQYF	TRBV7-9	TRBJ2-7
TGTGCTAGTGGTTTGAAAGGACCGCAGCCCCAGCATTTT	CASGLKGPQPQHF	TRBV12-5	TRBJ1-5
TGTGCCAGCAGTGAATACGAAACCGGGACCAAAGAGACCCAGTACTTC	CASSEYETGTKETQYF	TRBV25-1	TRBJ2-5
TGTGCCAGCAACGGGACACGGGACTTGTACAATGAGCAGTTCTTC	CASNGTRDLYNEQFF	TRBV27	TRBJ2-1
TGCGCCAGCCAGCGGGAGGGCGCGAACGAGCAGTACTTC	CASQREGANEQYF	TRBV10-2	TRBJ2-7
TGTGCCAGCAGCCCCCCCAAGGGTTTCAATCAGCCCCAGCATTTT	CASSPPKGFNQPQHF	TRBV7-9	TRBJ1-5
TGTGCCAGCAGCTTAGTTACCGGACAGCCCACCTTC	CASSLVTGQPTF	TRBV7-9	TRBJ1-2
TGTGCCTGGAAAACCAAACCCGGGACTAGCGGGAGTAAAGACCCACCAGATACGCAGTATTTT	CAWKTKPGTSGSKDPPDTQYF	TRBV30	TRBJ2-3
TGCAGCGTTGAAGAGGTTGACAGGGGCTACACCTTC	CSVEEVDRGYTF	TRBV29-1	TRBJ1-2
TGTGCCAGCAGTTACTCCGCGGCGGGGAGTAGGGGGAAAGAGACCCAGTACTTC	CASSYSAAGSRGKETQYF	TRBV6-2	TRBJ2-5
TGCGCCAGCAGCTTGCCGGACAGGTTTGGCTACACCTTC	CASSLPDRFGYTF	TRBV5-1	TRBJ1-2
TGTGCCAGCAGTTTCCCCAGGGAATATTATTTT	CASSFPREYYF	TRBV6-2	TRBJ1-3
TGTGCCAGCAGCCAAGATGTCAAGACTAGAGACAATGAGCAGTTCTTC	CASSQDVKTRDNEQFF	TRBV14	TRBJ2-1
TGTGCCTGGAGGTTAGCGGGGGAGACCCAGTACTTC	CAWRLAGETQYF	TRBV30	TRBJ2-5
TGTGCCTGGGGGGGACTAGCGGGTCAGACAGATACGCAGTATTTT	CAWGGLAGQTDTQYF	TRBV30	TRBJ2-3
TGTGCCAGCAGTTCGAGGGGACAATACACTGAAGCTTTCTTT	CASSSRGQYTEAFF	TRBV6-6	TRBJ1-1
TGTGCCAGTAGTACAGACAGCCTTATTGGGACCTACGAGCAGTACTTC	CASSTDSLIGTYEQYF	TRBV19	TRBJ2-7
TGTGCCAGCAGCGTCGCTGCCCTCGGACAGGGGGACACCATATATTTT	CASSVAALGQGDTIYF	TRBV9	TRBJ1-3
TGTGCCAGCAGTCCCCCAGGAGACGAGCAGTACTTC	CASSPPGDEQYF	TRBV27	TRBJ2-7
TGCAGTGCTAGAGGCCTGGAGGGTTATGGCTACACCTTC	CSARGLEGYGYTF	TRBV20-1	TRBJ1-2
TGTGCCAGAGCACATGGTATCTCTGGAAACACCATATATTTT	CARAHGISGNTIYF	TRBV9	TRBJ1-3
TGTGCCAGCGGCAGGGGTGGATGGGGATGTGGCTACACCTTC	CASGRGGWGCGYTF	TRBV27	TRBJ1-2
TGTGCCAGCAGCTTAACCAGGACAGGGCGTGAATATAGCAATCAGCCCCAGCATTTT	CASSLTRTGREYSNQPQHF	TRBV7-9	TRBJ1-5
TGCGCCAGCAGCTTAAGGATTTACGAGCAGTACTTC	CASSLRIYEQYF	TRBV5-1	TRBJ2-7
TGCAGTGCTCTACGGGACAGGAATGAGCAAGAGACCCAGTACTTC	CSALRDRNEQETQYF	TRBV20-1	TRBJ2-5
TGTGCCAGCAGTGACTCGAATGACAGGGGGCGTCCCGGGGAGCTGTTTTTT	CASSDSNDRGRPGELFF	TRBV6-4	TRBJ2-2
TGTGCCAGCAGCTATCGGGCCCCCGGGACAGGGTACTTC	CASSYRAPGTGYF	TRBV5-5	TRBJ2-7
TGTGCCAGCAGCGTCAAGCTTATGAATCCTAGCGGGAGCAGAGATACGCAGTATTTT	CASSVKLMNPSGSRDTQYF	TRBV7-3	TRBJ2-3
TGTGCCAGTAGTAACGATCCGAGGCCCGAGCAGTACTTC	CASSNDPRPEQYF	TRBV19	TRBJ2-7
TGTGCCAGCAGTTACCCGTTCACAGGGAGGGCACCGACCCAGTACTTC	CASSYPFTGRAPTQYF	TRBV6-5	TRBJ2-5
TGTGCCAGCAGTTCCGGGGGGCGACGAGACACCGGGGAGCTGTTTTTT	CASSSGGRRDTGELFF	TRBV28	TRBJ2-2
TGTGCCACTCTCTGGGCTGATGAGCAGTTCTTC	CATLWADEQFF	TRBV10-3	TRBJ2-1
TGTGCCAGCAGGCGTAGCGGGGTTGAGCAGTTCTTC	CASRRSGVEQFF	TRBV11-3	TRBJ2-1
TGTGCCTGGAATAAGCCCGAGAGGACAGCAAATTCCTACGAGCAGTACTTC	CAWNKPERTANSYEQYF	TRBV30	TRBJ2-7
TGCAGCGTTAATCAGTTAGGTTTCACTGAAGCTTTCTTT	CSVNQLGFTEAFF	TRBV29-1	TRBJ1-1
TGTGCCAGCAGGCCCCGGGGGCCTACCTACGAGCAGTACTTC	CASRPRGPTYEQYF	TRBV6-5	TRBJ2-7
TGTGCCAGCAGCCAAGATACGAGGGGGACAGGGGACGAGCAGTACTTC	CASSQDTRGTGDEQYF	TRBV3-1	TRBJ2-7
TGCGCCAGCAGCGAAAGCGCCCCGGGGGGGAATGAGCAGTTCTTC	CASSESAPGGNEQFF	TRBV4-1	TRBJ2-1
TGTGCCGAGGAAAACATTCAGTACTTC	CAEENIQYF	TRBV14	TRBJ2-4
TGCGCCAGCAGCAGAAAAACCATGACAGTAAAGAGCTCTGGGGCCAACGTCCTGACTTTC	CASSRKTMTVKSSGANVLTF	TRBV5-1	TRBJ2-6
TGTGCCAGCAGTGAAGTTGTTCAGGGGGCGGCCACTGAAGCTTTCTTT	CASSEVVQGAATEAFF	TRBV6-1	TRBJ1-1
TGTGCCAGCAGTTTATGCCCAATTTTACGTCCCGTTAGAATTTACAATGAGCAGTTCTTC	CASSLCPILRPVRIYNEQFF	TRBV28	TRBJ2-1
TGTGCCAGCAGTTTATCGGGGGCGCCTTACGAGCAGTACTTC	CASSLSGAPYEQYF	TRBV28	TRBJ2-7
TGTGCCAGCAGAGAACTTGAGCAGTACTTC	CASRELEQYF	TRBV6-6	TRBJ2-7
TGCAGCGAGGGGGGTAAGAACACCGGGGAGCTGTTTTTT	CSEGGKNTGELFF	TRBV29-1	TRBJ2-2
TGCAGTGCTAATCGTAGGAGGAGACTGTTTTTT	CSANRRRRLFF	TRBV20-1	TRBJ1-4
TGCGCCAGCAGCCGGTTAGGTGGAGGGCCCTTAAACATTCAGTACTTC	CASSRLGGGPLNIQYF	TRBV4-1	TRBJ2-4
TGCGCCAGCAGCAAGACACCAGGAGGGCATACCGGCAATGAGCAGTTCTTC	CASSKTPGGHTGNEQFF	TRBV4-1	TRBJ2-1
TGTGCCAGCAGGGGAGGGGTTGGTTACAATGAGCAGTTCTTC	CASRGGVGYNEQFF	TRBV7-7	TRBJ2-1
TGTGCCAGCAGTGAAACCAATCAGGGGGCATTCGAGCAGTACTTC	CASSETNQGAFEQYF	TRBV6-4	TRBJ2-7
TGTGCCAGCGCCTCGGACGGACGTGACTACAATGAGCAGTTCTTC	CASASDGRDYNEQFF	TRBV12-3	TRBJ2-1
TGTGCCAGCAGCCGGGACAGGGGGCGAACCCTCCACTTT	CASSRDRGRTLHF	TRBV11-3	TRBJ1-6
TGTGCCAGCAGCACCCGTCCCACTAACTATGGCTACACCTTC	CASSTRPTNYGYTF	TRBV5-6	TRBJ1-2
TGCAGCGCCCCGGACTATAAGGGGACCGGGGAGCTGTTTTTT	CSAPDYKGTGELFF	TRBV29-1	TRBJ2-2
TGTGCCAGCAGCCTCACAGGAGTCGAGCAGTACTTC	CASSLTGVEQYF	TRBV9	TRBJ2-7
TGTGCCAGCAGTAAACGTCCGAACACCGGGGAGCTGTTTTTT	CASSKRPNTGELFF	TRBV2	TRBJ2-2
TGTGCCAGCAGTTTCCCCCTCCTGACGGGTAACTATGGCTACACCTTC	CASSFPLLTGNYGYTF	TRBV27	TRBJ1-2
TGTGCCGAGCAGAGGGAAACCTACGAGCAGTACTTC	CAEQRETYEQYF	TRBV11-2	TRBJ2-7
TGTGCCTGGATAGGAGCGGGTACTTACTCTGGAAACACCATATATTTT	CAWIGAGTYSGNTIYF	TRBV30	TRBJ1-3
TGTGCCAGCAGCTTAGATAAAGCTCGGCGGGACTTTTACACAGATACGCAGTATTTT	CASSLDKARRDFYTDTQYF	TRBV11-2	TRBJ2-3
TGTGCCAGTAGTCCTACTGAGCAGTTCTTC	CASSPTEQFF	TRBV19	TRBJ2-1
TGCAGTGCTAGAGAGAGGTTGGCCTACGAGCAGTACTTC	CSARERLAYEQYF	TRBV20-1	TRBJ2-7
TGTGCCAGCAGCGATAGGGACTACGAGCAGTACTTC	CASSDRDYEQYF	TRBV7-9	TRBJ2-7
TGTGCCAGCAGCGATTCTCGCCGGGGTGATAGCAATCAGCCCCAGCATTTT	CASSDSRRGDSNQPQHF	TRBV13	TRBJ1-5
TGTGCCATCAGTGTGGGAACCCCGGGGCGGGGGAAGCCCCAGCATTTT	CAISVGTPGRGKPQHF	TRBV10-3	TRBJ1-5
TGTGCCAGCAGCTCCCTAGTCCGGGACAGGGACACTGAAGCTTTCTTT	CASSSLVRDRDTEAFF	TRBV7-3	TRBJ1-1
TGTGCCAGCACGGCCGGGGAGTTGACTAGCGAGCAGTACTTC	CASTAGELTSEQYF	TRBV5-4	TRBJ2-7
TGTGCCAGCAGCCAAGATGAAGGGCCCGGGACTAGCATTTGCGAGCAGTACTTC	CASSQDEGPGTSICEQYF	TRBV4-2	TRBJ2-7
TGCGCCAGCAGCCAACCGCCAACGGACTGTGGCCAAGAGACCCAGTACTTC	CASSQPPTDCGQETQYF	TRBV4-1	TRBJ2-5
TGTGCCAGCAGTTACTCTTGGGGGAATTCACCCCTCCACTTT	CASSYSWGNSPLHF	TRBV6-5	TRBJ1-6
TGTATGGGACTAGCGCCCTACGAGCAGTACTTC	CMGLAPYEQYF	TRBV20-1	TRBJ2-7
TGTGCCAGCAGCTTAGGCTACAGTCGTCGCTACGAGCAGTACTTC	CASSLGYSRRYEQYF	TRBV7-9	TRBJ2-7
TGCAGCGTTCGCCGGGACAGGGCTTCGTTTGGCTACACCTTC	CSVRRDRASFGYTF	TRBV29-1	TRBJ1-2
TGTGCCTGGAAATGGGACAGGGCCTACGAGCAGTACTTC	CAWKWDRAYEQYF	TRBV30	TRBJ2-7
TGTGCCAGCAGGCAGGCTAGGGTCTACGAGCAGTACTTC	CASRQARVYEQYF	TRBV16	TRBJ2-7
TGTGCCAGCAGCTTGGACAGGGCAATCTATGGCTACACCTTC	CASSLDRAIYGYTF	TRBV7-9	TRBJ1-2
TGCAGTGCTAGAGACCTACAGGGGAAGAGTATCAACACTGAAGCTTTCTTT	CSARDLQGKSINTEAFF	TRBV20-1	TRBJ1-1
TGTGCCTGCCCCGAGGGGGGCAAAAACATTCAGTACTTC	CACPEGGKNIQYF	TRBV30	TRBJ2-4
TGCGCCAGCAGCCAAGATGGGTCGGGACTAGCAGTGGAGCAGTACTTC	CASSQDGSGLAVEQYF	TRBV4-1	TRBJ2-7
TGTGCCAGCAGCCCGGACAAAAGTTGGAACACTGAAGCTTTCTTT	CASSPDKSWNTEAFF	TRBV28	TRBJ1-1
TGTGCCAGCAGCTTGACTTGGAGGTCCCAAGAGACCCAGTACTTC	CASSLTWRSQETQYF	TRBV5-6	TRBJ2-5
TGTGCCAGCAGTGAAGCCGCGGTTTCGACAGACATTACAGATACGCAGTATTTT	CASSEAAVSTDITDTQYF	TRBV6-1	TRBJ2-3
TGTGCCAGCAGCTATCCCTGGACAGGTAGCAATGAGCAGTTCTTC	CASSYPWTGSNEQFF	TRBV7-9	TRBJ2-1
TGTGCCAGCAGCCAAGAAGAGGGACTAGCGGGAGGCGGGTACGAGCAGTACTTC	CASSQEEGLAGGGYEQYF	TRBV14	TRBJ2-7
TGTGCCACAAACGAGACAGGAGGAAGGGGTACCGGGGAGCTGTTTTTT	CATNETGGRGTGELFF	TRBV24-1	TRBJ2-2
TGTGCCAGCAGCTATGTTTTAGCCTACGAGCAGTACTTC	CASSYVLAYEQYF	TRBV5-6	TRBJ2-7
TGTGCCAGCAGCTTAGGGGACTTCAATCAGCCCCAGCATTTT	CASSLGDFNQPQHF	TRBV7-9	TRBJ1-5
TGTGCCAGCAGTGAAGACAGGGTATCGAACACTGAAGCTTTCTTT	CASSEDRVSNTEAFF	TRBV6-1	TRBJ1-1
TGTGCCAGCAGAAACGTTGGGGAGGGACAGACGAACACTGAAGCTTTCTTT	CASRNVGEGQTNTEAFF	TRBV2	TRBJ1-1
TGTGCCAGCAGCCAACCCGTGGACAGGGGGATCAGCAATCAGCCCCAGCATTTT	CASSQPVDRGISNQPQHF	TRBV14	TRBJ1-5
TGTGCCAGCAGCCCAGTGACACTCGAGCAGTACTTC	CASSPVTLEQYF	TRBV9	TRBJ2-7
TGTGCCAGCAGCTTAACGAATGGGGGAGGGGGAGACGAGCAGTACTTC	CASSLTNGGGGDEQYF	TRBV7-3	TRBJ2-7
TGCGCCAGCAGCTTGGTCCCCCGTCCCAGGGGCGACAGTGTCACCTACGAGCAGTACTTC	CASSLVPRPRGDSVTYEQYF	TRBV5-1	TRBJ2-7
TGTGCCAGCAGCGTAGAATGCAGAGGCCTCACTGAAGCTTTCTTT	CASSVECRGLTEAFF	TRBV9	TRBJ1-1
TGTGCCAGCAGTTTCGCGGGAGTGAACACTGAAGCTTTCTTT	CASSFAGVNTEAFF	TRBV27	TRBJ1-1
TGTGCCAGCAGCCCCTACCACGAGCAGTACTTC	CASSPYHEQYF	TRBV7-9	TRBJ2-7
TGTGCCAGCAGTGATCCTGGACAGGGGGCCACTGAAGCTTTCTTT	CASSDPGQGATEAFF	TRBV6-6	TRBJ1-1
TGTGCCAGCAGTTCATCTGGTAATTCACCCCTCCACTTT	CASSSSGNSPLHF	TRBV6-5	TRBJ1-6
TGCGCCAGCAGTGAGTCTGACAGGGGTATGAGAACTCAGAACTATGGCTACACCTTC	CASSESDRGMRTQNYGYTF	TRBV10-1	TRBJ1-2
TGTGCCAGCAGTGAGAGCGGTGGGTCCTACAATGAGCAGTTCTTC	CASSESGGSYNEQFF	TRBV6-4	TRBJ2-1
TGTGCCAGCAGTGAAGCGCTTGTGCGGGGCAAAAACATTCAGTACTTC	CASSEALVRGKNIQYF	TRBV2	TRBJ2-4
TGCGCCAGCAGCCGAGGGATAACTGAAGCTTTCTTT	CASSRGITEAFF	TRBV4-3	TRBJ1-1
TGTGCCAGCAGTGAAACGTCTAGCGGGTGGTACGAGCAGTACTTC	CASSETSSGWYEQYF	TRBV6-4	TRBJ2-7
TGTGCCAGCAGTTACGAACTACTAGCGGGGAACACAGATACGCAGTATTTT	CASSYELLAGNTDTQYF	TRBV6-5	TRBJ2-3
TGCGCCAGCAGCCGTATAAAGGACCAAGAGCCGACGCCCCAGCATTTT	CASSRIKDQEPTPQHF	TRBV4-3	TRBJ1-5
TGTGCCAGCAGCTCCAGACTAGCGGGCAGCGTAGAGACCCAGTACTTC	CASSSRLAGSVETQYF	TRBV5-4	TRBJ2-5
TGTGCCAGCAGTGGACTTACTGCCTACAATGAGCAGTTCTTC	CASSGLTAYNEQFF	TRBV6-2	TRBJ2-1
TGTGCCAGCAGCCATCCGAAAGGGGGGAACAATGAGCAGTTCTTC	CASSHPKGGNNEQFF	TRBV3-1	TRBJ2-1
TGTGCCAGCAGAACAGGGGGCTGGGATCAGGAGACCCAGTACTTC	CASRTGGWDQETQYF	TRBV11-2	TRBJ2-5
TGTGCCAGCAGCTTAGATAGCGGGGGTGCGTACAATGAGCAGTTCTTC	CASSLDSGGAYNEQFF	TRBV7-9	TRBJ2-1
TGTGCCAGCAGTAGGGACAACAATGAGCAGTTCTTC	CASSRDNNEQFF	TRBV6-4	TRBJ2-1
TGTGCCAGCAGCCCGCAGGGGATAAAAGGCTACGAGCAGTACTTC	CASSPQGIKGYEQYF	TRBV9	TRBJ2-7
TGCGCCAGCAGGGACAGGTGTAGCAATCAGCCCCAGCATTTT	CASRDRCSNQPQHF	TRBV4-1	TRBJ1-5
TGTGCCAGCAGTCATTTCCCGTCCCTCAGCGGGACAAACGAAGACACTGAAGCTTTCTTT	CASSHFPSLSGTNEDTEAFF	TRBV6-1	TRBJ1-1
TGCGCCAGCAGCTTGGGGGGACGACACAATGAGCAGTTCTTC	CASSLGGRHNEQFF	TRBV5-1	TRBJ2-1
TGTGCCAGCAGTTACCCCGTACTACATTGGAAGGGTAATGAAAAACTGTTTTTT	CASSYPVLHWKGNEKLFF	TRBV6-2	TRBJ1-4
TGTGCCAGCGTCCCACGGGGATATAGCAATCAGCCCCAGCATTTT	CASVPRGYSNQPQHF	TRBV6-1	TRBJ1-5
TGTGCCAGCAGGTTCCAGGGATCCAATCAGCCCCAGCATTTT	CASRFQGSNQPQHF	TRBV7-3	TRBJ1-5
TGTGCCAGCAGGTGGGGGCCCGAGCAGTACTTC	CASRWGPEQYF	TRBV12-3	TRBJ2-7
TGTGCCAGCAGCCCAGCGAGAATGTCCGGGGAGCTGTTTTTT	CASSPARMSGELFF	TRBV6-5	TRBJ2-2
TGTGCCAGCAGTTGTCCTGGGACCCCTGACTTAGAGACCCAGTACTTC	CASSCPGTPDLETQYF	TRBV11-2	TRBJ2-5
TGTGCCAGCAGTGCCGTGGGGGGGCGCTACGAGCAGTACTTC	CASSAVGGRYEQYF	TRBV6-4	TRBJ2-7
TGTGCCAGCAGGGTTCACAGGGGGAATGAGCAGTTCTTC	CASRVHRGNEQFF	TRBV11-3	TRBJ2-1
TGCGCCAGCGTGAGGGTTGGGAACACTGAAGCTTTCTTT	CASVRVGNTEAFF	TRBV10-1	TRBJ1-1
TGTGCCCAAGCAAACAGGAAGGGTTTTAACTATGGCTACACCTTC	CAQANRKGFNYGYTF	TRBV28	TRBJ1-2
TGTGCCAGCAGTGTTGGACCCAGCAACCCCCGCGATGGCTACACCTTC	CASSVGPSNPRDGYTF	TRBV25-1	TRBJ1-2
TGTGCCAGCAGTGAATGGGGGGCCGAGCAGTACTTC	CASSEWGAEQYF	TRBV6-1	TRBJ2-7
TGTGCCAGCAGCATCCCGCGCAATGAAAAACTGTTTTTT	CASSIPRNEKLFF	TRBV3-1	TRBJ1-4
TGTGCCAGCACCCCCGGCTGGCCCCGGAACACTGAAGCTTTCTTT	CASTPGWPRNTEAFF	TRBV2	TRBJ1-1
TGTGCCAGCAGCATAGCGGGAACGGGGCCCACAGATACGCAGTATTTT	CASSIAGTGPTDTQYF	TRBV7-3	TRBJ2-3
TGTGCCACCAGTGATTTTATAAGCCCACCGGGAGGTCGTGCTCACGAGCAGTACTTC	CATSDFISPPGGRAHEQYF	TRBV24-1	TRBJ2-7
TGCGCCAGCAGCTTGCAGGATTTCGACTGGCTAGGGGCGCAAGAGACCCAGTACTTC	CASSLQDFDWLGAQETQYF	TRBV5-1	TRBJ2-5
TGCGCCAGCCCCATGGGGGGGCCACACGAGCAGTACTTC	CASPMGGPHEQYF	TRBV10-1	TRBJ2-7
TGTGCCAGCAACCCCGTAGGACAGGGGGCTGCCAAGGGCTACACCTTC	CASNPVGQGAAKGYTF	TRBV5-6	TRBJ1-2
TGTGCCAGCAGCAGCGGGACTAGGCTTTACAATGAGCAGTTCTTC	CASSSGTRLYNEQFF	TRBV6-5	TRBJ2-1
TGTGCCTGGAGTAAGACGACCGGGACGGCCTCTGGAAACACCATATATTTT	CAWSKTTGTASGNTIYF	TRBV30	TRBJ1-3
TGTGCCTACAACAGGGGCCTCCACTTT	CAYNRGLHF	TRBV6-5	TRBJ1-6
TGTGCCTGGTCTTCAGGACAGTGGAACGAGCAGTACTTC	CAWSSGQWNEQYF	TRBV30	TRBJ2-7
TGTGCCAGCAGTTCTCTAGCGAAAGGGAGTACCTACAATGAGCAGTTCTTC	CASSSLAKGSTYNEQFF	TRBV27	TRBJ2-1
TGTGCCAGCAGGCGGGAGGGTGAAGCTTTCTTT	CASRREGEAFF	TRBV6-5	TRBJ1-1
TGTGCCAGCAGACACTGCCGGCCCAGGACAGTCGCGGGCTACACCTTC	CASRHCRPRTVAGYTF	TRBV6-1	TRBJ1-2
TGCAGTGCTGCGGGACAGGCCTGGGGCACAGATACGCAGTATTTT	CSAAGQAWGTDTQYF	TRBV20-1	TRBJ2-3
TGTGCCAGCAGCGGCTGGGGACCCGAGCAGTACTTC	CASSGWGPEQYF	TRBV7-2	TRBJ2-7
TGTGCCTGGATAACCACTGAAGCTTTCTTT	CAWITTEAFF	TRBV30	TRBJ1-1
TGTGCCAGCAGCCTTCACGAGCAGTACTTC	CASSLHEQYF	TRBV13	TRBJ2-7
TGCAGCGTTGAAGCTCGCCCTCTATACTCTGGGGCCAACGTCCTGACTTTC	CSVEARPLYSGANVLTF	TRBV29-1	TRBJ2-6
TGCAATTTGGGCCAGAAGGCCGGGGAGCTGTTTTTT	CNLGQKAGELFF	TRBV29-1	TRBJ2-2
TGTGCCACCAGCAGAGAATGCGGGACAGGGTCCTACGAGCAGTACTTC	CATSRECGTGSYEQYF	TRBV15	TRBJ2-7
TGTGCCATCTCACCCCGACAGGACGCGAAACTAAAGCAAGAAGGACGGGGGTCCTACGAGCAGTACTTC	CAISPRQDAKLKQEGRGSYEQYF	TRBV6-2	TRBJ2-7
TGTGCCAGCAGCCAAGCCCCCACTAGAGACGCGAACACCGGGGAGCTGTTTTTT	CASSQAPTRDANTGELFF	TRBV3-1	TRBJ2-2
TGTGCCAGCAGTCCCCCCGTTCAGGTCTCTGGAAACACCATATATTTT	CASSPPVQVSGNTIYF	TRBV27	TRBJ1-3
TGTGCCAGCTTCAGTTATAATCAGCCCCAGCATTTT	CASFSYNQPQHF	TRBV13	TRBJ1-5
TGTGCCAGCAGCAGGCCCGGTACTAGCGGGAGGGTCGAGCAGTTCTTC	CASSRPGTSGRVEQFF	TRBV6-1	TRBJ2-1
TGTGCCAGCAGCTTACACCCCAGAGGAGCTGAAGCTTTCTTT	CASSLHPRGAEAFF	TRBV11-3	TRBJ1-1
TGCGCCAGCGAGGGGGGGGCTTGGAGGAGTGAGCAGTTCTTC	CASEGGAWRSEQFF	TRBV4-1	TRBJ2-1
TGTGCCAGCAGCAATGACGAGCAGTACTTC	CASSNDEQYF	TRBV6-1	TRBJ2-7
TGTGCCAGCCGCGGGGGGCAAGAGACCCAGTACTTC	CASRGGQETQYF	TRBV27	TRBJ2-5
TGCAGTGCTCGAGACCGGCGCTACGAGCAGTACTTC	CSARDRRYEQYF	TRBV20-1	TRBJ2-7
TGTGCCAGCAGCTTAGTTCCGATGCAGTGCCATTCACCCCTCCACTTT	CASSLVPMQCHSPLHF	TRBV11-2	TRBJ1-6
TGTGCCAGCTCGTCCGGAGGGTTCAACCCGAAGTACAATGAGCAGTTCTTC	CASSSGGFNPKYNEQFF	TRBV18	TRBJ2-1
TGTGCCAGTAGCCGAAATCCGGACAGGGAGGTTAATCAGCCCCAGCATTTT	CASSRNPDREVNQPQHF	TRBV19	TRBJ1-5
TGTGCCAGCAGCTTACGGGGAGAGCAGTTCTTC	CASSLRGEQFF	TRBV5-4	TRBJ2-1
TGCAGTGCTAGAGATTCTAATGACAGGGGACATAGCAATCAGCCCCAGCATTTT	CSARDSNDRGHSNQPQHF	TRBV20-1	TRBJ1-5
TGTGCCAGCAGCTGGGATCGTGGGACGAACACCGGGGAGCTGTTTTTT	CASSWDRGTNTGELFF	TRBV7-4	TRBJ2-2
TGTGCCAGCAGCCTAATCACTCGCGGGGCTAAAGGTGATACTGAAGCTTTCTTT	CASSLITRGAKGDTEAFF	TRBV7-3	TRBJ1-1
TGTGCCAGCAGGGAAGACGGGACAGGGAGGTCCTACAATGAGCAGTTCTTC	CASREDGTGRSYNEQFF	TRBV7-3	TRBJ2-1
TGTGCCAGCAGCTTAGGACCGGGGGGCCGCTTAGAGACCCAGTACTTC	CASSLGPGGRLETQYF	TRBV7-4	TRBJ2-5
TGTGCCAGCAGTGAATACCCAAAGGTTTCTCTGTATGGCTACACCTTC	CASSEYPKVSLYGYTF	TRBV25-1	TRBJ1-2
TGTGCCAGCAGCGGGCCGAGGGCGGGGCGAGCCTCCTACGAGCAGTACTTC	CASSGPRAGRASYEQYF	TRBV13	TRBJ2-7
TGCAGCGTTGAGAGGAAGGGACAGTCCTACAATGAGCAGTTCTTC	CSVERKGQSYNEQFF	TRBV29-1	TRBJ2-1
TGTGCCAGTAGTATCGGCCTAGCGGGGCAAAAAAACGAGCAGTACTTC	CASSIGLAGQKNEQYF	TRBV19	TRBJ2-7
TGCGCCAGCAGCTTGGCCGACCAACAGAACGCGAACACCGGGGAGCTGTTTTTT	CASSLADQQNANTGELFF	TRBV5-1	TRBJ2-2
TGTGCCAGCCCTACCAAACCTCCCAAAAACATTCAGTACTTC	CASPTKPPKNIQYF	TRBV2	TRBJ2-4
TGTGCCAGCAGCGTAGTGGCATTAGTCAATCAGCCCCAGCATTTT	CASSVVALVNQPQHF	TRBV9	TRBJ1-5
TGTGCCAGCAGCGGCGAAGGGGGCAAAGACGTGTGGAACACCGGGGAGCTGTTTTTT	CASSGEGGKDVWNTGELFF	TRBV13	TRBJ2-2
TGTGCCAGCAGCCGACGGGCTATAGGCAAAGGTGCTGAAGCTTTCTTT	CASSRRAIGKGAEAFF	TRBV3-1	TRBJ1-1
TGCGCCAGCAAAGGACAGGGTTCCGGGAAGCCCCAGCATTTT	CASKGQGSGKPQHF	TRBV10-1	TRBJ1-5
TGTGCCAGCAGCCAAGCGGTGGGGGGCCTGTCCCTCTATGGCTACACCTTC	CASSQAVGGLSLYGYTF	TRBV3-1	TRBJ1-2
TGTGCCAGTAGTATAGCATGTCTCAAATGGACAGAAGAGACCCAGTACTTC	CASSIACLKWTEETQYF	TRBV19	TRBJ2-5
TGTGCCAGCAGTTTTGGAGTGAGACAGGGTCACTCCTATAATTCACCCCTCCACTTT	CASSFGVRQGHSYNSPLHF	TRBV27	TRBJ1-6
TGTGCCAGTACCGGGACAGGGACTTCCTACGAGCAGTACTTC	CASTGTGTSYEQYF	TRBV19	TRBJ2-7
TGTGCCTGGGGTAGCGGGGAGGACGAGCAGTACTTC	CAWGSGEDEQYF	TRBV6-5	TRBJ2-7
TGCAGTGCTAGCCCCTCCAGCGGGGGGGCCTACGAGCAGTACTTC	CSASPSSGGAYEQYF	TRBV20-1	TRBJ2-7
TGCAGCCCCGACAGGACCTTCACAGATACGCAGTATTTT	CSPDRTFTDTQYF	TRBV29-1	TRBJ2-3
TGCGCCAGCAGGGGGACTAGCGGTACCCGCTCGGGGTACGAGCAGTACTTC	CASRGTSGTRSGYEQYF	TRBV10-2	TRBJ2-7
TGTGCCAGCAGCACCGAGGGGGGCGATGGCTACACCTTC	CASSTEGGDGYTF	TRBV5-6	TRBJ1-2
TGTGCCAGCACCCCGGGACAGGGGTACGACTATGGCTACACCTTC	CASTPGQGYDYGYTF	TRBV3-1	TRBJ1-2
TGTGCCATCAGTGAGGAGACTAGCGGGCAAGAGACCCAGTACTTC	CAISEETSGQETQYF	TRBV10-3	TRBJ2-5
TGCAGCGGGGTTCTAAAGAGGGGGAGTTCCCAGGTCAAGGAGGAGGCGGTGAACACTGAAGCTTTCTTT	CSGVLKRGSSQVKEEAVNTEAFF	TRBV29-1	TRBJ1-1
TGTGCCAGCAGCGAGCCGGGACTAGCGGGAGCGTACGAGCAGTACTTC	CASSEPGLAGAYEQYF	TRBV5-4	TRBJ2-7
TGTGCCAGCAGCGTCGTAGCGGGCCCAGATACGCAGTATTTT	CASSVVAGPDTQYF	TRBV9	TRBJ2-3
TGCAGTAATGGGGGGCCCCAGCATTTT	CSNGGPQHF	TRBV20-1	TRBJ1-5
TGTGCCAGCAGCTACAAGGACAGCGTAGGCTATGGCTACACCTTC	CASSYKDSVGYGYTF	TRBV7-9	TRBJ1-2
TGTGCCAGCAGCGCGTACGAGCAGTACTTC	CASSAYEQYF	TRBV5-8	TRBJ2-7
TGTGCCAGCAGCCAAGATCCTCTTGGGGATAGCAATCAGCCCCAGCATTTT	CASSQDPLGDSNQPQHF	TRBV3-1	TRBJ1-5
TGCGCCAGCAGTGAAGGGGGGAGGAATCAGCCCCAGCATTTT	CASSEGGRNQPQHF	TRBV10-1	TRBJ1-5
TGTGCCAGCAGCTTTAGGACAGCCCAGCCCCAGCATTTT	CASSFRTAQPQHF	TRBV7-7	TRBJ1-5
TGTGCCAGTAGTGAGGGCATAGGCTACGAGCAGTACTTC	CASSEGIGYEQYF	TRBV19	TRBJ2-7
TGTGCCTGGAGCCCAAGCGGGACGTCCTACGAGCAGTACTTC	CAWSPSGTSYEQYF	TRBV30	TRBJ2-7
TGTGCCGGCAGACAGGGAACCCTCCACTTT	CAGRQGTLHF	TRBV30	TRBJ1-6
TGTGCCAGCAGTTATTACTTAGGGTATACCTGCTACGAGCAGTACTTC	CASSYYLGYTCYEQYF	TRBV6-5	TRBJ2-7
TGTGCCACCAGTGATTTGCTCCAGCTCGAGCTAGGGAATGAGCAGTTCTTC	CATSDLLQLELGNEQFF	TRBV24-1	TRBJ2-1
TGTGCCAGCAGCAGCAGGGGAGGTAATGAAAAACTGTTTTTT	CASSSRGGNEKLFF	TRBV9	TRBJ1-4
TGCGCCAGCACGGGGGACGGCTACACCTTC	CASTGDGYTF	TRBV5-1	TRBJ1-2
TGTGCCAGCAGTGACGAAGGGGCCACAGCGGACGAGCAGTACTTC	CASSDEGATADEQYF	TRBV6-4	TRBJ2-7
TGTGCCACCAGTGATTTACATTTCCCGGGACAGTATGAAAAACTGTTTTTT	CATSDLHFPGQYEKLFF	TRBV24-1	TRBJ1-4
TGTGCCACCCCAGGGCAGCCCCTCCACTTT	CATPGQPLHF	TRBV24-1	TRBJ1-6
TGTGCCAGCTCACCACACAGAGGGGTAAGCTACGAGCAGTACTTC	CASSPHRGVSYEQYF	TRBV18	TRBJ2-7
TGCGCCAGCAGCGCTCCTAGCGGGGAAGTCCAAGAGACCCAGTACTTC	CASSAPSGEVQETQYF	TRBV5-1	TRBJ2-5
TGTGCCAGATATGCGGCTGGGACAGCTGAAGCTTTCTTT	CARYAAGTAEAFF	TRBV2	TRBJ1-1
TGTGCCAGCAGTGACTCGGTAGAGGTCGGAAACACCATATATTTT	CASSDSVEVGNTIYF	TRBV6-4	TRBJ1-3
TGTGCCAGCAGTGACATATCCTACGAGCAGTACTTC	CASSDISYEQYF	TRBV25-1	TRBJ2-7
TGCGCCAGTTGGACAGGGTCGGTGGCTGGGGAGACCCAGTACTTC	CASWTGSVAGETQYF	TRBV4-1	TRBJ2-5
TGCACGAATTCTGGGACAGGGTTTTACTATGGCTACACCTTC	CTNSGTGFYYGYTF	TRBV20-1	TRBJ1-2
TGTGCCAGCAGTGAGAACGGATTCCAGGGGCAAGAGACCCAGTACTTC	CASSENGFQGQETQYF	TRBV25-1	TRBJ2-5
TGCGCCAGCAGCGACAGGGGGCACACTGAAGCTTTCTTT	CASSDRGHTEAFF	TRBV5-1	TRBJ1-1
TGTGCCAGCAGTTTATCCCAAATCACCTTTAGGGGACGGGGTGTTGACGAGCAGTACTTC	CASSLSQITFRGRGVDEQYF	TRBV27	TRBJ2-7
TGTGCCAGCAGCCCAGGACAGGGGTTTAAAACGAACACTGAAGCTTTCTTT	CASSPGQGFKTNTEAFF	TRBV13	TRBJ1-1
TGTGCCAGCTCACCACGGGTAGAGCAGGGGGGGTACGAGCAGTACTTC	CASSPRVEQGGYEQYF	TRBV18	TRBJ2-7
TGCAGTGCTAGAGTTAGGCGGTTTCAGCCCCAGCATTTT	CSARVRRFQPQHF	TRBV20-1	TRBJ1-5
TGTGCCAGCAACGGGACTAAGGTCTCCCGACGTGGAAATGAGCAGTTCTTC	CASNGTKVSRRGNEQFF	TRBV6-4	TRBJ2-1
TGCAGCGTTCGAGGGATCCGGGGGGGAATCTCTAGGAGGAGTGACGAGCAGTACTTC	CSVRGIRGGISRRSDEQYF	TRBV29-1	TRBJ2-7
TGCGCCAGCAGCCACGAACGGCTATACAATGAGCAGTTCTTC	CASSHERLYNEQFF	TRBV5-1	TRBJ2-1
TGTGCCAGCAGCCCGGGTCGGGGTGATTTCTACGAGCAGTACTTC	CASSPGRGDFYEQYF	TRBV13	TRBJ2-7
TGTGCCAGCAGTGACTCAAGTAGGGGGGCCTCCTACGAGCAGTACTTC	CASSDSSRGASYEQYF	TRBV6-4	TRBJ2-7
TGTGCCACCAGCAATCTAGCGGGGGACACAGATACGCAGTATTTT	CATSNLAGDTDTQYF	TRBV24-1	TRBJ2-3
TGTGCCAGCAGCCTTTCGGTGGGGCAAGAGACCCAGTACTTC	CASSLSVGQETQYF	TRBV9	TRBJ2-5
TGTGCCAGCAGGACAGGGGGCGGCCCCGACACTGAAGCTTTCTTT	CASRTGGGPDTEAFF	TRBV2	TRBJ1-1
TGTGCCAGTAGTATCGGCGATCCCCCCAATCAGCCCCAGCATTTT	CASSIGDPPNQPQHF	TRBV19	TRBJ1-5
TGTGCCAGCAGTGACTCGAGGGGGAGGGGGCCTTTCTTT	CASSDSRGRGPFF	TRBV6-4	TRBJ1-1
TGTGCCAGCAGGGACGGAACCTACGAGCAGTACTTC	CASRDGTYEQYF	TRBV28	TRBJ2-7
TGTGCCAGCAGCGGCGGAGCCCGGGGGGAATCCTACAATGAGCAGTTCTTC	CASSGGARGESYNEQFF	TRBV13	TRBJ2-1
TGTGCCAGCAGCCTAAGTAAGGGACTAGAGTCTGACTACAATGAGCAGTTCTTC	CASSLSKGLESDYNEQFF	TRBV3-1	TRBJ2-1
TGTGCCAGCATCCGACAGGGTCAGCCCCAGCATTTT	CASIRQGQPQHF	TRBV6-5	TRBJ1-5
TGTGCGCCGGGACCCACGCCCAATGAAAAACTGTTTTTT	CAPGPTPNEKLFF	TRBV9	TRBJ1-4
TGCGCCAGCAGCTTGGTAATCTCGTTCTACGAGCAGTACTTC	CASSLVISFYEQYF	TRBV5-1	TRBJ2-7
TGTAGACCCCTGGGGGGGGGAGAATACAATGAGCAGTTCTTC	CRPLGGGEYNEQFF	TRBV7-9	TRBJ2-1
TGTGCCAGCAGTGTACGAGATCCTGGCTACACCTTC	CASSVRDPGYTF	TRBV6-6	TRBJ1-2
TGTGCCAGCAGTGATAGACGATTTAATCCCGGGAACGAGCAGTACTTC	CASSDRRFNPGNEQYF	TRBV6-1	TRBJ2-7
TGTGCCAGCAGCTTAGCGTCCGGGGGCCGAGCTTTCTTT	CASSLASGGRAFF	TRBV7-6	TRBJ1-1
TGTGCCAGCAGCTTAGGAAACGCCGGGACACTTTCCAAGTACGAGCAGTACTTC	CASSLGNAGTLSKYEQYF	TRBV7-6	TRBJ2-7
TGCGCCAGCAGCCAAGACGGTGGGAGCAATCAGCCCCAGCATTTT	CASSQDGGSNQPQHF	TRBV4-1	TRBJ1-5
TGTGCCAGCAGTGTCCGGGACAACCTCTACGAGCAGTACTTC	CASSVRDNLYEQYF	TRBV27	TRBJ2-7
TGCGCCAGCAGCTCCGCTGGACAGGGGGGATACGAGCAGTACTTC	CASSSAGQGGYEQYF	TRBV5-1	TRBJ2-7
TGTGCCACCAGTGATTTGCCATATGACAGTGAAACAGATACGCAGTATTTT	CATSDLPYDSETDTQYF	TRBV24-1	TRBJ2-3
TGTGCCAGCAGTCCCCGCCGGGACAGAGCCTACGAGCAGTACTTC	CASSPRRDRAYEQYF	TRBV6-4	TRBJ2-7
TGTGCTAGTGGGGGCAACGGGACTAGCGGGCTCCAAGAGACCCAGTACTTC	CASGGNGTSGLQETQYF	TRBV12-5	TRBJ2-5
TGTGCCAGCAGTCTCTACGAGCAGTACTTC	CASSLYEQYF	TRBV28	TRBJ2-7
TGTCTTGAGCAGGGGTACACTGAAGCTTTCTTT	CLEQGYTEAFF	TRBV6-5	TRBJ1-1
TGTGCCAGCTCAGCCCGGGACAGGGGGGACGAGCAGTACTTC	CASSARDRGDEQYF	TRBV18	TRBJ2-7
TGTGCCAGCGTTGTCCGAGGGGACTACGAGCAGTACTTC	CASVVRGDYEQYF	TRBV6-2	TRBJ2-7
TGTGCCAGCAGTCCTAATGACAGTTCCTACGAGCAGTACTTC	CASSPNDSSYEQYF	TRBV6-2	TRBJ2-7
TGTGCCACCACAGGTTACTCTGGAAACACCATATATTTT	CATTGYSGNTIYF	TRBV27	TRBJ1-3
TGTGCCAGCAGCTTGGCCCAGGGGGGCACAGATACGCAGTATTTT	CASSLAQGGTDTQYF	TRBV5-5	TRBJ2-3
TGTGCCAGCAGCCAAGGTGGGACGGACCCCGTTCCGACAGGTTACGAGCAGTACTTC	CASSQGGTDPVPTGYEQYF	TRBV14	TRBJ2-7
TGTGCCAGCAGTTACGTGCCGGGGGGGGACTCTGGGGCCAACGTCCTGACTTTC	CASSYVPGGDSGANVLTF	TRBV6-5	TRBJ2-6
TGTGCCAGCATAATGGGCTACGAGCAGTACTTC	CASIMGYEQYF	TRBV6-5	TRBJ2-7
TGTGCCAGTAGTCTCCGCGGGGGGGAAATAGAGACCCAGTACTTC	CASSLRGGEIETQYF	TRBV19	TRBJ2-5
TGCAGTGCTAGCCTAGTAAGGGACAGTAAGTCTGAAGCTTTCTTT	CSASLVRDSKSEAFF	TRBV20-1	TRBJ1-1
TGTGCCAGCAGTGGCCTCAGCGGTAACACCGGGGAGCTGTTTTTT	CASSGLSGNTGELFF	TRBV12-4	TRBJ2-2
TGTGCCAGCCCCCCGGGACTAGCGGGAATCAAAAACATTCAGTACTTC	CASPPGLAGIKNIQYF	TRBV6-3	TRBJ2-4
TGTGCCAGCAGTGAACCGGCGACAGGAGCGACCTACGAGCAGTACTTC	CASSEPATGATYEQYF	TRBV25-1	TRBJ2-7
TGTGCTAGTGGTCCGGGACTAGGGCAAGAGACCCAGTACTTC	CASGPGLGQETQYF	TRBV12-5	TRBJ2-5
TGTGCCAGCAAGGGACGGCTGCTTGCCAATGAGCAGTTCTTC	CASKGRLLANEQFF	TRBV5-4	TRBJ2-1
TGTGCCAGCAGCCGCGGGGGCATAGGGACCAATGAGCAGTTCTTC	CASSRGGIGTNEQFF	TRBV5-4	TRBJ2-1
TGTGCCAGCAGTTATACGGGAGACTATGGCTACACCTTC	CASSYTGDYGYTF	TRBV6-2	TRBJ1-2
TGCGCCAGCAGCTTTGGTCCGAACAGGGGGCTTAGGTACGCAACTAATGAAAAACTGTTTTTT	CASSFGPNRGLRYATNEKLFF	TRBV5-1	TRBJ1-4
TGTGCCAGCACCCTAGCTTACGAGCAGTACTTC	CASTLAYEQYF	TRBV7-9	TRBJ2-7
TGCAGCGGAGTGAGGACCTCAGATACGCAGTATTTT	CSGVRTSDTQYF	TRBV29-1	TRBJ2-3
TGTGCCAGTCCCGTCCCGGGACTACAGACGCGGGGGGATGAGCAGTTCTTC	CASPVPGLQTRGDEQFF	TRBV12-3	TRBJ2-1
TGCGCCAGCAGCTTGGGGGTGTCGTGCTCGAGCAAAAACATTCAGTACTTC	CASSLGVSCSSKNIQYF	TRBV5-1	TRBJ2-4
TGCGCCAGCAGGGTTACAGCACCCCTCCACTTT	CASRVTAPLHF	TRBV10-1	TRBJ1-6
TGTGCCAGCAGCTTAAGTAAAGAGACCCAGTACTTC	CASSLSKETQYF	TRBV6-5	TRBJ2-5
TGTGCCAGCAGCCGGTCCTGCCGGGACGCGAGCACAGATACGCAGTATTTT	CASSRSCRDASTDTQYF	TRBV4-2	TRBJ2-3
TGTGCCAGCAGTGTAGTCAGGGGGACAGATACGCAGTATTTT	CASSVVRGTDTQYF	TRBV2	TRBJ2-3
TGTGCCAGCAGCAGTCTGGCGGGCCCTAGCTCTGGGGCCAACGTCCTGACTTTC	CASSSLAGPSSGANVLTF	TRBV13	TRBJ2-6
TGCGCCAGCAGAGGGACAGGCTACGAGCAGTACTTC	CASRGTGYEQYF	TRBV5-1	TRBJ2-7
TGTGCCAGCTGGGAACAGGGGAGCAACAGTCAGCCCCAGCATTTT	CASWEQGSNSQPQHF	TRBV2	TRBJ1-5
TGCGCCAGCAGCCCGAGGTATAGAGTTGACAATGAGCAGTTCTTC	CASSPRYRVDNEQFF	TRBV5-1	TRBJ2-1
TGTGCCAGCAGCGTTTTAGGGGGAGGTACAATAGGCTATGGCTACACCTTC	CASSVLGGGTIGYGYTF	TRBV11-3	TRBJ1-2
TGCGCCAGCAGCCCCAGGGACGGGGCTTACTACGAGCAGTACTTC	CASSPRDGAYYEQYF	TRBV5-1	TRBJ2-7
TGTGCCAGCAGTTTGGGGTCACCCCTCCACTTT	CASSLGSPLHF	TRBV6-5	TRBJ1-6
TGTGCCACCAGCCCCGAAACTGGCACCTACGAGCAGTACTTC	CATSPETGTYEQYF	TRBV15	TRBJ2-7
TGTGCCAGCAGTACAACAGGAGGAGGGAATTCACGTGAGCAGTTCTTC	CASSTTGGGNSREQFF	TRBV27	TRBJ2-1
TGTGCCAGCAGTGACGGCTCTGATGGCTACACCTTC	CASSDGSDGYTF	TRBV6-4	TRBJ1-2
TGTGCCAGCAGTAAATGTTACAATCCTCCGCCGGGACTAGCGGGAGGAGGGCAGGGGAACACTGAAGCTTTCTTT	CASSKCYNPPPGLAGGGQGNTEAFF	TRBV12-3	TRBJ1-1
TGTGCCAGCAGACTGAGGGGGGACTATGGCTACACCTTC	CASRLRGDYGYTF	TRBV6-1	TRBJ1-2
TGTGCCAGCAGTTACAAAAGCCGGGCTAGCGGGGCTACCAATGAGCAGTTCTTC	CASSYKSRASGATNEQFF	TRBV6-5	TRBJ2-1
TGTGCCAGCAGCAGGGGGGGCTACGAGCAGTACTTC	CASSRGGYEQYF	TRBV9	TRBJ2-7
TGTGCCAGCAGCCACGACGGGAGGGGAACTGAAGCTTTCTTT	CASSHDGRGTEAFF	TRBV3-1	TRBJ1-1
TGTGCCACTCGGGGGGGGGATACGCAGTATTTT	CATRGGDTQYF	TRBV27	TRBJ2-3
TGTGCCAGCAGCGGCTCCATGGACAGGGGGTACCAAGAGACCCAGTACTTC	CASSGSMDRGYQETQYF	TRBV7-8	TRBJ2-5
TGCAGTGCTAGACTGACACCCCACTATGGCTACACCTTC	CSARLTPHYGYTF	TRBV20-1	TRBJ1-2
TGTGGACCGGGACAGGGGACTCCTAATGAAAAACTGTTTTTT	CGPGQGTPNEKLFF	TRBV11-3	TRBJ1-4
TGTGCCAGCAGCCAAGAGGCGGATCAGCCCCAGCATTTT	CASSQEADQPQHF	TRBV3-1	TRBJ1-5
TGTGCCAGCAGCGCCAGAAGGAGGGGGGTCTCGGTTGCAGATACGCAGTATTTT	CASSARRRGVSVADTQYF	TRBV7-4	TRBJ2-3
TGCAGTGGAGGGACTAGAATCCTTTCCTCCTACGAGCAGTACTTC	CSGGTRILSSYEQYF	TRBV20-1	TRBJ2-7
TGTGCCAGTAAAACGGACAGGGTGCCCCAGCATTTT	CASKTDRVPQHF	TRBV19	TRBJ1-5
TGTGCCAGCAGTTCCCCTGGAACTGGGGGCAGCTCTGGAAACACCATATATTTT	CASSSPGTGGSSGNTIYF	TRBV27	TRBJ1-3
TGTGCCAGCAGCTTTCGACAGGGTCGTAATTCACCCCTCCACTTT	CASSFRQGRNSPLHF	TRBV7-3	TRBJ1-6
TGTGCCAGCAGCCCCCCCACAGGGGGGGGGAACACTGAAGCTTTCTTT	CASSPPTGGGNTEAFF	TRBV7-6	TRBJ1-1
TGTGCTAGTGGCCGGGGGGGGGACACCATATATTTT	CASGRGGDTIYF	TRBV12-5	TRBJ1-3
TGTGCCAGCTCACCACAAGCGGGGAAGTTAGAGACCCAGTACTTC	CASSPQAGKLETQYF	TRBV18	TRBJ2-5
TGTGCCAGCAGTCCCCCCCCAGAGGAGAACACCATATATTTT	CASSPPPEENTIYF	TRBV6-3	TRBJ1-3
TGTGCCAGCAGTTACCACGGGACTAGCGGGTGCTCCTACAATGAGCAGTTCTTC	CASSYHGTSGCSYNEQFF	TRBV6-5	TRBJ2-1
TGTGCCTGGGAAATTCCCGGGACAGGGAATGGAAACACCATATATTTT	CAWEIPGTGNGNTIYF	TRBV30	TRBJ1-3
TGCGCCAGCAGTGTTACGATCTCCTACGAGCAGTACTTC	CASSVTISYEQYF	TRBV10-2	TRBJ2-7
TGTGCCAGCAGCAGGGCAGTCTACGAGCAGTACTTC	CASSRAVYEQYF	TRBV7-3	TRBJ2-7
TGTGCCTGGAGTGGGCAGGGGAGGGGGCAAGAAATGAATTCACCCCTCCACTTT	CAWSGQGRGQEMNSPLHF	TRBV30	TRBJ1-6
TGTGCCATCAGGCGACAGGTACAGCCCCAGCATTTT	CAIRRQVQPQHF	TRBV10-3	TRBJ1-5
TGCGCCAGCAGCCGCAGGGGAGACACTGAAGCTTTCTTT	CASSRRGDTEAFF	TRBV5-1	TRBJ1-1
TGCGCCAGCAGGGCCCGCAATCAGCCCCAGCATTTT	CASRARNQPQHF	TRBV5-1	TRBJ1-5
TGTGCCACCAGTGATTTACGGAGGGCCTACGAGCAGTACTTC	CATSDLRRAYEQYF	TRBV24-1	TRBJ2-7
TGTGCCAGCAGCAGGACTCCGTCTGGGGAGGTCTCCACTGAAGCTTTCTTT	CASSRTPSGEVSTEAFF	TRBV3-1	TRBJ1-1
TGTGCCAGCAGCCAAGATCTTGGGACTCGGCGGCTGGGCTACACCTTC	CASSQDLGTRRLGYTF	TRBV14	TRBJ1-2
TGCGCCAGCAGCTTATACACGCGCCGGGACCTACTCGACAATGAGCAGTTCTTC	CASSLYTRRDLLDNEQFF	TRBV5-1	TRBJ2-1
TGTGCCAGTAGAAATGGGCCCAGCAAAAACATTCAGTACTTC	CASRNGPSKNIQYF	TRBV19	TRBJ2-4
TGTGCCAGCAGTTCTAGAGAAGGGGGCGGAACTGAAGCTTTCTTT	CASSSREGGGTEAFF	TRBV6-6	TRBJ1-1
TGTGCCAGCAGTTACTGCCTCGGGACAGGGGGAGCAGACTTAGCTTTCTTT	CASSYCLGTGGADLAFF	TRBV6-5	TRBJ1-1
TGTGCCACCTGCCTCCGCCAGGAGGGTAACAATGAGCAGTTCTTC	CATCLRQEGNNEQFF	TRBV24-1	TRBJ2-1
TGTGCCACAGTCAACTCTGGGGCCAACGTCCTGACTTTC	CATVNSGANVLTF	TRBV19	TRBJ2-6
TGTGCCAGCAGCTCCTCCGGGACCTATGGCTACACCTTC	CASSSSGTYGYTF	TRBV11-2	TRBJ1-2
TGTGCCAGCAGTTCCACGGGGCGTTGCACTGAAGCTTTCTTT	CASSSTGRCTEAFF	TRBV12-4	TRBJ1-1
TGTGCCACCGGGGCCCCGGGACAGGTCAATCAGCCCCAGCATTTT	CATGAPGQVNQPQHF	TRBV15	TRBJ1-5
TGCGCCAGCAGCCTGAATAGGGACAGGGCTACTCAGCCCCAGCATTTT	CASSLNRDRATQPQHF	TRBV4-3	TRBJ1-5
TGTGCCAGCAGCTTGGCCTCTCTCGGACAGGCGGATGGCTACACCTTC	CASSLASLGQADGYTF	TRBV5-6	TRBJ1-2
TGTGCCAGCAGCTTACTCCCGGAGGGTGGACACGAGCAGTACTTC	CASSLLPEGGHEQYF	TRBV7-9	TRBJ2-7
TGTGCCAGCAGTCGGAAGGGACGGGACAGCTTCAATCAGCCCCAGCATTTT	CASSRKGRDSFNQPQHF	TRBV27	TRBJ1-5
TGTGCCAGCAGTTTCTTATTCCGGGACGGCCCCCGGTTGTATTCACCCCTCCACTTT	CASSFLFRDGPRLYSPLHF	TRBV12-3	TRBJ1-6
TGTGCCAGCAGCTTATACGCTCTTAGCGACTCACCCTCCGCGAACACCGGGGAGCTGTTTTTT	CASSLYALSDSPSANTGELFF	TRBV7-2	TRBJ2-2
TGTGCCAGCAGTTACGGGGTAGGATCTGGAAACACCATATATTTT	CASSYGVGSGNTIYF	TRBV6-5	TRBJ1-3
TGCGCCAGCAGCCAAGAGACAGGGGCATGTGGCTACACCTTC	CASSQETGACGYTF	TRBV4-1	TRBJ1-2
TGTGCCAGCAGCCCCCTGGCTTACGAGCAGTACTTC	CASSPLAYEQYF	TRBV7-3	TRBJ2-7
TGCAGTGCAAACAGAACTAACTATGGCTACACCTTC	CSANRTNYGYTF	TRBV20-1	TRBJ1-2
TGTGCCAGCAGTTTGGGACAGGATGAGCAGTTCTTC	CASSLGQDEQFF	TRBV12-3	TRBJ2-1
TGTGCCAGCAGTGATAATCCAAAAGGGGGAGCTTGGCGATGGGGGTCCAATCAGCCCCAGCATTTT	CASSDNPKGGAWRWGSNQPQHF	TRBV6-4	TRBJ1-5
TGCGCCAGCAGTGAGCACCCGATTCGCACCCCTCTGATTTCTCCCTACGAGCAGTACTTC	CASSEHPIRTPLISPYEQYF	TRBV10-1	TRBJ2-7
TGTGCCAGCAGTTTTCGGGACACTGAAGCTTTCTTT	CASSFRDTEAFF	TRBV27	TRBJ1-1
TGCAGTGCTAGAAATCTACACGAGCAGTACTTC	CSARNLHEQYF	TRBV20-1	TRBJ2-7
TGCAGCGTTAAAGCTTCGGGGTGGGCAAGAAATTCACCCCTCCACTTT	CSVKASGWARNSPLHF	TRBV29-1	TRBJ1-6
TGTGCCAGCAGCCAAGTCGTTCATAATTCACCCCTCCACTTT	CASSQVVHNSPLHF	TRBV4-2	TRBJ1-6
TGTGCCAGCAGGATAACGGGACATCGGGGGATTCCGATAGCCAAAAACATTCAGTACTTC	CASRITGHRGIPIAKNIQYF	TRBV9	TRBJ2-4
TGCGCCAGCAACCCTCCGGGACAGGGGAGTAACCACAATGAGCAGTTCTTC	CASNPPGQGSNHNEQFF	TRBV10-1	TRBJ2-1
TGTGCCACCAGAGGCGAGCGAGGCTTCCCGACAGGGATCCAAGAGACCCAGTACTTC	CATRGERGFPTGIQETQYF	TRBV24-1	TRBJ2-5
TGTGCCAGCAGTGAGGGGACAGGCTACAATGAGCAGTTCTTC	CASSEGTGYNEQFF	TRBV6-1	TRBJ2-1
TGTGCCTCAGATGAAGCTTTCTTT	CASDEAFF	TRBV28	TRBJ1-1
TGTGCCAGCAGCATTTGGCCTTCCTACGAGCAGTACTTC	CASSIWPSYEQYF	TRBV7-3	TRBJ2-7
TGTGCCAGCCAGGGCAGCCAGGGGGCGAGGATCCACATTCAGTACTTC	CASQGSQGARIHIQYF	TRBV7-4	TRBJ2-4
TGTGCCAGCGCCGGGGCTTCCACTGAAGCTTTCTTT	CASAGASTEAFF	TRBV7-9	TRBJ1-1
TGTGCCAGCAGCTCGGGGACAGAGCACACTGAAGCTTTCTTT	CASSSGTEHTEAFF	TRBV5-6	TRBJ1-1
TGTGCCAGCAGCACCCGCCCGGGGGCGGCCCCCCCAACTAATGAAAAACTGTTTTTT	CASSTRPGAAPPTNEKLFF	TRBV13	TRBJ1-4
TGCAGTGCTAGAGGCCCCCCAGGGGTTTGTCCAGAGACCCAGTACTTC	CSARGPPGVCPETQYF	TRBV20-1	TRBJ2-5
TGTGCCAGCAGCTGGAGAACGGAGTACAATGAGCAGTTCTTC	CASSWRTEYNEQFF	TRBV7-2	TRBJ2-1
TGTGCTCGGTACTCTGGAAACACCATATATTTT	CARYSGNTIYF	TRBV25-1	TRBJ1-3
TGTGCCAGCAGCCATTGGGGGGGGGTTTCCTACGAGCAGTACTTC	CASSHWGGVSYEQYF	TRBV3-1	TRBJ2-7
TGTGCCAGCAGTTACTCGAGGGACAGGAACACTGAAGCTTTCTTT	CASSYSRDRNTEAFF	TRBV6-5	TRBJ1-1
TGTGCCAGCAGTGCAACACTCCCTAGCGGGACGGCCAATGAGCAGTTCTTC	CASSATLPSGTANEQFF	TRBV6-5	TRBJ2-1
TGTGCCAGCAGCCAAGAAGGACTGGCAGGGGTTCTCAATCAGCCCCAGCATTTT	CASSQEGLAGVLNQPQHF	TRBV3-1	TRBJ1-5
TGTGCCAGCAGCGGAGGGGACAATTTGGGGCTTCAAACTGAAGCTTTCTTT	CASSGGDNLGLQTEAFF	TRBV9	TRBJ1-1
TGCGCCAGCAGCCAAGACTATACCGTAGACTTCCTAGCCAAAAACATTCAGTACTTC	CASSQDYTVDFLAKNIQYF	TRBV4-1	TRBJ2-4
TGCGCCAGCAGCTTGAATGGAACAGCTACTGAAGCTTTCTTT	CASSLNGTATEAFF	TRBV5-1	TRBJ1-1
TGTGCCAGCAGCTTGTACGGTAGGGGCTACACCTTC	CASSLYGRGYTF	TRBV5-6	TRBJ1-2
TGTGCCAGCGATGAAAATCCTTTCACTGAAGCTTTCTTT	CASDENPFTEAFF	TRBV27	TRBJ1-1
TGTGCCAGCAGCGATAAAGGGGTCACTAATGAAAAACTGTTTTTT	CASSDKGVTNEKLFF	TRBV7-9	TRBJ1-4
TGTGCCAGCAGCTGTATCAGGGCGGCTAGCACAGATACGCAGTATTTT	CASSCIRAASTDTQYF	TRBV7-3	TRBJ2-3
TGTGCCAGCTCACCACTCCTAGTCCTCAATGAGCAGTTCTTC	CASSPLLVLNEQFF	TRBV18	TRBJ2-1
TGTGCCAGCAGCGGAGGACGGGGACAGACCGAAAAACTGTTTTTT	CASSGGRGQTEKLFF	TRBV7-2	TRBJ1-4
TGTGCCAGCAGTGACTCGCACGAGACCCAGTACTTC	CASSDSHETQYF	TRBV6-4	TRBJ2-5
TGTGCCAGCAGTGAATATCACGACGAGGTAGGACTAGCCAAAAACATTCAGTACTTC	CASSEYHDEVGLAKNIQYF	TRBV25-1	TRBJ2-4
TGTGCCAGCAGAAGTTCATCTCGACAGGGCTACACCTTC	CASRSSSRQGYTF	TRBV28	TRBJ1-2
TGCGCCAGCAGAGCAAGGGGAAGGTACGAGCAGTACTTC	CASRARGRYEQYF	TRBV10-2	TRBJ2-7
TGTGCCAGCAGTTGCCCGGGGACGGAAGATTACGAGCAGTACTTC	CASSCPGTEDYEQYF	TRBV27	TRBJ2-7
TGTGCCACCAGCAGACAAGGGGGCGAGACCCAGTACTTC	CATSRQGGETQYF	TRBV15	TRBJ2-5
TGTGCCAGCAACCTAGATCTCTACGAGCAGTACTTC	CASNLDLYEQYF	TRBV27	TRBJ2-7
TGTGCCAGCAGCTGTGTTAAGCAGTACTTC	CASSCVKQYF	TRBV13	TRBJ2-7
TGCAGCGTGACCGAAGTAGGGATGAATTCACCCCTCCACTTT	CSVTEVGMNSPLHF	TRBV29-1	TRBJ1-6
TGTGCCAGCTGCGCTGTGTTAGACAGGATAATACAGCCCCAGCATTTT	CASCAVLDRIIQPQHF	TRBV28	TRBJ1-5
TGTGCCAGCAGTGGTAGGGCGGGAGGAATGGTCTACGAGCAGTACTTC	CASSGRAGGMVYEQYF	TRBV27	TRBJ2-7
TGCGCCAGCAGCCAAGAGCGGGGGCGGGGCTACGAGCAGTACTTC	CASSQERGRGYEQYF	TRBV4-3	TRBJ2-7
TGTGCCAGCAGTTTTGGGCCCCGATTCACTAGCGGGAGGTACCAGTACTTC	CASSFGPRFTSGRYQYF	TRBV12-3	TRBJ2-5
TGTGCCAGCAGGAACGTAAAGGGACTAGCGGGCACAGATACGCAGTATTTT	CASRNVKGLAGTDTQYF	TRBV6-5	TRBJ2-3
TGTGCCAGCAGTTTATACCAGAAGGGATACACCGGGGAGCTGTTTTTT	CASSLYQKGYTGELFF	TRBV28	TRBJ2-2
TGTGCCAGCAAGGGGGCGGCCCAACGGGGGACCGGGGAGCTGTTTTTT	CASKGAAQRGTGELFF	TRBV7-3	TRBJ2-2
TGCAGCGTTGCGATTCGCCGACTGAGAAGCTTTAATCAGCCCCAGCATTTT	CSVAIRRLRSFNQPQHF	TRBV29-1	TRBJ1-5
TGTGCCAGCAGTTTATTGCGTAGTAGACAGTTCGCTGGTGGCCCTAGCAATCAGCCCCAGCATTTT	CASSLLRSRQFAGGPSNQPQHF	TRBV27	TRBJ1-5
TGTGCTAGTGTCGGAACAGGGAGTTACGAGCAGTACTTC	CASVGTGSYEQYF	TRBV12-5	TRBJ2-7
TGCAGTGCTAGAGACATACACCGGAACACCGGGGAGCTGTTTTTT	CSARDIHRNTGELFF	TRBV20-1	TRBJ2-2
TGTGCCAGCAGTTACGAGGGGAGACTCAAGCCCCAGCATTTT	CASSYEGRLKPQHF	TRBV6-6	TRBJ1-5
TGTGCCAGCAGTGTGGAGGTCCCGCACGGACAGGATTATGTATACAATGAGCAGTTCTTC	CASSVEVPHGQDYVYNEQFF	TRBV6-4	TRBJ2-1
TGTGCCAGCAGCCCGACTAGGGGGAGAGACGAGCAGTACTTC	CASSPTRGRDEQYF	TRBV9	TRBJ2-7
TGCAGCGGATCCTGGGGAGTGCGTGGCAATCAGCCCCAGCATTTT	CSGSWGVRGNQPQHF	TRBV29-1	TRBJ1-5
TGTGCCAGCAGTGACTCGAATAGACGATCCTACTCCTACGAGCAGTACTTC	CASSDSNRRSYSYEQYF	TRBV6-4	TRBJ2-7
TGTGCCAGCAGCTTGCAGGCTACCGAGCAGTACTTC	CASSLQATEQYF	TRBV7-3	TRBJ2-7
TGTGCCAGCAGCCATACACGGAATTCACCCCTCCACTTT	CASSHTRNSPLHF	TRBV4-2	TRBJ1-6
TGCGCCAGCAGCGGTCCATTGGTACAGTTTAATGAAAAACTGTTTTTT	CASSGPLVQFNEKLFF	TRBV5-1	TRBJ1-4
TGCAGCGTTGAATTCTTGTTGGGGGCCCCAGGGACAGATACGCAGTATTTT	CSVEFLLGAPGTDTQYF	TRBV29-1	TRBJ2-3
TGTGCCAGCAGCCAAGATTACCCGCGCGAGCAGTACTTC	CASSQDYPREQYF	TRBV14	TRBJ2-7
TGTGCCAGCAGGGGTTCGTGGGTAGTCGAGCAGTACTTC	CASRGSWVVEQYF	TRBV6-5	TRBJ2-7
TGCAGTGTTACAGGGAGCAATCAGCCCCAGCATTTT	CSVTGSNQPQHF	TRBV20-1	TRBJ1-5
TGTGCCACCAGTGATTTGGTGTGGGGGGACGAGCAGTACTTC	CATSDLVWGDEQYF	TRBV24-1	TRBJ2-7
TGTGCCAGCAATCCAGGCACTGAAAAACTGTTTTTT	CASNPGTEKLFF	TRBV6-2	TRBJ1-4
TGTGCCAGCAAAGAGACTAGACACGAGCAGTACTTC	CASKETRHEQYF	TRBV6-6	TRBJ2-7
TGTGCCAGCAGTGACCCTCTAGGCAGGGGGCGCGGTGATCAGCATAGCAATCAGCCCCAGCATTTT	CASSDPLGRGRGDQHSNQPQHF	TRBV25-1	TRBJ1-5
TGTGCCAGCAGCCGGACAGCCGGCTCTGGGGCCAACGTCCTGACTTTC	CASSRTAGSGANVLTF	TRBV7-3	TRBJ2-6
TGCGCCAGCAGGAGAGAACAGGGTTATGGCTACACCTTC	CASRREQGYGYTF	TRBV5-1	TRBJ1-2
TGCGCCAGATTACTAGCGGGAGGGCCTCCCGGCTACACCTTC	CARLLAGGPPGYTF	TRBV5-1	TRBJ1-2
TGTGCCAGCAGCTTCCTGCCGAGGGGAATGGGATCCTACGAGCAGTACTTC	CASSFLPRGMGSYEQYF	TRBV5-4	TRBJ2-7
TGTGCCAGCAGCAGGACAGGGACTGAAGCTTTCTTT	CASSRTGTEAFF	TRBV7-8	TRBJ1-1
TGCGCCAGCAGCTCCATGGCGAGGAGCAATCAGCCCCAGCATTTT	CASSSMARSNQPQHF	TRBV5-1	TRBJ1-5
TGTGCCAGCAGCGGCCGCGACAGGGTGGCGAACACCGGGGAGCTGTTTTTT	CASSGRDRVANTGELFF	TRBV9	TRBJ2-2
TGCGCCAGCAGCCAAGTGGACACTGGGGCCAACGTCCTGACTTTC	CASSQVDTGANVLTF	TRBV4-1	TRBJ2-6
TGTGCCAGCAGTCCCAGGGGCCGGGATGGCTACACCTTC	CASSPRGRDGYTF	TRBV12-3	TRBJ1-2
TGTGCCAGCAGCCAAGAGGGGCGATTGGAAACTGCCGAAGACGAGCAGTACTTC	CASSQEGRLETAEDEQYF	TRBV3-1	TRBJ2-7
TGTGCCAGCCCCAAGGACAGGGCCGATAACCAAGAGACCCAGTACTTC	CASPKDRADNQETQYF	TRBV7-6	TRBJ2-5
TGTGCCAGCAGTTTACAGACACCTGAAAAACTGTTTTTT	CASSLQTPEKLFF	TRBV27	TRBJ1-4
TGCGCCAGCAGCTTTGGACAAGTCAATCAGCCCCAGCATTTT	CASSFGQVNQPQHF	TRBV5-1	TRBJ1-5
TGTGCCAGCATCTTCCTCCAGCGGCCAGATACGCAGTATTTT	CASIFLQRPDTQYF	TRBV6-2	TRBJ2-3
TGTGCCAGCAGCGCTACTAGGGGGAGCGGGAGTCAAGAGACCCAGTACTTC	CASSATRGSGSQETQYF	TRBV9	TRBJ2-5
TGCGCCAGCAGCCAAAAGGGGAAGGCCCTCGAAGGGAGCTCCTACAATGAGCAGTTCTTC	CASSQKGKALEGSSYNEQFF	TRBV4-1	TRBJ2-1
TGTGCCAGCAGCTTGCACCTAAGCCGGAAAGATACGCAGTATTTT	CASSLHLSRKDTQYF	TRBV5-6	TRBJ2-3
TGTGCCAGCAGCTTAGCCAGGGAGAATGAGCAGTTCTTC	CASSLARENEQFF	TRBV11-2	TRBJ2-1
TGCAGCGTTGCTCCGCGCTCTAAAAAGAACACCTTC	CSVAPRSKKNTF	TRBV29-1	TRBJ1-2
TGTGCCAGCAGCTTAAGACGGGGGGGCAGGGACGAGCAGTACTTC	CASSLRRGGRDEQYF	TRBV11-3	TRBJ2-7
TGTGCCAGCAGGAGACAGGGTCCGAACACCGGGGAGCTGTTTTTT	CASRRQGPNTGELFF	TRBV6-1	TRBJ2-2
TGTGCGATTTGGAGGGACAACAATGAGCAGTTCTTC	CAIWRDNNEQFF	TRBV24-1	TRBJ2-1
TGCGCCAGCAGCGGTCCCGTCCTGAGGAATCAGCCCCAGCATTTT	CASSGPVLRNQPQHF	TRBV5-1	TRBJ1-5
TGTGCCAGCAGCAGCCCCCGGGACAGTGCTTATGGCTACACCTTC	CASSSPRDSAYGYTF	TRBV6-6	TRBJ1-2
TGCAGCGTTGGGGATCTTATCTACGAGCAGTACTTC	CSVGDLIYEQYF	TRBV29-1	TRBJ2-7
TGTGCCAGCAGTGACCCCCGGCCTGGGGGGTACGAGCAGTACTTC	CASSDPRPGGYEQYF	TRBV6-1	TRBJ2-7
TGCGCCAGCAGCTTGGTTAGGCGGGACAAGGCAGATACGCAGTATTTT	CASSLVRRDKADTQYF	TRBV5-1	TRBJ2-3
TGCGCCAGCAGCGATAGGCCCACGGCCCGTTATGGCTACACCTTC	CASSDRPTARYGYTF	TRBV5-1	TRBJ1-2
TGTGCCAGCAGCACCGGACAGGGAAACCCTCAGCCCCAGCATTTT	CASSTGQGNPQPQHF	TRBV7-3	TRBJ1-5
TGTGCCACCAGTGATGACAGAGGGATTATACCCTACGAGCAGTACTTC	CATSDDRGIIPYEQYF	TRBV24-1	TRBJ2-7
TGTGCCAGCAGTGACAAGTCCGCTAGGTACCACGAGCAGTACTTC	CASSDKSARYHEQYF	TRBV25-1	TRBJ2-7
TGTGCCAGCAGTGGGACAGGGGGCGCAGCAGTCCTGCGTAGCTCCTACGAGCAGTACTTC	CASSGTGGAAVLRSSYEQYF	TRBV28	TRBJ2-7
TGTGCCAGCAGCTTAGGGCGGACTAGCCGCTCCTACGAGCAGTACTTC	CASSLGRTSRSYEQYF	TRBV11-3	TRBJ2-7
TGTGCCAGCAGCCCTGGACAGGGGGTTTCAAACATTCAGTACTTC	CASSPGQGVSNIQYF	TRBV7-3	TRBJ2-4
TGTGCCAGCAGTTACATTGAGGGATCTTTCGTTAGCACAGATACGCAGTATTTT	CASSYIEGSFVSTDTQYF	TRBV6-2	TRBJ2-3
TGTGCCAGCAGTTCCCTTATCGGTGGGGCCAATGAGCAGTTCTTC	CASSSLIGGANEQFF	TRBV27	TRBJ2-1
TGTGCCAGCAGCGTGGCAGTCCCGGACGAGCAGTACTTC	CASSVAVPDEQYF	TRBV7-3	TRBJ2-7
TGTGCCAGCAGTGCCGGTGAGACCCAGTACTTC	CASSAGETQYF	TRBV6-1	TRBJ2-5
TGCGCCAGCACTTTAAGATTGGGGCGAAGGGCAACTAATGAAAAACTGTTTTTT	CASTLRLGRRATNEKLFF	TRBV10-1	TRBJ1-4
TGTGCCAGCAGTGACTCGAAAGTAGACAGATACTCCTACGAGCAGTACTTC	CASSDSKVDRYSYEQYF	TRBV6-4	TRBJ2-7
TGTGCCAGCAAACGAATGTACAATGAGCAGTTCTTC	CASKRMYNEQFF	TRBV7-3	TRBJ2-1
TGCGCCAGCAGCTGCGCACTAGGGGAGACCCAGTACTTC	CASSCALGETQYF	TRBV5-1	TRBJ2-5
TGTGCCAGCAGTGTAAGAAAAACAGCGGATCAGCCCCAGCATTTT	CASSVRKTADQPQHF	TRBV6-2	TRBJ1-5
TGTGCCAGCAGCTTAGCGGTTCGGGACAGGGGGGTATTCGCTAACTATGGCTACACCTTC	CASSLAVRDRGVFANYGYTF	TRBV7-6	TRBJ1-2
TGCAGTGCTAGGGTCCCCGGGGGTCCCTACAATGAGCAGTTCTTC	CSARVPGGPYNEQFF	TRBV20-1	TRBJ2-1
TGTGCCAGCAGTTCCTACCAAGGTCTCACTGAAGCTTTCTTT	CASSSYQGLTEAFF	TRBV28	TRBJ1-1
TGTGCCAGCATAACGGACGGAAATGAAAAACTGTTTTTT	CASITDGNEKLFF	TRBV28	TRBJ1-4
TGTGCCAGGGAGGAGGGGGGGGCTGAAGCTTTCTTT	CAREEGGAEAFF	TRBV19	TRBJ1-1
TGCAGTGCAGAGTTCCCTCCGGGTCCTACCCCCCACACTGAAGCTTTCTTT	CSAEFPPGPTPHTEAFF	TRBV20-1	TRBJ1-1
TGTGCCAGCAGCGAAGGGGATAGTCATAGCAATCAGCCCCAGCATTTT	CASSEGDSHSNQPQHF	TRBV5-4	TRBJ1-5
TGTGCCAGCAGCGGTTGCAGGCCCGATCGAGCCAAAAACATTCAGTACTTC	CASSGCRPDRAKNIQYF	TRBV13	TRBJ2-4
TGTGCCAGCAGTTCGCCGGGACAGGGCTATAGCAATCAGCCCCAGCATTTT	CASSSPGQGYSNQPQHF	TRBV28	TRBJ1-5
TGTGCCAGCAGCCCTGATTCAAGTAAGGGGGCCGTCTCTGGAAACACCATATATTTT	CASSPDSSKGAVSGNTIYF	TRBV7-3	TRBJ1-3
TGTGCTAGTGGTCTATACAGGGGGGTAGTCGCGAACACCGGGGAGCTGTTTTTT	CASGLYRGVVANTGELFF	TRBV12-5	TRBJ2-2
TGTGCCACCAGTGAGCCCCCGGGACGGCGGAAAGAGACCCAGTACTTC	CATSEPPGRRKETQYF	TRBV24-1	TRBJ2-5
TGTGCCAGCAGCAGTCAATCCGGGACAGGGTGCCATCAGCCCCAGCATTTT	CASSSQSGTGCHQPQHF	TRBV7-4	TRBJ1-5
TGTGCCAGCAGGGGCAGGGGGCGAACGGAACGGGTTGTAGATAATTCACCCCTCCACTTT	CASRGRGRTERVVDNSPLHF	TRBV12-3	TRBJ1-6
TGTGCCAGCACCTCTGGGGCCAACGTCCTGACTTTC	CASTSGANVLTF	TRBV6-3	TRBJ2-6
TGTGCCAGCAGCGCGGCTACAGGATTCGAGACCCAGTACTTC	CASSAATGFETQYF	TRBV9	TRBJ2-5
TGTGCCTGGAGTGTATCCGAGCCGTTTCTACTGGAGGGCAATCAGCCCCAGCATTTT	CAWSVSEPFLLEGNQPQHF	TRBV30	TRBJ1-5
TGTGCCAGCAGCACGGTTCGCCCCCATGGCTACACCTTC	CASSTVRPHGYTF	TRBV7-3	TRBJ1-2
TGTGCCAGCAGGTACGTAGGGGATGGCTACACCTTC	CASRYVGDGYTF	TRBV6-5	TRBJ1-2
TGTGCCCTGCTAGCGGGAATTTCAGATACGCAGTATTTT	CALLAGISDTQYF	TRBV28	TRBJ2-3
TGCAGTGCAGGGGGCGGAGGGGATAGCAATCAGCCCCAGCATTTT	CSAGGGGDSNQPQHF	TRBV20-1	TRBJ1-5
TGTGCCAGCAGCAAACGGGCATGCTACGAGCAGTACTTC	CASSKRACYEQYF	TRBV9	TRBJ2-7
TGTGCCAGCAGCCAGGAGGGTTTCGAGAACCCCCGGGACAGCAGGGATCAGCCCCAGCATTTT	CASSQEGFENPRDSRDQPQHF	TRBV7-8	TRBJ1-5
TGTGCCAGCAGGGGGGGGGGGTTTCTATTGGGGGCCGGAGATACGCAGTATTTT	CASRGGGFLLGAGDTQYF	TRBV2	TRBJ2-3
TGCGCCAGCAGTCGACAGGGGGCGTTTTTCACAGATACGCAGTATTTT	CASSRQGAFFTDTQYF	TRBV10-1	TRBJ2-3
TGTGCCAGCCGAGACAGGGCCTACGAGCAGTACTTC	CASRDRAYEQYF	TRBV9	TRBJ2-7
TGTGCCAGCAGCTTGGGACAGGAAATCTATAGCAATCAGCCCCAGCATTTT	CASSLGQEIYSNQPQHF	TRBV7-3	TRBJ1-5
TGTGCCAGCAGCCTCCCGGCCTACGAGCAGTACTTC	CASSLPAYEQYF	TRBV14	TRBJ2-7
TGCGCCAGCACCGGGGGTCAGGGGTGCTCCTACGAGCAGTACTTC	CASTGGQGCSYEQYF	TRBV4-3	TRBJ2-7
TGCGCCAGCAGTGAGTCAACAGGGAGAGTTGGTGACCAAGAGACCCAGTACTTC	CASSESTGRVGDQETQYF	TRBV10-1	TRBJ2-5
TGTGCCAGCAGTGGCACCCGGAAACCAGCCGCCAACACTGAAGCTTTCTTT	CASSGTRKPAANTEAFF	TRBV6-4	TRBJ1-1
TGTGCCAGCAGAAATCAGGGTACTAAGGTGGGGGGCTACACCTTC	CASRNQGTKVGGYTF	TRBV28	TRBJ1-2
TGCAAATGGGGGGGGGCCGGGACGTCTTTCTATGTCGACAATCAGCCCCAGCATTTT	CKWGGAGTSFYVDNQPQHF	TRBV20-1	TRBJ1-5
TGCAGTGCTAGAGGGACCAGCGATGGCTACACCTTC	CSARGTSDGYTF	TRBV20-1	TRBJ1-2
TGTGCCAGCCGTCCCCAACTTCTAGAGCAGCCCCAGCATTTT	CASRPQLLEQPQHF	TRBV27	TRBJ1-5
TGTGCCAGCAGTGACACTCGGGGTCAGACTGCCGAGCAGTACTTC	CASSDTRGQTAEQYF	TRBV6-4	TRBJ2-7
TGTGCCAGCAGTTACTCCGGGACTAGCGGAGGCTCCTACAATGAGCAGTTCTTC	CASSYSGTSGGSYNEQFF	TRBV6-5	TRBJ2-1
TGTGCCAGCAGTGAATGCGAGGGTAACTACAATGAGCAGTTCTTC	CASSECEGNYNEQFF	TRBV25-1	TRBJ2-1
TGCGCCAGCAGCCGGGCTCCGCCAGGGGGGATCTACGAGCAGTACTTC	CASSRAPPGGIYEQYF	TRBV4-3	TRBJ2-7
TGTGCCAGCAGCGGTAGATCCAATGAGCAGTTCTTC	CASSGRSNEQFF	TRBV5-5	TRBJ2-1
TGTGCCAGCAGTTCTTCCAGCAGGTGGGCTGAGGGGACCGAGCAGTACTTC	CASSSSSRWAEGTEQYF	TRBV6-5	TRBJ2-7
TGTGCCAGCACGACAGGGGCCTCTGGAAACACCATATATTTT	CASTTGASGNTIYF	TRBV2	TRBJ1-3
TGTGCCAGCAAAGTGGTACCCCTGAGGACGGGTCAGCCCCAGCATTTT	CASKVVPLRTGQPQHF	TRBV6-2	TRBJ1-5
TGTGCCAGCAGTTTGACGAATAGGGGGGGTGTGGGGCACCAAGAGACCCAGTACTTC	CASSLTNRGGVGHQETQYF	TRBV12-4	TRBJ2-5
TGTGCCAGCAGCCACTCTAGCGGGGACAATGAGCAGTTCTTC	CASSHSSGDNEQFF	TRBV3-1	TRBJ2-1
TGTGCCGGAATCTGGGGGGGGGTTACTGGCTACACCTTC	CAGIWGGVTGYTF	TRBV24-1	TRBJ1-2
TGTGCCAACGAACCCGACGGGGGGGGGTCGAATGAGCAGTTCTTC	CANEPDGGGSNEQFF	TRBV28	TRBJ2-1
TGCGCCAGCAGCCAAGTAAAAAGTCGGTTAGGGGCCTACAATGAGCAGTTCTTC	CASSQVKSRLGAYNEQFF	TRBV4-3	TRBJ2-1
TGTGCCAGCAGCTTCTGTGAGTTGACAGGGGAGTATTTT	CASSFCELTGEYF	TRBV7-2	TRBJ2-3
TGTGCCAGCTGGCGGGACAGGGCCCGTAATGAAAAACTGTTTTTT	CASWRDRARNEKLFF	TRBV27	TRBJ1-4
TGCGCCAGCAGCCAAGTAATAGGGACAGACGGCCAAAATCAGCCCCAGCATTTT	CASSQVIGTDGQNQPQHF	TRBV4-1	TRBJ1-5
TGCGCCAGCAGCCAGGGACCGACAGAGAGTCATAATTCACCCCTCCACTTT	CASSQGPTESHNSPLHF	TRBV4-1	TRBJ1-6
TGTGCCAGCAGCTGCAGGGGGCCGGCCTACGAGCAGTACTTC	CASSCRGPAYEQYF	TRBV7-3	TRBJ2-7
TGTGCCAGCAGTGCCCCCCTTGCGGACGAGCAGTACTTC	CASSAPLADEQYF	TRBV6-4	TRBJ2-7
TGTGCCACCAGCCGGCTCGCGGTTCAGCCCCAGCATTTT	CATSRLAVQPQHF	TRBV24-1	TRBJ1-5
TGCAGCGTTGGGAAATACCTACGGACGGGTTATGGCTACACCTTC	CSVGKYLRTGYGYTF	TRBV29-1	TRBJ1-2
TGCAGTGCTAGAGATCGGGTACATGGGGCTAGGGGGCCCTGTCGGAACTATGGCTACACCTTC	CSARDRVHGARGPCRNYGYTF	TRBV20-1	TRBJ1-2
TGTGCCAGCACTATTGACAGGGGATACGGGGAGCTGTTTTTT	CASTIDRGYGELFF	TRBV27	TRBJ2-2
TGTGCCAGCAGTCGCGGACAGGGTTCTTACAATGAGCAGTTCTTC	CASSRGQGSYNEQFF	TRBV27	TRBJ2-1
TGTGCCAGCAGTGACACGAGGAAGGACAGGGGGGTGAACACTGAAGCTTTCTTT	CASSDTRKDRGVNTEAFF	TRBV6-1	TRBJ1-1
TGCAGTGCTAGAGATCTTCAGGGTAATAGAAATGGGACTGAAGCTTTCTTT	CSARDLQGNRNGTEAFF	TRBV20-1	TRBJ1-1
TGTGCCAGCAGGTGCCTCGGACAGGGGGTTCACTCTGGAAACACCATATATTTT	CASRCLGQGVHSGNTIYF	TRBV6-3	TRBJ1-3
TGTGCCAGCAGCTTAAACCAACAGGCTATGGAAAAACTGTTTTTT	CASSLNQQAMEKLFF	TRBV7-3	TRBJ1-4
TGTGCCAGCAGCTCCGGGCGGGAGCTGGGTCTCAATGAGCAGTTCTTC	CASSSGRELGLNEQFF	TRBV5-4	TRBJ2-1
TGTGCCAGCAGTTCGAGGTCCACCCAGCATTTT	CASSSRSTQHF	TRBV12-3	TRBJ1-5
TGTGCCTGGAGTGTACGGTTCGCAGGGGAGACCCAGTACTTC	CAWSVRFAGETQYF	TRBV30	TRBJ2-5
TGTGCCAGCAGGAAACAGGGCTACGAGCAGTACTTC	CASRKQGYEQYF	TRBV6-4	TRBJ2-7
TGTGCCTGGAACCGGGACATAGAGAACACTGAAGCTTTCTTT	CAWNRDIENTEAFF	TRBV30	TRBJ1-1
TGTGCCAGCAGCGTAGAAAAGGGGGGTGAGACCCAGTACTTC	CASSVEKGGETQYF	TRBV9	TRBJ2-5
TGTGCCAGCAGCGGTCAGGGGAGAGAAGACACTGAAGCTTTCTTT	CASSGQGREDTEAFF	TRBV6-1	TRBJ1-1
TGCGCCAGCAGCAGCGGGGGGACCCTCTACAATGAGCAGTTCTTC	CASSSGGTLYNEQFF	TRBV4-1	TRBJ2-1
TGTGCCAGCAGTGACTGTCCGGTCGGCTACGAGCAGTACTTC	CASSDCPVGYEQYF	TRBV6-4	TRBJ2-7
TGTGCCAGCAGCGGAGAAGGGCGGGACAATGAGCAGTTCTTC	CASSGEGRDNEQFF	TRBV7-3	TRBJ2-1
TGTGCCAGCAGTGAAGAGGGAGCGGGGGAGTACGAGCAGTACTTC	CASSEEGAGEYEQYF	TRBV25-1	TRBJ2-7
TGTGCCAGTAGTACCCGGGGGGGGATTCGATATTTT	CASSTRGGIRYF	TRBV19	TRBJ2-3
TGCAGTGCTAGAACCGGTTCATACAATGAGCAGTTCTTC	CSARTGSYNEQFF	TRBV20-1	TRBJ2-1
TGTGCCAGCAGCGAGGTGGACAGGGGGTACTTC	CASSEVDRGYF	TRBV14	TRBJ2-7
TGTGCCAGCAGTCCAAGTCCACCAGGGGTAGGGGGGACCGATGAGCAGTTCTTC	CASSPSPPGVGGTDEQFF	TRBV6-6	TRBJ2-1
TGTGCCAGCAGTAAGTCGTTTTATGTGCCGAAGAGCTACGAGCAGTACTTC	CASSKSFYVPKSYEQYF	TRBV6-5	TRBJ2-7
TGTGCCAGCAAAACCATCTATAATGAAAAACTGTTTTTT	CASKTIYNEKLFF	TRBV12-3	TRBJ1-4
TGTGCCACCAGTGATTTCCATTGTGGCTACACCTTC	CATSDFHCGYTF	TRBV24-1	TRBJ1-2
TGTGCCACCAGCAGAGCGACTAGCGCATACGAGCAGTACTTC	CATSRATSAYEQYF	TRBV15	TRBJ2-7
TGTGCCAGCAGCAGTCATATTAGCGGGTGGACCTTCAATGGCTACGAGCAGTACTTC	CASSSHISGWTFNGYEQYF	TRBV6-3	TRBJ2-7
TGTGCCAGCCAGCCAGTCGCTGGAAACACCATATATTTT	CASQPVAGNTIYF	TRBV6-1	TRBJ1-3
TGTGCCAGCAGTGACGGGGGGGACTACGAGCAGTACTTC	CASSDGGDYEQYF	TRBV25-1	TRBJ2-7
TGCAGTGCTTTGTTCCTCGCCGGGGGCCACACTGAAGCTTTCTTT	CSALFLAGGHTEAFF	TRBV20-1	TRBJ1-1
TGTGCCAGCAGTAGTGTGGGTGGCAGGGCTAGCACAGATACGCAGTATTTT	CASSSVGGRASTDTQYF	TRBV6-5	TRBJ2-3
TGTGCCAGCAGCGCGGGCTCGCGTGAGCAGTTCTTC	CASSAGSREQFF	TRBV7-3	TRBJ2-1
TGTGCCAGTAGTATGACAGGGTGGGGGCTTTCACCCCTCCACTTT	CASSMTGWGLSPLHF	TRBV19	TRBJ1-6
TGTGCCAGCAGCTCGGCGGGAGCTAACTATGGCTACACCTTC	CASSSAGANYGYTF	TRBV7-9	TRBJ1-2
TGTGCCAGCAGACTACTTGACAGGGATGAGACCCAGTACTTC	CASRLLDRDETQYF	TRBV6-2	TRBJ2-5
TGTGCCACCAGCAGAGCGGACCTAAAAGGCCACTACGAGCAGTACTTC	CATSRADLKGHYEQYF	TRBV15	TRBJ2-7
TGTGCCAGCAGCCTGGGGGGACAGGCTGAAGCTTTCTTT	CASSLGGQAEAFF	TRBV5-4	TRBJ1-1
TGTGCCAGCAGCTTAGAAGGCTGGACTGGTAGCAATCAGCCCCAGCATTTT	CASSLEGWTGSNQPQHF	TRBV7-6	TRBJ1-5
TGTGCCAGGGGGCTAGTCAGTAATTTGGGATACGAGCAGTACTTC	CARGLVSNLGYEQYF	TRBV7-2	TRBJ2-7
TGTGCCAGCAGTTACGGGCGGCCGCGCTCCAAGGTCTCCTACAATGAGCAGTTCTTC	CASSYGRPRSKVSYNEQFF	TRBV6-5	TRBJ2-1
TGCAGTGCTAGGACGAGGACAGGGGGGGTTCGAGAATCCTACAATGAGCAGTTCTTC	CSARTRTGGVRESYNEQFF	TRBV20-1	TRBJ2-1
TGTGCCAGCCCCCCACTAGCGGGGTACAATGAGCAGTTCTTC	CASPPLAGYNEQFF	TRBV27	TRBJ2-1
TGTGCCAGCAGTTACTCTCAGGGGCCTGATGGCTACACCTTC	CASSYSQGPDGYTF	TRBV6-6	TRBJ1-2
TGTGCCAGCAGACCCCTATTGGTATTCACAGGTACCTTTGGGGAAGTTGGGTCCTACGAGCAGTACTTC	CASRPLLVFTGTFGEVGSYEQYF	TRBV28	TRBJ2-7
TGTGCCACGGGCCTGGGGGGGGCTAGCACAGATACGCAGTATTTT	CATGLGGASTDTQYF	TRBV5-4	TRBJ2-3
TGTGCCAGCAGCCGGGGGGGAGATACGCAGTATTTT	CASSRGGDTQYF	TRBV3-1	TRBJ2-3
TGCGCCAGTGTGCTATGTCGCACAGATACGCAGTATTTT	CASVLCRTDTQYF	TRBV5-1	TRBJ2-3
TGTGCCAGCAAAAGGGGGCTTACCCTCCACTTT	CASKRGLTLHF	TRBV6-4	TRBJ1-6
TGCAGTGCTAGAGAACTGGGCCGACAGAAGGTACGAAACTTATACGAGCAGTACTTC	CSARELGRQKVRNLYEQYF	TRBV20-1	TRBJ2-7
TGTGCCAGCAGCCCAGTGAGGGGCTACGAGCAGTACTTC	CASSPVRGYEQYF	TRBV7-9	TRBJ2-7
TGTGCCAGCAGTCCGGCCGGACAGGGACGGAAGAGGACTAATGAAAAACTGTTTTTT	CASSPAGQGRKRTNEKLFF	TRBV27	TRBJ1-4
TGCGCCAGCAGCGAACGGGCCGACTCTGGAAACACCATATATTTT	CASSERADSGNTIYF	TRBV5-1	TRBJ1-3
TGCAGCGTTGCCGACCGTAGCGGGATGGGCCACACCGGGGAGCTGTTTTTT	CSVADRSGMGHTGELFF	TRBV29-1	TRBJ2-2
TGTGCCAGCAGGGGACAGTTACTCTCCTACGAGCAGTACTTC	CASRGQLLSYEQYF	TRBV5-4	TRBJ2-7
TGCGCCAGCAGCGCCCCTTGCCGGGACAGGGAACCGACAGATACGCAGTATTTT	CASSAPCRDREPTDTQYF	TRBV5-1	TRBJ2-3
TGTGCCAGCAGTTTATCCGGGGATCGTACTAGCAATCAGCCCCAGCATTTT	CASSLSGDRTSNQPQHF	TRBV27	TRBJ1-5
TGTGCCATGAGGGGGGGAAGTAACGGGGAGCTGTTTTTT	CAMRGGSNGELFF	TRBV19	TRBJ2-2
TGCAGTGCCCTCGGGGCTGCCGGGACTAGCGAGGAGACCCAGTACTTC	CSALGAAGTSEETQYF	TRBV20-1	TRBJ2-5
TGCAGTGCGGTAAGGGGTGGGGGCCCACTAACAGATACGCAGTATTTT	CSAVRGGGPLTDTQYF	TRBV20-1	TRBJ2-3
TGTGCCAGTACCCTAAGATGCACAGATACGCAGTATTTT	CASTLRCTDTQYF	TRBV19	TRBJ2-3
TGTGCCAGCAGCTTATCCACGGGCCGGGACAGGGCTGATAAAACAGATACGCAGTATTTT	CASSLSTGRDRADKTDTQYF	TRBV13	TRBJ2-3
TGTGCCAGCAGCATCGGAATGGGTAACACCGGGGAGCTGTTTTTT	CASSIGMGNTGELFF	TRBV7-9	TRBJ2-2
TGTGCCAGCAGTTTATTTTCTCGGGGGGCGCGGGGATTCACCGGGGAGCTGTTTTTT	CASSLFSRGARGFTGELFF	TRBV12-4	TRBJ2-2
TGTGCCAGCAGCTGGGTCCTCGGCCGGACAGGGATTGGCTACACCTTC	CASSWVLGRTGIGYTF	TRBV5-6	TRBJ1-2
TGTGCCAGCAGCACCTCCGGGACTAGTCCGGTGATAGGGAGCTACGAGCAGTACTTC	CASSTSGTSPVIGSYEQYF	TRBV13	TRBJ2-7
TGTGCCAGCAGCTTAATTCCATCCCGACTCTACGAGCAGTACTTC	CASSLIPSRLYEQYF	TRBV7-3	TRBJ2-7
TGTGCCAGCTCGGGACTAGCGGGAAACACCGGGGAGCTGTTTTTT	CASSGLAGNTGELFF	TRBV6-1	TRBJ2-2
TGTGCCAGCAGCCCTCCTACTCAGGGGGCCAACACTGAAGCTTTCTTT	CASSPPTQGANTEAFF	TRBV7-3	TRBJ1-1
TGTGCCGACAGGGCCCTTTCGGGCAGTCAGCCCCAGCATTTT	CADRALSGSQPQHF	TRBV19	TRBJ1-5
TGCGCCAGCAGCTTGGCCGTTCTTACGCTAAGGCGCTACGAGCAGTACTTC	CASSLAVLTLRRYEQYF	TRBV5-1	TRBJ2-7
TGTGCCAGCAGCCCCAGGGACGATTTTCGCTCCTACAATGAGCAGTTCTTC	CASSPRDDFRSYNEQFF	TRBV13	TRBJ2-1
TGTGCCAGCAGTTGGGCGGGGTGGGGTAATCAGCCCCAGCATTTT	CASSWAGWGNQPQHF	TRBV28	TRBJ1-5
TGTGCCAGTGCCGGGGTAGGCTTC	CASAGVGF	TRBV9	TRBJ2-5
TGTGCCTGGTACCTACACTCTGCACCCTACGAGCAGTACTTC	CAWYLHSAPYEQYF	TRBV30	TRBJ2-7
TGCAGTGCTAGAGATCCAATTAGCGGAGTTGCCTACAATGAGCAGTTCTTC	CSARDPISGVAYNEQFF	TRBV20-1	TRBJ2-1
TGTGCCAGCAGCAATCTGAATAGACAGGGCGGGCCCCAGCATTTT	CASSNLNRQGGPQHF	TRBV5-4	TRBJ1-5
TGTGCCAGCAGGACAGAGGGGGGACGATTCGGCTACACCTTC	CASRTEGGRFGYTF	TRBV25-1	TRBJ1-2
TGTGCCAGCAGTACCTGTAGAAAGACAGGGGTGTTAGGGGGGAATTCACCCCTCCACTTT	CASSTCRKTGVLGGNSPLHF	TRBV27	TRBJ1-6
TGCAGCGTTGCGGGGAGGGTGTGCTCCTACGAGCAGTACTTC	CSVAGRVCSYEQYF	TRBV29-1	TRBJ2-7
TGTGCCAGCAGCTTAGCCTCTGTCCCCTCATACTCCTACGAGCAGTACTTC	CASSLASVPSYSYEQYF	TRBV11-1	TRBJ2-7
TGTGCCAGCAGAGTACTTTCCCCGACAGGGGCCCTGTCCTACGAGCAGTACTTC	CASRVLSPTGALSYEQYF	TRBV6-6	TRBJ2-7
TGCGCCAGCAGTGGGCGGGCTCCTCGACAGGGGACCTCCTATAATTCACCCCTCCACTTT	CASSGRAPRQGTSYNSPLHF	TRBV10-1	TRBJ1-6
TGTGCCAGCAGCCCCTCCGGGGCAACACGGAAGCCCCAGCATTTT	CASSPSGATRKPQHF	TRBV7-3	TRBJ1-5
TGTGCCAGCAGCGGGGGGACGTGCTCCTACGAGCAGTACTTC	CASSGGTCSYEQYF	TRBV7-4	TRBJ2-7
TGTGCCAGCAGCTGGGACAGAGGATGGACCCAGTACTTC	CASSWDRGWTQYF	TRBV13	TRBJ2-5
TGTGCCAGCACCCCCAGCCTTTCCACTGAAGCTTTCTTT	CASTPSLSTEAFF	TRBV27	TRBJ1-1
TGCAGTGCTAGAGATCTGGGTGCGCTAGGCTTC	CSARDLGALGF	TRBV20-1	TRBJ2-7
TGTGCCAGCAGCTTGCTGGGTTCCCGGGACAGGGGTTGCCAAGAGACCCAGTACTTC	CASSLLGSRDRGCQETQYF	TRBV5-6	TRBJ2-5
TGCAGTGCTCATCGGACAGGTGGCAACACTGAAGCTTTCTTT	CSAHRTGGNTEAFF	TRBV20-1	TRBJ1-1
TGTGCCAGCACCGGACTGATAGACGTAAAGGAGACCCAGTACTTC	CASTGLIDVKETQYF	TRBV27	TRBJ2-5
TGCAGTGCTAGAACGGGAAGGGGGCTTGGCTACGAGCAGTACTTC	CSARTGRGLGYEQYF	TRBV20-1	TRBJ2-7
TGTGCTAGTGGTTTGAATGTCTTCCGGGTCACGACGGCAAATGAGCAGTTCTTC	CASGLNVFRVTTANEQFF	TRBV12-5	TRBJ2-1
TGTGCCAGCACGACAGGGGCAACTGAAGCTTTCTTT	CASTTGATEAFF	TRBV6-6	TRBJ1-1
TGTGCCAGCAGGCCACAGGGGGAGTACAATGAGCAGTTCTTC	CASRPQGEYNEQFF	TRBV28	TRBJ2-1
TGTGCCAGCTCCGGGACACCTACGCAGTATTTT	CASSGTPTQYF	TRBV2	TRBJ2-3
TGTGCCAGCAGAAGAAGGGAGGCTCCAGCCAAAAACATTCAGTACTTC	CASRRREAPAKNIQYF	TRBV6-4	TRBJ2-4
TGTGCCAGCAGCTTAAGGGTCGGGAGATCCTACGAGCAGTACTTC	CASSLRVGRSYEQYF	TRBV7-9	TRBJ2-7
TGTGCCAGCAGCGTATCCCCAGGGGGGGGGGACCGGGGAAATCAGCCCCAGCATTTT	CASSVSPGGGDRGNQPQHF	TRBV13	TRBJ1-5
TGTGCCAGCAGTGAGAGGGGGCATGGGACTACAAGCACTGAAGCTTTCTTT	CASSERGHGTTSTEAFF	TRBV6-4	TRBJ1-1
TGTGCCAGCAGCGACTGGACTTGTGGCTACACCTTC	CASSDWTCGYTF	TRBV5-5	TRBJ1-2
TGTGCCAGCAGTTTACTAACACAGGCCCCCAGAGCCTACGAGCAGTACTTC	CASSLLTQAPRAYEQYF	TRBV28	TRBJ2-7
TGTGCCAGCAGCGTAGGTTCCGGGCAGGGGCCTAGGAACACTGAAGCTTTCTTT	CASSVGSGQGPRNTEAFF	TRBV9	TRBJ1-1
TGTGCGGACCAAGAGACCCAGTACTTC	CADQETQYF	TRBV11-3	TRBJ2-5
TGCAGCGTTGGTCAGGGGGGCTCCCTCGACAGCTCTGGGGCCAACGTCCTGACTTTC	CSVGQGGSLDSSGANVLTF	TRBV29-1	TRBJ2-6
TGCGCCAGCAGCAGTTCAGCGGGATCGAACACCGGGGAGCTGTTTTTT	CASSSSAGSNTGELFF	TRBV5-1	TRBJ2-2
TGCAGTGCTAGAGGTAGCCCCCGACAGGGGTACGATCCGACTGAAGCTTTCTTT	CSARGSPRQGYDPTEAFF	TRBV20-1	TRBJ1-1
TGTGCCAGCAGCTTGGAACCACCCACTAGGACCGGGGAGCTGTTTTTT	CASSLEPPTRTGELFF	TRBV5-6	TRBJ2-2
TGCAGTGCTAGCCCGCGGGGACCAAGGACGTACAATGAGCAGTTCTTC	CSASPRGPRTYNEQFF	TRBV20-1	TRBJ2-1
TGTGCCAGCAGCGTTGGGTGTCCTGGACACAGATCTTGCACCTCCTACGAGCAGTACTTC	CASSVGCPGHRSCTSYEQYF	TRBV11-1	TRBJ2-7
TGTGCCAGCAGCGTACAACAAGAGGGGATTACCGGGGAGCTGTTTTTT	CASSVQQEGITGELFF	TRBV9	TRBJ2-2
TGTGCCAGCAGCGGAGGGGAGGGAGTGCGGGGGGAGCAGTACTTC	CASSGGEGVRGEQYF	TRBV7-3	TRBJ2-7
TGTGCCAGCAGGCACGACGGACCAGCTTTCTTT	CASRHDGPAFF	TRBV6-2	TRBJ1-1
TGTGCCAGCAGGAGCCAGGGACAGGACGGGGGGCGGCCTGGCTACACCTTC	CASRSQGQDGGRPGYTF	TRBV6-4	TRBJ1-2
TGCGCCAGCAGCCAAGATGCGGGACTAGCGGGCTCCGAGCAGTACTTC	CASSQDAGLAGSEQYF	TRBV4-3	TRBJ2-7
TGTGCCAGCCGTAGTGGAGGGGACACTGAAGCTTTCTTT	CASRSGGDTEAFF	TRBV27	TRBJ1-1
TGTGCCAGCAGTAACCATGTTCGGGTGGGCACAGATACGCAGTATTTT	CASSNHVRVGTDTQYF	TRBV6-2	TRBJ2-3
TGTGCCACCAGTGATCCGGGGGTTAACTATGGCTACACCTTC	CATSDPGVNYGYTF	TRBV24-1	TRBJ1-2
TGTGCCAGCAGGACGCGGAAAGGGGATACGCAGTATTTT	CASRTRKGDTQYF	TRBV6-2	TRBJ2-3
TGTGCCAGCGGAGGGGAGGTCGAAAAACTGTTTTTT	CASGGEVEKLFF	TRBV6-1	TRBJ1-4
TGTGCCTGGGGACCTCCCCGGGGCTGGGTGTACTATGGCTACACCTTC	CAWGPPRGWVYYGYTF	TRBV30	TRBJ1-2
TGTGCCAGCAGCGTAGGAGGACAGGTAGATGGCCGATCTAACTATGGCTACACCTTC	CASSVGGQVDGRSNYGYTF	TRBV9	TRBJ1-2
TGTGCCAGCAGTTCCACCGGGACAGACGAGCAGTACTTC	CASSSTGTDEQYF	TRBV27	TRBJ2-7
TGTGCCACCAGTGATTTGGCCCGGGACAGCTCCTACAATGAGCAGTTCTTC	CATSDLARDSSYNEQFF	TRBV24-1	TRBJ2-1
TGTGCCAGCAGCCTTCCCCGAAGAGTAAACTCCTACGAGCAGTACTTC	CASSLPRRVNSYEQYF	TRBV13	TRBJ2-7
TGTGCCAGCAGCGTAGGGATCGGCAGACAGGGGGGTGGTGAAGCTTTCTTT	CASSVGIGRQGGGEAFF	TRBV9	TRBJ1-1
TGTGCCAGCTCACGGGGTGGAACTAACTATGGCTACACCTTC	CASSRGGTNYGYTF	TRBV18	TRBJ1-2
TGTGCCAGCAGCTTTTCGGGCGGGGGTAACAATGAGCAGTTCTTC	CASSFSGGGNNEQFF	TRBV6-4	TRBJ2-1
TGTGCCAGCAGCTTAGTTCTCAACTCGACAGGGGGGAACGAGCAGTACTTC	CASSLVLNSTGGNEQYF	TRBV7-2	TRBJ2-7
TGTGCCAGCAGCCCCCGGGAGAACACTGAAGCTTTCTTT	CASSPRENTEAFF	TRBV5-6	TRBJ1-1
TGTGCCAGCAGTAAAGAAATCTTTAGGGACTATAATGAAAAACTGTTTTTT	CASSKEIFRDYNEKLFF	TRBV6-1	TRBJ1-4
TGTGCCTGGAGGCAAGGGGGCCAATACGAGCAGTACTTC	CAWRQGGQYEQYF	TRBV30	TRBJ2-7
TGTGCCAGCAGTGTCCGACAGGGTCTGAAGCATAGGGTGTCCCAAGAGACCCAGTACTTC	CASSVRQGLKHRVSQETQYF	TRBV6-4	TRBJ2-5
TGTGCCTGGAGTAGGGCGGACAGGGGTCGCGGTACAGATACGCAGTATTTT	CAWSRADRGRGTDTQYF	TRBV30	TRBJ2-3
TGTGCCAGCAGCTTAATCCCCCCGGGACATGAAAAACTGTTTTTT	CASSLIPPGHEKLFF	TRBV7-3	TRBJ1-4
TGCAGTGCTAGAGAGTCAACAGACGGGGAGCTGTTTTTT	CSARESTDGELFF	TRBV20-1	TRBJ2-2
TGTGCTAGTGGTAAACGGGACAGGATGAACACTGAAGCTTTCTTT	CASGKRDRMNTEAFF	TRBV12-5	TRBJ1-1
TGCAGTGCTAGAAGCAGGGGGGCCGAGACCCAGTACTTC	CSARSRGAETQYF	TRBV20-1	TRBJ2-5
TGCGCCAGCAGCGCCCCCTCCCCGGGAGAAAGGGGTGAGCAGTACTTC	CASSAPSPGERGEQYF	TRBV5-1	TRBJ2-7
TGTGCCACCGACAGGGGGGGTTCCTACGAGCAGTACTTC	CATDRGGSYEQYF	TRBV6-4	TRBJ2-7
TGCGCCAGCAGCCTAAAGGGGCCCCCAGATACGCAGTATTTT	CASSLKGPPDTQYF	TRBV5-1	TRBJ2-3
TGTGCCAGCAGCTCCATAGGGGAGGGCAAATCCGCAACTAATGAAAAACTGTTTTTT	CASSSIGEGKSATNEKLFF	TRBV9	TRBJ1-4
TGTGCCTGGAGAGGACCCCAAGGACAGGCTTCCCTGCCAGAAGCCAAAAACATTCAGTACTTC	CAWRGPQGQASLPEAKNIQYF	TRBV30	TRBJ2-4
TGCGCCAGCAGCCAAGATTCCGGACTAGCGCCGGCTAACACCGGGGAGCTGTTTTTT	CASSQDSGLAPANTGELFF	TRBV4-1	TRBJ2-2
TGTGCCAGCAGCCAAGATCAGTTTAAAAACAGGGCCTTCGGTAGCTCCTACGAGCAGTACTTC	CASSQDQFKNRAFGSSYEQYF	TRBV3-1	TRBJ2-7
TGTGCCAGCAGCCAAGATGTCTCATCCAGGGTGGACACCGGGGAGCTGTTTTTT	CASSQDVSSRVDTGELFF	TRBV4-2	TRBJ2-2
TGTGCCAGCAGCCCCCCCACTAGAGTTTCCCCCTACGAGCAGTACTTC	CASSPPTRVSPYEQYF	TRBV13	TRBJ2-7
TGTGCCAGCAGCTTAGCCGGGACAACCTACGAGCAGTACTTC	CASSLAGTTYEQYF	TRBV7-9	TRBJ2-7
TGTGCCAGCAGCGTAGGGGATAGGAGTGGGGGACAGACCGGGGAGCTGTTTTTT	CASSVGDRSGGQTGELFF	TRBV9	TRBJ2-2
TGTGCCAGTAGTATGGATGCCAGAAGCGGGAGAATGGGGAACTTC	CASSMDARSGRMGNF	TRBV19	TRBJ2-7
TGTGCCAGCAGTGACCAGGCTCGGACACGCCACGGCAAAAACATTCAGTACTTC	CASSDQARTRHGKNIQYF	TRBV6-4	TRBJ2-4
TGTGCCATCAGCACCTCCGGGGGCCCATATAATTCACCCCTCCACTTT	CAISTSGGPYNSPLHF	TRBV10-3	TRBJ1-6
TGTGCGTACAGGGGCAACCCTAGCAATCAGCCCCAGCATTTT	CAYRGNPSNQPQHF	TRBV28	TRBJ1-5
TGTGCCACCCGGACTACTAACACTGAAGCTTTCTTT	CATRTTNTEAFF	TRBV24-1	TRBJ1-1
TGCGCCAGCAGCTTGGGAGGTCCCAGGGCAACTAATGAAAAACTGTTTTTT	CASSLGGPRATNEKLFF	TRBV5-1	TRBJ1-4
TGTGCCAGCAGCTCCAGACCGAACTATGGCTACACCTTC	CASSSRPNYGYTF	TRBV7-2	TRBJ1-2
TGTGCCAGCAGGGAATCCCGGGACAGGGGGGGCATGAACACTGAAGCTTTCTTT	CASRESRDRGGMNTEAFF	TRBV6-1	TRBJ1-1
TGTGCCACCCCCGAAACTAGCGGGAGGGCGGACACCGGGGAGCTGTTTTTT	CATPETSGRADTGELFF	TRBV24-1	TRBJ2-2
TGTGCCAGCAGCTTGGCCGAAATAGGACAACACGAGCAGTACTTC	CASSLAEIGQHEQYF	TRBV5-6	TRBJ2-7
TGTGCCAGCAGCTTCCGACTGGGGGCACATGGCTACACCTTC	CASSFRLGAHGYTF	TRBV11-2	TRBJ1-2
TGTGCCAGCAGTTTCCAGACTTCTATGGGGGCCTGGTCTGAAGCTTTCTTT	CASSFQTSMGAWSEAFF	TRBV12-4	TRBJ1-1
