TGTGCCAGCAGCTCTTTGAAAAGCTATGGCTACACCTTC	CASSSLKSYGYTF	TRBV9	TRBJ1-2
TGCAGTGCTACCGGGGATGGGCAAGTAGGCTACACCTTC	CSATGDGQVGYTF	TRBV20-1	TRBJ1-2
TGCAGTGCTCTCTGGGGCTACACCTTC	CSALWGYTF	TRBV20-1	TRBJ1-2
TGTGCCAGCAGTTACCCCCTGACTAGCGGGAGGGCCCGGGGGTACTTC	CASSYPLTSGRARGYF	TRBV6-5	TRBJ2-4
TGTGCCACCAGTGATTTGCGCTGCCGGCGGGGCACCGGGGAGCTGTTTTTT	CATSDLRCRRGTGELFF	TRBV24-1	TRBJ2-2
TGTGCCAGCAGTGGGCGGGATGAGCAGTTCTTC	CASSGRDEQFF	TRBV14	TRBJ2-1
TGTGCCAGCAGTTTGGAAACAGAAGAGACCCAGTACTTC	CASSLETEETQYF	TRBV27	TRBJ2-5
TGTGCCAGCTCCTCTCCGGGACTAAGAACTGGAAACACCATATATTTT	CASSSPGLRTGNTIYF	TRBV18	TRBJ1-3
TGTGCCAGCAGCCAGTGTAGGGGTCCCTACAATGAGCAGTTCTTC	CASSQCRGPYNEQFF	TRBV5-5	TRBJ2-1
TGTGCCAGCAGTGACTCGACGCTCCCCCCAGGGGTAGGGTTTAATGAAAAACTGTTTTTT	CASSDSTLPPGVGFNEKLFF	TRBV6-4	TRBJ1-4
TGCGCCAGCAGCTTGGCCCGGGAAGTGCGGGGGGAGATCGAGGACATTCAGTACTTC	CASSLAREVRGEIEDIQYF	TRBV5-1	TRBJ2-4
TGCGCCAGCAGTGAGCCGGGGAGAGGGGCCTACGAGCAGTACTTC	CASSEPGRGAYEQYF	TRBV10-1	TRBJ2-7
TGCGCCAGCAGCCAAGAGGGAAGCGGGATTTCGGAGCACAATGAGCAGTTCTTC	CASSQEGSGISEHNEQFF	TRBV4-1	TRBJ2-1
TGTGCCAGCAGAGAGTCTCGGACAAATAGCAATCAGCCCCAGCATTTT	CASRESRTNSNQPQHF	TRBV11-2	TRBJ1-5
TGTGCCAGCAGCGTCCGACCCGACAGGGGGGTTATCTCCTACGAGCAGTACTTC	CASSVRPDRGVISYEQYF	TRBV9	TRBJ2-7
TGTGCCAGCAGTCGGATACGGACTAAGAATGGCTACACCTTC	CASSRIRTKNGYTF	TRBV6-4	TRBJ1-2
TGTGCCTGGAAGCCGGGACTAGCGGGGGGGCGAAATGAGCAGTTCTTC	CAWKPGLAGGRNEQFF	TRBV30	TRBJ2-1
TGCGCCAGCAGTCTTCCAGGGAATCAGCCCCAGCATTTT	CASSLPGNQPQHF	TRBV10-1	TRBJ1-5
TGTGCCAGCAGCGAAGGGGAGTATCAGCCCCAGCATTTT	CASSEGEYQPQHF	TRBV9	TRBJ1-5
TGCAGTGCTAGAACGGCCACTAGCTGCCACGAAGAACAAGAGACCCAGTACTTC	CSARTATSCHEEQETQYF	TRBV20-1	TRBJ2-5
TGTGCCAGCAGCCTAGCGGGGTACGAGCAGTACTTC	CASSLAGYEQYF	TRBV5-8	TRBJ2-7
TGTGCTAGTGGTTTGTGTGTGGAGGGATCTAACTATGGCTACACCTTC	CASGLCVEGSNYGYTF	TRBV12-5	TRBJ1-2
TGCGCCAGCAGCCAGCGGGTGGGAACCGGGGAGCTGTTTTTT	CASSQRVGTGELFF	TRBV4-1	TRBJ2-2
TGTGCCAGCAGCGTTTGGCCCCCAACAGGGGACTCCAAGTGTAACTATGGCTACACCTTC	CASSVWPPTGDSKCNYGYTF	TRBV7-9	TRBJ1-2
TGTGCCAGCAGCCTGACTAGCGGGGGGATTCCCTACGAGCAGTACTTC	CASSLTSGGIPYEQYF	TRBV7-3	TRBJ2-7
TGTGCCAGCAGCTTAAAGGTGGACTACGAGCAGTACTTC	CASSLKVDYEQYF	TRBV5-6	TRBJ2-7
TGTGCCAGCAGCCGACAGGGGTGTGACAACACTGAAGCTTTCTTT	CASSRQGCDNTEAFF	TRBV4-2	TRBJ1-1
TGCGCCAGCAGTGAGAGGGGGACAGGGTCCTACGAGCAGTACTTC	CASSERGTGSYEQYF	TRBV10-1	TRBJ2-7
TGCAGTGCTAGCCCCACGACAGGGGGGTACGAGCAGTACTTC	CSASPTTGGYEQYF	TRBV20-1	TRBJ2-7
TGTGCCAGCAGTTTCCGGCCCGTAACAGATACGCAGTATTTT	CASSFRPVTDTQYF	TRBV27	TRBJ2-3
TGTGCCAGCAGTAATCAGACCGCCTATGGCTACACCTTC	CASSNQTAYGYTF	TRBV11-3	TRBJ1-2
TGTGCCTGGAGTGCCGGGACAGGGGGGCATTCACCCCTCCACTTT	CAWSAGTGGHSPLHF	TRBV30	TRBJ1-6
TGTGCCAGCAGCTGGGTCCAGGGAGAGCATGGCTACACCTTC	CASSWVQGEHGYTF	TRBV27	TRBJ1-2
TGCGCCAGCAGCTGTTGTAGGGGGTACACCGGGGAGCTGTTTTTT	CASSCCRGYTGELFF	TRBV5-1	TRBJ2-2
TGCAGTGCTAGAGAGATTCGGGGGGTGAACACCGGGGAGCTGTTTTTT	CSAREIRGVNTGELFF	TRBV20-1	TRBJ2-2
TGTGCCAGTCCCCAACAAGGGGGGGCGGAAGTTGTAACTGAGCAGTTCTTC	CASPQQGGAEVVTEQFF	TRBV19	TRBJ2-1
TGTGCCGAATATGGGACAGGGAGAGAAAGCTCCTACGAGCAGTACTTC	CAEYGTGRESSYEQYF	TRBV14	TRBJ2-7
TGCGCCAGCAGCAAAGTGAAGGGGCCAGGTTCGCGCTACGAGCAGTACTTC	CASSKVKGPGSRYEQYF	TRBV5-1	TRBJ2-7
TGCAGTGCTAGCCTACAGGAGCCCAACGAGCAGTACTTC	CSASLQEPNEQYF	TRBV20-1	TRBJ2-7
TGCATCAATCGACAGGGGGCCTACAATGAGCAGTTCTTC	CINRQGAYNEQFF	TRBV20-1	TRBJ2-1
TGTGCCAGCAGCCACCTTCCTAGCTATGGAGATACGCAGTATTTT	CASSHLPSYGDTQYF	TRBV7-9	TRBJ2-3
TGTGCCAGCAGCGGCCACCCGACAGGGTGTGACACTGAAGCTTTCTTT	CASSGHPTGCDTEAFF	TRBV13	TRBJ1-1
TGTGCCAGCAGGGTAGGGAGGTCAGTCCGGGGGGCTTTCTCCTATAATTCACCCCTCCACTTT	CASRVGRSVRGAFSYNSPLHF	TRBV6-1	TRBJ1-6
TGCAGTGCCAGACCACCCTTATTTCGGAACGGCAGGGCCAATCAGCCCCAGCATTTT	CSARPPLFRNGRANQPQHF	TRBV20-1	TRBJ1-5
TGTGCCAGCAGTTCAAGGTCGAGGGGGGCTACTGAAGCTTTCTTT	CASSSRSRGATEAFF	TRBV6-3	TRBJ1-1
TGTGCCAGCAGCTGTAGGATAGGACTAGCGGGAGATATGAGCTCCTACGAGCAGTACTTC	CASSCRIGLAGDMSSYEQYF	TRBV11-2	TRBJ2-7
TGTGCCACCAGTGAACACACTGAAAAACTGTTTTTT	CATSEHTEKLFF	TRBV24-1	TRBJ1-4
TGTGCCAGCAGCTTAGGGGCCGGGGCCACCGGGGAGCTGTTTTTT	CASSLGAGATGELFF	TRBV7-9	TRBJ2-2
TGTGCCACCAGTGATTACGGACAGGGGGCGATGGGAACTGAAGCTTTCTTT	CATSDYGQGAMGTEAFF	TRBV24-1	TRBJ1-1
TGTGCCAGCAGCCCCAAACCCCCTGGGGTGGTCCCTTTCGAAACAGATACGCAGTATTTT	CASSPKPPGVVPFETDTQYF	TRBV4-2	TRBJ2-3
TGTGCCAGCAGCCTTGGGAGGTCCAAGCAGTACTTC	CASSLGRSKQYF	TRBV7-2	TRBJ2-7
TGTGCCAGCAGCAGGGAGCAGGGCCTCACCGGGGAGCTGTTTTTT	CASSREQGLTGELFF	TRBV7-3	TRBJ2-2
TGCGCCAGCAGCTTGGGACGGGAGGAGATCTTC	CASSLGREEIF	TRBV5-1	TRBJ2-1
TGCGCCAGCAGCTTGTTAGGCACCTCTGGAAACACCATATATTTT	CASSLLGTSGNTIYF	TRBV5-1	TRBJ1-3
TGTGCCAGCAGTCTTAGGGGGGGGGGCTATGGCTACACCTTC	CASSLRGGGYGYTF	TRBV28	TRBJ1-2
TGTGCCAGCAGCGACAGGGCCCGGAGAATTTATTCTGAAGCTTTCTTT	CASSDRARRIYSEAFF	TRBV14	TRBJ1-1
TGTGCCACCAGTGATCCACAGGGACCGACGAACACTGAAGCTTTCTTT	CATSDPQGPTNTEAFF	TRBV24-1	TRBJ1-1
TGTGCCAGCACCCCGGACAGCGGCGGGAACACCGGGGAGCTGTTTTTT	CASTPDSGGNTGELFF	TRBV11-1	TRBJ2-2
TGTGCCTGGAGGATCCTTGGGACTAGGGGGGACGAGCAGTACTTC	CAWRILGTRGDEQYF	TRBV30	TRBJ2-7
TGTGCCACCAGCAGAGATACGTTCCCCAGGGGCCTCCATGAGCAGTTCTTC	CATSRDTFPRGLHEQFF	TRBV15	TRBJ2-1
TGTGCCAGCAGCAAGCGGCCCGGAAGCAATCAGCCCCAGCATTTT	CASSKRPGSNQPQHF	TRBV7-2	TRBJ1-5
TGTGCCAGCAGCCAGGGGCCCCACCCCCATGAGCAGTTCTTC	CASSQGPHPHEQFF	TRBV13	TRBJ2-1
TGTGCCAGCAGTTACGGGGACCGGGACATTAATGAGCAGTTCTTC	CASSYGDRDINEQFF	TRBV6-6	TRBJ2-1
TGTGCCAGCAGCTTTAGTGGGCCTGAAACTAGCACAGATACGCAGTATTTT	CASSFSGPETSTDTQYF	TRBV13	TRBJ2-3
TGCGCCAGCAGCTTGGAGGCGGGACAGATAAATGGAAACACCATATATTTT	CASSLEAGQINGNTIYF	TRBV5-1	TRBJ1-3
TGCAGCGTTTGGCCCTGCACAGGGGGGGAGCACTACGAGCAGTACTTC	CSVWPCTGGEHYEQYF	TRBV29-1	TRBJ2-7
TGTGCCAGCCGAGTGAGCGGGAATCACTTC	CASRVSGNHF	TRBV6-2	TRBJ2-7
TGCAGCGTTGAAGAATATTTGACGGTGTCTGAGCAGTTCTTC	CSVEEYLTVSEQFF	TRBV29-1	TRBJ2-1
TGTGCCAGCACCCGACCAGGGGCCTACGAGCAGTACTTC	CASTRPGAYEQYF	TRBV5-6	TRBJ2-7
TGTTCCAGGGGGCGCGGCTACACCTTC	CSRGRGYTF	TRBV10-3	TRBJ1-2
TGTGCCAGCAGCTTGCTGGGTGACAGGGGGCAGAGCTCCTACGAGCAGTACTTC	CASSLLGDRGQSSYEQYF	TRBV5-4	TRBJ2-7
TGTGCCAGCAGCTCATGGGGGGAGGCTGTGATCGAAGAGACCCAGTACTTC	CASSSWGEAVIEETQYF	TRBV9	TRBJ2-5
TGTGCCAGCAGCGTAAGGGCAGGGTCCGTCCACAGGGGCCAAGAGACCCAGTACTTC	CASSVRAGSVHRGQETQYF	TRBV9	TRBJ2-5
TGTGCCAGCAGCTTACGAATTCCTCCCGGACAGGGTTCCGCTTTCTTT	CASSLRIPPGQGSAFF	TRBV7-6	TRBJ1-1
TGTGCCACCACCAACAGGGGGCGCGAAGGGGGGTTAAGTGAAGCTTTCTTT	CATTNRGREGGLSEAFF	TRBV24-1	TRBJ1-1
TGTGCCAGCAGCGCGACTAGCGGGCAAGAGACCCAGTACTTC	CASSATSGQETQYF	TRBV7-9	TRBJ2-5
TGTGCCAGCAGCTCCCCAGTTAGATCCACTGAAGCTTTCTTT	CASSSPVRSTEAFF	TRBV13	TRBJ1-1
TGTGCCAGTAGGGTGATAGGCCGACGGGAGCAGTACTTC	CASRVIGRREQYF	TRBV6-1	TRBJ2-7
TGCAGCCCGGGGCCACGGCCCCAGCATTTT	CSPGPRPQHF	TRBV29-1	TRBJ1-5
TGCACGCGGGACGAGCAGTTCTTC	CTRDEQFF	TRBV20-1	TRBJ2-1
TGTGCCAGCACAGTTGGTTCTCCCACTGAAGCTTTCTTT	CASTVGSPTEAFF	TRBV27	TRBJ1-1
TGTGCCAGCAGCTTAAAACATCAGCCCCAGCATTTT	CASSLKHQPQHF	TRBV7-9	TRBJ1-5
TGCGCCAGCAGCCAAACCCCAAAAGGATCCGCTTTCTTT	CASSQTPKGSAFF	TRBV4-1	TRBJ1-1
TGCAGTGCTAGAGATCTTACGGAGGGGGCGGAAGGTGTTAATCAGCCCCAGCATTTT	CSARDLTEGAEGVNQPQHF	TRBV20-1	TRBJ1-5
TGTGCCAGCAGCCGTGGAGGACAGGGCGGTGAGCAGTTCTTC	CASSRGGQGGEQFF	TRBV3-1	TRBJ2-1
TGCGCCAGCAGCATAAGCCGGCTGGTTCGCTCCTACGAGCAGTACTTC	CASSISRLVRSYEQYF	TRBV5-1	TRBJ2-7
TGTGCCAGCTGGCTCCGAGGACAGGGAAATGTGGCCTACGAGCAGTACTTC	CASWLRGQGNVAYEQYF	TRBV27	TRBJ2-7
TGTGCCAGCAGCCGGAGTCGTATCCACAGTTGGAACTATGGCTACACCTTC	CASSRSRIHSWNYGYTF	TRBV4-2	TRBJ1-2
TGTGCCAGCGGATATAGCACTGAAGCTTTCTTT	CASGYSTEAFF	TRBV6-4	TRBJ1-1
TGTGCCAGCAGTCATGGCCCAGTAATCGGCCCCGAGCAGTACTTC	CASSHGPVIGPEQYF	TRBV12-3	TRBJ2-7
TGTGCCAGCTCACCCTGCGGGACAGGGATTCCGGAGTTCGGCTCCTCCTACGAGCAGTACTTC	CASSPCGTGIPEFGSSYEQYF	TRBV18	TRBJ2-7
TGCAGCGTTGACTCTAGCGGGACAGGGGCGGGTCACTTC	CSVDSSGTGAGHF	TRBV29-1	TRBJ2-7
TGTGCCAGCAGAGCGGCTGCTCACGGGGAGCTGTTTTTT	CASRAAAHGELFF	TRBV5-6	TRBJ2-2
TGCGCCAGCAGCTTGGTGAAGGGGGGGGCAGCCTACAATGAGCAGTTCTTC	CASSLVKGGAAYNEQFF	TRBV5-1	TRBJ2-1
TGCGCCAGCAGTGAGTCGGGGCTTAAACGTGACCCAGAGACCCAGTACTTC	CASSESGLKRDPETQYF	TRBV10-1	TRBJ2-5
TGTGCCAGCAGCGGTTTGCGTCGGGCAGGGTCCTATAATTCACCCCTCCACTTT	CASSGLRRAGSYNSPLHF	TRBV7-3	TRBJ1-6
TGTGCCAGCAGCGGGACAGGGGGCGCTGAAGCTTTCTTT	CASSGTGGAEAFF	TRBV27	TRBJ1-1
TGTGCCACCAGTGATCCGGGGGCAGGGAGCTCCTACGAGCAGTACTTC	CATSDPGAGSSYEQYF	TRBV24-1	TRBJ2-7
TGTGCCAGCAGCCAAGGGTCCCGTCCTTCTCCTGGGGCCAACGTCCTGACTTTC	CASSQGSRPSPGANVLTF	TRBV4-2	TRBJ2-6
TGTGCCAGCAGTTTATACCCGGGACTGTCGAGAAAAGAAATTGCCAAAAACATTCAGTACTTC	CASSLYPGLSRKEIAKNIQYF	TRBV27	TRBJ2-4
TGTGCCAGCAGCCGGGCTAGCGGGGGGTCCTACGAGCAGTACTTC	CASSRASGGSYEQYF	TRBV7-3	TRBJ2-7
TGTGCCAGCAATATCCCCGGACAGGTACCGCGCACCGGGGAGCTGTTTTTT	CASNIPGQVPRTGELFF	TRBV9	TRBJ2-2
TGTGCCAGCAGCCCCGCGGGAGGAGCCTACGAGCAGTACTTC	CASSPAGGAYEQYF	TRBV7-9	TRBJ2-7
TGCGCCAGCACATGGGGGGACAGGGACGGAAACACCATATATTTT	CASTWGDRDGNTIYF	TRBV10-1	TRBJ1-3
TGTGCCAGCAGCCCAAGATGGAGCTACTTC	CASSPRWSYF	TRBV7-3	TRBJ1-2
TGTGCCAGCAGCAATGAAGTGGCAGGGGGAGTCAACTCACCCCTCCACTTT	CASSNEVAGGVNSPLHF	TRBV7-9	TRBJ1-6
TGTGCCAGCAGTGAGGGGGGGGAGGAAGAGACCCAGTACTTC	CASSEGGEEETQYF	TRBV6-1	TRBJ2-5
TGTGCCAGCAGCTTATCGCGTAGGCCCCCGACAGGGCCTAACACCGGGGAGCTGTTTTTT	CASSLSRRPPTGPNTGELFF	TRBV11-2	TRBJ2-2
TGTGCGAGCGGGAGGCTTAGCACCGGGGAGCTGTTTTTT	CASGRLSTGELFF	TRBV11-3	TRBJ2-2
TGCAGCGATCCTAGGCGGCTGTGGAGAGCCAAAAACATTCAGTACTTC	CSDPRRLWRAKNIQYF	TRBV29-1	TRBJ2-4
TGTGCCAGCAGAACTCGGGGCAGGGGGTACACTGAAGCTTTCTTT	CASRTRGRGYTEAFF	TRBV25-1	TRBJ1-1
TGTGCCAGCAGGTCTAGTTCAAGCTACGAGCAGTACTTC	CASRSSSSYEQYF	TRBV12-3	TRBJ2-7
TGCGCCACAGGGGACAGAAATCAGCCCCAGCATTTT	CATGDRNQPQHF	TRBV10-2	TRBJ1-5
TGTGCCAGCAGCCCTCCCATTTCCGGGACGGGTGACGAGCAGTACTTC	CASSPPISGTGDEQYF	TRBV6-5	TRBJ2-7
TGTGCCACCAGTGACTGGGCGACAGCGAGCCAGCCCCAGCATTTT	CATSDWATASQPQHF	TRBV24-1	TRBJ1-5
TGTGCCAGCAGCTTAGTGACTAGGGGCTACAATGAGCAGTTCTTC	CASSLVTRGYNEQFF	TRBV11-2	TRBJ2-1
TGTGCCAGCAGCTTAGGGGCAACCCAGCATTTT	CASSLGATQHF	TRBV11-2	TRBJ1-5
TGCGCCAGCAGTCCCAGGGGATCCTACAATGAGCAGTTCTTC	CASSPRGSYNEQFF	TRBV10-1	TRBJ2-1
TGTGCCAGCAGCTGTCGACTAGCGGCACCCTCCTACAATGAGCAGTTCTTC	CASSCRLAAPSYNEQFF	TRBV11-2	TRBJ2-1
TGTGCCAGCACTAGCGTAGGAGCAGATACGCAGTATTTT	CASTSVGADTQYF	TRBV28	TRBJ2-3
TGTGCCACCAGTGATTACGGGAGGGAGTTTTCGAACACCGGGGAGCTGTTTTTT	CATSDYGREFSNTGELFF	TRBV24-1	TRBJ2-2
TGCAGCGTTTGGCGTTGGACAGGACCGGTTCGAAACACCATATATTTT	CSVWRWTGPVRNTIYF	TRBV29-1	TRBJ1-3
TGTGCCAGCAGCGGGAGTTGGGGATGCCTCTATGGCTACACCTTC	CASSGSWGCLYGYTF	TRBV5-4	TRBJ1-2
TGCAGCGTTGAAGGGAGGCAAGAGACCCAGTACTTC	CSVEGRQETQYF	TRBV29-1	TRBJ2-5
TGTGCCAGCAGCGGTCCACTCGCCGAGCAGTACTTC	CASSGPLAEQYF	TRBV13	TRBJ2-7
TGTGCCTGTGCCGGGGGGCTTGACACAGATACGCAGTATTTT	CACAGGLDTDTQYF	TRBV30	TRBJ2-3
TGCAAAGCAGGGCCCCCGGACTCCTACGAGCAGTACTTC	CKAGPPDSYEQYF	TRBV20-1	TRBJ2-7
TGTGCCAGCAGCTACATATCTGGAGGGGACTTC	CASSYISGGDF	TRBV5-4	TRBJ2-7
TGTGCCAGCAGTTATACGTGGGCATATGAAAAACTGTTTTTT	CASSYTWAYEKLFF	TRBV6-3	TRBJ1-4
TGTGCCAGCAGCGTGACCAACGAGCAGTACTTC	CASSVTNEQYF	TRBV9	TRBJ2-7
TGTGCTAGTGGGGAGGCGGGAGGAGAGCAGTACTTC	CASGEAGGEQYF	TRBV12-5	TRBJ2-7
TGTGTTTTTCTGGGGGCTCCCAGCTCTGGAAACACCATATATTTT	CVFLGAPSSGNTIYF	TRBV3-1	TRBJ1-3
TGTGCCAGCAGCCTTCCAGGGGCACAGCAGTACTTC	CASSLPGAQQYF	TRBV7-9	TRBJ2-7
TGTGCCAGCAATACTCTGGGGTACAATGAGCAGTTCTTC	CASNTLGYNEQFF	TRBV25-1	TRBJ2-1
TGTGCCAGCAGCTTGGGGGATTTTTCCCCATCGGCACGGGGCTATGGCTACACCTTC	CASSLGDFSPSARGYGYTF	TRBV5-6	TRBJ1-2
TGTGCCAGCAGTGACAGGGGGCGGATGTCTGGCTCCTACAATGAGCAGTTCTTC	CASSDRGRMSGSYNEQFF	TRBV6-4	TRBJ2-1
TGTGCCAGCAGCGGGGACGAGCAGTACTTC	CASSGDEQYF	TRBV5-5	TRBJ2-7
TGTGCCAGCAGAAAAAAGACAGGGGGACTAAGCAATCAGCCCCAGCATTTT	CASRKKTGGLSNQPQHF	TRBV13	TRBJ1-5
TGTGCCAGCACGGGCGGGAGGGCCAAAAACATTCAGTACTTC	CASTGGRAKNIQYF	TRBV27	TRBJ2-4
TGTGCCAGCAGCGCCCGGGGGGATGAGACCCAGTACTTC	CASSARGDETQYF	TRBV2	TRBJ2-5
TGTGCCAGCAGCTTTGGGGCCTTAGACACTGAAGCTTTCTTT	CASSFGALDTEAFF	TRBV13	TRBJ1-1
TGTGCCAGCATGGTTCGGGGGATGGTCTTC	CASMVRGMVF	TRBV27	TRBJ2-1
TGTGCCAGCAGCTTAGCGGCGGGAGTCTGGAGAGAACGGTTCAATGAAAAACTGTTTTTT	CASSLAAGVWRERFNEKLFF	TRBV7-2	TRBJ1-4
TGTGCCAGCACTAGCGGGAGGGCTAGGAAGAACCGGAACACCGGGGAGCTGTTTTTT	CASTSGRARKNRNTGELFF	TRBV12-4	TRBJ2-2
TGCGCCAGCAGCTTACTAACGCGCCTAGGGGGCTACACCTTC	CASSLLTRLGGYTF	TRBV5-1	TRBJ1-2
TGTGCCAGCGGTGGGGGGGGGGAGAACACCGGGGAGCTGTTTTTT	CASGGGGENTGELFF	TRBV12-3	TRBJ2-2
TGTGCCAGCAGTCCACCCGTATGTTACCAAGAGACCCAGTACTTC	CASSPPVCYQETQYF	TRBV6-6	TRBJ2-5
TGTGCCACCCGCGGGAGGGCCTACGAGCAGTACTTC	CATRGRAYEQYF	TRBV24-1	TRBJ2-7
TGTGCCAGCAGCCCCCCCCCGGACGGGACTAGCGGGTCATCCAATGAGCAGTTCTTC	CASSPPPDGTSGSSNEQFF	TRBV13	TRBJ2-1
TGTGCCAGCAGAAGACAGGGGGCAAGACGGGGGGAAACTATGACAACTAATGAAAAACTGTTTTTT	CASRRQGARRGETMTTNEKLFF	TRBV6-5	TRBJ1-4
TGTGCCACGACACGGGCGTACTTC	CATTRAYF	TRBV24-1	TRBJ2-5
TGTGCCAGCAGCTTGCCGACAGGGGGATCGTCCTCCTACGAGCAGTACTTC	CASSLPTGGSSSYEQYF	TRBV5-4	TRBJ2-7
TGTGCCAGCAGGCAACGGGGGGTCTACGAGCAGTACTTC	CASRQRGVYEQYF	TRBV6-5	TRBJ2-7
TGTGCCAGCAGTTACTCGCACGAGAGCCGCTATGGCTACACCTTC	CASSYSHESRYGYTF	TRBV6-5	TRBJ1-2
TGTGCCAGACAGCTAGGGAGGTACAATGAGCAGTTCTTC	CARQLGRYNEQFF	TRBV2	TRBJ2-1
TGTGCCAGCAGCTTCCTCCCCACAGGGGCATACGAGCAGTACTTC	CASSFLPTGAYEQYF	TRBV5-6	TRBJ2-7
TGTGCCACCAGTGATTTGGATGAGGGCGAGACTAGCGGGGGGGTACACAATGAGCAGTTCTTC	CATSDLDEGETSGGVHNEQFF	TRBV24-1	TRBJ2-1
TGTGCCACCAGTGATGTGGGGGGGGTTAGCACAGATACGCAGTATTTT	CATSDVGGVSTDTQYF	TRBV24-1	TRBJ2-3
TGTGCCAGCAGTGACTCAGGGGCACCATCTCTATATCCCTATAATTCACCCCTCCACTTT	CASSDSGAPSLYPYNSPLHF	TRBV6-4	TRBJ1-6
TGTGCCAGCAGCAGAGTGACAGGGAACAATTCACCCCTCCACTTT	CASSRVTGNNSPLHF	TRBV5-5	TRBJ1-6
TGTGCCAGCACAAGCCAGTCGCAGGGCGGCTATGGCTACACCTTC	CASTSQSQGGYGYTF	TRBV27	TRBJ1-2
TGCAGTGCGGGCAAGGGCTACGAGCAGTACTTC	CSAGKGYEQYF	TRBV20-1	TRBJ2-7
TGTGCCACCAGGAGGCAGGGGGCGCAGTCGAACACCGGGGAGCTGTTTTTT	CATRRQGAQSNTGELFF	TRBV24-1	TRBJ2-2
TGTGCCAGCAGCGTAATACGGGTCGGGCCATGCTACGAGCAGTACTTC	CASSVIRVGPCYEQYF	TRBV7-6	TRBJ2-7
TGTGCCAGCAGTCGCACAGGGGGCATAGATAGCAATCAGCCCCAGCATTTT	CASSRTGGIDSNQPQHF	TRBV6-1	TRBJ1-5
TGTGCTAGTGGTTTGGTACCTGCCCGGGACAGTCCTGAAAAACTGTTTTTT	CASGLVPARDSPEKLFF	TRBV12-5	TRBJ1-4
TGTGCCATAGGACGTTGGCCTTTAGGCTCCTACGAGCAGTACTTC	CAIGRWPLGSYEQYF	TRBV6-5	TRBJ2-7
TGTGCCAGCAGCTTACCGAGCGTGGGAGGGGTCACCGGGGAGCTGTTTTTT	CASSLPSVGGVTGELFF	TRBV7-2	TRBJ2-2
TGCAGTGCTATATGTCCGACAGATCAGCCCCAGCATTTT	CSAICPTDQPQHF	TRBV20-1	TRBJ1-5
TGTGCCAGGCTCACGTTAGGGGCAGGACCTCCCTCCTACGAGCAGTACTTC	CARLTLGAGPPSYEQYF	TRBV7-2	TRBJ2-7
TGTGCCAGCAGCTTGGGGTCCGAGTTACATAGGCATTTCAGTAAGAGCGAGCAGTACTTC	CASSLGSELHRHFSKSEQYF	TRBV5-4	TRBJ2-7
TGTGCCACCAGTGATTTGGGCAAGGAGAACACTGAAGCTTTCTTT	CATSDLGKENTEAFF	TRBV24-1	TRBJ1-1
TGTGCCAGCATGACCGGACAGGGGTATAATTCACCCCTCCACTTT	CASMTGQGYNSPLHF	TRBV7-9	TRBJ1-6
TGTGCCAGCAGCTTAGGGGACTCCACACTTAGAGCGGGAGATGGCTACACCTTC	CASSLGDSTLRAGDGYTF	TRBV7-2	TRBJ1-2
TGTGCCAGCGCCGGAGACAGGGGGCGCGAAGAGACCCAGTACTTC	CASAGDRGREETQYF	TRBV12-3	TRBJ2-5
TGTGCCAGCAGTGTCACAGTAAGCTCCTACGAGCAGTACTTC	CASSVTVSSYEQYF	TRBV6-1	TRBJ2-7
TGTGCCAGCAGCTTAGAAGCACCCGGGACCAGAACCTACGAGCAGTACTTC	CASSLEAPGTRTYEQYF	TRBV7-9	TRBJ2-7
TGTGCCAGCAGCTTATGGACAGGGAGAGATTCACCCCTCCACTTT	CASSLWTGRDSPLHF	TRBV7-2	TRBJ1-6
TGTGCCCAGGAGAGCACAGATACGCAGTATTTT	CAQESTDTQYF	TRBV7-3	TRBJ2-3
TGTGCCACCACAGGACAGGGAACGAATGAGCAGTTCTTC	CATTGQGTNEQFF	TRBV24-1	TRBJ2-1
TGTGCCAGCAGTTGGAGGGTGAATCAGCCCCAGCATTTT	CASSWRVNQPQHF	TRBV12-3	TRBJ1-5
TGTGCCAGCAGCGCTAGGACAGGGGAAAGCAATCAGCCCCAGCATTTT	CASSARTGESNQPQHF	TRBV7-9	TRBJ1-5
TGTGCCACCATGGACAGGGCCAGCGGGAGTAGATGTAGCTCCAATTCCAACTATGGCTACACCTTC	CATMDRASGSRCSSNSNYGYTF	TRBV24-1	TRBJ1-2
TGTGCCAGCCGGACCCATAGGTCCGGACAGCACGGAAATGAGCAGTTCTTC	CASRTHRSGQHGNEQFF	TRBV6-2	TRBJ2-1
TGTGCCAGCAATTTCAGGGGGTACAATGAGCAGTTCTTC	CASNFRGYNEQFF	TRBV27	TRBJ2-1
TGTGCCAGCAAGAGGGACGTCCCGCAAGAGACCCAGTACTTC	CASKRDVPQETQYF	TRBV6-4	TRBJ2-5
TGTGCCAGCAGCGAGACAGGAGAATCCTACAATGAGCAGTTCTTC	CASSETGESYNEQFF	TRBV13	TRBJ2-1
TGTGCCACCAGTGAGGACTCCGGGACTAGATGGTACGAGCAGTACTTC	CATSEDSGTRWYEQYF	TRBV24-1	TRBJ2-7
TGCGCCATACGACTCATGGACCCCCTCCACTTT	CAIRLMDPLHF	TRBV5-1	TRBJ1-6
TGTGCCAGCAGCCAAAACGGGAGAGGCTACGAGCAGTACTTC	CASSQNGRGYEQYF	TRBV3-1	TRBJ2-7
TGCAGTGCTAGGGAACCGGTGGGGTTACCCTACAATGAGCAGTTCTTC	CSAREPVGLPYNEQFF	TRBV20-1	TRBJ2-1
TGTGCCAGCAGCGGGCTTGGCAATCAGCCCCAGCATTTT	CASSGLGNQPQHF	TRBV27	TRBJ1-5
TGCAGTGCTAGGCAACAGGGTGAGGGGAAGCCCCAGCATTTT	CSARQQGEGKPQHF	TRBV20-1	TRBJ1-5
TGTGCCAGCAGCTTCCAGGACTCCTACGAGCAGTACTTC	CASSFQDSYEQYF	TRBV7-3	TRBJ2-7
TGTGCCAGCAGCGTCCTATCCCCCCAGCATTTT	CASSVLSPQHF	TRBV12-3	TRBJ1-5
TGTGCCAGCAGCGGAGGGACAGGGTTGAATCAGCCCCAGCATTTT	CASSGGTGLNQPQHF	TRBV5-6	TRBJ1-5
TGTGCCAGCAGCCTTTTCAGGGGGACAGGGGGGAATGAAAAACTGTTTTTT	CASSLFRGTGGNEKLFF	TRBV13	TRBJ1-4
TGTGCCAGCAGTTTACAGGGCGGGGTTTCACCCCTCCACTTT	CASSLQGGVSPLHF	TRBV12-4	TRBJ1-6
TGTGCCAGCAGTAGGATCCCTGGGACTCCTGAAGCTTTCTTT	CASSRIPGTPEAFF	TRBV12-3	TRBJ1-1
TGTGCCAGCAGCTTAGTCCGGACGCAAAATGAAAAACTGTTTTTT	CASSLVRTQNEKLFF	TRBV11-2	TRBJ1-4
TGTGCCAGCAGCCACCCGGGCGGCTACACCTTC	CASSHPGGYTF	TRBV3-1	TRBJ1-2
TGCAGTGCCGGGACAGGGATGAACACTGAAGCTTTCTTT	CSAGTGMNTEAFF	TRBV20-1	TRBJ1-1
TGCGCCAGCAGCTTGATGCGGCTCTGTGGCTACACCTTC	CASSLMRLCGYTF	TRBV5-1	TRBJ1-2
TGTGCCAGCAGCAACGTGCACATTAGAGCTTTCTTT	CASSNVHIRAFF	TRBV9	TRBJ1-1
TGTGCCAGCAGTGTCATAGGGGGGGCCGAAGATACGCAGTATTTT	CASSVIGGAEDTQYF	TRBV6-4	TRBJ2-3
TGTGCCAGCAGCCCGGGGACAAATGAGACCCAGTACTTC	CASSPGTNETQYF	TRBV7-2	TRBJ2-5
TGCGCCAGCAGCCAGCGGTCTGAAGCTTTCTTT	CASSQRSEAFF	TRBV4-1	TRBJ1-1
TGTGCCAGCAGCGTAGCCCCCACAGGGCTTCTCTTC	CASSVAPTGLLF	TRBV9	TRBJ2-1
TGTGCCAGCGTCGTAGCGGGCGCCTTCGCGAACACCGGGGAGCTGTTTTTT	CASVVAGAFANTGELFF	TRBV12-3	TRBJ2-2
TGTGCCAGCAGTTTACTAGCGCGATTCTGCTACGAGCAGTACTTC	CASSLLARFCYEQYF	TRBV27	TRBJ2-7
TGTGCCAGCAGTATCACCGCCATTGCGGGTTCTACCTACAATGAGCAGTTCTTC	CASSITAIAGSTYNEQFF	TRBV6-5	TRBJ2-1
TGTGCCAGCAGCGTAGGTCTGGGACGGGTCGAGACCCAGTACTTC	CASSVGLGRVETQYF	TRBV9	TRBJ2-5
TGTGCCAGCAGTGCACGGGGGTACTTTCCGCAGAATGAGCAGTTCTTC	CASSARGYFPQNEQFF	TRBV6-4	TRBJ2-1
TGCGCCAGCAGCGGTGACGGGACCCAGTACTTC	CASSGDGTQYF	TRBV4-1	TRBJ2-5
TGTGCCAGCAGACAGGACGGAGTAAGGCTAGCCAAAAACATTCAGTACTTC	CASRQDGVRLAKNIQYF	TRBV28	TRBJ2-4
TGCAGTGCGCGCAATGAGCAGTTCTTC	CSARNEQFF	TRBV20-1	TRBJ2-1
TGTGCCAGTAGTATAACTGGCAGGGTAAGAGAGACCCAGTACTTC	CASSITGRVRETQYF	TRBV19	TRBJ2-5
TGTGCCAGCAGCGCGGGAGGCCACGAGCAGTACTTC	CASSAGGHEQYF	TRBV13	TRBJ2-7
TGTGCCAGCAGCCAAAGTGATACGCAGTATTTT	CASSQSDTQYF	TRBV3-1	TRBJ2-3
TGTGCCAGCCAGGGGGCGGCGACAGAGCAGTACTTC	CASQGAATEQYF	TRBV6-4	TRBJ2-7
TGTGCCAGCAGCCTTCCGCACAATACCTCATCTAGCACAGATACGCAGTATTTT	CASSLPHNTSSSTDTQYF	TRBV7-3	TRBJ2-3
TGTGCCAGCAGGGGGGACACTGAAGCTTTCTTT	CASRGDTEAFF	TRBV13	TRBJ1-1
TGTGCCTGGACACCGGGAGGGCTTGGCTACACCTTC	CAWTPGGLGYTF	TRBV30	TRBJ1-2
TGCAGTGCTAACTCCGATGCCGGGGAGCTGTTTTTT	CSANSDAGELFF	TRBV20-1	TRBJ2-2
TGTGCCAGCAACCACAGCTGGAACACTGAAGCTTTCTTT	CASNHSWNTEAFF	TRBV6-1	TRBJ1-1
TGTGCCAGCAGCTTAGCCGAGGAGTATGGCTACACCTTC	CASSLAEEYGYTF	TRBV7-3	TRBJ1-2
TGCGCCAGCAAAAACATAGGAGTTGGTGAAGCTTTCTTT	CASKNIGVGEAFF	TRBV4-1	TRBJ1-1
TGTGCCTGGACTAGCACAGATACGCAGTATTTT	CAWTSTDTQYF	TRBV30	TRBJ2-3
TGTGCCAGCAGTTTATTCAGGGATCAGCCCCAGCATTTT	CASSLFRDQPQHF	TRBV28	TRBJ1-5
TGTGCCAGCCTAGAAAGAGAGACCCAGTACTTC	CASLERETQYF	TRBV5-8	TRBJ2-5
TGTGCCAGCAGTTTCCCCTTAGGGCAGTACTTC	CASSFPLGQYF	TRBV27	TRBJ2-7
TGTGCCACCAGCAGAGACAAATTTTCGGGAAAAAGGCAGTACTTC	CATSRDKFSGKRQYF	TRBV15	TRBJ2-7
TGCGCCAGCAGCCAAGACCCTACTGAGACCCAGTACTTC	CASSQDPTETQYF	TRBV4-3	TRBJ2-5
TGTGCCAGCAGGGTGGCGGGGAAAGACAATGAGCAGTTCTTC	CASRVAGKDNEQFF	TRBV27	TRBJ2-1
TGTGCCAGCTCCCCAAAGCGGCCGGTAACAGATACGCAGTATTTT	CASSPKRPVTDTQYF	TRBV28	TRBJ2-3
TGTGCCAGCAGCATACCGAGCGGGACGCACACAGATACGCAGTATTTT	CASSIPSGTHTDTQYF	TRBV9	TRBJ2-3
TGTGCCAGCAGCGCCCTCTTCCTAGCGGGCTACGAGCAGTACTTC	CASSALFLAGYEQYF	TRBV9	TRBJ2-7
TGTGCCAGCAGGGTAGCGTTCCCCGGAGAGAGGGGTGACACTGAAGCTTTCTTT	CASRVAFPGERGDTEAFF	TRBV6-1	TRBJ1-1
TGTGCCAGCAGTTACTCGAGGGTGGACAGGGGGCAAGCTTTCTTT	CASSYSRVDRGQAFF	TRBV6-3	TRBJ1-1
TGCGCCAGCAGCGACCTCCAGACAACTGCGCCCTCTGGGGCCAACGTCCTGACTTTC	CASSDLQTTAPSGANVLTF	TRBV10-2	TRBJ2-6
TGTGCCAGGGGGGGGCGACCCGAGCAGTACTTC	CARGGRPEQYF	TRBV19	TRBJ2-7
TGTGCCAGCAGTTCCCTACAGTTTAACGAGCAGTACTTC	CASSSLQFNEQYF	TRBV6-3	TRBJ2-7
TGTGCCAGCAGAGGACAAGGAGCCTACGAGCAGTACTTC	CASRGQGAYEQYF	TRBV6-5	TRBJ2-7
TGTGCCAGCAGTCCCCCCCGGACAGGGACGAGAATAAAACTGTTTTTT	CASSPPRTGTRIKLFF	TRBV6-5	TRBJ1-4
TGTGCCAGTAGTATAGTTGGAGAGCTCGCCGGGGGGGGCACCGGGGAGCTGTTTTTT	CASSIVGELAGGGTGELFF	TRBV19	TRBJ2-2
TGCGCCAGCAGTGGACAGGTGACCTACGAGCAGTACTTC	CASSGQVTYEQYF	TRBV10-1	TRBJ2-7
TGCAGTGCTAGCGGCCCGTTATGGGACAGCGATCAGCCCCAGCATTTT	CSASGPLWDSDQPQHF	TRBV20-1	TRBJ1-5
TGCAGTGCTAGAGTAGACTACTTCAATCAGCCCCAGCATTTT	CSARVDYFNQPQHF	TRBV20-1	TRBJ1-5
TGTGCCAGCAGTAACCTTCTACTCGGCACAGATACGCAGTATTTT	CASSNLLLGTDTQYF	TRBV27	TRBJ2-3
TGCGCCAGCAGCGCCGGGACAGGGCAGCCCCAGCATTTT	CASSAGTGQPQHF	TRBV10-2	TRBJ1-5
TGTGCCAGCAGCTTCGGCTACAATGAGCAGTTCTTC	CASSFGYNEQFF	TRBV9	TRBJ2-1
TGTGCCAGCAGCACCAATTTCTGGGGGACAGGGGGCTCGTGGGCCGGGGAGCTGTTTTTT	CASSTNFWGTGGSWAGELFF	TRBV9	TRBJ2-2
TGTGCCAGCAGCAATTCTCTCGCTCACGAGTACTTC	CASSNSLAHEYF	TRBV13	TRBJ2-4
TGTGCCAGCAGCCAAGTAGGGGAGGGTTGTCCTGTGACCCAGTACTTC	CASSQVGEGCPVTQYF	TRBV14	TRBJ2-5
TGTGCCAGCAGGACAGGGGGCGGATTGAACACTGAAGCTTTCTTT	CASRTGGGLNTEAFF	TRBV2	TRBJ1-1
TGTGCCAGCTCACGAACAGGAAGGGGGGGGGGCCTGTTAGAGACCCAGTACTTC	CASSRTGRGGGLLETQYF	TRBV18	TRBJ2-5
TGTGCCAGCAGCCACACGGACGGGGCTCAGCCCCAGCATTTT	CASSHTDGAQPQHF	TRBV13	TRBJ1-5
TGTGCCATGGGACAGGGATATAGCAATCAGCCCCAGCATTTT	CAMGQGYSNQPQHF	TRBV27	TRBJ1-5
TGTGCCAGCAGCGGATGGGAGTCCCTCCACTTT	CASSGWESLHF	TRBV7-9	TRBJ1-6
TGTGCCAGCAGTGAAGCTAATGACAGGAATGAAAAACTGTTTTTT	CASSEANDRNEKLFF	TRBV6-1	TRBJ1-4
TGCAGTGCTAAGACAGGGAGGTGCTACGAGCAGTACTTC	CSAKTGRCYEQYF	TRBV20-1	TRBJ2-7
TGTGCCAGTTCCGTGGGGTCGTCCGACGAGCAGTACTTC	CASSVGSSDEQYF	TRBV6-4	TRBJ2-7
TGTGCCAGCAGCCCGAGGGGCAAATACGGATACAATGAGCAGTTCTTC	CASSPRGKYGYNEQFF	TRBV11-2	TRBJ2-1
TGTGCCAGCGTAACCTACGAGCAGTACTTC	CASVTYEQYF	TRBV6-4	TRBJ2-7
TGCAGCGTTCACTTCGAGGAGGTGCTAAGCTCTGGGGCCAACGTCCTGACTTTC	CSVHFEEVLSSGANVLTF	TRBV29-1	TRBJ2-6
TGTGCCAGCAGCCGGACCCATAGCAATCAGCCCCAGCATTTT	CASSRTHSNQPQHF	TRBV27	TRBJ1-5
TGCAGTGCTAGAAAGCGGGAGGGACGCTACAATGAGCAGTTCTTC	CSARKREGRYNEQFF	TRBV20-1	TRBJ2-1
TGCAGTGCTAGAGAGGCTCGGGGCGGGACACCCAAAGGCTACACCTTC	CSAREARGGTPKGYTF	TRBV20-1	TRBJ1-2
TGTGCCAGCAGTTTGTCAGGGAGGGAAGGTGGACTTAACTACGAGCAGTACTTC	CASSLSGREGGLNYEQYF	TRBV27	TRBJ2-7
TGTGCCAGCAGTGCATTATGGCGTGAAAAACTGTTTTTT	CASSALWREKLFF	TRBV27	TRBJ1-4
TGTGCCAGCAGGCTAGGACTAGCGGACACAGATACGCAGTATTTT	CASRLGLADTDTQYF	TRBV6-4	TRBJ2-3
TGTGCCAGCAGTCAGACAGGGTCTGGAAACACCATATATTTT	CASSQTGSGNTIYF	TRBV28	TRBJ1-3
TGTGCTAGTGGTTTGGTACGGACTGGGCCCGACTACGAGCAGTACTTC	CASGLVRTGPDYEQYF	TRBV12-5	TRBJ2-7
TGTGCCAGCAGCCTGACAGGGGGCACCGGGGAGCTGTTTTTT	CASSLTGGTGELFF	TRBV7-9	TRBJ2-2
TGCAGTGAGGGCCCGCGCCTTCTTACTGAAGCTTTCTTT	CSEGPRLLTEAFF	TRBV20-1	TRBJ1-1
TGTGCCAGCAGCTTAGCTCCATACGTGAAACGGGACCATGGAAACACCATATATTTT	CASSLAPYVKRDHGNTIYF	TRBV11-2	TRBJ1-3
TGTGCCAGCAGCTTAACCCCGGGACAGAATGGCTACACCTTC	CASSLTPGQNGYTF	TRBV7-8	TRBJ1-2
TGTGCCAGCAGCCCAGCCGTAGAGGAGACCCAGTACTTC	CASSPAVEETQYF	TRBV6-1	TRBJ2-5
TGTGCCAGCAGTTTGAACAGGGTGGGCTATGGCTACACCTTC	CASSLNRVGYGYTF	TRBV28	TRBJ1-2
TGTGCCAGCAGCTTGGCTTACCTAGACGGCTGGGTCGGGGAGCTGTTTTTT	CASSLAYLDGWVGELFF	TRBV5-6	TRBJ2-2
TGTGCCAGCAGCTTTTACAGGGGGCAGAACACTGAAGCTTTCTTT	CASSFYRGQNTEAFF	TRBV5-4	TRBJ1-1
TGCGCCAGCAGCCAAGAGCGGGCCGGGACTAGCGGGGTTGGGGGACAGGGCTACAATGAGCAGTTCTTC	CASSQERAGTSGVGGQGYNEQFF	TRBV4-1	TRBJ2-1
TGTGCCTGGAGTCCCAGGGGGCATAACACAGATACGCAGTATTTT	CAWSPRGHNTDTQYF	TRBV30	TRBJ2-3
TGTGCCATCCAAGCGGTGAATTCACCCCTCCACTTT	CAIQAVNSPLHF	TRBV10-3	TRBJ1-6
TGCGCCAGCAGCCAGTTTGCCGGGACTAGCGGCATATATACGCAGTATTTT	CASSQFAGTSGIYTQYF	TRBV4-1	TRBJ2-3
TGTGCCAGTTGGCGACAGGGGAAGAATGAAAAACTGTTTTTT	CASWRQGKNEKLFF	TRBV6-6	TRBJ1-4
TGTGCCAGCTCACCAACTTGGGAGGGGGTTACTAATGAAAAACTGTTTTTT	CASSPTWEGVTNEKLFF	TRBV18	TRBJ1-4
TGTGCCAGCAGTTTAAGGACAGGGAACTCTAACTATGGCTACACCTTC	CASSLRTGNSNYGYTF	TRBV28	TRBJ1-2
TGTGCCAGTAGCGGGAATTTCCCGACAGGGGGGGGAATCAATCAGCCCCAGCATTTT	CASSGNFPTGGGINQPQHF	TRBV19	TRBJ1-5
TGCAGTGCTGAGACTAGCAGGTCGCTCTTC	CSAETSRSLF	TRBV20-1	TRBJ2-1
TGCGCCAGCAGCGCCGAAGGGGGGCAGATCGGGGAGCTGTTTTTT	CASSAEGGQIGELFF	TRBV5-1	TRBJ2-2
TGTGCCAGCAGCCTAAGGACAAGGATTTTAGAGACCCAGTACTTC	CASSLRTRILETQYF	TRBV13	TRBJ2-5
TGTGCCACATTTAGTGCTGGACAGGCTAGATTTCGCCCCTATAATTCACCCCTCCACTTT	CATFSAGQARFRPYNSPLHF	TRBV11-3	TRBJ1-6
TGTGCCACCAGTGATCCAAGACAGAAGACCTTTAATTCACCCCTCCACTTT	CATSDPRQKTFNSPLHF	TRBV24-1	TRBJ1-6
TGTGCCAGCAGTGAAAGGACGAACGCCTACGAGCAGTACTTC	CASSERTNAYEQYF	TRBV6-4	TRBJ2-7
TGTGCCAGCAGTTTGAACAAGCGGACTAGCGGGATTCCGGCCCCTAGCTCCTACAATGAGCAGTTCTTC	CASSLNKRTSGIPAPSSYNEQFF	TRBV27	TRBJ2-1
TGCGCCAGCAGCCAACAACTAGCGGGAGAGCCAAATCAGCCCCAGCATTTT	CASSQQLAGEPNQPQHF	TRBV4-1	TRBJ1-5
TGTGCCAGCAGCTTAGACCAGAGAAAAAAACTGTTTTTT	CASSLDQRKKLFF	TRBV7-4	TRBJ1-4
TGTGCCAGCAGCTTCCATACCGCGACAGAGTCCCTCGGCACCGGGGAGCTGTTTTTT	CASSFHTATESLGTGELFF	TRBV7-8	TRBJ2-2
TGCAGTGCATCGGACAGGGCGACTGGGGCCAACGTCCTGACTTTC	CSASDRATGANVLTF	TRBV20-1	TRBJ2-6
TGTGCCAGCAGCGGTTGGGGATACACTGAAGCTTTCTTT	CASSGWGYTEAFF	TRBV9	TRBJ1-1
TGCGCCAGCAGCTTGGTATTGGGGTTGAACACCGGGGAGCTGTTTTTT	CASSLVLGLNTGELFF	TRBV5-1	TRBJ2-2
TGCAGTGCATTGACGACTTACAATGAGCAGTTCTTC	CSALTTYNEQFF	TRBV20-1	TRBJ2-1
TGTGCCAGCAGTGATAGCGGGAGTCGGTACAATGAGCAGTTCTTC	CASSDSGSRYNEQFF	TRBV2	TRBJ2-1
TGCAGTGCTAGAGTTCCAGACAGGAATGAAAAACTGTTTTTT	CSARVPDRNEKLFF	TRBV20-1	TRBJ1-4
TGCAGTGCTAGAGATCGGTGGGGGCTTGAGACCCAGTACTTC	CSARDRWGLETQYF	TRBV20-1	TRBJ2-5
TGTGCCAGCAGTAAGTGGTATGACAATTACGAGCAGTACTTC	CASSKWYDNYEQYF	TRBV6-1	TRBJ2-7
TGTGCCACCTTCCCAGATGGCCCGTACGAGCAGTACTTC	CATFPDGPYEQYF	TRBV10-3	TRBJ2-7
TGTGCCACCAGCAGAGGAGATGCTTTCTTT	CATSRGDAFF	TRBV15	TRBJ1-1
TGTGCCAGCAGTTTATTAGAGAACGACAGGGGAGTGGGAAGCTATGGCTACACCTTC	CASSLLENDRGVGSYGYTF	TRBV27	TRBJ1-2
TGCGCCAGCAGCTTGACAGACCGGGAAGACAGGACAAGGAATGGCTACACCTTC	CASSLTDREDRTRNGYTF	TRBV5-1	TRBJ1-2
TGTGCCAGCAGCCAAGATGACAGGGTCTACGAGCAGTACTTC	CASSQDDRVYEQYF	TRBV4-2	TRBJ2-7
TGTGCCATCAGGGGAGCCGGGGAGCTGTTTTTT	CAIRGAGELFF	TRBV2	TRBJ2-2
TGCAGTGCTCCAGCGGGAGACTATGGCTACACCTTC	CSAPAGDYGYTF	TRBV20-1	TRBJ1-2
TGTGCCAGCAGCGTAGCCCCACCCGGGGCCTACGAGCAGTACTTC	CASSVAPPGAYEQYF	TRBV9	TRBJ2-7
TGCAGTGCTGGGGACACCGAGCAGTACTTC	CSAGDTEQYF	TRBV20-1	TRBJ2-7
TGTGCCACCAGTGCCTTTCCGGGGGGCGTAAATCAGCCCCAGCATTTT	CATSAFPGGVNQPQHF	TRBV24-1	TRBJ1-5
TGTGCTAGTGGTCGTCCAAATCGGTTCACCAGGGGTGTAAATCAGCCCCAGCATTTT	CASGRPNRFTRGVNQPQHF	TRBV12-5	TRBJ1-5
TGTGCCTGGAGTAGAGGAGGAGGGCCAAGAGAGACCCAGTACTTC	CAWSRGGGPRETQYF	TRBV30	TRBJ2-5
TGCAGTGCTAGGGTAATAAGGCAGTATTTT	CSARVIRQYF	TRBV20-1	TRBJ2-3
TGTGCCATCACTAGTTTGCAAGAGACCCAGTACTTC	CAITSLQETQYF	TRBV10-3	TRBJ2-5
TGTGCCAGCAGCTCACGCAGTGGAACAACTAATGAAAAACTGTTTTTT	CASSSRSGTTNEKLFF	TRBV5-4	TRBJ1-4
TGTGCCAGCAGCCGACAGATCCTCTCTGGAAACACCATATATTTT	CASSRQILSGNTIYF	TRBV3-1	TRBJ1-3
TGCAGTGCTAGAGATTTCCCAGGGGGGGGCTCCTACGAGCAGTACTTC	CSARDFPGGGSYEQYF	TRBV20-1	TRBJ2-7
TGTGCCAGCAGCCCCAGCGGGGGAAACGAGCAGTACTTC	CASSPSGGNEQYF	TRBV9	TRBJ2-7
TGCAGCCAAATTCGTGGGAGGGACTACAATGAGCAGTTCTTC	CSQIRGRDYNEQFF	TRBV29-1	TRBJ2-1
TGTGCTAGTGGTGGGTCACAGGGGGCGCTAGGCTACACCTTC	CASGGSQGALGYTF	TRBV12-5	TRBJ1-2
TGTGCCAGCAGTTTTAATTGGCAAGAGACCCAGTACTTC	CASSFNWQETQYF	TRBV12-3	TRBJ2-5
TGTGCCACCACCAAACTAGCGGGAGCTAGCCCATTCGAGCAGTACTTC	CATTKLAGASPFEQYF	TRBV24-1	TRBJ2-7
TGTGCCATCAGTTCGGGGGGTGGAAGGGGTACGCAGTATTTT	CAISSGGGRGTQYF	TRBV10-3	TRBJ2-3
TGTGCCAGCAGCGTAACTACAGGGGCCCTGAATTGTGAAAAACTGTTTTTT	CASSVTTGALNCEKLFF	TRBV9	TRBJ1-4
TGTGCCAGCAGCCCCTGTTCGGACACTGAAGCTTTCTTT	CASSPCSDTEAFF	TRBV7-3	TRBJ1-1
TGTGCCACCAGCGAGAAGATGGTTGGGAGCTCCTACGAGCAGTACTTC	CATSEKMVGSSYEQYF	TRBV15	TRBJ2-7
TGTGCCAGCAGCCTCGAAACAGGGTTTGAGCAGTTCTTC	CASSLETGFEQFF	TRBV13	TRBJ2-1
TGTGCCAGCAGCGGGAGATCAAAAGGGTCTATTGGCTACACCTTC	CASSGRSKGSIGYTF	TRBV13	TRBJ1-2
TGTGCCAGCAGCTTACCATCCGGGACAGGGGGACCTCCTACCAATCAGCCCCAGCATTTT	CASSLPSGTGGPPTNQPQHF	TRBV7-4	TRBJ1-5
TGCGCCAGCAGCCACCCCAATGCTAGTGGGGGGAGGGGCTACACCTTC	CASSHPNASGGRGYTF	TRBV4-1	TRBJ1-2
TGTGCCAGCAGCAACCACCAGGGTCCCAAAAGCAGCTCTGGGGCCAACGTCCTGACTTTC	CASSNHQGPKSSSGANVLTF	TRBV5-4	TRBJ2-6
TGTGCCAGCAGACTAGCGGGAGCGACCGGGGAGCTGTTTTTT	CASRLAGATGELFF	TRBV3-1	TRBJ2-2
TGTGCCAGCAGACGGACAGGGGACGAGCATGAAAAACTGTTTTTT	CASRRTGDEHEKLFF	TRBV28	TRBJ1-4
TGCGCCAGCAGCTTCTTGAACCCGGTCTTCCCACATTGTGGGAGCTACGAGCAGTACTTC	CASSFLNPVFPHCGSYEQYF	TRBV5-1	TRBJ2-7
TGTGCCAGCAGTGAGACGGAATGGCGACCGCTAGGCATTCAGTACTTC	CASSETEWRPLGIQYF	TRBV6-1	TRBJ2-4
TGTGCCAGCAGCGTAGCTACCCATAGGAATCAGCCCCAGCATTTT	CASSVATHRNQPQHF	TRBV9	TRBJ1-5
TGTGCCGACTCTGGAATGCGGGGCCAAGAAAAACTGTTTTTT	CADSGMRGQEKLFF	TRBV6-5	TRBJ1-4
TGTGCCAGCAGCCAAGATGGACCAAGCGGGAGCCGGGGTATGGCGTACGAGCAGTACTTC	CASSQDGPSGSRGMAYEQYF	TRBV3-1	TRBJ2-7
TGTGCCAGCAGCGTAGGTAAAAGCGGGACTGAAGCTTTCTTT	CASSVGKSGTEAFF	TRBV9	TRBJ1-1
TGTGCCAGCAGATCCCAGGGGACAGATGTAACCTACGAGCAGTACTTC	CASRSQGTDVTYEQYF	TRBV6-1	TRBJ2-7
TGTGCCAGCAGTGAGGGCCAGGACCAAGAGACCCAGTACTTC	CASSEGQDQETQYF	TRBV2	TRBJ2-5
TGCGCCAGCAGCTTGACCAGGGGGCGCACAGATACGCAGTATTTT	CASSLTRGRTDTQYF	TRBV5-1	TRBJ2-3
TGCAGGAAGGGAGGCCTCCAAGAGACCCAGTACTTC	CRKGGLQETQYF	TRBV20-1	TRBJ2-5
TGTGCCAGCAGCCGTCCGCCAGGGGATGGCTACACCTTC	CASSRPPGDGYTF	TRBV7-3	TRBJ1-2
TGTGCTAGTGTTCTAGCGTACAATGAGCAGTTCTTC	CASVLAYNEQFF	TRBV12-5	TRBJ2-1
TGTGCCAGCAGCGTATACATTGGGATTTACAATGAGCAGTTCTTC	CASSVYIGIYNEQFF	TRBV9	TRBJ2-1
TGTGCCAGCAGCGGTGAGAAACAGGATACCCCTTATGGCTACACCTTC	CASSGEKQDTPYGYTF	TRBV7-9	TRBJ1-2
TGTGCCAGCAGCTTAGTGAGTGGACAGGCAAGGGACAATGAGCAGTTCTTC	CASSLVSGQARDNEQFF	TRBV7-6	TRBJ2-1
TGTGCCAGCAGCTTCGGGACAGGGAGGACCTACAATGAGCAGTTCTTC	CASSFGTGRTYNEQFF	TRBV5-6	TRBJ2-1
TGTGCCAGCAGTTTATGGTGGGGAAGTGCGGAAACTAATGAAAAACTGTTTTTT	CASSLWWGSAETNEKLFF	TRBV28	TRBJ1-4
TGTGCCAGCAGTAAAACCGGGGACTTTACTCCGTATAGCAATCAGCCCCAGCATTTT	CASSKTGDFTPYSNQPQHF	TRBV6-4	TRBJ1-5
TGCAGCGGTACTAGGGACAACTACGAGCAGTACTTC	CSGTRDNYEQYF	TRBV29-1	TRBJ2-7
TGTGCCAGCAGTTACAAAACCAGGAAACGGTTCTTAGGAAACACCATATATTTT	CASSYKTRKRFLGNTIYF	TRBV6-2	TRBJ1-3
TGTGCCAGCAGCGCAAGGGGGCGGAATCAGCCCCAGCATTTT	CASSARGRNQPQHF	TRBV7-3	TRBJ1-5
TGTGCCAGCAGCCTCTTAACCGGGGAGAATGACTATGGCTACACCTTC	CASSLLTGENDYGYTF	TRBV7-9	TRBJ1-2
TGTGCCAGCAGCTTCTCGGAGGTTATTGACACAGATACGCAGTATTTT	CASSFSEVIDTDTQYF	TRBV11-1	TRBJ2-3
TGTGCCAGCAGCCGGACCCCGAATCAGCCCCAGCATTTT	CASSRTPNQPQHF	TRBV27	TRBJ1-5
TGTGCCAGCAGCTTAGTTCCCCGGGGGCTCCTCGGCGAGCAGTACTTC	CASSLVPRGLLGEQYF	TRBV7-8	TRBJ2-7
TGTGCCAGCAGCCGGAATCCTGAATATGGGGGTAAGGCAGCCTTAATTATTTACGAGTGGAACAATGAGCAGTTCTTC	CASSRNPEYGGKAALIIYEWNNEQFF	TRBV7-9	TRBJ2-1
TGTGCCAGCAGTGACTACGGGGGCAATCAGCCCCAGCATTTT	CASSDYGGNQPQHF	TRBV6-4	TRBJ1-5
TGTGCCAGCAGCCACCTACAAGGACAGGGCCCTCCTGTTCGCAATCAGCCCCAGCATTTT	CASSHLQGQGPPVRNQPQHF	TRBV14	TRBJ1-5
TGCAGTGCCCCGACAGCCGATGAAAAACTGTTTTTT	CSAPTADEKLFF	TRBV20-1	TRBJ1-4
TGTGCCAGCAGTTACGTCAGCGGGAGTCAGCCCCAGCATTTT	CASSYVSGSQPQHF	TRBV6-2	TRBJ1-5
TGTGCCACGCCCTCATACGAGCAGTACTTC	CATPSYEQYF	TRBV10-3	TRBJ2-7
TGCAGTGCTACCTTTGGGGGGGGGGATCATGAGCAGTTCTTC	CSATFGGGDHEQFF	TRBV20-1	TRBJ2-1
TGTGCCAGCAAAGGGAGCAGTGGGGTGCATGGCTACACCTTC	CASKGSSGVHGYTF	TRBV27	TRBJ1-2
TGTGCCAGCTTTGCAGCATGTTATGGCTACACCTTC	CASFAACYGYTF	TRBV9	TRBJ1-2
TGTGCCAGCTCACCGGAAACGGGAGACCCATGTCTAATAGCGGGGGAAGCTAGCTCCTACGAGCAGTACTTC	CASSPETGDPCLIAGEASSYEQYF	TRBV18	TRBJ2-7
TGTGCCAGCAGCAATAATAGGACAGGCACAGATACGCAGTATTTT	CASSNNRTGTDTQYF	TRBV13	TRBJ2-3
TGTGCCAGCAGCTTACACGGGCTATCTGAGCAGTTCTTC	CASSLHGLSEQFF	TRBV7-4	TRBJ2-1
TGTGCCAGCAGTGATATAACATCGGACAGGATTGTCTATGGCTACACCTTC	CASSDITSDRIVYGYTF	TRBV6-4	TRBJ1-2
TGTGCCAGCAGTAGGACAGCGTCCGGAAACACCATATATTTT	CASSRTASGNTIYF	TRBV27	TRBJ1-3
TGTGCCAGCAGAATCCAACATAGTGATCAGCCCCAGCATTTT	CASRIQHSDQPQHF	TRBV28	TRBJ1-5
TGTGCCAGCAGCTTAGCTAGTCACGCCCCCGACTCGGAAGTTCTCTCCTACGAGCAGTACTTC	CASSLASHAPDSEVLSYEQYF	TRBV7-9	TRBJ2-7
TGTGCCAGCGGGGGGACTAGCGGGACGGTTCGTTATGAGCAGTTCTTC	CASGGTSGTVRYEQFF	TRBV6-4	TRBJ2-1
TGTGCCAGCAGCCAAGACAGGATTGAAAAACTGTTTTTT	CASSQDRIEKLFF	TRBV14	TRBJ1-4
TGCAGTGCTACAGCCGGGACTAGGGCAGAGCAAGAGACCCAGTACTTC	CSATAGTRAEQETQYF	TRBV20-1	TRBJ2-5
TGTGCCAGCAGTTCGGAAGTTGGGCGTCTTAGGAACACCGGGGAGCTGTTTTTT	CASSSEVGRLRNTGELFF	TRBV6-1	TRBJ2-2
TGTGCCAGCAGTTTTCCCGATCGCGAGCAGTACTTC	CASSFPDREQYF	TRBV27	TRBJ2-7
TGTGCCAGCAGCTTAGGCGTTAATGGGGGGGCCGTACAAGAGACCCAGTACTTC	CASSLGVNGGAVQETQYF	TRBV7-9	TRBJ2-5
TGTGCCACCAGTGGCCCTAGACTAGCGGGAAACAATGAGCAGTTCTTC	CATSGPRLAGNNEQFF	TRBV24-1	TRBJ2-1
TGCAGTGCTAGCCCTAAGCCAGCACCGGGACGAAAACGGCGGGTCTTC	CSASPKPAPGRKRRVF	TRBV20-1	TRBJ2-1
TGTGCCAGCAGCTTAAGGGGTGGTGTCCCAGGGATCTGTAATGAGCAGTTCTTC	CASSLRGGVPGICNEQFF	TRBV5-5	TRBJ2-1
TGTGCCAGTAGTTTAGCCCTATCCCCCATAGACGAAGGGGACTTC	CASSLALSPIDEGDF	TRBV19	TRBJ2-7
TGCGCCAGCAGAGGGAGAACCTACGAGCAGTACTTC	CASRGRTYEQYF	TRBV4-1	TRBJ2-7
TGTGCCACCAGTGATTTCCCATCAGTGAAGTATAGCAATCAGCCCCAGCATTTT	CATSDFPSVKYSNQPQHF	TRBV24-1	TRBJ1-5
TGTGCCAGCAAAGAGGGACAGGGCAAAGTGAACACTGAAGCTTTCTTT	CASKEGQGKVNTEAFF	TRBV9	TRBJ1-1
TGTGCCAGCCTCCTATTTAATGAAAAACTGTTTTTT	CASLLFNEKLFF	TRBV25-1	TRBJ1-4
TGTGTTGAGGGAATGTATTGGCCGGGGGGCCTGTTGGATGCAACTAATGAAAAACTGTTTTTT	CVEGMYWPGGLLDATNEKLFF	TRBV20-1	TRBJ1-4
TGTGCCAGCAGCAAGGGACAGGGAGGTGCTCACTTATACTATGGCTACACCTTC	CASSKGQGGAHLYYGYTF	TRBV7-2	TRBJ1-2
TGTGGGGGCGATTGGGGGAATGAAAAACTGTTTTTT	CGGDWGNEKLFF	TRBV24-1	TRBJ1-4
TGCGCGAGCCTCCCCTGCTCCTACGAGCAGTACTTC	CASLPCSYEQYF	TRBV10-1	TRBJ2-7
TGTGCCAGCAGTTATTGGAAGACAGTCGATACGCAGTATTTT	CASSYWKTVDTQYF	TRBV7-9	TRBJ2-3
TGTGCCAGCCCAGGGGGCGTGAGCTCCTATAATTCACCCCTCCACTTT	CASPGGVSSYNSPLHF	TRBV2	TRBJ1-6
TGTGCCACCAGCAGTGCTCTTTTTAGCACAGATACGCAGTATTTT	CATSSALFSTDTQYF	TRBV15	TRBJ2-3
TGTGCCAGCAGCAGGGACAGGGTTACGCAGTATTTT	CASSRDRVTQYF	TRBV7-9	TRBJ2-3
TGTGCCCACGGGGGGGCGAGGTACTTC	CAHGGARYF	TRBV24-1	TRBJ2-7
TGTGCCAGCAGTGACCATGTTCCCCAGCGGGAGGCTGGCATAAAGTCACCCCTCCACTTT	CASSDHVPQREAGIKSPLHF	TRBV6-4	TRBJ1-6
TGTGCCAGCAGACCACAGCACGGGCGGACGGGCGAGGACTCTGGAAACACCATATATTTT	CASRPQHGRTGEDSGNTIYF	TRBV6-1	TRBJ1-3
TGTGCCAGCAGAAATGGGGAGGATGCAACTAATGAAAAACTGTTTTTT	CASRNGEDATNEKLFF	TRBV6-4	TRBJ1-4
TGTGCCAGCAGCCAATTATCTGGGACGGGCAGCAATCAGCCCCAGCATTTT	CASSQLSGTGSNQPQHF	TRBV3-1	TRBJ1-5
TGCGCCAGCAGCCCCCGGTACCGGGGACAGGGCCAGGGGACCCAGTACTTC	CASSPRYRGQGQGTQYF	TRBV4-1	TRBJ2-5
TGTGCCAGCAGCCAGACAGGGACAGGGAGGGGGGTATTAATGAACACTGAAGCTTTCTTT	CASSQTGTGRGVLMNTEAFF	TRBV3-1	TRBJ1-1
TGCAGTGCTGCTAGGCCGGACAGGGATCAATATGGCTACACCTTC	CSAARPDRDQYGYTF	TRBV20-1	TRBJ1-2
TGTGCCAGCAGCCAAAAGTCCACAGGGGAAACCTACGAGCAGTACTTC	CASSQKSTGETYEQYF	TRBV5-4	TRBJ2-7
TGCAGTGCTAACAGGAACCCTAACGAGCAGTACTTC	CSANRNPNEQYF	TRBV20-1	TRBJ2-7
TGTGCCAGCACAGGGTCCCGGGGCGCCTACGAGCAGTACTTC	CASTGSRGAYEQYF	TRBV6-6	TRBJ2-7
TGTGCCCCACTAGCGGGAGGGCGCCGGTGCGATGGCTACACCTTC	CAPLAGGRRCDGYTF	TRBV6-4	TRBJ1-2
TGTGCCAGCAGCCATAGATTTTACGAGCAGTACTTC	CASSHRFYEQYF	TRBV7-3	TRBJ2-7
TGTGCCAGCAGTTACTCTGGGGGGCTGTTTTTT	CASSYSGGLFF	TRBV6-3	TRBJ1-4
TGTGCCAGCAGCTCCATCCGCAAGCAGGGGCGGAGTCAAGAGACCCAGTACTTC	CASSSIRKQGRSQETQYF	TRBV7-9	TRBJ2-5
TGTGCCAGCAGCCAAGATCGCGGGGAAACCAAGGAAGAGACCCAGTACTTC	CASSQDRGETKEETQYF	TRBV14	TRBJ2-5
TGCGCCAGCAGCCAAGCCCCCTTCCGGGGACTAGCGGGGCGGGAGCAGTTCTTC	CASSQAPFRGLAGREQFF	TRBV4-1	TRBJ2-1
TGTGCCTGGCCCACCCCGGGTGGCTACACCTTC	CAWPTPGGYTF	TRBV30	TRBJ1-2
TGCAGTGCGCAATGGACAGCCCAGCGGGGCCTTCGCGAGCAGTACTTC	CSAQWTAQRGLREQYF	TRBV20-1	TRBJ2-7
TGTGCCAGCAGCCAATGCCACAGGGTGCCAGACACTGAAGCTTTCTTT	CASSQCHRVPDTEAFF	TRBV4-2	TRBJ1-1
TGTGCCAGCAGGGATGGGGGCAACAATCAGCCCCAGCATTTT	CASRDGGNNQPQHF	TRBV28	TRBJ1-5
TGCGCCAGCAGCTTGCTTCGGGGGCGTCGTTTATGTCAGCCCCAGCATTTT	CASSLLRGRRLCQPQHF	TRBV5-1	TRBJ1-5
TGTGCCAGCAGAGTTTCCCCGCCCGTTCCCGGGGGGGTTCGTGGAAACACCATATATTTT	CASRVSPPVPGGVRGNTIYF	TRBV12-3	TRBJ1-3
TGTGCCAGCTGCTCCATCCCTGTGTATTACTCAAGGGGCGGCTACACCTTC	CASCSIPVYYSRGGYTF	TRBV6-4	TRBJ1-2
TGTGCCAGCAGTGACTTCGTTCCGGGGAGCTCCTACAATGAGCAGTTCTTC	CASSDFVPGSSYNEQFF	TRBV6-4	TRBJ2-1
TGTGCCAGCAGGGGGACAGATACGCAGTATTTT	CASRGTDTQYF	TRBV6-4	TRBJ2-3
TGTGCCACCAGTCTAAGACAGGTTAGGAACTATGGCTACACCTTC	CATSLRQVRNYGYTF	TRBV24-1	TRBJ1-2
TGTGCCACTCTCCCCTGTGAGAGGACAGGTGGCTACGAGCAGTACTTC	CATLPCERTGGYEQYF	TRBV24-1	TRBJ2-7
TGCAGCGGGCCACCACTGTACGAGCAGTACTTC	CSGPPLYEQYF	TRBV29-1	TRBJ2-7
TGTGCCAGCAGCCCTTCAAATCCAGGGAACTATGGCTACACCTTC	CASSPSNPGNYGYTF	TRBV13	TRBJ1-2
TGTGCCAGCACGGACAGGGTGATATTCTATGGCTACACCTTC	CASTDRVIFYGYTF	TRBV12-3	TRBJ1-2
TGCAGCGTTAAAGTTCACAGGGAAACCCTCCACTTT	CSVKVHRETLHF	TRBV29-1	TRBJ1-6
TGTGCCAGCAGCCAAGTTTTTAACAGGAGGGCTGGAAACACCATATATTTT	CASSQVFNRRAGNTIYF	TRBV3-1	TRBJ1-3
TGCGCCAGCAGCCAAGCCGCGAGGGGGGTCTACGAGCAGTACTTC	CASSQAARGVYEQYF	TRBV4-1	TRBJ2-7
TGTGCCAGCAGCACTGTTACCCCGGGAGGGGGCGCGTATGAGCAGTTCTTC	CASSTVTPGGGAYEQFF	TRBV7-6	TRBJ2-1
TGTGCCAGCAGTTATTCGAAGGGGGGATTCGGGGAGCTGTTTTTT	CASSYSKGGFGELFF	TRBV6-2	TRBJ2-2
TGTGCCAGTAGTAGTCAGGGAAGACAGCCCCAGCATTTT	CASSSQGRQPQHF	TRBV19	TRBJ1-5
TGTGCCAGTAGTATGAAGCAGAACCGCCAAGAGACCCAGTACTTC	CASSMKQNRQETQYF	TRBV19	TRBJ2-5
TGCAGTGCTAGACGGTTTGACAGGGGGTTCACAGATACGCAGTATTTT	CSARRFDRGFTDTQYF	TRBV20-1	TRBJ2-3
TGTGCCAGCAGTTTAACTAGCGGAGCCGACACCGGGGAGCTGTTTTTT	CASSLTSGADTGELFF	TRBV28	TRBJ2-2
TGCAGTGCAAGCGGGAACTTCTCCAATTCACCCCTCCACTTT	CSASGNFSNSPLHF	TRBV20-1	TRBJ1-6
TGTGCCACCAGTGATTTGCCGGAGGGACAGTCTTATAATTCACCCCTCCACTTT	CATSDLPEGQSYNSPLHF	TRBV24-1	TRBJ1-6
TGTGCCAGCAGGCGGACAGGGAAAGAACCGAACTCCTACAATGAGCAGTTCTTC	CASRRTGKEPNSYNEQFF	TRBV12-4	TRBJ2-1
TGCGCCAGCAGCCAAAGTTTGAACAGGGTAGTCTACGAGCAGTACTTC	CASSQSLNRVVYEQYF	TRBV4-3	TRBJ2-7
TGTGCCAGCACCGACAGGGGTAACACTGAAGCTTTCTTT	CASTDRGNTEAFF	TRBV7-9	TRBJ1-1
TGTGCCAGCGCTAGGGTGGGAGAGTACTTC	CASARVGEYF	TRBV14	TRBJ2-7
TGTGCCAGCACCCAGCCCTACCGGACTAGGCCGAACACCGGGGAGCTGTTTTTT	CASTQPYRTRPNTGELFF	TRBV6-3	TRBJ2-2
TGTGCCAGCAGCGCACGGAGACGAGGGCAAAGCTCCTACGAGCAGTACTTC	CASSARRRGQSSYEQYF	TRBV9	TRBJ2-7
TGCGCCAGCAGCCACCCGGGCCAGCAGGGTCCCCAAACTGACACTGAAGCTTTCTTT	CASSHPGQQGPQTDTEAFF	TRBV4-3	TRBJ1-1
TGTGCCACCAGTGGCGGGAGATCAGGGGACAATGAGCAGTTCTTC	CATSGGRSGDNEQFF	TRBV24-1	TRBJ2-1
TGTGCTAGTGGTCAGTCCTGTACATTAGGATCCACAGATACGCAGTATTTT	CASGQSCTLGSTDTQYF	TRBV12-5	TRBJ2-3
TGTGCCAGCAGCCGGAGGGCAGAGACCCAGTACTTC	CASSRRAETQYF	TRBV7-3	TRBJ2-5
TGCAGCGACACTAGGGGAGAGCAGTTCTTC	CSDTRGEQFF	TRBV29-1	TRBJ2-1
TGTGCCAGCAGCCCCAGGGGGGGTCGCTCCTACGAGCAGTACTTC	CASSPRGGRSYEQYF	TRBV7-6	TRBJ2-7
TGTGCCAGCAGCTTAGAAATAGGGACAGATAGGCCGGAAGAGACCCAGTACTTC	CASSLEIGTDRPEETQYF	TRBV7-9	TRBJ2-5
TGTGCCAGCAGTTTCCTGTTACAAATCGATACCTACGAGCAGTACTTC	CASSFLLQIDTYEQYF	TRBV28	TRBJ2-7
TGTGCCAGCAGAATAACCCCGGGACTAGCGGGATGTAGCTCTGGAAACACCATATATTTT	CASRITPGLAGCSSGNTIYF	TRBV6-6	TRBJ1-3
TGTGCCAGCAGCAGCCACGACAGATATTTT	CASSSHDRYF	TRBV13	TRBJ1-3
TGCGCCAGCAGCTCCGGGGGGGCCTGGATTTATGAGCAGTTCTTC	CASSSGGAWIYEQFF	TRBV5-1	TRBJ2-1
TGTGCCCCGCAGAGGGACAATGAGCAGTTCTTC	CAPQRDNEQFF	TRBV7-9	TRBJ2-1
TGCGCCAGCAGCCCCGTGGGGACAGGCCCAGTCTCCTACGAGCAGTACTTC	CASSPVGTGPVSYEQYF	TRBV5-1	TRBJ2-7
TGTGCCAGTAGCCACCCTCCTGGGGGAGGGTACGAGCAGTACTTC	CASSHPPGGGYEQYF	TRBV19	TRBJ2-7
TGTGCCAGCAGCCAAGATACTCCGGGTCAGGGGAATCAGCCCCAGCATTTT	CASSQDTPGQGNQPQHF	TRBV14	TRBJ1-5
TGCGCCAGCAGCTTGGCCGAAGGGGACGAGCAGTACTTC	CASSLAEGDEQYF	TRBV5-1	TRBJ2-7
TGTGCCATCAGTGAGTCCCTACAGGGGTGCGAGAACACTGAAGCTTTCTTT	CAISESLQGCENTEAFF	TRBV10-3	TRBJ1-1
TGTGCCACCAGTGAACGACGATGTTACAATGAGCAGTTCTTC	CATSERRCYNEQFF	TRBV24-1	TRBJ2-1
TGTGCCAGCATTGGGAGCGGGACAGCTCTTCGAAATCCCGGCTACGAGCAGTACTTC	CASIGSGTALRNPGYEQYF	TRBV9	TRBJ2-7
TGTGCCAGCAGCCAAGAGAAACTAATACAAGAGACCCAGTACTTC	CASSQEKLIQETQYF	TRBV14	TRBJ2-5
TGTGCTAGTGGTTCCACCCTTCGTTCTCAGGGGGATTATCTCCCCCCTAGTTACTACGAGCAGTACTTC	CASGSTLRSQGDYLPPSYYEQYF	TRBV12-5	TRBJ2-7
TGTGCCAGCAGTGAAGCCCCGGGACAGGGGGGCTACACCGGGGAGCTGTTTTTT	CASSEAPGQGGYTGELFF	TRBV6-1	TRBJ2-2
TGTGCCAGCAGCGTACGACAGGGACAGGATTCACCCCTCCACTTT	CASSVRQGQDSPLHF	TRBV13	TRBJ1-6
TGTGCCAGCAGCCACAATCGGGGGACGGATAATTCACCCCTCCACTTT	CASSHNRGTDNSPLHF	TRBV13	TRBJ1-6
TGTGCCAGCAGCTTGGATCTAGGACAGGGTTCGCAGTACTTC	CASSLDLGQGSQYF	TRBV5-4	TRBJ2-7
TGTGCCAGCAGAGTGGGTCCAGTAGGACTAGAATTATACAATGAGCAGTTCTTC	CASRVGPVGLELYNEQFF	TRBV5-4	TRBJ2-1
TGTGCCAGCACCAACAGGGCGGGTCAGCCCCAGCATTTT	CASTNRAGQPQHF	TRBV7-2	TRBJ1-5
TGTGCCAGCAGCTATTACCGACAGGGTTGTAAAGAAAAACTGTTTTTT	CASSYYRQGCKEKLFF	TRBV11-3	TRBJ1-4
TGTGCCAGCAGCCAAGAGCAGGAATGGACAGATGCGAACACCGGGGAGCTGTTTTTT	CASSQEQEWTDANTGELFF	TRBV14	TRBJ2-2
TGTGCCACCATCCCGCTCCCCCCTTGGAGCGAGCAGTACTTC	CATIPLPPWSEQYF	TRBV24-1	TRBJ2-7
TGTGCCAGCAGTTTTTATAGCGGGGGAAATGAGCAGTTCTTC	CASSFYSGGNEQFF	TRBV28	TRBJ2-1
TGTGCCACTCGGGACACTGAAGCTTTCTTT	CATRDTEAFF	TRBV24-1	TRBJ1-1
TGTGCCAGCAGTTTATGGGACCGGGACAGAGACACTGAAGCTTTCTTT	CASSLWDRDRDTEAFF	TRBV28	TRBJ1-1
TGCAGTGCTAGACCGCGGGGACCTGGAGGTGAAAAACTGTTTTTT	CSARPRGPGGEKLFF	TRBV20-1	TRBJ1-4
TGTGCCAGCAGTTGGAAGGGACAGGGGAAGTCCTACGAGCAGTACTTC	CASSWKGQGKSYEQYF	TRBV27	TRBJ2-7
TGTGCCTGGAGTGTTTTAAGATCCTACAATGAGCAGTTCTTC	CAWSVLRSYNEQFF	TRBV30	TRBJ2-1
TGTGCCAGCAGCGAATGCGGGAGGAGGTACCATGGCTACACCTTC	CASSECGRRYHGYTF	TRBV7-9	TRBJ1-2
TGTGCCAGCACTAGCGGGTACACCGGGGAGCTGTTTTTT	CASTSGYTGELFF	TRBV28	TRBJ2-2
TGTGCCAGCAGGGGTCGGCAGGGCGGGGAGCAGTACTTC	CASRGRQGGEQYF	TRBV6-1	TRBJ2-7
TGTGCCTGGACCGGTTGGGGGCTAGGGGGGTCAGATACGCAGTATTTT	CAWTGWGLGGSDTQYF	TRBV30	TRBJ2-3
TGTGCCAGCAGAGCGGCGGACAGGGGGCGGCTACTTAGCAATCAGCCCCAGCATTTT	CASRAADRGRLLSNQPQHF	TRBV6-2	TRBJ1-5
TGTGCCAGCAGCTTAGCGCCCAGCCTAGCGGTCAGGGGAACCTACGAGCAGTACTTC	CASSLAPSLAVRGTYEQYF	TRBV7-6	TRBJ2-7
TGTGCCAGCAATCCCATAGAGGCTCCGTCCCGAAATCAGCCCCAGCATTTT	CASNPIEAPSRNQPQHF	TRBV19	TRBJ1-5
TGTGCCAGCAGCAAGAATCCTAGTCAAGAGACCCAGTACTTC	CASSKNPSQETQYF	TRBV9	TRBJ2-5
TGTGCCAGCAGCGGTAGACAGGTAAGAGAAGGGCCCTACAATGAGCAGTTCTTC	CASSGRQVREGPYNEQFF	TRBV7-3	TRBJ2-1
TGCAGTGCTAGCCGACTAGCGGGAGATGAGCAGTTCTTC	CSASRLAGDEQFF	TRBV20-1	TRBJ2-1
TGTGCCAGCCCGGGACAGGGGGGTGGCAAGAGCTCCGAGCAGTACTTC	CASPGQGGGKSSEQYF	TRBV27	TRBJ2-7
TGTGCCACCAGTGATTTCAGGGGGGGACATCACGACACTGAAGCTTTCTTT	CATSDFRGGHHDTEAFF	TRBV24-1	TRBJ1-1
TGTGCCAGCACCGTAGGGACTACTAGGTCGAACACTGAAGCTTTCTTT	CASTVGTTRSNTEAFF	TRBV9	TRBJ1-1
TGTGCCTTGCGAGGTGGGGTCACTGAAGCTTTCTTT	CALRGGVTEAFF	TRBV30	TRBJ1-1
TGCGCCAGCAGCCAAGCCGATCAGCGACGGGCTTTCTTT	CASSQADQRRAFF	TRBV4-1	TRBJ1-1
TGTGCCAGTAGTATGAATGCGGGAGAAGAGACCCAGTACTTC	CASSMNAGEETQYF	TRBV19	TRBJ2-5
TGCGCCAGCAAGAGGGGGTACGAGCAGTACTTC	CASKRGYEQYF	TRBV10-1	TRBJ2-7
TGTGCCAGCAGTGAAGAATCTCGTTGGGGGGATACTAACTATGGCTACACCTTC	CASSEESRWGDTNYGYTF	TRBV6-1	TRBJ1-2
TGCGCCAGCAGCCAAGATCCACTAGCGGAGGCAGAGCAGTTCTTC	CASSQDPLAEAEQFF	TRBV4-1	TRBJ2-1
TGTGCCAGCAGCCGCTCGGACAGGGAAATGAGCTCCTATAATTCACCCCTCCACTTT	CASSRSDREMSSYNSPLHF	TRBV13	TRBJ1-6
TGTGCCAGCAGCTTGTATGGCCTGGACCTAGATGAGCAGTTCTTC	CASSLYGLDLDEQFF	TRBV5-6	TRBJ2-1
TGTGCCAGCGCCCACACCCTCGAACGCGAGGTGGATGGCTACACCTTC	CASAHTLEREVDGYTF	TRBV6-1	TRBJ1-2
TGTGCCAGCAGCTGGGGACAGGGGGCTAACAATGAGCAGTTCTTC	CASSWGQGANNEQFF	TRBV7-2	TRBJ2-1
TGCGCCAGCCGAAGGGTACGAGCTTTCTTT	CASRRVRAFF	TRBV10-1	TRBJ1-1
TGTGCCAGCAGGTACTCCTACGAGCAGTACTTC	CASRYSYEQYF	TRBV14	TRBJ2-7
TGCAGTGCTAGAGGCCGGGGCCTGGGCACAGATACGCAGTATTTT	CSARGRGLGTDTQYF	TRBV20-1	TRBJ2-3
TGTGCCAGCAGCAAGGAAGGGACAGGTCGATACTATGGCTACACCTTC	CASSKEGTGRYYGYTF	TRBV14	TRBJ1-2
TGCGCCAGCCCACGCAATGAGCAGTTCTTC	CASPRNEQFF	TRBV10-1	TRBJ2-1
TGTGCCACCAGTGAACGCCCCCGGGACATTTCGATGTACATTCAGTACTTC	CATSERPRDISMYIQYF	TRBV24-1	TRBJ2-4
TGTGCCAGCTGGGACTATGGCTACACCTTC	CASWDYGYTF	TRBV5-6	TRBJ1-2
TGCAGTGCAGATCGGGGAGGCAATCAGCCCCAGCATTTT	CSADRGGNQPQHF	TRBV20-1	TRBJ1-5
TGCGCCAGCAGCCCCACAGACTACGAGCAGTACTTC	CASSPTDYEQYF	TRBV5-1	TRBJ2-7
TGTGCCAGCAGCTTAGGTGAGACCGGCCAAGGGACAGGGGGAGATACGCAGTATTTT	CASSLGETGQGTGGDTQYF	TRBV7-2	TRBJ2-3
TGCAGTGCTAGCCGGACAGGGTTTATGAACACTGAAGCTTTCTTT	CSASRTGFMNTEAFF	TRBV20-1	TRBJ1-1
TGTGCCAGCTCCCTGCTGCGGAACACTGAAGCTTTCTTT	CASSLLRNTEAFF	TRBV18	TRBJ1-1
TGTGCCAGCAGTTTATACACGACCTTCGGTACATACGAGCAGTACTTC	CASSLYTTFGTYEQYF	TRBV28	TRBJ2-7
TGTGCCAGCAGTAATGGCGTGGATCCCTACGAGCAGTACTTC	CASSNGVDPYEQYF	TRBV2	TRBJ2-7
TGTGCCTGGAGTGTAAAGGGGTTGGGGAGAGGAAAACAAGAGACCCAGTACTTC	CAWSVKGLGRGKQETQYF	TRBV30	TRBJ2-5
TGTGCCAGCCCAGGACACGAGCAGTACTTC	CASPGHEQYF	TRBV9	TRBJ2-7
TGTGCCAGCAGCTTAGCCGATCTAAGGGCAGATACGCAGTATTTT	CASSLADLRADTQYF	TRBV7-9	TRBJ2-3
TGTGCCACCTCAGACAGGGGGCAGGGCTACACCTTC	CATSDRGQGYTF	TRBV24-1	TRBJ1-2
TGTGCCAGCCCCATTCGGACAGAAGACAATGAAAAACTGTTTTTT	CASPIRTEDNEKLFF	TRBV2	TRBJ1-4
TGTGCCAGCAGCCCTACGGGAGAGACCCAGTACTTC	CASSPTGETQYF	TRBV28	TRBJ2-5
TGCAGTGCTAGAGGGAAATGGGGGGTCAATCAGCCCCAGCATTTT	CSARGKWGVNQPQHF	TRBV20-1	TRBJ1-5
TGTGCCAGCAGCCATCCGGGGAGGGAGCAGTACTTC	CASSHPGREQYF	TRBV7-3	TRBJ2-7
TGTGCCAGCCCGAAACCGACAGGGCCGAGGTTGCTTGAGCAGTTCTTC	CASPKPTGPRLLEQFF	TRBV18	TRBJ2-1
TGTGCCAAGTTGGAGGTGCTAAGAGGGGCCTCACCCCTCCACTTT	CAKLEVLRGASPLHF	TRBV28	TRBJ1-6
TGTGCTAGCAGCCAAAATGACGGGCCGCGGGCGCAGTTCTTC	CASSQNDGPRAQFF	TRBV7-7	TRBJ2-1
TGTGCCAGCAGCTCGCCTGTAATACGGACTACCGGGGAGCTGTTTTTT	CASSSPVIRTTGELFF	TRBV13	TRBJ2-2
TGCGCCAGCAGCCCGCTTCCGGGACAGCTGGCAGATACGCAGTATTTT	CASSPLPGQLADTQYF	TRBV5-1	TRBJ2-3
TGCGCCAGCAGCCACAGACTCCGGGAGGGCGAGCAGTACTTC	CASSHRLREGEQYF	TRBV4-1	TRBJ2-7
TGTGCCAGCAGCCATGACGTCAGGGGGCCCCGCTTT	CASSHDVRGPRF	TRBV14	TRBJ1-1
TGCGCCAGCAGCCAACTTAACGTCAGGGTTAATGAGCAGTTCTTC	CASSQLNVRVNEQFF	TRBV4-1	TRBJ2-1
TGTGCCAGTATGGGTAGCGGGTACGAGCAGTACTTC	CASMGSGYEQYF	TRBV19	TRBJ2-7
TGTGCCAGCAGCGGGGACCGAATTAACACTGAAGCTTTCTTT	CASSGDRINTEAFF	TRBV13	TRBJ1-1
TGTGCCAGCACGGACAGGTGTCTTTACGCAACTAATGAAAAACTGTTTTTT	CASTDRCLYATNEKLFF	TRBV28	TRBJ1-4
TGCAGTGATCCGAGGGAAGAAAAACTGTTTTTT	CSDPREEKLFF	TRBV20-1	TRBJ1-4
TGTGCCAGCAGCGAGGGGTGGACAGGTTGCACAGATACGCAGTATTTT	CASSEGWTGCTDTQYF	TRBV5-6	TRBJ2-3
TGTGCCAGCAGCATCGGGGCGGGGGATAGCAATCAGCCCCAGCATTTT	CASSIGAGDSNQPQHF	TRBV7-2	TRBJ1-5
TGTGCCAGCAGTGAATGTGCTAGGGGAGCGGGGGGCAGCTCCTACAATGAGCAGTTCTTC	CASSECARGAGGSSYNEQFF	TRBV6-1	TRBJ2-1
TGTGCCAGCAGTTCTGGGGGGGGACGTACCCCCCAGTACTTC	CASSSGGGRTPQYF	TRBV6-5	TRBJ2-5
TGTGCCAGCAGCTTAGCAGCTTCGGGACAAAAGCCGAACACTGAAGCTTTCTTT	CASSLAASGQKPNTEAFF	TRBV7-2	TRBJ1-1
TGTGCCAGCAGCCACTCCGGCGATGGCTACACCTTC	CASSHSGDGYTF	TRBV7-4	TRBJ1-2
TGTGCCAGCACGACTAGGAGGTTGATCTTTGACGAGCAGTACTTC	CASTTRRLIFDEQYF	TRBV4-2	TRBJ2-7
TGTGCCAGCAGTGATGCCGAGCGGTGGTCCTACGAGCAGTACTTC	CASSDAERWSYEQYF	TRBV6-4	TRBJ2-7
TGTGCCAGCACCGGCAGTTATAGTGAAAAACTGTTTTTT	CASTGSYSEKLFF	TRBV12-3	TRBJ1-4
TGTGCCAGCAGCCAGGGACTAGCGGCCCCCTACAATGAGCAGTTCTTC	CASSQGLAAPYNEQFF	TRBV6-5	TRBJ2-1
TGTGCTAGTGGTAATACGAGAAAACTGGCAACTAATGAAAAACTGTTTTTT	CASGNTRKLATNEKLFF	TRBV12-5	TRBJ1-4
TGTGCCAGCATGGAAACTAGGATAACGCAGTATTTT	CASMETRITQYF	TRBV11-3	TRBJ2-3
TGTGCCATCAGTCCGAGGGACGCAGGTAAGGGGAATCAGCCCCAGCATTTT	CAISPRDAGKGNQPQHF	TRBV10-3	TRBJ1-5
TGTGCCTGGAGTGTATCCCGGGGGCACGCCAATGAAAAACTGTTTTTT	CAWSVSRGHANEKLFF	TRBV30	TRBJ1-4
TGTGCCAGCAGTGACTCGAGAACGGCACAACCGCAGAACGAGCAGTACTTC	CASSDSRTAQPQNEQYF	TRBV6-4	TRBJ2-7
TGTGCCAGTAGTATGTGGCCTTCCAGCTCCTACAATGAGCAGTTCTTC	CASSMWPSSSYNEQFF	TRBV19	TRBJ2-1
TGTGCCAGCAGCTTAGATCCTTTACAAGGGGGCCGGGAGCAGTTCTTC	CASSLDPLQGGREQFF	TRBV7-6	TRBJ2-1
TGTGCCAGCAGTGACGCCAGGGGGGCCCCCCAGCATTTT	CASSDARGAPQHF	TRBV25-1	TRBJ1-5
TGTGCCAGCCTCCTGATAGGGGGCTCCGATAGCAATCAGCCCCAGCATTTT	CASLLIGGSDSNQPQHF	TRBV6-3	TRBJ1-5
TGTGCCAGCAGGGGGGACAGGGGGCCCAGTTCCTACGAGCAGTACTTC	CASRGDRGPSSYEQYF	TRBV12-4	TRBJ2-7
TGTGCCAGCAGCCAAGATCTACGTTCTTGGGACAGGGGAAATGAGCAGTTCTTC	CASSQDLRSWDRGNEQFF	TRBV14	TRBJ2-1
TGTGCCAGCAGCTTGGCCTGTCCCCCGGGCCGGTGCTACACCTTC	CASSLACPPGRCYTF	TRBV5-4	TRBJ1-2
TGCAGTGCTCCTACAGGGCTGGGGGGGGGGCCCCAGCATTTT	CSAPTGLGGGPQHF	TRBV20-1	TRBJ1-5
TGTGCCTGGAGCAAGGGACAGGAGAACACTGAAGCTTTCTTT	CAWSKGQENTEAFF	TRBV30	TRBJ1-1
TGTGCCAGCAGTGACCGGGTTGAAAACAACGAGCAGTACTTC	CASSDRVENNEQYF	TRBV6-4	TRBJ2-7
TGCGCCACCTTGGCCAAGGGCAATCAGCCCCAGCATTTT	CATLAKGNQPQHF	TRBV10-1	TRBJ1-5
TGTGCCAGCAGCCCCATTCGGGCTGTCACTGAAGCTTTCTTT	CASSPIRAVTEAFF	TRBV5-8	TRBJ1-1
TGTGCCAGCATTACAGGGGGCCGATTTCCCTCTGGGGCCAACGTCCTGACTTTC	CASITGGRFPSGANVLTF	TRBV9	TRBJ2-6
TGCGCCAGCAGACCCCCAAAAGGAGAGACTATTCGTTCACCCCTCCACTTT	CASRPPKGETIRSPLHF	TRBV10-2	TRBJ1-6
TGTGCCAGCCCCACTTCGGGCCCTTTGGTCTTC	CASPTSGPLVF	TRBV28	TRBJ2-5
TGCAGTGCTATTCACAGGGCAGAGTACTTC	CSAIHRAEYF	TRBV20-1	TRBJ2-7
TGTGCCAGCAGCTGTGGGACGTACAATCAGCCCCAGCATTTT	CASSCGTYNQPQHF	TRBV7-3	TRBJ1-5
TGTGCCACCACCTCAGGAGATGGCTACACCTTC	CATTSGDGYTF	TRBV24-1	TRBJ1-2
TGTGCCAGCAGAGACAGGGAGGTGAACACAGATACGCAGTATTTT	CASRDREVNTDTQYF	TRBV6-6	TRBJ2-3
TGTGCCAGCAGAGTGGGACCTAGCCTATTCAATGAGCAGTTCTTC	CASRVGPSLFNEQFF	TRBV6-2	TRBJ2-1
TGTGCCAGCAGCTTCCCACGTCCGGGACAGGGAGTGGTAGCTTTCTTT	CASSFPRPGQGVVAFF	TRBV7-4	TRBJ1-1
TGTGCCTGGAGTCGGGACGGGAGCTCCTATAATTCACCCCTCCACTTT	CAWSRDGSSYNSPLHF	TRBV30	TRBJ1-6
TGTGCCAGCAGCCCCCCCGGGGGACATCATGGCTACACCTTC	CASSPPGGHHGYTF	TRBV7-3	TRBJ1-2
TGTGCCAGCAGCCGAATGCCCACGGGACTCAGTCTCTTC	CASSRMPTGLSLF	TRBV13	TRBJ2-1
TGCGCCAGCAGCTGGCACCCCCTGTCCGGGACTAACCGCTGCCCCGTAGCCAAAAACATTCAGTACTTC	CASSWHPLSGTNRCPVAKNIQYF	TRBV5-1	TRBJ2-4
TGTGCCAGCAGGGAGGGCGGGAGGAACTCACCCCTCCACTTT	CASREGGRNSPLHF	TRBV12-4	TRBJ1-6
TGTGCCAGCAGTAAACTGAACACTGAAGCTTTCTTT	CASSKLNTEAFF	TRBV12-3	TRBJ1-1
TGCGCCAGCAGCCAAGAAGGGTTATCCGGGACGAACACTGAAGCTTTCTTT	CASSQEGLSGTNTEAFF	TRBV4-3	TRBJ1-1
TGCAGTGCTAGGTCCAGAGAGTACACAGAGACCCAGTACTTC	CSARSREYTETQYF	TRBV20-1	TRBJ2-5
TGTGCCAAGACCGGGACTGAAGCTTTCTTT	CAKTGTEAFF	TRBV6-3	TRBJ1-1
TGTGCCAGCAGTGATCGGGGGGGCTCGTCCTACGAGCAGTACTTC	CASSDRGGSSYEQYF	TRBV6-1	TRBJ2-7
TGTGCCAGCAGTGGGGGGGCGGGCACAGATACGCAGTATTTT	CASSGGAGTDTQYF	TRBV6-3	TRBJ2-3
TGTGCCACCAGTGATTCAGGGGCGTATGGCTACACCTTC	CATSDSGAYGYTF	TRBV24-1	TRBJ1-2
TGCGCCAGCAGCCAAGGGTCCCGGGGAGAACAAGAGACCCAGTACTTC	CASSQGSRGEQETQYF	TRBV4-3	TRBJ2-5
TGTGCCAGCACACCGGACGATCCCTATGGCTACACCTTC	CASTPDDPYGYTF	TRBV6-4	TRBJ1-2
TGTGCCAGCTATACTCTTAACACAGGGGGCAGTTTTCTCTATGGCTACACCTTC	CASYTLNTGGSFLYGYTF	TRBV5-6	TRBJ1-2
TGTGCCAGCATTTTCGCCCTTGGCTACACCTTC	CASIFALGYTF	TRBV5-5	TRBJ1-2
TGCAGTTTAAAAACTGAAGCTTTCTTT	CSLKTEAFF	TRBV20-1	TRBJ1-1
TGTGCCAGCAGCTTGGCACCGGGACGGGGAATGCCCTACGAGCAGTACTTC	CASSLAPGRGMPYEQYF	TRBV5-6	TRBJ2-7
TGTGCCAGCAGTTCGCCGGGAGGTTTACAAGAGACCCAGTACTTC	CASSSPGGLQETQYF	TRBV6-1	TRBJ2-5
TGCGCCAGCAGCTTGGATGCGGCGCTACAGGAAGTAACTGAAGCTTTCTTT	CASSLDAALQEVTEAFF	TRBV5-1	TRBJ1-1
TGTGCCAGCAGCCCTCCGACAGGGATCGGGGCCTCTGGGGCCAACGTCCTGACTTTC	CASSPPTGIGASGANVLTF	TRBV9	TRBJ2-6
TGTGCCACCAGAGACCGGGACAGGGGGGGGAACACTGAAGCTTTCTTT	CATRDRDRGGNTEAFF	TRBV24-1	TRBJ1-1
TGTGCTAGCAGCGCCCGGGAGGGGTACAATGAGCAGTTCTTC	CASSAREGYNEQFF	TRBV7-7	TRBJ2-1
TGCGCCAGCGGTAATCTCACAGATACGCAGTATTTT	CASGNLTDTQYF	TRBV5-1	TRBJ2-3
TGTGCCAGCAGGTCAGGGGAAACTGAAGCTTTCTTT	CASRSGETEAFF	TRBV6-2	TRBJ1-1
TGTGCCAGCAGCCTGGACAGGACAAAAATCAATCAGCCCCAGCATTTT	CASSLDRTKINQPQHF	TRBV7-3	TRBJ1-5
TGTGCCAGCAGCCACATTCGGGGAGGTTTTGGCTACACCTTC	CASSHIRGGFGYTF	TRBV14	TRBJ1-2
TGCGCCAGCACGCCCGTATCTTGTTTCGGATACTCCTACGAGCAGTACTTC	CASTPVSCFGYSYEQYF	TRBV10-1	TRBJ2-7
TGTGCCAGCAGCGCGCGACTGGTAGGAGAGACCCAGTACTTC	CASSARLVGETQYF	TRBV9	TRBJ2-5
TGTGCCAGCAGTTTCCGACTCCGGGACAGGGAACCTAGCAATCAGCCCCAGCATTTT	CASSFRLRDREPSNQPQHF	TRBV27	TRBJ1-5
TGTGCCACCAGTGCCACGGCTTTGAATAGTGAGCAGTTCTTC	CATSATALNSEQFF	TRBV24-1	TRBJ2-1
TGTGCCAGCACGTCCCGGGTTTCCCGGGGATCCACGCAGTATTTT	CASTSRVSRGSTQYF	TRBV6-5	TRBJ2-3
TGTGCCAGCAGCTTACGAAGGGGACAGGGGGGGGATACGCAGTATTTT	CASSLRRGQGGDTQYF	TRBV11-3	TRBJ2-3
TGTGCCACCATATCCCAAAGGGGACATGTTTTCGCTTCTGGAAACACCATATATTTT	CATISQRGHVFASGNTIYF	TRBV24-1	TRBJ1-3
TGTGCCAGCAGCAACAGGGCACCGAATGAGCAGTTCTTC	CASSNRAPNEQFF	TRBV7-9	TRBJ2-1
TGTGCCACCAGTGATCTGAGAAGGGGGGTTCAAGAGACCCAGTACTTC	CATSDLRRGVQETQYF	TRBV24-1	TRBJ2-5
TGCGCCAGCAGCACGTCGGGGACCCTCTCCCGGGATGAAAAACTGTTTTTT	CASSTSGTLSRDEKLFF	TRBV5-1	TRBJ1-4
TGCAGTGCTAGAGCCCGTTTCCCCAGTTGTTTAAAGGGGGCTTGTCAGCCCCAGCATTTT	CSARARFPSCLKGACQPQHF	TRBV20-1	TRBJ1-5
TGTGCCAGCAGCTTAGGCAGGGGGTCCGGCTCCTACAATGAGCAGTTCTTC	CASSLGRGSGSYNEQFF	TRBV7-9	TRBJ2-1
TGTGCCAGCAGCAGGACTACTAATGAAAAACTGTTTTTT	CASSRTTNEKLFF	TRBV7-3	TRBJ1-4
TGTGCCAGCAGCCAAGCGCCGGGGCTCATCTCCTACGAGCAGTACTTC	CASSQAPGLISYEQYF	TRBV3-1	TRBJ2-7
TGTGCCAGCAGTAGGAGTAGCGGGCGCCTCAGAAAGACGGATGGCGAGCAGTTCTTC	CASSRSSGRLRKTDGEQFF	TRBV12-4	TRBJ2-1
TGTGCCAGTACTAGCGGGAGGCGGGATAATTCACCCCTCCACTTT	CASTSGRRDNSPLHF	TRBV6-4	TRBJ1-6
TGTGCCAGCAGCCGTCATAATCCGGGGGCATTAGAGTATAATTCACCCCTCCACTTT	CASSRHNPGALEYNSPLHF	TRBV7-3	TRBJ1-6
TGCAGTGCTAGAGTTCGGGGCGAGCAGTACTTC	CSARVRGEQYF	TRBV20-1	TRBJ2-7
TGTGCCAGCAATGTCCAGGGGTCTATAGGCCAGAACACTGAAGCTTTCTTT	CASNVQGSIGQNTEAFF	TRBV12-4	TRBJ1-1
TGTGCCAGCAGTGCAAGGGGCCCGGGAGAAGAATCCTACAATGAGCAGTTCTTC	CASSARGPGEESYNEQFF	TRBV27	TRBJ2-1
TGTGCCAGCAGCCCCTTGGGGAACAACTATGGCTACACCTTC	CASSPLGNNYGYTF	TRBV7-3	TRBJ1-2
TGCAGTGCCCTAAGACAGGGGCCCTCGCGCTGCTACGAGCAGTACTTC	CSALRQGPSRCYEQYF	TRBV20-1	TRBJ2-7
TGCGCCAGCAGCTGCCTTCAGACCTATACCCAGCATTTT	CASSCLQTYTQHF	TRBV5-1	TRBJ1-5
TGCAGTGCTAGTCCGGGGGTCGATGGCTACACCTTC	CSASPGVDGYTF	TRBV20-1	TRBJ1-2
TGTGCCAGCAGTCAGGCCAGGGGGATTGAAGCTTTCTTT	CASSQARGIEAFF	TRBV6-4	TRBJ1-1
TGTGCCAGTACCCCCTCGGGGGGCGTAACCGGGGAGCTGTTTTTT	CASTPSGGVTGELFF	TRBV19	TRBJ2-2
TGTGCCACCAGTGAACTGGACGCGCAGCCCCAGCATTTT	CATSELDAQPQHF	TRBV24-1	TRBJ1-5
TGTGCCAGCAGCCGCGGGACAGGGGGCACATTATCCGAGACCCAGTACTTC	CASSRGTGGTLSETQYF	TRBV3-1	TRBJ2-5
TGCAGTGCTCACGGACATGCGTCAGATACGCAGTATTTT	CSAHGHASDTQYF	TRBV20-1	TRBJ2-3
TGCAGCGCCGGGACAGGGAGCACAGATACGCAGTATTTT	CSAGTGSTDTQYF	TRBV29-1	TRBJ2-3
TGTGCCAGCAACAGCCAGACTGAAGCTTTCTTT	CASNSQTEAFF	TRBV7-8	TRBJ1-1
TGTGCCAGCAGCCAAGTACGGTACTTTCTTGGGGCTTTCTTT	CASSQVRYFLGAFF	TRBV3-1	TRBJ1-1
TGTGCCAGTAGCCTAGTCGGCCTCGGACAGGGGAACTACGAGCAGTACTTC	CASSLVGLGQGNYEQYF	TRBV19	TRBJ2-7
TGTGCCAGCAGCCTGTACTCGACCCGGCTGGACAGGGGCTCAGGCAATGAGCAGTTCTTC	CASSLYSTRLDRGSGNEQFF	TRBV13	TRBJ2-1
TGTGCCACCAGTGATTTTCCCGGAGCCGGGAGGTACGAGCAGTACTTC	CATSDFPGAGRYEQYF	TRBV24-1	TRBJ2-7
TGTGCCACCAGCAGACCTCCCCTCCCTCCAGGGGCTGAAGCTTTCTTT	CATSRPPLPPGAEAFF	TRBV15	TRBJ1-1
TGCGCCAGCAGCCATCCGAGAGCTCACACCATATATTTT	CASSHPRAHTIYF	TRBV4-3	TRBJ1-3
TGTGCCAGCAGCGTAGTTGGGCGACAGGGGGCCACAGATACGCAGTATTTT	CASSVVGRQGATDTQYF	TRBV9	TRBJ2-3
TGTGCCAGCAGCCAAGCTGGCCCCAATGGTGGACAGGGGAAGTACGAGCAGTACTTC	CASSQAGPNGGQGKYEQYF	TRBV14	TRBJ2-7
TGTGCCACCAGTGATTTGCCCCCTAACGGGGGAGGGGTTGGGGGATGGAGCTCCTACAATGAGCAGTTCTTC	CATSDLPPNGGGVGGWSSYNEQFF	TRBV24-1	TRBJ2-1
TGTGCCAGCAGCCCGGGCCCAGAGGAGTCCTTCAACTATGGCTACACCTTC	CASSPGPEESFNYGYTF	TRBV5-5	TRBJ1-2
TGTGCCACCAGTGACTCTAGCAGCTCAGGGGGTGATGACACCGGGGAGCTGTTTTTT	CATSDSSSSGGDDTGELFF	TRBV24-1	TRBJ2-2
TGTGCCAGCAGTGATACGGGGACTAGCGGACCAGATACGCAGTATTTT	CASSDTGTSGPDTQYF	TRBV6-1	TRBJ2-3
TGTGCCAGCAGTTACTCCCGACTGCCCGGGACAGGTGGGCCCAAACGGGAGCAGTACTTC	CASSYSRLPGTGGPKREQYF	TRBV6-6	TRBJ2-7
TGTGCCATACCAGGTCCTAATGAAAAACTGTTTTTT	CAIPGPNEKLFF	TRBV28	TRBJ1-4
TGCGCCAGCAGCTACGAGCGAGCGGATCCTTCGAACACTGAAGCTTTCTTT	CASSYERADPSNTEAFF	TRBV5-1	TRBJ1-1
TGTGCCAGAGGCGTACTGGCGACCTACAATGAGCAGTTCTTC	CARGVLATYNEQFF	TRBV27	TRBJ2-1
TGTGCCAGCAGTGTAACTAGGGTCCACACAGATACGCAGTATTTT	CASSVTRVHTDTQYF	TRBV6-5	TRBJ2-3
TGCGCCAGAAGAGGGTCAGAGGGCGAGCGTGAAAAACTGTTTTTT	CARRGSEGEREKLFF	TRBV10-1	TRBJ1-4
TGCAGTGCGCCACGGGACGAGCAAGAGACCCAGTACTTC	CSAPRDEQETQYF	TRBV20-1	TRBJ2-5
TGCGCCAGCAGTGATAACAACCACCTCTGTCAGCCCCAGCATTTT	CASSDNNHLCQPQHF	TRBV10-1	TRBJ1-5
TGTGCCAGCACCATGGGACAGTCACCCCTCCACTTT	CASTMGQSPLHF	TRBV28	TRBJ1-6
TGCGCCAGCAGTGAGTGTCGGGACTCGGATGAGCAGTTCTTC	CASSECRDSDEQFF	TRBV10-1	TRBJ2-1
TGTGCCAGCAGTGTGGACATAGTCAGCAATCAGCCCCAGCATTTT	CASSVDIVSNQPQHF	TRBV28	TRBJ1-5
TGTGCCAGCAGCCCTGGATGGACTAGCGGACCTTGGAACACCGGGGAGCTGTTTTTT	CASSPGWTSGPWNTGELFF	TRBV7-9	TRBJ2-2
TGTGTAGCGAGGGCAGATACGCAGTATTTT	CVARADTQYF	TRBV6-1	TRBJ2-3
TGTGCCAGCAGGCTTTTAACGATTATCCACAATGAGCAGTTCTTC	CASRLLTIIHNEQFF	TRBV28	TRBJ2-1
TGTGCCAGCAGCGGGGTAGAGGGCGCTGCCTACGAGCAGTACTTC	CASSGVEGAAYEQYF	TRBV7-3	TRBJ2-7
TGTGCCAGCAGCCCCGCTAAGCGGGGACGAACCCAGCCCCAGCATTTT	CASSPAKRGRTQPQHF	TRBV3-1	TRBJ1-5
TGTGCCAGCAGCCACTTATGCGACAGGCCCAGCTCCTACGAGCAGTACTTC	CASSHLCDRPSSYEQYF	TRBV7-9	TRBJ2-7
TGTGCCAGCCTACTTTCCGATTGGCTCAAAAACAAGAACAATGAGCAGTTCTTC	CASLLSDWLKNKNNEQFF	TRBV12-3	TRBJ2-1
TGCAGCGGAGGATGGTGGGAGTACAATGAGCAGTTCTTC	CSGGWWEYNEQFF	TRBV29-1	TRBJ2-1
TGTGCCACCAGCAGAATGCCTGGAAGCTACACTGAAGCTTTCTTT	CATSRMPGSYTEAFF	TRBV15	TRBJ1-1
TGTGCCAGCAGCTCCCCCGAGCCAGGCGGTCACAGGAATCAGCCCCAGCATTTT	CASSSPEPGGHRNQPQHF	TRBV3-1	TRBJ1-5
TGTGCCACCAGTGCGCGGCCACCGGGGGCCTCCTACGAGCAGTACTTC	CATSARPPGASYEQYF	TRBV24-1	TRBJ2-7
TGTGCCAGCAGTCCCGTTGGATCCAATGAGCAGTTCTTC	CASSPVGSNEQFF	TRBV12-3	TRBJ2-1
TGTGCCAGCAGCCCATGGGGGACAGGGGCTGCCTACGAGCAGTACTTC	CASSPWGTGAAYEQYF	TRBV6-5	TRBJ2-7
TGCGCCAGCAGCTTGGCGGGGCATCCTAGGGTAGAGACCCAGTACTTC	CASSLAGHPRVETQYF	TRBV5-1	TRBJ2-5
TGTGCCATCAGGCCAAGACAGGGGCAGGCCGCTAATGAAAAACTGTTTTTT	CAIRPRQGQAANEKLFF	TRBV10-3	TRBJ1-4
TGCGCCAGCAGCTTGAAAGGGGGAGACACAGATACGCAGTATTTT	CASSLKGGDTDTQYF	TRBV5-1	TRBJ2-3
TGTGCCAGCAGCGACGGACAGGGTAAGAGGGCGCAGAACACTGAAGCTTTCTTT	CASSDGQGKRAQNTEAFF	TRBV7-9	TRBJ1-1
TGTGCCAGCAGCGGTTACCGGAGCTCTAACTATGGCTACACCTTC	CASSGYRSSNYGYTF	TRBV5-4	TRBJ1-2
TGCAGTGCTCTACAGGGCCGCCCCACCGGGGAGCTGTTTTTT	CSALQGRPTGELFF	TRBV20-1	TRBJ2-2
TGTGCCAGCATCAAACGCTATGGCTACACCTTC	CASIKRYGYTF	TRBV3-1	TRBJ1-2
TGTGCCAGCAGGGGAACAGGGAGAAGCGAGCAGTACTTC	CASRGTGRSEQYF	TRBV6-5	TRBJ2-7
TGTGCCAGCAGCTTAGCCCCACCGGATGAGCAGTTCTTC	CASSLAPPDEQFF	TRBV7-9	TRBJ2-1
TGTGCCAGCAGCCAAGCAAGGAACACTGAAGCTTTCTTT	CASSQARNTEAFF	TRBV11-3	TRBJ1-1
TGTGCCAGCAGCTTGGGGGCCGTCGACAGGGGGGAGTTGCCTGAAGCTTTCTTT	CASSLGAVDRGELPEAFF	TRBV5-6	TRBJ1-1
TGCAGTGCTTACGTCGACAGGCGGAGCTCCTATAATTCACCCCTCCACTTT	CSAYVDRRSSYNSPLHF	TRBV20-1	TRBJ1-6
TGTGCCAGCAGTTATTGGGCCACTGAAGCTTTCTTT	CASSYWATEAFF	TRBV6-5	TRBJ1-1
TGTGCCATCAGCCACAGGGGCATGTATTTGCCAATCTTCTTT	CAISHRGMYLPIFF	TRBV10-3	TRBJ1-1
TGTGCCAGCAGCTTACAGCTCCCACGCGGAGCTAACTATGGCTACACCTTC	CASSLQLPRGANYGYTF	TRBV7-3	TRBJ1-2
TGTGCCACCAACCCTGGGGGCGCAGACTATGGCTACACCTTC	CATNPGGADYGYTF	TRBV24-1	TRBJ1-2
TGTGCCAGCAGAAGGGTAAAACCCCATAATTCACCCCTCCACTTT	CASRRVKPHNSPLHF	TRBV2	TRBJ1-6
TGCGCCAGCAGCTTGGGGCAGAATGAGCAGTTCTTC	CASSLGQNEQFF	TRBV5-1	TRBJ2-1
TGTGCCAGCAGTTTAGGGACAGGGGCCGGAAACCAAGAGACCCAGTACTTC	CASSLGTGAGNQETQYF	TRBV12-4	TRBJ2-5
TGTGCCAGCAGTTACTCTCCACAAAACGGGACTAGCCGTTACAATGAGCAGTTCTTC	CASSYSPQNGTSRYNEQFF	TRBV6-5	TRBJ2-1
TGTGCCAGCAGTTGCGGTCCCTGGGACAGGTCGCCTAATGAAAAACTGTTTTTT	CASSCGPWDRSPNEKLFF	TRBV6-9	TRBJ1-4
TGTGCCAGCAGTGGATTCACGGCGCTATGCGGGGGCCCTTTCTATGGCTACACCTTC	CASSGFTALCGGPFYGYTF	TRBV6-5	TRBJ1-2
TGTGCCAGCAGCTCTGAGAAGGCCGGCTACACCTTC	CASSSEKAGYTF	TRBV13	TRBJ1-2
TGTGCCAGCAGTTTGTGCCTCGGCCCCTACGAGCAGTACTTC	CASSLCLGPYEQYF	TRBV27	TRBJ2-7
TGTGCCAGCAGCTTACTGTACCTGGCGGGAGTGACCGGGGACTTAGGCAATGAGCAGTTCTTC	CASSLLYLAGVTGDLGNEQFF	TRBV7-9	TRBJ2-1
TGTGCCAGCAGCTCGGGCAGGAAGGGTCGCAAAAACATTCAGTACTTC	CASSSGRKGRKNIQYF	TRBV5-4	TRBJ2-4
TGTGCCAGCATGGCGCGACTAGCGGGGGAAGCGGGGGACGAGCAGTACTTC	CASMARLAGEAGDEQYF	TRBV12-3	TRBJ2-7
TGCGCCAGCAGTAAAACGACTAGCGGGGAACAGTACCAAGAGACCCAGTACTTC	CASSKTTSGEQYQETQYF	TRBV10-2	TRBJ2-5
TGCGCCAGCAGCGGTGATAATCAGCCCCAGCATTTT	CASSGDNQPQHF	TRBV10-2	TRBJ1-5
TGTGCCAGCAGCGGTAACAGGGAAGGGGAAAACTATGGCTACACCTTC	CASSGNREGENYGYTF	TRBV7-9	TRBJ1-2
TGCAGTGCTAGAAAGGAAGGCGGGAGCACAGATACGCAGTATTTT	CSARKEGGSTDTQYF	TRBV20-1	TRBJ2-3
TGCGCCAGCAGCCACAGGGTTGGCTACACCTTC	CASSHRVGYTF	TRBV10-1	TRBJ1-2
TGTGCCAGCACGCCCCAGGTGGGGCCTGGCTACACCTTC	CASTPQVGPGYTF	TRBV11-2	TRBJ1-2
TGTGCCAGCAGCACCAGTGCAGATCTTAACTATGGCTACACCTTC	CASSTSADLNYGYTF	TRBV13	TRBJ1-2
TGTGCCACCAGCGCCCGGGAGATCACAGATACGCAGTATTTT	CATSAREITDTQYF	TRBV15	TRBJ2-3
TGTGCCAGCAGTTTATGCGCGTGGGAAATTCAGCCCCAGCATTTT	CASSLCAWEIQPQHF	TRBV28	TRBJ1-5
TGCAGTGCTAGAGTACAATGGGTTGCCCGGCACCCCGCATATAGCAATCAGCCCCAGCATTTT	CSARVQWVARHPAYSNQPQHF	TRBV20-1	TRBJ1-5
TGTGCCAGCAGTGCCCGCTCGACTAGCGGGCTAGCCTACAATGAGCAGTTCTTC	CASSARSTSGLAYNEQFF	TRBV27	TRBJ2-1
TGTGCCAGCAGCTTGCCCTCCTCCCGGGACGGCAATCAGCCCCAGCATTTT	CASSLPSSRDGNQPQHF	TRBV5-6	TRBJ1-5
TGTGCCAGCAGAGGGGGCCCGCCCTACGAGCAGTACTTC	CASRGGPPYEQYF	TRBV7-2	TRBJ2-7
TGTGCCAGCAGCCAAGCCGGGACCGGGATTGTCGGGAACAATGAGCAGTTCTTC	CASSQAGTGIVGNNEQFF	TRBV4-2	TRBJ2-1
TGTGCCACCTTAACCGGGGGGCGACATCAACATAGCAATCAGCCCCAGCATTTT	CATLTGGRHQHSNQPQHF	TRBV24-1	TRBJ1-5
TGTGCCATCAGACAGGCGGCGTACCAAGAGACCCAGTACTTC	CAIRQAAYQETQYF	TRBV10-3	TRBJ2-5
TGTGCCAGCAGCGGGCAGGGGGCTCAGCCCCAGCATTTT	CASSGQGAQPQHF	TRBV11-2	TRBJ1-5
TGTGCCAGCAGCTTGGAGACTCGGGCCGGCTACATTCAGTACTTC	CASSLETRAGYIQYF	TRBV5-4	TRBJ2-4
TGTGCCAGCAGCCAGAACTCGAGTACCCTTCAGGGGGAGGCCGGGGAGCTGTTTTTT	CASSQNSSTLQGEAGELFF	TRBV3-1	TRBJ2-2
TGTGCCAGCAGCGCCAGGGAGTGTCAGCCCCAGCATTTT	CASSARECQPQHF	TRBV7-3	TRBJ1-5
TGTGCCAGCAGTGGTGTCTTCTTAGACAAGAACACTGAAGCTTTCTTT	CASSGVFLDKNTEAFF	TRBV2	TRBJ1-1
TGTGCCACCAGCAGGCCCCCCGGGACCGACTCACCCCTCCACTTT	CATSRPPGTDSPLHF	TRBV15	TRBJ1-6
TGCAGTGCTGGCCCAACAGGGAGGGGTAGGTTAAGCTCCTACGAGCAGTACTTC	CSAGPTGRGRLSSYEQYF	TRBV20-1	TRBJ2-7
TGTGCCAGCAGTAGAGACAGGGGGAACGAGCAGTACTTC	CASSRDRGNEQYF	TRBV6-4	TRBJ2-7
TGTGCCAGCTCAAAGAGAAATATACCCCCAGATACGCAGTATTTT	CASSKRNIPPDTQYF	TRBV18	TRBJ2-3
TGTGCCAGCAGCTTAGATCTTAAGCTAGCGGGGGTAAACACCGGGGAGCTGTTTTTT	CASSLDLKLAGVNTGELFF	TRBV11-3	TRBJ2-2
TGTGCCAGCAGCGGAGCCGGGACCAAGAGCAATCAGCCCCAGCATTTT	CASSGAGTKSNQPQHF	TRBV6-4	TRBJ1-5
TGTGCCAGCAGCCTGGGGATTTATAGCAATCAGCCCCAGCATTTT	CASSLGIYSNQPQHF	TRBV5-4	TRBJ1-5
TGTGCCAGCAGCGGGCTCCCCCTAAGCACAGATACGCAGTATTTT	CASSGLPLSTDTQYF	TRBV2	TRBJ2-3
TGCAGTGCTCCAGGGGGTCACCATTATAGCAATCAGCCCCAGCATTTT	CSAPGGHHYSNQPQHF	TRBV20-1	TRBJ1-5
TGTGCCACCACAGGGGACAGGGGGGGTTTGGGGTCCGAAATTTACGAGCAGTACTTC	CATTGDRGGLGSEIYEQYF	TRBV24-1	TRBJ2-7
TGTGCCAGCAGCGGGATAGTGGGACTAGCCAGCTCCTACGAGCAGTACTTC	CASSGIVGLASSYEQYF	TRBV13	TRBJ2-7
TGTGCCAGCAAAACAAAATCGAGAGCCGGGCTCTCTGGGGCCAACGTCCTGACTTTC	CASKTKSRAGLSGANVLTF	TRBV27	TRBJ2-6
TGTGCCTTCCCTTTCCTAGCGGGCCTTAAAGACGCAGATACGCAGTATTTT	CAFPFLAGLKDADTQYF	TRBV19	TRBJ2-3
TGTGCCAGCAGCATCCAGGGCACGGCCTACGAGCAGTACTTC	CASSIQGTAYEQYF	TRBV11-2	TRBJ2-7
TGCAGCGTTGAAGAGCGGCATTGGGGGGGGGTAGGTATCCTTCAGCCCCAGCATTTT	CSVEERHWGGVGILQPQHF	TRBV29-1	TRBJ1-5
TGTGCCAGCAGGGGAGTCTATACAGATACGCAGTATTTT	CASRGVYTDTQYF	TRBV28	TRBJ2-3
TGTGCCATCAGTGATCCCTCGGGTCGGGAGCAGTACTTC	CAISDPSGREQYF	TRBV10-3	TRBJ2-7
TGTGCCAGCAGTGGGCCCACGGTCAGGAACACCGGGGAGCTGTTTTTT	CASSGPTVRNTGELFF	TRBV6-4	TRBJ2-2
TGTGCCAGCAGCTTAGTACAGCTGAGTCTTCGCCGCACCGGGGAGCTGTTTTTT	CASSLVQLSLRRTGELFF	TRBV7-9	TRBJ2-2
TGTGCCAGCAGTTCCCGGCGGCCAAACACTGAAGCTTTCTTT	CASSSRRPNTEAFF	TRBV28	TRBJ1-1
TGTGCCACCAGTGATTTGAGCCACAGGGTCCGCTCCTACGAGCAGTACTTC	CATSDLSHRVRSYEQYF	TRBV24-1	TRBJ2-7
TGTGCCAGCAGGGGGGAGACCCAGTACTTC	CASRGETQYF	TRBV2	TRBJ2-5
TGTGCCAGCAATGGGGGCATACCCTACGAGCAGTACTTC	CASNGGIPYEQYF	TRBV27	TRBJ2-7
TGCAGTGCTTCACGAGGCTTTAGGGTAGAGCAGTTCTTC	CSASRGFRVEQFF	TRBV20-1	TRBJ2-1
TGTGCCAGCCGGCCAGCCGGGACCGTGGGGGAGACCCAGTACTTC	CASRPAGTVGETQYF	TRBV2	TRBJ2-5
TGTGCCAGCAGCTCCGACAGTCAGGTTGGCTACACCTTC	CASSSDSQVGYTF	TRBV7-9	TRBJ1-2
TGTGCCAGCAATGGACAGGGAGGCAGCTACGAGCAGTACTTC	CASNGQGGSYEQYF	TRBV27	TRBJ2-7
TGCGCCAGCAGCTGGGGGGGCGGGGGGGAGTATTTT	CASSWGGGGEYF	TRBV5-1	TRBJ2-3
TGTGCCAGCAGTGACCCCCGACAGGAGGTGAGCACTGAAGCTTTCTTT	CASSDPRQEVSTEAFF	TRBV6-4	TRBJ1-1
TGCAGTGCTACTATACTAGCGGGAGCACTCAGCTCCTACGAGCAGTACTTC	CSATILAGALSSYEQYF	TRBV20-1	TRBJ2-7
TGCGCCAGACTAGCGGGGGGGCTGGGCAGAAACGAGCAGTACTTC	CARLAGGLGRNEQYF	TRBV10-1	TRBJ2-7
TGTGCCAGCAGCTTTCGCCTGTGCGGTCATCAGCCCCAGCATTTT	CASSFRLCGHQPQHF	TRBV7-9	TRBJ1-5
TGTGCCAGCAGCAGGACAGGGGGTTATGGTAACTCCTACAATGAGCAGTTCTTC	CASSRTGGYGNSYNEQFF	TRBV13	TRBJ2-1
TGTGCCAGCAGCTACGATGCCCGGGCGCATCAGCCCCAGCATTTT	CASSYDARAHQPQHF	TRBV11-1	TRBJ1-5
TGTGCCAGCAGCCAAGCCCCCTTGAGGGTCGTTTCTGGAAACACCATATATTTT	CASSQAPLRVVSGNTIYF	TRBV3-1	TRBJ1-3
TGTGCCATGAGCAATCAGCCCCAGCATTTT	CAMSNQPQHF	TRBV10-3	TRBJ1-5
TGTGCCAGCAGCGTCCTAGAGCAGGGGGATGGCTACACCTTC	CASSVLEQGDGYTF	TRBV9	TRBJ1-2
TGTGCTAGCAGCTGGGGGCCCGGAGGAAACACCATATATTTT	CASSWGPGGNTIYF	TRBV7-7	TRBJ1-3
TGTGCCAGCCCCCGGGGGCGGGGCTATGGCTACACCTTC	CASPRGRGYGYTF	TRBV5-6	TRBJ1-2
TGTGCCAGCTCACCACCAGGGGAGATGAACACTGAAGCTTTCTTT	CASSPPGEMNTEAFF	TRBV18	TRBJ1-1
TGTGCCACCAGTGATTTGCGTAGGGAGGTCGACTACGAGCAGTACTTC	CATSDLRREVDYEQYF	TRBV24-1	TRBJ2-7
TGTGCTAGCAGCTTACAGGGGGGGGAGATCTATGGCTACACCTTC	CASSLQGGEIYGYTF	TRBV7-7	TRBJ1-2
TGTGCCAGCAGCTTACGCAGGGCAAGAACTAATGAAAAACTGTTTTTT	CASSLRRARTNEKLFF	TRBV7-8	TRBJ1-4
TGTGCCAGCTCACAGCGGACAATCGCGACCCAGTACTTC	CASSQRTIATQYF	TRBV18	TRBJ2-5
TGTGCCAGCAGTTTATGGCCCCTGGACAGGGAGCAAGAGACCCAGTACTTC	CASSLWPLDREQETQYF	TRBV27	TRBJ2-5
TGTGCCACCAACTACCTAGGCTACACCTTC	CATNYLGYTF	TRBV15	TRBJ1-2
TGTGCCAGCAGCTTTCCAGCTCAAGAGACCCAGTACTTC	CASSFPAQETQYF	TRBV7-2	TRBJ2-5
TGTGCCATTCGTCCGGTAGATCAGCCCCAGCATTTT	CAIRPVDQPQHF	TRBV6-1	TRBJ1-5
TGCGCCAGCAGTGATCTAGTTATAACCGGCAATGAGCAGTTCTTC	CASSDLVITGNEQFF	TRBV10-1	TRBJ2-1
TGTGCCAGCAGCATGACAGACCCCGGACATAACTATGGCTACACCTTC	CASSMTDPGHNYGYTF	TRBV7-3	TRBJ1-2
TGTGCCACCAGCAGACAACCAACAGGGGGCCTCAGACCGACCCAGTACTTC	CATSRQPTGGLRPTQYF	TRBV15	TRBJ2-5
TGTGCCAGCATATCAATCTACAATGAGCAGTTCTTC	CASISIYNEQFF	TRBV28	TRBJ2-1
TGTGCCAGCAGCGTAGGAAAAGTGGGGGAACCCTACGAGCAGTACTTC	CASSVGKVGEPYEQYF	TRBV9	TRBJ2-7
TGTGCCAGCAGCTCAGGATGGTTCTACGAGCAGTACTTC	CASSSGWFYEQYF	TRBV11-3	TRBJ2-7
TGTGCCAGCAGCCAACCCCAGACCCCGTCCTACGAGCAGTACTTC	CASSQPQTPSYEQYF	TRBV14	TRBJ2-7
TGTGCCAGCAGAAAGGGACACTATGGCTACACCTTC	CASRKGHYGYTF	TRBV7-3	TRBJ1-2
TGTGCCAGCAGTTACTTTTACCACTCCATGAACACTGAAGCTTTCTTT	CASSYFYHSMNTEAFF	TRBV6-5	TRBJ1-1
TGTGCCAATACAGGGGGGTATGGCTACACCTTC	CANTGGYGYTF	TRBV27	TRBJ1-2
TGTGCCAGCAGTGGGGACAGGGCCTACGAGCAGTACTTC	CASSGDRAYEQYF	TRBV27	TRBJ2-7
TGTGCCATCACCTACATGACCTACGAGCAGTACTTC	CAITYMTYEQYF	TRBV10-3	TRBJ2-7
TGTGCCAGCAAACATGGTATCCAAGAGACCCAGTACTTC	CASKHGIQETQYF	TRBV6-5	TRBJ2-5
TGCAGTGCTAGAGTACCAGACAGGGGGCTACGCAATCAGCCCCAGCATTTT	CSARVPDRGLRNQPQHF	TRBV20-1	TRBJ1-5
TGTGCCAGCAGCGTAATGACTCAAAACATTCAGTACTTC	CASSVMTQNIQYF	TRBV9	TRBJ2-4
TGTGCCAGCAGTTACTCCCGTCGGGACAGGGATCCCAGCAATCAGCCCCAGCATTTT	CASSYSRRDRDPSNQPQHF	TRBV6-3	TRBJ1-5
TGTGCCAGCAGTGAACCCCTGGGACAGGTTTGGCACATGAACACTGAAGCTTTCTTT	CASSEPLGQVWHMNTEAFF	TRBV25-1	TRBJ1-1
TGTGCCAGCAGCCAAGATGTGAATCACCGGAACACTGAAGCTTTCTTT	CASSQDVNHRNTEAFF	TRBV14	TRBJ1-1
TGTGCCAGCAGCTTTCTTCAAATAACTAACTATGGCTACACCTTC	CASSFLQITNYGYTF	TRBV11-3	TRBJ1-2
TGTGCCAGCAGCTTACTTGATCAGGGTAAGTGCAATCAGCCCCAGCATTTT	CASSLLDQGKCNQPQHF	TRBV7-6	TRBJ1-5
TGTGCTAGCCGGCTAGCCAAAAACATTCAGTACTTC	CASRLAKNIQYF	TRBV12-5	TRBJ2-4
TGTGCCACCAGCAGCTTTCGGGGGGGAAATGGGGACGTCTACGAGCAGTACTTC	CATSSFRGGNGDVYEQYF	TRBV15	TRBJ2-7
TGTGCCAGCAGCTTAGGTATTCATGTTCGGGAGAACACTGAAGCTTTCTTT	CASSLGIHVRENTEAFF	TRBV7-4	TRBJ1-1
TGCCCGGAACCCCAGGGGGCTCGTTCGGGGCCCCAGCATTTT	CPEPQGARSGPQHF	TRBV29-1	TRBJ1-5
TGTGCCAGCAGTTACCTAACTAGCGGGGACCGCGACAATGAGCAGTTCTTC	CASSYLTSGDRDNEQFF	TRBV6-5	TRBJ2-1
TGTGCCACCAGTGATGAAGGACTAGCGGGGCGAGGGAAATTCCAAGAGACCCAGTACTTC	CATSDEGLAGRGKFQETQYF	TRBV24-1	TRBJ2-5
TGTGCCAGCAGCCAGGGGACCCTTGACTCCTATAATTCACCCCTCCACTTT	CASSQGTLDSYNSPLHF	TRBV6-4	TRBJ1-6
TGCATTTGGGACGGCGATCTATCCTACAATGAGCAGTTCTTC	CIWDGDLSYNEQFF	TRBV20-1	TRBJ2-1
TGTGCCAGCAGCTTGCTTTTCATCGGGACAGGAAGCCCCAACACCGGGGAGCTGTTTTTT	CASSLLFIGTGSPNTGELFF	TRBV5-5	TRBJ2-2
TGCAGCGCCTGGGCCTACGAGCAGTACTTC	CSAWAYEQYF	TRBV29-1	TRBJ2-7
TGTGCCAGCAGTAGGGGACAGGGGGCTCAGGAAGCTTTCTTT	CASSRGQGAQEAFF	TRBV27	TRBJ1-1
TGTGCCAGCAGCGGGGGTCCCAATGAGCAGTTCTTC	CASSGGPNEQFF	TRBV13	TRBJ2-1
TGCGCCAGCAGCTTATCGGGGGGCAGAGACTATAATTCACCCCTCCACTTT	CASSLSGGRDYNSPLHF	TRBV5-1	TRBJ1-6
TGTGCCAGCAGTGACGGGCCCCCGAACACCGGGGAGCTGTTTTTT	CASSDGPPNTGELFF	TRBV2	TRBJ2-2
TGCAGTGCTGGTTCTAGGGGACCTAATACGCAGTATTTT	CSAGSRGPNTQYF	TRBV20-1	TRBJ2-3
TGTGCCAGCAGCTACCCGCGTGACACAGATACGCAGTATTTT	CASSYPRDTDTQYF	TRBV7-4	TRBJ2-3
TGTGCCAGCAGGCCGGGGGGATACTCCTACGAGCAGTACTTC	CASRPGGYSYEQYF	TRBV6-1	TRBJ2-7
TGTGCCAGCAGCCTCAAGAAGAATGGCATTATGTGCCTCTACGAGCAGTACTTC	CASSLKKNGIMCLYEQYF	TRBV13	TRBJ2-7
TGTGCCAGCAGCGCTCAGGGGGCAGGTCCCCAAGAGACCCAGTACTTC	CASSAQGAGPQETQYF	TRBV11-1	TRBJ2-5
TGTGCCTGGAGTACCCCGGGAGGGCCCTTGGTTGAAAAACTGTTTTTT	CAWSTPGGPLVEKLFF	TRBV30	TRBJ1-4
TGTGCCAGCAGCCTCCCACAGGGACCCCTAGCCAAAAACATTCAGTACTTC	CASSLPQGPLAKNIQYF	TRBV3-1	TRBJ2-4
TGTGCCAGCAGCCCGACAGGGAGGAGCACAGATACGCAGTATTTT	CASSPTGRSTDTQYF	TRBV7-8	TRBJ2-3
TGTGCCAGTAGTCCCCGGGACAGGGCTGAAGCTTTCTTT	CASSPRDRAEAFF	TRBV19	TRBJ1-1
TGTGCCAGCAGCTTACTCCCTGGGGGCGAGGGGATTAAACAGCCCCAGCATTTT	CASSLLPGGEGIKQPQHF	TRBV7-2	TRBJ1-5
TGTGCCTACAGGACAGAGATGGCCTACGAGCAGTACTTC	CAYRTEMAYEQYF	TRBV11-3	TRBJ2-7
TGTGCCAGCAGGCGACAGGGCGATAATTCACCCCTCCACTTT	CASRRQGDNSPLHF	TRBV6-5	TRBJ1-6
TGTGCCAGCAGTTTCGGGGGATATACAGATACGCAGTATTTT	CASSFGGYTDTQYF	TRBV27	TRBJ2-3
TGCGCCAGCAGCTCAAGCGGATGGGGTAGGGGAGGCCAAGAGACCCAGTACTTC	CASSSSGWGRGGQETQYF	TRBV5-1	TRBJ2-5
TGTGCCAGCCTGACTAGCGGGGGTGAGACCCAGTACTTC	CASLTSGGETQYF	TRBV7-2	TRBJ2-5
TGTGCTAGCAGCGTGGGGGTTCAGCCCCAGCATTTT	CASSVGVQPQHF	TRBV7-7	TRBJ1-5
TGTGCCAGCAGCTTGGCTCACCTGGACAGGGAACAGCCCCAGCATTTT	CASSLAHLDREQPQHF	TRBV5-5	TRBJ1-5
TGCGCCAGCAGCCAGAGGGGACGTCCTGTTGTAAGAGGCTACACCTTC	CASSQRGRPVVRGYTF	TRBV4-1	TRBJ1-2
TGTGCCAGCAGTGATACACGGTCGCTCGTCGAGCAGTACTTC	CASSDTRSLVEQYF	TRBV6-5	TRBJ2-7
TGTGCCAGCAGCACCCCCCTACTGGACGGGGAGCTGTTTTTT	CASSTPLLDGELFF	TRBV13	TRBJ2-2
TGTGCCAGCAGCAAAGTGTCTTCCAACGATTGGGTCGGCTACACCTTC	CASSKVSSNDWVGYTF	TRBV9	TRBJ1-2
TGTGCCAGCAGTTTGACATCCCGGGCCGGGCCCCAGCATTTT	CASSLTSRAGPQHF	TRBV28	TRBJ1-5
TGCAGTGCTAGAGCCCGGGGACTAGAGACCCAGTACTTC	CSARARGLETQYF	TRBV20-1	TRBJ2-5
TGTGCCAGCAGCCTGCGGGAGCTATACGAGCAGTACTTC	CASSLRELYEQYF	TRBV5-5	TRBJ2-7
TGCGCCAGCACATACCGGAGGGCCTACGAGCAGTACTTC	CASTYRRAYEQYF	TRBV10-1	TRBJ2-7
TGTGCTAGTGGTTTGGTCAATTCTGACAGGGGGCCCGCCGGGCAGCCCCAGCATTTT	CASGLVNSDRGPAGQPQHF	TRBV12-5	TRBJ1-5
TGTGCCATCGGGCGGGGCTCCTACGAGCAGTACTTC	CAIGRGSYEQYF	TRBV10-3	TRBJ2-7
TGTGCCAGCAGGTGTCTTACCACGGAAAAACTGTTTTTT	CASRCLTTEKLFF	TRBV28	TRBJ1-4
TGTGCCGAGGTGGGGGCAACTAATAGCAATCAGCCCCAGCATTTT	CAEVGATNSNQPQHF	TRBV5-4	TRBJ1-5
TGTGCCTGGAGAGAGCTAAATTATATTTCGGGACAGGGTCGGAGGGGAAGTAATCAGCCCCAGCATTTT	CAWRELNYISGQGRRGSNQPQHF	TRBV30	TRBJ1-5
TGTGCCAGCAGCAAGGGGGGCGAAACTGAAGCTTTCTTT	CASSKGGETEAFF	TRBV7-3	TRBJ1-1
TGTGCCGACCGGGACAGGGGGGCCTACGAGCAGTACTTC	CADRDRGAYEQYF	TRBV27	TRBJ2-7
TGTGCCAGCAGTGGGGGGGCCAAGGAGACCCAGTACTTC	CASSGGAKETQYF	TRBV6-1	TRBJ2-5
TGTGCCACCAGTGAAAAGGTACCTAGAGGAAATTCACCCCTCCACTTT	CATSEKVPRGNSPLHF	TRBV24-1	TRBJ1-6
TGTGCCAGCAGAATTAGGCCAATTGGACTCTACAATGAGCAGTTCTTC	CASRIRPIGLYNEQFF	TRBV11-2	TRBJ2-1
TGTGCCTGGAATCGCTACAGTCCTAGCGGGGCAGATACGCAGTATTTT	CAWNRYSPSGADTQYF	TRBV30	TRBJ2-3
TGTGCCAGCAGTTACTCGTTTGGGGGCGGGGATAACTATGGCTACACCTTC	CASSYSFGGGDNYGYTF	TRBV6-5	TRBJ1-2
TGTGCCAGTAGTATCTCGGGGGACAGAGAAGCGGAAAAACTGTTTTTT	CASSISGDREAEKLFF	TRBV19	TRBJ1-4
TGTGCCAGCATTCTAGGGGGACTTCACGGGAGCTCTTCAATGGATACTGAAGCTTTCTTT	CASILGGLHGSSSMDTEAFF	TRBV6-4	TRBJ1-1
TGTGCCAGCAGCTTTTGGACAGGGGTTTACGAGCAGTACTTC	CASSFWTGVYEQYF	TRBV7-2	TRBJ2-7
TGTGCCAGCAGCGTAACAGACGCGAACACTGAAGCTTTCTTT	CASSVTDANTEAFF	TRBV9	TRBJ1-1
TGCAGTGCTAGAATGGAGGAGCTAGGGGGGGAACCACACAATGAGCAGTTCTTC	CSARMEELGGEPHNEQFF	TRBV20-1	TRBJ2-1
TGTGCCAGCAGCTGGATTATAGGAGATGAGACCCAGTACTTC	CASSWIIGDETQYF	TRBV7-3	TRBJ2-5
TGTGCCAGCAGCTTACTGGTCAAAAACATTCAGTACTTC	CASSLLVKNIQYF	TRBV7-3	TRBJ2-4
TGTGCCAGCACGTTTTGGGTGTCCTCCTACGAGCAGTACTTC	CASTFWVSSYEQYF	TRBV25-1	TRBJ2-7
TGTGCCAGCAGGCCGGGACCCCTTCGAGGGGACGAGCAGTACTTC	CASRPGPLRGDEQYF	TRBV6-6	TRBJ2-7
TGTGCCAGCAGCGGGACAGGGCGGCGAACCTACGAGCAGTACTTC	CASSGTGRRTYEQYF	TRBV7-3	TRBJ2-7
TGTGCCAGCAGTGCCTGGGCCGAGCAGTACTTC	CASSAWAEQYF	TRBV25-1	TRBJ2-7
TGCGCCAGCAGCTTCTGGGACAGGGGACCTACAGCCGTGGAAACAGATACGCAGTATTTT	CASSFWDRGPTAVETDTQYF	TRBV5-1	TRBJ2-3
TGTGCCACCTATGAAGCTTTCTTT	CATYEAFF	TRBV15	TRBJ1-1
TGTGCCACCAGTGATTTAAAAGCAGAGAGACAGGGGCTCCTGGGTAGCAATCAGCCCCAGCATTTT	CATSDLKAERQGLLGSNQPQHF	TRBV24-1	TRBJ1-5
TGTGCCAGTGTTATCAGGGGAGGTTTGTACGAGCAGTACTTC	CASVIRGGLYEQYF	TRBV28	TRBJ2-7
TGCGCCAGCAGCCAAAGAGGGTGGGATGGCTACACCTTC	CASSQRGWDGYTF	TRBV4-1	TRBJ1-2
TGTGCCAGCAGTTTCTTCGACAGGGGGGAAGAAACCTACGAGCAGTACTTC	CASSFFDRGEETYEQYF	TRBV12-3	TRBJ2-7
TGCAGCATTGGGGCGGGCTACGAGCAGTACTTC	CSIGAGYEQYF	TRBV29-1	TRBJ2-7
TGTGCCACCAGCAGAGATACAAGGTGTCCATTTCCAAGAATAGGCACAGATACGCAGTATTTT	CATSRDTRCPFPRIGTDTQYF	TRBV15	TRBJ2-3
TGTGCCACCAGTGTGGGACAGGGACAAGTGATTGCTTTCTTT	CATSVGQGQVIAFF	TRBV24-1	TRBJ1-1
TGCGCCAGCACCCAAGAGGGACGGATGAACACTGAAGCTTTCTTT	CASTQEGRMNTEAFF	TRBV10-1	TRBJ1-1
TGTGCCAGCAGTTGTTGGACAGGCGTAACTAATGAAAAACTGTTTTTT	CASSCWTGVTNEKLFF	TRBV6-2	TRBJ1-4
TGTGCCAGCAGCACCGCTCCTGAAAACATGAACACTGAAGCTTTCTTT	CASSTAPENMNTEAFF	TRBV13	TRBJ1-1
TGCAGTGCTAGCATTGGGGAGTACCAAGAGACCCAGTACTTC	CSASIGEYQETQYF	TRBV20-1	TRBJ2-5
TGTGCCAGCAGCCAAGATTCTCCGGGACAGAACTATGGCTACACCTTC	CASSQDSPGQNYGYTF	TRBV4-2	TRBJ1-2
TGTGCCAGCAATCTAGTCGAATACAATGAGCAGTTCTTC	CASNLVEYNEQFF	TRBV28	TRBJ2-1
TGTGCCAGCAGTTACGCCTCCGAGGGTAGATTCCGTGCTGCTGAGCAGTTCTTC	CASSYASEGRFRAAEQFF	TRBV6-3	TRBJ2-1
TGTGCCAGCAGCCCGGGACTAGTTTGGAAGTCGGCCTACGAGCAGTACTTC	CASSPGLVWKSAYEQYF	TRBV7-3	TRBJ2-7
TGTGCCAGCAGTTACTCGACCCGTCCGGGGAGCACGGGAACCGAGCAGTACTTC	CASSYSTRPGSTGTEQYF	TRBV6-5	TRBJ2-7
TGTGCCAGCAGTTTATCCGGGAAAGGACGGCTGGGCTCTGGAAACACCATATATTTT	CASSLSGKGRLGSGNTIYF	TRBV27	TRBJ1-3
TGCAGTGCACCTAGTCAACGATCCCCCGGGGAGCTGTTTTTT	CSAPSQRSPGELFF	TRBV20-1	TRBJ2-2
TGTGCCAGCAGTTTCCTTCGCACCGGGACAGTTTCCGAAGGGGCCAACGTCCTGACTTTC	CASSFLRTGTVSEGANVLTF	TRBV28	TRBJ2-6
TGCAGCGTTCCCCTGGACAGGGGTCCCGACGAGCAGTACTTC	CSVPLDRGPDEQYF	TRBV29-1	TRBJ2-7
TGTGCCAGCAGTTTACATGTCGCGGAACTCCACACAGATACGCAGTATTTT	CASSLHVAELHTDTQYF	TRBV27	TRBJ2-3
TGTGCCAGCAGCCAGGACAGGGGAATTAGCTCTGGAAACACCATATATTTT	CASSQDRGISSGNTIYF	TRBV3-1	TRBJ1-3
TGTGCCAGCAGTGATAGGGGGGGAGGGGAGCAGTTCTTC	CASSDRGGGEQFF	TRBV27	TRBJ2-1
TGTGCCACCAGCAGGCTTGCAGGGGGCGTTGCAACTAATGAAAAACTGTTTTTT	CATSRLAGGVATNEKLFF	TRBV24-1	TRBJ1-4
TGTGCCAGCAGCGCCCGGAGGGATGGTGAGCAGTTCTTC	CASSARRDGEQFF	TRBV9	TRBJ2-1
TGTGCCAAGAGGGGGATGGTCACTGAAGCTTTCTTT	CAKRGMVTEAFF	TRBV19	TRBJ1-1
TGTGCCAGCAGCCGAGACAGGGGGCGCATTTCCGGGGAGCTGTTTTTT	CASSRDRGRISGELFF	TRBV6-1	TRBJ2-2
TGTGCCCAGACCATAGACGTCCATGAGCAGTTCTTC	CAQTIDVHEQFF	TRBV11-2	TRBJ2-1
TGTGCCAGCAGCTTAGCTCAACAGGGGGGGGATTACGAGCAGTACTTC	CASSLAQQGGDYEQYF	TRBV7-2	TRBJ2-7
TGTGCCAGCAGTTTAAAAACCCCTTTTATTGACCCGGGACAGGTGCCGAGTAGCTCCTACAATGAGCAGTTCTTC	CASSLKTPFIDPGQVPSSSYNEQFF	TRBV27	TRBJ2-1
TGTGCCAGCACATCTTCCAAAAGACTCATCGATCCTGAAGCTTTCTTT	CASTSSKRLIDPEAFF	TRBV11-2	TRBJ1-1
TGCGCCAGCAGCTTCCCCCCCCCAGGGGAAGCTTTCTTT	CASSFPPPGEAFF	TRBV5-1	TRBJ1-1
TGTGCCAGCAGCCAAGCAAGTACGCCAACTAATGAAAAACTGTTTTTT	CASSQASTPTNEKLFF	TRBV3-1	TRBJ1-4
TGTGCCAGCAGCTTGTTTCTACCGGGGGGGGAGAGCTACGAGCAGTACTTC	CASSLFLPGGESYEQYF	TRBV5-8	TRBJ2-7
TGTGCCAGCAGTGATCTGAACTTTTGGGGGAGGAACACTGAAGCTTTCTTT	CASSDLNFWGRNTEAFF	TRBV6-1	TRBJ1-1
TGTGCCAGTAACCAGGGGGGTAACACTGAAGCTTTCTTT	CASNQGGNTEAFF	TRBV19	TRBJ1-1
TGTGCCAGCAGCGAGAGGACAGGGATTTCTGGAGAGACCCAGTACTTC	CASSERTGISGETQYF	TRBV13	TRBJ2-5
TGTGCCAGCATGAAGGGGGCTTTCCTGGACAACTCCTACGAGCAGTACTTC	CASMKGAFLDNSYEQYF	TRBV6-4	TRBJ2-7
TGTGCCAGCTGGCCTTGGGTCTATACTGAAGCTTTCTTT	CASWPWVYTEAFF	TRBV6-6	TRBJ1-1
TGTGCCACCAGCTCCCCCCTGCCTGCCACCTACGAGCAGTACTTC	CATSSPLPATYEQYF	TRBV15	TRBJ2-7
TGCAGTGCTAGAGATAAGACAGGGCTAGGAAACACCATATATTTT	CSARDKTGLGNTIYF	TRBV20-1	TRBJ1-3
TGTGCCAGCAGCGCGAGGGGCTTGAATGAAGCTTTCTTT	CASSARGLNEAFF	TRBV13	TRBJ1-1
TGTGCCAGCAGTTATATGGAGGGACGACTAGGCCAAAATGAGCAGTTCTTC	CASSYMEGRLGQNEQFF	TRBV27	TRBJ2-1
TGTGGAGACAGGGGGGGTGGCTACACCTTC	CGDRGGGYTF	TRBV28	TRBJ1-2
TGTGCCAGCAGCCCGGGCGGGGGCTACACCTTC	CASSPGGGYTF	TRBV13	TRBJ1-2
TGTGCCAGCAGTGACTCGAGAGTAGGGGACTCTCTAAGGGACTTC	CASSDSRVGDSLRDF	TRBV6-4	TRBJ2-7
TGTGCCAGCAGTCCCCCAAAGCGGGAGTATAGCAATCAGCCCCAGCATTTT	CASSPPKREYSNQPQHF	TRBV27	TRBJ1-5
TGTGCCAGCGCGGGGGGCGATCAGCCCCAGCATTTT	CASAGGDQPQHF	TRBV11-2	TRBJ1-5
TGCAGTGCAACCTACGTAGGTGAGGGGGTGACTGAGTATGGCTACACCTTC	CSATYVGEGVTEYGYTF	TRBV20-1	TRBJ1-2
TGTGCCAGCAGTGAATACTACTCTAGCTCCTACGAGCAGTACTTC	CASSEYYSSSYEQYF	TRBV6-1	TRBJ2-7
TGTGCCAGCAGCGGACAGGGCGTGGAGCAGTACTTC	CASSGQGVEQYF	TRBV11-3	TRBJ2-7
TGCGCCAGCCGTCGGGGCAGGTCCGGCTACGAGCAGTACTTC	CASRRGRSGYEQYF	TRBV4-3	TRBJ2-7
TGTGCCAGCACTGTGGGGGGGCCTAGAGACAATGAGCAGTTCTTC	CASTVGGPRDNEQFF	TRBV9	TRBJ2-1
TGTGCCAGCAGCGAGGTCGGCACCGGGGAGCTGTTTTTT	CASSEVGTGELFF	TRBV6-3	TRBJ2-2
TGTGCCAGCACGAGGGGGGCCAACGTCCTGACTTTC	CASTRGANVLTF	TRBV6-2	TRBJ2-6
TGCAGTGCTAGAGCGCGGACGGGGGTTAGCAATCAGCCCCAGCATTTT	CSARARTGVSNQPQHF	TRBV20-1	TRBJ1-5
TGCGCCAGCAGGGCTTCGAGGGATAGCGGTTTCCACACTGAAGCTTTCTTT	CASRASRDSGFHTEAFF	TRBV4-1	TRBJ1-1
TGTGCCAGCAGCACTCGATTAGCCAAAAACATTCAGTACTTC	CASSTRLAKNIQYF	TRBV5-4	TRBJ2-4
TGTGCCAGCAGCCCAAGGGGGTATAATTCACCCCTCCACTTT	CASSPRGYNSPLHF	TRBV27	TRBJ1-6
TGTGCCAGCAAATGCGTTGGCATCGGGCCTAGCAATCAGCCCCAGCATTTT	CASKCVGIGPSNQPQHF	TRBV27	TRBJ1-5
TGTGCCACCAGCAGAGGTGACATTTCCTACAATGAGCAGTTCTTC	CATSRGDISYNEQFF	TRBV15	TRBJ2-1
TGCAGCGTTCCTGAGCGGGAGACTAAACTTGGGAAGAGCAATCAGCCCCAGCATTTT	CSVPERETKLGKSNQPQHF	TRBV29-1	TRBJ1-5
TGCAGTGCTAGTGCCCCGTCTCGGGGGCGGCATTCACCCCTCCACTTT	CSASAPSRGRHSPLHF	TRBV20-1	TRBJ1-6
TGTGCCAGCAGCACGAGACAGGGGGCCTATGAAGCTTTCTTT	CASSTRQGAYEAFF	TRBV13	TRBJ1-1
TGTGCCAGCAGTGAGTTGTGGGGTACAGGGAACACTGAAGCTTTCTTT	CASSELWGTGNTEAFF	TRBV6-1	TRBJ1-1
TGTGCCAGCAGTTACGGCCAAATGGACAGGGGACCCACTGAAGCTTTCTTT	CASSYGQMDRGPTEAFF	TRBV6-5	TRBJ1-1
TGCGCCAGCACCCGGGAGGGCCCAAACAATGAGCAGTTCTTC	CASTREGPNNEQFF	TRBV10-1	TRBJ2-1
TGCAGTGCTGGGGGGGCCAAAAACATTCAGTACTTC	CSAGGAKNIQYF	TRBV20-1	TRBJ2-4
TGTGCCAGCATTAACACAGTACTAGAGGGGGTCTACGAGCAGTACTTC	CASINTVLEGVYEQYF	TRBV13	TRBJ2-7
TGTGCCAGCAGTTATTTGGAAACACGGACAGTCACCGGGGAGCTGTTTTTT	CASSYLETRTVTGELFF	TRBV6-8	TRBJ2-2
TGTGCCAGGATACGACCCCATTTAGCTAATGAAAAACTGTTTTTT	CARIRPHLANEKLFF	TRBV24-1	TRBJ1-4
TGTGCCAGCAGATTAAGGATACACGCGATCAATCAGCCCCAGCATTTT	CASRLRIHAINQPQHF	TRBV6-4	TRBJ1-5
TGTGCCAGCAGCGGGGCAGGGGAGTCGAACACTGAAGCTTTCTTT	CASSGAGESNTEAFF	TRBV5-4	TRBJ1-1
TGTGCCTGGGGGGGGCAGAGACGCTACGAGCAGTACTTC	CAWGGQRRYEQYF	TRBV30	TRBJ2-7
TGTGCCAGCAGCATTTGGACGGGTAGCTATGGCTACACCTTC	CASSIWTGSYGYTF	TRBV14	TRBJ1-2
TGCGCCAGCAGCTCCGTCCGGGACAGGGGGAAGGCCAATGAGCAGTTCTTC	CASSSVRDRGKANEQFF	TRBV5-1	TRBJ2-1
TGTGCCAGCAGTCAGGGGGGGCCGGGGGTTTCGGATAGCAATCAGCCCCAGCATTTT	CASSQGGPGVSDSNQPQHF	TRBV12-4	TRBJ1-5
TGCGCCAGCAGCCAAGAGAGAGGGGGCATATCCTACGAGCAGTACTTC	CASSQERGGISYEQYF	TRBV4-1	TRBJ2-7
TGTGCCAGCAGCGTACTAAGCTCCTACAATGAGCAGTTCTTC	CASSVLSSYNEQFF	TRBV7-3	TRBJ2-1
TGTGCCAGCAGTTTTAGCGGGGTGAATCCCTACGAGCAGTACTTC	CASSFSGVNPYEQYF	TRBV28	TRBJ2-7
TGTGCCAGCAGCTTCAGGAGGCTTACCCACAATGAGCAGTTCTTC	CASSFRRLTHNEQFF	TRBV11-1	TRBJ2-1
TGCAGTGCTAGACCTTGGGCGGCAAGGGGAGCTAACTATGGCTACACCTTC	CSARPWAARGANYGYTF	TRBV20-1	TRBJ1-2
TGTGCCACCAGGGGACTAGCCGTTACCGGGGAGCTGTTTTTT	CATRGLAVTGELFF	TRBV24-1	TRBJ2-2
TGTGCCAGCAGCCAGGCAGATACGCAGTATTTT	CASSQADTQYF	TRBV11-3	TRBJ2-3
TGTGCCAGCAGTTCGGATAATCGTGACACAGATACGCAGTATTTT	CASSSDNRDTDTQYF	TRBV12-3	TRBJ2-3
TGTGCCAGCGGTGAATGTCCCGGGACAGGGGGCTCGGGGGCCAACGTCCTGACTTTC	CASGECPGTGGSGANVLTF	TRBV6-4	TRBJ2-6
TGTGCCACCAGTGATTCATGTTCTGCAGCCCCCGGATACGAGCAGTACTTC	CATSDSCSAAPGYEQYF	TRBV24-1	TRBJ2-7
TGTGCCATCAGTGACCATCTGGGGGGGGCTAGCACAGATACGCAGTATTTT	CAISDHLGGASTDTQYF	TRBV10-3	TRBJ2-3
TGTGCCAGCTCGTCAGGGTTCGAGCCGGAAAGGCCCTACGAGCAGTACTTC	CASSSGFEPERPYEQYF	TRBV18	TRBJ2-7
TGTGCCAGTACCTACGCCCAAAGGGGAGTAGGGGAGCTGTTTTTT	CASTYAQRGVGELFF	TRBV19	TRBJ2-2
TGTGCCACCAGTGATCCTAGACCAGAGGGGAATGAAGCTTTCTTT	CATSDPRPEGNEAFF	TRBV24-1	TRBJ1-1
TGTGCCAGTAGTATTACGCTCCTAGCGGGGGGAAAGCCCGGGGAGCTGTTTTTT	CASSITLLAGGKPGELFF	TRBV19	TRBJ2-2
TGCGCCAGCAGCTCCTATGGGGTCTACGAGCAGTACTTC	CASSSYGVYEQYF	TRBV4-1	TRBJ2-7
TGTGCCAGCAGTTTAGAGTTTCGGGGCTTAGGCGGGAACACTGAAGCTTTCTTT	CASSLEFRGLGGNTEAFF	TRBV27	TRBJ1-1
TGCGCCAGCAGCCCGCAGGTGCAAGAGACCCAGTACTTC	CASSPQVQETQYF	TRBV4-3	TRBJ2-5
TGTGCCAGCAGCGAACGACAGCCCGGGGAGCTGTTTTTT	CASSERQPGELFF	TRBV9	TRBJ2-2
TGTGCCAGCAGTCCCTGGACAGGGGCACTCTATCAGCCCCAGCATTTT	CASSPWTGALYQPQHF	TRBV28	TRBJ1-5
TGTGCCAGCATGGATAAGGCGGACGAGCAGTACTTC	CASMDKADEQYF	TRBV7-4	TRBJ2-7
TGTGCCCCCGGTGGGGGAGCTTTCGCCAATCAGCCCCAGCATTTT	CAPGGGAFANQPQHF	TRBV3-1	TRBJ1-5
TGCGCCAGCAGCTTGGTCGGCCACAGGGACCCGAACACTGAAGCTTTCTTT	CASSLVGHRDPNTEAFF	TRBV5-1	TRBJ1-1
TGTGCCAGCAGTCACTCCAAAAAACTCCCACGTGGGGCCAACGTCCTGACTTTC	CASSHSKKLPRGANVLTF	TRBV6-1	TRBJ2-6
TGTGCCAGCAGTTGTGGGATTTCTGATCAGCCCCAGCATTTT	CASSCGISDQPQHF	TRBV28	TRBJ1-5
TGTGCCAGCAGCCTTTACGAGCAGTACTTC	CASSLYEQYF	TRBV7-9	TRBJ2-7
TGTGCCAGCAGTTTAGCTGACCATCAGCCCCAGCATTTT	CASSLADHQPQHF	TRBV27	TRBJ1-5
TGTGCCAGCACTAGCACTGAAGCTTTCTTT	CASTSTEAFF	TRBV11-3	TRBJ1-1
TGTGCCAGCAGTTTCAGGAATGAGCAGTTCTTC	CASSFRNEQFF	TRBV27	TRBJ2-1
TGTGCCAGCAGCTTAGGAACTCACAGGGGGGGGGACACTGAAGCTTTCTTT	CASSLGTHRGGDTEAFF	TRBV7-2	TRBJ1-1
TGTGCCAGCAGCCCGGAAAGTTTCCCGGGACAGGGGGGAAGCTACGAGCAGTACTTC	CASSPESFPGQGGSYEQYF	TRBV12-3	TRBJ2-7
TGTGCCAGCAGCAAACAGGGGGTTAGCAATCAGCCCCAGCATTTT	CASSKQGVSNQPQHF	TRBV7-9	TRBJ1-5
TGTGCCAGCAGCTCGAGGGGACAGGACTCCTACGAGCAGTACTTC	CASSSRGQDSYEQYF	TRBV5-6	TRBJ2-7
TGCGCCACAAGGGATGGCTACACCTTC	CATRDGYTF	TRBV10-1	TRBJ1-2
TGCGCCAGCACGTCAGCAAAGCCAAGACGCTCTGGAAACACCATATATTTT	CASTSAKPRRSGNTIYF	TRBV5-1	TRBJ1-3
TGCGCCAGCAGCCAACCGACAGGCCAAGCTTTCTTT	CASSQPTGQAFF	TRBV4-1	TRBJ1-1
TGTGCTAGTGGTTCACAGGGGGCAGGCTATTGTCAGCCCCAGCATTTT	CASGSQGAGYCQPQHF	TRBV12-5	TRBJ1-5
TGCGCCAGCAGCTTAGGTTCGGGGGATCTTCGCATGAACACTGAAGCTTTCTTT	CASSLGSGDLRMNTEAFF	TRBV5-1	TRBJ1-1
TGTGCCAGCAGCTCTGACGGGACGACCGGGGAGCTGTTTTTT	CASSSDGTTGELFF	TRBV7-6	TRBJ2-2
TGCGCCAGCAGCCAAGCCAGGGGCACCTTC	CASSQARGTF	TRBV4-1	TRBJ1-2
TGCGCCAGCAGCTTTTTTAGCCCGGGACAGGCCGAGCAGTACTTC	CASSFFSPGQAEQYF	TRBV5-1	TRBJ2-7
TGTGCCAGCACCGGCCCCCGGGACAGGGGCCAAAGAGCTTTCTTT	CASTGPRDRGQRAFF	TRBV12-4	TRBJ1-1
TGCAGTGCCCGCGGGAAAGATAATTCACCCCTCCACTTT	CSARGKDNSPLHF	TRBV20-1	TRBJ1-6
TGTGCCAGCAGCGTATGCAAACCAGGACTAGACTATGGCTACACCTTC	CASSVCKPGLDYGYTF	TRBV9	TRBJ1-2
TGCAGCGTTTTAGGCGTGCAAGAGACCCAGTACTTC	CSVLGVQETQYF	TRBV29-1	TRBJ2-5
TGTGCCAGCAGCTTAACGACGAGGGTCTTATTGGACGAGCAGTACTTC	CASSLTTRVLLDEQYF	TRBV7-3	TRBJ2-7
TGTGCCAGTAGTATACCGGACAGGGTTCAGCCCCAGCATTTT	CASSIPDRVQPQHF	TRBV19	TRBJ1-5
TGTGCCAGCAGTCGATACAATGAGCAGTTCTTC	CASSRYNEQFF	TRBV6-8	TRBJ2-1
TGTGCCAGCAGTTACCCCGTATACAGATCACCCCTCCACTTT	CASSYPVYRSPLHF	TRBV6-5	TRBJ1-6
TGTGCCAGCAGCAACCTGGCGGACGATGGGGCCAACGTCCTGACTTTC	CASSNLADDGANVLTF	TRBV27	TRBJ2-6
TGCGCCAGCAGCCAAGCCCACTCCTACGAGCAGTACTTC	CASSQAHSYEQYF	TRBV4-1	TRBJ2-7
TGTGCCAGGGCGCCCAGACAGTGTCATCCCTCCTACGAGCAGTACTTC	CARAPRQCHPSYEQYF	TRBV5-4	TRBJ2-7
TGTGCCAGCAGCTACGGGGCGGTTGGCTACACCTTC	CASSYGAVGYTF	TRBV7-6	TRBJ1-2
TGTGCCAGCAGCTTGAAGCAGGCAGGGCCGGGGGCTAACTATGGCTACACCTTC	CASSLKQAGPGANYGYTF	TRBV5-6	TRBJ1-2
TGTGCCAGCAGCTTCAAAGGACAGAAGTGGGCTAACTATGGCTACACCTTC	CASSFKGQKWANYGYTF	TRBV11-3	TRBJ1-2
TGTGCCAGCAGTTACTCGAGTGGACAGGGGGCCAAGTCTAACTATGGCTACACCTTC	CASSYSSGQGAKSNYGYTF	TRBV6-3	TRBJ1-2
TGTGCCAGCAGCAACGGGCTAGCAGGGAAGTATGGCTACACCTTC	CASSNGLAGKYGYTF	TRBV7-8	TRBJ1-2
TGTGCCAGCAGCTTCAGATGCCGGGACAGGGAAGATGGCTACACCTTC	CASSFRCRDREDGYTF	TRBV11-2	TRBJ1-2
TGTGCCAGCAGCTCACGCGTCGAGTCCAATGAGCAGTTCTTC	CASSSRVESNEQFF	TRBV7-4	TRBJ2-1
TGTGCCAGCAGCTTTCGGGGTGGGCCGAGCTCTGGAAACACCATATATTTT	CASSFRGGPSSGNTIYF	TRBV7-7	TRBJ1-3
TGTGCCATCAGTGTCTTGGTCCTCTCCAGGGGGGGGGGGAATAAAGTATCCTACGAGCAGTACTTC	CAISVLVLSRGGGNKVSYEQYF	TRBV10-3	TRBJ2-7
TGTGCCAGCAGTTACGGACGGGAACTCCGTTCTAGCAATCAGCCCCAGCATTTT	CASSYGRELRSSNQPQHF	TRBV6-6	TRBJ1-5
TGTGCCAGCAGCTTAGCGAGACGGACTAACTATGGCTACACCTTC	CASSLARRTNYGYTF	TRBV7-6	TRBJ1-2
TGTGCCAGCAGTACGAGTAGCAATCAGCCCCAGCATTTT	CASSTSSNQPQHF	TRBV6-2	TRBJ1-5
TGTGCCAGCAGTGGGGGGGCCTCCTACGAGCAGTACTTC	CASSGGASYEQYF	TRBV6-1	TRBJ2-7
TGTGCCAGCAGCGCTTACCGGGACAGGGGGGAGAATCAGCCCCAGCATTTT	CASSAYRDRGENQPQHF	TRBV9	TRBJ1-5
TGTGCCAGCAGCGTGGGTGGGGGTAACACCGGGGAGCTGTTTTTT	CASSVGGGNTGELFF	TRBV9	TRBJ2-2
TGCAGTCGATCGGACAGTTTCTTC	CSRSDSFF	TRBV20-1	TRBJ2-1
TGTGCCACCAGTGAGGGGCGAACGCTAAGTTCACCCCTCCACTTT	CATSEGRTLSSPLHF	TRBV24-1	TRBJ1-6
