TGCGCCAGCAGGAACAGGGTTGGTCGTTTCGTTTACGAGCAGTACTTC	CASRNRVGRFVYEQYF	TRBV5-1	TRBJ2-7
TGTGCCAGTACGGGACAGAAAGGCTATGGCTACACCTTC	CASTGQKGYGYTF	TRBV19	TRBJ1-2
TGTGCCAGTAGTATGACGGGGGCCGGGAAACGGGACACTGAAGCTTTCTTT	CASSMTGAGKRDTEAFF	TRBV19	TRBJ1-1
TGTGCCAGAGTGGGGGGGCGGGCTAGCACAGATACGCAGTATTTT	CARVGGRASTDTQYF	TRBV19	TRBJ2-3
TGTGCCAGCAGTGAAAACCCGGGGGTACATGGCTACACCTTC	CASSENPGVHGYTF	TRBV6-1	TRBJ1-2
TGTGCCAGCAGCTTAGCGCCGGGACAGCAGAACACTGAAGCTTTCTTT	CASSLAPGQQNTEAFF	TRBV7-3	TRBJ1-1
TGTGCCAGCACTCTTTTCAGGGCGGATGGAAACACCATATATTTT	CASTLFRADGNTIYF	TRBV7-3	TRBJ1-3
TGCAGTGCTCCCTCCGGGCAAGAGACCCAGTACTTC	CSAPSGQETQYF	TRBV20-1	TRBJ2-5
TGTGCCCACTCGGGGGAAAAACTGTTTTTT	CAHSGEKLFF	TRBV10-3	TRBJ1-4
TGTGCCAGCCCCCCGGCCTACATTCAGTACTTC	CASPPAYIQYF	TRBV13	TRBJ2-4
TGTGCCAGCAGTGACCTGTACGAGCAGTACTTC	CASSDLYEQYF	TRBV6-4	TRBJ2-7
TGTGCCAGCAGTGACTCGACGATTGGAACCAGACCTCCCAACCTGGGGGGACAGGGTAGGGAACTAGGAGGCTACACCTTC	CASSDSTIGTRPPNLGGQGRELGGYTF	TRBV6-4	TRBJ1-2
TGTGCCAGCAGCTTAGCCGCACAGGGTCGACCAGATACGCAGTATTTT	CASSLAAQGRPDTQYF	TRBV7-9	TRBJ2-3
TGTGCCAGCAGTGCAGTACAAGGCACAGATACGCAGTATTTT	CASSAVQGTDTQYF	TRBV28	TRBJ2-3
TGTGCCAGCAGCGTTACGGGTCAGCCCCAGCATTTT	CASSVTGQPQHF	TRBV14	TRBJ1-5
TGTGCCACCAGCCGGGACAGGAGCAATTCACCCCTCCACTTT	CATSRDRSNSPLHF	TRBV15	TRBJ1-6
TGTGCCAGTAGTATAGTCCTATCAGGCGACTACAATGAGCAGTTCTTC	CASSIVLSGDYNEQFF	TRBV19	TRBJ2-1
TGTGCCAGCAGCTTCCCCCCGGGGGGCAATCAGCCCCAGCATTTT	CASSFPPGGNQPQHF	TRBV5-5	TRBJ1-5
TGTGCCAGCACTCGAAGGCATGGGAACACTGAAGCTTTCTTT	CASTRRHGNTEAFF	TRBV11-3	TRBJ1-1
TGTGCTAGCAGCTTAGAAAAGACGGGGGATAATGAAAAACTGTTTTTT	CASSLEKTGDNEKLFF	TRBV7-7	TRBJ1-4
TGTGCCACCAGCTATTGGACAGGGCTGGGAGAGACCCAGTACTTC	CATSYWTGLGETQYF	TRBV24-1	TRBJ2-5
TGCAGCGTTGACTCCTCCTCTAGCGGGCCAGATACGCAGTATTTT	CSVDSSSSGPDTQYF	TRBV29-1	TRBJ2-3
TGTGCCAGCAGCCTGATACGTCGGCAAGAGACCCAGTACTTC	CASSLIRRQETQYF	TRBV5-5	TRBJ2-5
TGTGCCAGTAGTATAGCTCGAGGACAGGGGGCCAATGGCTACACCTTC	CASSIARGQGANGYTF	TRBV19	TRBJ1-2
TGTGCCAGCAGCGGGGTAAGAATGGGGGGCGAAAAAAACACCGGGGAGCTGTTTTTT	CASSGVRMGGEKNTGELFF	TRBV7-4	TRBJ2-2
TGCGCCAGCAGCTTGATACCGGGACAGGGGGCGGCGTACTATGGCTACACCTTC	CASSLIPGQGAAYYGYTF	TRBV5-1	TRBJ1-2
TGTGCCACCAGTGATTTCAGGGGGGGCCCACGGAAGGACACAGATACGCAGTATTTT	CATSDFRGGPRKDTDTQYF	TRBV24-1	TRBJ2-3
TGCGCCAGTCAAACTCCAGGGGGCGGCAATCAGCCCCAGCATTTT	CASQTPGGGNQPQHF	TRBV5-1	TRBJ1-5
TGTGCCAGCAGCAACCGTACGGGGCTTTATGGCTACACCTTC	CASSNRTGLYGYTF	TRBV7-9	TRBJ1-2
TGTGCCAGCAGGCCGGGGGGGGACGGGGGAGTCGAGCAGTACTTC	CASRPGGDGGVEQYF	TRBV6-4	TRBJ2-7
TGTGCCAGCAGCCGTGGGGACAGCTTTGAAAAACTGTTTTTT	CASSRGDSFEKLFF	TRBV13	TRBJ1-4
TGTGCCTGGTTATGGACTAGCGGTGTGTACGAGCAGTACTTC	CAWLWTSGVYEQYF	TRBV30	TRBJ2-7
TGTGCCAGCAGCCTGAAGAGTACTGGAAACACCATATATTTT	CASSLKSTGNTIYF	TRBV13	TRBJ1-3
TGCGCCAGCAGCGTGCGGGGGTCGGGGACCGCCTCCTACAATGAGCAGTTCTTC	CASSVRGSGTASYNEQFF	TRBV5-1	TRBJ2-1
TGCAGTGCTAGAGATAAAAAAGGGGACACTCCTCCCAAAGAGACCCAGTACTTC	CSARDKKGDTPPKETQYF	TRBV20-1	TRBJ2-5
TGTGCCTGGATTCCGGGGACTAGCGGGATTACGGGGGTCGGGGATTGGCCCACAGATACGCAGTATTTT	CAWIPGTSGITGVGDWPTDTQYF	TRBV30	TRBJ2-3
TGTGCCAGCAGCTTAAACAGGGGGGGGTGGACCGGGGAGCTGTTTTTT	CASSLNRGGWTGELFF	TRBV11-3	TRBJ2-2
TGTGCCAGCAGCGGTGTGACGGTAGGATCAGAGACCTACAATGAGCAGTTCTTC	CASSGVTVGSETYNEQFF	TRBV9	TRBJ2-1
TGTGCCAGCAGCGTGACTAGCGGGGGGGCTTACCCCTACGAGCAGTACTTC	CASSVTSGGAYPYEQYF	TRBV13	TRBJ2-7
TGTGCCACCAGTGTTTCGTGTGGGGGGGCGGTCACAGATACGCAGTATTTT	CATSVSCGGAVTDTQYF	TRBV24-1	TRBJ2-3
TGTGCCACCAGTGATAGGAGAGGGGACTCACTATACAATGAGCAGTTCTTC	CATSDRRGDSLYNEQFF	TRBV24-1	TRBJ2-1
TGCGCCAGCAGTGAACCCCGGGACGGCCGGGACAGAGGATGCACAGATACGCAGTATTTT	CASSEPRDGRDRGCTDTQYF	TRBV10-1	TRBJ2-3
TGTGCCAGTAGTATAACACAGGGGTCGGTGAACACTGAAGCTTTCTTT	CASSITQGSVNTEAFF	TRBV19	TRBJ1-1
TGTGCCAGCAGCTTGCCGTTGGCGGGACAGGGTAATGAGCAGTACTTC	CASSLPLAGQGNEQYF	TRBV7-9	TRBJ2-7
TGTGCCAGCAGTGCTCGGACAGACGAGCCCGGGGAGCTGTTTTTT	CASSARTDEPGELFF	TRBV6-2	TRBJ2-2
TGTGCCAGCAGCCCAGGGGGCTCCTACGAGCAGTACTTC	CASSPGGSYEQYF	TRBV6-6	TRBJ2-7
TGTGCCAGCAAGCGTACGGGGGCCTATGGCTACACCTTC	CASKRTGAYGYTF	TRBV12-4	TRBJ1-2
TGTGCTAGTGGTTTCTCGGGAGTACCGATGAACACTGAAGCTTTCTTT	CASGFSGVPMNTEAFF	TRBV12-5	TRBJ1-1
TGTGCCAGCTCACCACGCCAAACGGGGAGCTTC	CASSPRQTGSF	TRBV18	TRBJ2-5
TGTGCCAGCAGTTTTCCTAATAGGAGGTACAATGAGCAGTTCTTC	CASSFPNRRYNEQFF	TRBV28	TRBJ2-1
TGCTTGGGAGTGTACGAGCAGTACTTC	CLGVYEQYF	TRBV20-1	TRBJ2-7
TGTGCCAGCAGTTTCCCGGGCCGGGACGGGGGTTGGTCAGAGACCCAGTACTTC	CASSFPGRDGGWSETQYF	TRBV6-1	TRBJ2-5
TGTGCCAGCAGTGAGCGGTGGGGGGATCACACTGAAGCTTTCTTT	CASSERWGDHTEAFF	TRBV6-4	TRBJ1-1
TGTGCTAGCCCGTTCATACCCAGCGAGCAGTACTTC	CASPFIPSEQYF	TRBV12-5	TRBJ2-7
TGCAGCGGGGGGGGGGAGACCCAGTACTTC	CSGGGETQYF	TRBV29-1	TRBJ2-5
TGCGCCAGCAGCGCCTCAGGAAGAGATGGCTACACCTTC	CASSASGRDGYTF	TRBV5-1	TRBJ1-2
TGCGCCAGCACCTGGACTACCACAGATACGCAGTATTTT	CASTWTTTDTQYF	TRBV10-1	TRBJ2-3
TGTGCCAGCAGCGGGGGACAGATATCCTACGAGCAGTACTTC	CASSGGQISYEQYF	TRBV7-3	TRBJ2-7
TGTGCCAGCATCGGGGGGCCCCAGATTTCCTACGAGCAGTACTTC	CASIGGPQISYEQYF	TRBV6-1	TRBJ2-7
TGTGCCAGCAGCCCCCGTCCAGAAGAGGAGAAACCGAACACTGAAGCTTTCTTT	CASSPRPEEEKPNTEAFF	TRBV13	TRBJ1-1
TGTGCCAGCAGTTTACCCACAGTGGGTGGCGAGCAGTACTTC	CASSLPTVGGEQYF	TRBV27	TRBJ2-7
TGTGCCAGCAGCTTAGATGCCGACAGGGCCTTGGTATATAGCAATCAGCCCCAGCATTTT	CASSLDADRALVYSNQPQHF	TRBV11-2	TRBJ1-5
TGTGCCAGCAGCTTGGGACTAGCGGGAGGGCCCCCTTGTACTTTCTTT	CASSLGLAGGPPCTFF	TRBV5-6	TRBJ1-1
TGTGAAGACCCGGGGGATCAGCCCCAGCATTTT	CEDPGDQPQHF	TRBV24-1	TRBJ1-5
TGTGCCATCAGCCCCCTCGGGTACTATGGCTACACCTTC	CAISPLGYYGYTF	TRBV10-3	TRBJ1-2
TGCAGTGCTGTCGGAGAACACAGGGTCGAGACCCAGTACTTC	CSAVGEHRVETQYF	TRBV20-1	TRBJ2-5
TGTGCCAGCAGCCCTAGTAGGAGAACCGGGGAGCTGTTTTTT	CASSPSRRTGELFF	TRBV7-3	TRBJ2-2
TGTGCCAGCAGCAAAATCGGCTACGAGCAGTACTTC	CASSKIGYEQYF	TRBV13	TRBJ2-7
TGTGCCAGCAGCATAGGCCCAGGACAGGGGGCGTTAGATACGCAGTATTTT	CASSIGPGQGALDTQYF	TRBV2	TRBJ2-3
TGTGCCAGCAGTTTAGGAATTTGGGGCGGGGAGACCCAGTACTTC	CASSLGIWGGETQYF	TRBV12-4	TRBJ2-5
TGTGCCAGCAGTTACCGGGGCGGGACGACCCGCTCCTACGAGCAGTACTTC	CASSYRGGTTRSYEQYF	TRBV6-5	TRBJ2-7
TGTGCCAGCAGGGGACATGGCTACACCTTC	CASRGHGYTF	TRBV12-3	TRBJ1-2
TGTGCCAGCAGCCTCTGCGAAGACAGGGATCAGCAGCCCCAGCATTTT	CASSLCEDRDQQPQHF	TRBV14	TRBJ1-5
TGTGCCAGCAGCTTACCGTATGGAGCCCCTGCCTACGAGCAGTACTTC	CASSLPYGAPAYEQYF	TRBV7-2	TRBJ2-7
TGTGCCAGCAGCCACAGGGGGCTTAAGACAGATACGCAGTATTTT	CASSHRGLKTDTQYF	TRBV7-8	TRBJ2-3
TGTGCCAGCTCACCTGCAACCACTAGCGGGAGGCCCGGCTACACCTTC	CASSPATTSGRPGYTF	TRBV18	TRBJ1-2
TGTGCCAGCAGTTATACAGTCCTCAGGGCCAATTCACCCCTCCACTTT	CASSYTVLRANSPLHF	TRBV6-3	TRBJ1-6
TGTGCCAGCAGCGGTACCAGGCAGCCCCAGCATTTT	CASSGTRQPQHF	TRBV9	TRBJ1-5
TGCAGCGTTGGCGGGGGGACTAGCGGGGGAGTAGAGACCCAGTACTTC	CSVGGGTSGGVETQYF	TRBV29-1	TRBJ2-5
TGTGCCAGCAGCAGGGAATGGGGGGAGGACGGCTATGGCTACACCTTC	CASSREWGEDGYGYTF	TRBV25-1	TRBJ1-2
TGTGCCAGCAGGGCAGATTCCCCGAAGTCTTCACCCCTCCACTTT	CASRADSPKSSPLHF	TRBV9	TRBJ1-6
TGTGCCAGCAGTTACCCAAAGACAGGGAATGAAAAACTGTTTTTT	CASSYPKTGNEKLFF	TRBV6-5	TRBJ1-4
TGTGCCAGCAGTTACTCGAGTGTTCCGCATCAGCCCCAGCATTTT	CASSYSSVPHQPQHF	TRBV6-5	TRBJ1-5
TGTGCCAGCCTGTGGGACTCCGAGCAGTACTTC	CASLWDSEQYF	TRBV9	TRBJ2-7
TGTGCCAGCAGCAAACGCTCCTACGAGCAGTACTTC	CASSKRSYEQYF	TRBV13	TRBJ2-7
TGTGCCAGCAGCTTGAGAATGAACACTGAAGCTTTCTTT	CASSLRMNTEAFF	TRBV7-3	TRBJ1-1
TGTGCCACCAGTGGGGGGGGGGACAATGAGCAGTTCTTC	CATSGGGDNEQFF	TRBV24-1	TRBJ2-1
TGTGCCAGCAGCTCTCGATTAGCTTTCTTT	CASSSRLAFF	TRBV7-8	TRBJ1-1
TGCGCCAGCAGCCTCAACAGGGGGGGAACCTACGAGCAGTACTTC	CASSLNRGGTYEQYF	TRBV5-1	TRBJ2-7
TGTGCCAGCAGCTTGGCACTGACGGACAATGAGCAGTTCTTC	CASSLALTDNEQFF	TRBV5-5	TRBJ2-1
TGTGCCAGCAGCGTCGAGAGGGAGTACAATGAGCAGTTCTTC	CASSVEREYNEQFF	TRBV9	TRBJ2-1
TGTGCCAGCAGGGGGGACAGGGAAGATGAAAAACTGTTTTTT	CASRGDREDEKLFF	TRBV2	TRBJ1-4
TGTGCCATCAGTGAGTCCAGGGGGGACAGGGCATTTAGCAATCAGCCCCAGCATTTT	CAISESRGDRAFSNQPQHF	TRBV10-3	TRBJ1-5
TGTGCCAGCAGCTGGGACCCCCGTGGGTACAATGAGCAGTTCTTC	CASSWDPRGYNEQFF	TRBV5-5	TRBJ2-1
TGTGCCAGCAGCGACCCGACAGGGGCCACTAACTATGGCTACACCTTC	CASSDPTGATNYGYTF	TRBV11-3	TRBJ1-2
TGCGCCAGCGACCCGGGACACGCTGAAGCTTTCTTT	CASDPGHAEAFF	TRBV5-1	TRBJ1-1
TGTGCCAGCAGCTTAGCGGGTAATGAGCAGTTCTTC	CASSLAGNEQFF	TRBV13	TRBJ2-1
TGTGCCAGTAGTATCGAGTCCCTGGACTTTCACACCGGGGAGCTGTTTTTT	CASSIESLDFHTGELFF	TRBV19	TRBJ2-2
TGTGCCACCAGTGATCCAGTCCCTTACTCCCGGAGGGGACAGCAACATAACACTGAAGCTTTCTTT	CATSDPVPYSRRGQQHNTEAFF	TRBV24-1	TRBJ1-1
TGTGCCACCAGTGAAAGTGGAGTCTTTATTGGTGTCAATTCACCCCTCCACTTT	CATSESGVFIGVNSPLHF	TRBV24-1	TRBJ1-6
TGCGCCAGCAGCTTGACCGGGAGGGCAAAGGCAAGACAGCACTACGAGCAGTACTTC	CASSLTGRAKARQHYEQYF	TRBV5-1	TRBJ2-7
TGCAGTGCTAGAGTCGGGGGGGCGTTCAATGAGCAGTTCTTC	CSARVGGAFNEQFF	TRBV20-1	TRBJ2-1
TGTGCCACCAGCCCCCCAAGGGACTATTGGCAGGGTTACGAGCAGTACTTC	CATSPPRDYWQGYEQYF	TRBV15	TRBJ2-7
TGTGCCAGCAGTTACCACTTATTTAAGCAGTTCTTC	CASSYHLFKQFF	TRBV6-6	TRBJ2-1
TGTGCCAGCAGCTTCAGTAGGCCCTTCCCATCTGGGGTTTTCTTC	CASSFSRPFPSGVFF	TRBV7-3	TRBJ2-1
TGTGCCAGCAAGTACGAAGGGACAGGGACGCCCTACGAGCAGTACTTC	CASKYEGTGTPYEQYF	TRBV5-6	TRBJ2-7
TGTGCCAGCAAAAGGGATCGGGGAGTCAATCAGCCCCAGCATTTT	CASKRDRGVNQPQHF	TRBV7-2	TRBJ1-5
TGTGCCAGCAGGTTAAAACGAGGGAGGTACGAGCAGTACTTC	CASRLKRGRYEQYF	TRBV27	TRBJ2-7
TGTGCCAGCGAGCACAGGGGGCGAGTCAATCAGCCCCAGCATTTT	CASEHRGRVNQPQHF	TRBV5-6	TRBJ1-5
TGTGCCAGCAGTTCTGGGGGGGCAAATGAGCAGTTCTTC	CASSSGGANEQFF	TRBV28	TRBJ2-1
TGTGCCAGCAGTTTCAGGAGCAGGGGGCAGTACGAGCAGTACTTC	CASSFRSRGQYEQYF	TRBV12-4	TRBJ2-7
TGTGCCAGCAGCTCAGCGGCGGGGCCAGGCCACTATGGCTACACCTTC	CASSSAAGPGHYGYTF	TRBV12-4	TRBJ1-2
TGTGCCAGCAGCCAAGGGCAATGGGACAGGGTGGCGGTCAGAGCAACTAATGAAAAACTGTTTTTT	CASSQGQWDRVAVRATNEKLFF	TRBV3-1	TRBJ1-4
TGTGCCACCAGTGATACTTGCGGGAGCAAAGGGTCTGCCAAAAACATTCAGTACTTC	CATSDTCGSKGSAKNIQYF	TRBV24-1	TRBJ2-4
TGTGCTAGTGGTAGCCTGTACTTC	CASGSLYF	TRBV12-5	TRBJ2-5
TGTGCCAGCAGTTTTTCGCCAGGACCGAAAGAGTACTTC	CASSFSPGPKEYF	TRBV27	TRBJ2-7
TGTGCCAGCCGGGGGGCAGAGACCTACGAGCAGTACTTC	CASRGAETYEQYF	TRBV5-6	TRBJ2-7
TGTGCCAGCAGTTACTCGCGAACACTAGCGGGAGGGCTGGCCTCTGGAAACACCATATATTTT	CASSYSRTLAGGLASGNTIYF	TRBV6-6	TRBJ1-3
TGTGCTAGCAGCAAATACAGGGGGCATGAGGGGGGCTACACCTTC	CASSKYRGHEGGYTF	TRBV7-7	TRBJ1-2
TGTGCCAGCAGCTTTTGGAAGGACTGGATTAATTTTCATCACTACGAGCAGTACTTC	CASSFWKDWINFHHYEQYF	TRBV7-9	TRBJ2-7
TGCGCCAGCAGCCCCCTGGACAGGGGGCGGGGCTACGAGCAGTACTTC	CASSPLDRGRGYEQYF	TRBV10-1	TRBJ2-7
TGTGCCAGCAGCCAGACTAGGGGTCCTTCCGGATCGAACACCGGGGAGCTGTTTTTT	CASSQTRGPSGSNTGELFF	TRBV7-3	TRBJ2-2
TGTGCCAGCAGAAGTGGACAGGGGAGCGAGAACACTGAAGCTTTCTTT	CASRSGQGSENTEAFF	TRBV6-4	TRBJ1-1
TGTGCCAGCAGTTACCACGGAGGAAGGGCCGGGGGTCGTCATCAGCCCCAGCATTTT	CASSYHGGRAGGRHQPQHF	TRBV6-5	TRBJ1-5
TGTGCCAGCAGCCAAGATACCGGATTGGGGAGCAATCAGCCCCAGCATTTT	CASSQDTGLGSNQPQHF	TRBV14	TRBJ1-5
TGTGCCAGCTCAGGGGATGAAAAACTGTTTTTT	CASSGDEKLFF	TRBV2	TRBJ1-4
TGTGCCAGCAGCGACCCTAGCGGGGCGGTAAGTGAGCAGTTCTTC	CASSDPSGAVSEQFF	TRBV7-3	TRBJ2-1
TGTGCCAGCAGTTACTCGACCCGAAACGGGACTAACCCGAGCACAGATACGCAGTATTTT	CASSYSTRNGTNPSTDTQYF	TRBV6-6	TRBJ2-3
TGCAGTGCTAGAAAGGGCGTTGGGGACAGGCCAACTTACACTGAAGCTTTCTTT	CSARKGVGDRPTYTEAFF	TRBV20-1	TRBJ1-1
TGTGCCAGCAGCCAAGGAAAAGGGTATGGCTACACCTTC	CASSQGKGYGYTF	TRBV3-1	TRBJ1-2
TGTGCCAGTAGTATTAGGATGTGGGGACTTTATGGCTACACCTTC	CASSIRMWGLYGYTF	TRBV19	TRBJ1-2
TGCAGTGCTAGAGATCACCTTAGCAAGGTCAGGGAAGATAATTCACCCCTCCACTTT	CSARDHLSKVREDNSPLHF	TRBV20-1	TRBJ1-6
TGTGCCAGCAGCCTATGGGGACAACCCACCGGGGAGCTGTTTTTT	CASSLWGQPTGELFF	TRBV13	TRBJ2-2
TGTGCCAGCAGCCAAGGGCGGGGGCCGGGTCCATACGAGCAGTACTTC	CASSQGRGPGPYEQYF	TRBV4-2	TRBJ2-7
TGTGCCAGCAGCTTAGTACAGGGTATTTCTGGAAACACCATATATTTT	CASSLVQGISGNTIYF	TRBV7-2	TRBJ1-3
TGTGCCAGCTTATGGGACACCGGGGAGCTGTTTTTT	CASLWDTGELFF	TRBV6-5	TRBJ2-2
TGTGCCAGCAGCCGAGGACCCTACGAGCAGTACTTC	CASSRGPYEQYF	TRBV7-2	TRBJ2-7
TGTGCCAGCAGCCCTGGGGAGCGGGAGCGGCGAGCAGATACGCAGTATTTT	CASSPGERERRADTQYF	TRBV5-5	TRBJ2-3
TGTGCCAGCAGCAGAGGGAGTAATGGCTACACCTTC	CASSRGSNGYTF	TRBV9	TRBJ1-2
TGTGCCAGCAGCCAAAGCGGTCGACAGGGTGGCTGGGACAATCAGCCCCAGCATTTT	CASSQSGRQGGWDNQPQHF	TRBV14	TRBJ1-5
TGTGCCAGCAGCTCACTAGCCAACAGCTCCTACGAGCAGTACTTC	CASSSLANSSYEQYF	TRBV7-6	TRBJ2-7
TGTGCCAGCAGCCGAACGGGAGGAATCCTAAACGCTGAAGCTTTCTTT	CASSRTGGILNAEAFF	TRBV9	TRBJ1-1
TGTGCCAGCAGCTTAGACCGAGGGGCGGGGAACACTGAAGCTTTCTTT	CASSLDRGAGNTEAFF	TRBV7-9	TRBJ1-1
TGTGCCAGCAGCGCTAGCGGGGAGGCACGTGAGCAGTTCTTC	CASSASGEAREQFF	TRBV13	TRBJ2-1
TGTGCCAGCAGCAAACTAGCGGGAGCGGACAATGAGCAGTTCTTC	CASSKLAGADNEQFF	TRBV7-4	TRBJ2-1
TGTGCCAGCTCACCACCACGGGGGGGGGAGGACTACGAGCAGTACTTC	CASSPPRGGEDYEQYF	TRBV18	TRBJ2-7
TGTGCCAGCAGCTCCGATACGGGGAGCTCCTACAATGAGCAGTTCTTC	CASSSDTGSSYNEQFF	TRBV11-3	TRBJ2-1
TGTGCCAGCAGCAAGGAGGCAGGTTACTATGGCTACACCTTC	CASSKEAGYYGYTF	TRBV13	TRBJ1-2
TGCGCCAGCAGCTACGTAGGCCGGGACAGCGAAGAACTTAACTATGGCTACACCTTC	CASSYVGRDSEELNYGYTF	TRBV5-1	TRBJ1-2
TGTGCCAGCAGCCAAGATCATGGGACCGAGCAGTACTTC	CASSQDHGTEQYF	TRBV14	TRBJ2-7
TGTGCCAGCAGCTCTAGGACAGGGGGCGGCTACGAGCAGTACTTC	CASSSRTGGGYEQYF	TRBV5-4	TRBJ2-7
TGTGCCAGCACAAGTGGGGACAGACCAAACGGGCAGCCCCAGCATTTT	CASTSGDRPNGQPQHF	TRBV7-9	TRBJ1-5
TGTGCCAGCAGCCAATCTTGCTACGAGCAGTACTTC	CASSQSCYEQYF	TRBV14	TRBJ2-7
TGTGCCAGCAGCTTACTTACCAGCACAGATACGCAGTATTTT	CASSLLTSTDTQYF	TRBV7-3	TRBJ2-3
TGTGCCAGTAGTATGAGGGATCAGCCCCAGCATTTT	CASSMRDQPQHF	TRBV19	TRBJ1-5
TGTGCCAGCAGCTTACGCCACTCGCCTCAGGGGGAAGACTCCTACGAGCAGTACTTC	CASSLRHSPQGEDSYEQYF	TRBV7-9	TRBJ2-7
TGTGCCACCAGCAGGGCGAAGGGGGGGATCCACAATGAGCAGTTCTTC	CATSRAKGGIHNEQFF	TRBV15	TRBJ2-1
TGTGCCAGCAGCAGAGAAGACCGGGACAGGCTAGAGGAGGGGCAGCCCCAGCATTTT	CASSREDRDRLEEGQPQHF	TRBV9	TRBJ1-5
TGTGCCAGCAGTTACCGGATCATAGAGACCCAGTACTTC	CASSYRIIETQYF	TRBV6-2	TRBJ2-5
TGCACTCAGGGGGCGCTTTGCGGGGAGCTGTTTTTT	CTQGALCGELFF	TRBV6-1	TRBJ2-2
TGCAGTGCAAGGGGGTTGAGGAGGTTCTTTTACATTCAGTACTTC	CSARGLRRFFYIQYF	TRBV20-1	TRBJ2-4
TGTGCCAGCAGCCAAGTCGTGCTCCAATCGTGGTATGGCTACACCTTC	CASSQVVLQSWYGYTF	TRBV14	TRBJ1-2
TGTGCCACCAGTGCTCCACTAGCGGGAGAGGGCTACGAGCAGTACTTC	CATSAPLAGEGYEQYF	TRBV24-1	TRBJ2-7
TGTGCCAGCAGCTTACTAGCGAGCGGCCCCTCCTACGAGCAGTACTTC	CASSLLASGPSYEQYF	TRBV7-2	TRBJ2-7
TGTGCCAGTAGGGCCGGGGACGAGCAGTACTTC	CASRAGDEQYF	TRBV19	TRBJ2-7
TGTGCCAGCAGCGTAGACAGGCAAGAGGGCTATGGCTACACCTTC	CASSVDRQEGYGYTF	TRBV9	TRBJ1-2
TGCAGTGCTAGGGGGGCTCATGGCTACACCTTC	CSARGAHGYTF	TRBV20-1	TRBJ1-2
TGTGCCAGCAGCAACTCCACAGTTAAGCCCCAGCATTTT	CASSNSTVKPQHF	TRBV7-6	TRBJ1-5
TGTGCCAGTAGTCGCCTCAGGGAAAGTTGCGGCACAGATACGCAGTATTTT	CASSRLRESCGTDTQYF	TRBV19	TRBJ2-3
TGCGCCAGCAGCAATACAGGGGGCAGCTCCTATAATTCACCCCTCCACTTT	CASSNTGGSSYNSPLHF	TRBV10-1	TRBJ1-6
TGTGCCGGCCATAGGAACAATGAGCAGTTCTTC	CAGHRNNEQFF	TRBV11-2	TRBJ2-1
TGCGCCAGCAGCTTCCTGGATCAGCCCCAGCATTTT	CASSFLDQPQHF	TRBV5-1	TRBJ1-5
TGTGCCAGCAAGGGACTAGCGGGCCGCACCGGGGAGCTGTTTTTT	CASKGLAGRTGELFF	TRBV25-1	TRBJ2-2
TGTGCCAGCAGCTTCCGCGGGAGGTCAGGATCTAACTATGGCTACACCTTC	CASSFRGRSGSNYGYTF	TRBV7-2	TRBJ1-2
TGTGCCAGCAGCTTATCGGGACAGGGTCAGCCCCAGCATTTT	CASSLSGQGQPQHF	TRBV7-2	TRBJ1-5
TGTGCCAGCAGCTCCCCCTTGGGGGTTTATAGACTGAACACTGAAGCTTTCTTT	CASSSPLGVYRLNTEAFF	TRBV9	TRBJ1-1
TGTGCCAGCAGCCAAGACCGGGAACGAGGAAACACCATATATTTT	CASSQDRERGNTIYF	TRBV3-1	TRBJ1-3
TGTGCCAGCAGCCAAGACGCGGGAGCTGAAGCTTTCTTT	CASSQDAGAEAFF	TRBV3-1	TRBJ1-1
TGTGCCAGCACCCCCAGTCGCGTCGTCATTTACGAGCAGTACTTC	CASTPSRVVIYEQYF	TRBV28	TRBJ2-7
TGTGCCAGCAGCGCGTATGACAGGGGCTACGAGCAGTACTTC	CASSAYDRGYEQYF	TRBV9	TRBJ2-7
TGCAGTGCTAGAGATGTTCAGTCCGGTGCGGGGGTTTACACCTTC	CSARDVQSGAGVYTF	TRBV20-1	TRBJ1-2
TGCGCCAGCAGTGCCAGGGGGCGAGGACCTGGAGGCCAAGAGACCCAGTACTTC	CASSARGRGPGGQETQYF	TRBV10-1	TRBJ2-5
TGTGCCAGCAGTACTACTACCTTAGGTAATGCCAACACCGGGGAGCTGTTTTTT	CASSTTTLGNANTGELFF	TRBV6-5	TRBJ2-2
TGTGCCAGCAGCGACGGGACAGGGAAGCAGAACACTGAAGCTTTCTTT	CASSDGTGKQNTEAFF	TRBV11-2	TRBJ1-1
TGTGCCAGCACCAGGACCAATAGCACAGATACGCAGTATTTT	CASTRTNSTDTQYF	TRBV6-2	TRBJ2-3
TGTGCCAGCAGACCCCCGGGGGTGACTGAAGCTTTCTTT	CASRPPGVTEAFF	TRBV27	TRBJ1-1
TGTGCCAGTAGTATCCAGGGGACTGAAGCTTTCTTT	CASSIQGTEAFF	TRBV19	TRBJ1-1
TGCGCCAGCAGCCGGCTTCTAGACGAGGGGAAGGGACTCAGCTACACCTTC	CASSRLLDEGKGLSYTF	TRBV4-3	TRBJ1-2
TGCAGTGCCCACAGTGATCCCGCGGGAATGAACACTGAAGCTTTCTTT	CSAHSDPAGMNTEAFF	TRBV20-1	TRBJ1-1
TGCAGTGCTCGGGGGCACCTACCTAGCACAGATACGCAGTATTTT	CSARGHLPSTDTQYF	TRBV20-1	TRBJ2-3
TGCAGCGTTGAAACTGGAGGGGGGAGCTCCTACGAGCAGTACTTC	CSVETGGGSSYEQYF	TRBV29-1	TRBJ2-7
TGTGCCTGGAGGTGGGGACAAAGGGACTATAGCAATCAGCCCCAGCATTTT	CAWRWGQRDYSNQPQHF	TRBV30	TRBJ1-5
TGTGCCAGCAGCCCGGGACAGGGAAACGAGCAGTACTTC	CASSPGQGNEQYF	TRBV9	TRBJ2-7
TGCGCCAGCAGTGCAGGGGTAGCCCAGTACTTC	CASSAGVAQYF	TRBV10-1	TRBJ2-5
TGCGCCAGCAGCTTGCGGGGTTTGGGGACTAGCGGGCGGGGAGGTCGGCCGGGCAGGTACAATGAGCAGTTCTTC	CASSLRGLGTSGRGGRPGRYNEQFF	TRBV5-1	TRBJ2-1
TGCGCCAGCCAGGGACTACAAGAGACCCAGTACTTC	CASQGLQETQYF	TRBV10-1	TRBJ2-5
TGTGCCAGCAGTGAAGGGCAGGAGGGGGGGGCCCAAGAGACCCAGTACTTC	CASSEGQEGGAQETQYF	TRBV2	TRBJ2-5
TGCGCCAGCAGCCAAGAGCGCTTCGAGGGGGGATCCACGGTCTCTGGGGCCAACGTCCTGACTTTC	CASSQERFEGGSTVSGANVLTF	TRBV4-1	TRBJ2-6
TGTGCCGAACCCCGGGGGAACACTGAAGCTTTCTTT	CAEPRGNTEAFF	TRBV5-6	TRBJ1-1
TGTGCCAGCAGCTTAGTTTGCAGGAATGAAGCTTTCTTT	CASSLVCRNEAFF	TRBV7-6	TRBJ1-1
TGCAGTGCTAGAGTCCAAGGACAGGGGTCTATCAAGGGAGCTAACTATGGCTACACCTTC	CSARVQGQGSIKGANYGYTF	TRBV20-1	TRBJ1-2
TGTGCCAGCAGCTCCTGGTTCCCAGCTGAGCAGTTCTTC	CASSSWFPAEQFF	TRBV11-3	TRBJ2-1
TGTGCCTGGAGCACAGAGCCGGGACAGGGTTCCTTCTACGAGCAGTACTTC	CAWSTEPGQGSFYEQYF	TRBV30	TRBJ2-7
TGTGCCAGTTGGCCCGGGACAGTGGGCAATCAGCCCCAGCATTTT	CASWPGTVGNQPQHF	TRBV19	TRBJ1-5
TGTGCCAGCCTCGCGGACAGGGAGGCCCATGGCTACACCTTC	CASLADREAHGYTF	TRBV19	TRBJ1-2
TGTGCCAGCAGTTCGTTTTTGACAAGGGGATTTACAGATACGCAGTATTTT	CASSSFLTRGFTDTQYF	TRBV27	TRBJ2-3
TGCGCCAGCAGCCAAGTCGGACAGGGAAATCGAAATTCACCCCTCCACTTT	CASSQVGQGNRNSPLHF	TRBV4-1	TRBJ1-6
TGTGCCAGCAGTGAAGCGCCGGTCCGGGGGGGGAACACTGAAGCTTTCTTT	CASSEAPVRGGNTEAFF	TRBV2	TRBJ1-1
TGTGCCAGCAGCGAATCACCAACAGGGGAGGGCTACACCTTC	CASSESPTGEGYTF	TRBV13	TRBJ1-2
TGTGCCATCATGAGACTAGCGGGCATTACAACTAGCACAGATACGCAGTATTTT	CAIMRLAGITTSTDTQYF	TRBV10-3	TRBJ2-3
TGTGCCAGCAGTACTTCCGGCCTCTACGAGCAGTACTTC	CASSTSGLYEQYF	TRBV6-1	TRBJ2-7
TGTGCCAGCAGCTTAGCCCGACCTGGGGCCCAGTTCACCGGGGAGCTGTTTTTT	CASSLARPGAQFTGELFF	TRBV7-6	TRBJ2-2
TGTGCCAGCAGCACAGGATTCGGGGCCAACGAGCAGTACTTC	CASSTGFGANEQYF	TRBV7-6	TRBJ2-7
TGTGCCTGGAGAGTGGGTCGAAATAACACCGGGGAGCTGTTTTTT	CAWRVGRNNTGELFF	TRBV30	TRBJ2-2
TGTGCCAGCAGTGATCCCTCTAGGACAGGGGGCCGCGGCTACGAGCAGTACTTC	CASSDPSRTGGRGYEQYF	TRBV25-1	TRBJ2-7
TGCAGTGCACTTCTCCACCGGGGGGCCCCATACGAGCAGTACTTC	CSALLHRGAPYEQYF	TRBV20-1	TRBJ2-7
TGCGCCAGCAGCTCTGGCCGCGATCAGCCCCAGCATTTT	CASSSGRDQPQHF	TRBV5-1	TRBJ1-5
TGCGCCGAAAGGGTTGAAAACTACGAGCAGTACTTC	CAERVENYEQYF	TRBV5-1	TRBJ2-7
TGTGCCAGCGTCAGGGATAATTCACCCCTCCACTTT	CASVRDNSPLHF	TRBV6-5	TRBJ1-6
TGTGCCAGCATTTGCGGGAGCAGGGGGGATACGCAGTATTTT	CASICGSRGDTQYF	TRBV2	TRBJ2-3
TGTGCCAGCAGTGAACCTAGCGGGAGAGGGAAAGGGGGGGGTCGCAGAGACAATGAGCAGTTCTTC	CASSEPSGRGKGGGRRDNEQFF	TRBV6-4	TRBJ2-1
TGCGCCAGCAGCTTGATGGGAGGGCCCATTGGGGTAGATACGCAGTATTTT	CASSLMGGPIGVDTQYF	TRBV5-1	TRBJ2-3
TGTGCCAGTAGTAAGGGGATCACAGATACGCAGTATTTT	CASSKGITDTQYF	TRBV19	TRBJ2-3
TGTGCCAGCAGCTCGACTAGCCGAAGTGCCTACGAGCAGTACTTC	CASSSTSRSAYEQYF	TRBV5-4	TRBJ2-7
TGTGCCAGCAGCTTACTTGGACTAGCGGCCGGCGAGCAGTACTTC	CASSLLGLAAGEQYF	TRBV7-3	TRBJ2-7
TGTGCCAGCAGCTACTGGGGGGAGCCTTCGGAGGAGACCCAGTACTTC	CASSYWGEPSEETQYF	TRBV7-9	TRBJ2-5
TGCGCCAGCAGCCAAGATCTTCGGACAGGGAAGAACACTGAAGCTTTCTTT	CASSQDLRTGKNTEAFF	TRBV4-1	TRBJ1-1
TGTGCCAGCAGCCGAAAGATAGGCAGTACGCAGTATTTT	CASSRKIGSTQYF	TRBV7-4	TRBJ2-3
TGTGCCAGCAGCTTGTACAGGGGGCGGTTGCAGCCCCAGCATTTT	CASSLYRGRLQPQHF	TRBV5-5	TRBJ1-5
TGTGCCAGCACCCGCGGGGGGGATTCCTTGCCACGTTCCTACGAGCAGTACTTC	CASTRGGDSLPRSYEQYF	TRBV25-1	TRBJ2-7
TGTGCCGCGCAGGGGAAAGATTCACCCCTCCACTTT	CAAQGKDSPLHF	TRBV5-6	TRBJ1-6
TGCGCCAGCAGCCAAGATCACCTAGTGTACGGAACCTACAATGAGCAGTTCTTC	CASSQDHLVYGTYNEQFF	TRBV4-1	TRBJ2-1
TGTGCCAGCATACGGACGTTAGGCTACACCTTC	CASIRTLGYTF	TRBV2	TRBJ1-2
TGTGCCAGCAGTCCGTGTCGTTCACTAGCGGGAGGAAGCTCTGGGGCCAACGTCCTGACTTTC	CASSPCRSLAGGSSGANVLTF	TRBV12-3	TRBJ2-6
TGTGCCAGTAGTGGGCCCACAGGATTAACCATATATTTT	CASSGPTGLTIYF	TRBV19	TRBJ1-3
TGTGCGCGCCGCAGAGCCTTC	CARRRAF	TRBV24-1	TRBJ1-2
TGTGCCAGCAGCCCTACTAGCTCCTACAATGAGCAGTTCTTC	CASSPTSSYNEQFF	TRBV13	TRBJ2-1
TGTGCCAGCAGCTTGGTTCGCCGGACAGGGAGGATGAACACTGAAGCTTTCTTT	CASSLVRRTGRMNTEAFF	TRBV11-2	TRBJ1-1
TGTGCCAGCAGCCCCCTCGGGAGGTATCCCAGGTACTTC	CASSPLGRYPRYF	TRBV7-2	TRBJ2-7
TGTGCCATAGGGGTTTCAGGTGCTTTTAACGAGCAGTACTTC	CAIGVSGAFNEQYF	TRBV19	TRBJ2-7
TGTGCATCTCCTGGACACAGTTCCTACAATGAGCAGTTCTTC	CASPGHSSYNEQFF	TRBV9	TRBJ2-1
TGTGCCAGTACGGTATATCTCGAGCAGTACTTC	CASTVYLEQYF	TRBV19	TRBJ2-7
TGCAGTGCCCCCCGTCCCCCCACTAGCGGGAGGACTGGAAACACCATATATTTT	CSAPRPPTSGRTGNTIYF	TRBV20-1	TRBJ1-3
TGTGCCAGCAGCGCAGGGAAGTCAGATACGCAGTATTTT	CASSAGKSDTQYF	TRBV12-4	TRBJ2-3
TGTGCCAGCTTTCTTAGGCGGGAGAGGGTTGAAGCTTTCTTT	CASFLRRERVEAFF	TRBV28	TRBJ1-1
TGTGCTAGTGCAGACAGTCATACGCAGTATTTT	CASADSHTQYF	TRBV12-5	TRBJ2-3
TGCGCCAGCAGCTTGGTCCCAGGGACCCCAGAGACCCAGTACTTC	CASSLVPGTPETQYF	TRBV5-1	TRBJ2-5
TGTGCCAGCAGTGATTTTCCGGGACACTTGGGATATAATGAGCAGTTCTTC	CASSDFPGHLGYNEQFF	TRBV28	TRBJ2-1
TGCGCCAGCAGCAGGGGGGGGAGAAACACCATATATTTT	CASSRGGRNTIYF	TRBV5-1	TRBJ1-3
TGTGCCAGCAGTTACTCAGCGCAAGAGACCCAGTACTTC	CASSYSAQETQYF	TRBV6-5	TRBJ2-5
TGCGCCAGCAGCCAGCCCTTAGTGGGACAGGGTCCAAGCAGAAACATTCAGTACTTC	CASSQPLVGQGPSRNIQYF	TRBV4-1	TRBJ2-4
TGTGCCAGCAGCCAAGGGCAGGACGAAGAGGGCGGGTTCTACGAGCAGTACTTC	CASSQGQDEEGGFYEQYF	TRBV3-1	TRBJ2-7
TGTGCCAGCTCTCTGACTAGCGGGGGAGGGCACACCGGGGAGCTGTTTTTT	CASSLTSGGGHTGELFF	TRBV6-2	TRBJ2-2
TGCAGTGCTAGAATGGGGGGTCGGGGGAGCTATGGCTACACCTTC	CSARMGGRGSYGYTF	TRBV20-1	TRBJ1-2
TGTGCCAGCAGCCGAACGGGGGGGGCAATCTACGAGCAGTACTTC	CASSRTGGAIYEQYF	TRBV3-1	TRBJ2-7
TGTGCCAGCAGTTTGGCAGGGATAGACGAGCAGTACTTC	CASSLAGIDEQYF	TRBV12-4	TRBJ2-7
TGCGCCAGCAGGACCCGAGAGACCCAGTACTTC	CASRTRETQYF	TRBV10-1	TRBJ2-5
TGTGCCAGCAGCTTAAGTCGTGCGAATCAGCCCCAGCATTTT	CASSLSRANQPQHF	TRBV11-1	TRBJ1-5
TGTGCCAGCAGAGCTGGGGGGGCGGCCTACGAGCAGTACTTC	CASRAGGAAYEQYF	TRBV12-3	TRBJ2-7
TGTGCCACCAGTGCCCTCGGGAACAATGAGCAGTTCTTC	CATSALGNNEQFF	TRBV24-1	TRBJ2-1
TGCGCCAGCAGGCCATCGGGGGGTCTTCAGTACTTC	CASRPSGGLQYF	TRBV10-2	TRBJ2-5
TGTGCCAGCAGTTGGACGGGGGGGACAGGGTCATGTTGTGTGTCTGGAAACACCATATATTTT	CASSWTGGTGSCCVSGNTIYF	TRBV12-3	TRBJ1-3
TGTGCCAGCAGCTCTGCTTCTAGAGGCGCTTCGAGAGGATCTGGAAACACCATATATTTT	CASSSASRGASRGSGNTIYF	TRBV7-3	TRBJ1-3
TGTGCCAGCAGCGTAGACCGGTTAAGGGGCACAGATACGCAGTATTTT	CASSVDRLRGTDTQYF	TRBV9	TRBJ2-3
TGTGCCAACTCAGGTCAGTACTTC	CANSGQYF	TRBV6-4	TRBJ2-5
TGTGCCAGCATCCCCCGGGGCTATGGCTACACCTTC	CASIPRGYGYTF	TRBV6-2	TRBJ1-2
TGTGCCAGCAGTCCCCCGGGACTAGCGGGAGGAGGATTTCGCCGAACAGAGACCCAGTACTTC	CASSPPGLAGGGFRRTETQYF	TRBV27	TRBJ2-5
TGCAGTGCTAGATTCCCACCGGGGGATTCACCCCTCCACTTT	CSARFPPGDSPLHF	TRBV20-1	TRBJ1-6
TGCAGTGCCCGTCCGGGACAGCGAAGCGACTATGGCTACACCTTC	CSARPGQRSDYGYTF	TRBV20-1	TRBJ1-2
TGTGCCAGCAGTTATGGGCGGAGGACTAACACCGGGGAGCTGTTTTTT	CASSYGRRTNTGELFF	TRBV6-5	TRBJ2-2
TGTGCCAGCAGACTGGGGGCTAATCAGCCCCAGCATTTT	CASRLGANQPQHF	TRBV12-4	TRBJ1-5
TGTGCCAGCAGCCAAGATTCCTTTCTCAAACAGGATCCCCTCGAAAAACTGTTTTTT	CASSQDSFLKQDPLEKLFF	TRBV3-1	TRBJ1-4
TGTGCCAGCACAGGGGATAAGGGGGGCTCTGGGGCCAACGTCCTGACTTTC	CASTGDKGGSGANVLTF	TRBV6-2	TRBJ2-6
TGTGCCAGCAGCCCCTACGGTCGGTACTTC	CASSPYGRYF	TRBV6-5	TRBJ2-5
TGCGCCAGCGGTCCGGGACACCGGACAGGGGGACCCTACGAGCAGTACTTC	CASGPGHRTGGPYEQYF	TRBV10-1	TRBJ2-7
TGCGCCAGCATAGGAAGGGTTAGCTCCTACGAGCAGTACTTC	CASIGRVSSYEQYF	TRBV10-1	TRBJ2-7
TGCGCCAGCCGGGGGCTCCGAAACACTGAAGCTTTCTTT	CASRGLRNTEAFF	TRBV5-1	TRBJ1-1
TGTGCCAGCACGGACAGGGGAGCCAAAAACATTCAGTACTTC	CASTDRGAKNIQYF	TRBV28	TRBJ2-4
TGTGCCAGCAGGGGGCGATACTATGGCTACACCTTC	CASRGRYYGYTF	TRBV12-4	TRBJ1-2
TGTGCCAGCAGCCCGCATTCAGGGGGCGGAGGGGAGCTGTTTTTT	CASSPHSGGGGELFF	TRBV9	TRBJ2-2
TGCGCCAGCAGAGCGAGGGAGGTTGGAAACACCATATATTTT	CASRAREVGNTIYF	TRBV10-1	TRBJ1-3
TGTGCCGCCGCATTGTTAGAGACCCAGTACTTC	CAAALLETQYF	TRBV27	TRBJ2-5
TGCAGTGCTAGCAGGGGGAGGGCTCGGTCCGTTCCTGCCTACGAGCAGTACTTC	CSASRGRARSVPAYEQYF	TRBV20-1	TRBJ2-7
TGCAGTGCTAGAACATGCAACACCGGGGAGCTGTTTTTT	CSARTCNTGELFF	TRBV20-1	TRBJ2-2
TGTGCCTGGCACTTATGGGAAGTAAATGAAAAACTGTTTTTT	CAWHLWEVNEKLFF	TRBV30	TRBJ1-4
TGTGCCAGCTTACTAGAGATCCCTGATGAGCAGTTCTTC	CASLLEIPDEQFF	TRBV7-4	TRBJ2-1
TGTGCCACCTCCTCTGCACATCCGGGACAGGGGCGACGGATCCCCTCCTACGAGCAGTACTTC	CATSSAHPGQGRRIPSYEQYF	TRBV12-4	TRBJ2-7
TGCGCCAGCAGCTTGGACAGGGAATCGAACACTGAAGCTTTCTTT	CASSLDRESNTEAFF	TRBV5-1	TRBJ1-1
TGTGCCAGCAGGGCCGGGACTTACGAGCAGTACTTC	CASRAGTYEQYF	TRBV27	TRBJ2-7
TGTGCCAGCAAGCCCGCACAGGGCAGCAATCAGCCCCAGCATTTT	CASKPAQGSNQPQHF	TRBV6-2	TRBJ1-5
TGTGCCAGCAGCTTAGTACAGACTAGCGGAATAGGTGAGCAGTTCTTC	CASSLVQTSGIGEQFF	TRBV11-3	TRBJ2-1
TGCAGCGTTGTCCTAGCGGCCACAGATACGCAGTATTTT	CSVVLAATDTQYF	TRBV29-1	TRBJ2-3
TGTGCCAGCAGGATCCTAGCGGGCTGGACAGATACGCAGTATTTT	CASRILAGWTDTQYF	TRBV7-9	TRBJ2-3
TGTGCCAGCAGGACCTTCCGGGTGGCCGATACGCAGTATTTT	CASRTFRVADTQYF	TRBV28	TRBJ2-3
TGTGCCAGCGATAAAACCAGTTCCACTGAAGCTTTCTTT	CASDKTSSTEAFF	TRBV18	TRBJ1-1
TGTGCCAGCAGGGTTTGTAGAGACGGGAGGGCCCTAGGGGTTTACCTCTCTGGAAACACCATATATTTT	CASRVCRDGRALGVYLSGNTIYF	TRBV7-9	TRBJ1-3
TGTGCCAGCAGCTTCAAGGTCTATCGGACTGAAGCTTTCTTT	CASSFKVYRTEAFF	TRBV11-3	TRBJ1-1
TGTGCCAGCAGTTACCTGGGGCTCACCTCTGGAAACACCATATATTTT	CASSYLGLTSGNTIYF	TRBV6-5	TRBJ1-3
TGTGGCCGACAGGGGTATAGCAATCAGCCCCAGCATTTT	CGRQGYSNQPQHF	TRBV9	TRBJ1-5
TGTGCCAGCAGTTTAGCCTTGACTAGCGCGGAGCAGTTCTTC	CASSLALTSAEQFF	TRBV27	TRBJ2-1
TGTGCCAGCAGCTTCCTCGGGGGGGGGGTTCCGGACTTC	CASSFLGGGVPDF	TRBV11-2	TRBJ2-5
TGTGCCAGCAGTTTGCTAGCGGGAGATACGCAGTATTTT	CASSLLAGDTQYF	TRBV27	TRBJ2-3
TGTGCCAGCAGCTTCGCAGGGGGCGGGAGGGCCGAGCAGTACTTC	CASSFAGGGRAEQYF	TRBV7-3	TRBJ2-7
TGTGCCACCAGTGAGCCTCCCGCGGGAAACACCATATATTTT	CATSEPPAGNTIYF	TRBV24-1	TRBJ1-3
TGTGCCGACAGGGGGGATACGCAGTATTTT	CADRGDTQYF	TRBV10-3	TRBJ2-3
TGTGCCAGCAGCTTATCACCCAAAGGGGACAGGTATTCTGAAGCTTTCTTT	CASSLSPKGDRYSEAFF	TRBV11-2	TRBJ1-1
TGTGCCAGCAGTTACGCGGGGGGAGGATGGGCCTACGAGCAGTACTTC	CASSYAGGGWAYEQYF	TRBV27	TRBJ2-7
TGCAGCGACCAGGGGGAAGCTGAAGCTTTCTTT	CSDQGEAEAFF	TRBV29-1	TRBJ1-1
TGCGCCAGCTGCCCCCCTAGCGGTGTGTGGCGGGACACCGGGGAGCTGTTTTTT	CASCPPSGVWRDTGELFF	TRBV5-1	TRBJ2-2
TGCAGCGTTTGGGGGGGAGTGGGTGAGCAGTTCTTC	CSVWGGVGEQFF	TRBV29-1	TRBJ2-1
TGTGCCAGTAGTATAGGCTGGGACAGGGGGGTACCCCACACTGAAGCTTTCTTT	CASSIGWDRGVPHTEAFF	TRBV19	TRBJ1-1
TGTGCCAGCAGCTCCCCTAGGAAAGGAGAGACCCAGTACTTC	CASSSPRKGETQYF	TRBV13	TRBJ2-5
TGTGCCAGCAGCCCCCTAGGAGAGGAGCTGTTTTTT	CASSPLGEELFF	TRBV14	TRBJ2-2
TGTGCTAGTGGTTTGCTATGGCTTGGGGCTGGGTTGAGCTACACCTTC	CASGLLWLGAGLSYTF	TRBV12-5	TRBJ1-2
TGCGCCAGCAGCTTGCCAATCAAAGCCGACCTGCAAGAGACCCAGTACTTC	CASSLPIKADLQETQYF	TRBV5-1	TRBJ2-5
TGTGCCAGCAGCTTGTCGGGGCAGGGGGCGTATGGCTACACCTTC	CASSLSGQGAYGYTF	TRBV5-6	TRBJ1-2
TGTGCCAGCAGCTTCGTGAAGGACCGGTATGGCTACACCTTC	CASSFVKDRYGYTF	TRBV5-4	TRBJ1-2
TGCAGTGCTCTGCCTGGCAGGGGGGGGGAGACCCAGTACTTC	CSALPGRGGETQYF	TRBV20-1	TRBJ2-5
TGTGCCAGCAGCATTACCGGGACAGGGGAGGAGACCTACGAGCAGTACTTC	CASSITGTGEETYEQYF	TRBV5-6	TRBJ2-7
TGTGCCAGCAGCTGGCCGGGTTTCGAGCAGTACTTC	CASSWPGFEQYF	TRBV7-2	TRBJ2-7
TGTGCCAGCAGTGTAGACGACAGCCTGGCCACTGAAGCTTTCTTT	CASSVDDSLATEAFF	TRBV28	TRBJ1-1
TGTGCCAGCAGCCAAAAGACAGGTTGGGTTACCCTTCCCTACGAGCAGTACTTC	CASSQKTGWVTLPYEQYF	TRBV3-1	TRBJ2-7
TGCAGCGTTGAAGATCCATCCGATCCGGACAGGGGGTGGGCTAATGAAAAACTGTTTTTT	CSVEDPSDPDRGWANEKLFF	TRBV29-1	TRBJ1-4
TGTGCCAGTAGCAGCGGGAGGGGCAATCAGCCCCAGCATTTT	CASSSGRGNQPQHF	TRBV19	TRBJ1-5
TGTGCCAGCAGCTTGTTGACTAGCGGGGTACTTAACAATGAGCAGTTCTTC	CASSLLTSGVLNNEQFF	TRBV5-8	TRBJ2-1
TGCGCCAGCAGCATGCCCCCGCAGGGGGCAGGGGGGATAAACTACGAGCAGTACTTC	CASSMPPQGAGGINYEQYF	TRBV5-1	TRBJ2-7
TGTGCCAGCAGCTACCAGGGGGGGGTAAGCTACGAGCAGTACTTC	CASSYQGGVSYEQYF	TRBV14	TRBJ2-7
TGTGCCAGCTCACCCGGTGACAGGGTAGTTAAGACCTATGGCTACACCTTC	CASSPGDRVVKTYGYTF	TRBV18	TRBJ1-2
TGCAGTGCTAGACCAGCATGGGACGGGATCTATGGCTACACCTTC	CSARPAWDGIYGYTF	TRBV20-1	TRBJ1-2
TGTGCCAGCAGCTCATGGGAGGGGGGCAATCAGCCCCAGCATTTT	CASSSWEGGNQPQHF	TRBV5-6	TRBJ1-5
TGTGCCAGCAGTTACGAATCCTCGGGCAGGAAGACCGCAGATACGCAGTATTTT	CASSYESSGRKTADTQYF	TRBV6-2	TRBJ2-3
TGTGCCTCTCAGGTGCTTGGCTACACCTTC	CASQVLGYTF	TRBV19	TRBJ1-2
TGTGCCAGTAGTATATTCCTCCCCCGGACAGGCGGGGTTCCCTACGAGCAGTACTTC	CASSIFLPRTGGVPYEQYF	TRBV19	TRBJ2-7
TGTGCCAGCAGTGAGGGGCCAGGAGCCGAAAAACTGTTTTTT	CASSEGPGAEKLFF	TRBV25-1	TRBJ1-4
TGCAGTGCTCCGGGCCGGGACAGTACGGGCAATCAGCCCCAGCATTTT	CSAPGRDSTGNQPQHF	TRBV20-1	TRBJ1-5
TGTGCCAGCAGCCAAGATTCCTCGGTCTGCTACGAGCAGTACTTC	CASSQDSSVCYEQYF	TRBV3-1	TRBJ2-7
TGTGCCAGCAGTTTCCCGGGACAGGGGTGCAATCAGCCCCAGCATTTT	CASSFPGQGCNQPQHF	TRBV27	TRBJ1-5
TGTGCCAGCAGCGTAGGGCGGACCGACACCTTC	CASSVGRTDTF	TRBV7-8	TRBJ1-2
TGTGCCAGCAGTTACCAGACCCATGAGCAGCCCCAGCATTTT	CASSYQTHEQPQHF	TRBV28	TRBJ1-5
TGTGCCACCCTACCCCATATGGGGTTCGGTGGAAGGCCTGAAGCTTTCTTT	CATLPHMGFGGRPEAFF	TRBV15	TRBJ1-1
TGCGCCAGCAGTGCTAGCGGGACAGGGGGGGGCGAGCAGTACTTC	CASSASGTGGGEQYF	TRBV10-1	TRBJ2-7
TGTGCCAAACGACAGGCTATCTTTAACTACGAGCAGTACTTC	CAKRQAIFNYEQYF	TRBV19	TRBJ2-7
TGTGCCATCAGACAGGGCCAGTCCTCTGGAAACACCATATATTTT	CAIRQGQSSGNTIYF	TRBV19	TRBJ1-3
TGCAGTGCTAGAAACAGGGTCCGAAACACCATATATTTT	CSARNRVRNTIYF	TRBV20-1	TRBJ1-3
TGCGCCACTCAAATAGTCAGGGGCAAGTACTTC	CATQIVRGKYF	TRBV5-1	TRBJ2-7
TGTGCCAGCAGCTTACAGAAGGCCCCCTACAATGAGCAGTTCTTC	CASSLQKAPYNEQFF	TRBV11-3	TRBJ2-1
TGTGCCAGCACCGGACTCCGATACAATGAGCAGTTCTTC	CASTGLRYNEQFF	TRBV27	TRBJ2-1
TGTGCCAGGCCGAAGGACTTAGCGGGGAATGAGCAGTTCTTC	CARPKDLAGNEQFF	TRBV28	TRBJ2-1
TGTGCCACCAGTGATCACGACAGGGGGGATGAGCAGTTCTTC	CATSDHDRGDEQFF	TRBV24-1	TRBJ2-1
TGCCAACGGTACGGGACTATATACAATGAGCAGTTCTTC	CQRYGTIYNEQFF	TRBV5-1	TRBJ2-1
TGTGCCACCAGCAGAACCGGGAATGGGACTCGGGGAGAGACCCAGTACTTC	CATSRTGNGTRGETQYF	TRBV15	TRBJ2-5
TGTGCCAGCAGTGAATGGCAGGGGGAAGGCAATCAGCCCCAGCATTTT	CASSEWQGEGNQPQHF	TRBV6-1	TRBJ1-5
TGTGCCAGCAGCTCCGTCTTCGCCCCCGGGACAGGGGAGGACACTGAAGCTTTCTTT	CASSSVFAPGTGEDTEAFF	TRBV11-3	TRBJ1-1
TGTGCCGGAGGTCCCGGGGTCTCTGAAAAACTGTTTTTT	CAGGPGVSEKLFF	TRBV7-6	TRBJ1-4
TGCGCCAGCAGTGAGCCAAACAGGGCTTATAGCAATCAGCCCCAGCATTTT	CASSEPNRAYSNQPQHF	TRBV10-1	TRBJ1-5
TGTGCCAGCAGTTCGGATCGGGGGCTGGACGAGCAGTACTTC	CASSSDRGLDEQYF	TRBV6-5	TRBJ2-7
TGTGCCAGCAGCGTAGGGGAATACACAGATACGCAGTATTTT	CASSVGEYTDTQYF	TRBV9	TRBJ2-3
TGCAGTGCGGTAGGCAGGGATCAGCCCCAGCATTTT	CSAVGRDQPQHF	TRBV20-1	TRBJ1-5
TGTGCCACCAGTGCAAGACGGACAGAAAAAGCTTTCTTT	CATSARRTEKAFF	TRBV24-1	TRBJ1-1
TGTGCCAGCAGCGAACCGGCGAGGCCTTTTACGGGGCGGTCTGCTTCCGGGGAGCTGTTTTTT	CASSEPARPFTGRSASGELFF	TRBV2	TRBJ2-2
TGCGCCAGCAGCCAAGAGGGAGGTCAGTGCGGGGAGCTGTTTTTT	CASSQEGGQCGELFF	TRBV4-1	TRBJ2-2
TGTGCCATCAGTGAGTCGGAAGCAGGGCAGTGCACAAATCAGCCCCAGCATTTT	CAISESEAGQCTNQPQHF	TRBV10-3	TRBJ1-5
TGTGCCAGCAGTTACCATGATCACCGGACAGGGGGGGCAATGAACACTGAAGCTTTCTTT	CASSYHDHRTGGAMNTEAFF	TRBV6-2	TRBJ1-1
TGTGCCAGCAGCGCCGACAGGGATAATTCACCCCTCCACTTT	CASSADRDNSPLHF	TRBV9	TRBJ1-6
TGTGCCAGCAGCCCAAAGTCAAGGGAAGACACTGAAGCTTTCTTT	CASSPKSREDTEAFF	TRBV3-1	TRBJ1-1
TGTGCCAGCCGGCCTGGGGGCAAGTACAATGAGCAGTTCTTC	CASRPGGKYNEQFF	TRBV13	TRBJ2-1
TGCGCCAGCAGCCAAGGTGGGGCCCTAAACTACGAGCAGTACTTC	CASSQGGALNYEQYF	TRBV4-1	TRBJ2-7
TGTGCCAGCAGAGTTGTGAGGCTCGAAAAACTGTTTTTT	CASRVVRLEKLFF	TRBV12-3	TRBJ1-4
TGTGCCAGCAGCCAGCCCGGGACTAGCCCCGAGCAGTACTTC	CASSQPGTSPEQYF	TRBV14	TRBJ2-7
TGTGCCAGCAGTAGGCTTTACGCCGGTGGCTACACCTTC	CASSRLYAGGYTF	TRBV12-3	TRBJ1-2
TGTGCCAGCAGATTGTTAAGGACGGACGAGCAGTACTTC	CASRLLRTDEQYF	TRBV6-4	TRBJ2-7
TGTGCCAGCAGCCAAGTGTCCGGGGGGCCTGAATACGAGCAGTACTTC	CASSQVSGGPEYEQYF	TRBV3-1	TRBJ2-7
TGTGCCACCAGTGATTTCAAGGAAGAAGAGACCCAGTACTTC	CATSDFKEEETQYF	TRBV24-1	TRBJ2-5
TGTGCCAGCAGCTTCGGGAGCTTCTACGAGCAGTACTTC	CASSFGSFYEQYF	TRBV7-9	TRBJ2-7
TGTGCCAGCAGTTGGGATATCCCTATTCTCTATGGCTACACCTTC	CASSWDIPILYGYTF	TRBV27	TRBJ1-2
TGTGCCAGCAGTGAGGGACCAGGCGACAAAAACACTGAAGCTTTCTTT	CASSEGPGDKNTEAFF	TRBV6-4	TRBJ1-1
TGTGCCACCAGGGCTTCGAATGCTGGGGTCACAGATACGCAGTATTTT	CATRASNAGVTDTQYF	TRBV24-1	TRBJ2-3
TGCAGCATGGCCCGACAGGTGGCCGGGTATCAGCCCCAGCATTTT	CSMARQVAGYQPQHF	TRBV29-1	TRBJ1-5
TGTGCCAGCAGCTTTAGGGATCTCCGGACGAACACCGGGGAGCTGTTTTTT	CASSFRDLRTNTGELFF	TRBV7-6	TRBJ2-2
TGTGCCAGCAGCCGTGGGGGGGGTGGAAATGAAAAACTGTTTTTT	CASSRGGGGNEKLFF	TRBV4-2	TRBJ1-4
TGCAGCGTCAAATGGGGGGTAGGGACAGGGGGCGACCTTTATGCAACTAATGAAAAACTGTTTTTT	CSVKWGVGTGGDLYATNEKLFF	TRBV29-1	TRBJ1-4
TGTGCCAGCAGCCAGGACAGGTGGGAGCAGTACTTC	CASSQDRWEQYF	TRBV14	TRBJ2-7
TGTGCCTATAACAAACCCTACGAGCAGTACTTC	CAYNKPYEQYF	TRBV25-1	TRBJ2-7
TGCAGTGCGGAACCGGGACTAGCGGGCTTC	CSAEPGLAGF	TRBV20-1	TRBJ2-5
TGTGCCAGCAGTTACGGGACAGGGGACAATGAGCAGTTCTTC	CASSYGTGDNEQFF	TRBV6-2	TRBJ2-1
TGTGCCACCAGCAGGACACAGGGACAACGGGATTACGAGCAGTACTTC	CATSRTQGQRDYEQYF	TRBV15	TRBJ2-7
TGTGCCAGCAGCCTAGGAAAGGGGAACACTGAAGCTTTCTTT	CASSLGKGNTEAFF	TRBV7-3	TRBJ1-1
TGCAGCGTTGTAACATGGGACACCGGGGAGCTGTTTTTT	CSVVTWDTGELFF	TRBV29-1	TRBJ2-2
TGTGCCAGCAGTTCTGGGGGGTACGAGCAGTACTTC	CASSSGGYEQYF	TRBV6-1	TRBJ2-7
TGCGCCAGCAGCTTGGGCCAAGCTAAAGTCTACAATGAGCAGTTCTTC	CASSLGQAKVYNEQFF	TRBV5-1	TRBJ2-1
TGTGCCAGGGGAATACTCGAACAGGGGGCGCCAGCTTACACTGAAGCTTTCTTT	CARGILEQGAPAYTEAFF	TRBV25-1	TRBJ1-1
TGTGCCTGGAGTGGTACTAGCGGGAGGCTAGAGACCCAGTACTTC	CAWSGTSGRLETQYF	TRBV30	TRBJ2-5
TGCGCCAGCAGCTTGGGCACAGGGGGCGAAAGTGAGCAGTTCTTC	CASSLGTGGESEQFF	TRBV5-1	TRBJ2-1
TGTGCCAGCACGACCATCGAACGGGACCGACCCCAAGAGACCCAGTACTTC	CASTTIERDRPQETQYF	TRBV3-1	TRBJ2-5
TGTGCCAGCAGCGGTTACCGGAAATGCCCGTTGACGAACACCGGGGAGCTGTTTTTT	CASSGYRKCPLTNTGELFF	TRBV27	TRBJ2-2
TGCAGTGCTCCGGAGGGAGGTTGGAATTCACCCCTCCACTTT	CSAPEGGWNSPLHF	TRBV20-1	TRBJ1-6
TGTGCCAGCAGTGAAATCCAGGGGTCACCCCTCCACTTT	CASSEIQGSPLHF	TRBV6-1	TRBJ1-6
TGCAGCGTTGAAGGCGGCGGGGAGCTGTTTTTT	CSVEGGGELFF	TRBV29-1	TRBJ2-2
TGTGCCAGCAGCAGGAGACCTGACAGGGTGAGAAACACCATATATTTT	CASSRRPDRVRNTIYF	TRBV7-3	TRBJ1-3
TGTGCCACCACCAATAGCGGGTCGAGCTCCTACAATGAGCAGTTCTTC	CATTNSGSSSYNEQFF	TRBV24-1	TRBJ2-1
TGTGCCACCAGTGATTCGGGGACTAGCGGGGGGGCCTACCGTGAGCAGTACTTC	CATSDSGTSGGAYREQYF	TRBV24-1	TRBJ2-7
TGTGCCATCAGTGTTGGAGACGAGCAAGAGACCCAGTACTTC	CAISVGDEQETQYF	TRBV10-3	TRBJ2-5
TGTGCCAGCAGCGTAGTGGGACTAGCGGGATATTCCAGAGTCTGCTACAATGAGCAGTTCTTC	CASSVVGLAGYSRVCYNEQFF	TRBV9	TRBJ2-1
TGTGCCAGCAGCCGTGAGGGGGCGCCCCAGCATTTT	CASSREGAPQHF	TRBV6-5	TRBJ1-5
TGTGCCAGCAGTTCGGGGGGGGTGTTTCCCGGCTACACCTTC	CASSSGGVFPGYTF	TRBV27	TRBJ1-2
TGTGCCACCAGTGGGGGAGGGCCATCTCTGAGGGAGACCCAGTACTTC	CATSGGGPSLRETQYF	TRBV24-1	TRBJ2-5
TGCAGCGTTGATAAGGAGGACAGGATAGGGTTTCCTGATACGCAGTATTTT	CSVDKEDRIGFPDTQYF	TRBV29-1	TRBJ2-3
TGTGCCAGCAGGACTAGCGGGTCTCCCGGGGAGCTGTTTTTT	CASRTSGSPGELFF	TRBV6-5	TRBJ2-2
TGCAGTGCTAGAGATCATCGCAGGGGCCTCAATCAGCCCCAGCATTTT	CSARDHRRGLNQPQHF	TRBV20-1	TRBJ1-5
TGCAGCGTTGGTCCACCCGGGACAGGGCTCGAGCAGTACTTC	CSVGPPGTGLEQYF	TRBV29-1	TRBJ2-7
TGTGCCAGCAGCTTACCCCTAGCGGGTCAATGCCTGCAGTTCTTC	CASSLPLAGQCLQFF	TRBV7-3	TRBJ2-1
TGCAGTGCTAGAGTAGCGGGGGATACAGATACGCAGTATTTT	CSARVAGDTDTQYF	TRBV20-1	TRBJ2-3
TGTGCCAGAGGACAGGGGGCCCACGAGCAGTACTTC	CARGQGAHEQYF	TRBV3-1	TRBJ2-7
TGTGCCAGCACTCCGCGGCTAGGAATAGGATACGAGCAGTACTTC	CASTPRLGIGYEQYF	TRBV11-3	TRBJ2-7
TGTGCCAGTAGTATCCGGGGGTACAATGAGCAGTTCTTC	CASSIRGYNEQFF	TRBV19	TRBJ2-1
TGTGCCAGCAGCTTTGAAGAGGGGAGCTATGGCTACACCTTC	CASSFEEGSYGYTF	TRBV7-2	TRBJ1-2
TGTGCCACCGGACAGGGTGACTTCTATGGCTACACCTTC	CATGQGDFYGYTF	TRBV15	TRBJ1-2
TGCGCCAGCAGGAAACCGGAAATCACTGAAGCTTTCTTT	CASRKPEITEAFF	TRBV5-1	TRBJ1-1
TGTGCCAGCAGTAGACTGGGACTAGCGTTCCCAGAGACCCAGTACTTC	CASSRLGLAFPETQYF	TRBV12-4	TRBJ2-5
TGTGCCAGCATTACTTGCGGGCTATCAGATACGCAGTATTTT	CASITCGLSDTQYF	TRBV5-4	TRBJ2-3
TGTGCCAGCAGTTACCCGACGGGGGACATTGCTTCCTACGAGCAGTACTTC	CASSYPTGDIASYEQYF	TRBV6-5	TRBJ2-7
TGCAGTGCTAGAGATTGGGGCTACGAGCAGTACTTC	CSARDWGYEQYF	TRBV20-1	TRBJ2-7
TGTGCCACCAGGGCCGGGAGCTCCTACGAGCAGTACTTC	CATRAGSSYEQYF	TRBV28	TRBJ2-7
TGTGCCAGCAGTTTATCAAAGGGCGGGGGGCTGGATGAGACCCAGTACTTC	CASSLSKGGGLDETQYF	TRBV27	TRBJ2-5
TGTGCCAGCTCCGGGGACAGGGGGCGGTCGTGCTTTCTGTATGGCTACACCTTC	CASSGDRGRSCFLYGYTF	TRBV18	TRBJ1-2
TGTGCCAGTAGTATAGATGGTCCGGGGGTTTCCTATGGCTACACCTTC	CASSIDGPGVSYGYTF	TRBV19	TRBJ1-2
TGCAGTGCTAGTGGGGGAAAGGGACTAGCTCGGCAAGAGACCCAGTACTTC	CSASGGKGLARQETQYF	TRBV20-1	TRBJ2-5
TGCACCGGTGTGGGGGTCACCGAGCAGTACTTC	CTGVGVTEQYF	TRBV29-1	TRBJ2-7
TGCAGTTATGGGAGAGGCAGCTCCTATAATTCACCCCTCCACTTT	CSYGRGSSYNSPLHF	TRBV20-1	TRBJ1-6
TGCGCCAGCAGCGAACTTGGGGATGAGCAGTACTTC	CASSELGDEQYF	TRBV5-1	TRBJ2-7
TGTGCCAACGGGGACACGGGGGAGGAAGAGAACTATGGCTACACCTTC	CANGDTGEEENYGYTF	TRBV5-5	TRBJ1-2
TGTGCCAGCAAGAAATGGGGTGACGCCCTGTTTTTT	CASKKWGDALFF	TRBV6-5	TRBJ1-4
TGTGCCAGTAGTCTCCAATTATCATCAACCAGCAACACTGAAGCTTTCTTT	CASSLQLSSTSNTEAFF	TRBV19	TRBJ1-1
TGTGCCAGCAGCACGTCACGAGACAGGGATGGGGAGCAGTACTTC	CASSTSRDRDGEQYF	TRBV12-3	TRBJ2-7
TGTGCCAGCAGCCTAGCCGGGACTAGCGGGAGTGGAGATACGCAGTATTTT	CASSLAGTSGSGDTQYF	TRBV7-9	TRBJ2-3
TGTGCCAGCAGTGTCACTAGCGGGAGTAAATGCAATCAGCCCCAGCATTTT	CASSVTSGSKCNQPQHF	TRBV27	TRBJ1-5
TGTGCCAGTAGGCATACAGGGGGCGGATTAGCAATCCGGGATCTCTACGAGCAGTACTTC	CASRHTGGGLAIRDLYEQYF	TRBV19	TRBJ2-7
TGTCAACCGGGACTAGTCCTTTCGAACCAAGAGACCCAGTACTTC	CQPGLVLSNQETQYF	TRBV30	TRBJ2-5
TGTGCCAGCAGCTTACTGGGGGACACTGAAGCTTTCTTT	CASSLLGDTEAFF	TRBV7-6	TRBJ1-1
TGTGCCAGCAGCCAAGGTCTGCAACTGATAGAGAACACTGAAGCTTTCTTT	CASSQGLQLIENTEAFF	TRBV14	TRBJ1-1
TGCAGCGTTGAAGTGGCACCGTTAGTCAGTCTCTCTGATTACAATGAGCAGTTCTTC	CSVEVAPLVSLSDYNEQFF	TRBV29-1	TRBJ2-1
TGTGCCAGCAAGGGCCACTTCTACGAGCAGTACTTC	CASKGHFYEQYF	TRBV12-3	TRBJ2-7
TGTGCCAGCAGTGAACCCGAGGGAGAGTTCTGCTACACCTTC	CASSEPEGEFCYTF	TRBV6-4	TRBJ1-2
TGCGCCAGCAGCTTGGACAGGGCAGGGGAAAAACTGTTTTTT	CASSLDRAGEKLFF	TRBV5-1	TRBJ1-4
TGTGCCAGCAGCTTGGGGGGAGGGAATAGCTCCTACGAGCAGTACTTC	CASSLGGGNSSYEQYF	TRBV27	TRBJ2-7
TGTGCCAGTAATATATTACAGGGGGCATACGAGCAGTACTTC	CASNILQGAYEQYF	TRBV19	TRBJ2-7
TGTGCCACAAATCGGCTAGAAGAGACCCAGTACTTC	CATNRLEETQYF	TRBV19	TRBJ2-5
TGCGCCAGCAGTCCTAATTATGGCTACACCTTC	CASSPNYGYTF	TRBV10-1	TRBJ1-2
TGCGCTATAGCGGGCGGCACCGGGGAGCTGTTTTTT	CAIAGGTGELFF	TRBV5-1	TRBJ2-2
TGTGCCAAAATGACGAGCAATGAGCAGTTCTTC	CAKMTSNEQFF	TRBV12-3	TRBJ2-1
TGTGCCTGGAGTGTACCAGACCCACTAATGAACACTGAAGCTTTCTTT	CAWSVPDPLMNTEAFF	TRBV30	TRBJ1-1
TGTGCCAGCCGGCCCCGAGTTGAGACCCAGTACTTC	CASRPRVETQYF	TRBV7-9	TRBJ2-5
TGTGCCAACGAGCTCGTCCGAAGGGGGCAATTACCAGAGACCCAGTACTTC	CANELVRRGQLPETQYF	TRBV6-2	TRBJ2-5
TGTGCCAGCGCCTGGAGACTGCAACGTCTCGCTTTCTTT	CASAWRLQRLAFF	TRBV6-2	TRBJ1-1
TGTGCCACCAGTGACCGGACCAACGAATCCTACGAGCAGTACTTC	CATSDRTNESYEQYF	TRBV24-1	TRBJ2-7
TGTGCCAGCAGCTTAGATACCGACATCCCCCCTAGCACCTACGAGCAGTACTTC	CASSLDTDIPPSTYEQYF	TRBV11-2	TRBJ2-7
TGTGCCAGCAGCCACCCTTGGGGGCCCAAGTCAGATACGCAGTATTTT	CASSHPWGPKSDTQYF	TRBV7-3	TRBJ2-3
TGTGCCACCAGCAGCGGAGTGTTAGGGGGTTCGTGGATACCTTTAGCTGAGCAGTTCTTC	CATSSGVLGGSWIPLAEQFF	TRBV15	TRBJ2-1
TGCGCCAGTCTGAGGTCTTCCGGGACAGGGATTGAAAAACTGTTTTTT	CASLRSSGTGIEKLFF	TRBV10-1	TRBJ1-4
TGTGCCAGCAGCCAAGATCCGTTGAGGTACAATGAGCAGTTCTTC	CASSQDPLRYNEQFF	TRBV14	TRBJ2-1
TGTGCCAGCAGCCACGAGGTGGGTATGCCGTCGTACTCGAGCAATCAGCCCCAGCATTTT	CASSHEVGMPSYSSNQPQHF	TRBV3-1	TRBJ1-5
TGTGCCACCAGTGATACACTTGCTGGACAGGGCCTAACTGAAGCTTTCTTT	CATSDTLAGQGLTEAFF	TRBV24-1	TRBJ1-1
TGTGCCAGCAGCAATGGACGCCATGTTTGGAACACTGAAGCTTTCTTT	CASSNGRHVWNTEAFF	TRBV11-3	TRBJ1-1
TGTGCCAGCAGCCCTCCTTCACAGGGAACGGGCAATCAGCCCCAGCATTTT	CASSPPSQGTGNQPQHF	TRBV13	TRBJ1-5
TGCAGCGGGACAGTTACGTACGAGCAGTACTTC	CSGTVTYEQYF	TRBV29-1	TRBJ2-7
TGTGCCAGCAGCTTAAGGGTTCCCCCGGGCACTGAAGCTTTCTTT	CASSLRVPPGTEAFF	TRBV7-3	TRBJ1-1
TGCAGCGCCGTGACAGATACGCAGTATTTT	CSAVTDTQYF	TRBV29-1	TRBJ2-3
TGTGCCAGCAGCTTAGCGAAGGGAAGTTCCGGGGAGCTGTTTTTT	CASSLAKGSSGELFF	TRBV7-4	TRBJ2-2
TGTGCCAGCAGCGTTCCAGGGCTGGCGAAAGCTTTCTTT	CASSVPGLAKAFF	TRBV5-4	TRBJ1-1
TGTGCCAGCACGTGGGACAGGTATCGGGAAGCTTTCTTT	CASTWDRYREAFF	TRBV28	TRBJ1-1
TGTGCCAGCTTTTCACGCCTTCTAGCCCGATACGAGCAGTACTTC	CASFSRLLARYEQYF	TRBV14	TRBJ2-7
TGCAGTGCTAGCGCGGTTGGGACTGAAGCTTTCTTT	CSASAVGTEAFF	TRBV20-1	TRBJ1-1
TGTGCCAGCAGCGGTCCGTCTGCAGCACAAGAGACCCAGTACTTC	CASSGPSAAQETQYF	TRBV9	TRBJ2-5
TGTGCCAGCAGCCGGCCGGGACTAGCGGCCTACGAGCAGTACTTC	CASSRPGLAAYEQYF	TRBV3-1	TRBJ2-7
TGTGCCATGTCCGATCAGGGCGGCCGGTACAATGAGCAGTTCTTC	CAMSDQGGRYNEQFF	TRBV10-3	TRBJ2-1
TGTGCCAGCAGTGCAGGGGGCCGAATGAACACTGAAGCTTTCTTT	CASSAGGRMNTEAFF	TRBV6-4	TRBJ1-1
TGCGCCAGCAGCCAAGAGGCTCCAGGGGCGAACCCAGATACGCAGTATTTT	CASSQEAPGANPDTQYF	TRBV4-3	TRBJ2-3
TGTGCCAGCAGTTATCTGCCGGGGGCGAAGAACACCGGGGAGCTGTTTTTT	CASSYLPGAKNTGELFF	TRBV27	TRBJ2-2
TGTGCCAGCGTATGTCCTGACAGAGGCTCAGCGGATTCACCCCTCCACTTT	CASVCPDRGSADSPLHF	TRBV6-2	TRBJ1-6
TGTGCCAGCAGTGGAGAAACGACAGATGATGATGAAAAACTGTTTTTT	CASSGETTDDDEKLFF	TRBV2	TRBJ1-4
TGTGCCAGCCCGCACTATGGCTACACCTTC	CASPHYGYTF	TRBV9	TRBJ1-2
TGTGCCAGCAGCTTCAAGACAGGAGGGGGAGGGTACTACGAGCAGTACTTC	CASSFKTGGGGYYEQYF	TRBV7-6	TRBJ2-7
TGTGCCAGCAGTGGATACTTTAGGGGTCCCAATGAGCAGTTCTTC	CASSGYFRGPNEQFF	TRBV6-1	TRBJ2-1
TGTGCCAGCAGTGGGTCGGGGAACACCGGGGAGCTGTTTTTT	CASSGSGNTGELFF	TRBV12-3	TRBJ2-2
TGTGCCAGCAGTGACGTCCCAGGTTTGCATTTT	CASSDVPGLHF	TRBV6-4	TRBJ1-5
TGTGCCACCAGACGGGAAAAACTGTTTTTT	CATRREKLFF	TRBV24-1	TRBJ1-4
TGTGCCAGCAGTACTAGCGGGTTCACTGAAGCTTTCTTT	CASSTSGFTEAFF	TRBV27	TRBJ1-1
TGTGCCATCAGTGACTTCCGGGACGAGCAGTACTTC	CAISDFRDEQYF	TRBV10-3	TRBJ2-7
TGTGCTAGTGGTTTGTATCATCGGGGTGGTTGGAATGAGCAGTTCTTC	CASGLYHRGGWNEQFF	TRBV12-5	TRBJ2-1
TGTGCCAGCAGCTTTTACCGGGGCGGGAGGTTCTTCTCCCAGCATTTT	CASSFYRGGRFFSQHF	TRBV5-5	TRBJ1-5
TGTGCTAGTGGTTGGGAGGCTAGGAGCGCCAAAAACATTCAGTACTTC	CASGWEARSAKNIQYF	TRBV12-5	TRBJ2-4
TGTGCCAGCAGGGGGTCAAGGGGGGCGAGTCACTCTACAGATACGCAGTATTTT	CASRGSRGASHSTDTQYF	TRBV7-4	TRBJ2-3
TGTGCCAGCAGCTTAGACAGGGGGAACTATGGCTACACCTTC	CASSLDRGNYGYTF	TRBV11-3	TRBJ1-2
TGTGCCAGCAGCGGACGCACCGACCTGCGATACGAGCAGTACTTC	CASSGRTDLRYEQYF	TRBV9	TRBJ2-7
TGTGCCAGCAGCCTGGAAGCAGGGGAACTCCGCACTGAAGCTTTCTTT	CASSLEAGELRTEAFF	TRBV11-3	TRBJ1-1
TGCGCCAGCCAGGTGACGAATCGGAACATGTACAATGAGCAGTTCTTC	CASQVTNRNMYNEQFF	TRBV5-1	TRBJ2-1
TGTGCCACCAGTGATTTAGGCGGGCCGTATAGCAACACTGAAGCTTTCTTT	CATSDLGGPYSNTEAFF	TRBV24-1	TRBJ1-1
TGTGCCACCAGTGGGGACGAGCAGTACTTC	CATSGDEQYF	TRBV24-1	TRBJ2-7
TGTGCCAGCGTCACCCGACAGGGCAGGAACGAGCAGTACTTC	CASVTRQGRNEQYF	TRBV12-4	TRBJ2-7
TGTGCCAGCAGCTGGGGCGGGTCCTACGAGCAGTACTTC	CASSWGGSYEQYF	TRBV11-3	TRBJ2-7
TGTGCCAGCAGCCAAGATTGGGGGGGGCTTCTCCCCAGAAACACCGGGGAGCTGTTTTTT	CASSQDWGGLLPRNTGELFF	TRBV4-2	TRBJ2-2
TGTGCCAGCACCGGGACAGGTCCCTACGAGCAGTACTTC	CASTGTGPYEQYF	TRBV28	TRBJ2-7
TGTGCCAGCAGTTCCCGGGACAGGAATTCACCCCTCCACTTT	CASSSRDRNSPLHF	TRBV6-1	TRBJ1-6
TGTGCCTCGAGACAGGGTTGCTCCTACGAGCAGTACTTC	CASRQGCSYEQYF	TRBV6-2	TRBJ2-7
TGTGCCAGCAGCCAAGGACAGGGCTACGAGCAGTACTTC	CASSQGQGYEQYF	TRBV11-3	TRBJ2-7
TGTGCCAGCAGCTTAGATGGGGGTGTGGCCCACGAGCAGTACTTC	CASSLDGGVAHEQYF	TRBV7-6	TRBJ2-7
TGTGCCAGCAGCCCGACTAGCGGGCCTCTGCAGTTCTTC	CASSPTSGPLQFF	TRBV7-9	TRBJ2-1
TGCGCCAGCAGATACGATCAGACGAACTATGGCTACACCTTC	CASRYDQTNYGYTF	TRBV5-1	TRBJ1-2
TGCGGGCGGGAGATTTTGCTAGCCAAAAACATTCAGTACTTC	CGREILLAKNIQYF	TRBV20-1	TRBJ2-4
TGTGCCAGCAGGCTACTCTGGCTGAATCAGCCCCAGCATTTT	CASRLLWLNQPQHF	TRBV6-4	TRBJ1-5
TGTGCTAGTAACCCCCCTGGAGGGACCGATGAGCAGTTCTTC	CASNPPGGTDEQFF	TRBV12-5	TRBJ2-1
TGTGCCAAAAACTATTTAGTTAGCAATCAGCCCCAGCATTTT	CAKNYLVSNQPQHF	TRBV19	TRBJ1-5
TGTGCCAGCAGCCTCGGCGGGGGGACAGGGGAGGATCAGCCCCAGCATTTT	CASSLGGGTGEDQPQHF	TRBV3-1	TRBJ1-5
TGTGCCAGTAGTATAGTAGACAAAGAGACCGGGGAGCTGTTTTTT	CASSIVDKETGELFF	TRBV19	TRBJ2-2
TGTGCCAGCAGGCCGGGACTCATTGGGCCGGATACCATGAACACTGAAGCTTTCTTT	CASRPGLIGPDTMNTEAFF	TRBV6-4	TRBJ1-1
TGTGCCAGCAGCTTAGTTCCAAAAAACAGGGGGTGGTGGGGCTACACCTTC	CASSLVPKNRGWWGYTF	TRBV7-9	TRBJ1-2
TGTGCCAGCAGCAGACTAGCGGGGGGGCAATGGGCCGGGGAGCTGTTTTTT	CASSRLAGGQWAGELFF	TRBV9	TRBJ2-2
TGTGCCAGCATCCAGGGGGCGCATCTCAAGCAGTACTTC	CASIQGAHLKQYF	TRBV6-2	TRBJ2-7
TGTGCCAGCGCACAGTTAGGGGAGGAGTACGAGCAGTACTTC	CASAQLGEEYEQYF	TRBV28	TRBJ2-7
TGTGCCAGCAGCCCGGTGGACTACTGGGCTTACTCTGGAAACACCATATATTTT	CASSPVDYWAYSGNTIYF	TRBV3-1	TRBJ1-3
TGTGCCTGGAGTGTACGCCCGAGAGTACGACCGACTGAAGCTTTCTTT	CAWSVRPRVRPTEAFF	TRBV30	TRBJ1-1
TGTGCCAGCAGCTTAATGAACAGGGCGGGGGGAAGCACAGATACGCAGTATTTT	CASSLMNRAGGSTDTQYF	TRBV7-3	TRBJ2-3
TGTGCCAGCAACTCGCAGGGGGCGCCTCAGCCCCAGCATTTT	CASNSQGAPQPQHF	TRBV2	TRBJ1-5
TGTGCCAGCAGCGCGCTGTTTTTT	CASSALFF	TRBV6-1	TRBJ1-4
TGTGCCAGCAGCTTAGTCCGTAAAAATTCACCCCTCCACTTT	CASSLVRKNSPLHF	TRBV11-3	TRBJ1-6
TGTGCCAGCAGTTTATGTGATAGTGTTTCAGATACGCAGTATTTT	CASSLCDSVSDTQYF	TRBV28	TRBJ2-3
TGCGCCAGCAGAGATAGACCCCGGGACAGGGGGTACGAGCAGTACTTC	CASRDRPRDRGYEQYF	TRBV10-1	TRBJ2-7
TGTGCCTGGATTGGCGGAGACAGGGCTCGAGCAGATACGCAGTATTTT	CAWIGGDRARADTQYF	TRBV30	TRBJ2-3
TGTGCCAGCAGTTTAAGAAGGGGGGAGTATAGCAATCAGCCCCAGCATTTT	CASSLRRGEYSNQPQHF	TRBV27	TRBJ1-5
TGTGCCAGCAGTGAAGGGACTGACAGGGGGTATAGCAATCAGCCCCAGCATTTT	CASSEGTDRGYSNQPQHF	TRBV6-1	TRBJ1-5
TGCAGTGCGGGTCGGGAGACCCAGTACTTC	CSAGRETQYF	TRBV20-1	TRBJ2-5
TGCGCCAGCAAATTTTGCGGCACAGATACGCAGTATTTT	CASKFCGTDTQYF	TRBV10-1	TRBJ2-3
TGTGCCATCAGTGAGAGAGTGGGACTAGCGGCCGAAAATGAGCAGTTCTTC	CAISERVGLAAENEQFF	TRBV10-3	TRBJ2-1
TGCAGTGCTAGAAACAGTGGAACTCTAGGCTACGAGCAGTACTTC	CSARNSGTLGYEQYF	TRBV20-1	TRBJ2-7
TGCAGCGTTGACCCGGGAAGACCGGAGGCCTACGAGCAGTACTTC	CSVDPGRPEAYEQYF	TRBV29-1	TRBJ2-7
TGCGCCAGCAGCTTTTGCAATAGCCCGGCGACAGGGGCCAAAAACATTCAGTACTTC	CASSFCNSPATGAKNIQYF	TRBV10-1	TRBJ2-4
TGTGCTAGTGGTTTGGGACAATCGGGGAACAATGAGCAGTTCTTC	CASGLGQSGNNEQFF	TRBV12-5	TRBJ2-1
TGCGCCAGCAGCTTGGGAGGGGGGCCCCCACGACAGGAGCAGCCCCAGCATTTT	CASSLGGGPPRQEQPQHF	TRBV5-1	TRBJ1-5
TGTGCCAGCAAGAAAGGGGGGGAATTCTACGAGCAGTACTTC	CASKKGGEFYEQYF	TRBV6-2	TRBJ2-7
TGTGCCCGGGGAGGTGGAACTGGCTACACCTTC	CARGGGTGYTF	TRBV6-4	TRBJ1-2
TGTGCCAGCAGTTTGCATTGCTGCCAAGAGACCCAGTACTTC	CASSLHCCQETQYF	TRBV6-9	TRBJ2-5
TGTGCCAGCAGCTCAGACAGTGGGGGACACTATGGCTACACCTTC	CASSSDSGGHYGYTF	TRBV5-8	TRBJ1-2
TGCGCCAGCAGTGAAACCACTGAGGGGACCGCCTACGAGCAGTACTTC	CASSETTEGTAYEQYF	TRBV10-1	TRBJ2-7
TGTGCCAGCAGGAGAGGTGGGACTGAAGGACAGCCCCAGCATTTT	CASRRGGTEGQPQHF	TRBV14	TRBJ1-5
TGTGCCAGCAGGAGTGGGACAGGGGGCGGGACCGGGGAGCTGTTTTTT	CASRSGTGGGTGELFF	TRBV27	TRBJ2-2
TGTGCCTGGAGGCCCGGGACTAGCGGGAAGGGGTATGAGCAGTTCTTC	CAWRPGTSGKGYEQFF	TRBV30	TRBJ2-1
TGTGCCAGCAGCTTGAAAAAACGGGACAGCCCCTGCGGGTCACCCCTCCACTTT	CASSLKKRDSPCGSPLHF	TRBV5-4	TRBJ1-6
TGTGCCAGCAGCCTCAAGGAGACCCAGTACTTC	CASSLKETQYF	TRBV7-2	TRBJ2-5
TGTGCCAGCAGCTTAGGGACACTTGATCAGCCCCAGCATTTT	CASSLGTLDQPQHF	TRBV7-2	TRBJ1-5
TGTGCCAGCAGCCCTAAAGGGGCCACTAATGAAAAACTGTTTTTT	CASSPKGATNEKLFF	TRBV7-3	TRBJ1-4
TGCGCCAGCAGTTCCGGGACAGGGTCGAAGAACACTGAAGCTTTCTTT	CASSSGTGSKNTEAFF	TRBV10-1	TRBJ1-1
TGTGCCAGCAGCACAATGCGGGAGGGGACCGGGGAGCTGTTTTTT	CASSTMREGTGELFF	TRBV7-2	TRBJ2-2
TGCGCCAGCAGCTTGGGGGCTTACACCGGGGAGCTGTTTTTT	CASSLGAYTGELFF	TRBV5-1	TRBJ2-2
TGTGCCAGCTCACCCCACGGAACTGGACACCCAGCGGGAGTCGATGGCTACACCTTC	CASSPHGTGHPAGVDGYTF	TRBV18	TRBJ1-2
TGTGCCAGCCGGTACAATGAGCAGTTCTTC	CASRYNEQFF	TRBV6-5	TRBJ2-1
TGTGCCAACCTGGGAACAATGACAGGGAGGGAGCAGTACTTC	CANLGTMTGREQYF	TRBV28	TRBJ2-7
TGTGCCAGCAGTTCCCGGCCGGGACAGAAGGTTTATTCACCCCTCCACTTT	CASSSRPGQKVYSPLHF	TRBV12-4	TRBJ1-6
TGTGCCAGCAAGTATCCGACAGGTGTTATGAACACTGAAGCTTTCTTT	CASKYPTGVMNTEAFF	TRBV25-1	TRBJ1-1
TGTGCCAGAAAAAGGACAGGGTATAGCAATCAGCCCCAGCATTTT	CARKRTGYSNQPQHF	TRBV6-5	TRBJ1-5
TGTGCCAGCACCGGGACAGACACTGAAGCTTTCTTT	CASTGTDTEAFF	TRBV9	TRBJ1-1
TGCGCCAGCAGCTTAATAGGACAGGGGGAATTCACTGAAGCTTTCTTT	CASSLIGQGEFTEAFF	TRBV5-1	TRBJ1-1
TGCGCCAGCACCCCGGTAGGAAGCAATCAGCCCCAGCATTTT	CASTPVGSNQPQHF	TRBV10-1	TRBJ1-5
TGCGCCAGCATGCGGGGGCCTAATCAGCCCCAGCATTTT	CASMRGPNQPQHF	TRBV10-2	TRBJ1-5
TGTGCCAGCAGCTGCCGGGACAGGGGGCCCAACGAGCAGTACTTC	CASSCRDRGPNEQYF	TRBV11-2	TRBJ2-7
TGTGCCAGCAGCCGACAGGGGACGCCCAAGCCAACTGAAGCTTTCTTT	CASSRQGTPKPTEAFF	TRBV6-6	TRBJ1-1
TGCAGTGCTAGAGGGCGGGACGAACCATTCATGAACACTGAAGCTTTCTTT	CSARGRDEPFMNTEAFF	TRBV20-1	TRBJ1-1
TGTGCCAGCAGCAAAGTCTGGGGGGACCTTGGGTGCTACGAGCAGTACTTC	CASSKVWGDLGCYEQYF	TRBV11-2	TRBJ2-7
TGTGCCACCAGGAGGGGGCCCCCTAGGTTTACTTATAGCACTAGCACAGATACGCAGTATTTT	CATRRGPPRFTYSTSTDTQYF	TRBV24-1	TRBJ2-3
TGTGCCAGCAGCTTAGATGGCCAAGGACGGACTAGCGGGTTGAGTCGACAAGAGACCCAGTACTTC	CASSLDGQGRTSGLSRQETQYF	TRBV11-2	TRBJ2-5
TGTGCCAGCTCACCCGAAAGGTGGACAGGGGGGAGGGGAAAGGGAGTAAGCGAGCAGTACTTC	CASSPERWTGGRGKGVSEQYF	TRBV18	TRBJ2-7
TGTGCCAGCAGCTCCCGGGCCCAGATCGCCGCCTACGAGCAGTACTTC	CASSSRAQIAAYEQYF	TRBV7-3	TRBJ2-7
TGCGCCCTAGGGCTTTTAGCGGGACACTCACCCCTCCACTTT	CALGLLAGHSPLHF	TRBV10-2	TRBJ1-6
TGTGCCAGCAGTTACCGTTCATCCGAGGGGGCTCAGCCCCAGCATTTT	CASSYRSSEGAQPQHF	TRBV6-6	TRBJ1-5
TGTGCCAGCAGCCAAGATCTACCCCGTCGGCCCGGGACTAGCGGGACCGTGTACACCGGGGAGCTGTTTTTT	CASSQDLPRRPGTSGTVYTGELFF	TRBV4-2	TRBJ2-2
TGTGCCAGCAGTTACCGGGACGCGACCTACGAGCAGTACTTC	CASSYRDATYEQYF	TRBV6-2	TRBJ2-7
TGTGCCAGCAGTTACTCGACAAAACGACTAGCGGGGCCCTCCTACAATGAGCAGTTCTTC	CASSYSTKRLAGPSYNEQFF	TRBV6-5	TRBJ2-1
TGTGCTCACAGTGACGCCTCTGGGGCCAACGTCCTGACTTTC	CAHSDASGANVLTF	TRBV24-1	TRBJ2-6
TGCGCCGGAGTCGGGGGGGCGAAGGGGTGGAGGGAGACAGATACGCAGTATTTT	CAGVGGAKGWRETDTQYF	TRBV5-1	TRBJ2-3
TGTGCCAGTAGTGATTCGGGCGAGAAGGATGAGCAGTTCTTC	CASSDSGEKDEQFF	TRBV19	TRBJ2-1
TGTGCCTGGAGTATAGGCAGGGACGTAAACACCGGGGAGCTGTTTTTT	CAWSIGRDVNTGELFF	TRBV30	TRBJ2-2
TGTGCCAGCAGAGGGGTAGCCACAGATACGCAGTATTTT	CASRGVATDTQYF	TRBV27	TRBJ2-3
TGTGCCAGCAGTGTAATGTTGCCAGGGGACGAGCAGTACTTC	CASSVMLPGDEQYF	TRBV28	TRBJ2-7
TGTGCCAGCAGGTTCCTACGGGTCGGGGACACCGGGGAGCTGTTTTTT	CASRFLRVGDTGELFF	TRBV6-5	TRBJ2-2
TGTGCCAGCAGCTTGGTAGACGGGGGGCTAGCTGAGCAGTTCTTC	CASSLVDGGLAEQFF	TRBV5-6	TRBJ2-1
TGTGCCTGTAGCTCCCGGACCTACACTGAAGCTTTCTTT	CACSSRTYTEAFF	TRBV30	TRBJ1-1
TGTGCCTGGTGGAACAAGTTTGCGACTGAAGCTTTCTTT	CAWWNKFATEAFF	TRBV30	TRBJ1-1
TGTGCCAGCAGCTTAGCCGGGGCCCTGACTACAGCTTCCAATGAGCAGTTCTTC	CASSLAGALTTASNEQFF	TRBV11-3	TRBJ2-1
TGTGCCAGTACAACAGGGGGCAGCGGGAGCTCCTACGAGCAGTACTTC	CASTTGGSGSSYEQYF	TRBV19	TRBJ2-7
TGTGCCAGCAGCTTGTCGGTGTGGAAGGGGGCGAGGTGGGCACTCTCCTACGAGCAGTACTTC	CASSLSVWKGARWALSYEQYF	TRBV5-4	TRBJ2-7
TGCAGTGCTCGGTGGACTAGCGGGGCTGAGGGGGTAGCGGAGCAGTACTTC	CSARWTSGAEGVAEQYF	TRBV20-1	TRBJ2-7
TGTGCCAGAACGGAAAAGGGACTAGCGGGCCAAGAGACCCAGTACTTC	CARTEKGLAGQETQYF	TRBV28	TRBJ2-5
TGTGCCAGCAGCCCTAGCGGGGGGGCCCCAGAGACCCAGTACTTC	CASSPSGGAPETQYF	TRBV14	TRBJ2-5
TGTGCCTGGAGTGTGACAGGGGATGGAGATACGCAGTATTTT	CAWSVTGDGDTQYF	TRBV30	TRBJ2-3
TGCAGTGCTAGAGTCGTTATGAGGGGGCCATACAATGAGCAGTTCTTC	CSARVVMRGPYNEQFF	TRBV20-1	TRBJ2-1
TGTGCCAGCAGGACTCACAGGAACACCGGGGAGCTGTTTTTT	CASRTHRNTGELFF	TRBV25-1	TRBJ2-2
TGTGCCAGCACCGGGAGGGGGCAGCTCTGTCAGCCCCAGCATTTT	CASTGRGQLCQPQHF	TRBV28	TRBJ1-5
TGTGCCACCAGCAGCAGGCCGGGACAGGAGCAGTACTTC	CATSSRPGQEQYF	TRBV15	TRBJ2-7
TGTGCCAGCAGTGAATGGGAGTTTCAGGGAGAGGGTAACTATGGCTACACCTTC	CASSEWEFQGEGNYGYTF	TRBV25-1	TRBJ1-2
TGTGCCACCACCCACAGGGGGAACACTGAAGCTTTCTTT	CATTHRGNTEAFF	TRBV24-1	TRBJ1-1
TGTGCCAGCTCACCACCGTGGCACGATAGCAATCAGCCCCAGCATTTT	CASSPPWHDSNQPQHF	TRBV18	TRBJ1-5
TGTGCCAGCAGTGAAGAAGAGTTGGGGGGGATAAACTATGGCTACACCTTC	CASSEEELGGINYGYTF	TRBV6-1	TRBJ1-2
TGTGCCAGCAGTCAGGAGGCTGGGGCCAACGTCCTGACTTTC	CASSQEAGANVLTF	TRBV12-3	TRBJ2-6
TGTGCCAGCAGCGTCGGGGAAAACTATGGCTACACCTTC	CASSVGENYGYTF	TRBV7-3	TRBJ1-2
TGTGCCAGCAGTTACAAAAACACAGGGGATAAAAGGGCAACTAATGAAAAACTGTTTTTT	CASSYKNTGDKRATNEKLFF	TRBV6-5	TRBJ1-4
TGCAGTGCTAGAGATTGGTGGGGCTACGAGCAGTACTTC	CSARDWWGYEQYF	TRBV20-1	TRBJ2-7
TGCGCCAGCAGTTACCCCCAGGGGACCGAAGCCAAAAACATTCAGTACTTC	CASSYPQGTEAKNIQYF	TRBV10-2	TRBJ2-4
TGTGCCACACTTAGGTACGAGCAGTACTTC	CATLRYEQYF	TRBV7-9	TRBJ2-7
TGTGCCAGTAGTCGGGGGGCATTGTATAATTCACCCCTCCACTTT	CASSRGALYNSPLHF	TRBV19	TRBJ1-6
TGCACCCTGGACGAATACGAGCAGTACTTC	CTLDEYEQYF	TRBV20-1	TRBJ2-7
TGTGCCAGCAGCTTAGCGTGTAAAGCGAATGGGTTTCCCGGGGAGCTGTTTTTT	CASSLACKANGFPGELFF	TRBV7-9	TRBJ2-2
TGTGCCACTTCGTATGGGACTAACTATGGCTACACCTTC	CATSYGTNYGYTF	TRBV24-1	TRBJ1-2
TGTGCCAGCAGCTTGGCTAAGTTAGTGAACACTGAAGCTTTCTTT	CASSLAKLVNTEAFF	TRBV5-4	TRBJ1-1
TGTGCCAGTGGCGGCGAGCAGTACTTC	CASGGEQYF	TRBV19	TRBJ2-7
TGCAGTGCTAGCCCCCCAAGGAAAGGATCCGGGGAGCTGTTTTTT	CSASPPRKGSGELFF	TRBV20-1	TRBJ2-2
TGTGCCAGCAGCCCCCGGGACAGCTTAGGGTATGGCTACACCTTC	CASSPRDSLGYGYTF	TRBV14	TRBJ1-2
TGCGCCACCTGTTCCCGTTTATTGACAGACCGCAATCAGCCCCAGCATTTT	CATCSRLLTDRNQPQHF	TRBV10-1	TRBJ1-5
TGTGCCACCAGCAGAGCAGGTTGGGAGACCCAGTACTTC	CATSRAGWETQYF	TRBV15	TRBJ2-5
TGCGCCACTACAGGGGGGCTTCCGGGAAACAATGAGCAGTTCTTC	CATTGGLPGNNEQFF	TRBV10-1	TRBJ2-1
TGTGCCTGGAGTACGGTACGGGACAGGAGCAATCAGCCCCAGCATTTT	CAWSTVRDRSNQPQHF	TRBV30	TRBJ1-5
TGTGCTAGTGACAGGGGCAGCTATCCCGCTGGGGCCAACGTCCTGACTTTC	CASDRGSYPAGANVLTF	TRBV12-5	TRBJ2-6
TGTGCCAGCAGCCGAGTTTTAAACACACAGGGCTCCATAGACTATGGCTACACCTTC	CASSRVLNTQGSIDYGYTF	TRBV7-3	TRBJ1-2
TGCGCCAGCAGTGAACGTGTAGACGGCGGCTTC	CASSERVDGGF	TRBV10-1	TRBJ1-2
TGTGCCGAGGCCGAGCAGTACTTC	CAEAEQYF	TRBV30	TRBJ2-7
TGTGCCAGCAGTTCTCTAGCGTCCTTCAAAAGCACAGATACGCAGTATTTT	CASSSLASFKSTDTQYF	TRBV6-4	TRBJ2-3
TGTGCCAGCAGCGCGAGTCCGGGACTAGCGGGGGGGGTAAACTCCTACAATGAGCAGTTCTTC	CASSASPGLAGGVNSYNEQFF	TRBV13	TRBJ2-1
TGCAGCGTTGACCGAGGAGCCACTGAAGCTTTCTTT	CSVDRGATEAFF	TRBV29-1	TRBJ1-1
TGTGCCACGGGGAGGCCTCTCAATCAGCCCCAGCATTTT	CATGRPLNQPQHF	TRBV19	TRBJ1-5
TGTGCCAGCATAGCGGGTTCGAATGAGCAGTTCTTC	CASIAGSNEQFF	TRBV7-9	TRBJ2-1
TGTGCCAGCAGCCAGCTCTGGGAGCGGGAGGACTCCTACAATGAGCAGTTCTTC	CASSQLWEREDSYNEQFF	TRBV4-2	TRBJ2-1
TGCGCCAGCTGCCCTCAGGAACCAGATACGCAGTATTTT	CASCPQEPDTQYF	TRBV4-3	TRBJ2-3
TGCGCCAGCAGTGACTGCGCCGACAGGGGGCTGGGCAATCAGCCCCAGCATTTT	CASSDCADRGLGNQPQHF	TRBV10-1	TRBJ1-5
TGTGCCAGCAGTCCCCCCAGGGGTCGCTCTGGGGCCAACGTCCTGACTTTC	CASSPPRGRSGANVLTF	TRBV6-5	TRBJ2-6
TGCGCCAGCAGCCAACAGGGCTGGGGGGGAAAGAACACTGAAGCTTTCTTT	CASSQQGWGGKNTEAFF	TRBV4-3	TRBJ1-1
TGTGCCAGTAGTTGTGATCAGGGGCGTAACCCTAGATTGGACTATGGCTACACCTTC	CASSCDQGRNPRLDYGYTF	TRBV19	TRBJ1-2
TGTGCCAGCAGCTTAGTTCTCCCCCGTCCAGGGGGGAGCGAGCAGTACTTC	CASSLVLPRPGGSEQYF	TRBV7-9	TRBJ2-7
TGTGCCAGCATGGGGTTGGGGGGGCCCTACGAGCAGTACTTC	CASMGLGGPYEQYF	TRBV28	TRBJ2-7
TGTGCCAGCAGTGCCACTGGGACAGGGTACACTGAAGCTTTCTTT	CASSATGTGYTEAFF	TRBV27	TRBJ1-1
TGCGCCAGCACGGCCATAAGAAGCAACACTGAAGCTTTCTTT	CASTAIRSNTEAFF	TRBV5-1	TRBJ1-1
TGTGCCTGGAGCCCCGTTAGGCGGATCACAGATACGCAGTATTTT	CAWSPVRRITDTQYF	TRBV30	TRBJ2-3
TGCAGTGCTAGACCGGGGGGGGCTTATGAGACCCAGTACTTC	CSARPGGAYETQYF	TRBV20-1	TRBJ2-5
TGCGCCAGCAATGCGTCGCGGACAGGATCGGGTGCAACTAATGAAAAACTGTTTTTT	CASNASRTGSGATNEKLFF	TRBV5-1	TRBJ1-4
TGTGCCAGCAGTCTTTCCATCAGGGTATGGGGAGACGAGCAGTACTTC	CASSLSIRVWGDEQYF	TRBV6-1	TRBJ2-7
TGTGCCACCAGTTCGACAGGGGTCGACTACGAGCAGTACTTC	CATSSTGVDYEQYF	TRBV24-1	TRBJ2-7
TGTGCCAGTAGTGGGGTGAGTCCCGGGGATAGCAATCAGCCCCAGCATTTT	CASSGVSPGDSNQPQHF	TRBV19	TRBJ1-5
TGTGCCAGTAGGCCCGCTTCCAAGACAGGGGCTTATGACCCCGGGGAGCTGTTTTTT	CASRPASKTGAYDPGELFF	TRBV19	TRBJ2-2
TGTGCCAGCAGTAAGGGGAGACCTAGCACAGATACGCAGTATTTT	CASSKGRPSTDTQYF	TRBV6-2	TRBJ2-3
TGTGCCAGCAGCGAGCGGGACAGGGGGCGGGAAGCTTTCTTT	CASSERDRGREAFF	TRBV13	TRBJ1-1
TGTGCCAGCAGCTTGCGGGAGACCGATGAGCAGTTCTTC	CASSLRETDEQFF	TRBV7-2	TRBJ2-1
TGTGCCAGCAGCGACCCTAGAACCAATCAGCCCCAGCATTTT	CASSDPRTNQPQHF	TRBV7-3	TRBJ1-5
TGTGAACTGAGAAACACTGAAGCTTTCTTT	CELRNTEAFF	TRBV12-3	TRBJ1-1
TGTGCCAGCAGCCGGGTTTTGGGACAACGATCACCCCTCCACTTT	CASSRVLGQRSPLHF	TRBV7-4	TRBJ1-6
TGTGCCAGCAGCAATACGCTCCAGTATTTT	CASSNTLQYF	TRBV5-6	TRBJ2-3
TGTGCCAGCAGCGCTTTCCGGGGGCGAGGACATGGCTACACCTTC	CASSAFRGRGHGYTF	TRBV7-9	TRBJ1-2
TGTGCCACCAGTGTAATGGAACCAGGAAACGGGACAGATACGCAGTATTTT	CATSVMEPGNGTDTQYF	TRBV24-1	TRBJ2-3
TGTGCCACCAGTGAGGCCGCGGGAGACACAGATACGCAGTATTTT	CATSEAAGDTDTQYF	TRBV24-1	TRBJ2-3
TGTGCCACCCCGGGACTAGCGGGGGGCTACGAGCAGTACTTC	CATPGLAGGYEQYF	TRBV12-3	TRBJ2-7
TGTGCCAGCAGCCAAGATGGTAGACTAGAAGAAAACATTCAGTACTTC	CASSQDGRLEENIQYF	TRBV4-2	TRBJ2-4
TGCAGTGCTAGCTCAGGATTCCGGGGATGGACTAGCGGGCTAGATACGCAGTATTTT	CSASSGFRGWTSGLDTQYF	TRBV20-1	TRBJ2-3
TGTGCCAGCAGCCAAGAGGCGGGGCCCGAGACCCAGTACTTC	CASSQEAGPETQYF	TRBV4-2	TRBJ2-5
TGTGCCTGGAGTAATTCTAAATCAAGTGGAGAATCTCGGTGGACCTACGAGCAGTACTTC	CAWSNSKSSGESRWTYEQYF	TRBV30	TRBJ2-7
TGTGCCAGTAACTTACCTACCATTATGAGGTATGGCTACACCTTC	CASNLPTIMRYGYTF	TRBV19	TRBJ1-2
TGTGCCAGCAGCTTGGACCCCCCGACAGGGGGCCCCTTCAATCAGCCCCAGCATTTT	CASSLDPPTGGPFNQPQHF	TRBV5-4	TRBJ1-5
TGTGCCAGCAGGGCTACGGGACAAGTGACTGGGGCCAACGTCCTGACTTTC	CASRATGQVTGANVLTF	TRBV6-1	TRBJ2-6
TGTGCCAGCATCCCTCGGAGTTACGATGAGCAGTTCTTC	CASIPRSYDEQFF	TRBV12-4	TRBJ2-1
TGTGCCAGCTCCCCAGTAGGATTTGGCTACACCTTC	CASSPVGFGYTF	TRBV18	TRBJ1-2
TGCAGTAAGGGACAGGGGGCTAGCTCCTATAATTCACCCCTCCACTTT	CSKGQGASSYNSPLHF	TRBV20-1	TRBJ1-6
TGTGCCAGCACAGCGGGGGACACCGAAGCTTTCTTT	CASTAGDTEAFF	TRBV5-4	TRBJ1-1
TGTGCCAGCAGCGTGGGGGGGCCAGTCTCCGGGGAGCTGTTTTTT	CASSVGGPVSGELFF	TRBV13	TRBJ2-2
TGTGCCATCATCTGGGGGGGGGACACTGAAGCTTTCTTT	CAIIWGGDTEAFF	TRBV10-3	TRBJ1-1
TGTGCCAGCAGCAGGGAGGGCGGCTGGACTAGCGGCAGGGGGCAAGAGACCCAGTACTTC	CASSREGGWTSGRGQETQYF	TRBV13	TRBJ2-5
TGTGCCAGCAGCCAAGATCCCTCTGCCACTGGACAGGGGGATGAGCAGTTCTTC	CASSQDPSATGQGDEQFF	TRBV4-2	TRBJ2-1
TGTGCCAGCAGCCCGTATGGGACAGCCGGGGAGCTGTTTTTT	CASSPYGTAGELFF	TRBV7-8	TRBJ2-2
TGTGCCAGCAGCTACAAGCTATCAGGGGAGAGGAACACTGAAGCTTTCTTT	CASSYKLSGERNTEAFF	TRBV7-2	TRBJ1-1
TGTGCCAGCAGCTTGGTAGGCAGGGGGCTTCGCACAGATACGCAGTATTTT	CASSLVGRGLRTDTQYF	TRBV5-6	TRBJ2-3
TGTGCCAGCAGCTTTATTCAGGGAGTCCATTCTGGAAACACCATATATTTT	CASSFIQGVHSGNTIYF	TRBV5-4	TRBJ1-3
TGTGCCAGCAGTGACGTCCGGGACAGGGGCAAGAACACCATATATTTT	CASSDVRDRGKNTIYF	TRBV6-4	TRBJ1-3
TGTGCCAGCCCCAGGGTATGTAATCGGGGGAACACCGGGGAGCTGTTTTTT	CASPRVCNRGNTGELFF	TRBV11-3	TRBJ2-2
TGTGCCAGCAGCGCCGGGAGGGCGGACAATGAGCAGTTCTTC	CASSAGRADNEQFF	TRBV6-2	TRBJ2-1
TGCGCCAGCAGCCAAGGGACAGGGAATGTGAGCTACGAGCAGTACTTC	CASSQGTGNVSYEQYF	TRBV4-1	TRBJ2-7
TGCGCCAGCAGCCCAAGACCGGGACAGGGCGACTACGAGCAGTACTTC	CASSPRPGQGDYEQYF	TRBV4-1	TRBJ2-7
TGTGCCAGCAGCTTGGCACAGGGAACAGGGTGTAATCAGCCCCAGCATTTT	CASSLAQGTGCNQPQHF	TRBV5-5	TRBJ1-5
TGTGCCAGCGTCCAGGAGCAGGCTCAGCCCCAGCATTTT	CASVQEQAQPQHF	TRBV6-1	TRBJ1-5
TGCGCCAGCAGCCGGGCTGGCAATCAGCCCCAGCATTTT	CASSRAGNQPQHF	TRBV4-1	TRBJ1-5
TGTGCCAGCAGCCCCTCCGGGACAGGGACCGGGAACACTGAAGCTTTCTTT	CASSPSGTGTGNTEAFF	TRBV7-9	TRBJ1-1
TGTGCCAGCAGTGTTTGGACAGGGGGCACGGGGCACTCTGGAAACACCATATATTTT	CASSVWTGGTGHSGNTIYF	TRBV27	TRBJ1-3
TGTGGTAAGGACAGCGGTGGGGAGCTGTTTTTT	CGKDSGGELFF	TRBV24-1	TRBJ2-2
TGTGCCAGCAGTTTAATCGTCCTGGCTCACCCCTCTGGAAACACCATATATTTT	CASSLIVLAHPSGNTIYF	TRBV27	TRBJ1-3
TGCAGTGCTAGAACCCAACCTCAGCCCCAGCATTTT	CSARTQPQPQHF	TRBV20-1	TRBJ1-5
TGCAGCACGGACAGGGCGCGGGCCTACGAGCAGTACTTC	CSTDRARAYEQYF	TRBV29-1	TRBJ2-7
TGCAGTGCTAGGGTGCCTAATTTTACCGGCCCCGACACTGAAGCTTTCTTT	CSARVPNFTGPDTEAFF	TRBV20-1	TRBJ1-1
TGTGCCAGCAGCTTAACGACAGAAGCCGGCTATGGCTACACCTTC	CASSLTTEAGYGYTF	TRBV7-8	TRBJ1-2
TGTGCCAGCAGTTACTCGAGGACAGGGGACTTAGGGTCCAATCAGCCCCAGCATTTT	CASSYSRTGDLGSNQPQHF	TRBV6-5	TRBJ1-5
TGTGCCAGCAGTGCTGGGACAGGCTACACCTTC	CASSAGTGYTF	TRBV6-4	TRBJ1-2
TGCGCCAGCAGCTTAGTACAAATAGGGTCGAATTCACCCCTCCACTTT	CASSLVQIGSNSPLHF	TRBV5-1	TRBJ1-6
TGCAGTGCTAGAGATCAACGGTTGGACTCCTACGAGCAGTACTTC	CSARDQRLDSYEQYF	TRBV20-1	TRBJ2-7
TGCGCCAGCAGCCCAAAATCCGGCGAGACCCAGTACTTC	CASSPKSGETQYF	TRBV5-1	TRBJ2-5
TGTGCCAGCCCGGACAGGGCCTACTATGGCTACACCTTC	CASPDRAYYGYTF	TRBV25-1	TRBJ1-2
TGTGCCAGCAGCGCATTCTCCTACGAGCAGTACTTC	CASSAFSYEQYF	TRBV9	TRBJ2-7
TGTGCCAGCCGGAGAGCCTATGGCTACACCTTC	CASRRAYGYTF	TRBV7-3	TRBJ1-2
TGTGCCAGCAGTGAGGGGGATGGCGAGCAGTACTTC	CASSEGDGEQYF	TRBV12-3	TRBJ2-7
TGCAGTGCGGGACAGGCTTTCTTT	CSAGQAFF	TRBV20-1	TRBJ1-1
TGCAGTTTCATTGAAGCGGGAAAAATCTCCTACAATGAGCAGTTCTTC	CSFIEAGKISYNEQFF	TRBV20-1	TRBJ2-1
TGTGCCAGCAGCTTCCTAAAGGACAGAGACGAGAACACTGAAGCTTTCTTT	CASSFLKDRDENTEAFF	TRBV11-3	TRBJ1-1
TGTGCCACTGAGCAGTACTTC	CATEQYF	TRBV19	TRBJ2-7
TGTGCCAGCAGTTACTCGAAAGACAGTACAGATACGCAGTATTTT	CASSYSKDSTDTQYF	TRBV6-2	TRBJ2-3
TGTGCCAGCATTGGGCCTGAAGCTTTCTTT	CASIGPEAFF	TRBV27	TRBJ1-1
TGTGCCAGCAGTGCCGGATCCCCACCGGGACAATCCAGTACCGGGGAGCTGTTTTTT	CASSAGSPPGQSSTGELFF	TRBV6-4	TRBJ2-2
TGCGCCAGCAGCCAAGCCCCTTACGGACAGGGCAATCAGCCCCAGCATTTT	CASSQAPYGQGNQPQHF	TRBV4-1	TRBJ1-5
TGCGCCAGCAGAGACAGGGCTGTAAGGAACAATCAGCCCCAGCATTTT	CASRDRAVRNNQPQHF	TRBV10-1	TRBJ1-5
TGTGCCAGCACTGAGCCAGGGAATGAGCAGTTCTTC	CASTEPGNEQFF	TRBV9	TRBJ2-1
TGTGCCTGGAGTGTACATACCCGGGACAGGGGGCTGGAGCCCCAGCATTTT	CAWSVHTRDRGLEPQHF	TRBV30	TRBJ1-5
TGTGCCAGCAGCAAAACTGGACAGGGAGCTGAGACCCAGTACTTC	CASSKTGQGAETQYF	TRBV13	TRBJ2-5
TGTGCCATTAGGGCAGTCGCGGGGGAGGTCAGCACAGATACGCAGTATTTT	CAIRAVAGEVSTDTQYF	TRBV10-3	TRBJ2-3
TGTGCCACCCATAGGGGGGCCACCTACAATGAGCAGTTCTTC	CATHRGATYNEQFF	TRBV24-1	TRBJ2-1
TGTGCCAGCAGTGGAGGGGGGGGCCTTAGGACACGGGGTGAGCAGTTCTTC	CASSGGGGLRTRGEQFF	TRBV2	TRBJ2-1
TGTGCCACCAGCGTGGATACTTGTGGGACAGGGGGCCATCAGCCCCAGCATTTT	CATSVDTCGTGGHQPQHF	TRBV15	TRBJ1-5
TGTGCCAGCAGTTTTGGTCCGCCCGGGACTAGCGGGAGGACTGAAAAACTGTTTTTT	CASSFGPPGTSGRTEKLFF	TRBV12-4	TRBJ1-4
TGCGCCAGCAGTGAGTGGGGGCCAGACTATGGCTACACCTTC	CASSEWGPDYGYTF	TRBV10-1	TRBJ1-2
TGTGCCATCAGTCTGGGGATGCCCTCTGAGCCCCAGCATTTT	CAISLGMPSEPQHF	TRBV10-3	TRBJ1-5
TGTGCCATCAGTGAGTCTCGAGGACAGTCGCGCAATCAGCCCCAGCATTTT	CAISESRGQSRNQPQHF	TRBV10-3	TRBJ1-5
TGTGCCAGCAGCGGGGGCGCGAGGCCGAACAATCAGCCCCAGCATTTT	CASSGGARPNNQPQHF	TRBV13	TRBJ1-5
TGCAGTGCTAGAGATCACCGAGCGGGACAGGGAAAGGTCTACGAGCAGTACTTC	CSARDHRAGQGKVYEQYF	TRBV20-1	TRBJ2-7
TGTGCCAGCAAATTCCCCGGGACAGGCCGGAATGCAACTAATGAAAAACTGTTTTTT	CASKFPGTGRNATNEKLFF	TRBV6-1	TRBJ1-4
TGTGCCAGCTCTAGAATTAGCGGGGGGGGTAATGAGCAGTTCTTC	CASSRISGGGNEQFF	TRBV7-4	TRBJ2-1
TGTGCCAGCAGTGGTCGGGACTCCTGTCCAGATACGCAGTATTTT	CASSGRDSCPDTQYF	TRBV7-8	TRBJ2-3
TGTGCCAGCAGCCAGCTCAGGGCCCCCAGCAGGCAGCCCCAGCATTTT	CASSQLRAPSRQPQHF	TRBV14	TRBJ1-5
TGTGCTAGTGGTTTGGTATCGAGGGGCCCAGGGGGGAACACTGAAGCTTTCTTT	CASGLVSRGPGGNTEAFF	TRBV12-5	TRBJ1-1
TGTGCCAGCAGCACCGGACCCACCTACGAGCAGTACTTC	CASSTGPTYEQYF	TRBV6-1	TRBJ2-7
TGTGCCAGCAGCCATGAAGGGCCCGAGCAGTACTTC	CASSHEGPEQYF	TRBV7-2	TRBJ2-7
TGTGCCAGCTCACCGCTCTGCTATGGCTACACCTTC	CASSPLCYGYTF	TRBV18	TRBJ1-2
TGCGCCAGCAGCCAGCCACAGGGGTTGTACGAGCAGTACTTC	CASSQPQGLYEQYF	TRBV5-1	TRBJ2-7
TGTGCCAGCAGTAGCTTGACAGTGGTAAATGAGCAGTTCTTC	CASSSLTVVNEQFF	TRBV27	TRBJ2-1
TGTGGTCAGACAGGGGATGGCTACACCTTC	CGQTGDGYTF	TRBV6-2	TRBJ1-2
TGTGCCAGCAGAATGACAGGGGGTGGATACGAGCAGTACTTC	CASRMTGGGYEQYF	TRBV7-9	TRBJ2-7
TGTGCCAGTATTCTCTCGACTAGCGGGCTGAATGAGCAGTTCTTC	CASILSTSGLNEQFF	TRBV19	TRBJ2-1
TGTGCCAGCAGCTTACAGGGGGCGGTGCAGTATTTT	CASSLQGAVQYF	TRBV7-9	TRBJ2-3
TGTGCCAGCGGGGAGAATGAAAAACTGTTTTTT	CASGENEKLFF	TRBV12-4	TRBJ1-4
TGTGCCAGCAGCTTGGTAGACACGGGGGATCCCAGCGCTGGCTGGGTTCACTCTGGAAACACCATATATTTT	CASSLVDTGDPSAGWVHSGNTIYF	TRBV5-6	TRBJ1-3
TGTGCCAGCAGCCGGCCTGGGGCCGCGTTCGGGGAGCTGTTTTTT	CASSRPGAAFGELFF	TRBV7-3	TRBJ2-2
TGTGCCAGCAGTTATTCCGGGACAGGGAGAGGTAGGTATCAGCCCCAGCATTTT	CASSYSGTGRGRYQPQHF	TRBV6-5	TRBJ1-5
TGTGCCAGCAGTTTTAGGGGGCTACTTCCAGCTGGAAACACCATATATTTT	CASSFRGLLPAGNTIYF	TRBV28	TRBJ1-3
TGTGCCAGCAGGCAAGATGGAGTTATTTGGGGGGGAAGCTCCTACGAGCAGTACTTC	CASRQDGVIWGGSSYEQYF	TRBV7-3	TRBJ2-7
TGTGCCAGCAGCTTAGCTACCCCCTCGAAAAGGGGAGTGTCGCCCCAGCATTTT	CASSLATPSKRGVSPQHF	TRBV7-9	TRBJ1-5
TGTGCCAGCAGCGTACGGGAAAGGCGACGGCCCTACGAGCAGTACTTC	CASSVRERRRPYEQYF	TRBV7-4	TRBJ2-7
TGTGCCAGCAGTTACTCCACTAGCGGGAGGGCTGGGAGCCCTAGCGGTGTCCAAGAGACCCAGTACTTC	CASSYSTSGRAGSPSGVQETQYF	TRBV6-3	TRBJ2-5
TGTGCCATCAGTAGGCGGACAGGGGACTCACCGCATCAGCCCCAGCATTTT	CAISRRTGDSPHQPQHF	TRBV10-3	TRBJ1-5
TGCAGTGCTAGTCCAGGGGGGAGCAATCAGCCCCAGCATTTT	CSASPGGSNQPQHF	TRBV20-1	TRBJ1-5
TGTGCCAGCAGGGCTTCTCCCCCGGGACTAGCGGGACAAAATAACGAGCAGTACTTC	CASRASPPGLAGQNNEQYF	TRBV12-3	TRBJ2-7
TGTGCCAGCAGCTCAACGGGACAGGGTAATGAAAAACTGTTTTTT	CASSSTGQGNEKLFF	TRBV5-6	TRBJ1-4
TGTGCCAGCAGCTTAGCGGGGGGGGCACCCCTCCACTTT	CASSLAGGAPLHF	TRBV7-2	TRBJ1-6
TGTGCCACCAGCAGAGGCATCCAGCGGGAGGTGAACAATGAGCAGTTCTTC	CATSRGIQREVNNEQFF	TRBV15	TRBJ2-1
TGCGCCAGCAGCTTCTCCGACGCCTACGAGCAGTACTTC	CASSFSDAYEQYF	TRBV5-1	TRBJ2-7
TGTGCCAGCAGTACAAATAGCGGGGTGGCTGCTCCGTACTTCACGCAGTATTTT	CASSTNSGVAAPYFTQYF	TRBV27	TRBJ2-3
TGTGCTAGTGGTTTGGTACATAAGGGGGCAAGCCAAGAGACCCAGTACTTC	CASGLVHKGASQETQYF	TRBV12-5	TRBJ2-5
TGTGCCAGCAGCTTAGGGTCTTGGGACGAGACCCAGTACTTC	CASSLGSWDETQYF	TRBV11-2	TRBJ2-5
TGTGCTAGACAGGATGGGTACGAGCAGTACTTC	CARQDGYEQYF	TRBV12-5	TRBJ2-7
TGTGCCAGCAGTGGAACGGAGGGGGTCACCGGGGAGCTGTTTTTT	CASSGTEGVTGELFF	TRBV28	TRBJ2-2
TGTGCCAGCAGCGAACTCATCCCCTACGAGCAGTACTTC	CASSELIPYEQYF	TRBV7-4	TRBJ2-7
TGTGCCAGCAGTGACGGGAGGGACAGGGGACGGGGCAAAAACATTCAGTACTTC	CASSDGRDRGRGKNIQYF	TRBV6-4	TRBJ2-4
TGTGCCAGCAGCGGGATCTACGAGCAGTACTTC	CASSGIYEQYF	TRBV5-4	TRBJ2-7
TGTGCCAGCAGCGTCTACGGGGGGTCTTATCGGCCCTGGCTAAAATCCTACGAGCAGTACTTC	CASSVYGGSYRPWLKSYEQYF	TRBV9	TRBJ2-7
TGTGCCAGCAGCTTAATTTTCCGACGACAGAAAACGACTGAAGCTTTCTTT	CASSLIFRRQKTTEAFF	TRBV11-2	TRBJ1-1
TGTGCCAGCTCCCGGGACAGCGAGCAGTACTTC	CASSRDSEQYF	TRBV6-4	TRBJ2-7
TGTGCCAGCGATGGCCCTCGGGGACAGGAAGAGTTCAGGAGGGCCTCCTACGAGCAGTACTTC	CASDGPRGQEEFRRASYEQYF	TRBV25-1	TRBJ2-7
TGTGCCAGATTTTTATTACCCCCCATGGGAATAATAGAGCGGGAAAAGCAGTACTTC	CARFLLPPMGIIEREKQYF	TRBV9	TRBJ2-7
TGCAGTGCGCCACCCAGGGGAGAGGAGAAGAATGGCTACACCTTC	CSAPPRGEEKNGYTF	TRBV20-1	TRBJ1-2
TGTGCCAGCAGCCGGGCGCACATGGATGAGACCCAGTACTTC	CASSRAHMDETQYF	TRBV13	TRBJ2-5
TGTGCCAGCAGCCCGAACGACGGGGGGCCGATCTACAATGAGCAGTTCTTC	CASSPNDGGPIYNEQFF	TRBV13	TRBJ2-1
TGCAGCGTTGAGGCTTGGACCCAGGCCCAACAGCCCCAGCATTTT	CSVEAWTQAQQPQHF	TRBV29-1	TRBJ1-5
TGTGGAGTGATTTGGACAATTTTTGGGGCGGTTAATCAGCCCCAGCATTTT	CGVIWTIFGAVNQPQHF	TRBV28	TRBJ1-5
TGCAGTGCTAGAGAGCTCGACAGTAACACTGAAGCTTTCTTT	CSARELDSNTEAFF	TRBV20-1	TRBJ1-1
TGTGCCAGCAGCTTAGACATACCGGGACAGGGCTACGAGCAGTACTTC	CASSLDIPGQGYEQYF	TRBV7-2	TRBJ2-7
TGTGCCAGCTCACCTCAAAAGGAGACTAGCGGGGAAAGCTACAATGAGCAGTTCTTC	CASSPQKETSGESYNEQFF	TRBV18	TRBJ2-1
TGTGCCTTCGAAGGCGATGAGCAGTTCTTC	CAFEGDEQFF	TRBV18	TRBJ2-1
TGTGCCAGCAGACAGCGGATCGGAGAGGCTAACTATGGCTACACCTTC	CASRQRIGEANYGYTF	TRBV28	TRBJ1-2
TGTGCCAGCAGCCCAGAAGGGGACTTGAAGGACTACGAGCAGTACTTC	CASSPEGDLKDYEQYF	TRBV9	TRBJ2-7
TGTGCTAGCAGCCCATCAGCAGGGTATACTGAAGCTTTCTTT	CASSPSAGYTEAFF	TRBV7-7	TRBJ1-1
TGTGCCAGCAGTCCTCGGACAGCTTGCACAGATACGCAGTATTTT	CASSPRTACTDTQYF	TRBV12-4	TRBJ2-3
TGTGCCAGCAGTGGTGGAAGGGACAAGTACTTC	CASSGGRDKYF	TRBV6-5	TRBJ2-7
TGTGCCAGTAGGCAGGCTTTCTTT	CASRQAFF	TRBV19	TRBJ1-1
TGTGCCAGTAGTGTTCCTGGGGGGCCCAGAGACACCGGGGAGCTGTTTTTT	CASSVPGGPRDTGELFF	TRBV19	TRBJ2-2
TGTGCCAGCAGCCAAGACAGGGTATTCACTGAAGCTTTCTTT	CASSQDRVFTEAFF	TRBV4-2	TRBJ1-1
TGCGCCAGCACCCCGGGACGCGAGGGCAAAAACATTCAGTACTTC	CASTPGREGKNIQYF	TRBV10-1	TRBJ2-4
TGCAGCCAATATCAACACAATGAGCAGTTCTTC	CSQYQHNEQFF	TRBV29-1	TRBJ2-1
TGTGCCAGCAGCTTAGAGGGCGAGGATCTAGACGAGCAGTACTTC	CASSLEGEDLDEQYF	TRBV7-9	TRBJ2-7
TGTGCCAGCAGCCAAGATCCCCGGACAGACGACGGCTACACCTTC	CASSQDPRTDDGYTF	TRBV14	TRBJ1-2
TGTGCCAGCAGTGAAGGGACTGCGGTCTCCTACAATGAGCAGTTCTTC	CASSEGTAVSYNEQFF	TRBV2	TRBJ2-1
TGTGCCAGCAGCCAATTAGGGTCCTACGAGCAGTACTTC	CASSQLGSYEQYF	TRBV9	TRBJ2-7
TGTGCCAGCAGCTTGGTAGTAGCGGGCCTCATCAATCAGCCCCAGCATTTT	CASSLVVAGLINQPQHF	TRBV5-5	TRBJ1-5
TGTGCCAGCAGCTGCCAGGGTACTCCGGGGGGGGGTAACATGTTAGATACGCAGTATTTT	CASSCQGTPGGGNMLDTQYF	TRBV11-3	TRBJ2-3
TGTGCCAGCAGTTGCGGCCTTCGGGGTGGCTACGAGCAGTACTTC	CASSCGLRGGYEQYF	TRBV27	TRBJ2-7
TGTGCCAGCAGCCGGGAGTCTGCAGTGACGGATGGCTACACCTTC	CASSRESAVTDGYTF	TRBV28	TRBJ1-2
TGTGCCTGGAGTGCTCAGGGGGGGGGAGCTTCCTACGAGCAGTACTTC	CAWSAQGGGASYEQYF	TRBV30	TRBJ2-7
TGCAGCGTTTCAAGGACAGGGACCTACGAGCAGTACTTC	CSVSRTGTYEQYF	TRBV29-1	TRBJ2-7
TGTGCCAGCAAGTGCCTAGATACGCAGTATTTT	CASKCLDTQYF	TRBV27	TRBJ2-3
TGCGCCAGCAGAACCCCGCGGTATTTCGCAACTAATGAAAAACTGTTTTTT	CASRTPRYFATNEKLFF	TRBV10-1	TRBJ1-4
TGTGCCAGTAGGTGCGGGGGACATTCGGAAGGAAACACCATATATTTT	CASRCGGHSEGNTIYF	TRBV19	TRBJ1-3
TGTGCCAGCAGATGGACAGGGGGTTCCTACAATGAGCAGTTCTTC	CASRWTGGSYNEQFF	TRBV27	TRBJ2-1
TGTGCCAGCAGCGACCGGCGTGGTTATCGCTCGCTTCAGCCCCAGCATTTT	CASSDRRGYRSLQPQHF	TRBV7-3	TRBJ1-5
TGTGCCAGCAGTTACCTGCCTACGGCCCGATACACCGGGGAGCTGTTTTTT	CASSYLPTARYTGELFF	TRBV6-5	TRBJ2-2
TGTGCCAGCAGTGAAAGAGCAGTAGAGACCCAGTACTTC	CASSERAVETQYF	TRBV6-6	TRBJ2-5
TGTGCCAGCAGAAAACCCCGGGACAGTTATCACTACAATGAGCAGTTCTTC	CASRKPRDSYHYNEQFF	TRBV6-4	TRBJ2-1
TGTGCCAGCAGCCTCCGGGACAGGGAGGACAGGTACTTC	CASSLRDREDRYF	TRBV7-3	TRBJ2-7
TGTGCCAGCATCCGGGCGACCGGGGAGCTGTTTTTT	CASIRATGELFF	TRBV28	TRBJ2-2
TGTGCCAGCAGTGACAAGACTGGACTAGCCACAGATACGCAGTATTTT	CASSDKTGLATDTQYF	TRBV6-4	TRBJ2-3
TGTGCCTACCAGCCAGAGCAGTACTTC	CAYQPEQYF	TRBV10-3	TRBJ2-7
TGTGCCAGCAGCGTCGCCGTCGGGGAGGACTACGAGCAGTACTTC	CASSVAVGEDYEQYF	TRBV9	TRBJ2-7
TGTGCCAGTAGATATCCTCAAGGCTTTGCCTACGAGCAGTACTTC	CASRYPQGFAYEQYF	TRBV19	TRBJ2-7
TGTGCCAGCAGTTTGACGTCAGGACTAGCGGGGGGATCCGGAGATACGCAGTATTTT	CASSLTSGLAGGSGDTQYF	TRBV27	TRBJ2-3
TGTGCCACCAGCAGAGAACTATGTAAAGACAGGAAGCCCCTAAAGGGGAAAACTGGCTACACCTTC	CATSRELCKDRKPLKGKTGYTF	TRBV15	TRBJ1-2
TGTGCCAGCAGTGACTTGACACCTCGGGGGCATCAGCCCCAGCATTTT	CASSDLTPRGHQPQHF	TRBV6-4	TRBJ1-5
TGTGCCAGCAGCAGAGGGTTAGAAAAACTGTTTTTT	CASSRGLEKLFF	TRBV11-3	TRBJ1-4
TGTGCCAGTAGTATCCGCGAGATCCGGGACAGGGCCTATAATTCACCCCTCCACTTT	CASSIREIRDRAYNSPLHF	TRBV19	TRBJ1-6
TGTGCCAGCAGCTCCCCAACCGGCACAGATACGCAGTATTTT	CASSSPTGTDTQYF	TRBV7-9	TRBJ2-3
TGTGCCAGCAGTTTCACAGGAAGAGGGGGCACAGATACGCAGTATTTT	CASSFTGRGGTDTQYF	TRBV6-2	TRBJ2-3
TGCAGCGTTGAAGCCCACCGGGACTGTGGCTACACCTTC	CSVEAHRDCGYTF	TRBV29-1	TRBJ1-2
TGTGCCAGCAGAGGGTGTAGCGGACCCCACGAGCAGTACTTC	CASRGCSGPHEQYF	TRBV28	TRBJ2-7
TGTGCCACCAGTGATTTGCATCTGGTACAGTATCTGAAGAACACTGAAGCTTTCTTT	CATSDLHLVQYLKNTEAFF	TRBV24-1	TRBJ1-1
TGTGCCAGCAGCTTGCCCACTCCGGAAGGCCAAGAGACCCAGTACTTC	CASSLPTPEGQETQYF	TRBV5-6	TRBJ2-5
TGCGCCAGCAGCTTGGCCCACGGCGACTTTGGCTACAATGAGCAGTTCTTC	CASSLAHGDFGYNEQFF	TRBV5-1	TRBJ2-1
TGTGCCACCAGTGAAATCGAGGAGAAAGGGAAAATACAAGAGACCCAGTACTTC	CATSEIEEKGKIQETQYF	TRBV24-1	TRBJ2-5
TGCGCCAGCAGCCGCGGGACAGGTGAAGCTTTCTTT	CASSRGTGEAFF	TRBV4-1	TRBJ1-1
TGTGCCAGCAGCTCCGCCTGGGATGAGAGGGTTGACACCGGGGAGCTGTTTTTT	CASSSAWDERVDTGELFF	TRBV5-6	TRBJ2-2
TGTGCCAGCAGCATACTGCTGATGGCCGCAGATACGCAGTATTTT	CASSILLMAADTQYF	TRBV7-9	TRBJ2-3
TGTGCCAGCAGCCCGGGCAGGGGCTATGGCTACACCTTC	CASSPGRGYGYTF	TRBV6-4	TRBJ1-2
TGTGCCAGCAGTTTGTCGGGGGGACGACCTGAGCAGTACTTC	CASSLSGGRPEQYF	TRBV12-3	TRBJ2-7
TGTGCCAGCAGCTCCCGGCGAAATTCAGGCGCCCCCGGCTACACCTTC	CASSSRRNSGAPGYTF	TRBV5-6	TRBJ1-2
TGTGCCTGGAGTGTATTTCTCGCAGAGACCCAGTACTTC	CAWSVFLAETQYF	TRBV30	TRBJ2-5
TGTGCCAGCCTTAGGTATTCCGGGGGCGGCTATGGCTACACCTTC	CASLRYSGGGYGYTF	TRBV6-2	TRBJ1-2
TGCAGCGTGCACAGTCCTTCCGGGGAGCTGTTTTTT	CSVHSPSGELFF	TRBV29-1	TRBJ2-2
TGTGCCAGCCGACGAAATCGGTCACCCCTCCACTTT	CASRRNRSPLHF	TRBV5-6	TRBJ1-6
TGTGCCAGCAGCTGGCGGAAGGGACAAGAGACCCAGTACTTC	CASSWRKGQETQYF	TRBV7-3	TRBJ2-5
TGCAGCGTTAGGAGGCTTGGTGCCTACGAGCAGTACTTC	CSVRRLGAYEQYF	TRBV29-1	TRBJ2-7
TGTGCCACGCCAGGGGGAGCCGGGGAGCTGTTTTTT	CATPGGAGELFF	TRBV14	TRBJ2-2
TGCGCCAGCAGTGAGTCGGACAGGGGGCGCCTTATAGTCCTAGCCAAAAACATTCAGTACTTC	CASSESDRGRLIVLAKNIQYF	TRBV10-2	TRBJ2-4
TGTGCCCCCCCGGGGGGCCCAGATTGGAACACCGGGGAGCTGTTTTTT	CAPPGGPDWNTGELFF	TRBV24-1	TRBJ2-2
TGTGCCAGCAGCCAAAAATGGACAGGGTGGCAGTATTTT	CASSQKWTGWQYF	TRBV14	TRBJ2-3
TGCAGCGTAGATTCTGGACAGAATGAGACCCAGTACTTC	CSVDSGQNETQYF	TRBV29-1	TRBJ2-5
TGCGCCAGCAGTGAGGGGTCCTCTGGGGCCAACGTCCTGACTTTC	CASSEGSSGANVLTF	TRBV10-1	TRBJ2-6
TGTGCCAGCGCCGGGAGTCCGGGCGGGGGGATCGGCACAGATACGCAGTATTTT	CASAGSPGGGIGTDTQYF	TRBV6-5	TRBJ2-3
TGCAGTGCACCTGGGGTGCTGGACACCGGGGAGCTGTTTTTT	CSAPGVLDTGELFF	TRBV20-1	TRBJ2-2
TGTGCCAGCAGCTATAAGGGACTAGCGCGTGGCCCGCATTCTGGGGCTGAGACCCAGTACTTC	CASSYKGLARGPHSGAETQYF	TRBV5-6	TRBJ2-5
TGTGCCAGCAGCGTAGTATTGCCCCTAGAAAATGAGCAGTTCTTC	CASSVVLPLENEQFF	TRBV9	TRBJ2-1
TGTGCCAGCAGCCACGGGATCAGCCTCCCCTCCTACGAGCAGTACTTC	CASSHGISLPSYEQYF	TRBV13	TRBJ2-7
TGTGCCAGCAGTTACTCGGATCAGGGGAATATGAGCAATCAGCCCCAGCATTTT	CASSYSDQGNMSNQPQHF	TRBV6-3	TRBJ1-5
TGTGCCAGCAGCTGCAAAACTAGCGGGACCCAGTACTTC	CASSCKTSGTQYF	TRBV11-2	TRBJ2-5
TGTGCCAGCAGCCAAGATTTCACCCTTCGGGGCGCCCAGGAGATGAACACTGAAGCTTTCTTT	CASSQDFTLRGAQEMNTEAFF	TRBV4-2	TRBJ1-1
TGCAGTGCTGGAGAGGGGGAGACCCAGTACTTC	CSAGEGETQYF	TRBV20-1	TRBJ2-5
TGTGCCTGGAGTGTACATAGTGGCGCTGCTCTTTGCGGGAACTATGGCTACACCTTC	CAWSVHSGAALCGNYGYTF	TRBV30	TRBJ1-2
TGTGCCAGCAGGGAGAAAGACTATGGCTACACCTTC	CASREKDYGYTF	TRBV12-4	TRBJ1-2
TGTGCCAGCAGGAGGGACGACTTTGAAAAACTGTTTTTT	CASRRDDFEKLFF	TRBV6-5	TRBJ1-4
TGTGCCAGCAGCCCCAATCCAGTAGGTAGCAATCAGCCCCAGCATTTT	CASSPNPVGSNQPQHF	TRBV14	TRBJ1-5
TGCAGTGCTAGCAGGAGCTATAGCAATCAGCCCCAGCATTTT	CSASRSYSNQPQHF	TRBV20-1	TRBJ1-5
TGTGCCAGCAGCGACCAAAATCTCCAGGGGAGACAGAATCAGCCCCAGCATTTT	CASSDQNLQGRQNQPQHF	TRBV11-3	TRBJ1-5
TGCGCCAGCAGCATCCGGGGGCGGAACATTCAGTACTTC	CASSIRGRNIQYF	TRBV5-1	TRBJ2-4
TGTGCCAGTAGTATCAGGGGGCGAAATTCACCCCTCCACTTT	CASSIRGRNSPLHF	TRBV19	TRBJ1-6
TGTGCCAGCAGTTACTTCAAGGTACTTGAAGAGACCCAGTACTTC	CASSYFKVLEETQYF	TRBV6-6	TRBJ2-5
TGTGCCACCAGCGCAAACACCGGGGAGCTGTTTTTT	CATSANTGELFF	TRBV24-1	TRBJ2-2
TGTGCCAGCAGTTTCAGAAGCAGGGGACAGGGATTGTCTGGGGCCAACGTCCTGACTTTC	CASSFRSRGQGLSGANVLTF	TRBV6-5	TRBJ2-6
TGTGCCAGCAGCCGAGGGACTAGCGGGTTAAATGAGCAGTTCTTC	CASSRGTSGLNEQFF	TRBV2	TRBJ2-1
TGTGCCAGCAGCTCGGGGGGCGAAAATTCACCCCTCCACTTT	CASSSGGENSPLHF	TRBV5-4	TRBJ1-6
TGTGCCAGCAGCATGGCTAGCGACACCGGGGAGCTGTTTTTT	CASSMASDTGELFF	TRBV7-2	TRBJ2-2
TGTGCCAGCAGTGTAACGGGGACGCCCCAGCATTTT	CASSVTGTPQHF	TRBV6-1	TRBJ1-5
TGTGCCAGCAGCCCACCCCGGGAGGGGGGGACGCAGTATTTT	CASSPPREGGTQYF	TRBV14	TRBJ2-3
TGCAGTGCTAGAGATCCCCTAGTTTGGGGCATAATATACGAGCAGTACTTC	CSARDPLVWGIIYEQYF	TRBV20-1	TRBJ2-7
TGTGCCAGCAGCAGGATGGGGACTAGCGGGCATTGCACAGATACGCAGTATTTT	CASSRMGTSGHCTDTQYF	TRBV11-2	TRBJ2-3
TGCGCCAGCAGCCACCTGGCGTACTTC	CASSHLAYF	TRBV4-1	TRBJ2-7
TGTGCCACCTCCCCTTGTAAGGTTGGGGGGGGGGGGAATGAGCAGTTCTTC	CATSPCKVGGGGNEQFF	TRBV24-1	TRBJ2-1
TGCAGTGCTCCCTACACCAGTTTGAGGGATGAGCAGTACTTC	CSAPYTSLRDEQYF	TRBV20-1	TRBJ2-7
TGTGCCACCAGTGCTACTTTGGTACCAAGCGGCCGGCCACCAACAGATACGCAGTATTTT	CATSATLVPSGRPPTDTQYF	TRBV24-1	TRBJ2-3
TGTGCCAGCAGTGAACCCGGAGGGGGGAACTCTGGGGCCAACGTCCTGACTTTC	CASSEPGGGNSGANVLTF	TRBV6-4	TRBJ2-6
TGTGCCATCAGTGAACCGGGATGCGGGGAGACCCAGTACTTC	CAISEPGCGETQYF	TRBV10-3	TRBJ2-5
TGCGCCAGCAGCGTTACAACGGGACGCATGGCAGAAGAGACCCAGTACTTC	CASSVTTGRMAEETQYF	TRBV5-1	TRBJ2-5
TGCAGTGCTAATACGTATGAGCAGTTCTTC	CSANTYEQFF	TRBV20-1	TRBJ2-1
TGCAGCGTTCCGACAGGTGGGAACACTGAAGCTTTCTTT	CSVPTGGNTEAFF	TRBV29-1	TRBJ1-1
TGCGCCAGCAGCCCCAGGGGGGGCAAATCCTACGAGCAGTACTTC	CASSPRGGKSYEQYF	TRBV4-3	TRBJ2-7
TGCAGTGCAGTGTTAGCCAACTACGAGCAGTACTTC	CSAVLANYEQYF	TRBV20-1	TRBJ2-7
TGTGCCAGCAGCGGCACAAAGTTACAGGGGGCATTAGGGGGAAACGAGCAGTACTTC	CASSGTKLQGALGGNEQYF	TRBV9	TRBJ2-7
TGTGCCAGTACCCACCCGGGCGCTTTCTTT	CASTHPGAFF	TRBV19	TRBJ1-1
TGTGCCAGCAGCGGGGTGAACACTGAAGCTTTCTTT	CASSGVNTEAFF	TRBV7-9	TRBJ1-1
TGTGCCAGCAGCCCCTTTGGGGTCGGACTAGCGGGCCTCGCCCAAGAGACCCAGTACTTC	CASSPFGVGLAGLAQETQYF	TRBV9	TRBJ2-5
TGTGCCAAAGACACTAATGAAAAACTGTTTTTT	CAKDTNEKLFF	TRBV6-5	TRBJ1-4
TGTGCCAGCCTACTCACAGATACGCAGTATTTT	CASLLTDTQYF	TRBV6-5	TRBJ2-3
TGCAGTGCTAGCCCAGGAAACTACCAGTACGGCCCACGGTTATGGATCTACAATGAGCAGTTCTTC	CSASPGNYQYGPRLWIYNEQFF	TRBV20-1	TRBJ2-1
TGCGCCAGCAGCCAAGGTAAAGTAAGGGCCGTTTATTCCGACGCCTACGAGCAGTACTTC	CASSQGKVRAVYSDAYEQYF	TRBV4-1	TRBJ2-7
TGTGCCAGCAGTGTATGGGGCGGCTACGAGCAGTACTTC	CASSVWGGYEQYF	TRBV6-4	TRBJ2-7
TGCGCCAGCAGCTTGGTGCCCTCTCCGAGACAGAACCACGGTGAAAAACTGTTTTTT	CASSLVPSPRQNHGEKLFF	TRBV5-1	TRBJ1-4
TGTGCCAGCTCACCCCAAGGCCGATCCTACGAGCAGTACTTC	CASSPQGRSYEQYF	TRBV18	TRBJ2-7
TGTGCCAGCAGCTTCACGGGGACAGTGGTAAATGAAAAACTGTTTTTT	CASSFTGTVVNEKLFF	TRBV7-7	TRBJ1-4
TGTGCCAGCAGTGAATATATGGGGACAGGGGGAGGAGGGCAGTACTTC	CASSEYMGTGGGGQYF	TRBV25-1	TRBJ2-7
TGCAGTGCTAGAGACCCCCCGAGCTACAATGAGCAGTTCTTC	CSARDPPSYNEQFF	TRBV20-1	TRBJ2-1
TGCGCCAGCAGTGTCAGGACAGGGCCCAGCAATCAGCCCCAGCATTTT	CASSVRTGPSNQPQHF	TRBV5-1	TRBJ1-5
TGCGCCAGCAGCCAAGATTACACCCAGGGTCGAGAAAAACTGTTTTTT	CASSQDYTQGREKLFF	TRBV4-1	TRBJ1-4
TGTGCCAGCAGCTTAGGGTGGGGACAGGGGGACGTGAACACTGAAGCTTTCTTT	CASSLGWGQGDVNTEAFF	TRBV7-2	TRBJ1-1
TGTGCCAGCAGTTTCACCCAGGGAAGTCCAGAGACCCAGTACTTC	CASSFTQGSPETQYF	TRBV27	TRBJ2-5
TGTGCCAGCAGGGGGGAATACTCCTACGAGCAGTACTTC	CASRGEYSYEQYF	TRBV6-8	TRBJ2-7
TGCCCCCCCCCCCCAGGGGATACGCAGTATTTT	CPPPPGDTQYF	TRBV20-1	TRBJ2-3
TGTGCCAGCAGCCAAGAAGGTACCAGGGGGATACACAATGAGCAGTTCTTC	CASSQEGTRGIHNEQFF	TRBV14	TRBJ2-1
TGTGCCAGCAGCTCCCGAAGGGTATTCAGGATCCCGGATGGCTACACCTTC	CASSSRRVFRIPDGYTF	TRBV5-6	TRBJ1-2
TGTGCCAGCAGTTTGGACAGCAATCAGCCCCAGCATTTT	CASSLDSNQPQHF	TRBV27	TRBJ1-5
TGTGCCAGCAGTGCGTGGCGGGGAAAGGGGAGCTCCTACAATGAGCAGTTCTTC	CASSAWRGKGSSYNEQFF	TRBV28	TRBJ2-1
TGTGCTAGGGGAGGACACGAGCAGTACTTC	CARGGHEQYF	TRBV12-5	TRBJ2-7
TGTAGGGGCCAGAGGACAGGGAACGAGCAGTACTTC	CRGQRTGNEQYF	TRBV20-1	TRBJ2-7
TGTGCCAGCAGTTTACAACGACAGGGTGAGAACACCGGGGAGCTGTTTTTT	CASSLQRQGENTGELFF	TRBV12-4	TRBJ2-2
TGCGCCAAAAAACAGGGACCCAGTCTTATCACCGGGGAGCTGTTTTTT	CAKKQGPSLITGELFF	TRBV10-1	TRBJ2-2
TGTGCCAGCAGTCCGACGAGGCTGGTAGATGAGCAGTTCTTC	CASSPTRLVDEQFF	TRBV27	TRBJ2-1
TGTGCCTCGGGGAGTCAATTCTCTGGGGCCAACGTCCTGACTTTC	CASGSQFSGANVLTF	TRBV9	TRBJ2-6
TGTGCCAGTAGCCGGGGGGGTGGGGGGAATCAGCCCCAGCATTTT	CASSRGGGGNQPQHF	TRBV19	TRBJ1-5
TGTGCCAGCAGTGCGGCGAGGTTCGAGACCCAGTACTTC	CASSAARFETQYF	TRBV6-4	TRBJ2-5
TGTGCCAGCAGCTACCCGGGGGCCCAAAATCAGCCCCAGCATTTT	CASSYPGAQNQPQHF	TRBV7-3	TRBJ1-5
TGTGCCACCAGTGAAAACACCATATATTTT	CATSENTIYF	TRBV24-1	TRBJ1-3
TGTGCCAGCAGCAGGCCGGGACTAGGAAATGTTACCAATGAGCAGTTCTTC	CASSRPGLGNVTNEQFF	TRBV7-2	TRBJ2-1
TGTGCCAGTATCGGGACAACCTCCTACAATGAGCAGTTCTTC	CASIGTTSYNEQFF	TRBV19	TRBJ2-1
TGTGCCAGCAGCCGTAGGGACAGCAAGTACCAAGAGACCCAGTACTTC	CASSRRDSKYQETQYF	TRBV11-3	TRBJ2-5
TGTGCCAGCAGCGACGAAGCGGACAGGGGAATAGTGGGGTACGAGCAGTACTTC	CASSDEADRGIVGYEQYF	TRBV27	TRBJ2-7
TGTGCCAGCAGCGTAGGACATTCCCGGGACAGCTTCTACGAGCAGTACTTC	CASSVGHSRDSFYEQYF	TRBV9	TRBJ2-7
TGTGCCAGCAGCCAAGTTCGTCTGACAGGGGCGTATGGCTACACCTTC	CASSQVRLTGAYGYTF	TRBV14	TRBJ1-2
TGTGCCAGCAGCTCGAGCTCAGGGCACTATGGCTACACCTTC	CASSSSSGHYGYTF	TRBV9	TRBJ1-2
TGTGCCAGCAGCTTGGAGGGAAACACCATATATTTT	CASSLEGNTIYF	TRBV7-8	TRBJ1-3
TGTGCCAGCGGAGGGCGCAATCAGCCCCAGCATTTT	CASGGRNQPQHF	TRBV6-3	TRBJ1-5
TGCAGTGCTAGACCAGGTGGCTATGGCTACACCTTC	CSARPGGYGYTF	TRBV20-1	TRBJ1-2
TGCAGTGCTAGAGATACCCGAGGACAGGGGGCGCGCGCCTACGAGCAGTACTTC	CSARDTRGQGARAYEQYF	TRBV20-1	TRBJ2-7
TGCGCCAGCAGTGTCAGGACAGTGACTGAAGCTTTCTTT	CASSVRTVTEAFF	TRBV10-1	TRBJ1-1
TGTGCCAGCGCCCAAGGGAACACCGGGGAGCTGTTTTTT	CASAQGNTGELFF	TRBV14	TRBJ2-2
TGCAGTGCACTGAATCAGCCCCAGCATTTT	CSALNQPQHF	TRBV20-1	TRBJ1-5
TGTGCCAGCGGCATGGAATCTCCAACTAATGAAAAACTGTTTTTT	CASGMESPTNEKLFF	TRBV11-3	TRBJ1-4
TGTGCCAGCAGAGGGCGGGTAGAAGAGACCCAGTACTTC	CASRGRVEETQYF	TRBV6-5	TRBJ2-5
TGTGCCTGGAGTGGGCGACAGGGTTCAAGCTCCTACGAGCAGTACTTC	CAWSGRQGSSSYEQYF	TRBV30	TRBJ2-7
TGTGCCAGCTACGCCGGGACTAGCGGGGAATTTGCCTACGAGCAGTACTTC	CASYAGTSGEFAYEQYF	TRBV12-3	TRBJ2-7
TGTGCCAGCAGTTACTCCATCGGAAGGAGCGCCCGAGAGAGGTTTTGCTATGGCTACACCTTC	CASSYSIGRSARERFCYGYTF	TRBV6-3	TRBJ1-2
TGTGCCACCAGTGATTTCCTAGCGGAGGGGAGACCAGATACGCAGTATTTT	CATSDFLAEGRPDTQYF	TRBV24-1	TRBJ2-3
TGCGCCAGCACAGGGGGGGGGAGCTCCTACAATGAGCAGTTCTTC	CASTGGGSSYNEQFF	TRBV10-1	TRBJ2-1
TGTGCCAGCAGACGGTATCCCAGGGACAGGGAGATTGTTCAGCCCCAGCATTTT	CASRRYPRDREIVQPQHF	TRBV6-2	TRBJ1-5
TGTGCCAGCAGCTTAGCTAGACACACTGGTAAAGGCTCCTACGAGCAGTACTTC	CASSLARHTGKGSYEQYF	TRBV7-9	TRBJ2-7
TGCAGCGTGTTGGGGGACAATGAAAAACTGTTTTTT	CSVLGDNEKLFF	TRBV29-1	TRBJ1-4
TGTGCCAGCAGTCGAGCGGGAGGGGTGGGTCACATTCAGTACTTC	CASSRAGGVGHIQYF	TRBV28	TRBJ2-4
TGTGCCAGCAGCGCCCCAACTGACAGCTCCCAGCCCTTGACTGAAGCTTTCTTT	CASSAPTDSSQPLTEAFF	TRBV27	TRBJ1-1
TGCAGCGTTGAGCATTTAAAAGAGACCCAGTACTTC	CSVEHLKETQYF	TRBV29-1	TRBJ2-5
TGTGCCACTCGCAGACAGGGCCACCTGGGGGAGACCCAGTACTTC	CATRRQGHLGETQYF	TRBV13	TRBJ2-5
TGTGCCAGCAGCCGAGGACAGGGGGCGGGGAAGAACACTGAAGCTTTCTTT	CASSRGQGAGKNTEAFF	TRBV5-6	TRBJ1-1
TGTGCCACCAGGCTGTATCCTAGGAGATTTTCCGAGCAGTACTTC	CATRLYPRRFSEQYF	TRBV24-1	TRBJ2-7
TGTGCCATCAACAAAACTAGCGGGAGAGTCAGTGAAGCTTTCTTT	CAINKTSGRVSEAFF	TRBV10-3	TRBJ1-1
TGCAGCGTTGAAGGATCCGCGGGACATGCTGAAGCTTTCTTT	CSVEGSAGHAEAFF	TRBV29-1	TRBJ1-1
TGTGCCAGCAGCCAGGAAACAACTGAAGCTTTCTTT	CASSQETTEAFF	TRBV7-4	TRBJ1-1
TGCGCCTCTTGGCCACTAGCGGGAGGGCGACCGAACGAGCAGTACTTC	CASWPLAGGRPNEQYF	TRBV10-1	TRBJ2-7
TGTGCCAGCAGTTCCGGGGTGAGCTATGAAAAACTGTTTTTT	CASSSGVSYEKLFF	TRBV6-5	TRBJ1-4
TGCAAAGGACAGACTGGAAACACCATATATTTT	CKGQTGNTIYF	TRBV20-1	TRBJ1-3
TGTGCCAGCAGTTTCGACCAATACAGGGTGCTAAGAACTAATGAAAAACTGTTTTTT	CASSFDQYRVLRTNEKLFF	TRBV12-4	TRBJ1-4
TGTGCCAGCAGTTCAGGTGTCCGTAGGCGAAGAGATACGCAGTATTTT	CASSSGVRRRRDTQYF	TRBV27	TRBJ2-3
TGTGCCAGCAGAAGTGGAAAACGTGAGCAGTTCTTC	CASRSGKREQFF	TRBV6-5	TRBJ2-1
TGTGCCAGCAGCGCTCCCTCCAGGCAGGGATTAGGGCTGGAGTTGAACACCATATATTTT	CASSAPSRQGLGLELNTIYF	TRBV9	TRBJ1-3
TGTGCCAGGTGTGGGACGGGGCCCACTGAAGCTTTCTTT	CARCGTGPTEAFF	TRBV19	TRBJ1-1
TGTGCCAGCAGCTGGACTTTCCTCCGAGAGCAGTTCTTC	CASSWTFLREQFF	TRBV7-2	TRBJ2-1
TGTGCCAGCAGTCGCTGCGGGGGCGGCGTCCGGTGCTTCTCTGGGGCCAACGTCCTGACTTTC	CASSRCGGGVRCFSGANVLTF	TRBV6-4	TRBJ2-6
TGTGCCAGCAGTTTGAGGAGGGGGAGGTTGAATGAGCAGTTCTTC	CASSLRRGRLNEQFF	TRBV28	TRBJ2-1
TGTGCCAGTAGTTGGGGCATAGCGGGCGACACCGGGGAGCTGTTTTTT	CASSWGIAGDTGELFF	TRBV19	TRBJ2-2
TGTGCCAGCAGCCAAGTCGCGCCGGGACAGGAAAAAGGCAATCAGCCCCAGCATTTT	CASSQVAPGQEKGNQPQHF	TRBV4-2	TRBJ1-5
TGTGCCAGTAGTATTCTGACAGGGGCAGCCAAAAACATTCAGTACTTC	CASSILTGAAKNIQYF	TRBV19	TRBJ2-4
TGTGCCAGCAGCCAAGATGACTGTTGGGGGGGGAATGAGCAGTTCTTC	CASSQDDCWGGNEQFF	TRBV14	TRBJ2-1
TGCAGTGCTAGAGATTCGGCGCCTCTCGAGCAGTACTTC	CSARDSAPLEQYF	TRBV20-1	TRBJ2-7
TGCAGCGTTAACGACGAAGAGCAGTACTTC	CSVNDEEQYF	TRBV29-1	TRBJ2-7
TGTGCCAGCAGCTTGTACGGGACTAGCGGGCCCTGTAAGAACAATGAGCAGTTCTTC	CASSLYGTSGPCKNNEQFF	TRBV5-6	TRBJ2-1
TGTGCCAGCAGTGGGAGGACAGGGAGGGGTATCTACGAGCAGTACTTC	CASSGRTGRGIYEQYF	TRBV6-1	TRBJ2-7
TGTGCCAGCAGCTTTAGAGGACAGGGCCGCAATCAGCCCCAGCATTTT	CASSFRGQGRNQPQHF	TRBV11-3	TRBJ1-5
TGTGCCAATCGTTGTCGGACAGGGGGGGAAACTAATGAAAAACTGTTTTTT	CANRCRTGGETNEKLFF	TRBV6-3	TRBJ1-4
TGTGCCAGCAGCTTTTACTTCTACGAGCAGTACTTC	CASSFYFYEQYF	TRBV13	TRBJ2-7
TGTGCCAGCAGTGGAGGGGGCGGCAACACTGAAGCTTTCTTT	CASSGGGGNTEAFF	TRBV6-2	TRBJ1-1
TGTGCCAGGGGGCATAGCAATCAGCCCCAGCATTTT	CARGHSNQPQHF	TRBV28	TRBJ1-5
TGTGCCAGCAGCAGGGATGGCTACACCTTC	CASSRDGYTF	TRBV12-3	TRBJ1-2
TGTGCCAGCAGTTCCGGGGGGGGGGCCCCCCACCAAGAGACCCAGTACTTC	CASSSGGGAPHQETQYF	TRBV27	TRBJ2-5
TGTGCCAGCACCCACGGGGGGAACACAGATACGCAGTATTTT	CASTHGGNTDTQYF	TRBV7-4	TRBJ2-3
TGTGCCACCAGTGCACCTGGCAGTGTCCGGAATTCACCCCTCCACTTT	CATSAPGSVRNSPLHF	TRBV24-1	TRBJ1-6
TGTGCCAGCAGCCAGGTAGACTACGAGCAGTACTTC	CASSQVDYEQYF	TRBV11-2	TRBJ2-7
TGCAGTGCTAGGCCGGCCCCGGGACTAGGGCGCGGGGGAAGAAGCACAGATACGCAGTATTTT	CSARPAPGLGRGGRSTDTQYF	TRBV20-1	TRBJ2-3
TGTGCCAGCAGCGCCCTTCTGGCCCGTACTGGGGTGTCTGGAAACACCATATATTTT	CASSALLARTGVSGNTIYF	TRBV11-3	TRBJ1-3
TGCGCCAGCAGCCTCCCAACGACCCCAACCTACGAGCAGTACTTC	CASSLPTTPTYEQYF	TRBV4-1	TRBJ2-7
TGTGCCAGCAGCTTAAATCCTATTGACAGGGAGTCAGATACGCAGTATTTT	CASSLNPIDRESDTQYF	TRBV7-9	TRBJ2-3
TGTGCCAGCTCACCCCCCCTCATGAGGGATGAAGCTTTCTTT	CASSPPLMRDEAFF	TRBV18	TRBJ1-1
TGTGCCAGCAGCTTACCTGGGACAGGGGATGAAGGCCGTGGCACAGATACGCAGTATTTT	CASSLPGTGDEGRGTDTQYF	TRBV7-2	TRBJ2-3
TGTGCCAGCCCTACAGGAGTCAATGAGCAGTTCTTC	CASPTGVNEQFF	TRBV13	TRBJ2-1
TGTGCCAGCAGCTCGAGAAGTAACTCGGGGGCTGGGGAGCTGTTTTTT	CASSSRSNSGAGELFF	TRBV7-4	TRBJ2-2
TGTGCCACCGGGGGGGGGCTTATCAATGAGCAGTTCTTC	CATGGGLINEQFF	TRBV24-1	TRBJ2-1
TGTGCCAGCGGCGACAGTGCGGGCGGGGGGAATCAGCCCCAGCATTTT	CASGDSAGGGNQPQHF	TRBV6-6	TRBJ1-5
TGTGCCAGCCAGGGGGCCGAACATTTAGAGCAGTACTTC	CASQGAEHLEQYF	TRBV18	TRBJ2-7
TGTGCCACCAAGGCCCGGGAGGGCGAGGCCCAAAGTGGGGCCAACGTCCTGACTTTC	CATKAREGEAQSGANVLTF	TRBV24-1	TRBJ2-6
TGTGCCAGCAGCTCGGGGGAGGTGTGTCTCCAAGAGACCCAGTACTTC	CASSSGEVCLQETQYF	TRBV5-4	TRBJ2-5
TGTGCCAGCAGCTTAGCGCCTCCGGGACCGCTGTACACTGAAGCTTTCTTT	CASSLAPPGPLYTEAFF	TRBV7-2	TRBJ1-1
TGTGCCAGCAGTGTCGGGAGCGGGATCCTCTATGGCTACACCTTC	CASSVGSGILYGYTF	TRBV6-1	TRBJ1-2
TGTGCCAGCAGCGTGGGTCTATACAGGGGGGTTGAGAACACTGAAGCTTTCTTT	CASSVGLYRGVENTEAFF	TRBV9	TRBJ1-1
TGTGCCAGCAGCGGAGGATTGGCTAGGTGCACTGAAGCTTTCTTT	CASSGGLARCTEAFF	TRBV6-1	TRBJ1-1
TGTGCCAGCAGCAATAGGGACTTCTGCTCTGGAAACACCATATATTTT	CASSNRDFCSGNTIYF	TRBV13	TRBJ1-3
TGTGCCAGCAGCAGGGGCAATCAGCCCCAGCATTTT	CASSRGNQPQHF	TRBV13	TRBJ1-5
TGTGCCAGCAGCTTGGTATGGACAGGGAGCGTTGATTCACCCCTCCACTTT	CASSLVWTGSVDSPLHF	TRBV5-4	TRBJ1-6
TGTGCCAGCAGCCATGTGGGGGCTTCAGCTGGGGCCAACGTCCTGACTTTC	CASSHVGASAGANVLTF	TRBV7-7	TRBJ2-6
TGTGCCAGCAGCTTAGGTCCCCAAAAAGGGTATGGCTACACCTTC	CASSLGPQKGYGYTF	TRBV7-9	TRBJ1-2
TGTGCCAGCAGCTTGGACTCCCCTATAAATGAGCAGTTCTTC	CASSLDSPINEQFF	TRBV5-6	TRBJ2-1
TGTGCCAGTATGGGGACTGAAGCTTTCTTT	CASMGTEAFF	TRBV19	TRBJ1-1
TGTGCCACCAGTGATTTAACACATGCGGGAGCCAACGAGCAGTACTTC	CATSDLTHAGANEQYF	TRBV24-1	TRBJ2-7
TGTGCCAGCAGCTGTTCAAAACAGGGGGGGGACATTCAGTACTTC	CASSCSKQGGDIQYF	TRBV9	TRBJ2-4
TGCAGTGCTAAAGTCGACTACGCCGGGGATAGCTCCTACGAGCAGTACTTC	CSAKVDYAGDSSYEQYF	TRBV20-1	TRBJ2-7
