TGTGCCAGCAGTGAGTTTTGCCGTCATGGGGGACTAAATGAAAAACTGTTTTTT	CASSEFCRHGGLNEKLFF	TRBV6-4	TRBJ1-4
TGCGCCAGCAGCTTGCTAGCGGGACTCTCCTACAATGAGCAGTTCTTC	CASSLLAGLSYNEQFF	TRBV5-1	TRBJ2-1
TGTGCCACGTCTAGGTCAGGTGAAGCTTTCTTT	CATSRSGEAFF	TRBV24-1	TRBJ1-1
TGTGCCAGCAGGGCGTCCCCCGGGGAGACTGAAGCTTTCTTT	CASRASPGETEAFF	TRBV6-1	TRBJ1-1
TGCAGTGCCAAGCGGGAGTCCGAGCAGTACTTC	CSAKRESEQYF	TRBV20-1	TRBJ2-7
TGCAGTGCTAGACGACCTCGGGACAGGGAGTATCTTGAGCCCAACACCGGGGAGCTGTTTTTT	CSARRPRDREYLEPNTGELFF	TRBV20-1	TRBJ2-2
TGTGCCAGCAGCTTTTTCAGGTCGTGCTACACCTTC	CASSFFRSCYTF	TRBV5-4	TRBJ1-2
TGTGCCAGCTTAGCAGTCACAGATACGCAGTATTTT	CASLAVTDTQYF	TRBV9	TRBJ2-3
TGTGCCAGCAGCCGGGACAGCAATTCACCCCTCCACTTT	CASSRDSNSPLHF	TRBV3-1	TRBJ1-6
TGTGCCAGCAGTTACAAACGATCCCACTCTGGAAACACCATATATTTT	CASSYKRSHSGNTIYF	TRBV6-6	TRBJ1-3
TGCGCCAGCAGCTTATTAGGGACCTCTGGAAACACCATATATTTT	CASSLLGTSGNTIYF	TRBV5-1	TRBJ1-3
TGTGCCTTTACTAGCGGGGCCTACAATGAGCAGTTCTTC	CAFTSGAYNEQFF	TRBV10-3	TRBJ2-1
TGTGCCAGCAGCTTAGCGCTTGGAACTTACTACTACGAGCAGTACTTC	CASSLALGTYYYEQYF	TRBV7-9	TRBJ2-7
TGTGCCAGTAGTATCCGCCTAGCGGGTACCTACAATGAGCAGTTCTTC	CASSIRLAGTYNEQFF	TRBV19	TRBJ2-1
TGTGCCAGCAGTTATTTCTCCGGGACATTGAATCAGCCCCAGCATTTT	CASSYFSGTLNQPQHF	TRBV6-5	TRBJ1-5
TGTGCCAGCGAACTCGGGACTAGCGGGATCGATGCCCAGTACTTC	CASELGTSGIDAQYF	TRBV12-3	TRBJ2-5
TGTGCCAGCAGTTACTCCTGGCACCTAGCGGGTGAGCAGTTCTTC	CASSYSWHLAGEQFF	TRBV6-5	TRBJ2-1
TGCGCCAGCAGCCAAGGACGGGCGGGGAGGGGCACAGATACGCAGTATTTT	CASSQGRAGRGTDTQYF	TRBV4-1	TRBJ2-3
TGCGCCAGCAGCTTGGCTAATTCATGCTTGCTGAACACCGGGGAGCTGTTTTTT	CASSLANSCLLNTGELFF	TRBV5-1	TRBJ2-2
TGTGCCAGCAGTAGGATAGGACTACCCTCGTACGAGCAGTACTTC	CASSRIGLPSYEQYF	TRBV6-2	TRBJ2-7
TGTGCCAGCAGTCAGGGGGAGAGCTACGAGCAGTACTTC	CASSQGESYEQYF	TRBV6-6	TRBJ2-7
TGCGCCAGCAGCCAAGTTGACGGGGGGGGCACCGGGGAGCTGTTTTTT	CASSQVDGGGTGELFF	TRBV4-1	TRBJ2-2
TGTGCCAGCAGCCAAGGCGGGGGGTGGAGACATTGTTCTCCGAGGGGGACCACTAATGAAAAACTGTTTTTT	CASSQGGGWRHCSPRGTTNEKLFF	TRBV3-1	TRBJ1-4
TGCAGCGTCCCAGGGGCCTACGAGCAGTACTTC	CSVPGAYEQYF	TRBV29-1	TRBJ2-7
TGCGCCAGCAGCTTGGTTCTAGGACTTTATGGGTATGGCTACACCTTC	CASSLVLGLYGYGYTF	TRBV5-1	TRBJ1-2
TGCAGCGTTGTGGCCGGGACAGCCAAAAACATTCAGTACTTC	CSVVAGTAKNIQYF	TRBV29-1	TRBJ2-4
TGTGCCAGCAGCTTAGCGAGCCGCACAGATACGCAGTATTTT	CASSLASRTDTQYF	TRBV7-4	TRBJ2-3
TGTGCTAGTGACTCCAGGACAGGCCCTTACGAGCAGTACTTC	CASDSRTGPYEQYF	TRBV12-5	TRBJ2-7
TGTGCCAGCAGGTGGGGACGCAATTTGAACACTGAAGCTTTCTTT	CASRWGRNLNTEAFF	TRBV27	TRBJ1-1
TGCGCCAGCGGGAAGATCCCCTGGAGCGGGACGGACCACACTGAAGCTTTCTTT	CASGKIPWSGTDHTEAFF	TRBV4-1	TRBJ1-1
TGTGCCAGCAGTGACTCGACAGTAGGAGCCTCCTATAATTCACCCCTCCACTTT	CASSDSTVGASYNSPLHF	TRBV6-4	TRBJ1-6
TGTGCCAGCAGCTTAGAACCAGTTGACACCGGGGAGCTGTTTTTT	CASSLEPVDTGELFF	TRBV11-2	TRBJ2-2
TGTGCCAGCAGCTTAAAATGGACAAGGGGGAGCAATCAGCCCCAGCATTTT	CASSLKWTRGSNQPQHF	TRBV11-2	TRBJ1-5
TGTGCCAGCAGTTATGCCCCAGGGTATGGCTACACCTTC	CASSYAPGYGYTF	TRBV6-2	TRBJ1-2
TGTGCCAGCAGAAGCCGGGACAGGGTCTCCAATCAGCCCCAGCATTTT	CASRSRDRVSNQPQHF	TRBV5-8	TRBJ1-5
TGCGCCAGCCCAAGCGGGAGCTGGCTAGCCAAAAACATTCAGTACTTC	CASPSGSWLAKNIQYF	TRBV10-1	TRBJ2-4
TGTGCCAGCAGTGAAGCGGGAGAGGAGGCTGAAGCTTTCTTT	CASSEAGEEAEAFF	TRBV2	TRBJ1-1
TGTGCCAGCAGCGCTAGTCAGGGTCAATACACTGAAGCTTTCTTT	CASSASQGQYTEAFF	TRBV11-3	TRBJ1-1
TGTGCCAGCAGGGGGGGGACTGAGCAGTTCTTC	CASRGGTEQFF	TRBV11-3	TRBJ2-1
TGTGCCAGCAGCGCCCGACTAGCGGGAGGGATTAATTCACCCCTCCACTTT	CASSARLAGGINSPLHF	TRBV9	TRBJ1-6
TGCAGTGCTAGACCCCGGGACATAGAGACCCAGTACTTC	CSARPRDIETQYF	TRBV20-1	TRBJ2-5
TGCAGTGCTAGTACCCGAGGATCTTCGGCCTACGAGCAGTACTTC	CSASTRGSSAYEQYF	TRBV20-1	TRBJ2-7
TGTGCCAGCAGCTCCGGGACAGACACAGATACGCAGTATTTT	CASSSGTDTDTQYF	TRBV11-3	TRBJ2-3
TGCAGTGCTATTGAGTGGCAGCCCCAGCATTTT	CSAIEWQPQHF	TRBV20-1	TRBJ1-5
TGTGCCAGCAGAGCACAGTATATTACCTATGGCTACACCTTC	CASRAQYITYGYTF	TRBV12-4	TRBJ1-2
TGTGCCAGTAGTATATCTAGCTGTTCGGGGCGGGGAGGGAAGTCCCACAATGAGCAGTTCTTC	CASSISSCSGRGGKSHNEQFF	TRBV19	TRBJ2-1
TGTGCCAGCAGTGCAAGCGTGATCATAAAGGTGACTAGCGGGGGGGCCGGCCTCTCTGGGGCCAACGTCCTGACTTTC	CASSASVIIKVTSGGAGLSGANVLTF	TRBV6-4	TRBJ2-6
TGTGCCACCAGTGATAATTATTCAGGGTACGTTCCCCGTGAAAAACTGTTTTTT	CATSDNYSGYVPREKLFF	TRBV24-1	TRBJ1-4
TGTGCCAGCAGTTATGACCGGCAGGGTGAAGCTTTCTTT	CASSYDRQGEAFF	TRBV6-2	TRBJ1-1
TGTGCCAGCAGCCTAATCAACCTAGGACAGATCCGCAATCAGCCCCAGCATTTT	CASSLINLGQIRNQPQHF	TRBV7-4	TRBJ1-5
TGTGCCAGTCTTCAGAACAGGGCGGGGGAGCTGTTTTTT	CASLQNRAGELFF	TRBV28	TRBJ2-2
TGTGCCACCAGCCTAAACCCCCCAGTGGACATGGCCACCGGGGAGCTGTTTTTT	CATSLNPPVDMATGELFF	TRBV24-1	TRBJ2-2
TGCAGTTCCCCAGGGGGGTATGGCTACACCTTC	CSSPGGYGYTF	TRBV20-1	TRBJ1-2
TGTGCCAGCACAACTCTAGGGACAGGGGTCCGAGATGAGCAGTTCTTC	CASTTLGTGVRDEQFF	TRBV14	TRBJ2-1
TGTGCCAGCAGAAAATATGCACGGACAGGGGAGGGCTTTTACTATGGCTACACCTTC	CASRKYARTGEGFYYGYTF	TRBV28	TRBJ1-2
TGTGCCAGCAGTTACTCCACCGGGACAGGGGCCGCCGCTGACTATGGCTACACCTTC	CASSYSTGTGAAADYGYTF	TRBV6-6	TRBJ1-2
TGTGCCAGCAGCCAATTAGCGGGGGGGAATGAGCAGTTCTTC	CASSQLAGGNEQFF	TRBV9	TRBJ2-1
TGTGCCAGCAGCGCGGGACAGCTAGGATATAGCAATCAGCCCCAGCATTTT	CASSAGQLGYSNQPQHF	TRBV13	TRBJ1-5
TGCAGCGTTGCAGGGGGCCACAGAAACACCGGGGAGCTGTTTTTT	CSVAGGHRNTGELFF	TRBV29-1	TRBJ2-2
TGTGCCAGCAGCCCCCCCCTAGCGGGTGTACGCGGAGATTCCTACGAGCAGTACTTC	CASSPPLAGVRGDSYEQYF	TRBV6-3	TRBJ2-7
TGTGCCAGCTCACCACTTACTAGCGGGAGTTTCTTT	CASSPLTSGSFF	TRBV18	TRBJ1-1
TGTGCCAGCAGCCAAGAGGCAGGACAGTCATCCTACACCGGGGAGCTGTTTTTT	CASSQEAGQSSYTGELFF	TRBV14	TRBJ2-2
TGTGCCAGCAGCGTACGCCCTCCGGTCTACAATGAGCAGTTCTTC	CASSVRPPVYNEQFF	TRBV9	TRBJ2-1
TGTGCCAGCAGTGCCGGGGACTGTAACACTGAAGCTTTCTTT	CASSAGDCNTEAFF	TRBV25-1	TRBJ1-1
TGTGCCAGCTCCAAAACGAGGGGGCGCTCGATGGATCAGCCCCAGCATTTT	CASSKTRGRSMDQPQHF	TRBV11-3	TRBJ1-5
TGTGCCACCAGCCAAGGCGGGGAGCTGTTTTTT	CATSQGGELFF	TRBV15	TRBJ2-2
TGCGCCGTTCTAACCCCCTATAGCAATCAGCCCCAGCATTTT	CAVLTPYSNQPQHF	TRBV5-1	TRBJ1-5
TGTGCTAGAAGCGGGAGCATCATCGGGGAGCTGTTTTTT	CARSGSIIGELFF	TRBV12-5	TRBJ2-2
TGTGCCAGCTCACGGGTGACAATGTCAGATACGCAGTATTTT	CASSRVTMSDTQYF	TRBV18	TRBJ2-3
TGCGCCAGCAGCTTCCGGGGGGGTCTCACAGATACGCAGTATTTT	CASSFRGGLTDTQYF	TRBV5-1	TRBJ2-3
TGTGCCAGCAGTATGGGACAGGGACACCGATATAATTCACCCCTCCACTTT	CASSMGQGHRYNSPLHF	TRBV25-1	TRBJ1-6
TGTGCCACCGGACTAGCGGGAACTGCCTCCTACGAGCAGTACTTC	CATGLAGTASYEQYF	TRBV7-9	TRBJ2-7
TGTGCCAGCAGTTACGTGCGCGCAGGGGGTTCTAGAACCGGGGAGCTGTTTTTT	CASSYVRAGGSRTGELFF	TRBV6-5	TRBJ2-2
TGTGCCTGGACTGTTAGACGGACAGATACGCAGTATTTT	CAWTVRRTDTQYF	TRBV30	TRBJ2-3
TGTGCCAGCAGCGGGGGGAGGGATCAGCCCCAGCATTTT	CASSGGRDQPQHF	TRBV28	TRBJ1-5
TGTGCCACAGAGAGGGCGAAGTCCTACAATGAGCAGTTCTTC	CATERAKSYNEQFF	TRBV24-1	TRBJ2-1
TGTGCCAGCAGCGGACAGGGGAGGAACACTGAAGCTTTCTTT	CASSGQGRNTEAFF	TRBV7-4	TRBJ1-1
TGTGCCAGCAGTTACCCAGGGGGGGCCAAAAACATTCAGTACTTC	CASSYPGGAKNIQYF	TRBV6-6	TRBJ2-4
TGTGCCAGCAGTTTAAAAATAGACAGGGGGGTAGATAGCAATCAGCCCCAGCATTTT	CASSLKIDRGVDSNQPQHF	TRBV27	TRBJ1-5
TGCGCCAGCAGCGGACCCCCCACAGGGAGAATTACGAACACTGAAGCTTTCTTT	CASSGPPTGRITNTEAFF	TRBV5-1	TRBJ1-1
TGTGCCAGCAGTTTACGGTGTTGGGGCTACGAGCAGTACTTC	CASSLRCWGYEQYF	TRBV27	TRBJ2-7
TGTGCCAGCAGTGAAGCGCTGTCGACAGGGGGCGCGGCCAACACTGAAGCTTTCTTT	CASSEALSTGGAANTEAFF	TRBV6-1	TRBJ1-1
TGTGCCAGCAGTGAGGGCAGAAAACTAGCGGGAGTTATTGCTGAGCAGTTCTTC	CASSEGRKLAGVIAEQFF	TRBV2	TRBJ2-1
TGTGCCCGGGACAGGGCTCATTCGAACACTGAAGCTTTCTTT	CARDRAHSNTEAFF	TRBV19	TRBJ1-1
TGTGCCAGCAGCTGGGAAACAGGGGTGAACACTGAAGCTTTCTTT	CASSWETGVNTEAFF	TRBV5-6	TRBJ1-1
TGTGCCAGCCAGACAGGGTACTTC	CASQTGYF	TRBV7-9	TRBJ2-7
TGTGCCAGCAGTGAAGACAGGTACCAAGAGACCCAGTACTTC	CASSEDRYQETQYF	TRBV6-1	TRBJ2-5
TGTGCCAGCCGCGGAGGGGACAGGTACGAGCAGTACTTC	CASRGGDRYEQYF	TRBV6-4	TRBJ2-7
TGTGCCACCAGTGATTCCCGAGTCTCTATCGGTGACTATGGCTACACCTTC	CATSDSRVSIGDYGYTF	TRBV24-1	TRBJ1-2
TGTGCCAGCAGTTACTCCCTATCTTTCGGAGACGAGCAGTACTTC	CASSYSLSFGDEQYF	TRBV6-2	TRBJ2-7
TGCAGCGTTGCCGTGGTCCTTAAGACAGCGCAAGAGACCCAGTACTTC	CSVAVVLKTAQETQYF	TRBV29-1	TRBJ2-5
TGTGCCAGCAGTGACTGGCAGGAGGGCACTGAAGCTTTCTTT	CASSDWQEGTEAFF	TRBV25-1	TRBJ1-1
TGTGCCAGCAGATCCACGGACAGGGAGGGCTACGAGCAGTACTTC	CASRSTDREGYEQYF	TRBV28	TRBJ2-7
TGTGCCAGCAGTGTAGACCGGGGGTTATCTAATGAAAAACTGTTTTTT	CASSVDRGLSNEKLFF	TRBV6-4	TRBJ1-4
TGCAGTGCTATCGGGACAGGGTCTTGGCGCTCCTACAATGAGCAGTTCTTC	CSAIGTGSWRSYNEQFF	TRBV20-1	TRBJ2-1
TGTGCCACCAGTGCCAGTAGTAGCCGACAGTATAGCAATCAGCCCCAGCATTTT	CATSASSSRQYSNQPQHF	TRBV24-1	TRBJ1-5
TGCTACCAACTAGCGGGAGCCAAAAACATTCAGTACTTC	CYQLAGAKNIQYF	TRBV20-1	TRBJ2-4
TGCGCCAGCAGCTCTACCCAGGCCGGGAATCAGCCCCAGCATTTT	CASSSTQAGNQPQHF	TRBV5-1	TRBJ1-5
TGCAGTGCCCGACGCTCGGACAGGGTATATCAGCCCCAGCATTTT	CSARRSDRVYQPQHF	TRBV20-1	TRBJ1-5
TGTGCCAGCAGACGGGACAGGGTGGACACTGAAGCTTTCTTT	CASRRDRVDTEAFF	TRBV27	TRBJ1-1
TGTGCCACCAGTGTCGTAAGGGAAGGAGCTATATACGAGCAGTACTTC	CATSVVREGAIYEQYF	TRBV24-1	TRBJ2-7
TGCAGTGCTCGCCTCGAGTCCTACGAGCAGTACTTC	CSARLESYEQYF	TRBV20-1	TRBJ2-7
TGTGCCAGCAGATTAGAATGCTACGAGCAGTACTTC	CASRLECYEQYF	TRBV6-1	TRBJ2-7
TGTGCCAGCTCACCACCGGAGGACGGGCCTAGCAATCAGCCCCAGCATTTT	CASSPPEDGPSNQPQHF	TRBV18	TRBJ1-5
TGTGCCACCAGTCGTCCAGGGGGTCCAGACAATGAGCAGTTCTTC	CATSRPGGPDNEQFF	TRBV24-1	TRBJ2-1
TGTGCCAGCTCACGGCGGACCTACGAGCAGTACTTC	CASSRRTYEQYF	TRBV18	TRBJ2-7
TGTGCCACCCCGGGACTAGCGGGGGGGGATACGCAGTATTTT	CATPGLAGGDTQYF	TRBV24-1	TRBJ2-3
TGTGCCAGCAGCTTAGATAAAGGGAGGGAGGAAGAGACCCAGTACTTC	CASSLDKGREEETQYF	TRBV11-3	TRBJ2-5
TGTGCCAGCAGTTTAGATCACCTCCGGGACAGCCCTTACTATGGCTACACCTTC	CASSLDHLRDSPYYGYTF	TRBV27	TRBJ1-2
TGCGCCAGCAGCTTGGCCCTGGGGCAAGGCTACACCTTC	CASSLALGQGYTF	TRBV5-1	TRBJ1-2
TGTGCCAGCAGTTGGAAGGTGGGGCCCTACGAGCAGTACTTC	CASSWKVGPYEQYF	TRBV12-3	TRBJ2-7
TGTGCCAGCGAGACTCGGACAGGTGGGGCCAACGTCCTGACTTTC	CASETRTGGANVLTF	TRBV6-3	TRBJ2-6
TGTGCCAGCAGCAACGACAGGGAAAAAAACACCATATATTTT	CASSNDREKNTIYF	TRBV7-3	TRBJ1-3
TGTGCCAGTAGTCAGGGGGCGTCTTATCAGCCCCAGCATTTT	CASSQGASYQPQHF	TRBV19	TRBJ1-5
TGTGCCAGCAGTGATTCGGGACTAGCGGGTTCCCCCCAAGAGACCCAGTACTTC	CASSDSGLAGSPQETQYF	TRBV25-1	TRBJ2-5
TGTGCCAGCAGTTGCAACCGCCACAGGGTTGGTTACACTGAAGCTTTCTTT	CASSCNRHRVGYTEAFF	TRBV6-5	TRBJ1-1
TGTGCCACCCGTTACTACGAGCAGTACTTC	CATRYYEQYF	TRBV19	TRBJ2-7
TGCGCCAGCAGTGAACCCCACCCAGCCAGGGTTCCCGCCGAAAAACTGTTTTTT	CASSEPHPARVPAEKLFF	TRBV10-1	TRBJ1-4
TGTGCCAGTCCCTGGACCTACACTGAAGCTTTCTTT	CASPWTYTEAFF	TRBV2	TRBJ1-1
TGCAGTGCTAGAAGTCTGAGCGGGAGGGATGGCTACACCTTC	CSARSLSGRDGYTF	TRBV20-1	TRBJ1-2
TGTGCCAGCAGCCCGGACAGGACGGTCAGCTATGGCTACACCTTC	CASSPDRTVSYGYTF	TRBV7-2	TRBJ1-2
TGTGCCAGCAGTTACTCGATTAGCGGGGGACGGTCCTTC	CASSYSISGGRSF	TRBV6-5	TRBJ2-7
TGTGCCAGCAGCCGGTTAGCGGGTTGGACGAACACCGGGGAGCTGTTTTTT	CASSRLAGWTNTGELFF	TRBV5-5	TRBJ2-2
TGTGCCAGACCCGTCTTCCAGAGGGGGGAGGGTTCACCCCTCCACTTT	CARPVFQRGEGSPLHF	TRBV13	TRBJ1-6
TGTGCCAGCAGTTACCCTCCTTCTCTTGGTAAACGTCAAGAGACCCAGTACTTC	CASSYPPSLGKRQETQYF	TRBV6-5	TRBJ2-5
TGCGCCAGCAGCCAAGAAAGCGGATGGAAAGAATCTGAAAAACTGTTTTTT	CASSQESGWKESEKLFF	TRBV4-3	TRBJ1-4
TGTGCCAGCAGCCCCCCCTCGAGCGGATGGACCCAGTACTTC	CASSPPSSGWTQYF	TRBV7-8	TRBJ2-5
TGTGCTAGTGGGGAATCTAGGGCTTCGGGGTCGAGCAATCAGCCCCAGCATTTT	CASGESRASGSSNQPQHF	TRBV12-5	TRBJ1-5
TGTGCCAGCAGCTTACGATTGACAGGGGAAGGCTCCTATAATTCACCCCTCCACTTT	CASSLRLTGEGSYNSPLHF	TRBV7-2	TRBJ1-6
TGTGCCAGCATGGGGGGGGATAAGCCGCAGTACTTC	CASMGGDKPQYF	TRBV3-1	TRBJ2-7
TGTGCCAGCAGCCCCCTAGAGGAGAGCTATGGCTACACCTTC	CASSPLEESYGYTF	TRBV6-5	TRBJ1-2
TGCGCCAGCAGCCAAGTCCCGGACAGCCCACAAAGGGGGGCCAACGTCCTGACTTTC	CASSQVPDSPQRGANVLTF	TRBV4-3	TRBJ2-6
TGCGCCAGCAGCCAGAGGACAGGTGGGAACTATGGCTACACCTTC	CASSQRTGGNYGYTF	TRBV5-1	TRBJ1-2
TGTGCCAGCAGCTTAGCGGTGAAGTTCGGGGGGTTGAACACTGAAGCTTTCTTT	CASSLAVKFGGLNTEAFF	TRBV7-4	TRBJ1-1
TGCAGTGCTGATTACTTCCTCCTCATTGTTCAGCAGTACTTC	CSADYFLLIVQQYF	TRBV20-1	TRBJ2-7
TGTGCCAGCAGCTTGGATTGTCAGGGTAGAACCTACGAGCAGTACTTC	CASSLDCQGRTYEQYF	TRBV7-8	TRBJ2-7
TGCGCCAGCAGCCAAGACAGGGGGGGGGACCGGCGCTCTGGGGCCAACGTCCTGACTTTC	CASSQDRGGDRRSGANVLTF	TRBV4-1	TRBJ2-6
TGTGCCACATCAGGGACAGCAAGGGGGACCCACACTGAAGCTTTCTTT	CATSGTARGTHTEAFF	TRBV24-1	TRBJ1-1
TGCGCCAGCAGTGAGTCGGTAGCGGGGTACGAGCAGTACTTC	CASSESVAGYEQYF	TRBV10-1	TRBJ2-7
TGTGCCAGCAGCCCATTATGGGTGGGGGCCCGTAAAACTGAAGCTTTCTTT	CASSPLWVGARKTEAFF	TRBV11-2	TRBJ1-1
TGTGCCAGCAGTGGATACCCGGGACAGGGGGTCAATCAGCCCCAGCATTTT	CASSGYPGQGVNQPQHF	TRBV7-3	TRBJ1-5
TGTGCCAGCAGCCAAGTACCCGGGACTAGCGGGAGTGTGAACACTGAAGCTTTCTTT	CASSQVPGTSGSVNTEAFF	TRBV13	TRBJ1-1
TGTGCCACCGTCGGGGCCACAGATACGCAGTATTTT	CATVGATDTQYF	TRBV28	TRBJ2-3
TGTGCCAGCAGCTGCCGACTGGGCTCCTACGAGCAGTACTTC	CASSCRLGSYEQYF	TRBV7-4	TRBJ2-7
TGCAGCGTTGAGGGACAGTCCAGCTCTGGGGCCAACGTCCTGACTTTC	CSVEGQSSSGANVLTF	TRBV29-1	TRBJ2-6
TGTGCTAGTGCTACAGGGTGCGAGAACACTGAAGCTTTCTTT	CASATGCENTEAFF	TRBV12-5	TRBJ1-1
TGCAGTGCTAGATGTATAACAAGGGGCTTAGCTTTCTTT	CSARCITRGLAFF	TRBV20-1	TRBJ1-1
TGTGCCAGCAGCGAGTGGACTAAGGGGGACGAGCAGTACTTC	CASSEWTKGDEQYF	TRBV9	TRBJ2-7
TGTGCCAGCAGTAGCCAAGGGGGTGATGACTATGGCTACACCTTC	CASSSQGGDDYGYTF	TRBV7-3	TRBJ1-2
TGTGCCAGCAGTTACACCCCTAGCGGGTGGTACGAGCAGTACTTC	CASSYTPSGWYEQYF	TRBV6-5	TRBJ2-7
TGTGCCAGCAGTTTAAACGAACAAGAGACCCAGTACTTC	CASSLNEQETQYF	TRBV6-3	TRBJ2-5
TGTGCCAGCAGCATTGCGACAGGGTCGTCGGCCGGGGAGCTGTTTTTT	CASSIATGSSAGELFF	TRBV7-4	TRBJ2-2
TGTGCCATTGCGGGGACCCAGTACTTC	CAIAGTQYF	TRBV19	TRBJ2-5
TGTGCCAGCAGGTTCATGACTAGCGGGCATCCCAACGAGCAGTACTTC	CASRFMTSGHPNEQYF	TRBV6-4	TRBJ2-7
TGTGCCAGCAGCTTTTCAGGACGGTGCACAGATACGCAGTATTTT	CASSFSGRCTDTQYF	TRBV5-4	TRBJ2-3
TGTGCCAGCAGCCAAGATTTAGGCTGGCAGGAGGAAAACACCATATATTTT	CASSQDLGWQEENTIYF	TRBV14	TRBJ1-3
TGTGCCAGCAGTGACGCAGGGGCGAGGATGGCCAAAAACATTCAGTACTTC	CASSDAGARMAKNIQYF	TRBV6-4	TRBJ2-4
TGTGCCAGCAGCTTGATCGACAGGGGGAACGAGCAGTACTTC	CASSLIDRGNEQYF	TRBV5-4	TRBJ2-7
TGTGCCAGCAGCCTTCGGGGGAACACCGGGGAGCTGTTTTTT	CASSLRGNTGELFF	TRBV7-4	TRBJ2-2
TGCGCCAGCAGCTCCCGGGACAGGCGAAAGGGCTACACCTTC	CASSSRDRRKGYTF	TRBV5-1	TRBJ1-2
TGCGCCAGCAGCCAAGATAACCTGCCGGGCGGGAACACTGAAGCTTTCTTT	CASSQDNLPGGNTEAFF	TRBV4-1	TRBJ1-1
TGTGCCAGCAGTCGAAGCGGAGTGGGCTCCTACGAGCAGTACTTC	CASSRSGVGSYEQYF	TRBV6-4	TRBJ2-7
TGTGCCAGCAGCCCCCGGGACCCGGTCAAGTCCCACACCATATATTTT	CASSPRDPVKSHTIYF	TRBV4-2	TRBJ1-3
TGTGCCACCATAGGGGTCCGACAGGGGGCCCGCTCCTACGAGCAGTACTTC	CATIGVRQGARSYEQYF	TRBV24-1	TRBJ2-7
TGTGCCAGCAGCCAACCCCCCCGAGTTAGCGGGGATACAGATACGCAGTATTTT	CASSQPPRVSGDTDTQYF	TRBV3-1	TRBJ2-3
TGCAGTGCTAGGACCCCCAGTTCCCAGCATTTT	CSARTPSSQHF	TRBV20-1	TRBJ1-5
TGCAGCGTTGTCCCCCCAAGGGGTAATAATGAAAAACTGTTTTTT	CSVVPPRGNNEKLFF	TRBV29-1	TRBJ1-4
TGTGCCAGCAGGCCACAGGGGACTACCGGGGAGCTGTTTTTT	CASRPQGTTGELFF	TRBV9	TRBJ2-2
TGTGCCAGCAGCTTGTTAGCCGGGACAGCGGTGGAAGAGACCCAGTACTTC	CASSLLAGTAVEETQYF	TRBV7-3	TRBJ2-5
TGTGCCAGCAGCTTATGTCTCCCAAGAATGGATGAAAAGCACACCGGGGAGCTGTTTTTT	CASSLCLPRMDEKHTGELFF	TRBV7-6	TRBJ2-2
TGTGCCAGCAGCTCACGATCCACCTACAGGGTTTCCTACGAGCAGTACTTC	CASSSRSTYRVSYEQYF	TRBV5-6	TRBJ2-7
TGTGCCAACCGAGGACAGGGACACGAGCAGTACTTC	CANRGQGHEQYF	TRBV19	TRBJ2-7
TGTGCCAGCAGCCCTAGGGGGGGCCCGGCAAGGGGGTCAAGCTCCTACGAGCAGTACTTC	CASSPRGGPARGSSSYEQYF	TRBV9	TRBJ2-7
TGTGCCATAGATGAAGGGGGGCTTTCCTACAATGAGCAGTTCTTC	CAIDEGGLSYNEQFF	TRBV10-3	TRBJ2-1
TGTGCCAGCAGCTTTGGACAGGCCGGGGAGCTGTTTTTT	CASSFGQAGELFF	TRBV7-7	TRBJ2-2
TGTGCCAGCAGCGTAGTCCGAAGTCAATCCTACAATGAGCAGTTCTTC	CASSVVRSQSYNEQFF	TRBV9	TRBJ2-1
TGTGCCAGCAGTGGGACAGGGGGAACTAGGATCAATCAGCCCCAGCATTTT	CASSGTGGTRINQPQHF	TRBV6-1	TRBJ1-5
TGTGCCAGCAGCCAAAGCGGGAGAATGAACGAGCAGTACTTC	CASSQSGRMNEQYF	TRBV4-2	TRBJ2-7
TGCGCCAGCAGCTTTGCCGGGGGTAGAGCCACCTACGAGCAGTACTTC	CASSFAGGRATYEQYF	TRBV5-1	TRBJ2-7
TGTGCCAGCAGTTTACTCCAGCGAGGGAGGAAGATTAGCAATCAGCCCCAGCATTTT	CASSLLQRGRKISNQPQHF	TRBV12-4	TRBJ1-5
TGTGCCAGCAGCGTGGTGGACAGGGTACTCAATCAGCCCCAGCATTTT	CASSVVDRVLNQPQHF	TRBV9	TRBJ1-5
TGTGCCACCAGTGAAGGGGGAAGGGACAGCAAGCCCAATCAGCCCCAGCATTTT	CATSEGGRDSKPNQPQHF	TRBV24-1	TRBJ1-5
TGTGCCAGGGGCTATGGCTACACCTTC	CARGYGYTF	TRBV19	TRBJ1-2
TGCGCCAGCAGCCCGGGACATTTCTATTGCACAGATACGCAGTATTTT	CASSPGHFYCTDTQYF	TRBV5-1	TRBJ2-3
TGTGCCAGCAGCTTGGTTCGGGACGCTACCATGAACACTGAAGCTTTCTTT	CASSLVRDATMNTEAFF	TRBV5-4	TRBJ1-1
TGTGCCAGCAGCCGCTGGAGTGAGCAGTTCTTC	CASSRWSEQFF	TRBV13	TRBJ2-1
TGTGCCTGGAGTCGGGCGGAGACCCAGTACTTC	CAWSRAETQYF	TRBV30	TRBJ2-5
TGTGCCAGCAGTTTCGGCTTAGATACGCAGTATTTT	CASSFGLDTQYF	TRBV12-3	TRBJ2-3
TGTGCCAGCAGCCAAGATGAAACGACAGGCAGGTCCTACGAGCAGTACTTC	CASSQDETTGRSYEQYF	TRBV4-2	TRBJ2-7
TGTGCCAGCAGGGTGACAGGGATAGAAAAACTGTTTTTT	CASRVTGIEKLFF	TRBV6-4	TRBJ1-4
TGTGCCAGCAGTAGAGGGAGATCAAAACTGTTTTTT	CASSRGRSKLFF	TRBV12-4	TRBJ1-4
TGTGCCAGCAGCTCAACCCCCCGGGCGAGAGTTAGCAATCAGCCCCAGCATTTT	CASSSTPRARVSNQPQHF	TRBV7-6	TRBJ1-5
TGTGCCAGCCGTGGCACTGGACAGGGCTTAGCGATCTCTGGAAACACCATATATTTT	CASRGTGQGLAISGNTIYF	TRBV25-1	TRBJ1-3
TGTGCCAGTAGGAAGTCGGGGACACCCTACTATGGCTACACCTTC	CASRKSGTPYYGYTF	TRBV19	TRBJ1-2
TGCGCCAGCAGCCCGGGTCATTGGTACTTC	CASSPGHWYF	TRBV4-3	TRBJ2-7
TGTGCCAGCAGCTCAGGGCACAATGAGCAGTTCTTC	CASSSGHNEQFF	TRBV11-3	TRBJ2-1
TGTGCCAGCCTTATCCCCGGGACAGGGTTGAACACTGAAGCTTTCTTT	CASLIPGTGLNTEAFF	TRBV5-6	TRBJ1-1
TGTGCCAGCAGTGAAGCAGAAATAGGAAGTGGTAACTATGGCTACACCTTC	CASSEAEIGSGNYGYTF	TRBV2	TRBJ1-2
TGTGCCAGCAGGTTTCGCGGGGGAAGGGGACAGGGGGAGGATGGCTACACCTTC	CASRFRGGRGQGEDGYTF	TRBV6-2	TRBJ1-2
TGTGCCTGGAGTGTACCAATGGGGGAGATGAACACTGAAGCTTTCTTT	CAWSVPMGEMNTEAFF	TRBV30	TRBJ1-1
TGTGCCAGCAGTGAAGCTCGACCCAGGGGCGAGCAGTACTTC	CASSEARPRGEQYF	TRBV6-1	TRBJ2-7
TGTGCCAGCAACAGGGCTTTTGAGTACCAAGAGACCCAGTACTTC	CASNRAFEYQETQYF	TRBV6-4	TRBJ2-5
TGTGCCAGTCACCAGTCTGGACTTAATTCACCCCTCCACTTT	CASHQSGLNSPLHF	TRBV19	TRBJ1-6
TGTGCCAGCCAATACGCTAGGGACGAGCAGTACTTC	CASQYARDEQYF	TRBV5-5	TRBJ2-7
TGTGCCAGCAGCTTGCGGCCGGGTGGCTACGAGCAGTACTTC	CASSLRPGGYEQYF	TRBV7-2	TRBJ2-7
TGCAGTGCTAGCGATGGACTAGCGGGAGGGGAGGCCTACGAGCAGTACTTC	CSASDGLAGGEAYEQYF	TRBV20-1	TRBJ2-7
TGTGCTAAAAAGCCATCCCGGAATGCTCCAAACATTCAGTACTTC	CAKKPSRNAPNIQYF	TRBV12-5	TRBJ2-4
TGTGCCACCAGTGTACCCTTAAGCGTCAGGGATTTCCAGCCCCAGCATTTT	CATSVPLSVRDFQPQHF	TRBV24-1	TRBJ1-5
TGTGCCAGCAAGGGAAAGTCAAGCCAAGAGACCCAGTACTTC	CASKGKSSQETQYF	TRBV7-3	TRBJ2-5
TGTGCCAGCAGCTTACTTAGAGGCTCCCGGTTACTGAAGAGGGCCACAGATACGCAGTATTTT	CASSLLRGSRLLKRATDTQYF	TRBV11-1	TRBJ2-3
TGTGCCGATATTCCCACCGGGACTAGCGGGTCCAATGAGCAGTTCTTC	CADIPTGTSGSNEQFF	TRBV25-1	TRBJ2-1
TGTGCCAGCAGCCAAGATGCCGGGGGCCACTACACCTTC	CASSQDAGGHYTF	TRBV3-1	TRBJ1-2
TGTGCCAGCAGCTTGGCAGGGACAGGTTATAGCAATCAGCCCCAGCATTTT	CASSLAGTGYSNQPQHF	TRBV5-8	TRBJ1-5
TGTGCCAGCAGTTTATCGCCGAACGACCCGGCGTACGAGCAGTACTTC	CASSLSPNDPAYEQYF	TRBV27	TRBJ2-7
TGTGCCAGCTACCCAGGGAGGGTTCTGGCCTACAATGAGCAGTTCTTC	CASYPGRVLAYNEQFF	TRBV28	TRBJ2-1
TGTGCCAGCAGCAAGTCCCCCCCGGGACAGGACACTGAAGCTTTCTTT	CASSKSPPGQDTEAFF	TRBV7-4	TRBJ1-1
TGTGCCAGCAGTTTGTCGACAGGGGCCTTTCAGCCCCAGCATTTT	CASSLSTGAFQPQHF	TRBV12-4	TRBJ1-5
TGCAGTGCTAGACTGGGGACGAGCGAGCAGTACTTC	CSARLGTSEQYF	TRBV20-1	TRBJ2-7
TGTGCCAGCAGCGTGCTGGTAGACAGGGGAGCAAGTGAAGCTTTCTTT	CASSVLVDRGASEAFF	TRBV9	TRBJ1-1
TGTGCCAGCAGCTTTTTACAGGGAGAAAATCAGCCCCAGCATTTT	CASSFLQGENQPQHF	TRBV7-9	TRBJ1-5
TGTGCCAGCAGCAGGGCACGGGGGGACAGGGGGCATCAAGAGACCCAGTACTTC	CASSRARGDRGHQETQYF	TRBV7-8	TRBJ2-5
TGCGCCAGTACCCTAGCGGGTCGAAATGAGCAGTTCTTC	CASTLAGRNEQFF	TRBV5-1	TRBJ2-1
TGTGCCACCAGTGATTTGGAGACCGTACAGGGGTATGCTTTCTTT	CATSDLETVQGYAFF	TRBV24-1	TRBJ1-1
TGTGCCAGCAGCACCGACGAGGGGGATGGCTACACCTTC	CASSTDEGDGYTF	TRBV13	TRBJ1-2
TGTGCCAGCAGATCCGGGACTTGCTCCTACGAGCAGTACTTC	CASRSGTCSYEQYF	TRBV28	TRBJ2-7
TGTGCCACCAGTTCCGAGGTTGGGGGGGGGGCGGACGAGCAGTACTTC	CATSSEVGGGADEQYF	TRBV24-1	TRBJ2-7
TGTGCCAGCAGTGGGACGAACACTGAAGCTTTCTTT	CASSGTNTEAFF	TRBV28	TRBJ1-1
TGTGCCAGCATATGGGGCGCGGCCCATTCACCCCTCCACTTT	CASIWGAAHSPLHF	TRBV6-1	TRBJ1-6
TGTGCCAGCAGCGTTCGTCGACAAATGAACACTGAAGCTTTCTTT	CASSVRRQMNTEAFF	TRBV7-3	TRBJ1-1
TGCGCCAGCAGGGAGGGACCTTATAGCTCTGAGCAGTTCTTC	CASREGPYSSEQFF	TRBV10-1	TRBJ2-1
TGTGCCACCATATTTAGGCGGGACAGGGGGCATCCCAAGTATAGCAATCAGCCCCAGCATTTT	CATIFRRDRGHPKYSNQPQHF	TRBV24-1	TRBJ1-5
TGTGCCAGCAGTTCGTGGGGACAGGGCGACAATGAAGCTTTCTTT	CASSSWGQGDNEAFF	TRBV6-1	TRBJ1-1
TGTGCCAGCAGCCGCACTAGCGGGTACTACAATGAGCAGTTCTTC	CASSRTSGYYNEQFF	TRBV5-5	TRBJ2-1
TGTGCCAGCAGCTTATACGGGAAGGTGAATTCACCCCTCCACTTT	CASSLYGKVNSPLHF	TRBV13	TRBJ1-6
TGTGCCAGCCCTGGCTCTCACGCCAAAAACATTCAGTACTTC	CASPGSHAKNIQYF	TRBV7-4	TRBJ2-4
TGTGCCAGCAGTGTGGGATGGGATTATAGCAATCAGCCCCAGCATTTT	CASSVGWDYSNQPQHF	TRBV27	TRBJ1-5
TGTGCCAGCAGCCAAGATCGGGAAGGTCTAAGCTCCTACGAGCAGTACTTC	CASSQDREGLSSYEQYF	TRBV14	TRBJ2-7
TGCAGTGCCCCCGGGACAGGGGGTGGCTACACCTTC	CSAPGTGGGYTF	TRBV20-1	TRBJ1-2
TGTGCCAGCAGTGACTCGGATGACAGGTATGGCTTGCCAGCTTTCTTT	CASSDSDDRYGLPAFF	TRBV6-4	TRBJ1-1
TGCAGTGCTAGAGTCGCCCAGGGACAGGGGGGCTATAATTCACCCCTCCACTTT	CSARVAQGQGGYNSPLHF	TRBV20-1	TRBJ1-6
TGTGCCAGCAGCCGAACGGGGATACCCTGGACATATTCACCCCTCCACTTT	CASSRTGIPWTYSPLHF	TRBV3-1	TRBJ1-6
TGTGCCAGCACCAACAACCTAGCGTACGAGCAGTACTTC	CASTNNLAYEQYF	TRBV2	TRBJ2-7
TGCGCCAGCAGTGACTGCCGGCTAGGACAGGGGGCTGGGCTTTTCTACGAGCAGTACTTC	CASSDCRLGQGAGLFYEQYF	TRBV10-1	TRBJ2-7
TGCGCCAGCAGCTGCAAGAATCATTGGCTTGGTGGGGGGCTAAGCAATCAGCCCCAGCATTTT	CASSCKNHWLGGGLSNQPQHF	TRBV5-1	TRBJ1-5
TGTGCCACCAGTGTGCGGGGATGTAGATGGGTGGCCTATAATTCACCCCTCCACTTT	CATSVRGCRWVAYNSPLHF	TRBV24-1	TRBJ1-6
TGTGCCAGCAGTTACTCGAGTAGGCGGGAGGAGGGAACAGAGAATCAGCCCCAGCATTTT	CASSYSSRREEGTENQPQHF	TRBV6-5	TRBJ1-5
TGTGCCAGCAGCACCATAAGGTGGACAGATACGCAGTATTTT	CASSTIRWTDTQYF	TRBV7-9	TRBJ2-3
TGTGCCAGCAGCTTCAAGCCGGGACAGGGTGAAAAACTGTTTTTT	CASSFKPGQGEKLFF	TRBV7-7	TRBJ1-4
TGTGCCAGCAGTCTTGGGGCCGAAAAACTGTTTTTT	CASSLGAEKLFF	TRBV27	TRBJ1-4
TGTGCCAGCAGCGGAGAGACAGATACGCAGTATTTT	CASSGETDTQYF	TRBV5-6	TRBJ2-3
TGCAGCGTTGCCCCGGGGATAGAAAAACTGTTTTTT	CSVAPGIEKLFF	TRBV29-1	TRBJ1-4
TGCGCCAGCAGCCAAGATGGTCGTAGGCCCTACGAGCAGTACTTC	CASSQDGRRPYEQYF	TRBV4-1	TRBJ2-7
TGTGCCAGCAGTTTTGGGGGGCCTTTAGACAATGAGCAGTTCTTC	CASSFGGPLDNEQFF	TRBV28	TRBJ2-1
TGTGCCAGCACCGGGACAGGGATGGAGCCCCAGCATTTT	CASTGTGMEPQHF	TRBV6-2	TRBJ1-5
TGTGCCAGCAGCGCGCTATGTTCCATCTTAGGCTACAATGAGCAGTTCTTC	CASSALCSILGYNEQFF	TRBV13	TRBJ2-1
TGTGCCAGCGTCTATGGAACTAACTCTGGAAACACCATATATTTT	CASVYGTNSGNTIYF	TRBV6-2	TRBJ1-3
TGTGCCAGCAGAAAAGACACTGAAGCTTTCTTT	CASRKDTEAFF	TRBV7-9	TRBJ1-1
TGTGCCAGCAGCTTAGACTCAGAAGCGGGAGAGGTTGCCAAAAACATTCAGTACTTC	CASSLDSEAGEVAKNIQYF	TRBV11-3	TRBJ2-4
TGTGCCAGCAGCGCAGGGGTATGGCGGAGCTACGAGCAGTACTTC	CASSAGVWRSYEQYF	TRBV9	TRBJ2-7
TGTGCCAGCAGCGAGGGACAGGGGAATTATGGCTACACCTTC	CASSEGQGNYGYTF	TRBV7-3	TRBJ1-2
TGTGCCAGCAGCTGCCCGCAGAGGACAGGGGTCTCCTCCTATAATTCACCCCTCCACTTT	CASSCPQRTGVSSYNSPLHF	TRBV5-4	TRBJ1-6
TGTGCCAGCAGTTATTACCAAAGGAGAGGAAGTGGGGCCAACGTCCTGACTTTC	CASSYYQRRGSGANVLTF	TRBV12-3	TRBJ2-6
TGTGCCGCTAACCTAGGGGGGGGTGGATTCGCCGATACGCAGTATTTT	CAANLGGGGFADTQYF	TRBV30	TRBJ2-3
TGCGCCAGCAGGAGGGGAGGCTCACCCCTCCACTTT	CASRRGGSPLHF	TRBV10-1	TRBJ1-6
TGTGCCAGCAGTCCACAGGGCGGGACTAACTATGGCTACACCTTC	CASSPQGGTNYGYTF	TRBV6-5	TRBJ1-2
TGCGCCAGCAGTGAGCAGGCAGATACGCAGTATTTT	CASSEQADTQYF	TRBV10-1	TRBJ2-3
TGTGCTAGTGGTTTTTTTTCGAGTCGACTAGGAACAGATACGCAGTATTTT	CASGFFSSRLGTDTQYF	TRBV12-5	TRBJ2-3
TGTGCCACTAGCGGGGGGATGGACGGAGTTAGGGGACGAGTAGAGACCCAGTACTTC	CATSGGMDGVRGRVETQYF	TRBV7-9	TRBJ2-5
TGTGCCAGCAAACGACTAGCGGGGGCAGAGACCCAGTACTTC	CASKRLAGAETQYF	TRBV6-1	TRBJ2-5
TGTGCCAGTAGTATCACCAGGGCCTCGGTGTACGAGCAGTACTTC	CASSITRASVYEQYF	TRBV19	TRBJ2-7
TGTTGGGTCAGGGGAGAAAAACTGTTTTTT	CWVRGEKLFF	TRBV19	TRBJ1-4
TGTGCCAGCAGTGACTCCCTAGCGCTTCCAGATACGCAGTATTTT	CASSDSLALPDTQYF	TRBV6-4	TRBJ2-3
TGTGCCTGGAGTGTGAAACCCCCCCTCGTTCATCACAGGAAAGCCTACGAGCAGTACTTC	CAWSVKPPLVHHRKAYEQYF	TRBV30	TRBJ2-7
TGTGCCACCAATAGAGGGGGGGCGAACGCCCGGGGGGGTAAGAGCACAGATACGCAGTATTTT	CATNRGGANARGGKSTDTQYF	TRBV24-1	TRBJ2-3
TGCGCCAGCAGTGAGACTAGCGGGGGGGCCAGGAACACCGGGGAGCTGTTTTTT	CASSETSGGARNTGELFF	TRBV10-1	TRBJ2-2
TGTGCTAGCAGCTTAGACCGCTTGGGAGGACAAGCCTACGAGCAGTACTTC	CASSLDRLGGQAYEQYF	TRBV7-7	TRBJ2-7
TGCGCCAGCACCCCAGGGTCTCAGCCGGATACGCAGTATTTT	CASTPGSQPDTQYF	TRBV5-1	TRBJ2-3
TGTGCCAGCAGTTTAGGTAGGCCGACAGGGGATATAAGGGAGCAGTACTTC	CASSLGRPTGDIREQYF	TRBV12-4	TRBJ2-7
TGTGCCAGCAGCCTCAGCGGGAGATCGCCCCTCTACAATGAGCAGTTCTTC	CASSLSGRSPLYNEQFF	TRBV7-6	TRBJ2-1
TGTGCCAGCAGCATCTTAGCCCAGTGGGATCAGCCCCAGCATTTT	CASSILAQWDQPQHF	TRBV7-6	TRBJ1-5
TGTGCCACCGGTGGCCGGGAGGAACCACCACATCAGCCCCAGCATTTT	CATGGREEPPHQPQHF	TRBV24-1	TRBJ1-5
TGTGCCAGCAGTTTTGGGGACAGGGGACGGGGATGGGGTGTAGACAATGAGCAGTTCTTC	CASSFGDRGRGWGVDNEQFF	TRBV6-3	TRBJ2-1
TGCGCCAGCGCCAGTGGGGCCAACGTCCTGACTTTC	CASASGANVLTF	TRBV5-1	TRBJ2-6
TGCAGTGCTAGCCTGGTGGGGGGCAGGAATGAGCAGTTCTTC	CSASLVGGRNEQFF	TRBV20-1	TRBJ2-1
TGTGCCAGCAGCAGTGTTAGCGGGAGTTCCTCTCAGCCCCAGCATTTT	CASSSVSGSSSQPQHF	TRBV5-4	TRBJ1-5
TGTGCCAGCAGCGACACGGGGGCGCCGAAGAACTATAATTCACCCCTCCACTTT	CASSDTGAPKNYNSPLHF	TRBV9	TRBJ1-6
TGTGCCAGCAGCCAATTACTAGCGGGAGTTTCCTACGAGCAGTACTTC	CASSQLLAGVSYEQYF	TRBV14	TRBJ2-7
TGTGCCAGCAGCCGGGGGGGCCAAGAGACCCAGTACTTC	CASSRGGQETQYF	TRBV3-1	TRBJ2-5
TGTGCCAGCTCCCAGCGTTACAATGAGCAGTTCTTC	CASSQRYNEQFF	TRBV18	TRBJ2-1
TGTGCCATCAGTGAGCAAAGGGCGGATGAAGCTTTCTTT	CAISEQRADEAFF	TRBV10-3	TRBJ1-1
TGCGCCAGCAGCCAAGACCCCATTTTTTCATGTGGCTACACCTTC	CASSQDPIFSCGYTF	TRBV4-3	TRBJ1-2
TGTGCCAGCAGTTTTAGGCGGGAGAGCCAAGAGACCCAGTACTTC	CASSFRRESQETQYF	TRBV6-1	TRBJ2-5
TGTGCTAGTGGAGAACGGTATGGCTACACCTTC	CASGERYGYTF	TRBV12-5	TRBJ1-2
TGTGCCAGCAGCGGAAGTTTAGGGAACACTGAAGCTTTCTTT	CASSGSLGNTEAFF	TRBV9	TRBJ1-1
TGTGCCTGCATAGGCACCTCATTGCAGGAGACCCAGTACTTC	CACIGTSLQETQYF	TRBV30	TRBJ2-5
TGTGCCCGGGGGGGGGTGCAAATAGATACGCAGTATTTT	CARGGVQIDTQYF	TRBV9	TRBJ2-3
TGTGCCAGCAGCGGACTAGCGGGGGGGCCCGAACGGGAGGTCCTCTCCTACAATGAGCAGTTCTTC	CASSGLAGGPEREVLSYNEQFF	TRBV9	TRBJ2-1
TGTGCCAGCAGCCAAGACCATAACGTCGGGACAGGGGGGCCAAACACTGAAGCTTTCTTT	CASSQDHNVGTGGPNTEAFF	TRBV14	TRBJ1-1
TGTGCCAGCAGCTATCGGGATCGGGGGCCAGCTTTCTTT	CASSYRDRGPAFF	TRBV5-4	TRBJ1-1
TGTGCCAGCAGTTTAGACAAAGGCAGGGGGCTCCCCAATCAGCCCCAGCATTTT	CASSLDKGRGLPNQPQHF	TRBV27	TRBJ1-5
TGTGCCTGGACTCTCTACGAGCAGTACTTC	CAWTLYEQYF	TRBV30	TRBJ2-7
TGCAGTGCTCAGGACGACAGCTCCTACGAGCAGTACTTC	CSAQDDSSYEQYF	TRBV20-1	TRBJ2-7
TGTGCCAGGCCGGCCCAGGGGGGGCGGGACAATGAGCAGTTCTTC	CARPAQGGRDNEQFF	TRBV27	TRBJ2-1
TGCGCCAGCAGTGGCCCGGGGGGGTCCCAGCATTTT	CASSGPGGSQHF	TRBV10-1	TRBJ1-5
TGTGCCAGCGTTAGGGGGGGACGGGAATACGAGCAGTACTTC	CASVRGGREYEQYF	TRBV9	TRBJ2-7
TGTGCCAGCAGCTTAGATCTTTGGGACAAAAACACCTTC	CASSLDLWDKNTF	TRBV11-2	TRBJ1-2
TGCGCCAGCAGGTCACAAGAGGCAGGAAGGACGAACGAGCAGTACTTC	CASRSQEAGRTNEQYF	TRBV4-1	TRBJ2-7
TGCGCCAGCAGCCAAGATGGGACTAGCGGCTTTGAGACCCAGTACTTC	CASSQDGTSGFETQYF	TRBV4-1	TRBJ2-5
TGTGCCATGCTTCCCCCTAGAATTCATGAGCAGTTCTTC	CAMLPPRIHEQFF	TRBV10-3	TRBJ2-1
TGTGCCAGCAGCTTAGTTGGGGTGTTTAGCAATCAGCCCCAGCATTTT	CASSLVGVFSNQPQHF	TRBV11-3	TRBJ1-5
TGTGCCACCAGCATTAGGGAAAGTGGAAACACCATATATTTT	CATSIRESGNTIYF	TRBV15	TRBJ1-3
TGCGCCAGCGGGACAGCGGCTTTCTTT	CASGTAAFF	TRBV10-1	TRBJ1-1
TGTGCCAGCAGCTTGGGGGCAATGGCACTTTCCCCGGGACCCTACGAGCAGTACTTC	CASSLGAMALSPGPYEQYF	TRBV5-4	TRBJ2-7
TGTGCCAGCAGCTTAATACAGGGGTATGAAAAACTGTTTTTT	CASSLIQGYEKLFF	TRBV11-2	TRBJ1-4
TGTGCCACGGGGGGGGGCTACGAGCAGTACTTC	CATGGGYEQYF	TRBV24-1	TRBJ2-7
TGTGCTAGGTTAGCGGGAACGACAAGATGGACCACAGATACGCAGTATTTT	CARLAGTTRWTTDTQYF	TRBV12-5	TRBJ2-3
TGCGCCAGCAGACCTGGGAGGGTGAACTCCTACGAGCAGTACTTC	CASRPGRVNSYEQYF	TRBV10-1	TRBJ2-7
TGCAGTGCTAGCGGACTAGCGGGCGAGCAGTACTTC	CSASGLAGEQYF	TRBV20-1	TRBJ2-7
TGTGCTAGTGGCACCCGCGGGAGCCCGGCCAATCAGCCCCAGCATTTT	CASGTRGSPANQPQHF	TRBV12-5	TRBJ1-5
TGTGCCATCAGGGGCTATGGCTACACCTTC	CAIRGYGYTF	TRBV10-3	TRBJ1-2
TGCAGCGTTGGACAGTTTGGGAGGGCCGACGCCGGTCACAATGAGCAGTTCTTC	CSVGQFGRADAGHNEQFF	TRBV29-1	TRBJ2-1
TGTGCCAGCGACCCTACTAGCGGGAGAGGAGGCACAGATACGCAGTATTTT	CASDPTSGRGGTDTQYF	TRBV6-4	TRBJ2-3
TGTGCCAGCAGGGGACTAGCGGGCTACGAGCAGTACTTC	CASRGLAGYEQYF	TRBV7-2	TRBJ2-7
TGTGCCAGCAGTTTCAGGACACCTAACTCTGGGGCCAACGTCCTGACTTTC	CASSFRTPNSGANVLTF	TRBV6-5	TRBJ2-6
TGTGCCAGCAGTTTGCGGGCCGGGACAGGGGCGCACTATGGCTACACCTTC	CASSLRAGTGAHYGYTF	TRBV6-2	TRBJ1-2
TGTGCCAGTAGTGTCGCTAGACGCTCCTACGAGCAGTACTTC	CASSVARRSYEQYF	TRBV19	TRBJ2-7
TGTGCCAGCAGTTTTTTTGCGGTCTCAGGGGGCGTCTCTGGAAACACCATATATTTT	CASSFFAVSGGVSGNTIYF	TRBV27	TRBJ1-3
TGTGCCAGCAGCTTAGCCCGGTCCCCCTTAAGGGGGGCCTACGAGCAGTACTTC	CASSLARSPLRGAYEQYF	TRBV7-2	TRBJ2-7
TGTGCCAGCAGCCCCGGACGCACAGATACGCAGTATTTT	CASSPGRTDTQYF	TRBV7-4	TRBJ2-3
TGTGCCAGCATGCACAGGGGTGCCACAGATACGCAGTATTTT	CASMHRGATDTQYF	TRBV9	TRBJ2-3
TGCAGTGCTAGACCCACAGGGAAGTCCTACGAGCAGTACTTC	CSARPTGKSYEQYF	TRBV20-1	TRBJ2-7
TGTGCCAGCAGCAAAAACCCTTTTAATCTCACCGGGGACAGGGGCGGGGAGCTGTTTTTT	CASSKNPFNLTGDRGGELFF	TRBV13	TRBJ2-2
TGTGCCAGCAGCTCCGGGGGGGATAGCAATCAGCCCCAGCATTTT	CASSSGGDSNQPQHF	TRBV6-1	TRBJ1-5
TGTGCCAGCAGCTTGGATGGGGAGGGGGCCGCATATACGCAGTATTTT	CASSLDGEGAAYTQYF	TRBV5-8	TRBJ2-3
TGTGCCAGCAGCTCGGGGCGGGACAGATATAGCAATCAGCCCCAGCATTTT	CASSSGRDRYSNQPQHF	TRBV11-3	TRBJ1-5
TGTGCCAGCAGCCCTGTCACCCGACAGGGGCCGAGCTCCTACGAGCAGTACTTC	CASSPVTRQGPSSYEQYF	TRBV5-6	TRBJ2-7
TGTGCCAGCAGCCAAGAAAGCCGGGACAGGGAGGGGATGAAGACCCAGTACTTC	CASSQESRDREGMKTQYF	TRBV3-1	TRBJ2-5
TGTGCCAGCCAATGTCCTGGGGAGGACAGGGCCCAAAGGCAATCGGGGGAGCTTTGGGAAAAACTGTTTTTT	CASQCPGEDRAQRQSGELWEKLFF	TRBV5-4	TRBJ1-4
TGTGCCAGCAGTTGTGGGACTAGCGGGGTTAGGGACGAGCAGTACTTC	CASSCGTSGVRDEQYF	TRBV12-4	TRBJ2-7
TGCGCCAGCAGCTTGGGACGAGATGGGAAGCATGAGCAGTTCTTC	CASSLGRDGKHEQFF	TRBV5-1	TRBJ2-1
TGCGCCAGCAGCTTGTCGGGGGGCGAATTCTACAATGAGCAGTTCTTC	CASSLSGGEFYNEQFF	TRBV5-1	TRBJ2-1
TGTGCCAGCAGCTTGGGTGAACCCACAGATACGCAGTATTTT	CASSLGEPTDTQYF	TRBV5-4	TRBJ2-3
TGTGCCAGACAGGGGGAGCCCTTGAACACTGAAGCTTTCTTT	CARQGEPLNTEAFF	TRBV12-4	TRBJ1-1
TGTGCCTGGAGTGAAATTCGTTTGAGGGTTGGATATCAGCCCCAGCATTTT	CAWSEIRLRVGYQPQHF	TRBV30	TRBJ1-5
TGTGCCAGCAGTTACAAGGGGGACAGGGGCGGCTACACCTTC	CASSYKGDRGGYTF	TRBV6-5	TRBJ1-2
TGTGCCAGCAGCTACCAGCCGGGCAATCAGCCCCAGCATTTT	CASSYQPGNQPQHF	TRBV7-3	TRBJ1-5
TGCGCCAGCAGCCAAGATATCATTCCAGGGGTGAACACTGAAGCTTTCTTT	CASSQDIIPGVNTEAFF	TRBV4-1	TRBJ1-1
TGTGCCAGCAGTGAGGACATCTCGAACACCGGGGAGCTGTTTTTT	CASSEDISNTGELFF	TRBV2	TRBJ2-2
TGTGCCATCAGTGAGAGCCTGACAGGGGGCGCGGACCCTAATCAGCCCCAGCATTTT	CAISESLTGGADPNQPQHF	TRBV10-3	TRBJ1-5
TGTGCCCCCAGGGGACTCTCTGGAAACACCATATATTTT	CAPRGLSGNTIYF	TRBV10-3	TRBJ1-3
TGTGCCAGCAGTGTACAGGGGGAGTATAGCAATCAGCCCCAGCATTTT	CASSVQGEYSNQPQHF	TRBV12-4	TRBJ1-5
TGTGCCAGCGGACCGCGCGAGCAGTACTTC	CASGPREQYF	TRBV19	TRBJ2-7
TGTGCCAGTAAGAGGGAGGAGGGCCAGCAGTACTTC	CASKREEGQQYF	TRBV6-6	TRBJ2-7
TGTGCCAGCAGTTACACAGCGTACGGCTCTGGGGCCAACGTCCTGACTTTC	CASSYTAYGSGANVLTF	TRBV6-5	TRBJ2-6
TGTGCCAGCAGTATTTGGGACAGGGCGCCGGGAGACACCGGGGAGCTGTTTTTT	CASSIWDRAPGDTGELFF	TRBV6-1	TRBJ2-2
TGTGCCAGCAGCAAGGGGCGCACGGGACAGGGGGGAAAAGAGACCCAGTACTTC	CASSKGRTGQGGKETQYF	TRBV13	TRBJ2-5
TGTGCCAGCGGGACCTCGAACACCGGGGAGCTGTTTTTT	CASGTSNTGELFF	TRBV27	TRBJ2-2
TGTGCCAGCAGCCTTGTCCAGGGTTGGGAACTTACCCAGCCCCAGCATTTT	CASSLVQGWELTQPQHF	TRBV7-3	TRBJ1-5
TGTGCCAGCAGCCAAGTTCCGACGAATGAATCTCAGCCCCAGCATTTT	CASSQVPTNESQPQHF	TRBV3-1	TRBJ1-5
TGTGCCAGCAGCCCGTACGGGAAAGATCAGCCCCAGCATTTT	CASSPYGKDQPQHF	TRBV7-4	TRBJ1-5
TGTGCCAGTAGTTACGAAAAACTGTTTTTT	CASSYEKLFF	TRBV19	TRBJ1-4
TGTGCCAGCAGCTCCGGCGGGAGAGTAAACACCGGGGAGCTGTTTTTT	CASSSGGRVNTGELFF	TRBV7-9	TRBJ2-2
TGTGCCAGCAGTTACCTTTGGTGCCACAGGGACGCTGAAGCTTTCTTT	CASSYLWCHRDAEAFF	TRBV6-5	TRBJ1-1
TGTGCCAGCAGCATCGGGAGCGGACGCAACTATGGCTACACCTTC	CASSIGSGRNYGYTF	TRBV9	TRBJ1-2
TGCGCCAGCAGTGTCCCCAGTGGCTCAAAGGAAAAACTGTTTTTT	CASSVPSGSKEKLFF	TRBV10-1	TRBJ1-4
TGTGCCAGCAGTTTGACCTACGAGCAGTACTTC	CASSLTYEQYF	TRBV6-5	TRBJ2-7
TGTGCCAGCAGTGAAGATGGACTAGCGGTGTCCTACAATGAGCAGTTCTTC	CASSEDGLAVSYNEQFF	TRBV6-1	TRBJ2-1
TGTGCCAGCAGCCATGGGGGACATAACTATGGCTACACCTTC	CASSHGGHNYGYTF	TRBV13	TRBJ1-2
TGTGCCAGCAGCTTAGAAAACCCCGGGGGGGGGAAGACCCAGTACTTC	CASSLENPGGGKTQYF	TRBV7-9	TRBJ2-5
TGTGCCAGCAGTGACAGGGACAGGGGGAACAATGAGCAGTTCTTC	CASSDRDRGNNEQFF	TRBV6-4	TRBJ2-1
TGCGCCAGCACGTGGACTATAGCCGAAGAGACCCAGTACTTC	CASTWTIAEETQYF	TRBV5-1	TRBJ2-5
TGTGCCAGCAGCTGCACGCCCATATTAAACGAGCAGTACTTC	CASSCTPILNEQYF	TRBV7-6	TRBJ2-7
TGCGCCAGCAGCCAATGGGACAGCAACGGGAATTCACCCCTCCACTTT	CASSQWDSNGNSPLHF	TRBV4-3	TRBJ1-6
TGTGCCAGCAGCTTAGTGGGGTCCAAGAATAGGGGGTACGGCTACACCTTC	CASSLVGSKNRGYGYTF	TRBV7-8	TRBJ1-2
TGTGCCAGCAGCTTAGCGCGCAACCCCCGGGACGGGAACTATAGCAATCAGCCCCAGCATTTT	CASSLARNPRDGNYSNQPQHF	TRBV7-7	TRBJ1-5
TGTGCCACCAGTGGGCATGGTGGGGCCTTTCCCACAGATACGCAGTATTTT	CATSGHGGAFPTDTQYF	TRBV24-1	TRBJ2-3
TGTGCCCGTCCAATAGGGGTAGGGGGGACGGTAATGAACACTGAAGCTTTCTTT	CARPIGVGGTVMNTEAFF	TRBV7-2	TRBJ1-1
TGTGCCAGCAGTCTCGAGGTTAGATTTGGCGTGGGCACAGATACGCAGTATTTT	CASSLEVRFGVGTDTQYF	TRBV27	TRBJ2-3
TGCATCAAAAAGGGTGAGCAGTACTTC	CIKKGEQYF	TRBV20-1	TRBJ2-7
TGTGCCAGCAGAAAGGAGGGGAGTATTTGCACAGATACGCAGTATTTT	CASRKEGSICTDTQYF	TRBV2	TRBJ2-3
TGTGCCAGCAGCAGGCGGGCAGGCATCACCATATATTTT	CASSRRAGITIYF	TRBV13	TRBJ1-3
TGTGCCAGCAGCGATTCCTGGACCGGCTCACCCATGCCGTCTAACTATGGCTACACCTTC	CASSDSWTGSPMPSNYGYTF	TRBV13	TRBJ1-2
TGCGCCAGCAGATCCGTGCCGGGACAGGGGCGAACGACCGGGGAGCTGTTTTTT	CASRSVPGQGRTTGELFF	TRBV4-1	TRBJ2-2
TGTGCCAGTAGTATAGGCCCGGGACTAGCGGGGCTCTACGAGCAGTACTTC	CASSIGPGLAGLYEQYF	TRBV19	TRBJ2-7
TGTGCCCCTGGGACAGTAGAGACCCAGTACTTC	CAPGTVETQYF	TRBV28	TRBJ2-5
TGTGCCAGCAGTGAGTGGAACTCAGGGAAAGAGACCCAGTACTTC	CASSEWNSGKETQYF	TRBV6-4	TRBJ2-5
TGTGCCAGCAGCCACCCACAGTTTGGGTCCGTAAGCAATCAGCCCCAGCATTTT	CASSHPQFGSVSNQPQHF	TRBV14	TRBJ1-5
TGCGCCAGCAGCTTGAGGTCTGGGAAGCATTTT	CASSLRSGKHF	TRBV5-1	TRBJ1-5
TGTGCCAGCAGTTATCTGTGTCCCCCGCCGAATTCACCCCTCCACTTT	CASSYLCPPPNSPLHF	TRBV11-2	TRBJ1-6
TGTGCTAGGGCCCTCGGTTGGACAGGGATGAACACTGAAGCTTTCTTT	CARALGWTGMNTEAFF	TRBV12-5	TRBJ1-1
TGTGCCAGCAGTTACTCGAAAGTTTGTGGGGGACTAGCGGGGGGGCTGTTCGCGTCTGGGGCCAACGTCCTGACTTTC	CASSYSKVCGGLAGGLFASGANVLTF	TRBV6-6	TRBJ2-6
TGTGCCAGCAGCCCTCTACTAGCTCTGGGAAACGAGCAGTACTTC	CASSPLLALGNEQYF	TRBV7-2	TRBJ2-7
TGTGCCAGCAGCCTAAGTGACGAGCAGTACTTC	CASSLSDEQYF	TRBV13	TRBJ2-7
TGTGCCCTCCCTACCTACGAGCAGTACTTC	CALPTYEQYF	TRBV6-1	TRBJ2-7
TGTGCCAGCAGGTTAGGCTATGGCTACACCTTC	CASRLGYGYTF	TRBV6-6	TRBJ1-2
TGTGCCCCTGACAGGCGTAAGAAGTCTGGCACAGATACGCAGTATTTT	CAPDRRKKSGTDTQYF	TRBV7-9	TRBJ2-3
TGTGCCAGCCAGGGACCCAGTAGCAATCAGCCCCAGCATTTT	CASQGPSSNQPQHF	TRBV2	TRBJ1-5
TGTGCCAGCAGCACCAGACTGAGGGCCTACGAGCAGTACTTC	CASSTRLRAYEQYF	TRBV7-9	TRBJ2-7
TGTGCCAGCAGGCAAAACTATGGCTACACCTTC	CASRQNYGYTF	TRBV6-4	TRBJ1-2
TGTGCCAGCAGCACCCCCTTAGCGGACCAAGAGACCCAGTACTTC	CASSTPLADQETQYF	TRBV5-5	TRBJ2-5
TGTGCTGGGCTAGCGGGGGGACCCGTATGCTCCTACAATGAGCAGTTCTTC	CAGLAGGPVCSYNEQFF	TRBV7-7	TRBJ2-1
TGTGCCACCAGTGCTGAGACTAGCGGGGACTTACTCTACGAGCAGTACTTC	CATSAETSGDLLYEQYF	TRBV24-1	TRBJ2-7
TGTGCCAGCAGCGCGCAGAAACGCTCCTACGAGCAGTACTTC	CASSAQKRSYEQYF	TRBV13	TRBJ2-7
TGTGCCAGCAGTAACAGGACTAGCGGGTGGGGCTACGAGCAGTACTTC	CASSNRTSGWGYEQYF	TRBV6-5	TRBJ2-7
TGTGCCAGCAGTTTTGGACTCGGTGAAGCTTTCTTT	CASSFGLGEAFF	TRBV27	TRBJ1-1
TGTGCCAGCAGCTTATACAGTAACCCGAACACTGAAGCTTTCTTT	CASSLYSNPNTEAFF	TRBV7-8	TRBJ1-1
TGTGCCAGCAGTTCGCAGGGAGGGAACACCGGGGAGCTGTTTTTT	CASSSQGGNTGELFF	TRBV27	TRBJ2-2
TGTGCCAGCAGCTTAGTCCGGACAGGGTCCTACGAGCAGTACTTC	CASSLVRTGSYEQYF	TRBV7-6	TRBJ2-7
TGTGCCACCCCCAGGGGAACCGGTAATGAAAAACTGTTTTTT	CATPRGTGNEKLFF	TRBV6-6	TRBJ1-4
TGCGCCAGCAGCTTGGTGGAGAGGGCGCAGGAGTATTTT	CASSLVERAQEYF	TRBV5-1	TRBJ1-3
TGTGCCAGCAGCCCGTCTTGGCCAGGCAGGGTAGGCTACGAGCAGTACTTC	CASSPSWPGRVGYEQYF	TRBV28	TRBJ2-7
TGTGCCAGCAGTTTTGAGGAGTGCCAGCCCCAGCATTTT	CASSFEECQPQHF	TRBV27	TRBJ1-5
TGTGCCAGCAGCCGGACAGAAAGCAATCAGCCCCAGCATTTT	CASSRTESNQPQHF	TRBV9	TRBJ1-5
TGTGCCCCGGGGGGCTTTCCCTCGGGCTACGAGCAGTACTTC	CAPGGFPSGYEQYF	TRBV2	TRBJ2-7
TGTGCCAGCAGCCCTCGGGGGGGGCGCTACGAGCAGTACTTC	CASSPRGGRYEQYF	TRBV27	TRBJ2-7
TGCGCCAGCAGTGAGGTCACAGGGAACTATGGCTACACCTTC	CASSEVTGNYGYTF	TRBV10-1	TRBJ1-2
TGTGCCAGCAGCGGCCCTCCGAAAACCCGCGGGAGCCTCACTGAAGCTTTCTTT	CASSGPPKTRGSLTEAFF	TRBV13	TRBJ1-1
TGCGCCAGCGTCGGGAGACCGGGTGCAACTAATGAAAAACTGTTTTTT	CASVGRPGATNEKLFF	TRBV5-1	TRBJ1-4
TGTGCCAGCAGTTTCTGGCTCTATGAGCAGTTCTTC	CASSFWLYEQFF	TRBV28	TRBJ2-1
TGTGCCAGCAGTTTGAGGTGCAGGGGGCAAACAGATACGCAGTATTTT	CASSLRCRGQTDTQYF	TRBV12-4	TRBJ2-3
TGTGCCAGCAGTTCCGCGGGGCGCCTCGTTCTTATGACCTATGGCTACACCTTC	CASSSAGRLVLMTYGYTF	TRBV12-4	TRBJ1-2
TGTGCCAGCAGCTCCGTTGGAGCGGGCGGGATAGCCCCCAAGTATGGCTACACCTTC	CASSSVGAGGIAPKYGYTF	TRBV5-6	TRBJ1-2
TGTGCCAGTAGGGGGGTGGGGGGGGGGGGGACAAATGAGCAGTTCTTC	CASRGVGGGGTNEQFF	TRBV19	TRBJ2-1
TGTGCCACCAGTGATTTCTGGGGGTTGCAAGAGACCCAGTACTTC	CATSDFWGLQETQYF	TRBV24-1	TRBJ2-5
TGTGCCAGCAGTTACTCGAGAACCGGATATTCTGGAAACACCATATATTTT	CASSYSRTGYSGNTIYF	TRBV6-8	TRBJ1-3
TGCGCCAGCAAGCCACCGTCCTACAATGAGCAGTTCTTC	CASKPPSYNEQFF	TRBV5-1	TRBJ2-1
TGTGCCAGCAGCTTAGAGCGGGACTACGAGCAGTACTTC	CASSLERDYEQYF	TRBV5-4	TRBJ2-7
TGTGCCAGCAGCCTCTGTAGGGGCTCTGGAAACACCATATATTTT	CASSLCRGSGNTIYF	TRBV7-3	TRBJ1-3
TGTGCCAGCAGTTATATTACAGGGTCCGTATTACCTGAAAAACTGTTTTTT	CASSYITGSVLPEKLFF	TRBV6-6	TRBJ1-4
TGTGCCAGCAGTGTGGGGGGGGACCCGGAGACCCAGTACTTC	CASSVGGDPETQYF	TRBV6-3	TRBJ2-5
TGTGCCAGCATCCTAAGGAACACCGGGGAGCTGTTTTTT	CASILRNTGELFF	TRBV6-4	TRBJ2-2
TGTGCCAGCAGCTGCCGGGACATAGATCAGCCCCAGCATTTT	CASSCRDIDQPQHF	TRBV6-4	TRBJ1-5
TGTGCCAGCAGTTACCCTTCCCGGGACAGGGTACCGAGGGCGCAAGAGACCCAGTACTTC	CASSYPSRDRVPRAQETQYF	TRBV6-9	TRBJ2-5
TGTGCCAGCAGCCTTGCGGAGGTCGAGCAGTTCTTC	CASSLAEVEQFF	TRBV9	TRBJ2-1
TGTGCCAGCTCACAAGATCGTCTTGGAATTGAGACCCAGTACTTC	CASSQDRLGIETQYF	TRBV18	TRBJ2-5
TGCGCCAGCAGCGGACGGGGCGCTTGGGGATCACCCCTCCACTTT	CASSGRGAWGSPLHF	TRBV5-1	TRBJ1-6
TGTGCCATCAGTGCCCTAGCGGGGACAATCTTC	CAISALAGTIF	TRBV10-3	TRBJ2-1
TGTGCCAGCAGCTTATCCTCTCGGGACAGGGGAGGACCGAGGACTAATGAAAAACTGTTTTTT	CASSLSSRDRGGPRTNEKLFF	TRBV5-5	TRBJ1-4
TGTGCCAGCTCACCACGAGGGGGGGAACCCTACAATGAGCAGTTCTTC	CASSPRGGEPYNEQFF	TRBV18	TRBJ2-1
TGCAGTGCTGAGGGAGAGACCCAGTACTTC	CSAEGETQYF	TRBV20-1	TRBJ2-5
TGTGCCAGCAGTGACTCGGCTAGCGGGGGCCGAGGGATAGGCACAGATACGCAGTATTTT	CASSDSASGGRGIGTDTQYF	TRBV6-4	TRBJ2-3
TGTGCTAGTGGTTTCCAGGGCGGCGAGGGAGATACGCAGTATTTT	CASGFQGGEGDTQYF	TRBV12-5	TRBJ2-3
TGTGCCAGCAGCGGCGGTGCCAGCTCCTACAATGAGCAGTTCTTC	CASSGGASSYNEQFF	TRBV6-1	TRBJ2-1
TGCGCCAGCAGCCACCGGGGCGAGGGACAGGGATTGAAAGCTAACTATGGCTACACCTTC	CASSHRGEGQGLKANYGYTF	TRBV4-3	TRBJ1-2
TGTGCCAGCATAATACCAAAGGAGCCGCCAACCTACGAGCAGTACTTC	CASIIPKEPPTYEQYF	TRBV6-2	TRBJ2-7
TGCGCCAGCAGCTCTCCCTGGCAGGGTCCCACAGATACGCAGTATTTT	CASSSPWQGPTDTQYF	TRBV5-1	TRBJ2-3
TGTGCCAGCAGCTTGGGGTTGACAGGGGTGCTGCCAGGCTCCTACGAGCAGTACTTC	CASSLGLTGVLPGSYEQYF	TRBV5-4	TRBJ2-7
TGTGCTAGTGGTTTGGAAATCCCTCAGCCCCAGCATTTT	CASGLEIPQPQHF	TRBV12-5	TRBJ1-5
TGCGCCAGCAGCTTGGGTAGAACGGAGACCTGCGGTCGAAGCAATCAGCCCCAGCATTTT	CASSLGRTETCGRSNQPQHF	TRBV5-1	TRBJ1-5
TGTGCCAGCAGCGACCCCCCTAGCGGGGGAATTCCCTCCTACAATGAGCAGTTCTTC	CASSDPPSGGIPSYNEQFF	TRBV7-3	TRBJ2-1
TGTGCCCTAAGGTCTTATAGCAATCAGCCCCAGCATTTT	CALRSYSNQPQHF	TRBV6-4	TRBJ1-5
TGTGCCAGCAGTTTATGGACAGGGATGGGGTATAATTCACCCCTCCACTTT	CASSLWTGMGYNSPLHF	TRBV28	TRBJ1-6
TGTGCCGGGACGGACAGGGGGCATAGCAATCAGCCCCAGCATTTT	CAGTDRGHSNQPQHF	TRBV19	TRBJ1-5
TGTGCCACCAGCAGGTTTACGAACTCACGAGGTCCCAACACTGAAGCTTTCTTT	CATSRFTNSRGPNTEAFF	TRBV15	TRBJ1-1
TGTGCCAGTAGTATGTCTATCGTCAGGGGCAACTCCTACGAGCAGTACTTC	CASSMSIVRGNSYEQYF	TRBV19	TRBJ2-7
TGTGCCAGCAGCCAAGATATCGGACTGACGGCCGGCGCTGGAAACACCATATATTTT	CASSQDIGLTAGAGNTIYF	TRBV4-2	TRBJ1-3
TGCGCCAGCAGCCGGGACAGCATCAGCTCTGGAAACACCATATATTTT	CASSRDSISSGNTIYF	TRBV10-1	TRBJ1-3
TGTGCCAGCAGCTGGGAATCGGGACTAGCGAAGGACTACGAGCAGTACTTC	CASSWESGLAKDYEQYF	TRBV5-4	TRBJ2-7
TGTGCCAGCAGTCCGGGGCCTCGGAACAGGGTCGGGACCTATGGCTACACCTTC	CASSPGPRNRVGTYGYTF	TRBV6-4	TRBJ1-2
TGCAGTGCTTATTACGCCTGGACAGGGGAGAAATATGGCTACACCTTC	CSAYYAWTGEKYGYTF	TRBV20-1	TRBJ1-2
TGCAGTGCCGCGGGAGCGTCCCGGCTCTGTTACGAGCAGTACTTC	CSAAGASRLCYEQYF	TRBV20-1	TRBJ2-7
TGTGCCAGCAGCCAAGATACGAGGACTAGCGGGGAGTATCTCCCAGATACGCAGTATTTT	CASSQDTRTSGEYLPDTQYF	TRBV3-1	TRBJ2-3
TGCGCCAGCAGCTCAGGACAGGAGAACACCGGGGAGCTGTTTTTT	CASSSGQENTGELFF	TRBV5-1	TRBJ2-2
TGTGCCAGCAGTTTAGGTGAGGGAGTCGCTAACACTGAAGCTTTCTTT	CASSLGEGVANTEAFF	TRBV12-4	TRBJ1-1
TGCAGTGCACCCGGGACAGGGGATCAGCCCCAGCATTTT	CSAPGTGDQPQHF	TRBV20-1	TRBJ1-5
TGTGCCAGCAGCGTAGGAGAGGGGGGCCCTACTGGCACAGATACGCAGTATTTT	CASSVGEGGPTGTDTQYF	TRBV9	TRBJ2-3
TGTGCCAGCAGCTTCCAGTTAGCGAGGGCACCCCTCCACTTT	CASSFQLARAPLHF	TRBV5-6	TRBJ1-6
TGTGCCAGCAGCCAGGCCGGGCTAGCGGTAGGCACAGATACGCAGTATTTT	CASSQAGLAVGTDTQYF	TRBV14	TRBJ2-3
TGTGCCAGCAGCCTCCCCGGTAAATATTCCACCGCCTACGAGCAGTACTTC	CASSLPGKYSTAYEQYF	TRBV7-3	TRBJ2-7
TGCAGCGTTGAAAGGGTAGGGCTCTACGAGCAGTACTTC	CSVERVGLYEQYF	TRBV29-1	TRBJ2-7
TGTGCCAGCAGCGTCAGGGCCACGTGCCCTAACTATGGCTACACCTTC	CASSVRATCPNYGYTF	TRBV9	TRBJ1-2
TGTGCCAGCACCCCAACACAGGGGGATAACACCGGGGAGCTGTTTTTT	CASTPTQGDNTGELFF	TRBV7-2	TRBJ2-2
TGCGCCAGCCCAAGTTCCGCGGGAGCGCAGTACTTC	CASPSSAGAQYF	TRBV5-1	TRBJ2-7
TGTGCCAGCAGCTTACTTAGGTACGGAGGACGGGGCGGGGAGCTGTTTTTT	CASSLLRYGGRGGELFF	TRBV11-2	TRBJ2-2
TGTGCCAGCAGTGAATGGGATAACACTAGCGGGAGCTGTAGAGAGACCCAGTACTTC	CASSEWDNTSGSCRETQYF	TRBV6-1	TRBJ2-5
TGTGCCAGCAGCTTAGCCGAGGAGGAACGCACAGATACGCAGTATTTT	CASSLAEEERTDTQYF	TRBV11-3	TRBJ2-3
TGTGCCAGCAGCGCTGGTATGGGATACGAGCAGTACTTC	CASSAGMGYEQYF	TRBV13	TRBJ2-7
TGTGCCAGCAGTGAAGTTGAAGGGACAGATCTCGGGGTCACGATGGGGAACACTGAAGCTTTCTTT	CASSEVEGTDLGVTMGNTEAFF	TRBV6-1	TRBJ1-1
TGTGCCAGCAGCGTCACGCCCTATGGGGGCGAGCAGTACTTC	CASSVTPYGGEQYF	TRBV9	TRBJ2-7
TGTGCCTCCTTAGGGAACTCCTACGAGCAGTACTTC	CASLGNSYEQYF	TRBV6-5	TRBJ2-7
TGCAGTGCTAGACAAGGGAGGGTCTCTGGGGCCAACGTCCTGACTTTC	CSARQGRVSGANVLTF	TRBV20-1	TRBJ2-6
TGTGCCAGCAGTTTATGCCCCAAGGCGGGGGGCTACACCTTC	CASSLCPKAGGYTF	TRBV28	TRBJ1-2
TGTGCTAGTGGGCCGGGACAGGGGTACGGGGAGCTGTTTTTT	CASGPGQGYGELFF	TRBV12-5	TRBJ2-2
TGTGCCAGCTCAAATCCGCTGCCGGGACTAGAACGCGGGGAGCTGTTTTTT	CASSNPLPGLERGELFF	TRBV18	TRBJ2-2
TGTGCCACCAGTGACATCGGGGTTAGCGGGCGAGGAGGCACAGATACGCAGTATTTT	CATSDIGVSGRGGTDTQYF	TRBV24-1	TRBJ2-3
TGCGCCAGCAGCGTATTCGGACAGGGAGGGAATAGCAATCAGCCCCAGCATTTT	CASSVFGQGGNSNQPQHF	TRBV5-1	TRBJ1-5
TGTGCCCGCAACGAATCATGTAATTCACCCCTCCACTTT	CARNESCNSPLHF	TRBV5-6	TRBJ1-6
TGTGCCAGCAGTATTGGGACATACCTTTTCTATGGCTACACCTTC	CASSIGTYLFYGYTF	TRBV6-3	TRBJ1-2
TGCAGTGCTAGCCAGGGGACTGAAGCTTTCTTT	CSASQGTEAFF	TRBV20-1	TRBJ1-1
TGCGCCAGCAGTGAGTCGCGGGAGGAGGACGCCGAGCAGTACTTC	CASSESREEDAEQYF	TRBV10-1	TRBJ2-7
TGTGCCACCAGTGATCCACAGGCCGTGGAGCTGTTTTTT	CATSDPQAVELFF	TRBV24-1	TRBJ2-2
TGCGCCAGCAGTGAGTCCAGGGGAACGCAAGAGACCCAGTACTTC	CASSESRGTQETQYF	TRBV10-1	TRBJ2-5
TGCAGCGTTGAGCTACCTATTGATGAAAAACTGTTTTTT	CSVELPIDEKLFF	TRBV29-1	TRBJ1-4
TGTGCCTGGAGTGGAGGACAGGGTGGTAATTCACCCCTCCACTTT	CAWSGGQGGNSPLHF	TRBV30	TRBJ1-6
TGCAGTGGGCGGGGCGGGGAGACCCAGTACTTC	CSGRGGETQYF	TRBV20-1	TRBJ2-5
TGTGCCAGCAGCTTAGGAAGGAGGATTACGGGCGGGAATCAGCCCCAGCATTTT	CASSLGRRITGGNQPQHF	TRBV7-6	TRBJ1-5
TGTGCCAGCAGGTTGCGGTGGGGGCCTACTCGCACTAATGAAAAACTGTTTTTT	CASRLRWGPTRTNEKLFF	TRBV12-4	TRBJ1-4
TGTGCCAGCATCCCGGCTGTTGGCAATCAGCCCCAGCATTTT	CASIPAVGNQPQHF	TRBV6-3	TRBJ1-5
TGTGCCAGCAGCTTGAACGACCGGGGGGGCCAGCGGTACACCTACGAGCAGTACTTC	CASSLNDRGGQRYTYEQYF	TRBV5-6	TRBJ2-7
TGCGCCAGCAGCTTGGTAGACAGAGCCGAGCAGTACTTC	CASSLVDRAEQYF	TRBV5-1	TRBJ2-7
TGTGCCAGCAGGCCGGGACTAGCGCCAGATACGCAGTATTTT	CASRPGLAPDTQYF	TRBV25-1	TRBJ2-3
TGCAGTGCGGACGGCTCCGGTCCAGCGGAAAAACTGTTTTTT	CSADGSGPAEKLFF	TRBV20-1	TRBJ1-4
TGTGCCAGCAGTTACTGTCTGAAGGACTATGGCTACACCTTC	CASSYCLKDYGYTF	TRBV6-5	TRBJ1-2
TGCGCCAGCACGGGAGACGGATATAATTCACCCCTCCACTTT	CASTGDGYNSPLHF	TRBV10-1	TRBJ1-6
TGCAGCGTTGAGGTGCGACTAGCGGGAATGAGGAGGTCCAATGAGCAGTTCTTC	CSVEVRLAGMRRSNEQFF	TRBV29-1	TRBJ2-1
TGTGCCAAATGCCCCTCAGGGAATGAAAAACTGTTTTTT	CAKCPSGNEKLFF	TRBV4-2	TRBJ1-4
TGTGCCAGCAGTTCCCCCCCAGTAGCGGGAAGGGCCGCCGGGGAGCTGTTTTTT	CASSSPPVAGRAAGELFF	TRBV6-5	TRBJ2-2
TGTGCCAGCAGCTTAGGGGAGTACCTCTCCTACGAGCAGTACTTC	CASSLGEYLSYEQYF	TRBV7-2	TRBJ2-7
TGCGCCAGCAGCTTGGCCTCTGGTAACATTCAGTACTTC	CASSLASGNIQYF	TRBV5-1	TRBJ2-4
TGCGCCAGCAGCCAAGATATCGATGGGAGTCTAGCGGGTAGGCCAGATACGCAGTATTTT	CASSQDIDGSLAGRPDTQYF	TRBV4-3	TRBJ2-3
TGTGCCAGCAGCTTAGCAGGGGGCGTAAAACTGTTTTTT	CASSLAGGVKLFF	TRBV7-2	TRBJ1-4
TGTGCCAGCTCTACGACAAGACAGGGTTACGAGCAGTACTTC	CASSTTRQGYEQYF	TRBV18	TRBJ2-7
TGTGCCAGCAGCTCGATATCCGGGACTAGCGAAGTCGAGCAGTACTTC	CASSSISGTSEVEQYF	TRBV7-6	TRBJ2-7
TGTGCCAGCAGCGCCTTTGAACAGGGTGTCCCTCCCTACAATGAGCAGTTCTTC	CASSAFEQGVPPYNEQFF	TRBV9	TRBJ2-1
TGTGCCAGCAGCCCGCTCAGGGGAGGAAACACCGGGGAGCTGTTTTTT	CASSPLRGGNTGELFF	TRBV7-3	TRBJ2-2
TGTGCCAGCAGCTTAGCTCGGGGGGGGTCTAACTATGGCTACACCTTC	CASSLARGGSNYGYTF	TRBV7-3	TRBJ1-2
TGTGCCAGCAGCTTCACACCAGGGTCTAATGAAAAACTGTTTTTT	CASSFTPGSNEKLFF	TRBV13	TRBJ1-4
TGTGCCAGCAAAGCAGCAGAGACCCAGTACTTC	CASKAAETQYF	TRBV6-6	TRBJ2-5
TGTGCCAGCAGCACTAGCGGGGACGGGGAGCTGTTTTTT	CASSTSGDGELFF	TRBV13	TRBJ2-2
TGTGCCAGCAGTTCCCAGACAGGGAAAGACACTGAAGCTTTCTTT	CASSSQTGKDTEAFF	TRBV6-9	TRBJ1-1
TGTGCCAGCAGTGGCTGTCACCCTAGGACAGGGGGCATATCCTACGAGCAGTACTTC	CASSGCHPRTGGISYEQYF	TRBV6-4	TRBJ2-7
TGTGCCAGCAAACCCGGTGGGGTAATGTACTTC	CASKPGGVMYF	TRBV12-3	TRBJ2-7
TGTGCCAGCAGCCTTCAGGCTTCCTACAATGAGCAGTTCTTC	CASSLQASYNEQFF	TRBV6-5	TRBJ2-1
TGTGCCAGCAGTGATTTAGTCGCAGGCGCTATAAACACCATATATTTT	CASSDLVAGAINTIYF	TRBV6-4	TRBJ1-3
TGTGCCAGCAGCTGTCAGGGGGCCGGGAACACTGAAGCTTTCTTT	CASSCQGAGNTEAFF	TRBV13	TRBJ1-1
TGTGCCAGCAGCCTCGGGTGGGACAATAGTTACATTCAGTACTTC	CASSLGWDNSYIQYF	TRBV6-4	TRBJ2-4
TGCAGCGTGCCCGAGAAGGGCTACACCTTC	CSVPEKGYTF	TRBV29-1	TRBJ1-2
TGTGCCCTCCAGGACCGGAACACTGAAGCTTTCTTT	CALQDRNTEAFF	TRBV12-3	TRBJ1-1
TGTGCCAGCAGCTTGGCCACTCCAGCTTTCTTT	CASSLATPAFF	TRBV5-6	TRBJ1-1
TGTGCCATACGTACGGTGGGACTAGCGGGGGGGGGCCGCACAGATACGCAGTATTTT	CAIRTVGLAGGGRTDTQYF	TRBV6-4	TRBJ2-3
TGTGAAACCGGGACTCCCAGAGAGACCCAGTACTTC	CETGTPRETQYF	TRBV10-3	TRBJ2-5
TGTGCCAGCAGTTTGGGGAGGGGCATTCAGTACTTC	CASSLGRGIQYF	TRBV28	TRBJ2-4
TGCTTTTGGACTAGCGGGGGGGCCACAAGGATGGGAGATACGCAGTATTTT	CFWTSGGATRMGDTQYF	TRBV20-1	TRBJ2-3
TGTGCCAGCAGCGCGCCCTACGAGCAGTACTTC	CASSAPYEQYF	TRBV13	TRBJ2-7
TGTGCCAGCAGTGGTAGGGGGAGCAGGGGGGGGAATTCACCCCTCCACTTT	CASSGRGSRGGNSPLHF	TRBV2	TRBJ1-6
TGTGCCAGTAGGACGGACAGGGGGGGTCTGAACTACGAGCAGTACTTC	CASRTDRGGLNYEQYF	TRBV19	TRBJ2-7
TGTGCCATCAGTGACTCAGGGTTCAGGGGGACGTTGATGAACACTGAAGCTTTCTTT	CAISDSGFRGTLMNTEAFF	TRBV10-3	TRBJ1-1
TGTGCCAGCAGTTTAGAGGCGGGCTACGACGGGGAGGCCTTC	CASSLEAGYDGEAF	TRBV27	TRBJ1-2
TGTGCCAGCAGCGTAGGATTGCAGGGGGGAGCCTACGAGCAGTACTTC	CASSVGLQGGAYEQYF	TRBV9	TRBJ2-7
TGCGCCAGCAGAAAGCACCCCGAGCATAGCAATCAGCCCCAGCATTTT	CASRKHPEHSNQPQHF	TRBV5-1	TRBJ1-5
TGCGCCAGCAGCCAAGAGGGACTACGCAATGAGCAGTTCTTC	CASSQEGLRNEQFF	TRBV4-1	TRBJ2-1
TGTGCCAGCAGTTACGCCCCATTGGGGGGCTACACCTTC	CASSYAPLGGYTF	TRBV6-5	TRBJ1-2
TGCAGCGTTGAGGGCGAGGAATCCTCTGGGGCCAACGTCCTGACTTTC	CSVEGEESSGANVLTF	TRBV29-1	TRBJ2-6
TGTGCCAGCAGGAGACTGAGCACAGATACGCAGTATTTT	CASRRLSTDTQYF	TRBV28	TRBJ2-3
TGTCCCCCCGGGACAGGTAATTCACCCCTCCACTTT	CPPGTGNSPLHF	TRBV30	TRBJ1-6
TGTGCCAGCAGCCCGAAAGGAAAGAAAGCCCTAGAAAATGAGCAGTTCTTC	CASSPKGKKALENEQFF	TRBV7-3	TRBJ2-1
TGCGCCAGCACCCCCCCCTCTAGCGGAGAGCAGTACTTC	CASTPPSSGEQYF	TRBV5-1	TRBJ2-7
TGTGCCAGCTCACCAGTAGAATATTCTGAAGCTTTCTTT	CASSPVEYSEAFF	TRBV18	TRBJ1-1
TGTGCCAGCAGTTTAAAGCTTAGCGGGGGCACAGATACGCAGTATTTT	CASSLKLSGGTDTQYF	TRBV27	TRBJ2-3
TGTGCCAGCAGCTTATCCTATTGGATACCGAACACCGGGGAGCTGTTTTTT	CASSLSYWIPNTGELFF	TRBV5-5	TRBJ2-2
TGTGCTAGTGGTTTGGTAAGGTCCCCCCCTAGTCCCTCTAATTCACCCCTCCACTTT	CASGLVRSPPSPSNSPLHF	TRBV12-5	TRBJ1-6
TGTGCCAGCAGTTTTACTGCGGGAGACGAGAATCAGCCCCAGCATTTT	CASSFTAGDENQPQHF	TRBV27	TRBJ1-5
TGTGCCAGCAGTTTGCCCCTCACGGACAGGGGGGAAGCTGAAGCTTTCTTT	CASSLPLTDRGEAEAFF	TRBV12-3	TRBJ1-1
TGTGCCATCCCGGGACAGCTTCGAAACAATCAGCCCCAGCATTTT	CAIPGQLRNNQPQHF	TRBV10-3	TRBJ1-5
TGTGCCAGCAGCTGTGGACTAGCGGGGTGGTCCTACAATGAGCAGTTCTTC	CASSCGLAGWSYNEQFF	TRBV5-6	TRBJ2-1
TGTGCCAGCAGCTTAACCAACAGGGTTTGGGGGACCTACAATGAGCAGTTCTTC	CASSLTNRVWGTYNEQFF	TRBV11-2	TRBJ2-1
TGTGCCAGCAGTAGCCAGGGAGGCATTTGCACCGGGGAGCTGTTTTTT	CASSSQGGICTGELFF	TRBV6-4	TRBJ2-2
TGTGCCAGCAGCTTAGAGGTTATCGGGGAGCTGTTTTTT	CASSLEVIGELFF	TRBV7-3	TRBJ2-2
TGTGCCAGCAGGTGGGACAGGGAAGGGGTCCAGCCCCAGCATTTT	CASRWDREGVQPQHF	TRBV28	TRBJ1-5
TGTGCCATCAGTGAAGGAGGGAACTATGGCTACACCTTC	CAISEGGNYGYTF	TRBV10-3	TRBJ1-2
TGTGCCAGGCGGAGCCTCCCCACTGTGGGGCAGTATTTT	CARRSLPTVGQYF	TRBV7-3	TRBJ2-3
TGTGCCAGCAGCTATGACTGTTGGGGGGGAAGGGAGGAGACCCAGTACTTC	CASSYDCWGGREETQYF	TRBV11-3	TRBJ2-5
TGTGCCAGCAGCTTGACACTCTTCTACGAGCAGTACTTC	CASSLTLFYEQYF	TRBV5-4	TRBJ2-7
TGTGCCAGCAGTATGTTTAACAGGACGGTGGGCTACACCTTC	CASSMFNRTVGYTF	TRBV6-4	TRBJ1-2
TGTGCCAGCAGCAACGGGGGAGATACCTACAATGAGCAGTTCTTC	CASSNGGDTYNEQFF	TRBV7-3	TRBJ2-1
TGCAGTGCTAGGTCCAACAAGGAACGGGGCCCAAACGGGGGCTGGGACGAGCAGTACTTC	CSARSNKERGPNGGWDEQYF	TRBV20-1	TRBJ2-7
TGTGCCAGCAGCCTGGGGGGACCACGCGACTCCTACAATGAGCAGTTCTTC	CASSLGGPRDSYNEQFF	TRBV7-3	TRBJ2-1
TGTGCCAGCAGCTTAGACCCTAAGCCGAAGGGGCAACTTAGGACTGAAGCTTTCTTT	CASSLDPKPKGQLRTEAFF	TRBV11-2	TRBJ1-1
TGCGCCAGCCCTGGACAGGGGTATGAAAAACTGTTTTTT	CASPGQGYEKLFF	TRBV5-1	TRBJ1-4
TGTGCCAGCCCTGGAGGGCACGAGACCCAGTACTTC	CASPGGHETQYF	TRBV7-9	TRBJ2-5
TGCGCCAGCAGCTTGGGGGGGGACAGGGGGGCCTACGAGCAGTACTTC	CASSLGGDRGAYEQYF	TRBV5-1	TRBJ2-7
TGTGCCAGCAGCGTAATAGTAGTTTATGAGCAGTTCTTC	CASSVIVVYEQFF	TRBV9	TRBJ2-1
TGTGCCAGCAGGGGAGACCTAGCGGGAGGGGCCTACGAGCAGTACTTC	CASRGDLAGGAYEQYF	TRBV27	TRBJ2-7
TGTGCCACCAGCAGAGAGCTCGGTCATGAGCAGTTCTTC	CATSRELGHEQFF	TRBV15	TRBJ2-1
TGTGCCAGCAGCTTTGGACTAGCGGTTTCCGGGGAGCTGTTTTTT	CASSFGLAVSGELFF	TRBV7-8	TRBJ2-2
TGTGCCAGCAGCCAACCGGGGGTGGAGGGCTCGGGTGAGCAGTTCTTC	CASSQPGVEGSGEQFF	TRBV14	TRBJ2-1
TGTGCCAGAATGCAACTAGGGCCCGAGCAGTACTTC	CARMQLGPEQYF	TRBV28	TRBJ2-7
TGTGCCAGCGGCCGAGGATGGAGGAGCACAGATACGCAGTATTTT	CASGRGWRSTDTQYF	TRBV28	TRBJ2-3
TGTGCCAGCGGGCTCCACCCGGAGACCCAGTACTTC	CASGLHPETQYF	TRBV28	TRBJ2-5
TGTGCCACCAGTGCCCCCACGTTGACAGGGAAGAGGAGCTACGAGCAGTACTTC	CATSAPTLTGKRSYEQYF	TRBV24-1	TRBJ2-7
TGTGCCACCAGTGATTTTCAACTAGCGGGTCCGGAGCAGTACTTC	CATSDFQLAGPEQYF	TRBV24-1	TRBJ2-7
TGTGCCAGCAGCGAGGAGCCGGGGTCCGCGGCGGATTACGAGCAGTACTTC	CASSEEPGSAADYEQYF	TRBV7-3	TRBJ2-7
TGTGCCAGCAGCAGGTTGAACCTAGCGGTACTGGAGGAAGAGACCCAGTACTTC	CASSRLNLAVLEEETQYF	TRBV7-9	TRBJ2-5
TGTGCCATCAGTGTAGGAGGGGGACCTGCAACTAATGAAAAACTGTTTTTT	CAISVGGGPATNEKLFF	TRBV10-3	TRBJ1-4
TGTGCCAGCAGTGAAGCGACTAGCGGGTGGGGCACAGATACGCAGTATTTT	CASSEATSGWGTDTQYF	TRBV2	TRBJ2-3
TGTGCCAGCAGTGATCTAACTCTCAATGACAGGGTAGGGGTCATCCAGCCCCAGCATTTT	CASSDLTLNDRVGVIQPQHF	TRBV2	TRBJ1-5
TGCAGTGCTAGCCCGAGGGCAGGACAGACTAATGAAAAACTGTTTTTT	CSASPRAGQTNEKLFF	TRBV20-1	TRBJ1-4
TGTGCCAGCAGCTTAGCAGGGCAGGACAAGCGTGGAGAAAAACTGTTTTTT	CASSLAGQDKRGEKLFF	TRBV7-6	TRBJ1-4
TGTGCCAGCACACCCGGGGTGGGATGGGGAATTATGAACACTGAAGCTTTCTTT	CASTPGVGWGIMNTEAFF	TRBV6-4	TRBJ1-1
TGTGCCAGCAGCACCCGACAGGGTAGAAATTCCTACGAGCAGTACTTC	CASSTRQGRNSYEQYF	TRBV7-9	TRBJ2-7
TGTGCCAGCAGCGCCACCAGGGGCCCCACTGAAGCTTTCTTT	CASSATRGPTEAFF	TRBV9	TRBJ1-1
TGTGCCAGCAGCTATACTAGCGGCAGGGGTAAGGGAGGCTACAATGAGCAGTTCTTC	CASSYTSGRGKGGYNEQFF	TRBV6-5	TRBJ2-1
TGTGCCCTCTCACTAGCGGGTCGGGGGTTGGACAATGAGCAGTTCTTC	CALSLAGRGLDNEQFF	TRBV9	TRBJ2-1
TGTGCCAGTAGTATGATAAGCCAGGTTCGCCGTAACTATGGCTACACCTTC	CASSMISQVRRNYGYTF	TRBV19	TRBJ1-2
TGCAGTGCTAGGGTAGAAGATCAGCCCCAGCATTTT	CSARVEDQPQHF	TRBV20-1	TRBJ1-5
TGTGCCTGGAGCTCAGTGCCCGACAGGGGCGTGCAGCCCCAGCATTTT	CAWSSVPDRGVQPQHF	TRBV30	TRBJ1-5
TGTGCCTGGAGAAGACCGGGGGAGGTCAATGAGCAGTTCTTC	CAWRRPGEVNEQFF	TRBV30	TRBJ2-1
TGTGCCAGCAGCGAGTTGGGGGCTAGCGGGATAGCCAACTCCTACAATGAGCAGTTCTTC	CASSELGASGIANSYNEQFF	TRBV7-3	TRBJ2-1
TGTGCCAGTACGGGGAATCCGCAAGAGACCCAGTACTTC	CASTGNPQETQYF	TRBV19	TRBJ2-5
TGCGCCAGCAGCCAAGATCATCAGGCGGCGGGAACTGAAGCTTTCTTT	CASSQDHQAAGTEAFF	TRBV4-1	TRBJ1-1
TGTGCCAGCAGCCACCAGGGGGCTAACTATGGCTACACCTTC	CASSHQGANYGYTF	TRBV6-3	TRBJ1-2
TGTGCCAGCAGCTTGCCCAGAGGGAACTACGAGCAGTACTTC	CASSLPRGNYEQYF	TRBV7-8	TRBJ2-7
TGTGCCAGCAGTTACTCCCTACTAGGGACACAAAGAGATACGCAGTATTTT	CASSYSLLGTQRDTQYF	TRBV6-5	TRBJ2-3
TGCGCCAGCAGCTTCCCCTGGACTAGCGGGAGGTACAATGAGCAGTTCTTC	CASSFPWTSGRYNEQFF	TRBV5-1	TRBJ2-1
TGTGCCAGTTTTATAGGCGGACGTGGCGGAGCCTACAATGAGCAGTTCTTC	CASFIGGRGGAYNEQFF	TRBV19	TRBJ2-1
TGTGCCAGCAGCATATTGGGACTAGCGGGGATTGGGGCCAACGTCCTGACTTTC	CASSILGLAGIGANVLTF	TRBV11-3	TRBJ2-6
TGTGCCAGCAGCGAAATTAGCGGTGAAAGCGGGCAAGAGACCCAGTACTTC	CASSEISGESGQETQYF	TRBV9	TRBJ2-5
TGTGCCAGCTGGGGGAATACTGGGGCCAACGTCCTGACTTTC	CASWGNTGANVLTF	TRBV7-3	TRBJ2-6
TGTGCCTGGAGAATCCGACTAGCGGGTCTGGGCGGAGCTTTCACAGATACGCAGTATTTT	CAWRIRLAGLGGAFTDTQYF	TRBV30	TRBJ2-3
TGTGCCACCAGTGCGACAGGGGAAGGGCCAGATACGCAGTATTTT	CATSATGEGPDTQYF	TRBV24-1	TRBJ2-3
TGTGCCAGCAGTGAAGACAGACGATACGAGCAGTACTTC	CASSEDRRYEQYF	TRBV6-1	TRBJ2-7
TGTGCCAGCAGCGGGCCCCAGCATTTT	CASSGPQHF	TRBV9	TRBJ1-5
TGCGCCAGCAGCTTGGTTTCCCAGGGCGGAAACTACGAGCAGTACTTC	CASSLVSQGGNYEQYF	TRBV5-1	TRBJ2-7
TGTGCTAGCAGCTTAAAAGGGTCAGGGGTGGAGGAGCAGTACTTC	CASSLKGSGVEEQYF	TRBV7-7	TRBJ2-7
TGTGCCAGCACGGTGGTCCGGGAACCCCGACACAAAAACATTCAGTACTTC	CASTVVREPRHKNIQYF	TRBV6-1	TRBJ2-4
TGTGCCGTCAGCAGCGAGCAGTACTTC	CAVSSEQYF	TRBV24-1	TRBJ2-7
TGTGCCAGCAAAGGCGCCAAGAACTCTGGAAACACCATATATTTT	CASKGAKNSGNTIYF	TRBV12-3	TRBJ1-3
TGTGCCAGCAGCTCCCCGCAGGGTGCCGGTTCCACTGAAGCTTTCTTT	CASSSPQGAGSTEAFF	TRBV7-3	TRBJ1-1
TGCGCCAGCAGCCAAGGTAATCGGGGACCCTCCTACAATGAGCAGTTCTTC	CASSQGNRGPSYNEQFF	TRBV4-1	TRBJ2-1
TGCGCCAGCAGCGAACCGCTGGGCCACACCTTC	CASSEPLGHTF	TRBV5-1	TRBJ1-2
TGTGCCAGCAGCCACGGACAGCTCCGCTCTGGAAACACCATATATTTT	CASSHGQLRSGNTIYF	TRBV14	TRBJ1-3
TGTGCCAGCAGCTTAGGGACAAACCAAGAGACCCAGTACTTC	CASSLGTNQETQYF	TRBV11-3	TRBJ2-5
TGTGCCAGCAGCCGCTTAGAGGGACGTGACTGCTCCTACAATGAGCAGTTCTTC	CASSRLEGRDCSYNEQFF	TRBV7-9	TRBJ2-1
TGTGCCAGCAGTGCCAGCGGGGTGGAAGCTTTCTTT	CASSASGVEAFF	TRBV6-1	TRBJ1-1
TGTGCCAAGGGGACAGGACTTGAGCAGTTCTTC	CAKGTGLEQFF	TRBV25-1	TRBJ2-1
TGTGCCAGCAGCTCCCGCCGGGACAGACGTAGCTCCTACAATGAGCAGTTCTTC	CASSSRRDRRSSYNEQFF	TRBV13	TRBJ2-1
TGTGCCAGTAGTATAACACGGCTGGGGCGGGGTCTCTATGGCTACACCTTC	CASSITRLGRGLYGYTF	TRBV19	TRBJ1-2
TGCGCCAGCATTTGGATGGCGGAAAACATTCAGTACTTC	CASIWMAENIQYF	TRBV10-2	TRBJ2-4
TGTGCCAGCAGCTTCCCCACTCAGGGGGTACCCGGCTACAATGAGCAGTTCTTC	CASSFPTQGVPGYNEQFF	TRBV13	TRBJ2-1
TGTGCCAGCAGCCGTGGGGTGGGTGAAGCTTTCTTT	CASSRGVGEAFF	TRBV14	TRBJ1-1
TGTGCCAGCAGTTGGAGACTGGACAGGGATGGCTACACCTTC	CASSWRLDRDGYTF	TRBV28	TRBJ1-2
TGTGCCAGTACATCAGGGGTACTCAACTATGGCTACACCTTC	CASTSGVLNYGYTF	TRBV19	TRBJ1-2
TGTGCCAGCACCGGGAGACGTGCCTACAATGAGCAGTTCTTC	CASTGRRAYNEQFF	TRBV27	TRBJ2-1
TGCGCCAGCAGCCAAGGGAACTTCCCGGGCGGCAATCAGCCCCAGCATTTT	CASSQGNFPGGNQPQHF	TRBV4-1	TRBJ1-5
TGTGCCAGACCAGGGGCCTACGAGCAGTACTTC	CARPGAYEQYF	TRBV9	TRBJ2-7
TGTGCCATCAAATCCGACGGGGGGTCGACAGAGACCCAGTACTTC	CAIKSDGGSTETQYF	TRBV10-3	TRBJ2-5
TGCAGTGCACCCTTAGGGAGAAGAGGGAGGTCCTACGAGCAGTACTTC	CSAPLGRRGRSYEQYF	TRBV20-1	TRBJ2-7
TGCTCCGGGGGGTGCTACGAGCAGTACTTC	CSGGCYEQYF	TRBV20-1	TRBJ2-7
TGCGCCAGCAGTGACTTGGATGGACTAGCAAGGCACGAGCAGTACTTC	CASSDLDGLARHEQYF	TRBV10-1	TRBJ2-7
TGCAGCGTTCCGACCCGGTGGAGTGGGGGCGCTGAAGCTTTCTTT	CSVPTRWSGGAEAFF	TRBV29-1	TRBJ1-1
TGTGCCACAGGAGCTGAGACCCAGTACTTC	CATGAETQYF	TRBV7-9	TRBJ2-5
TGTGCCAAGTGCCGGACCGGGGGTGGCAATGAGCAGTTCTTC	CAKCRTGGGNEQFF	TRBV19	TRBJ2-1
TGTGCCAGCAGCTTAATAAGAGGGGCCCGCTCCGAGGGCCCAGGTCGCAATCAGCCCCAGCATTTT	CASSLIRGARSEGPGRNQPQHF	TRBV7-3	TRBJ1-5
TGTGCCACCAGTGGGAGTGGATGCGGCAAGGATTACAATGAGCAGTTCTTC	CATSGSGCGKDYNEQFF	TRBV24-1	TRBJ2-1
TGCGCCAACGACAGTCGATCAGGTAATGAAAAACTGTTTTTT	CANDSRSGNEKLFF	TRBV10-2	TRBJ1-4
TGCGCCAGCAGCCTGGGGCCGTCGCAAGAGACCCAGTACTTC	CASSLGPSQETQYF	TRBV4-1	TRBJ2-5
TGTGCCAGCAGCAGAGGGACAGGAATCGGAGCTTTCTTT	CASSRGTGIGAFF	TRBV2	TRBJ1-1
TGTGCTAGTGGTGGGAGCGAACCCTACGAGCAGTACTTC	CASGGSEPYEQYF	TRBV12-5	TRBJ2-7
TGTGCCAGCAGCCAAATGAACCCGGGACAGGGAATGAACACTGAAGCTTTCTTT	CASSQMNPGQGMNTEAFF	TRBV14	TRBJ1-1
TGTGCCAGCAGCTTAAAACGGGGGGGGGGGTCCTACGAGCAGTACTTC	CASSLKRGGGSYEQYF	TRBV5-5	TRBJ2-7
TGCGCCAGCAGCTCCTCCTGTAACTACGAGCAGTACTTC	CASSSSCNYEQYF	TRBV5-1	TRBJ2-7
TGCGCCAGCAGCTTGACCCCGGGCTATGGCTACACCTTC	CASSLTPGYGYTF	TRBV5-1	TRBJ1-2
TGTGCCAGCAGGGGGCCGAGAGATTACGAGCAGTACTTC	CASRGPRDYEQYF	TRBV27	TRBJ2-7
TGTGCCAGCAGCAAAGGGACAGGGGAAACATTCAATTCACCCCTCCACTTT	CASSKGTGETFNSPLHF	TRBV5-5	TRBJ1-6
TGCGCCAGCAGTGGCTCCGTCGTAGGCGGGGCGGTAAATCAGCCCCAGCATTTT	CASSGSVVGGAVNQPQHF	TRBV10-2	TRBJ1-5
TGTGCCAGTTCAACGGCAATCCTGGGAGCTAACTATGGCTACACCTTC	CASSTAILGANYGYTF	TRBV19	TRBJ1-2
TGTGCCAGCATGCCTCCGTCAGGGACAGCCTACGAGCAGTACTTC	CASMPPSGTAYEQYF	TRBV6-3	TRBJ2-7
TGTGCCACCAGTGATTGGGGGAGAGTCCAGCCCCAGCATTTT	CATSDWGRVQPQHF	TRBV24-1	TRBJ1-5
TGTGCCAGCAGGAATGACAACGAGCAGTACTTC	CASRNDNEQYF	TRBV27	TRBJ2-7
TGTGCCAGCAGCCAACTAGCGGGAGAAGGAAACACCATATATTTT	CASSQLAGEGNTIYF	TRBV6-5	TRBJ1-3
TGTGCCAGCAGCTTAGAATCAGGGGGAATTACTGAAGCTTTCTTT	CASSLESGGITEAFF	TRBV11-3	TRBJ1-1
TGTGCCAGCAGCTTAGCGACCCGGGTACTTCAAAACATTCAGTACTTC	CASSLATRVLQNIQYF	TRBV7-2	TRBJ2-4
TGTGCCAGCAGTTCTGGGGGGAGCAATCAGCCCCAGCATTTT	CASSSGGSNQPQHF	TRBV6-5	TRBJ1-5
TGTGCCAGCAGTGGGCCTAGCGGTAGATACAATGAGCAGTTCTTC	CASSGPSGRYNEQFF	TRBV6-5	TRBJ2-1
TGCACTCCCCAGCTGGAAGAGCAGTTCTTC	CTPQLEEQFF	TRBV20-1	TRBJ2-1
TGTGCCAGCAGCCAAGCAAAATCCGTGTCTTGCCCGAACACCGGGGAGCTGTTTTTT	CASSQAKSVSCPNTGELFF	TRBV3-1	TRBJ2-2
TGTGCCAGCAAGACAGGGGCCCGAGTGGCGAGCGAGACCCAGTACTTC	CASKTGARVASETQYF	TRBV6-4	TRBJ2-5
TGTGCCAGCAGTGGACACAGCTGGCGGATTAACTATGGCTACACCTTC	CASSGHSWRINYGYTF	TRBV6-5	TRBJ1-2
TGCGCCAGCAGACCCAGGGGGCGCTTGTCACCCCTCCACTTT	CASRPRGRLSPLHF	TRBV5-1	TRBJ1-6
TGTGCCAGCAGTTTTGGGGAAAGGTGGGGGTTTACTGAAGCTTTCTTT	CASSFGERWGFTEAFF	TRBV27	TRBJ1-1
TGTGCCAGCAGCCAAGATAGAGATAGCTCCTACGAGCAGTACTTC	CASSQDRDSSYEQYF	TRBV14	TRBJ2-7
TGTGCCAGTAGTCGAGAGGCGCATCAGATTGAGCAGTACTTC	CASSREAHQIEQYF	TRBV19	TRBJ2-7
TGTGCCAGCAGCGTGGGTGGGGGTCTGAACACCATATATTTT	CASSVGGGLNTIYF	TRBV7-3	TRBJ1-3
TGTGCCACCAGTGAATCAGGGGGGCTGGGGTCGAACACCGGGGAGCTGTTTTTT	CATSESGGLGSNTGELFF	TRBV24-1	TRBJ2-2
TGTGCCGGGACAGGCCGCGAGCTAGCCAAAAACATTCAGTACTTC	CAGTGRELAKNIQYF	TRBV2	TRBJ2-4
TGCAGTGCTATCGTATCGGCCTATGGCTACACCTTC	CSAIVSAYGYTF	TRBV20-1	TRBJ1-2
TGTGCCAGCAGTTACCGCAGGGGCGCATATGGCTACACCTTC	CASSYRRGAYGYTF	TRBV6-5	TRBJ1-2
TGTGCCAGCACGGGATTTATTAGCTTGAATGAGCAGTTCTTC	CASTGFISLNEQFF	TRBV28	TRBJ2-1
TGTGCCATAGCCCGGGGACAGTCGGTGTCAGATACGCAGTATTTT	CAIARGQSVSDTQYF	TRBV19	TRBJ2-3
TGCGCCAAAGACTCGACAGATGGGACTAATGAAAAACTGTTTTTT	CAKDSTDGTNEKLFF	TRBV5-1	TRBJ1-4
TGTGCCAGCGCCCCGGGACAACAGCATTCCTATAATTCACCCCTCCACTTT	CASAPGQQHSYNSPLHF	TRBV6-5	TRBJ1-6
TGCGCCAGCAGCCATCCCCCGGGACAAGGCGGCAATGAGCAGTTCTTC	CASSHPPGQGGNEQFF	TRBV4-1	TRBJ2-1
TGTGCCACCAGTGATCCTACTAGCGGGAGGGATACGCAGTATTTT	CATSDPTSGRDTQYF	TRBV24-1	TRBJ2-3
TGTGCCAGCAGCTTATACTACGAGCAGTACTTC	CASSLYYEQYF	TRBV13	TRBJ2-7
TGTGCCAGCAGCTTAGCCAATCCCCCGTTTCACCAGGGGCTTACAGTGAGAGATACGCAGTATTTT	CASSLANPPFHQGLTVRDTQYF	TRBV7-4	TRBJ2-3
TGCAGTGCTAGAGATGCATACCGACAGGTGATGGTTGAAGCTTTCTTT	CSARDAYRQVMVEAFF	TRBV20-1	TRBJ1-1
TGCGCCAGCAGCCAAGATTCTCGACAGCTTCCGCTAGCCAAAAACATTCAGTACTTC	CASSQDSRQLPLAKNIQYF	TRBV4-1	TRBJ2-4
TGTGCCAGCAGCTTACCCCTTCACAGCGCTGGGGCCAACGTCCTGACTTTC	CASSLPLHSAGANVLTF	TRBV7-8	TRBJ2-6
TGTGCCAGCAGCGTAGGGGTCAATTCACCCCTCCACTTT	CASSVGVNSPLHF	TRBV11-3	TRBJ1-6
TGCGCCAGCAGGTCCTTCCCAGACATTTCGCCTAGGAGGGGTAGTAAGACCCAGTACTTC	CASRSFPDISPRRGSKTQYF	TRBV5-1	TRBJ2-5
TGTGCCAGCAGCTTAGCACGACTCGAGCAGTACTTC	CASSLARLEQYF	TRBV11-3	TRBJ2-7
TGCGCCAGCAGCTTAGATCGGAACCCGAGTAGAAGACTAGCAAACAATGAGCAGTTCTTC	CASSLDRNPSRRLANNEQFF	TRBV5-1	TRBJ2-1
TGTGCCAGCAGGAGCCCGTACGAGCAGTACTTC	CASRSPYEQYF	TRBV28	TRBJ2-7
TGCAGCGTTAGACCGGGGGACAGTTTTGCCGGGAACATGACTGAAGCTTTCTTT	CSVRPGDSFAGNMTEAFF	TRBV29-1	TRBJ1-1
TGTGCCAGCATTCCCCACAGGGATTTCACTGTGGGTGACACTGAAGCTTTCTTT	CASIPHRDFTVGDTEAFF	TRBV6-1	TRBJ1-1
TGTGCCAGCAGCTTAGATGGGGGGCCGTCCGAGCAGTACTTC	CASSLDGGPSEQYF	TRBV7-2	TRBJ2-7
TGTGCCAGCAGTTACAGATACCGGCCGGCTGGGGCCAACGTCCTGACTTTC	CASSYRYRPAGANVLTF	TRBV6-5	TRBJ2-6
TGTGCCAGCAGTTGTGGACAGGGGGCATCCCAAGAGACCCAGTACTTC	CASSCGQGASQETQYF	TRBV12-3	TRBJ2-5
TGTGCGGTCCCATTTCTGTCGGACAGGCACACCGGGGAGCTGTTTTTT	CAVPFLSDRHTGELFF	TRBV7-7	TRBJ2-2
TGTGCCAGCAGCCGGGGGGAATGCTACAATGAGCAGTTCTTC	CASSRGECYNEQFF	TRBV27	TRBJ2-1
TGCAGTGCTAGAGTAAAGGGGTTCACCACAGATACGCAGTATTTT	CSARVKGFTTDTQYF	TRBV20-1	TRBJ2-3
TGCAGTGCTAGAAAAACGTGCGAAGAGACCCAGTACTTC	CSARKTCEETQYF	TRBV20-1	TRBJ2-5
TGCAGCGTTGTGGTCCAGGGCGGGCTGAACACCGGGGAGCTGTTTTTT	CSVVVQGGLNTGELFF	TRBV29-1	TRBJ2-2
TGTGCCAGCGGAGGGGGCAGCACAGATACGCAGTATTTT	CASGGGSTDTQYF	TRBV7-9	TRBJ2-3
TGTGCCACTGTAGGGCCCGGGGAGCTGTTTTTT	CATVGPGELFF	TRBV24-1	TRBJ2-2
TGCAGTGCTAGACGGAGGAGATTAGAGCAGGCGCAGCCCCAGCATTTT	CSARRRRLEQAQPQHF	TRBV20-1	TRBJ1-5
TGCAGCGTTGAACCGGGACACGTGGCTTTCTTT	CSVEPGHVAFF	TRBV29-1	TRBJ1-1
TGTGCCAGCAGTTGGCGGGGTGCCTACGAGCAGTACTTC	CASSWRGAYEQYF	TRBV6-5	TRBJ2-7
TGTGCCAGCAGCGTTCCGACGACAGGGGGCTACACCTTC	CASSVPTTGGYTF	TRBV13	TRBJ1-2
TGTGCCAGCAGTGACCGTCGGAGGACAATCGATGTGAACACTGAAGCTTTCTTT	CASSDRRRTIDVNTEAFF	TRBV2	TRBJ1-1
TGTGCCAGCTCGGACGCGGGAAGCTCCTACGAGCAGTACTTC	CASSDAGSSYEQYF	TRBV18	TRBJ2-7
TGTGCCAGCAGGCCAACCTTCATAGGGGAAGCTTTCTTT	CASRPTFIGEAFF	TRBV6-5	TRBJ1-1
TGTGCTAGCAGCTTAGGCCCCGGGACATATTCACCCCTCCACTTT	CASSLGPGTYSPLHF	TRBV7-7	TRBJ1-6
TGTGCCAGCAGTGACCCGAACTCAGGGGATGGCTACACCTTC	CASSDPNSGDGYTF	TRBV6-4	TRBJ1-2
TGTGCCCGTGACCATTATGTACGATTGCTACAGCCCCAGCATTTT	CARDHYVRLLQPQHF	TRBV5-4	TRBJ1-5
TGTGCCGCAGTTCCCTATGGCTACACCTTC	CAAVPYGYTF	TRBV9	TRBJ1-2
TGTGCCAGCAGCAGGGACAGGGACAATGAGCAGTTCTTC	CASSRDRDNEQFF	TRBV11-3	TRBJ2-1
TGTGCCAGCAGCGTCGGGGCCGAAGGCTCTCAGGGGAGTACTAATGAAAAACTGTTTTTT	CASSVGAEGSQGSTNEKLFF	TRBV9	TRBJ1-4
TGTGCCAGCAGCTTGGCCCAGGGGTTGGGTCAGCCCCAGCATTTT	CASSLAQGLGQPQHF	TRBV5-4	TRBJ1-5
TGCGCCAGCAAACAAGGGGTCATGAACTATGGCTACACCTTC	CASKQGVMNYGYTF	TRBV10-1	TRBJ1-2
TGTGCCACCGTACGGGGGGTCAAACGCACAGATACGCAGTATTTT	CATVRGVKRTDTQYF	TRBV24-1	TRBJ2-3
TGTGCCCGCCGCGGGAGTTGGAATAGCAATCAGCCCCAGCATTTT	CARRGSWNSNQPQHF	TRBV24-1	TRBJ1-5
TGTGCCAGCAGCAGGGGGTCCGACAACACTGAAGCTTTCTTT	CASSRGSDNTEAFF	TRBV7-8	TRBJ1-1
TGCGCCAGAGCTGAGGGCATCAGGGCTACCCGGACTGCGAACACCGGGGAGCTGTTTTTT	CARAEGIRATRTANTGELFF	TRBV10-1	TRBJ2-2
TGCAGTGCTAGCCTAGTTGAGCAGTTCTTC	CSASLVEQFF	TRBV20-1	TRBJ2-1
TGTGCCAGCAGCCAAGAGAGGGACAGCAATCAGCCCCAGCATTTT	CASSQERDSNQPQHF	TRBV14	TRBJ1-5
TGTGCCAGTAGAAAAATCTGGGGGGGAGACAGACCCGAGACCACAGATACGCAGTATTTT	CASRKIWGGDRPETTDTQYF	TRBV19	TRBJ2-3
TGTGCCAGCAGTTACATCCCGGGGGCCTTTTCGACCCAGTACTTC	CASSYIPGAFSTQYF	TRBV6-5	TRBJ2-5
TGTGCCAGCAGTTTCAGTTTTGGCTCCTACGAGCAGTACTTC	CASSFSFGSYEQYF	TRBV6-5	TRBJ2-7
TGTGCCAGCAGCTGGTCTGTCACAGGGGAGGAGACCCAGTACTTC	CASSWSVTGEETQYF	TRBV13	TRBJ2-5
TGTGCCAGCAGTGAAAAGAACGACAGGGGGCAACCTGGGGCCAACGTCCTGACTTTC	CASSEKNDRGQPGANVLTF	TRBV2	TRBJ2-6
TGCAGTGCTAGAGGTGGGGACGTTAGGGACACTGAAGCTTTCTTT	CSARGGDVRDTEAFF	TRBV20-1	TRBJ1-1
TGTGCCAGCAGCCAAAGGCCTCTGACTAGCGGGCCCTCCTACGAGCAGTACTTC	CASSQRPLTSGPSYEQYF	TRBV14	TRBJ2-7
TGTGCCAGCAGCCCTGTCCCCGGACTAGCGGGGATACCCGAGCAGTACTTC	CASSPVPGLAGIPEQYF	TRBV7-8	TRBJ2-7
TGCGCCAGCAGTGAGAGGGACACACATCAGCCCCAGCATTTT	CASSERDTHQPQHF	TRBV10-1	TRBJ1-5
TGTGCCAGCAGCGTTCAGCGGGGGTTTGATGGGGCCAACGTCCTGACTTTC	CASSVQRGFDGANVLTF	TRBV13	TRBJ2-6
TGTGCCAGCAGCGGACCCCCGGGACAGGGTGAAAAACTGTTTTTT	CASSGPPGQGEKLFF	TRBV11-3	TRBJ1-4
TGTGCCAGCAGCAGGTACGTGAGAAGGGGGCAGGATGACATTCAGTACTTC	CASSRYVRRGQDDIQYF	TRBV7-9	TRBJ2-4
TGTGCTGCGACAGGGGTTGGGGGGCGAAACACCATATATTTT	CAATGVGGRNTIYF	TRBV27	TRBJ1-3
TGTGCCAGCCACGTCCGTTTATCCATGAACACTGAAGCTTTCTTT	CASHVRLSMNTEAFF	TRBV2	TRBJ1-1
TGTGCCAGCAGTTACTCGAGATTCGACAGGGAGGAGCCCCAGCATTTT	CASSYSRFDREEPQHF	TRBV6-5	TRBJ1-5
TGTGCCGGCGGGGACTACGAGCAGTACTTC	CAGGDYEQYF	TRBV27	TRBJ2-7
TGTGCCAGCAGCCAAGGAGGGGGTGGAAACACCATATATTTT	CASSQGGGGNTIYF	TRBV4-2	TRBJ1-3
TGTGCCAGCAGTGGACAGAGACCCGAGACCCAGTACTTC	CASSGQRPETQYF	TRBV27	TRBJ2-5
TGTGCCAGCAGCTTAGGGAGGCCCGATACGCAGTATTTT	CASSLGRPDTQYF	TRBV7-2	TRBJ2-3
TGCGCCAGCAGTGCCCGACCCTCAGGGGGATCGGGCTACGAGCAGTACTTC	CASSARPSGGSGYEQYF	TRBV10-1	TRBJ2-7
TGTGCCAGCAGCCGGGGGACTAGCGGGGTAGGCAACGAGCAGTACTTC	CASSRGTSGVGNEQYF	TRBV9	TRBJ2-7
TGTGCCAGCAGTTGGGGATACACCGGGGAGCTGTTTTTT	CASSWGYTGELFF	TRBV6-1	TRBJ2-2
TGTGCCAGTAAGGGACGGTTCTACGAGCAGTACTTC	CASKGRFYEQYF	TRBV19	TRBJ2-7
TGTGCCACCAGTGGTAGGACCGATGAGGAAAAACTGTTTTTT	CATSGRTDEEKLFF	TRBV24-1	TRBJ1-4
TGTGCCAGCAGCCAAGAGGTATACAATGAGCAGTTCTTC	CASSQEVYNEQFF	TRBV14	TRBJ2-1
TGCGCCAGCAGCGTTATACACAGGGAAGACCAGCCCCAGCATTTT	CASSVIHREDQPQHF	TRBV5-1	TRBJ1-5
TGCGCCAGCAGCTTGGCTGGGCCAGGGGCGGGGGATAATGAAAAACTGTTTTTT	CASSLAGPGAGDNEKLFF	TRBV5-1	TRBJ1-4
TGTGCCAGCAAGGAGCGATATGGGAAGGATAGCAATCAGCCCCAGCATTTT	CASKERYGKDSNQPQHF	TRBV6-4	TRBJ1-5
TGTGCCAGCACAGTCTCGTACGAGCAGTACTTC	CASTVSYEQYF	TRBV6-5	TRBJ2-7
TGTGCCAGCAGCCCCCCACTAGCGGGACACGGAAAGAGCACAGATACGCAGTATTTT	CASSPPLAGHGKSTDTQYF	TRBV2	TRBJ2-3
TGCGCCAGCAGCTTGCCGGGACACTCCCTAATGGCCTACGAGCAGTACTTC	CASSLPGHSLMAYEQYF	TRBV5-1	TRBJ2-7
TGTGCCAGCAGTGAAGCATTCCTGCCAGACAGCGAACAGTACGAGCAGTACTTC	CASSEAFLPDSEQYEQYF	TRBV6-1	TRBJ2-7
TGTGCCAGCAGTGAAGGGGATAGACGGCATTTTGACGAGCAGTACTTC	CASSEGDRRHFDEQYF	TRBV6-1	TRBJ2-7
TGTGCCAGCAGAACCCCGGGACTAGCGGGAGCGCCGACCGGGGAGCTGTTTTTT	CASRTPGLAGAPTGELFF	TRBV7-9	TRBJ2-2
TGTGCCAGCAGCTACCTTAAGGGGCAGAGACAAGAGACCCAGTACTTC	CASSYLKGQRQETQYF	TRBV5-4	TRBJ2-5
TGCGCCAGCAGCCAAGAGGAGGTGCACGAGCAGTACTTC	CASSQEEVHEQYF	TRBV4-3	TRBJ2-7
TGTGCCAGCAGCAGGGAGGACAGGTACTACAATCAGCCCCAGCATTTT	CASSREDRYYNQPQHF	TRBV13	TRBJ1-5
TGTGCCACCAGTGATCCGACAGTGGGTAATTCACCCCTCCACTTT	CATSDPTVGNSPLHF	TRBV24-1	TRBJ1-6
TGCAGTGCTAGAGCCCAAAGTCCTCAGGGGACAGATACGCAGTATTTT	CSARAQSPQGTDTQYF	TRBV20-1	TRBJ2-3
TGTGCCAGCAGCCGTGTGACTTATTACATTCAGTACTTC	CASSRVTYYIQYF	TRBV13	TRBJ2-4
TGCGCCAGCAGAAGGGGGAACACTGAAGCTTTCTTT	CASRRGNTEAFF	TRBV5-1	TRBJ1-1
TGCGCCAGCAGCCCGACGAGGGTCCTTCATTCACCCCTCCACTTT	CASSPTRVLHSPLHF	TRBV4-1	TRBJ1-6
TGTGCCAGCAGCTTACCCGGGGTCTATAGCAATCAGCCCCAGCATTTT	CASSLPGVYSNQPQHF	TRBV7-9	TRBJ1-5
TGTGCCAGCAGAACTCAGGGGATCTACGAGCAGTACTTC	CASRTQGIYEQYF	TRBV2	TRBJ2-7
TGTGCCAGCAGTGCTGCCTCCGGGGGCCGGGAGTATGGCTACACCTTC	CASSAASGGREYGYTF	TRBV6-1	TRBJ1-2
TGCGCCAGCAGCTTGGACGGGACAGGGTGGGGAGATGAAAAACTGTTTTTT	CASSLDGTGWGDEKLFF	TRBV5-1	TRBJ1-4
TGTGCCAGCAGCCGGCCGAACGGGGAGGGATTACCCTACGAGCAGTACTTC	CASSRPNGEGLPYEQYF	TRBV9	TRBJ2-7
TGTGCCAGCAGCTTGAGAGCCCCCGGGACAGGAAATGAGCAGTTCTTC	CASSLRAPGTGNEQFF	TRBV5-6	TRBJ2-1
TGTGCCACCAGCAGAAGTGGGACTAGTTTGTGCTACGAGCAGTACTTC	CATSRSGTSLCYEQYF	TRBV15	TRBJ2-7
TGTGCCAGCAGCCAAGATGTGCGGCCGGACGAGAACGCCAGGGGCCCCTACGAGCAGTACTTC	CASSQDVRPDENARGPYEQYF	TRBV14	TRBJ2-7
TGTGCCTGGAGTGTATTAGGGGGGGGCCGGGCGGGAGTCAACACCGGGGAGCTGTTTTTT	CAWSVLGGGRAGVNTGELFF	TRBV30	TRBJ2-2
TGTGCCAGCAGTGAGGGAGGAGCTGGCTACACCTTC	CASSEGGAGYTF	TRBV6-1	TRBJ1-2
TGCGCCAGCAGAACTCACGGACAGGGGCGGTTTGCCACAGATACGCAGTATTTT	CASRTHGQGRFATDTQYF	TRBV10-1	TRBJ2-3
TGTGCCAGCAGACCCGACCCCCTACAAAGGACCTACAATGAGCAGTTCTTC	CASRPDPLQRTYNEQFF	TRBV13	TRBJ2-1
TGCGCCAGCAGCCCAGGGGATCATGAGCAGTTCTTC	CASSPGDHEQFF	TRBV4-1	TRBJ2-1
TGCAGCGTCCTTACAGGGGCCGGTGGCTACACCTTC	CSVLTGAGGYTF	TRBV29-1	TRBJ1-2
TGTGCCAGCAGCTGGGGGCATAGTCAAGAGACCCAGTACTTC	CASSWGHSQETQYF	TRBV5-4	TRBJ2-5
TGTGCCATCAGTGAAGATGGGCGGAGCTCCTACGAGCAGTACTTC	CAISEDGRSSYEQYF	TRBV10-3	TRBJ2-7
TGTGCCAGCAGTTTACTGCCGGGACAGGGGGGTCCCTCCTACGAGCAGTACTTC	CASSLLPGQGGPSYEQYF	TRBV12-4	TRBJ2-7
TGTGCCACCAGCAGAGGACCGGGACAGGGACTCAACTATGGCTACACCTTC	CATSRGPGQGLNYGYTF	TRBV15	TRBJ1-2
TGTGCCAGCAGCGAAGGACAGGGTAGCAATCAGCCCCAGCATTTT	CASSEGQGSNQPQHF	TRBV9	TRBJ1-5
TGTGCCACCAAGTCTCCGGGGGAAAGGGGGTTGCCCCAGCATTTT	CATKSPGERGLPQHF	TRBV24-1	TRBJ1-5
TGTGCCAGCAGTGAATACTCAATACAGCAGCACAATGAGCAGTTCTTC	CASSEYSIQQHNEQFF	TRBV6-1	TRBJ2-1
TGTGCCAGCACCGCACTAGCGGGAGTCAACACAGATACGCAGTATTTT	CASTALAGVNTDTQYF	TRBV6-6	TRBJ2-3
TGTGCCAGCAGTTACCCACAGGGAATGGACACCGGGGAGCTGTTTTTT	CASSYPQGMDTGELFF	TRBV6-3	TRBJ2-2
TGCGCCAGCAGCCTACCTTACAGGGGGTACTATGGCTACACCTTC	CASSLPYRGYYGYTF	TRBV5-1	TRBJ1-2
TGTGCCACCAGCCAAGGCCACGAGCAGTACTTC	CATSQGHEQYF	TRBV15	TRBJ2-7
TGTGCCAGCAAGTATCCCGGGACAGTGTATAACTATGGCTACACCTTC	CASKYPGTVYNYGYTF	TRBV12-3	TRBJ1-2
TGTGCCAGCAGCCAACCTAGTCCCCCACTTCCTGACACCGGGGAGCTGTTTTTT	CASSQPSPPLPDTGELFF	TRBV7-9	TRBJ2-2
TGTGCCAGCAGCTTGGCAGCAACTAGGGGGGCTCCTTTTTTGGGCGGGGAGCTGTTTTTT	CASSLAATRGAPFLGGELFF	TRBV7-2	TRBJ2-2
TGTGCCACCACCCACAGCCCTTACGAGCAGTACTTC	CATTHSPYEQYF	TRBV24-1	TRBJ2-7
TGTGCCAGCAGTTTACCCCCTAGGGACAGGGGGCCCGGCTACACCTTC	CASSLPPRDRGPGYTF	TRBV28	TRBJ1-2
TGTGCCAGCAGGTACTCAGGGGACTCCTACGAGCAGTACTTC	CASRYSGDSYEQYF	TRBV9	TRBJ2-7
TGTGCCAGCAGCCTGCCACAGGGGGATTGGAGGCATGAGCAGTACTTC	CASSLPQGDWRHEQYF	TRBV5-4	TRBJ2-7
TGTGCCAGCATAGTGGTGGCGGGAGGAAACACCATATATTTT	CASIVVAGGNTIYF	TRBV6-5	TRBJ1-3
TGTGCCAGCAGCTTAAGACCGCCCTCGGCGGGAACGTATAATTCACCCCTCCACTTT	CASSLRPPSAGTYNSPLHF	TRBV7-2	TRBJ1-6
TGCGCCAGCAGCCGGTGCCCAGGGGAAGATACGCAGTATTTT	CASSRCPGEDTQYF	TRBV10-1	TRBJ2-3
TGCAGAGGTGAAGGTCTTAGGGAGTATAATTCACCCCTCCACTTT	CRGEGLREYNSPLHF	TRBV29-1	TRBJ1-6
TGCGCCAGCAGCCAAGACTTTCCCAACAGGGGAGCATCCCTCCACTTT	CASSQDFPNRGASLHF	TRBV4-1	TRBJ1-6
TGTGCCAGCAGGGGACTAGCGGGCGGAGCACGGGATGAGCAGTTCTTC	CASRGLAGGARDEQFF	TRBV27	TRBJ2-1
TGTGCCAGCAGAGCCACAGGGTTGCTGAACACTGAAGCTTTCTTT	CASRATGLLNTEAFF	TRBV12-3	TRBJ1-1
TGTGCCATCAGTGAGTCGCTAGGTACTAGCCGCAATGAGCAGTTCTTC	CAISESLGTSRNEQFF	TRBV10-3	TRBJ2-1
TGTGCCATCAAACTAGCGGGAGGCAATGAGCAGTTCTTC	CAIKLAGGNEQFF	TRBV10-3	TRBJ2-1
TGTGCCATGCCAATTTTCCGACAGGGAGCTAATGAAAAACTGTTTTTT	CAMPIFRQGANEKLFF	TRBV19	TRBJ1-4
TGTGCCACCAGTGATTGTGGTAGCGGGACTTCCCAAGAGACCCAGTACTTC	CATSDCGSGTSQETQYF	TRBV24-1	TRBJ2-5
TGCAGTGCTAGAGTGCTAGGCCAGACCTACGAGCAGTACTTC	CSARVLGQTYEQYF	TRBV20-1	TRBJ2-7
TGTGCCACCAGCAGCCCCGATTACCCCAGATTGTATGAGCAGTTCTTC	CATSSPDYPRLYEQFF	TRBV15	TRBJ2-1
TGTGCCAGGTCGGCCTACAATGAGCAGTTCTTC	CARSAYNEQFF	TRBV7-2	TRBJ2-1
TGTGCCAGCAGCCAGGGGCAAAGCTCCTACAATGAGCAGTTCTTC	CASSQGQSSYNEQFF	TRBV14	TRBJ2-1
TGTGCCAGCAGTGACGGGTATGGGGGGTTCAATCAGCCCCAGCATTTT	CASSDGYGGFNQPQHF	TRBV6-4	TRBJ1-5
TGTGCCAGCAGTACCAGAGGCACAGATACGCAGTATTTT	CASSTRGTDTQYF	TRBV12-4	TRBJ2-3
TGTGCCAGCAGCAAGGACAGTGGGGGTAACTATGGCTACACCTTC	CASSKDSGGNYGYTF	TRBV9	TRBJ1-2
TGCGCCAGCAGCTTGGCCACTTCCGGGACAGGAATCAACTATGGCTACACCTTC	CASSLATSGTGINYGYTF	TRBV5-1	TRBJ1-2
TGTGCCAGCAGCGCAGCTAAATTCTTTGATACGCAGTATTTT	CASSAAKFFDTQYF	TRBV9	TRBJ2-3
TGTGCCAGCAGAGCACAGGGGGAAAGGTACACTGAAGCTTTCTTT	CASRAQGERYTEAFF	TRBV12-3	TRBJ1-1
TGTGCTAGTCCCCCGGGACAGGGGCTTAGCACAGATACGCAGTATTTT	CASPPGQGLSTDTQYF	TRBV12-5	TRBJ2-3
TGCGCCAGCACCGCACGGAGGGGTAATGAAAAACTGTTTTTT	CASTARRGNEKLFF	TRBV10-1	TRBJ1-4
TGTGCTAGTGGGGGCAGGGGGCGACAAGAGACCCAGTACTTC	CASGGRGRQETQYF	TRBV12-5	TRBJ2-5
TGCAGCGTTGAAAAGCATTCGGGAGGCGAACACGTAAGGTTCCCAACTCTGTTGAACACTGAAGCTTTCTTT	CSVEKHSGGEHVRFPTLLNTEAFF	TRBV29-1	TRBJ1-1
TGTGCCAGCAGCCTGGGGAGAGGTCCCTACGAGCAGTACTTC	CASSLGRGPYEQYF	TRBV5-6	TRBJ2-7
TGTGCCAGCAGCGGACGAGGTCGGGAGACCCAGTACTTC	CASSGRGRETQYF	TRBV7-3	TRBJ2-5
TGCGCCAGCAGATCTGGGGAGGGCGGAAGCAATCAGCCCCAGCATTTT	CASRSGEGGSNQPQHF	TRBV10-1	TRBJ1-5
TGTGCCAGCAGTGAACAGGGGGGCTCCTACGAGCAGTACTTC	CASSEQGGSYEQYF	TRBV6-1	TRBJ2-7
TGTGCTAGCAGCCCCCCGGCGCTCCTCACCGGGGAGCTGTTTTTT	CASSPPALLTGELFF	TRBV7-7	TRBJ2-2
TGCGCCAGCAGCGGGCAGACTGCGAAGGGCTCCTACAATGAGCAGTTCTTC	CASSGQTAKGSYNEQFF	TRBV5-1	TRBJ2-1
TGTGCCAGCAGTTACCCTGTGGACAGGGTAACGGGCTACACCTTC	CASSYPVDRVTGYTF	TRBV6-5	TRBJ1-2
TGTGCCAGCGAGGTTCAAAACACTGAAGCTTTCTTT	CASEVQNTEAFF	TRBV6-1	TRBJ1-1
TGTGCCAGCAGCGGAGAACGAGGGTTGGGGGACATTCAGTACTTC	CASSGERGLGDIQYF	TRBV5-4	TRBJ2-4
TGCAGTGCGGCACTAGGTGTAGAGACCCAGTACTTC	CSAALGVETQYF	TRBV20-1	TRBJ2-5
TGCGCCAGCAGAAGGGGCAGTGGGGACTACACCTTC	CASRRGSGDYTF	TRBV10-1	TRBJ1-2
TGTGCCAGCCCCGTTGCCAAGCCCGGGCAAGAGACCCAGTACTTC	CASPVAKPGQETQYF	TRBV12-3	TRBJ2-5
TGTGCCAGCAGCGGCTGGTTCGGGCTGGACTATGGCTACACCTTC	CASSGWFGLDYGYTF	TRBV13	TRBJ1-2
TGTGCCAGCAGCTTGCGGACTAAGTATAGCAATCAGCCCCAGCATTTT	CASSLRTKYSNQPQHF	TRBV11-2	TRBJ1-5
TGCGCCAGCAGCGGGACAGGGGTCTACTATGGCTACACCTTC	CASSGTGVYYGYTF	TRBV4-1	TRBJ1-2
TGCGCCAGCGAAGAGGGGCTACTGGACAGGCGTAAGATGACCCAGTACTTC	CASEEGLLDRRKMTQYF	TRBV10-1	TRBJ2-5
TGCGCCAGCAGCCTCCCCCCCACAGGCAATCAGCCCCAGCATTTT	CASSLPPTGNQPQHF	TRBV4-1	TRBJ1-5
TGTGCCAGCATTCCCCCGCGGGTGGCGATGCAGTTCTTC	CASIPPRVAMQFF	TRBV2	TRBJ2-1
TGTGCCAGCAGTGAGGAGGACGACCTCTACGAGCAGTACTTC	CASSEEDDLYEQYF	TRBV12-4	TRBJ2-7
TGTGCCAGCGCCCAGGGGGCCGTTCAGCCCCAGCATTTT	CASAQGAVQPQHF	TRBV27	TRBJ1-5
TGTGCCAGCAGCTTACCCCTTTGTGGTCTCCCGGGACAGGGCTCAGAAGGTGCTAACTATGGCTACACCTTC	CASSLPLCGLPGQGSEGANYGYTF	TRBV7-9	TRBJ1-2
TGCAGTGCTAGAGATCTGAACCGGGACCTTCTTTCACCCCTCCACTTT	CSARDLNRDLLSPLHF	TRBV20-1	TRBJ1-6
TGTGCCAGCAGTTGCCGACGGACAGGGAAGGGGAACTACGAGCAGTACTTC	CASSCRRTGKGNYEQYF	TRBV28	TRBJ2-7
TGCAGTGCTACGTGGAGTAGGAGGGAAACTAAGGCTGTCGAAAAACTGTTTTTT	CSATWSRRETKAVEKLFF	TRBV20-1	TRBJ1-4
TGTGCCAGTAGTATCTCACGGCCAAATGGTAACGAGCAGTACTTC	CASSISRPNGNEQYF	TRBV19	TRBJ2-7
TGTGCCACCATGAGGGACAGGGAATGCGCTGAAGCTTTCTTT	CATMRDRECAEAFF	TRBV19	TRBJ1-1
TGCGCCAGCAGCTTGGGGACAGGGAACGAGCAGTACTTC	CASSLGTGNEQYF	TRBV5-1	TRBJ2-7
TGTGCCAGCAGCAGTGGGGGGGGGACGAACGAGCAGTACTTC	CASSSGGGTNEQYF	TRBV7-9	TRBJ2-7
TGTGCCAGCAGCTCAGGGGACTTGGGCTATGGCTACACCTTC	CASSSGDLGYGYTF	TRBV5-4	TRBJ1-2
TGCAGTGCTAGAGATCTGAACCCGGGACTAGCGGGAGTTGTAGCTGAAGCTTTCTTT	CSARDLNPGLAGVVAEAFF	TRBV20-1	TRBJ1-1
TGTGCCAGCAGCCAAGTAGCCACGTACCCGAACACTGAAGCTTTCTTT	CASSQVATYPNTEAFF	TRBV14	TRBJ1-1
TGCGCCAGCAGTGAGGCGACCGGACTAGCGGGGGGGGACCGGGGCGAGCAGTACTTC	CASSEATGLAGGDRGEQYF	TRBV10-1	TRBJ2-7
TGTGCTAGTAAGCATCCAAGGCCCCAGCATTTT	CASKHPRPQHF	TRBV12-5	TRBJ1-5
TGTGCCAGTAGTAGGGGTCGGGCCTACGAGCAGTACTTC	CASSRGRAYEQYF	TRBV19	TRBJ2-7
TGTGCCAGCAGTGCGCATAATGGGGGCGGCTGGGTCGGCTCCTACAATGAGCAGTTCTTC	CASSAHNGGGWVGSYNEQFF	TRBV27	TRBJ2-1
TGTGCCAGCAGCTCTGAGGGCTTTAAGAAGCCCTACCCTAATGAAAAACTGTTTTTT	CASSSEGFKKPYPNEKLFF	TRBV6-4	TRBJ1-4
TGTGCCCCGGGGTCCGGGTGCACAGATACGCAGTATTTT	CAPGSGCTDTQYF	TRBV30	TRBJ2-3
TGTGCCAGCTCACCACGGACCGGGGAGCTGTTTTTT	CASSPRTGELFF	TRBV18	TRBJ2-2
TGCGCCAGCAGCCTGAAGGGGACAGGGGTAGGAAACACCATATATTTT	CASSLKGTGVGNTIYF	TRBV5-1	TRBJ1-3
TGTGCCACCAGTGAGGGGGGCCGACTCTCCGAGCAGTACTTC	CATSEGGRLSEQYF	TRBV24-1	TRBJ2-7
TGTGCCAGCAGTTACGAACATCAGCCAATGTACGAGCAGTACTTC	CASSYEHQPMYEQYF	TRBV6-5	TRBJ2-7
TGTGCCAGCAGTGGGGGGATAAGCTCCTACGAGCAGTACTTC	CASSGGISSYEQYF	TRBV28	TRBJ2-7
TGTGCCAGCAGCTTAGGGGGACAGGGGATTCAGCCCCAGCATTTT	CASSLGGQGIQPQHF	TRBV11-3	TRBJ1-5
TGTGCCAGCCAGGGGAGGTGGTCCTACGAGCAGTACTTC	CASQGRWSYEQYF	TRBV27	TRBJ2-7
TGCGCCAGCAGCCAAGGTGGGACAGGGCGAGGGAATCGTCAGCCCCAGCATTTT	CASSQGGTGRGNRQPQHF	TRBV4-3	TRBJ1-5
TGTGCCAGCAGCTTCCCCGGACTAGCGGGACTAGCCAAAAACATTCAGTACTTC	CASSFPGLAGLAKNIQYF	TRBV11-3	TRBJ2-4
TGCAGTGCCGCCTGGACAGGATACAATGAGCAGTTCTTC	CSAAWTGYNEQFF	TRBV20-1	TRBJ2-1
TGTGCCAGCAGCTGCCGCAATCCCTTCCGAGATACGCAGTATTTT	CASSCRNPFRDTQYF	TRBV7-6	TRBJ2-3
TGTGCCTGGATCCAACGGGTTACCGACAGGGAACGCCAAAACTATGGCTACACCTTC	CAWIQRVTDRERQNYGYTF	TRBV30	TRBJ1-2
TGTGCCAGCAGCGAAGGACCACAGGGGGAAGTCTATGGCTACACCTTC	CASSEGPQGEVYGYTF	TRBV7-2	TRBJ1-2
TGTGCCAGCAGTGACGACTTGCAGTTCTTC	CASSDDLQFF	TRBV25-1	TRBJ2-1
TGTGCCAGCAGTTTATCGTTTCCGGCCTCGCTAGCAGATACGCAGTATTTT	CASSLSFPASLADTQYF	TRBV27	TRBJ2-3
TGTGCCAGCAGTTACTTCGGGGCGCAGACCGGGGAGCTGTTTTTT	CASSYFGAQTGELFF	TRBV6-2	TRBJ2-2
TGTGCCCTAGGGGGCCCGCCCTCCTATAATTCACCCCTCCACTTT	CALGGPPSYNSPLHF	TRBV28	TRBJ1-6
TGTGCCAGCAGTTGGGGCCAAAATGAAAAACTGTTTTTT	CASSWGQNEKLFF	TRBV12-4	TRBJ1-4
TGTGCCAGCAGTTTATCGCATAGGGGAAGCCCAGGACTGTTTTTT	CASSLSHRGSPGLFF	TRBV27	TRBJ1-4
TGTGCCAGCAGCTTAGGAATTAAGGGGCTTGGACAGGCCGAGACCCAGTACTTC	CASSLGIKGLGQAETQYF	TRBV7-4	TRBJ2-5
TGTGCCAGCAGCAAGATTGAGCGGGACGAAGGACAGAACACTGAAGCTTTCTTT	CASSKIERDEGQNTEAFF	TRBV4-2	TRBJ1-1
TGTGCCAGCAGCTTGGCCTACAGGGAGCGCTATGGCTACACCTTC	CASSLAYRERYGYTF	TRBV5-8	TRBJ1-2
TGTGCCAGCAGTGAATCGAGACAGGGTACCCCGAGGGTTAGCTCCTACAATGAGCAGTTCTTC	CASSESRQGTPRVSSYNEQFF	TRBV6-1	TRBJ2-1
TGTGCCAGCAGCTGTGGTACCAGGAGAAATCAGCCCCAGCATTTT	CASSCGTRRNQPQHF	TRBV11-3	TRBJ1-5
TGTGCCAGCCCACAACCGACAGCCCGTAGCAATCAGCCCCAGCATTTT	CASPQPTARSNQPQHF	TRBV3-1	TRBJ1-5
TGTGCCAGCAGGACAGGGGTTGGGAAGAGGTTCTTCTTT	CASRTGVGKRFFF	TRBV27	TRBJ1-1
TGTGCCACCAGTGATCTCCGACAGACCCCCGGCTCCTACGAGCAGTACTTC	CATSDLRQTPGSYEQYF	TRBV24-1	TRBJ2-7
TGCGCCAGCAGCTTACGCACAGGGCGTAAGGCGAACACTGAAGCTTTCTTT	CASSLRTGRKANTEAFF	TRBV5-1	TRBJ1-1
TGCGCCAGCAGCGGCAGGGATCCCTATGGCTACACCTTC	CASSGRDPYGYTF	TRBV4-1	TRBJ1-2
TGTGCCAGCAGCCATTGCCACAGGGGGCCGCCTAGAAACACCTTC	CASSHCHRGPPRNTF	TRBV3-1	TRBJ1-2
TGTGCCAGCAGACAGGGCGGCTACGAGCAGTACTTC	CASRQGGYEQYF	TRBV11-3	TRBJ2-7
TGCGCCAGCAGCAGGGGACTCTATGGCTACACCTTC	CASSRGLYGYTF	TRBV10-2	TRBJ1-2
TGTGCCATTGTGGGGACAGGGGGGGGTAATGAAAAACTGTTTTTT	CAIVGTGGGNEKLFF	TRBV10-3	TRBJ1-4
TGTGCCAGATCTGGGGCCAACGTCCTGACTTTC	CARSGANVLTF	TRBV5-6	TRBJ2-6
TGTGCCAGCACATACGACAGGCATCTTGCCTCCTACGAGCAGTACTTC	CASTYDRHLASYEQYF	TRBV6-4	TRBJ2-7
TGTGCCAGCAGCGGAGAGCGGAGTTACACCTACAATGAGCAGTTCTTC	CASSGERSYTYNEQFF	TRBV5-5	TRBJ2-1
TGTGCCAGCTGCTCAAGGGGGGCAGAGGCGGACAGGGCCGGAGATACGCAGTATTTT	CASCSRGAEADRAGDTQYF	TRBV27	TRBJ2-3
TGCAGCTTGGTTGGGCCGGGACTAGACCAAGAGACCCAGTACTTC	CSLVGPGLDQETQYF	TRBV29-1	TRBJ2-5
TGTGCCAGCAGCTTATCCAGTAGCGCGAACACCGGGGAGCTGTTTTTT	CASSLSSSANTGELFF	TRBV7-2	TRBJ2-2
TGTGCCAGCAACACTAACACTGAAGCTTTCTTT	CASNTNTEAFF	TRBV6-6	TRBJ1-1
TGCAGTGCTAGAGATCCCCCGGGACAGGGGGCTAGCAATCAGCCCCAGCATTTT	CSARDPPGQGASNQPQHF	TRBV20-1	TRBJ1-5
TGTGCCAGTAGGTCGGCGTGCGGGGATACGCAGTATTTT	CASRSACGDTQYF	TRBV19	TRBJ2-3
TGTGCCAGCAGTTTCGTCCTACAGGAGAGCAATCAGCCCCAGCATTTT	CASSFVLQESNQPQHF	TRBV12-3	TRBJ1-5
TGTGCCAGCAGTGAACCCCGGGATTCCTATGGCTACACCTTC	CASSEPRDSYGYTF	TRBV2	TRBJ1-2
TGTGCCAGCAGCCAACCCGGGCAGGGGTCTTGCTACGAGCAGTACTTC	CASSQPGQGSCYEQYF	TRBV4-2	TRBJ2-7
TGTGCCAGTAGTAGTACGACAGGCACAGATACGCAGTATTTT	CASSSTTGTDTQYF	TRBV19	TRBJ2-3
TGTGCCAGCAGCTTGCTAATTCCCTATGACACCGGGGAGCTGTTTTTT	CASSLLIPYDTGELFF	TRBV5-4	TRBJ2-2
TGCAGTGCTAGAGGGGTCGGAGACTATGGCTACACCTTC	CSARGVGDYGYTF	TRBV20-1	TRBJ1-2
TGTGCCAGCAGCTTAGCGGGACAGGGGGTATCTGGAAACACCATATATTTT	CASSLAGQGVSGNTIYF	TRBV7-8	TRBJ1-3
TGCAGTGCTCCGTGGGGGACAGGGGAGGTAAGCTATGGCTACACCTTC	CSAPWGTGEVSYGYTF	TRBV20-1	TRBJ1-2
TGTGCTAGCAGCTTAGATGCACGTGGAGAGAATCAGCCCCAGCATTTT	CASSLDARGENQPQHF	TRBV7-7	TRBJ1-5
TGCAGTGCTAGAGGGGGTTGCCCAGGTAACTCTGGGGCCAACGTCCTGACTTTC	CSARGGCPGNSGANVLTF	TRBV20-1	TRBJ2-6
TGTGCCAGCAGTGAGGCCAGAGGTTCTGAAGCTTTCTTT	CASSEARGSEAFF	TRBV6-4	TRBJ1-1
TGTGCCAGCAGCCAGGAAGGGAACACCGGGGAGCTGTTTTTT	CASSQEGNTGELFF	TRBV13	TRBJ2-2
TGTGCCAGCAGGTCCGGACAGGGTTTCGAGCAGTACTTC	CASRSGQGFEQYF	TRBV6-2	TRBJ2-7
TGTGCCAGTAGTATACGTCGGGGGTATTTTGGTGGCTACACCTTC	CASSIRRGYFGGYTF	TRBV19	TRBJ1-2
TGTGCCATCAGCCCAGTTGAAAACACTGAAGCTTTCTTT	CAISPVENTEAFF	TRBV10-3	TRBJ1-1
TGTGCCAGCAGTTCAAAGTCCTATAATTCACCCCTCCACTTT	CASSSKSYNSPLHF	TRBV27	TRBJ1-6
TGTGCCAGCAGCTTAGAGCGGGAGAGGAAGTATGGCTACACCTTC	CASSLERERKYGYTF	TRBV7-9	TRBJ1-2
TGTGCCAGCAGCCAGGGACGGGATGAGCAGTTCTTC	CASSQGRDEQFF	TRBV5-5	TRBJ2-1
TGTGCCACCGCCAGTCGGGAGCTGAAAAGGGTTAAGGGCTACACCTTC	CATASRELKRVKGYTF	TRBV24-1	TRBJ1-2
TGTGCCAGTAGTATAGATCACAGTAAGGACAGAGCCAAAAACATTCAGTACTTC	CASSIDHSKDRAKNIQYF	TRBV19	TRBJ2-4
TGTGCCAGCAGCCCGTATCTGGTAGAACCGGCCCGGGCCGGTGGGGGACACAATGAGCAGTTCTTC	CASSPYLVEPARAGGGHNEQFF	TRBV12-4	TRBJ2-1
TGTGCCAGCAGTGAAATTAGGGAGCAGGCGACCTCTGGGGCCAACGTCCTGACTTTC	CASSEIREQATSGANVLTF	TRBV6-4	TRBJ2-6
TGTGCCAGCTCACGATCTCGGGACGGAGAGACCCAGTACTTC	CASSRSRDGETQYF	TRBV18	TRBJ2-5
TGTGCCAGCAGCTTTGTGCGTGGGATCGGGGGGACCTACGAGCAGTACTTC	CASSFVRGIGGTYEQYF	TRBV13	TRBJ2-7
TGTGCCAGCAGTAAGGGACAGCGGGTCCGCAGCACAGATACGCAGTATTTT	CASSKGQRVRSTDTQYF	TRBV27	TRBJ2-3
TGTGCCAGCAGTTACCGGTCCAGGGGAAGGGGTAGCAATGAGCAGTTCTTC	CASSYRSRGRGSNEQFF	TRBV6-3	TRBJ2-1
TGTGCCATCAGTGAGTCGTCAGGGTCGAGCTACGAGCAGTACTTC	CAISESSGSSYEQYF	TRBV10-3	TRBJ2-7
TGCGCCAGCAGCTCCCATGGGAGCTACGAGCAGTACTTC	CASSSHGSYEQYF	TRBV5-1	TRBJ2-7
TGTGCCAGCTTAAGGACGACAGATACGCAGTATTTT	CASLRTTDTQYF	TRBV6-4	TRBJ2-3
TGTGCCATCACGAATACGGGGGGGGAGGAGGGGGAAGGAGATACGCAGTATTTT	CAITNTGGEEGEGDTQYF	TRBV10-3	TRBJ2-3
TGTGCCAGCAGCTCAGTAGCGGGGAAAGTAGAGACCCAGTACTTC	CASSSVAGKVETQYF	TRBV12-3	TRBJ2-5
TGTGCCAGCATGGGGGGGGGGCGATTGCAGTTCTTC	CASMGGGRLQFF	TRBV12-3	TRBJ2-1
TGTGCCAGCTCGCGGGGCAACGAGCAGTACTTC	CASSRGNEQYF	TRBV5-5	TRBJ2-7
TGTGCCAGTAGTATGGGGACCCGGGTCAATGAGCAGTTCTTC	CASSMGTRVNEQFF	TRBV19	TRBJ2-1
TGTGCCAGCTCGACTAGCGGGAGAGTTAATGAGACCCAGTACTTC	CASSTSGRVNETQYF	TRBV6-6	TRBJ2-5
TGTGCCAGCAGGGTTAGAGGGGACCACACCGGGGAGCTGTTTTTT	CASRVRGDHTGELFF	TRBV12-3	TRBJ2-2
TGTGCCAGCAGTGCGTCGTGGGGGCTGAGCTCCTACGAGCAGTACTTC	CASSASWGLSSYEQYF	TRBV6-1	TRBJ2-7
TGTGCCAGTAGTATTTACACCGGCACTGAAGCTTTCTTT	CASSIYTGTEAFF	TRBV19	TRBJ1-1
TGTGCCACCAGTGGAGAAACCACAGGGGTGGGAGATACGCAGTATTTT	CATSGETTGVGDTQYF	TRBV24-1	TRBJ2-3
TGTGCCAGCAGTTACCCAACCGGGACAGGGCCGGGGATGAACACTGAAGCTTTCTTT	CASSYPTGTGPGMNTEAFF	TRBV6-2	TRBJ1-1
TGTGCCAGCAGTTACCAGGGCACAGGTGGCCACCGTTACTATGGCTACACCTTC	CASSYQGTGGHRYYGYTF	TRBV6-5	TRBJ1-2
TGTGCCACTCCAGGGAACTACGAGCAGTACTTC	CATPGNYEQYF	TRBV6-1	TRBJ2-7
TGTGCCAGCAGCCATCCGATGGAGGACGATGGCTACACCTTC	CASSHPMEDDGYTF	TRBV3-1	TRBJ1-2
TGTGCCAGCAGCGGGGCCTTTATTGGATTGGCTCCTGGCTATGGCTACACCTTC	CASSGAFIGLAPGYGYTF	TRBV9	TRBJ1-2
TGTGCCAGCAGCTTCCGGGACGGGGGAAGATATGAGCAGTTCTTC	CASSFRDGGRYEQFF	TRBV11-2	TRBJ2-1
TGTGCCAGCAGCTTAGAATCGGCCATGAGGAGCAATCAGCCCCAGCATTTT	CASSLESAMRSNQPQHF	TRBV7-9	TRBJ1-5
TGCAGTGCTAGAGATCAATACGAATTCGGGGGCGCCGGTACCAAAAACATTCAGTACTTC	CSARDQYEFGGAGTKNIQYF	TRBV20-1	TRBJ2-4
TGTGCCAGCAGCCAAGAAGAGGTGGGAACCTCCTACGAGCAGTACTTC	CASSQEEVGTSYEQYF	TRBV3-1	TRBJ2-7
TGTGCCTGGGAAGACAGGTGGGAGACCCAGTACTTC	CAWEDRWETQYF	TRBV30	TRBJ2-5
TGTGCCAGCAGTGCAGCCGACAGGGGCAGAGATGAAAAACTGTTTTTT	CASSAADRGRDEKLFF	TRBV25-1	TRBJ1-4
TGCGCCAGCAGCGGGACTCACTACGAGCAGTACTTC	CASSGTHYEQYF	TRBV5-1	TRBJ2-7
TGTGCCTGGAGTGCCCTTTCGGGACAGGAGGGCGAGCAGTACTTC	CAWSALSGQEGEQYF	TRBV30	TRBJ2-7
TGTGCCAGCAGGTACTACGAGCAGTACTTC	CASRYYEQYF	TRBV14	TRBJ2-7
TGTGCCACCAGTGATTTGATAGCCTTCTCTAGCGGAAGGGGATACGAGCAGTACTTC	CATSDLIAFSSGRGYEQYF	TRBV24-1	TRBJ2-7
TGTGCCAGCAGGGGAGGGACTGAGGCCTACGAGCAGTACTTC	CASRGGTEAYEQYF	TRBV2	TRBJ2-7
TGTGCCAGCAGGTTTCCGCCTAAGGGACAGGGGGATATTGAGTGCAATCAGCCCCAGCATTTT	CASRFPPKGQGDIECNQPQHF	TRBV12-4	TRBJ1-5
TGTGCCAGCAGCTTGCGGACCGAGCACCGAAGACAGGCTCACACTGAAGCTTTCTTT	CASSLRTEHRRQAHTEAFF	TRBV5-5	TRBJ1-1
TGTGCCAGCAGCTTATGGGGGACTGAGACTGAAGCTTTCTTT	CASSLWGTETEAFF	TRBV7-2	TRBJ1-1
TGTGCCAGCAGCGGGTGGCCGACACCTGAAAAACTGTTTTTT	CASSGWPTPEKLFF	TRBV13	TRBJ1-4
TGCAGTGCTAGAGACCCGGCGCAGGACAGGGGTTATCCCCTGAGCTCCTACGAGCAGTACTTC	CSARDPAQDRGYPLSSYEQYF	TRBV20-1	TRBJ2-7
TGTGCCAGCAGCCAAAATAAGTGTCGGTCGGTGCCGAGGGACGTATGCTACACCTTC	CASSQNKCRSVPRDVCYTF	TRBV7-9	TRBJ1-2
TGTGCCAGCAGCAAACCTGGACAGGGGGGTCCGGATGGCTACACCTTC	CASSKPGQGGPDGYTF	TRBV7-9	TRBJ1-2
TGTGCCAGCAACGTGACGGACATCTGTTATACGCAGTATTTT	CASNVTDICYTQYF	TRBV6-3	TRBJ2-3
TGTGCCAGCAGCCCAGCTCTGGTGCTTGTTCTCTACGAGCAGTACTTC	CASSPALVLVLYEQYF	TRBV13	TRBJ2-7
TGTGCCAGCATTGGGACGGGGACAGGATGCCCCCCAACTAACTATGGCTACACCTTC	CASIGTGTGCPPTNYGYTF	TRBV12-3	TRBJ1-2
TGTGCCAGCAGCACGGGACAAGGGTGGGATGAAAAACTGTTTTTT	CASSTGQGWDEKLFF	TRBV5-6	TRBJ1-4
TGTGCCAGCAGTTATTCATCCCGCAGAAGGGACAGGGGGGGTCCAGCTTTCTTT	CASSYSSRRRDRGGPAFF	TRBV6-9	TRBJ1-1
TGCAGTGCTAGTACGGACAGGAGCTCCTACGAGCAGTACTTC	CSASTDRSSYEQYF	TRBV20-1	TRBJ2-7
TGTGCCAGCAGTGACCCCTGGACAGGGGAGGACTGCGAGCAGTACTTC	CASSDPWTGEDCEQYF	TRBV6-1	TRBJ2-7
TGCAGCGTTGAAGAGGGACCCGAAAACACCGGGGAGCTGTTTTTT	CSVEEGPENTGELFF	TRBV29-1	TRBJ2-2
TGTGCCAGCAGTTTATCCGAAATACAGGGGGGAAAGTCCTACGAGCAGTACTTC	CASSLSEIQGGKSYEQYF	TRBV28	TRBJ2-7
TGCAGTGCTAGAGACGCCACGGGCCGGAATGAAGCTTTCTTT	CSARDATGRNEAFF	TRBV20-1	TRBJ1-1
TGTGCCAGAGCGAACAGGGGGCGTAACTATGGCTACACCTTC	CARANRGRNYGYTF	TRBV19	TRBJ1-2
TGCAGTGCTAGAGATATCAAGTGGACAGGGGGGTCTGGCTACACCTTC	CSARDIKWTGGSGYTF	TRBV20-1	TRBJ1-2
TGTGCCAGCAAGCGGCGTCATGAGCAGTTCTTC	CASKRRHEQFF	TRBV28	TRBJ2-1
TGTGCCATTTGGGGGGAAATCCGGCTCCATGGCTACACCTTC	CAIWGEIRLHGYTF	TRBV6-5	TRBJ1-2
TGCAGTGCATTGGGCCGGGGGGGCAGCATCGGAGGTAAGTATAGCAATCAGCCCCAGCATTTT	CSALGRGGSIGGKYSNQPQHF	TRBV20-1	TRBJ1-5
TGTGCCAGCAAGGCAACAGGGGAGAATGAAAAACTGTTTTTT	CASKATGENEKLFF	TRBV5-4	TRBJ1-4
TGTGCCAGCAGTATACAGGGGTTAAGGGCCTATGGCTACACCTTC	CASSIQGLRAYGYTF	TRBV12-3	TRBJ1-2
TGCGCCAGCAGCTCAGGGACAGGGAAGAACTATGGCTACACCTTC	CASSSGTGKNYGYTF	TRBV5-1	TRBJ1-2
TGTGCCAGCAGCGGCCGCTGGGCCGGGACAGGACTGGGCGAGCAGTACTTC	CASSGRWAGTGLGEQYF	TRBV11-2	TRBJ2-7
TGTGCCAGCAGCCCCACTAGCGGGAGCAGGGGCTACGAGCAGTACTTC	CASSPTSGSRGYEQYF	TRBV2	TRBJ2-7
TGCGCCCGGACAGCCAACGGCTACACTGAAGCTTTCTTT	CARTANGYTEAFF	TRBV10-1	TRBJ1-1
TGCGCCAGCAGCCAAGATAATCAGACGGGAGGGCCCCAGCATTTT	CASSQDNQTGGPQHF	TRBV4-1	TRBJ1-5
TGTGCCAGCAGCGGGGGGCGCGAGAGCATGAACACTGAAGCTTTCTTT	CASSGGRESMNTEAFF	TRBV9	TRBJ1-1
TGTGCCACCAGTGATTTGCCCCCGACTAGCTCCTACAATGAGCAGTTCTTC	CATSDLPPTSSYNEQFF	TRBV24-1	TRBJ2-1
TGTGCCAGCAGCTGCCCTCCTGTTTTCCTACCTATACATAAAGAGACCCAGTACTTC	CASSCPPVFLPIHKETQYF	TRBV5-6	TRBJ2-5
TGTGCCAGCAGCGTAGGGGGGGACATAGATACGCAGTATTTT	CASSVGGDIDTQYF	TRBV9	TRBJ2-3
TGTGCCAGCAGCGTTGGGAGGGCCCCGGACAATGAGCAGTTCTTC	CASSVGRAPDNEQFF	TRBV13	TRBJ2-1
TGTGCCAGCAGACCACAGGGGAATAACGAGCAGTACTTC	CASRPQGNNEQYF	TRBV7-2	TRBJ2-7
TGTGCCAGCAGCTTGGGACTAGAGTGGGCGGCCGGGGAGCTGTTTTTT	CASSLGLEWAAGELFF	TRBV7-9	TRBJ2-2
TGTGCCATATGGGGACAGATGTCCTACGAGCAGTACTTC	CAIWGQMSYEQYF	TRBV24-1	TRBJ2-7
TGTGCCAGCAGTACCGGACGCGGGTTTTACAATGAGCAGTTCTTC	CASSTGRGFYNEQFF	TRBV28	TRBJ2-1
TGCAGTGCTATTTCAGGGCCCGTTGACTATGGCTACACCTTC	CSAISGPVDYGYTF	TRBV20-1	TRBJ1-2
TGTGCCTGGAGTTGCCCGAGGGGCAATCAGCCCCAGCATTTT	CAWSCPRGNQPQHF	TRBV30	TRBJ1-5
TGCGCCAGCACATGGGACACCAACTATGGCTACACCTTC	CASTWDTNYGYTF	TRBV10-2	TRBJ1-2
