TGTGCCAGCAGCAACCTATTGAAACCAGATACGCAGTATTTT	CASSNLLKPDTQYF	TRBV5-4	TRBJ2-3
TGTGCCAGCGGAGACAGGGACACTGAAGCTTTCTTT	CASGDRDTEAFF	TRBV5-4	TRBJ1-1
TGTGCCAGCAGCTTAAAATCGTTGGGTCAGCCCCAGCATTTT	CASSLKSLGQPQHF	TRBV7-4	TRBJ1-5
TGTGCCAGCAGCCAAGATGGGGCAGGGGGGCGGGACAGCTCTAATCAGCCCCAGCATTTT	CASSQDGAGGRDSSNQPQHF	TRBV4-2	TRBJ1-5
TGCGCCAGCAGCGATAGACAGGGGACCTACGAGCAGTACTTC	CASSDRQGTYEQYF	TRBV10-1	TRBJ2-7
TGTGCCAGCCGACAGGGGGATATCTTCTACGAGCAGTACTTC	CASRQGDIFYEQYF	TRBV6-2	TRBJ2-7
TGTGCCAGCAGTGCGCGGGACGCCTACGAGCAGTACTTC	CASSARDAYEQYF	TRBV2	TRBJ2-7
TGTGCCAGCAGGCACGCCGGGGGGATGAGGGGTAATGAAAAACTGTTTTTT	CASRHAGGMRGNEKLFF	TRBV6-5	TRBJ1-4
TGCAGCGTTAGCGGACAGGGAGCGGACGAGCAGTACTTC	CSVSGQGADEQYF	TRBV29-1	TRBJ2-7
TGTGCCAGCAGCCCTCTTTCGGGACAGGGAGAGACCCAGTACTTC	CASSPLSGQGETQYF	TRBV7-9	TRBJ2-5
TGTGCCCTCCCGATTATGTACAGGGGAGAGAACACTGAAGCTTTCTTT	CALPIMYRGENTEAFF	TRBV19	TRBJ1-1
TGTGCCAGCAGCCAAGATAAAGTAAGGTCCGGGACAGGCATGAACACTGAAGCTTTCTTT	CASSQDKVRSGTGMNTEAFF	TRBV3-1	TRBJ1-1
TGTGCCAACGGGGGGGGGGGAGAGCAGTTCTTC	CANGGGGEQFF	TRBV6-1	TRBJ2-1
TGCGCCAGCAGCTTGGTCCTCCTGGGACAGGGGGCTAATAATGAAAAACTGTTTTTT	CASSLVLLGQGANNEKLFF	TRBV5-1	TRBJ1-4
TGTGCCAGCAGCTGGAGACCCTACGAGCAGTACTTC	CASSWRPYEQYF	TRBV7-9	TRBJ2-7
TGTGCCAGCAGCACGGAGACCCAGTACTTC	CASSTETQYF	TRBV3-1	TRBJ2-5
TGTGCCAGCAGTTCAGCAGGGGGCCAGCCCCAGCATTTT	CASSSAGGQPQHF	TRBV6-6	TRBJ1-5
TGTGCCAGCAGCTCTAGCTCTGTATCATGCTACAATGAGCAGTTCTTC	CASSSSSVSCYNEQFF	TRBV5-4	TRBJ2-1
TGCGCCAGCAGCTTCATTCAGGACGGCTACGAGCAGTACTTC	CASSFIQDGYEQYF	TRBV5-1	TRBJ2-7
TGCGCCAGCAGCCTTTCGGGGGCGTTAGAGCAGTTCTTC	CASSLSGALEQFF	TRBV4-1	TRBJ2-1
TGTGCCAGCAGCGAGCTGGGGGGGTTACCGGAGACCCAGTACTTC	CASSELGGLPETQYF	TRBV13	TRBJ2-5
TGCGCCAGCAGTGAGGCGCCTTCGGCAACGGGGTGGGCGGAAAAAGAGACCCAGTACTTC	CASSEAPSATGWAEKETQYF	TRBV10-2	TRBJ2-5
TGCAGTGCTAGGCCGACAGGTACCGTGAACCATCAGCCCCAGCATTTT	CSARPTGTVNHQPQHF	TRBV20-1	TRBJ1-5
TGTGCCAGCAGCCCAAACCACTTCCAACCGGGACTAGCGGGTAAAGAAGCCTACGAGCAGTACTTC	CASSPNHFQPGLAGKEAYEQYF	TRBV6-4	TRBJ2-7
TGTGCCAGACCACGCTTAGGGACAGGGAGCTACGAGCAGTACTTC	CARPRLGTGSYEQYF	TRBV2	TRBJ2-7
TGTGCCAGCAGTCACGCACCCCGTGAGGGGGAGCAGTACTTC	CASSHAPREGEQYF	TRBV6-2	TRBJ2-7
TGTGCCAGCAGTTTATCGCCGAAGGGACTCACCACAGATACGCAGTATTTT	CASSLSPKGLTTDTQYF	TRBV27	TRBJ2-3
TGTGCCAGCAGCGGTCGGACAGGTCGGTATAGCAATCAGCCCCAGCATTTT	CASSGRTGRYSNQPQHF	TRBV7-2	TRBJ1-5
TGCGCCAGCATATGGGAGGACTCTAAGGGGTATAATTCACCCCTCCACTTT	CASIWEDSKGYNSPLHF	TRBV5-1	TRBJ1-6
TGTGCCAGCAGTGACGCTCAGGGTGCGAGTGAAAAACTGTTTTTT	CASSDAQGASEKLFF	TRBV6-4	TRBJ1-4
TGCGCCAGCAGTGACAGGTCGGACAGGGGGGGAGTTCATGGCTACACCTTC	CASSDRSDRGGVHGYTF	TRBV10-1	TRBJ1-2
TGTGCCAGCAGCCAATGTCAGACCCACCAGCCCCAGCATTTT	CASSQCQTHQPQHF	TRBV14	TRBJ1-5
TGTGCCACCCATGACAGGGGTCTGGATAATTCACCCCTCCACTTT	CATHDRGLDNSPLHF	TRBV15	TRBJ1-6
TGCGCCAGCAGTACCAAACCTGAAGCGGGACACCAGAGCTCCTACGAGCAGTACTTC	CASSTKPEAGHQSSYEQYF	TRBV10-1	TRBJ2-7
TGTGCCCCTACTTGGACAGGGTCCTACAATGAGCAGTTCTTC	CAPTWTGSYNEQFF	TRBV5-5	TRBJ2-1
TGCAGTGCTGTTGGGGGCAGTCTGTGCAATCAGCCCCAGCATTTT	CSAVGGSLCNQPQHF	TRBV20-1	TRBJ1-5
TGCAGTGCTGCAATCCGCTCTGGGGCCAACGTCCTGACTTTC	CSAAIRSGANVLTF	TRBV20-1	TRBJ2-6
TGTGCCAGCAGGCGGGGGGTGAACACTGAAGCTTTCTTT	CASRRGVNTEAFF	TRBV25-1	TRBJ1-1
TGTGCCAGCAGTTACTCCCCAGGGGAGCGCCATTCACCCCTCCACTTT	CASSYSPGERHSPLHF	TRBV6-5	TRBJ1-6
TGCGCGGGACAGGGGGCAAATTGCAATCAGCCCCAGCATTTT	CAGQGANCNQPQHF	TRBV20-1	TRBJ1-5
TGTGCCAGCAGCTCATCCCCGGACACTGAAGCTTTCTTT	CASSSSPDTEAFF	TRBV7-9	TRBJ1-1
TGTGCCAGCAGAATCCGGGACCGGCCCGGGGAGCTGTTTTTT	CASRIRDRPGELFF	TRBV7-7	TRBJ2-2
TGTGCCAGCACCCTCACCAATATGGCCGGGACAGCCCAGCATTTT	CASTLTNMAGTAQHF	TRBV27	TRBJ1-5
TGTGCCAGCAGCTTCCCCCCGTGGGGGGGCGATGAGCAGTTCTTC	CASSFPPWGGDEQFF	TRBV5-6	TRBJ2-1
TGCGCCAGCAGCAGCCCCACCAAGGGTCCTACGGGACAGGGGGCCACCGTCTTCTCCTACGAGCAGTACTTC	CASSSPTKGPTGQGATVFSYEQYF	TRBV5-1	TRBJ2-7
TGTGCCAGCAGCGATGGGATAAGGCCAGAGGAGGTTTACAATGAGCAGTTCTTC	CASSDGIRPEEVYNEQFF	TRBV13	TRBJ2-1
TGTGCCAGCAACCTAAACCGACTTGGAGACTTGTTCCCTCAGTACTTC	CASNLNRLGDLFPQYF	TRBV6-2	TRBJ2-5
TGTGCCAGCAGTTGCATCTTGTCCCTCACAGGGGAGACGAGCTCCTATAATTCACCCCTCCACTTT	CASSCILSLTGETSSYNSPLHF	TRBV2	TRBJ1-6
TGTGCCAGCAGCTACCGGGAGTTAGCAGATACGCAGTATTTT	CASSYRELADTQYF	TRBV11-2	TRBJ2-3
TGTGCCAGCAGCCAAGATGGAGGCCCACAGGGCCCCTTCTCCTACGAGCAGTACTTC	CASSQDGGPQGPFSYEQYF	TRBV14	TRBJ2-7
TGCGCCAGCAGCTTACAGGGGGTTAGTTCCTACGAGCAGTACTTC	CASSLQGVSSYEQYF	TRBV5-1	TRBJ2-7
TGTGCCAGCAGCCAAGAAACCGGACGGAAGGAGCAGTACTTC	CASSQETGRKEQYF	TRBV3-1	TRBJ2-7
TGTGCCAGCAGTTACAATCGCCCGGGGTTCTCTACGGCAGATACGCAGTATTTT	CASSYNRPGFSTADTQYF	TRBV6-3	TRBJ2-3
TGTGCCAGTGGGCCTAAGGGGGGACCAGGGGGCTTGTTAGAAATCTACAATGAGCAGTTCTTC	CASGPKGGPGGLLEIYNEQFF	TRBV19	TRBJ2-1
TGTGCCAGCAGCCACCGACAGGGGGCCTATGGCTACACCTTC	CASSHRQGAYGYTF	TRBV7-3	TRBJ1-2
TGTGCCAGCAGCTTCACCTGGGACAGGGCGCGCAATCAGCCCCAGCATTTT	CASSFTWDRARNQPQHF	TRBV7-9	TRBJ1-5
TGTGCCAGCAGCGTAGCCCCCCCGGGACAGGGCTACGAGCAGTACTTC	CASSVAPPGQGYEQYF	TRBV9	TRBJ2-7
TGCAGTGCTCGGCTTCTAGGACTAGCGGGTGGTCTTCCCTACGAGCAGTACTTC	CSARLLGLAGGLPYEQYF	TRBV20-1	TRBJ2-7
TGTGCCAGCAGTGAACTTGGACAGTTCACAGATACGCAGTATTTT	CASSELGQFTDTQYF	TRBV6-4	TRBJ2-3
TGTGCCAGCAGCCAAGATGTAAGACACCGGGACAGTTTTATCTCTGGGGCCAACGTCCTGACTTTC	CASSQDVRHRDSFISGANVLTF	TRBV4-2	TRBJ2-6
TGTGCTAGTGGTTTGGTACACGGCGGGAGATACCCCTCTGGGGCCAACGTCCTGACTTTC	CASGLVHGGRYPSGANVLTF	TRBV12-5	TRBJ2-6
TGTGCCAGCAGCCCTGCGGGAGTGAGACTTAGCAATCAGCCCCAGCATTTT	CASSPAGVRLSNQPQHF	TRBV11-1	TRBJ1-5
TGTGCCAGCAGTAGGGACAGGGCCACTGGAAACACCATATATTTT	CASSRDRATGNTIYF	TRBV6-1	TRBJ1-3
TGTGCCAGCAGCTCGCCCAGGGGGGCAATCTACGAGCAGTACTTC	CASSSPRGAIYEQYF	TRBV11-1	TRBJ2-7
TGCAGTGCTAGAGGGGGCGGGAGCAAAGAGACCCAGTACTTC	CSARGGGSKETQYF	TRBV20-1	TRBJ2-5
TGCGCCAGACGACGCCGGGCGTACGAGCAGTACTTC	CARRRRAYEQYF	TRBV4-1	TRBJ2-7
TGCGCCAGCAGCCAAGAGGTTGCTCGGGGGGGTCACAATGAGCAGTTCTTC	CASSQEVARGGHNEQFF	TRBV4-1	TRBJ2-1
TGTGCCAGCAGTTTACTCCCCGGGACTAGAGCCGGGGAGCTGTTTTTT	CASSLLPGTRAGELFF	TRBV12-4	TRBJ2-2
TGTGCCAGCAGCTCGCTAGGAGGAGGGGCGGAAAAACTGTTTTTT	CASSSLGGGAEKLFF	TRBV11-3	TRBJ1-4
TGTGCCACCTCGGGGCTTCTAGCCAAAAACATTCAGTACTTC	CATSGLLAKNIQYF	TRBV24-1	TRBJ2-4
TGTGCCAGTAGTATAGCCCTAGCGGGCACGTGGCAAGAGACCCAGTACTTC	CASSIALAGTWQETQYF	TRBV19	TRBJ2-5
TGTGCCAGCAGGGACCAGGTGCGGGAGAGCACAGATACGCAGTATTTT	CASRDQVRESTDTQYF	TRBV7-4	TRBJ2-3
TGTGCCAGTAGTATGGCACACTGTGAATACGAGCAGTACTTC	CASSMAHCEYEQYF	TRBV19	TRBJ2-7
TGTGCCAGCAGCCCCTCGGGCTGGGGAGGTAAGACCCAGTACTTC	CASSPSGWGGKTQYF	TRBV4-2	TRBJ2-5
TGTGCCAGCAGCGCGTCTACCACAGATACGCAGTATTTT	CASSASTTDTQYF	TRBV13	TRBJ2-3
TGTGCCAGCAGCTTGCTAGCGGGTCAAGAGACCCAGTACTTC	CASSLLAGQETQYF	TRBV7-2	TRBJ2-5
TGTGCTAGTGGTTTGGTACTAGATAGGGACAGGGCTTTCTTT	CASGLVLDRDRAFF	TRBV12-5	TRBJ1-1
TGTGCCAGCAGCCACAGGGGGGAGAACACCGGGGAGCTGTTTTTT	CASSHRGENTGELFF	TRBV3-1	TRBJ2-2
TGTGCCAGCAGCGCGGGACCGACCACAGATACGCAGTATTTT	CASSAGPTTDTQYF	TRBV28	TRBJ2-3
TGTGCCAGCAGCACGAGGGTAAGACAGAACACTGAAGCTTTCTTT	CASSTRVRQNTEAFF	TRBV7-2	TRBJ1-1
TGCGCCAATAGGCGGGGGGGGCCAAAAGATACGCAGTATTTT	CANRRGGPKDTQYF	TRBV5-1	TRBJ2-3
TGTGCCACCAGCAGAGAGTCCGCCAGGGACTCCTACGAGCAGTACTTC	CATSRESARDSYEQYF	TRBV15	TRBJ2-7
TGTGCCAGCAGTCTCTCACGCAATCAGCCCCAGCATTTT	CASSLSRNQPQHF	TRBV6-4	TRBJ1-5
TGTGCCACCAGTGATTTGCACCGACGGACAGGAGAAAAACTGTTTTTT	CATSDLHRRTGEKLFF	TRBV24-1	TRBJ1-4
TGTGCCACCTCCAAGCGGACAGCCAATGAAAAACTGTTTTTT	CATSKRTANEKLFF	TRBV24-1	TRBJ1-4
TGTGCCAGGTCCCACTCTCAGGGCAATCAGCCCCAGCATTTT	CARSHSQGNQPQHF	TRBV5-6	TRBJ1-5
TGCAGTGCTAGAGATCCCATACCGGGGACAGGCCAGCATGGCTACACCTTC	CSARDPIPGTGQHGYTF	TRBV20-1	TRBJ1-2
TGTGCCACCAGTGGGATAGGTCATACGCAGTATTTT	CATSGIGHTQYF	TRBV24-1	TRBJ2-3
TGTGCCAGCAGCCACGGGTGGCGGGAGCTGGCTCGCCAAAACACTGAAGCTTTCTTT	CASSHGWRELARQNTEAFF	TRBV4-2	TRBJ1-1
TGCGCCAGCAGCCAAGAACCGAATAATCAGCCCCAGCATTTT	CASSQEPNNQPQHF	TRBV4-3	TRBJ1-5
TGCGCCAGCTCCGACAGGGAAGAGACCCAGTACTTC	CASSDREETQYF	TRBV5-1	TRBJ2-5
TGTGCCAGCAGCCCGGGGGGGAACACTGAAGCTTTCTTT	CASSPGGNTEAFF	TRBV13	TRBJ1-1
TGTGCCAGCTCTAGCAGGGGAGAAAATCAGCCCCAGCATTTT	CASSSRGENQPQHF	TRBV18	TRBJ1-5
TGTGCCAGCAAGTTGGGGTGGGAGCAGCCCCAGCATTTT	CASKLGWEQPQHF	TRBV6-6	TRBJ1-5
TGTGCCAGTAGTATGAGCGGGTCTCAATATGAGCAGTTCTTC	CASSMSGSQYEQFF	TRBV19	TRBJ2-1
TGTGCCAGCAGAACTGACGGGACAGGGGGCGAAGGTTCGGAGGTCGGAGAGACCCAGTACTTC	CASRTDGTGGEGSEVGETQYF	TRBV2	TRBJ2-5
TGTGCCAGCAGTGCCGCCGGGACTCAGATGGGAGATACGCAGTATTTT	CASSAAGTQMGDTQYF	TRBV6-1	TRBJ2-3
TGTGCCAGCAGCTTAGCTGGGTCTCCGGGACAGTATCCGAGCAATCAGCCCCAGCATTTT	CASSLAGSPGQYPSNQPQHF	TRBV7-6	TRBJ1-5
TGTGCCTGGACTAGCGGGCTGAAACGCACAGATACGCAGTATTTT	CAWTSGLKRTDTQYF	TRBV30	TRBJ2-3
TGTGCCAGCAGCCGGCCAGACCGGGACAGGAACACTGAAGCTTTCTTT	CASSRPDRDRNTEAFF	TRBV7-3	TRBJ1-1
TGTGCCAGCAGCGGCCGAACAGGGATTACCACTGAAGCTTTCTTT	CASSGRTGITTEAFF	TRBV3-1	TRBJ1-1
TGTGCCAGAAAACCCCAGACCCTTCGCCAAGAGACCCAGTACTTC	CARKPQTLRQETQYF	TRBV7-2	TRBJ2-5
TGTGCCAGTAGTACCCGAAACTGGGGCGGAGGCCGGGTGTTCGATAGCAATCAGCCCCAGCATTTT	CASSTRNWGGGRVFDSNQPQHF	TRBV19	TRBJ1-5
TGTGCCAGCAGTTATCCCGCTCTGGCCGGGGAGCTGTTTTTT	CASSYPALAGELFF	TRBV6-6	TRBJ2-2
TGTGCCACCAGTGCGACCCCTCCGACATTAAACACTGAAGCTTTCTTT	CATSATPPTLNTEAFF	TRBV24-1	TRBJ1-1
TGTGCCAGCATACAGGGGGCTGAAAAACTGTTTTTT	CASIQGAEKLFF	TRBV28	TRBJ1-4
TGCAGCGTTGATGGCGGTACTAATGAGCAGTTCTTC	CSVDGGTNEQFF	TRBV29-1	TRBJ2-1
TGCGCCAGCAGCTTGAAGTTATTAAGACCCCCAGGAGTGGACAACATTCAGTACTTC	CASSLKLLRPPGVDNIQYF	TRBV5-1	TRBJ2-4
TGTGCCAGCAGCTCCCGCCCCTTTTCCCCTAGCGGTCCGAACACCGGGGAGCTGTTTTTT	CASSSRPFSPSGPNTGELFF	TRBV7-3	TRBJ2-2
TGCAGCGTTCTGGGACAGGGGAAGTATGGCTACACCTTC	CSVLGQGKYGYTF	TRBV29-1	TRBJ1-2
TGTGCCAGCAGCACAGGGTCCGGGGGGCAAGAGACCCAGTACTTC	CASSTGSGGQETQYF	TRBV3-1	TRBJ2-5
TGTGCCAGCATCGCCCGGAATCAAGAGACCCAGTACTTC	CASIARNQETQYF	TRBV11-3	TRBJ2-5
TGCGCCAGCAGCCAAGACACATTTCGGAGTCGAGAGCAGTTCTTC	CASSQDTFRSREQFF	TRBV4-1	TRBJ2-1
TGTGCCAGCAGTGAGGGGCAATGGGCCTATTCACCCCTCCACTTT	CASSEGQWAYSPLHF	TRBV2	TRBJ1-6
TGCAGCGTACCACGAGAATACGAGCAGTACTTC	CSVPREYEQYF	TRBV29-1	TRBJ2-7
TGTGCCAGCAGCCAAGATCTGGGGTCGGCATATGGCTACACCTTC	CASSQDLGSAYGYTF	TRBV3-1	TRBJ1-2
TGCGCCAAGCGAGGTTGGTACGAGCAGTACTTC	CAKRGWYEQYF	TRBV10-1	TRBJ2-7
TGTGCCAGCAGTGACTGGCCCCGTTTTCGGGACGGTAAAGTCGAGACCCAGTACTTC	CASSDWPRFRDGKVETQYF	TRBV6-4	TRBJ2-5
TGCAGCGTTGGCAAGGGAGGGGTTCGCAATCAGCCCCAGCATTTT	CSVGKGGVRNQPQHF	TRBV29-1	TRBJ1-5
TGCGCCAGCAAACCCACAGGGGTTTGCACAGATACGCAGTATTTT	CASKPTGVCTDTQYF	TRBV10-1	TRBJ2-3
TGTGCCAGCATAGAAAGGACAGGGGAATTTGAGCAGTTCTTC	CASIERTGEFEQFF	TRBV6-1	TRBJ2-1
TGTGCCAGCAGACAGGGGATCTCTGGAAACACCATATATTTT	CASRQGISGNTIYF	TRBV7-2	TRBJ1-3
TGTGCCAGCAGACCTGGGTCCCTAGTGACAGGGAACACTGAAGCTTTCTTT	CASRPGSLVTGNTEAFF	TRBV6-4	TRBJ1-1
TGTGCCACCAGTGATAGTAGTAGGCAGTTCTTC	CATSDSSRQFF	TRBV24-1	TRBJ2-1
TGTGCCAGCAGCTTAATAACAGGACAGGGGGAGGAAAAACTGTTTTTT	CASSLITGQGEEKLFF	TRBV7-3	TRBJ1-4
TGTGCCAGCAGCCACTATATCGGTCGGGACGGGGTATACGAGCAGTACTTC	CASSHYIGRDGVYEQYF	TRBV13	TRBJ2-7
TGTGCCAGCAGCTTAGACCGGGCTCGACTCACCGGGGAGCTGTTTTTT	CASSLDRARLTGELFF	TRBV7-4	TRBJ2-2
TGTGCCAGCAGTTACGCGACAGGGCGGGTCACTCGTACAATGGCACCCAATACCGGGGAGCTGTTTTTT	CASSYATGRVTRTMAPNTGELFF	TRBV6-5	TRBJ2-2
TGTGCCAGCAGTTTCACTGGGGTGGGAATGGTCCACGAGCAGTACTTC	CASSFTGVGMVHEQYF	TRBV12-3	TRBJ2-7
TGTGCCAGCAGTTACTTAACCGGGACTTGGCCTAACGCCAAAAACATTCAGTACTTC	CASSYLTGTWPNAKNIQYF	TRBV6-2	TRBJ2-4
TGCGCCAGCAGCTTGGACTTTCAAAGGGTGGGGCAAGAGACCCAGTACTTC	CASSLDFQRVGQETQYF	TRBV5-1	TRBJ2-5
TGTGCCAGCAGTTTCAAGTGGACAGGTCTGGCTGGAAACACCATATATTTT	CASSFKWTGLAGNTIYF	TRBV12-3	TRBJ1-3
TGTGCCAGCAGCACCCGAGCCAACGGGGAGCTGTTTTTT	CASSTRANGELFF	TRBV11-3	TRBJ2-2
TGCGCCAGCAGGAGCCGGGACAGGGGGAATTCACCCCTCCACTTT	CASRSRDRGNSPLHF	TRBV5-1	TRBJ1-6
TGCAGTGCTAAGATCCAGGGGATCTATGGCTACACCTTC	CSAKIQGIYGYTF	TRBV20-1	TRBJ1-2
TGTGCCAGCACTACTCACCGTATGAACACTGAAGCTTTCTTT	CASTTHRMNTEAFF	TRBV11-3	TRBJ1-1
TGTGCCTGGAACATCCAGGGGTACCACAATGAGCAGTTCTTC	CAWNIQGYHNEQFF	TRBV30	TRBJ2-1
TGTGCCAGCAGTTACGCCTGGACCCAACTAGCGGGAGATGAGCAGTTCTTC	CASSYAWTQLAGDEQFF	TRBV6-6	TRBJ2-1
TGTGCCAGCAGTCGACTAGCGGCAGAGCAGTACTTC	CASSRLAAEQYF	TRBV27	TRBJ2-7
TGTGCCAGCAGTAGGGACGATGGCTACACCTTC	CASSRDDGYTF	TRBV6-2	TRBJ1-2
TGCAGCGTTGAAGATCTTAGGAGGGTGGAAAGCTACAATGAGCAGTTCTTC	CSVEDLRRVESYNEQFF	TRBV29-1	TRBJ2-1
TGTGCCAGCAGTGAAGTTTTTGCGGACTCTTTTAATGAGCAGTTCTTC	CASSEVFADSFNEQFF	TRBV25-1	TRBJ2-1
TGTGCCAGCAGCTTGCCGGAGGGGACAGATACGCAGTATTTT	CASSLPEGTDTQYF	TRBV5-6	TRBJ2-3
TGTGCCACCCCTAAAGGCCGGGACAGACATTATGGCTACACCTTC	CATPKGRDRHYGYTF	TRBV19	TRBJ1-2
TGTGCCTGGAGTGTAGGACCATTCCCCACCCTGCCCCAGCATTTT	CAWSVGPFPTLPQHF	TRBV30	TRBJ1-5
TGTGCCACCACCACCAGGGTATGGGGTTCTGGAAACACCATATATTTT	CATTTRVWGSGNTIYF	TRBV24-1	TRBJ1-3
TGTGCCAGCAGTGTTCGGGGACAGGAGTACCAAGAGACCCAGTACTTC	CASSVRGQEYQETQYF	TRBV27	TRBJ2-5
TGTGCCAGCAGTTTAAAAACATCTCAAGAAGAGACCCAGTACTTC	CASSLKTSQEETQYF	TRBV28	TRBJ2-5
TGTGCCGCGGGGGGGCAGAACACTGAAGCTTTCTTT	CAAGGQNTEAFF	TRBV10-3	TRBJ1-1
TGTGCCATCACCTTGACTAGCGGGGATGTAGGGGAGCAGTTCTTC	CAITLTSGDVGEQFF	TRBV10-3	TRBJ2-1
TGTGCCAGCAGCGTAGCGGGACAGGGTCCTGGGGCCAACGTCCTGACTTTC	CASSVAGQGPGANVLTF	TRBV9	TRBJ2-6
TGTGCCACCAGTACCGGGACTGAAGCTTTCTTT	CATSTGTEAFF	TRBV24-1	TRBJ1-1
TGTGCCATCAGTGAAAGGGGGGTTAGCTACGAGCAGTACTTC	CAISERGVSYEQYF	TRBV10-3	TRBJ2-7
TGCGCCAGCAGCCAAGATAGTGCCCAAAAACGGACAGGGGGCCATCAGCCCCAGCATTTT	CASSQDSAQKRTGGHQPQHF	TRBV4-1	TRBJ1-5
TGTGCCAGCAGCGGAGGGGGCCCGGGACTAGCGGGGAAAGGAGAGACCCAGTACTTC	CASSGGGPGLAGKGETQYF	TRBV7-3	TRBJ2-5
TGTGCCAGCAGTTTAGGTCGGGCCCCAAGCAATCAGCCCCAGCATTTT	CASSLGRAPSNQPQHF	TRBV12-4	TRBJ1-5
TGTGCCAGCAGTGAATCCCGGGCGCCCTGGGACCCCCAAGTGGGCTCTGGAAACACCATATATTTT	CASSESRAPWDPQVGSGNTIYF	TRBV25-1	TRBJ1-3
TGCAAAGTCGGATCAAGGTATAGCAATCAGCCCCAGCATTTT	CKVGSRYSNQPQHF	TRBV20-1	TRBJ1-5
TGTGCCAGCAGTTCCTATTTAGAGCAGTACTTC	CASSSYLEQYF	TRBV6-5	TRBJ2-7
TGTGCCAGCAGCCAAGTTCCGGGACAGGGAACCCGCCAGCCCCAGCATTTT	CASSQVPGQGTRQPQHF	TRBV14	TRBJ1-5
TGTGCCAGCAGCCAAGAGCCACAGGGGGCGCGGGGGATAGGTGGATGCAATCAGCCCCAGCATTTT	CASSQEPQGARGIGGCNQPQHF	TRBV14	TRBJ1-5
TGTGCCAGCCCCACGGTAGGGGGGCAACACCATAGCGAGTGGGGGAGGGCCAAAAACATTCAGTACTTC	CASPTVGGQHHSEWGRAKNIQYF	TRBV6-5	TRBJ2-4
TGTGCCAGCAGCGAAAGTAGATCTTGCTGGAGGTTCTTC	CASSESRSCWRFF	TRBV5-8	TRBJ2-1
TGTGCCAGCAGCTTACCGCGGGACTGGAGCTCCTACAATGAGCAGTTCTTC	CASSLPRDWSSYNEQFF	TRBV7-6	TRBJ2-1
TGCAGTGCTAGCAACCCGGACAGTCTGAACACTGAAGCTTTCTTT	CSASNPDSLNTEAFF	TRBV20-1	TRBJ1-1
TGTGCCAGCAGCCCAGCGGGTAAGGAGACCCAGTACTTC	CASSPAGKETQYF	TRBV7-3	TRBJ2-5
TGTGCCAGCAGCCAAGATACGGGGGAAAACACCATATATTTT	CASSQDTGENTIYF	TRBV3-1	TRBJ1-3
TGTGCCACCAGCCACTACAGGGATGAAGCTTTCTTT	CATSHYRDEAFF	TRBV24-1	TRBJ1-1
TGTGCCACCAGTGATTTAGGGAGTGGCTACACCTTC	CATSDLGSGYTF	TRBV24-1	TRBJ1-2
TGTGCCAGCACCCATCCGGCCGAGCATGGGCGTTACGAGCAGTACTTC	CASTHPAEHGRYEQYF	TRBV7-3	TRBJ2-7
TGTGCCAGCAGCTTCAGGGGGGGAGGAAGGACCCAGTACTTC	CASSFRGGGRTQYF	TRBV5-5	TRBJ2-5
TGTGCCAGCAGCAAAGGGACAGGGGCAGCTGGAAACACCATATATTTT	CASSKGTGAAGNTIYF	TRBV7-8	TRBJ1-3
TGTGCCAGCAGCTTAGCTCCGTTCAGGGGACAGGGGGACTATGGCTACACCTTC	CASSLAPFRGQGDYGYTF	TRBV7-9	TRBJ1-2
TGTGCCAGCAGCCCGACCCCCAGCTACGAGCAGTACTTC	CASSPTPSYEQYF	TRBV3-1	TRBJ2-7
TGTGCCAGCCTTGAAGGGAACGGGTCCTACAATGAGCAGTTCTTC	CASLEGNGSYNEQFF	TRBV7-6	TRBJ2-1
TGCGCCAGCATTCAGCGGGATCTTGTTAGCACAGATACGCAGTATTTT	CASIQRDLVSTDTQYF	TRBV10-1	TRBJ2-3
TGTGCCAGCACTTTAGCGAAAGGGACAGGGGGAACTAATGAAAAACTGTTTTTT	CASTLAKGTGGTNEKLFF	TRBV6-5	TRBJ1-4
TGTGCCAGCAATCGGGTATGTAGCGGGAAAGCAGATACGCAGTATTTT	CASNRVCSGKADTQYF	TRBV7-2	TRBJ2-3
TGTGCCAGCAGCCAAGACAGGGGGGTGATGAACTATGGCTACACCTTC	CASSQDRGVMNYGYTF	TRBV14	TRBJ1-2
TGTGCCAGCAGCGGACAGGGGTCCCAAGATAGCTACACCGGGGAGCTGTTTTTT	CASSGQGSQDSYTGELFF	TRBV7-3	TRBJ2-2
TGTGCCAGCAGCGGGGATCTCACAGATACGCAGTATTTT	CASSGDLTDTQYF	TRBV7-3	TRBJ2-3
TGTGCCAGCAAGGGGGGGCCGAGGGGGGCCAACGTCCTGACTTTC	CASKGGPRGANVLTF	TRBV27	TRBJ2-6
TGTGCCAGCAGCCCAGCTTTCCAGTACTTC	CASSPAFQYF	TRBV13	TRBJ2-5
TGTGCCAGCAGTGACAGGGGTTTTGAGACCCAGTACTTC	CASSDRGFETQYF	TRBV6-6	TRBJ2-5
TGTGCCAGCAGCTTACCTTTCCGGGGGGCCTACAATGAGCAGTTCTTC	CASSLPFRGAYNEQFF	TRBV7-6	TRBJ2-1
TGTGCCAGCAGTTACTACGGTGTGATGAACACTGAAGCTTTCTTT	CASSYYGVMNTEAFF	TRBV6-6	TRBJ1-1
TGCGCCAGCAGGGGCGAGGGGAACACTGAAGCTTTCTTT	CASRGEGNTEAFF	TRBV5-1	TRBJ1-1
TGTGCCAGCAGCACTCCAGGGGGCGGAGCTTTCTTT	CASSTPGGGAFF	TRBV9	TRBJ1-1
TGTGCCAGCAGCTTGTTGGGAGGGAGGGCGCAGCCCCAGCATTTT	CASSLLGGRAQPQHF	TRBV11-3	TRBJ1-5
TGCAGCGGGACAGTTGTGGATGGCTACACCTTC	CSGTVVDGYTF	TRBV29-1	TRBJ1-2
TGTGCCAGCAGCTTACGTAGCGGGAAGTACGAGCAGTACTTC	CASSLRSGKYEQYF	TRBV7-2	TRBJ2-7
TGTGCCAGCAGTCCCCCAGGGATCTACGAGCAGTACTTC	CASSPPGIYEQYF	TRBV12-3	TRBJ2-7
TGTGCCAGCTGTCGTAGCAACAATGAGCAGTTCTTC	CASCRSNNEQFF	TRBV7-6	TRBJ2-1
TGTGCCAGCAGTTACGGGGCAGGGGGGCCCCTCCACTTT	CASSYGAGGPLHF	TRBV6-5	TRBJ1-6
TGTGCCAGCAGCAGAGCAAAGTTCAGGGAGTGGACCGTGGGTAATGGCTACACCTTC	CASSRAKFREWTVGNGYTF	TRBV13	TRBJ1-2
TGTGCCAGTAGGGCTCACACCTACGAGCAGTACTTC	CASRAHTYEQYF	TRBV19	TRBJ2-7
TGTGCCAGCAGCACCCCCATGCAGACACAGGGTAAGGATCAGCCCCAGCATTTT	CASSTPMQTQGKDQPQHF	TRBV7-3	TRBJ1-5
TGTGCCACCCGGGACAGGGGGATAAGGAACACTGAAGCTTTCTTT	CATRDRGIRNTEAFF	TRBV24-1	TRBJ1-1
TGTGCCAGCATAGGCCGGGGGGGGACGTACAATGAGCAGTTCTTC	CASIGRGGTYNEQFF	TRBV13	TRBJ2-1
TGCGCCAGCAGCTTGGGAGACACTAGCCCGAACACCGGGGAGCTGTTTTTT	CASSLGDTSPNTGELFF	TRBV5-1	TRBJ2-2
TGTGCCAGCAGCCGCCCTGTTTCTAAGCCCCAGCATTTT	CASSRPVSKPQHF	TRBV7-9	TRBJ1-5
TGTGCCAGCAGTCCGTACCCACTTGCAGATACGCAGTATTTT	CASSPYPLADTQYF	TRBV6-3	TRBJ2-3
TGTGCCAGCAGCTTAGTAAATCACGGGGGGCCTGGCTTT	CASSLVNHGGPGF	TRBV7-9	TRBJ1-1
TGTGCCAGCAGCCGAGGCGACGTTCGACAGGGGGGGTCCCGCTACACCTTC	CASSRGDVRQGGSRYTF	TRBV3-1	TRBJ1-2
TGTGCCAGCAGTGTTTTTTGCGGACAGGGGGGTGAAGCTTTCTTT	CASSVFCGQGGEAFF	TRBV6-4	TRBJ1-1
TGTGCCAGCAGCCGAGACAGGGTGAAGGAGGGGTCCCAAGAGACCCAGTACTTC	CASSRDRVKEGSQETQYF	TRBV14	TRBJ2-5
TGTGCCAGACTTGGGGGCTGCTATGGCTACACCTTC	CARLGGCYGYTF	TRBV19	TRBJ1-2
TGTGCCTGGCAGGGGGCCGCAAGAAGAGGGGGGCCCCAGCATTTT	CAWQGAARRGGPQHF	TRBV30	TRBJ1-5
TGCTTAATTTTAGCGTCAGATACGCAGTATTTT	CLILASDTQYF	TRBV19	TRBJ2-3
TGTGCCAGCAGTGCGCCGACTGGACGGGAGTCCTCCTACAATGAGCAGTTCTTC	CASSAPTGRESSYNEQFF	TRBV12-3	TRBJ2-1
TGCAGTGCTAGAGCGATCGGACACCTGACGTCAGAGACCCAGTACTTC	CSARAIGHLTSETQYF	TRBV20-1	TRBJ2-5
TGTGCCAGCAGCGTAGCACCAAACGCCGGGACAGGAATGGGTAATGAAAAACTGTTTTTT	CASSVAPNAGTGMGNEKLFF	TRBV9	TRBJ1-4
TGCGCCAGCAGCTTGGCCTCCCCTACCCTAGCCATCCAGCATTTT	CASSLASPTLAIQHF	TRBV5-1	TRBJ1-5
TGTGCCAGCAGCCAAGAATATACCGGAGGGGCTCGGACAGATACGCAGTATTTT	CASSQEYTGGARTDTQYF	TRBV3-1	TRBJ2-3
TGTGCCAGCAGCTTAGATGCCAGCAGGGGCGAGCCCCAGCATTTT	CASSLDASRGEPQHF	TRBV7-6	TRBJ1-5
TGTGCCAGCAGCGAGCTAGGGCCCCAGCATTTT	CASSELGPQHF	TRBV9	TRBJ1-5
TGTGCCAGCAGCCTTTTCAGGGCCTCTTCACCCCTCCACTTT	CASSLFRASSPLHF	TRBV14	TRBJ1-6
TGCAGCGACAGGGTAGGACCCGGGGGAGCTTTCTTT	CSDRVGPGGAFF	TRBV29-1	TRBJ1-1
TGTGCCAGCTCCCAGGGGGATCCGAACACTGAAGCTTTCTTT	CASSQGDPNTEAFF	TRBV25-1	TRBJ1-1
TGTGCCAGCAGTGGGGAGGGAAGTGAGCAGTTCTTC	CASSGEGSEQFF	TRBV6-1	TRBJ2-1
TGCAGTGCTAGCCGGACCAGGGAACAAGAGACCCAGTACTTC	CSASRTREQETQYF	TRBV20-1	TRBJ2-5
TGTGCCAGCAGCGGACAGGGGGCGAGCGAGCAGTACTTC	CASSGQGASEQYF	TRBV9	TRBJ2-7
TGTGCCAAGGGACAGGGAAGGTGCGCCTGCAATCAGCCCCAGCATTTT	CAKGQGRCACNQPQHF	TRBV19	TRBJ1-5
TGTGCCAGCAGCTTAACAGGACAGGGGAGTTGTATGTACTTC	CASSLTGQGSCMYF	TRBV11-1	TRBJ2-7
TGTGCCCCGGGACTAGCGGGAGCGATTAATCAGCCCCAGCATTTT	CAPGLAGAINQPQHF	TRBV19	TRBJ1-5
TGTGCCAGCCCACCCCCGGGACAGGGGGCGGTCTCCTACGAGCAGTACTTC	CASPPPGQGAVSYEQYF	TRBV2	TRBJ2-7
TGTGCCAGCAGGCCTTGGCGTTTGGACACTGAAGCTTTCTTT	CASRPWRLDTEAFF	TRBV6-5	TRBJ1-1
TGTGCCAGCAAGGATCAGGGGTCACAGACTTACACTGAAGCTTTCTTT	CASKDQGSQTYTEAFF	TRBV6-4	TRBJ1-1
TGTGCCAGCAGCGGAGCCCTGGGTGAGACCCAGTACTTC	CASSGALGETQYF	TRBV13	TRBJ2-5
TGTGCCAGCAGCATACTAGCGGGAGACCTCACCTTC	CASSILAGDLTF	TRBV13	TRBJ1-2
TGTGCCAGCAGCGTTAGGACAGAGGGCACGAGACATGGCTACACCTTC	CASSVRTEGTRHGYTF	TRBV7-2	TRBJ1-2
TGTGCCAGCAGTGAACGGGGGGGCTCTTCACCCCTCCACTTT	CASSERGGSSPLHF	TRBV6-1	TRBJ1-6
TGTGCCAGCAGCTCAGTGGGGGACGAGCAGTACTTC	CASSSVGDEQYF	TRBV7-9	TRBJ2-7
TGCGCCAGCAGCTGGACAGGGGGCTACAATGAGCAGTTCTTC	CASSWTGGYNEQFF	TRBV5-1	TRBJ2-1
TGTGCCAGCAGCTTAGCGCACCCCGGGACCCCCCTACACATTCAGTACTTC	CASSLAHPGTPLHIQYF	TRBV7-9	TRBJ2-4
TGCGCCAGCATACAGGTATCCACTAATGAAAAACTGTTTTTT	CASIQVSTNEKLFF	TRBV10-1	TRBJ1-4
TGTGCCAGTAGGCACCAGGCTGACACCTTC	CASRHQADTF	TRBV19	TRBJ1-2
TGTGCCAGCAGCGGGTCACATAATGAAAAACTGTTTTTT	CASSGSHNEKLFF	TRBV7-2	TRBJ1-4
TGTAAGGCGGGTGACAATGAGCAGTTCTTC	CKAGDNEQFF	TRBV7-9	TRBJ2-1
TGCAAACGGCAGCCGGACGAGCAGTACTTC	CKRQPDEQYF	TRBV20-1	TRBJ2-7
TGTGCCACCAGTGATTTGCTCCTTCCCCTTTGGGGCTACTACGAGCAGTACTTC	CATSDLLLPLWGYYEQYF	TRBV24-1	TRBJ2-7
TGTGCTAGTGGTTTCTCAGATTCCTCTGGAAACACCATATATTTT	CASGFSDSSGNTIYF	TRBV12-5	TRBJ1-3
TGTGCCAGCAGTGAAGCGCAAGACCTCCCCGGGACGAATCCTTCGGATAGCTCCTACGAGCAGTACTTC	CASSEAQDLPGTNPSDSSYEQYF	TRBV6-1	TRBJ2-7
TGCAGTGCTAGAATATTTAATCTGAGTAGGAGCGAGCAGTACTTC	CSARIFNLSRSEQYF	TRBV20-1	TRBJ2-7
TGTGCCAGCACCCGGGATCCTTCCAGGGGGCAATGCTACGAGCAGTACTTC	CASTRDPSRGQCYEQYF	TRBV27	TRBJ2-7
TGCGCCAGCAGCTCCGCGCACTACAATGAGCAGTTCTTC	CASSSAHYNEQFF	TRBV4-1	TRBJ2-1
TGTGCCAGCAGCTTAGTTGCCCCCTTACCCCCCCTCCACAGACTTAATGAGCAGTTCTTC	CASSLVAPLPPLHRLNEQFF	TRBV13	TRBJ2-1
TGTGCCAGCAGCTTAGCCCGCGTCGACAGGGCAGCCAATGAGCAGTTCTTC	CASSLARVDRAANEQFF	TRBV7-8	TRBJ2-1
TGTGCCAGCAGCAGCTTCAGACAGGGGGGTTCCAATCAGCCCCAGCATTTT	CASSSFRQGGSNQPQHF	TRBV13	TRBJ1-5
TGCAGTGCTAGAGGTGGGGGCTGTGATGCTGTCCATTTGAACACTGAAGCTTTCTTT	CSARGGGCDAVHLNTEAFF	TRBV20-1	TRBJ1-1
TGTGCCAGCAGTGACGGACTTCCAAGGGATAACACCGGGGAGCTGTTTTTT	CASSDGLPRDNTGELFF	TRBV27	TRBJ2-2
TGTGCCAGCAGTTTACAGGCCGAAAATGACACTGAAGCTTTCTTT	CASSLQAENDTEAFF	TRBV27	TRBJ1-1
TGTGCCAGCAGTTTTGGGACAGGGTTACTGTTTTTT	CASSFGTGLLFF	TRBV27	TRBJ1-4
TGTGCCAGCAGCGGACAGGGGGGAGCTGGAAACACCATATATTTT	CASSGQGGAGNTIYF	TRBV13	TRBJ1-3
TGTGCCAGCAGCCACAGAGTCCCCTATAGGCTGGGCTACGAGCAGTACTTC	CASSHRVPYRLGYEQYF	TRBV14	TRBJ2-7
TGTGCCAGCAGTTGTGAAGTGAACACTGAAGCTTTCTTT	CASSCEVNTEAFF	TRBV6-3	TRBJ1-1
TGTGCCAGCAGCCGAACGGGGGGGGGCTACGAGCAGTACTTC	CASSRTGGGYEQYF	TRBV7-4	TRBJ2-7
TGTGCCAGCAGTTCAGGACGAGTTCAGCCCCAGCATTTT	CASSSGRVQPQHF	TRBV6-2	TRBJ1-5
TGTGCCAAGGAAGGGAGCGGGAGCCCCATTTTGCGGGCTGGGGCCAACGTCCTGACTTTC	CAKEGSGSPILRAGANVLTF	TRBV27	TRBJ2-6
TGTGCCAGCAGTGAAAGGTCAGAAAACACTGAAGCTTTCTTT	CASSERSENTEAFF	TRBV6-1	TRBJ1-1
TGTGCCATCAGTGACCTTCCGGGACGGAGATCCATATATTTT	CAISDLPGRRSIYF	TRBV10-3	TRBJ1-3
TGCAGTGCTAGCAGTACGGACGATCGGGGGGGCTCCTACGAGCAGTACTTC	CSASSTDDRGGSYEQYF	TRBV20-1	TRBJ2-7
TGTGCCAGCAGCTATTCCCCGCTGCAGGGAGGCACAGATACGCAGTATTTT	CASSYSPLQGGTDTQYF	TRBV5-4	TRBJ2-3
TGTGCCAGCAGCTTAGCAATATTCGGACTAGCGGGGGGGCGAGGAGATACGCAGTATTTT	CASSLAIFGLAGGRGDTQYF	TRBV7-4	TRBJ2-3
TGCAGCGTTGATTATCTCGGGACAGGGAATCCGGGTGAGCAGTACTTC	CSVDYLGTGNPGEQYF	TRBV29-1	TRBJ2-7
TGTGCCAGCAGTGACCTTCCACGGCAAGGGTCACCCCTCCACTTT	CASSDLPRQGSPLHF	TRBV6-4	TRBJ1-6
TGTGCCAGCAGCGTAGGTCTAGCGGGCCAGAATGCCCTAGCCAAAAACATTCAGTACTTC	CASSVGLAGQNALAKNIQYF	TRBV9	TRBJ2-4
TGTGCCAGCAGCTTATCCCCGGGACAGTTTGGCTGCGACAATGAGCAGTTCTTC	CASSLSPGQFGCDNEQFF	TRBV11-2	TRBJ2-1
TGTGCCAGCAGCGTAGGGCTGTTTCATGGCTACACCTTC	CASSVGLFHGYTF	TRBV9	TRBJ1-2
TGTGCCAGCAGTGCCGGGACTAGAGAGTACACCGGGGAGCTGTTTTTT	CASSAGTREYTGELFF	TRBV6-4	TRBJ2-2
TGTGCCAGCGGGACTAGTTACAATGAGCAGTTCTTC	CASGTSYNEQFF	TRBV6-4	TRBJ2-1
TGTGCCAGTAGAGGTTGCACATGGCGGGGGCATGCGCCTAAGGCCCGGTATAGCAATCAGCCCCAGCATTTT	CASRGCTWRGHAPKARYSNQPQHF	TRBV19	TRBJ1-5
TGTGCCTGGAGTGTATCTCAGGGGGCGGGGGAGTCGCAGTATTTT	CAWSVSQGAGESQYF	TRBV30	TRBJ2-3
TGTGCCAGCATAGCACGGGGCCATAATCGACTGTTTTTT	CASIARGHNRLFF	TRBV2	TRBJ1-4
TGTGCCAGCAGCATCGCGGGTAACAACATTCAGTACTTC	CASSIAGNNIQYF	TRBV9	TRBJ2-4
TGTGCCAGCAGGTCTGGACAGGGGGCTCTGGATGGCTACACCTTC	CASRSGQGALDGYTF	TRBV6-5	TRBJ1-2
TGTGCCAGCAGCTCCCCTCCCAGGGAATGCAATCAGCCCCAGCATTTT	CASSSPPRECNQPQHF	TRBV13	TRBJ1-5
TGTGCCAGCGCCACAGGCTTGGGCAATGAGCAGTTCTTC	CASATGLGNEQFF	TRBV6-4	TRBJ2-1
TGTGCCAGCAGGTCCCCGGGCCCAACACTTCAGAAAGGGGATCAGCCCCAGCATTTT	CASRSPGPTLQKGDQPQHF	TRBV6-1	TRBJ1-5
TGCGCCAGCAGCTGTGGGACTAGCGGGGGTTCCAATGAGCAGTTCTTC	CASSCGTSGGSNEQFF	TRBV5-1	TRBJ2-1
TGTGCCAGCAGACATAGTTCACCCTCTGGGGCCAACGTCCTGACTTTC	CASRHSSPSGANVLTF	TRBV6-1	TRBJ2-6
TGTGCCACCAGCAGAGATAAGACAGGGAGACCTAGCTATGGCTACACCTTC	CATSRDKTGRPSYGYTF	TRBV15	TRBJ1-2
TGTGCCAGCCTTGGGAGACTAGCGGCCTACGAGCAGTACTTC	CASLGRLAAYEQYF	TRBV12-4	TRBJ2-7
TGCGCCAGCAGCAAAAGGGGGGCCTACGAGCAGTACTTC	CASSKRGAYEQYF	TRBV5-1	TRBJ2-7
TGTGCTAGTGGCCCACCATCCAAACCGGCTTCTACTATCTTC	CASGPPSKPASTIF	TRBV12-5	TRBJ2-1
TGTGCCAGCAGTTACCGGGACGGGGGCTATGGCTACACCTTC	CASSYRDGGYGYTF	TRBV6-5	TRBJ1-2
TGTGCCAGCAGCGTAGGAGGGGGCGGCTCTGGAAACACCATATATTTT	CASSVGGGGSGNTIYF	TRBV9	TRBJ1-3
TGCGCCAGCAGCTGGGACAGGGGGGAGGGGTACGAGCAGTACTTC	CASSWDRGEGYEQYF	TRBV5-1	TRBJ2-7
TGTGCCAGCAGATACAGGGGGCAGATCCACTCTGGGGCCAACGTCCTGACTTTC	CASRYRGQIHSGANVLTF	TRBV27	TRBJ2-6
TGTGCCAGCAGCCACAGGGGGATGAACACTGAAGCTTTCTTT	CASSHRGMNTEAFF	TRBV13	TRBJ1-1
TGTGCCAGCAGCGCGGCCGGGACAGAAATTCATGAAAAACTGTTTTTT	CASSAAGTEIHEKLFF	TRBV7-3	TRBJ1-4
TGTGCCAGCAGTGCGTTGGACGTGGGCTACACCTTC	CASSALDVGYTF	TRBV2	TRBJ1-2
TGTGCCAGCAGTACAGGAGTGTCCGGACAGAAAGAGCAGTACTTC	CASSTGVSGQKEQYF	TRBV7-4	TRBJ2-7
TGTGCCAGCAGCTGGACAGTGTCGGGCTATGGCTACACCTTC	CASSWTVSGYGYTF	TRBV5-4	TRBJ1-2
TGCGCCAGCAGCTTGGGTTGCGTAGGCGACAATGAGCAGTTCTTC	CASSLGCVGDNEQFF	TRBV5-1	TRBJ2-1
TGTGCCAGCAGCTGTCCGACCAGGGGCGAAGGCACCTATGGCTACACCTTC	CASSCPTRGEGTYGYTF	TRBV7-3	TRBJ1-2
TGTGCCAGCAGTATGGAGTACGAGCAGTACTTC	CASSMEYEQYF	TRBV6-5	TRBJ2-7
TGTGCCATCCAGGACGGCACTGAAGCTTTCTTT	CAIQDGTEAFF	TRBV10-3	TRBJ1-1
TGTGCCAGCAGGAGGGCCGGGGGCTCCGATTCACCCCTCCACTTT	CASRRAGGSDSPLHF	TRBV27	TRBJ1-6
TGTGCCAGCAGCGGGACAGGGGGCGGGTCTGGAAACACCATATATTTT	CASSGTGGGSGNTIYF	TRBV27	TRBJ1-3
TGTGCCACCAGCAGCGGCCGGGACAACGGGGGAGAGACCCAGTACTTC	CATSSGRDNGGETQYF	TRBV15	TRBJ2-5
TGTGCCAGCAGCTTAAGACAGGGCCTTTACAATGAGCAGTTCTTC	CASSLRQGLYNEQFF	TRBV7-3	TRBJ2-1
TGTGCCAGCAGCTTAGGGGGACGAGGCTACACCTTC	CASSLGGRGYTF	TRBV7-3	TRBJ1-2
TGTGCCAGCAGCGGTAATCAGGGGGAGCCTGAAGCTTTCTTT	CASSGNQGEPEAFF	TRBV9	TRBJ1-1
TGTGCCAGCAGCTTGGGAATTGGGGTCACCGGGGAGCTGTTTTTT	CASSLGIGVTGELFF	TRBV5-6	TRBJ2-2
TGTGCCAGCAGCTTGACCCGGGGGCGTAGCAATCAGCCCCAGCATTTT	CASSLTRGRSNQPQHF	TRBV5-6	TRBJ1-5
TGTGCCAGCAGCCCTTCAAGGACGGCCCGGGGAGCAGATACGCAGTATTTT	CASSPSRTARGADTQYF	TRBV9	TRBJ2-3
TGTGCCACCAGTGATTCTCCTCTCCGCCGGGGGGGCTGGAACACCGGGGAGCTGTTTTTT	CATSDSPLRRGGWNTGELFF	TRBV24-1	TRBJ2-2
TGTGCCAGTAGTATTCGGCAAAAGGAGACCCAGTACTTC	CASSIRQKETQYF	TRBV19	TRBJ2-5
TGTGCCAGCACAGGGGGGGATGAAGCTTTCTTT	CASTGGDEAFF	TRBV7-2	TRBJ1-1
TGCGCCAGCAGCCAAGAGAGACTAGCGGGAGCCCGATTCCGGCAAGAGACCCAGTACTTC	CASSQERLAGARFRQETQYF	TRBV4-1	TRBJ2-5
TGTGCCAGCAGTGATACAGAGGGAATCCGCACAGATACGCAGTATTTT	CASSDTEGIRTDTQYF	TRBV25-1	TRBJ2-3
TGTGCCAGCAGTTCTACGCCGGGACAGGGGGGATATAGCAATCAGCCCCAGCATTTT	CASSSTPGQGGYSNQPQHF	TRBV12-3	TRBJ1-5
TGTGCCAGCAGCATTTCCGCGACAGGGCCTTTGAGCGGCACAGATACGCAGTATTTT	CASSISATGPLSGTDTQYF	TRBV7-9	TRBJ2-3
TGTGCCAGCAGCGAATTCCACGACAGGGACCTCAACACTGAAGCTTTCTTT	CASSEFHDRDLNTEAFF	TRBV6-5	TRBJ1-1
TGCGCCAGCAGCCAAGAACTGGTGAACATTCAGTACTTC	CASSQELVNIQYF	TRBV4-3	TRBJ2-4
TGTGCCAGCAGCTTGGGGAGCCCAGCGGGAGTGGACCGCAATCAGCCCCAGCATTTT	CASSLGSPAGVDRNQPQHF	TRBV5-6	TRBJ1-5
TGTGCCACCAGTGAGAGGGGTGATGAAAAACTGTTTTTT	CATSERGDEKLFF	TRBV24-1	TRBJ1-4
TGTGCCACCAGCAGGGGGGCTCTGTTCTATGGCTACACCTTC	CATSRGALFYGYTF	TRBV15	TRBJ1-2
TGCGCCAGCAGCCTTATGGACAGGGTTCTTTATGGCTACACCTTC	CASSLMDRVLYGYTF	TRBV4-1	TRBJ1-2
TGTGCCAGCGAGAAACAGGGACCCTACGAGCAGTACTTC	CASEKQGPYEQYF	TRBV5-8	TRBJ2-7
TGTGCCAGCAGCGTCGGGACTGGGGATGAGCAGTTCTTC	CASSVGTGDEQFF	TRBV7-9	TRBJ2-1
TGTGCCAGCAGCCCCGGGACAGTCTCTGGAAACACCATATATTTT	CASSPGTVSGNTIYF	TRBV3-1	TRBJ1-3
TGTGCCCTATTTGCGGGAGGGCTCCCAACTGAGACCCAGTACTTC	CALFAGGLPTETQYF	TRBV24-1	TRBJ2-5
TGTGCCAGCAGCATCCGGGGCGGAGAGTATTTT	CASSIRGGEYF	TRBV13	TRBJ2-3
TGCGCCAGCAGTGAGAACACCGGGACTAGGGCCTACAATGAGCAGTTCTTC	CASSENTGTRAYNEQFF	TRBV10-2	TRBJ2-1
TGTGCCAGCAGCCCTACATCCGGGACAGGGGTATACACTGAAGCTTTCTTT	CASSPTSGTGVYTEAFF	TRBV14	TRBJ1-1
TGTGCCAGCAGACGGCAGGGGGTGCTCACCGGGGAGCTGTTTTTT	CASRRQGVLTGELFF	TRBV5-6	TRBJ2-2
TGTGCCAGCAGTTACAAAGCGGGACGGGATTACATTCAGTACTTC	CASSYKAGRDYIQYF	TRBV6-5	TRBJ2-4
TGTGCCATGAGGGCAAGGGTGGTTGAGACCCAGTACTTC	CAMRARVVETQYF	TRBV2	TRBJ2-5
TGTGCCAGCAGGCAACCAGGGGGGCTCACAGATACGCAGTATTTT	CASRQPGGLTDTQYF	TRBV7-9	TRBJ2-3
TGTGCCAGCAGTGTCCCGGGCTATGGGGTGGTCCGCTATGGCTACACCTTC	CASSVPGYGVVRYGYTF	TRBV25-1	TRBJ1-2
TGTGCCACCAGTGTTTTAGCCACTAGCGGGAGCCTCGTGCAAGAGACCCAGTACTTC	CATSVLATSGSLVQETQYF	TRBV24-1	TRBJ2-5
TGCGCCAGCAGTGAGGGTGATATGAGGCAGGGAGATGAGCAGTTCTTC	CASSEGDMRQGDEQFF	TRBV10-1	TRBJ2-1
TGCAGCGTTGAACCCGGGCCCCAGAGCAATCAGCCCCAGCATTTT	CSVEPGPQSNQPQHF	TRBV29-1	TRBJ1-5
TGCGCCAGCAGCTTGCGGGACAGGGTATCCTACGAGCAGTACTTC	CASSLRDRVSYEQYF	TRBV5-1	TRBJ2-7
TGTGCCAGCAGTGAGGGGCTAGCGGGTGTCTACGAGCAGTACTTC	CASSEGLAGVYEQYF	TRBV6-1	TRBJ2-7
TGTGCCAGCAGGGGCCCCCTACCAGCTTTCTTT	CASRGPLPAFF	TRBV6-6	TRBJ1-1
TGTGCCAGCAGTCACCATAGGGGACTAGCGGGGGGGGGGCATGAGCAGTTCTTC	CASSHHRGLAGGGHEQFF	TRBV12-3	TRBJ2-1
TGTGCCAGCAGCTTAGCTAGCGAGAGAGAGACCCAGTACTTC	CASSLASERETQYF	TRBV11-3	TRBJ2-5
TGTGCCAGCAGCAACGACCCTCCCCCAGAAGAGCAGTACTTC	CASSNDPPPEEQYF	TRBV11-3	TRBJ2-7
TGTGCCACCAGTGATCGAGGGACTAGCGGCACTGAGCAGTTCTTC	CATSDRGTSGTEQFF	TRBV24-1	TRBJ2-1
TGTGCCAGCAGCTTAGCCTCTACTAGCGGGAGTGGGGCGAACACCGGGGAGCTGTTTTTT	CASSLASTSGSGANTGELFF	TRBV7-2	TRBJ2-2
TGTGCCAGCAGCTTAGGCCGGGGGGAATTTGAGCAGTTCTTC	CASSLGRGEFEQFF	TRBV7-4	TRBJ2-1
TGTGCCTGCCGGGATGGGCCGAGGCGCCTCCACTTT	CACRDGPRRLHF	TRBV30	TRBJ1-6
TGTGCCAGCAGCGGTCCTTCTCCCTTTTACCAGCAGTACTTC	CASSGPSPFYQQYF	TRBV13	TRBJ2-7
TGCGCCAGCAGTGGCCCCAAGAAGGGCTACGAGCAGTACTTC	CASSGPKKGYEQYF	TRBV5-1	TRBJ2-7
TGCGCCAGCACCCAGGGGGGAGGCCCGAACCCCTACAATGAGCAGTTCTTC	CASTQGGGPNPYNEQFF	TRBV10-2	TRBJ2-1
TGTGCCACCAGTGATTTAGGTCTCGGGGCCAACACCGGGGAGCTGTTTTTT	CATSDLGLGANTGELFF	TRBV24-1	TRBJ2-2
TGTGCCTGGAGGGGGATGACCGGGACTAGCGGGAGCCAGGGAACGAACACCGGGGAGCTGTTTTTT	CAWRGMTGTSGSQGTNTGELFF	TRBV30	TRBJ2-2
TGTGCCTGGACCCTTCTTACCTATGGCTACACCTTC	CAWTLLTYGYTF	TRBV30	TRBJ1-2
TGTGCCAGCAGATGTACAGGGGCACAGCCCCAGCATTTT	CASRCTGAQPQHF	TRBV25-1	TRBJ1-5
TGTGCCAGCCCCGGAGCGTACGAGCAGTACTTC	CASPGAYEQYF	TRBV6-4	TRBJ2-7
TGTGCCAGCAGCCAAGATATCGTAAAGGTATGTCCGGGACGACAATACACCTTC	CASSQDIVKVCPGRQYTF	TRBV3-1	TRBJ1-2
TGCGCCAGCAGCTTGTTTCCGGGGGGCTATGGCTACACCTTC	CASSLFPGGYGYTF	TRBV5-1	TRBJ1-2
TGTGCCAGTCCACCCATGACAGGGGGCCGCTCTGGAAACACCATATATTTT	CASPPMTGGRSGNTIYF	TRBV25-1	TRBJ1-3
TGTGCCAGCAGCCACGTGGACCCATCCGGGGAGCTGTTTTTT	CASSHVDPSGELFF	TRBV7-2	TRBJ2-2
TGTGCCAGCAGCCGGCTAGCGGGGGGCGGGGAGCTGTTTTTT	CASSRLAGGGELFF	TRBV3-1	TRBJ2-2
TGTGCCAGCAGCTTAGAGGGACTAGCGGGAAGCTTATACGAGCAGTACTTC	CASSLEGLAGSLYEQYF	TRBV11-3	TRBJ2-7
TGTGCCAGCAGTTTAGCCGCGGGATCGGGGGGGAGGGGGGAAGAGACCCAGTACTTC	CASSLAAGSGGRGEETQYF	TRBV27	TRBJ2-5
TGCAGTGCTAGAGCTAGGGAGGAAAAACTGTTTTTT	CSARAREEKLFF	TRBV20-1	TRBJ1-4
TGTGCCAGCAGTGGTGGGGGACAGGATGATCAGCCCCAGCATTTT	CASSGGGQDDQPQHF	TRBV2	TRBJ1-5
TGTGCCAGAGGAAGGCAGCCCCAGCATTTT	CARGRQPQHF	TRBV27	TRBJ1-5
TGCGCCAGCAGCCGAAGACCCCCAGGGGGGTATAGCAATCAGCCCCAGCATTTT	CASSRRPPGGYSNQPQHF	TRBV5-1	TRBJ1-5
TGTGCGACATTCAGGGCGGGGGTGCCGAACACTGAAGCTTTCTTT	CATFRAGVPNTEAFF	TRBV9	TRBJ1-1
TGTGCCAGCAGTAAACTCAGTTCAGCCAAAAACATTCAGTACTTC	CASSKLSSAKNIQYF	TRBV12-4	TRBJ2-4
TGTGCCAGCAGACTAAGTCAGGGGAACACTGAAGCTTTCTTT	CASRLSQGNTEAFF	TRBV7-4	TRBJ1-1
TGCGCCAGCAGCGATTCGCAGTTCTTC	CASSDSQFF	TRBV5-1	TRBJ2-1
TGTGCCTGGAGTGTACGGTTGGGGGCGCTAGGAGATACGCAGTATTTT	CAWSVRLGALGDTQYF	TRBV30	TRBJ2-3
TGTGCCAGAGGCGGTGCTCACGGCAATCAGCCCCAGCATTTT	CARGGAHGNQPQHF	TRBV10-3	TRBJ1-5
TGCGCCAGCAGCTTATGCAGGGGGGGGAACGAGCAGTACTTC	CASSLCRGGNEQYF	TRBV5-1	TRBJ2-7
TGTGCCAGCAGCGTAGTGGCAGGGTGGGCTCAAAACTATGGCTACACCTTC	CASSVVAGWAQNYGYTF	TRBV9	TRBJ1-2
TGCAGTGCAGGGCCCCGGGGGGGGCAGCCCCAGCATTTT	CSAGPRGGQPQHF	TRBV20-1	TRBJ1-5
TGTGCCAGCAGCGTAGTTCTGGGGGTTGGGTCAGGCTACACCTTC	CASSVVLGVGSGYTF	TRBV9	TRBJ1-2
TGTGCCAGCAGCCCCGGACTAGCGGGGTCCTACGAGCAGTACTTC	CASSPGLAGSYEQYF	TRBV9	TRBJ2-7
TGTGCCAGCCGGGGATCCTACGAGCAGTACTTC	CASRGSYEQYF	TRBV3-1	TRBJ2-7
TGTGCCAGCAGTTCGAGCAGGGACACTGAAGCTTTCTTT	CASSSSRDTEAFF	TRBV14	TRBJ1-1
TGTGCCAGCAGCTGTTCCACCTCCGAGCAGTACTTC	CASSCSTSEQYF	TRBV11-2	TRBJ2-7
TGTGCCAGCAGTTACAGGGGAGCCGTTCAGCCCCAGCATTTT	CASSYRGAVQPQHF	TRBV6-5	TRBJ1-5
TGTGCCAGCAGCGGGACAGGGGAAGCTTTCTTT	CASSGTGEAFF	TRBV13	TRBJ1-1
TGTGCCAGCAGCCGGTTCCCTACAGGGGGCTCCTACGAGCAGTACTTC	CASSRFPTGGSYEQYF	TRBV7-3	TRBJ2-7
TGCAGTGCTAGAGATGTAGGACCGGGGCTGCCTTGCTACGAGCAGTACTTC	CSARDVGPGLPCYEQYF	TRBV20-1	TRBJ2-7
TGTGCCAGCAGTAGCCTTAACGGCCCATTCGAGCGTCAGCCCCAGCATTTT	CASSSLNGPFERQPQHF	TRBV28	TRBJ1-5
TGCAGTGCATCCTTCTCCCGGGACAGAAAACTGTTTTTT	CSASFSRDRKLFF	TRBV20-1	TRBJ1-4
TGCAGTGCTAGAGATCGGGACAGGGTCCGCTTC	CSARDRDRVRF	TRBV20-1	TRBJ2-7
TGTGCCAGCAGCCAAGGGGGCGAGCGGGGCACAGATACGCAGTATTTT	CASSQGGERGTDTQYF	TRBV3-1	TRBJ2-3
TGCAGTGCTAGAATAACTATCTCCCGGGTGACAGGGGAAAAACTGTTTTTT	CSARITISRVTGEKLFF	TRBV20-1	TRBJ1-4
TGTGCGTGGCCGAGCAGGGTTCCCTCGGGGGGGTGTTGGCAGCCCCAGCATTTT	CAWPSRVPSGGCWQPQHF	TRBV28	TRBJ1-5
TGTGCCAGCATTGGACTAGCGTGGGTGGGAGTCAGTAACACCGGGGAGCTGTTTTTT	CASIGLAWVGVSNTGELFF	TRBV27	TRBJ2-2
TGCAGTGCTAGAGGAACCGATACGCAGTATTTT	CSARGTDTQYF	TRBV20-1	TRBJ2-3
TGTGCCAGCAGCCCCGTCGACAGGGATGAGCAGTTCTTC	CASSPVDRDEQFF	TRBV5-5	TRBJ2-1
TGTGCCAGCAGCCACCCCGGCCCCGCTCTAGGGTCAAGTAACTATGGCTACACCTTC	CASSHPGPALGSSNYGYTF	TRBV7-9	TRBJ1-2
TGTGCCAGCCACAGCAATCAGCCCCAGCATTTT	CASHSNQPQHF	TRBV7-6	TRBJ1-5
TGCGCCAGCAGCCAAGCAGGGGGTTACACCGGGGAGCTGTTTTTT	CASSQAGGYTGELFF	TRBV4-3	TRBJ2-2
TGTGCCATGCCCCGAGATACGCAGTATTTT	CAMPRDTQYF	TRBV7-9	TRBJ2-3
TGTGCCAAATTGAGCGGGAGAAATAATTCACCCCTCCACTTT	CAKLSGRNNSPLHF	TRBV10-3	TRBJ1-6
TGCGCCAGCAGTGAGTCCTGCACAGGGCCTCTTAACACTGAAGCTTTCTTT	CASSESCTGPLNTEAFF	TRBV10-1	TRBJ1-1
TGTGCCAGCATCACGGACAGATGGATCTTAGCACGAGTCACCGGGGAGCTGTTTTTT	CASITDRWILARVTGELFF	TRBV11-3	TRBJ2-2
TGTGCCAGCAGTGACAACGCCTCGGCTCAAACGAACACTGAAGCTTTCTTT	CASSDNASAQTNTEAFF	TRBV6-4	TRBJ1-1
TGTGCCAGCAGTGTCAATGGACGTTCCTCAACCGCAACTAATGAAAAACTGTTTTTT	CASSVNGRSSTATNEKLFF	TRBV28	TRBJ1-4
TGTGCCAGCAGTGGGGCGCTGAACACCATATATTTT	CASSGALNTIYF	TRBV6-1	TRBJ1-3
TGCGCCAGCAACGCGGACAATGAGCAGTTCTTC	CASNADNEQFF	TRBV5-1	TRBJ2-1
TGTGCCAGCAGCTTGGAAAGGGGACAGGGCCCGGAGTCGTATTTT	CASSLERGQGPESYF	TRBV5-6	TRBJ2-3
TGCAGTGCCCCAGGGACGAGGACATCTTCCGAGCAGTACTTC	CSAPGTRTSSEQYF	TRBV20-1	TRBJ2-7
TGTGCCAGCAGCGACCAGGACTGCAATCAGCCCCAGCATTTT	CASSDQDCNQPQHF	TRBV9	TRBJ1-5
TGTGCCAGCAGCTCACTAGCGGGAGCTAAAGAGACCCAGTACTTC	CASSSLAGAKETQYF	TRBV11-2	TRBJ2-5
TGCAGGTTGTTGACAGGGGGCAGGAACACTGAAGCTTTCTTT	CRLLTGGRNTEAFF	TRBV29-1	TRBJ1-1
TGTGCCAGCAGCAACACCGGGACAGGGTACGGGGTGACCCAGTACTTC	CASSNTGTGYGVTQYF	TRBV14	TRBJ2-5
TGCAGCGTTGAGGGCAATCAGCCCCAGCATTTT	CSVEGNQPQHF	TRBV29-1	TRBJ1-5
TGTGCCAGCAGCAGAGGGGGGGCTTACCCCATAAGGTACAATGAGCAGTTCTTC	CASSRGGAYPIRYNEQFF	TRBV13	TRBJ2-1
TGTGCCAGCAGCTCCATCCTAATGGCACCGGGACAGGGGCTGGTTTCGAACTATGGCTACACCTTC	CASSSILMAPGQGLVSNYGYTF	TRBV9	TRBJ1-2
TGTGCCATCCGGGCGTTTCAGCCCCAGCATTTT	CAIRAFQPQHF	TRBV10-3	TRBJ1-5
TGTGCCAGCAGCTCCCCCCCCAGGGACAGGGGGGAAAAGGACTCCTACGAGCAGTACTTC	CASSSPPRDRGEKDSYEQYF	TRBV7-2	TRBJ2-7
TGCAGTGCGCCCCCGGGGAGGGGACTGGCCTACGAGCAGTACTTC	CSAPPGRGLAYEQYF	TRBV20-1	TRBJ2-7
TGCGCCAGACTACAGGGAACCAGGCCTACTCAGCCCCAGCATTTT	CARLQGTRPTQPQHF	TRBV10-1	TRBJ1-5
TGCGCCAGCAGCATTCTAGCGGGGGGTTCCTACGAGCAGTACTTC	CASSILAGGSYEQYF	TRBV5-1	TRBJ2-7
TGCGCCAGCAGCTCCCCGGTGGGGGGGACCTCGATTCGAGCAGCTTTCTTT	CASSSPVGGTSIRAAFF	TRBV5-1	TRBJ1-1
TGTGCCAGCAGTGACGGGACTAGCGGGTTTTGCGAGCAGTTCTTC	CASSDGTSGFCEQFF	TRBV6-4	TRBJ2-1
TGTGCCAGCAGCCCAGGACCGCAGTACTTC	CASSPGPQYF	TRBV14	TRBJ2-7
TGCGCCAGCAGCTTTAACCGACTAGGCGACTGGGCCTACGAGCAGTACTTC	CASSFNRLGDWAYEQYF	TRBV5-1	TRBJ2-7
TGCGCCAGCAGTGTCTTATGTGGAGGTGCCGGACGGGGGAGCTCCTACGAGCAGTACTTC	CASSVLCGGAGRGSSYEQYF	TRBV10-1	TRBJ2-7
TGTGCCAGCAGCTTAGTTGGGGACTGGGAGACCCAGTACTTC	CASSLVGDWETQYF	TRBV11-3	TRBJ2-5
TGCAGCGTTGAACAGGGACGGTACGAGCAGTACTTC	CSVEQGRYEQYF	TRBV29-1	TRBJ2-7
TGTGCCAGCTCACCACGTTGGCGGCCAGATACGCAGTATTTT	CASSPRWRPDTQYF	TRBV18	TRBJ2-3
TGTGCCAGCAGCAACCGGGGGGGGGAGACCTACGAGCAGTACTTC	CASSNRGGETYEQYF	TRBV5-4	TRBJ2-7
TGCAGGAGCCCTCTAGCGGGTAACGAGCAGTACTTC	CRSPLAGNEQYF	TRBV20-1	TRBJ2-7
TGTGCCAGCAGCAGCTGGGGGCTCCGCCGCACTTTGGGGGGCGGTAAGGTATGTAGCACAGATACGCAGTATTTT	CASSSWGLRRTLGGGKVCSTDTQYF	TRBV7-8	TRBJ2-3
TGTGCCAGCAGCTCCATAGCCGTCAGTGCAACTAATGAAAAACTGTTTTTT	CASSSIAVSATNEKLFF	TRBV11-3	TRBJ1-4
TGTGCCAGCAGTGAAAAGACCGGGACTAGCGGCGGGGACTACGAGCAGTACTTC	CASSEKTGTSGGDYEQYF	TRBV6-1	TRBJ2-7
TGTGCCAGCAGCGTAGAACAGACTGTGAACAATGAGCAGTTCTTC	CASSVEQTVNNEQFF	TRBV9	TRBJ2-1
TGTGCCATCAGCCGTGTCTTGTATGATAGTAATGAAAAACTGTTTTTT	CAISRVLYDSNEKLFF	TRBV10-3	TRBJ1-4
TGTGCCACACCCGCCGGGACAGACGAGCAGTACTTC	CATPAGTDEQYF	TRBV2	TRBJ2-7
TGTGCCAGCTCACCAATCTTGCGGCCCCAAGAGACCCAGTACTTC	CASSPILRPQETQYF	TRBV18	TRBJ2-5
TGTGCCAGCAGCCCTGGGGACAGGCGGGGCAATCAGCCCCAGCATTTT	CASSPGDRRGNQPQHF	TRBV7-3	TRBJ1-5
TGTGCCAGCAGCAAGGACAATGAGCAGTTCTTC	CASSKDNEQFF	TRBV13	TRBJ2-1
TGTGCCAGCAGTTTACGGGGCCCAATTCAGTACTTC	CASSLRGPIQYF	TRBV28	TRBJ2-5
TGTGCCAGCAGCTTAGATCCTCGGGGCCGTGGCGAGACCCAGTACTTC	CASSLDPRGRGETQYF	TRBV11-3	TRBJ2-5
TGCGCCAGCAGCGAGGTGGGACCCATGGATCAGCCCCAGCATTTT	CASSEVGPMDQPQHF	TRBV5-1	TRBJ1-5
TGCAGCGTTGACAGGGCCTTAAGGCCCGGCTATGGCTACACCTTC	CSVDRALRPGYGYTF	TRBV29-1	TRBJ1-2
TGTGCCAGCAGCTTAGTTCCCCTAGGGGAAGGAGGCTACGAGCAGTACTTC	CASSLVPLGEGGYEQYF	TRBV7-8	TRBJ2-7
TGTGCCAGCAGTTGCGGGGGTGCAAGCTCCTACAATGAGCAGTTCTTC	CASSCGGASSYNEQFF	TRBV28	TRBJ2-1
TGTGCCAGTAGTCCTATTCCGACGGTGGCCATTCAGTACTTC	CASSPIPTVAIQYF	TRBV19	TRBJ2-5
TGTGCCAGCAGTAACCGCAGCAGCAATCAGCCCCAGCATTTT	CASSNRSSNQPQHF	TRBV7-6	TRBJ1-5
TGTGCCAGCAGTATTAGGGATTACGGAGCAAGTCAAGAGACCCAGTACTTC	CASSIRDYGASQETQYF	TRBV6-4	TRBJ2-5
TGTGCCAGCAGTTACCACCAGGTCGAGAGGGAGCTCGGATCCGAGCAGTTCTTC	CASSYHQVERELGSEQFF	TRBV6-5	TRBJ2-1
TGTGCCAGCAGCTTTGACCACCGGGACAACAATCAGCCCCAGCATTTT	CASSFDHRDNNQPQHF	TRBV11-3	TRBJ1-5
TGCAGCTGCCACCGGGACAGGGGGCATGAAAAACTGTTTTTT	CSCHRDRGHEKLFF	TRBV29-1	TRBJ1-4
TGCGCCAGCAGTGAAAGCCGAGGACAGGCAGGGCCACTTACCATTGATCAGCCCCAGCATTTT	CASSESRGQAGPLTIDQPQHF	TRBV10-1	TRBJ1-5
TGTGCCAGCAGCTGTTTTTACAGTCCCGGGTGCCCTTATGGCTACACCTTC	CASSCFYSPGCPYGYTF	TRBV5-6	TRBJ1-2
TGTGCCAGCAGCTCCGACAGGGGGCCAGAGACCCAGTACTTC	CASSSDRGPETQYF	TRBV7-6	TRBJ2-5
TGTGCCAGCAGTTTAGGTTCTAGGGGACAGGGCCGGGACTATGGCTACACCTTC	CASSLGSRGQGRDYGYTF	TRBV12-4	TRBJ1-2
TGTGCCAGTAGTATAGGGCAGCTGAAGGCCAAAAACATTCAGTACTTC	CASSIGQLKAKNIQYF	TRBV19	TRBJ2-4
TGTGCCAGCAGCGGATTTCTGGGACAGGGACTCTATGGCTACACCTTC	CASSGFLGQGLYGYTF	TRBV9	TRBJ1-2
TGTGCCACCAGTGATCTCCGGGGTGGTCTCAACCTGTGCTATGGCTACACCTTC	CATSDLRGGLNLCYGYTF	TRBV24-1	TRBJ1-2
TGCAGTGCTGATGATCCGGGACAGGGGGAAATGAAGGGGAAGCAGCCCCAGCATTTT	CSADDPGQGEMKGKQPQHF	TRBV20-1	TRBJ1-5
TGTGCCAGCAGTGCAGGGGCGGGATCGTACGAGCAGTACTTC	CASSAGAGSYEQYF	TRBV2	TRBJ2-7
TGTGCCAGCAGCACAACAGGGAAACACTATGGCTACACCTTC	CASSTTGKHYGYTF	TRBV13	TRBJ1-2
TGTGCCAGCAGCGTCTCGAGGACAGGGGCCCTCTCCTACGAGCAGTACTTC	CASSVSRTGALSYEQYF	TRBV6-1	TRBJ2-7
TGTGCCAGCAGTCTAGAGGGGTTGTACGAGCAGTACTTC	CASSLEGLYEQYF	TRBV6-1	TRBJ2-7
TGTGCCAGCAGCCTGACAGGGGGCTGGGGTGGGGCTAACTATGGCTACACCTTC	CASSLTGGWGGANYGYTF	TRBV5-4	TRBJ1-2
TGTGCCACCAGTGATTCTACAATCAGAATGGTCTATGGCTACACCTTC	CATSDSTIRMVYGYTF	TRBV24-1	TRBJ1-2
TGTGCCAGCAGCAAACAGTGGCACTATGGCTACACCTTC	CASSKQWHYGYTF	TRBV11-2	TRBJ1-2
TGTGCCAGCAGCTCCAGCCTGGGGGGCACTCGAAATGAGCAGTTCTTC	CASSSSLGGTRNEQFF	TRBV7-3	TRBJ2-1
TGTGCCAGCTCACCGGGACACGCCTCTGGAAACACCATATATTTT	CASSPGHASGNTIYF	TRBV18	TRBJ1-3
TGTGCCATCAACCACCCGGGACTAGCGGGTCCGAACACCGGGGAGCTGTTTTTT	CAINHPGLAGPNTGELFF	TRBV10-3	TRBJ2-2
TGTGCCAGCAGTTCTCCCCCAGTTGTGTATATCACCGGGGAGCTGTTTTTT	CASSSPPVVYITGELFF	TRBV27	TRBJ2-2
TGTGCCAGCAGTTTGTCAGTCTGGAACACTGAAGCTTTCTTT	CASSLSVWNTEAFF	TRBV27	TRBJ1-1
TGCAGTGCAGTTTGCCGGGACAGGGTCACTGAAGCTTTCTTT	CSAVCRDRVTEAFF	TRBV20-1	TRBJ1-1
TGTGCCAGCAGTGTGGCGATAAACGAGCAGTACTTC	CASSVAINEQYF	TRBV6-1	TRBJ2-7
TGTGCCAGCAGCTTTCATTGCCACATTAGCGGGTGGGGGCCCGAGGCCAAAAACATTCAGTACTTC	CASSFHCHISGWGPEAKNIQYF	TRBV7-4	TRBJ2-4
TGTGCCTGGAAAACGTTCGGGACGTACCAAGAGACCCAGTACTTC	CAWKTFGTYQETQYF	TRBV30	TRBJ2-5
TGTGCCAGCAGCCAGGTGAAGCGTGGGGAAGGCTACACCTTC	CASSQVKRGEGYTF	TRBV7-3	TRBJ1-2
TGTGCCAGCAGCGCTAGGGTAACAGTGGGGTTGGAGCTGTTTTTT	CASSARVTVGLELFF	TRBV9	TRBJ2-2
TGTGCCAGCAGTCAAGGGGTATTGGGAACCGGGGAGCTGTTTTTT	CASSQGVLGTGELFF	TRBV27	TRBJ2-2
TGTGCCAGCAGTTACGGCGGGGCGAGGTCTGATAACACCGGGGAGCTGTTTTTT	CASSYGGARSDNTGELFF	TRBV6-3	TRBJ2-2
TGTGCCAGTAGTATAGCGATGGGACTAGCGGGAAGGTACAATGAGCAGTTCTTC	CASSIAMGLAGRYNEQFF	TRBV19	TRBJ2-1
TGCGCCAGCAGCTGTTCCTGGGCCCCCCCCTTCCTGGGACAGGGGAACAGTCATTCGAACACCGGGGAGCTGTTTTTT	CASSCSWAPPFLGQGNSHSNTGELFF	TRBV5-1	TRBJ2-2
TGTGCCAGCAGCTCTAGACCAAGTATTCATGGGGGGCCAAGCTCCTACAATGAGCAGTTCTTC	CASSSRPSIHGGPSSYNEQFF	TRBV11-2	TRBJ2-1
TGTGCCAGCAGCGGTCTGTTAGGGGGGGCAAGAAGGACTTGCGAGCAGTACTTC	CASSGLLGGARRTCEQYF	TRBV7-9	TRBJ2-7
TGTGCCAGCAGCGGACTAGAGCAGTACTTC	CASSGLEQYF	TRBV13	TRBJ2-7
TGTGCCAGCAGTTTACAGCCTAGGCATGACAATGAGCAGTTCTTC	CASSLQPRHDNEQFF	TRBV12-4	TRBJ2-1
TGTGCCACCGTAAGGGATCACTCGGGACCGGATAGCAATCAGCCCCAGCATTTT	CATVRDHSGPDSNQPQHF	TRBV24-1	TRBJ1-5
TGTGCCATCAGGAGACAGCAAGAGACCCAGTACTTC	CAIRRQQETQYF	TRBV10-3	TRBJ2-5
TGTGCCTGGAAGGCAGGAAATCAGCCCCAGCATTTT	CAWKAGNQPQHF	TRBV30	TRBJ1-5
TGTGCCAGCAGTGAAGCAGTACTTGACAGGGCCTATAATTCACCCCTCCACTTT	CASSEAVLDRAYNSPLHF	TRBV6-1	TRBJ1-6
TGTGCCAGCAGCTTGCAGACCGGGACAGGGGCCCCCTATGGCTACACCTTC	CASSLQTGTGAPYGYTF	TRBV5-6	TRBJ1-2
TGTGCCAGCTCGTACCAGGGAATCCTCGGACCCGGGGAGCTGTTTTTT	CASSYQGILGPGELFF	TRBV2	TRBJ2-2
TGCAGTGCTAGAGAACGGGTTTCTGAAGCTTTCTTT	CSARERVSEAFF	TRBV20-1	TRBJ1-1
TGTGCCAGCAGCCCACAGGGTAGGCCCCAGCATTTT	CASSPQGRPQHF	TRBV12-3	TRBJ1-5
TGTGCCAGCCAGGGACTAGCGGACCGGGAGACCCAGTACTTC	CASQGLADRETQYF	TRBV6-6	TRBJ2-5
TGTGCCAGCAGCTTACAATTCCTAGGACAGGGAACAACTGAAGCTTTCTTT	CASSLQFLGQGTTEAFF	TRBV7-2	TRBJ1-1
TGTGCCAGCAGCTGGGGGTATCTTGTTAAGTACTTC	CASSWGYLVKYF	TRBV7-2	TRBJ2-5
TGTGCCAGCAGCGGGCGACCAACCGAGACCCAGTACTTC	CASSGRPTETQYF	TRBV7-3	TRBJ2-5
TGTGCCAGCAGCTTAGGGAGTTATCCTTGCCCTTACTATGGCTACACCTTC	CASSLGSYPCPYYGYTF	TRBV7-9	TRBJ1-2
TGTGCCAGCTCACCTGACTACGGACAGGGCAATCAGCCCCAGCATTTT	CASSPDYGQGNQPQHF	TRBV18	TRBJ1-5
TGTGCCAGCAGTGCTAGCGGCGAGACCCAGTACTTC	CASSASGETQYF	TRBV12-3	TRBJ2-5
TGTGCCAGCAGTACAGGGGGCCTAGGAGGGAACACCGGGGAGCTGTTTTTT	CASSTGGLGGNTGELFF	TRBV6-1	TRBJ2-2
TGTGCCAGCAGCCCGGGCAGAGCTAACTATGGCTACACCTTC	CASSPGRANYGYTF	TRBV7-9	TRBJ1-2
TGTGCCAGCAGCCACCAAAATTCCCCCGACTCGGAGCAGTACTTC	CASSHQNSPDSEQYF	TRBV11-3	TRBJ2-7
TGTGCCAGCAGCCAAGCAATGGGGTGGGGACGCTCCTACGAGCAGTACTTC	CASSQAMGWGRSYEQYF	TRBV14	TRBJ2-7
TGTGCCAGAGGGACAGGGGGTCTTCTAAACTATGGCTACACCTTC	CARGTGGLLNYGYTF	TRBV7-9	TRBJ1-2
TGTGCCAGCAGCTTAGCGCACAGGGTGAGTAGAATTTATAGCAATCAGCCCCAGCATTTT	CASSLAHRVSRIYSNQPQHF	TRBV11-2	TRBJ1-5
TGTGCCAGCAGAAAACCCGACCGTTCACCCCTCCACTTT	CASRKPDRSPLHF	TRBV6-5	TRBJ1-6
TGTGCCAGCAGCGGGGCGGGAGTGTGGGAACGGCCTTCCGCTTTCTTT	CASSGAGVWERPSAFF	TRBV13	TRBJ1-1
TGTGCCAGCAGCTTAACCAGAGGGACAAGACTGGCAACTAATGAAAAACTGTTTTTT	CASSLTRGTRLATNEKLFF	TRBV7-9	TRBJ1-4
TGTGCCAGCAGGGTAGCGGGAGCGACAGATACGCAGTATTTT	CASRVAGATDTQYF	TRBV6-5	TRBJ2-3
TGTGCCAACCAAAGAAATAATTGCATGAACACTGAAGCTTTCTTT	CANQRNNCMNTEAFF	TRBV13	TRBJ1-1
TGTGCTAGCAGCTTCGTCAGGGGACAGGGAATTATGCACTATGGCTACACCTTC	CASSFVRGQGIMHYGYTF	TRBV7-7	TRBJ1-2
TGCACCGAAGGTTTGTCTAGCGGGGGGGCGATTGACAATGAGCAGTTCTTC	CTEGLSSGGAIDNEQFF	TRBV20-1	TRBJ2-1
TGTGCCAGCAGTTACTCGAAGCAGGGGGCCTACGAGCAGTACTTC	CASSYSKQGAYEQYF	TRBV6-2	TRBJ2-7
TGTGCCAGCAGCCAAGCCCGACCAGGACGGGACTACGAGCAGTACTTC	CASSQARPGRDYEQYF	TRBV3-1	TRBJ2-7
TGCGCCAGCAGGGGGAACGAGCAGTACTTC	CASRGNEQYF	TRBV5-1	TRBJ2-7
TGCAGCGTTGAACCGGATGACCACTGTAGCTATGGCTACACCTTC	CSVEPDDHCSYGYTF	TRBV29-1	TRBJ1-2
TGTGCCAGCAGTGACGGGCCCCCACCCGAACGAGGGGCCCAGTACTTC	CASSDGPPPERGAQYF	TRBV6-4	TRBJ2-5
TGTGCCAGCCCCGGCACCTTGAGCACCGGGGAGCTGTTTTTT	CASPGTLSTGELFF	TRBV7-9	TRBJ2-2
TGTGCCAGCAGCGGACTAGCGGGGGGCCCGAACACCGGGGAGCTGTTTTTT	CASSGLAGGPNTGELFF	TRBV28	TRBJ2-2
TGCGCCAGCAGCCAAGACCTTGGAAGCGGGACGGATTCTTGGGATTTTACTGAAGCTTTCTTT	CASSQDLGSGTDSWDFTEAFF	TRBV4-1	TRBJ1-1
TGTGCCAGCAGGCCCCTTCTACCCGGGACAGCTAAACACTCCTACGAGCAGTACTTC	CASRPLLPGTAKHSYEQYF	TRBV28	TRBJ2-7
TGTGCCAGCAGCTTGTGTTTGACTATGGCTGAAGCTTTCTTT	CASSLCLTMAEAFF	TRBV11-3	TRBJ1-1
TGTGCCATCAGTGAGTCCGAAACAGGACTGAACACTGAAGCTTTCTTT	CAISESETGLNTEAFF	TRBV10-3	TRBJ1-1
TGTGCCATCATGCCGACAGGGCGAGATGGCTACACCTTC	CAIMPTGRDGYTF	TRBV10-3	TRBJ1-2
TGTGCCAGCAGTTCGGATATTCCGGGAAGCGGGGAGCTGTTTTTT	CASSSDIPGSGELFF	TRBV27	TRBJ2-2
TGTGCCAGCAGCCAAGAGCCCGGGACAGGGGCTAAGAGGTCCTCTGGGGCCAACGTCCTGACTTTC	CASSQEPGTGAKRSSGANVLTF	TRBV3-1	TRBJ2-6
TGTGCCAGCAGTCAGCGGGGAGGACCAGATACGCAGTATTTT	CASSQRGGPDTQYF	TRBV27	TRBJ2-3
TGTGCCAGCAGCCTGATGCGGGAGATACTCCGGGTGGCCACTGGGGCCAACGTCCTGACTTTC	CASSLMREILRVATGANVLTF	TRBV11-3	TRBJ2-6
TGTGCCAGCAGTTTGTATCGAACTAGCGGGAGGGCTGGAAACACCATATATTTT	CASSLYRTSGRAGNTIYF	TRBV27	TRBJ1-3
TGTGCCAGCAGTGCTCCTTGGGGGGGGAGCTGGAGGAGCACAGATACGCAGTATTTT	CASSAPWGGSWRSTDTQYF	TRBV2	TRBJ2-3
TGTGCCACCAGCCCCCGGACCCTCACAGATACGCAGTATTTT	CATSPRTLTDTQYF	TRBV15	TRBJ2-3
TGTGCCAGCACAAGCCGGGGGGCGGACGGGGAGCTGTTTTTT	CASTSRGADGELFF	TRBV6-8	TRBJ2-2
TGCGCCAGCAGGTCGGGACGGGTCTCCTGGGACAATGAGCAGTTCTTC	CASRSGRVSWDNEQFF	TRBV10-1	TRBJ2-1
TGTGCCAGCAAGGGACGGAATCAGCCCCAGCATTTT	CASKGRNQPQHF	TRBV6-6	TRBJ1-5
TGTGCCAGCAGTTACCGGACTAGCGGGGGGAATTTAGCGAACACCGGGGAGCTGTTTTTT	CASSYRTSGGNLANTGELFF	TRBV6-6	TRBJ2-2
TGCAGTGCTAGTTTATATGCGGGTTTCCGACAGCTGATCGACACTGAAGCTTTCTTT	CSASLYAGFRQLIDTEAFF	TRBV20-1	TRBJ1-1
TGCGCCAGCTGGTTCCAGGGACGGGAGTGTGGAAACACCATATATTTT	CASWFQGRECGNTIYF	TRBV10-1	TRBJ1-3
TGTGCCAGCAGCCTAATAGGAGGACGGGATGAGCAGTTCTTC	CASSLIGGRDEQFF	TRBV11-2	TRBJ2-1
TGCGCCAAGGCTCCCGTGACTTTCCGCTACGAGCAGTACTTC	CAKAPVTFRYEQYF	TRBV4-3	TRBJ2-7
TGTGCCAGTAGTTCGGAGATTGGGCGTAGTGGGGCCAACGTCCTGACTTTC	CASSSEIGRSGANVLTF	TRBV19	TRBJ2-6
TGTGCCAGCAGCCAAGATCACCGGACAGGGGAGACCCAGTACTTC	CASSQDHRTGETQYF	TRBV14	TRBJ2-5
TGTGCCAGCAGGAGGGAAGGGGGGAAGGGCTACAATGAGCAGTTCTTC	CASRREGGKGYNEQFF	TRBV6-1	TRBJ2-1
TGTGCCAGCAGTTACACCCCGGGGTGCGGTTACGAGCAGTACTTC	CASSYTPGCGYEQYF	TRBV6-6	TRBJ2-7
TGCAGTGCTATTCTTCCCCCAGATTCCGAAAAACTGTTTTTT	CSAILPPDSEKLFF	TRBV20-1	TRBJ1-4
TGCGCCAGCACTAGGACAGGGACCGGAGAGCAGTACTTC	CASTRTGTGEQYF	TRBV5-1	TRBJ2-7
TGTGCCAGCAGCTTAGATGGGCGAAGCCGGGCACGCTACGAGCAGTACTTC	CASSLDGRSRARYEQYF	TRBV11-3	TRBJ2-7
TGTGCCAGCAGTTACCGGATCAGGGCGATGAACACTGAAGCTTTCTTT	CASSYRIRAMNTEAFF	TRBV6-5	TRBJ1-1
TGTGCCAGCAGTTTAGGAGCAGGGGGCTACTTCAATGAAAAACTGTTTTTT	CASSLGAGGYFNEKLFF	TRBV12-4	TRBJ1-4
TGCGCCAGCAGCCAGCTATCAGCGGGATCCCCCGGCTACACCTTC	CASSQLSAGSPGYTF	TRBV4-3	TRBJ1-2
TGTGCCAGCAGTGAACGGGGGGTGCCCTGTTGGTACGAGCAGTACTTC	CASSERGVPCWYEQYF	TRBV2	TRBJ2-7
TGCGCCAGCAGCTTGGAAGACGAGGCTGGTTGCTACGAGCAGTACTTC	CASSLEDEAGCYEQYF	TRBV5-1	TRBJ2-7
TGTGCCAGCAGCTTCCGTGGGGGGTTGGTGAGCTCCTACGAGCAGTACTTC	CASSFRGGLVSSYEQYF	TRBV5-8	TRBJ2-7
TGCGCCAGCAGCTCTCGGGGTCGAAGCCATCCTGAAAAACTGTTTTTT	CASSSRGRSHPEKLFF	TRBV4-3	TRBJ1-4
TGTGCCAGCAGCTTGGGACAGTGCATAAATTCACCCCTCCACTTT	CASSLGQCINSPLHF	TRBV5-5	TRBJ1-6
TGTGCCAGCAGCGAGGGGCCCCCCAACAATCAGCCCCAGCATTTT	CASSEGPPNNQPQHF	TRBV9	TRBJ1-5
TGTGCCAAAGGGCCCCCCGGACAGGGGTACGAGCAGTACTTC	CAKGPPGQGYEQYF	TRBV28	TRBJ2-7
TGTGCCAGCAGGGGGGGGGGAAGCGTAAGGGTCACCGGGGAGCTGTTTTTT	CASRGGGSVRVTGELFF	TRBV7-3	TRBJ2-2
TGTGCCTGGATCAGGGGTGGGAATCAGCCCCAGCATTTT	CAWIRGGNQPQHF	TRBV30	TRBJ1-5
TGTGCCAGCAGCTTGGCCAAACAGGGGGGGACTGGGGCCAACGTCCTGACTTTC	CASSLAKQGGTGANVLTF	TRBV5-6	TRBJ2-6
TGTGCCACCAGTGATTTCCGGGACGGCATGGGCACAGATACGCAGTATTTT	CATSDFRDGMGTDTQYF	TRBV24-1	TRBJ2-3
TGTGCCAGCAGCCTTATAGCGGGATGGGGTCCTAGGGGATACTTC	CASSLIAGWGPRGYF	TRBV4-2	TRBJ2-5
TGTGCCAGCAGCCCGGGGGGGCAGAATCAGCCCCAGCATTTT	CASSPGGQNQPQHF	TRBV7-9	TRBJ1-5
TGTGCCAGCAGTAAATACCAATGGGAGAAATACAATGAGCAGTTCTTC	CASSKYQWEKYNEQFF	TRBV27	TRBJ2-1
TGTGCCAGCAGCCCGGGACATACTGAAGCTTTCTTT	CASSPGHTEAFF	TRBV13	TRBJ1-1
TGTGCCACAAATGAGCAGTTCTTC	CATNEQFF	TRBV7-9	TRBJ2-1
TGTGCCAGCAGCTTTATTGTTCAGGGTTATCACAATGAGCAGTTCTTC	CASSFIVQGYHNEQFF	TRBV7-4	TRBJ2-1
TGTGCCAAGATGACAGGGGGGAAGCCCCAGCATTTT	CAKMTGGKPQHF	TRBV24-1	TRBJ1-5
TGTGCCAGCAGCGGCAGGGTCGATACGCAGTATTTT	CASSGRVDTQYF	TRBV13	TRBJ2-3
TGCAGTGCTAGAGATCAAGGGGACCCCCTCCCCGATGAAAAACTGTTTTTT	CSARDQGDPLPDEKLFF	TRBV20-1	TRBJ1-4
TGCAGTGCTAGAGATCAGTTTCAGGGGGCGGGGGTTCGTAGCAATCAGCCCCAGCATTTT	CSARDQFQGAGVRSNQPQHF	TRBV20-1	TRBJ1-5
TGCGCCAGCAGTGAGACCCCCCAGGCGTGTGCGGACTATGGCTACACCTTC	CASSETPQACADYGYTF	TRBV10-2	TRBJ1-2
TGTGCCAGCAGCTTTGCCAGTCCACTGGCCTACGAGCAGTACTTC	CASSFASPLAYEQYF	TRBV7-9	TRBJ2-7
TGCGCCAGCAGCTTGATAAAAACCCGGGACAGGGGATTGCTGGGCTTCGTGCACTACGAGCAGTACTTC	CASSLIKTRDRGLLGFVHYEQYF	TRBV5-1	TRBJ2-7
TGTGCCATCCAGGCTTTCTTT	CAIQAFF	TRBV6-5	TRBJ1-1
TGTGCCAGCAGCTTGGAGCGACTAGCGGGAGCAGATACGCAGTATTTT	CASSLERLAGADTQYF	TRBV5-6	TRBJ2-3
TGCAGTGCTAGACGCAGGAATTCACCCCTCCACTTT	CSARRRNSPLHF	TRBV20-1	TRBJ1-6
TGTGCCAGCAGCTCTTGGGGGTGGTCGGCCCAAGAGACCCAGTACTTC	CASSSWGWSAQETQYF	TRBV5-6	TRBJ2-5
TGTGCCAGCAGCCAAGATCCGTCGGGGGAGGTAGGGCGCAATCAGCCCCAGCATTTT	CASSQDPSGEVGRNQPQHF	TRBV3-1	TRBJ1-5
TGTGCCAGCAGTTATTTAGCGGCTGGTGAGCAGTTCTTC	CASSYLAAGEQFF	TRBV6-5	TRBJ2-1
TGTGCCACACGAAAGTATGGCTACACCTTC	CATRKYGYTF	TRBV27	TRBJ1-2
TGTGCCAGCAGCCAAGAGGAAGACAGCACTATGAACACTGAAGCTTTCTTT	CASSQEEDSTMNTEAFF	TRBV3-1	TRBJ1-1
TGCGCCAGCAGCCAGAGACAGGACAGGAACACTGAAGCTTTCTTT	CASSQRQDRNTEAFF	TRBV4-1	TRBJ1-1
TGTGCCAGCAGCTCACGGCTCAGCAATCAGCCCCAGCATTTT	CASSSRLSNQPQHF	TRBV7-3	TRBJ1-5
TGTGCCAGCAGTTCCGGGACTAGCGGGAGTACCGGACCCCCTAGCTCTGGAAACACCATATATTTT	CASSSGTSGSTGPPSSGNTIYF	TRBV27	TRBJ1-3
TGCAGTGCTAGAGATTCAACGGTAAACAGGGTCAATCGGGCAACCCACGAGCAGTACTTC	CSARDSTVNRVNRATHEQYF	TRBV20-1	TRBJ2-7
TGCAGTGCTCCTCAACCTCCAGGACCTTATGGCTACACCTTC	CSAPQPPGPYGYTF	TRBV20-1	TRBJ1-2
TGTGCCAGCAGTTACCCGGACCCCCCCTACGAGCAGTACTTC	CASSYPDPPYEQYF	TRBV6-5	TRBJ2-7
TGTGCCAGCAGCGTACGGCAAGACCTGGGGCGAGAAGCTTTCTTT	CASSVRQDLGREAFF	TRBV9	TRBJ1-1
TGTGCCAGCTCACCCCCTCTAGCTCTCTCCTACGAGCAGTACTTC	CASSPPLALSYEQYF	TRBV18	TRBJ2-7
TGTGCCAGCAGCTTAAAGCTGGACAGTACATACGAGCAGTACTTC	CASSLKLDSTYEQYF	TRBV7-3	TRBJ2-7
TGCGCCAGGACCTGGAGGGGGCCCTCGAACACCGGGGAGCTGTTTTTT	CARTWRGPSNTGELFF	TRBV10-1	TRBJ2-2
TGTGCCAGCAGTTTCCTCTCAATGTGCAGCAATCAGCCCCAGCATTTT	CASSFLSMCSNQPQHF	TRBV27	TRBJ1-5
TGTGCCAGCTGGGGGGGCGTCTACGAGCAGTACTTC	CASWGGVYEQYF	TRBV6-1	TRBJ2-7
TGTGCCAGCAGTGAATCCGGGGCTGAGGGGAATGAAAAACTGTTTTTT	CASSESGAEGNEKLFF	TRBV25-1	TRBJ1-4
TGTGCCAGCAGTTTACTCTGGGCCTTACACGTTAGAACCGTCTCCTACGAGCAGTACTTC	CASSLLWALHVRTVSYEQYF	TRBV27	TRBJ2-7
TGCGCCAGCTCCCCATGGACAGGGGGCGTGAACACTGAAGCTTTCTTT	CASSPWTGGVNTEAFF	TRBV5-1	TRBJ1-1
TGTGCCAGTAGTTGGGACAGCCGTTGCCCCTACGAGCAGTACTTC	CASSWDSRCPYEQYF	TRBV19	TRBJ2-7
TGTGCCTGGAGTGTACGGGGGGGGCGAAACACCATATATTTT	CAWSVRGGRNTIYF	TRBV30	TRBJ1-3
TGTGCCATCATTCTACAGCGCTACGAGCAGTACTTC	CAIILQRYEQYF	TRBV10-3	TRBJ2-7
TGTGCCACCAGCAGAGACGGAAAATGGGTGGTTGGCTACACCTTC	CATSRDGKWVVGYTF	TRBV15	TRBJ1-2
TGTGCCAGCAGCCAAAGTTGGACTGAAAAACTGTTTTTT	CASSQSWTEKLFF	TRBV7-9	TRBJ1-4
TGTGCCAGCAGCGAAGAACTGGACAGGGGTTACAACACCGGGGAGCTGTTTTTT	CASSEELDRGYNTGELFF	TRBV13	TRBJ2-2
TGTGCCAGCAGCTTAGCCCCTCCCTGGATGGGACACTCAACTAATGAAAAACTGTTTTTT	CASSLAPPWMGHSTNEKLFF	TRBV11-2	TRBJ1-4
TGCGCCAGCAGCCTGCAGGGGGGGGTTCATGCAAACATTCAGTACTTC	CASSLQGGVHANIQYF	TRBV4-1	TRBJ2-4
TGTGCCAGCAGTGAAGACAGGGAAGAGCAGTACTTC	CASSEDREEQYF	TRBV27	TRBJ2-7
TGTGCCAGCAGTTACGAAGGGGTAAACAATGAGCAGTTCTTC	CASSYEGVNNEQFF	TRBV6-3	TRBJ2-1
TGTGCCAGCAGCCAGGCGACAGGGGATGAAAAACTGTTTTTT	CASSQATGDEKLFF	TRBV14	TRBJ1-4
TGCGCCAGCAGTACAGGTCCTTCCCCCGCGCCCCAGCATTTT	CASSTGPSPAPQHF	TRBV5-1	TRBJ1-5
TGCGCCAGCAGCAAAGGACAGGGCATCTCCTACGAGCAGTACTTC	CASSKGQGISYEQYF	TRBV5-1	TRBJ2-7
TGTGCCAGCAGCTCGACGGCGGTCTCGGGGGGGGTCTACGAGCAGTACTTC	CASSSTAVSGGVYEQYF	TRBV13	TRBJ2-7
TGTGCCAGCAGCCCCGGGGGACAGGTACCCTACGAGCAGTACTTC	CASSPGGQVPYEQYF	TRBV3-1	TRBJ2-7
TGTGCCAGCAGCTTAAGGGGATGGGGGGAAAGTGAAGCTTTCTTT	CASSLRGWGESEAFF	TRBV7-9	TRBJ1-1
TGTGCCATCAAGGTGCCCGGGGACGAGCAGTACTTC	CAIKVPGDEQYF	TRBV10-3	TRBJ2-7
TGTGCCAGCAGCTTGGACGGGGGACGCCTGAACACTGAAGCTTTCTTT	CASSLDGGRLNTEAFF	TRBV5-6	TRBJ1-1
TGTGCCAGCAGCTTGCGTGGCAATCACACCGGGGAGCTGTTTTTT	CASSLRGNHTGELFF	TRBV6-1	TRBJ2-2
TGTGCCAGCAGTGACTCGATCCCAGGATGGTATGGCTACACCTTC	CASSDSIPGWYGYTF	TRBV6-4	TRBJ1-2
TGCAGCGGCCCACGACGCCTGGGGCCAACTAATGAAAAACTGTTTTTT	CSGPRRLGPTNEKLFF	TRBV29-1	TRBJ1-4
TGTGCTAGTGGTTTGGGACTAGCGGGGTTAGATGAGCAGTTCTTC	CASGLGLAGLDEQFF	TRBV12-5	TRBJ2-1
TGCAGCGTTGAAGATGAGGGGGGACAGAGGGGGTTTTCGAACACCGGGGAGCTGTTTTTT	CSVEDEGGQRGFSNTGELFF	TRBV29-1	TRBJ2-2
TGTGCCAGCAGCTTAGAGGCAGATCACAGGGCAGGCTACACCTTC	CASSLEADHRAGYTF	TRBV7-6	TRBJ1-2
TGTGCCAGCAGAGGGGGGGGCTACGAGCAGTACTTC	CASRGGGYEQYF	TRBV6-5	TRBJ2-7
TGTGCCAGCAGCCTGACATACGAGCAGTACTTC	CASSLTYEQYF	TRBV6-5	TRBJ2-7
TGTGCCAGCAGCGGGTCCGGGACAGGGAGGTGGACTGAAGCTTTCTTT	CASSGSGTGRWTEAFF	TRBV11-2	TRBJ1-1
TGTGCTAGTGGTTCATGTAGAGAACGGGGTGATCGCTCCTATAATTCACCCCTCCACTTT	CASGSCRERGDRSYNSPLHF	TRBV12-5	TRBJ1-6
TGTGCCAGCACGTGGGGACAAGATGTTAGTCTTAGGGGGCGTCAGCCCCAGCATTTT	CASTWGQDVSLRGRQPQHF	TRBV12-3	TRBJ1-5
TGTGCCAGCAGCAGGCATGGCTACACCTTC	CASSRHGYTF	TRBV6-5	TRBJ1-2
TGTGCCAGCAGCTTTCACCCACACGAGCAGTACTTC	CASSFHPHEQYF	TRBV7-9	TRBJ2-7
TGTGCCAGCAGCTCCCCGGGACAGAACTATGGCTACACCTTC	CASSSPGQNYGYTF	TRBV11-3	TRBJ1-2
TGTGCCAGCAGGGGCATCCACACTAGCGTATCCTACGAGCAGTACTTC	CASRGIHTSVSYEQYF	TRBV6-1	TRBJ2-7
TGTGCCAGCAGCTTCAAGGTATTATCACCCCTCCACTTT	CASSFKVLSPLHF	TRBV7-3	TRBJ1-6
TGTGCCAGCAGCTTAAGACAGGGTTATAGCAATCAGCCCCAGCATTTT	CASSLRQGYSNQPQHF	TRBV11-3	TRBJ1-5
TGTGCCAGCAGCTTCCAAACGGGGACCCACACTGAAGCTTTCTTT	CASSFQTGTHTEAFF	TRBV11-2	TRBJ1-1
TGCGCCAGCGGGGACCCTGAAGCTTTCTTT	CASGDPEAFF	TRBV5-1	TRBJ1-1
TGTGCCAGCAAAGATACTAGCGGGAGGGCCCTTCATGAGCAGTTCTTC	CASKDTSGRALHEQFF	TRBV6-5	TRBJ2-1
TGCAGTGCTAGTCGGAAGACCTACGAGCAGTACTTC	CSASRKTYEQYF	TRBV20-1	TRBJ2-7
TGTGCCAGCGACCTGGGAGCTGGCCTTGAGACCCAGTACTTC	CASDLGAGLETQYF	TRBV28	TRBJ2-5
TGTGCCAGCATCCCGACAGCGAACTATGGCTACACCTTC	CASIPTANYGYTF	TRBV6-3	TRBJ1-2
TGTGCCAGCAAACCAGGGTTTGCCAATCAGCCCCAGCATTTT	CASKPGFANQPQHF	TRBV12-3	TRBJ1-5
TGTGCCAGCAGTGAAATTAGACAAAGGGCCGAGCAGTACTTC	CASSEIRQRAEQYF	TRBV2	TRBJ2-7
TGCAGTGCTAGAAAACAACCGACGGGTGGCTATGGCTACACCTTC	CSARKQPTGGYGYTF	TRBV20-1	TRBJ1-2
TGCGCCAGCAGCCAAGATCCCTGTCAGATCGTTAGTTTCTACAATGAGCAGTTCTTC	CASSQDPCQIVSFYNEQFF	TRBV4-1	TRBJ2-1
TGTGCCAGCAGTGGACAGGGATGTCTAGCGGGTCCGACCTACGAGCAGTACTTC	CASSGQGCLAGPTYEQYF	TRBV25-1	TRBJ2-7
TGTGCCAGCAGCGAACGGGGGCAGACTGGCTACACCTTC	CASSERGQTGYTF	TRBV13	TRBJ1-2
TGTGCCAGCAGCGACCTAAATTCGGGGAGGGGAAACACCATATATTTT	CASSDLNSGRGNTIYF	TRBV13	TRBJ1-3
TGTGCCAGCCCAGGGCTAATAGAGACCCAGTACTTC	CASPGLIETQYF	TRBV12-3	TRBJ2-5
TGCGCCAGCAAATGGACAGGGAACAGGATGAACACTGAAGCTTTCTTT	CASKWTGNRMNTEAFF	TRBV10-1	TRBJ1-1
TGCGCCAGCAAAAAAGAGAGCCCAGACTATGGCTACACCTTC	CASKKESPDYGYTF	TRBV10-1	TRBJ1-2
TGCGCCAGCAGCACCCCAGGGCCCCATCAGCCCCAGCATTTT	CASSTPGPHQPQHF	TRBV10-1	TRBJ1-5
TGTGCCAGCAGTTACGTCACTCGAGGGGATGACTCAAACAAAAACATTCAGTACTTC	CASSYVTRGDDSNKNIQYF	TRBV6-6	TRBJ2-4
TGTGCCAGCAGTTCTATGGGAAGAACAGATACGCAGTATTTT	CASSSMGRTDTQYF	TRBV6-6	TRBJ2-3
TGTGCCAGCAGCCAAGGGGCTAGCGGGGGTAATGAGCAGTTCTTC	CASSQGASGGNEQFF	TRBV14	TRBJ2-1
TGCGCCAGCAGCTCTCGAGGGACCACCCCCATCTATGAGCAGTTCTTC	CASSSRGTTPIYEQFF	TRBV5-1	TRBJ2-1
TGTGCCAGCAGTTCTATCCCGGGACTAGCGGTAGAGACCCAGTACTTC	CASSSIPGLAVETQYF	TRBV6-6	TRBJ2-5
TGCGCCAGCAGCTTCCCCCGGGGGCATCGGCGATCCTACGAGCAGTACTTC	CASSFPRGHRRSYEQYF	TRBV5-1	TRBJ2-7
TGTGCCAGCAGTTACGGCGACAGGGGTGTTGAAAAACTGTTTTTT	CASSYGDRGVEKLFF	TRBV6-6	TRBJ1-4
TGTGCCAGCAGCAAACAGGGAAGAGTTATGGTGAACACTGAAGCTTTCTTT	CASSKQGRVMVNTEAFF	TRBV14	TRBJ1-1
TGTGCCAGCAGCTTTTGGACAGGTCCCACTGAAGCTTTCTTT	CASSFWTGPTEAFF	TRBV11-2	TRBJ1-1
TGTGCCAGCAGCACCACAATAGATCACCAAGAGACCCAGTACTTC	CASSTTIDHQETQYF	TRBV7-3	TRBJ2-5
TGCAGTGCTAGAGGCCTCGCATACAGGGACAGCTATGGCTACACCTTC	CSARGLAYRDSYGYTF	TRBV20-1	TRBJ1-2
TGTGCCAGCAGCTTTCGGGACAGGGGGCCTTCGATTCAAGAGACCCAGTACTTC	CASSFRDRGPSIQETQYF	TRBV7-9	TRBJ2-5
TGTGCCAGCAGCTTGGTTTCTCAGGGGGTTGACACTGAAGCTTTCTTT	CASSLVSQGVDTEAFF	TRBV11-2	TRBJ1-1
TGTGCCACCAGTGATTTGGGGGAGGATAATCAGCCCCAGCATTTT	CATSDLGEDNQPQHF	TRBV24-1	TRBJ1-5
TGTGCCAGCAGCCAAGATGCCCCGGGGGGGGGGGACACCGGGGAGCTGTTTTTT	CASSQDAPGGGDTGELFF	TRBV3-1	TRBJ2-2
TGTGCCACCACGGACTGGGAAGAGACCCAGTACTTC	CATTDWEETQYF	TRBV24-1	TRBJ2-5
TGTGCCAGCGGGGGCCTGAACACTGAAGCTTTCTTT	CASGGLNTEAFF	TRBV9	TRBJ1-1
TGTGCCAGTAGCCTCCTCGGGTTGGGGACTAGCGGGGGCTACAATGAGCAGTTCTTC	CASSLLGLGTSGGYNEQFF	TRBV19	TRBJ2-1
TGTGCCAGCAGCTTGGACTTAGGGACAGTCGGTCGCGATGGGAAGAACACTGAAGCTTTCTTT	CASSLDLGTVGRDGKNTEAFF	TRBV7-4	TRBJ1-1
TGTGCCAGCACCGGACCCGGGCTCGACCGAACTGAAGCTTTCTTT	CASTGPGLDRTEAFF	TRBV7-2	TRBJ1-1
TGTGCCAGCAGTGTTACCAATCCTCGACAGGGGCATGAGCAGTTCTTC	CASSVTNPRQGHEQFF	TRBV6-4	TRBJ2-1
TGTGCCACGCTGGGGGGGTGGAGCACAGATACGCAGTATTTT	CATLGGWSTDTQYF	TRBV24-1	TRBJ2-3
TGTGCCAGCTCACCGCAGGGGAGGGAGTACTTC	CASSPQGREYF	TRBV18	TRBJ2-5
TGTGCCAGCCCCACAGGGGAGATGAACACTGAAGCTTTCTTT	CASPTGEMNTEAFF	TRBV6-1	TRBJ1-1
TGTGCCAGCAGGTTCGGGGCGGAAAATCAGCCCCAGCATTTT	CASRFGAENQPQHF	TRBV6-2	TRBJ1-5
TGCGCCAGCAGTGAGGGGGGAGCCAATTCACCCCTCCACTTT	CASSEGGANSPLHF	TRBV10-1	TRBJ1-6
TGTGCCAGCAGTGAAATGCGTCGGGACAGGGGGGACCACACCTTC	CASSEMRRDRGDHTF	TRBV6-5	TRBJ1-2
TGTGCCAGCAGTTACGGTACAGGGGTGGTGGGGGACCCCTACGAGCAGTACTTC	CASSYGTGVVGDPYEQYF	TRBV6-3	TRBJ2-7
TGTGCCAGCAGTTTAGGGCCGTTGGGACAGAACACTGAAGCTTTCTTT	CASSLGPLGQNTEAFF	TRBV12-3	TRBJ1-1
TGTGCCATCAGTAAGAGGGACGGGTACGAGCAGTACTTC	CAISKRDGYEQYF	TRBV10-3	TRBJ2-7
TGTGCCAGCAGCTTAGGCAGGACTAGCCAGCGGGATACGCAGTATTTT	CASSLGRTSQRDTQYF	TRBV7-4	TRBJ2-3
TGTGCCAGCAGACGTTCCCAAAAGGGCACTGAAGCTTTCTTT	CASRRSQKGTEAFF	TRBV6-5	TRBJ1-1
TGTGCCAGCAGGTTTCGAAGCAATCAGCCCCAGCATTTT	CASRFRSNQPQHF	TRBV11-1	TRBJ1-5
TGCGCCAGCCCGACAGGGGAGACCCAGTACTTC	CASPTGETQYF	TRBV4-3	TRBJ2-5
TGCAGTGCTAGAGTACCGGGACTCTCCTACGAGCAGTACTTC	CSARVPGLSYEQYF	TRBV20-1	TRBJ2-7
TGTGCCAGCAGCGTAGATCGCCCCGAGGGGGATCCAACCGGGGAGCTGTTTTTT	CASSVDRPEGDPTGELFF	TRBV9	TRBJ2-2
TGTGCCTGGAAATGGGGGGGGGAGCTGTTTTTT	CAWKWGGELFF	TRBV2	TRBJ2-2
TGTGCCACTAACGTTGCAACTAATGAAAAACTGTTTTTT	CATNVATNEKLFF	TRBV28	TRBJ1-4
TGCGCCAGCAGCATTCTAGACGAGCAGTACTTC	CASSILDEQYF	TRBV5-1	TRBJ2-7
TGTGCCAGCAGCTTAGATGCGGACGTACAAGAGACCCAGTACTTC	CASSLDADVQETQYF	TRBV11-2	TRBJ2-5
TGTGCCACCAGTGATAGCCGGGACAGGGGGAACTATAATTCACCCCTCCACTTT	CATSDSRDRGNYNSPLHF	TRBV24-1	TRBJ1-6
TGTGCCAGCAGTGATCCCCTGACAGGGGAGATAGGCGAGCAGTACTTC	CASSDPLTGEIGEQYF	TRBV7-9	TRBJ2-7
TGTGCCAGCAGCCACTGGAGGGTTCGGACTCCCTACGAGCAGTACTTC	CASSHWRVRTPYEQYF	TRBV14	TRBJ2-7
TGCGCCAAAACTCTCCGGACAGGGTCACTAGGCACAGATACGCAGTATTTT	CAKTLRTGSLGTDTQYF	TRBV4-1	TRBJ2-3
TGCAGTGCTGTGTATCAGCATCCCGGGAGGAGCTCCTACGAGCAGTACTTC	CSAVYQHPGRSSYEQYF	TRBV20-1	TRBJ2-7
TGCGCCAGCAGCCAAGCTTACAGGGGAATTAGATGTAGCAATCAGCCCCAGCATTTT	CASSQAYRGIRCSNQPQHF	TRBV4-1	TRBJ1-5
TGCGCCAGCAGCTTGCGGCTAGGACGGGTTAGCAATCAGCCCCAGCATTTT	CASSLRLGRVSNQPQHF	TRBV5-1	TRBJ1-5
TGTGCCAGCAGTGGAGATGTCCGCGGGGGGGCCGAAGCCAACTATGGCTACACCTTC	CASSGDVRGGAEANYGYTF	TRBV6-4	TRBJ1-2
TGTGCCAGCACGTTTCAAGCGGGACTCAACTATGGCTACACCTTC	CASTFQAGLNYGYTF	TRBV27	TRBJ1-2
TGCAAGAGGCCGGGACTAACCCCAGATGAGCAGTTCTTC	CKRPGLTPDEQFF	TRBV20-1	TRBJ2-1
TGCAGCGTAGCGTCCAAAGTGTCTCAGCCCCAGCATTTT	CSVASKVSQPQHF	TRBV29-1	TRBJ1-5
TGTGCCAGCATCCCTATGGAGGCAGGGGGAGCGAACACCGGGGAGCTGTTTTTT	CASIPMEAGGANTGELFF	TRBV6-5	TRBJ2-2
TGTGCCAGCAGTTACTCGAGGAGGGGCGGAATTACAGATACGCAGTATTTT	CASSYSRRGGITDTQYF	TRBV6-2	TRBJ2-3
TGTGCCAGCAGTTTCGTCCGCCGCAGAAGACTAGGGAATCCCTATAATTCACCCCTCCACTTT	CASSFVRRRRLGNPYNSPLHF	TRBV27	TRBJ1-6
TGTGCCAGCAGCTTGGCCGGTAGGGGGGCCTACGAGCAGTACTTC	CASSLAGRGAYEQYF	TRBV5-5	TRBJ2-7
TGTGCCAGCAGCCAAGGACTAGCGGGCACAGATACGCAGTATTTT	CASSQGLAGTDTQYF	TRBV7-6	TRBJ2-3
TGTGCCAGCTCTATGGGACAGGAGGGGATCTTCAACACTGAAGCTTTCTTT	CASSMGQEGIFNTEAFF	TRBV18	TRBJ1-1
TGTGCCAGCAGCTTAGAGGGTGATAGCTCCTACGAGCAGTACTTC	CASSLEGDSSYEQYF	TRBV13	TRBJ2-7
TGCGCCAGCAGCTTGTCAGGAAGCCCCGGCTACACCTTC	CASSLSGSPGYTF	TRBV5-1	TRBJ1-2
TGTGCCAGCAGCCATGGACAGTTCTACGAGCAGTACTTC	CASSHGQFYEQYF	TRBV3-1	TRBJ2-7
TGTGCCAGCAGTTACTACGGAGGGCGCGTCTTCGTGGGCTACACCTTC	CASSYYGGRVFVGYTF	TRBV6-5	TRBJ1-2
TGCGCCACCCCCTCACAGGACTGGTCTGAAGCTTTCTTT	CATPSQDWSEAFF	TRBV5-1	TRBJ1-1
TGTGCCAGCAGCTTAGCGTTTAGCGGGGTGGATGAGCAGTTCTTC	CASSLAFSGVDEQFF	TRBV7-9	TRBJ2-1
TGCGCCAGCAGCCATCTCGGGGGGGACACCGGGGAGCTGTTTTTT	CASSHLGGDTGELFF	TRBV4-3	TRBJ2-2
TGTGCCACCAGTGATTTCCGTGATCCTATAGGTCCTGCCGACACCGGGGAGCTGTTTTTT	CATSDFRDPIGPADTGELFF	TRBV24-1	TRBJ2-2
TGTGCCAGCAGTGTCATCCCAGAGGAGTCCAGCTCCTACGAGCAGTACTTC	CASSVIPEESSSYEQYF	TRBV6-1	TRBJ2-7
TGTGCCAGCAGCCCGGGGGGACTCGGCCCAGATACGCAGTATTTT	CASSPGGLGPDTQYF	TRBV6-3	TRBJ2-3
TGTGCCACCAGTGCTGAAGATCAGCCCCAGCATTTT	CATSAEDQPQHF	TRBV24-1	TRBJ1-5
TGTGCCAGCAGTTTTCCCCCTGGGCAGGTAAATGAGCAGTTCTTC	CASSFPPGQVNEQFF	TRBV27	TRBJ2-1
TGTGCCAGCAGCGCAAACCGACAGGGGACCCTCCACTTT	CASSANRQGTLHF	TRBV7-3	TRBJ1-6
TGTGCCAGCAGTTTTAAGCTGTGCGGACAAGCCTGTCAAGAGACCCAGTACTTC	CASSFKLCGQACQETQYF	TRBV12-3	TRBJ2-5
TGTGCCAGCCTTCACAGGGGAAATAGCAATCAGCCCCAGCATTTT	CASLHRGNSNQPQHF	TRBV27	TRBJ1-5
TGTGCCATCAGTGAGTACTGGACAGCGGGCGAGCAGTACTTC	CAISEYWTAGEQYF	TRBV10-3	TRBJ2-7
TGCAGCGTCCGGCCCTACGAGCAGTACTTC	CSVRPYEQYF	TRBV29-1	TRBJ2-7
TGTGCCAGCAGGGACGGACAGGGGTTGGGGACTGAAGCTTTCTTT	CASRDGQGLGTEAFF	TRBV28	TRBJ1-1
TGTGCCATCAGTGGTAGGGACATTCCCTACGAGCAGTACTTC	CAISGRDIPYEQYF	TRBV10-3	TRBJ2-7
TGTGCCACCAGTGTTTTCCCAGGCACAAGCAATGAGCAGTTCTTC	CATSVFPGTSNEQFF	TRBV24-1	TRBJ2-1
TGTGCCTGGGACTTGAATAGCAATCAGCCCCAGCATTTT	CAWDLNSNQPQHF	TRBV6-2	TRBJ1-5
TGTGCCAGCAGTGAGGTTGTGCTTCGGTCCAAAGAGCAGTACTTC	CASSEVVLRSKEQYF	TRBV28	TRBJ2-7
TGTGCCAGCAGTCCAAGAACGAACTATGGCTACACCTTC	CASSPRTNYGYTF	TRBV27	TRBJ1-2
TGTGCCAGCAGTGCAGGTCCAAGATTCTCCGCGAGAGAAGTTATTGGCACCGGGGAGCTGTTTTTT	CASSAGPRFSAREVIGTGELFF	TRBV6-4	TRBJ2-2
TGTGCCAGCAGCCAGCTCACAGGGAACACTGAAGCTTTCTTT	CASSQLTGNTEAFF	TRBV14	TRBJ1-1
TGCGGTAGGTTGGGCCTACATTACGAGCAGTACTTC	CGRLGLHYEQYF	TRBV20-1	TRBJ2-7
TGTGCCAGCATGGTAGGTGACGGGTCCGGGGAGCTGTTTTTT	CASMVGDGSGELFF	TRBV28	TRBJ2-2
TGTGCCAGCAGCCAAGTCGAGCGGGAGGGAACTGAAGCTTTCTTT	CASSQVEREGTEAFF	TRBV3-1	TRBJ1-1
TGTGCCAGCAGCATCTACTCGTGGACCTTTGCCTTGGAAGAAAAACTGTTTTTT	CASSIYSWTFALEEKLFF	TRBV14	TRBJ1-4
TGTGCCAGCAGTTCGGGGGGCCTTTACTCCTACGAGCAGTACTTC	CASSSGGLYSYEQYF	TRBV27	TRBJ2-7
TGTGCCAGCAGCGAGGGGGGGCCCACAGATACGCAGTATTTT	CASSEGGPTDTQYF	TRBV13	TRBJ2-3
TGTGCCAGCAGCTGCAGCTATGGCTACACCTTC	CASSCSYGYTF	TRBV7-4	TRBJ1-2
TGCAGTGCTCGGGACGGTTACATTCAGTACTTC	CSARDGYIQYF	TRBV20-1	TRBJ2-4
TGTGCCAGGCGGCATCCAGGTGAAGCTTTCTTT	CARRHPGEAFF	TRBV5-4	TRBJ1-1
TGTGCCAGCAGCAGACGGGACAGGGTAGTACTTTGCAATCAGCCCCAGCATTTT	CASSRRDRVVLCNQPQHF	TRBV3-1	TRBJ1-5
TGTGCCAGCAGCGCCGCGCACCAGCCCCAGCATTTT	CASSAAHQPQHF	TRBV7-2	TRBJ1-5
TGTGCCAGCAGTTACATAAGCCAGGACAGTAGCAATCAGCCCCAGCATTTT	CASSYISQDSSNQPQHF	TRBV6-5	TRBJ1-5
TGTGCCACCAGTGGACTAGACAACCTTGGCGGGGAGCTGTTTTTT	CATSGLDNLGGELFF	TRBV24-1	TRBJ2-2
TGTGCCAGCAGCGGCAAGCGGGAGGGTAGAGAGACCCAGTACTTC	CASSGKREGRETQYF	TRBV5-5	TRBJ2-5
TGCGCCAGCAGCTTGGCGGGCGACGTCACTAGCGGGAGGCGGAGCACCTACGAGCAGTACTTC	CASSLAGDVTSGRRSTYEQYF	TRBV5-1	TRBJ2-7
TGTGCCACCAGCAGAGTAGGGGGACGAGTGGTTACCTACGAGCAGTACTTC	CATSRVGGRVVTYEQYF	TRBV15	TRBJ2-7
TGTGCCTGGAGTCGGGATACCTACAATGAGCAGTTCTTC	CAWSRDTYNEQFF	TRBV30	TRBJ2-1
TGTGCTAGTGGTCCCAACTCTAGCGGGAACACCGGGGAGCTGTTTTTT	CASGPNSSGNTGELFF	TRBV12-5	TRBJ2-2
TGTGCCAGCAGTTTACTGAAGGGGGAGACCCAGCCCCAGCATTTT	CASSLLKGETQPQHF	TRBV27	TRBJ1-5
TGCGCCAGCAGCGTAGACAGCACTGAAGCTTTCTTT	CASSVDSTEAFF	TRBV5-1	TRBJ1-1
TGTGCCAGCAGCAGTCAATTACTTGGGGGGAGGAGTCGTGGGGTCTCAGCCAAAAACATTCAGTACTTC	CASSSQLLGGRSRGVSAKNIQYF	TRBV13	TRBJ2-4
TGTGCCAGCAAATGTACCGGGGCTGGTCAGCCCCAGCATTTT	CASKCTGAGQPQHF	TRBV27	TRBJ1-5
TGTGCCAGCAGCGTGGGTGAGGGGAATTCACCCCTCCACTTT	CASSVGEGNSPLHF	TRBV13	TRBJ1-6
TGTGCCAGCAGCGTAGGCGGGACAGGGACTCCCCAGCATTTT	CASSVGGTGTPQHF	TRBV9	TRBJ1-5
TGTGCCAGCAGCTTGGCACCCCGGAGAGGCCCTGAGCAGTACTTC	CASSLAPRRGPEQYF	TRBV5-4	TRBJ2-7
TGTGCCACCAGTGATTTGGTGGGACAGGGTTTGGGGCTTAGGTACCATAGCAATCAGCCCCAGCATTTT	CATSDLVGQGLGLRYHSNQPQHF	TRBV24-1	TRBJ1-5
TGTGCCAGCAGCCGAAGGGGGGGAGAGACCCAGTACTTC	CASSRRGGETQYF	TRBV12-4	TRBJ2-5
TGTGCCTCTAAATATACAGATCTGGGGACCCATCAGCCCCAGCATTTT	CASKYTDLGTHQPQHF	TRBV10-3	TRBJ1-5
TGCGCCAGCATTCGGCGATTCCAGACAGCACGGGCGGAGCCCCAGCATTTT	CASIRRFQTARAEPQHF	TRBV10-2	TRBJ1-5
TGTGCCAGCAGCAGCGGAGCCTTCGGGGACAGCTACAATGAGCAGTTCTTC	CASSSGAFGDSYNEQFF	TRBV9	TRBJ2-1
TGTGCCAGCCTAGCCGGGACAGGGGCTTCCAACAATCAGCCCCAGCATTTT	CASLAGTGASNNQPQHF	TRBV27	TRBJ1-5
TGTGCCAACTGTGATATCCGGGGATACTTATATGACAATGAGCAGTTCTTC	CANCDIRGYLYDNEQFF	TRBV19	TRBJ2-1
TGTGCCAGCAGCTTACTGACTAGCTACGAGCAGTACTTC	CASSLLTSYEQYF	TRBV7-2	TRBJ2-7
TGCGCCAGCAGCCAAGACGGACCTAAATCTATGGCTAAAAACACCGGGGAGCTGTTTTTT	CASSQDGPKSMAKNTGELFF	TRBV4-1	TRBJ2-2
TGCAGCGTTGGAAGGGGACAGGGGGAACGCTCCTACGAGCAGTACTTC	CSVGRGQGERSYEQYF	TRBV29-1	TRBJ2-7
TGTGCCAGCAGCTTCCGGTCACGGGGGACCTACGAGCAGTACTTC	CASSFRSRGTYEQYF	TRBV11-3	TRBJ2-7
TGTGCCAGCAGCAGGGAACCGGGACGAGGCCCCTACGAGCAGTACTTC	CASSREPGRGPYEQYF	TRBV11-2	TRBJ2-7
TGTGCCAGCAGCGTAGCTTCCTGGGGGAGCACAGATACGCAGTATTTT	CASSVASWGSTDTQYF	TRBV9	TRBJ2-3
TGTGCCAGCAGCCACACAGGTGGTTGGACTAGCGGGAGCGGTGGGCAAGAGACCCAGTACTTC	CASSHTGGWTSGSGGQETQYF	TRBV3-1	TRBJ2-5
TGTGCCAGCAGCTTCCAGGGCTACGAGCAGTACTTC	CASSFQGYEQYF	TRBV6-5	TRBJ2-7
TGTGCCAGCAGTGAGGGAGAGGATCAGCCCCAGCATTTT	CASSEGEDQPQHF	TRBV25-1	TRBJ1-5
TGTGCCAGCAGTTACAAGGGTCCTGGACTAGCGGGGAGGTTCCCGGCCTACGAGCAGTACTTC	CASSYKGPGLAGRFPAYEQYF	TRBV6-5	TRBJ2-7
TGCAGTGTCGGGAACACAGGCAATCAGCCCCAGCATTTT	CSVGNTGNQPQHF	TRBV20-1	TRBJ1-5
TGTGCCAGCAGCTTAGTAGTGTCTGGCTACACCTTC	CASSLVVSGYTF	TRBV11-1	TRBJ1-2
TGCGCCAGCAGTGAACGTGTTCTTGGGGGGGGCATAGATACGCAGTATTTT	CASSERVLGGGIDTQYF	TRBV10-1	TRBJ2-3
TGTGCCAGCAGCTTCGGGGCAGGATGCCAAGATACTAACTATGGCTACACCTTC	CASSFGAGCQDTNYGYTF	TRBV11-3	TRBJ1-2
TGTGCCAGCAGTTCATTTACCGGGACTAGCGGGAGTTTACGGGACTTCGCGCAGTATTTT	CASSSFTGTSGSLRDFAQYF	TRBV28	TRBJ2-3
TGTGCCAGCAGTTACTCGACCACTGGGACACTCTACGAGCAGTACTTC	CASSYSTTGTLYEQYF	TRBV6-5	TRBJ2-7
TGTGCCAGAAACAGGTTGCAAAACATTCAGTACTTC	CARNRLQNIQYF	TRBV9	TRBJ2-4
TGTGCCACCGTAAAGCCGACTCCTCAGCCCCAGCATTTT	CATVKPTPQPQHF	TRBV24-1	TRBJ1-5
TGTGCCACCAGAACGACAGTACGAAGATACGAGCAGTACTTC	CATRTTVRRYEQYF	TRBV24-1	TRBJ2-7
TGTGCCAGCAGCTTGCGGGGGCCCGGCTACACCTTC	CASSLRGPGYTF	TRBV5-4	TRBJ1-2
TGTGCCAGCAGCCAAGATCCAGGCCAGTACGAGCAGTACTTC	CASSQDPGQYEQYF	TRBV14	TRBJ2-7
TGTGCCAGCAGCAACGGACCGCGGACAGGGCCTCAGGACACCGGGGAGCTGTTTTTT	CASSNGPRTGPQDTGELFF	TRBV5-5	TRBJ2-2
TGTGCCAGGAACGATTGTACGCAGTATTTT	CARNDCTQYF	TRBV7-9	TRBJ2-3
TGTGCCAGCAATCATGGGCTTTACGAGCAGTACTTC	CASNHGLYEQYF	TRBV14	TRBJ2-7
TGTATTAAGACCGACAATGAGCAGTTCTTC	CIKTDNEQFF	TRBV30	TRBJ2-1
TGTGCCACCAGTGATATGCAAGAGGGCCTGGTCTACAATGAGCAGTTCTTC	CATSDMQEGLVYNEQFF	TRBV24-1	TRBJ2-1
TGTGCCACCAGTGATTTGCTGAACACGCAGCCCCAGCATTTT	CATSDLLNTQPQHF	TRBV24-1	TRBJ1-5
TGTGCCAGCAGTTACTCCGGGGGACTACAAGAGACCCAGTACTTC	CASSYSGGLQETQYF	TRBV6-3	TRBJ2-5
TGTGCCACCAGTGATTCCGGGACACTGGTCAAGGGCGGGATTAATAACTATGGCTACACCTTC	CATSDSGTLVKGGINNYGYTF	TRBV24-1	TRBJ1-2
TGTGCCAGCAGCTTAGAGCCCCCGGGACACGGCTACACCTTC	CASSLEPPGHGYTF	TRBV11-2	TRBJ1-2
TGTGCCAGCAGCCCAACGAGGCCACCCTATGGCTACACCTTC	CASSPTRPPYGYTF	TRBV6-3	TRBJ1-2
TGCGCCAGCAGCGGGTTAGCACACAGGGACACCCCCATGAACACTGAAGCTTTCTTT	CASSGLAHRDTPMNTEAFF	TRBV5-1	TRBJ1-1
TGTGCCAGCAGTTCAAACTCCTACGTCGGGGGGGGTTCCACAGATACGCAGTATTTT	CASSSNSYVGGGSTDTQYF	TRBV6-2	TRBJ2-3
TGTGCCAGCAGCCAAGATCTTTATCTCAGGACAGGGCGACCGTGGTACAATGAGCAGTTCTTC	CASSQDLYLRTGRPWYNEQFF	TRBV4-2	TRBJ2-1
TGCGCCAGCAGCCCCAGGCCGGGACAGGGGCGAAATCAGCCCCAGCATTTT	CASSPRPGQGRNQPQHF	TRBV5-1	TRBJ1-5
TGTGCCAGCAGCAAGGGACTCGAACGTAATCAGCCCCAGCATTTT	CASSKGLERNQPQHF	TRBV9	TRBJ1-5
TGTGCCAGCAGCCAAGATCCGGGCCAGGGTAATGAAAAACTGTTTTTT	CASSQDPGQGNEKLFF	TRBV14	TRBJ1-4
TGTGCCAGCAGTTACAGAAGTCCCGGCACTGAAGCTTTCTTT	CASSYRSPGTEAFF	TRBV6-5	TRBJ1-1
TGCGCCAGGGTAGGGAACGCCTACGAGCAGTACTTC	CARVGNAYEQYF	TRBV4-3	TRBJ2-7
TGTGCCAGCAGTTTACGACTAGGCGAGACCCAGTACTTC	CASSLRLGETQYF	TRBV27	TRBJ2-5
TGTGCCAGCAGTAGCAACTCGAACCAGCTAAACTACAATGAGCAGTTCTTC	CASSSNSNQLNYNEQFF	TRBV27	TRBJ2-1
TGTGCCAGCAGCGGGTCGGGAGGTAGCTATTCACCCCTCCACTTT	CASSGSGGSYSPLHF	TRBV13	TRBJ1-6
TGTGCCGGGGACGGACAGGGGGCCTTGAACACTGAAGCTTTCTTT	CAGDGQGALNTEAFF	TRBV28	TRBJ1-1
TGTGCCAGCAGTGACGGAAACGGACAGGCCAAACCGGACGAGCAGTACTTC	CASSDGNGQAKPDEQYF	TRBV6-4	TRBJ2-7
TGCAGTGCTAGGCACGTAAGACCACATCAGCCCCAGCATTTT	CSARHVRPHQPQHF	TRBV20-1	TRBJ1-5
TGTGCCAGCAGCTTGTTTAGGACTAGCGGGAGCAATGAGCAGTTCTTC	CASSLFRTSGSNEQFF	TRBV7-6	TRBJ2-1
TGTGCCAGCAGCAGCCAGGGGGTATACAATGAGCAGTTCTTC	CASSSQGVYNEQFF	TRBV9	TRBJ2-1
TGTGCCAGCAGTGGACCGGGGGTCTCAAGTGGCTACACCTTC	CASSGPGVSSGYTF	TRBV6-1	TRBJ1-2
TGTGCCAGCAGCCAAGACCTCAGGGCTTTCGAGCAGTACTTC	CASSQDLRAFEQYF	TRBV3-1	TRBJ2-7
TGTGCCAGCTCACCCCCTGTGGCCGGGAACGAGCAGTACTTC	CASSPPVAGNEQYF	TRBV18	TRBJ2-7
TGTGCCAGCAGCCCACGGGGTACGAGCTCCTATAATTCACCCCTCCACTTT	CASSPRGTSSYNSPLHF	TRBV13	TRBJ1-6
TGTGCCAGCAGCTTAGGTGGGAAGGGGGAGGATACGCAGTATTTT	CASSLGGKGEDTQYF	TRBV7-8	TRBJ2-3
TGCAGTGCCGGTCATGGGCCCATCGGACTAGCGGGGGGACCAGTGGACACAGATACGCAGTATTTT	CSAGHGPIGLAGGPVDTDTQYF	TRBV20-1	TRBJ2-3
TGTGCCTGGAGTGTAGGCGGGAGAGAGCATCAGCCCCAGCATTTT	CAWSVGGREHQPQHF	TRBV30	TRBJ1-5
TGTGCCAGCAGTTACCCTGGACGCGGGGCTTTCTTT	CASSYPGRGAFF	TRBV6-6	TRBJ1-1
TGTGCCAGCAGTTTGTCTATCACAGAGACCCAGTACTTC	CASSLSITETQYF	TRBV12-3	TRBJ2-5
TGTGCCAGCCTCGACAGGGGGAATAGCAATCAGCCCCAGCATTTT	CASLDRGNSNQPQHF	TRBV28	TRBJ1-5
TGCGCCAGCAGCGCTCCCTGGGACAGGGCCTACGAGCAGTACTTC	CASSAPWDRAYEQYF	TRBV4-1	TRBJ2-7
TGTGCCAGCAGTGACGGAATAGAAAATCAGCCCCAGCATTTT	CASSDGIENQPQHF	TRBV6-4	TRBJ1-5
TGCAGTGCTAGAGCCCCGGAGAAAACTTGCGAGCAGTACTTC	CSARAPEKTCEQYF	TRBV20-1	TRBJ2-7
TGCGCCAGCAGTGACCCACGGGGGGACAATGGTAAAGACTATGGCTACACCTTC	CASSDPRGDNGKDYGYTF	TRBV10-1	TRBJ1-2
TGTGCCAGCAGTCTGGGGAGAGTGCACTACGAGCAGTACTTC	CASSLGRVHYEQYF	TRBV28	TRBJ2-7
TGTGCCAGCAGTGAGCAGGAAATCTATCAGATGAACACTGAAGCTTTCTTT	CASSEQEIYQMNTEAFF	TRBV6-4	TRBJ1-1
TGTGCCAGCAGACGGGACAGACGAACCGGGGAGCTGTTTTTT	CASRRDRRTGELFF	TRBV6-4	TRBJ2-2
TGTGCCAGCAGTGAACGTGTGGACAGACATGGCTACACCTTC	CASSERVDRHGYTF	TRBV6-1	TRBJ1-2
TGTGCCTCCCTGGGAGAACCGAACGAGCAGTACTTC	CASLGEPNEQYF	TRBV27	TRBJ2-7
TGTGCTAGTGGCGATGAGGGAACCTACGAGCAGTACTTC	CASGDEGTYEQYF	TRBV12-5	TRBJ2-7
TGCGCCAGCAGTACTAGGGTCGGCTCAGATACGCAGTATTTT	CASSTRVGSDTQYF	TRBV10-1	TRBJ2-3
TGTGCCAGCAGAGCCCAGGGAGGATCACCCCTCCACTTT	CASRAQGGSPLHF	TRBV6-4	TRBJ1-6
TGTGCTAGTGGTTCAGAAGAGGGGCAAGAGACCCAGTACTTC	CASGSEEGQETQYF	TRBV12-5	TRBJ2-5
TGTGCCAGCAGCAGACACAGGGGCGAGACTTCCTACGAGCAGTACTTC	CASSRHRGETSYEQYF	TRBV5-8	TRBJ2-7
TGTGCCACCAGTGATTGGGGGGGACAGGCCCTCCACTTT	CATSDWGGQALHF	TRBV24-1	TRBJ1-6
TGTGCCAGTACCTGCGCCAGGGTTAGCAATCAGCCCCAGCATTTT	CASTCARVSNQPQHF	TRBV19	TRBJ1-5
TGTGCCAGCACCGGACAGGTGGTAGGAGAGACCCAGTACTTC	CASTGQVVGETQYF	TRBV6-5	TRBJ2-5
TGTGCCTGGAGTGTACTTAGTTTGGGGGCAGGGAATTCACCCCTCCACTTT	CAWSVLSLGAGNSPLHF	TRBV30	TRBJ1-6
TGTGCCAGCAGTGACGACACGAGGGTCTACACCCAGTACTTC	CASSDDTRVYTQYF	TRBV6-4	TRBJ2-5
TGTGCCAGCAGTGAGGCAAACAATTTCTCCTACGAGCAGTACTTC	CASSEANNFSYEQYF	TRBV6-4	TRBJ2-7
TGTGCCAGCAGCGCGTTGACAGATACGCAGTATTTT	CASSALTDTQYF	TRBV9	TRBJ2-3
TGTGCCATCAGTGCCGTGACTACGATCCAGACCCAGTACTTC	CAISAVTTIQTQYF	TRBV10-3	TRBJ2-5
TGTGCCAGCAGTGAAGTGGACAGGGGGCTCAATCAGCCCCAGCATTTT	CASSEVDRGLNQPQHF	TRBV2	TRBJ1-5
TGTGCCAGGGTCGGAAAACTTTTGCGCGAGCAGTACTTC	CARVGKLLREQYF	TRBV2	TRBJ2-7
TGTGCCACCAGTGACCGACAGGGCATGAATTCACCCCTCCACTTT	CATSDRQGMNSPLHF	TRBV24-1	TRBJ1-6
TGTGCCAGTAGTATGACACGGGAGGGCCCTTTCCAAAGGATAAATGGGGCCAACGTCCTGACTTTC	CASSMTREGPFQRINGANVLTF	TRBV19	TRBJ2-6
TGTGCCACCAGCAGGACGTCCCGACTGCCCCAGCATTTT	CATSRTSRLPQHF	TRBV15	TRBJ1-5
TGTGCCAGTAGTAGGCAGGAGTTAAACTCCTACAATGAGCAGTTCTTC	CASSRQELNSYNEQFF	TRBV19	TRBJ2-1
TGTGCCAGCAGCTTAGTCCGGACAATCAATCAGCCCCAGCATTTT	CASSLVRTINQPQHF	TRBV7-2	TRBJ1-5
TGTGCCAGCAGCGGGGGCCTGAATGAGCAGTTCTTC	CASSGGLNEQFF	TRBV9	TRBJ2-1
TGTGCCAGCAGTACTACCCTGGGAAGTCGGGGCAATCAGCCCCAGCATTTT	CASSTTLGSRGNQPQHF	TRBV27	TRBJ1-5
TGTGCCAGCAGCTTAGAGGGACAGGCTGGAAACACCATATATTTT	CASSLEGQAGNTIYF	TRBV7-2	TRBJ1-3
TGTGCCAGCAGCAGATTTCAGGTCTGCTCCTACGAGCAGTACTTC	CASSRFQVCSYEQYF	TRBV6-1	TRBJ2-7
TGTGCCACCAGCGGGCGGGAGGGGATGTCCCCCTACGAGCAGTACTTC	CATSGREGMSPYEQYF	TRBV15	TRBJ2-7
TGTGCCAGCAGTTACCCCCCCTGGGGGAGAAGTATTCCTGGAAACACCATATATTTT	CASSYPPWGRSIPGNTIYF	TRBV6-3	TRBJ1-3
TGTGCCAGCTCCTCTGGGCTAGCCCGCACAGATACGCAGTATTTT	CASSSGLARTDTQYF	TRBV27	TRBJ2-3
TGTGCCAGCCCCCTACGGACAGAGAATGAAAAACTGTTTTTT	CASPLRTENEKLFF	TRBV13	TRBJ1-4
TGCAGCGTTGCATGGACAGGGGGCCCCTACGAGCAGTACTTC	CSVAWTGGPYEQYF	TRBV29-1	TRBJ2-7
TGTGCCAGCAGCGGACAAAGCAGGCAGCCCCAGCATTTT	CASSGQSRQPQHF	TRBV7-3	TRBJ1-5
TGTGCCAGCAGAGATTTATGGACAGGAACTAACTATGGCTACACCTTC	CASRDLWTGTNYGYTF	TRBV6-1	TRBJ1-2
TGTGCCAGCAGGGCCCCGGGACAGAAATTTATCTATGGCTACACCTTC	CASRAPGQKFIYGYTF	TRBV28	TRBJ1-2
TGTGCCAGCCCTGCACTATTTGACGAAAACATTCAGTACTTC	CASPALFDENIQYF	TRBV2	TRBJ2-4
TGTGCCAGCAGTTCCGGGGGACAGGTAGGCTACGAGCAGTACTTC	CASSSGGQVGYEQYF	TRBV6-9	TRBJ2-7
TGTGCCAGCAGCTTAACACTAGCGGGAGCGGTGAGCTCCTACGAGCAGTACTTC	CASSLTLAGAVSSYEQYF	TRBV7-2	TRBJ2-7
TGTGCCAGCAGCCCCCTCGTAGGAGGTGCCTACGAGCAGTACTTC	CASSPLVGGAYEQYF	TRBV7-8	TRBJ2-7
TGCAGTGCTAGAGATGAGGGCAAACTGGATACGCAGTATTTT	CSARDEGKLDTQYF	TRBV20-1	TRBJ2-3
TGTGCCACTTATACTAGCGGGAGTGATGAGCAGTTCTTC	CATYTSGSDEQFF	TRBV19	TRBJ2-1
TGTGCCAGCAGTGGTACTAGCGGAGAGGGCACAGATACGCAGTATTTT	CASSGTSGEGTDTQYF	TRBV27	TRBJ2-3
TGTGCCAGCAGCAAATTACTAGCGGGAGGGATAGGAGGGGAGCTGTTTTTT	CASSKLLAGGIGGELFF	TRBV13	TRBJ2-2
TGTGCCAGCAGCCAAGGGGAGGGACCCTCCTCCTACGAGCAGTACTTC	CASSQGEGPSSYEQYF	TRBV4-2	TRBJ2-7
TGTGCCAGCAGCTGTATACGCGGGAGGGTCTGGTGTCCCTACGAGCAGTACTTC	CASSCIRGRVWCPYEQYF	TRBV13	TRBJ2-7
TGTGCCAGCCTGGGGACAGGGCAGCCCCAGCATTTT	CASLGTGQPQHF	TRBV5-6	TRBJ1-5
TGTGCCAGCAGCTTGGGGGACGCCGGGACCTGGACCCAGCCCCAGCATTTT	CASSLGDAGTWTQPQHF	TRBV5-4	TRBJ1-5
TGCGCCAGCAGCGTCTGTGGCGCCGAGACCCAGTACTTC	CASSVCGAETQYF	TRBV5-1	TRBJ2-5
TGTGCCAGCAAACCCACCAGGAGAAACACCATATATTTT	CASKPTRRNTIYF	TRBV28	TRBJ1-3
TGCGCCAGCAGCTTGGGAAACACAGGTCAAGAGACCCAGTACTTC	CASSLGNTGQETQYF	TRBV5-1	TRBJ2-5
TGCAGTACCTCAAGGAGGAGGAACTATGGCTACACCTTC	CSTSRRRNYGYTF	TRBV20-1	TRBJ1-2
TGTGCCAGCTCACCAGCACGGGGTAATGAGCAGTTCTTC	CASSPARGNEQFF	TRBV18	TRBJ2-1
TGTGCCAGCAGCGCGTCGAGGGGTACGGGAGATCAGCCCCAGCATTTT	CASSASRGTGDQPQHF	TRBV11-2	TRBJ1-5
TGCGCCAGCAGCTTCGTAGGGGTCTTTTGTGGCTACACCTTC	CASSFVGVFCGYTF	TRBV5-1	TRBJ1-2
TGTGCCAGCAGTTATCAGTCGGGGGACAGGGCCCTATGGGGCTCTGGAAACACCATATATTTT	CASSYQSGDRALWGSGNTIYF	TRBV6-2	TRBJ1-3
TGCGCCAGCAGGGAGGACCATTATGGCTACACCTTC	CASREDHYGYTF	TRBV10-1	TRBJ1-2
TGTGCCAGCAGCTGTCCTTCCGGCAATGAGCAGTTCTTC	CASSCPSGNEQFF	TRBV5-5	TRBJ2-1
TGTGCCAGCAGTCACCGACTCTCCGGTCGGTACGAGCAGTACTTC	CASSHRLSGRYEQYF	TRBV27	TRBJ2-7
TGTGCCAGCAGCCAGGGGCCGTTCCTCAAAGATTCACCCCTCCACTTT	CASSQGPFLKDSPLHF	TRBV3-1	TRBJ1-6
TGTGCCATCAAACCGGGACAGAGGCGCGAGCAGTACTTC	CAIKPGQRREQYF	TRBV11-2	TRBJ2-7
TGTGCCAGCAGTGAGGCTGGGGAAGGGCCCTCTCCCCGTGGGGAGCTGTTTTTT	CASSEAGEGPSPRGELFF	TRBV27	TRBJ2-2
TGTGCCAGCAGCTTAGCAACAGCCGGTGGAAACACCATATATTTT	CASSLATAGGNTIYF	TRBV11-3	TRBJ1-3
TGTGCCAGCAGTTATGGAACAGGGGAAAATTCACCCCTCCACTTT	CASSYGTGENSPLHF	TRBV6-5	TRBJ1-6
TGCAGTGCTAGGATTCAGGACAACAGGGAGGGCTACGAGCAGTACTTC	CSARIQDNREGYEQYF	TRBV20-1	TRBJ2-7
TGTGCCAGCAGTCAGAACCAGGGGCTCTATGGCTACACCTTC	CASSQNQGLYGYTF	TRBV27	TRBJ1-2
TGTGCCAGCAGTTACATTAGGAGATTAGCGGGGACCTACAATGAGCAGTTCTTC	CASSYIRRLAGTYNEQFF	TRBV6-5	TRBJ2-1
TGTGCCAGCAGCCTCGGGGAGGGAATGGTCCACGGGGAGCTGTTTTTT	CASSLGEGMVHGELFF	TRBV5-4	TRBJ2-2
TGCGCCAGCAGCTTGCCCTCAGGGAGGGGCAATCAGCCCCAGCATTTT	CASSLPSGRGNQPQHF	TRBV5-1	TRBJ1-5
TGTGCCATCCTGGGGGGGCCAATGGAATGTACGAGCACAGATACGCAGTATTTT	CAILGGPMECTSTDTQYF	TRBV10-3	TRBJ2-3
TGTGCCAGCAGCCGTCAGGCCCAATCTAGCTCCTATAATTCACCCCTCCACTTT	CASSRQAQSSSYNSPLHF	TRBV7-9	TRBJ1-6
TGTGCCACCAGGCTAGATGAGCAGTTCTTC	CATRLDEQFF	TRBV15	TRBJ2-1
TGTGCCAGCAGCTTACAGTGGACTAGCGGGGATGAGCAGTTCTTC	CASSLQWTSGDEQFF	TRBV7-3	TRBJ2-1
TGCGCCAGCAGTAGGGACTCGATGAACACTGAAGCTTTCTTT	CASSRDSMNTEAFF	TRBV5-1	TRBJ1-1
TGTGCCACCACTTCTGGTAACAGGCTCTACGAGCAGTACTTC	CATTSGNRLYEQYF	TRBV24-1	TRBJ2-7
TGTGCCAGCAGCTTAGCGAAGGACAGGGATATACGCGAGGAATATAGCAATCAGCCCCAGCATTTT	CASSLAKDRDIREEYSNQPQHF	TRBV7-8	TRBJ1-5
TGTGCCGTTACAGGGGGGGCTAGCCTCTACGAGCAGTACTTC	CAVTGGASLYEQYF	TRBV19	TRBJ2-7
TGTGCCAGCAGACGGGAGGAGCAGTTCTTC	CASRREEQFF	TRBV27	TRBJ2-1
TGTGCCAGCAGCGCCAGGTCGTCCCTGCAAGGGTGTAAGGAAAACCTCACAGATACGCAGTATTTT	CASSARSSLQGCKENLTDTQYF	TRBV13	TRBJ2-3
TGTGCCAGCAGCTTAGTAACAGGGACCACTGAAGCTTTCTTT	CASSLVTGTTEAFF	TRBV7-2	TRBJ1-1
TGTGCCACCAGCGCCGGAAGTGGGGGCGGCTACACCTTC	CATSAGSGGGYTF	TRBV15	TRBJ1-2
TGTGCCAGCAGTATACTCCGGGACAGGGGGCAAAGCACAGATACGCAGTATTTT	CASSILRDRGQSTDTQYF	TRBV27	TRBJ2-3
TGTGCTAGTGGTTTGGGACGGGGGGGGGATGGCTACACCTTC	CASGLGRGGDGYTF	TRBV12-5	TRBJ1-2
TGTGCCAGCAGCCGCAGGGGCATGAACAATGAGCAGTTCTTC	CASSRRGMNNEQFF	TRBV7-9	TRBJ2-1
TGTGCCAGCAGCGGATGCTGGAATCAGCCCCAGCATTTT	CASSGCWNQPQHF	TRBV9	TRBJ1-5
TGTGCCAGCAGCTTAGTAGACAGGGGGCGTAGCAATCAGCCCCAGCATTTT	CASSLVDRGRSNQPQHF	TRBV7-9	TRBJ1-5
TGCAGCAAGGGGACCGGTTGGATCGCGGGATACGAGCAGTACTTC	CSKGTGWIAGYEQYF	TRBV29-1	TRBJ2-7
TGTGCCAGCAGCGTGGACAGGGTTCACCGCTACGAGCAGTACTTC	CASSVDRVHRYEQYF	TRBV7-2	TRBJ2-7
TGTGCCAGCAGTTACTACAGGAGGGGACCTCGGAACGAGCAGTACTTC	CASSYYRRGPRNEQYF	TRBV6-6	TRBJ2-7
TGTGCCAGCAGACAAGTCTTAGACAGCCACTCCTACGAGCAGTACTTC	CASRQVLDSHSYEQYF	TRBV13	TRBJ2-7
TGTGCCAGCACCGACAGGGTTGCAACTAATGAAAAACTGTTTTTT	CASTDRVATNEKLFF	TRBV6-3	TRBJ1-4
TGTGCCGCTCGGGACAAACTAGCTTTCTTT	CAARDKLAFF	TRBV10-3	TRBJ1-1
TGTGCCAGCAGCTTAGCCCCCACCCAGTCCTATGAAAAACTGTTTTTT	CASSLAPTQSYEKLFF	TRBV11-2	TRBJ1-4
TGTGCCAGCAGAGGGAAGGGGCGGTCCCCGAATCTCGAGCAGTACTTC	CASRGKGRSPNLEQYF	TRBV6-3	TRBJ2-7
TGTGCCAGCAGCGCGGACGGGGGTGAGCAGTTCTTC	CASSADGGEQFF	TRBV7-9	TRBJ2-1
TGTGCCAGCAGCATAGACAGGGTTACCAAAAACATTCAGTACTTC	CASSIDRVTKNIQYF	TRBV11-3	TRBJ2-4
TGTGCCAGCAGCCAAGCCGGGACAGCCTACGAGCAGTACTTC	CASSQAGTAYEQYF	TRBV3-1	TRBJ2-7
TGTGCCAACCTTGCACAAGATACGCAGTATTTT	CANLAQDTQYF	TRBV27	TRBJ2-3
TGTGCCAGCAGCACCGACCACAGGGGGGGCTACTCTGGGGCCAACGTCCTGACTTTC	CASSTDHRGGYSGANVLTF	TRBV9	TRBJ2-6
TGTGCTAGTGGTTTGGTCCCACCTAGCGGGATTTCCGACGAGCAGTACTTC	CASGLVPPSGISDEQYF	TRBV12-5	TRBJ2-7
TGTGCCAGCAGCTTAGTGTCTAGCAGGGCCTACAATGAGCAGTTCTTC	CASSLVSSRAYNEQFF	TRBV5-4	TRBJ2-1
TGTGCCAGCAGCCCACCTCCGGGACAGGGGGTCCATGGGGCCAACGTCCTGACTTTC	CASSPPPGQGVHGANVLTF	TRBV3-1	TRBJ2-6
TGTGCCAGCAGCCAAGCATCAGATTCCTCTGGAAACACCATATATTTT	CASSQASDSSGNTIYF	TRBV4-2	TRBJ1-3
TGTGCCAGCAGCGCCCCGGACAGGCTATACACCATATATTTT	CASSAPDRLYTIYF	TRBV9	TRBJ1-3
TGTGCCAGCAGCCACCAGTTGACAGGGCCGCCCCGGGGAGATGTGAACACTGAAGCTTTCTTT	CASSHQLTGPPRGDVNTEAFF	TRBV3-1	TRBJ1-1
TGTGCCAGCAGCAGGGGGGCCGAATACAATGAGCAGTTCTTC	CASSRGAEYNEQFF	TRBV14	TRBJ2-1
TGCAGCGTTGCGTACCAAGACACTGAAGCTTTCTTT	CSVAYQDTEAFF	TRBV29-1	TRBJ1-1
TGTGCCAGTAGTGAGGGACAGGGGGTTTACGAGCAGTACTTC	CASSEGQGVYEQYF	TRBV19	TRBJ2-7
TGTGCCAGCAGCATGGGAGGGCGCATGAACACCGGGGAGCTGTTTTTT	CASSMGGRMNTGELFF	TRBV7-3	TRBJ2-2
TGCGCCAGCAGCCAAAACGAGGCGACTGCTACTAATGAAAAACTGTTTTTT	CASSQNEATATNEKLFF	TRBV4-1	TRBJ1-4
TGTGCCAGCAGCAGCGCTCACGTGATCAATGAGCAGTTCTTC	CASSSAHVINEQFF	TRBV11-3	TRBJ2-1
TGTGCCAGCAGCCAAGGGGGTGAGGGGGGACTAGCGGGGACTGAGCAGTTCTTC	CASSQGGEGGLAGTEQFF	TRBV4-2	TRBJ2-1
TGTGCCAGCAGTGACGGCCCCAGAGTTTACCCACCCCTCCACTTT	CASSDGPRVYPPLHF	TRBV6-4	TRBJ1-6
TGTGCCAGCAGCGAACCTGTCTACGAGCAGTACTTC	CASSEPVYEQYF	TRBV13	TRBJ2-7
TGTGCCAGCAGCCTTTTAGCGGGCCACACCAGGGATACGCAGTATTTT	CASSLLAGHTRDTQYF	TRBV6-6	TRBJ2-3
TGTGCTAGCAGCCACTACCGGGACAGGGGCGAAAGCTCCTATAATTCACCCCTCCACTTT	CASSHYRDRGESSYNSPLHF	TRBV7-7	TRBJ1-6
TGTGCCAGTAGTATGCAGGGGGGATACGACTATGGCTACACCTTC	CASSMQGGYDYGYTF	TRBV19	TRBJ1-2
TGTGCCAGCAGCCAAACCCAGACGGGACAGGGGGTAAGGAACACTGAAGCTTTCTTT	CASSQTQTGQGVRNTEAFF	TRBV14	TRBJ1-1
TGTGCCAGCAGACTTGGACCGAATCAGCCCCAGCATTTT	CASRLGPNQPQHF	TRBV27	TRBJ1-5
TGTGCCAGCAGCTTTCGTCACGCCCGGGGGGGGGGGGCCAACGTCCTGACTTTC	CASSFRHARGGGANVLTF	TRBV11-3	TRBJ2-6
TGCGCCAGCAGCTATAGCACACGCGAGCAGCCCCAGCATTTT	CASSYSTREQPQHF	TRBV5-1	TRBJ1-5
TGTGCCACCAGTGATGTTAGGGACAAGGTTAGTGAAAAACTGTTTTTT	CATSDVRDKVSEKLFF	TRBV24-1	TRBJ1-4
TGCAGCGTTGCCGGGGGGGCAGATACGCAGTATTTT	CSVAGGADTQYF	TRBV29-1	TRBJ2-3
TGTGCCAGCAGCTTAGATGACGGATTGGCGGAGGCTTTCTTT	CASSLDDGLAEAFF	TRBV11-3	TRBJ1-1
TGTGCCAGCAGCGACACTCTGGGTCCCTGGGAGACCCAGTACTTC	CASSDTLGPWETQYF	TRBV9	TRBJ2-5
TGCGCCAGCAGCCAAGAGACAGACTTCTCCTACGAGCAGTACTTC	CASSQETDFSYEQYF	TRBV4-1	TRBJ2-7
TGCAGTGCTAGGGGGGCAACCCATAGCAATCAGCCCCAGCATTTT	CSARGATHSNQPQHF	TRBV20-1	TRBJ1-5
TGCAGTGCTAGAGAACGGACTAGCGGGCGTCGTATCCCGTACGAGCAGTACTTC	CSARERTSGRRIPYEQYF	TRBV20-1	TRBJ2-7
TGTGCCAGCAGCTTGAGGACTAGCGGGAGCCTTCCTACCGGGGAGCTGTTTTTT	CASSLRTSGSLPTGELFF	TRBV5-5	TRBJ2-2
TGCGCCAGCAGCTTGACGAGAACTAGAAGATATGGCTACACCTTC	CASSLTRTRRYGYTF	TRBV5-1	TRBJ1-2
TGTGCCAGCAGTAGGATATACCAAGAGACCCAGTACTTC	CASSRIYQETQYF	TRBV2	TRBJ2-5
TGTGCCAGCAGCCAAGACGCCAGGACCCGACAGAGGAATTCACCCCTCCACTTT	CASSQDARTRQRNSPLHF	TRBV14	TRBJ1-6
TGTGCCAGCAGTTTAACAGGGACTTTTTTCTACGAGCAGTACTTC	CASSLTGTFFYEQYF	TRBV12-3	TRBJ2-7
TGTGCCAGCAGCGGGGACAGGCTCCCTGGGGCCAACGTCCTGACTTTC	CASSGDRLPGANVLTF	TRBV9	TRBJ2-6
TGTGCCAGCAGCTTGTTTCCCGGACAGGGGAATGAAAAACTGTTTTTT	CASSLFPGQGNEKLFF	TRBV5-4	TRBJ1-4
TGTGCCAGCAGCGACAGGGGTAGCGAGCAGTACTTC	CASSDRGSEQYF	TRBV6-5	TRBJ2-7
TGCAGTGCGAGCCTAGCGCCAGATACGCAGTATTTT	CSASLAPDTQYF	TRBV20-1	TRBJ2-3
TGTGCCAGCCCTCTTACAGATACGCAGTATTTT	CASPLTDTQYF	TRBV6-4	TRBJ2-3
TGTGCCAGCAGTATTCATCGGACAGGGGATGGCTACACCTTC	CASSIHRTGDGYTF	TRBV28	TRBJ1-2
TGTGCCTGGAGCCCAATGGCTCAGGGCCACCCTTATAGCAATCAGCCCCAGCATTTT	CAWSPMAQGHPYSNQPQHF	TRBV30	TRBJ1-5
TGTGCCAGCAGCCAAGATAGTCCTTCTCTTACCGGAGGGCTGGAGAATCAGCCCCAGCATTTT	CASSQDSPSLTGGLENQPQHF	TRBV14	TRBJ1-5
TGCAGTGCCAGGAAAGATAATTCACCCCTCCACTTT	CSARKDNSPLHF	TRBV20-1	TRBJ1-6
TGCGCCAGCAGCATCAGGAACACTGAAGCTTTCTTT	CASSIRNTEAFF	TRBV5-1	TRBJ1-1
TGTGCCAGCAGCGTTCTCCCCCTGGCGAACCCTTATGAGCAGTTCTTC	CASSVLPLANPYEQFF	TRBV9	TRBJ2-1
TGTGCCAGCAGCCAAGATTCGGCGCGGGGCCTCCAAGAGACCCAGTACTTC	CASSQDSARGLQETQYF	TRBV3-1	TRBJ2-5
TGTGCCAGCAGCGGGCCCCCGACTAGCGGGCTGTACAAAAACATTCAGTACTTC	CASSGPPTSGLYKNIQYF	TRBV9	TRBJ2-4
TGTGCCAGCAGTTACTCGGCAGGGGGCCCAGAGACCCAGTACTTC	CASSYSAGGPETQYF	TRBV6-5	TRBJ2-5
TGTGCTAGTGGTTTGCCGGGGCCGGAGACCCAGTACTTC	CASGLPGPETQYF	TRBV12-5	TRBJ2-5
TGTGCCAGCAGCTTATCAGGGGCTCCGATTGAAAAACTGTTTTTT	CASSLSGAPIEKLFF	TRBV7-4	TRBJ1-4
TGTGCCAGCAGCCAAGGGGGGACAGGGCGGACTACCGGTGGAAACACCATATATTTT	CASSQGGTGRTTGGNTIYF	TRBV3-1	TRBJ1-3
TGTGCCAGCAGCTTGACGTTGATGTCCGGACTAGCGGGGTTGGGCCTCAGGTACTACAATGAGCAGTTCTTC	CASSLTLMSGLAGLGLRYYNEQFF	TRBV7-9	TRBJ2-1
TGCGCCAGCAGCCCGGCCGGGGGGGGCCCGGACACCGGGGAGCTGTTTTTT	CASSPAGGGPDTGELFF	TRBV5-1	TRBJ2-2
TGCGCCAGCAGCTCCCTCAGGGGGATATACTATGGCTACACCTTC	CASSSLRGIYYGYTF	TRBV5-1	TRBJ1-2
TGTGCCAGCAGCCCTAACAGGGGAGGTGGAAACACCATATATTTT	CASSPNRGGGNTIYF	TRBV7-9	TRBJ1-3
TGTGCCAGCAGCCTCGTGGGGGCCCCTGGTTTCTCCTACGAGCAGTACTTC	CASSLVGAPGFSYEQYF	TRBV3-1	TRBJ2-7
TGCGCCAGCAGCCAAGACCCTAGAGGGGACTACGAGCAGTACTTC	CASSQDPRGDYEQYF	TRBV4-3	TRBJ2-7
TGCAGTGCTAGGCTGGGGGGCAGGTACGAGCAGTACTTC	CSARLGGRYEQYF	TRBV20-1	TRBJ2-7
TGTGCCAGCAGTTACGGCCATCAGGCTTCCTGCACAGATACGCAGTATTTT	CASSYGHQASCTDTQYF	TRBV6-5	TRBJ2-3
TGCGCCAGCAGCTGGACTCGAGACATTCAGTACTTC	CASSWTRDIQYF	TRBV5-1	TRBJ2-4
TGTGCCAGCAGCGAGGGGGGCCCTCAAGAGACCCAGTACTTC	CASSEGGPQETQYF	TRBV5-8	TRBJ2-5
TGTGCCAGCAGCCCTAGGGACAGAGAGGCTGAAGCTTTCTTT	CASSPRDREAEAFF	TRBV13	TRBJ1-1
TGTGCCAGCAGCAGCCCCCGCGGGTCCGTCGAGCAGTACTTC	CASSSPRGSVEQYF	TRBV6-3	TRBJ2-7
TGTGCCAGCAGCCAACCGTGTCAGGTTCACTACGAGCAGTACTTC	CASSQPCQVHYEQYF	TRBV3-1	TRBJ2-7
TGTGCCAGCAGTACCCGAGGGGGGACAGATACGCAGTATTTT	CASSTRGGTDTQYF	TRBV28	TRBJ2-3
TGTGCCAGCAGGGGTCCCGACTCAAACACTGAAGCTTTCTTT	CASRGPDSNTEAFF	TRBV12-4	TRBJ1-1
TGCAGTGCTAGGATAGCGGGAGTGGGCACAGATACGCAGTATTTT	CSARIAGVGTDTQYF	TRBV20-1	TRBJ2-3
TGTGCCAGCAGACTTGACTACAGGCAGGAGCGGAGCTCTGGAAACACCATATATTTT	CASRLDYRQERSSGNTIYF	TRBV6-5	TRBJ1-3
TGTGCCAGTAGTCGAGGGGGGGCGGGCACAGATACGCAGTATTTT	CASSRGGAGTDTQYF	TRBV19	TRBJ2-3
TGTGCCAGCAGTGAGGGACGGTCTGGAGTGAACACTGAAGCTTTCTTT	CASSEGRSGVNTEAFF	TRBV6-1	TRBJ1-1
TGTGCCAGCAGGGCCCCCCCGTGGACAGCATTGCCCCAGCATTTT	CASRAPPWTALPQHF	TRBV6-4	TRBJ1-5
TGTGCCAGCAGTTTGCGTAAACTTCAATCGGGGGCGAAGCAAGAGACCCAGTACTTC	CASSLRKLQSGAKQETQYF	TRBV12-4	TRBJ2-5
TGTGCCAGTAGTAAACGAGTGGGTGGAGATACGCAGTATTTT	CASSKRVGGDTQYF	TRBV19	TRBJ2-3
TGTGCACAATGCCAGGGGTTGGCTGAAGCTTTCTTT	CAQCQGLAEAFF	TRBV5-4	TRBJ1-1
TGTGCCAGCAGCGCAGCTCGGGCTGGAAACACCATATATTTT	CASSAARAGNTIYF	TRBV7-3	TRBJ1-3
TGTGCCAGCAGCTCAACCTCGGCCTCTGGAAACACCATATATTTT	CASSSTSASGNTIYF	TRBV5-6	TRBJ1-3
TGTGCCAGCAGCCAAGGAAATGTCCGATGGACAGCTGGCTACACCTTC	CASSQGNVRWTAGYTF	TRBV4-2	TRBJ1-2
TGTGCCAGCAGCCAAGACAAGACTAGCGGGAATGCCTACAATGAGCAGTTCTTC	CASSQDKTSGNAYNEQFF	TRBV14	TRBJ2-1
TGTGCCTGGAGTGTAGGGGCGACAGGGGGCTACACCTTC	CAWSVGATGGYTF	TRBV30	TRBJ1-2
TGTGCCAGCAGCTGCGGGAGGGGCTATGGCTACACCTTC	CASSCGRGYGYTF	TRBV7-9	TRBJ1-2
