TGTGCCAGCGACACAGGGACCGGGGAGCTGTTTTTT	CASDTGTGELFF	TRBV6-1	TRBJ2-2
TGTGCCAGCCTGGGGGGGGAGGAAGAGCAGTACTTC	CASLGGEEEQYF	TRBV6-2	TRBJ2-7
TGTGCCAGCAGTGAATACAGCTCCGGGACAGGGGGGGTAACAGATACGCAGTATTTT	CASSEYSSGTGGVTDTQYF	TRBV25-1	TRBJ2-3
TGCGCCAGCAGCCAAGCGTACAGGGGGCGGGGGCCCCAGCATTTT	CASSQAYRGRGPQHF	TRBV4-3	TRBJ1-5
TGTGCCATCAGTGGGGGGAGAGCTTTCTTT	CAISGGRAFF	TRBV10-3	TRBJ1-1
TGTGCCATATTCAGGGGGCTCGACGAGCAGTACTTC	CAIFRGLDEQYF	TRBV6-4	TRBJ2-7
TGCAGTGCTAGAGGGGGGGCCGACCCCTACGAGCAGTACTTC	CSARGGADPYEQYF	TRBV20-1	TRBJ2-7
TGCAGTGCTACTGGACAACCCTGCTACGAGCAGTACTTC	CSATGQPCYEQYF	TRBV20-1	TRBJ2-7
TGTGCCAGCAGCTTAGGATGGGCCCCACGAAGCAATGAGCAGTTCTTC	CASSLGWAPRSNEQFF	TRBV7-2	TRBJ2-1
TGTGCCAGCAGCTTAGGTCATCAGGGGGCTCAGCCTGAAGCTTTCTTT	CASSLGHQGAQPEAFF	TRBV7-6	TRBJ1-1
TGTGCCAGCAGCTGCCGGACACCCTGTGGTGTGGAGAACACTGAAGCTTTCTTT	CASSCRTPCGVENTEAFF	TRBV14	TRBJ1-1
TGTGCCAGCAGTTTGGACAGGGGATTAAGTTTCCAGCCCCAGCATTTT	CASSLDRGLSFQPQHF	TRBV12-4	TRBJ1-5
TGTGCCAGCAGCCTAAGGGGCTGGGAAGCTTTCTTT	CASSLRGWEAFF	TRBV7-8	TRBJ1-1
TGTGCCAGCAGTTTCCGGGCCAGATCCTACGAGCAGTACTTC	CASSFRARSYEQYF	TRBV12-4	TRBJ2-7
TGTGCCAGCAGCCCCGAGGGTCCGGGCTCCTACGAGCAGTACTTC	CASSPEGPGSYEQYF	TRBV11-3	TRBJ2-7
TGTGCCAGCAGTCGGATCGAGGTCTCCAGGAGGGGAAAGAGGGCTCTGCGCTCCTACAATGAGCAGTTCTTC	CASSRIEVSRRGKRALRSYNEQFF	TRBV12-3	TRBJ2-1
TGTGCCAGCAGCCAAAGGGGAGGAGGCTACACCTTC	CASSQRGGGYTF	TRBV7-9	TRBJ1-2
TGCGCCAGCACCGCGGGGTTTGAGCAGTTCTTC	CASTAGFEQFF	TRBV10-1	TRBJ2-1
TGTGCCAGACGGACAGGGGTGGGGAGCTACGAGCAGTACTTC	CARRTGVGSYEQYF	TRBV6-5	TRBJ2-7
TGTGCCAGCAGCCCATGGGACAGGGTCCTGAGCTCTGGGGCCAACGTCCTGACTTTC	CASSPWDRVLSSGANVLTF	TRBV7-2	TRBJ2-6
TGCAGTGCTAGACCTAGCGGGGAGAGGCCTAATGAGCAGTTCTTC	CSARPSGERPNEQFF	TRBV20-1	TRBJ2-1
TGTGCCAGCAGCTTAGTTCCGTTGGCCGCCCGGGAGTCCGGTTATAGCAATCAGCCCCAGCATTTT	CASSLVPLAARESGYSNQPQHF	TRBV7-2	TRBJ1-5
TGTGCCAGCAGCTTAGCGACAGGGTTAACCTATGAAAAACTGTTTTTT	CASSLATGLTYEKLFF	TRBV11-2	TRBJ1-4
TGTGCCAGCAGTTTCCTGACCAATCGGGACAGAATGACCATATATTTT	CASSFLTNRDRMTIYF	TRBV27	TRBJ1-3
TGTGCCAGCAGCTTACACCTCCGCGGGAGGCAAGAGACCCAGTACTTC	CASSLHLRGRQETQYF	TRBV7-8	TRBJ2-5
TGTGCCAGCAGCACAGCGGGATATGGCTACGAGCAGTACTTC	CASSTAGYGYEQYF	TRBV11-2	TRBJ2-7
TGTGCCAGCAGCTTAAGAGGACAGGGGCGTTTTGGCTACACCTTC	CASSLRGQGRFGYTF	TRBV7-3	TRBJ1-2
TGTGCCAGCACCCGGGGGGGCAGGGGGATCTACGAGCAGTACTTC	CASTRGGRGIYEQYF	TRBV9	TRBJ2-7
TGCGCCAGCAGCCTATGGGGACAGGGGTATAATGTGTTGAATTCACCCCTCCACTTT	CASSLWGQGYNVLNSPLHF	TRBV4-1	TRBJ1-6
TGCGCCAGCAGCTTGCCTGCAGGTACTGAAAAACTGTTTTTT	CASSLPAGTEKLFF	TRBV5-1	TRBJ1-4
TGTGCCTGGAGTCGACAATCCACTCCTGTGGATAACTATGGCTACACCTTC	CAWSRQSTPVDNYGYTF	TRBV30	TRBJ1-2
TGTGCCAGCAGCACAGGAAAACTGTTTTTT	CASSTGKLFF	TRBV13	TRBJ1-4
TGCAGTGCTCCCAAGGGGAGGGTCACTGAAGCTTTCTTT	CSAPKGRVTEAFF	TRBV20-1	TRBJ1-1
TGCAGTGCTAGAGAGCTCCGGGACAGGCTCTACGAGCAGTACTTC	CSARELRDRLYEQYF	TRBV20-1	TRBJ2-7
TGTGCTAGTGGTTTCATGTTCACCGACAGGGAAAAGGGGGGCTACACCTTC	CASGFMFTDREKGGYTF	TRBV12-5	TRBJ1-2
TGTGCCGAAGCGGGACAGGGGGCCGGACGCAAAAACATTCAGTACTTC	CAEAGQGAGRKNIQYF	TRBV28	TRBJ2-4
TGCGCCAGGAGACATCAGCCCCAGCATTTT	CARRHQPQHF	TRBV10-1	TRBJ1-5
TGTGCCAGCAGTAGGCCTCGCGGGGCCCGCTACGAGCAGTACTTC	CASSRPRGARYEQYF	TRBV6-1	TRBJ2-7
TGTGCCAGCGTTCCGCCGACTAGCGATAGGAGGATCACCGGGGAGCTGTTTTTT	CASVPPTSDRRITGELFF	TRBV7-3	TRBJ2-2
TGTGCCAGCAGTTGTAGTGGGGGGAACACTGAAGCTTTCTTT	CASSCSGGNTEAFF	TRBV6-5	TRBJ1-1
TGCGCCAGCCACCCCGCTTCCTACGAGCAGTACTTC	CASHPASYEQYF	TRBV4-3	TRBJ2-7
TGTGCCAGCAGCGATCGTGGGTGGGCGCGCCTATATGAGCAGTTCTTC	CASSDRGWARLYEQFF	TRBV7-4	TRBJ2-1
TGCGCCAGCAGAAGGTCGGACTACGAGCAGTACTTC	CASRRSDYEQYF	TRBV10-1	TRBJ2-7
TGTGCTAGTGGTTTGGCCTCGGACAGGGGATCGAGTCAGCCCCAGCATTTT	CASGLASDRGSSQPQHF	TRBV12-5	TRBJ1-5
TGTGCCCTTTTCAGGGCCATCGGGGGGGCGAAAGATACGCAGTATTTT	CALFRAIGGAKDTQYF	TRBV10-3	TRBJ2-3
TGTGCCAGCAGTTTAAGGAAACTTTCTGGAGACAGGAGCAAAGCCAACGAGCAGTACTTC	CASSLRKLSGDRSKANEQYF	TRBV28	TRBJ2-7
TGTGCCACCACCCGAGCGGGAGGGGAGGAGACCCAGTACTTC	CATTRAGGEETQYF	TRBV24-1	TRBJ2-5
TGTGCCAGCAGTGTTGAAAGGGACAGGGGGTTCCGGTATAGCAATCAGCCCCAGCATTTT	CASSVERDRGFRYSNQPQHF	TRBV6-1	TRBJ1-5
TGTGCCAGTAGTACCAACTATGGCTACACCTTC	CASSTNYGYTF	TRBV19	TRBJ1-2
TGCAGTGCGGGGCGGATCCTAGGCTATAACTCCTACGAGCAGTACTTC	CSAGRILGYNSYEQYF	TRBV20-1	TRBJ2-7
TGTGCCAGTAGTCCGTCGTACCGTATTCACCACACCGGGGAGCTGTTTTTT	CASSPSYRIHHTGELFF	TRBV19	TRBJ2-2
TGTGCCACCAGTGATGGAGGTTATGAGCAGTTCTTC	CATSDGGYEQFF	TRBV24-1	TRBJ2-1
TGTGCCATCAGGACAGGTTACAGGGGGACAGGCAATCAGCCCCAGCATTTT	CAIRTGYRGTGNQPQHF	TRBV10-3	TRBJ1-5
TGTGCCAGCAGCTCCTTCGCGCCTTGGACAGGGGCGGGCTCCTACAATGAGCAGTTCTTC	CASSSFAPWTGAGSYNEQFF	TRBV5-6	TRBJ2-1
TGTGCCAGCAGCAGCGGGACCAGGATGTACGAGCAGTACTTC	CASSSGTRMYEQYF	TRBV9	TRBJ2-7
TGTGCCACTGGGGGGAGGAATCAGCCCCAGCATTTT	CATGGRNQPQHF	TRBV14	TRBJ1-5
TGTGCCAGCAGCCCTTCGAGATGGACTAGCGGGATGGCCTACAATGAGCAGTTCTTC	CASSPSRWTSGMAYNEQFF	TRBV13	TRBJ2-1
TGTGCCAGCAGTCCGGAGGCGTTCTCCTACGAGCAGTACTTC	CASSPEAFSYEQYF	TRBV6-4	TRBJ2-7
TGCAGTGCTAGAGATACACGAAGTATCATGAACACTGAAGCTTTCTTT	CSARDTRSIMNTEAFF	TRBV20-1	TRBJ1-1
TGTGCCACCAGTGAGGCGGGACAGGGCCCGGGGGGAGGCGAGCAGTACTTC	CATSEAGQGPGGGEQYF	TRBV24-1	TRBJ2-7
TGTGCCAGCAGCTTTCTTGGGGGGGGGTTGCAGTATTTT	CASSFLGGGLQYF	TRBV11-3	TRBJ2-3
TGTGCCAGCAGCCCCGTGGGGGATTATAAAAATCAGCCCCAGCATTTT	CASSPVGDYKNQPQHF	TRBV7-7	TRBJ1-5
TGTGCCAGCAGCGGGAGCCACCCGGCGGCCCCGACCGGGGAGCTGTTTTTT	CASSGSHPAAPTGELFF	TRBV13	TRBJ2-2
TGTGCCTGGAGCCCGGCCTCGGATGCTTTCTTT	CAWSPASDAFF	TRBV30	TRBJ1-1
TGCGCCAGCAGCCGACGGACTCACAAATACAATGAGCAGTTCTTC	CASSRRTHKYNEQFF	TRBV5-1	TRBJ2-1
TGCAGTGCGCGGGAGCTTAGCTCCTACAATGAGCAGTTCTTC	CSARELSSYNEQFF	TRBV20-1	TRBJ2-1
TGTGCCAGCAGCCAAAGGAAACCAGGGGCCCGCTATGGCTACACCTTC	CASSQRKPGARYGYTF	TRBV14	TRBJ1-2
TGTGCCAGAACGGGACTAGCGGGTGGAGATACGCAGTATTTT	CARTGLAGGDTQYF	TRBV6-1	TRBJ2-3
TGTGCCAGCAGCTTACCCGGGCCCACATTTGAGACCCAGTACTTC	CASSLPGPTFETQYF	TRBV11-2	TRBJ2-5
TGTGCCTGGAGTGTACCGGGGGGGCCCGGGACAACCTACGAGCAGTACTTC	CAWSVPGGPGTTYEQYF	TRBV30	TRBJ2-7
TGTGCCAGCAGTTTAAGTTGGGACAGGGGGGAGTTTGGGGAGACCCAGTACTTC	CASSLSWDRGEFGETQYF	TRBV27	TRBJ2-5
TGTGCCAGCAGCTTGCCCCTTAAGGTTATAACCTACGAGCAGTACTTC	CASSLPLKVITYEQYF	TRBV5-6	TRBJ2-7
TGTGCCAGCAGGTGGGACAGGCGTCTAGCCAAAAACATTCAGTACTTC	CASRWDRRLAKNIQYF	TRBV6-5	TRBJ2-4
TGTGCCAGCAGCTTGTCTTTGTTCGGAATAGGCCCAACTAATGAAAAACTGTTTTTT	CASSLSLFGIGPTNEKLFF	TRBV5-5	TRBJ1-4
TGTGCCAGCAGCCAAGGAATTAGGGGGAAGAGCGGCAATCAGCCCCAGCATTTT	CASSQGIRGKSGNQPQHF	TRBV4-2	TRBJ1-5
TGTGCCAGCAGTTTATCGATGGATCAGATCCGGGAGAACTACGAGCAGTACTTC	CASSLSMDQIRENYEQYF	TRBV27	TRBJ2-7
TGTGCCAGCAGTGACGGAAACTGCTCTGGGGCCAACGTCCTGACTTTC	CASSDGNCSGANVLTF	TRBV6-1	TRBJ2-6
TGTGCCATCAACCGGGACTTCAATCAGCCCCAGCATTTT	CAINRDFNQPQHF	TRBV10-3	TRBJ1-5
TGTGCCAGCAGCTTATCTCCCCACAGGGGGCTGGGTGGCGAGCAGTACTTC	CASSLSPHRGLGGEQYF	TRBV5-6	TRBJ2-7
TGTGCCAGCAGCCTTCCATGGGACAGCATGGGGAAGGGCTACACCTTC	CASSLPWDSMGKGYTF	TRBV3-1	TRBJ1-2
TGTGCCAGCAGTTCAGGGGCAAACTACAATGAGCAGTTCTTC	CASSSGANYNEQFF	TRBV25-1	TRBJ2-1
TGTGCCAGCAGCTTGGCGGATGGGTTCCCCGGGACTAGCGGGACGCAGTATTTT	CASSLADGFPGTSGTQYF	TRBV5-6	TRBJ2-3
TGTGCCAGCAGCGTAGGTGTCCCAAGACAGGGACTCAATTCACCCCTCCACTTT	CASSVGVPRQGLNSPLHF	TRBV9	TRBJ1-6
TGCAGTGCGGCAGACAGGGGTGTAGAAAAACTGTTTTTT	CSAADRGVEKLFF	TRBV20-1	TRBJ1-4
TGTGCCAGCAGTGACTCCCGGGCCCAGGGCCAAGAGACCCAGTACTTC	CASSDSRAQGQETQYF	TRBV6-4	TRBJ2-5
TGTGCCACATTGTCAGGGCCACACGAGCAGTACTTC	CATLSGPHEQYF	TRBV6-6	TRBJ2-7
TGTGCCAGCAGCCCACTGGGGACAGGGGGCTCACTAGAGACCCAGTACTTC	CASSPLGTGGSLETQYF	TRBV5-5	TRBJ2-5
TGCGCCAGCAGCCACCACCCCAGGGAGACAACTAATGAAAAACTGTTTTTT	CASSHHPRETTNEKLFF	TRBV5-1	TRBJ1-4
TGTGCCATCACTAGCGGGAGTTTATGGATCACAGATACGCAGTATTTT	CAITSGSLWITDTQYF	TRBV10-3	TRBJ2-3
TGCAGTGCTGAGATCGTGGACAGGGGTGGTGGAAACACCATATATTTT	CSAEIVDRGGGNTIYF	TRBV20-1	TRBJ1-3
TGTGCCAGCTCACCAGTACAGGGTAACTATGGCTACACCTTC	CASSPVQGNYGYTF	TRBV18	TRBJ1-2
TGTGCCAGCAGCTGTCCAATCTCTGAGAATGAAAAACTGTTTTTT	CASSCPISENEKLFF	TRBV7-3	TRBJ1-4
TGTGCCAGCAGCTTGATCTTCCGAGGGAGGGCGAACACCGGGGAGCTGTTTTTT	CASSLIFRGRANTGELFF	TRBV5-5	TRBJ2-2
TGTGCCCCAGACCACCGGGGACAGGGGCCTGGGGCCAACGTCCTGACTTTC	CAPDHRGQGPGANVLTF	TRBV3-1	TRBJ2-6
TGCATATATAACTACATGAACACTGAAGCTTTCTTT	CIYNYMNTEAFF	TRBV20-1	TRBJ1-1
TGTGCCACCGGCCCAGTGAGGGTGGACCGTCGCTACACTGAAGCTTTCTTT	CATGPVRVDRRYTEAFF	TRBV24-1	TRBJ1-1
TGTGCCAGCAGCTTAGTGAGCGGACAGGGCTACAATGAGCAGTTCTTC	CASSLVSGQGYNEQFF	TRBV7-6	TRBJ2-1
TGTGCCGAGGGAACGGGGTACGAGCAGTACTTC	CAEGTGYEQYF	TRBV6-4	TRBJ2-7
TGTGCCACCAGTGATTGCCAAGAATCCCTCCAAATCAGGGGGCGCCATGAGACCCAGTACTTC	CATSDCQESLQIRGRHETQYF	TRBV24-1	TRBJ2-5
TGTGCCAGCAGCAAGCCAGTGACTAGCTCGGGACGCAATGAGCAGTTCTTC	CASSKPVTSSGRNEQFF	TRBV9	TRBJ2-1
TGTGCCAGCAGTAAGAAGGATACGGGGCGAACACACACTGAAGCTTTCTTT	CASSKKDTGRTHTEAFF	TRBV27	TRBJ1-1
TGCGCCAGCAGCCGGACTCTCCGGGACAGGGGTAACTATGGCTACACCTTC	CASSRTLRDRGNYGYTF	TRBV5-1	TRBJ1-2
TGCGCCAGCAGCGAGACCGGAGGGAGGGCTCGTGGCTACACCTTC	CASSETGGRARGYTF	TRBV5-1	TRBJ1-2
TGTGCCAGCAGCACGAAACCCAGGACAGGAACTGAAGCTTTCTTT	CASSTKPRTGTEAFF	TRBV9	TRBJ1-1
TGTGCCAGCAGCCAAGACCGAGATCAGCCCCAGCATTTT	CASSQDRDQPQHF	TRBV4-2	TRBJ1-5
TGTGCCAGCAGTGGTCGACAGGGGCCTAAGCAGGAGCTGTTTTTT	CASSGRQGPKQELFF	TRBV6-6	TRBJ2-2
TGTGCCAGCAGCCCGACAGGGGAGGAAGACTACGAGCAGTACTTC	CASSPTGEEDYEQYF	TRBV5-5	TRBJ2-7
TGCGCCAGCAGCAGAGGCTACGAGCAGTACTTC	CASSRGYEQYF	TRBV10-2	TRBJ2-7
TGTGCCAGCAGCGGGATTGGACAGGGGTGGGGGGGAAGCACTGAAGCTTTCTTT	CASSGIGQGWGGSTEAFF	TRBV13	TRBJ1-1
TGTGCCAGTACCCAGCCGCTTAAGACTAGCGGGAGCGGAGGAGGATCGCCCTATAGCAATCAGCCCCAGCATTTT	CASTQPLKTSGSGGGSPYSNQPQHF	TRBV19	TRBJ1-5
TGTGCCAGCAGCGCCTATCCGCGTAGGGCCCGCCCCTACGAGCAGTACTTC	CASSAYPRRARPYEQYF	TRBV13	TRBJ2-7
TGTGCCAGCTTACCCAACATACCCCTCCACTTT	CASLPNIPLHF	TRBV6-4	TRBJ1-6
TGTGCCTGGAGGGACAATGAGCAGTTCTTC	CAWRDNEQFF	TRBV30	TRBJ2-1
TGTGCCATTAGAACAGATACGCAGTATTTT	CAIRTDTQYF	TRBV6-5	TRBJ2-3
TGTGCCAGCAATCTTTCGGACGGCGAGCAGTACTTC	CASNLSDGEQYF	TRBV3-1	TRBJ2-7
TGTGCCAGCAGTTACGGCCCACGGGCCAGCCGGTCGAATGAGCAGTTCTTC	CASSYGPRASRSNEQFF	TRBV6-5	TRBJ2-1
TGTGCCAGCAGCCAAGCCCAGGGACAGGGGGCATTTGCATATAGCAATCAGCCCCAGCATTTT	CASSQAQGQGAFAYSNQPQHF	TRBV14	TRBJ1-5
TGTGCCAGCAGTTACTCGAATCGTACCGGGGGGGCCTCCTACGAGCAGTACTTC	CASSYSNRTGGASYEQYF	TRBV6-5	TRBJ2-7
TGCAGTGCTATCCCCAAAACCCGAGCAATGACAAATCAGCCCCAGCATTTT	CSAIPKTRAMTNQPQHF	TRBV20-1	TRBJ1-5
TGTGCCAGCAGTGTTAGGGGAGAGACCCAGTACTTC	CASSVRGETQYF	TRBV27	TRBJ2-5
TGTGCCAGCAGCTACGGGGAGTTGCTTTCCTACGAGCAGTACTTC	CASSYGELLSYEQYF	TRBV7-3	TRBJ2-7
TGTGCCTGGAGTGAAGCCGGACTAGCGGGGGGGCCATTCTTCAGAGCTCATGAGCAGTTCTTC	CAWSEAGLAGGPFFRAHEQFF	TRBV30	TRBJ2-1
TGTGCCAGCTCCAGACAGGGGGCACCTTCTAACCGGGGGACCAGCTCCTACGAGCAGTACTTC	CASSRQGAPSNRGTSSYEQYF	TRBV28	TRBJ2-7
TGTGCCAGCAGCGGTCTACCGGACAACTATGGCTACACCTTC	CASSGLPDNYGYTF	TRBV9	TRBJ1-2
TGCAGTGCTAGAGAAACACCCAGCTACGAGCAGTACTTC	CSARETPSYEQYF	TRBV20-1	TRBJ2-7
TGTGCCAGAGATGGGGGGACAGCGGTCCTCACAGATACGCAGTATTTT	CARDGGTAVLTDTQYF	TRBV7-4	TRBJ2-3
TGTGCCAGCAGTGGGGGCCTCTATGAGCAGTTCTTC	CASSGGLYEQFF	TRBV27	TRBJ2-1
TGTGCCAGCAATCAGGGTCTATATCAGCCCCAGCATTTT	CASNQGLYQPQHF	TRBV6-5	TRBJ1-5
TGCAGTGCTAGAGATCGGCCTAGCGGATGGAACACCGGGGAGCTGTTTTTT	CSARDRPSGWNTGELFF	TRBV20-1	TRBJ2-2
TGTGCCACCCTGGGGGGCACCGGGGAGCTGTTTTTT	CATLGGTGELFF	TRBV7-9	TRBJ2-2
TGCAGCGTGTGCCGGGGGCTTCTAGCCAAAAACATTCAGTACTTC	CSVCRGLLAKNIQYF	TRBV29-1	TRBJ2-4
TGTGCCAGCAGCTTACAGGGAACGAATGGCTACACCTTC	CASSLQGTNGYTF	TRBV11-3	TRBJ1-2
TGTGCCAGCAGCCCAGGGAGGCGGCGCCAAGAGACCCAGTACTTC	CASSPGRRRQETQYF	TRBV7-9	TRBJ2-5
TGTGCCACCAGCAGACCGAGAACTAGCGGGAGTGACACAGATACGCAGTATTTT	CATSRPRTSGSDTDTQYF	TRBV15	TRBJ2-3
TGTGCCAGCAGCTGGCATGGGACAGCGACTGAAGCTTTCTTT	CASSWHGTATEAFF	TRBV5-5	TRBJ1-1
TGCGCCAGCAGCTTGGGATGGGGGCTTCGGCAGTACTTC	CASSLGWGLRQYF	TRBV5-1	TRBJ2-5
TGTGCCAGCAGCGTAGTCATCGGGGGTCCTAACTATGGCTACACCTTC	CASSVVIGGPNYGYTF	TRBV9	TRBJ1-2
TGTGCCAGCAGCACCTGGGGGGAGACCCAGTACTTC	CASSTWGETQYF	TRBV12-3	TRBJ2-5
TGTGCCAGCAGGGAAGGGACAGCATACTATGGCTACACCTTC	CASREGTAYYGYTF	TRBV7-8	TRBJ1-2
TGCGCCAGCAGCCAATCACGATGCGAGCAGTACTTC	CASSQSRCEQYF	TRBV4-1	TRBJ2-7
TGTGCCAGCAGTGACCTGGTTTCCAGACTAGCGGTCGATACGCAGTATTTT	CASSDLVSRLAVDTQYF	TRBV6-4	TRBJ2-3
TGTGCCAGCAGCACACAGGAATCGGCCCGGGATACTAATGAAAAACTGTTTTTT	CASSTQESARDTNEKLFF	TRBV6-2	TRBJ1-4
TGTGCCAGCAGCTTTTTGACTGGAATGAACACTGAAGCTTTCTTT	CASSFLTGMNTEAFF	TRBV7-8	TRBJ1-1
TGTGCCAGCAGTTACTCGATAAAGCGGGAGGGCAGAACTAGCACAGATACGCAGTATTTT	CASSYSIKREGRTSTDTQYF	TRBV6-5	TRBJ2-3
TGTGCCAGCAGTGAGGTTCCCCCCGGGACTGAGGCTGCTTTCTTT	CASSEVPPGTEAAFF	TRBV6-4	TRBJ1-1
TGTGCCAGCAGTTTCCCATTACGGCGGGCAAACGAGCAGTACTTC	CASSFPLRRANEQYF	TRBV6-5	TRBJ2-7
TGTGCCAGCAGCTCAGAAAGCGGGAGGAAGTGGTCAGATACGCAGTATTTT	CASSSESGRKWSDTQYF	TRBV11-2	TRBJ2-3
TGTGCCAGACAGGGGCGGGAGGAGGACACCGGGGAGCTGTTTTTT	CARQGREEDTGELFF	TRBV6-1	TRBJ2-2
TGTGCCAGCAGCTTGTCAAGCTTGACACAGCCCCAGCATTTT	CASSLSSLTQPQHF	TRBV5-6	TRBJ1-5
TGTGCCACCAGTGCCGCGGGGCCATATTGCAATCAGCCCCAGCATTTT	CATSAAGPYCNQPQHF	TRBV24-1	TRBJ1-5
TGCGCCAGCAGCATGACCCAGGGGGCGGAGGCAGATACGCAGTATTTT	CASSMTQGAEADTQYF	TRBV5-1	TRBJ2-3
TGTGCCAGCAGCCCCGTGGGAAGAATGGGGCGAAACACCATATATTTT	CASSPVGRMGRNTIYF	TRBV7-2	TRBJ1-3
TGTGCCAGCATGAATCCAGGACAGGGGGCGCGCGGGACCGGCGAGCAGTACTTC	CASMNPGQGARGTGEQYF	TRBV6-5	TRBJ2-7
TGCGCCAGCAATTGGGCAGGGGTGTCTCGCAATCAGCCCCAGCATTTT	CASNWAGVSRNQPQHF	TRBV10-1	TRBJ1-5
TGTGCTAGTGGTTTCCAGGGGACAGGTCTTGACTACGAGCAGTACTTC	CASGFQGTGLDYEQYF	TRBV12-5	TRBJ2-7
TGCGCCAGCAGCTTGACACCCGCTGACGATAAAATATACGAGCAGTACTTC	CASSLTPADDKIYEQYF	TRBV5-1	TRBJ2-7
TGTGCCAGCAGCTATAAGTACTATTCGCCTATCTTC	CASSYKYYSPIF	TRBV13	TRBJ2-1
TGTGCCAGCAGCACAAGAGACAGGAGAGCTTTCTTT	CASSTRDRRAFF	TRBV13	TRBJ1-1
TGCGCCAGCAGCAGGCAGAGACTAGCGGGGTTCTATACCGGGGAGCTGTTTTTT	CASSRQRLAGFYTGELFF	TRBV5-1	TRBJ2-2
TGCGCCAGCAGCCATTATGGGGGGGGACGCAATGAGCAGTTCTTC	CASSHYGGGRNEQFF	TRBV4-3	TRBJ2-1
TGTACCACGACAGGTTTAACAGATACGCAGTATTTT	CTTTGLTDTQYF	TRBV7-9	TRBJ2-3
TGCGCCAGCAGCGCATTTCCCTCAGGGTGGGAGCTGTTTTTT	CASSAFPSGWELFF	TRBV5-1	TRBJ2-2
TGTGCCAGCAGCGTACGGGGCCGGGACAGGGTAAGCAATCAGCCCCAGCATTTT	CASSVRGRDRVSNQPQHF	TRBV9	TRBJ1-5
TGTGCCAGCAGCGCCCGGGGGCGATCCAACACTGAAGCTTTCTTT	CASSARGRSNTEAFF	TRBV13	TRBJ1-1
TGTGCCAGCAGATCAGGGGATTACGAGCAGTACTTC	CASRSGDYEQYF	TRBV28	TRBJ2-7
TGTGCCAGCAGACAGAGCGGATGCTCCTACGAGCAGTACTTC	CASRQSGCSYEQYF	TRBV27	TRBJ2-7
TGTGCCAGCCTTTCGACTAGGGAGAGCTCCTACGAGCAGTACTTC	CASLSTRESSYEQYF	TRBV9	TRBJ2-7
TGTGCCAGCAGTGCAGGGAGGGCTTATGGCTACACCTTC	CASSAGRAYGYTF	TRBV6-4	TRBJ1-2
TGTGCTACGAGGAACGCACGCATCTCTGGAAACACCATATATTTT	CATRNARISGNTIYF	TRBV30	TRBJ1-3
TGTGCCAGCAACGGACACGAGCAGTACTTC	CASNGHEQYF	TRBV6-4	TRBJ2-7
TGTGCCACCAGCAGGCAGACAGGGGATTACCGCAATCAGCCCCAGCATTTT	CATSRQTGDYRNQPQHF	TRBV15	TRBJ1-5
TGTGCCAGTTCGGGGCTCGGAAACACCATATATTTT	CASSGLGNTIYF	TRBV11-3	TRBJ1-3
TGTGCCAGCAGCGCCCGGGACAGGACCCCCTTTTGTTCACCCCTCCACTTT	CASSARDRTPFCSPLHF	TRBV7-2	TRBJ1-6
TGTGCCAGCAGATACTATCAGCCCCAGCATTTT	CASRYYQPQHF	TRBV27	TRBJ1-5
TGTGCCAGCGACAGTCGGCCCAATGAGCAGTTCTTC	CASDSRPNEQFF	TRBV27	TRBJ2-1
TGCAGTGCTAGACGACAGGGAATTCCCAGCCTACCGTATGATACTAATGAAAAACTGTTTTTT	CSARRQGIPSLPYDTNEKLFF	TRBV20-1	TRBJ1-4
TGTGCCAGCAGCTTAGAAGGGCACATCGGGCCGCCGTACGAGCAGTACTTC	CASSLEGHIGPPYEQYF	TRBV7-2	TRBJ2-7
TGTGCCAGCAGCCAAGTCCGGGACAGTATCCACAAAGCTAACTATGGCTACACCTTC	CASSQVRDSIHKANYGYTF	TRBV3-1	TRBJ1-2
TGTGCCAGCAGCGTAGCCGCGGAGGGGGGGCCTCCAGCCAAAAACATTCAGTACTTC	CASSVAAEGGPPAKNIQYF	TRBV9	TRBJ2-4
TGTGCCAGCAGTTTGCCGACTGGGACCCAGTACTTC	CASSLPTGTQYF	TRBV12-4	TRBJ2-5
TGTGCCAGCAGTTTCAGAAAGGCCTACGAGCAGTACTTC	CASSFRKAYEQYF	TRBV28	TRBJ2-7
TGCGCCAGCACCCGGGACATAAAGTCAACTAATGAAAAACTGTTTTTT	CASTRDIKSTNEKLFF	TRBV10-1	TRBJ1-4
TGTGCCAGCACCACTAGCGGGAGGGAAAGGGCAGATACGCAGTATTTT	CASTTSGRERADTQYF	TRBV27	TRBJ2-3
TGTGCCAGCGAAATAGTGGGGGAACTCTATGGCTACACCTTC	CASEIVGELYGYTF	TRBV27	TRBJ1-2
TGTGCCAGCAGAACGCCGGGGGCCAAAAACATTCAGTACTTC	CASRTPGAKNIQYF	TRBV27	TRBJ2-4
TGTGCCATCAGTGAGTCGGCAGGCGGGGGGGGGGGGAACACCGGGGAGCTGTTTTTT	CAISESAGGGGGNTGELFF	TRBV10-3	TRBJ2-2
TGTGCCAGCAGCAAAGGGACGGGTAGCTACACCTTC	CASSKGTGSYTF	TRBV7-9	TRBJ1-2
TGTGCCAGCAGCCAAGGACAGGGACAGGCTTTTGGTAGCAGCTACGAGCAGTACTTC	CASSQGQGQAFGSSYEQYF	TRBV11-3	TRBJ2-7
TGTGCCAGCAGGAGGGAGGGGTCTTTTAACTATGGCTACACCTTC	CASRREGSFNYGYTF	TRBV6-4	TRBJ1-2
TGTGCCAGCAGCGTAAACATGGGACAGGGGGGGGGCCACGAGCAGTACTTC	CASSVNMGQGGGHEQYF	TRBV9	TRBJ2-7
TGTGCCAGAATAACTAGCGGGCTAGGCTCCTACAATGAGCAGTTCTTC	CARITSGLGSYNEQFF	TRBV11-3	TRBJ2-1
TGTGCCAGCAGTTTATCAGGTGAAGCTTTCTTT	CASSLSGEAFF	TRBV12-3	TRBJ1-1
TGTGCCAGCAGTGCTTTCCCCGGTTCTTCAAGACCCCAGCCCCAGCATTTT	CASSAFPGSSRPQPQHF	TRBV27	TRBJ1-5
TGTGCCAGCAGCTCCGGAAAGTCTAGCGGGAAGGTGAACACCGGGGAGCTGTTTTTT	CASSSGKSSGKVNTGELFF	TRBV13	TRBJ2-2
TGCAGTGCTAGGGAGGACAGGGCCAATGAAAAACTGTTTTTT	CSAREDRANEKLFF	TRBV20-1	TRBJ1-4
TGTGCTAGTGGTTTACAATCCGGGACAGGGGGGATTAATAGCAATCAGCCCCAGCATTTT	CASGLQSGTGGINSNQPQHF	TRBV12-5	TRBJ1-5
TGTGCCACCAGTGTTGAGCATTGGACCGGGGAGCTGTTTTTT	CATSVEHWTGELFF	TRBV24-1	TRBJ2-2
TGCGCCAGCAGTGAAACACGCGGGAGCGTAATGTCTGGAAACACCATATATTTT	CASSETRGSVMSGNTIYF	TRBV10-1	TRBJ1-3
TGCGCCAGCCGGGCTCAAGAGACCCAGTACTTC	CASRAQETQYF	TRBV10-1	TRBJ2-5
TGTGCCAGCAGCAGTGGACAGAGGTCGTTGGACTACGAGCAGTACTTC	CASSSGQRSLDYEQYF	TRBV9	TRBJ2-7
TGTGCCAGCAGCTTCAAGGTTCTGGGCCCGGGACTCTCCTACGAGCAGTACTTC	CASSFKVLGPGLSYEQYF	TRBV7-3	TRBJ2-7
TGTGCCAGCTCACCAGATGGTAGGAGGGGTCGCAATCAGCCCCAGCATTTT	CASSPDGRRGRNQPQHF	TRBV18	TRBJ1-5
TGTGCCAGCAGTTACGTAGGACAGGTTGAAGAGACCCAGTACTTC	CASSYVGQVEETQYF	TRBV6-5	TRBJ2-5
TGTGCCAGCAGTGATTTCGTAGCGGGCACCGGGGAGCTGTTTTTT	CASSDFVAGTGELFF	TRBV6-4	TRBJ2-2
TGCAGCGTCCGCAGGGGGCGCAACTACGAGCAGTACTTC	CSVRRGRNYEQYF	TRBV29-1	TRBJ2-7
TGCAGTGCAAGTGATCGGGGGACAGGGCAGGCGTCCGCTGCAACTAATGAAAAACTGTTTTTT	CSASDRGTGQASAATNEKLFF	TRBV20-1	TRBJ1-4
TGCGCCAGCAGCTCAGTCCTCACTAGGGCCAGCGGGTGGAACGAGCAGTACTTC	CASSSVLTRASGWNEQYF	TRBV5-1	TRBJ2-7
TGTGCCAGCAGTTTATGCTCCTGGGGTTATGGCTACACCTTC	CASSLCSWGYGYTF	TRBV28	TRBJ1-2
TGTGCCTGGAGTGTACCTAGTCACAGGGATGAGCAGTTCTTC	CAWSVPSHRDEQFF	TRBV30	TRBJ2-1
TGTGCCAGCAGCACCGTCCTGGACATACGTACAACAGAGTGCTACGAGCAGTACTTC	CASSTVLDIRTTECYEQYF	TRBV13	TRBJ2-7
TGTGCCAGCAGTGAATCAGTTGGAGCGCAAGAGACCCAGTACTTC	CASSESVGAQETQYF	TRBV25-1	TRBJ2-5
TGCGCCAGCAACACAATCCAGGGGGCTTACGATGAGCAGTTCTTC	CASNTIQGAYDEQFF	TRBV10-1	TRBJ2-1
TGTGCCAGCAGCGAGCGCACGGCACCCTCCTACGAGCAGTACTTC	CASSERTAPSYEQYF	TRBV7-3	TRBJ2-7
TGTGCCTGGAGTGTCTTAGCGGGCCACTACGAGCAGTACTTC	CAWSVLAGHYEQYF	TRBV30	TRBJ2-7
TGTGCCAGCAGCGTAGCCCTTAACAAGGCAGGGAGGGTTGAAAAACTGTTTTTT	CASSVALNKAGRVEKLFF	TRBV9	TRBJ1-4
TGTGCCAGCCCCTCACTAGCGGGAGTTACCACGTATGAGCAGTTCTTC	CASPSLAGVTTYEQFF	TRBV28	TRBJ2-1
TGTGCCAGCAGCAACCATGCCGGGACTGGGGCTTTCTTT	CASSNHAGTGAFF	TRBV13	TRBJ1-1
TGTGCCAGCAGCATAGGGGGTAAGGGCTTTGAAGCTTTCTTT	CASSIGGKGFEAFF	TRBV13	TRBJ1-1
TGTGCCAGCAGTTACTCGGTGGTCCACATCCAGGGTTTGTCCTACGAGCAGTACTTC	CASSYSVVHIQGLSYEQYF	TRBV6-3	TRBJ2-7
TGTGCCAGCAGCACCTGGGGACTCCGCGTAAGCAATCAGCCCCAGCATTTT	CASSTWGLRVSNQPQHF	TRBV11-1	TRBJ1-5
TGCGCCAGCAGCCACAAGACTTTGGGGAAGGAGGACGAGCAGTACTTC	CASSHKTLGKEDEQYF	TRBV4-1	TRBJ2-7
TGCGCCAGCAGCTTGGCAACGGGATCCTCTGGAAACACCATATATTTT	CASSLATGSSGNTIYF	TRBV5-1	TRBJ1-3
TGTGCCAGCAGCCCAGGAGGGAACACTGAAGCTTTCTTT	CASSPGGNTEAFF	TRBV27	TRBJ1-1
TGTGCCAGCAGCCGGGTGAAGGTTGTACCTGATACGCAGTATTTT	CASSRVKVVPDTQYF	TRBV11-2	TRBJ2-3
TGTGCCAGCATCAGGCGGCCTTCGGAGGGAACTGAAGCTTTCTTT	CASIRRPSEGTEAFF	TRBV7-4	TRBJ1-1
TGTGCCAGCAGGGCTGGGGCAGATACGCAGTATTTT	CASRAGADTQYF	TRBV7-2	TRBJ2-3
TGTGCCAGCAGCTCAGGGGGCGACAAAAACATTCAGTACTTC	CASSSGGDKNIQYF	TRBV9	TRBJ2-4
TGTGGGAGACAGCCCCGGGACAGGGGACAAACCGGGGAGCTGTTTTTT	CGRQPRDRGQTGELFF	TRBV27	TRBJ2-2
TGCGCCAGCAAACCAAGCTACGAGCAGTACTTC	CASKPSYEQYF	TRBV4-3	TRBJ2-7
TGTGCCACCAGTGAGAGTGGACTCGAAGAGACCCAGTACTTC	CATSESGLEETQYF	TRBV24-1	TRBJ2-5
TGTGCCAGCAGTGACTTGACAGGGGAGAGGGGCTACACCTTC	CASSDLTGERGYTF	TRBV6-1	TRBJ1-2
TGTGCCAGCAGCCAAGATCAGGGACGAAACACCATATATTTT	CASSQDQGRNTIYF	TRBV3-1	TRBJ1-3
TGTGCCAGCAGTCCAGGCGATGGACAGAGATCGAACACTGAAGCTTTCTTT	CASSPGDGQRSNTEAFF	TRBV12-4	TRBJ1-1
TGTGCCAGCAGGTCGCGTCCCCATATTTCAGCTTTCTTT	CASRSRPHISAFF	TRBV6-5	TRBJ1-1
TGTGCCAGCAGTTACCCGACTCATAGTGGTAATGAAAAACTGTTTTTT	CASSYPTHSGNEKLFF	TRBV6-5	TRBJ1-4
TGTGCCAGCAGGTCCCCGACAGGGATCTCTAAGAACACTGAAGCTTTCTTT	CASRSPTGISKNTEAFF	TRBV12-3	TRBJ1-1
TGTGCCAGAAAGGGAGGCTTCGCGCGAAACATTCAGTACTTC	CARKGGFARNIQYF	TRBV6-5	TRBJ2-4
TGCGCCAGCAGCCAGTCGGGGCCAATAGAGTCAATGAACACTGAAGCTTTCTTT	CASSQSGPIESMNTEAFF	TRBV4-1	TRBJ1-1
TGTGCCAGCAGCCCTCGGTGGCCGACAGGGAGCTCCTACGAGCAGTACTTC	CASSPRWPTGSSYEQYF	TRBV9	TRBJ2-7
TGCAGTGCTAGAGATTTCTGGCTTGCCTACGAGCAGTACTTC	CSARDFWLAYEQYF	TRBV20-1	TRBJ2-7
TGTGCCAGCATGGGACAGGGAGAGGGGAACACTGAAGCTTTCTTT	CASMGQGEGNTEAFF	TRBV27	TRBJ1-1
TGTGCCAGCAGCATCACAGATGGGCGCGGAGACGAGCAGTACTTC	CASSITDGRGDEQYF	TRBV6-8	TRBJ2-7
TGTGCCAGCACCGGGGTAGTTGGCTACACCTTC	CASTGVVGYTF	TRBV7-2	TRBJ1-2
TGTGCCTGGAGAGTCCCGGCTTCTGGCCAAGAGACCCAGTACTTC	CAWRVPASGQETQYF	TRBV30	TRBJ2-5
TGTGCCTGGACTGGTCGGACCACCTTC	CAWTGRTTF	TRBV30	TRBJ1-2
TGTGCCAGCAGCTTAGAGTCCTTTCAGCGGGAGAGCACCGGGGAGCTGTTTTTT	CASSLESFQRESTGELFF	TRBV7-9	TRBJ2-2
TGTGCCAGCAGCCAAGCGCCCCGCCGGGAATTAGAGCAGTACTTC	CASSQAPRRELEQYF	TRBV3-1	TRBJ2-7
TGTGCCAGCAGCGTAGGAAATTCTCGGGGCGAGTACGAGCAGTACTTC	CASSVGNSRGEYEQYF	TRBV9	TRBJ2-7
TGTGCCAGGGTTAACCAAGGCGGACTAGCTTGGGTCTTC	CARVNQGGLAWVF	TRBV11-2	TRBJ2-1
TGTGCCAGAAAGGGGAGGGGGGTTAACAATGAGCAGTTCTTC	CARKGRGVNNEQFF	TRBV19	TRBJ2-1
TGTGCCAGCAGCCGGGGTCCCAGAGCTACGCAGTATTTT	CASSRGPRATQYF	TRBV11-3	TRBJ2-3
TGTGCCAGCAGCACTCCGCAGGGACCCCAGCCCCAGCATTTT	CASSTPQGPQPQHF	TRBV7-3	TRBJ1-5
TGTGCCAGCAGAATCAAGAACACTGAAGCTTTCTTT	CASRIKNTEAFF	TRBV12-4	TRBJ1-1
TGTGCCAGCAGCTGGGGGACAGGTGGAAACACCATATATTTT	CASSWGTGGNTIYF	TRBV7-9	TRBJ1-3
TGTGCCAGCAGTTTGGGGACTAGCGGGTGGGCCCCGGAGCAGTACTTC	CASSLGTSGWAPEQYF	TRBV12-3	TRBJ2-7
TGTGCCAGCAGCCAAGACGGTGGGACAGGGGAGGGGACTAACTATGGCTACACCTTC	CASSQDGGTGEGTNYGYTF	TRBV14	TRBJ1-2
TGTGCCATCAATCGGGACAGGGACACTGAAGCTTTCTTT	CAINRDRDTEAFF	TRBV10-3	TRBJ1-1
TGTGCCAGCAGTTTGGAGTGTCGTAGCAGGGAGAGGAACACTGAAGCTTTCTTT	CASSLECRSRERNTEAFF	TRBV27	TRBJ1-1
TGTGCCAGCAGCATGGGGGAGGAGGGATGTACTGAAGCTTTCTTT	CASSMGEEGCTEAFF	TRBV6-2	TRBJ1-1
TGTGCCAGCCCTACGGTGGACACTGAAGCTTTCTTT	CASPTVDTEAFF	TRBV12-3	TRBJ1-1
TGTGCCAGCAGCCCGCGGGGCGTACCCCTCCACTTT	CASSPRGVPLHF	TRBV13	TRBJ1-6
TGTGCCACCAGTGATGAATCACGGGACGAGCAGTACTTC	CATSDESRDEQYF	TRBV24-1	TRBJ2-7
TGTGCCAGCAGTTTCCCTGGAATGCGCGGGGAGACCCAGTACTTC	CASSFPGMRGETQYF	TRBV27	TRBJ2-5
TGTGCCAGCAGTGAACCCCAAGATCACAAATCAAATGAGCAGTTCTTC	CASSEPQDHKSNEQFF	TRBV6-1	TRBJ2-1
TGTGCCAGCAGCACTCCAATTAGACTCGGAGGCCCTAACAATGAGCAGTTCTTC	CASSTPIRLGGPNNEQFF	TRBV11-2	TRBJ2-1
TGCGCCAGCAGCCGGGAATCAGGGGGATCCGTGCCCCAGCATTTT	CASSRESGGSVPQHF	TRBV4-1	TRBJ1-5
TGCAGTGCTAGAGCGGAATATCGCTCCTACAATGAGCAGTTCTTC	CSARAEYRSYNEQFF	TRBV20-1	TRBJ2-1
TGTGCCAGCCCAGACAGGGGCCGGGAGGCGGGTGGCTACACCTTC	CASPDRGREAGGYTF	TRBV7-3	TRBJ1-2
TGTGCCAGCCAATATGTGCCGGTCCCTCTGCGGACTAACTATGGCTACACCTTC	CASQYVPVPLRTNYGYTF	TRBV6-5	TRBJ1-2
TGCAGCGCTATATACGACGGGGAAGCTTTCTTT	CSAIYDGEAFF	TRBV29-1	TRBJ1-1
TGTGCCACCAGCGGGACTGCTGAAGCTTTCTTT	CATSGTAEAFF	TRBV24-1	TRBJ1-1
TGTGCCAGCACCTCCCGGGTACCAGATACGCAGTATTTT	CASTSRVPDTQYF	TRBV6-4	TRBJ2-3
TGCGCCAGGGTTAGGGGCTGCCAGGGGGGTCGCTACGAGCAGTACTTC	CARVRGCQGGRYEQYF	TRBV10-1	TRBJ2-7
TGTGCCAGCAGCATTAACCCCGTGCCCATATATGAGCAGTTCTTC	CASSINPVPIYEQFF	TRBV3-1	TRBJ2-1
TGTGCCAGCAGCGAGGGGCAACTTGAGACCCAGTACTTC	CASSEGQLETQYF	TRBV11-2	TRBJ2-5
TGTGCCAGCAGCTTAACTAGGGAATTGCACGCCTATGGCTACACCTTC	CASSLTRELHAYGYTF	TRBV11-2	TRBJ1-2
TGTGCCAGCAGGGAACAGGGCCAGAAGGGTGGGTATGGCTACACCTTC	CASREQGQKGGYGYTF	TRBV9	TRBJ1-2
TGTGCCAGCAGTCCAGGGACAGAAAGCTGCAATCAGCCCCAGCATTTT	CASSPGTESCNQPQHF	TRBV6-6	TRBJ1-5
TGTGCCAGCAGAGGGAGAGACAATGAGCAGTTCTTC	CASRGRDNEQFF	TRBV12-4	TRBJ2-1
TGTGCCAGCAGCACGAAGGGATCAACAACCGAGGGAATTCAAAATGACAATGAGCAGTTCTTC	CASSTKGSTTEGIQNDNEQFF	TRBV5-4	TRBJ2-1
TGCAGTGCCAGCCTCACTGGGGGGGATGAACTTAATCAGCCCCAGCATTTT	CSASLTGGDELNQPQHF	TRBV20-1	TRBJ1-5
TGTGCCAGCAGCTTACACAACTGCACAGATACGCAGTATTTT	CASSLHNCTDTQYF	TRBV11-3	TRBJ2-3
TGTGCCAGCAGTTTATGTTTAACCAGGGTTGAAAAACTGTTTTTT	CASSLCLTRVEKLFF	TRBV27	TRBJ1-4
TGTGCCAGCAGCGTACTCGGGACTAGCGGGATGGACATTCAGTACTTC	CASSVLGTSGMDIQYF	TRBV9	TRBJ2-4
TGCAGTGCTAGAGATCCTGGGCCAAAGACCCAGTACTTC	CSARDPGPKTQYF	TRBV20-1	TRBJ2-5
TGTGCCAGCAGCCATAGGGGCTACGAGCAGTACTTC	CASSHRGYEQYF	TRBV13	TRBJ2-7
TGTGCCAGCAGCTTACTGTCGGTAGCCACAGATACGCAGTATTTT	CASSLLSVATDTQYF	TRBV7-6	TRBJ2-3
TGTGCCAGCAGTGCTCCTCGGGGCTACGAGCAGTACTTC	CASSAPRGYEQYF	TRBV6-1	TRBJ2-7
TGCAGTGCTAGAGCCTCCGGACAGGGTGGCACAGATACGCAGTATTTT	CSARASGQGGTDTQYF	TRBV20-1	TRBJ2-3
TGTGCCAGCAGTGAAGACAGGGGAGGGACGACTGGCCACTACGAGCAGTACTTC	CASSEDRGGTTGHYEQYF	TRBV6-1	TRBJ2-7
TGTGCCAGCAGTTTTACGCCGGGAGGGTCCTATGGCTACACCTTC	CASSFTPGGSYGYTF	TRBV27	TRBJ1-2
TGCGCCAGCAGCCAAGATATCTCCTCCTACGAGCAGTACTTC	CASSQDISSYEQYF	TRBV4-3	TRBJ2-7
TGTGACAGGGGGCACAATAAAAACATTCAGTACTTC	CDRGHNKNIQYF	TRBV4-2	TRBJ2-4
TGTGCCACCAGTGATTTGGCCCCTCATGGACAGGCCTCCTACAATGAGCAGTTCTTC	CATSDLAPHGQASYNEQFF	TRBV24-1	TRBJ2-1
TGTGCCAGCAGTGGACGGGGGGAGCTGTTTTTT	CASSGRGELFF	TRBV28	TRBJ2-2
TGTGCCAGCAGCCCGGGGGCCGCTGACAATGAGCAGTTCTTC	CASSPGAADNEQFF	TRBV7-2	TRBJ2-1
TGTGCCAGCAGCCAGTGGGCCAATCAGCCCCAGCATTTT	CASSQWANQPQHF	TRBV5-6	TRBJ1-5
TGCAGTGCTAATCAGGGGAATAATGAAAAACTGTTTTTT	CSANQGNNEKLFF	TRBV20-1	TRBJ1-4
TGTGCCAGCAGCAGGATGGACAGGGTTTATAGCAATCAGCCCCAGCATTTT	CASSRMDRVYSNQPQHF	TRBV6-2	TRBJ1-5
TGTGCCAGCAGCCAAGAGGATACAGGGAAGGGGAAGTCCTCGTATGGCTACACCTTC	CASSQEDTGKGKSSYGYTF	TRBV4-2	TRBJ1-2
TGTGCCAGCAGCCATGGGCGGGGGGGGCAAGAGACCCAGTACTTC	CASSHGRGGQETQYF	TRBV4-2	TRBJ2-5
TGTGCCAGCAGATCCGGAGGGGGGGTAAACTCTGGAAACACCATATATTTT	CASRSGGGVNSGNTIYF	TRBV6-3	TRBJ1-3
TGTGCCAGCAGCTTGTCCCAACCCGGCAGGAGCGAGCAGTACTTC	CASSLSQPGRSEQYF	TRBV5-6	TRBJ2-7
TGTGCCAGCAGCTTATCCGGGACTGTCGGCGCCGTCCAGCAAGAGACCCAGTACTTC	CASSLSGTVGAVQQETQYF	TRBV11-2	TRBJ2-5
TGCGCCAGCAGCCAAGACGGGGAGACCCAGTACTTC	CASSQDGETQYF	TRBV4-1	TRBJ2-5
TGCGCCAGGCCGGGACTAGGTAGTATGCTCTACGAGCAGTACTTC	CARPGLGSMLYEQYF	TRBV5-1	TRBJ2-7
TGTGCCAGCAGCCCACCAAGGGACGGGGGTAAGCAGTTCTTC	CASSPPRDGGKQFF	TRBV13	TRBJ2-1
TGTGCCTTCGGACCAAATAGCAATCAGCCCCAGCATTTT	CAFGPNSNQPQHF	TRBV2	TRBJ1-5
TGCAGCGTAGTAGCTTCTTGGGCTAACTATGGCTACACCTTC	CSVVASWANYGYTF	TRBV29-1	TRBJ1-2
TGTGCCAGCAGGCCTGACAGGGCCACAGATACGCAGTATTTT	CASRPDRATDTQYF	TRBV11-2	TRBJ2-3
TGTGCCAGCATTGCGGGACAACGAACCAGTAGCAATCAGCCCCAGCATTTT	CASIAGQRTSSNQPQHF	TRBV25-1	TRBJ1-5
TGCGCCAGCGGACAAGCGGCACTTGTAGATACGCAGTATTTT	CASGQAALVDTQYF	TRBV5-1	TRBJ2-3
TGTGCCAGCAGCTTAGCCCCCGGACAGGGCGTACTGGTCTACACCTTC	CASSLAPGQGVLVYTF	TRBV7-4	TRBJ1-2
TGTGCCAGCAGGCGATACTACGAGCAGTACTTC	CASRRYYEQYF	TRBV6-5	TRBJ2-7
TGCGCCAGCAGCGTCCGGGCGGTTAATGAAAAACTGTTTTTT	CASSVRAVNEKLFF	TRBV5-1	TRBJ1-4
TGTGCCAGCAAAAGAGTATTATGGTTGGCTAGCACAGATACGCAGTATTTT	CASKRVLWLASTDTQYF	TRBV25-1	TRBJ2-3
TGCAGCGTTGAAGATCCGACACCAGGCTACCACACCGGGGAGCTGTTTTTT	CSVEDPTPGYHTGELFF	TRBV29-1	TRBJ2-2
TGTGCCAGCTCACCCGTAACGAACAACTACGAGCAGTACTTC	CASSPVTNNYEQYF	TRBV18	TRBJ2-7
TGTGCCTGGAGGCCTTGGCCGGGACTAGGGCTGGTCTACAATGAGCAGTTCTTC	CAWRPWPGLGLVYNEQFF	TRBV30	TRBJ2-1
TGTGCTAGTGGTGAGGGGGGAACGGACACTGAAGCTTTCTTT	CASGEGGTDTEAFF	TRBV12-5	TRBJ1-1
TGCGCCAGCAGTGAGCTGGGTGGCGGGCTATCCGGGGAGCTGTTTTTT	CASSELGGGLSGELFF	TRBV10-1	TRBJ2-2
TGTGCCATCACAGGGGCTCCGAACACCGGGGAGCTGTTTTTT	CAITGAPNTGELFF	TRBV12-3	TRBJ2-2
TGTGCCAGCAGCTTTCGGGGTTTCACTGAAGCTTTCTTT	CASSFRGFTEAFF	TRBV5-6	TRBJ1-1
TGTGCCAGCAGTTATACCCGTCCGAGTGCCGGCTACACCTTC	CASSYTRPSAGYTF	TRBV6-5	TRBJ1-2
TGTGCCAGCAGTGAGCTTAACACTGAAGCTTTCTTT	CASSELNTEAFF	TRBV6-4	TRBJ1-1
TGTGCCAGCAGCTTCCACAGGGTGGGGCAGCCCCAGCATTTT	CASSFHRVGQPQHF	TRBV5-4	TRBJ1-5
TGCAGCGTTGGTTGGGGGGGCCCCGGATTGGAGACCCAGTACTTC	CSVGWGGPGLETQYF	TRBV29-1	TRBJ2-5
TGTGCCAGCAGCTGGGACCGTAGGAAACAGGGAGAGACCCAGTACTTC	CASSWDRRKQGETQYF	TRBV7-4	TRBJ2-5
TGTGCCAGCAGCGGAAAAAATCAAAGGCACGCTTATGGTAAGGTCGAGACCCAGTACTTC	CASSGKNQRHAYGKVETQYF	TRBV13	TRBJ2-5
TGCGCCAGCAGCCAAGTCCGGGGGCGTCGTTTCTACGAGCAGTACTTC	CASSQVRGRRFYEQYF	TRBV4-3	TRBJ2-7
TGTGCCAGCAGCCCCCCCGCGGGAGTAGCAAGGGCCAAAAACATTCAGTACTTC	CASSPPAGVARAKNIQYF	TRBV5-6	TRBJ2-4
TGTGCCAGCAGCACAACCCTGGGGGAGTCGAACACCGGGGAGCTGTTTTTT	CASSTTLGESNTGELFF	TRBV7-9	TRBJ2-2
TGTGCCAGCAGTGCTCACCAGGGGCCCGGGAATCCCGGGGAGCTGTTTTTT	CASSAHQGPGNPGELFF	TRBV12-3	TRBJ2-2
TGTGCCAGCAGCCGAATATTGGTGATGGTGTGGGAGATCTACGAGCAGTACTTC	CASSRILVMVWEIYEQYF	TRBV4-2	TRBJ2-7
TGCGCCAGCAGCTACCTTAGCGGGATGTACGAGCAGTACTTC	CASSYLSGMYEQYF	TRBV5-1	TRBJ2-7
TGTGCCACCCCAACAAGCCATGAAAAACTGTTTTTT	CATPTSHEKLFF	TRBV24-1	TRBJ1-4
TGTGCCAGCTCACGGTTCAACGGGGGGGAGGCTAACTATGGCTACACCTTC	CASSRFNGGEANYGYTF	TRBV18	TRBJ1-2
TGCGCCAGCAGCTTAACATCGGATCAGCCCCAGCATTTT	CASSLTSDQPQHF	TRBV5-1	TRBJ1-5
TGTGCCAGCAGCGGGGAGTACAATGAGCAGTTCTTC	CASSGEYNEQFF	TRBV9	TRBJ2-1
TGTGCCAGCAGCCAAGCTCCCATTCGAGGAAATCACGAGCAGTACTTC	CASSQAPIRGNHEQYF	TRBV4-2	TRBJ2-7
TGTGCCAGCAGCTCCGGAGAAGATCCCCCGAAGGATCGTAGCTACGAGCAGTACTTC	CASSSGEDPPKDRSYEQYF	TRBV7-2	TRBJ2-7
TGTGCCAGCAGTGCCAACAGCCCTGAAAAACTGTTTTTT	CASSANSPEKLFF	TRBV27	TRBJ1-4
TGTGCCAGCACCCCACGAAGATTGGGACTAGCGGGAGTCGCCCAGGAGCAGTACTTC	CASTPRRLGLAGVAQEQYF	TRBV12-3	TRBJ2-7
TGTGCCAGCAAGGTCTCGGGGGATTATCAGCCCCAGCATTTT	CASKVSGDYQPQHF	TRBV27	TRBJ1-5
TGTGCCAGCAGTAAGAAGACCCTGACTGAAGCTTTCTTT	CASSKKTLTEAFF	TRBV25-1	TRBJ1-1
TGTGCCTGGCCCCCCCCGTGCAGGGGTGAGCAGTTCTTC	CAWPPPCRGEQFF	TRBV30	TRBJ2-1
TGCGCCAGCAGCCCGGGGCGGGGGACAGGGGCCAAAAACATTCAGTACTTC	CASSPGRGTGAKNIQYF	TRBV4-3	TRBJ2-4
TGTGCCAGCAGTTTATGGGGGGGGACCTGTCACACAGATACGCAGTATTTT	CASSLWGGTCHTDTQYF	TRBV27	TRBJ2-3
TGTGCCAGCAGCCAAGAGGGTGGAATCAGGGGGCTTGAACCTCAGGGGACTAATCAGCCCCAGCATTTT	CASSQEGGIRGLEPQGTNQPQHF	TRBV4-2	TRBJ1-5
TGTGCCAGCAGTGACTTAGACAGGACTGGGAACACTGAAGCTTTCTTT	CASSDLDRTGNTEAFF	TRBV6-4	TRBJ1-1
TGTGCCAGCTACCAACCAGAAAGATTCCGCAATCAGCCCCAGCATTTT	CASYQPERFRNQPQHF	TRBV7-2	TRBJ1-5
TGTGCCAGCAGCTATTTCCAGGGAGGTCCGGGCTACACCTTC	CASSYFQGGPGYTF	TRBV9	TRBJ1-2
TGCAGTGCTAGTATCCCCAACAGAGACGAGCAGTACTTC	CSASIPNRDEQYF	TRBV20-1	TRBJ2-7
TGTGCCAGCAGTACAGCCTTTTATGGCTACACCTTC	CASSTAFYGYTF	TRBV6-2	TRBJ1-2
TGTGCCAGCAGCTTACGGGGAGCAACACCCTCCTACGAGCAGTACTTC	CASSLRGATPSYEQYF	TRBV5-6	TRBJ2-7
TGTGCCAGCAGCGTTCGGGGGGAGACCCAGTACTTC	CASSVRGETQYF	TRBV9	TRBJ2-5
TGTGCCAGCGGGTTACAGGGGGAACCGAACACCGGGGAGCTGTTTTTT	CASGLQGEPNTGELFF	TRBV6-3	TRBJ2-2
TGTGCCAGTAGTAATCAGAATGAGCAGTTCTTC	CASSNQNEQFF	TRBV19	TRBJ2-1
TGTGCCAGCAGCTTCCGAGAGGGACACCGGGCCAATTCACCCCTCCACTTT	CASSFREGHRANSPLHF	TRBV7-2	TRBJ1-6
TGTGCCAGCAGTGACCAGGGCCTGCCCCAGCATTTT	CASSDQGLPQHF	TRBV6-4	TRBJ1-5
TGCAGCGTTGCCGTAAGGGATCTTTCTGGCAATCAGCCCCAGCATTTT	CSVAVRDLSGNQPQHF	TRBV29-1	TRBJ1-5
TGTGCCAGCAGTTTGGAGGGGTTTCTTGAGAGTCGAAAGGGGGCCCAGTACTTC	CASSLEGFLESRKGAQYF	TRBV12-4	TRBJ2-5
TGTGCGTTACCCGGGACAGGGGGCGTCCCGGGACGCTCCACCTTC	CALPGTGGVPGRSTF	TRBV28	TRBJ1-2
TGCGCCAGCAGGGAAAGCCTGGGACATGATCAGCCCCAGCATTTT	CASRESLGHDQPQHF	TRBV5-1	TRBJ1-5
TGTGCCAGCGAGGGACAGAACGGGTACGAGCAGTACTTC	CASEGQNGYEQYF	TRBV2	TRBJ2-7
TGTGCCTGGCGGTGGAGTGCCTACGAGCAGTACTTC	CAWRWSAYEQYF	TRBV30	TRBJ2-7
TGTGCCAGCAGCTTAGGGGCGGGAGCCTACGAGCAGTACTTC	CASSLGAGAYEQYF	TRBV7-6	TRBJ2-7
TGTGCCAGCAGCCCCCACGCAGCTTTAAGGGCCTACGAGCAGTACTTC	CASSPHAALRAYEQYF	TRBV7-3	TRBJ2-7
TGTGCCAGCAGAGAGTCGAAGGCCGAGCAGTACTTC	CASRESKAEQYF	TRBV28	TRBJ2-7
TGCAGTGCTAGAGGGTCTGTTTTTGAGAACACTGAAGCTTTCTTT	CSARGSVFENTEAFF	TRBV20-1	TRBJ1-1
TGCAGCGCGTGGGGGGGAGTCAATGAGCAGTTCTTC	CSAWGGVNEQFF	TRBV29-1	TRBJ2-1
TGTGCCAGCAGTTACTCCCGGGGACTAGCGGGGCCCCGTATTCCCTACAATGAGCAGTTCTTC	CASSYSRGLAGPRIPYNEQFF	TRBV6-5	TRBJ2-1
TGTGCCAGCAGCGATCAGACACCTCAGGGAAACGTAACTAATGAAAAACTGTTTTTT	CASSDQTPQGNVTNEKLFF	TRBV13	TRBJ1-4
TGTGCCAGCAGACCAGACAGAAAAGCCCGACCCTCTGGGGCCAACGTCCTGACTTTC	CASRPDRKARPSGANVLTF	TRBV6-8	TRBJ2-6
TGTGCCACCAGTGGCCAGGGGGCCGCGACAACCTATAATTCACCCCTCCACTTT	CATSGQGAATTYNSPLHF	TRBV24-1	TRBJ1-6
TGTGCCAGCAGCGTTCGGGCTAACTATGGCTACACCTTC	CASSVRANYGYTF	TRBV7-2	TRBJ1-2
TGTGCCAGCAGCGACAGGGGTGAGCGGACCCAGCATTTT	CASSDRGERTQHF	TRBV13	TRBJ1-5
TGTGCCAGCAGTTACCGAGACGGAACCGGGGAGCTGTTTTTT	CASSYRDGTGELFF	TRBV6-5	TRBJ2-2
TGTGCCAGCAGCCCGTGGACAGGGGTGGCCAATGGTTGCTATGGCTACACCTTC	CASSPWTGVANGCYGYTF	TRBV7-4	TRBJ1-2
TGTGCCAGCAGCGCGCAAAGGCCGGGACAACTCTTCTTT	CASSAQRPGQLFF	TRBV7-9	TRBJ1-1
TGCGCCAGCAGCCAAGATCCAGACAGGGGATGTGGCTACACCTTC	CASSQDPDRGCGYTF	TRBV4-1	TRBJ1-2
TGTGCCAGCAGTTTATGTTGGGACAGGGACGTCTCACCCCTCCACTTT	CASSLCWDRDVSPLHF	TRBV28	TRBJ1-6
TGTGCCAGCAGCGCGACTAGCGGGAGGGGGGAGTACAATGAGCAGTTCTTC	CASSATSGRGEYNEQFF	TRBV13	TRBJ2-1
TGTGCCAGCAGCTTATCGACAAAATATCAGCCCCAGCATTTT	CASSLSTKYQPQHF	TRBV11-2	TRBJ1-5
TGTGCCAGCAGCCGGGGGTGGGACTACGAGCAGTACTTC	CASSRGWDYEQYF	TRBV13	TRBJ2-7
TGTGCCAGCAGCTACATTCTAGCGTTAAACACCGGGGAGCTGTTTTTT	CASSYILALNTGELFF	TRBV7-8	TRBJ2-2
TGCAGTGCTAGAGATGGGAGGGGGGGAGATACGCAGTATTTT	CSARDGRGGDTQYF	TRBV20-1	TRBJ2-3
TGTGCCAGCACATCCCGGGACAGCCAGGGGACCCAGCATTTT	CASTSRDSQGTQHF	TRBV6-3	TRBJ1-5
TGTGCCAGCAGAGGGACAAGGACAGATACGCAGTATTTT	CASRGTRTDTQYF	TRBV6-4	TRBJ2-3
TGTGCCAGCAGCCCATCTCCTCGGACAGGTGATGAAAAACTGTTTTTT	CASSPSPRTGDEKLFF	TRBV4-2	TRBJ1-4
TGTGCCAGCAGTGAATCAGAAAAGACAGAGGCTCATGGCACAGATACGCAGTATTTT	CASSESEKTEAHGTDTQYF	TRBV25-1	TRBJ2-3
TGCGCCAGCAGCCAAGATACTCGCCCTTACGAGCAGTACTTC	CASSQDTRPYEQYF	TRBV4-1	TRBJ2-7
TGCGCCAGCAGCTTGGATATGTCAGTGCAAGAGCAGTACTTC	CASSLDMSVQEQYF	TRBV5-1	TRBJ2-7
TGTGCCAGCAGCGGACGAGAACGCAATCAGCCCCAGCATTTT	CASSGRERNQPQHF	TRBV13	TRBJ1-5
TGTGCCAGCAGCTACGAGAAGCGCTTT	CASSYEKRF	TRBV7-9	TRBJ1-1
TGTGCCAGCAGCCGACAGCAGATGAACACCGGGGAGCTGTTTTTT	CASSRQQMNTGELFF	TRBV14	TRBJ2-2
TGTGCCAGCAGCTTACTGAGAGGGCATGGCTACACCTTC	CASSLLRGHGYTF	TRBV7-3	TRBJ1-2
TGTGCCAGCAGCCAAGTGACCCAGGGACAGGGGGGCCAAGGTTCCTACGAGCAGTACTTC	CASSQVTQGQGGQGSYEQYF	TRBV14	TRBJ2-7
TGTGCCAGCAGTGTCGGGGCGGCTTGGGAGCTGTTTTTT	CASSVGAAWELFF	TRBV6-1	TRBJ2-2
TGTGCCCTAGTGTGGACGGGACAGGCCTTGTATGAGCAGTTCTTC	CALVWTGQALYEQFF	TRBV7-2	TRBJ2-1
TGCAGCGTTGAAGCCCGAGACAGGGTATTAACCGCCTACGAGCAGTACTTC	CSVEARDRVLTAYEQYF	TRBV29-1	TRBJ2-7
TGTGCCAGCAGCTGGAACCCCACTAGCGGCGGGGAGCTGTTTTTT	CASSWNPTSGGELFF	TRBV11-3	TRBJ2-2
TGTGCCAGCAGCTTTTCACAGGGGACTGGCTACACCTTC	CASSFSQGTGYTF	TRBV11-3	TRBJ1-2
TGCGCCAGCAGCCAAGATTTGGCGGGATGGAAAAACATTCAGTACTTC	CASSQDLAGWKNIQYF	TRBV4-1	TRBJ2-4
TGCGCCAGCAGCCAAGGCAAACACAGGGGACATAGCAATCAGCCCCAGCATTTT	CASSQGKHRGHSNQPQHF	TRBV4-1	TRBJ1-5
TGTGCCAGCAGAGGGAGAGGTAAAGATACGCAGTATTTT	CASRGRGKDTQYF	TRBV27	TRBJ2-3
TGTGCCAGCAGCACCGGCTCCATAAGGGAAGAGACCCAGTACTTC	CASSTGSIREETQYF	TRBV7-2	TRBJ2-5
TGTGCCAGCAGCATCCCGGGACGAGGCTATGGCTACACCTTC	CASSIPGRGYGYTF	TRBV13	TRBJ1-2
TGTGCCAGCAGACGCAGAATGAACACTGAAGCTTTCTTT	CASRRRMNTEAFF	TRBV9	TRBJ1-1
TGTGCCAGCAGCTTAAGGGGGACCGACACTGAAGCTTTCTTT	CASSLRGTDTEAFF	TRBV7-3	TRBJ1-1
TGTGCCAGCAGTTATTCAGGGGGCGGGGAACTGTTTTTT	CASSYSGGGELFF	TRBV6-5	TRBJ1-4
TGTGCCTGGGCAGCAGGGGCCTTCCTACATGGCTACACCTTC	CAWAAGAFLHGYTF	TRBV30	TRBJ1-2
TGCAGCGCCCAAGGCGAGTTCCCTAACTATGGCTACACCTTC	CSAQGEFPNYGYTF	TRBV29-1	TRBJ1-2
TGTGCTAGTGGTTTGGTGGACGGCGTTCGGGACTACGAGCAGTACTTC	CASGLVDGVRDYEQYF	TRBV12-5	TRBJ2-7
TGTGCCAGCAGTGCGCCGCGGGAGGCAAATAACTATGGCTACACCTTC	CASSAPREANNYGYTF	TRBV12-4	TRBJ1-2
TGTGCCAGTAAGGTCGACCGCTCACCCCTCCACTTT	CASKVDRSPLHF	TRBV19	TRBJ1-6
TGCAGCGTGCTTAACTATGGCTACACCTTC	CSVLNYGYTF	TRBV29-1	TRBJ1-2
TGCGCCAGCAGCTCGTTACAGGGAGATGGCTACACCTTC	CASSSLQGDGYTF	TRBV5-1	TRBJ1-2
TGTGCCAGCAGCTTAAAGGGGGACAGAGGCGAAGCTAATGAAAAACTGTTTTTT	CASSLKGDRGEANEKLFF	TRBV7-9	TRBJ1-4
TGCAGTGCTACCCTTTGGCCGGACGGAAATTCACCCCTCCACTTT	CSATLWPDGNSPLHF	TRBV20-1	TRBJ1-6
TGTGCCAGCAGTTACCCCTCCCCTAGCGGTCAGACCCAGTACTTC	CASSYPSPSGQTQYF	TRBV6-5	TRBJ2-5
TGCAGTGCTACCGGGGGCGGGAACACAACTAATGAAAAACTGTTTTTT	CSATGGGNTTNEKLFF	TRBV20-1	TRBJ1-4
TGTGCCAGCAGTTCGTGGGCCTTC	CASSSWAF	TRBV6-3	TRBJ1-2
TGCAGTGCTAGAGACCCCCCCAGCTACGAGCAGTACTTC	CSARDPPSYEQYF	TRBV20-1	TRBJ2-7
TGCAGCGTAGGTGCGCCCCAGGGGGGGCTGTTTTTT	CSVGAPQGGLFF	TRBV29-1	TRBJ2-2
TGTGCCAGCAGTTACGAACGGACAGGACGTGGCTACACCTTC	CASSYERTGRGYTF	TRBV6-5	TRBJ1-2
TGTGCCAGCAGCGGAGGGACGAAGACCTCTGGAAACACCATATATTTT	CASSGGTKTSGNTIYF	TRBV7-9	TRBJ1-3
TGTGCCAGCACCCCCTTACCGGGACAGGGTGATCACACCGGGGAGCTGTTTTTT	CASTPLPGQGDHTGELFF	TRBV6-4	TRBJ2-2
TGTGCCAGCTCGCCGGGACGGACTTACAATGAGCAGTTCTTC	CASSPGRTYNEQFF	TRBV28	TRBJ2-1
TGTGCCAGCAGCCTCCGGGGGAGTCCTCAGCCCCAGCATTTT	CASSLRGSPQPQHF	TRBV13	TRBJ1-5
TGTGAAGTATGGGGACAGGGGTGGGAAGATGGCTACACCTTC	CEVWGQGWEDGYTF	TRBV27	TRBJ1-2
TGTGCCAGCAGCATGCAATGGGAGGAGTGCACAGATACGCAGTATTTT	CASSMQWEECTDTQYF	TRBV13	TRBJ2-3
TGTGCCAGCAGTTACTCACTTTTTCCTTTCCGACGAGACTATGGCTACACCTTC	CASSYSLFPFRRDYGYTF	TRBV6-3	TRBJ1-2
TGTGCCACCAGCAGAGATCCAAATCCACAGGGGGAGCCCGAGCAGTACTTC	CATSRDPNPQGEPEQYF	TRBV15	TRBJ2-7
TGTGCCAGCAGGGAAGCGGTCGGGGTTGGTGGCTACACCTTC	CASREAVGVGGYTF	TRBV6-3	TRBJ1-2
TGTGCCAGCAGCAACCAGACAGGGGCCGGGGAAAAACTGTTTTTT	CASSNQTGAGEKLFF	TRBV11-3	TRBJ1-4
TGCGCCCGATCTAGCGGGCTTTATGAGCAGTTCTTC	CARSSGLYEQFF	TRBV20-1	TRBJ2-1
TGTGCCAGCAGCCCAGATACGGACAGCACTACCGAGCAGTACTTC	CASSPDTDSTTEQYF	TRBV14	TRBJ2-7
TGTGCCAGCAGCTCGAATCGTGGGGGGGTCTTGGAGCAGTTCTTC	CASSSNRGGVLEQFF	TRBV11-3	TRBJ2-1
TGCAGCGGAGTGGGGAACACTGAAGCTTTCTTT	CSGVGNTEAFF	TRBV29-1	TRBJ1-1
TGTGCCAGCAGTTACCAGTCTAGAAGGAGGGCATCCAGGCCTCGCGTGAACACTGAAGCTTTCTTT	CASSYQSRRRASRPRVNTEAFF	TRBV6-5	TRBJ1-1
TGTGCCAGCAGCTCTACAGGGTCCCCCTACGAGCAGTACTTC	CASSSTGSPYEQYF	TRBV5-4	TRBJ2-7
TGTGCCAGCAGCTTAGACAGAGAATGCGACTATAATTCACCCCTCCACTTT	CASSLDRECDYNSPLHF	TRBV7-2	TRBJ1-6
TGTGCTAGCCCCCCTGGGACTAGGAGACTAGCCCTAGAGACCCAGTACTTC	CASPPGTRRLALETQYF	TRBV7-7	TRBJ2-5
TGCGCCAGCCTGAGGCGAGTACGCCTAGCGGGAACAGGCTCCTACGAGCAGTACTTC	CASLRRVRLAGTGSYEQYF	TRBV10-1	TRBJ2-7
TGTGCCAGCAGTAAGGGGGGAGTATACCAAGAGACCCAGTACTTC	CASSKGGVYQETQYF	TRBV27	TRBJ2-5
TGTGCCAGCTCACCAACCTTTCCCAGCACAGGAACGAATCAGCCCCAGCATTTT	CASSPTFPSTGTNQPQHF	TRBV18	TRBJ1-5
TGTGCCAGCAGTTACTGGCAGGCCAGCCGCTCCTACGAGCAGTACTTC	CASSYWQASRSYEQYF	TRBV6-2	TRBJ2-7
TGTGCCAGCAGCGTGGCTTTCCCTCTAGAATTATCCTACAATGAGCAGTTCTTC	CASSVAFPLELSYNEQFF	TRBV13	TRBJ2-1
TGCAGTGCTAGTCTTATAATGCAGGTCTATGGCTACACCTTC	CSASLIMQVYGYTF	TRBV20-1	TRBJ1-2
TGTGCCAGCAGTTTATCCGGGACTAGCGGGATCACAGATACGCAGTATTTT	CASSLSGTSGITDTQYF	TRBV27	TRBJ2-3
TGTGCCAGCCCCAAATCGACAGGGCCCGAACAGGATGGCTACACCTTC	CASPKSTGPEQDGYTF	TRBV7-3	TRBJ1-2
TGTGCCAGCAGTTTATCGCTCGGCGAGCTGTTTTTT	CASSLSLGELFF	TRBV28	TRBJ1-4
TGTGCCAGTAGCCACCAAAACGTTCCGGGACTAGCGGGAGGGACCAATGAGCAGTTCTTC	CASSHQNVPGLAGGTNEQFF	TRBV19	TRBJ2-1
TGCGCCAGCAGCTTGGCGTGCAACGAGACTGACGGGGAGCTGTTTTTT	CASSLACNETDGELFF	TRBV5-1	TRBJ2-2
TGTGCCACCGCCTCCTGGGCCGATTACTCTGGGGCCAACGTCCTGACTTTC	CATASWADYSGANVLTF	TRBV24-1	TRBJ2-6
TGTGCCAGTAATGGGGAGGAAAGCACAGATACGCAGTATTTT	CASNGEESTDTQYF	TRBV19	TRBJ2-3
TGTGCCAGTCTGTGCAGGGGGCGGCCCGGCTACACCTTC	CASLCRGRPGYTF	TRBV2	TRBJ1-2
TGCGCCAGCAGCTTGAAAACCAGACTAAGGTACGTAAGCAATCAGCCCCAGCATTTT	CASSLKTRLRYVSNQPQHF	TRBV5-1	TRBJ1-5
TGTGCCAGCAGTTACTCCTGTCCGAGACAAGGGAGGACTGAAGCTTTCTTT	CASSYSCPRQGRTEAFF	TRBV6-2	TRBJ1-1
TGTGCCAGCTCAGCTCACGTGATGGGAGGAAGCCCCAAAAACATTCAGTACTTC	CASSAHVMGGSPKNIQYF	TRBV18	TRBJ2-4
TGCAGGGTCCAGGGGAAGGTTGGCTACACCTTC	CRVQGKVGYTF	TRBV20-1	TRBJ1-2
TGTGCCAGCAGGGGACATTTTACCGGGGAGCTGTTTTTT	CASRGHFTGELFF	TRBV28	TRBJ2-2
TGTGCCAGCAGCGTACCCCCAACGACAGGGCGAGCCTACGAGCAGTACTTC	CASSVPPTTGRAYEQYF	TRBV9	TRBJ2-7
TGTGCCAGCAGCCGGGGGGCCTACGAGCAGTACTTC	CASSRGAYEQYF	TRBV7-8	TRBJ2-7
TGTGCCAGCAGTTTAGGTACTCGCACTGAAGCTTTCTTT	CASSLGTRTEAFF	TRBV27	TRBJ1-1
TGTGCCAGCAGCCAAGCTACCTTAGGGGGGGGGCCCGAGCAGGGCACAGATACGCAGTATTTT	CASSQATLGGGPEQGTDTQYF	TRBV4-2	TRBJ2-3
TGCAGTGGTACCTCGGGGGGGCGCTACGAGCAGTACTTC	CSGTSGGRYEQYF	TRBV20-1	TRBJ2-7
TGCGCCAGCAGCCACCGAAGCAGGGAACAGTACTTC	CASSHRSREQYF	TRBV5-1	TRBJ2-4
TGCGCCAGCAGCCAAGAGCCAGCAGGGGGGCCGACGACGAAAGAGCAGTTCTTC	CASSQEPAGGPTTKEQFF	TRBV4-1	TRBJ2-1
TGTGCCAGCAGTGCTAGGACGTCACCCCTCCACTTT	CASSARTSPLHF	TRBV25-1	TRBJ1-6
TGTGCCAGCAGCCAATGGGACAGCTCCTACGAGCAGTACTTC	CASSQWDSSYEQYF	TRBV3-1	TRBJ2-7
TGTGCCAGCAAAACACACTATGGCTACACCTTC	CASKTHYGYTF	TRBV12-3	TRBJ1-2
TGTGCCAGCAGGGTGAGCCGAACCCACTTAAGCTATGGCTACACCTTC	CASRVSRTHLSYGYTF	TRBV11-2	TRBJ1-2
TGTGGGTATACCGATGAGCAGTTCTTC	CGYTDEQFF	TRBV7-9	TRBJ2-1
TGTGCCAGCAGTAGGGTGGACAGGGAGAGGTCAGAGACCCAGTACTTC	CASSRVDRERSETQYF	TRBV6-5	TRBJ2-5
TGTGCCAGCAGTTACGATCCGCACCAGGGCGAGCAGTACTTC	CASSYDPHQGEQYF	TRBV6-5	TRBJ2-7
TGCGCCAGCAGCTTGGGTTGGGAGGATAAATGCAATCAGCCCCAGCATTTT	CASSLGWEDKCNQPQHF	TRBV5-1	TRBJ1-5
TGCAGTGCAACTGAAGGGCAGAGTGGCTACACCTTC	CSATEGQSGYTF	TRBV20-1	TRBJ1-2
TGTGCCAGCAGCTTGTTCTTACTGGACAGTAGTTCACCCCTCCACTTT	CASSLFLLDSSSPLHF	TRBV5-6	TRBJ1-6
TGTGCCAGCTCACCACAATGGACAGAGACCCAGTACTTC	CASSPQWTETQYF	TRBV18	TRBJ2-5
TGTGCCATCAGAAAACGGAAAGAGACCCAGTACTTC	CAIRKRKETQYF	TRBV10-3	TRBJ2-5
TGCGCCAGCTTTCAGGGAGGGCGGAACACTGAAGCTTTCTTT	CASFQGGRNTEAFF	TRBV5-1	TRBJ1-1
TGCGCCAGCAGCCAAGCGGTACCGGGGGTTACGGAGGCGCCTAGGTCCTATAATTCACCCCTCCACTTT	CASSQAVPGVTEAPRSYNSPLHF	TRBV4-3	TRBJ1-6
TGCGCCAGCAGCTTGCCAGGCGGGTCCTACGAGCAGTACTTC	CASSLPGGSYEQYF	TRBV5-1	TRBJ2-7
TGCAGTGCGTCGGAGGACAGGGACAAGCAGTACTTC	CSASEDRDKQYF	TRBV20-1	TRBJ2-7
TGTGCCTGGAGTGTATCATCCATAGCGGGTTTAGAGACCCAGTACTTC	CAWSVSSIAGLETQYF	TRBV30	TRBJ2-5
TGTGCCAGCAGCTGGCATCGGGCAGAGACCCAGTACTTC	CASSWHRAETQYF	TRBV5-6	TRBJ2-5
TGTGCCACCAGTGATAGGGCTCCCATCCTCGGACAGGTCCGCTCTGGAAACACCATATATTTT	CATSDRAPILGQVRSGNTIYF	TRBV24-1	TRBJ1-3
TGTGCCAGCTACCGGGACAGAACCCGCTACGAGCAGTACTTC	CASYRDRTRYEQYF	TRBV5-6	TRBJ2-7
TGTGCCAGTAGGAAGAGGGGGCAAGAGACCCAGTACTTC	CASRKRGQETQYF	TRBV19	TRBJ2-5
TGTGCCAGCAGTGGTCATAGCGGGGAAGCCTACGAGCAGTACTTC	CASSGHSGEAYEQYF	TRBV2	TRBJ2-7
TGCGCCAGCAGCCCACTAAAGGAGACGGGGTTAGGAAACTATGGCTACACCTTC	CASSPLKETGLGNYGYTF	TRBV4-3	TRBJ1-2
TGTGCCAGCAGTTTGGTACCGGGGACAGGGTCCTATCTCTATGGCTACACCTTC	CASSLVPGTGSYLYGYTF	TRBV27	TRBJ1-2
TGTGCCACCATTTGTCGGGACAACGACTACAATGAGCAGTTCTTC	CATICRDNDYNEQFF	TRBV24-1	TRBJ2-1
TGTGCCAGCAGTTTAACTGGAAGAGGCTACTACGAGCAGTACTTC	CASSLTGRGYYEQYF	TRBV27	TRBJ2-7
TGTGCCAGCAGCTGCCGGTCCTCCGAGCAGTACTTC	CASSCRSSEQYF	TRBV7-6	TRBJ2-7
TGTGCCAGCCCCTATACGCAGACGGAGCAGTTCTTC	CASPYTQTEQFF	TRBV6-1	TRBJ2-1
TGTGCCAGCCACTACACTGAAGCTTTCTTT	CASHYTEAFF	TRBV6-5	TRBJ1-1
TGTGCCAGTTCGGGACAGTCGGCTGGAAACACCATATATTTT	CASSGQSAGNTIYF	TRBV27	TRBJ1-3
TGTGCCAGTACAGGGACCAATGAGCAGTTCTTC	CASTGTNEQFF	TRBV19	TRBJ2-1
TGTGCCAGCAGCTTAGCGATAAGGGGGAACACTGAAGCTTTCTTT	CASSLAIRGNTEAFF	TRBV7-8	TRBJ1-1
TGCGCCAGCAGCTTGGCCAGGGGGCTAGATAGCAATCAGCCCCAGCATTTT	CASSLARGLDSNQPQHF	TRBV5-1	TRBJ1-5
TGTGCCAGTAGTATAGCGGAAAGACAGGGGGCGCTAAGTCACACTGAAGCTTTCTTT	CASSIAERQGALSHTEAFF	TRBV19	TRBJ1-1
TGTGCCAGCAGTAGGGGGGTTCGTAAAGAACGCTATGGCTACACCTTC	CASSRGVRKERYGYTF	TRBV6-1	TRBJ1-2
TGTGCCAGCAGTGACAGGGACAGGGGGGAAAAACTGTTTTTT	CASSDRDRGEKLFF	TRBV6-4	TRBJ1-4
TGCGCCAGCAGCCAAGACCCCGTTAGCGGGCTAGAGACCCAGTACTTC	CASSQDPVSGLETQYF	TRBV4-1	TRBJ2-5
TGTGCCAGCTCCAGACCACACCCGGACACTGAAGCTTTCTTT	CASSRPHPDTEAFF	TRBV18	TRBJ1-1
TGTGCCATGGGACCGACGGCGGCAGCGGGGGGCTCCTACGAGCAGTACTTC	CAMGPTAAAGGSYEQYF	TRBV10-3	TRBJ2-7
TGTGCCAGCAGCTTAGCCAAGGACCGCTACCGGACTAGCGGGGGCGAGCAGTACTTC	CASSLAKDRYRTSGGEQYF	TRBV7-4	TRBJ2-7
TGTGCCAGCAGCCAAGAAGCCGGACCTTACCATTCGGGGGGGCCCTACGAGCAGTACTTC	CASSQEAGPYHSGGPYEQYF	TRBV14	TRBJ2-7
TGTGCCAGTAAAACCGGGGGGGGCTACACCGGGGAGCTGTTTTTT	CASKTGGGYTGELFF	TRBV19	TRBJ2-2
TGCAGATGGGGTCCATCCTACGAGCAGTACTTC	CRWGPSYEQYF	TRBV20-1	TRBJ2-7
TGTGCCAGCAGCAGCAACCTCGGTCTAGCGGGAGGCAATGAGCAGTTCTTC	CASSSNLGLAGGNEQFF	TRBV5-6	TRBJ2-1
TGTGCCAGCAGGTTACAAAACGGGACAGGGTTAAACGAGCAGTACTTC	CASRLQNGTGLNEQYF	TRBV6-1	TRBJ2-7
TGCGCCAGCGAGATATGGGCTTGGAACACTGAAGCTTTCTTT	CASEIWAWNTEAFF	TRBV10-1	TRBJ1-1
TGTGCCAGCAGCTTATCTAGAACAACCAGGACAGAAGGTAGAGCAGATACGCAGTATTTT	CASSLSRTTRTEGRADTQYF	TRBV11-1	TRBJ2-3
TGTGCCAGCAGTGACTCACATAGGGACAGGGTGTACCTTGAGACCCAGTACTTC	CASSDSHRDRVYLETQYF	TRBV6-4	TRBJ2-5
TGTGCCAGCAGTGAACGGGGGCAACCCTTC	CASSERGQPF	TRBV6-4	TRBJ1-2
TGTGCCAGCATAACCCCTAAGGGCAAAAACATTCAGTACTTC	CASITPKGKNIQYF	TRBV2	TRBJ2-4
TGTGCGCGGACAGGGTCTTGTCAGCCCCAGCATTTT	CARTGSCQPQHF	TRBV28	TRBJ1-5
TGTGCCTGGACCCAAGGGGGAAACACCATATATTTT	CAWTQGGNTIYF	TRBV30	TRBJ1-3
TGTGCCAGCACCCGGACAAACTTC	CASTRTNF	TRBV2	TRBJ2-5
TGTGCCATCATCCCGATATGGGGGAAGAAACGAGGCTACGAGCAGTACTTC	CAIIPIWGKKRGYEQYF	TRBV10-3	TRBJ2-7
TGCGCCAGCAGTGATAGACAGGGCCGTCTGGAGCAGTACTTC	CASSDRQGRLEQYF	TRBV10-1	TRBJ2-7
TGTGCCAGCAGCCCACCCTGGCCCCCGGGACAGGGCCGTGAGACCCAGTACTTC	CASSPPWPPGQGRETQYF	TRBV7-3	TRBJ2-5
TGTGCCAGCGGTCCCCGCGGGTCCCGGTTCTACAATGAGCAGTTCTTC	CASGPRGSRFYNEQFF	TRBV14	TRBJ2-1
TGTGCCAGCAACAGGGTGCCGGGAGGGCCCCAGCATTTT	CASNRVPGGPQHF	TRBV25-1	TRBJ1-5
TGTGCCAGCAGCCAAGATTATTTGGGGCGCACCTGGGATACGCAGTATTTT	CASSQDYLGRTWDTQYF	TRBV14	TRBJ2-3
TGTGCCAGCGGGGGACCGGCTGGGGCCAACGTCCTGACTTTC	CASGGPAGANVLTF	TRBV6-2	TRBJ2-6
TGTGCCAGCAGCAGACTTCCGGGACTAGTAGACTCTGGGGCCAACGTCCTGACTTTC	CASSRLPGLVDSGANVLTF	TRBV13	TRBJ2-6
TGTGCCAGCACTTGTAGACAGGGGATTATACGGGGCGAGCAGTACTTC	CASTCRQGIIRGEQYF	TRBV6-3	TRBJ2-7
TGTGCCACCAGTGATTTGGGGAGGGGGCCCGACACTGAAGCTTTCTTT	CATSDLGRGPDTEAFF	TRBV24-1	TRBJ1-1
TGTGCCAGCAGTTACATCATCCGACAGGGGGCGGAGCAGTACTTC	CASSYIIRQGAEQYF	TRBV6-3	TRBJ2-7
TGTGCCAGCAGTGACTCACTAACAGGTGACCCTACCTATGGCTACACCTTC	CASSDSLTGDPTYGYTF	TRBV6-4	TRBJ1-2
TGTGCCAGCAGTTCGGGGGGGCGCGGGGAGCTGTTTTTT	CASSSGGRGELFF	TRBV27	TRBJ2-2
TGCAGTGCTCGGGCCCTTTCTTACGAGCAGTACTTC	CSARALSYEQYF	TRBV20-1	TRBJ2-7
TGTGCCAGCAGTTCCAATCTAGCGGGGCAGGTTTCGAGCTCCTACAATGAGCAGTTCTTC	CASSSNLAGQVSSSYNEQFF	TRBV27	TRBJ2-1
TGTGCCAGCAAGTGTTCGGGACTAGGGAGCTCCTACGAGCAGTACTTC	CASKCSGLGSSYEQYF	TRBV7-2	TRBJ2-7
TGCGCCAGCAGCCAAGCGAAACCGACAGAAGGGAATGAAAAACTGTTTTTT	CASSQAKPTEGNEKLFF	TRBV4-3	TRBJ1-4
TGCAGTGCCCGCGGGAGACCCTACGAGCAGTACTTC	CSARGRPYEQYF	TRBV20-1	TRBJ2-7
TGTGCCAGCAGTTTCGCGGATCATACCTACGAGCAGTACTTC	CASSFADHTYEQYF	TRBV27	TRBJ2-7
TGTGCCTGGAGTGTACGAGCCAGGGGGGTGAACAGGGCCTACGAGCAGTACTTC	CAWSVRARGVNRAYEQYF	TRBV30	TRBJ2-7
TGTGCCATCTGGTTTCCTGGGGGAGCAAAAGGGGGTAACTATGGCTACACCTTC	CAIWFPGGAKGGNYGYTF	TRBV10-3	TRBJ1-2
TGTGCCAGCAGCTTGGTACTAGCGGCTACGAGCTCCTACAATGAGCAGTTCTTC	CASSLVLAATSSYNEQFF	TRBV7-6	TRBJ2-1
TGCGCCAGCAGCATTCTCCGGGCGGGGGGTAACTATGGCTACACCTTC	CASSILRAGGNYGYTF	TRBV5-1	TRBJ1-2
TGTGCCAGCTATCCCGGGACAGAAACCGTACCAAGCTCCTACGAGCAGTACTTC	CASYPGTETVPSSYEQYF	TRBV18	TRBJ2-7
TGTGCCAGCAGCCAGCCGACGCGCTACGAGCAGTACTTC	CASSQPTRYEQYF	TRBV4-2	TRBJ2-7
TGCGCCAGCATAATAGACCATTTTACGCAGTATTTT	CASIIDHFTQYF	TRBV10-1	TRBJ2-3
TGTGCCGACAAACCCCCGGGACTAGGAGCGAACACCGGGGAGCTGTTTTTT	CADKPPGLGANTGELFF	TRBV3-1	TRBJ2-2
TGTGCCAGCAGCTGGGCCGAGTATAGCAATCAGCCCCAGCATTTT	CASSWAEYSNQPQHF	TRBV5-8	TRBJ1-5
TGTGCCAGCAGCCACCGGTCAAATAGCAATCAGCCCCAGCATTTT	CASSHRSNSNQPQHF	TRBV3-1	TRBJ1-5
TGTGCCAGCAGTTACACTTACATTGCGGAGAGCTCCTACGAGCAGTACTTC	CASSYTYIAESSYEQYF	TRBV6-5	TRBJ2-7
TGTGCTATGGGACTAGCCCAAGAGACCCAGTACTTC	CAMGLAQETQYF	TRBV7-9	TRBJ2-5
TGTGCCAGCATGCCCAAAGAGCAGTACTTC	CASMPKEQYF	TRBV28	TRBJ2-7
TGTGCCAGCAGTCGACCCAGGGGCGAACGGAAGAACACTGAAGCTTTCTTT	CASSRPRGERKNTEAFF	TRBV28	TRBJ1-1
TGTGCCTGGAAAATTCCGAGAGGGCAGACAGATACGCAGTATTTT	CAWKIPRGQTDTQYF	TRBV30	TRBJ2-3
TGTGCCAGCAGTGACCGGGGACAGGGGGCCCTCCACTTT	CASSDRGQGALHF	TRBV25-1	TRBJ1-6
TGTGCCAGCAGCCGTGGGGGGAGCACAGATACGCAGTATTTT	CASSRGGSTDTQYF	TRBV7-2	TRBJ2-3
TGTGCCAGCAGTGGGGACGGGGGGTACGAGCAGTACTTC	CASSGDGGYEQYF	TRBV6-1	TRBJ2-7
TGTGCCAGCACCGGGCTCCGGGACAGGCGGAGCTCGCACTCTGGAAACACCATATATTTT	CASTGLRDRRSSHSGNTIYF	TRBV7-8	TRBJ1-3
TGTGCCAGCAGCTTGCCAGCGATTACGCAGTATTTT	CASSLPAITQYF	TRBV5-4	TRBJ2-3
TGTGCCAGCAGCCCGGACCGCTACGAGCAGTACTTC	CASSPDRYEQYF	TRBV6-6	TRBJ2-7
TGTGCCAGCAGCTTAAGCCGGGGTGCTGAGACCCAGTACTTC	CASSLSRGAETQYF	TRBV7-8	TRBJ2-5
TGCAGAAAGAGTCCAGGATTCTACGAGCAGTACTTC	CRKSPGFYEQYF	TRBV20-1	TRBJ2-7
TGCAGCGTCCCCTACCCGGGGAGTAGTTGCGAGCAGTACTTC	CSVPYPGSSCEQYF	TRBV29-1	TRBJ2-7
TGTGCCAGCCTCCGGTCCTACTCCTACGAGCAGTACTTC	CASLRSYSYEQYF	TRBV6-6	TRBJ2-7
TGTGCCAGCAGTTTATCCCTGCTGGGACTAGCGGGTGAGCAGTTCTTC	CASSLSLLGLAGEQFF	TRBV28	TRBJ2-1
TGTGCCAGCAGCTTAGTTACCATGGACAGCTCTCAGCCCCAGCATTTT	CASSLVTMDSSQPQHF	TRBV7-2	TRBJ1-5
TGTGCCAGCAGTACTTTGATAACAGGCTCCCCAATTAACGAGCAGTACTTC	CASSTLITGSPINEQYF	TRBV5-5	TRBJ2-7
TGTGCCAGATCGATACGATGGGAGAGCTCCTACGAGCAGTACTTC	CARSIRWESSYEQYF	TRBV27	TRBJ2-7
TGCAGTGCTAGAGATACGCTGACAGGGGCCGGGCCCGGCTCCTACGAGCAGTACTTC	CSARDTLTGAGPGSYEQYF	TRBV20-1	TRBJ2-7
TGTGCCAGCAGCTTTAGGTTGGGGGGGATACGTACAGATACGCAGTATTTT	CASSFRLGGIRTDTQYF	TRBV5-4	TRBJ2-3
TGTGCCAGCAGCGTCAACACTAGCGGGAGTTGGGTTGCTTCCTACACTGAAGCTTTCTTT	CASSVNTSGSWVASYTEAFF	TRBV9	TRBJ1-1
TGTGCCAGCGAACTAGTCGGTAGCTCCTACGAGCAGTACTTC	CASELVGSSYEQYF	TRBV7-2	TRBJ2-7
TGTGCCAGCAGCTTCAATAGGGGCGGGGACACTGAAGCTTTCTTT	CASSFNRGGDTEAFF	TRBV5-5	TRBJ1-1
TGCGCCAGCCGCCGGGACACGGGTCCCTACGAGCAGTACTTC	CASRRDTGPYEQYF	TRBV10-1	TRBJ2-7
TGTGCCAGCAAGTGGGGAATCTACGAGCAGTACTTC	CASKWGIYEQYF	TRBV2	TRBJ2-7
TGTGCCAGCAGCGAGGACTCCTACGAGCAGTACTTC	CASSEDSYEQYF	TRBV13	TRBJ2-7
TGCGCCAGCAGCCTAGTGGGGGTAGACTATGGCTACACCTTC	CASSLVGVDYGYTF	TRBV10-1	TRBJ1-2
TGTGCCAGCAGGGCCCTTCTGGGAGAACGGGACAGGGGGAGGGACTATGGCTACACCTTC	CASRALLGERDRGRDYGYTF	TRBV28	TRBJ1-2
TGCGCCAGCAGCTCACTAGCGCGGAGCTCCTACAATGAGCAGTTCTTC	CASSSLARSSYNEQFF	TRBV5-1	TRBJ2-1
TGTGCCACCAGCAGAGATGATAAGGGGGCAGAATCGAAGGCCCAGTACTTC	CATSRDDKGAESKAQYF	TRBV15	TRBJ2-5
TGTGCCAGCAGCTTAGGGACAGGCCCGCCCCAGCATTTT	CASSLGTGPPQHF	TRBV7-6	TRBJ1-5
TGTGCCAGCTTCCGGACAGGGCCAGAGTGCGGGGAGCTGTTTTTT	CASFRTGPECGELFF	TRBV6-1	TRBJ2-2
TGTGCCAGCCGCCTTAGCGGGTGTCCGAACACCGGGGAGCTGTTTTTT	CASRLSGCPNTGELFF	TRBV6-4	TRBJ2-2
TGCAGTGCCTACCGGGGCACAGATACGCAGTATTTT	CSAYRGTDTQYF	TRBV20-1	TRBJ2-3
TGTGCCAGCAGCTTACTGGGGGACGAGCACCACCAAACTGAGCAGTTCTTC	CASSLLGDEHHQTEQFF	TRBV7-9	TRBJ2-1
TGTGAAGAGGGCCAGGGACTAGCGGGGTCCCGTAGGCAGTACTTC	CEEGQGLAGSRRQYF	TRBV25-1	TRBJ2-7
TGCAGTGCTAGAGGGGATGGGGGGGTTGAAGCTTTCTTT	CSARGDGGVEAFF	TRBV20-1	TRBJ1-1
TGTGCCAGTACTTTGCCCGACCAGGGGCCTGAGTGTTATAGCAATCAGCCCCAGCATTTT	CASTLPDQGPECYSNQPQHF	TRBV19	TRBJ1-5
TGTGCCACCAGCAGCGAAGAGACCCAGTACTTC	CATSSEETQYF	TRBV24-1	TRBJ2-5
TGCGCCAGCAGTGAGTCGGTTCCCCAGCCAGTTTCAAACACCATATATTTT	CASSESVPQPVSNTIYF	TRBV10-1	TRBJ1-3
TGTGCCAGCAGCCCCCCAGGTCACACTGAAGCTTTCTTT	CASSPPGHTEAFF	TRBV13	TRBJ1-1
TGTGCCAGCAGCGAGCGACAGGGCATGAACACTGAAGCTTTCTTT	CASSERQGMNTEAFF	TRBV7-2	TRBJ1-1
TGCAGTGCTAGAGGGGGGGGGCCCGCCCCCTACGAGCAGTACTTC	CSARGGGPAPYEQYF	TRBV20-1	TRBJ2-7
TGCAGTCGTAAGACGGGAGGGATTAATTCACCCCTCCACTTT	CSRKTGGINSPLHF	TRBV20-1	TRBJ1-6
TGCGCCAGCAGCTTGGCGTCGAGGACAGAGTGTTGGTCACCCCTCCACTTT	CASSLASRTECWSPLHF	TRBV5-1	TRBJ1-6
TGTGCCAGCAGTTTAGCATCGCCTAGAGGAAACAATGAGCAGTTCTTC	CASSLASPRGNNEQFF	TRBV28	TRBJ2-1
TGTGCCACCAGTGACACACAGGGTCCCGGACCGGGAGGCTACACCTTC	CATSDTQGPGPGGYTF	TRBV24-1	TRBJ1-2
TGTGCCAGCAGTTGCAGGAATATGAACACTGAAGCTTTCTTT	CASSCRNMNTEAFF	TRBV12-4	TRBJ1-1
TGTGCCCCCCCCGGGACTAGCGGGCCCTACGAGCAGTACTTC	CAPPGTSGPYEQYF	TRBV7-2	TRBJ2-7
TGTGCCAGCAGTGACGGTCGGCGAGGGTTGTGTCAGCCCCAGCATTTT	CASSDGRRGLCQPQHF	TRBV6-4	TRBJ1-5
TGTGCCAGCAGCTTCCGACAGGGTGAGACGAACGTCTACGAGCAGTACTTC	CASSFRQGETNVYEQYF	TRBV7-9	TRBJ2-7
TGTGCCAGCTCCGGGACAGGGGGCCCAGGTAGGTCCTACAATGAGCAGTTCTTC	CASSGTGGPGRSYNEQFF	TRBV12-3	TRBJ2-1
TGTGCCAGCATGACAGGGGGGGTCTATGGCTACACCTTC	CASMTGGVYGYTF	TRBV6-3	TRBJ1-2
TGTGCCAGTAGTGAGGTCGGGACAGCTTGTTCGAACACTGAAGCTTTCTTT	CASSEVGTACSNTEAFF	TRBV19	TRBJ1-1
TGTGCCACCAGAATTTCCCGAAATGTCCGGGTGCAGGGGGGTTCTGGAAACACCATATATTTT	CATRISRNVRVQGGSGNTIYF	TRBV24-1	TRBJ1-3
TGTGCCACCAGTGATTTTGAGTCACGACAGGGGGCGGATGAGCAGTTCTTC	CATSDFESRQGADEQFF	TRBV24-1	TRBJ2-1
TGTGCCAGCAGCCGGAGGGGGGCCAATGAGCAGTTCTTC	CASSRRGANEQFF	TRBV14	TRBJ2-1
TGTGCCAGCAGTGACGGGACAGGTGGCTACACCTTC	CASSDGTGGYTF	TRBV6-4	TRBJ1-2
TGTGCCAGCAGTTTATATGGACTAGCGGGCCCGGGGCCAGATACGCAGTATTTT	CASSLYGLAGPGPDTQYF	TRBV27	TRBJ2-3
TGTGCCAGCTATCTCCAGGGAGATAAAACAGATACGCAGTATTTT	CASYLQGDKTDTQYF	TRBV6-3	TRBJ2-3
TGTGCCAGCAGTTACTCGGTCCGAAGCGACAAATATGAGCAGTTCTTC	CASSYSVRSDKYEQFF	TRBV6-2	TRBJ2-1
TGCGCCAGCAGCCGATCACAGGGGGCCCACACTGAAGCTTTCTTT	CASSRSQGAHTEAFF	TRBV4-1	TRBJ1-1
TGTGCCAGCACGCGGGACGGGGGACTAGGGGAGCTGTTTTTT	CASTRDGGLGELFF	TRBV6-2	TRBJ2-2
TGTGCCAGCAGCAGAGTTGGTCAGGGGGGCTACGAGCAGTACTTC	CASSRVGQGGYEQYF	TRBV12-3	TRBJ2-7
TGCGCCAGGGGAGGACGTGATACGCAGTATTTT	CARGGRDTQYF	TRBV5-1	TRBJ2-3
TGTGCCAGCAGTGCGCAGTTGTATAGCGGGAGGAACCGCTCCTACAATGAGCAGTTCTTC	CASSAQLYSGRNRSYNEQFF	TRBV6-5	TRBJ2-1
TGTGCCAGCGGACAGATGGGCACTGAAGCTTTCTTT	CASGQMGTEAFF	TRBV9	TRBJ1-1
TGTGCCAGCAGAGCCGGGAGCTACGAGCAGTACTTC	CASRAGSYEQYF	TRBV2	TRBJ2-7
TGTGCCACCAGTGATTTGGAAGAGCTGGGACTAGTATTGGGACCCCTGAGCACAGATACGCAGTATTTT	CATSDLEELGLVLGPLSTDTQYF	TRBV24-1	TRBJ2-3
TGTGCCAGCAGTGAAGGCGAAGGGGGCCAGAGCCCCTACGAGCAGTACTTC	CASSEGEGGQSPYEQYF	TRBV6-1	TRBJ2-7
TGCGCCAGCAACCGCCCTGGGGGGGACGGTGAGCAGTTCTTC	CASNRPGGDGEQFF	TRBV5-1	TRBJ2-1
TGCGCCAGCAGCTTGCCGCCGGGGACGTTAGGGGGGGGTGCGGACACTGAAGCTTTCTTT	CASSLPPGTLGGGADTEAFF	TRBV5-1	TRBJ1-1
TGTGGTTTAAGAGGGAGTACCTATAATTCACCCCTCCACTTT	CGLRGSTYNSPLHF	TRBV27	TRBJ1-6
TGCGCCAGCAGCTCACAACTGACTAGCGGCACCGGGGAGCTGTTTTTT	CASSSQLTSGTGELFF	TRBV5-1	TRBJ2-2
TGTGCCAGCAGTTTAGGACAGGGGGCGAGGTACAATGAGCAGTTCTTC	CASSLGQGARYNEQFF	TRBV27	TRBJ2-1
TGTGCCATCAGTATGATCTACGACGGAAACATTCAGTACTTC	CAISMIYDGNIQYF	TRBV10-3	TRBJ2-4
TGTGCCAGCGCCAGAACTAACTATGGCTACACCTTC	CASARTNYGYTF	TRBV6-5	TRBJ1-2
TGTGCCAGCAGCCCAAACTCAGGGGGCACGGGCCCCTCTGCAACTAATGAAAAACTGTTTTTT	CASSPNSGGTGPSATNEKLFF	TRBV7-2	TRBJ1-4
TGCGCCAGCAGTGCGGGACAGGGAAGGCCCCAGCATTTT	CASSAGQGRPQHF	TRBV10-1	TRBJ1-5
TGTGCCAGCAGCCAAAGGCGTGTGGGAGAGACCCAGTACTTC	CASSQRRVGETQYF	TRBV3-1	TRBJ2-5
TGTGCCAGCAGCCACCAGTTCACCAAGTCCTGCAATCAGCCCCAGCATTTT	CASSHQFTKSCNQPQHF	TRBV3-1	TRBJ1-5
TGTGCCAGCAGCAGGGGACTAGTCACAGATACGCAGTATTTT	CASSRGLVTDTQYF	TRBV5-6	TRBJ2-3
TGTGCCAGCAGCGGTCGACCAGCGAACACCGGGGAGCTGTTTTTT	CASSGRPANTGELFF	TRBV9	TRBJ2-2
TGTGCCAGCAGCCCCCTCCCTGCAGGGGCGTGCGAGCAGTACTTC	CASSPLPAGACEQYF	TRBV13	TRBJ2-7
TGTGCCAGCAGTGACACTAGGGGGGTCCCCTACGAGCAGTACTTC	CASSDTRGVPYEQYF	TRBV6-4	TRBJ2-7
TGTGCTTATGTGCAGCTTAAAGGTTCACCCCTCCACTTT	CAYVQLKGSPLHF	TRBV12-5	TRBJ1-6
TGTGCCCCCGGGGATGCCTACGAGCAGTACTTC	CAPGDAYEQYF	TRBV2	TRBJ2-7
TGTGCCTGGAGACCGAGGAATCAGCCCCAGCATTTT	CAWRPRNQPQHF	TRBV30	TRBJ1-5
TGCAGTGCTAGAGTCCCCATGAGGGGGGCCTTGAACACTGAAGCTTTCTTT	CSARVPMRGALNTEAFF	TRBV20-1	TRBJ1-1
TGCAGTGCTAGAGATCACCTGCAAAGGACTAGCGGAAATAGGTGGGAAGAGACCCAGTACTTC	CSARDHLQRTSGNRWEETQYF	TRBV20-1	TRBJ2-5
TGTGCCAGCAAGGGTCCAGATTCTCCGTACGAGCAGTACTTC	CASKGPDSPYEQYF	TRBV6-5	TRBJ2-7
TGTGCCACCAGTGATTATCGGGACAGGGCTGGGGCCAACGTCCTGACTTTC	CATSDYRDRAGANVLTF	TRBV24-1	TRBJ2-6
TGTGCCAGAGGGGGCCGGGCCTACGAGCAGTACTTC	CARGGRAYEQYF	TRBV28	TRBJ2-7
TGTGCCAGCGATGATCGGGGGGGGGGAATTACGCAGTATTTT	CASDDRGGGITQYF	TRBV6-1	TRBJ2-3
TGTGCCAGCAGCTTAGGCCACTGTAGAGACTCGTCCTACGAGCAGTACTTC	CASSLGHCRDSSYEQYF	TRBV7-9	TRBJ2-7
TGCAGTGCTAGAGATCAGACAGGGGGGGCCAACGTCCTGACTTTC	CSARDQTGGANVLTF	TRBV20-1	TRBJ2-6
TGTGCCAGCAGAAGAGGGGGTTTATGGAACACTGAAGCTTTCTTT	CASRRGGLWNTEAFF	TRBV6-5	TRBJ1-1
TGCGCCAGCAGCTTCCCCCGGGGCACCATTCAGCCCCAGCATTTT	CASSFPRGTIQPQHF	TRBV5-1	TRBJ1-5
TGTGCCAGCAGCTACCAGGGCGACCTCAGCTCCTACGAGCAGTACTTC	CASSYQGDLSSYEQYF	TRBV7-3	TRBJ2-7
TGTGCCAGCAGCCCTGACGGAATAGATAGCAATCAGCCCCAGCATTTT	CASSPDGIDSNQPQHF	TRBV7-4	TRBJ1-5
TGTGCCAGCAGCGCCCAGGACAGGGGAAGCTACGAGCAGTACTTC	CASSAQDRGSYEQYF	TRBV7-4	TRBJ2-7
TGTGCGGGGACAGGGAGGTCGAGTGGAAACACCATATATTTT	CAGTGRSSGNTIYF	TRBV6-2	TRBJ1-3
TGTGCCAGCCCGACAGGGGGTGCCTACGAGCAGTACTTC	CASPTGGAYEQYF	TRBV6-4	TRBJ2-7
TGTGCCAGCACAGGGGGCGTAACTACCGAGCAGTACTTC	CASTGGVTTEQYF	TRBV12-3	TRBJ2-7
TGCAGCGTTGAGGGGACCTACTATGGCTACACCTTC	CSVEGTYYGYTF	TRBV29-1	TRBJ1-2
TGTGCCAGCAGCTTATGGGCAGGAGACCCAGTCACTGAAGCTTTCTTT	CASSLWAGDPVTEAFF	TRBV11-3	TRBJ1-1
TGTGCCTGCCTAGGTCCCTACAATGAGCAGTTCTTC	CACLGPYNEQFF	TRBV30	TRBJ2-1
TGCAGTGCTAGAGGGAAACTGGTAAGATTAGCCAAAAACATTCAGTACTTC	CSARGKLVRLAKNIQYF	TRBV20-1	TRBJ2-4
TGTGCCAGTAGGATACCCTGTAAAGGGAGCTCCTATAATTCACCCCTCCACTTT	CASRIPCKGSSYNSPLHF	TRBV19	TRBJ1-6
TGTGCCAGCAGCACCCAAGGGGGGGATTTCAATGAGCAGTTCTTC	CASSTQGGDFNEQFF	TRBV7-9	TRBJ2-1
TGTGCCACCAGCAGCCGCCCAGTACAGCCCCAGCATTTT	CATSSRPVQPQHF	TRBV15	TRBJ1-5
TGCGCCAGCAGACCCCCAGGACTAGCGGGCACCTACAATGAGCAGTTCTTC	CASRPPGLAGTYNEQFF	TRBV10-1	TRBJ2-1
TGTGCCAGAATTCACAGGGGGCCATGCACTGAAGCTTTCTTT	CARIHRGPCTEAFF	TRBV6-4	TRBJ1-1
TGTGCCAGCAGTGACCAATATAGTCGGACAGATGGGAGGGTCACAGATACGCAGTATTTT	CASSDQYSRTDGRVTDTQYF	TRBV6-4	TRBJ2-3
TGTGCCAGCAGCAGCGGGGATGACAATGAAAAACTGTTTTTT	CASSSGDDNEKLFF	TRBV13	TRBJ1-4
TGTGCCAGCAGCCGGGCCGGGACAGGGGAAGTTACCGGGGAGCTGTTTTTT	CASSRAGTGEVTGELFF	TRBV7-6	TRBJ2-2
TGTGTACCCGCCGGGACGACAGAGACCCAGTACTTC	CVPAGTTETQYF	TRBV27	TRBJ2-5
TGTGCCAGCAGTTATTCAAGCTACCCTGGGGCCCATGAGCAGTTCTTC	CASSYSSYPGAHEQFF	TRBV6-9	TRBJ2-1
TGCGCCAGCAGTGAGTCGGGCGGGGGCAGGTCACGCAATCAGCCCCAGCATTTT	CASSESGGGRSRNQPQHF	TRBV10-1	TRBJ1-5
TGTGCCAGCAGTTTCCGGGGGAGTACTGAAGCTTTCTTT	CASSFRGSTEAFF	TRBV28	TRBJ1-1
TGTGCCAGCAGCGTAGAGCGGAAGCATGGGGAAAAAGCCTACGAGCAGTACTTC	CASSVERKHGEKAYEQYF	TRBV9	TRBJ2-7
TGTGCCAGTAGCCGGGACGGACCCCTCCACTTT	CASSRDGPLHF	TRBV19	TRBJ1-6
TGTGCCACTGAGCGGGACGGGCGCGAGCAGTACTTC	CATERDGREQYF	TRBV9	TRBJ2-7
TGCAGCCCTTCCATCTGGGGGATTGGGGGGGACGGCACCGGGGAGCTGTTTTTT	CSPSIWGIGGDGTGELFF	TRBV29-1	TRBJ2-2
TGTGCCAGCAGCTTAATAGATCGGTCCTACGAGCAGTACTTC	CASSLIDRSYEQYF	TRBV11-2	TRBJ2-7
TGTGCCAGCAGTCGGGCCGGACAGGGCTCCTACGAGCAGTACTTC	CASSRAGQGSYEQYF	TRBV6-4	TRBJ2-7
TGTGCCAGCGCCCAACAACCCCCGGGGCGGGAAAAACTGTTTTTT	CASAQQPPGREKLFF	TRBV9	TRBJ1-4
TGTGCCAGCAGCTTAGGGGTTCGCAGGGGGATCGGGAACACTGAAGCTTTCTTT	CASSLGVRRGIGNTEAFF	TRBV11-3	TRBJ1-1
TGTGCCAGCAGGAGGGGAAACCCAGCATCGTCCCACACTGAAGCTTTCTTT	CASRRGNPASSHTEAFF	TRBV6-5	TRBJ1-1
TGTGCCACCCGGATAGGTGCTAGCACAGATACGCAGTATTTT	CATRIGASTDTQYF	TRBV24-1	TRBJ2-3
TGTGCCAGTAGCCCATTCCATCAGGGGCCTCGGGATCAGCCCCAGCATTTT	CASSPFHQGPRDQPQHF	TRBV19	TRBJ1-5
TGCGCCAGCAGCCCAGCGGAGGGGAGGTACGAGCAGTACTTC	CASSPAEGRYEQYF	TRBV5-1	TRBJ2-7
TGTGCCTGGACGTGCACTAATCAGCCCCAGCATTTT	CAWTCTNQPQHF	TRBV30	TRBJ1-5
TGCGCCAGCAGTGAGTCTCCTCTGACTAGCGGGAGACCCGAGCAGTACTTC	CASSESPLTSGRPEQYF	TRBV10-2	TRBJ2-7
TGTGCCAGCAGTTTTACAGGGAGGTACACTGAAGCTTTCTTT	CASSFTGRYTEAFF	TRBV6-6	TRBJ1-1
TGTGCCAGCAGCCCTAGCGGGTTATACTCCTACAATGAGCAGTTCTTC	CASSPSGLYSYNEQFF	TRBV11-3	TRBJ2-1
TGTGCCAGCAGCGCCAATTTTACAGGGAGGAGAGGGAAAGAGACCCAGTACTTC	CASSANFTGRRGKETQYF	TRBV7-3	TRBJ2-5
TGCGCCAGCAGTGAGCCTCGGGGCCCACAGCTCTTC	CASSEPRGPQLF	TRBV10-1	TRBJ2-1
TGTGCCAGCAGTTCCGCGGGACTAGCGGGATACGAGCAGTACTTC	CASSSAGLAGYEQYF	TRBV27	TRBJ2-7
TGTGCCAGCAGCTTCTCCGGGACTAGCTCCTACAATGAGCAGTTCTTC	CASSFSGTSSYNEQFF	TRBV7-8	TRBJ2-1
TGTGCCAGCTCACTGGGAGGGCTTGCCACAGATACGCAGTATTTT	CASSLGGLATDTQYF	TRBV18	TRBJ2-3
TGTGCCAGCAGCGACGCGGGGGCCTACGAGCAGTACTTC	CASSDAGAYEQYF	TRBV7-3	TRBJ2-7
TGTGCCAGCAGAAAACGACTAGGGGGGGGATACGAGCAGTACTTC	CASRKRLGGGYEQYF	TRBV2	TRBJ2-7
TGTGCCAGCGACCCTCCGGAACGGGGGAGGGACGCCGGGGAGCTGTTTTTT	CASDPPERGRDAGELFF	TRBV6-5	TRBJ2-2
TGTGCCATCCCCGGGACAGAGAAGTCCTACGAGCAGTACTTC	CAIPGTEKSYEQYF	TRBV24-1	TRBJ2-7
TGTGCCAGCAGCGCCGGGGTGAGCAATCAGCCCCAGCATTTT	CASSAGVSNQPQHF	TRBV7-9	TRBJ1-5
TGTGCCAGCAGCTTCCCCGGGCCACGAGGGCTACATGAGCAGTTCTTC	CASSFPGPRGLHEQFF	TRBV7-9	TRBJ2-1
TGCGCCAGCGGACCCCGTCCCGGAGGCTCCTACGAGCAGTACTTC	CASGPRPGGSYEQYF	TRBV4-1	TRBJ2-7
TGTGCCAGCAGTTTATTCATAGGTTGCACAGATACGCAGTATTTT	CASSLFIGCTDTQYF	TRBV12-4	TRBJ2-3
TGTGGATCAGGTGAGGGCACAGGTACGCAGTATTTT	CGSGEGTGTQYF	TRBV25-1	TRBJ2-3
TGTGCCAGCAGTTACCCGCACTGCTCTGGTGAGCAGTTCTTC	CASSYPHCSGEQFF	TRBV6-5	TRBJ2-1
TGCGCCAGCAGCCAAACGACAGGGAGGAGGCCTATGGCGGGGCCTCTAGAAGAGACCCAGTACTTC	CASSQTTGRRPMAGPLEETQYF	TRBV4-1	TRBJ2-5
TGCAGCGCAACCCAGGGGGAAGAGACCCAGTACTTC	CSATQGEETQYF	TRBV29-1	TRBJ2-5
TGTGCCACCAGTGAGGCCGGGCCGGGTAGCTCCTACAATGAGCAGTTCTTC	CATSEAGPGSSYNEQFF	TRBV24-1	TRBJ2-1
TGTGCCAGCAGACTGCCATCAGCCTCCTACGAGCAGTACTTC	CASRLPSASYEQYF	TRBV2	TRBJ2-7
TGTGCCAGCAGGAAACCCGGACAGTATGCCGGGGAGCTGTTTTTT	CASRKPGQYAGELFF	TRBV7-9	TRBJ2-2
TGCGCCAGCAGCCACCCCGGGACAGGGGGAGCTGAAGCTTTCTTT	CASSHPGTGGAEAFF	TRBV4-1	TRBJ1-1
TGCGCCAGCAGCTTGGCCCTTCCGGGACGGACCCGGAGCAATCAGCCCCAGCATTTT	CASSLALPGRTRSNQPQHF	TRBV5-1	TRBJ1-5
TGTGCCAGCAGCTTAAGAGTCCCATATTGCTACGAGCAGTACTTC	CASSLRVPYCYEQYF	TRBV11-3	TRBJ2-7
TGTGCCAGCAGCCGTACGGGACAGTTTATTGGACCTTGGAACACTGAAGCTTTCTTT	CASSRTGQFIGPWNTEAFF	TRBV6-6	TRBJ1-1
TGCGCCAGCAGTGAGTCGCCGGGCCGCCTCGATAGCAATCAGCCCCAGCATTTT	CASSESPGRLDSNQPQHF	TRBV10-1	TRBJ1-5
TGTGCCAGTCAGGGGGCAAAGTGCACTGAAGCTTTCTTT	CASQGAKCTEAFF	TRBV9	TRBJ1-1
TGTGCCAGCAGCTTAGCTTCATATCGGTGCTGGACCCTGTCCGAGCAGTACTTC	CASSLASYRCWTLSEQYF	TRBV7-8	TRBJ2-7
TGTGCCAGCAGCCAAGGAGGGGACGGGGCCTACGAGCAGTACTTC	CASSQGGDGAYEQYF	TRBV14	TRBJ2-7
TGCAGTGCTAGCGGACGGTTCTCCTACGAGCAGTACTTC	CSASGRFSYEQYF	TRBV20-1	TRBJ2-7
TGTGCCAGCAGTTACGACGACCCTGGCTGGGGCTACACCTTC	CASSYDDPGWGYTF	TRBV6-5	TRBJ1-2
TGTGCCAGCAGTGTGGAGACAGGGACGACAGATACGCAGTATTTT	CASSVETGTTDTQYF	TRBV28	TRBJ2-3
TGTGCCAGCAGCGGCCTTGCCGGGACAGGTAACAATTCACCCCTCCACTTT	CASSGLAGTGNNSPLHF	TRBV11-3	TRBJ1-6
TGCGCCAGCAGCTTGACGGGGGGGACTGGTTTCTCTGGAAACACCATATATTTT	CASSLTGGTGFSGNTIYF	TRBV5-1	TRBJ1-3
TGTGCCATCAGTGGCGGGACCAATGGTCAGCCCCAGCATTTT	CAISGGTNGQPQHF	TRBV10-3	TRBJ1-5
TGCAGTGCACGACCGCGACTCCCCCAAGAGACCCAGTACTTC	CSARPRLPQETQYF	TRBV20-1	TRBJ2-5
TGCGCCAGCAGCTTGGCCCCACGACAGGTCACTGAAGCTTTCTTT	CASSLAPRQVTEAFF	TRBV5-1	TRBJ1-1
TGTGCCAGCAGCCGTGGACAGGGGTGTCTAGCCAAAAACATTCAGTACTTC	CASSRGQGCLAKNIQYF	TRBV11-2	TRBJ2-4
TGTGCCAGCAGCTTAAGACTACAAGGGGACATAGAGACCCAGTACTTC	CASSLRLQGDIETQYF	TRBV5-5	TRBJ2-5
TGTGCCTGGAGTGGTAAAGTGCAGCGGCTTGATCAGCCCCAGCATTTT	CAWSGKVQRLDQPQHF	TRBV30	TRBJ1-5
TGTGCCAGCAGTCACAGGGACACTGAAGCTTTCTTT	CASSHRDTEAFF	TRBV27	TRBJ1-1
TGCAGTGCTAGAGAACTAGCGGGAGGGCGCTACGAGCAGTACTTC	CSARELAGGRYEQYF	TRBV20-1	TRBJ2-7
TGTGCCTGGATGGACTGCCAAGAGACCCAGTACTTC	CAWMDCQETQYF	TRBV30	TRBJ2-5
TGTGCCACCAGCAGAGATCCCCCGGGACTAGCGGGAAATGAGCAGTTCTTC	CATSRDPPGLAGNEQFF	TRBV15	TRBJ2-1
TGTGCCAGCAGCGATAATTTGTATGAGCAGTTCTTC	CASSDNLYEQFF	TRBV13	TRBJ2-1
TGCAGTGCTAGTAAGCCCGACTCCACTGAAGCTTTCTTT	CSASKPDSTEAFF	TRBV20-1	TRBJ1-1
TGTGCCAGCAGTTACTCTCCGAAAGGGCCAGACCTTGCAGATACGCAGTATTTT	CASSYSPKGPDLADTQYF	TRBV6-2	TRBJ2-3
TGTGCCAGCAGCCAACTGCCGCGCAGGGACAGGGGTTTCACAGATACGCAGTATTTT	CASSQLPRRDRGFTDTQYF	TRBV3-1	TRBJ2-3
TGTGCCAGCTCACCACCGCTAAACTATGGCTACACCTTC	CASSPPLNYGYTF	TRBV18	TRBJ1-2
TGTGCCAGCAGCTTCTCTTGGGGCCCGGGAAAATGCAATCAGCCCCAGCATTTT	CASSFSWGPGKCNQPQHF	TRBV7-3	TRBJ1-5
TGCGCCAGCAGCTTGGGCGTTCTGGGCTCCCCCGAGCAGTACTTC	CASSLGVLGSPEQYF	TRBV5-1	TRBJ2-7
TGCGCCAGCAGCCAAGATAACGCCGTGTACGTGGAGGGGGCTACGAGCTCCTACAATGAGCAGTTCTTC	CASSQDNAVYVEGATSSYNEQFF	TRBV4-3	TRBJ2-1
TGTGCCAGCAGCGGTGTTCAGGGTACCCTCAATCAGCCCCAGCATTTT	CASSGVQGTLNQPQHF	TRBV9	TRBJ1-5
TGTGCCAGCAGCTACCAGGGACTCTCTGGAAACACCATATATTTT	CASSYQGLSGNTIYF	TRBV11-2	TRBJ1-3
TGCAGTGCTGCCGGGGGGACCCGCAATGAGCAGTTCTTC	CSAAGGTRNEQFF	TRBV20-1	TRBJ2-1
TGCGCCAGCAGCCAACTAGCAGTTAATCGGGACAGGGAGACGGAAAATCAGCCCCAGCATTTT	CASSQLAVNRDRETENQPQHF	TRBV4-3	TRBJ1-5
TGCACAAGGACTAGCGGGATTGCGTCCTACAATGAGCAGTTCTTC	CTRTSGIASYNEQFF	TRBV20-1	TRBJ2-1
TGTGCCAGCAGCTTAGGACAGGGGGAACAAACCTACGAGCAGTACTTC	CASSLGQGEQTYEQYF	TRBV7-6	TRBJ2-7
TGTGCCAGCAGCTTAGTCTACAACTTCCTGAGGGGCCATTACGAGCAGTACTTC	CASSLVYNFLRGHYEQYF	TRBV7-2	TRBJ2-7
TGCGCCCAAGACACCGACACTGAAGCTTTCTTT	CAQDTDTEAFF	TRBV10-1	TRBJ1-1
TGTGCCACCCGTCTAGCGGGAGTCCACAATGAGCAGTTCTTC	CATRLAGVHNEQFF	TRBV24-1	TRBJ2-1
TGTGCCAGCAGCCAAGAAATTCGAAAGGGACCCCATGAGCAGTTCTTC	CASSQEIRKGPHEQFF	TRBV3-1	TRBJ2-1
TGTGCCATTGGGACTAGCGGCGACAATGAGCAGTTCTTC	CAIGTSGDNEQFF	TRBV27	TRBJ2-1
TGTGCCACCAGTGGAACGGACAGAATTGTCACCGGGGAGCTGTTTTTT	CATSGTDRIVTGELFF	TRBV24-1	TRBJ2-2
TGTGCCTGGACGTCCCTGGTAGCGGGTAGCACAGATACGCAGTATTTT	CAWTSLVAGSTDTQYF	TRBV30	TRBJ2-3
TGTGCCAGCAGCCGCAGGGGAAGGTACGAGCAGTACTTC	CASSRRGRYEQYF	TRBV14	TRBJ2-7
TGCAGTGCTTGGGCGAAAACGGGCTACAATGAGCAGTTCTTC	CSAWAKTGYNEQFF	TRBV20-1	TRBJ2-1
TGTGCCAGCAGTTTAGGGGGACAAAACTTCACAGATACGCAGTATTTT	CASSLGGQNFTDTQYF	TRBV12-4	TRBJ2-3
TGTGCCAGCAGCTTAGGCCCCACTCCGGAATCCTACGAGCAGTACTTC	CASSLGPTPESYEQYF	TRBV7-9	TRBJ2-7
TGCAGTGCTAGTTTCCGGGACAGGGGTGGCTACACCTTC	CSASFRDRGGYTF	TRBV20-1	TRBJ1-2
TGTGCCAGCAACGCATCAATAGGGACCGGGGAGCTGTTTTTT	CASNASIGTGELFF	TRBV28	TRBJ2-2
TGTGCCAGCAGCGTCCATCCCCGGGACATCCAGAGGTGGAACACTGAAGCTTTCTTT	CASSVHPRDIQRWNTEAFF	TRBV7-3	TRBJ1-1
TGCGCCAGCAGCCAGAATGCGGCTAAAAAAAAACTGTTTTTT	CASSQNAAKKKLFF	TRBV4-3	TRBJ1-4
TGTGCCACCAGGACTAGGTCCTACGAGCAGTACTTC	CATRTRSYEQYF	TRBV24-1	TRBJ2-7
TGTGCCACCAGCAGTGCGGGGGGTGATGACACTGAAGCTTTCTTT	CATSSAGGDDTEAFF	TRBV15	TRBJ1-1
TGTGCCAGCAGTGAGCGGGACAGGGGGCCGTCTAGGGGCTACGAGCAGTACTTC	CASSERDRGPSRGYEQYF	TRBV25-1	TRBJ2-7
TGTGCCAGCAGCAGGGGGGCCCGAAAGCCCCAGCATTTT	CASSRGARKPQHF	TRBV11-2	TRBJ1-5
TGCAGCGTTATTTGGGGCTCTGGAAACACCATATATTTT	CSVIWGSGNTIYF	TRBV29-1	TRBJ1-3
TGTGCCAGCAGCCAGTACGGGACAGGGGCCTACGAGCAGTACTTC	CASSQYGTGAYEQYF	TRBV7-3	TRBJ2-7
TGCGCCAGCAGTGAGTCCATTCAGGGGACAGGGGAATGTTCCTACGAGCAGTACTTC	CASSESIQGTGECSYEQYF	TRBV10-1	TRBJ2-7
TGTGCCAGCAGCGGGAGGATCGGGGAGACAGGCTACACCTTC	CASSGRIGETGYTF	TRBV13	TRBJ1-2
TGTGCCAGTAGTCCTATTGGACAGGGCAGATTGGATCAGCCCCAGCATTTT	CASSPIGQGRLDQPQHF	TRBV19	TRBJ1-5
TGTGCCAGCAGTTTATGGGGGGCCCCGGTCTATGAGCAGTTCTTC	CASSLWGAPVYEQFF	TRBV12-3	TRBJ2-1
TGCGCCAGCACCTCCGGGATGGGACAGGCTTATGGCTACACCTTC	CASTSGMGQAYGYTF	TRBV5-1	TRBJ1-2
TGTGCCAGCCGAGGAGGCTACGAGCAGTACTTC	CASRGGYEQYF	TRBV6-5	TRBJ2-7
TGTGCCAGCAGCCCTTTTATCCATGGACGAAGCAATGAGCAGTTCTTC	CASSPFIHGRSNEQFF	TRBV13	TRBJ2-1
TGCAGTGCTAGTACTCGTTTTCGGGGATTTGATTTGTACGAGCAGTACTTC	CSASTRFRGFDLYEQYF	TRBV20-1	TRBJ2-7
TGTGCCAGCTCACCACAGGGTTGCGCCTACGAGCAGTACTTC	CASSPQGCAYEQYF	TRBV18	TRBJ2-7
TGTGCCAGCAGCCAACCGCCAAAGCGGGGTGCAGATACGCAGTATTTT	CASSQPPKRGADTQYF	TRBV3-1	TRBJ2-3
TGCGCCAGCAGCTTGGGAGATGCCGTTGGGGACCAGCCCCAGCATTTT	CASSLGDAVGDQPQHF	TRBV5-1	TRBJ1-5
TGCGCCAGCAATTCTCCGGGACTAGCGGGAGCTTTCTACGAGCAGTACTTC	CASNSPGLAGAFYEQYF	TRBV10-1	TRBJ2-7
TGTGCCAGCAGCGACAAACCTAAAGACAGTTTCTATGGCTACACCTTC	CASSDKPKDSFYGYTF	TRBV13	TRBJ1-2
TGTGCCAGCAGCTTAGGACTACGAGTCCAGGTCTCTGGGGCCAACGTCCTGACTTTC	CASSLGLRVQVSGANVLTF	TRBV7-9	TRBJ2-6
TGCGCCAGCAGCTTGGGGGGGGGCCACTACAATGAGCAGTTCTTC	CASSLGGGHYNEQFF	TRBV5-1	TRBJ2-1
TGTGCCAGCAGTGACAGGGAGGGAGGGACATACACTGAAGCTTTCTTT	CASSDREGGTYTEAFF	TRBV6-4	TRBJ1-1
TGTGCCAGCAGCCCACTGCCCCAGCATTTT	CASSPLPQHF	TRBV6-4	TRBJ1-5
TGTGCCAGCAGCCCTGCTAGCGGGCGAATAGCCAAAAACATTCAGTACTTC	CASSPASGRIAKNIQYF	TRBV9	TRBJ2-4
TGTGCCAGCAGTGAATTTCAAGCGGGTACCTACGAGCAGTACTTC	CASSEFQAGTYEQYF	TRBV6-1	TRBJ2-7
TGTGCCAGCAGCTTAGCGATGCGCACAATGAACACTGAAGCTTTCTTT	CASSLAMRTMNTEAFF	TRBV7-6	TRBJ1-1
TGTGCCTGGTCCCTAGACCCCCAAGAGACCCAGTACTTC	CAWSLDPQETQYF	TRBV30	TRBJ2-5
TGTGCCTGGAGTCGTGGGACAGGGGGCGCGAACGAGCAGTACTTC	CAWSRGTGGANEQYF	TRBV30	TRBJ2-7
TGTGCCAGCAGCCGCGGACTAGCGGGGGATGGGGACGCCGAGCAGTTCTTC	CASSRGLAGDGDAEQFF	TRBV27	TRBJ2-1
TGTGCCAGCCGACGGCTCTACGAGCAGTACTTC	CASRRLYEQYF	TRBV10-3	TRBJ2-7
TGCGCCAGCCACGACAGGGTGCGGGACAATGAGCAGTTCTTC	CASHDRVRDNEQFF	TRBV10-1	TRBJ2-1
TGTGCCAGCAGCTTATCACCGACTAGCGGCTCGCAGTACTTC	CASSLSPTSGSQYF	TRBV13	TRBJ2-7
TGTGCCAGCAGCGGGACCCCAAGCAATCAGCCCCAGCATTTT	CASSGTPSNQPQHF	TRBV7-3	TRBJ1-5
TGTGCCAGCAGTTTTTGCCGGGAGTACAATGAGCAGTTCTTC	CASSFCREYNEQFF	TRBV12-4	TRBJ2-1
TGTGCCTCACTAGCGGGAGGGTACGAGCAGTACTTC	CASLAGGYEQYF	TRBV5-4	TRBJ2-7
TGTGCCAGCAGCTATTGGGGGGACGGGGATCAGCCCCAGCATTTT	CASSYWGDGDQPQHF	TRBV11-2	TRBJ1-5
TGTGCCAGTAGAAACAGGGGGGCCAACACTGAAGCTTTCTTT	CASRNRGANTEAFF	TRBV19	TRBJ1-1
TGTGCCAGCTCACCTACACTAGCGGGAGTCGGCAATCAGCCCCAGCATTTT	CASSPTLAGVGNQPQHF	TRBV18	TRBJ1-5
TGTGCCAGCAGTGACAGGACCGCCTACGAGCAGTACTTC	CASSDRTAYEQYF	TRBV12-4	TRBJ2-7
TGTGCCAGCAGCTTGGGCCAGTTTTGCCCGGGGGAAGCTTTCTTT	CASSLGQFCPGEAFF	TRBV7-2	TRBJ1-1
TGTGCCAGCAGCTTAATCCGGGGGGAAGGGGTGTATAGCAATCAGCCCCAGCATTTT	CASSLIRGEGVYSNQPQHF	TRBV7-8	TRBJ1-5
TGTGCCAGCAGCGTCCCCGGGGCAAGCTCCTACGAGCAGTACTTC	CASSVPGASSYEQYF	TRBV7-4	TRBJ2-7
TGTGCCAGCAGTGTGCCGGGGGCTAGCATGGAGACCCAGTACTTC	CASSVPGASMETQYF	TRBV6-4	TRBJ2-5
TGCGCCAGCAGGGACAATCCCAACTATGGCTACACCTTC	CASRDNPNYGYTF	TRBV10-2	TRBJ1-2
TGTGCCAGCAGCTCCCGTCTCCGGAACCCGCAATACGAGCAGTACTTC	CASSSRLRNPQYEQYF	TRBV5-6	TRBJ2-7
TGTGCCACCAGTGATGGGCTGGGGGCGGCGAACACTGAAGCTTTCTTT	CATSDGLGAANTEAFF	TRBV24-1	TRBJ1-1
TGTGCCAGCAGCTTTAGCCGAGGCTTTCGGGCAGTGAACACTGAAGCTTTCTTT	CASSFSRGFRAVNTEAFF	TRBV7-3	TRBJ1-1
TGCGCCAGCAGCTCAGATATAGTCACCTATAATTCACCCCTCCACTTT	CASSSDIVTYNSPLHF	TRBV5-1	TRBJ1-6
TGTGCCAGTTATCCGGGACAGTGCCTAAATGAGCAGTTCTTC	CASYPGQCLNEQFF	TRBV19	TRBJ2-1
TGTGCCACTAGCGGGAGGGCCGCCCTGGACAGCAATCAGCCCCAGCATTTT	CATSGRAALDSNQPQHF	TRBV6-5	TRBJ1-5
TGCAGTGCTGCCCGAGGGGCCCTCGGCACAGATACGCAGTATTTT	CSAARGALGTDTQYF	TRBV20-1	TRBJ2-3
TGTGCCATGGGTTTGCAGGTCATGGGTGAAAAACTGTTTTTT	CAMGLQVMGEKLFF	TRBV12-4	TRBJ1-4
TGTGCCAGTAGTATAGGATGGGCTACCTACGAGCAGTACTTC	CASSIGWATYEQYF	TRBV19	TRBJ2-7
TGTGCCAGCTCACAATACCGGTCCGCCGGGACTGAGGGATACAATGAGCAGTTCTTC	CASSQYRSAGTEGYNEQFF	TRBV18	TRBJ2-1
TGTGCCAGCAGCGCTGAGGCAGGGAGCTCCTACGAGCAGTACTTC	CASSAEAGSSYEQYF	TRBV7-4	TRBJ2-7
TGTGCCAGCAGTTTAATTCGAGGTACCCACGAGCAGTACTTC	CASSLIRGTHEQYF	TRBV12-3	TRBJ2-7
TGCAGCGTGTCGGCCAGGCCCTACGAGCAGTACTTC	CSVSARPYEQYF	TRBV29-1	TRBJ2-7
TGTGCCAGCAGTGGCGACAGGTCTACTCAGCCCCAGCATTTT	CASSGDRSTQPQHF	TRBV6-2	TRBJ1-5
TGTGCCACCAGTGATTTCCTAGTACTAACCACCTACGAGCAGTACTTC	CATSDFLVLTTYEQYF	TRBV24-1	TRBJ2-7
TGTGCCTGGGGGGTCCCGGGAGGGTCGGGATGTAGCAATCAGCCCCAGCATTTT	CAWGVPGGSGCSNQPQHF	TRBV30	TRBJ1-5
TGTGCCACCACCCTCCCTAAACTCGGGCGGCGGTGCACCGGGGAGCTGTTTTTT	CATTLPKLGRRCTGELFF	TRBV24-1	TRBJ2-2
TGTGCCAGCAGCCCATGTCGCGGACAGCGAAATCAGCCCCAGCATTTT	CASSPCRGQRNQPQHF	TRBV13	TRBJ1-5
TGTGCCAGCAGCCCAGGGACTAGCGAGCGCCCTGAGACCCAGTACTTC	CASSPGTSERPETQYF	TRBV7-3	TRBJ2-5
TGTGCCAGCAGTTCTGCAGGAAACACTGAAGCTTTCTTT	CASSSAGNTEAFF	TRBV12-3	TRBJ1-1
TGTGCCAGCGGACGGGACAGAGAAGATACGCAGTATTTT	CASGRDREDTQYF	TRBV27	TRBJ2-3
TGTGCCAGCAGCTTGAACTCAGATAGAGGGAACACTGAAGCTTTCTTT	CASSLNSDRGNTEAFF	TRBV11-3	TRBJ1-1
TGTGCCAGCAGCTTCCCCCCTCCGGGGGGAGAGGGTAAGGAAGCTTTCTTT	CASSFPPPGGEGKEAFF	TRBV11-2	TRBJ1-1
TGTGCTAGCAGCCCCCGTGGCAACACTGAAGCTTTCTTT	CASSPRGNTEAFF	TRBV7-7	TRBJ1-1
TGTGCCAGCAGTGACTCGCGGGGACGAGCAGATTCACCCCTCCACTTT	CASSDSRGRADSPLHF	TRBV6-4	TRBJ1-6
TGTGCCAGCAGCGGGAAGGAGCTAACCGGGGAGCTGTTTTTT	CASSGKELTGELFF	TRBV14	TRBJ2-2
TGTGCCAGCAGCAATGACCCTGGCGGACTCGATAACTATGGCTACACCTTC	CASSNDPGGLDNYGYTF	TRBV13	TRBJ1-2
TGCGCCAGCAGGGTTAGCGGGTCTTCCGGGAACGAGCAGTACTTC	CASRVSGSSGNEQYF	TRBV10-2	TRBJ2-7
TGTGCCAGCAGCGCCGGGACGAGACCCAATGAGCAGTTCTTC	CASSAGTRPNEQFF	TRBV13	TRBJ2-1
TGTGCCAGTGACCCGGGACAGGGGCCGAACACCGGGGAGCTGTTTTTT	CASDPGQGPNTGELFF	TRBV19	TRBJ2-2
TGTGCACTCGGCACTGCCTATGGCTACACCTTC	CALGTAYGYTF	TRBV24-1	TRBJ1-2
TGTGCTAGTGGTTTGCCGGGACATGGCTACACCTTC	CASGLPGHGYTF	TRBV12-5	TRBJ1-2
TGTGCCATCGCAGACGATCAGCCCCAGCATTTT	CAIADDQPQHF	TRBV10-3	TRBJ1-5
TGTGCCAGCAGCCCCGGACTAGCGGGAGGCTTTAATGAGCAGTTCTTC	CASSPGLAGGFNEQFF	TRBV6-5	TRBJ2-1
TGTGCCAGCAGCTCTAACAGGGGCCTGGCCTACGAGCAGTACTTC	CASSSNRGLAYEQYF	TRBV9	TRBJ2-7
TGCGCCAGCAGCGGTGCTTGGGGAGAGGAGCAGTACTTC	CASSGAWGEEQYF	TRBV5-1	TRBJ2-7
TGCGCCAGCAGTGAAACGGGGGCATCCCTTTCCTACGAGCAGTACTTC	CASSETGASLSYEQYF	TRBV10-1	TRBJ2-7
TGCGCCAGCAGTACCCGAGATGTCCAGGGCAATCAGCCCCAGCATTTT	CASSTRDVQGNQPQHF	TRBV10-1	TRBJ1-5
TGTGCCAGCAGCGAACAAACCAACGTCCTGACTTTC	CASSEQTNVLTF	TRBV9	TRBJ2-6
TGTGCCAGCGACCCCGCCTTACCGTTCAGGGGTTGTAGCTCTGGGGCCAACGTCCTGACTTTC	CASDPALPFRGCSSGANVLTF	TRBV6-3	TRBJ2-6
TGTGCCAGCAGCCCTGACTATAGCAATCAGCCCCAGCATTTT	CASSPDYSNQPQHF	TRBV9	TRBJ1-5
TGTGCCAGCAGCTTCCCACAGGGGTTTCAGCCCCAGCATTTT	CASSFPQGFQPQHF	TRBV5-5	TRBJ1-5
TGTGCCAGCAGCTTCCTGAGGCGGAGCTCCTACAATGAGCAGTTCTTC	CASSFLRRSSYNEQFF	TRBV7-6	TRBJ2-1
TGCAGTGCTAGAGCTAACGACAGGGATGGGGAGAGGCCTGAAGCTTTCTTT	CSARANDRDGERPEAFF	TRBV20-1	TRBJ1-1
TGTGCCAGCAGCGGGCTGCAGGGCGGGAGCGTTTGTCAAGAGACCCAGTACTTC	CASSGLQGGSVCQETQYF	TRBV5-4	TRBJ2-5
TGTGCCAGCAGCTTGTGGTACGGCGGGAGAGTGGGAAACACCATATATTTT	CASSLWYGGRVGNTIYF	TRBV13	TRBJ1-3
TGTGCCAGCACCAACCGCCAAGAGACCCAGTACTTC	CASTNRQETQYF	TRBV2	TRBJ2-5
TGTGCCAGCAGCGTAAGGATAACATTGAGACAGGTCTACGAGCAGTACTTC	CASSVRITLRQVYEQYF	TRBV9	TRBJ2-7
TGTGCCAGCAGTCCTTCCCCGACAGAAAAAGTGACACAGGGCGTGGAGACCCAGTACTTC	CASSPSPTEKVTQGVETQYF	TRBV6-5	TRBJ2-5
TGTGCCAGCAGAGTCGGGAGGGGGGAAGAGACCCAGTACTTC	CASRVGRGEETQYF	TRBV27	TRBJ2-5
TGTGCCAGCAGCGCTGGACAGGTATCCGGGGAGCTGTTTTTT	CASSAGQVSGELFF	TRBV7-2	TRBJ2-2
TGTGCCAGCAGTTACCCAAGGACCGGGCGGTCCTACGAGCAGTACTTC	CASSYPRTGRSYEQYF	TRBV27	TRBJ2-7
TGTGCCAGCAGCTCGGACAGCCGGGGGAACACTGAAGCTTTCTTT	CASSSDSRGNTEAFF	TRBV7-2	TRBJ1-1
TGTGCCAGCACTACTAGCGGGAGGGGGGGAAACACCGGGGAGCTGTTTTTT	CASTTSGRGGNTGELFF	TRBV9	TRBJ2-2
TGCGCCGGGGACAGACCGAGAGATACGCAGTATTTT	CAGDRPRDTQYF	TRBV5-1	TRBJ2-3
TGTGCCAGCAGTCGCCCAAACCAAAGCGAGGATCCCCAGCATTTT	CASSRPNQSEDPQHF	TRBV27	TRBJ1-5
TGTGCCAGCAGCTTGGCGGGGGGGCTGGGCTACGAGCAGTACTTC	CASSLAGGLGYEQYF	TRBV6-5	TRBJ2-7
TGTGCCAGCAGCCTGAGGCGGTACGAGCAGTACTTC	CASSLRRYEQYF	TRBV9	TRBJ2-7
TGTGCCAGCAGCCACGGTCGGACGAATTCACCCCTCCACTTT	CASSHGRTNSPLHF	TRBV3-1	TRBJ1-6
TGCAGCGCAGGAATAGAGCAGTTCTTC	CSAGIEQFF	TRBV29-1	TRBJ2-1
TGTGCCAGCAGCTTGGGACACAACACTGAAGCTTTCTTT	CASSLGHNTEAFF	TRBV5-6	TRBJ1-1
TGTGCCAGCAGCCACCTTGGGGACAGCTCTGGGGCCAACGTCCTGACTTTC	CASSHLGDSSGANVLTF	TRBV9	TRBJ2-6
TGCAGCGGAACGGACAGCGGCTACACCTTC	CSGTDSGYTF	TRBV29-1	TRBJ1-2
TGTGCCAGCAGCTTAGTATCCGCAGGGGATCAGCCCCAGCATTTT	CASSLVSAGDQPQHF	TRBV11-3	TRBJ1-5
TGTGCCAGCAGCTTAGGCACGATAAGGAGCGGGAGGCCCCAGCATTTT	CASSLGTIRSGRPQHF	TRBV7-2	TRBJ1-5
TGCGCCAGCAGTGATACTCCTGGGGGCACAGATACGCAGTATTTT	CASSDTPGGTDTQYF	TRBV10-1	TRBJ2-3
TGTGCCTTGAACTATGCCGAGCGGGACAGGGGGCGCGGCTACACCTTC	CALNYAERDRGRGYTF	TRBV24-1	TRBJ1-2
TGTGCCAGCAGTGCCGTGGGGGGGGAAGAAAACATTCAGTACTTC	CASSAVGGEENIQYF	TRBV6-1	TRBJ2-4
TGTGCCAGCAGTGAAATAAGCGGGACTCTTGAGCAGTTCTTC	CASSEISGTLEQFF	TRBV6-1	TRBJ2-1
TGTGCCAGCAGCCAGGCCGGGACAGGAAGGTATAATTCACCCCTCCACTTT	CASSQAGTGRYNSPLHF	TRBV14	TRBJ1-6
TGTGCCAGCAGAGAGGGAGGCGGCTACGAGCAGTACTTC	CASREGGGYEQYF	TRBV6-5	TRBJ2-7
TGTGCCAGCAGACCCGGGGAGGAGTATGGCTACACCTTC	CASRPGEEYGYTF	TRBV7-2	TRBJ1-2
TGCAGTGCTAGTGGACACTTACCTTTCTACCACAATGAGCAGTTCTTC	CSASGHLPFYHNEQFF	TRBV20-1	TRBJ2-1
TGTGCCAGCAAAAACCTCCCCGGGGCCCTCAGGAACACTGAAGCTTTCTTT	CASKNLPGALRNTEAFF	TRBV6-1	TRBJ1-1
TGTGCCAGCAGTTACTCGACGAGGACAGTCGGCTCTGGAAACACCATATATTTT	CASSYSTRTVGSGNTIYF	TRBV6-5	TRBJ1-3
TGCGCCAGCAGCTTGGCGAAGGGAGGCTGCACAGATACGCAGTATTTT	CASSLAKGGCTDTQYF	TRBV5-1	TRBJ2-3
TGCGCCAGCAGCTTGTCTGCCGTATGCGGGGAGCTGTTTTTT	CASSLSAVCGELFF	TRBV5-1	TRBJ2-2
TGTGCCAGCAAACATACACTAGTTCAGCCCCAGCATTTT	CASKHTLVQPQHF	TRBV7-3	TRBJ1-5
TGTGCCAGCAGTTGTGTGTCCAGGTACAGGGGGGAAAATCAGCCCCAGCATTTT	CASSCVSRYRGENQPQHF	TRBV6-2	TRBJ1-5
TGTGCCAGCAGCTTGGCCCCCCTCGCGTGGGGCCGCACAGATACGCAGTATTTT	CASSLAPLAWGRTDTQYF	TRBV5-4	TRBJ2-3
TGTGCCAGCAGCCACAGGGGGCGCGATAGGGCAGGCTATGGCTACACCTTC	CASSHRGRDRAGYGYTF	TRBV7-3	TRBJ1-2
TGTGCCAGCCCGGGGGGGGGAGCTTTCTTT	CASPGGGAFF	TRBV6-2	TRBJ1-1
TGTGCCAGCAAAGTGGACAGGGTCGTGGGGGGGCTCGCTAATGCAACTAATGAAAAACTGTTTTTT	CASKVDRVVGGLANATNEKLFF	TRBV6-6	TRBJ1-4
TGTGCCAGCAGCAGTTCAGGGGAGCTGTTTTTT	CASSSSGELFF	TRBV7-9	TRBJ2-2
TGTGCCAGCAGTCCAAAGAGGTATGGCTACACCTTC	CASSPKRYGYTF	TRBV7-9	TRBJ1-2
TGTGCCAGCAGTTTCCCCCAAAACGACAGGAGCTCCTACAATGAGCAGTTCTTC	CASSFPQNDRSSYNEQFF	TRBV28	TRBJ2-1
TGTGCCAGCGGGGTTGGCCCGGACAGGGTCGACTATGGCTACACCTTC	CASGVGPDRVDYGYTF	TRBV25-1	TRBJ1-2
TGTGCCAGCAGCTACCACCCTCCATCCCGGGCCGGAAACGTGAACACTGAAGCTTTCTTT	CASSYHPPSRAGNVNTEAFF	TRBV11-3	TRBJ1-1
TGTGCCAGCAGCTCCAGGGGCAGGGTTGGCTACACCTTC	CASSSRGRVGYTF	TRBV7-3	TRBJ1-2
TGTGCCAGTAGTATCCCCTGCAGGGGGCGGGACTCTGGAAACACCATATATTTT	CASSIPCRGRDSGNTIYF	TRBV19	TRBJ1-3
TGTGCCAGCAGCCGTTCACAGGGGAGCTCTGGAAACACCATATATTTT	CASSRSQGSSGNTIYF	TRBV3-1	TRBJ1-3
TGTGCCAGCAGTGAGCCGGAAGGGAGGGCAGCCGGGACTGGGGCCAACGTCCTGACTTTC	CASSEPEGRAAGTGANVLTF	TRBV2	TRBJ2-6
TGCGCCAGCAGCTTGCCAGTTGATACGCAGTATTTT	CASSLPVDTQYF	TRBV5-1	TRBJ2-3
TGTGCCAGCAATTGGAGGGTGGGCTACACCTTC	CASNWRVGYTF	TRBV27	TRBJ1-2
TGTGCCAAAGCCCAGGGATTAGCTTTCTTT	CAKAQGLAFF	TRBV28	TRBJ1-1
TGCGCCAGCAGCTTGCCCGGCAGGGAGAGTAATTCACCCCTCCACTTT	CASSLPGRESNSPLHF	TRBV5-1	TRBJ1-6
TGTGCCAGCAGTGGGAAGGGGTCCTATAATTCACCCCTCCACTTT	CASSGKGSYNSPLHF	TRBV27	TRBJ1-6
TGTGCCAGCAGCATACATGACAATGAGCAGTTCTTC	CASSIHDNEQFF	TRBV7-3	TRBJ2-1
TGTGCCAGCAGCCTGGGGGGGGCAGAGACCCAGTACTTC	CASSLGGAETQYF	TRBV28	TRBJ2-5
TGTGCCAGCAGCTGTGTCGGCAACCTGGATAGCAATCAGCCCCAGCATTTT	CASSCVGNLDSNQPQHF	TRBV5-6	TRBJ1-5
TGTGCCAGTCCAGAGGGTGTGACCCAGTACTTC	CASPEGVTQYF	TRBV6-1	TRBJ2-5
TGTGCCAGCAGTGATTCCTGGGGAGTAATCTACGAGCAGTACTTC	CASSDSWGVIYEQYF	TRBV25-1	TRBJ2-7
TGTGCCAGCAGCCCGCCGGGCAATCAGCCCCAGCATTTT	CASSPPGNQPQHF	TRBV7-4	TRBJ1-5
TGTGCCAGTAGTATAGGGGGGGGGAGCAATGAGCAGTTCTTC	CASSIGGGSNEQFF	TRBV19	TRBJ2-1
TGTGCCAGCAGCCAAGATCCTTTTACTAACGAGCAGTACTTC	CASSQDPFTNEQYF	TRBV14	TRBJ2-7
TGTGCCAGCAGTTTCCACCGGGACGGCACTGAAGCTTTCTTT	CASSFHRDGTEAFF	TRBV12-4	TRBJ1-1
TGTGCCAGCAAACCAGGGTGGGCCTACGAGCAGTACTTC	CASKPGWAYEQYF	TRBV19	TRBJ2-7
TGTGCCAGCAGCTCACAGGGGGCTAGAGCTTTAGTCCAGACCCAGTACTTC	CASSSQGARALVQTQYF	TRBV7-2	TRBJ2-5
TGTGCCAGCAGCCTTAAACCGAGTATAACCCACAATGAGCAGTTCTTC	CASSLKPSITHNEQFF	TRBV7-3	TRBJ2-1
TGTGCCAGCAGTGAACCAGGGGATGGTCATGATGGCTACACCTTC	CASSEPGDGHDGYTF	TRBV6-1	TRBJ1-2
TGCAGTGCTAGAGATGTCTTCCTAGGGGACTCTGAGAACACTGAAGCTTTCTTT	CSARDVFLGDSENTEAFF	TRBV20-1	TRBJ1-1
TGTGCCAGTAGTATCCAGGGAAGCTCCTACGAGCAGTACTTC	CASSIQGSSYEQYF	TRBV19	TRBJ2-7
TGTGCCAGCAGATTCAAGGACAGGGGGAACTTGGGAACGGATGACACTGAAGCTTTCTTT	CASRFKDRGNLGTDDTEAFF	TRBV6-4	TRBJ1-1
TGTGCCACCAGCAGAGCCTCCGGGGGACTAGCTTGTGGGTTGCAGTTCTTC	CATSRASGGLACGLQFF	TRBV15	TRBJ2-1
TGTGCCAGCAGCTTAGATGGGCTGGACAGGGGTTTCCGTGACTATAGCAATCAGCCCCAGCATTTT	CASSLDGLDRGFRDYSNQPQHF	TRBV11-3	TRBJ1-5
TGTGCCAGCAGCTTGCGGAGCTCGGGGTGGGAGACCCAGTACTTC	CASSLRSSGWETQYF	TRBV5-4	TRBJ2-5
TGTGCCAGCAGTTACCTCCGAGGGGTGACTGCGGGCACAGATACGCAGTATTTT	CASSYLRGVTAGTDTQYF	TRBV6-3	TRBJ2-3
TGTGCCAGCAGTTCCGGGACAGGGACTAAAAATCAGCCCCAGCATTTT	CASSSGTGTKNQPQHF	TRBV27	TRBJ1-5
TGCAGTGCTTCCTGGGGGCCGTGGAATGGCTACACCTTC	CSASWGPWNGYTF	TRBV20-1	TRBJ1-2
TGTGCCAGCTCACCACGACTACCCCGGGGCAGGGGGCGCACCCCAAGCGAGCAGTACTTC	CASSPRLPRGRGRTPSEQYF	TRBV18	TRBJ2-7
TGCGCCAGCAGTGTGGTGGACAGGTTCTGTTCAAACACCATATATTTT	CASSVVDRFCSNTIYF	TRBV10-1	TRBJ1-3
TGCAGTGCTCCCCCAACTAGCGGCTCCGCAGATACGCAGTATTTT	CSAPPTSGSADTQYF	TRBV20-1	TRBJ2-3
TGTGCCAGCAGCCAAGATCCCCCTTTTTTGTACATCCGGAAAAACATTCAGTACTTC	CASSQDPPFLYIRKNIQYF	TRBV14	TRBJ2-4
TGTGCCAGCAGTTACCCTAGGGGAGTAAATAGCAATCAGCCCCAGCATTTT	CASSYPRGVNSNQPQHF	TRBV6-5	TRBJ1-5
TGTGCCAGCAGAGGACTCAGGCGCTCCTACGAGCAGTACTTC	CASRGLRRSYEQYF	TRBV2	TRBJ2-7
TGTGCTAGTGGTTTGGGACAGGGGGCCCACACTGAAGCTTTCTTT	CASGLGQGAHTEAFF	TRBV12-5	TRBJ1-1
TGTGCCAGCAGATGTCTTGAGGTGGATCAGCCCCAGCATTTT	CASRCLEVDQPQHF	TRBV6-8	TRBJ1-5
TGTGCCTGGCAGACGGGAAAGACCAAAAACATTCAGTACTTC	CAWQTGKTKNIQYF	TRBV30	TRBJ2-4
TGTGCCAGCAGTTTTCAGCGTAGCGAGCAGTACTTC	CASSFQRSEQYF	TRBV27	TRBJ2-7
TGTGCCAGGGAGACGAAATTGAACTATGGCTACACCTTC	CARETKLNYGYTF	TRBV19	TRBJ1-2
TGTGCCAGCAGTTTTCACTCGGGGACAGGGGACATGCATTTT	CASSFHSGTGDMHF	TRBV28	TRBJ1-5
TGCAGTGCTAGAGTTGGGGACTCCCGGTACTATGGCTACACCTTC	CSARVGDSRYYGYTF	TRBV20-1	TRBJ1-2
TGTGCCTGGAGTAGGACAGATTCGGGTCCCATTGTTGCGATGAATCTCCACTTT	CAWSRTDSGPIVAMNLHF	TRBV30	TRBJ1-6
TGCGCCAGCAGCTTGGGGACAGCCGGAAACTATGGCTACACCTTC	CASSLGTAGNYGYTF	TRBV5-1	TRBJ1-2
TGTGCCAGCAGCGCGGCGTGGGACAGGGGTGAACTGGACACCGGGGAGCTGTTTTTT	CASSAAWDRGELDTGELFF	TRBV13	TRBJ2-2
TGCGCCAGCTCCTCCCAAAAACTTGGGCATAATGAAAAACTGTTTTTT	CASSSQKLGHNEKLFF	TRBV10-1	TRBJ1-4
TGCGCCAGCAGCTTGGGGGAAGCTAGCGGGCCCAAGTACGAGCAGTACTTC	CASSLGEASGPKYEQYF	TRBV5-1	TRBJ2-7
TGCAGTGCTTACCCTCCCGGGACAGGGGTATGGCAAGAGACCCAGTACTTC	CSAYPPGTGVWQETQYF	TRBV20-1	TRBJ2-5
TGTGCCACCAAGCCAACAGTAACCGGGGAGCTGTTTTTT	CATKPTVTGELFF	TRBV24-1	TRBJ2-2
TGTGCCAGCAGTTACTCGAGGGTGGGGAGCTATGGCTACACCTTC	CASSYSRVGSYGYTF	TRBV6-5	TRBJ1-2
TGCGCCAGCAGCTTAAGGGGGCTTAGCACAGATACGCAGTATTTT	CASSLRGLSTDTQYF	TRBV5-1	TRBJ2-3
TGTGCCAGCAAGTTTCCATTAGCGGGGGTGAAGTACGAGCAGTACTTC	CASKFPLAGVKYEQYF	TRBV6-1	TRBJ2-7
TGTGCCAGTAAGTCGGACACGGAGTCCTACGAGCAGTACTTC	CASKSDTESYEQYF	TRBV19	TRBJ2-7
TGTGCCAGCAGCCAAGAAACGAGGGACCGGGACAGTGCAGCAACTAATGAAAAACTGTTTTTT	CASSQETRDRDSAATNEKLFF	TRBV14	TRBJ1-4
TGCGCCGGACCGGGGGGAGAGACCCAGTACTTC	CAGPGGETQYF	TRBV10-1	TRBJ2-5
TGCAGTGCATTTGGGGACAGGGGGCTCAGTCGCATGAACACTGAAGCTTTCTTT	CSAFGDRGLSRMNTEAFF	TRBV20-1	TRBJ1-1
TGCGCCAGCAGTGCAATCTCAAGGTTTCTAGCTTCAGATACGCAGTATTTT	CASSAISRFLASDTQYF	TRBV10-2	TRBJ2-3
TGCGCCAGCAGCCAAGAACCCCCCGGGACAGGGGGGGGAGCGAACACCGGGGAGCTGTTTTTT	CASSQEPPGTGGGANTGELFF	TRBV4-1	TRBJ2-2
TGTGCCAGCAGTTTGGAAGACAGGGCGTACACCGGGGAGCTGTTTTTT	CASSLEDRAYTGELFF	TRBV28	TRBJ2-2
TGTGCCAGCAGCTCGAGGAGGAGACTCTGTTCAAACATTCAGTACTTC	CASSSRRRLCSNIQYF	TRBV7-9	TRBJ2-4
TGTGCCAGCAGTTACGGGGGGCAGAAGAGAGATAATCAGCCCCAGCATTTT	CASSYGGQKRDNQPQHF	TRBV6-5	TRBJ1-5
TGTGCCAGCAGTGACAAAAATAGGGGGATTCCTGGGGAGCTGTTTTTT	CASSDKNRGIPGELFF	TRBV25-1	TRBJ2-2
TGTGCCAGCACCACCGGGGGGGTAAGGGGAAAAAACATTCAGTACTTC	CASTTGGVRGKNIQYF	TRBV7-9	TRBJ2-4
TGCGCCAGCAGCGCCTCCGGGAGCCCTGGGGAGAGCAATCAGCCCCAGCATTTT	CASSASGSPGESNQPQHF	TRBV5-1	TRBJ1-5
TGTTTTGCCCGGGGGGCGAGACACTACAATGAGCAGTTCTTC	CFARGARHYNEQFF	TRBV30	TRBJ2-1
TGTGCCAGCAGTTTCCAGGGGGCGTTGAACACTGAAGCTTTCTTT	CASSFQGALNTEAFF	TRBV7-9	TRBJ1-1
TGCGCCAGTAGGGGACGAGCCTACGAGCAGTACTTC	CASRGRAYEQYF	TRBV10-1	TRBJ2-7
TGTGCCAGCAGTACACACGACCCAAGGCCCTACAATGAGCAGTTCTTC	CASSTHDPRPYNEQFF	TRBV6-4	TRBJ2-1
TGTGCCAGACTTGGTGGGACAGGGGTTCAGCCCCAGCATTTT	CARLGGTGVQPQHF	TRBV6-5	TRBJ1-5
TGTGCCAGCAGCCCGGGATGGAATCCGGGACAGGGTGCATACGAGCAGTACTTC	CASSPGWNPGQGAYEQYF	TRBV5-4	TRBJ2-7
TGTGCCACCAGTGATTTCCCTTCTAGAGGGACCGGGGAGCTGTTTTTT	CATSDFPSRGTGELFF	TRBV24-1	TRBJ2-2
TGTGCCAGTAGTATCCCGCCCCAGGGGAGTTCCGATAGCAATCAGCCCCAGCATTTT	CASSIPPQGSSDSNQPQHF	TRBV19	TRBJ1-5
TGTGCCAGCAGTTTATTGGACCTAGCGGTAGATTACGAGCAGTACTTC	CASSLLDLAVDYEQYF	TRBV27	TRBJ2-7
TGTGCCAGCAGCTTGGCAAGGGCTAAGGGGACTGAAGCTTTCTTT	CASSLARAKGTEAFF	TRBV5-4	TRBJ1-1
TGTGCCATCAGCCTAGGGACAGGGGAACTCGAGCAGTACTTC	CAISLGTGELEQYF	TRBV10-3	TRBJ2-7
TGTGCCAGCAGTTCGGGACAGTTTTTCGAGCAGTACTTC	CASSSGQFFEQYF	TRBV2	TRBJ2-7
TGTGCCAGCTCACCACCGGGGCCCGAGACTGAAGCTTTCTTT	CASSPPGPETEAFF	TRBV18	TRBJ1-1
TGCGCCAGCAGCTCCGAGGGACTAGTCCCGAGCTCCTACGAGCAGTACTTC	CASSSEGLVPSSYEQYF	TRBV5-1	TRBJ2-7
TGTGCCAGCAGCTTAGCCCCAGAGGGATTGAACACTGAAGCTTTCTTT	CASSLAPEGLNTEAFF	TRBV7-8	TRBJ1-1
TGTGCCAGTAGAGTTGGACAGGGTTGGGCTGAAGCTTTCTTT	CASRVGQGWAEAFF	TRBV19	TRBJ1-1
TGTGCCAGCAGGGACGGGATGCAGAGCTCCTATAATTCACCCCTCCACTTT	CASRDGMQSSYNSPLHF	TRBV7-3	TRBJ1-6
TGTGCCAGCAGGGTGATTTGGACAGGTAGGATCAGAGTGTTATATGGCTACACCTTC	CASRVIWTGRIRVLYGYTF	TRBV6-4	TRBJ1-2
TGTGCCAGCACGGGACAGGTGCAGACCCAGTACTTC	CASTGQVQTQYF	TRBV28	TRBJ2-5
TGTGCCAGCATAGAGGGGGGGGGTTGGTGGGGGGTCAATGAGCAGTTCTTC	CASIEGGGWWGVNEQFF	TRBV9	TRBJ2-1
TGTGCCAGGCATACCTACGAGCAGTACTTC	CARHTYEQYF	TRBV6-4	TRBJ2-7
TGTGCCAGCAGTAGCCCGGACATAGAGACCTACGAGCAGTACTTC	CASSSPDIETYEQYF	TRBV6-2	TRBJ2-7
TGCAGTGCTAGAGGGCCACCCTCAGTGAACACTGAAGCTTTCTTT	CSARGPPSVNTEAFF	TRBV20-1	TRBJ1-1
TGCGCCAGCAGTTCGGGGTCCTACGAGCAGTACTTC	CASSSGSYEQYF	TRBV10-1	TRBJ2-7
TGCGCCGGAGCGGGACAGTCTAGATCGAACAATGAGCAGTTCTTC	CAGAGQSRSNNEQFF	TRBV5-1	TRBJ2-1
TGTGCCATAGGACACAATCAGCCCCAGCATTTT	CAIGHNQPQHF	TRBV10-3	TRBJ1-5
TGTGCCAGCGAGCGGGAGGGCCAAAAACTCACCGGGGAGCTGTTTTTT	CASEREGQKLTGELFF	TRBV27	TRBJ2-2
TGTGCCAGGACTAGCGGGAGGGGTTACGAGCAGTACTTC	CARTSGRGYEQYF	TRBV6-1	TRBJ2-7
TGCGCCAGCAGCTTGGTTCGTGGGACAGGGTCTATACCCTACGAGCAGTACTTC	CASSLVRGTGSIPYEQYF	TRBV5-1	TRBJ2-7
TGCGCCAGCAGCTTGGCCTTGCGTCACGAGCAGTACTTC	CASSLALRHEQYF	TRBV5-1	TRBJ2-7
TGTGCCACCAGCACAGGGGGAGATACGCAGTATTTT	CATSTGGDTQYF	TRBV15	TRBJ2-3
TGCGCCAGCAGCCAAGAGTACGGAAGGGAAACCCGACTTAGCTCCTATAATTCACCCCTCCACTTT	CASSQEYGRETRLSSYNSPLHF	TRBV4-1	TRBJ1-6
TGTGCCAGTAGTATACTCCCAGGGGGTTCTGGCTCCTACGAGCAGTACTTC	CASSILPGGSGSYEQYF	TRBV19	TRBJ2-7
TGTGCCAGCAGCCAAGAGATGACTAGTGAGCAGTTCTTC	CASSQEMTSEQFF	TRBV4-2	TRBJ2-1
TGTGCCAGTAGTATAGGGACAGGGAAGGGGAATGAAAAACTGTTTTTT	CASSIGTGKGNEKLFF	TRBV19	TRBJ1-4
TGTGCCAGCTCACCCAAGGGGCGGCCCCAGCATTTT	CASSPKGRPQHF	TRBV18	TRBJ1-5
TGTGCCAGCAGCTTCTCTCCCACTGAAGCTTTCTTT	CASSFSPTEAFF	TRBV7-3	TRBJ1-1
TGTGCCAGCAGTTTAGCGTTGGCCGGGGGCTGCGGGGAGACCCAGTACTTC	CASSLALAGGCGETQYF	TRBV6-5	TRBJ2-5
TGTGCCAGCAGCGCAAGTGGGGACAGGGGACCCGAGCAGTACTTC	CASSASGDRGPEQYF	TRBV7-4	TRBJ2-7
TGTGCCACCAGTGATTTGCGGGGGGGGGAAACTGGAAACACCATATATTTT	CATSDLRGGETGNTIYF	TRBV24-1	TRBJ1-3
TGCGCCAGCAGTGCAGAGACAGGGGGGGATCAGCCCCAGCATTTT	CASSAETGGDQPQHF	TRBV10-1	TRBJ1-5
