TGTGCCAGCAGCACGGAGGGGGACATGAACACTGAAGCTTTCTTT	CASSTEGDMNTEAFF	TRBV5-5	TRBJ1-1
TGTGCCAGCAGCCGGGAGACTGAAGCTTTCTTT	CASSRETEAFF	TRBV7-4	TRBJ1-1
TGTGCCAGCAGCGTCAAGGGTAGTGAAAAACTGTTTTTT	CASSVKGSEKLFF	TRBV7-3	TRBJ1-4
TGTGCCAGCAGTTCTCCCAGGGCTAATGAGCAGTTCTTC	CASSSPRANEQFF	TRBV27	TRBJ2-1
TGTGCCAGCAGTTACCCGGGACTTCCTTCCCAGTACTTC	CASSYPGLPSQYF	TRBV6-3	TRBJ2-5
TGCAGTGCTAGTAGGGGACACATAGGGGGACTCGAGCAGTACTTC	CSASRGHIGGLEQYF	TRBV20-1	TRBJ2-7
TGTGCCAGCTCAACCTTTACAGCTGTGCCACCTCCGGAGAACACCGGGGAGCTGTTTTTT	CASSTFTAVPPPENTGELFF	TRBV18	TRBJ2-2
TGTGCCAGCAGAGCAGATTGGGGTGAGCAGTTCTTC	CASRADWGEQFF	TRBV6-5	TRBJ2-1
TGTGCCAGCAGCTTAGTTTGCAGACAATATAGCAATCAGCCCCAGCATTTT	CASSLVCRQYSNQPQHF	TRBV7-2	TRBJ1-5
TGCAGTGCCACGGGGGGGATTCCCACAGATACGCAGTATTTT	CSATGGIPTDTQYF	TRBV20-1	TRBJ2-3
TGTGCCAGCAGCCTCTTTAGGGGGACTAACTATGGCTACACCTTC	CASSLFRGTNYGYTF	TRBV7-2	TRBJ1-2
TGTGCCAGTAGTATCTGGACGTTCGGGCGTAATCAGCCCCAGCATTTT	CASSIWTFGRNQPQHF	TRBV19	TRBJ1-5
TGTGCCAGCAGATTCATTAAAATGAGCTACGAGCAGTACTTC	CASRFIKMSYEQYF	TRBV7-2	TRBJ2-7
TGTGCCAGCAGTTCCCCTGGACAGGGACAAGGTTCATATCAGCCCCAGCATTTT	CASSSPGQGQGSYQPQHF	TRBV6-5	TRBJ1-5
TGTGCCAGCAGCCTTTCCCCGGGCTACAATGAGCAGTTCTTC	CASSLSPGYNEQFF	TRBV5-4	TRBJ2-1
TGCGCCAGCAGCGGGGACGGTAGGAATACGCAGTATTTT	CASSGDGRNTQYF	TRBV5-1	TRBJ2-3
TGCAGTGCGACAGGGTTCAAGGAAAACATTCAGTACTTC	CSATGFKENIQYF	TRBV20-1	TRBJ2-4
TGCAGCGTTGAGTTACCGGGACAGGGTAATGAAAAACTGTTTTTT	CSVELPGQGNEKLFF	TRBV29-1	TRBJ1-4
TGTGCCAGCAGTTACTCGTTTTCGGATTTCTTC	CASSYSFSDFF	TRBV6-3	TRBJ2-1
TGTGCCAGCAGTAAGCTAGCGGGAGACAATGAGCAGTTCTTC	CASSKLAGDNEQFF	TRBV27	TRBJ2-1
TGTGCCAGCAGCCACAGGGGCGTAAATGAAAAACTGTTTTTT	CASSHRGVNEKLFF	TRBV13	TRBJ1-4
TGTGCCAGCAGCTACCCGGTTCCCGGGACTAGCGGGAGAGATACGCAGTATTTT	CASSYPVPGTSGRDTQYF	TRBV7-9	TRBJ2-3
TGTGCCACCAGTGATTCGGGGAACACAGGGGGGGGTACTAAGGGTGAAAAACTGTTTTTT	CATSDSGNTGGGTKGEKLFF	TRBV24-1	TRBJ1-4
TGTGCCAGCAGCCGGGACAGGATCGGGAGGGACCCTAATGAAAAACTGTTTTTT	CASSRDRIGRDPNEKLFF	TRBV7-7	TRBJ1-4
TGTGCCACCAGTGATGTTCTAGAAGAGAGCTCCTACAATGAGCAGTTCTTC	CATSDVLEESSYNEQFF	TRBV24-1	TRBJ2-1
TGTGCCAGCTGGGTGCGTGAGGGGGATGAGCAGTTCTTC	CASWVREGDEQFF	TRBV6-5	TRBJ2-1
TGTGCCAGCAGCTTAGCGCCTCGCGGGAACCCCTACGAGCAGTACTTC	CASSLAPRGNPYEQYF	TRBV7-4	TRBJ2-7
TGTGCCAGCAGCGGGTTGGACCATCATGGCTACACCTTC	CASSGLDHHGYTF	TRBV9	TRBJ1-2
TGTGCCAGCAGTGATTCCCTAGCGGGTAATGAGCAGTTCTTC	CASSDSLAGNEQFF	TRBV2	TRBJ2-1
TGTGCCAGCAGCCCTATGGGGGATGAAGCTTTCTTT	CASSPMGDEAFF	TRBV3-1	TRBJ1-1
TGTGCCAGCAGCAACTTCCAGAGGGTGAACACTGAAGCTTTCTTT	CASSNFQRVNTEAFF	TRBV7-9	TRBJ1-1
TGTGCCAGCAGTGACGGGACCTACGAGCAGTACTTC	CASSDGTYEQYF	TRBV25-1	TRBJ2-7
TGTGCCACCAGCAAAGCTCATCCGCCGGGACTAGCGGGCTCCTCCTACAATGAGCAGTTCTTC	CATSKAHPPGLAGSSYNEQFF	TRBV15	TRBJ2-1
TGTGCCAGCCCCAGGACAGGGACGGTTGGCAATCAGCCCCAGCATTTT	CASPRTGTVGNQPQHF	TRBV7-3	TRBJ1-5
TGTGCCAGCAGTGGAACTAGGTCCGAGACCCAGTACTTC	CASSGTRSETQYF	TRBV6-4	TRBJ2-5
TGTGCCAGCAGGCCAGTCTATGGCTACACCTTC	CASRPVYGYTF	TRBV6-1	TRBJ1-2
TGTGCCAGCAGCAAGGACATGGTGCCATACGAGCAGTACTTC	CASSKDMVPYEQYF	TRBV7-2	TRBJ2-7
TGTGCCAGCAGTGCCATTCAGGGAATGGGCTACGAGCAGTACTTC	CASSAIQGMGYEQYF	TRBV6-4	TRBJ2-7
TGCAGCGCATCCTCGAGGCCACAGAGCGAGCAGTACTTC	CSASSRPQSEQYF	TRBV29-1	TRBJ2-7
TGTGCCAGCAGCGTCCGGGATGATTCCTATGAGCAGTTCTTC	CASSVRDDSYEQFF	TRBV7-9	TRBJ2-1
TGTGCCATTGGGTGTCCGACAGATGAGCAGTTCTTC	CAIGCPTDEQFF	TRBV25-1	TRBJ2-1
TGTGCCAGCAGCCAAGTCTATAACAACAGGGGGTCGGAGTATAGCAATCAGCCCCAGCATTTT	CASSQVYNNRGSEYSNQPQHF	TRBV3-1	TRBJ1-5
TGCGCCAGCAGCTTGGTACCGACAACGCGGGGCGGGCCCGTGAGCTCCTACGAGCAGTACTTC	CASSLVPTTRGGPVSSYEQYF	TRBV5-1	TRBJ2-7
TGTGCCACCAGTGAGTCAGCAACGACAGGGGACCCCCTCCACTTT	CATSESATTGDPLHF	TRBV24-1	TRBJ1-6
TGTGCCAGCAGCTTAGCCGGGACTGTTTCAGATACGCAGTATTTT	CASSLAGTVSDTQYF	TRBV7-8	TRBJ2-3
TGTGCCAGCAGGTGTCTGGGACAGGTCGTTAATTCACCCCTCCACTTT	CASRCLGQVVNSPLHF	TRBV11-3	TRBJ1-6
TGTGCCATCATCTCCGAGCTAGCGGGAACGAACACCGGGGAGCTGTTTTTT	CAIISELAGTNTGELFF	TRBV10-3	TRBJ2-2
TGTGCCAGTAGTATAGATGAACGGACAGGGTCAGATGGCTACACCTTC	CASSIDERTGSDGYTF	TRBV19	TRBJ1-2
TGTGCCAGCAGTGACTCCGCAGGGGGTCAGCCCCAGCATTTT	CASSDSAGGQPQHF	TRBV6-4	TRBJ1-5
TGTGCCCTTGGGAGATCCTACAATGAGCAGTTCTTC	CALGRSYNEQFF	TRBV5-5	TRBJ2-1
TGTGCCAGCAGCGGGCGACGAAGGGGCTCCACTGGCTACACCTTC	CASSGRRRGSTGYTF	TRBV9	TRBJ1-2
TGCAGTGCCCCAGCCGACGGGACTCTGGGGTCCTACGAGCAGTACTTC	CSAPADGTLGSYEQYF	TRBV20-1	TRBJ2-7
TGTGCCAGCAGCTTCGGCTTCACAGATACGCAGTATTTT	CASSFGFTDTQYF	TRBV7-2	TRBJ2-3
TGTGCCAGTTCCGGGACAGGGGGGGCTTTCTTT	CASSGTGGAFF	TRBV28	TRBJ1-1
TGCAGTGCTGTTCGGTGGGGTCCCTCCTACGAGCAGTACTTC	CSAVRWGPSYEQYF	TRBV20-1	TRBJ2-7
TGCGCCAGCAGCCAGTTCCCAGGGAGTTACGAGCAGTACTTC	CASSQFPGSYEQYF	TRBV4-1	TRBJ2-7
TGCAGCGTTGCGGCGGTAGATTCAGATACGCAGTATTTT	CSVAAVDSDTQYF	TRBV29-1	TRBJ2-3
TGTGCCAGCAGTGAGACCCTCGGGGTGGACACCGGGGAGCTGTTTTTT	CASSETLGVDTGELFF	TRBV6-4	TRBJ2-2
TGTGCCAGCAGAAGCCTCGGGTGGTCCTACAATGAGCAGTTCTTC	CASRSLGWSYNEQFF	TRBV11-2	TRBJ2-1
TGTGCCAGTAGTAGGGGGCCCGTGAATCAGCCCCAGCATTTT	CASSRGPVNQPQHF	TRBV19	TRBJ1-5
TGCGCCAGCAGTGATCCCGGGGGGGGACTCGGCTCTGGGGCCAACGTCCTGACTTTC	CASSDPGGGLGSGANVLTF	TRBV10-1	TRBJ2-6
TGTGCCAGCAGCTTAGTGACAGGAGGAGGGAATTCGCAGCCCCAGCATTTT	CASSLVTGGGNSQPQHF	TRBV7-6	TRBJ1-5
TGCAGTGCTCCCCCAGTTAACAATGAGCAGTTCTTC	CSAPPVNNEQFF	TRBV20-1	TRBJ2-1
TGTGCCAGCAGTTACCAGGGGATCGAGCAGTACTTC	CASSYQGIEQYF	TRBV6-2	TRBJ2-7
TGTCGATGCGACAGGGGGGGGAACACTGAAGCTTTCTTT	CRCDRGGNTEAFF	TRBV11-1	TRBJ1-1
TGTGCCAGCAGCTTTCGCGGGGGCTACGAGCAGTACTTC	CASSFRGGYEQYF	TRBV7-9	TRBJ2-7
TGTGCCAGCATGACAGCCATGGAACCCTACGAGCAGTACTTC	CASMTAMEPYEQYF	TRBV6-4	TRBJ2-7
TGCATCCCCGGGACAGAGGAGAGTGGCCTCCACTTT	CIPGTEESGLHF	TRBV5-1	TRBJ1-6
TGTGCCAGCAGTGAAACGGGAGCCACCTACGAGCAGTACTTC	CASSETGATYEQYF	TRBV6-4	TRBJ2-7
TGTGCCAGCAGCCAAGCTTCTCGACAGGGATGCAATCAGCCCCAGCATTTT	CASSQASRQGCNQPQHF	TRBV14	TRBJ1-5
TGCGCCAGCAGCCAACCACGGGGACTAGACTATGGCTACACCTTC	CASSQPRGLDYGYTF	TRBV4-1	TRBJ1-2
TGTGCCAGCAGTGGGGGACGGGAGCCCCAGCATTTT	CASSGGREPQHF	TRBV27	TRBJ1-5
TGCGCCAGCAGCTCGGCTACGGGGGGCGCTAGCACAGATACGCAGTATTTT	CASSSATGGASTDTQYF	TRBV5-1	TRBJ2-3
TGTGCCAGCAGCATCAGGGGGCGCAATCAGCCCCAGCATTTT	CASSIRGRNQPQHF	TRBV13	TRBJ1-5
TGTGCCACCAGTGATTTTTTGGGGGTCGAGTGCGAAAAACTGTTTTTT	CATSDFLGVECEKLFF	TRBV24-1	TRBJ1-4
TGTGCCAGCAGTAGGGGGACCAGGGAGACCCAGTACTTC	CASSRGTRETQYF	TRBV5-6	TRBJ2-5
TGTGCCAGCAGTAAAGCGATGACAGAGGGGCGACAAGAGACCCAGTACTTC	CASSKAMTEGRQETQYF	TRBV27	TRBJ2-5
TGCGTGGGGGGGAGTCTCTACGAGCAGTACTTC	CVGGSLYEQYF	TRBV5-1	TRBJ2-7
TGTGCCAGCAGTCAGTGGGAGGGGAGAAACAACGCCTACAATGAGCAGTTCTTC	CASSQWEGRNNAYNEQFF	TRBV27	TRBJ2-1
TGTGCCAGCATCTCGCGGCCGCTCAATGAGCAGTTCTTC	CASISRPLNEQFF	TRBV2	TRBJ2-1
TGCGCCAGCAGCCAAGGACAGGGGTTTTGGGGCAATCAGCCCCAGCATTTT	CASSQGQGFWGNQPQHF	TRBV4-1	TRBJ1-5
TGTGCCAGCAGTGAAGCGCGGCCGGCAGGGGACTATGGCTACACCTTC	CASSEARPAGDYGYTF	TRBV6-1	TRBJ1-2
TGTGCCAGCAGCTTAGCTCACAGGGGGCGGGTAATTGGCTACACCTTC	CASSLAHRGRVIGYTF	TRBV11-3	TRBJ1-2
TGTGCTAGTGGTTACGGACCTAGAGAGCAGTACTTC	CASGYGPREQYF	TRBV12-5	TRBJ2-7
TGCAGTGCTGTTAGACTCACTGAAGCTTTCTTT	CSAVRLTEAFF	TRBV20-1	TRBJ1-1
TGTGCTAGCAGCGTTCGATTGACAGGTTACGAGCAGTACTTC	CASSVRLTGYEQYF	TRBV7-7	TRBJ2-7
TGTGCTACAGTTGCAGGGACAACGGCCCAGCATTTT	CATVAGTTAQHF	TRBV28	TRBJ1-5
TGTGCCAGCAGTGTGGGACAGGGGGCGTCTGGAGACGAGCAGTACTTC	CASSVGQGASGDEQYF	TRBV27	TRBJ2-7
TGTGCCAGCAGCTTGCACACACCGACTGTGGTGTATAATTCACCCCTCCACTTT	CASSLHTPTVVYNSPLHF	TRBV5-5	TRBJ1-6
TGTGCCACCAAATCCGGGACAGGGCCCCCGAAGGGATCAGTGAACACTGAAGCTTTCTTT	CATKSGTGPPKGSVNTEAFF	TRBV24-1	TRBJ1-1
TGTGCCAGCAGGGTACGGAACGAGCAGTACTTC	CASRVRNEQYF	TRBV6-4	TRBJ2-7
TGTGCCACCCGACTCCCCGGGGCTAAATTCTACTATAGCAATCAGCCCCAGCATTTT	CATRLPGAKFYYSNQPQHF	TRBV6-1	TRBJ1-5
TGCAGTGCTAGAATCACTAGCGGGAGGGCTGCCTACGAGCAGTACTTC	CSARITSGRAAYEQYF	TRBV20-1	TRBJ2-7
TGTGCCAGCAGCTTTAAAGGGGGGCCGACAAGCTCCTACGAGCAGTACTTC	CASSFKGGPTSSYEQYF	TRBV7-9	TRBJ2-7
TGTGCCAGCAGCCAAGAACGCGGACAGCTGTATGGCTACACCTTC	CASSQERGQLYGYTF	TRBV9	TRBJ1-2
TGTGCCAGCAGCAGCGGGACGATGGCAACTAATGAAAAACTGTTTTTT	CASSSGTMATNEKLFF	TRBV12-3	TRBJ1-4
TGTGCCAGCAGTTTATCGAAAGGGCGGAGGGACGAGCAGTACTTC	CASSLSKGRRDEQYF	TRBV27	TRBJ2-7
TGTGCCAGCAGCCAAGCAGGACCCGGGACGCCTTCTGGAAACACCATATATTTT	CASSQAGPGTPSGNTIYF	TRBV3-1	TRBJ1-3
TGTGCCAGTGGAAGGGGAGAGACCCAGTACTTC	CASGRGETQYF	TRBV2	TRBJ2-5
TGTGCCTGGAGTTTAGGGACTAGCGGGGGGAAAGTCTTC	CAWSLGTSGGKVF	TRBV30	TRBJ2-1
TGTGCCAGCAGTTCGGAGATTCCACAGGATTGGGCCCATCAGCCCCAGCATTTT	CASSSEIPQDWAHQPQHF	TRBV6-5	TRBJ1-5
TGTGCCAGCAGGGCAGGGACAGGGGTTAACTATGGCTACACCTTC	CASRAGTGVNYGYTF	TRBV2	TRBJ1-2
TGCGCCAGCAGCTTGATGGGGACTAGCGGGCTTAATAATGAGCAGTTCTTC	CASSLMGTSGLNNEQFF	TRBV5-1	TRBJ2-1
TGTGCCAGCAGCTGCTTATCACAGGGACTCTACGAGCAGTACTTC	CASSCLSQGLYEQYF	TRBV7-9	TRBJ2-7
TGCGCCAGCAGCTGGGGTGGTAGGGGTTCCGCTGAAGCTTTCTTT	CASSWGGRGSAEAFF	TRBV5-1	TRBJ1-1
TGTGCCAGCAGTGAATGTGTCTCAGGGGGTCAAGAGACCCAGTACTTC	CASSECVSGGQETQYF	TRBV25-1	TRBJ2-5
TGTGCCAGCAGTGAACTCGGGACCGCGGGAGAATTTTACGAGCAGTACTTC	CASSELGTAGEFYEQYF	TRBV6-1	TRBJ2-7
TGTGCCAGTAGACCGGGGGAGAACCATGAAAAACTGTTTTTT	CASRPGENHEKLFF	TRBV19	TRBJ1-4
TGTGCCAGCAGCGGTGGGGACCGAAACACCATATATTTT	CASSGGDRNTIYF	TRBV5-4	TRBJ1-3
TGTGCCAGCAGCGGTGTCGGGGCACTCCACTTT	CASSGVGALHF	TRBV7-3	TRBJ1-6
TGTGCCAGCAGCCAGCGGGGGGGTAGGTTGGTCTTC	CASSQRGGRLVF	TRBV14	TRBJ2-1
TGTGCCAGCAGGGGGACAGGTCAGCCCCAGCATTTT	CASRGTGQPQHF	TRBV6-1	TRBJ1-5
TGTGCCAGCAGCCCGGCAGGCCTGACCGGGGAGCTGTTTTTT	CASSPAGLTGELFF	TRBV9	TRBJ2-2
TGTGCCAGCAGCACAACTCGGGTTGAGCAGTTCTTC	CASSTTRVEQFF	TRBV13	TRBJ2-1
TGTGCCAGCAGCTATGCCAGCGATGAAAAACTGTTTTTT	CASSYASDEKLFF	TRBV13	TRBJ1-4
TGCGCCAGCAGCTTGTTCCCCACTAGCGGGAGCAGGGGGGAGTACTTC	CASSLFPTSGSRGEYF	TRBV5-1	TRBJ2-5
TGCAAAGGTACTGGAGGACAGGGGGGCGATCAGCCCCAGCATTTT	CKGTGGQGGDQPQHF	TRBV20-1	TRBJ1-5
TGTGCCAGCAGCCCCGGGGTCTCTGGAAACACCATATATTTT	CASSPGVSGNTIYF	TRBV9	TRBJ1-3
TGTGCCAGCACCCGACTAGCGGGAGAGAACTATGGCTACACCTTC	CASTRLAGENYGYTF	TRBV9	TRBJ1-2
TGTGCCAGCAGCGGGGGAGGGACGCCAGAGACCCAGTACTTC	CASSGGGTPETQYF	TRBV7-2	TRBJ2-5
TGTGCCAGCAGTCGGAGAATTGGGGGGCCGACTAACTATGGCTACACCTTC	CASSRRIGGPTNYGYTF	TRBV27	TRBJ1-2
TGTGCCAGCAGCCGCACGCGCGGGAGTGAAACGCAGTATTTT	CASSRTRGSETQYF	TRBV9	TRBJ2-3
TGTGCCAGCAGCGTCTACAGGGGGAGGTATAGCAATCAGCCCCAGCATTTT	CASSVYRGRYSNQPQHF	TRBV7-8	TRBJ1-5
TGTGCCAGCACAGCCGGGACTCATAACTATGGCTACACCTTC	CASTAGTHNYGYTF	TRBV12-3	TRBJ1-2
TGTGCCAGTAGTATAGGCCCCGGGACAGTTAAAGTAGCTGAAGCTTTCTTT	CASSIGPGTVKVAEAFF	TRBV19	TRBJ1-1
TGCAGCGTAGCGGGGGGTGGCACCGGGGAGCTGTTTTTT	CSVAGGGTGELFF	TRBV29-1	TRBJ2-2
TGTGCCAGCAGCCAGACTAGCGGGGGGGCCGGTACAGATACGCAGTATTTT	CASSQTSGGAGTDTQYF	TRBV14	TRBJ2-3
TGTGCCAGCACCCTTGCTGGGGGTCAGCCCCAGCATTTT	CASTLAGGQPQHF	TRBV28	TRBJ1-5
TGCGCCAGCAGCGACGCCAGCACTGAAGCTTTCTTT	CASSDASTEAFF	TRBV5-1	TRBJ1-1
TGCGCCAGCACCCCTGTGACGGGGGGGAGCGCCTACGAGCAGTACTTC	CASTPVTGGSAYEQYF	TRBV10-2	TRBJ2-7
TGTGCCAGCACTAGCGGGATAGACTCCTACGAGCAGTACTTC	CASTSGIDSYEQYF	TRBV3-1	TRBJ2-7
TGTGCCAGCAGCCACCGAACTAGCGGACACAATGAGCAGTTCTTC	CASSHRTSGHNEQFF	TRBV7-2	TRBJ2-1
TGTGCCAGCATGCGAGACCCCAATGAAAAACTGTTTTTT	CASMRDPNEKLFF	TRBV6-4	TRBJ1-4
TGTGCCAGCAGCCACAGACAGTCCCTTCAGCCCCAGCATTTT	CASSHRQSLQPQHF	TRBV4-2	TRBJ1-5
TGTGCCAGCAGCCTGCAGTTGGGACAGCCGTATGAGCAGTTCTTC	CASSLQLGQPYEQFF	TRBV9	TRBJ2-1
TGTGCCAGCAGCCATGGTCGAATGGAACCGGACGGCGAGCAGTACTTC	CASSHGRMEPDGEQYF	TRBV14	TRBJ2-7
TGTGCCAGCAGCCCACAGAGACGCGGGGAGCTGTTTTTT	CASSPQRRGELFF	TRBV7-9	TRBJ2-2
TGTGCCAGTCACCGCCGGGACAGGGTTTGCAATCAGCCCCAGCATTTT	CASHRRDRVCNQPQHF	TRBV25-1	TRBJ1-5
TGTGCCACGCACCGAGTTAGCGATGGCTACACCTTC	CATHRVSDGYTF	TRBV24-1	TRBJ1-2
TGTGCCACCAGTGATATAGGGGTCTATGGCTACACCTTC	CATSDIGVYGYTF	TRBV24-1	TRBJ1-2
TGTGCCAGCAGCCTGGAGGGCAGGAGCTCCTACAATGAGCAGTTCTTC	CASSLEGRSSYNEQFF	TRBV13	TRBJ2-1
TGCAGTAAGTGCCGGGGGGTGACCTACGAGCAGTACTTC	CSKCRGVTYEQYF	TRBV20-1	TRBJ2-7
TGTGCCAGCAGCTTTGGGGACAGGGGGCAGTGGTACGAGCAGTACTTC	CASSFGDRGQWYEQYF	TRBV13	TRBJ2-7
TGTGCCCCCGGAGGGGGTACCGAGCAGTACTTC	CAPGGGTEQYF	TRBV12-5	TRBJ2-7
TGTGCCTGGAGTGTACCCCACAGGGAGCTACCGAGCCTCTTT	CAWSVPHRELPSLF	TRBV30	TRBJ1-1
TGTGCCAGCAGTTACACTGTGGACAGAAAAAACATTCAGTACTTC	CASSYTVDRKNIQYF	TRBV6-5	TRBJ2-4
TGCAGTGCTAGAGATCTCAAAGGTGGGGACCTTAAGGCCAACGTCCTGACTTTC	CSARDLKGGDLKANVLTF	TRBV20-1	TRBJ2-6
TGTGCCAGCACGTCCGAAGAAGGGGGTGGAAGCTATGGCTACACCTTC	CASTSEEGGGSYGYTF	TRBV7-9	TRBJ1-2
TGCGCCGTTGGGACAGAGGATCAGCCCCAGCATTTT	CAVGTEDQPQHF	TRBV10-2	TRBJ1-5
TGCAAACCCCCCCGACAGCCCACCTTC	CKPPRQPTF	TRBV20-1	TRBJ1-2
TGTGCCATCAGCGAGAGCCCTGGCAATACGCAGTATTTT	CAISESPGNTQYF	TRBV10-3	TRBJ2-3
TGTGCCAGCAGCCCAAGGACAGTAGGGGGAGACTACACCTTC	CASSPRTVGGDYTF	TRBV5-4	TRBJ1-2
TGTGCCAGCAGCAGACTAGGGGAGACCCAGTACTTC	CASSRLGETQYF	TRBV13	TRBJ2-5
TGTGCCAGCAGCTGGGCAGTCATGAACACTGAAGCTTTCTTT	CASSWAVMNTEAFF	TRBV7-3	TRBJ1-1
TGTGCCAGCAGCTCCCCCCTTCGGGGTTTGGGGGGATACGAGCAGTACTTC	CASSSPLRGLGGYEQYF	TRBV13	TRBJ2-7
TGCAGTGCAATGACGGGGGGGAGCAATCAGCCCCAGCATTTT	CSAMTGGSNQPQHF	TRBV20-1	TRBJ1-5
TGCAGTGCTAGACAGACCGGGACAGTGGAGACTGAAGCTTTCTTT	CSARQTGTVETEAFF	TRBV20-1	TRBJ1-1
TGTGCCAGCAGTGACTCGAGGAATAGCGGACGAAATGAGCAGTTCTTC	CASSDSRNSGRNEQFF	TRBV6-4	TRBJ2-1
TGTGCCAGCAGCCTAGGGGACAGCGGGGGCTACACCTTC	CASSLGDSGGYTF	TRBV5-4	TRBJ1-2
TGTAGGGGAAACAATGAGCAGTTCTTC	CRGNNEQFF	TRBV10-3	TRBJ2-1
TGTGCCAGCAGCAATACCCGACCGACAGGGTCTACAGATACGCAGTATTTT	CASSNTRPTGSTDTQYF	TRBV11-1	TRBJ2-3
TGTGCCAGCAGCCCGGGGGGGGCGGGATACAATGAGCAGTTCTTC	CASSPGGAGYNEQFF	TRBV7-9	TRBJ2-1
TGTGCCAGCAGTTACTCGAAGGGGGTGCGGGCCTCCTATAATTCACCCCTCCACTTT	CASSYSKGVRASYNSPLHF	TRBV6-5	TRBJ1-6
TGTGCCAGCAGCTTAATAAGCCTGGGGGGGACCACAGATACGCAGTATTTT	CASSLISLGGTTDTQYF	TRBV11-2	TRBJ2-3
TGTGCCAGTAGTATAGGCCCTAGCGGGAGGCAAGAGACCCAGTACTTC	CASSIGPSGRQETQYF	TRBV19	TRBJ2-5
TGCAGTGCTAGAGGGAGAAATCGGGGGGGTATAGGGACCCAGTACTTC	CSARGRNRGGIGTQYF	TRBV20-1	TRBJ2-5
TGCGCCAGCAGACCCGACAGGGGGAACTACGAGCAGTACTTC	CASRPDRGNYEQYF	TRBV4-1	TRBJ2-7
TGTGCCAGCCGGGGGTACGAGCAGTACTTC	CASRGYEQYF	TRBV4-2	TRBJ2-7
TGTGCCAGCAGTTTATGCTCGAGACAGGAGAACTATGGCTACACCTTC	CASSLCSRQENYGYTF	TRBV28	TRBJ1-2
TGTGCCAGCACCCAGCCGAGGCGCTATGGCTACACCTTC	CASTQPRRYGYTF	TRBV6-5	TRBJ1-2
TGCAGTGCATGCCCAACTAATGAAAAACTGTTTTTT	CSACPTNEKLFF	TRBV20-1	TRBJ1-4
TGTGCCAGCAGTACGGAGAGCGTCTTC	CASSTESVF	TRBV27	TRBJ2-1
TGTGCCAGCAGTAGGGGGAAAACTGCGCAGTATTTT	CASSRGKTAQYF	TRBV12-3	TRBJ2-3
TGTGCCAGCAGCTTGGCCCCAGCGGGACTGTGGCAATATGACAATGAGCAGTTCTTC	CASSLAPAGLWQYDNEQFF	TRBV5-6	TRBJ2-1
TGTGCCAGCGACCCGGCCTACACCTTC	CASDPAYTF	TRBV7-4	TRBJ1-2
TGCGCCAGCAGTCTAGGGAGGGTGAACACTGAAGCTTTCTTT	CASSLGRVNTEAFF	TRBV10-1	TRBJ1-1
TGTGCCAGCAGCGGCGGGTTGAGTCGGTTCCGGAGACAAGAGACCCAGTACTTC	CASSGGLSRFRRQETQYF	TRBV9	TRBJ2-5
TGTGCCAGCAGTTTACCTGTCCACAGGCCCCAAAAACTGTTTTTT	CASSLPVHRPQKLFF	TRBV28	TRBJ1-4
TGTGCCAGCAGCATCCCAGGGGAAATAGAACCTGAGCAGTTCTTC	CASSIPGEIEPEQFF	TRBV7-4	TRBJ2-1
TGTGCCAGCAGCTTACGATTACCAGGGGACAGGGGGCAGCCCCAGCATTTT	CASSLRLPGDRGQPQHF	TRBV7-6	TRBJ1-5
TGTGCCAGCAGTGGGCAGGGCGAGCAGTACTTC	CASSGQGEQYF	TRBV28	TRBJ2-7
TGTGCCAGCAGCTTAGAGGCGACAGAGGGCACCGGGGAGCTGTTTTTT	CASSLEATEGTGELFF	TRBV11-2	TRBJ2-2
TGTGCCTGGAGCGAGCGGGAAGGACAGTGTTCCACCGAGCAGTACTTC	CAWSEREGQCSTEQYF	TRBV30	TRBJ2-7
TGTGCCTGGATTCTCCACAGGGATTCCTACGAGCAGTACTTC	CAWILHRDSYEQYF	TRBV30	TRBJ2-7
TGTGCCAGCAGTAGGGACAGCCCAGGCGAGCAGTACTTC	CASSRDSPGEQYF	TRBV7-4	TRBJ2-7
TGCAGTGCTAGAGAGAAGGGGGTCGTCCGGGACAGGGGTAATGAAAAACTGTTTTTT	CSAREKGVVRDRGNEKLFF	TRBV20-1	TRBJ1-4
TGTGCCTTCCGGGACGGTGCCAAAAACATTCAGTACTTC	CAFRDGAKNIQYF	TRBV27	TRBJ2-4
TGTGCCAGCAGCCCAAGCCATGGGGGGGCCCATGAGCAGTTCTTC	CASSPSHGGAHEQFF	TRBV5-6	TRBJ2-1
TGTGCCAGCACCTCCCTTAGGAGAAATGAGCAGTTCTTC	CASTSLRRNEQFF	TRBV6-1	TRBJ2-1
TGTGCTAGCAGCTTAGCAATTAGGGCTCGACTAGTGCGGGGTTGTGAGCAGTTCTTC	CASSLAIRARLVRGCEQFF	TRBV7-7	TRBJ2-1
TGTGCCAGCAGCCAAGACAGGGAAGCTGAAGCTTTCTTT	CASSQDREAEAFF	TRBV3-1	TRBJ1-1
TGTGCCAGCCGAGAACAGGGCAATGAAAAACTGTTTTTT	CASREQGNEKLFF	TRBV6-2	TRBJ1-4
TGTGCCAGATTCCAGGGCCGCGAAAACTATGGCTACACCTTC	CARFQGRENYGYTF	TRBV30	TRBJ1-2
TGTGCCTGGAGTCGTAGGACAGGGCACTGCACTGAAGCTTTCTTT	CAWSRRTGHCTEAFF	TRBV30	TRBJ1-1
TGCGCCAGCAGCCGAAGCCAACCGGGACAGGGGCTGGATAGCAATCAGCCCCAGCATTTT	CASSRSQPGQGLDSNQPQHF	TRBV4-1	TRBJ1-5
TGTGCCAGCAGTGGGAAACCAGGGCCGCCGAACACTGAAGCTTTCTTT	CASSGKPGPPNTEAFF	TRBV6-1	TRBJ1-1
TGTGCCTGGAGTGTACCGGGACAGGGGCGTTTTGTCCTCGGGGAGCTGTTTTTT	CAWSVPGQGRFVLGELFF	TRBV30	TRBJ2-2
TGTGCCAGCAGCCCGACAGGGGGAGCTTTCTTT	CASSPTGGAFF	TRBV7-9	TRBJ1-1
TGTGCCAGCAGTGTTTGCAAGGGAGGGTCGGTGGATACGCAGTATTTT	CASSVCKGGSVDTQYF	TRBV2	TRBJ2-3
TGTGCCAGCAGCGGAGCTCCAGGGCATTACGAGCAGTACTTC	CASSGAPGHYEQYF	TRBV7-4	TRBJ2-7
TGCGCCAGCACTAGGGATCCCCGAGCAGCCTACGAGCAGTACTTC	CASTRDPRAAYEQYF	TRBV5-1	TRBJ2-7
TGCAGCGTTTCCCACAGGGAGCGTGGAGCACAGTCACCCCTCCACTTT	CSVSHRERGAQSPLHF	TRBV29-1	TRBJ1-6
TGTGCCAGCAGGACAGGGTACGAGCAGTACTTC	CASRTGYEQYF	TRBV6-1	TRBJ2-7
TGCGCCAGCAGCTTGGTTGGCACCTCGGGCGGCTACACCTTC	CASSLVGTSGGYTF	TRBV5-1	TRBJ1-2
TGCGCCAGCAGTGAGCAAGGCCCGTTGGGAGGGACAGATACGCAGTATTTT	CASSEQGPLGGTDTQYF	TRBV10-1	TRBJ2-3
TGCAGGGGATGCCCTAATTCACCCCTCCACTTT	CRGCPNSPLHF	TRBV20-1	TRBJ1-6
TGCGCCAGCAGCTTGAGGGGGTACGAGCAGTACTTC	CASSLRGYEQYF	TRBV5-1	TRBJ2-7
TGTGCCAGCAGGAGGCAGGTCAGGGGCGGGAGCAATCAGCCCCAGCATTTT	CASRRQVRGGSNQPQHF	TRBV6-4	TRBJ1-5
TGTGCCAGCAGCCAAGTGCACTGGACTAGCGGGGGAAGGCAGTTCTTC	CASSQVHWTSGGRQFF	TRBV3-1	TRBJ2-1
TGTGCCAGCAGCATGCCCGGGACTAGGGTCACAGATACGCAGTATTTT	CASSMPGTRVTDTQYF	TRBV7-4	TRBJ2-3
TGTGCCAGCAGTTTTACCCTTTACAGGGGCCCTTTCACAGATACGCAGTATTTT	CASSFTLYRGPFTDTQYF	TRBV12-3	TRBJ2-3
TGTGCCAGCAGTGAAGCGCAGGGGGGGGGTTCGGACTACGAGCAGTACTTC	CASSEAQGGGSDYEQYF	TRBV6-1	TRBJ2-7
TGTGCCAGCAGTGACTCAAGGAGCGGGACTCGCCAGCCCTACAATGAGCAGTTCTTC	CASSDSRSGTRQPYNEQFF	TRBV6-4	TRBJ2-1
TGTGCCACCGTGTACAACAGGCGGGACAGGGACTATGGCTACACCTTC	CATVYNRRDRDYGYTF	TRBV24-1	TRBJ1-2
TGCAGTGCTAACTCCCCGGGGACAGGTGCGAACACCGGGGAGCTGTTTTTT	CSANSPGTGANTGELFF	TRBV20-1	TRBJ2-2
TGCAGTGCTAGGTCGGCTACTTACAATGAGCAGTTCTTC	CSARSATYNEQFF	TRBV20-1	TRBJ2-1
TGTGCCATCGGGACCTTCAAAGGCTCCTACGAGCAGTACTTC	CAIGTFKGSYEQYF	TRBV10-3	TRBJ2-7
TGCGCCAGCAGCGGGTCTCTGGGGACGCCGAACTTTATCTATGGCTACACCTTC	CASSGSLGTPNFIYGYTF	TRBV5-1	TRBJ1-2
TGTGCCAGCAGCGGGACAGGGGAGGGCTCTGGGGCCAACGTCCTGACTTTC	CASSGTGEGSGANVLTF	TRBV7-4	TRBJ2-6
TGTGCCAGCAGCCCCCCCGGATTAAGCTCCTACAATGAGCAGTTCTTC	CASSPPGLSSYNEQFF	TRBV13	TRBJ2-1
TGTGCTAGCAGCCGCCTCAGGGCGATATTGAACACTGAAGCTTTCTTT	CASSRLRAILNTEAFF	TRBV7-7	TRBJ1-1
TGTGCCTATCCCCCCCAGACAGGGGATGAAACGGGAAACACCATATATTTT	CAYPPQTGDETGNTIYF	TRBV27	TRBJ1-3
TGTGCCAGCAGCGCAAACGGGGCCACTGAAGCTTTCTTT	CASSANGATEAFF	TRBV7-9	TRBJ1-1
TGTGCCAGCAGCCGGACAGACGAGAGAAAGAACGAGACCCAGTACTTC	CASSRTDERKNETQYF	TRBV6-1	TRBJ2-5
TGTGCCAGCCGCGGGAGGCCGGAGGAGGCGAACACTGAAGCTTTCTTT	CASRGRPEEANTEAFF	TRBV7-3	TRBJ1-1
TGTGCCACCAGTGTGTCGGGGTTAAGCTCCTATAATTCACCCCTCCACTTT	CATSVSGLSSYNSPLHF	TRBV24-1	TRBJ1-6
TGTGCCAGCAGCTTAGTTCCACCGGGGGAGATAAGCTACGAGCAGTACTTC	CASSLVPPGEISYEQYF	TRBV11-2	TRBJ2-7
TGCTATCTCGCTCAGGGACTGGGCCAAGAGACCCAGTACTTC	CYLAQGLGQETQYF	TRBV20-1	TRBJ2-5
TGTGCCAGCACCGCTCCGGACCGGACCACCTACGAGCAGTACTTC	CASTAPDRTTYEQYF	TRBV6-5	TRBJ2-7
TGCAGTGCGCCACAGGTCCTGGGGGACGAGCAGTACTTC	CSAPQVLGDEQYF	TRBV20-1	TRBJ2-7
TGTGCCAGCAGTTGTGGAAGGTTGACAGGGAAGGGGAACACTGAAGCTTTCTTT	CASSCGRLTGKGNTEAFF	TRBV28	TRBJ1-1
TGTGCCAGCTCACCAAGGTTTTCGCGACCCTACGCGAACACCGGGGAGCTGTTTTTT	CASSPRFSRPYANTGELFF	TRBV18	TRBJ2-2
TGCAGTGCTCGGGCCGTTTTGTTCCAAGCTTTCTTT	CSARAVLFQAFF	TRBV20-1	TRBJ1-1
TGTGCCAGCAGTTACTCTCCGGGACAGGGGACAAACTACGAGCAGTACTTC	CASSYSPGQGTNYEQYF	TRBV6-5	TRBJ2-7
TGTGCCAGCAGCTTACCCGCCGGACCGGGGGGGTTGGGGACTCACGAGCAGTACTTC	CASSLPAGPGGLGTHEQYF	TRBV7-9	TRBJ2-7
TGTGCCAGCAGCCAAGCCCAGGGGGAAACGCTGGAAATGAACACTGAAGCTTTCTTT	CASSQAQGETLEMNTEAFF	TRBV14	TRBJ1-1
TGTGCCAGCAGCGTAGGTACGGTGCGGGGCTGGAGCGGGGAGCTGTTTTTT	CASSVGTVRGWSGELFF	TRBV9	TRBJ2-2
TGTGCCAGCAGCCAAAGGGGACAAAGTCACTTCTCCTACGAGCAGTACTTC	CASSQRGQSHFSYEQYF	TRBV13	TRBJ2-7
TGCGCCAGCAGCTTAATTCCAGGGACGCCTAGCACAGATACGCAGTATTTT	CASSLIPGTPSTDTQYF	TRBV5-1	TRBJ2-3
TGTGCCAGCAGTTGGGGTAGAGGGCACCAGGATTGCCGAAATCAGCCCCAGCATTTT	CASSWGRGHQDCRNQPQHF	TRBV27	TRBJ1-5
TGTGCCAGGCTAGGACAAGGGAGGGCCTATAATTCACCCCTCCACTTT	CARLGQGRAYNSPLHF	TRBV6-1	TRBJ1-6
TGTGCCAGCAGTGACCACGGGGACGAGCAGTACTTC	CASSDHGDEQYF	TRBV6-4	TRBJ2-7
TGTGCCAGCAGCCACAGGGAACCTAAAGCTTTCTTT	CASSHREPKAFF	TRBV27	TRBJ1-1
TGTGCCAGCGTCCCGACAGCTCCTAACAATGAGCAGTTCTTC	CASVPTAPNNEQFF	TRBV7-9	TRBJ2-1
TGTGCCAGCAGCGGTAGGGGGGAGTCCTACGAGCAGTACTTC	CASSGRGESYEQYF	TRBV13	TRBJ2-7
TGTGCCTGGCGTACCTGGGTAGATCGGTACGAGCAGTACTTC	CAWRTWVDRYEQYF	TRBV30	TRBJ2-7
TGCGCCAGCAGACAAGAAATGAACACTGAAGCTTTCTTT	CASRQEMNTEAFF	TRBV10-1	TRBJ1-1
TGTGCCAGCAGAGGAGGGTCGCGGCATGAGCAGTTCTTC	CASRGGSRHEQFF	TRBV2	TRBJ2-1
TGTGCCAGCAGCGGTGGCCGGGGGGCTGAAACAACTAATGAAAAACTGTTTTTT	CASSGGRGAETTNEKLFF	TRBV13	TRBJ1-4
TGTGCCACCAGTGATCGGACCTGTTACGAGCAGTACTTC	CATSDRTCYEQYF	TRBV24-1	TRBJ2-7
TGTGCCATGCATGCGGGGTTTCCGAACACCGGGGAGCTGTTTTTT	CAMHAGFPNTGELFF	TRBV3-1	TRBJ2-2
TGTGCCAGCAGCGTAGTTAGGGGGACCTTCTATGGCTACACCTTC	CASSVVRGTFYGYTF	TRBV9	TRBJ1-2
TGCAGTGCCAATGGGCTAGGGGGGAACACTGAAGCTTTCTTT	CSANGLGGNTEAFF	TRBV20-1	TRBJ1-1
TGTGCCAGCACCCGGAGGAATAGAAACGGGGAGCTGTTTTTT	CASTRRNRNGELFF	TRBV7-9	TRBJ2-2
TGTGCCAGCCCCGAAGTCGGGATCGAACTCCAGAGATCCTACAATGAGCAGTTCTTC	CASPEVGIELQRSYNEQFF	TRBV12-3	TRBJ2-1
TGTGCCAGCAGCCGGGTCTGGGGGAGACAAGGAATAATGCCCTACGAGCAGTACTTC	CASSRVWGRQGIMPYEQYF	TRBV7-3	TRBJ2-7
TGTGCCAGCAGCCCCGGACAGGGGGCCCCAGAGGCGAACACTGAAGCTTTCTTT	CASSPGQGAPEANTEAFF	TRBV3-1	TRBJ1-1
TGTGCCAGCAGTCGGTCCAAGGGCTACACCTTC	CASSRSKGYTF	TRBV27	TRBJ1-2
TGCGCCAGCAGCTTGGGGGGGGGTGAAAAACTGTTTTTT	CASSLGGGEKLFF	TRBV5-1	TRBJ1-4
TGCGCCAGAGTAAAAGATCTAGTCTCCTACAATGAGCAGTTCTTC	CARVKDLVSYNEQFF	TRBV10-1	TRBJ2-1
TGTGCCAGCAGTTTATCACCGGACAGGGGCTATAAGGGCACCGGGGAGCTGTTTTTT	CASSLSPDRGYKGTGELFF	TRBV12-4	TRBJ2-2
TGTGCCAGCGGGGACAGGGGGCGCTACACAACGATCTCCTACGAGCAGTACTTC	CASGDRGRYTTISYEQYF	TRBV6-4	TRBJ2-7
TGTGCCAGCAGCAGGACCCACTGCAGGGTGCACACTGAAGCTTTCTTT	CASSRTHCRVHTEAFF	TRBV5-4	TRBJ1-1
TGTGCCAGCAGTTTAGATGAGGGGGACTACGAGCAGTACTTC	CASSLDEGDYEQYF	TRBV27	TRBJ2-7
TGTGCCAGCGAGGGGGTCACAGATACGCAGTATTTT	CASEGVTDTQYF	TRBV6-1	TRBJ2-3
TGTGCCAGCTCACCATTGGGCTTGAACACTGAAGCTTTCTTT	CASSPLGLNTEAFF	TRBV18	TRBJ1-1
TGCGCCAGCAGCCGGGCGGGACAGCCGGGAAACACCATATATTTT	CASSRAGQPGNTIYF	TRBV5-1	TRBJ1-3
TGCAGCGTTGCGGGTCTCAATGAGCAGTTCTTC	CSVAGLNEQFF	TRBV29-1	TRBJ2-1
TGTGCCAGCAGTCTAATGACAGGGCGGGACAATGAGCAGTTCTTC	CASSLMTGRDNEQFF	TRBV9	TRBJ2-1
TGTGCCAGCAGTCCAGGGGACGAGCAGTACTTC	CASSPGDEQYF	TRBV2	TRBJ2-7
TGTGCCACCGCAGGGGGCTGCACCGGGGAGCTGTTTTTT	CATAGGCTGELFF	TRBV5-5	TRBJ2-2
TGTGCCAGCAGCCGGGGAAAAGTAGGTTATAGCAATCAGCCCCAGCATTTT	CASSRGKVGYSNQPQHF	TRBV6-3	TRBJ1-5
TGTGCCAGCAGCCAAGATTGCCTAGCTCTCGAGCAGTACTTC	CASSQDCLALEQYF	TRBV3-1	TRBJ2-7
TGCGCCAGCTCCGGGGAGTCCCCATTCCGGCTACTGAACACTGAAGCTTTCTTT	CASSGESPFRLLNTEAFF	TRBV5-1	TRBJ1-1
TGCGCCAGCAGCCCATCACAGACCCCAGATAGCAATCAGCCCCAGCATTTT	CASSPSQTPDSNQPQHF	TRBV4-1	TRBJ1-5
TGCATCTGGATCCCTTCCACAGATACGCAGTATTTT	CIWIPSTDTQYF	TRBV20-1	TRBJ2-3
TGTGCCAGCAGTTTACCTAATAAGGGTCGCGGGGAGCTGTTTTTT	CASSLPNKGRGELFF	TRBV27	TRBJ2-2
TGTGCCAGCAGTGATGCCCGAGATAACTATGGCTACACCTTC	CASSDARDNYGYTF	TRBV6-1	TRBJ1-2
TGCAGTGCTAGGACCGACAGTGGCCTCGGAGCTAGAGGTGAGCAGTTCTTC	CSARTDSGLGARGEQFF	TRBV20-1	TRBJ2-1
TGTGCCAGCAGCTGGGCCTCCATGAACACTGAAGCTTTCTTT	CASSWASMNTEAFF	TRBV7-2	TRBJ1-1
TGTGCCAGCCAATTGGGTGGGCCTCAGCCCCAGCATTTT	CASQLGGPQPQHF	TRBV27	TRBJ1-5
TGTGCCAGCAGCGGACAGGCAGGCTACGAGCAGTACTTC	CASSGQAGYEQYF	TRBV11-2	TRBJ2-7
TGTGCCATGGCCGGACAGGTGAGCTCTGGGGCCAACGTCCTGACTTTC	CAMAGQVSSGANVLTF	TRBV19	TRBJ2-6
TGTGCCACCAGCATAAGGGACTATGGCTACACCTTC	CATSIRDYGYTF	TRBV15	TRBJ1-2
TGTGCCAGCAGCCAAGATCCTAGCAGCTACAATGAGCAGTTCTTC	CASSQDPSSYNEQFF	TRBV4-2	TRBJ2-1
TGTGCCAGCAGCATAGCGGGAACTTTGAACACCGGGGAGCTGTTTTTT	CASSIAGTLNTGELFF	TRBV7-3	TRBJ2-2
TGTGCCAGCTCCGAAGATAATGAGCAGTTCTTC	CASSEDNEQFF	TRBV6-5	TRBJ2-1
TGTGCCAGCAGCTTAGCGGATCATCTTTCCCTATCCAGGGGGCTAGAGACCCAGTACTTC	CASSLADHLSLSRGLETQYF	TRBV11-2	TRBJ2-5
TGCGCCAGCGTACCCCGGGGTATCTCCCTTGAAAAACTGTTTTTT	CASVPRGISLEKLFF	TRBV10-1	TRBJ1-4
TGTGCCACCAGCAGAGTCGGGGGGTCTGAGGGACTTTCCTACAATGAGCAGTTCTTC	CATSRVGGSEGLSYNEQFF	TRBV15	TRBJ2-1
TGTGCCAGCAGCGTAGGGGGGTATCAGCCCCAGCATTTT	CASSVGGYQPQHF	TRBV9	TRBJ1-5
TGTGCCAGCAACCAGGGCACTGAAGCTTTCTTT	CASNQGTEAFF	TRBV6-4	TRBJ1-1
TGTGAAGAGGTACTCGGGACTGAAGTGAACACTGAAGCTTTCTTT	CEEVLGTEVNTEAFF	TRBV6-6	TRBJ1-1
TGTGCCTGGAGTGTAGAACCGGGTAGCGGGCCGCTTTACGAGCAGTACTTC	CAWSVEPGSGPLYEQYF	TRBV30	TRBJ2-7
TGTGCCACCAGCCCCCCCCCCCCGGTGGGACAGGGGGGAGGGTCCTACGAGCAGTACTTC	CATSPPPPVGQGGGSYEQYF	TRBV24-1	TRBJ2-7
TGTGCCAGCAGCCAAGCGAGCCTCCCAACTAATGAAAAACTGTTTTTT	CASSQASLPTNEKLFF	TRBV3-1	TRBJ1-4
TGTGCCACCAGCAGAAGGGGGGGTAATCAGCCCCAGCATTTT	CATSRRGGNQPQHF	TRBV15	TRBJ1-5
TGTGCCAGCAGGGAAGGAGCGCACATGAACACTGAAGCTTTCTTT	CASREGAHMNTEAFF	TRBV6-5	TRBJ1-1
TGTGCCAGCAGTACTTGGTTCCGGCAACCCGGGAAACCCTACGAGCAGTACTTC	CASSTWFRQPGKPYEQYF	TRBV6-8	TRBJ2-7
TGCGCCAGCAGTGAGGCCTGGGTACCGGGACAGGAGCGGTGCTACGAGCAGTACTTC	CASSEAWVPGQERCYEQYF	TRBV10-2	TRBJ2-7
TGTGCCCCGACTAGCGGGAGGGCAGGGGTCCCGGGCTACGAGCAGTACTTC	CAPTSGRAGVPGYEQYF	TRBV9	TRBJ2-7
TGTGCCAGCGGAGGGAAACAGCGACCTCGGGAGCAGTACTTC	CASGGKQRPREQYF	TRBV6-1	TRBJ2-7
TGTGCCAGCAGCATAAGGGGCATGAACACTGAAGCTTTCTTT	CASSIRGMNTEAFF	TRBV5-4	TRBJ1-1
TGTGCCAGCAGCCTATTGGAATACGAGCAGTACTTC	CASSLLEYEQYF	TRBV7-4	TRBJ2-7
TGTGCCAGCATCGGGACGCTAAGCTCCTACAATGAGCAGTTCTTC	CASIGTLSSYNEQFF	TRBV6-4	TRBJ2-1
TGTGCCAACCACCCGGGACAGGGAACTAACACTGAAGCTTTCTTT	CANHPGQGTNTEAFF	TRBV3-1	TRBJ1-1
TGTGCCAGCAGTGACTCGCTTGGAGGGGGAGAGCAGTTCTTC	CASSDSLGGGEQFF	TRBV6-4	TRBJ2-1
TGCAGCAATGGTTTAGGAAGGACACGTAACGAGCAGTACTTC	CSNGLGRTRNEQYF	TRBV29-1	TRBJ2-7
TGTGCCAGCAGGGCTTACGAGCAGTACTTC	CASRAYEQYF	TRBV6-2	TRBJ2-7
TGTGCCAGCAGCTTAGCAGACAGGGGGGGCTACGAGCAGTACTTC	CASSLADRGGYEQYF	TRBV7-6	TRBJ2-7
TGTGCTAGTGGCGACAGGAACAATCAGCCCCAGCATTTT	CASGDRNNQPQHF	TRBV12-5	TRBJ1-5
TGTGCCAGCGGGGGGCCTCCTTACGATGAGCAGTTCTTC	CASGGPPYDEQFF	TRBV18	TRBJ2-1
TGTGCCAGCAGTGGCACCGGGCGCAATCAGCCCCAGCATTTT	CASSGTGRNQPQHF	TRBV6-4	TRBJ1-5
TGTGCCAGCAGTCACCAAGGCTATGGCTACACCTTC	CASSHQGYGYTF	TRBV6-3	TRBJ1-2
TGCAGTGCTAGTCCTAGGGGTGAGCAGTTCTTC	CSASPRGEQFF	TRBV20-1	TRBJ2-1
TGTGCCAGCAGCGGTAAAGACAGGGGAGAACGGAGCAATCAGCCCCAGCATTTT	CASSGKDRGERSNQPQHF	TRBV5-6	TRBJ1-5
TGTGCCAGCAGCGTAGCCCTACTAGCGCTCGATGGGTTCACAGATACGCAGTATTTT	CASSVALLALDGFTDTQYF	TRBV9	TRBJ2-3
TGTGCCAGCAGCTTACGGGGGCCTGTTACTTTTCCTAACTATGGCTACACCTTC	CASSLRGPVTFPNYGYTF	TRBV7-9	TRBJ1-2
TGCGCCAGCAGCTGGACGGTGAACACTGAAGCTTTCTTT	CASSWTVNTEAFF	TRBV5-1	TRBJ1-1
TGTGCCAGCGGGACAGGCGAAGATACGCAGTATTTT	CASGTGEDTQYF	TRBV27	TRBJ2-3
TGCGCCAGCGTGAAAGACAGGGGCCCATACGGGGGCTACGAGCAGTACTTC	CASVKDRGPYGGYEQYF	TRBV5-1	TRBJ2-7
TGTGCCACCAGCGCAAGGAAGGACAGGAACACTGAAGCTTTCTTT	CATSARKDRNTEAFF	TRBV24-1	TRBJ1-1
TGCAGTGCTAGGAAGCCAGGGCCGGATGAGCAGTTCTTC	CSARKPGPDEQFF	TRBV20-1	TRBJ2-1
TGTGCCAGCAGCTTGGGAAGGGATACGCAGTATTTT	CASSLGRDTQYF	TRBV5-8	TRBJ2-3
TGTGCCAGCAGCGATTCAGGATGGGAGAACACCGGGGAGCTGTTTTTT	CASSDSGWENTGELFF	TRBV13	TRBJ2-2
TGTGCCAGCAGTTTTAGGACAGGCAAAGAAATAGGCTACACCTTC	CASSFRTGKEIGYTF	TRBV27	TRBJ1-2
TGTGCCTGGCAAAGACAGAGGCAGTACTTC	CAWQRQRQYF	TRBV30	TRBJ2-7
TGTGCCACCAGGTTGGTCACAGCGGGAGGCTCCTACAATGAGCAGTTCTTC	CATRLVTAGGSYNEQFF	TRBV24-1	TRBJ2-1
TGTGCCAGCAGCTGCCAGAGGCACCGCAATCAGCCCCAGCATTTT	CASSCQRHRNQPQHF	TRBV13	TRBJ1-5
TGTGCCAGCAGTTGGCCCCGAACAGGGGATGATAACTATGGCTACACCTTC	CASSWPRTGDDNYGYTF	TRBV27	TRBJ1-2
TGCGCCAGCAGCTTGGTACCATCAGGGCCCTCTGGAAACACCATATATTTT	CASSLVPSGPSGNTIYF	TRBV5-1	TRBJ1-3
TGTGCCAGCAGTTACCCGGGACAGGGATTATATATTGGCTCTGGAAACACCATATATTTT	CASSYPGQGLYIGSGNTIYF	TRBV6-5	TRBJ1-3
TGTGCCAGCAGCAACGGGAATAACATTCAGTACTTC	CASSNGNNIQYF	TRBV11-2	TRBJ2-4
TGTGCCAGCAGACAAGGACGGGGGGGGAAAGCTTTCTTT	CASRQGRGGKAFF	TRBV27	TRBJ1-1
TGTGCCAGCAGCCAAGTTGGATTGGACCCGCGAGCAGGGGGCTGGCAGTACGAGCAGTACTTC	CASSQVGLDPRAGGWQYEQYF	TRBV14	TRBJ2-7
TGTGCCAGCAGCTTGGCCGGGACTGCCATCAATGAGCAGTTCTTC	CASSLAGTAINEQFF	TRBV11-1	TRBJ2-1
TGTGCCAGCAGCTTAGACCGAGTGGGACAGAATCGACCGGAGCAGTACTTC	CASSLDRVGQNRPEQYF	TRBV11-3	TRBJ2-7
TGCGCCATCCTCGGGCGGAGGACAAACCAGACCCTTGGGCACCCTAATGAAAAACTGTTTTTT	CAILGRRTNQTLGHPNEKLFF	TRBV10-2	TRBJ1-4
TGTGCCAGCAGCCGAACAACAGGGCTCACAGATACGCAGTATTTT	CASSRTTGLTDTQYF	TRBV14	TRBJ2-3
TGTGCCAGCAAGGGCCGTTCGCCGGGACAGGGGTGCCAGCACTATGGCTACACCTTC	CASKGRSPGQGCQHYGYTF	TRBV6-2	TRBJ1-2
TGTGCCGGGAGCAGGACCGGCACTGAAGCTTTCTTT	CAGSRTGTEAFF	TRBV7-3	TRBJ1-1
TGTGCCAACCCGCTCAGAGGAGCCTACAATGAGCAGTTCTTC	CANPLRGAYNEQFF	TRBV7-9	TRBJ2-1
TGTGCCAGCAGTTACTCGAGCCGGGACAGGGAAGTTTCACCCCTCCACTTT	CASSYSSRDREVSPLHF	TRBV6-6	TRBJ1-6
TGCGCCAGCAGACCAGGCCGACGGGGTCAGCCCCAGCATTTT	CASRPGRRGQPQHF	TRBV10-1	TRBJ1-5
TGTGCCAGCAGCGGGGGGGGGTCCTACAATGAGCAGTTCTTC	CASSGGGSYNEQFF	TRBV13	TRBJ2-1
TGTGCGTTCTCGTGTGACAGGGGCGCCGAGACCCAGTACTTC	CAFSCDRGAETQYF	TRBV2	TRBJ2-5
TGTGCCGGGCGAAGTCTAGAGCAGTTCTTC	CAGRSLEQFF	TRBV7-9	TRBJ2-1
TGTGCCAGCAGCGAGGGTAACCGGCTCTACAATGAGCAGTTCTTC	CASSEGNRLYNEQFF	TRBV14	TRBJ2-1
TGCGCCAGCAGGGAGAGACCGGGACAGTCCTATGGCTACACCTTC	CASRERPGQSYGYTF	TRBV10-1	TRBJ1-2
TGTGCCAGACGTTTGTCACAGGGTCAGTGTAGCTCCTACGAGCAGTACTTC	CARRLSQGQCSSYEQYF	TRBV19	TRBJ2-7
TGTGCCAGCAGCCAAGCCCTTAATGAGGACTATGGCTACACCTTC	CASSQALNEDYGYTF	TRBV14	TRBJ1-2
TGTGCCAGCAGGGGCCACTGGACTTTGACCGGGGAGCTGTTTTTT	CASRGHWTLTGELFF	TRBV27	TRBJ2-2
TGTGCCAGCAGCGTAGCCATGGTGCATTTCTCTGGGGCCAACGTCCTGACTTTC	CASSVAMVHFSGANVLTF	TRBV9	TRBJ2-6
TGTGCCAGCAGTGGCCTTCGGATTAACACCATATATTTT	CASSGLRINTIYF	TRBV2	TRBJ1-3
TGTGCCGACGACGAGGGGTTCTCTGGAAACACCATATATTTT	CADDEGFSGNTIYF	TRBV27	TRBJ1-3
TGTGCCAGCAGCTTAACTGGGGCCCTCCCAGATACGCAGTATTTT	CASSLTGALPDTQYF	TRBV7-6	TRBJ2-3
TGTGCCAGCAGCGTGATCAGGGACAGGGGACTTCAGCCCCAGCATTTT	CASSVIRDRGLQPQHF	TRBV9	TRBJ1-5
TGCAGTGCGTGTGATAATGAAAAACTGTTTTTT	CSACDNEKLFF	TRBV20-1	TRBJ1-4
TGTGCCACCAGCTTCACGAACAGAGAGACCCAGTACTTC	CATSFTNRETQYF	TRBV15	TRBJ2-5
TGTGCCAGCTTCCCGGACAGGGACCTCAATCAGCCCCAGCATTTT	CASFPDRDLNQPQHF	TRBV6-5	TRBJ1-5
TGTGCCAGCAGCTTGGTCCTCGGGACAATGCGCACTGAAGCTTTCTTT	CASSLVLGTMRTEAFF	TRBV5-4	TRBJ1-1
TGTGCCAGCAGGAGGGGGATTTACACCGGGGAGCTGTTTTTT	CASRRGIYTGELFF	TRBV27	TRBJ2-2
TGTGCCAGCCCACGGTGGACTAGCGGCTCGAAGGGCAATGAGCAGTTCTTC	CASPRWTSGSKGNEQFF	TRBV12-4	TRBJ2-1
TGTGCCACCAGTGAACGCAGAAGGGTCTATGGCTACACCTTC	CATSERRRVYGYTF	TRBV24-1	TRBJ1-2
TGTGCCAGCAGCGCGGACAGAGCTTTCTTT	CASSADRAFF	TRBV5-6	TRBJ1-1
TGTGCCACCAGTGATAGGAGGGCAATTCCTTCCTATGGCTACACCTTC	CATSDRRAIPSYGYTF	TRBV24-1	TRBJ1-2
TGTGCCGCAGGGCTAGATCAGCCCCAGCATTTT	CAAGLDQPQHF	TRBV5-6	TRBJ1-5
TGTGCCAGCAGTTTATCACTTCGGGACAGGGCGCCGGGGGGAACGGGTTCACCCCTCCACTTT	CASSLSLRDRAPGGTGSPLHF	TRBV12-4	TRBJ1-6
TGCAGCGTTGGCGATCCCATCAAAATCGACAGGGGAATAGGGGGTGGCTACACCTTC	CSVGDPIKIDRGIGGGYTF	TRBV29-1	TRBJ1-2
TGTGCCAGCAGTGAAGGTCTCGGCGAGCAGTACTTC	CASSEGLGEQYF	TRBV6-1	TRBJ2-7
TGCGCCAGCAGCTTGGTTGGCCAGGGGGGCGCCAATTCACCCCTCCACTTT	CASSLVGQGGANSPLHF	TRBV5-1	TRBJ1-6
TGTGCCACCAGCACCCCCAGGGGAGGGAACAATGAGCAGTTCTTC	CATSTPRGGNNEQFF	TRBV15	TRBJ2-1
TGTGCCAGCAGCGCTTGTAGGACAGGGGGGGAAGCTTTCTTT	CASSACRTGGEAFF	TRBV13	TRBJ1-1
TGCGCCAGCAGCCAATTAGGGGAGACCCTACCTAACTATGGCTACACCTTC	CASSQLGETLPNYGYTF	TRBV4-3	TRBJ1-2
TGTGCCTGGAGAGTTGGCTGTTACACCGGGGAGCTGTTTTTT	CAWRVGCYTGELFF	TRBV30	TRBJ2-2
TGTGCCATCAGTGAGAGTTATATTGAAAAACTGTTTTTT	CAISESYIEKLFF	TRBV10-3	TRBJ1-4
TGTGCCAGTAGTATAGCCCCGACAGGTTGCACAGATACGCAGTATTTT	CASSIAPTGCTDTQYF	TRBV19	TRBJ2-3
TGCAGTGCTAGTCCCAGGGTTTACTACGAGCAGTACTTC	CSASPRVYYEQYF	TRBV20-1	TRBJ2-7
TGTGCCAGTAGTCCGATTCAGGGAGTAGTCGGCAGCAATCAGCCCCAGCATTTT	CASSPIQGVVGSNQPQHF	TRBV19	TRBJ1-5
TGCAGTGCTAACGAAACTAGCGGGAGGGCCCCTAAATACAATGAGCAGTTCTTC	CSANETSGRAPKYNEQFF	TRBV20-1	TRBJ2-1
TGTGCCAGTAGTATTCTTCGGGACAACTCCACAGATACGCAGTATTTT	CASSILRDNSTDTQYF	TRBV19	TRBJ2-3
TGTGCCACCAGTGATTTGCAAGGACAGGGGACCCTCTCCTATAATTCACCCCTCCACTTT	CATSDLQGQGTLSYNSPLHF	TRBV24-1	TRBJ1-6
TGTGCCTGGAGTGCGGCGACTGAAGCTTTCTTT	CAWSAATEAFF	TRBV30	TRBJ1-1
TGTGCCAGCAGTGACACGGACAGTCAGCCCCAGCATTTT	CASSDTDSQPQHF	TRBV6-1	TRBJ1-5
TGTGCCAGCAGCGGTGGAAGGTGTTCACCCCTCCACTTT	CASSGGRCSPLHF	TRBV7-9	TRBJ1-6
TGCAGTGCTGGGATAGATCAAGAGACCCAGTACTTC	CSAGIDQETQYF	TRBV20-1	TRBJ2-5
TGTGCCGGACGTCACCCAACAGGAAACACCATATATTTT	CAGRHPTGNTIYF	TRBV6-5	TRBJ1-3
TGTGCCAGCAGGGCGGGTTACGAGCAGTACTTC	CASRAGYEQYF	TRBV6-3	TRBJ2-7
TGTGCCTGGAGAACCTGCCAGGGGGAAAAACTGTTTTTT	CAWRTCQGEKLFF	TRBV30	TRBJ1-4
TGTGCCAGCAGTCGGCTAGCGGAAGGCTGGGGCACAGATACGCAGTATTTT	CASSRLAEGWGTDTQYF	TRBV12-4	TRBJ2-3
TGTGCCAGCGCCCTCAAGGGTGGGGGCTACGAGCAGTACTTC	CASALKGGGYEQYF	TRBV13	TRBJ2-7
TGTGCCAGCAGCCAAGATCCGGCATTTCTGCCCAACGAGCAGTACTTC	CASSQDPAFLPNEQYF	TRBV4-2	TRBJ2-7
TGTGCCACCAGTGAAGTGACAGGGAGAAATTCACCCCTCCACTTT	CATSEVTGRNSPLHF	TRBV24-1	TRBJ1-6
TGTGCCAGCAAAGGGGCTTGTCCATCACCCCTCCACTTT	CASKGACPSPLHF	TRBV14	TRBJ1-6
TGTGCCAGCAGTGAAGCCGAGGGACGGAAGATTAGGAATTCACCCCTCCACTTT	CASSEAEGRKIRNSPLHF	TRBV6-1	TRBJ1-6
TGTGCCAGTAGTATTAACAGGGGCTTGAAAAGGAACACCGGGGAGCTGTTTTTT	CASSINRGLKRNTGELFF	TRBV19	TRBJ2-2
TGCGCCAGCAGTGAGTCGTCTCGACTGGATATGGAGCTGTTTTTT	CASSESSRLDMELFF	TRBV10-2	TRBJ2-2
TGTGCCAGCAGTCCTCACAGGGGGGGGGGTGTCTACGAGCAGTACTTC	CASSPHRGGGVYEQYF	TRBV6-3	TRBJ2-7
TGCGCCAGCACTAACCTCCCCCGACCAGGGGCTGGTCGGCACTTC	CASTNLPRPGAGRHF	TRBV5-1	TRBJ2-7
TGCAGTGCTAGGAGGGTGGACAGAATGATCACAGATACGCAGTATTTT	CSARRVDRMITDTQYF	TRBV20-1	TRBJ2-3
TGTGCCAGAGGCAATTTACTTTGGGGGCAGGGTCCTGAGGCCTCTGGAAACACCATATATTTT	CARGNLLWGQGPEASGNTIYF	TRBV25-1	TRBJ1-3
TGTGCCAGCAGCTCCCCGAGGGACAGGTTGTGTGGACCCCTCCACTTT	CASSSPRDRLCGPLHF	TRBV7-9	TRBJ1-6
TGTGCCAGCTCACCACAAGAACGAGTAGTAGCCTACGAGCAGTACTTC	CASSPQERVVAYEQYF	TRBV18	TRBJ2-7
TGTGCCAGCAGGCCGTGCCGGGCCGACGAGCAGTACTTC	CASRPCRADEQYF	TRBV28	TRBJ2-7
TGCAGTGCTTCTGCAGGGGAAGGAACGTGGGAGACCCAGTACTTC	CSASAGEGTWETQYF	TRBV20-1	TRBJ2-5
TGTGCCACCAGTGATCCGGTGGCGGCGGAGGGGGCCACCTATGACGAGCAGTACTTC	CATSDPVAAEGATYDEQYF	TRBV24-1	TRBJ2-7
TGTGCCAGCATTAGGGGGCCTGAAGCTTTCTTT	CASIRGPEAFF	TRBV11-2	TRBJ1-1
TGTGCCAGCAGTTCCGGACAGGGTGGGTCACCCCTCCACTTT	CASSSGQGGSPLHF	TRBV6-4	TRBJ1-6
TGTGCCAGCAGCATTGAGGGGGGTAATTCACCCCTCCACTTT	CASSIEGGNSPLHF	TRBV12-3	TRBJ1-6
TGCGCCAGCAGTGAGATGGTGCAACTAGCGGGAGTACGAGTGGTGAACACTGAAGCTTTCTTT	CASSEMVQLAGVRVVNTEAFF	TRBV10-1	TRBJ1-1
TGTGCCATCGTTGGGACGGAGACCCAGTACTTC	CAIVGTETQYF	TRBV10-3	TRBJ2-5
TGTGCCAGCAGCTTACGCCCCCACCGCCAGAGTGAAAAACTGTTTTTT	CASSLRPHRQSEKLFF	TRBV11-3	TRBJ1-4
TGCGCCAGCCATCATCCGGGGGAAGGAGAGACCCAGTACTTC	CASHHPGEGETQYF	TRBV5-1	TRBJ2-5
TGTGCCAGCAGGGCTCGGTGGGAAACACTAGCGGGAGGGCTATACGAGCAGTACTTC	CASRARWETLAGGLYEQYF	TRBV6-5	TRBJ2-7
TGTGCCTGGAGTGTACCTAGCGGGGGGGAGCTGTTTTTT	CAWSVPSGGELFF	TRBV30	TRBJ2-2
TGTGCCACCAGCCGGACGGGTGAGGGCTACACCTTC	CATSRTGEGYTF	TRBV15	TRBJ1-2
TGTGCCAGCAGTTCTTCCCAAAACGGTGACGAGCAGTACTTC	CASSSSQNGDEQYF	TRBV2	TRBJ2-7
TGTGCCAGCAGCTATGCTAGCGGGAGGATGTCTGGGGCCAACGTCCTGACTTTC	CASSYASGRMSGANVLTF	TRBV7-8	TRBJ2-6
TGCAGTGCTACCGGTTGCAGGGCCACCACTGAAGCTTTCTTT	CSATGCRATTEAFF	TRBV20-1	TRBJ1-1
TGTGCCAGCAGCGCCGGCATACAACAGGGGCGTAGCAATCAGCCCCAGCATTTT	CASSAGIQQGRSNQPQHF	TRBV7-4	TRBJ1-5
TGTGCCAGCAGTGAGTCTACCGCCCCAGGGTGCGCCTCCTACGAGCAGTACTTC	CASSESTAPGCASYEQYF	TRBV25-1	TRBJ2-7
TGTGCCAGCAGCGAAGTACTTGGGACAGTAGAAGTGAACACTGAAGCTTTCTTT	CASSEVLGTVEVNTEAFF	TRBV9	TRBJ1-1
TGTGCCAGCATTGCCGGGACAGGGGTAAATCAGCCCCAGCATTTT	CASIAGTGVNQPQHF	TRBV7-2	TRBJ1-5
TGTGCCAGCAGCCAAGGAATAAGGGGGGGTAAGGGAGGCGACGAGCAGTACTTC	CASSQGIRGGKGGDEQYF	TRBV3-1	TRBJ2-7
TGTGCCATCAAACCGATACAGGGGGGAAAGGGCTACACCTTC	CAIKPIQGGKGYTF	TRBV10-3	TRBJ1-2
TGTGCCAGCTCACCCCCGGGGGAAAGCTCTGGAAACACCATATATTTT	CASSPPGESSGNTIYF	TRBV18	TRBJ1-3
TGTGCCAGCAGTTGCACGTCTCCTATGGGCTACACCTTC	CASSCTSPMGYTF	TRBV6-3	TRBJ1-2
TGTGCCAGCAGCGGGGTCCTGGGGGGGACTGAAGCTTTCTTT	CASSGVLGGTEAFF	TRBV11-3	TRBJ1-1
TGCGCCGCGTACCGGACTAGCGGACTTACGCAGTATTTT	CAAYRTSGLTQYF	TRBV5-1	TRBJ2-3
TGTGCCAGCAGCCATCGCAGACGCCCGGACTATGGCTACACCTTC	CASSHRRRPDYGYTF	TRBV3-1	TRBJ1-2
TGCGCCAGCAGCCAAGACAGTGAGTCGAGAGAGACCCAGTACTTC	CASSQDSESRETQYF	TRBV4-1	TRBJ2-5
TGCAGCGTTGAAGGACCCCTACGACTAGGGGGGGATCAGCCCCAGCATTTT	CSVEGPLRLGGDQPQHF	TRBV29-1	TRBJ1-5
TGTGCCAGCAGCCTACGCGGAGCGAACACTGAAGCTTTCTTT	CASSLRGANTEAFF	TRBV13	TRBJ1-1
TGCAGTGCTGGGACTAGCGGGAGCACAGATACGCAGTATTTT	CSAGTSGSTDTQYF	TRBV20-1	TRBJ2-3
TGTGCCAGCATCAGGGGTGCGTTTCCCCGGGAGACCCAGTACTTC	CASIRGAFPRETQYF	TRBV6-5	TRBJ2-5
TGCAGTGCTCCGTTTGACAGGGGAAATCATAATGAGCAGTTCTTC	CSAPFDRGNHNEQFF	TRBV20-1	TRBJ2-1
TGTGCCAGCAGTGGCAGGGTCACCGGGGAGCTGTTTTTT	CASSGRVTGELFF	TRBV6-4	TRBJ2-2
TGCGCCAGCAGCTGTCGGTCGGGGGTACATAATTCACCCCTCCACTTT	CASSCRSGVHNSPLHF	TRBV5-1	TRBJ1-6
TGTGCCAGCAGTGACCGGGTAAATGAAAAACTGTTTTTT	CASSDRVNEKLFF	TRBV6-4	TRBJ1-4
TGTGCCTGGAGTGCCAGGGCAGGGGAATACTATGGCTACACCTTC	CAWSARAGEYYGYTF	TRBV30	TRBJ1-2
TGTGCCAGCAGGGAACTGGCTAATTCGTCACTAGCGGGGGGGCCGGTTGAGACCCAGTACTTC	CASRELANSSLAGGPVETQYF	TRBV5-6	TRBJ2-5
TGCAGCGTAGTGGTTCCAGGGCGGCCCAATCAGCCCCAGCATTTT	CSVVVPGRPNQPQHF	TRBV29-1	TRBJ1-5
TGTGCCAGCAGCCAAACCTGCCCGGCCCGGGACCCCTATTCCCAGCATTTT	CASSQTCPARDPYSQHF	TRBV3-1	TRBJ1-5
TGTGCCAGCAGTGGTCCCTGGGGGGAGCAGCCCCAGCATTTT	CASSGPWGEQPQHF	TRBV2	TRBJ1-5
TGTGCCACCGCCTCCAGAAAACCTGGGGCCAACGTCCTGACTTTC	CATASRKPGANVLTF	TRBV24-1	TRBJ2-6
TGTGCCAGCAGGGGACAAACCGGGGAGCTGTTTTTT	CASRGQTGELFF	TRBV11-3	TRBJ2-2
TGTGCCCATGGGACAGGGGGCTCTGCTAGCTCCTACGAGCAGTACTTC	CAHGTGGSASSYEQYF	TRBV6-4	TRBJ2-7
TGTGCCAGCAAGTGGAGCTGCTACACTGAAGCTTTCTTT	CASKWSCYTEAFF	TRBV2	TRBJ1-1
TGCGCCAGCAGCTTGGACTCACGACAGGGGGCTAATCAGCCCCAGCATTTT	CASSLDSRQGANQPQHF	TRBV5-1	TRBJ1-5
TGTGCCAGCAGCGGGGGGACAGGGGGACACGAGCAGTACTTC	CASSGGTGGHEQYF	TRBV13	TRBJ2-7
TGTGCCAGCAGCCTGATCAGCTGCTCTGGAAACACCATATATTTT	CASSLISCSGNTIYF	TRBV3-1	TRBJ1-3
TGTGCCAGCAGCTTAGAACAGATTAGGCCCCAGCATTTT	CASSLEQIRPQHF	TRBV7-9	TRBJ1-5
TGTGCCAGCAGCTCCAGACGCTCCAACACCGGGGAGCTGTTTTTT	CASSSRRSNTGELFF	TRBV7-9	TRBJ2-2
TGTGCCAGTAAATACCGGCGGGGCGCCTACGAGCAGTACTTC	CASKYRRGAYEQYF	TRBV19	TRBJ2-7
TGTGCCAGCAGCTTAGGGTGGTCAGGGGTCAGGCCCCAGCATTTT	CASSLGWSGVRPQHF	TRBV11-3	TRBJ1-5
TGTGCCAGCAGCTTCGTCCGACCTTACTACGAGCAGTACTTC	CASSFVRPYYEQYF	TRBV7-7	TRBJ2-7
TGTGCCAGCAGCGGGTGGCGAGGGGTCTCGCTCGGACCCTACGAGCAGTACTTC	CASSGWRGVSLGPYEQYF	TRBV7-8	TRBJ2-7
TGTGCCAGTGGTGGGACAGGGGATAATCAGCCCCAGCATTTT	CASGGTGDNQPQHF	TRBV19	TRBJ1-5
TGTGCCAGCAGCTTCCACAGCGCTCTAAGCTCTGGAAACACCATATATTTT	CASSFHSALSSGNTIYF	TRBV7-6	TRBJ1-3
TGTGCCAGCAGCTTGGAGCAGGGGGGATATGGCTACACCTTC	CASSLEQGGYGYTF	TRBV5-6	TRBJ1-2
TGTGCCGACACCACCGGACAGGGGTTCAACTATGGCTACACCTTC	CADTTGQGFNYGYTF	TRBV24-1	TRBJ1-2
TGCGCCAGCAGCTGCCTTCCGGTAGGGACCGGGGAGCTGTTTTTT	CASSCLPVGTGELFF	TRBV5-1	TRBJ2-2
TGCGCCAGCAGCTATAGAGGGGGCAAATATTCACCCCTCCACTTT	CASSYRGGKYSPLHF	TRBV5-1	TRBJ1-6
TGCGCCAGCAACGAGCCTTATGGCTACACCTTC	CASNEPYGYTF	TRBV10-2	TRBJ1-2
TGTGCCTGGAGATGTACAGCCCGGAACTATGGCTACACCTTC	CAWRCTARNYGYTF	TRBV30	TRBJ1-2
TGTGCCAGCAGGATGTTCACAATCTATGGCTACACCTTC	CASRMFTIYGYTF	TRBV7-6	TRBJ1-2
TGTGCCAGCAGCGTGAGGGACTTCCACGAGCAGTACTTC	CASSVRDFHEQYF	TRBV13	TRBJ2-7
TGTGCGGGGGCGCGTTACTTGACTGAAGCTTTCTTT	CAGARYLTEAFF	TRBV24-1	TRBJ1-1
TGTGCCAGCAGCTTAGCCCGGGACGGTGATCAGCCCCAGCATTTT	CASSLARDGDQPQHF	TRBV11-3	TRBJ1-5
TGCGCCAGCAGACAGGCCGGACCAGAGACCCAGTACTTC	CASRQAGPETQYF	TRBV4-1	TRBJ2-5
TGTGCCAGCAGCTTAGCGGGAAGAGATACAGGTCGGGGGATGAACACTGAAGCTTTCTTT	CASSLAGRDTGRGMNTEAFF	TRBV7-8	TRBJ1-1
TGTGCCAGCAGTGAAGGAATCCCTAGCGGGGGTTCTCCTAGCACAGATACGCAGTATTTT	CASSEGIPSGGSPSTDTQYF	TRBV6-1	TRBJ2-3
TGTGCCAGCAGTTGGACATTCACAGATACGCAGTATTTT	CASSWTFTDTQYF	TRBV6-5	TRBJ2-3
TGTGCCACCAGGTTTCTGGCTGAAGCTTTCTTT	CATRFLAEAFF	TRBV24-1	TRBJ1-1
TGTGCCAGCAGCCGAGTATACCAGTACTTC	CASSRVYQYF	TRBV6-5	TRBJ2-5
TGTGCCTGGAGTGGGGGTAAGGGGCACGAGCAGTACTTC	CAWSGGKGHEQYF	TRBV30	TRBJ2-7
TGTGCCAGCAGCCAGAATGAGTTTCAGGGGGACCCATACTATGGCTACACCTTC	CASSQNEFQGDPYYGYTF	TRBV3-1	TRBJ1-2
TGTGCCAGCAGGTTTGGGGACAAGAAGGGTAACTATGGCTACACCTTC	CASRFGDKKGNYGYTF	TRBV6-5	TRBJ1-2
TGTGCCAGCAGCCAAGATCCGATGCACCCCGGACAGGGACGCTATGGCTACACCTTC	CASSQDPMHPGQGRYGYTF	TRBV14	TRBJ1-2
TGTGCCACCAGTGATTTGGTTCCCTGCTCGCCCAATCAGCCCCAGCATTTT	CATSDLVPCSPNQPQHF	TRBV24-1	TRBJ1-5
TGTGCCAGCAGTTTGGCGAAAGGCCGGGAAAACTATGGCTACACCTTC	CASSLAKGRENYGYTF	TRBV27	TRBJ1-2
TGTGCCAGCAGCTTTTCTGGGGACAGGGGAGAAGAGAACGGTGAAGCTTTCTTT	CASSFSGDRGEENGEAFF	TRBV7-3	TRBJ1-1
TGTGCCAGCAGTTTAGTCGGACTAGCGGATAATACGCAGTATTTT	CASSLVGLADNTQYF	TRBV12-4	TRBJ2-3
TGTGCCAGTATCATATTGGTGGGGCGCTACAATGAGCAGTTCTTC	CASIILVGRYNEQFF	TRBV19	TRBJ2-1
TGTGCCAGCAAGTTGGACAGGGGGCCAGGAAACACCATATATTTT	CASKLDRGPGNTIYF	TRBV6-4	TRBJ1-3
TGTGCCAGCAGTGCTACTACCTCTGGAAACACCATATATTTT	CASSATTSGNTIYF	TRBV25-1	TRBJ1-3
TGCAGTGCTAGCCGACTAGCGGGAGGGTCGTCCAGCTACGAGCAGTACTTC	CSASRLAGGSSSYEQYF	TRBV20-1	TRBJ2-7
TGTGCCAGCAGCCCCCGACCGGGGCAATCCACTGGAAACACCATATATTTT	CASSPRPGQSTGNTIYF	TRBV11-2	TRBJ1-3
TGTGCCAGCTCACCAAACATTCAGTACTTC	CASSPNIQYF	TRBV18	TRBJ2-4
TGTGCCGACGGTGGTAGCAATCAGCCCCAGCATTTT	CADGGSNQPQHF	TRBV6-4	TRBJ1-5
TGTGCCAGCAGCCGAGAAAACGGTTACTCTGGGGCCAACGTCCTGACTTTC	CASSRENGYSGANVLTF	TRBV7-2	TRBJ2-6
TGCAGTGCTTTTACTAGCGGGAGAGGGAACTCCTACGAGCAGTACTTC	CSAFTSGRGNSYEQYF	TRBV20-1	TRBJ2-7
TGTGCCAGCAGTTCACAGGGGATAGAGACCCAGTACTTC	CASSSQGIETQYF	TRBV12-3	TRBJ2-5
TGTGCCAGCAGTGAAGTCGACAACCAAAGGACAATTAGATGCGATACGCAGTATTTT	CASSEVDNQRTIRCDTQYF	TRBV2	TRBJ2-3
TGTGCCAGCAGTTCGGGGGAGTGCACAGATACGCAGTATTTT	CASSSGECTDTQYF	TRBV12-4	TRBJ2-3
TGTGCCAGCAGATCTTATAGCGGTGCCTTCACCGGGGAGCTGTTTTTT	CASRSYSGAFTGELFF	TRBV6-5	TRBJ2-2
TGCAGTGCTAGGCAAAAGGACAGTCCTGAGCAGTTCTTC	CSARQKDSPEQFF	TRBV20-1	TRBJ2-1
TGTGCCAGGGGGGTCTGCACAGATACGCAGTATTTT	CARGVCTDTQYF	TRBV28	TRBJ2-3
TGTGCCAGCAGTGGCCGGCTGGGACAGAGAAACTATGGCTACACCTTC	CASSGRLGQRNYGYTF	TRBV25-1	TRBJ1-2
TGTGCCGCGAGGCCCTACGAGCAGTACTTC	CAARPYEQYF	TRBV24-1	TRBJ2-7
TGTGCCAGCAGCTTAGCGGGGACCCGAGAGACCCAGTACTTC	CASSLAGTRETQYF	TRBV11-2	TRBJ2-5
TGTGCCAGCAGCTCCAAGGGGCCGGTGTACAATGAGCAGTTCTTC	CASSSKGPVYNEQFF	TRBV5-4	TRBJ2-1
TGTGCCAGCAGTTTATCCTGGACAGGGGACGAGGGCGAGCAGTACTTC	CASSLSWTGDEGEQYF	TRBV27	TRBJ2-7
TGTGCCTCTGGTCTCAACAGTCAGGGGGATCAGCCCCAGCATTTT	CASGLNSQGDQPQHF	TRBV19	TRBJ1-5
TGTGCCAGCAGCTGGAATGGGAGCTCCTATGGCTACACCTTC	CASSWNGSSYGYTF	TRBV7-6	TRBJ1-2
TGTGCCAGCAGCCAAGCCTCACTAGCGGGAGGGCGTCCAGAGTACAATGAGCAGTTCTTC	CASSQASLAGGRPEYNEQFF	TRBV14	TRBJ2-1
TGCGCCAGCAGCCTAGCGGAAGGCTTCCGGAAAAACATTCAGTACTTC	CASSLAEGFRKNIQYF	TRBV5-1	TRBJ2-4
TGTGCCAGCCCGGGTACGGGACAGGGTACGGTCTCCTACGAGCAGTACTTC	CASPGTGQGTVSYEQYF	TRBV6-5	TRBJ2-7
TGTGCCAGCAGCAAAATTGCCGACAGGGCTGTTAGCAATCAGCCCCAGCATTTT	CASSKIADRAVSNQPQHF	TRBV7-3	TRBJ1-5
TGTGCCAGCAGATCGCTAGTTAACGAGCAGTACTTC	CASRSLVNEQYF	TRBV11-3	TRBJ2-7
TGTGCCAGCATTGAAAACGGACGCTTTGGCTACACCTTC	CASIENGRFGYTF	TRBV6-1	TRBJ1-2
TGTGCCACCGGCATCCCCTACGAGCAGTACTTC	CATGIPYEQYF	TRBV27	TRBJ2-7
TGTGCCAGCAGGGGGGACAGGGTTAGGATAGAGAACACTGAAGCTTTCTTT	CASRGDRVRIENTEAFF	TRBV4-2	TRBJ1-1
TGTGCCAGCAGCGGACCATCGACCCACAACTACGAGCAGTACTTC	CASSGPSTHNYEQYF	TRBV7-3	TRBJ2-7
TGTGCCAGCAGCAGTCGACATGGGAGAGAAAAACTGTTTTTT	CASSSRHGREKLFF	TRBV11-2	TRBJ1-4
TGTGCCAAAGCCAGCTTCGGGAAACGGGGTATCGAGCAGTACTTC	CAKASFGKRGIEQYF	TRBV11-2	TRBJ2-7
TGTGCCAGCAGTTTTGCGGGGTCCTCCTACGAGCAGTACTTC	CASSFAGSSYEQYF	TRBV25-1	TRBJ2-7
TGTGCCAGCAGATCTAGAGGGGCATACGAGCATTTT	CASRSRGAYEHF	TRBV27	TRBJ1-5
TGTGCCAGCAGCGGGCAGCTTTGTAACTATGGCTACACCTTC	CASSGQLCNYGYTF	TRBV11-3	TRBJ1-2
TGCAGTGCTAGAGGGGGGGATACGCAGTATTTT	CSARGGDTQYF	TRBV20-1	TRBJ2-3
TGTGCCAGCAGGTTTGACAGGGCCGCTTCCTATAATTCACCCCTCCACTTT	CASRFDRAASYNSPLHF	TRBV6-5	TRBJ1-6
TGTGCCAGCAGTCCGGGACAGGGGGGAGACTCCTACAATGAGCAGTTCTTC	CASSPGQGGDSYNEQFF	TRBV6-5	TRBJ2-1
TGTGCCACCAGCAGGTTGACCGATGGACAGCAGCCCCAGCATTTT	CATSRLTDGQQPQHF	TRBV15	TRBJ1-5
TGTGCCAGCAGCTTAGGGTTACAGGGGGTCTCACCCCTCCACTTT	CASSLGLQGVSPLHF	TRBV7-4	TRBJ1-6
TGTGCCAGCAGCCGTGAGGGGGCGGTTACATCAGATACGCAGTATTTT	CASSREGAVTSDTQYF	TRBV7-9	TRBJ2-3
TGTGCCAGCAGCTTAGTTAAGGGGGGGGGTCGTGAGCAGTTCTTC	CASSLVKGGGREQFF	TRBV7-6	TRBJ2-1
TGCGCCAGCAGCTCACCCCGGGACAGGGGCCAGCTGTTTTTT	CASSSPRDRGQLFF	TRBV5-1	TRBJ2-2
TGTGCCAGCAGCCAGTTTATGGGCCCCGAACATGGCACAGATACGCAGTATTTT	CASSQFMGPEHGTDTQYF	TRBV7-3	TRBJ2-3
TGTGCCTGGAGTGTACGGCCCCGACTAGCGGGGGGGCATTGGGAAGATACGCAGTATTTT	CAWSVRPRLAGGHWEDTQYF	TRBV30	TRBJ2-3
TGTGCTAGCAGCCATGAGGGTTTTGGCACAGATACGCAGTATTTT	CASSHEGFGTDTQYF	TRBV7-7	TRBJ2-3
TGCGCCAGCAGTGAGTCGCTGGACAGGAAAGAGACCCAGTACTTC	CASSESLDRKETQYF	TRBV10-1	TRBJ2-5
TGTGCCAGCAGCGTTGGCGGAATTTCAAATCAGCCCCAGCATTTT	CASSVGGISNQPQHF	TRBV7-6	TRBJ1-5
TGCGCCAGCAGCCAAGATTTCTCTACAGGTTCCTACGAGCAGTACTTC	CASSQDFSTGSYEQYF	TRBV4-1	TRBJ2-7
TGCGCCAGCACCCTTAGGACGCACGAGCAGTACTTC	CASTLRTHEQYF	TRBV5-1	TRBJ2-7
TGTGCCAGCAGCTTAGATCTCAATAAGTCAGGCAACATGAACACTGAAGCTTTCTTT	CASSLDLNKSGNMNTEAFF	TRBV11-2	TRBJ1-1
TGTGCCAGCAGCTTACCATCTAGTTCCACCGGGGAGCTGTTTTTT	CASSLPSSSTGELFF	TRBV7-8	TRBJ2-2
TGTGCCAGCATTAGGTCCGGGACAAGCGGGGGGGGCTACGAGCAGTACTTC	CASIRSGTSGGGYEQYF	TRBV7-6	TRBJ2-7
TGTGCCAGCAGCTTAGCGCCTAGTCGAACCGACTACGAGCAGTACTTC	CASSLAPSRTDYEQYF	TRBV7-9	TRBJ2-7
TGTGCCAGCAGTTTAACCTCGAAGGTTTGTCCTGTCACCGGGGAGCTGTTTTTT	CASSLTSKVCPVTGELFF	TRBV12-4	TRBJ2-2
TGTGCCACCAGTGATTTAGAAGAGGGGGGCACAGATACGCAGTATTTT	CATSDLEEGGTDTQYF	TRBV24-1	TRBJ2-3
TGTGCCAGCAGCGTAGATCGGGGTGTACAAATCTACGAGCAGTACTTC	CASSVDRGVQIYEQYF	TRBV9	TRBJ2-7
TGTGCCAGCACCAGCCGAGACTATGGCTACACCTTC	CASTSRDYGYTF	TRBV6-3	TRBJ1-2
TGTGCCAGCAGTGACCTCAAGGGTGGGTTGCAGTACTTC	CASSDLKGGLQYF	TRBV6-1	TRBJ2-7
TGTGCCAGTAGTATTGACCCCGGGGAGACCCAGTACTTC	CASSIDPGETQYF	TRBV19	TRBJ2-5
TGTGCCAGCAGTTTAGCGCATCTAGCGGGCCAGGTCCGAACCTACGAGCAGTACTTC	CASSLAHLAGQVRTYEQYF	TRBV12-4	TRBJ2-7
TGTGCCACCAGCGTATGTACATATGGCTACACCTTC	CATSVCTYGYTF	TRBV24-1	TRBJ1-2
TGTGCCAGCAGCTTAGCCATCAGGGACAACGGCTCCTACGAGCAGTACTTC	CASSLAIRDNGSYEQYF	TRBV7-6	TRBJ2-7
TGTGCCAGCAGTGAAGGGGGCGCGGTGGCCTACGAGCAGTACTTC	CASSEGGAVAYEQYF	TRBV6-4	TRBJ2-7
TGTGCCAGCAGCGGAAAGAACCGTACTAATGAAAAACTGTTTTTT	CASSGKNRTNEKLFF	TRBV5-4	TRBJ1-4
TGCGCCAGCAGCTTGAACAGGCAGTCTGGCGGCAATCAGCCCCAGCATTTT	CASSLNRQSGGNQPQHF	TRBV5-1	TRBJ1-5
TGTGCCAGCAGCAATGATCTAGCGGGGGTTGAGCAGTTCTTC	CASSNDLAGVEQFF	TRBV13	TRBJ2-1
TGTGCCAGCACCCCATGGGCTAAGAATAGCAATCAGCCCCAGCATTTT	CASTPWAKNSNQPQHF	TRBV9	TRBJ1-5
TGCAGTGCTAGGCGACAGGACGGGGAAGAATCGGCAAGCTATGGCTACACCTTC	CSARRQDGEESASYGYTF	TRBV20-1	TRBJ1-2
TGTGCCAGCAGTTACTCAGTTAGCGGGAGAACTGAAGCTTTCTTT	CASSYSVSGRTEAFF	TRBV6-3	TRBJ1-1
TGTGCTAGTGGTGTCGGTGAAGCCTACGAGCAGTACTTC	CASGVGEAYEQYF	TRBV12-5	TRBJ2-7
TGTGCCAGCAGCTCTGTACCCAGCAATCAGCCCCAGCATTTT	CASSSVPSNQPQHF	TRBV7-9	TRBJ1-5
TGTGCGGACCGGGATACTAGCGGGAGGAGCAATCAGCCCCAGCATTTT	CADRDTSGRSNQPQHF	TRBV11-3	TRBJ1-5
TGCGCCCCGTGTAGCGGGCTTCGCACAGATACGCAGTATTTT	CAPCSGLRTDTQYF	TRBV10-1	TRBJ2-3
TGTGCCAGCAGCCAACTAATACGCCAGGGATTTAGGGGCGAGGACCACACTGAAGCTTTCTTT	CASSQLIRQGFRGEDHTEAFF	TRBV3-1	TRBJ1-1
TGTGCCAGCAGTTTTCCAGGGGGGGGAGAGACCCAGTACTTC	CASSFPGGGETQYF	TRBV27	TRBJ2-5
TGTGCCAGCAGTCGCGGGCCAGATACGCAGTATTTT	CASSRGPDTQYF	TRBV7-4	TRBJ2-3
TGTGCTAGTGGTTGGGGGTTCTGGACAGGGCGGGGTGAAAAACTGTTTTTT	CASGWGFWTGRGEKLFF	TRBV12-5	TRBJ1-4
TGTGCCAGCAGCTCCCGTACCGGACAGGTGATTAGCTCCTACGAGCAGTACTTC	CASSSRTGQVISSYEQYF	TRBV11-2	TRBJ2-7
TGCGCCTCTCTAGCGGATGATTGCTACAATGAGCAGTTCTTC	CASLADDCYNEQFF	TRBV5-1	TRBJ2-1
TGTGCCAGCTCACCACCGGGTGCAGGGGTTAGAATTGTGGGCTACACCTTC	CASSPPGAGVRIVGYTF	TRBV18	TRBJ1-2
TGCAGTGCTAGAGGAAGCAGTAAGCCTTCCGAAGCTTTCTTT	CSARGSSKPSEAFF	TRBV20-1	TRBJ1-1
TGTGCCAGCAAACGCAGCGTTCATGAAAAACTGTTTTTT	CASKRSVHEKLFF	TRBV6-1	TRBJ1-4
TGTGCCAGCAGTCCCGGGGCAGCTAACTATGGCTACACCTTC	CASSPGAANYGYTF	TRBV6-4	TRBJ1-2
TGCGCCAGCAGCGGACAGGGCCTAGCTTTCTTT	CASSGQGLAFF	TRBV5-1	TRBJ1-1
TGCGCCAGCAGTGAGTCCCCCCGTCCCTCGGGTTTCTGTAGGCGGACTAGCGGGGTCAATGAGCAGTTCTTC	CASSESPRPSGFCRRTSGVNEQFF	TRBV10-2	TRBJ2-1
TGCAGCGTTGAGTATTACCAACTAGCGGGAGGGGGGGTCAATGAGCAGTTCTTC	CSVEYYQLAGGGVNEQFF	TRBV29-1	TRBJ2-1
TGTGCCAGCAGCTTTCTTTCGGGCTCTATTGAAAAACTGTTTTTT	CASSFLSGSIEKLFF	TRBV7-7	TRBJ1-4
TGCAGCGTCAGGGGGCCGAAATTTGTGGAAGGCTACACCTTC	CSVRGPKFVEGYTF	TRBV29-1	TRBJ1-2
TGCGCCAGCAGGCGGGACTGTAGCCAAGAGACCCAGTACTTC	CASRRDCSQETQYF	TRBV10-1	TRBJ2-5
TGTGCCAGTAGTATCCCTCTGGGGGGGGGGTCCTACGAGCAGTACTTC	CASSIPLGGGSYEQYF	TRBV19	TRBJ2-7
TGTGCCAGCAGCTCTCTAGACAGGGGCTTTTGGCCAGATACGCAGTATTTT	CASSSLDRGFWPDTQYF	TRBV7-6	TRBJ2-3
TGTGCCAGTAGTTCCGCAGCGGGACTAGCGGGCTACGAGCAGTACTTC	CASSSAAGLAGYEQYF	TRBV19	TRBJ2-7
TGTGCCAGCAGTCCCCAGGGGAATCACTACGAGCAGTACTTC	CASSPQGNHYEQYF	TRBV27	TRBJ2-7
TGCAGTGCTAAGAGAAGCAATCAGCCCCAGCATTTT	CSAKRSNQPQHF	TRBV20-1	TRBJ1-5
TGTGCCAGCAGGATACATTATGGCTACACCTTC	CASRIHYGYTF	TRBV7-9	TRBJ1-2
TGTGCCAGCAGCCATACTGGGGTAAATAGGGCTACCCCTGGAAACACCATATATTTT	CASSHTGVNRATPGNTIYF	TRBV13	TRBJ1-3
TGTGCCAGCAAGGATGAGAGCAATAGGAGCGCATTTGCTTCCTACGAGCAGTACTTC	CASKDESNRSAFASYEQYF	TRBV2	TRBJ2-7
TGTGCCAGCAGCGTAGGGGACAGGGCCAGCTACTCCTATAATTCACCCCTCCACTTT	CASSVGDRASYSYNSPLHF	TRBV9	TRBJ1-6
TGTGCCAGCAGCCAATTTTCCGGCGGATACTTC	CASSQFSGGYF	TRBV3-1	TRBJ2-5
TGCAGTGCTAGCCCGACAGGGGGTTCACCCCTCCACTTT	CSASPTGGSPLHF	TRBV20-1	TRBJ1-6
TGTGCCAGCAAGGCCGGAGGACGAAGGAGAGACGCCACCGGGGAGCTGTTTTTT	CASKAGGRRRDATGELFF	TRBV6-3	TRBJ2-2
TGTGCCAGCAGGGTCACTGACTTAGTCGAGGCCAAAAACATTCAGTACTTC	CASRVTDLVEAKNIQYF	TRBV2	TRBJ2-4
TGCGCCAGCAGCCAAGAGCGTCGGAAGCCTTCAGATACGCAGTATTTT	CASSQERRKPSDTQYF	TRBV4-1	TRBJ2-3
TGTGCCAGCAGCTTAGCCAAAACAGGGGGCAATCAGCCCCAGCATTTT	CASSLAKTGGNQPQHF	TRBV11-2	TRBJ1-5
TGTGCCAGCAGCCCGAGGCGGGACACCGGGGAGCTGTTTTTT	CASSPRRDTGELFF	TRBV11-2	TRBJ2-2
TGTGCCAGTAGCGGGACAGCCTACGAGCAGTACTTC	CASSGTAYEQYF	TRBV19	TRBJ2-7
TGTGCCTGGAGTGTAGCCGACCCCGGGACAGCGAATAGCAATCAGCCCCAGCATTTT	CAWSVADPGTANSNQPQHF	TRBV30	TRBJ1-5
TGTGCCAGCAGCCTCCCCCATATGAACAAGCGTTTCCTCCACTTT	CASSLPHMNKRFLHF	TRBV9	TRBJ1-6
TGTGCCAGCAGCCGGGATTATAGCAATCAGCCCCAGCATTTT	CASSRDYSNQPQHF	TRBV6-4	TRBJ1-5
TGCAGTGCTAGGCCAGGGAACAATGGCTACACCTTC	CSARPGNNGYTF	TRBV20-1	TRBJ1-2
TGCGCCAGCAGATCCGGACCTTCTACCTATAATTCACCCCTCCACTTT	CASRSGPSTYNSPLHF	TRBV4-1	TRBJ1-6
TGTGGCCGGACAGGAGAGGGAGCTTTCTTT	CGRTGEGAFF	TRBV11-3	TRBJ1-1
TGTGCCAGCAGCCTTTTTTGGGGGCGAGGCGTGGAGGGCAATCAGCCCCAGCATTTT	CASSLFWGRGVEGNQPQHF	TRBV14	TRBJ1-5
TGTGCCAGCAGTTGCTGGGGCGACTATGGCTACACCTTC	CASSCWGDYGYTF	TRBV6-2	TRBJ1-2
TGTGCCAGCAGTCGGAGAGAGCAGGGGGGGTATAAGACCGAGCAGTACTTC	CASSRREQGGYKTEQYF	TRBV27	TRBJ2-7
TGTGCCAGCAGCTTGGTGGACAGGCAGGAAAGCTATGGCTACACCTTC	CASSLVDRQESYGYTF	TRBV5-4	TRBJ1-2
TGTGCCAGCAGCTTGGATAACAGTGCGGGGCGAAAACTGTTTTTT	CASSLDNSAGRKLFF	TRBV5-4	TRBJ1-4
TGTGCCAGCAGCGCCCACCGGGCTGGGACCTACAGCACTTATAATTCACCCCTCCACTTT	CASSAHRAGTYSTYNSPLHF	TRBV9	TRBJ1-6
TGTGCCAGCAGCGGCGTCTCATGTAGCACTGAAGCTTTCTTT	CASSGVSCSTEAFF	TRBV4-2	TRBJ1-1
TGTGCCTGCATTAAGGGTGGTGATACGCAGTATTTT	CACIKGGDTQYF	TRBV30	TRBJ2-3
TGTGCCAGCAGACACCGCTCCTACGAGCAGTACTTC	CASRHRSYEQYF	TRBV14	TRBJ2-7
TGCAGCGTCCAGGGTAACACTGAAGCTTTCTTT	CSVQGNTEAFF	TRBV29-1	TRBJ1-1
TGCAGTGCAAGAGGCGAGCAGTACTTC	CSARGEQYF	TRBV20-1	TRBJ2-7
TGCAGCGAATGGGGGTGGGATCAGCCCCAGCATTTT	CSEWGWDQPQHF	TRBV29-1	TRBJ1-5
TGTGCCAGCTCACCAAGAACCCACTGTGGGGCCAACGTCCTGACTTTC	CASSPRTHCGANVLTF	TRBV18	TRBJ2-6
TGTGCCACCAGCAGAGATGGAGTCTTCCAGGGGGCGCCTGATTCACCCCTCCACTTT	CATSRDGVFQGAPDSPLHF	TRBV15	TRBJ1-6
TGCAGTGCTAGGCTCCCCTGGGGGGGCGAAGATACGCAGTATTTT	CSARLPWGGEDTQYF	TRBV20-1	TRBJ2-3
TGCGCCAGCAGCCCCTGGTCAGGGTCGGACCCAGAGACCCAGTACTTC	CASSPWSGSDPETQYF	TRBV10-1	TRBJ2-5
TGTGCCAGCAGGCAAGACGGGGCCCAAGTCCCCTACGAGCAGTACTTC	CASRQDGAQVPYEQYF	TRBV27	TRBJ2-7
TGCGCCAGCAGCCAAGATTTGTCGGGGGGCTACGAGCAGTACTTC	CASSQDLSGGYEQYF	TRBV4-1	TRBJ2-7
TGTGCCAGCAGCTTAGCACGACTGGAGCTGTTTTTT	CASSLARLELFF	TRBV11-2	TRBJ2-2
TGTGCCAGCAGCTTATATGGACATGACGGGGAGCTGTTTTTT	CASSLYGHDGELFF	TRBV7-3	TRBJ2-2
TGTGCCAGCAGCTTATCACCTCTTCGGGGACAGGGCGCTGAAGCTTTCTTT	CASSLSPLRGQGAEAFF	TRBV7-3	TRBJ1-1
TGTGCCAGCAGTTACCCCGCCGTCAGCCGAGCTAGCACAGATACGCAGTATTTT	CASSYPAVSRASTDTQYF	TRBV6-2	TRBJ2-3
TGTGCCAGCAGTACAAAGTTGCCTGAGGATGAAGCTTTCTTT	CASSTKLPEDEAFF	TRBV12-3	TRBJ1-1
TGTGCCAGCAGCCAAGATCAGAGTTCTTACTGCCGGGACAGGAACACTGAAGCTTTCTTT	CASSQDQSSYCRDRNTEAFF	TRBV14	TRBJ1-1
TGTGCCAGCAGTCACCCTTCCGACATTACCGGGGAGCTGTTTTTT	CASSHPSDITGELFF	TRBV27	TRBJ2-2
TGTGCCAGCAGCTTAGTCCGGGACAATGAGTACGAGCAGTACTTC	CASSLVRDNEYEQYF	TRBV7-2	TRBJ2-7
TGTGCCGATATCCCCGGGGTGGCTTCTGGAAACACCATATATTTT	CADIPGVASGNTIYF	TRBV10-3	TRBJ1-3
TGTGCCAGCAGCTTAGGGACAGGGGGAGTACAGACCCAGTACTTC	CASSLGTGGVQTQYF	TRBV7-4	TRBJ2-5
TGTGCCACCAGTGATTTGAAAGGGTATCATCCCACCGGGGAGCTGTTTTTT	CATSDLKGYHPTGELFF	TRBV24-1	TRBJ2-2
TGCGCCAGCGGGGTGGGAAAAACTGAAGCTTTCTTT	CASGVGKTEAFF	TRBV10-1	TRBJ1-1
TGTGCCTGGAGTGTAACTCCTAGCGGGCTGGAGCAGTACTTC	CAWSVTPSGLEQYF	TRBV30	TRBJ2-7
TGCAGTGCTAGAAAAAAGGGGGCTGGAAACACCATATATTTT	CSARKKGAGNTIYF	TRBV20-1	TRBJ1-3
TGTGCCAGCAGGTACCAGCCGATTATCACAGATACGCAGTATTTT	CASRYQPIITDTQYF	TRBV27	TRBJ2-3
TGCGCCAGCAGTGAGCAGCACGGTACTGAAGCTTTCTTT	CASSEQHGTEAFF	TRBV10-2	TRBJ1-1
TGTGCCAGCAGCTTCCGGATGCCGCGGGACAGGGAAAATCAGCCCCAGCATTTT	CASSFRMPRDRENQPQHF	TRBV11-3	TRBJ1-5
TGCGCCAGCAGACAGGGGCCTAACTATGGCTACACCTTC	CASRQGPNYGYTF	TRBV10-1	TRBJ1-2
TGTGCCAGCAAGCAGGGGAGTCGTTACGAGCAGTACTTC	CASKQGSRYEQYF	TRBV28	TRBJ2-7
TGTGCCCCCGAGCTAGCGGGGGGGCGCGAACGGAATGAGCAGTTCTTC	CAPELAGGRERNEQFF	TRBV7-9	TRBJ2-1
TGTGCCAGCAGCCAAGACGGACAGGTAAGCTCCTACAATGAGCAGTTCTTC	CASSQDGQVSSYNEQFF	TRBV4-2	TRBJ2-1
TGTGCCAGCAGCGTAGTCCCGGGCCCGAAAGAGACCCAGTACTTC	CASSVVPGPKETQYF	TRBV9	TRBJ2-5
TGCGCCAGCAGCCAAGATTTGCCTGCCTTTTGTGCTGACGAGCAGTACTTC	CASSQDLPAFCADEQYF	TRBV4-1	TRBJ2-7
TGCAGTGCTAGGGAATCTCCAGCTAGTGGGCACGAGCAGTACTTC	CSARESPASGHEQYF	TRBV20-1	TRBJ2-7
TGTGCCAGCAGCTCTCATGGGTCACATCGGAGCAATCAGCCCCAGCATTTT	CASSSHGSHRSNQPQHF	TRBV11-3	TRBJ1-5
TGCAGTGCTAAGGGAGTACTAGCGGGAACATCCTACGAGCAGTACTTC	CSAKGVLAGTSYEQYF	TRBV20-1	TRBJ2-7
TGTGCCAGCAGCCCCCTCCGGGACAGGGGGACTTCCTACGAGCAGTACTTC	CASSPLRDRGTSYEQYF	TRBV6-4	TRBJ2-7
TGTGCCAGCAGCTTAGATGCTGCGCGTAGCTCCTATAATTCACCCCTCCACTTT	CASSLDAARSSYNSPLHF	TRBV7-2	TRBJ1-6
TGTGCTAGCAGCTCGGTGAAGAACACTGAAGCTTTCTTT	CASSSVKNTEAFF	TRBV7-7	TRBJ1-1
TGCGCCAGCTGGGGAAACCTTCAGGTGACCACTGAAGCTTTCTTT	CASWGNLQVTTEAFF	TRBV10-1	TRBJ1-1
TGTGCCAGCAGCAAGACAGGTATCGACATTCAGTACTTC	CASSKTGIDIQYF	TRBV7-3	TRBJ2-4
TGTGCCAGCTCACCACTCCCTAGCGGAGCCACCGGGGAGCTGTTTTTT	CASSPLPSGATGELFF	TRBV18	TRBJ2-2
TGTGCCATCCCCTTAGACAGGGACATTCAGTACTTC	CAIPLDRDIQYF	TRBV7-2	TRBJ2-4
TGCAGCGATTCTACCAGCGGGACGAGTTATAATTCACCCCTCCACTTT	CSDSTSGTSYNSPLHF	TRBV29-1	TRBJ1-6
TGCGCCAGCAGCCAAGTAAGAGCGGGACTAGCGGTAAGCCAGTACTTC	CASSQVRAGLAVSQYF	TRBV4-1	TRBJ2-5
TGTGCCAGCAGGCCTGGGGGGTATTCTGGAAACACCATATATTTT	CASRPGGYSGNTIYF	TRBV6-6	TRBJ1-3
TGTGCCTGGAGTGTAAAGCGGGATATTGATACGCAGTATTTT	CAWSVKRDIDTQYF	TRBV30	TRBJ2-3
TGTGCCAGCAGTGAGATCAGGTGCCAACAGTACTTC	CASSEIRCQQYF	TRBV6-4	TRBJ2-7
TGTGCCAGCAGCTTGGGGGACAGTTCGGGTAACTATGGCTACACCTTC	CASSLGDSSGNYGYTF	TRBV7-8	TRBJ1-2
TGTGCCAGCAGCCGCCCCTATTGGGGGGGGAGTAATTCTGGAAACACCATATATTTT	CASSRPYWGGSNSGNTIYF	TRBV11-2	TRBJ1-3
TGTGCCAGCAGTTACAAGACAGGGTGTGGGGGCTATGGCTACACCTTC	CASSYKTGCGGYGYTF	TRBV6-2	TRBJ1-2
TGCGCCAGCAGCCAACGTACAGTAAAAGAGACCCAGTACTTC	CASSQRTVKETQYF	TRBV4-3	TRBJ2-5
TGTGCCAGCAGCACAGGCTTAGGGCTCTATGGCTACACCTTC	CASSTGLGLYGYTF	TRBV27	TRBJ1-2
TGCAGCGGTCGAGGGGTGGGTAGCACAGATACGCAGTATTTT	CSGRGVGSTDTQYF	TRBV29-1	TRBJ2-3
TGTGCCAGCAGCTCCGGCTGGAAGGAGCAGTTCTTC	CASSSGWKEQFF	TRBV11-2	TRBJ2-1
TGTGCCAGCAGCTACCCGGGCTGGAGCACTGAAGCTTTCTTT	CASSYPGWSTEAFF	TRBV7-8	TRBJ1-1
TGTGCCACATTCCCCGGACTAGCGGGATATAGCACAGATACGCAGTATTTT	CATFPGLAGYSTDTQYF	TRBV6-2	TRBJ2-3
TGTGCCAGCAGTCACAGCAAAACCAGACGGGGCCTATATTCCAACTATGGCTACACCTTC	CASSHSKTRRGLYSNYGYTF	TRBV2	TRBJ1-2
TGTGCCAGCTCTCAGACGGCCTCTCGGTCCTACGAGCAGTACTTC	CASSQTASRSYEQYF	TRBV6-5	TRBJ2-7
TGTGCCAGCAGCGTGCCACACCTCTCTGGAAACACCATATATTTT	CASSVPHLSGNTIYF	TRBV5-6	TRBJ1-3
TGTGCCAGCAAACATAACTCCTACGAGCAGTACTTC	CASKHNSYEQYF	TRBV7-2	TRBJ2-7
TGTGCCAGCAGCCAGGCGTACAATGAGCAGTTCTTC	CASSQAYNEQFF	TRBV3-1	TRBJ2-1
TGTGCCACCAGTGATTTGATTGAGGTAGGGGGGGTGGGTGGGGGCGGGTCCTACGAGCAGTACTTC	CATSDLIEVGGVGGGGSYEQYF	TRBV24-1	TRBJ2-7
TGTGCCAGCAGTGCCCTCCGCGGAAAAAACATTCAGTACTTC	CASSALRGKNIQYF	TRBV6-1	TRBJ2-4
TGCGCCAGCAGCGAGGACAGGGGGGGCAATGAGCAGTTCTTC	CASSEDRGGNEQFF	TRBV4-1	TRBJ2-1
TGTGCCAGCAGCGTGGGACAGGGGAGCACCGGGGAGCTGTTTTTT	CASSVGQGSTGELFF	TRBV9	TRBJ2-2
TGCAGTGCTAGATGTAGGGGGCTGAGTCGGAATCAGCCCCAGCATTTT	CSARCRGLSRNQPQHF	TRBV20-1	TRBJ1-5
TGTGCCAGCAGTTGCTCCAGGTCGAGGGGCAATGAGCAGTTCTTC	CASSCSRSRGNEQFF	TRBV12-3	TRBJ2-1
TGTGCCAGCAGTTCGGGACTAGGTGATGAGCAGTTCTTC	CASSSGLGDEQFF	TRBV6-5	TRBJ2-1
TGCGCCAGCAGCCGGGCCCCACCCTTACTAGCGGCGGGGGGCCAAGAGACCCAGTACTTC	CASSRAPPLLAAGGQETQYF	TRBV4-1	TRBJ2-5
TGTGCCACCGACCCGGGTAAGAAGAACACTGAAGCTTTCTTT	CATDPGKKNTEAFF	TRBV28	TRBJ1-1
TGCGCCAGCAGCGGGGGGGGCGCGATAAATCAGCCCCAGCATTTT	CASSGGGAINQPQHF	TRBV5-1	TRBJ1-5
TGCGCCAGCAGCCCCCGCAGATGGGAGCAGTACTTC	CASSPRRWEQYF	TRBV4-1	TRBJ2-7
TGTGCCTCCCATATGGATCAGCCCCAGCATTTT	CASHMDQPQHF	TRBV6-1	TRBJ1-5
TGTGCCAGCAGCCAGTGTGGGGGGCTGTCCTACACCTTC	CASSQCGGLSYTF	TRBV7-8	TRBJ1-2
TGTGCCATCAGTGAGTCGATACTAGGGGGAGCCTACGAGCAGTACTTC	CAISESILGGAYEQYF	TRBV10-3	TRBJ2-7
TGTGCCAGCAGCTTTGCCAAAGGCTACACCTTC	CASSFAKGYTF	TRBV7-2	TRBJ1-2
TGTGCCAGCAGGATCTCCAGACTTGCTCCGGGGACTGAAGCTTTCTTT	CASRISRLAPGTEAFF	TRBV13	TRBJ1-1
TGTGCCAGTGGGACAGGGGATAATCAGCCCCAGCATTTT	CASGTGDNQPQHF	TRBV6-1	TRBJ1-5
TGTGCCAGCAGTTACCATCGGGACGGAGTTCCTGGGGCCAACGTCCTGACTTTC	CASSYHRDGVPGANVLTF	TRBV6-5	TRBJ2-6
TGTGCCAGCAGCGAAGACAGTGTTTCCGGATATGGCTACACCTTC	CASSEDSVSGYGYTF	TRBV11-2	TRBJ1-2
TGTGCCAGCAGTGCCCAAGCCGGACCCCGTGAAAAACTGTTTTTT	CASSAQAGPREKLFF	TRBV6-4	TRBJ1-4
TGCGCCAGCAGCCAAGTTCCGTCTCAGCGGGCTTACTCCTACAATGAGCAGTTCTTC	CASSQVPSQRAYSYNEQFF	TRBV4-1	TRBJ2-1
TGTGCCAGCAGCATTACCCAGGGGCAGAGGGCCCTCCACTTT	CASSITQGQRALHF	TRBV13	TRBJ1-6
TGTGCCAGCTCACCAGCGTGTCGAAGGGGGGAGGAGGGCTCCTACGAGCAGTACTTC	CASSPACRRGEEGSYEQYF	TRBV18	TRBJ2-7
TGTGCCAGCAGCGTTCCACAGGGTAGGACCACTGAAGCTTTCTTT	CASSVPQGRTTEAFF	TRBV9	TRBJ1-1
TGTGCCAGCAGTTTACTGTATGGAACAGTCCGAGAGACCCAGTACTTC	CASSLLYGTVRETQYF	TRBV28	TRBJ2-5
TGTGCCAGCGGCGGTACCGAGCAGTACTTC	CASGGTEQYF	TRBV9	TRBJ2-7
TGTGCCAGACGGGGGCTGTCAAAATGGAGCTCCTACGAGCAGTACTTC	CARRGLSKWSSYEQYF	TRBV10-3	TRBJ2-7
TGTGCCAGCAGCGTGGAACAGGGGTACGAGCAGTACTTC	CASSVEQGYEQYF	TRBV27	TRBJ2-7
TGTGCTAGTGGCCCCCTGGAACTCTCCTACAATGAGCAGTTCTTC	CASGPLELSYNEQFF	TRBV12-5	TRBJ2-1
TGTGCCAGCAGCAGAAGGACGCAGCCCCAGCATTTT	CASSRRTQPQHF	TRBV11-3	TRBJ1-5
TGTGCCAGCAGCCAAAGTTGGGGGGAGAACACTGAAGCTTTCTTT	CASSQSWGENTEAFF	TRBV9	TRBJ1-1
TGTGCCAGCAGTTTAGGTGGAACCAACAGGGTGACAGCCCACACTGAAGCTTTCTTT	CASSLGGTNRVTAHTEAFF	TRBV28	TRBJ1-1
TGTGCCAGCAGTTACGGGACAGGGGGCCCCGAGCAGTACTTC	CASSYGTGGPEQYF	TRBV6-5	TRBJ2-7
TGTGCCAGCCGGTCCCGGGACAGGGGAGGTCTCACTGGAAACACCATATATTTT	CASRSRDRGGLTGNTIYF	TRBV28	TRBJ1-3
TGTGCCAGCAGCGCTAGGGGAGAAGGCTACACCTTC	CASSARGEGYTF	TRBV7-8	TRBJ1-2
TGTGCCAGCAGCCTGGGCTCCTACGAGCAGTACTTC	CASSLGSYEQYF	TRBV7-3	TRBJ2-7
TGTGCCAGCAGGAGCCTGCTAATCTGCGAGCAGTACTTC	CASRSLLICEQYF	TRBV3-1	TRBJ2-7
TGTGCCAGCAGTTCCGACAGGGGGAGACATGGAAGGTCCTACGAGCAGTACTTC	CASSSDRGRHGRSYEQYF	TRBV28	TRBJ2-7
TGCGCCAGCAGCCAAGATTCCCCAGGGTCACACTATGGCTACACCTTC	CASSQDSPGSHYGYTF	TRBV4-1	TRBJ1-2
TGTGCCAGCAAAAGCGGGTTCTTCACGCAGTATTTT	CASKSGFFTQYF	TRBV3-1	TRBJ2-3
TGTGCTAGTGGTTTGATCGGGGGTAGGAACACTGAAGCTTTCTTT	CASGLIGGRNTEAFF	TRBV12-5	TRBJ1-1
TGTGCCAGCAGCTTTCGGACAGGGCAAGAGGGAAATGAGCAGTTCTTC	CASSFRTGQEGNEQFF	TRBV9	TRBJ2-1
TGTGCCAGCAGCTGTCCTGGGGCCATATTAGGAGATACGCAGTATTTT	CASSCPGAILGDTQYF	TRBV7-9	TRBJ2-3
TGCAGTGCATCAGGAAGGGGGCGGTGTGGCTACGAGCAGTACTTC	CSASGRGRCGYEQYF	TRBV20-1	TRBJ2-7
TGTGCCAGCAGCTTGTATTACCAAGAGACCCAGTACTTC	CASSLYYQETQYF	TRBV9	TRBJ2-5
TGTGCCAGCAGCTTAGGGGACTCCTACGAGCAGTACTTC	CASSLGDSYEQYF	TRBV7-2	TRBJ2-7
TGCAGTGCTAGAGATCTGATATTTGGACAGCCCCAGCATTTT	CSARDLIFGQPQHF	TRBV20-1	TRBJ1-5
TGTGCCAGCAGCTTAGCAACCGGTGCAGGCTGGCTTTACTACGAGCAGTACTTC	CASSLATGAGWLYYEQYF	TRBV11-2	TRBJ2-7
TGTGCTAGCAGCTTAGCCCCCCATTTCGGCGCGCGCACGGGCGGTGAAGCTTTCTTT	CASSLAPHFGARTGGEAFF	TRBV7-7	TRBJ1-1
TGTGCCAGCAGCATGGTCACTGATTGGAACACCGGGGAGCTGTTTTTT	CASSMVTDWNTGELFF	TRBV7-2	TRBJ2-2
TGTGCCAGCAGCACGGACAGGGCCCCCCCCTACGAGCAGTACTTC	CASSTDRAPPYEQYF	TRBV13	TRBJ2-7
TGTGCCAGCTCACCGGCCAAGCTGGCCTACGAGCAGTACTTC	CASSPAKLAYEQYF	TRBV18	TRBJ2-7
TGTGCCAGCACCAGGCCCCCGACAGCTAGGAACGAGCAGTACTTC	CASTRPPTARNEQYF	TRBV6-3	TRBJ2-7
TGCGCCAGCAGCCACCCGGGACAGGGGTTTTACGAAAAACTGTTTTTT	CASSHPGQGFYEKLFF	TRBV5-1	TRBJ1-4
TGTGCCACCAGGTGGACAGCAGGTTCCCTCAATCAGCCCCAGCATTTT	CATRWTAGSLNQPQHF	TRBV24-1	TRBJ1-5
TGTGCCAGCAGCTTCCGGGACAGGGACAATGAGCAGTTCTTC	CASSFRDRDNEQFF	TRBV7-2	TRBJ2-1
TGTGCCAGCAGCCGAAGGACTCAGCCCCAGCATTTT	CASSRRTQPQHF	TRBV4-2	TRBJ1-5
TGTGCCAGCGCCAGGACGGAGAGCTCCTACGAGCAGTACTTC	CASARTESSYEQYF	TRBV6-3	TRBJ2-7
TGCAGTGCATCACTGACTGAAGCTTTCTTT	CSASLTEAFF	TRBV20-1	TRBJ1-1
TGTGCCAGCAGCTGGTGTACTAGCGGGAGCGAGCAGTACTTC	CASSWCTSGSEQYF	TRBV12-3	TRBJ2-7
TGTGCCAGCAGCTTAGCCAACTTGGGGCGACCAGGGGGTTATAGCAATCAGCCCCAGCATTTT	CASSLANLGRPGGYSNQPQHF	TRBV7-9	TRBJ1-5
TGTGCCAGCAGGGAGCCTAGCGCCTACGAGCAGTACTTC	CASREPSAYEQYF	TRBV28	TRBJ2-7
TGTGCCAGCAAGGAACGGGTCGGCTCTGGAAACACCATATATTTT	CASKERVGSGNTIYF	TRBV6-1	TRBJ1-3
TGTGCCAGCAGCGGTACAGGGGCCAGCTCCTACAATGAGCAGTTCTTC	CASSGTGASSYNEQFF	TRBV13	TRBJ2-1
TGTGCCAGCACCCTTAGGGGATTAAACACTGAAGCTTTCTTT	CASTLRGLNTEAFF	TRBV12-4	TRBJ1-1
TGTGCCAGCAGTTTAGCGGGTGGCACAGATACGCAGTATTTT	CASSLAGGTDTQYF	TRBV6-5	TRBJ2-3
TGCGCCAGCAGCTTGGCTGCCCTAAGCAGAGCAAACTATGGCTACACCTTC	CASSLAALSRANYGYTF	TRBV5-1	TRBJ1-2
TGTGCCAGCAGGAGGAGCTCCTATAATTCACCCCTCCACTTT	CASRRSSYNSPLHF	TRBV6-2	TRBJ1-6
TGTGCCAGCAGCAGCCCTAAACATACGCAGTATTTT	CASSSPKHTQYF	TRBV11-3	TRBJ2-3
TGCGCCAGCGGTTTCCGCAGGGGGCCCCCGGGACAGAAACCCTACGAGCAGTACTTC	CASGFRRGPPGQKPYEQYF	TRBV10-1	TRBJ2-7
TGTGCCAGCAGTTACTTTGGGGGGGACTCTGGAAACACCATATATTTT	CASSYFGGDSGNTIYF	TRBV6-5	TRBJ1-3
TGTGCCATCAGTGAGCAATTACTTGACCGGGGTGAAAAACTGTTTTTT	CAISEQLLDRGEKLFF	TRBV10-3	TRBJ1-4
TGCGCCAGCAGCTTGCCGAAGGCTGCAACGCCCTCCTACAATGAGCAGTTCTTC	CASSLPKAATPSYNEQFF	TRBV5-1	TRBJ2-1
TGTGCCAGCCCCCATGACAGGGGGGTGAACACTGAAGCTTTCTTT	CASPHDRGVNTEAFF	TRBV9	TRBJ1-1
TGTGCCTGCTCGACGGGAGGTCTAGAGCAGTACTTC	CACSTGGLEQYF	TRBV30	TRBJ2-7
TGTGCCAGCAGCTGGACGATGCCATTAGCGGGGTACAATGAGCAGTTCTTC	CASSWTMPLAGYNEQFF	TRBV7-9	TRBJ2-1
TGTGCCAGCAGCACCGGGGCCAATCAGCCCCAGCATTTT	CASSTGANQPQHF	TRBV7-9	TRBJ1-5
TGTGCCAGCAGTAAAGGGCGGGCGCCCTACGAGCAGTACTTC	CASSKGRAPYEQYF	TRBV6-5	TRBJ2-7
TGTGCCAGCAGTTACCGAGGGGGGGAGACCCAGTACTTC	CASSYRGGETQYF	TRBV6-6	TRBJ2-5
TGTGCCACCGAGGCTTCCTGGGCATATTCACCCCTCCACTTT	CATEASWAYSPLHF	TRBV24-1	TRBJ1-6
TGCAGTGCTCGGAGACTAGTGGGGGCCTACGAGCAGTACTTC	CSARRLVGAYEQYF	TRBV20-1	TRBJ2-7
TGCGCCAGCAGCAGGCAGAGAGCGGTATCCTACGAGCAGTACTTC	CASSRQRAVSYEQYF	TRBV5-1	TRBJ2-7
TGTGCCAGCCAGGGCGGCAATCAGCCCCAGCATTTT	CASQGGNQPQHF	TRBV19	TRBJ1-5
TGCGCCAGCAGCTTGCCCGGGACGAACTATGGCTACACCTTC	CASSLPGTNYGYTF	TRBV5-1	TRBJ1-2
TGTGCCAGCAGCGTAATCGACGCGGGGTACGACGGAAACACCATATATTTT	CASSVIDAGYDGNTIYF	TRBV9	TRBJ1-3
TGTGCCACCAGGCGGGACAGGGGGCAGGAAGTAGATACGCAGTATTTT	CATRRDRGQEVDTQYF	TRBV24-1	TRBJ2-3
TGCAGTGCTAGCCGGGCAAATGCTATCACTGAAGCTTTCTTT	CSASRANAITEAFF	TRBV20-1	TRBJ1-1
TGTGCCAGCAGTGACCTAGGGGCCCAGCAGTACTTC	CASSDLGAQQYF	TRBV6-4	TRBJ2-7
TGTGCCAGCAGCAATCGTGACGAGCAGTACTTC	CASSNRDEQYF	TRBV7-3	TRBJ2-7
TGTGCCACCCAACAGGATCCGCGTACGGACTACGAGCAGTACTTC	CATQQDPRTDYEQYF	TRBV24-1	TRBJ2-7
TGTGCCAGTAGTACCCGTCAGCGGGAAGCCAGCTACGAGCAGTACTTC	CASSTRQREASYEQYF	TRBV19	TRBJ2-7
TGTGCCAGCAGTGTTTGGCTCCCGACCCAGTACTTC	CASSVWLPTQYF	TRBV6-1	TRBJ2-5
TGTGCCTGGAGTGGAGACAGGGGGACTGAAGCTTTCTTT	CAWSGDRGTEAFF	TRBV30	TRBJ1-1
TGTGCCAGGCCCGGGGGGGTGGACACCGGGGAGCTGTTTTTT	CARPGGVDTGELFF	TRBV6-1	TRBJ2-2
TGTGCCACCACTAACAAGGGCACCCGTAATGAGCAGTTCTTC	CATTNKGTRNEQFF	TRBV10-3	TRBJ2-1
TGTGCCAGCAGCCCAAGGAGGGACAGGGGTAACTATGGCTACACCTTC	CASSPRRDRGNYGYTF	TRBV11-2	TRBJ1-2
TGTGCCAGCAGTTTAGCCTTCAGCAATACAGGGGCTTCAGAAGCTAACTATGGCTACACCTTC	CASSLAFSNTGASEANYGYTF	TRBV27	TRBJ1-2
TGTGCCAGCTACGGAAGAGACAGGGCTTCGAAAGGGGATACGCAGTATTTT	CASYGRDRASKGDTQYF	TRBV2	TRBJ2-3
TGCAGTGCTAGAACCGGGTGCTTCAAGTACGAGCAGTACTTC	CSARTGCFKYEQYF	TRBV20-1	TRBJ2-7
TGCGCCAGCAGCCTTAGGAAAGGACAGGGACGGGGGTATGGCTACACCTTC	CASSLRKGQGRGYGYTF	TRBV5-1	TRBJ1-2
TGTGCCAGCAGTACAGGGGATACTGGCTACACCTTC	CASSTGDTGYTF	TRBV27	TRBJ1-2
TGTGCCAGCAGCCAAGATATAGAAGTGACTAGTAGCTACGAGCAGTACTTC	CASSQDIEVTSSYEQYF	TRBV4-2	TRBJ2-7
TGTGCCATCAGTGTTCAAAATACAGGGCTAAGGAGCAATCAGCCCCAGCATTTT	CAISVQNTGLRSNQPQHF	TRBV10-3	TRBJ1-5
TGTGCCAGCAGCTTGGGTGGACAGGGGGGCTACACCTTC	CASSLGGQGGYTF	TRBV5-6	TRBJ1-2
TGCGCCAGCAGCCAAGATCGTACCGGGGAGGGAGGGCCCCCAGCTGAAGCTTTCTTT	CASSQDRTGEGGPPAEAFF	TRBV4-1	TRBJ1-1
TGTGCCACCCCAGCCGAAAACCCGGGACTAGCGGGAGGATCTCTAAACTATGGCTACACCTTC	CATPAENPGLAGGSLNYGYTF	TRBV24-1	TRBJ1-2
TGTGCCAGCTCACCACTGCCCACGGGGGTGAACACCGGGGAGCTGTTTTTT	CASSPLPTGVNTGELFF	TRBV18	TRBJ2-2
TGCGCCAGCAGTGAGATAGCCCGGGTTAGGACAGGTACCACTGAAGCTTTCTTT	CASSEIARVRTGTTEAFF	TRBV10-1	TRBJ1-1
TGTGCCAGCAGGCAGGGCCACGAGCAGTACTTC	CASRQGHEQYF	TRBV6-5	TRBJ2-7
TGTGCCAGCTACGTGGGAGGACGAGCTCAAGACGAGCAGTACTTC	CASYVGGRAQDEQYF	TRBV13	TRBJ2-7
TGTGCCAGCAGCTATCAGCCCGGGGCGAAAGGCTACACCTTC	CASSYQPGAKGYTF	TRBV7-2	TRBJ1-2
TGTGCCAGCAGTTACCCTCGGGATTGGACCATCGGGCGGAACACCGGGGAGCTGTTTTTT	CASSYPRDWTIGRNTGELFF	TRBV12-4	TRBJ2-2
TGTGCCAGCAGCTTACCACTAGCGGGGGACACAGATACGCAGTATTTT	CASSLPLAGDTDTQYF	TRBV7-2	TRBJ2-3
TGTGCCAGCTCACTAAGGACAGGAATTCATCAGGAAAAACTGTTTTTT	CASSLRTGIHQEKLFF	TRBV18	TRBJ1-4
TGTGCCATCAGTGATCGACAGGGGGCAGATGGTTATGGCTACACCTTC	CAISDRQGADGYGYTF	TRBV10-3	TRBJ1-2
TGTGCCAGCAGGCCACAGGGTTTACGGGGGCAAGAGACCCAGTACTTC	CASRPQGLRGQETQYF	TRBV28	TRBJ2-5
TGCGCCAGCTTGTCAACGGGCAATGAGCAGTTCTTC	CASLSTGNEQFF	TRBV5-1	TRBJ2-1
TGCGCCAGCAGCTATAAAGAGGACTTCAGAGTGAACACTGAAGCTTTCTTT	CASSYKEDFRVNTEAFF	TRBV5-1	TRBJ1-1
TGTGCCAGCAGAAGACCTAGGCTTAGCTCCTATAATTCACCCCTCCACTTT	CASRRPRLSSYNSPLHF	TRBV6-1	TRBJ1-6
TGTGCCAGCAGTGAGCCAATGGACTTATACGAAGAGACCCAGTACTTC	CASSEPMDLYEETQYF	TRBV6-1	TRBJ2-5
TGCAGCGTTTATGAGGGCGGAAGGAGCTCCTACAATGAGCAGTTCTTC	CSVYEGGRSSYNEQFF	TRBV29-1	TRBJ2-1
TGCAGTGCTAGAGATGGCCCAAGCGGGATGGCAACTAATGAAAAACTGTTTTTT	CSARDGPSGMATNEKLFF	TRBV20-1	TRBJ1-4
TGTGCCTTCGGGCCTGGGTACGACACGAACATTCAGTACTTC	CAFGPGYDTNIQYF	TRBV6-2	TRBJ2-4
TGCGCCAGCAGCCCCCAGGGTGTTGGCTACACCTTC	CASSPQGVGYTF	TRBV5-1	TRBJ1-2
TGTGCCAGCAGCTTCCGGACCCTTAGGATTGTCTACGAGCAGTACTTC	CASSFRTLRIVYEQYF	TRBV7-6	TRBJ2-7
TGTGCCCACCCGGGCGGTAGGGAGTATAGCAATCAGCCCCAGCATTTT	CAHPGGREYSNQPQHF	TRBV6-8	TRBJ1-5
TGTGCCAGCAACAGCGGGACTGGGGATTACAATGAGCAGTTCTTC	CASNSGTGDYNEQFF	TRBV5-6	TRBJ2-1
TGTGCCAGCAGTGAAATTGGGACAGAAAAACTGAACACTGAAGCTTTCTTT	CASSEIGTEKLNTEAFF	TRBV6-4	TRBJ1-1
TGTGCCAGCAGTAGGGGGGCCGGGTACCAAGAGACCCAGTACTTC	CASSRGAGYQETQYF	TRBV6-4	TRBJ2-5
TGTGCCAGCAGCCAAGTATGGTGGGACGGGGCAACTAATGAAAAACTGTTTTTT	CASSQVWWDGATNEKLFF	TRBV3-1	TRBJ1-4
TGTGCCACCCTTGCAGATACGCAGTATTTT	CATLADTQYF	TRBV9	TRBJ2-3
TGCGCCAGCAGCGACAATCAGCCCCAGCATTTT	CASSDNQPQHF	TRBV5-1	TRBJ1-5
TGCGCCAGCAGCTTGGCCTACCTCGGGACTAATGAGCAGTTCTTC	CASSLAYLGTNEQFF	TRBV5-1	TRBJ2-1
TGCGCCAGCAGCCGGGGCATGGACAACGAGCAGTACTTC	CASSRGMDNEQYF	TRBV5-1	TRBJ2-7
TGTGCCGGAGGGGTATACAATGAGCAGTTCTTC	CAGGVYNEQFF	TRBV30	TRBJ2-1
TGCGCCAGCAGCTTAAGGGACTCCAAGTTAAGCAACACCGGGGAGCTGTTTTTT	CASSLRDSKLSNTGELFF	TRBV5-1	TRBJ2-2
TGTGCCAGCAGCGGTCCCCGGGACTATGGCTACACCTTC	CASSGPRDYGYTF	TRBV13	TRBJ1-2
TGTGCCACGACAGGGGAGGGGAGCAATCAGCCCCAGCATTTT	CATTGEGSNQPQHF	TRBV24-1	TRBJ1-5
TGCGCCAGCAGCTTATACAAGGACGTGAGAGCCTACGAGCAGTACTTC	CASSLYKDVRAYEQYF	TRBV5-1	TRBJ2-7
TGTGGAACAGGGGTTTATGGCTACACCTTC	CGTGVYGYTF	TRBV2	TRBJ1-2
TGTGCCAGTTCACGGGACAGGGGGGACGAGCAGTACTTC	CASSRDRGDEQYF	TRBV28	TRBJ2-7
TGTGCCAGCAGTTTACAAACTGGTGAAGCTTTCTTT	CASSLQTGEAFF	TRBV12-4	TRBJ1-1
TGTGCCAGCAGCTTGGGGCTAGCGGGGGCCTACGAGCAGTACTTC	CASSLGLAGAYEQYF	TRBV5-4	TRBJ2-7
TGTGCCAGCAGACAGGGCATGAACACTGAAGCTTTCTTT	CASRQGMNTEAFF	TRBV5-6	TRBJ1-1
TGTGCCAGCAGCTTGGTCCCTTCCGCCACGGGGATTGAAAAACTGTTTTTT	CASSLVPSATGIEKLFF	TRBV5-6	TRBJ1-4
TGTGCCAGCAGCTTCCGCCAAGGAAGATCTAGCACAGATACGCAGTATTTT	CASSFRQGRSSTDTQYF	TRBV7-4	TRBJ2-3
TGTGCCAGACAAACGAACACCGGGGAGCTGTTTTTT	CARQTNTGELFF	TRBV15	TRBJ2-2
TGTGCCAGCAGCCTCGGAAACGGGGAGCTGTTTTTT	CASSLGNGELFF	TRBV7-4	TRBJ2-2
TGTGCCAGCAGCCCACCGGGGGACCATGAGCAGTTCTTC	CASSPPGDHEQFF	TRBV27	TRBJ2-1
TGTGCCAGCAGCGGAGGCGGGGGAAATTACCGGAATCAGCCCCAGCATTTT	CASSGGGGNYRNQPQHF	TRBV5-8	TRBJ1-5
TGTGCCAGCAGTTTTAGCGGGGGGGGTAATGAGCAGTTCTTC	CASSFSGGGNEQFF	TRBV27	TRBJ2-1
TGTGCCAGTAGTATAGTAGTCTACCGGAGAGAGAACACCGGGGAGCTGTTTTTT	CASSIVVYRRENTGELFF	TRBV19	TRBJ2-2
TGCAGTGGACAGACTAGCGGGAGTCGTAGGCTCGAGACCCAGTACTTC	CSGQTSGSRRLETQYF	TRBV20-1	TRBJ2-5
TGTGCCAGCAGTGTATTCCGGGTAAACAATGAGCAGTTCTTC	CASSVFRVNNEQFF	TRBV6-4	TRBJ2-1
TGTGCCAGCAGCGGGGCCTCAGGGAAGAACACCGGGGAGCTGTTTTTT	CASSGASGKNTGELFF	TRBV5-4	TRBJ2-2
TGTGCCAGCAGCCCTCCCCGTTCAGGCTACGAGCAGTACTTC	CASSPPRSGYEQYF	TRBV7-3	TRBJ2-7
TGTGCCAGCAGTTGTACGCGAGGGGAGCAGTACTTC	CASSCTRGEQYF	TRBV12-4	TRBJ2-7
TGTGCCAGCAGCGTCCGCGGGAGGGGGAATCAGCCCCAGCATTTT	CASSVRGRGNQPQHF	TRBV7-2	TRBJ1-5
TGTGCCAGCAGCCATCCCACCTTTTCCGCTGATTATAAAGAGACCCAGTACTTC	CASSHPTFSADYKETQYF	TRBV3-1	TRBJ2-5
TGTGCCACCAGTAGTCCACAAGTTCCAACAGGGCCGGTCGAGCAGTACTTC	CATSSPQVPTGPVEQYF	TRBV24-1	TRBJ2-7
TGTGCCAGCAGCGTCGGACCCAGGAATCAGCCCCAGCATTTT	CASSVGPRNQPQHF	TRBV11-3	TRBJ1-5
TGTGCCAGCAGCTTTCCGCAGGGTCGCTATGGCTACACCTTC	CASSFPQGRYGYTF	TRBV11-2	TRBJ1-2
TGTGCCAGCAGCGGGAAATGTACCCTGGACAGGGCCGCGAACACTGAAGCTTTCTTT	CASSGKCTLDRAANTEAFF	TRBV7-3	TRBJ1-1
TGTGCCAGCAGAGGGTTACAAGCTTTCTTT	CASRGLQAFF	TRBV6-6	TRBJ1-1
TGCAGCGTTGAAGTGGGGGAGGAGGGAAAGGGCGGCTACACCTTC	CSVEVGEEGKGGYTF	TRBV29-1	TRBJ1-2
TGTGCCTGGGGGGCACAGAACTATGGCTACACCTTC	CAWGAQNYGYTF	TRBV10-3	TRBJ1-2
TGTGCCATCAGTGAGCTACGAGCGGAGAACACTGAAGCTTTCTTT	CAISELRAENTEAFF	TRBV10-3	TRBJ1-1
TGTGCCAGCAGCTTAGCGGTGCCGAAAAGGAGCGGGTCCTACGAGCAGTACTTC	CASSLAVPKRSGSYEQYF	TRBV7-9	TRBJ2-7
TGTGCCAGCAGCAGTAGGGGGAACTCCTATAATTCACCCCTCCACTTT	CASSSRGNSYNSPLHF	TRBV9	TRBJ1-6
TGCGCCAGCAGTGCTAGGAGGACAGGGGGGTCAATCTATGGCTACACCTTC	CASSARRTGGSIYGYTF	TRBV10-1	TRBJ1-2
TGCAGTGCCCGAGGGGACCTCCACTTT	CSARGDLHF	TRBV20-1	TRBJ1-6
TGTGCCAGCAGCCCGGGACCTGGCGAGACAGATACGCAGTATTTT	CASSPGPGETDTQYF	TRBV11-3	TRBJ2-3
TGCAGCGTTGAAGACGGGCAGGGCTCTGGGGCCAACGTCCTGACTTTC	CSVEDGQGSGANVLTF	TRBV29-1	TRBJ2-6
TGTGCCAGCAGGAATACGGGAGGGAGCAATCAGCCCCAGCATTTT	CASRNTGGSNQPQHF	TRBV12-4	TRBJ1-5
TGCGCCAGCAGCTTGGATTCCGGGGAGTACGAGCAGTACTTC	CASSLDSGEYEQYF	TRBV5-1	TRBJ2-7
TGTGCCAGCAGCCTCGGGACAGGGTTTTTAGGCTACACCTTC	CASSLGTGFLGYTF	TRBV5-6	TRBJ1-2
TGCGCCAGCAGGTACAGTCAGCCCCAGCATTTT	CASRYSQPQHF	TRBV10-1	TRBJ1-5
TGTGCCAGCAGCTTAGTGCCAGACCGGGAAAAACTGTTTTTT	CASSLVPDREKLFF	TRBV11-3	TRBJ1-4
TGTGCCAGCTCACCACGAAACAATGAGCAGTTCTTC	CASSPRNNEQFF	TRBV18	TRBJ2-1
TGCGCCAGCAGTGAAAGTACGGGGTCAGGAGTCTCTGGAAACACCATATATTTT	CASSESTGSGVSGNTIYF	TRBV10-1	TRBJ1-3
TGTGCCAGCAAAAAGCCCGGGACAGGGGCCCCCGGGGAGCTGTTTTTT	CASKKPGTGAPGELFF	TRBV6-3	TRBJ2-2
TGTGCCAGCACTAGGGGGATCAAATATAACTATGGCTACACCTTC	CASTRGIKYNYGYTF	TRBV13	TRBJ1-2
TGCGCCAGCAGTGAAAGGAGGGACCCCTACGAGCAGTACTTC	CASSERRDPYEQYF	TRBV10-2	TRBJ2-7
TGTGCCAGCAGCACGACCTCGGGACTAGCGGGGAACAATGAGCAGTTCTTC	CASSTTSGLAGNNEQFF	TRBV13	TRBJ2-1
TGTGCCAGCAGCTCGGCGCCGGGACTCTACGAGCAGTACTTC	CASSSAPGLYEQYF	TRBV11-2	TRBJ2-7
TGTGCCAGCAGTTTAAAACTAGGGCCTACAGATACGCAGTATTTT	CASSLKLGPTDTQYF	TRBV28	TRBJ2-3
TGTGCCAGTGGTCCCGGGAGGGAGTATGGCTACACCTTC	CASGPGREYGYTF	TRBV10-3	TRBJ1-2
TGTGCCAGCAGCCCTAGACCTGCCTACGAGCAGTACTTC	CASSPRPAYEQYF	TRBV7-7	TRBJ2-7
TGCAGTGCTAGAGTCGGGGGATCCTACAATGAGCAGTTCTTC	CSARVGGSYNEQFF	TRBV20-1	TRBJ2-1
TGTGCCAGCAGCTTAACCTGGGGGGCTAATAACGAGACCCAGTACTTC	CASSLTWGANNETQYF	TRBV7-3	TRBJ2-5
TGCAGTGGGCAAAAATTATCCCCAAACCCGGAGGAGACCCAGTACTTC	CSGQKLSPNPEETQYF	TRBV20-1	TRBJ2-5
TGTGCTAGTGGTTTGGTCCCCCCGGTGATGAAAAAATACACTGAAGCTTTCTTT	CASGLVPPVMKKYTEAFF	TRBV12-5	TRBJ1-1
TGCAGTGCTAGAGATCAGTGGGTTTTTCTTTTGGGTCACGAGCAGTACTTC	CSARDQWVFLLGHEQYF	TRBV20-1	TRBJ2-7
TGTGCCAGCAGTTTATACACAGGGGAAGTCTATGGCTACACCTTC	CASSLYTGEVYGYTF	TRBV28	TRBJ1-2
TGTGCCAGCAGCCAAGATGGGGCAGATACGCAGTATTTT	CASSQDGADTQYF	TRBV4-2	TRBJ2-3
TGTGCCACCAAATCAGGGATACACACTGAAGCTTTCTTT	CATKSGIHTEAFF	TRBV24-1	TRBJ1-1
TGTGCCACCAGAAAAGGGGGGGGGATGAGCTCCTATAATTCACCCCTCCACTTT	CATRKGGGMSSYNSPLHF	TRBV24-1	TRBJ1-6
TGTGCCAGCAGCCCCGTCGAGGGGACTAGCGGGAGAGTCTACGAGCAGTACTTC	CASSPVEGTSGRVYEQYF	TRBV7-9	TRBJ2-7
TGTGCCACTCCCGGGTCGTCCAAAAACATTCAGTACTTC	CATPGSSKNIQYF	TRBV6-4	TRBJ2-4
TGTGCCAGCAGCTCTTCCCCGGGACTAGCGGGGCGTACCCAAGAGACCCAGTACTTC	CASSSSPGLAGRTQETQYF	TRBV7-9	TRBJ2-5
TGTGCCAGCAGCTGCCGGGGGGGCGGGGAGCTGTTTTTT	CASSCRGGGELFF	TRBV11-1	TRBJ2-2
TGCGCCAGCAGCTCCCGACAGCGGATCAGCTCCTATAATTCACCCCTCCACTTT	CASSSRQRISSYNSPLHF	TRBV5-1	TRBJ1-6
TGTGCCAGCACCAGTAGCGGGAGGGAGCAGTTCTTC	CASTSSGREQFF	TRBV7-4	TRBJ2-1
TGTGCCAGCAGCTTTGCCGACTTAGATTATGGCTACACCTTC	CASSFADLDYGYTF	TRBV11-3	TRBJ1-2
TGTGCCAGCAGTGATTTCCGACACTCCGCAGATACGCAGTATTTT	CASSDFRHSADTQYF	TRBV2	TRBJ2-3
TGTGCCACCAAGCCGGGACAGTCCTACAATGAGCAGTTCTTC	CATKPGQSYNEQFF	TRBV24-1	TRBJ2-1
TGCGCCAGCGGGACTCAACTCCGGGGTCTGGGCTACGAGCAGTACTTC	CASGTQLRGLGYEQYF	TRBV10-1	TRBJ2-7
TGTGCTAGTGGTTTGCCGACTAGCGGGAGGTCTCGGACTTGCTCTGGAAACACCATATATTTT	CASGLPTSGRSRTCSGNTIYF	TRBV12-5	TRBJ1-3
TGTGCCAGCAGTGATGCCGGAACCGGGGAGCTGTTTTTT	CASSDAGTGELFF	TRBV25-1	TRBJ2-2
TGCAGTGCTAGAGATTGCAGGACAGGGCCCAGCACTGAAGCTTTCTTT	CSARDCRTGPSTEAFF	TRBV20-1	TRBJ1-1
TGTGCCAGCAGTCCTAGCGGGTACTCCTACCTAGAGCAGTACTTC	CASSPSGYSYLEQYF	TRBV27	TRBJ2-7
TGTGCCAGCAGTGACTCATTCCTAGCGACTGAGCAGTTCTTC	CASSDSFLATEQFF	TRBV6-4	TRBJ2-1
TGTGCCAGCAGCTTACAGGGGACTAGCGGTCTAAGAATCATCTTCCATGAGCAGTTCTTC	CASSLQGTSGLRIIFHEQFF	TRBV7-3	TRBJ2-1
TGTGCCAGCAGCCAAGAAGCGGGGGGGAATGAGCAGTTCTTC	CASSQEAGGNEQFF	TRBV14	TRBJ2-1
TGTGCCAGCAGCGGCCAGGATAGCGGGAGCTGGCCCTACGAGCAGTACTTC	CASSGQDSGSWPYEQYF	TRBV7-3	TRBJ2-7
TGCAGTGCTAGCCATCCGACAGGGTACGAAAAACTGTTTTTT	CSASHPTGYEKLFF	TRBV20-1	TRBJ1-4
TGCGCCAGCGCCGGGACGCCTTACTCCACAGATACGCAGTATTTT	CASAGTPYSTDTQYF	TRBV5-1	TRBJ2-3
TGCGCCAGCAGCTTGACACAGGCCAGGAACACTGAAGCTTTCTTT	CASSLTQARNTEAFF	TRBV5-1	TRBJ1-1
TGTGCCAGCAGCCCTCTCCAGTGCCGGGCGAGAAGGGGGGGTTTTTATCAGCCCCAGCATTTT	CASSPLQCRARRGGFYQPQHF	TRBV7-3	TRBJ1-5
TGTGCCTGGATGGGTGGACTAAAACATGAACGACACTCCTACAATGAGCAGTTCTTC	CAWMGGLKHERHSYNEQFF	TRBV30	TRBJ2-1
TGTGCCAGCAAGCCAAACACTGAAGCTTTCTTT	CASKPNTEAFF	TRBV6-4	TRBJ1-1
TGTGCCAGCAGTCATCACAGCAAAACTAATGAAAAACTGTTTTTT	CASSHHSKTNEKLFF	TRBV6-2	TRBJ1-4
TGCAGCGTTGAAGATACAGACAGACCCCTAGGAAATTCACCCCTCCACTTT	CSVEDTDRPLGNSPLHF	TRBV29-1	TRBJ1-6
TGTGCCAGCAGTGTTAGGGGAGGGAGTTTCTCCTACGAGCAGTACTTC	CASSVRGGSFSYEQYF	TRBV2	TRBJ2-7
TGTGCCAGCAGACGTAGACTGGGTATGAACACTGAAGCTTTCTTT	CASRRRLGMNTEAFF	TRBV4-2	TRBJ1-1
TGTGCCAGCAGCACGGCTAGCGGTTACGAGCAGTACTTC	CASSTASGYEQYF	TRBV13	TRBJ2-7
TGTGCCAGCAGCTTACGAGGCCGGGACATTCACTATGGCTACACCTTC	CASSLRGRDIHYGYTF	TRBV7-9	TRBJ1-2
TGTGCCAGCAGTGACCGGGCCGAGGACTACGAGCAGTACTTC	CASSDRAEDYEQYF	TRBV6-4	TRBJ2-7
TGTGCCAGCAGTCCGGGAGAGATAGATCCGGGACTAGCGGGAGGGAAAGAGACCCAGTACTTC	CASSPGEIDPGLAGGKETQYF	TRBV12-3	TRBJ2-5
TGTGCCAGCAGCGGGTCGACTAGCCAAGAGACCCAGTACTTC	CASSGSTSQETQYF	TRBV2	TRBJ2-5
TGTGCCAGCAGCCAAGATCAGAAAGGACGCGGACTAGCGGGGAACTACGAGCAGTACTTC	CASSQDQKGRGLAGNYEQYF	TRBV3-1	TRBJ2-7
TGTGCCAGACCCAGCGTTGACTCGCATGAGCAGTTCTTC	CARPSVDSHEQFF	TRBV2	TRBJ2-1
TGTGCCAGCAGCGCAATAGCGGGGGAATGTATCACCGGGGAGCTGTTTTTT	CASSAIAGECITGELFF	TRBV9	TRBJ2-2
TGCAGTGCTAGAGGTCAGGGGGACCAAGAGACCCAGTACTTC	CSARGQGDQETQYF	TRBV20-1	TRBJ2-5
TGTGCCTCTATCCCCAAGACGATACACACTGAAGCTTTCTTT	CASIPKTIHTEAFF	TRBV25-1	TRBJ1-1
TGTGCCAGCAGCTATAGAGTCGGGCCGAATGAGCAGTTCTTC	CASSYRVGPNEQFF	TRBV11-3	TRBJ2-1
TGCAGTGCTAGTGGAGAAGAGACCCAGTACTTC	CSASGEETQYF	TRBV20-1	TRBJ2-5
TGTGCCAGCAGTCCGGGACACGGCAAAGGATCCGGGGAGCTGTTTTTT	CASSPGHGKGSGELFF	TRBV6-6	TRBJ2-2
TGTGCCAGCAGCCTATTGCGAAATGAGCAGTTCTTC	CASSLLRNEQFF	TRBV13	TRBJ2-1
TGTGCCAGCAGCTTAAGGGGGCGACAGGGAGGGGCTAACTATGGCTACACCTTC	CASSLRGRQGGANYGYTF	TRBV7-9	TRBJ1-2
TGTGCCAGCAGCAATAGGGGGGCTCGCTACGAGCAGTACTTC	CASSNRGARYEQYF	TRBV7-7	TRBJ2-7
TGTGCCAGCAGTCGGGGAGCGGGCCGCCCGGTGTACGAGCAGTACTTC	CASSRGAGRPVYEQYF	TRBV6-5	TRBJ2-7
TGTGCCTGGAACGGGGGGGATGCGGGAGAAGTGAACACTGAAGCTTTCTTT	CAWNGGDAGEVNTEAFF	TRBV30	TRBJ1-1
TGTGCCAGCAGCCAGGGGGGAGAGACCGGGGAGCTGTTTTTT	CASSQGGETGELFF	TRBV14	TRBJ2-2
TGCGCCAGCAGCTTGGGGCAGTACACTGAAGCTTTCTTT	CASSLGQYTEAFF	TRBV5-1	TRBJ1-1
TGTGCCAGCAGCCCGGGGTACAGGGCCTACGAGCAGTACTTC	CASSPGYRAYEQYF	TRBV7-2	TRBJ2-7
TGTGCCAGCAGTACCCAACAGGGGGCAGCTGGGAGGGGCATGCCCTGCTACGAGCAGTACTTC	CASSTQQGAAGRGMPCYEQYF	TRBV6-5	TRBJ2-7
TGTGCCAGCAGCTTAGCCTTGGGACACATCACAGATACGCAGTATTTT	CASSLALGHITDTQYF	TRBV7-2	TRBJ2-3
TGTGCCAGCTCACGAGGCGAGCAGACTGAAGCTTTCTTT	CASSRGEQTEAFF	TRBV18	TRBJ1-1
TGCGCCAGCATGCCTAGGCATGAGCAGTTCTTC	CASMPRHEQFF	TRBV10-2	TRBJ2-1
TGTGCCAGCAGCTTAGAGGGGGAGGGGCGGCAGCCCCAGCATTTT	CASSLEGEGRQPQHF	TRBV7-2	TRBJ1-5
TGCGCCAGCAGCTTGGAGAGGGAGGGGTATAGCAATCAGCCCCAGCATTTT	CASSLEREGYSNQPQHF	TRBV5-1	TRBJ1-5
TGTGCCAGCAGCCAAGGACGTGAAGCCGGGGAGCTGTTTTTT	CASSQGREAGELFF	TRBV3-1	TRBJ2-2
TGTGCCAGCAGCGCTTCCCCCAGGGGGGGAAACACCATATATTTT	CASSASPRGGNTIYF	TRBV9	TRBJ1-3
TGCAGCGCCCAGGGCGGACGAAACACCATATATTTT	CSAQGGRNTIYF	TRBV29-1	TRBJ1-3
TGTGCCAGCAGGGGACAGGGTCGGGAGGAGACCCAGTACTTC	CASRGQGREETQYF	TRBV7-3	TRBJ2-5
TGTGCCAGCAGCCGCTTTCTAGCGCCTTCCGGGGAGCTGTTTTTT	CASSRFLAPSGELFF	TRBV6-4	TRBJ2-2
TGTGCCAGCAGTTTACCCTCGGAAGCTGATGGCTACACCTTC	CASSLPSEADGYTF	TRBV27	TRBJ1-2
TGTGCCAGCAGTTACTCGCCTATACATGGGGGCTCTGGAAACACCATATATTTT	CASSYSPIHGGSGNTIYF	TRBV6-5	TRBJ1-3
TGTGCCAGCTCACCACTCGGTCTAGCGGGTAGAGAGGGCTACAATGAGCAGTTCTTC	CASSPLGLAGREGYNEQFF	TRBV18	TRBJ2-1
TGCGCCAGCAGCCAAGAGACAGAACGGCACTACGAGCAGTACTTC	CASSQETERHYEQYF	TRBV4-1	TRBJ2-7
TGTCCAAGGGACGTATTGAACACCGGGGAGCTGTTTTTT	CPRDVLNTGELFF	TRBV30	TRBJ2-2
TGTGCCAGCAGCTTCACCCGAGAGACCCAGTACTTC	CASSFTRETQYF	TRBV7-9	TRBJ2-5
TGTGCCAGCAGCGTGAAGGGGGTAATGAACACTGAAGCTTTCTTT	CASSVKGVMNTEAFF	TRBV7-3	TRBJ1-1
TGTGCCAGCCCAAGCCGAGGGTACGAGCAGTACTTC	CASPSRGYEQYF	TRBV6-1	TRBJ2-7
TGTGCCACCAGTCCCCATGATAATCAGCCCCAGCATTTT	CATSPHDNQPQHF	TRBV24-1	TRBJ1-5
TGTGCCAGCAGTGCCTGGGGACAGGGTGGGGCCAACGTCCTGACTTTC	CASSAWGQGGANVLTF	TRBV2	TRBJ2-6
TGCGCCGAAGCCCCGGGGAGGGAGTTCAGGGGCCCCTACAATGAGCAGTTCTTC	CAEAPGREFRGPYNEQFF	TRBV10-2	TRBJ2-1
TGCAGTGCTAGCCGACAGGAGACCCAGTACTTC	CSASRQETQYF	TRBV20-1	TRBJ2-5
TGCGCCAGCAGCCACGGGACGAAATACGAGCAGTACTTC	CASSHGTKYEQYF	TRBV4-1	TRBJ2-7
TGTGCCAGCATCGCGGGAGAACACTCGAACACTGAAGCTTTCTTT	CASIAGEHSNTEAFF	TRBV27	TRBJ1-1
TGTGCCAGCAGCTTAAAATTGACAGGGCGGAGCAATCAGCCCCAGCATTTT	CASSLKLTGRSNQPQHF	TRBV7-3	TRBJ1-5
TGTGCCAGCAGCCATTCACATTCCGGAGGGGGCACTGAAGCTTTCTTT	CASSHSHSGGGTEAFF	TRBV14	TRBJ1-1
TGCAGTGCTGGTAACACTAGCGGGAGCCTTCGGAACTATGGCTACACCTTC	CSAGNTSGSLRNYGYTF	TRBV20-1	TRBJ1-2
TGTGCCAGCAGTTTATTCAGTGGGAACACCGGGGAGCTGTTTTTT	CASSLFSGNTGELFF	TRBV27	TRBJ2-2
TGTGCCAGCAGCGTAGGACAGATAAGAAATCAGCCCCAGCATTTT	CASSVGQIRNQPQHF	TRBV13	TRBJ1-5
TGCAGTGCTAAGAACACTGAAGCTTTCTTT	CSAKNTEAFF	TRBV20-1	TRBJ1-1
TGTGCAACAAGGGGCGACTCCTACGAGCAGTACTTC	CATRGDSYEQYF	TRBV12-5	TRBJ2-7
TGTGCCAGCAGCGTATACCTAGCGGGAAGCTCCTACGAGCAGTACTTC	CASSVYLAGSSYEQYF	TRBV9	TRBJ2-7
TGTGCCAGCAGCTCACCGCCGGACAGGGGGGTCCAAAGGCACACCCAGCATTTT	CASSSPPDRGVQRHTQHF	TRBV7-6	TRBJ1-5
TGCAGTGCTAGATCGCTAGTCGGGGCTGAAGCTTTCTTT	CSARSLVGAEAFF	TRBV20-1	TRBJ1-1
TGCGCCAGCAGCTTGGGATCGGAAATTAAAAGCTCCTACGAGCAGTACTTC	CASSLGSEIKSSYEQYF	TRBV5-1	TRBJ2-7
TGTGCCAGCAGCAATGCCGGGACAAGCGACTACGAGCAGTACTTC	CASSNAGTSDYEQYF	TRBV6-8	TRBJ2-7
TGTGCCAGCAGTAGGGGGCTTCCGAGGAATGAGCAGTTCTTC	CASSRGLPRNEQFF	TRBV6-2	TRBJ2-1
TGTGCCAGCAGTTTAGGGGACCGTGTCTACGAGCAGTACTTC	CASSLGDRVYEQYF	TRBV27	TRBJ2-7
TGCGCCAGCAGCCGAGGGGCTGGCCCCCAGTACAATGAGCAGTTCTTC	CASSRGAGPQYNEQFF	TRBV5-1	TRBJ2-1
TGTGCCAGCAGCCATCACAGGGAGTACTTC	CASSHHREYF	TRBV3-1	TRBJ2-7
TGTGCCAGCAGTTACACACGGGGGGGAGGATTTGTCAATCAGCCCCAGCATTTT	CASSYTRGGGFVNQPQHF	TRBV6-3	TRBJ1-5
TGCGCCAGCAGCCCCTTAAGACGGAACACTGAAGCTTTCTTT	CASSPLRRNTEAFF	TRBV5-1	TRBJ1-1
TGCAGTGCCCTCGGAAGCAACGTTAACACTGAAGCTTTCTTT	CSALGSNVNTEAFF	TRBV20-1	TRBJ1-1
TGTGCCAGCAGTGAGGCCACTAGCGGGAGTTACACCGGGGAGCTGTTTTTT	CASSEATSGSYTGELFF	TRBV6-1	TRBJ2-2
TGTGCCACCAGTGAGGTGGATCGGGCATATGGCTACACCTTC	CATSEVDRAYGYTF	TRBV24-1	TRBJ1-2
TGTGCCAGCAGTGACCGGGGTGGGAGGTTTTTTCTGTTTTTT	CASSDRGGRFFLFF	TRBV6-1	TRBJ1-4
TGTGCCAGCAGTTTATCAGGGGGTGACTCTGGGGCCAACGTCCTGACTTTC	CASSLSGGDSGANVLTF	TRBV28	TRBJ2-6
TGTGCCAGCAGGCGGGTATGCGGGAGCCGGACGTACGAGCAGTACTTC	CASRRVCGSRTYEQYF	TRBV12-4	TRBJ2-7
TGTGCCAGCAGTGCCGGGAACTGCGACGAGCAGTACTTC	CASSAGNCDEQYF	TRBV27	TRBJ2-7
TGTGCCAGCGGAAATCGGGGTGGCGAGCAGTACTTC	CASGNRGGEQYF	TRBV6-5	TRBJ2-7
TGCAGTGCTAGAGATTCAGAGGAGGGGGGCAATGAGCAGTTCTTC	CSARDSEEGGNEQFF	TRBV20-1	TRBJ2-1
TGTGCCATAAAGTCCGACGGAGCCAAAAACATTCAGTACTTC	CAIKSDGAKNIQYF	TRBV7-8	TRBJ2-4
TGTGCCAGCACTTCCGTTCTCCACAACACTGAAGCTTTCTTT	CASTSVLHNTEAFF	TRBV6-6	TRBJ1-1
TGTGCCAGCAGCCAAGGTTGGGGGCTAAATCAGCCCCAGCATTTT	CASSQGWGLNQPQHF	TRBV3-1	TRBJ1-5
TGTGCCAGCAGTTTAGCAACAGGGCTTGGTTCACCCCTCCACTTT	CASSLATGLGSPLHF	TRBV28	TRBJ1-6
TGTGCCAGCAGTGATAGGTCACAGGGCCGCAACACCGGGGAGCTGTTTTTT	CASSDRSQGRNTGELFF	TRBV6-1	TRBJ2-2
TGTGCCAGCAGCTTATATCGAAGTAAGGAGCAGTACTTC	CASSLYRSKEQYF	TRBV7-4	TRBJ2-7
TGTGCCAGCAGTCTAGTGGGGAAGCAGTACTTC	CASSLVGKQYF	TRBV6-6	TRBJ2-7
TGCAGTGCTAATTCCTACAGGGGGAGTCGGAACTATGGCTACACCTTC	CSANSYRGSRNYGYTF	TRBV20-1	TRBJ1-2
TGCGCCAGCAGTGACGTAAGGGGTTATAGCAATCAGCCCCAGCATTTT	CASSDVRGYSNQPQHF	TRBV10-1	TRBJ1-5
TGCGCCAGCAGCTTGTCGATACCCTACGAGCAGTACTTC	CASSLSIPYEQYF	TRBV5-1	TRBJ2-7
TGCGCCAGCAGTCAGGTATCCTATAATTCACCCCTCCACTTT	CASSQVSYNSPLHF	TRBV5-1	TRBJ1-6
TGTGCCAGCAGTTTCCCGGGACTAGCGGGCAGCAATGAGCAGTTCTTC	CASSFPGLAGSNEQFF	TRBV27	TRBJ2-1
TGCGCCAGCAGCTTCTTAGGGTATAATGAAAAACTGTTTTTT	CASSFLGYNEKLFF	TRBV5-1	TRBJ1-4
TGTGCCACCGGTCCAGGGGATTTGGTTTTCCACTACGAGCAGTACTTC	CATGPGDLVFHYEQYF	TRBV24-1	TRBJ2-7
TGTGCCAGCAATCCCTCCCCGGCTGTATACCCCAATCAGCCCCAGCATTTT	CASNPSPAVYPNQPQHF	TRBV6-3	TRBJ1-5
TGTGCCAGCAGCCAAGATGAAAAGAGAACGTACAGGGTACGCTACACCTTC	CASSQDEKRTYRVRYTF	TRBV3-1	TRBJ1-2
TGTGCCAGCAGCTTGCCCAGACACGACAGTCTGAGTGGCTACACCTTC	CASSLPRHDSLSGYTF	TRBV5-4	TRBJ1-2
TGTGCCAGCAGATCACGGGGGTACAATGAGCAGTTCTTC	CASRSRGYNEQFF	TRBV12-4	TRBJ2-1
TGCGCCAGCAGCACCACGGGACCCAGAGGGGGATTCGAATCAGATACGCAGTATTTT	CASSTTGPRGGFESDTQYF	TRBV5-1	TRBJ2-3
TGCAGTGCGGAGCCGGGACAGGGGCCCCCCCACGAGCAGTACTTC	CSAEPGQGPPHEQYF	TRBV20-1	TRBJ2-7
TGTGCCAGCACCCCCCGGGACAGGGGGAATGAGCAGTTCTTC	CASTPRDRGNEQFF	TRBV5-4	TRBJ2-1
TGTGCCAGCAGCGATTTAACTGAAGCTTTCTTT	CASSDLTEAFF	TRBV7-9	TRBJ1-1
TGTGCCAGCAGCTTAGCAGGAGGGACATGCAATGAGCAGTTCTTC	CASSLAGGTCNEQFF	TRBV7-9	TRBJ2-1
TGTGCCAGCAGTGCGCAAGCCGGGGGTGGGGGCAGATGGAACACTGAAGCTTTCTTT	CASSAQAGGGGRWNTEAFF	TRBV2	TRBJ1-1
TGTGCCAGCAGCCAACACCAGGGGGGGGGTTGTATCCATCAGCCCCAGCATTTT	CASSQHQGGGCIHQPQHF	TRBV14	TRBJ1-5
TGTGCCAGCAGTTTGTGGGGGAACACCGGGGAGCTGTTTTTT	CASSLWGNTGELFF	TRBV27	TRBJ2-2
TGTGCCAGCAGTTACGTTGTAAGGGGCAGATTTAATCACACTGAAGCTTTCTTT	CASSYVVRGRFNHTEAFF	TRBV6-3	TRBJ1-1
TGTGCCACCGTAGCGGGATTCGGCAATGAGCAGTTCTTC	CATVAGFGNEQFF	TRBV11-3	TRBJ2-1
TGTGCCAGCAGCGGGCAACAGGGGAATGAAAAACTGTTTTTT	CASSGQQGNEKLFF	TRBV9	TRBJ1-4
TGTGCCAGCAGCCAAAGTGGGGGGGGCACTGAAGCTTTCTTT	CASSQSGGGTEAFF	TRBV5-4	TRBJ1-1
TGTGCCAGCAGTTACCGGGGGCGTGGCACTGAAGCTTTCTTT	CASSYRGRGTEAFF	TRBV6-9	TRBJ1-1
TGTGCCAGCAGTTTCCACCGGCGGTTACGGGCCGGGGAGCTGTTTTTT	CASSFHRRLRAGELFF	TRBV6-5	TRBJ2-2
TGTGCCACCACGTGGACAGAGGGGGGGATTACCTACAATGAGCAGTTCTTC	CATTWTEGGITYNEQFF	TRBV24-1	TRBJ2-1
TGCGCCAGCAGCCGGGGACAGCTTCTCGTTCATGGCTACACCTTC	CASSRGQLLVHGYTF	TRBV5-1	TRBJ1-2
TGTGCCAGCAGTTTATCAGTGTTCTCCTATAATTCACCCCTCCACTTT	CASSLSVFSYNSPLHF	TRBV27	TRBJ1-6
