TGTGCCTGGGGACAGGGGTGGTACCGTGTAGTCATGAACACTGAAGCTTTCTTT	CAWGQGWYRVVMNTEAFF	TRBV30	TRBJ1-1
TGTGCCAGCAGCCCCGGGTCGGGTGCATATCAGCCCCAGCATTTT	CASSPGSGAYQPQHF	TRBV5-4	TRBJ1-5
TGTGCCAGCAGCTTAACTATCAACAGGGTAAGCCGGGAGCAGTACTTC	CASSLTINRVSREQYF	TRBV7-3	TRBJ2-7
TGTGCCAGTAGCCACCGGGGGCGAAATCAGCCCCAGCATTTT	CASSHRGRNQPQHF	TRBV19	TRBJ1-5
TGTGCCAGCATGACTGGGGGGCGATGCAGTAGCTCCTACAATGAGCAGTTCTTC	CASMTGGRCSSSYNEQFF	TRBV27	TRBJ2-1
TGTGCCATCAGGGCCCCATCCTCCTACAATGAGCAGTTCTTC	CAIRAPSSYNEQFF	TRBV10-3	TRBJ2-1
TGTGCCAGCAGCTTGGACTGGGGGGCGCGTCAAGTATATGGCTACACCTTC	CASSLDWGARQVYGYTF	TRBV5-4	TRBJ1-2
TGTGCCATCGACCGGGACGTAGTTCGCGCTGGAAACACCATATATTTT	CAIDRDVVRAGNTIYF	TRBV24-1	TRBJ1-3
TGTGCCACCAGTGATTGGGGACGGACAGGGGGCATGAACTATAATTCACCCCTCCACTTT	CATSDWGRTGGMNYNSPLHF	TRBV24-1	TRBJ1-6
TGTGCCAGCAGCCAAGGAGGGACTAGCGGGGGCGGAAATACGCAGTATTTT	CASSQGGTSGGGNTQYF	TRBV4-2	TRBJ2-3
TGTGCCAGCAGCCAAATGTCTTACGCTAGCACAGATACGCAGTATTTT	CASSQMSYASTDTQYF	TRBV3-1	TRBJ2-3
TGTGCCAGCAGCTTAGACCTCTACGAGCAGTACTTC	CASSLDLYEQYF	TRBV6-4	TRBJ2-7
TGTGCCAGCAGTGAGTACCAGGGACTAGCGGGGGCACCTTCGTTTCCGGGGGCCTACGAGCAGTACTTC	CASSEYQGLAGAPSFPGAYEQYF	TRBV25-1	TRBJ2-7
TGTGCCAGCAGCTTGTTGGGGGGACCAGAGGGTCCTCGCTCCTATAATTCACCCCTCCACTTT	CASSLLGGPEGPRSYNSPLHF	TRBV5-6	TRBJ1-6
TGCAGCGTGACTAGCCATGAGCAGTTCTTC	CSVTSHEQFF	TRBV29-1	TRBJ2-1
TGTGCCACCAGCAGAGGGCCCCAACCCGGGACACTTCCAAATCAGCCCCAGCATTTT	CATSRGPQPGTLPNQPQHF	TRBV15	TRBJ1-5
TGTGCCAGCAGCGTCCACAGAAATTCACCCCTCCACTTT	CASSVHRNSPLHF	TRBV9	TRBJ1-6
TGCGCCAGCAGTGATAATCGGGACTGGTACGAGCAGTACTTC	CASSDNRDWYEQYF	TRBV10-2	TRBJ2-7
TGTGCCAGCAGCAGGACACCACAGGGGGGGGATTCGAACACCGGGGAGCTGTTTTTT	CASSRTPQGGDSNTGELFF	TRBV7-9	TRBJ2-2
TGCGCCAGCAGCCAACACCGGGGGCGCTACGAGCAGTACTTC	CASSQHRGRYEQYF	TRBV4-1	TRBJ2-7
TGTGCCAGCAACTCTACTGAAGCTTTCTTT	CASNSTEAFF	TRBV6-4	TRBJ1-1
TGTGCCAGCACCACAGGGGGCGGGGTCGGCGAGCAGTACTTC	CASTTGGGVGEQYF	TRBV6-5	TRBJ2-7
TGTGCCAGCAGTCGCGGGAGAAGCACCGGGGAGCTGTTTTTT	CASSRGRSTGELFF	TRBV25-1	TRBJ2-2
TGTGCCACACCCCTACTAGCGGGAGTGGGTGAGCAGTTCTTC	CATPLLAGVGEQFF	TRBV24-1	TRBJ2-1
TGTGCCTCAGGTTATTCACCCCTCCACTTT	CASGYSPLHF	TRBV30	TRBJ1-6
TGTGCCAGTAGTCCTCTGGGTTATGGCTACACCTTC	CASSPLGYGYTF	TRBV19	TRBJ1-2
TGTGCCAGCAGCTGGGGGGACGGCCGTTACCGGGAGACCCAGTACTTC	CASSWGDGRYRETQYF	TRBV5-6	TRBJ2-5
TGCGCCAGCAGCTTGGAGGGGGCTGGGGAGAAAGTGATCTCCGGCTATGGCTACACCTTC	CASSLEGAGEKVISGYGYTF	TRBV5-1	TRBJ1-2
TGTGCCTGGAGTGTACAGAGGGGATGCCCGGGGGCTTCTTATCAGCCCCAGCATTTT	CAWSVQRGCPGASYQPQHF	TRBV30	TRBJ1-5
TGTGCCAGCAACTTAGGGCCAGAAGACTACGAGCAGTACTTC	CASNLGPEDYEQYF	TRBV6-4	TRBJ2-7
TGTGCCAGCAGCTTGGGGGCGGGGGTTAGCTCCTATAATTCACCCCTCCACTTT	CASSLGAGVSSYNSPLHF	TRBV5-4	TRBJ1-6
TGTGCCAGCAGCTCGACAGGGGGCATCGGTAACACTGAAGCTTTCTTT	CASSSTGGIGNTEAFF	TRBV5-6	TRBJ1-1
TGTGCCATCAGACCGGGACAGGGGGAAAGCTCCTACAATGAGCAGTTCTTC	CAIRPGQGESSYNEQFF	TRBV10-3	TRBJ2-1
TGTGCCAGCAGAAGACAGGGTTCTCGCTATGGCTACACCTTC	CASRRQGSRYGYTF	TRBV9	TRBJ1-2
TGCGCCAGCAGCCAAGACTATAGGGGGGGAAGACACGAGCAGTACTTC	CASSQDYRGGRHEQYF	TRBV4-3	TRBJ2-7
TGTCCAGCGGGAGACACTGAAGCTTTCTTT	CPAGDTEAFF	TRBV30	TRBJ1-1
TGTGCCACCAGTGAGTATTCGACAGGCGACTCCTACGAGCAGTACTTC	CATSEYSTGDSYEQYF	TRBV24-1	TRBJ2-7
TGTGCCAGCAAGGGACTTAGAACCCCCCGGGGGGGGAGGGTGAGAACAGATACGCAGTATTTT	CASKGLRTPRGGRVRTDTQYF	TRBV28	TRBJ2-3
TGTGCCAGCAGCCAATATAAGCGCAGAAGCAATCAGCCCCAGCATTTT	CASSQYKRRSNQPQHF	TRBV14	TRBJ1-5
TGCAGTGCTAGGGGGGCCCTTCACGAGCAGTACTTC	CSARGALHEQYF	TRBV20-1	TRBJ2-7
TGTGCCAGCAGCGGGTCAAGACAGGGCTCTGGAAACACCATATATTTT	CASSGSRQGSGNTIYF	TRBV5-6	TRBJ1-3
TGTGCCAGTAGTATGGCCCGGAGGGACAAATCCCCCACCGGGGAGCTGTTTTTT	CASSMARRDKSPTGELFF	TRBV19	TRBJ2-2
TGTGCCAGCAGTTTGACTAGAGCCAAAAACATTCAGTACTTC	CASSLTRAKNIQYF	TRBV27	TRBJ2-4
TGTGCCAGCAGCGAGGGGAGGGTCGGCTACACCTTC	CASSEGRVGYTF	TRBV27	TRBJ1-2
TGTGCCAGCAGCTACTTACCCGGGGATGGCTACACCTTC	CASSYLPGDGYTF	TRBV9	TRBJ1-2
TGTGCTAGGACGGGTCCCAATCAGCCCCAGCATTTT	CARTGPNQPQHF	TRBV12-5	TRBJ1-5
TGCGCCAGCAGCTGGGGACAGTTAGCCTACGAGCAGTACTTC	CASSWGQLAYEQYF	TRBV5-1	TRBJ2-7
TGTGCCAGCAAGGTCCTCCCGGGACTAGCGGGCGCAGTTGAGCAGTTCTTC	CASKVLPGLAGAVEQFF	TRBV9	TRBJ2-1
TGTGCCAGCAGTGCTCCGGGGGACCCGGGGCAGTACTTC	CASSAPGDPGQYF	TRBV27	TRBJ2-7
TGTGCCAGCAGCTTATTACCTGGGGGACAGTGGGGCAATCAGCCCCAGCATTTT	CASSLLPGGQWGNQPQHF	TRBV7-4	TRBJ1-5
TGTGCCAGCAGTGAAGGGACTAGTCAAGAGACCCAGTACTTC	CASSEGTSQETQYF	TRBV6-4	TRBJ2-5
TGTGCCAGCATCCGCGGACAGCGACGGGAAAGGAGGGGTGCTTTCTTT	CASIRGQRRERRGAFF	TRBV19	TRBJ1-1
TGTGCCAGTAGTATAGCCACAGGGAGAAGGGGCTCCTATAATTCACCCCTCCACTTT	CASSIATGRRGSYNSPLHF	TRBV19	TRBJ1-6
TGTGCCAGCAGCATCCGGGACCTAAAGATCTCCTACGAGCAGTACTTC	CASSIRDLKISYEQYF	TRBV9	TRBJ2-7
TGTGCCAGCAGCTACCAGGCCGGGCCAGTATTCAAGGCGCAGTACTTC	CASSYQAGPVFKAQYF	TRBV27	TRBJ2-7
TGCAGTGCTAGAGATAGGACAAACGGCTACACCTTC	CSARDRTNGYTF	TRBV20-1	TRBJ1-2
TGTGCCAGTGACAACCCTAGGGGGCCTTCGGTGTCCCCTAACTATGGCTACACCTTC	CASDNPRGPSVSPNYGYTF	TRBV5-6	TRBJ1-2
TGTGCCATCTACCCTGGGACTAGCGGGCCACGGCGCACAGATACGCAGTATTTT	CAIYPGTSGPRRTDTQYF	TRBV10-3	TRBJ2-3
TGTGCCAGCACAAGGAGCCCGGGACAGCAAAATAGCAATCAGCCCCAGCATTTT	CASTRSPGQQNSNQPQHF	TRBV25-1	TRBJ1-5
TGCAGCGTTGAGAGGGGGCCCCGGATTAGCAATCAGCCCCAGCATTTT	CSVERGPRISNQPQHF	TRBV29-1	TRBJ1-5
TGTGCCAGCAGCAAAGGCGGTCGGGGGGTGCGACAAAGCTCCTACAATGAGCAGTTCTTC	CASSKGGRGVRQSSYNEQFF	TRBV13	TRBJ2-1
TGTGCCAGCAACGGACGCGGACAGGGATCCTACGAGCAGTACTTC	CASNGRGQGSYEQYF	TRBV28	TRBJ2-7
TGTGCCAGCAGAAAGCGAACAGGGTCGGATGAGCAGTTCTTC	CASRKRTGSDEQFF	TRBV11-2	TRBJ2-1
TGTGCCAGCAGTTACTTACTAGCGGGCCCCATTTATGGAATAATCTTC	CASSYLLAGPIYGIIF	TRBV6-5	TRBJ2-7
TGCAGTGCCTCCCTTGACAGGTTTGGTAATGAAAAACTGTTTTTT	CSASLDRFGNEKLFF	TRBV20-1	TRBJ1-4
TGCAGTGCTAGCGGGCCCGAGGACAGGGCTTTCTTT	CSASGPEDRAFF	TRBV20-1	TRBJ1-1
TGTGCCAGCAGGGAATCGCAGTACTTC	CASRESQYF	TRBV6-5	TRBJ2-7
TGCGCCAGCAGCAAGACAGGGGAGAGGATCTATGGCTACACCTTC	CASSKTGERIYGYTF	TRBV5-1	TRBJ1-2
TGTGCCAGCAGACCACAGGGGGCCGGATTCTACGAGCAGTACTTC	CASRPQGAGFYEQYF	TRBV27	TRBJ2-7
TGTGCCACCAGTCCCCCGGGGAAGAATGAAAAACTGTTTTTT	CATSPPGKNEKLFF	TRBV24-1	TRBJ1-4
TGCGCCAGCAGCCAAGATTCTACCGGGACATGGGTCACTGAAGCTTTCTTT	CASSQDSTGTWVTEAFF	TRBV4-1	TRBJ1-1
TGTGCCACGTACCGGGATCTCTATGGCTACACCTTC	CATYRDLYGYTF	TRBV28	TRBJ1-2
TGTGCCAGCAGCTTAGGCGCACCACGGGGGTTTTCACCCCTCCACTTT	CASSLGAPRGFSPLHF	TRBV7-6	TRBJ1-6
TGCAGTCCTAGCCTAGCGGGTGGGCTATACAATGAGCAGTTCTTC	CSPSLAGGLYNEQFF	TRBV20-1	TRBJ2-1
TGCAGTGCTAGAGTTAGGAGGGACAGGGTCTTGAAAGGGTATGGCTACACCTTC	CSARVRRDRVLKGYGYTF	TRBV20-1	TRBJ1-2
TGTGCCAGCAGCCTCGCGGGGCACGCTAATGAAAAACTGTTTTTT	CASSLAGHANEKLFF	TRBV3-1	TRBJ1-4
TGTGCCAGCAGCCAACCCGGGCGGACAGGGCGTAGCACAGATACGCAGTATTTT	CASSQPGRTGRSTDTQYF	TRBV3-1	TRBJ2-3
TGTGCCAGCAGCAGACAGAAAGTCTCCTATAATTCACCCCTCCACTTT	CASSRQKVSYNSPLHF	TRBV9	TRBJ1-6
TGCGCCAGCAGTGATAGGAATCAGCCCCAGCATTTT	CASSDRNQPQHF	TRBV10-2	TRBJ1-5
TGCGCCAGCAGCTTGTGTGACGGTAAAATCCGGTCCAATGAGCAGTTCTTC	CASSLCDGKIRSNEQFF	TRBV5-1	TRBJ2-1
TGTGCCAGCAGCCAGGGCGGGGCCGATTCACCCCTCCACTTT	CASSQGGADSPLHF	TRBV7-3	TRBJ1-6
TGTGCCAGCAGCCAAATTCCCGCAGAATCTGGCTACGAGCAGTACTTC	CASSQIPAESGYEQYF	TRBV3-1	TRBJ2-7
TGTGCCAGCAGTGATTTAAGGGGACTAGCGGGGGGGCCTCCTAACTACGAGCAGTACTTC	CASSDLRGLAGGPPNYEQYF	TRBV6-4	TRBJ2-7
TGTGCCAGCAGTTTGGAGTTGGACAGGGCACCAGATACGCAGTATTTT	CASSLELDRAPDTQYF	TRBV12-3	TRBJ2-3
TGCAGTGCTAGCCCCGGGACAGCCGTAGCCAAAAACATTCAGTACTTC	CSASPGTAVAKNIQYF	TRBV20-1	TRBJ2-4
TGTGCCAGCAGTCGGCCGGCGGGAAGCTCTGGAAACACCATATATTTT	CASSRPAGSSGNTIYF	TRBV6-6	TRBJ1-3
TGTGCCAGTAGTTTTCGCAAACAGCCCCAGCATTTT	CASSFRKQPQHF	TRBV19	TRBJ1-5
TGTGCCAGCAGCCCCTCCGGGGGGGTGACCACTGAAGCTTTCTTT	CASSPSGGVTTEAFF	TRBV14	TRBJ1-1
TGTGCCAGCAATCCTGGGGGGACATCCTACGAGCAGTACTTC	CASNPGGTSYEQYF	TRBV9	TRBJ2-7
TGTGCCAGCAGTTTCGCGCATGCGGGAGACAAGGAGCAGTACTTC	CASSFAHAGDKEQYF	TRBV12-4	TRBJ2-7
TGTGCCAGCAGACCGTCCGAAACGGCTGGTGGGTTCTCTGGGGCCAACGTCCTGACTTTC	CASRPSETAGGFSGANVLTF	TRBV6-5	TRBJ2-6
TGTGCCAGCAGTGAAGCGAGGGACAGGGGGTCGGCCCTCCACTTT	CASSEARDRGSALHF	TRBV2	TRBJ1-6
TGCGCCAGCAGCTCGATCGGTAAAGAGACCCAGTACTTC	CASSSIGKETQYF	TRBV5-1	TRBJ2-5
TGCGCCAGCAGCTTGCACCCGAGGGACAGGCTGTTTTTT	CASSLHPRDRLFF	TRBV5-1	TRBJ1-4
TGTGCCAGCAGCTTAGTAGAGACAGCGGTCCAAGATCAGCCCCAGCATTTT	CASSLVETAVQDQPQHF	TRBV5-4	TRBJ1-5
TGTGCCAGCAGCTTGAGGGCCACCGGGGAGCTGTTTTTT	CASSLRATGELFF	TRBV7-3	TRBJ2-2
TGTGCCAGCAGCCGACAGGGGAGGGTCGGTGGCTACACCTTC	CASSRQGRVGGYTF	TRBV6-1	TRBJ1-2
TGTGCCTGGCCTCCGACAGGGGGCGCAAAGGACGAGCAGTACTTC	CAWPPTGGAKDEQYF	TRBV30	TRBJ2-7
TGTGCCAGCAGTTGTGCAACATACAATCAGCCCCAGCATTTT	CASSCATYNQPQHF	TRBV27	TRBJ1-5
TGTGCCAGCAGCCATCCGGGACTAGAAGAGACCCAGTACTTC	CASSHPGLEETQYF	TRBV7-3	TRBJ2-5
TGTGCCAGCATGGAGGGCCGAGCGGAGAACACTGAAGCTTTCTTT	CASMEGRAENTEAFF	TRBV9	TRBJ1-1
TGTGCCAGCAGCCAAGAAAGCGCAGGGACATGGTCTAGCACAGATACGCAGTATTTT	CASSQESAGTWSSTDTQYF	TRBV3-1	TRBJ2-3
TGTGCCCGGGGTGACACTGAAGCTTTCTTT	CARGDTEAFF	TRBV6-2	TRBJ1-1
TGTGCCAGCATTGTATGGGGCTTAAACGGGGCCAACGTCCTGACTTTC	CASIVWGLNGANVLTF	TRBV6-5	TRBJ2-6
TGCGCCAGCAAAGACGGACACCCGGCCATGGGAGGCTACACCTTC	CASKDGHPAMGGYTF	TRBV10-1	TRBJ1-2
TGTGCTAGCAGCTGCGGCAACACCGGGGAGCTGTTTTTT	CASSCGNTGELFF	TRBV7-7	TRBJ2-2
TGTGCCAGCAGCTTAGAAATTGGGGCGGGGTCTTGGAGGGACTATGGCTACACCTTC	CASSLEIGAGSWRDYGYTF	TRBV7-4	TRBJ1-2
TGTGCCAGCAGCTTAGGGGGCAAGAGGGCCCCACTGGTTGTCTACAATGAGCAGTTCTTC	CASSLGGKRAPLVVYNEQFF	TRBV7-2	TRBJ2-1
TGCGCCAGGGGCGGCGATTCTGATACGCAGTATTTT	CARGGDSDTQYF	TRBV4-1	TRBJ2-3
TGTGCCAGCAGCGGGCGGACCATTCATCAGCCCCAGCATTTT	CASSGRTIHQPQHF	TRBV7-2	TRBJ1-5
TGCGCCAGCGACAGCCACACCGGGGAGCTGTTTTTT	CASDSHTGELFF	TRBV5-1	TRBJ2-2
TGTGCCAGCAGCCACACGGGAAGGGGGGAGCCGGACGAGCAGTACTTC	CASSHTGRGEPDEQYF	TRBV3-1	TRBJ2-7
TGTGCCAGCAGCTTGGGACAGGACGAGCAGTACTTC	CASSLGQDEQYF	TRBV5-5	TRBJ2-7
TGTGCCAGCAGCTTATTCATCAACTCTGGGGCCAACGTCCTGACTTTC	CASSLFINSGANVLTF	TRBV7-3	TRBJ2-6
TGTGCCAGCAGCCAGGCTGGAAAGGGCCGCTCTGGGGCCAACGTCCTGACTTTC	CASSQAGKGRSGANVLTF	TRBV5-8	TRBJ2-6
TGTGCCAGCAGGCCCCCATTCTGGCTTCAGCCCCAGCATTTT	CASRPPFWLQPQHF	TRBV6-4	TRBJ1-5
TGTGCCAGCAGACGGCAGACTACTGGGGCCAACGTCCTGACTTTC	CASRRQTTGANVLTF	TRBV27	TRBJ2-6
TGTGCCAGCAGCCCCAGGGACCCTTATTCACCCCTCCACTTT	CASSPRDPYSPLHF	TRBV5-4	TRBJ1-6
TGTGCCAGCAGTGTGACAGCCTATTACTTC	CASSVTAYYF	TRBV6-1	TRBJ2-5
TGTGCCAGCAGTTTCCGCGGATGGACTAGCGGGACCAACAATGAGCAGTTCTTC	CASSFRGWTSGTNNEQFF	TRBV28	TRBJ2-1
TGTGCCAGTACGACTAGGGTCGCTCGGTGGGGCTACGAGCAGTACTTC	CASTTRVARWGYEQYF	TRBV19	TRBJ2-7
TGCAGTGCTAGGGGGGGGCCTGGCAATGAGCAGTTCTTC	CSARGGPGNEQFF	TRBV20-1	TRBJ2-1
TGTGCCAGCAGTTCCCGGGAGAGTCAGGTAAAGGAAAAACTGTTTTTT	CASSSRESQVKEKLFF	TRBV27	TRBJ1-4
TGCGCCAGCCGGAGGGGGGCCCGATCTACTAGTCAAGAGACCCAGTACTTC	CASRRGARSTSQETQYF	TRBV5-1	TRBJ2-5
TGTGCCATCCGCGGGAACTCTGGGGCCAACGTCCTGACTTTC	CAIRGNSGANVLTF	TRBV6-5	TRBJ2-6
TGTGCCAGCAGCGGACTAGCGGGAGAGGGTTCGCAGTTCTTC	CASSGLAGEGSQFF	TRBV5-5	TRBJ2-1
TGTGCCACAGAGGGACAGTATGGCTACACCTTC	CATEGQYGYTF	TRBV27	TRBJ1-2
TGCTATCGGGACAGGATTTCCGGCGGGGAGCTGTTTTTT	CYRDRISGGELFF	TRBV5-1	TRBJ2-2
TGTGCCAGCAATAAGGGGGACACTGAAGCTTTCTTT	CASNKGDTEAFF	TRBV6-5	TRBJ1-1
TGTGCCACCAGTGATTTCAAACCGGGACAGGGTAGGGGTTCACCCCTCCACTTT	CATSDFKPGQGRGSPLHF	TRBV24-1	TRBJ1-6
TGTGCCAGCAGCGGTGGCAGAAAAGGTAGTCATGAGCAGTTCTTC	CASSGGRKGSHEQFF	TRBV9	TRBJ2-1
TGTGCTAGCAGCTTAGTCCCATGGGACAGGCCAACCGGGGCCAAAAACATTCAGTACTTC	CASSLVPWDRPTGAKNIQYF	TRBV7-7	TRBJ2-4
TGTGCCAGCAGCTTGCCACAGGGAATCGAGACCCAGTACTTC	CASSLPQGIETQYF	TRBV5-6	TRBJ2-5
TGTGCCAGCAAATGGGGGGCATCCAATGAGCAGTTCTTC	CASKWGASNEQFF	TRBV27	TRBJ2-1
TGTGCCACCTCTGTCGTAAATGCAGATACGCAGTATTTT	CATSVVNADTQYF	TRBV15	TRBJ2-3
TGTGCCAGCAGCCCAGAGGGGGACCTCTTTGAAGCTTTCTTT	CASSPEGDLFEAFF	TRBV7-4	TRBJ1-1
TGTGCCAGCAGCAGCAAACAGTCCTACAATGAGCAGTTCTTC	CASSSKQSYNEQFF	TRBV7-9	TRBJ2-1
TGTGCCAGCAGCCGCGGGACAGGGCAGTTAAATGAAAAACTGTTTTTT	CASSRGTGQLNEKLFF	TRBV6-3	TRBJ1-4
TGTGCCAGCAGCGATGGACAGGGCCGAACAGCTTTCTTT	CASSDGQGRTAFF	TRBV7-9	TRBJ1-1
TGTGCCACCAGTTCCTCCGGCGGTGATGAGCAGTTCTTC	CATSSSGGDEQFF	TRBV24-1	TRBJ2-1
TGTGCCAGCAGCGTGTCTACGTGTCTTATGAACACTGAAGCTTTCTTT	CASSVSTCLMNTEAFF	TRBV9	TRBJ1-1
TGCGCCAGCAGCTTACCGGAATATAGCAATCAGCCCCAGCATTTT	CASSLPEYSNQPQHF	TRBV5-1	TRBJ1-5
TGCGCCAGCAGCCAAGCCAGGGGCCCGTTGGGCAATCAGCCCCAGCATTTT	CASSQARGPLGNQPQHF	TRBV4-3	TRBJ1-5
TGTGCCAGCAAGGACAGGGTAGGGTCCTACGAGCAGTACTTC	CASKDRVGSYEQYF	TRBV6-5	TRBJ2-7
TGTGCCAGCAGCGGACAGGGTTGGGAATGCACAGATACGCAGTATTTT	CASSGQGWECTDTQYF	TRBV13	TRBJ2-3
TGTGCCAGCAACCCCTCTAGGGGGGGTAGCTCCTACAATGAGCAGTTCTTC	CASNPSRGGSSYNEQFF	TRBV6-1	TRBJ2-1
TGTGCCAGCAGCAAAGACGTTGGACAGCCGCCCTCGCCCCCGACGAGCAACTATGGCTACACCTTC	CASSKDVGQPPSPPTSNYGYTF	TRBV7-9	TRBJ1-2
TGCGCCAGCAGCGCACTAGGTGGACCATACGAGCAGTACTTC	CASSALGGPYEQYF	TRBV4-1	TRBJ2-7
TGCAGTGCTCAAGAGTCGTCAGGGACCAACAATCAGCCCCAGCATTTT	CSAQESSGTNNQPQHF	TRBV20-1	TRBJ1-5
TGTGCCAGCAGTTATCGGGGCGGGGGGGCCTTACGGGAAAAACTGTTTTTT	CASSYRGGGALREKLFF	TRBV6-5	TRBJ1-4
TGTGCCAGCAGTGACTCCCCCCCGCAGGGGCCGGCAACTAATGAAAAACTGTTTTTT	CASSDSPPQGPATNEKLFF	TRBV6-4	TRBJ1-4
TGCAGTGCCCGGGCAGCGGGAAACACCTACGAGCAGTACTTC	CSARAAGNTYEQYF	TRBV20-1	TRBJ2-7
TGTGCCAGCAGCCGGACAGGGGAAGACACTGAAGCTTTCTTT	CASSRTGEDTEAFF	TRBV14	TRBJ1-1
TGTGCCAGCTCCCGGGACAGGGCTCTAGAGACCCAGTACTTC	CASSRDRALETQYF	TRBV7-9	TRBJ2-5
TGTGCCAGCAGTTTCGGACCACAGGGGAACACTGAAGCTTTCTTT	CASSFGPQGNTEAFF	TRBV28	TRBJ1-1
TGTGCCAGCAGCGCCGGACAGGGGGCTTACCACACTGAAGCTTTCTTT	CASSAGQGAYHTEAFF	TRBV7-7	TRBJ1-1
TGCGCCCGGGGGCACCTTCCCACTGAAGCTTTCTTT	CARGHLPTEAFF	TRBV5-1	TRBJ1-1
TGTGCCAGTAATTCAGAAGAAAAACTGTTTTTT	CASNSEEKLFF	TRBV19	TRBJ1-4
TGCGCCAGCAGCCAAGTTAAGTGGACAGGGGGGTTTGACTACAATGAGCAGTTCTTC	CASSQVKWTGGFDYNEQFF	TRBV4-3	TRBJ2-1
TGTGCCAGCAGCTACAGTCCCGCACAGGGGGCTTACCGAATGTTCTACGAGCAGTACTTC	CASSYSPAQGAYRMFYEQYF	TRBV5-6	TRBJ2-7
TGTGCCAGCTCCCCACCGGCCGGCTATGGCTACACCTTC	CASSPPAGYGYTF	TRBV9	TRBJ1-2
TGTGCCAGCAAATCCCCCCCCCAGGACGGGGCCAAGTCCTATAATTCACCCCTCCACTTT	CASKSPPQDGAKSYNSPLHF	TRBV14	TRBJ1-6
TGTGCCAGCTCACCCGGACTGAACATTCAGTACTTC	CASSPGLNIQYF	TRBV18	TRBJ2-4
TGTGCCAGCAGTGATATACCTCCGTACTATGGCTACACCTTC	CASSDIPPYYGYTF	TRBV2	TRBJ1-2
TGTGCCAGCACTTTTAAAAAAGCAGGTAGCAATCAGCCCCAGCATTTT	CASTFKKAGSNQPQHF	TRBV27	TRBJ1-5
TGCGCCAGCGGGACTAGCGTCATCGGGGAGCTGTTTTTT	CASGTSVIGELFF	TRBV5-1	TRBJ2-2
TGCAGTGCTGAGGACAGGATTACTGGGGCCAACGTCCTGACTTTC	CSAEDRITGANVLTF	TRBV20-1	TRBJ2-6
TGTGCCAGCAGCTTGGACAGGGATGGCTACGAGCAGTACTTC	CASSLDRDGYEQYF	TRBV5-6	TRBJ2-7
TGCAGTGCTAGTCCCGGGACATCGAATCAGCCCCAGCATTTT	CSASPGTSNQPQHF	TRBV20-1	TRBJ1-5
TGTGCCAGCAGTTACGACGGAAGGGGCTGTGATACGCAGTATTTT	CASSYDGRGCDTQYF	TRBV6-3	TRBJ2-3
TGTGCCAGCAGCCAAGTCTTCATTAGCAGGGTGAGCAATCAGCCCCAGCATTTT	CASSQVFISRVSNQPQHF	TRBV3-1	TRBJ1-5
TGTGCCACCAGTGATTTAATCCAGGGCTTTCCCTATAATTCACCCCTCCACTTT	CATSDLIQGFPYNSPLHF	TRBV24-1	TRBJ1-6
TGTGCCAGCAGTAGGAGTAGACTAGCGGGAGCCTACAATGAGCAGTTCTTC	CASSRSRLAGAYNEQFF	TRBV28	TRBJ2-1
TGTGCCTGGAGTTCTACCAGGGACAGGGGGCCCCAGCATTTT	CAWSSTRDRGPQHF	TRBV30	TRBJ1-5
TGTGCCAGCAGCTTAACAGGGAGGAACACTGAAGCTTTCTTT	CASSLTGRNTEAFF	TRBV7-4	TRBJ1-1
TGTGCCAGCAGCTTAGCACGGACATTGGGCAGGGTTTCTCGCATCGAGGGGGGCTACGAGCAGTACTTC	CASSLARTLGRVSRIEGGYEQYF	TRBV7-9	TRBJ2-7
TGTGCCAGCAGCGCCTGGACGGCCCTAAATGAAAAACTGTTTTTT	CASSAWTALNEKLFF	TRBV9	TRBJ1-4
TGTGCCAGCATTCGGGGCGGTCAGCCCCAGCATTTT	CASIRGGQPQHF	TRBV6-8	TRBJ1-5
TGTGCCAGCCTCGGCTGGTCCAATGAGCAGTTCTTC	CASLGWSNEQFF	TRBV27	TRBJ2-1
TGTGCCAGCAGTTTATACGAAGGACGAAGCTCCTACGAGCAGTACTTC	CASSLYEGRSSYEQYF	TRBV27	TRBJ2-7
TGTGCCAGCAGCTTCCCCGGTCAGGGGGCTCCTCTCGAGCAGTACTTC	CASSFPGQGAPLEQYF	TRBV7-3	TRBJ2-7
TGCAGTGCTAGAATTCTTCCCGGCACAAAACTGTTTTTT	CSARILPGTKLFF	TRBV20-1	TRBJ1-4
TGTGCCAGCAGCATTAGGTTCCTGCCAGGGGGCGCCGCCAAAAACATTCAGTACTTC	CASSIRFLPGGAAKNIQYF	TRBV13	TRBJ2-4
TGTGCCAGCAGCACGGTCGGGGTTAGGGGGGGCTATGGCTACACCTTC	CASSTVGVRGGYGYTF	TRBV5-8	TRBJ1-2
TGTGCCAGCTCACCACCGGTGGGGGTCTCGGCTTTCTTT	CASSPPVGVSAFF	TRBV18	TRBJ1-1
TGTGCGGCTCCTAGCGGCTACGAGCAGTACTTC	CAAPSGYEQYF	TRBV9	TRBJ2-7
TGTGCCAGCATCCGACCGCCGGGACAGAGGAACACTGAAGCTTTCTTT	CASIRPPGQRNTEAFF	TRBV6-4	TRBJ1-1
TGTGTTTGGGGGGGAAACAATGAGCAGTTCTTC	CVWGGNNEQFF	TRBV10-3	TRBJ2-1
TGTGCCAGCAGGGGGACAGGCGATCAGCCCCAGCATTTT	CASRGTGDQPQHF	TRBV6-5	TRBJ1-5
TGTGCCAGCAGTGAACCCAAGAGGACCGAGCAGTACTTC	CASSEPKRTEQYF	TRBV6-4	TRBJ2-7
TGTGCCAGCAGTTGGCGGGGGGGCCAACCTGACTACAATGAGCAGTTCTTC	CASSWRGGQPDYNEQFF	TRBV27	TRBJ2-1
TGTGCCAGCAGCATTTCAGGGCGGGGGGCCTATGGCTACACCTTC	CASSISGRGAYGYTF	TRBV13	TRBJ1-2
TGTGCTAGTGGTGGGGGAGGCACAGATACGCAGTATTTT	CASGGGGTDTQYF	TRBV12-5	TRBJ2-3
TGTGCCAGCAGTGATAAGGGGGGCGGGATCAACGATGGCTACACCTTC	CASSDKGGGINDGYTF	TRBV2	TRBJ1-2
TGTGCACCAGGGAGAAAACTGTTTTTT	CAPGRKLFF	TRBV28	TRBJ1-4
TGCAGTGCTACGACTAGCCCCCCGAACACCGGGGAGCTGTTTTTT	CSATTSPPNTGELFF	TRBV20-1	TRBJ2-2
TGTGCCAGCAGCGTCAACCAAGGGACCCCCTACGAGCAGTACTTC	CASSVNQGTPYEQYF	TRBV9	TRBJ2-7
TGCAGCGTTGAAGATCTTCCCCAGGGCAGAGTAAGCTCCTACGAGCAGTACTTC	CSVEDLPQGRVSSYEQYF	TRBV29-1	TRBJ2-7
TGTGCCAGCAGCTTTCCCCGGGGGGGAACCGGGGAGCTGTTTTTT	CASSFPRGGTGELFF	TRBV7-2	TRBJ2-2
TGTGCCAGCAACTGGTCAGACAGAGAGACCCAGTACTTC	CASNWSDRETQYF	TRBV6-4	TRBJ2-5
TGTGCCAGCAGCTTCCACCGGACTAGCGGGTCTTCCGTCTTCCCCTACAATGAGCAGTTCTTC	CASSFHRTSGSSVFPYNEQFF	TRBV7-3	TRBJ2-1
TGTGCCAGTAGTATGCTCGATAATTCACCCCTCCACTTT	CASSMLDNSPLHF	TRBV19	TRBJ1-6
TGTGCCAGCAGTTACTCGGCTCAGCATCAGCCCCAGCATTTT	CASSYSAQHQPQHF	TRBV6-5	TRBJ1-5
TGTGCCGTCGTTCGGGACAGGTTGGCGCCGGTCTCTGGGGCCAACGTCCTGACTTTC	CAVVRDRLAPVSGANVLTF	TRBV10-3	TRBJ2-6
TGTGCCAGCAGGGTGGGACACCCCGGGGAGCTGTTTTTT	CASRVGHPGELFF	TRBV5-4	TRBJ2-2
TGTGCCAGCCCCACGACAGGGGGCGGGGCCGACTATGGCTACACCTTC	CASPTTGGGADYGYTF	TRBV27	TRBJ1-2
TGTGCCAGCAGCTTAGCCGCTTACAGAGGGTATGGCCAAGAGACCCAGTACTTC	CASSLAAYRGYGQETQYF	TRBV7-9	TRBJ2-5
TGTGCCAGCAGTTGGTCCGGGACATTCCCCGGGGGCGAGCAGTACTTC	CASSWSGTFPGGEQYF	TRBV12-3	TRBJ2-7
TGTGCCAGCAGTTACTCGATCGGAAAATCAGCTTTCGACTTAAAAGTCAGCTCCTACAATGAGCAGTTCTTC	CASSYSIGKSAFDLKVSSYNEQFF	TRBV6-3	TRBJ2-1
TGTGCCAGCAGGACCAGACAGGGGGAACAAGAGACCCAGTACTTC	CASRTRQGEQETQYF	TRBV6-6	TRBJ2-5
TGTGCCAGCAGTTACGGACAGGGCCTTACCACTGAAGCTTTCTTT	CASSYGQGLTTEAFF	TRBV6-5	TRBJ1-1
TGTGCCAGGAGGGGATGCAGCGGCGCTTACAATGAGCAGTTCTTC	CARRGCSGAYNEQFF	TRBV19	TRBJ2-1
TGTGCCAGCAGTGAACGTCTGGATACAAGGGGAAACACCATATATTTT	CASSERLDTRGNTIYF	TRBV2	TRBJ1-3
TGTGCCAGAGGGGACAAGTTTGGCACTGAAGCTTTCTTT	CARGDKFGTEAFF	TRBV11-3	TRBJ1-1
TGTGCCAGCAGCATTGGGGGACAGATAAATGAAAAACTGTTTTTT	CASSIGGQINEKLFF	TRBV6-4	TRBJ1-4
TGTGCCAGCAGCTCAGAAAACAGGGGGGTAGAGACCCAGTACTTC	CASSSENRGVETQYF	TRBV5-6	TRBJ2-5
TGCAGTGCTAGAGATCGAGGAAACACCGGGGAGCTGTTTTTT	CSARDRGNTGELFF	TRBV20-1	TRBJ2-2
TGTGCCTGGAGTCCCCCGGGGGCCGATGGGGAAGCTTTCTTT	CAWSPPGADGEAFF	TRBV30	TRBJ1-1
TGTGCCACCAGTGATTTCCCACGGGAGGCAACAAACTCTGGGGCCAACGTCCTGACTTTC	CATSDFPREATNSGANVLTF	TRBV24-1	TRBJ2-6
TGTGCCAGCAGCCAGCTCCAGGGTTGCTGGGGGTACGAGCAGTACTTC	CASSQLQGCWGYEQYF	TRBV14	TRBJ2-7
TGTGCCAGCAGCCAAGATAAACAGGGTCATCAGCCCCAGCATTTT	CASSQDKQGHQPQHF	TRBV14	TRBJ1-5
TGCAGTGCGGGATACGGGGAGCTGTTTTTT	CSAGYGELFF	TRBV20-1	TRBJ2-2
TGTGCCAGCAGTTACTGTGGGGCTGATGGCTACACCTTC	CASSYCGADGYTF	TRBV6-3	TRBJ1-2
TGTGCCAGCAGTTCCCCCGACCTAGGTTCCAGCTCCTACAATGAGCAGTTCTTC	CASSSPDLGSSSYNEQFF	TRBV12-3	TRBJ2-1
TGTGCCACCAGTGATCTAGCCATTTTCCCCTACGAGCAGTACTTC	CATSDLAIFPYEQYF	TRBV24-1	TRBJ2-7
TGTGCCAGCTCACGGTCTAAGGACAGCTCTGGGGCCAACGTCCTGACTTTC	CASSRSKDSSGANVLTF	TRBV18	TRBJ2-6
TGTGCCAGCAGCCGTCGAAGAGGCTCCACTGAAGCTTTCTTT	CASSRRRGSTEAFF	TRBV2	TRBJ1-1
TGTGCCACCAGTAGGGTTGACTATGGCTACACCTTC	CATSRVDYGYTF	TRBV24-1	TRBJ1-2
TGCGCCAGCAGCCAAGTTGACAGGTATAATTCACCCCTCCACTTT	CASSQVDRYNSPLHF	TRBV4-1	TRBJ1-6
TGTGCCAGCAGCGGGTCGGACAGCTCCTACGAGCAGTACTTC	CASSGSDSSYEQYF	TRBV13	TRBJ2-7
TGTGCCAGCAGCTTGTGGGACAGCAGCACCGGGGAGCTGTTTTTT	CASSLWDSSTGELFF	TRBV5-6	TRBJ2-2
TGTGCTAGTGGTTCTCCCCGGGACATGTACGAGCAGTACTTC	CASGSPRDMYEQYF	TRBV12-5	TRBJ2-7
TGTGCCTGGAGGGTGGACAGCGGGGAGCTGTTTTTT	CAWRVDSGELFF	TRBV30	TRBJ2-2
TGCAGCGTTGAAGCTCGGGTTTGGCAGTACTTC	CSVEARVWQYF	TRBV29-1	TRBJ2-7
TGCGCCAGCCTCAGGGGACGCTACGAGCAGTACTTC	CASLRGRYEQYF	TRBV5-1	TRBJ2-7
TGTGCCAGCAGTTACCAACAGGCGGGTCCTCGGGGTCGGGCCATAATGGGTGAAAACATTCAGTACTTC	CASSYQQAGPRGRAIMGENIQYF	TRBV6-6	TRBJ2-4
TGTGCCAGCAGCTTTTTCTCCGGGGGGTGCGGCACAGATACGCAGTATTTT	CASSFFSGGCGTDTQYF	TRBV5-4	TRBJ2-3
TGTGCCAGTGGAAAGTCTGGACAGGCCCCCACAGATACGCAGTATTTT	CASGKSGQAPTDTQYF	TRBV24-1	TRBJ2-3
TGTGCCACCAGTGATCCGATCCAGTCATACGAGCAGTACTTC	CATSDPIQSYEQYF	TRBV24-1	TRBJ2-7
TGTGCCAGCAGTTACTCAGACAGGGACTGCAATCAGCCCCAGCATTTT	CASSYSDRDCNQPQHF	TRBV6-5	TRBJ1-5
TGTGCCAGCAGTCCCCCCCAGGGAGGCTACGAGCAGTACTTC	CASSPPQGGYEQYF	TRBV27	TRBJ2-7
TGTGCCAGCAGCCTGGGGTGCGGGAGAGCCAAAAACATTCAGTACTTC	CASSLGCGRAKNIQYF	TRBV4-2	TRBJ2-4
TGTGCCAGCAGTGAAGCGCCAGGGCCCGGAGGACAGGTAAAGCAAGAGACCCAGTACTTC	CASSEAPGPGGQVKQETQYF	TRBV6-1	TRBJ2-5
TGTGCCAGCAGCTCCGATTGGGGTGTCGAACCTGAAGCTTTCTTT	CASSSDWGVEPEAFF	TRBV13	TRBJ1-1
TGTGCCAGCAGCTTAGCAGGGGGCACAGATACGCAGTATTTT	CASSLAGGTDTQYF	TRBV7-2	TRBJ2-3
TGTGCCAGCAGCCCAGGGACAGGGCAAGAAGCTTTCTTT	CASSPGTGQEAFF	TRBV7-4	TRBJ1-1
TGTGCCAGCAGTTTATCCGCGATTCTGGGCGGCCTGAAAAAAAGGTACGAGCAGTACTTC	CASSLSAILGGLKKRYEQYF	TRBV28	TRBJ2-7
TGTGCCAGTTTACCGGACACCGGGGAGCTGTTTTTT	CASLPDTGELFF	TRBV19	TRBJ2-2
TGTGCCCAGGAGGGGGTTTATGGCTACACCTTC	CAQEGVYGYTF	TRBV7-9	TRBJ1-2
TGCAGTGCTTCCGGACCAGGGGCAAATGAAAAACTGTTTTTT	CSASGPGANEKLFF	TRBV20-1	TRBJ1-4
TGTGCCAGCGATAAGATTCACACTTTCTTT	CASDKIHTFF	TRBV7-6	TRBJ1-1
TGTGCCAGCAGCCCCAGGGGTAGCAATCAGCCCCAGCATTTT	CASSPRGSNQPQHF	TRBV6-4	TRBJ1-5
TGTGCCAGCAGCCCCACGAGTGGCAGCTCCTATAATTCACCCCTCCACTTT	CASSPTSGSSYNSPLHF	TRBV6-4	TRBJ1-6
TGTGCCAGCAGTGAATTAGGGGCCCCCCCAGAGCAGTACTTC	CASSELGAPPEQYF	TRBV6-4	TRBJ2-7
TGTGCCAGTGGACTAGGTTGTTACAATGAGCAGTTCTTC	CASGLGCYNEQFF	TRBV6-6	TRBJ2-1
TGTGCCAGCAGCTTAGGGCGGGACATTAGTACCAACTACGAGCAGTACTTC	CASSLGRDISTNYEQYF	TRBV7-9	TRBJ2-7
TGTGCCACCATCCTTCCGGAAGCGAGGAACACTGAAGCTTTCTTT	CATILPEARNTEAFF	TRBV24-1	TRBJ1-1
TGTGCCACCAGTGATAAAACACGGACACCAGTCTTT	CATSDKTRTPVF	TRBV24-1	TRBJ1-1
TGTGCCAGCAGCGGGACAGGGGAGAACACTGAAGCTTTCTTT	CASSGTGENTEAFF	TRBV7-9	TRBJ1-1
TGTGCCAGCCCACTAGCGGGCCCCTACGAGCAGTACTTC	CASPLAGPYEQYF	TRBV6-5	TRBJ2-7
TGTGCCAGTACCACAAGAAGAGAAAGTGGCTACGAGCAGTACTTC	CASTTRRESGYEQYF	TRBV19	TRBJ2-7
TGTGCCAGTAGCCTTTGGGCCCTAGGCCGGACCAATGGCTACACCTTC	CASSLWALGRTNGYTF	TRBV19	TRBJ1-2
TGTGCCTGGAGGAGCGGCTACGAGCAGTACTTC	CAWRSGYEQYF	TRBV30	TRBJ2-7
TGTGCCACCAGTGATTTGCCCGCACTAGCGGGCAAGAATCTAGATACGCAGTATTTT	CATSDLPALAGKNLDTQYF	TRBV24-1	TRBJ2-3
TGTGCCAGCAGCATACCGGGACTTCAAGAGACCCAGTACTTC	CASSIPGLQETQYF	TRBV11-2	TRBJ2-5
TGTGCCAGCAAAGCCTGGGACAGAGCGAATCCAGCTTTCTTT	CASKAWDRANPAFF	TRBV9	TRBJ1-1
TGCGCCAGCAGCTTATTAGGCGTACACTACAATGAGCAGTTCTTC	CASSLLGVHYNEQFF	TRBV5-1	TRBJ2-1
TGCAGCGTTGCTCCCTTGGGCACAGATACGCAGTATTTT	CSVAPLGTDTQYF	TRBV29-1	TRBJ2-3
TGTGCCAGCAGCTTACTGGTCTCGGCACAATCCGGGGAGCTGTTTTTT	CASSLLVSAQSGELFF	TRBV7-2	TRBJ2-2
TGTGCCAGCAGCCCCCTTTTATTCAGGGGAAAGTACTTC	CASSPLLFRGKYF	TRBV27	TRBJ2-7
TGTGCCAGCAGCGAAGCATTCTATCCAGGTAGCTCCTACGAGCAGTACTTC	CASSEAFYPGSSYEQYF	TRBV6-4	TRBJ2-7
TGTGCCAGCAGTTATCTGAAATGCAATCAGCCCCAGCATTTT	CASSYLKCNQPQHF	TRBV6-3	TRBJ1-5
TGTGCCAGCAGCCTCCCACCTGTCATTGGACCCGGGACTGAAGCTTTCTTT	CASSLPPVIGPGTEAFF	TRBV11-2	TRBJ1-1
TGTGCCAGCAGCGGAAAAAGGGGATATACAAATTCACCCCTCCACTTT	CASSGKRGYTNSPLHF	TRBV7-3	TRBJ1-6
TGTGCCAGCAGTTGGTTAATTCACAGGGCGGTAGTTTCAACTAATGAAAAACTGTTTTTT	CASSWLIHRAVVSTNEKLFF	TRBV6-2	TRBJ1-4
TGTGCCAGCAGCAGGGACAGGGATCTCAATCAGCCCCAGCATTTT	CASSRDRDLNQPQHF	TRBV3-1	TRBJ1-5
TGTGCCAGCAGCCAATGCTTCAGCCCCGGGGGCCTGAACACTGAAGCTTTCTTT	CASSQCFSPGGLNTEAFF	TRBV4-2	TRBJ1-1
TGTGCCAGCAGCGGACCCTCGGCAGATCTAAATGAAAAACTGTTTTTT	CASSGPSADLNEKLFF	TRBV13	TRBJ1-4
TGCAGTGCACAGCAGAAGTTGTTCGGAAGGGAGGACAATAGTGGTTACGAGCAGTACTTC	CSAQQKLFGREDNSGYEQYF	TRBV20-1	TRBJ2-7
TGTGCCGGTTCAAGACAGGGGGCTAATTCACCCCTCCACTTT	CAGSRQGANSPLHF	TRBV30	TRBJ1-6
TGTGCCATCAGCAGTTGGCGGGAGGGCGCCTCTGGGGCCAACGTCCTGACTTTC	CAISSWREGASGANVLTF	TRBV10-3	TRBJ2-6
TGTGCCAGCAGCAATTCCCGATTAAAGACAGGGCGGGACACAGATACGCAGTATTTT	CASSNSRLKTGRDTDTQYF	TRBV13	TRBJ2-3
TGCAACCCAAGTTACAATGAGCAGTTCTTC	CNPSYNEQFF	TRBV20-1	TRBJ2-1
TGTGCCAGCAGCGTAGACAGGGGCGAGCAGTACTTC	CASSVDRGEQYF	TRBV9	TRBJ2-7
TGCAGCGTTGAAGAACGGGTCCAGAGGGGGCATCAGCCCCAGCATTTT	CSVEERVQRGHQPQHF	TRBV29-1	TRBJ1-5
TGTGCCAGCAGCCAAGAGGAAAATGAGCGGGAGACAGAGTACAATGAGCAGTTCTTC	CASSQEENERETEYNEQFF	TRBV14	TRBJ2-1
TGTGCCACCAGTGATATCGCCCCGGGACAGGGATATGGCTACACCTTC	CATSDIAPGQGYGYTF	TRBV24-1	TRBJ1-2
TGTGCCAGCAGCTTGTGCGGACAGGCTAATCAGCCCCAGCATTTT	CASSLCGQANQPQHF	TRBV7-3	TRBJ1-5
TGTGCCAGCAGTGGAAACCCGACTCCAGCGGAGACCCAGTACTTC	CASSGNPTPAETQYF	TRBV25-1	TRBJ2-5
TGTGCCAGCAGTGAAATCGTGACTAGCGGGATGACCACAGATACGCAGTATTTT	CASSEIVTSGMTTDTQYF	TRBV2	TRBJ2-3
TGTGCCAGCAGTTACTTTGGGGGGGCCGGAGACGAGCAGTACTTC	CASSYFGGAGDEQYF	TRBV6-5	TRBJ2-7
TGCACCCACAGGGACCACAACACCGGGGAGCTGTTTTTT	CTHRDHNTGELFF	TRBV29-1	TRBJ2-2
TGTGCCAGCAGCTTCCCGGACAGGGGGCGCTTATGGTCGTCTGAAGCTTTCTTT	CASSFPDRGRLWSSEAFF	TRBV13	TRBJ1-1
TGTGCCAGCAGCTATTCCCAGCTGTGGGACGAGCAGTACTTC	CASSYSQLWDEQYF	TRBV13	TRBJ2-7
TGCGCCAGCAGCTTACCAGGGTGCAATGAGCAGTTCTTC	CASSLPGCNEQFF	TRBV5-1	TRBJ2-1
TGTGCCAGCAGTTACTCGCAGGGTTTCCCGACTAGCGGGATTAAGCAGTTCTTC	CASSYSQGFPTSGIKQFF	TRBV6-8	TRBJ2-1
TGTGCCAGCAGCTCCCGGACAGCTCCCACAGATACGCAGTATTTT	CASSSRTAPTDTQYF	TRBV5-6	TRBJ2-3
TGTGCCAGCTGGGACAGGTCTCCTTACGATAATCAGCCCCAGCATTTT	CASWDRSPYDNQPQHF	TRBV14	TRBJ1-5
TGTGCCAGCAGCCCAAGCGGGATTGAGCAGTTCTTC	CASSPSGIEQFF	TRBV9	TRBJ2-1
TGTGCCAGCCCCACGGGAGGGGCAGCGCTCTACGAGCAGTACTTC	CASPTGGAALYEQYF	TRBV7-9	TRBJ2-7
TGTGCCAGTAGTATGGCCGGGACAGGGAGCTCTGAAGCTTTCTTT	CASSMAGTGSSEAFF	TRBV19	TRBJ1-1
TGTGCCAGCAGTGATGAATTAGGGGGCAATCAGCCCCAGCATTTT	CASSDELGGNQPQHF	TRBV6-4	TRBJ1-5
TGTGCCAGCAGCTTAGGGGACGGTAAGCACTCCTACGAGCAGTACTTC	CASSLGDGKHSYEQYF	TRBV11-3	TRBJ2-7
TGCGCCAGCAGCTTGCGGCGGCGGGACGAGCAGTACTTC	CASSLRRRDEQYF	TRBV5-1	TRBJ2-7
TGTGCCAGCAGCTTAACCGTTAGGGACAGGGCGGGAGTTGGCTACACCTTC	CASSLTVRDRAGVGYTF	TRBV7-3	TRBJ1-2
TGTGCCAGCAGCCGGGGTGCTCAGCCCCAGCATTTT	CASSRGAQPQHF	TRBV25-1	TRBJ1-5
TGTGCCAGCAGCTTACGATGCACAGATACGCAGTATTTT	CASSLRCTDTQYF	TRBV13	TRBJ2-3
TGTGCCAGCAGCGTAGTTGATCATGGACAGGGGGCAGCCATGAACACTGAAGCTTTCTTT	CASSVVDHGQGAAMNTEAFF	TRBV9	TRBJ1-1
TGTGCCACCAGTGATTTGACGCGGCAATACATTCAGTACTTC	CATSDLTRQYIQYF	TRBV24-1	TRBJ2-4
TGTGCCAGCAGCTTAGCGTGGACGGACAGGGACGAGCAGTACTTC	CASSLAWTDRDEQYF	TRBV7-2	TRBJ2-7
TGCAGCGAGGAGTGGGAACTGAACACTGAAGCTTTCTTT	CSEEWELNTEAFF	TRBV29-1	TRBJ1-1
TGTGCCAGTACCACCCAGGGGGCTAACGGAAATAGGAACACTGAAGCTTTCTTT	CASTTQGANGNRNTEAFF	TRBV19	TRBJ1-1
TGTGCCAGCAGTGAAGGAACGACTTCTGGAAACACCATATATTTT	CASSEGTTSGNTIYF	TRBV6-1	TRBJ1-3
TGTGCCAGCAGTTTAAGAAACAGGGGGGACTACGAGCAGTACTTC	CASSLRNRGDYEQYF	TRBV12-3	TRBJ2-7
TGTGCCAGCAGGGACTGTCCGTTTAGGTACAATGAGCAGTTCTTC	CASRDCPFRYNEQFF	TRBV11-3	TRBJ2-1
TGCAGTGCTAGACGGGCTAGCGGGCTGAGGGATACGCAGTATTTT	CSARRASGLRDTQYF	TRBV20-1	TRBJ2-3
TGTGCCAGTAGTATGGGGACAGGGGGCAAGAACACTGAAGCTTTCTTT	CASSMGTGGKNTEAFF	TRBV19	TRBJ1-1
TGTGCCAGCAGCCACCCCGATGGACAGGGTAGACTGGGTGGCTACACCTTC	CASSHPDGQGRLGGYTF	TRBV3-1	TRBJ1-2
TGTGCCAGCGACAGGCATGTAAGAGGACTTCAGCCCCAGCATTTT	CASDRHVRGLQPQHF	TRBV27	TRBJ1-5
TGTGCCAGCACTTCCGGGCCGGGCTATGGCTACACCTTC	CASTSGPGYGYTF	TRBV12-3	TRBJ1-2
TGTGCCACCTTAAGCCGGGACAGGGGTCTCAGCAATCAGCCCCAGCATTTT	CATLSRDRGLSNQPQHF	TRBV24-1	TRBJ1-5
TGCGCCAGCAGTGAGAATTTCCGGGACAGGGAGTTTGGCTACACCTTC	CASSENFRDREFGYTF	TRBV10-1	TRBJ1-2
TGCGCCAGCAGCCAAGTTAGGGAAAAGGGATCCAGCAATCAGCCCCAGCATTTT	CASSQVREKGSSNQPQHF	TRBV4-3	TRBJ1-5
TGTGCCAGCAGCCAACGCCCGCAGGTTCACAGTGCCGGGGAGCTGTTTTTT	CASSQRPQVHSAGELFF	TRBV14	TRBJ2-2
TGTGCCAGTAGGGGTTGTAAAGGCAGTGGCTACACCTTC	CASRGCKGSGYTF	TRBV19	TRBJ1-2
TGTGCCAGCAGCAGCTGGGACAGGGGAATGGACTATGGCTACACCTTC	CASSSWDRGMDYGYTF	TRBV7-7	TRBJ1-2
TGCAGTGCTAGAGCTCTGGGGTCCCCCAATCAGCCCCAGCATTTT	CSARALGSPNQPQHF	TRBV20-1	TRBJ1-5
TGTGCCAGCAGCGTGGGGCTCACCGGGGAGCTGTTTTTT	CASSVGLTGELFF	TRBV9	TRBJ2-2
TGCGCCAGCAGCCAATGCCCCTGCGGGAGTCTGAGACCGGTTGATACGCAGTATTTT	CASSQCPCGSLRPVDTQYF	TRBV4-3	TRBJ2-3
TGTGCCAGCAGTGAAAGAACAGGGCCCTACGAGCAGTACTTC	CASSERTGPYEQYF	TRBV6-1	TRBJ2-7
TGTGCCAGCAGTGACCTGATAGGTCCTCGACGGGCCTTGCGCAGGACTGAAGCTTTCTTT	CASSDLIGPRRALRRTEAFF	TRBV6-4	TRBJ1-1
TGTGCCACCAGTGATTTAAGGGGGCCGAACACCATATATTTT	CATSDLRGPNTIYF	TRBV24-1	TRBJ1-3
TGTGCCAGCAGCCGGCTCAGGTGTTTGAAATCTAATGAAAAACTGTTTTTT	CASSRLRCLKSNEKLFF	TRBV6-4	TRBJ1-4
TGTGCCAGTAGTATTCCGGGGTGTGAAGCTTTCTTT	CASSIPGCEAFF	TRBV19	TRBJ1-1
TGCAGTGCTAGAAGGGGGACAGGGAGTGGATACAATGAGCAGTTCTTC	CSARRGTGSGYNEQFF	TRBV20-1	TRBJ2-1
TGTGCCAGCAGCGACTCATTCAGAGGGAGGTTTAATGAAAAACTGTTTTTT	CASSDSFRGRFNEKLFF	TRBV9	TRBJ1-4
TGTGCCAGATCCGGGACGTGTAGATATGGCTACACCTTC	CARSGTCRYGYTF	TRBV27	TRBJ1-2
TGTGCCAGCAGGGGATCCGACGGGGGGTTTGATACGCAGTATTTT	CASRGSDGGFDTQYF	TRBV5-4	TRBJ2-3
TGTGCCAGCAGCACCACTAGCGGAGCCAAGACCTACGAGCAGTACTTC	CASSTTSGAKTYEQYF	TRBV7-3	TRBJ2-7
TGTGCCACGGGTCTAGGGACTAGCGGGGGGGCCGATCTAAGAAACTCCTACAATGAGCAGTTCTTC	CATGLGTSGGADLRNSYNEQFF	TRBV4-2	TRBJ2-1
TGTGCCAGTAGTTCAGGGAACCACACCGGGGAGCTGTTTTTT	CASSSGNHTGELFF	TRBV19	TRBJ2-2
TGCGCCAGCAAAGACGGTTTAGGGGACGTTGCAGGGAGCTCCTACAATGAGCAGTTCTTC	CASKDGLGDVAGSSYNEQFF	TRBV5-1	TRBJ2-1
TGTGCCAGCAGCGTAGGGTTAGCGGGTCCCCGCCAAGAGACCCAGTACTTC	CASSVGLAGPRQETQYF	TRBV9	TRBJ2-5
TGTGCCAGCAGGTCAGCTCCCTACGATCAGTCCTACAATGAGCAGTTCTTC	CASRSAPYDQSYNEQFF	TRBV9	TRBJ2-1
TGTGCCAGCAGTTACTGCGGGAGGGGGCAAGAGACCCAGTACTTC	CASSYCGRGQETQYF	TRBV6-2	TRBJ2-5
TGTGCCAGCAAACAGGCCCCCGGTTGTAAAGGGGATGAAAAACTGTTTTTT	CASKQAPGCKGDEKLFF	TRBV6-4	TRBJ1-4
TGCAGTGCTAGGGGACAGGGGGCTAATTCACCCCTCCACTTT	CSARGQGANSPLHF	TRBV20-1	TRBJ1-6
TGTGCCAGCGATACAGGGGGCGAATACACTGAAGCTTTCTTT	CASDTGGEYTEAFF	TRBV28	TRBJ1-1
TGTGCCTGGAGGAGAATGAATAACTATGGCTACACCTTC	CAWRRMNNYGYTF	TRBV30	TRBJ1-2
TGTGCCAGCAGCACAGGGAACACTGAAGCTTTCTTT	CASSTGNTEAFF	TRBV7-3	TRBJ1-1
TGTGCCACCAGTGCCGGGACGGCAAACACCGGGGAGCTGTTTTTT	CATSAGTANTGELFF	TRBV24-1	TRBJ2-2
TGTGCCATCAAGGGGGGCTACACCTTC	CAIKGGYTF	TRBV10-3	TRBJ1-2
TGTGCCAGCAGCCACATGAAGGGGCTCCCTCGCTATGGCTACACCTTC	CASSHMKGLPRYGYTF	TRBV3-1	TRBJ1-2
TGCAGTGCGGAGCGACAGGGGGAAATTAGTACCTACGAGCAGTACTTC	CSAERQGEISTYEQYF	TRBV20-1	TRBJ2-7
TGTGCCAGCATGCCCCCCGCCACAGGGGGTGGCCCCTATAGCAATCAGCCCCAGCATTTT	CASMPPATGGGPYSNQPQHF	TRBV9	TRBJ1-5
TGTGCCAGCAGGGCGGGAGTTCAGGGAGACGAGCAGTACTTC	CASRAGVQGDEQYF	TRBV12-3	TRBJ2-7
TGTGCCAGCAGCGTTAGGACTAGACTCACCTACGAGCAGTACTTC	CASSVRTRLTYEQYF	TRBV9	TRBJ2-7
TGTGCCAGCATTACGATGGGAAGGAGGTCTAACTATGGCTACACCTTC	CASITMGRRSNYGYTF	TRBV27	TRBJ1-2
TGTGCCAGCAGCCTCGCAGGGGCCTGGAGGGACACAGATACGCAGTATTTT	CASSLAGAWRDTDTQYF	TRBV14	TRBJ2-3
TGTGCCAGCAGCGTTACATGGGCCCGAACAGGTGAGCAGTTCTTC	CASSVTWARTGEQFF	TRBV5-6	TRBJ2-1
TGTGCCAGCAGCCAAGAATCCTCTGAGGGGGGGAGCACTGAAGCTTTCTTT	CASSQESSEGGSTEAFF	TRBV4-2	TRBJ1-1
TGTGCTAGTGGTTTCAAAAACGACGGGTGTACCCCCTACGAGCAGTACTTC	CASGFKNDGCTPYEQYF	TRBV12-5	TRBJ2-7
TGCAGTGCTGGGACTGACAGGGCTAAGAACACTGAAGCTTTCTTT	CSAGTDRAKNTEAFF	TRBV20-1	TRBJ1-1
TGTGCTAGCAGCTTTGGGGCCCACGTGTATAGCAATCAGCCCCAGCATTTT	CASSFGAHVYSNQPQHF	TRBV7-7	TRBJ1-5
TGTGCTAGTGGTTTGGGGAAATCCCTAGCGGCAGTCAATGAGCAGTTCTTC	CASGLGKSLAAVNEQFF	TRBV12-5	TRBJ2-1
TGTGCCAGCAGCGATAGGGGCGCGAACACCGGGGAGCTGTTTTTT	CASSDRGANTGELFF	TRBV7-9	TRBJ2-2
TGCGCCAGCAGCGCTCCCGGTTCGAAGGGGTGTCGAAGGAGCTCCTACAATGAGCAGTTCTTC	CASSAPGSKGCRRSSYNEQFF	TRBV5-1	TRBJ2-1
TGCAGTGCTAGGTCGGGACAGGACGAGCAGTACTTC	CSARSGQDEQYF	TRBV20-1	TRBJ2-7
TGCGCCAGCAGCTACCAACGGGCCGGGACAGGGGTAAACTATGGCTACACCTTC	CASSYQRAGTGVNYGYTF	TRBV5-1	TRBJ1-2
TGTGCCAGCAGGCGTATAGCGGTCCTTGAGCAGTTCTTC	CASRRIAVLEQFF	TRBV2	TRBJ2-1
TGTGCCTCGGCACAGGGGGCCATCAAGAATCAGCCCCAGCATTTT	CASAQGAIKNQPQHF	TRBV19	TRBJ1-5
TGTGCCAGCAGCGAATCAACACAGGGGTCGCTGGGGAAGAACACTGAAGCTTTCTTT	CASSESTQGSLGKNTEAFF	TRBV11-2	TRBJ1-1
TGCGCCAGCAGTGGCTGGAATTCACCCCTCCACTTT	CASSGWNSPLHF	TRBV5-1	TRBJ1-6
TGTGCCAGCAGTGACCCTTCCGGGCTCTATGGCTACACCTTC	CASSDPSGLYGYTF	TRBV6-4	TRBJ1-2
TGCAGTGCTGCGAGGTTCTCCGCGGAACAAGAGACCCAGTACTTC	CSAARFSAEQETQYF	TRBV20-1	TRBJ2-5
TGTGCCAGCAGTGGCCTTACTTCCAGGTATTCCGGAAGGGCCTACGAGCAGTACTTC	CASSGLTSRYSGRAYEQYF	TRBV27	TRBJ2-7
TGTGCCAGCTCACCTGCCTCGAGACAGGGGTTGTATTATCACCAGGAGCAGTTCTTC	CASSPASRQGLYYHQEQFF	TRBV18	TRBJ2-1
TGTGCCAGCAGTTTAGGGTTTGGGGCTACGCAGTATTTT	CASSLGFGATQYF	TRBV27	TRBJ2-3
TGCGCCAGCAGCCAAGAGGAGGGTGGCTACACCTTC	CASSQEEGGYTF	TRBV4-1	TRBJ1-2
TGTGCCAGAGAACAGGGAGTGGGGACGAACACTGAAGCTTTCTTT	CAREQGVGTNTEAFF	TRBV19	TRBJ1-1
TGTGCCTGGCCCGGGGGTGGGCTGCCAAACACTGAAGCTTTCTTT	CAWPGGGLPNTEAFF	TRBV30	TRBJ1-1
TGTGCCAGCAGTTACTCGAGTAAGACAGTCGAGCAGCCCCAGCATTTT	CASSYSSKTVEQPQHF	TRBV6-6	TRBJ1-5
TGCAGTGCTAGAGCGAAGGGCCTCTACGAGCAGTACTTC	CSARAKGLYEQYF	TRBV20-1	TRBJ2-7
TGCGCCAGCAAGGAGGGTCCGGGACAAGGAAGGCACACCGGGGAGCTGTTTTTT	CASKEGPGQGRHTGELFF	TRBV10-1	TRBJ2-2
TGTGCCAGCGGGTCCTCGCCCCAGCATTTT	CASGSSPQHF	TRBV19	TRBJ1-5
TGTGCCAGCAGTGACTCCTACCTTACGGGGTTGAGGCTCTACAATGAGCAGTTCTTC	CASSDSYLTGLRLYNEQFF	TRBV6-4	TRBJ2-1
TGTGCCAGCAGTTGGAAGCGAAACGGCAATCAGCCCCAGCATTTT	CASSWKRNGNQPQHF	TRBV27	TRBJ1-5
TGTGCCAGCGGGAGGACAGGGGAGACCCAGTACTTC	CASGRTGETQYF	TRBV27	TRBJ2-5
TGTGCCAGCAGCTTAGGTGGGGTGCCGGGCTTAATGGGGGCCAACGTCCTGACTTTC	CASSLGGVPGLMGANVLTF	TRBV11-2	TRBJ2-6
TGTGCCAGTGTTCATGGGGGGCCTAACTATGGCTACACCTTC	CASVHGGPNYGYTF	TRBV6-2	TRBJ1-2
TGTGCCAGCAGCTTAGGAAGGCTGGGACAGGGGGAAACCGGGAACACTGAAGCTTTCTTT	CASSLGRLGQGETGNTEAFF	TRBV11-3	TRBJ1-1
TGTGCCAGCAGCATAGGACAGGGTGGGAATCAGCCCCAGCATTTT	CASSIGQGGNQPQHF	TRBV7-3	TRBJ1-5
TGTGCCAGTCAGGACAGGGCGCACTACGAGCAGTACTTC	CASQDRAHYEQYF	TRBV3-1	TRBJ2-7
TGTGCCACCAGTGATTGGCGCGTAAAACTAGCGGGAAGAACAAATCGCCCCCTCACCGGGGAGCTGTTTTTT	CATSDWRVKLAGRTNRPLTGELFF	TRBV24-1	TRBJ2-2
TGTGCCAGCTCACCACTCCCCCCTCGGGGTTCCACAGATACGCAGTATTTT	CASSPLPPRGSTDTQYF	TRBV18	TRBJ2-3
TGTGCCAGCAGGACACCTTCCTCTGGAAACACCATATATTTT	CASRTPSSGNTIYF	TRBV7-9	TRBJ1-3
TGTGCCAGCAGTCCCATTTGGGGGGCTGCGAACACCGGGGAGCTGTTTTTT	CASSPIWGAANTGELFF	TRBV6-5	TRBJ2-2
TGCGCCAGCAGCCAAGGGATCCTACATGAAAAACTGTTTTTT	CASSQGILHEKLFF	TRBV4-3	TRBJ1-4
TGTGCCAGCAGCATACAGGGAGGAGCAACTCAGCCCCAGCATTTT	CASSIQGGATQPQHF	TRBV6-2	TRBJ1-5
TGTGCCGCCGGAGGGGGCTACGAGCAGTACTTC	CAAGGGYEQYF	TRBV28	TRBJ2-7
TGCAGTGCGGGGAGGGACTATGGCTACACCTTC	CSAGRDYGYTF	TRBV20-1	TRBJ1-2
TGCAGTGCTAGAGGGATCCGGGACAGGGGAGTCATGAACACTGAAGCTTTCTTT	CSARGIRDRGVMNTEAFF	TRBV20-1	TRBJ1-1
TGTGCCAGCCAGTGGTGCCCGGGACAGAACTGGGCTGGGGCCAACGTCCTGACTTTC	CASQWCPGQNWAGANVLTF	TRBV27	TRBJ2-6
TGTGCCAGCAGTCGGTCGGGGGGGGAGGGTATTGAGCAGTTCTTC	CASSRSGGEGIEQFF	TRBV7-8	TRBJ2-1
TGTGCCAGCAGCATTCGACAGTGGGTAAATGGAAAGCAGTACTTC	CASSIRQWVNGKQYF	TRBV5-4	TRBJ2-7
TGTGCCAGCAGGACAGGGGGCGGGAACACTGAAGCTTTCTTT	CASRTGGGNTEAFF	TRBV11-3	TRBJ1-1
TGTGCCAGCAGCCAATACGGGACTAGCGTAGATACGCAGTATTTT	CASSQYGTSVDTQYF	TRBV14	TRBJ2-3
TGTGCCAGCAGTTTAATGGACAGGCCCTACGAGCAGTACTTC	CASSLMDRPYEQYF	TRBV27	TRBJ2-7
TGTGCCAGGGGCTGGGTGAACTATGGCTACACCTTC	CARGWVNYGYTF	TRBV6-6	TRBJ1-2
TGTGCCAGCACCTTCCAGGGCATAGATACGCAGTATTTT	CASTFQGIDTQYF	TRBV27	TRBJ2-3
TGTGCCAGACACACGTTTTCCGTCTTC	CARHTFSVF	TRBV6-6	TRBJ2-1
TGTGCCTGGAGTGTCTCGAGGCTCGGCCAAGAGACCCAGTACTTC	CAWSVSRLGQETQYF	TRBV30	TRBJ2-5
TGTGCCAGCAGCTTACATCCACAGTTTTATCAGCCCCAGCATTTT	CASSLHPQFYQPQHF	TRBV5-8	TRBJ1-5
TGCAGTGCTAGAGACCCCAGGGGACGCAGCTCTGGGGCCAACGTCCTGACTTTC	CSARDPRGRSSGANVLTF	TRBV20-1	TRBJ2-6
TGTGCCAGCAGCCCCTTAGGGGGGGGGATTGAGCAGTTCTTC	CASSPLGGGIEQFF	TRBV6-8	TRBJ2-1
TGTGCCAGCAGCGTTGGGGGGAAAGGCAAACCAGATACGCAGTATTTT	CASSVGGKGKPDTQYF	TRBV13	TRBJ2-3
TGTGCCAGCAGCGTAGACGGCCGGGACAGGGGGAGCGGAAACACCATATATTTT	CASSVDGRDRGSGNTIYF	TRBV9	TRBJ1-3
TGTGCCAGCAGTTCCGCAAGTGCCTCCTACGAGCAGTACTTC	CASSSASASYEQYF	TRBV12-3	TRBJ2-7
TGTGCCAGCAGCTTATCCCCCTCGAACACTGAAGCTTTCTTT	CASSLSPSNTEAFF	TRBV7-9	TRBJ1-1
TGTGCCAGCAGCTTAGTCTGTTCTACGCGATCGGGTCAGCCCCAGCATTTT	CASSLVCSTRSGQPQHF	TRBV7-8	TRBJ1-5
TGTGCCAGCAGTGCCTGGGGACTAGCGGCTCTCGTCCCAGAGACCCAGTACTTC	CASSAWGLAALVPETQYF	TRBV6-4	TRBJ2-5
TGCAGTGCTAGAACTGCCGGGGGCCGAAGTAGGCAACCCGAGACCCAGTACTTC	CSARTAGGRSRQPETQYF	TRBV20-1	TRBJ2-5
TGTGCCACCGGCTCACGGCCCGCTAACTATGGCTACACCTTC	CATGSRPANYGYTF	TRBV24-1	TRBJ1-2
TGCACCCGGACGGGCGGGGGCAACAATGAGCAGTTCTTC	CTRTGGGNNEQFF	TRBV20-1	TRBJ2-1
TGTGCCAGCACCGGCGACAGGGTTTATAGCACAGATACGCAGTATTTT	CASTGDRVYSTDTQYF	TRBV27	TRBJ2-3
TGTGCCAGCAGCAAGGGACTCTCGCGGTACGAGCAGTACTTC	CASSKGLSRYEQYF	TRBV13	TRBJ2-7
TGTGCCAGCAGCAGGACAGTCTGGAACTATGGCTACACCTTC	CASSRTVWNYGYTF	TRBV6-1	TRBJ1-2
TGTGCCAGCAGCGGTGTAGCTAGCGGGCCCGCCTACAATGAGCAGTTCTTC	CASSGVASGPAYNEQFF	TRBV7-4	TRBJ2-1
TGCGCCAGCAGTGAGTACCCTCGGCAGGAGTACTTC	CASSEYPRQEYF	TRBV10-1	TRBJ2-5
TGTGCCAGTAATCACTATCAGCCCCAGCATTTT	CASNHYQPQHF	TRBV19	TRBJ1-5
TGCAGCCGAACTCCGGGACAGGGGGGTGCAAAGAGCTCCTATAATTCACCCCTCCACTTT	CSRTPGQGGAKSSYNSPLHF	TRBV29-1	TRBJ1-6
TGTGCCTGCCGACAGGGAGCAACTAATGAAAAACTGTTTTTT	CACRQGATNEKLFF	TRBV30	TRBJ1-4
TGTGCCAGCAGTTTTGCCCAAGACAGTAATAGCAATCAGCCCCAGCATTTT	CASSFAQDSNSNQPQHF	TRBV27	TRBJ1-5
TGTGCCAGCACGGGGCCATGCTGGGACAGGGTCACTAGCTCTGGAAACACCATATATTTT	CASTGPCWDRVTSSGNTIYF	TRBV6-4	TRBJ1-3
TGTGCCAGTAGTACGCGCCACAGAGGCAATCAGCCCCAGCATTTT	CASSTRHRGNQPQHF	TRBV19	TRBJ1-5
TGTGCCAGCACCTTGGAAGGGGAGCCCCAGCATTTT	CASTLEGEPQHF	TRBV6-4	TRBJ1-5
TGTGCCAGCAGCTTAGATGGTCGGGGACAGGGGGGGGATCAGCCCCAGCATTTT	CASSLDGRGQGGDQPQHF	TRBV11-2	TRBJ1-5
TGCGCCAGCAGCCATGACCGGGGGAATTGGCCCCAGCATTTT	CASSHDRGNWPQHF	TRBV4-1	TRBJ1-5
TGTGCCAGCAGTTACGGCGGATTCAGGGAGGGCCCGAACACTGAAGCTTTCTTT	CASSYGGFREGPNTEAFF	TRBV6-5	TRBJ1-1
TGTGCCAGCAGCCTACCGCAGGGTCCTCTGACGAACACCGGGGAGCTGTTTTTT	CASSLPQGPLTNTGELFF	TRBV7-4	TRBJ2-2
TGTGCCAGCAGTTTGGCTTTACCGCCCGGGACAGGGAATACGTCCTATGGCTACACCTTC	CASSLALPPGTGNTSYGYTF	TRBV27	TRBJ1-2
TGTGCCCCTCTGTCTATTTACAATGAGCAGTTCTTC	CAPLSIYNEQFF	TRBV6-2	TRBJ2-1
TGTGCCAGCAAACCGGGGAAGACGAGCAATCAGCCCCAGCATTTT	CASKPGKTSNQPQHF	TRBV6-4	TRBJ1-5
TGTGTCGCCTGGATCCTAGCGGGCCTCGACTACGAGCAGTACTTC	CVAWILAGLDYEQYF	TRBV25-1	TRBJ2-7
TGTGCCAGCAGCTTAATCTTTGCCGGGGGGATAAGATCTTGCTCCTACAATGAGCAGTTCTTC	CASSLIFAGGIRSCSYNEQFF	TRBV7-4	TRBJ2-1
TGTGCCAGCAGCTTGGACTGGACTGAAGCTTTCTTT	CASSLDWTEAFF	TRBV5-6	TRBJ1-1
TGCAGTGCTAGACGACAGCATAACAACACTGAAGCTTTCTTT	CSARRQHNNTEAFF	TRBV20-1	TRBJ1-1
TGTGCCAGCAGCAGCCCGGGGGGGGGGTTCTTC	CASSSPGGGFF	TRBV9	TRBJ2-1
TGCGCCAGCAGTGTACGCCAGGAGAACCCCCCTTACGAGCAGTACTTC	CASSVRQENPPYEQYF	TRBV10-1	TRBJ2-7
TGTGCCAGCAGTGACAGAAGGGGGCGGGGCGAGCAGTACTTC	CASSDRRGRGEQYF	TRBV6-4	TRBJ2-7
TGTGCCAGCAGCTTAGAAATTGGACAGGGGAATTCACCCCTCCACTTT	CASSLEIGQGNSPLHF	TRBV13	TRBJ1-6
TGTGCCTGGGGGGGGTCCTATGGCTACACCTTC	CAWGGSYGYTF	TRBV30	TRBJ1-2
TGTGCCAGCAGTTATCATGGGGTCTTGACCCATTCACCCCTCCACTTT	CASSYHGVLTHSPLHF	TRBV6-5	TRBJ1-6
TGTGCCAGCAGCCGCCTTAGTTGGGACAGGGGGAACTGGGATCAGCCCCAGCATTTT	CASSRLSWDRGNWDQPQHF	TRBV4-2	TRBJ1-5
TGTGCCACCCGGCCGGGACAGAACTATGGCTACACCTTC	CATRPGQNYGYTF	TRBV24-1	TRBJ1-2
TGTGCCAGCAGTGTACAGGGATTCGGTTCCGAAAAACTGTTTTTT	CASSVQGFGSEKLFF	TRBV6-2	TRBJ1-4
TGTGCCAGCAGTGACCACGCTAGCGGGGGGGCCAGAGACCACAACATTCAGTACTTC	CASSDHASGGARDHNIQYF	TRBV6-4	TRBJ2-4
TGTGCCAGCAGACGTTTAGGACTAGCGGGCCAGTACTTC	CASRRLGLAGQYF	TRBV6-4	TRBJ2-7
TGTGCCAGCTCACCACGTACCGATCTAGCGGGTAAGCATACGCAGTATTTT	CASSPRTDLAGKHTQYF	TRBV18	TRBJ2-3
TGTGCCAGCAGCAGCGGGGGGTGCCCTATGAACACTGAAGCTTTCTTT	CASSSGGCPMNTEAFF	TRBV5-4	TRBJ1-1
TGTGCCAGCAGCCAAAGCGTCGACAGGGGCTCTGGGGCCAACGTCCTGACTTTC	CASSQSVDRGSGANVLTF	TRBV6-4	TRBJ2-6
TGTGCCAGCAGCGAAGGGACAGGGTCGGGCAATGAAAAACTGTTTTTT	CASSEGTGSGNEKLFF	TRBV5-6	TRBJ1-4
TGTGCCAGCAGCGTAGGGCCTAGCGGGGAAATCTCCTACGAGCAGTACTTC	CASSVGPSGEISYEQYF	TRBV9	TRBJ2-7
TGTGCCAGCAGCTTGACTTCTACAGACAGGGTGGCTAATTCACCCCTCCACTTT	CASSLTSTDRVANSPLHF	TRBV7-3	TRBJ1-6
TGTGCCAGCGGTGCCCCGCCCACACAGGTTTTCTCCTACGAGCAGTACTTC	CASGAPPTQVFSYEQYF	TRBV5-8	TRBJ2-7
TGCGCCAGCAGCGGACAGGTGCGGGCGGGCTCCTATAATTCACCCCTCCACTTT	CASSGQVRAGSYNSPLHF	TRBV5-1	TRBJ1-6
TGTGCCATAGGGACGGGGCAAGGGAGCTCCTACGAGCAGTACTTC	CAIGTGQGSSYEQYF	TRBV6-3	TRBJ2-7
TGTGCCTGGAGTAACAGGGGGCCCGCGGTGATGAACACTGAAGCTTTCTTT	CAWSNRGPAVMNTEAFF	TRBV30	TRBJ1-1
TGTGCCAGCAGCACAGTTCAGGGCCATCCGAATGGATACGAGCAGTACTTC	CASSTVQGHPNGYEQYF	TRBV13	TRBJ2-7
TGCGCCAGCAGTGAGGACAGGAGGGGAAGCAATGGCTACACCTTC	CASSEDRRGSNGYTF	TRBV10-1	TRBJ1-2
TGTGCCAGGGGGGCCGTAGGGTGCCCGGATGAGCAGTTCTTC	CARGAVGCPDEQFF	TRBV19	TRBJ2-1
TGTGCCAGCAGCGTAGGGACCCAAGATCGGGGGAAAAACGAGCAGTACTTC	CASSVGTQDRGKNEQYF	TRBV9	TRBJ2-7
TGTGCCACCAGGGTCTCTAGCTTCAGTAGAAAGGGGGGCGAGCAGTACTTC	CATRVSSFSRKGGEQYF	TRBV24-1	TRBJ2-7
TGCAGCGTTGAAACCCGGACAGGGGGCTACGAGCAGTACTTC	CSVETRTGGYEQYF	TRBV29-1	TRBJ2-7
TGTGCCACTCGAATTGAGCAGTTCTTC	CATRIEQFF	TRBV9	TRBJ2-1
TGTGCCAGCAGCGCTAGCGGATCGAGCTACAATGAGCAGTTCTTC	CASSASGSSYNEQFF	TRBV13	TRBJ2-1
TGTGCCACAGTGGACAGGGGTCGGTCTGAAGCTTTCTTT	CATVDRGRSEAFF	TRBV24-1	TRBJ1-1
TGTGCCAGCAGTTCGCTAGCGGGAAGCGAAAGAGCCACGTGCGTCGGGGAGCTGTTTTTT	CASSSLAGSERATCVGELFF	TRBV27	TRBJ2-2
TGTGCCTGGAGTGCTGGAGTAGGGAATCGGGGGTATAGCAATCAGCCCCAGCATTTT	CAWSAGVGNRGYSNQPQHF	TRBV30	TRBJ1-5
TGTGCCACCAGCAAAGGGTGGACAGGGGGCGGCAATGAGCAGTTCTTC	CATSKGWTGGGNEQFF	TRBV15	TRBJ2-1
TGTGCCAGTAGTCTCCTTCCGGGGAACGAGCAGTACTTC	CASSLLPGNEQYF	TRBV19	TRBJ2-7
TGCGCCAGCAGCCGACGAGACCGGGAAACAGCCTATAATTCACCCCTCCACTTT	CASSRRDRETAYNSPLHF	TRBV4-1	TRBJ1-6
TGTGCCAGTAGTAGGGTATACTATCAGGACTACAATGAGCAGTTCTTC	CASSRVYYQDYNEQFF	TRBV19	TRBJ2-1
TGTGCCAGCAGGGCGGACAGCCGAAACACCATATATTTT	CASRADSRNTIYF	TRBV6-2	TRBJ1-3
TGTGCCAGCAGTTTATCGGACAGCAATCAGCCCCAGCATTTT	CASSLSDSNQPQHF	TRBV28	TRBJ1-5
TGTGCCAGCAGCCCGGGACTCTCCTACGAGCAGTACTTC	CASSPGLSYEQYF	TRBV6-4	TRBJ2-7
TGTGCCAGCAGCTTAGGCTTAGCCAAAAACATTCAGTACTTC	CASSLGLAKNIQYF	TRBV7-9	TRBJ2-4
TGTGCCAGCAGTTCGGGGGAGCCCTATGGCTACACCTTC	CASSSGEPYGYTF	TRBV6-2	TRBJ1-2
TGTGCCAGTTCAGACGAGCAGTACTTC	CASSDEQYF	TRBV19	TRBJ2-7
TGTGCCAGCAGCGGCGTTTGCTGTTATAAACCTGAGAATGAGCAGTTCTTC	CASSGVCCYKPENEQFF	TRBV7-3	TRBJ2-1
TGTGCCAGCAGCACTAAATTATCTGACAGGGTGGGCTGGGGGTTGGACTCTGGAAACACCATATATTTT	CASSTKLSDRVGWGLDSGNTIYF	TRBV7-4	TRBJ1-3
TGTGCCAGCAGGGTTTATTTTCCTCCTAGCGGGGGGCTGACCCAGTACTTC	CASRVYFPPSGGLTQYF	TRBV6-3	TRBJ2-5
TGCGCCAGCAGCATTCCGGGATCAGTGACTAACTATGGCTACACCTTC	CASSIPGSVTNYGYTF	TRBV5-1	TRBJ1-2
TGTGCCAGCAGCTCCCTCGTTCCCGGGACAGACGAGCAGTACTTC	CASSSLVPGTDEQYF	TRBV14	TRBJ2-7
TGCGCCAGCAGCTTGATTGGGCGGGGAGGATACGAGCAGTACTTC	CASSLIGRGGYEQYF	TRBV5-1	TRBJ2-7
TGCAGTGCTAGATCCCTAGCGGGAATTACCTACGAGCAGTACTTC	CSARSLAGITYEQYF	TRBV20-1	TRBJ2-7
TGTGCCAGCAGCGTTCCGCAAAAGCCCGGGACACTTACGCCCAGCAATCAGCCCCAGCATTTT	CASSVPQKPGTLTPSNQPQHF	TRBV13	TRBJ1-5
TGTGCCAGTGACAGGGGCCGATGCGAGCAGTACTTC	CASDRGRCEQYF	TRBV27	TRBJ2-7
TGCGCCAGCACTCGGAATTACAACACCGGGGAGCTGTTTTTT	CASTRNYNTGELFF	TRBV10-2	TRBJ2-2
TGTGCTAGTGGTGGACAGGACTACTACGAGCAGTACTTC	CASGGQDYYEQYF	TRBV12-5	TRBJ2-7
TGTGCCAGCAGCTTAGCGATCGGGACAGCTATCTCTGGAAACACCATATATTTT	CASSLAIGTAISGNTIYF	TRBV7-4	TRBJ1-3
TGCAGTGCTAGACTTGAAATGTGCCCGGGATGCCTAGTCGAGCAGTACTTC	CSARLEMCPGCLVEQYF	TRBV20-1	TRBJ2-7
TGTGCCAGTAGCAACGTATGCACAGATACGCAGTATTTT	CASSNVCTDTQYF	TRBV19	TRBJ2-3
TGTGCCAGCAGCCTCTTCGAACAGCCCCAGCATTTT	CASSLFEQPQHF	TRBV13	TRBJ1-5
TGCAGCGTTGTTTATGGCAATCCCAACACCGGGGAGCTGTTTTTT	CSVVYGNPNTGELFF	TRBV29-1	TRBJ2-2
TGTGCCAGCAGCTTCGGGAACCGCCCAGGGTTCTATCACTTC	CASSFGNRPGFYHF	TRBV5-8	TRBJ2-7
TGTGCCAGCAGAGGGGGAAATGAAGCTTTCTTT	CASRGGNEAFF	TRBV6-4	TRBJ1-1
TGTGCCAGCGGTGCAGGGAAATTGTCTCAGCCCCAGCATTTT	CASGAGKLSQPQHF	TRBV18	TRBJ1-5
TGTGCTAGTCCGGACGTCACTGAAGCTTTCTTT	CASPDVTEAFF	TRBV12-5	TRBJ1-1
TGTGCCAGCAGCTTAGCTATACCAGCCGGACTGGCAGCCACTGAAGCTTTCTTT	CASSLAIPAGLAATEAFF	TRBV7-4	TRBJ1-1
TGTGCCAGCAGTTTATCGCCACGACTAGCGGGGGGGGTGCCAGATACGCAGTATTTT	CASSLSPRLAGGVPDTQYF	TRBV27	TRBJ2-3
TGTGCCAGCAGCCAACTTCTGGGACTAGCGGGCTGCCCACTAAATGAGCAGTTCTTC	CASSQLLGLAGCPLNEQFF	TRBV3-1	TRBJ2-1
TGTGCCAGCAGCATTACCCATCTCCAGGGGGGGGTAATGCGTTCCTGGGAAAAACTGTTTTTT	CASSITHLQGGVMRSWEKLFF	TRBV11-3	TRBJ1-4
TGTGCCAGCAAGGAGTATTTGCCGGGACAGGGTTACACTGAAGCTTTCTTT	CASKEYLPGQGYTEAFF	TRBV7-2	TRBJ1-1
TGTGCTCCCCGGGACAGGGCAAACACAGATACGCAGTATTTT	CAPRDRANTDTQYF	TRBV5-4	TRBJ2-3
TGTGCCAGCGTCCCTAGCGGGGAACGGTTTGAGCAGTTCTTC	CASVPSGERFEQFF	TRBV6-1	TRBJ2-1
TGTGCCAGCAGTACTCGACGGGGACAGGGGGCGATGAACACTGAAGCTTTCTTT	CASSTRRGQGAMNTEAFF	TRBV27	TRBJ1-1
TGTGCCAGCAGCTATTGGGAGGGTTGGGACTACGAGCAGTACTTC	CASSYWEGWDYEQYF	TRBV7-3	TRBJ2-7
TGTGCCAGCAGCTCCGACAGGGCCCCGGAAAAACTGTTTTTT	CASSSDRAPEKLFF	TRBV7-9	TRBJ1-4
TGTGCCAGCAGCCCCCGAGACAGCAGGGGAGGGGAAGAGACCCAGTACTTC	CASSPRDSRGGEETQYF	TRBV11-2	TRBJ2-5
TGTGCCAGCAGTGACCTGATGGACACTGAAGCTTTCTTT	CASSDLMDTEAFF	TRBV6-4	TRBJ1-1
TGCGCCAGCAGCTTGGCCCTAGCGGGGCGGCTCACAGATACGCAGTATTTT	CASSLALAGRLTDTQYF	TRBV5-1	TRBJ2-3
TGTGCCAGCAGCTTCCACAGCCGTGAGCGGAGTACCGGGGAGCTGTTTTTT	CASSFHSRERSTGELFF	TRBV7-2	TRBJ2-2
TGTGCCAGCAGCCAAGATAGGGCTTATCAGCCCCAGCATTTT	CASSQDRAYQPQHF	TRBV3-1	TRBJ1-5
TGTGCCAGCAGGGCGGGTCAGCCCCAGCATTTT	CASRAGQPQHF	TRBV6-4	TRBJ1-5
TGTGCCAGCAGCTACCAGCGAGCAGGGCTCGGTGGCTACACCTTC	CASSYQRAGLGGYTF	TRBV7-9	TRBJ1-2
TGCGCCAGCAGCCAATCACCTCACGAGGGGGCGACCCTCCACTTT	CASSQSPHEGATLHF	TRBV4-3	TRBJ1-6
TGTGCCAGCAGCTGGATCTGGCCCGTACAGGGAAAGAATAGCAATCAGCCCCAGCATTTT	CASSWIWPVQGKNSNQPQHF	TRBV5-4	TRBJ1-5
TGTGCCAGCAGTTACGCGGGAGTTTCACCCCTCCACTTT	CASSYAGVSPLHF	TRBV6-3	TRBJ1-6
TGTGCCAGCAGCTCGAAGGACAACGGACGAACAGCTGAAGCTTTCTTT	CASSSKDNGRTAEAFF	TRBV7-6	TRBJ1-1
TGTGCCAGCAGTAAAGTGTCTAGCGGGGGAGAGACCCAGTACTTC	CASSKVSSGGETQYF	TRBV6-5	TRBJ2-5
TGTGCCAGTGCCAGGAGAGGGACCTACGAGCAGTACTTC	CASARRGTYEQYF	TRBV19	TRBJ2-7
TGTGCCAGCAGCAACGGTGACAGGGAGACTAATGAAAAACTGTTTTTT	CASSNGDRETNEKLFF	TRBV5-6	TRBJ1-4
TGTGCCAGCAGCGTAGCCGACCGGACGAAATTGAACACTGAAGCTTTCTTT	CASSVADRTKLNTEAFF	TRBV9	TRBJ1-1
TGTGCCAGTAGTGGACTCTCCGGGACAGGGGTTTATTATTGTGAAGCTTTCTTT	CASSGLSGTGVYYCEAFF	TRBV19	TRBJ1-1
TGTGCCAGCAGCTATGTGCGAATTGGCTCCTACGAGCAGTACTTC	CASSYVRIGSYEQYF	TRBV7-2	TRBJ2-7
TGTGCCAGCAGTTTGCGACGTGGCAATGAGCAGTTCTTC	CASSLRRGNEQFF	TRBV28	TRBJ2-1
TGTGCCAGCATACGAGGACAGGGGGCGGGCACAGATACGCAGTATTTT	CASIRGQGAGTDTQYF	TRBV9	TRBJ2-3
TGTGCCAGCAGCCGTGACAGATGGAATCAGCCCCAGCATTTT	CASSRDRWNQPQHF	TRBV5-6	TRBJ1-5
TGTGCCACGGCGAAGGGGATCATCAATCAGCCCCAGCATTTT	CATAKGIINQPQHF	TRBV24-1	TRBJ1-5
TGCGCCAGCAGCATTACTGGGAATGAAAAACTGTTTTTT	CASSITGNEKLFF	TRBV5-1	TRBJ1-4
TGTGCCAGTTGGCAGGACTACTGGAATGAGCAGTTCTTC	CASWQDYWNEQFF	TRBV19	TRBJ2-1
TGTGCCACCAGTGATTTGACTAGGACTAGCGGGGGGCACGAGCAGTTCTTC	CATSDLTRTSGGHEQFF	TRBV24-1	TRBJ2-1
TGTGCCAGCAGCTCCCATACTCTGGAGGGGGGGCCGGGCTACACCTTC	CASSSHTLEGGPGYTF	TRBV7-9	TRBJ1-2
TGTGCCAGCAGCTTACAGAGGGACAGGGGCTCCTACAATGAGCAGTTCTTC	CASSLQRDRGSYNEQFF	TRBV7-3	TRBJ2-1
TGTGCCAGCCAATCAACCCCGGGGGCGGATGGCTACACCTTC	CASQSTPGADGYTF	TRBV6-1	TRBJ1-2
TGTGCCAGCGCCTGGGACAGGGGGTTATACTATGGCTACACCTTC	CASAWDRGLYYGYTF	TRBV27	TRBJ1-2
TGTGCCAGCAGTTTCCGCGACCAGGAGACCCAGTACTTC	CASSFRDQETQYF	TRBV28	TRBJ2-5
TGTGCCACCACCAAAGGAGGGGGGGGGGTGGGATGTCATAGTGGAGATAGCCGCTCCTACGAGCAGTACTTC	CATTKGGGGVGCHSGDSRSYEQYF	TRBV24-1	TRBJ2-7
TGCGCCAGCACCGTCCCGATCACTGGCATCCTTGAAGCTTTCTTT	CASTVPITGILEAFF	TRBV4-1	TRBJ1-1
TGTGCCAGCAGCCAAGTGGTCGTTTCGACAGGTTATCGCCCCAACAATGAGCAGTTCTTC	CASSQVVVSTGYRPNNEQFF	TRBV14	TRBJ2-1
TGTGCCAGCAGCCGTGGGGCAGAGACCCAGTACTTC	CASSRGAETQYF	TRBV11-3	TRBJ2-5
TGTGCCAGCAGATTTTCTCGACACGAGCAGTACTTC	CASRFSRHEQYF	TRBV7-9	TRBJ2-7
TGCGCCAGCAGCAACCAGGGAAATACCAACACTGAAGCTTTCTTT	CASSNQGNTNTEAFF	TRBV5-1	TRBJ1-1
TGCGCCAGCAGCCGGTCACAGCATTGGGATGAGCAGTTCTTC	CASSRSQHWDEQFF	TRBV10-1	TRBJ2-1
TGTGCTAGTGGGTTAAGGGCCTTTTATGAAAAACTGTTTTTT	CASGLRAFYEKLFF	TRBV12-5	TRBJ1-4
TGTGCCAGCAGTGTTCCGGGGGACGAGCAGTACTTC	CASSVPGDEQYF	TRBV27	TRBJ2-7
TGTGCCAGCAGCGTTGACGAGGGGGCCCAGCCCCAGCATTTT	CASSVDEGAQPQHF	TRBV3-1	TRBJ1-5
TGTGCCAGCAGCCACCTAATTATGAGGGTAATCAACACTGAAGCTTTCTTT	CASSHLIMRVINTEAFF	TRBV7-9	TRBJ1-1
TGTGCCAGCAGCTTAGTTGTCCAGGGGCCCTACGAGCAGTACTTC	CASSLVVQGPYEQYF	TRBV7-9	TRBJ2-7
TGTGCCAGCAGTTTAAGGGCTTGGGAGACCCAGTACTTC	CASSLRAWETQYF	TRBV12-4	TRBJ2-5
TGTGCCAGCAGCAGGCCGGACCCGAACACTGAAGCTTTCTTT	CASSRPDPNTEAFF	TRBV9	TRBJ1-1
TGTGCCAGCTCACGTCAAGGCAACCACGCCAATGAGCAGTTCTTC	CASSRQGNHANEQFF	TRBV18	TRBJ2-1
TGTGCCAGCAGCAGTAGGGGGGGGAGGGATGGCTACACCTTC	CASSSRGGRDGYTF	TRBV11-2	TRBJ1-2
TGTGCCAGCAGTTTCTGGGGGGGACTTGTCTACGAGCAGTACTTC	CASSFWGGLVYEQYF	TRBV28	TRBJ2-7
TGTGCCAGCATCCCATGGAGAGAAGCTAACTATGGCTACACCTTC	CASIPWREANYGYTF	TRBV12-4	TRBJ1-2
TGTGCCAGCAGTTTATCCCAAGGAGGGCGGGGGGGCGAGACCCAGTACTTC	CASSLSQGGRGGETQYF	TRBV28	TRBJ2-5
TGCGCCAGCAGCCAAGATGAGGGACAGTGCTCCGGGGAGCTGTTTTTT	CASSQDEGQCSGELFF	TRBV4-1	TRBJ2-2
TGTGCCAGCATGGACTTTGGGGTTGATCAGCCCCAGCATTTT	CASMDFGVDQPQHF	TRBV6-5	TRBJ1-5
TGTGCTAGCAGCTTCTGGACGGCAAGTGAAGCTTTCTTT	CASSFWTASEAFF	TRBV7-7	TRBJ1-1
TGTGCCAGCAGTCGGGGGCCCCATTATTCACCCCTCCACTTT	CASSRGPHYSPLHF	TRBV12-4	TRBJ1-6
TGCGCCAGCAGCCAAATCGAGTACTACACCTTC	CASSQIEYYTF	TRBV4-1	TRBJ1-2
TGTGCCACCAGTGACAAGACTAGCGGGAGGGCTTGGGTATCACCCCTCCACTTT	CATSDKTSGRAWVSPLHF	TRBV24-1	TRBJ1-6
TGTGCCAGCAGCTTAATGGGGGCCCCACGCACAGATACGCAGTATTTT	CASSLMGAPRTDTQYF	TRBV7-7	TRBJ2-3
TGTGCCAGCAGGCGAAACACAAACACTGAAGCTTTCTTT	CASRRNTNTEAFF	TRBV12-4	TRBJ1-1
TGTGCCAGCAGCAGTTCCGGACATCAGCCCCAGCATTTT	CASSSSGHQPQHF	TRBV7-4	TRBJ1-5
TGCGCCAGCAGCGGCCTGGGGGCCGACCTCACAGATACGCAGTATTTT	CASSGLGADLTDTQYF	TRBV5-1	TRBJ2-3
TGCGCCAGCAGCCAAGAAGGATGCGGACTTAATTCACCCCTCCACTTT	CASSQEGCGLNSPLHF	TRBV4-3	TRBJ1-6
TGTGCCAGCAGCATGTGGGGAAAGGAAACCTACGAGCAGTACTTC	CASSMWGKETYEQYF	TRBV11-2	TRBJ2-7
TGTGCCAGCCTTCCTTCTCCGTTGGGACAGGGCCCAACTGTTTCAGGCACAGATACGCAGTATTTT	CASLPSPLGQGPTVSGTDTQYF	TRBV7-9	TRBJ2-3
TGTGCCAGCAGTTATTACCCTAAAGGACAGGGAGACTCTTGGCAGCCCCAGCATTTT	CASSYYPKGQGDSWQPQHF	TRBV6-9	TRBJ1-5
TGTGCCAGCAGCTGCAGGGCCCCAGATACGCAGTATTTT	CASSCRAPDTQYF	TRBV12-3	TRBJ2-3
TGTGCCAGCAGCCAGGGACTAGCGGAGAAGAGCACAGATACGCAGTATTTT	CASSQGLAEKSTDTQYF	TRBV13	TRBJ2-3
TGTGCCAGCAGCTCTTCCCTGGCAGAGGGCCCAGAGACCCAGTACTTC	CASSSSLAEGPETQYF	TRBV11-2	TRBJ2-5
TGCCACCGACAGGGGTTCGGGCACACTGAAGCTTTCTTT	CHRQGFGHTEAFF	TRBV20-1	TRBJ1-1
TGTGCCAGCAGCTCATCGCTGGTATTGGATACGCAGTATTTT	CASSSSLVLDTQYF	TRBV7-8	TRBJ2-3
TGCGCCAGCAGCTTGGTTCAGACAAATATAGAGCAGTACTTC	CASSLVQTNIEQYF	TRBV5-1	TRBJ2-7
TGTGCCACCAGTGCAGGGGAGTTGGGTGTGCCTTACCTAGCCAAAAACATTCAGTACTTC	CATSAGELGVPYLAKNIQYF	TRBV24-1	TRBJ2-4
TGTGCCAGCAGCGTCCCCAACGGGACAGGCTATGGCTACACCTTC	CASSVPNGTGYGYTF	TRBV9	TRBJ1-2
TGCGCCAGCAGCTTGAAGGGACAGGGCACACTTAATTCACCCCTCCACTTT	CASSLKGQGTLNSPLHF	TRBV5-1	TRBJ1-6
TGCGCCAGCAGTATGGGACTCTCGAATTATGGCTACACCTTC	CASSMGLSNYGYTF	TRBV10-2	TRBJ1-2
TGTGCCAGCAGCCCCGTTTCCCCCCCGGGACAGGGGCAGCGCTCACCCCTCCACTTT	CASSPVSPPGQGQRSPLHF	TRBV13	TRBJ1-6
TGCGCCAGCAGTGAGTCGCCAGTACCGACCACAAAGGTTGAGCAGTACTTC	CASSESPVPTTKVEQYF	TRBV10-1	TRBJ2-7
TGTGCTAGTGGTTTGGTACCAGCTTCGACTAGCGGGCGAGGAGCCAAAAACATTCAGTACTTC	CASGLVPASTSGRGAKNIQYF	TRBV12-5	TRBJ2-4
TGTGCCAGCAGCGGAGGGACAGGGGGAGGGGAGCTGTTTTTT	CASSGGTGGGELFF	TRBV13	TRBJ2-2
TGTGCCAGCAGCCAAGTTCCTAATGGTTGTGGGGGGAGCTCCTACGAGCAGTACTTC	CASSQVPNGCGGSSYEQYF	TRBV4-2	TRBJ2-7
TGCGCCAGCAGCTTGGGGGAGGGGGGGCCTTGGAGGAGTTGGGAGCAGTACTTC	CASSLGEGGPWRSWEQYF	TRBV5-1	TRBJ2-7
TGTGCTAGCAGGATTTGCGACGAGACTGGGAAGCGCACAGATACGCAGTATTTT	CASRICDETGKRTDTQYF	TRBV7-7	TRBJ2-3
TGTGCCAGTGCAAACCGGACAGGGGAGGCAACTAATGAAAAACTGTTTTTT	CASANRTGEATNEKLFF	TRBV19	TRBJ1-4
TGTGCCAGCAGCAACCCCCAGGGGGATACTCATCAGCCCCAGCATTTT	CASSNPQGDTHQPQHF	TRBV5-4	TRBJ1-5
TGCGCCAGCAGCCCCAGGTTGGGCTCCTACGAGCAGTACTTC	CASSPRLGSYEQYF	TRBV5-1	TRBJ2-7
TGTGCCAGCAGTTTGCCTACCCCCAGGGGCTATGGCTACACCTTC	CASSLPTPRGYGYTF	TRBV28	TRBJ1-2
TGTGCCAGCAAGACTTCCTACGAGCAGTACTTC	CASKTSYEQYF	TRBV12-3	TRBJ2-7
TGTGCCAGCAGCATGGCCAGAGGAGGAAACCGAAACACCATATATTTT	CASSMARGGNRNTIYF	TRBV7-9	TRBJ1-3
TGTGCCAGCAGGGACGAGCAGTACTTC	CASRDEQYF	TRBV19	TRBJ2-7
TGTGCCTGGAGTGCATCGCCGGGGGGAAGTGGTGCCCAGTACTTC	CAWSASPGGSGAQYF	TRBV30	TRBJ2-5
TGTGCCAGCAGTGACTCAAGGGAGGAGAACAGGGTTCTTAGAAATCAGCCCCAGCATTTT	CASSDSREENRVLRNQPQHF	TRBV6-4	TRBJ1-5
TGTGCCAGCAGAAAGACTCGGCAAGAGACCCAGTACTTC	CASRKTRQETQYF	TRBV6-2	TRBJ2-5
TGCGCCAGCAGCGAGGGTGAAGGGGATCCCTATGGCTACACCTTC	CASSEGEGDPYGYTF	TRBV5-1	TRBJ1-2
TGTGCCAGCAGTCCGCAGGGCCGACGAAATTCACCCCTCCACTTT	CASSPQGRRNSPLHF	TRBV28	TRBJ1-6
TGTGCCAACGCCGTCTTACGTGGCTATGGCTACACCTTC	CANAVLRGYGYTF	TRBV6-3	TRBJ1-2
TGTGCCAGCAGCAATAGAGGAAACGCGGGAGTCGACAATGAGCAGTTCTTC	CASSNRGNAGVDNEQFF	TRBV7-9	TRBJ2-1
TGTGCCAGCAGCTTGGGGGGAAAGGGAGGGAAGTGTAAGGTAACCTACGAGCAGTACTTC	CASSLGGKGGKCKVTYEQYF	TRBV5-6	TRBJ2-7
TGTGCCACTTGGGAGGGGTTTGCTGATACGCAGTATTTT	CATWEGFADTQYF	TRBV27	TRBJ2-3
TGCAGTGCTAGAGTCAACCTAGGCTTCGAGCAGTACTTC	CSARVNLGFEQYF	TRBV20-1	TRBJ2-7
TGTGCCACCAGTACTAGAAAACCTGTAGCCAAAAACATTCAGTACTTC	CATSTRKPVAKNIQYF	TRBV12-4	TRBJ2-4
TGTGCCAGCAGCGCCAGGACGACTAGTTCAGATACGCAGTATTTT	CASSARTTSSDTQYF	TRBV9	TRBJ2-3
TGTGCCACCAGGGGACCTGATGGGAGAAGCTCTGGGGCCAACGTCCTGACTTTC	CATRGPDGRSSGANVLTF	TRBV24-1	TRBJ2-6
TGTGCCAGCAGCCCAGGGGGCGAGAATTCACCCCTCCACTTT	CASSPGGENSPLHF	TRBV2	TRBJ1-6
TGTGCCAGCAGCTCCGGACAGCGCAAAAACATTCAGTACTTC	CASSSGQRKNIQYF	TRBV11-2	TRBJ2-4
TGTGCCAGCAGCGGACCCTCCGAGATGTATGAGCAGTTCTTC	CASSGPSEMYEQFF	TRBV13	TRBJ2-1
TGTGCCAGCAGCAAGGGAGGGGCCGTCTATCATTGCACAGATACGCAGTATTTT	CASSKGGAVYHCTDTQYF	TRBV11-3	TRBJ2-3
TGTGCCAGCAGCAAACCGGGACTAGCGGGGGGCACAGATACGCAGTATTTT	CASSKPGLAGGTDTQYF	TRBV5-4	TRBJ2-3
TGTGCCAGCACGGCAACTGAAGCTTTCTTT	CASTATEAFF	TRBV7-4	TRBJ1-1
TGCGCCAATGGACAGGGCAATCAGCCCCAGCATTTT	CANGQGNQPQHF	TRBV5-1	TRBJ1-5
TGTGCCAGTAGTATCAGAAGGGACAGGGCTGACTATGGCTACACCTTC	CASSIRRDRADYGYTF	TRBV19	TRBJ1-2
TGTGCCACCAGTGCTGTAGCGGAGACTATGGAGCAGTACTTC	CATSAVAETMEQYF	TRBV24-1	TRBJ2-7
TGCGCCAGCAGCTTGCCGTACCTCTCGTCTGGAAACACCATATATTTT	CASSLPYLSSGNTIYF	TRBV5-1	TRBJ1-3
TGCGCCAGCGAGCGGCAGAACACTGAAGCTTTCTTT	CASERQNTEAFF	TRBV4-1	TRBJ1-1
TGTGCCAGCAGCGTCCAGGAGACCCAGTACTTC	CASSVQETQYF	TRBV5-6	TRBJ2-5
TGTGCCAGCAGCTTAGTCAGCCTCCCAGTAAGAAACGAGCAGTACTTC	CASSLVSLPVRNEQYF	TRBV7-2	TRBJ2-7
TGCGCCAGCGCCGGGACAGGGCAAGTCTCTGGAAACACCATATATTTT	CASAGTGQVSGNTIYF	TRBV10-2	TRBJ1-3
TGTGCCAGCAGCGAGACGGTCAACATTCAGTACTTC	CASSETVNIQYF	TRBV11-3	TRBJ2-4
TGCGCCAGCAGCTCTCAGACAAGGTACAATGAGCAGTTCTTC	CASSSQTRYNEQFF	TRBV5-1	TRBJ2-1
TGTGCCATCAGTGAACTAGGGACCACCGGGGAGCTGTTTTTT	CAISELGTTGELFF	TRBV10-3	TRBJ2-2
TGTGCCAGCATACGGGACGAGCAGTACTTC	CASIRDEQYF	TRBV28	TRBJ2-7
TGTGCCAGCAGTTTAGTTGGGACAGTGGGTGCCTACGAGCAGTACTTC	CASSLVGTVGAYEQYF	TRBV28	TRBJ2-7
TGTGCCAGCAGCCCGGCAGGCTCCTACAATGAGCAGTTCTTC	CASSPAGSYNEQFF	TRBV9	TRBJ2-1
TGCGCCAGCAGCAGTAGAGTCGAGCAGTACTTC	CASSSRVEQYF	TRBV4-1	TRBJ2-7
TGTGCCTGGAGTGTAGCAATTGGAAGCCCAACATGGAACACTGAAGCTTTCTTT	CAWSVAIGSPTWNTEAFF	TRBV30	TRBJ1-1
TGTGCCAGCAGCCCTATAGCGGGCCTCCCGAGCTCCTACAATGAGCAGTTCTTC	CASSPIAGLPSSYNEQFF	TRBV14	TRBJ2-1
TGTGCCAGCAGCAGTGACAGGGAAAAAGCTGTTACCCGCAATCAGCCCCAGCATTTT	CASSSDREKAVTRNQPQHF	TRBV13	TRBJ1-5
TGCGCCAGCAGCTTGGCAGCACCGACAGGGCTAATTGACGACGAGCAGTACTTC	CASSLAAPTGLIDDEQYF	TRBV5-1	TRBJ2-7
TGTGCCAGCACGGGGGACGGGGCCTACGAGCAGTACTTC	CASTGDGAYEQYF	TRBV7-2	TRBJ2-7
TGCAGTGCTAGCCTGGACAGTGACACTGAAGCTTTCTTT	CSASLDSDTEAFF	TRBV20-1	TRBJ1-1
TGTGCCAGCAGCAAAGGACAGGGAATGAGCTATGGCTACACCTTC	CASSKGQGMSYGYTF	TRBV5-6	TRBJ1-2
TGTGCCAGCAGCTATTTCAAAAGTTTAATAGAGTACAATGAGCAGTTCTTC	CASSYFKSLIEYNEQFF	TRBV7-3	TRBJ2-1
TGTGCCAGCAGCTATCACGGGGATAATGAGCAGTTCTTC	CASSYHGDNEQFF	TRBV5-4	TRBJ2-1
TGTGCCAGCAGCTCCATCAGGGGGCCCTATGGCTACACCTTC	CASSSIRGPYGYTF	TRBV9	TRBJ1-2
TGTGCCAGCAGTACTAGGGGAAGCTCCTACGAGCAGTACTTC	CASSTRGSSYEQYF	TRBV12-3	TRBJ2-7
TGCGCCAGCAGCTGGGACGTGTGGGATACGCAGTATTTT	CASSWDVWDTQYF	TRBV5-1	TRBJ2-3
TGTGCCAGCAGTTTAAAAGGACGTAACACCGGGGAGCTGTTTTTT	CASSLKGRNTGELFF	TRBV27	TRBJ2-2
TGTGCCAGCAGTAGGATAGGACAGGGAGTGAATCAGCCCCAGCATTTT	CASSRIGQGVNQPQHF	TRBV27	TRBJ1-5
TGTGCCCGATTGACTTTTACTTTTAGCACAGATACGCAGTATTTT	CARLTFTFSTDTQYF	TRBV30	TRBJ2-3
TGTGCCAGGGGGGGCCCCGAGACCCAGTACTTC	CARGGPETQYF	TRBV27	TRBJ2-5
TGCGCCAGCAATAGCTACAATGAGCAGTTCTTC	CASNSYNEQFF	TRBV5-1	TRBJ2-1
TGTGCCAGCAGTTACCTTGCAGGCTCTGGAAACACCATATATTTT	CASSYLAGSGNTIYF	TRBV6-5	TRBJ1-3
TGCAGTGCTAGAGAGACTAGCGGGAAGCGACTGACCACAGATACGCAGTATTTT	CSARETSGKRLTTDTQYF	TRBV20-1	TRBJ2-3
TGCGCCAGCCGCGGACAGGACTACGAGCAGTACTTC	CASRGQDYEQYF	TRBV10-1	TRBJ2-7
TGTGCCAGCAGGGGGGGCCCCCATACCTTCGATACGCAGTATTTT	CASRGGPHTFDTQYF	TRBV27	TRBJ2-3
TGTGCCACACAAAATAGGCCCTATTCCTACGAGCAGTACTTC	CATQNRPYSYEQYF	TRBV6-1	TRBJ2-7
TGCAGTGCTAGAATAGACAGGGTGGCTCAGCCCCAGCATTTT	CSARIDRVAQPQHF	TRBV20-1	TRBJ1-5
TGTGCCAGCAGGGGGTCGATCAGCTACGAGCAGTACTTC	CASRGSISYEQYF	TRBV6-1	TRBJ2-7
TGCAGTGCTCGAAGGGGAGGTAGCAATCAGCCCCAGCATTTT	CSARRGGSNQPQHF	TRBV20-1	TRBJ1-5
TGTGCCAGCAGCCTACAGGTATACGAAGCTTTCTTT	CASSLQVYEAFF	TRBV14	TRBJ1-1
TGTGCCAGCAAGAGTTGGGACTCGGACTTCCTCTCTGGAAACACCATATATTTT	CASKSWDSDFLSGNTIYF	TRBV9	TRBJ1-3
TGCGCCAGCAAGCTAGCGGGGCGTAGCACAGATACGCAGTATTTT	CASKLAGRSTDTQYF	TRBV4-1	TRBJ2-3
TGCGCCAGCAGTGAGTCGTTGGAGGGCCCCGGGGACAGGATGAACACTGAAGCTTTCTTT	CASSESLEGPGDRMNTEAFF	TRBV10-1	TRBJ1-1
TGTGCCACCAGTGACCCAAAGTGCAATGAGCAGTTCTTC	CATSDPKCNEQFF	TRBV24-1	TRBJ2-1
TGTGCCAGCAGTAGCGGATTAGTCGGACCACATAGCAATCAGCCCCAGCATTTT	CASSSGLVGPHSNQPQHF	TRBV6-4	TRBJ1-5
TGTGCCAGCAGCCAACCCCGGAGTCAGGGCGTCCTGAACTATGGCTACACCTTC	CASSQPRSQGVLNYGYTF	TRBV4-2	TRBJ1-2
TGTGCCAGCAGTTACCGGGCCTCTGGAACTCACTGCTTAGAGACCCAGTACTTC	CASSYRASGTHCLETQYF	TRBV6-2	TRBJ2-5
TGCAGCGACAGTCGACAGGGGTGGGCCAAAAACATTCAGTACTTC	CSDSRQGWAKNIQYF	TRBV29-1	TRBJ2-4
TGTGCCAGCTCACCCCTCCGGGACAGTAGCAATCAGCCCCAGCATTTT	CASSPLRDSSNQPQHF	TRBV18	TRBJ1-5
TGTGCCAGCAGCCTCCGGGGGGGCAACGGCTCCTACAATGAGCAGTTCTTC	CASSLRGGNGSYNEQFF	TRBV3-1	TRBJ2-1
TGCAGTGCTAGAGAGTCAGCGGGTACCGGGGAGCTGTTTTTT	CSARESAGTGELFF	TRBV20-1	TRBJ2-2
TGTGCCAGCAGCAAACGCGTCCTTTCCTGGGATCAGCCCCAGCATTTT	CASSKRVLSWDQPQHF	TRBV6-5	TRBJ1-5
TGCGCCAGCAGCCCGAATTTAGCGGGAGCAGATACGCAGTATTTT	CASSPNLAGADTQYF	TRBV4-3	TRBJ2-3
TGTGCCAGCAGTGTTTCAGGACCAAGAGGACAATCCTACGAGCAGTACTTC	CASSVSGPRGQSYEQYF	TRBV28	TRBJ2-7
TGTGCTAGCGGGATTGGGGATACGCAGTATTTT	CASGIGDTQYF	TRBV28	TRBJ2-3
TGCGCCAGCAGCTTTCCCCCCACTGATGGGAAGGGGAGTCTTGAGGGCTACGAGCAGTACTTC	CASSFPPTDGKGSLEGYEQYF	TRBV5-1	TRBJ2-7
TGTGCCACCAGTGATTGTACGAGGGCTCAAGAGACCCAGTACTTC	CATSDCTRAQETQYF	TRBV24-1	TRBJ2-5
TGCAGTGCTTACAGGGCAGGAAGCGGGTACAATCAGCCCCAGCATTTT	CSAYRAGSGYNQPQHF	TRBV20-1	TRBJ1-5
TGCGCCAGCAGTGCTTGTGATACGCAGTATTTT	CASSACDTQYF	TRBV4-1	TRBJ2-3
TGTGCCACCAGTGATTCCCTATCGGGACAGGGTAAAAGCTCTGGAAACACCATATATTTT	CATSDSLSGQGKSSGNTIYF	TRBV24-1	TRBJ1-3
TGTGCCTGGACTTCCGTCGGTGATTGGCACAATGAGCAGTTCTTC	CAWTSVGDWHNEQFF	TRBV30	TRBJ2-1
TGTGCCAGCAGCACTGGACTAGCGACCCAAGGCGAGCAGTTCTTC	CASSTGLATQGEQFF	TRBV13	TRBJ2-1
TGTGCCAGTGATAGATTGGACAGGCCGGAAAAACTGTTTTTT	CASDRLDRPEKLFF	TRBV27	TRBJ1-4
TGTGCCAGCAGCCAAGGGGGGGAGGGGACGTATAGCACAGATACGCAGTATTTT	CASSQGGEGTYSTDTQYF	TRBV3-1	TRBJ2-3
TGTGCCAGCAGCTTAGGTCCCGGGTCGAGTTCAGCCTACGAGCAGTACTTC	CASSLGPGSSSAYEQYF	TRBV11-3	TRBJ2-7
TGTGCCAGCATCTGGACAGCTGGCTACACCTTC	CASIWTAGYTF	TRBV6-4	TRBJ1-2
TGTGCCAGCAGTGGCTTCAAGGGGGACGCGGCGGCGTACAATGAGCAGTTCTTC	CASSGFKGDAAAYNEQFF	TRBV12-3	TRBJ2-1
TGTGCCAGCAGTTATCTTGAGGGGGGTCCCGAAGCTTTCTTT	CASSYLEGGPEAFF	TRBV6-6	TRBJ1-1
TGCGCCAGCAGCTTGCATATGCCGGTACAGGGCGTGTCACCCCTCCACTTT	CASSLHMPVQGVSPLHF	TRBV5-1	TRBJ1-6
TGCGCCAGCAGCTTGGGGGGCCGGGGGGGAGGGTCCTACGAGCAGTACTTC	CASSLGGRGGGSYEQYF	TRBV5-1	TRBJ2-7
TGTGCCAGCAGGGTCCGACAGGGCGAAAAACTGTTTTTT	CASRVRQGEKLFF	TRBV27	TRBJ1-4
TGTGCCAGCAGTTACTCCGGGCAGAACACCGGGGAGCTGTTTTTT	CASSYSGQNTGELFF	TRBV6-3	TRBJ2-2
TGTGCCATGGGGGCCGGGGGCGCTTTCTTT	CAMGAGGAFF	TRBV10-3	TRBJ1-1
TGTGCCAGCAGCTTAGGAGTCAGGGGGCGAAGTAGAACTGAAGCTTTCTTT	CASSLGVRGRSRTEAFF	TRBV7-3	TRBJ1-1
TGTGCTAGTCTACGGCCTTGGAACACTGAAGCTTTCTTT	CASLRPWNTEAFF	TRBV12-5	TRBJ1-1
TGTGCCAGCAGCCTGGGGGACGGAGTTTCCTCCTACGAGCAGTACTTC	CASSLGDGVSSYEQYF	TRBV14	TRBJ2-7
TGTGCCAGCAGCCGGGTAATGGACAGGGGAATCTGCAATCAGCCCCAGCATTTT	CASSRVMDRGICNQPQHF	TRBV3-1	TRBJ1-5
TGCGCCAGCAGTGACGCCTGGACCGGAAGCTCCTACGAGCAGTACTTC	CASSDAWTGSSYEQYF	TRBV10-1	TRBJ2-7
TGTGCCAGCAGTGACCTTTCCGGGACAGGGGGAAACACCATATATTTT	CASSDLSGTGGNTIYF	TRBV6-1	TRBJ1-3
TGTGCTAGTGCCCACCGGGACAGGGGAAGGAGAACAGATACGCAGTATTTT	CASAHRDRGRRTDTQYF	TRBV12-5	TRBJ2-3
TGCAGCGTTGCGAAAGAATTAGACACCCCAGGAAACACCATATATTTT	CSVAKELDTPGNTIYF	TRBV29-1	TRBJ1-3
TGTGCCACCAGTGGGTGGGGCCCCTATAGCAATCAGCCCCAGCATTTT	CATSGWGPYSNQPQHF	TRBV24-1	TRBJ1-5
TGTGCCAAGCCCGGACAGACACTTAATGGCTACACCTTC	CAKPGQTLNGYTF	TRBV7-9	TRBJ1-2
TGTGCCAGCACGCCAACTAGCGGGCCCTTTCTCGAGCAGTACTTC	CASTPTSGPFLEQYF	TRBV11-3	TRBJ2-7
TGTGCCAGCAGTTTCCTTAGGATGGACAATGAGCAGTTCTTC	CASSFLRMDNEQFF	TRBV28	TRBJ2-1
TGTGCCAGTAGTCTAGCGGGCAGCGATTCCACCGGGGAGCTGTTTTTT	CASSLAGSDSTGELFF	TRBV19	TRBJ2-2
TGCAAAGTGGGGGCCCATGCCTACGAGCAGTACTTC	CKVGAHAYEQYF	TRBV20-1	TRBJ2-7
TGTGCCAGCAGCTTTTTGACAGGGGGCGGGAATGAGCAGTTCTTC	CASSFLTGGGNEQFF	TRBV5-6	TRBJ2-1
TGTGCCAGCAGCAGGGGTCCCAGCACTGAAGCTTTCTTT	CASSRGPSTEAFF	TRBV5-4	TRBJ1-1
TGTGCCAGCAGTGACCCCACAGGGGACACTGAAGCTTTCTTT	CASSDPTGDTEAFF	TRBV6-4	TRBJ1-1
TGTGCCAGCAGGACCGGGGGCTGTAATGAAAAACTGTTTTTT	CASRTGGCNEKLFF	TRBV25-1	TRBJ1-4
TGTGCCAGCAGCTTAAAAGCCGGGACAGAAGGACCTGGCTACACCTTC	CASSLKAGTEGPGYTF	TRBV7-2	TRBJ1-2
TGTGCCTGGACTGATAGCGGCCCTCTAGCCACCTACAATGAGCAGTTCTTC	CAWTDSGPLATYNEQFF	TRBV30	TRBJ2-1
TGTGCCAGCAGCGAAAAGGCAACGGGCTACACCTTC	CASSEKATGYTF	TRBV16	TRBJ1-2
TGCAGTGCTAGATTCCTCGGACAGGGACATTATGATACGCAGTATTTT	CSARFLGQGHYDTQYF	TRBV20-1	TRBJ2-3
TGCAGCGTTGAAATGGGGATTCGCAATAGCAATCAGCCCCAGCATTTT	CSVEMGIRNSNQPQHF	TRBV29-1	TRBJ1-5
TGTGCCAGCAGCAACAGGGGTGGCGCTGAGCAGTTCTTC	CASSNRGGAEQFF	TRBV11-3	TRBJ2-1
TGTGCCAGCAGTGACTCGGACCTCCATGAAGCTTTCTTT	CASSDSDLHEAFF	TRBV6-4	TRBJ1-1
TGTGCCAGCAGCGGAGGAACCCGATGGGAGACCCAGTACTTC	CASSGGTRWETQYF	TRBV13	TRBJ2-5
TGTGCCAGCAGCCACCAGGGGCGCTCCTACGAGCAGTACTTC	CASSHQGRSYEQYF	TRBV14	TRBJ2-7
TGCAGCGCCAAGGGGGGGCCGGAGGATTCGCAGTATTTT	CSAKGGPEDSQYF	TRBV29-1	TRBJ2-3
TGCGCCAGCAGCCCTCTGCCCCGCGGGGGGGGGGACAATGAGCAGTTCTTC	CASSPLPRGGGDNEQFF	TRBV4-3	TRBJ2-1
TGCGCCAGCAGCCGAGGGAAGGAGGGCAGCAAGAACATTCAGTACTTC	CASSRGKEGSKNIQYF	TRBV4-1	TRBJ2-4
TGTGCCACCAGCAGAGATCCCGGGACTAGCGGGGACACCGGGGAGCTGTTTTTT	CATSRDPGTSGDTGELFF	TRBV15	TRBJ2-2
TGTGCCAGCAGCCAAGCGCAGGGCGGGAGAGGGTCAAACTACGAGCAGTACTTC	CASSQAQGGRGSNYEQYF	TRBV14	TRBJ2-7
TGTGCCAGCAGAAATTGGGGGCATAGCAATCAGCCCCAGCATTTT	CASRNWGHSNQPQHF	TRBV6-5	TRBJ1-5
TGTGCCAGCTGTTCAGACAGGTTTTCCTATAATTCACCCCTCCACTTT	CASCSDRFSYNSPLHF	TRBV7-9	TRBJ1-6
TGTGCCAGCAGTGATGAGGGGGGCCTGAAGGACTCCTACGAGCAGTACTTC	CASSDEGGLKDSYEQYF	TRBV6-4	TRBJ2-7
TGTGCCAGCAGTTGCGGTCTAGCGGGGGGGAGGGAGCAGTACTTC	CASSCGLAGGREQYF	TRBV6-3	TRBJ2-7
TGTGCCAGCAGCCCCCGAGGACCCAGGTTTTACACTGAAGCTTTCTTT	CASSPRGPRFYTEAFF	TRBV7-6	TRBJ1-1
TGTGCCAGCAGCTTCCGGCTTACTAGCGGGGGGGCCCACTACGAGCAGTACTTC	CASSFRLTSGGAHYEQYF	TRBV7-9	TRBJ2-7
TGTGCCTTTGCGGGACAGGACTTCGGGATGAATTCACCCCTCCACTTT	CAFAGQDFGMNSPLHF	TRBV5-6	TRBJ1-6
TGTGCCACCCCACTGCCCCACACTGAAGCTTTCTTT	CATPLPHTEAFF	TRBV24-1	TRBJ1-1
TGCGCCAGCAACCCGGTACAGGGGGCACAAGAGACCCAGTACTTC	CASNPVQGAQETQYF	TRBV10-1	TRBJ2-5
TGTGCCAGGGGAACCAGGGGACAGCCCCAGCATTTT	CARGTRGQPQHF	TRBV27	TRBJ1-5
TGCAGCGTTTCTGAGGTGGGGGAGGCAGATACGCAGTATTTT	CSVSEVGEADTQYF	TRBV29-1	TRBJ2-3
TGTGCCAGCTCACCACAGGGCGGGAGGGGGGGATACAATGAGCAGTTCTTC	CASSPQGGRGGYNEQFF	TRBV18	TRBJ2-1
TGTGCCAGCAGCTTAGCCCAGGGGGGCGTCAAAAACATTCAGTACTTC	CASSLAQGGVKNIQYF	TRBV7-2	TRBJ2-4
TGTGCCAGCAGCTTGGGAACGGACAGGGCACGCAATCAGCCCCAGCATTTT	CASSLGTDRARNQPQHF	TRBV5-6	TRBJ1-5
TGTGCCAGCAAAACTTCGTGGGACAGGGGTTGGGACAATCAGCCCCAGCATTTT	CASKTSWDRGWDNQPQHF	TRBV6-3	TRBJ1-5
TGTGCCATCATCCTAGCCCCACGCCCGCAGGGGAGCTCCTACAATGAGCAGTTCTTC	CAIILAPRPQGSSYNEQFF	TRBV10-3	TRBJ2-1
TGCAGTGCACGGGAGGAGCACGAGCAGTACTTC	CSAREEHEQYF	TRBV20-1	TRBJ2-7
TGTGCCAGTCGGGACAGGGGTTTCTACGAGCAGTACTTC	CASRDRGFYEQYF	TRBV5-6	TRBJ2-7
TGTGCCAGCACCCCTGGACTAGTCTCACAGGTTTACAATGAGCAGTTCTTC	CASTPGLVSQVYNEQFF	TRBV7-6	TRBJ2-1
TGTGCCAGCAGCCTCCTGGGACAGGGAGGGCAAGAGACCCAGTACTTC	CASSLLGQGGQETQYF	TRBV13	TRBJ2-5
TGTGCCAGCAGGGGGCCGCTTGCCAAAAACATTCAGTACTTC	CASRGPLAKNIQYF	TRBV12-4	TRBJ2-4
TGTGCCAGCACAGGTCCAGTATTTTTAGAGACCCAGTACTTC	CASTGPVFLETQYF	TRBV7-3	TRBJ2-5
TGTGCCAGCAGCCACAGAGGACAGGGCGGGAGCTCCTACGAGCAGTACTTC	CASSHRGQGGSSYEQYF	TRBV9	TRBJ2-7
TGTGCCAGCAGCAGGGGGGGGGGGACCGGGGAGCTGTTTTTT	CASSRGGGTGELFF	TRBV9	TRBJ2-2
TGCGCCAGCAGCCATAGGGGGAGGGGGAACTACGAGCAGTACTTC	CASSHRGRGNYEQYF	TRBV4-1	TRBJ2-7
TGTGCCAGCAGCCCGGATCCCGAGGGAGGAGACAATGAGCAGTTCTTC	CASSPDPEGGDNEQFF	TRBV13	TRBJ2-1
TGTGCCAGCAGTTTATCGGGAGGGCCCGCTGGGGCCAACGTCCTGACTTTC	CASSLSGGPAGANVLTF	TRBV27	TRBJ2-6
TGTGCCGGGACAGAATATAGCAATCAGCCCCAGCATTTT	CAGTEYSNQPQHF	TRBV11-3	TRBJ1-5
TGTGCCAGCACTCCCGAGCGGGGGGACTGCTCCTACGAGCAGTACTTC	CASTPERGDCSYEQYF	TRBV7-2	TRBJ2-7
TGCGCCAGCAGGGAAGGCCGACAGCTGGATTATGGCTACACCTTC	CASREGRQLDYGYTF	TRBV5-1	TRBJ1-2
TGCAGTGCCCCGCGCAAGAGGTTCACAGGGGGAAGGTATGGCTACACCTTC	CSAPRKRFTGGRYGYTF	TRBV20-1	TRBJ1-2
TGTGCCAGCAGCTTAAGCAGGGATGAAAAACTGTTTTTT	CASSLSRDEKLFF	TRBV7-6	TRBJ1-4
TGTGCCAGCAGTTACTCGCCAGACGCCCACACTGAAGCTTTCTTT	CASSYSPDAHTEAFF	TRBV6-5	TRBJ1-1
TGTGCTAGCAGCTTATACCGGGGAAGCTCCTACAATGAGCAGTTCTTC	CASSLYRGSSYNEQFF	TRBV7-7	TRBJ2-1
TGTGCCAGCAGCGGAAAGACAGGGGTTGAAGCTTTCTTT	CASSGKTGVEAFF	TRBV5-6	TRBJ1-1
TGTGCCAGCAGTTACCAAATACGCAGGCAAGGGTACTATGGCTACACCTTC	CASSYQIRRQGYYGYTF	TRBV6-5	TRBJ1-2
TGTGCCAGCAGCTTTAATGGGACAGGGTCCACCTACGAGCAGTACTTC	CASSFNGTGSTYEQYF	TRBV5-4	TRBJ2-7
TGTGCCATGTGGGGTTACAATGAGCAGTTCTTC	CAMWGYNEQFF	TRBV6-1	TRBJ2-1
TGCAGCGTTGAAGGGCAGGCGGCCCGGAACTATGGCTACACCTTC	CSVEGQAARNYGYTF	TRBV29-1	TRBJ1-2
TGTGCCAGTAGTATAGATGGGGGGAGCACTATGGCTGAAGCTTTCTTT	CASSIDGGSTMAEAFF	TRBV19	TRBJ1-1
TGTGCCAGCAGTGCGAGTCGGGTAGAAGGGGTGGGGAACTATGGCTACACCTTC	CASSASRVEGVGNYGYTF	TRBV25-1	TRBJ1-2
TGTGCCACCAGCCCAGATGGAGGGGGAGCTTTCTTT	CATSPDGGGAFF	TRBV24-1	TRBJ1-1
TGTGCCAGCAGCGGCCGCCGACGGGTGAACACTGAAGCTTTCTTT	CASSGRRRVNTEAFF	TRBV28	TRBJ1-1
TGTGCCAGCAGCGTAGTCCGACAGGGCTCTGGGGCCAACGTCCTGACTTTC	CASSVVRQGSGANVLTF	TRBV3-1	TRBJ2-6
TGTGCCAGCAGCAACCGGGGGGGGAGGTACAATGAGCAGTTCTTC	CASSNRGGRYNEQFF	TRBV7-9	TRBJ2-1
TGTGCCAGCAGTGTAGGGGCAGCGGGACTCGAGCCCCAGCATTTT	CASSVGAAGLEPQHF	TRBV6-4	TRBJ1-5
TGTGCCAGCAGTGATAGCGGGAGAGGAGCTCACAATGAGCAGTTCTTC	CASSDSGRGAHNEQFF	TRBV6-4	TRBJ2-1
TGCGCCAGCAGCCGCCCAGGGAAGGAAGGCTACACCTTC	CASSRPGKEGYTF	TRBV4-1	TRBJ1-2
TGTGCCATCAGTGAGGTACACAGGACCACTGAAGCTTTCTTT	CAISEVHRTTEAFF	TRBV10-3	TRBJ1-1
TGTGCCAGCAGCCCTACGGGCGGGTGTAAGGGGAAAAACACCGGGGAGCTGTTTTTT	CASSPTGGCKGKNTGELFF	TRBV3-1	TRBJ2-2
TGTGCCAGCAAAAGATCGCAGGGGGCCCTCGACTACGAGCAGTACTTC	CASKRSQGALDYEQYF	TRBV27	TRBJ2-7
TGCGCCAGCAGCTGTGCCGGGACTTCGCGCCAAGAGACCCAGTACTTC	CASSCAGTSRQETQYF	TRBV5-1	TRBJ2-5
TGCGCCAGCAGCTTCCCAAAGGGCCCCAATGAGCAGTTCTTC	CASSFPKGPNEQFF	TRBV5-1	TRBJ2-1
TGTGCCAGCAGTTTGGATGGGGGGCTGTACAATGAGCAGTTCTTC	CASSLDGGLYNEQFF	TRBV27	TRBJ2-1
TGTGCCAGCAGTTCCAGGAGTACTGGGGCCAACGTCCTGACTTTC	CASSSRSTGANVLTF	TRBV6-3	TRBJ2-6
TGCAGCGTTGCAGGGGCTGGGAAAGAGACCCAGTACTTC	CSVAGAGKETQYF	TRBV29-1	TRBJ2-5
TGCGCCAGCAGCCACCCCGGGACAGGGGCCTGGAGGCAGTACTTC	CASSHPGTGAWRQYF	TRBV4-1	TRBJ2-7
TGCAGTGCTCGGACTGGGGGGGACTCGCAGTACTTC	CSARTGGDSQYF	TRBV20-1	TRBJ2-7
TGCAGTGCACCCCTGGGGACCCAAGAGACCCAGTACTTC	CSAPLGTQETQYF	TRBV20-1	TRBJ2-5
TGTGCCAGCAGCGAGACTAACACTGAAGCTTTCTTT	CASSETNTEAFF	TRBV5-6	TRBJ1-1
TGTGCCAGCAGCTGGGGGGGGGACGATACGCAGTATTTT	CASSWGGDDTQYF	TRBV7-4	TRBJ2-3
TGTGCCAGCAGCTTGGAGGTTCAGCCCCAGCATTTT	CASSLEVQPQHF	TRBV5-6	TRBJ1-5
TGTGCCAGCAGCGTCCCCGAGGGGGCCTCTGGGGCCAACGTCCTGACTTTC	CASSVPEGASGANVLTF	TRBV9	TRBJ2-6
TGTGCCAGCAGGGCTACTAGCACAGATACGCAGTATTTT	CASRATSTDTQYF	TRBV6-5	TRBJ2-3
TGTGCCCGGGCCCCGACCCACAGGGGGGGCACTGAAGCTTTCTTT	CARAPTHRGGTEAFF	TRBV10-3	TRBJ1-1
TGTGCCAGCAGCCCGCGGCCCCCTCGGGATGAAGAGACCCAGTACTTC	CASSPRPPRDEETQYF	TRBV7-2	TRBJ2-5
TGTGCCAGCAGCGCCGAGTCGTGGAGCTCCTACAATGAGCAGTTCTTC	CASSAESWSSYNEQFF	TRBV9	TRBJ2-1
TGTGCCAGCAGTGAGGAGGACAGGTCCCAAGAGACCCAGTACTTC	CASSEEDRSQETQYF	TRBV6-1	TRBJ2-5
TGTGCCAGCAGGGGGGTCACATCGGATGAGCAGTTCTTC	CASRGVTSDEQFF	TRBV6-4	TRBJ2-1
TGTGCCAGCAGCTTACTACAGGGTAGCAATCAGCCCCAGCATTTT	CASSLLQGSNQPQHF	TRBV7-7	TRBJ1-5
TGTGCCAGCAGCGTACCCTGGACTAGTGAAGCTTTCTTT	CASSVPWTSEAFF	TRBV7-3	TRBJ1-1
TGCGCCAGCAGTGTCCCGAAACCGGGACTTAACACCGGGGAGCTGTTTTTT	CASSVPKPGLNTGELFF	TRBV10-1	TRBJ2-2
TGTGCCAGCAGTCCTCTCAACACTGAAGCTTTCTTT	CASSPLNTEAFF	TRBV27	TRBJ1-1
TGTGCCAGCAGTGACTCTCACAGGGGGCGAGCCCCTGTCAGGGAGGGCTACACCTTC	CASSDSHRGRAPVREGYTF	TRBV6-4	TRBJ1-2
TGTGCCAGCAGCAACTACAGGGGGCTTTGTATGAACACTGAAGCTTTCTTT	CASSNYRGLCMNTEAFF	TRBV7-9	TRBJ1-1
TGCGCCAGCAGCCAAGATTTTAAACTGCATAATGAAAAACTGTTTTTT	CASSQDFKLHNEKLFF	TRBV4-1	TRBJ1-4
TGTGCCAGCAGCTTAGCCTGGACCCACAGGGGCCGTCCGAACACCGGGGAGCTGTTTTTT	CASSLAWTHRGRPNTGELFF	TRBV7-6	TRBJ2-2
TGTGCCAGCAGGACACGGGATGGGGCGAAGGTGAACACTGAAGCTTTCTTT	CASRTRDGAKVNTEAFF	TRBV27	TRBJ1-1
TGTGCCTGGAGACAGGCGAAGCAGTACTTC	CAWRQAKQYF	TRBV30	TRBJ2-7
TGTGCCAGCAGCTTAGATGATAGTCCCGGGCCCTTCTTC	CASSLDDSPGPFF	TRBV11-3	TRBJ1-2
TGTGCCATCCGGTTCGGGCCGGCTGAAGCTTTCTTT	CAIRFGPAEAFF	TRBV6-4	TRBJ1-1
TGTGCCAGCAGCATAACCTCAGGAATCCCCGGGGAGCTGTTTTTT	CASSITSGIPGELFF	TRBV7-3	TRBJ2-2
TGCAGTGCTAAAGGGGGGGCCCGAGAGCAGTACTTC	CSAKGGAREQYF	TRBV20-1	TRBJ2-7
TGTGCCAGCAGCCAAGCCACAGGGGGCCCCTACAATGAGCAGTTCTTC	CASSQATGGPYNEQFF	TRBV3-1	TRBJ2-1
TGTGCCTGTGCTAACAGGGATTATGAGCAGTTCTTC	CACANRDYEQFF	TRBV30	TRBJ2-1
TGTGCCGGTCAGGGCCGTTCACGAGGTGGCTACACCTTC	CAGQGRSRGGYTF	TRBV19	TRBJ1-2
TGCGCCAGCAGATTTTGGACAGGTGCAACTAATGAAAAACTGTTTTTT	CASRFWTGATNEKLFF	TRBV4-1	TRBJ1-4
TGTGCCAGCAGTTTAGGACAGGGGTACGTGCTAAGGTCCTATAATTCACCCCTCCACTTT	CASSLGQGYVLRSYNSPLHF	TRBV12-3	TRBJ1-6
TGTGCCATCAAATCGCCGAGGCCCTACGAGCAGTACTTC	CAIKSPRPYEQYF	TRBV10-3	TRBJ2-7
TGTGCCAGCAGCAAAGGGGGATCATTAAATCAGCCCCAGCATTTT	CASSKGGSLNQPQHF	TRBV13	TRBJ1-5
TGTGCCACCAAGATTCATGGACAGGGTAGCGCTCTGGACGAGCAGTACTTC	CATKIHGQGSALDEQYF	TRBV24-1	TRBJ2-7
TGTGCCAGCAGATACAGGGAAGATGAGCAGTTCTTC	CASRYREDEQFF	TRBV6-5	TRBJ2-1
TGTGCCAGCAGCTCCCTAAGGAGTAGGGCACATGGCTACACCTTC	CASSSLRSRAHGYTF	TRBV7-2	TRBJ1-2
TGTGCCAGCAGACCTACTAGCGGGAGCGTGTTAAATGAGCAGTTCTTC	CASRPTSGSVLNEQFF	TRBV9	TRBJ2-1
TGTGCCAGCAGCGGGTGGGCGATACTGAACACCGGGGAGCTGTTTTTT	CASSGWAILNTGELFF	TRBV13	TRBJ2-2
TGCAGTGCTAGTAGCGGGCCTCATGCCTACGAGCAGTACTTC	CSASSGPHAYEQYF	TRBV20-1	TRBJ2-7
TGTGCCAGCAGCTCCCGTTATGGGGGAACTAACTATGGCTACACCTTC	CASSSRYGGTNYGYTF	TRBV11-2	TRBJ1-2
TGTGCCAGCAGCCAAGATTCCCGTGTGGGCATTTCCAAACAGCCCCAGCATTTT	CASSQDSRVGISKQPQHF	TRBV3-1	TRBJ1-5
TGTGCCACCGTATACGTGTGCAATCAGCCCCAGCATTTT	CATVYVCNQPQHF	TRBV24-1	TRBJ1-5
TGTGCCAGCGTCCAGTATAGCAATCAGCCCCAGCATTTT	CASVQYSNQPQHF	TRBV7-3	TRBJ1-5
TGTGCCAGCAGTTTCATCCTCGGGAGTACTTTGGAATATAATTCACCCCTCCACTTT	CASSFILGSTLEYNSPLHF	TRBV6-3	TRBJ1-6
TGCGCCAGCAGCTTATCGCGGGCCAAGCAGTTCTTC	CASSLSRAKQFF	TRBV5-1	TRBJ2-1
TGTGCCAGCAGTTACCCCCGGGTCGGGGGCGCCCGGGAGACCCAGTACTTC	CASSYPRVGGARETQYF	TRBV6-3	TRBJ2-5
TGTGCCAGCAGTCACAGGTCGGACACTGAAGCTTTCTTT	CASSHRSDTEAFF	TRBV27	TRBJ1-1
TGCAGTGCTAGATGGACGGGACAGGGGACTGAAGCTTTCTTT	CSARWTGQGTEAFF	TRBV20-1	TRBJ1-1
TGTGCCTGTAGCGACTTCCGAAACACTGAAGCTTTCTTT	CACSDFRNTEAFF	TRBV5-6	TRBJ1-1
TGTGCCAGGAGGGGCACAGATACGCAGTATTTT	CARRGTDTQYF	TRBV5-4	TRBJ2-3
TGTGCCAGCAGCTTAGCGTTTTTATCGGACCACAATCAGCCCCAGCATTTT	CASSLAFLSDHNQPQHF	TRBV7-9	TRBJ1-5
TGTGCCAGCAGTGGGACCGGACTCCACTCTGGGGCCAACGTCCTGACTTTC	CASSGTGLHSGANVLTF	TRBV6-4	TRBJ2-6
TGCAGCGGGACTAGCGAGGGCTACGAGCAGTACTTC	CSGTSEGYEQYF	TRBV29-1	TRBJ2-7
TGTGCCAGCAGTTACTCCAGTCAAACCTATGGCTACACCTTC	CASSYSSQTYGYTF	TRBV6-5	TRBJ1-2
TGTGCCAGCAGCTTAACGACAGATGGCTTGCCCCAGCATTTT	CASSLTTDGLPQHF	TRBV7-3	TRBJ1-5
TGTGCCTGGAATAAGTTAACTAGCGGGTCAGATACGCAGTATTTT	CAWNKLTSGSDTQYF	TRBV30	TRBJ2-3
TGTGCCAGCAGTTCCCGAAGGGCCGGGGAGCTGTTTTTT	CASSSRRAGELFF	TRBV6-4	TRBJ2-2
TGTGCCAGCAGCTGGAGGTCCGGGACAGATACTTCTGAAAAACTGTTTTTT	CASSWRSGTDTSEKLFF	TRBV7-4	TRBJ1-4
TGTGCCAGCAGCCTGCAAGAGAATCAGCCCCAGCATTTT	CASSLQENQPQHF	TRBV7-2	TRBJ1-5
TGTGCCAGCAGCCAACTACAGGGTAGGGTATTGAACACTGAAGCTTTCTTT	CASSQLQGRVLNTEAFF	TRBV14	TRBJ1-1
TGTGCCTGGAGCCTCGTACAACAGCCCCAGCATTTT	CAWSLVQQPQHF	TRBV30	TRBJ1-5
TGTGCCAGCAGCTTAGTACGGACAGGGGAAGAGACCCAGTACTTC	CASSLVRTGEETQYF	TRBV7-9	TRBJ2-5
TGTGCCAGCAGCCAAGTTGAGGGACTGTGGTACGAGCAGTACTTC	CASSQVEGLWYEQYF	TRBV14	TRBJ2-7
TGTGCCAGCAGGGGCGAACAGGGTACGGGGGAGCATACGGGCTACACCTTC	CASRGEQGTGEHTGYTF	TRBV6-3	TRBJ1-2
TGTGCCAGCAAAGGGGTTTTGAACACTGAAGCTTTCTTT	CASKGVLNTEAFF	TRBV6-4	TRBJ1-1
TGTGCCAGCAGCCCGCCCGGGACAGGGGCCCCTGAAGCTTTCTTT	CASSPPGTGAPEAFF	TRBV13	TRBJ1-1
TGTGCCAGCAGTTACTCGGACCGTGGGGGACCGGGACACGGGGACGAGCAGTACTTC	CASSYSDRGGPGHGDEQYF	TRBV6-6	TRBJ2-7
TGTGCCAGCAGGGGACAGGGGGCCTATGGCTACACCTTC	CASRGQGAYGYTF	TRBV2	TRBJ1-2
TGTGCCACCAGTGATTGGCGGCGGACTCAGCCCCAGCATTTT	CATSDWRRTQPQHF	TRBV24-1	TRBJ1-5
TGCTATTGTCCGGGAATATCGGAAAAACTGTTTTTT	CYCPGISEKLFF	TRBV5-1	TRBJ1-4
TGTGCCAGCAGTAGCTACCCCGTGACTAGCGGTCTACCGGCGAACACCGGGGAGCTGTTTTTT	CASSSYPVTSGLPANTGELFF	TRBV2	TRBJ2-2
TGTGCCAGCAGCACCCTCGGCCCCAGGGGCCGGGGGACAAAACTGTTTTTT	CASSTLGPRGRGTKLFF	TRBV7-4	TRBJ1-4
TGTGCCAGCAGTGTCCGGGAAGGCAGGGTCTACGAGCAGTACTTC	CASSVREGRVYEQYF	TRBV6-1	TRBJ2-7
TGCGCCAAACCTAGTTCATACGAGCAGTACTTC	CAKPSSYEQYF	TRBV5-1	TRBJ2-7
TGTGCTAGTGGTGCCAAATCCGGGACCTACACCTTC	CASGAKSGTYTF	TRBV12-5	TRBJ1-2
TGTGCCAGCTCCGGGGGGGCACACTATACAGATACGCAGTATTTT	CASSGGAHYTDTQYF	TRBV18	TRBJ2-3
TGTGCCATCAACCTCGTGCCCTACAATGAGCAGTTCTTC	CAINLVPYNEQFF	TRBV10-3	TRBJ2-1
TGTGCCAGCAGCCTGGGACTAGCGGAGCGGTCGAGGTTCGCCAAAAACATTCAGTACTTC	CASSLGLAERSRFAKNIQYF	TRBV9	TRBJ2-4
TGTGCTTCCCGACAGGGGGGGGCCAACGTCCTGACTTTC	CASRQGGANVLTF	TRBV25-1	TRBJ2-6
TGTGCCATCATACGCACCTTC	CAIIRTF	TRBV10-3	TRBJ1-2
TGTGCCAGCAGTTTGAGGGTCTCTGGAAACACCATATATTTT	CASSLRVSGNTIYF	TRBV27	TRBJ1-3
TGTGCCAGTAGTGACCCAATAGGGGGGTACTATGAGCAGTTCTTC	CASSDPIGGYYEQFF	TRBV19	TRBJ2-1
TGCAGTGCTAGAGAACCGGGGCACACTGAAGCTTTCTTT	CSAREPGHTEAFF	TRBV20-1	TRBJ1-1
TGTGCCAGCAGCCCTTGGCTGCGCAATCAGCCCCAGCATTTT	CASSPWLRNQPQHF	TRBV9	TRBJ1-5
TGTGCCAGCAGCACTAGACAGGCTCGCAATCAGCCCCAGCATTTT	CASSTRQARNQPQHF	TRBV13	TRBJ1-5
TGTGCCAGTAGTCCCAAGGGACAGGGGCCTCCTAGCACAGATACGCAGTATTTT	CASSPKGQGPPSTDTQYF	TRBV19	TRBJ2-3
TGTGCCAGCAGCTGGATGATAGGGACAGAAATTCAGGGCACAGATACGCAGTATTTT	CASSWMIGTEIQGTDTQYF	TRBV9	TRBJ2-3
TGTGCCAGCAGTAAATCCTCTTTCCAGTACTTC	CASSKSSFQYF	TRBV6-5	TRBJ2-5
TGTGCTAGTGGTCTTCTACCCGGACCTGAAGCTTTCTTT	CASGLLPGPEAFF	TRBV12-5	TRBJ1-1
TGTGCCAGACTTGAGGGCTACGAGCAGTACTTC	CARLEGYEQYF	TRBV2	TRBJ2-7
TGTGCCAGCAGCATCCTATTGTGGGAATTTGAGCAGTTCTTC	CASSILLWEFEQFF	TRBV7-3	TRBJ2-1
TGCGCCAGCGGGGTGAACGGCAATGAAAAACTGTTTTTT	CASGVNGNEKLFF	TRBV10-1	TRBJ1-4
TGTGCCAGCCGGGGGAAGCTGTTTTTT	CASRGKLFF	TRBV6-4	TRBJ1-4
TGCAGCGTTTTTGGGGGGCCCAATGAGCAGTTCTTC	CSVFGGPNEQFF	TRBV29-1	TRBJ2-1
TGTGCCAGCAGTGAAGATGGGGGCAGGGTCATGAACACTGAAGCTTTCTTT	CASSEDGGRVMNTEAFF	TRBV6-4	TRBJ1-1
TGCGCCAGCAGCTTGGCGACCCCGCCCCTCCCCGGGTATAATTCACCCCTCCACTTT	CASSLATPPLPGYNSPLHF	TRBV5-1	TRBJ1-6
TGTGCCACCGGGACAGGGGCGTACTATGGCTACACCTTC	CATGTGAYYGYTF	TRBV7-9	TRBJ1-2
TGTGCCAGCAGTTACCAGGCGTCCGGGACAGGGCAGGATCAGCCCCAGCATTTT	CASSYQASGTGQDQPQHF	TRBV6-5	TRBJ1-5
TGTGCCAGCAACAGCTCCACTGAAGCTTTCTTT	CASNSSTEAFF	TRBV3-1	TRBJ1-1
TGTGCCAGCTACGGCCCTGACGATACGCAGTATTTT	CASYGPDDTQYF	TRBV18	TRBJ2-3
TGTGCCAGCAGTTTTCGAGGCAATCAGCCCCAGCATTTT	CASSFRGNQPQHF	TRBV28	TRBJ1-5
TGTGCCACCAGTGTAAAACTAGTCGACGTATACGAGCAGTACTTC	CATSVKLVDVYEQYF	TRBV24-1	TRBJ2-7
TGTGCCAGACTACACTTACCCGTCGGCCCGGGGAGGGAGACGTTAATCGCGAACACCGGGGAGCTGTTTTTT	CARLHLPVGPGRETLIANTGELFF	TRBV6-2	TRBJ2-2
TGTGCCAGCAGCGGGGAGGGGAAACACTTC	CASSGEGKHF	TRBV7-3	TRBJ2-7
TGTGCCAGCAGTGAATCGGCCACCTACGAGCAGTACTTC	CASSESATYEQYF	TRBV6-1	TRBJ2-7
TGTGCCAGCAGTACCGGGACAACACCCACAGATACGCAGTATTTT	CASSTGTTPTDTQYF	TRBV27	TRBJ2-3
TGTGCCAGCAGCCGGGGACAGATGGGGATAAGTCGGATCGTCCTCTACGAGCAGTACTTC	CASSRGQMGISRIVLYEQYF	TRBV11-2	TRBJ2-7
TGTGCCAGCAGCCAAGAACTGAAGGGAGACATTCCCTACGAGCAGTACTTC	CASSQELKGDIPYEQYF	TRBV3-1	TRBJ2-7
TGCAGTGCTAACGGAGACAACACCGGGGAGCTGTTTTTT	CSANGDNTGELFF	TRBV20-1	TRBJ2-2
TGTGCCAGCAGCAGCACCCAGAAGGGCGCCCGGGCCGGGGAGCTGTTTTTT	CASSSTQKGARAGELFF	TRBV7-3	TRBJ2-2
TGCGCCAGCCGGCCAGGGCTCGATGACACTGAAGCTTTCTTT	CASRPGLDDTEAFF	TRBV10-1	TRBJ1-1
TGTGCCAGCAGCCAAGAGATCTCGGACAGGACGCGTGAGACCCAGTACTTC	CASSQEISDRTRETQYF	TRBV14	TRBJ2-5
TGTGCCAGCAGTTTTCTACGCGGACTAGCGGGTGGCTACAATGAGCAGTTCTTC	CASSFLRGLAGGYNEQFF	TRBV27	TRBJ2-1
TGCGCCAGCAGCTTTAGCGGCTACGAGCAGTACTTC	CASSFSGYEQYF	TRBV5-1	TRBJ2-7
TGTGCCAGCAGTTCGGAGGACAGGGTTAATCAGCCCCAGCATTTT	CASSSEDRVNQPQHF	TRBV12-3	TRBJ1-5
TGTGCCAGCACAAGGACACGAGCTTTCTTT	CASTRTRAFF	TRBV6-4	TRBJ1-1
TGTGCCAAAACTAGCGGGAGGCTGTTTTTT	CAKTSGRLFF	TRBV19	TRBJ2-2
TGTGCCAAATTCAAACAGGGAGCTTTCTTT	CAKFKQGAFF	TRBV6-2	TRBJ1-1
TGCGCCAGCAGCTTGATGTCCGGGACAGGGGAGGAAACCAGGAATGAGCAGTTCTTC	CASSLMSGTGEETRNEQFF	TRBV5-1	TRBJ2-1
TGTGCCAGCAAAGCGAGCATGACCTACGAGCAGTACTTC	CASKASMTYEQYF	TRBV28	TRBJ2-7
TGTGCCAGCGTTGACTCCGGGGAGCTGTTTTTT	CASVDSGELFF	TRBV11-2	TRBJ2-2
TGCAGTGCTAGCGACAGGGATCGGGGCCAAGAGACCCAGTACTTC	CSASDRDRGQETQYF	TRBV20-1	TRBJ2-5
TGTGCCAGCAGTTACGGGGCTTACCGGGGGCTGGGGCAAGAGACCCAGTACTTC	CASSYGAYRGLGQETQYF	TRBV6-6	TRBJ2-5
TGCACCCGTTTCAGTGAAGCTTTCTTT	CTRFSEAFF	TRBV20-1	TRBJ1-1
TGTGCCAGCAGCCGGTACAGTACTGAAGCTTTCTTT	CASSRYSTEAFF	TRBV9	TRBJ1-1
TGTGCCAGCAGCTCTATAACCTACGTTTTGAGCTCCTATAATTCACCCCTCCACTTT	CASSSITYVLSSYNSPLHF	TRBV5-6	TRBJ1-6
TGTGCCAGCAGCTTGACGGCCAACTCTGGGGCCAACGTCCTGACTTTC	CASSLTANSGANVLTF	TRBV13	TRBJ2-6
TGTGCCAGCAGCTTAGTAATTTGCGGGGGGGCCGGGGAGCTGTTTTTT	CASSLVICGGAGELFF	TRBV7-9	TRBJ2-2
TGTGCTAGCAGCTTACGGGGGCTCCTCGAGCAGTACTTC	CASSLRGLLEQYF	TRBV7-7	TRBJ2-7
TGTGCCAGCAGGGGGCAACTGGAAAAACTGTTTTTT	CASRGQLEKLFF	TRBV6-4	TRBJ1-4
TGTGCCAGCAGTTTGACGCCAAGCAATCAGCCCCAGCATTTT	CASSLTPSNQPQHF	TRBV27	TRBJ1-5
TGTGCCAGCAGCGGGGGGTGCAGCTCCTACAATGAGCAGTTCTTC	CASSGGCSSYNEQFF	TRBV11-3	TRBJ2-1
TGCAGCGTCTATACCTACAATGAGCAGTTCTTC	CSVYTYNEQFF	TRBV29-1	TRBJ2-1
TGTGCCTCGCGGGACCAGTACTTC	CASRDQYF	TRBV12-4	TRBJ2-5
TGCAGTGCTAGAGATGGTCGTAGCCTGGTCTACACCGGGGAGCTGTTTTTT	CSARDGRSLVYTGELFF	TRBV20-1	TRBJ2-2
TGTGCCAGCAGCTACCCAAAGGACAGGAATGGCTACACCTTC	CASSYPKDRNGYTF	TRBV7-3	TRBJ1-2
TGTGCCACCACCCCCAGTAACGGGACAGGGGAGGTACTTGCTTTCTTT	CATTPSNGTGEVLAFF	TRBV24-1	TRBJ1-1
TGTGCCAGCAGCCAAGATGGAAACCGGGGGGGAGAGACCCAGTACTTC	CASSQDGNRGGETQYF	TRBV14	TRBJ2-5
TGTGCTAGCAGCTGGGACAGGGCGTGGGAAGACACTGAAGCTTTCTTT	CASSWDRAWEDTEAFF	TRBV7-7	TRBJ1-1
TGTGCCAGCAGCTTGCCAGCGGAGGGGTACGGGGAGCTGTTTTTT	CASSLPAEGYGELFF	TRBV5-4	TRBJ2-2
TGCAGTGCCGAGAGGGTATTGAGCTCCTACAATGAGCAGTTCTTC	CSAERVLSSYNEQFF	TRBV20-1	TRBJ2-1
TGTGCCAGCACTTGTCCAAGCTACAATGAGCAGTTCTTC	CASTCPSYNEQFF	TRBV6-2	TRBJ2-1
TGTGCCAGCAGCTTAGATCCCAGCGACAGGGTCTACGAGCAGTACTTC	CASSLDPSDRVYEQYF	TRBV11-3	TRBJ2-7
TGCGCCAGCAGCGGACTAGCGAGGAATGAGCAGTTCTTC	CASSGLARNEQFF	TRBV5-1	TRBJ2-1
TGCAGTGCTAGCATAGACAGGGGGCGCCTTAATCAGCCCCAGCATTTT	CSASIDRGRLNQPQHF	TRBV20-1	TRBJ1-5
TGTGCCAGCAGCTTAGCTGGTAGGATGGACGAGCAGTACTTC	CASSLAGRMDEQYF	TRBV11-2	TRBJ2-7
TGTGCCAGCAGCTGGAAGGGGGGGAGAAATGAGCAGTTCTTC	CASSWKGGRNEQFF	TRBV5-6	TRBJ2-1
TGTGCCAGCAGTTTACGACAGCTCTGCAATCAGCCCCAGCATTTT	CASSLRQLCNQPQHF	TRBV28	TRBJ1-5
TGTGCCACCAATCCCCCGGCCAGGGTTGGTAGCTACGAGCAGTACTTC	CATNPPARVGSYEQYF	TRBV24-1	TRBJ2-7
TGTGCCAGCAATGCTAATGAAGAGACCCAGTACTTC	CASNANEETQYF	TRBV6-1	TRBJ2-5
TGCAGTGCTAGAGGGACCCAGGGCCGGACGGGCTACGAGCAGTACTTC	CSARGTQGRTGYEQYF	TRBV20-1	TRBJ2-7
TGTGCCAGCAGTGAAGGTTTCCTCGCGGGAGATCGTGAGGATACGCAGTATTTT	CASSEGFLAGDREDTQYF	TRBV6-1	TRBJ2-3
TGTGCCAGCAGTGTGAAGCTGGGCTCCTACGAGCAGTACTTC	CASSVKLGSYEQYF	TRBV6-1	TRBJ2-7
TGTGCCAGCACGCCGGGACAGGTCGCCACCGGGGAGCTGTTTTTT	CASTPGQVATGELFF	TRBV6-4	TRBJ2-2
TGTGCTAGTGGTGGGTCTAGCGGGTTTGAGACCCAGTACTTC	CASGGSSGFETQYF	TRBV12-5	TRBJ2-5
TGTGCCACCAGTGGTCGCGCAGGACTAGCGGTAAATGAGCAGTTCTTC	CATSGRAGLAVNEQFF	TRBV24-1	TRBJ2-1
TGTGCCAGTAGTATAGATCGGCCTCGGCTGAGGCCGCTAGTCTTGTATTTT	CASSIDRPRLRPLVLYF	TRBV19	TRBJ2-3
TGTGCCAGCAACCTGACAGGGAACACTGAAGCTTTCTTT	CASNLTGNTEAFF	TRBV2	TRBJ1-1
TGCAGCGTTGTCCGGCAAGTAGACCGGGTGTGCTATGGCTACACCTTC	CSVVRQVDRVCYGYTF	TRBV29-1	TRBJ1-2
TGCGCCAGCAGATCCCCCCCAGGGGAAAAGAACACCGGGGAGCTGTTTTTT	CASRSPPGEKNTGELFF	TRBV5-1	TRBJ2-2
TGTGCCAGCAGTCAGGGGTACTATGGCTACACCTTC	CASSQGYYGYTF	TRBV27	TRBJ1-2
TGTGCCAGCAGTGAGGCCCCTTTACTCCAGAGGTCCTACGAGCAGTACTTC	CASSEAPLLQRSYEQYF	TRBV6-4	TRBJ2-7
TGTGCCAGCAGACGTACTATTATGCAGTACTTC	CASRRTIMQYF	TRBV5-6	TRBJ2-7
TGCGCCAGCAGTGAACAGGGGGGGGGGTCTGGGGCCAACGTCCTGACTTTC	CASSEQGGGSGANVLTF	TRBV10-1	TRBJ2-6
TGTGCCAGCAGCTCACCCTTGGGGGGGGCCGCTAGCTCCTACAATGAGCAGTTCTTC	CASSSPLGGAASSYNEQFF	TRBV11-3	TRBJ2-1
TGTGCTAGCAGCTCGAGGACTAGCGGGTGGCGTAATGAGCAGTTCTTC	CASSSRTSGWRNEQFF	TRBV7-7	TRBJ2-1
TGCAGTGCTAGAGATCTGGAGGGGAACTACTACGAGCAGTACTTC	CSARDLEGNYYEQYF	TRBV20-1	TRBJ2-7
TGTGCCAGCAGCCAAGATTCCCGGCACAGGCGGGGGCTGGGCAATCAGCCCCAGCATTTT	CASSQDSRHRRGLGNQPQHF	TRBV3-1	TRBJ1-5
TGTGCCAGCAGCCAGGCATACTACGAGCAGTACTTC	CASSQAYYEQYF	TRBV11-3	TRBJ2-7
TGTGCCATCAGTACGACTAGCGGCCCAGATACGCAGTATTTT	CAISTTSGPDTQYF	TRBV10-3	TRBJ2-3
TGTGCCAGCATACGTCCGAGAGACACCGGGGAGCTGTTTTTT	CASIRPRDTGELFF	TRBV2	TRBJ2-2
TGTGCCAGCAGCTTACCGACAGGGATCTATGGCTACACCTTC	CASSLPTGIYGYTF	TRBV7-6	TRBJ1-2
TGTGCCAGCAGTGACCCAGGGTGGGATCAGCCCCAGCATTTT	CASSDPGWDQPQHF	TRBV6-4	TRBJ1-5
TGTGCCAGCTCTCACCGCTCCTATGGCTACACCTTC	CASSHRSYGYTF	TRBV19	TRBJ1-2
TGTGCCAGCAGCAGAGAGACAGGGGGCGTCTTTTACGAGCAGTACTTC	CASSRETGGVFYEQYF	TRBV13	TRBJ2-7
TGCAGCGTTGAAGAAGGGGGGGGTTCCCACAGCTCCTACGAGCAGTACTTC	CSVEEGGGSHSSYEQYF	TRBV29-1	TRBJ2-7
TGTGCCACTCATAGGGACGATAGCACAGATACGCAGTATTTT	CATHRDDSTDTQYF	TRBV9	TRBJ2-3
TGTGCCAGCAGCTTAGCCAGGAGGAATGAAGCTTTCTTT	CASSLARRNEAFF	TRBV7-9	TRBJ1-1
TGCGCCAGCAGCTTCCCCGCGGGGGGAGAGACCCAGTACTTC	CASSFPAGGETQYF	TRBV5-1	TRBJ2-5
TGTGCCAGCAGTGCAGGGATAGGCTACGAGCAGTACTTC	CASSAGIGYEQYF	TRBV27	TRBJ2-7
TGTGCTAGTGGTTTGGTAGGGGGGTCTGAGCAGTTCTTC	CASGLVGGSEQFF	TRBV12-5	TRBJ2-1
TGTGCCAGCAGCGCCCCACAGTCCTTCAATCAGCCCCAGCATTTT	CASSAPQSFNQPQHF	TRBV7-9	TRBJ1-5
TGTGCCAGCAGCCAAGACAGCTCGGGGGACGAGCAGTACTTC	CASSQDSSGDEQYF	TRBV3-1	TRBJ2-7
TGTGCCAGCAGCGTGCGCATGGGCGCTACTGAAGCTTTCTTT	CASSVRMGATEAFF	TRBV7-3	TRBJ1-1
TGCGCCAGCAGCTCAGAACGGGTCTATGGCTACACCTTC	CASSSERVYGYTF	TRBV5-1	TRBJ1-2
TGTGCCAGCAGCTTAGATTCCCGGAGGGGGCGCAGGGGGGGTTCACCCCTCCACTTT	CASSLDSRRGRRGGSPLHF	TRBV11-2	TRBJ1-6
TGCGCCAGCAGCCCACGGGGCCGCTCGGCCTCCTACGAGCAGTACTTC	CASSPRGRSASYEQYF	TRBV4-1	TRBJ2-7
TGTGCCAGCAGCTTAGATGCCTGGGCGTTCTACGAGCAGTACTTC	CASSLDAWAFYEQYF	TRBV11-2	TRBJ2-7
TGTGCCAATTGTTGGGCGGGGTCCTACGAGCAGTACTTC	CANCWAGSYEQYF	TRBV2	TRBJ2-7
TGTGCCTGGAGTTGGCGCGCCAAAAACATTCAGTACTTC	CAWSWRAKNIQYF	TRBV30	TRBJ2-4
TGTGCCAGCAGTCAGCAGGGGGAGACCCAGTACTTC	CASSQQGETQYF	TRBV6-5	TRBJ2-5
TGCAGCGTTGAGAGCGGGAGGGGGTACAATGAGCAGTTCTTC	CSVESGRGYNEQFF	TRBV29-1	TRBJ2-1
TGTGCCAGCAGGTCCTTAATCCGGGACAGGTGCAATCAGCCCCAGCATTTT	CASRSLIRDRCNQPQHF	TRBV28	TRBJ1-5
TGTGCCAGCAGCCCAGGATCCAGGGAAATTCAGCCCCAGCATTTT	CASSPGSREIQPQHF	TRBV7-9	TRBJ1-5
TGTGCCAGCAGCTTGACCATAGCTAGACTGTTTTTT	CASSLTIARLFF	TRBV5-4	TRBJ1-4
TGTGCCAGCAGCCGAGGGGCCGTAGACAATCAGCCCCAGCATTTT	CASSRGAVDNQPQHF	TRBV7-3	TRBJ1-5
TGTGCCAGCAGCTTAGAGACGGATAACACTGAAGCTTTCTTT	CASSLETDNTEAFF	TRBV7-6	TRBJ1-1
TGTGCCAGCAGCTGCCGGGCTCTAGCGGAGACCTCCTACGAGCAGTACTTC	CASSCRALAETSYEQYF	TRBV7-9	TRBJ2-7
TGTGCCACTGCCCGTCCGGGACTAGCGGGAAGCTCCTACGAGCAGTACTTC	CATARPGLAGSSYEQYF	TRBV15	TRBJ2-7
TGCGCCAGCAGCACAGACATTCAGTACTTC	CASSTDIQYF	TRBV5-1	TRBJ2-4
TGCAGCGGCCGACGTACTAGCAATCAGCCCCAGCATTTT	CSGRRTSNQPQHF	TRBV29-1	TRBJ1-5
TGTGCCAGCAGTTTTTCACTAGCGGGAGAGGCGTTTAACTATGGCTACACCTTC	CASSFSLAGEAFNYGYTF	TRBV27	TRBJ1-2
TGTGCCAGCAGCAGCCCAATGGAGGGTACGGACAATGAGCAGTTCTTC	CASSSPMEGTDNEQFF	TRBV7-3	TRBJ2-1
TGCAGTGCTAGGCTCCGGGGGCCTGCGCACTATGGCTACACCTTC	CSARLRGPAHYGYTF	TRBV20-1	TRBJ1-2
TGTGCCAGCTCACCACCCCTAAAGGGGACAGGGAGGGGAGAGGTGAACTCCTATAATTCACCCCTCCACTTT	CASSPPLKGTGRGEVNSYNSPLHF	TRBV18	TRBJ1-6
TGTGCCAGCAAGGACAGAACTAGGAAGGAGAAACGAGGGAACACTGAAGCTTTCTTT	CASKDRTRKEKRGNTEAFF	TRBV6-1	TRBJ1-1
TGTGCCAGCAGACAGGGGACTATGAACACTGAAGCTTTCTTT	CASRQGTMNTEAFF	TRBV6-2	TRBJ1-1
TGCGCCAGCAGCTTGGTGAATCTAATCCTGGGGGGACCTGGATATCAGCCCCAGCATTTT	CASSLVNLILGGPGYQPQHF	TRBV5-1	TRBJ1-5
TGTGCTAGTGGTTTGGTACCCCCTGCTGGACAGTACGAGCAGTACTTC	CASGLVPPAGQYEQYF	TRBV12-5	TRBJ2-7
TGTGCCTGGATAAGCCCGGGACAGAGTGGGGCCAACGTCCTGACTTTC	CAWISPGQSGANVLTF	TRBV30	TRBJ2-6
TGTGCCAGCAGCTGGAAGGATACCCCACCAGATACGCAGTATTTT	CASSWKDTPPDTQYF	TRBV27	TRBJ2-3
TGCAGTGCTACGGCGAGGGACCACGAGCAGTACTTC	CSATARDHEQYF	TRBV20-1	TRBJ2-7
TGTGCCAGCCACCTGCAAAGACGGAAACTGTTTTTT	CASHLQRRKLFF	TRBV7-3	TRBJ1-4
