TGTGCCAGCAGCGGGTCCCTCTGGACTAGCGGAGGTGAGACCCAGTACTTC	CASSGSLWTSGGETQYF	TRBV9	TRBJ2-5
TGTGCCAGCAGCCTTGGGGGGGGGGTGGGCACAGATACGCAGTATTTT	CASSLGGGVGTDTQYF	TRBV5-6	TRBJ2-3
TGTGCCAGCAGTTATAAGTCACCCCTCCACTTT	CASSYKSPLHF	TRBV6-9	TRBJ1-6
TGTGCCAGCAGTTCCCCCTTACAGTGGCGGGGCGCAAACTATAATTCACCCCTCCACTTT	CASSSPLQWRGANYNSPLHF	TRBV5-6	TRBJ1-6
TGTGCCAGCAGTGACCCCGGGGGGGTTCTTTTGGAGTACTTC	CASSDPGGVLLEYF	TRBV6-4	TRBJ2-7
TGTGCCAGCAGCCCGTTGACTAGCGGTGTCACCGCGGGCCCGAAAGAGACCCAGTACTTC	CASSPLTSGVTAGPKETQYF	TRBV7-6	TRBJ2-5
TGTGCCAGTAGTCCAGGCCGGGACAGGGCCGGAAACACCATATATTTT	CASSPGRDRAGNTIYF	TRBV19	TRBJ1-3
TGTGCCACCAGTGATTTCAAGGACAGAGGGCCCTCCCAGCAACCCTACGAGCAGTACTTC	CATSDFKDRGPSQQPYEQYF	TRBV24-1	TRBJ2-7
TGCGCCAGCAGCGGGACTCTCGGCACAGATACGCAGTATTTT	CASSGTLGTDTQYF	TRBV4-1	TRBJ2-3
TGTGCCAGCAGCCCGACTAGCGGGCGCGGACAAGGCACAGATACGCAGTATTTT	CASSPTSGRGQGTDTQYF	TRBV9	TRBJ2-3
TGCGCCAGCAGCCAACTCAGGGGTGGCTACACCTTC	CASSQLRGGYTF	TRBV4-1	TRBJ1-2
TGTGCCAGCAGCTTAGGCCTGACTAGCGGGGGGACAGATACGCAGTATTTT	CASSLGLTSGGTDTQYF	TRBV7-2	TRBJ2-3
TGTGCCAGCTCACCACTCCCCCGAAGCAACGAGCAGTACTTC	CASSPLPRSNEQYF	TRBV18	TRBJ2-7
TGTGCCAGCAGCTCCTTCGGACTAGCGGGAGCGTTAGATACGCAGTATTTT	CASSSFGLAGALDTQYF	TRBV7-2	TRBJ2-3
TGCAGTGCTAGAGAACCCGGAACCGGGGTTGACAATGAGCAGTTCTTC	CSAREPGTGVDNEQFF	TRBV20-1	TRBJ2-1
TGTGCCAGTAGTATAGTGGACGGATACGAGCAGTACTTC	CASSIVDGYEQYF	TRBV19	TRBJ2-7
TGTGCCACCAGCAGGCCCGAGGGAAATGAGCAGTTCTTC	CATSRPEGNEQFF	TRBV15	TRBJ2-1
TGTGCCAGCAGTGTTTTTCGAATGCCAGATACGCAGTATTTT	CASSVFRMPDTQYF	TRBV2	TRBJ2-3
TGTGCCAGCAGCTCGGACAGGGGGCCAACCTCGAAGTATAGCAATCAGCCCCAGCATTTT	CASSSDRGPTSKYSNQPQHF	TRBV7-2	TRBJ1-5
TGTGCCAGCAGACCCCAGTCCCCGGACAGTTTCCTAAACACCATATATTTT	CASRPQSPDSFLNTIYF	TRBV12-4	TRBJ1-3
TGTGCCACCCTCGGGGACAGGGGGGGATATAATTCACCCCTCCACTTT	CATLGDRGGYNSPLHF	TRBV24-1	TRBJ1-6
TGCGCCAGCAGCCAAGCCACGGAAGCAACTAATGAAAAACTGTTTTTT	CASSQATEATNEKLFF	TRBV4-1	TRBJ1-4
TGTGCCAGCAGCCCCCCAATCCCCCAGCTCAGTCGCAATCAGCCCCAGCATTTT	CASSPPIPQLSRNQPQHF	TRBV9	TRBJ1-5
TGCAGCGGGGACAGGGGCGACTACGAGCAGTACTTC	CSGDRGDYEQYF	TRBV29-1	TRBJ2-7
TGTGCTAGTGGTTTTAGGCGGGGGCTATACCGCGAGCAGTACTTC	CASGFRRGLYREQYF	TRBV12-5	TRBJ2-7
TGTGCCAGCAGAAAAACTAGCGGGAGGGGGGCCGAGACCCAGTACTTC	CASRKTSGRGAETQYF	TRBV12-3	TRBJ2-5
TGTGCCAGCAGCCAAGTGTGGAGGGATAAGTGCCTGTTTTTT	CASSQVWRDKCLFF	TRBV3-1	TRBJ1-4
TGTGCCAGCAGCCTGGGAGGGGGTTTTTCAGAGACCCAGTACTTC	CASSLGGGFSETQYF	TRBV28	TRBJ2-5
TGTGCCATCACTACTAAGGGGGGGGTAAGGGACACAGATACGCAGTATTTT	CAITTKGGVRDTDTQYF	TRBV10-3	TRBJ2-3
TGCAGCGTTGAAGGACAAATTCGCTACGAGCAGTACTTC	CSVEGQIRYEQYF	TRBV29-1	TRBJ2-7
TGTGCCAGCAGCCGGGGGGGCGATTTAGAGCAGTACTTC	CASSRGGDLEQYF	TRBV9	TRBJ2-7
TGTGCCAGCAGTCCTAGCGGTTGGGACTACGAGCAGTACTTC	CASSPSGWDYEQYF	TRBV6-5	TRBJ2-7
TGTGCCAGCAGCCCTAGGGGGACAGCGGAGACCCAGTACTTC	CASSPRGTAETQYF	TRBV6-5	TRBJ2-5
TGTGCCAGCAGCGTGAGCGTGTTCGAGCAGTACTTC	CASSVSVFEQYF	TRBV9	TRBJ2-7
TGTGCCAGCAGCCCCGGGACTAGTACGAAAACCTACGAGCAGTACTTC	CASSPGTSTKTYEQYF	TRBV3-1	TRBJ2-7
TGTGCCAGCGACGAGCTAGCTTTCTTC	CASDELAFF	TRBV7-3	TRBJ2-7
TGTGCCAGCAGTTGGTTGCCCAACCGGGACAGTTTAGAGACCCAGTACTTC	CASSWLPNRDSLETQYF	TRBV28	TRBJ2-5
TGCGCCAGCCTTACGGACATCACCTACGAGCAGTACTTC	CASLTDITYEQYF	TRBV5-1	TRBJ2-7
TGTGCCAGCTCATCCCATGCGGACTACTATGGCTACACCTTC	CASSSHADYYGYTF	TRBV18	TRBJ1-2
TGTGCCAGCAGCAACAAGGCCCGGGACAGGGGCTCTGAAAAACTGTTTTTT	CASSNKARDRGSEKLFF	TRBV7-3	TRBJ1-4
TGCGCCAGCAGCTTGTTCATGTACAGGGGGGGGTATGGCTACACCTTC	CASSLFMYRGGYGYTF	TRBV5-1	TRBJ1-2
TGTGCCACCAGCACACCGTCCACAGGGGCCTACGAGCAGTACTTC	CATSTPSTGAYEQYF	TRBV15	TRBJ2-7
TGTGCCAGCAGCTTAATCAGGGACGAGCAGTACTTC	CASSLIRDEQYF	TRBV7-3	TRBJ2-7
TGTGCCACCCCCCGGACAGGCGGGGAGCTGTTTTTT	CATPRTGGELFF	TRBV10-3	TRBJ2-2
TGTGCCAGCAGTTATGACAGGGCCGGCAATCAGCCCCAGCATTTT	CASSYDRAGNQPQHF	TRBV27	TRBJ1-5
TGTGCCATCGCGGGACTAGCCGGGAAGGACAATGAGCAGTTCTTC	CAIAGLAGKDNEQFF	TRBV10-3	TRBJ2-1
TGTGCTAGTGGAATCGGGGGTCTCTTC	CASGIGGLF	TRBV12-5	TRBJ2-1
TGTGCCTGGACGAGCGTCCCTCGGGGGGCGGGGCAGGACACCGGGGAGCTGTTTTTT	CAWTSVPRGAGQDTGELFF	TRBV30	TRBJ2-2
TGCAGTGCTAGGCGGGGGGGGGGGGATCAGCCCCAGCATTTT	CSARRGGGDQPQHF	TRBV20-1	TRBJ1-5
TGCAGTGCTAGATTCAGCCGACCCCTAGCGGGGGAGGGTTACTACGAGCAGTACTTC	CSARFSRPLAGEGYYEQYF	TRBV20-1	TRBJ2-7
TGTGCCAGCAGTTACTGCCCCCCTACCGGGCGACAAGCCAAAAACATTCAGTACTTC	CASSYCPPTGRQAKNIQYF	TRBV6-6	TRBJ2-4
TGCGCCAGCAGCTTGCCTGGGCGGGAGACCAAGTACAATGAGCAGTTCTTC	CASSLPGRETKYNEQFF	TRBV5-1	TRBJ2-1
TGCGCCAGCAGGAGGGCCAACAATGAGCAGTTCTTC	CASRRANNEQFF	TRBV10-1	TRBJ2-1
TGTGCCAGCACCTTTACAGAAAGGGCATATGGCTACACCTTC	CASTFTERAYGYTF	TRBV27	TRBJ1-2
TGTGCCAGCAGCCAGGGAACGAGCGGGGGGGTGTACGAGCAGTACTTC	CASSQGTSGGVYEQYF	TRBV6-5	TRBJ2-7
TGTGCCAGCAGGACCGTTCACCAGGGTATAGAGCAGTACTTC	CASRTVHQGIEQYF	TRBV6-4	TRBJ2-7
TGTGCCAGCAGTGGCATGGGAATTCAGGGGGGGGGCTCCTACGAGCAGTACTTC	CASSGMGIQGGGSYEQYF	TRBV6-1	TRBJ2-7
TGTGCCAGCAGCCAAGTCCGACTCGCTTTCTTT	CASSQVRLAFF	TRBV3-1	TRBJ1-1
TGTGCCAGCCTTCGGCTAGCGGTCGGTAATGAGCAGTTCTTC	CASLRLAVGNEQFF	TRBV9	TRBJ2-1
TGTGCCAGCAGCCAAGTTAGAGATCTAGCGGGACTGCCCCACACCGGGGAGCTGTTTTTT	CASSQVRDLAGLPHTGELFF	TRBV14	TRBJ2-2
TGTGCCAGCAGCGGAGTCACTGTCTCCAACAGGGGGCAACATAGCAATCAGCCCCAGCATTTT	CASSGVTVSNRGQHSNQPQHF	TRBV13	TRBJ1-5
TGTGCCAGCAGGTGGCTAGCGCCCTCTTACAATGAGCAGTTCTTC	CASRWLAPSYNEQFF	TRBV6-6	TRBJ2-1
TGTGCCAGCAGTCGGGACAGGGGAAGAGGACACAATCAGCCCCAGCATTTT	CASSRDRGRGHNQPQHF	TRBV6-2	TRBJ1-5
TGTGCCAGCAGTTTTACGGGGAGAAACAATCAGCCCCAGCATTTT	CASSFTGRNNQPQHF	TRBV12-3	TRBJ1-5
TGTCCCTACCTAGAGCACTCTGGGGCCAACGTCCTGACTTTC	CPYLEHSGANVLTF	TRBV7-2	TRBJ2-6
TGTGCCAGCAGCGCGCCGTGGGAGGGCTACTATGGCTACACCTTC	CASSAPWEGYYGYTF	TRBV9	TRBJ1-2
TGTGCCAGCAGCCTTCAGGGAGCTTTCTTT	CASSLQGAFF	TRBV3-1	TRBJ1-1
TGTGCCAGCAGCTCCCCCAACAGGGACACTGAAGCTTTCTTT	CASSSPNRDTEAFF	TRBV7-3	TRBJ1-1
TGCGCCAGCAGCTTAGACGAGGGAGAGCACACTGAAGCTTTCTTT	CASSLDEGEHTEAFF	TRBV5-1	TRBJ1-1
TGTGCCAGCAGAAAAATTCTGCGGGTGCTACGCACAGATACGCAGTATTTT	CASRKILRVLRTDTQYF	TRBV13	TRBJ2-3
TGCGCCAGCAGCGATCGTTATTGCTACCGGGCTGAGGAAAAGCAGGTCCAGCCCCAGCATTTT	CASSDRYCYRAEEKQVQPQHF	TRBV5-1	TRBJ1-5
TGTGCCAGCAGCTTACTAGCGGGAGGAGTCTACGAGCAGTACTTC	CASSLLAGGVYEQYF	TRBV11-3	TRBJ2-7
TGCGCCAGCAGCTTGGCCCTTACTCTCTACGAGCAGTACTTC	CASSLALTLYEQYF	TRBV5-1	TRBJ2-7
TGTGCCAGCAGTGAGCGGGAAGGACAGTGTCAAGAGACCCAGTACTTC	CASSEREGQCQETQYF	TRBV6-4	TRBJ2-5
TGTGCCACCAGTGATTGTGACCGGGACAGGGGGACAGGGCGGCCCAGGCGCTCCTACAATGAGCAGTTCTTC	CATSDCDRDRGTGRPRRSYNEQFF	TRBV24-1	TRBJ2-1
TGTGCCAGCAGCGTCAGGGGTCGTAACACCGGGGAGCTGTTTTTT	CASSVRGRNTGELFF	TRBV5-4	TRBJ2-2
TGTGCCAGCAGCTTAGATTGGGACGACGCATACTCCTACGAGCAGTACTTC	CASSLDWDDAYSYEQYF	TRBV7-3	TRBJ2-7
TGTGCCACCAGTGATTTGGTGAGTCCGGCCGGGACAGGGGGACCCCAAAATGAAAAACTGTTTTTT	CATSDLVSPAGTGGPQNEKLFF	TRBV24-1	TRBJ1-4
TGTGCCAGCAGCCAGAGCGGGAGGGGGCACAGCTCTGGAAACACCATATATTTT	CASSQSGRGHSSGNTIYF	TRBV12-4	TRBJ1-3
TGCAGTGCTATTCCCAAACTAGCGGGAGGGCATATTACCGGGGAGCTGTTTTTT	CSAIPKLAGGHITGELFF	TRBV20-1	TRBJ2-2
TGCGCCAGCAGCTTGGTGCTGAGGAATCAGCCCCAGCATTTT	CASSLVLRNQPQHF	TRBV5-1	TRBJ1-5
TGTGCCAGCAGTTACTCAACCAGAGGGTGGAGGAGCGGGGAGCTGTTTTTT	CASSYSTRGWRSGELFF	TRBV6-5	TRBJ2-2
TGTGCCAGCAGTGCGACAGGTTGGAGCTATGGCTACACCTTC	CASSATGWSYGYTF	TRBV27	TRBJ1-2
TGTGCCAGCAGCTGCCCTGGCATGGCACAGTGTAGCACCGGGGAGCTGTTTTTT	CASSCPGMAQCSTGELFF	TRBV11-3	TRBJ2-2
TGCGCCAGCAGCTTGGACAACCGGGACAGGGTCATTAATGAAAAACTGTTTTTT	CASSLDNRDRVINEKLFF	TRBV5-1	TRBJ1-4
TGTGCCAGCAGCGGGGAGGACGCGTACGAGCAGTACTTC	CASSGEDAYEQYF	TRBV7-3	TRBJ2-7
TGTGCCAGCAGCGGTTCCGGGCGCTCTGGAAACACCATATATTTT	CASSGSGRSGNTIYF	TRBV7-2	TRBJ1-3
TGCGCCAGCAGCCAAGATGACTGTGCCTATACGCAGTATTTT	CASSQDDCAYTQYF	TRBV4-1	TRBJ2-3
TGTGCCAGCAGCCGGGATGCGGGAGGACGACCTGAAGCTTTCTTT	CASSRDAGGRPEAFF	TRBV14	TRBJ1-1
TGTGCCAGCAGTTGGGACAGGGAGGGCTACGAGCAGTACTTC	CASSWDREGYEQYF	TRBV28	TRBJ2-7
TGCGCCAGCAGCTTCACCCTAGCCAAAAACATTCAGTACTTC	CASSFTLAKNIQYF	TRBV5-1	TRBJ2-4
TGCGCCAGCAGGTCAGGACTAGAGGTATCATGCTCCTACGAGCAGTACTTC	CASRSGLEVSCSYEQYF	TRBV5-1	TRBJ2-7
TGTGCCAGCAGTGACCCCCTTAGCCGCGCCACCGGGGAGCTGTTTTTT	CASSDPLSRATGELFF	TRBV2	TRBJ2-2
TGTGCCAGCAGTTACCTCAAAGATGAGCAGTTCTTC	CASSYLKDEQFF	TRBV27	TRBJ2-1
TGTGCCAGCAACAGGACCTCTCCCGTAGGGGGAAACACCATATATTTT	CASNRTSPVGGNTIYF	TRBV27	TRBJ1-3
TGCGCCAGCAGTGAGACGGTGGGGACTAGATCGGAGCAGTTCTTC	CASSETVGTRSEQFF	TRBV10-1	TRBJ2-1
TGTGCCACCACGGGACTAGCGGAGGAAGATGAGCAGTTCTTC	CATTGLAEEDEQFF	TRBV19	TRBJ2-1
TGCAGCGTTGGAGAAGAGGCAGAGACCCAGTACTTC	CSVGEEAETQYF	TRBV29-1	TRBJ2-5
TGCGCCAGCAGTGAAGGTAGGGGCGCTGAAGCTTTCTTT	CASSEGRGAEAFF	TRBV10-2	TRBJ1-1
TGTGCCAGCAGCCAAGTACTCCGGGGGACAGGTCAGCCCCAGCATTTT	CASSQVLRGTGQPQHF	TRBV4-2	TRBJ1-5
TGCAGTGCTAGTTCCTCCACAGGTAACTGCTCTGGGGCCAACGTCCTGACTTTC	CSASSSTGNCSGANVLTF	TRBV20-1	TRBJ2-6
TGCGCCAGCTCAGGGTCCTACGAGCAGTACTTC	CASSGSYEQYF	TRBV5-1	TRBJ2-7
TGTGCCAGCAGCGATTTTACAGACAGGGAAGCGCAGTACTTC	CASSDFTDREAQYF	TRBV9	TRBJ2-7
TGTGCCAGCAGCTACTATCTGATGAAGGAGGGGGTTTCTAATGAAAAACTGTTTTTT	CASSYYLMKEGVSNEKLFF	TRBV7-3	TRBJ1-4
TGTGCCAGCAGCTTAATTGGTAAGGGCTACGAGCAGTACTTC	CASSLIGKGYEQYF	TRBV7-3	TRBJ2-7
TGTGCCAGGCGGACAGGGGTATTCTTT	CARRTGVFF	TRBV19	TRBJ1-1
TGTGCCAGCAGTTACGCGGGACAGCCCACAGATACGCAGTATTTT	CASSYAGQPTDTQYF	TRBV6-5	TRBJ2-3
TGTGCCAGCAGTGACAATTTCGACGGCGCGAACACTGAAGCTTTCTTT	CASSDNFDGANTEAFF	TRBV6-4	TRBJ1-1
TGTGCCAGCAGCGTACAACAAAAGGATCCTGAAGCTTTCTTT	CASSVQQKDPEAFF	TRBV11-2	TRBJ1-1
TGTGCCAGCAGCCAAGGGGTAGGGGTCTATGGCTACACCTTC	CASSQGVGVYGYTF	TRBV4-2	TRBJ1-2
TGTGCCAGCTGCGGGAGGGACGGTAAATATGGCTACACCTTC	CASCGRDGKYGYTF	TRBV6-4	TRBJ1-2
TGTGCCAGCAGCTCGGATAGCGGGAAGCCCATCTACGAGCAGTACTTC	CASSSDSGKPIYEQYF	TRBV13	TRBJ2-7
TGTGCTAGCAGCCATTTACAGGGGCCTGAGCAGTACTTC	CASSHLQGPEQYF	TRBV7-7	TRBJ2-7
TGTGCCAGCAGAAGGATAGTATACGAGCAGTACTTC	CASRRIVYEQYF	TRBV6-3	TRBJ2-7
TGCAGCGTTGCGCGGGCCGGGACCCTTGCCCCCTACGAGCAGTACTTC	CSVARAGTLAPYEQYF	TRBV29-1	TRBJ2-7
TGTGCCAGCAGTTATCGGGGCGGATCCTACGAGCAGTACTTC	CASSYRGGSYEQYF	TRBV6-2	TRBJ2-7
TGTGCCTGGAGGACTAGGGGGGGCGTATCTGGGTTTTCTGAGGACTACAATGAGCAGTTCTTC	CAWRTRGGVSGFSEDYNEQFF	TRBV30	TRBJ2-1
TGTGCCAGCAGTGAACAGGACAGGCCCTACGAGCAGTACTTC	CASSEQDRPYEQYF	TRBV2	TRBJ2-7
TGTGCCAGCTTGCCGGGACAGGGGGGGGGGGTTCCAGATACGCAGTATTTT	CASLPGQGGGVPDTQYF	TRBV6-4	TRBJ2-3
TGTGCCAGCAGCCCTCATTACAACACTGAAGCTTTCTTT	CASSPHYNTEAFF	TRBV6-1	TRBJ1-1
TGTGCCATCACACCGTTGTTCACGGAACTACCCGGGGTATGGATATATGAACCTGATTGCTACGAGCAGTACTTC	CAITPLFTELPGVWIYEPDCYEQYF	TRBV10-3	TRBJ2-7
TGTGCCAGCTCCGCCGATGAGCAGTTCTTC	CASSADEQFF	TRBV18	TRBJ2-1
TGCAGTGCCGGTAGGGTCCCGAGCTCCTACAATGAGCAGTTCTTC	CSAGRVPSSYNEQFF	TRBV20-1	TRBJ2-1
TGTGCCAGCAGTTTAGGAGCGGGAGGCGAGCAGTACTTC	CASSLGAGGEQYF	TRBV12-3	TRBJ2-7
TGTGCCAGCAAAGGCGGGATATCCTACAATGAGCAGTTCTTC	CASKGGISYNEQFF	TRBV6-4	TRBJ2-1
TGCGCCAGCAGCTTATGGGACCTATCTGGACAGGGGGCCACCAGCTCTGGGGCCAACGTCCTGACTTTC	CASSLWDLSGQGATSSGANVLTF	TRBV5-1	TRBJ2-6
TGCGCCAGCAGCCTAGACAGGGGGCTAAATTCACCCCTCCACTTT	CASSLDRGLNSPLHF	TRBV5-1	TRBJ1-6
TGTGCCAGCAGCGGAGGGGGGAGAGCCTGCCGGCCCGAGCAGTTCTTC	CASSGGGRACRPEQFF	TRBV6-5	TRBJ2-1
TGTGCCAGCAGCCTCACGAGGAACGAGCAGTACTTC	CASSLTRNEQYF	TRBV13	TRBJ2-7
TGTGCCAGCAGCTCGCCCACCTCCAGCCATTGGAATAATTCACCCCTCCACTTT	CASSSPTSSHWNNSPLHF	TRBV7-3	TRBJ1-6
TGCATTCCCGGGACTAGCGGGAGGGCCCCCTCCTACAATGAGCAGTTCTTC	CIPGTSGRAPSYNEQFF	TRBV20-1	TRBJ2-1
TGTGCCAGCAGCTCTCCTCGCAAGCTAACGCAGCCCCAGCATTTT	CASSSPRKLTQPQHF	TRBV6-4	TRBJ1-5
TGTGCCAGCAGCAGCCGGGGGGGGGCTTATAGCAATCAGCCCCAGCATTTT	CASSSRGGAYSNQPQHF	TRBV7-3	TRBJ1-5
TGCAGTGCTAGCCTGCGGTACGGACAGGGGCCTGACTCTGGAAACACCATATATTTT	CSASLRYGQGPDSGNTIYF	TRBV20-1	TRBJ1-3
TGTGCCAGCAGCTGGGCGGCTGAGCAGTTCTTC	CASSWAAEQFF	TRBV7-9	TRBJ2-1
TGTGCCAGCATCCTAAAACGGGGAAAAGGGGCCAACGTCCTGACTTTC	CASILKRGKGANVLTF	TRBV13	TRBJ2-6
TGTGCCAGCAGTGTTACCCAGCATTTT	CASSVTQHF	TRBV6-4	TRBJ1-5
TGTGCCACCAGAGTGACTAATCACGGGGAGCTGTTTTTT	CATRVTNHGELFF	TRBV15	TRBJ2-2
TGTGCCAGCAGCCAAGGGGACAGGGGCCGGAATTCACCCCTCCACTTT	CASSQGDRGRNSPLHF	TRBV3-1	TRBJ1-6
TGTGCCAGCACTAGCGGAATGAACACCGGGGAGCTGTTTTTT	CASTSGMNTGELFF	TRBV6-4	TRBJ2-2
TGTGCCAGCAGCTTAATGACCCGGACTAGCGGGAGCTCTAACACCGGGGAGCTGTTTTTT	CASSLMTRTSGSSNTGELFF	TRBV11-2	TRBJ2-2
TGCCGAGGGTATGGCTACACCTTC	CRGYGYTF	TRBV18	TRBJ1-2
TGTGCCAGCAGCTTATGCCTCAGGGGGGACCTACGGGGGCCTATTGGAGGCTACACCTTC	CASSLCLRGDLRGPIGGYTF	TRBV11-2	TRBJ1-2
TGTGCCAGCAGCTGGGACAGGAACAATGGCTACACCTTC	CASSWDRNNGYTF	TRBV11-3	TRBJ1-2
TGTGCCAGCAGTGATCATAGGCAAGCGGGAGGGAACACTGAAGCTTTCTTT	CASSDHRQAGGNTEAFF	TRBV25-1	TRBJ1-1
TGTGCCAGCAGACGCCAGGGACAGGGGGCGCTACTGTTTTTT	CASRRQGQGALLFF	TRBV28	TRBJ1-4
TGTGCCAGCAGCGGACTCTTCGGTCTCACCTACGAGCAGTACTTC	CASSGLFGLTYEQYF	TRBV7-4	TRBJ2-7
TGTGCCAGCAGCCATCCCGCAGCCGACAGGGGTGAAGCTTTCTTT	CASSHPAADRGEAFF	TRBV3-1	TRBJ1-1
TGTGCCACCAGCCTCAATGAGCAGTTCTTC	CATSLNEQFF	TRBV24-1	TRBJ2-1
TGCAGTGCCGGACATTTACCCTCTGGAAACACCATATATTTT	CSAGHLPSGNTIYF	TRBV20-1	TRBJ1-3
TGTGCCAGCAGCTCTCCAGGGGTTCAGAGGTGCACAGATACGCAGTATTTT	CASSSPGVQRCTDTQYF	TRBV7-6	TRBJ2-3
TGCGCCAGCAGCTTGGGTAGTGCCGGGGGTTCACCCCTCCACTTT	CASSLGSAGGSPLHF	TRBV5-1	TRBJ1-6
TGTGCCAGCCGGACAGGGTTCTACGAGCAGTACTTC	CASRTGFYEQYF	TRBV13	TRBJ2-7
TGTGCCAGCAGTTGGGGGCGCCTCCTCTACGAGCAGTACTTC	CASSWGRLLYEQYF	TRBV27	TRBJ2-7
TGTGCTAGTGGTTCCCAAAGTATACGAATCCCTAGCGGGTCCAGAACGAACACCGGGGAGCTGTTTTTT	CASGSQSIRIPSGSRTNTGELFF	TRBV12-5	TRBJ2-2
TGTGCCAGCAGTTCCACTAGATGGTGTCGACTCCTCTCTGGGGCCAACGTCCTGACTTTC	CASSSTRWCRLLSGANVLTF	TRBV28	TRBJ2-6
TGTGCCAGCAGCCTCCCAGGACGTTTCTATGGCTACACCTTC	CASSLPGRFYGYTF	TRBV13	TRBJ1-2
TGTGCCAGTAGAGTACCTAACCAAGAGACCCAGTACTTC	CASRVPNQETQYF	TRBV19	TRBJ2-5
TGTGCCACCAGCAGAGCCGGGGGGGGCCCCCCCTACGAGCAGTACTTC	CATSRAGGGPPYEQYF	TRBV15	TRBJ2-7
TGTGCCAGCAGTGACGAGGGTAGTACGCAGTATTTT	CASSDEGSTQYF	TRBV6-4	TRBJ2-3
TGTGCCACCAGTGCGCCCCCAAGGGGGAGGGGTGGAAACACCATATATTTT	CATSAPPRGRGGNTIYF	TRBV24-1	TRBJ1-3
TGTGCCAGCAGTTACCCGGGCCGTAATCAGCCCCAGCATTTT	CASSYPGRNQPQHF	TRBV6-2	TRBJ1-5
TGCGCCAGCAGCTTGTGGAGGGACAGGGGAAGGTACTATGGCTACACCTTC	CASSLWRDRGRYYGYTF	TRBV5-1	TRBJ1-2
TGTGCCAGCAGTTTCACAAATACTAATGAGCAGTTCTTC	CASSFTNTNEQFF	TRBV6-8	TRBJ2-1
TGTGCCAGCAGCCAAGGGCGCACAGATACGCAGTATTTT	CASSQGRTDTQYF	TRBV4-2	TRBJ2-3
TGTGCCAGCAGCTTTGGCCTTGAGGGACAAGCTTTCTTT	CASSFGLEGQAFF	TRBV11-2	TRBJ1-1
TGTGCCAGCAGCCCGAAGAGGGCGGACACCGGGGAGCTGTTTTTT	CASSPKRADTGELFF	TRBV9	TRBJ2-2
TGTGCCAGCAGTTTACGCGGGAGCCTCGACTGCTACGAGCAGTACTTC	CASSLRGSLDCYEQYF	TRBV28	TRBJ2-7
TGCGCCAGCAGCGCGGAGACAGGATCTGGAAACACCATATATTTT	CASSAETGSGNTIYF	TRBV5-1	TRBJ1-3
TGCGCCAGCAGCCCTGCTGACAGGGGGCCTGAAGCTTTCTTT	CASSPADRGPEAFF	TRBV5-1	TRBJ1-1
TGTGCCAGCAGCCAACCGGAGCTGGGACAGGGCTTCCGGCACGAGCAGTACTTC	CASSQPELGQGFRHEQYF	TRBV14	TRBJ2-7
TGTGCCAGCAGTTTAAAATCCCCGGGACAGGGAAGAGAGCCGAGCAATCAGCCCCAGCATTTT	CASSLKSPGQGREPSNQPQHF	TRBV27	TRBJ1-5
TGCAGTGCTAGAACCTCACTAGCGGGCACAGATACGCAGTATTTT	CSARTSLAGTDTQYF	TRBV20-1	TRBJ2-3
TGCGCCAGCAGCCAATATAGTACCCCCAGGGCAGAAAACACCGGGGAGCTGTTTTTT	CASSQYSTPRAENTGELFF	TRBV4-1	TRBJ2-2
TGTGCCAGCCGGGGAGACACCATATATTTT	CASRGDTIYF	TRBV6-4	TRBJ1-3
TGTGCTAGTGGTCTTCGAAGACACACCGGGGAGCTGTTTTTT	CASGLRRHTGELFF	TRBV12-5	TRBJ2-2
TGCACCGGCGGGAGAGGGGATGGTAGCCACACTGAAGCTTTCTTT	CTGGRGDGSHTEAFF	TRBV10-1	TRBJ1-1
TGTGCCAGCAGTACAGGACAGGGGGCGCGTGCTGAAGCTTTCTTT	CASSTGQGARAEAFF	TRBV6-3	TRBJ1-1
TGCGCCAGCAGTGGGGGCACTGAAGCTTTCTTT	CASSGGTEAFF	TRBV10-2	TRBJ1-1
TGTGCCAGCAGCCAAGATGAGGGGCCCATTAGCTCCTACAATGAGCAGTTCTTC	CASSQDEGPISSYNEQFF	TRBV3-1	TRBJ2-1
TGTGCCATCAGTGATTCCACAGGAGGCGGCCGGGCAGATACGCAGTATTTT	CAISDSTGGGRADTQYF	TRBV10-3	TRBJ2-3
TGTGCTAGTGGTTCAGACTATGGCTACACCTTC	CASGSDYGYTF	TRBV12-5	TRBJ1-2
TGTGCAAACCTGGGGGCGGATTCGGAAGAGACCCAGTACTTC	CANLGADSEETQYF	TRBV12-3	TRBJ2-5
TGTGCCAGCAGTAATGGGGACAGGTCCTACGAGCAGTACTTC	CASSNGDRSYEQYF	TRBV27	TRBJ2-7
TGTGCCACCGGGACAGGGGCTAAAAATCCCTACGAGCAGTACTTC	CATGTGAKNPYEQYF	TRBV12-3	TRBJ2-7
TGTGCCAAGTTGCCGGGACAGGGCTACGAGCAGTACTTC	CAKLPGQGYEQYF	TRBV18	TRBJ2-7
TGTGCCAGCAGTGACCTGGTGGGAGGGGGGAACTATGGCTACACCTTC	CASSDLVGGGNYGYTF	TRBV6-4	TRBJ1-2
TGTGCCAGCAGCGAGAGCCGACGTTATGGCTACACCTTC	CASSESRRYGYTF	TRBV5-6	TRBJ1-2
TGTGCCAGCAGCCAATCTTCACCATGGGCAGGCTACACCTTC	CASSQSSPWAGYTF	TRBV3-1	TRBJ1-2
TGTGCCACCAGTGATTTGGTCGGGACAGAGGACTACGAGCAGTACTTC	CATSDLVGTEDYEQYF	TRBV24-1	TRBJ2-7
TGTGCCAGCAGCTTGCCCCCCGACAGGGAGGAACGCGAGCAGTACTTC	CASSLPPDREEREQYF	TRBV5-6	TRBJ2-7
TGTGCCATCAGTGAGTCGCAGACCCCCCAGGAGAACTATGGCTACACCTTC	CAISESQTPQENYGYTF	TRBV10-3	TRBJ1-2
TGTGCCAGCATACCACCAATCAACAATGAAAAACTGTTTTTT	CASIPPINNEKLFF	TRBV6-4	TRBJ1-4
TGTGCCAGCACAGGGGCTCGAGGGGCTGGCTACACCTTC	CASTGARGAGYTF	TRBV2	TRBJ1-2
TGCAGTGCTACCGGGACAGGGCCTGTTGGCCCACCGAGGAATCAGCCCCAGCATTTT	CSATGTGPVGPPRNQPQHF	TRBV20-1	TRBJ1-5
TGTGCCACCAGTGATTTTGACCGACCGGGGGGCCCCCCGCCGATATTCGATAACACTGAAGCTTTCTTT	CATSDFDRPGGPPPIFDNTEAFF	TRBV24-1	TRBJ1-1
TGTGCCAGCAGACACAGGGAGAACTATGGCTACACCTTC	CASRHRENYGYTF	TRBV7-9	TRBJ1-2
TGTGCCAGCAGTGAATATCGTCGAAGCTACGAGCAGTACTTC	CASSEYRRSYEQYF	TRBV25-1	TRBJ2-7
TGTGCCAGCAATTCAGGACGGAACACTGAAGCTTTCTTT	CASNSGRNTEAFF	TRBV6-5	TRBJ1-1
TGCAGTGCTACGTCTAAGCGGGTCTACGAGCAGTACTTC	CSATSKRVYEQYF	TRBV20-1	TRBJ2-7
TGTGCCGCATCAGAACCCCACTACGAGCAGTACTTC	CAASEPHYEQYF	TRBV24-1	TRBJ2-7
TGTGCCAGCAGCATTCGGGGGGCGTTCTATCCGGGGAAAGCCGGGGAGCTGTTTTTT	CASSIRGAFYPGKAGELFF	TRBV5-4	TRBJ2-2
TGCAGTGCAAAGGGGACAGGGCAAGAGACCCAGTACTTC	CSAKGTGQETQYF	TRBV20-1	TRBJ2-5
TGTGCCAGCAGCCAAGATAACCCGGGGGGACCAAGCTCCTACGAGCAGTACTTC	CASSQDNPGGPSSYEQYF	TRBV4-2	TRBJ2-7
TGTGCCAGCAGCCAAGGTTTTTGGACTAGGGGGATCGGGGAGCTGTTTTTT	CASSQGFWTRGIGELFF	TRBV4-2	TRBJ2-2
TGTGCCAGCAGCTTATCGGACAGGGGGCGACCGGCTAATGAAAAACTGTTTTTT	CASSLSDRGRPANEKLFF	TRBV7-6	TRBJ1-4
TGTGCCAGCAGTGAAGGGGGGGCCTACGAGCAGTACTTC	CASSEGGAYEQYF	TRBV25-1	TRBJ2-7
TGTGCCAGCAGCTTACTCCGAGGGACGAACACCGGGGAGCTGTTTTTT	CASSLLRGTNTGELFF	TRBV11-2	TRBJ2-2
TGCAGCGTTGATGATGGACTAGCGGGGCAATTAGATTACAATGAGCAGTTCTTC	CSVDDGLAGQLDYNEQFF	TRBV29-1	TRBJ2-1
TGCGCCAGCTGTGGTGGGATTGAACAGGGCAACCACAATCAGCCCCAGCATTTT	CASCGGIEQGNHNQPQHF	TRBV10-1	TRBJ1-5
TGTGCCAGCAGCTTGCTAACCCTGGGACAGGGGTTTCGCAATCAGCCCCAGCATTTT	CASSLLTLGQGFRNQPQHF	TRBV5-5	TRBJ1-5
TGTGCCAGCAGGTATACCACTAGCGGGAGCTGGGACACCGGGGAGCTGTTTTTT	CASRYTTSGSWDTGELFF	TRBV6-5	TRBJ2-2
TGTGCCAGCACACAGGTTGGGACTAACAATGAGCAGTTCTTC	CASTQVGTNNEQFF	TRBV2	TRBJ2-1
TGTGCCAGCATTGTCCGACAGGGGGTACCCTACGAGCAGTACTTC	CASIVRQGVPYEQYF	TRBV6-2	TRBJ2-7
TGCGCCAGCAGCTTGGCCGTTAACAGGAACGGAGGAGTTCTGGGGCAGTTCTTC	CASSLAVNRNGGVLGQFF	TRBV5-1	TRBJ2-1
TGTGCCAGCAGTCGGAATAACAGGGATTGCAGCCGGGAGACCCAGTACTTC	CASSRNNRDCSRETQYF	TRBV6-6	TRBJ2-5
TGTGCCAGCAGCGTATCGGCAGGAGCGCCTAATGAAAAACTGTTTTTT	CASSVSAGAPNEKLFF	TRBV9	TRBJ1-4
TGCGCCAGCAGCTTGGAGTTGGGAGGGACAGACCCAACCTACGAGCAGTACTTC	CASSLELGGTDPTYEQYF	TRBV5-1	TRBJ2-7
TGTGCCAGCAACATTACGGGACAGGGCTTTTATAGCAATCAGCCCCAGCATTTT	CASNITGQGFYSNQPQHF	TRBV5-6	TRBJ1-5
TGTGCCAGCATCGGATTTGGACAGCTGCATCTGTTTTTT	CASIGFGQLHLFF	TRBV7-2	TRBJ1-4
TGTGCCAGCAGCCACGGCAAAAGGACAGGGTGGTCCCTTGGAGCTAACTATGGCTACACCTTC	CASSHGKRTGWSLGANYGYTF	TRBV14	TRBJ1-2
TGTGCCAGCAGTTACTTAACATGGGTGGGACAGGGGAGACAAGAGACCCAGTACTTC	CASSYLTWVGQGRQETQYF	TRBV6-6	TRBJ2-5
TGCAGTGCTAGCGCTGCTGACAGGGGTGATGAAAAACTGTTTTTT	CSASAADRGDEKLFF	TRBV20-1	TRBJ1-4
TGCAGCGTTGATCGACAGGCAACCTACGAGCAGTACTTC	CSVDRQATYEQYF	TRBV29-1	TRBJ2-7
TGTGCCAGCAGCACAGGGGGCATCGGCTATGGCTACACCTTC	CASSTGGIGYGYTF	TRBV12-4	TRBJ1-2
TGTGCCAGCAGCTTGAGGACGGGTGTCCGCTTAGACTATGGCTACACCTTC	CASSLRTGVRLDYGYTF	TRBV7-6	TRBJ1-2
TGTGCCAGCAGCGAAGATAGTGGGGGCGTTTACACCGGGGAGCTGTTTTTT	CASSEDSGGVYTGELFF	TRBV13	TRBJ2-2
TGCAGTGCTAGGGCAAACGGAGGGAGTGGCTACACCTTC	CSARANGGSGYTF	TRBV20-1	TRBJ1-2
TGTGCCAGTAGCCTTCGTAAGGGGTTCAGCGAGCAGTACTTC	CASSLRKGFSEQYF	TRBV19	TRBJ2-7
TGTGCCAGCATCGTATCGGGGACTAGCCCTGGCTCCTACGAGCAGTACTTC	CASIVSGTSPGSYEQYF	TRBV6-1	TRBJ2-7
TGTGCCAGCAGCCAAGATTGTCACACGAATAGGAGCAATCAGCCCCAGCATTTT	CASSQDCHTNRSNQPQHF	TRBV14	TRBJ1-5
TGCGCCAGCGCCGGGAGGGCCTACGAGCAGTACTTC	CASAGRAYEQYF	TRBV5-1	TRBJ2-7
TGCAGTTATAAGATGACAGAGGGGTGCTCCTACGAGCAGTACTTC	CSYKMTEGCSYEQYF	TRBV20-1	TRBJ2-7
TGTGCCAGCAGCCACCCAGGGTTCAACTATGGCTACACCTTC	CASSHPGFNYGYTF	TRBV14	TRBJ1-2
TGTGCCAGTAGGACTTTCCCGGACAGGGGATTAGGAAACACCATATATTTT	CASRTFPDRGLGNTIYF	TRBV19	TRBJ1-3
TGCAGCGTTACAGGGGTGGACTTCAACGATACGCAGTATTTT	CSVTGVDFNDTQYF	TRBV29-1	TRBJ2-3
TGTGCCAGCAGGAGTTTCCCCACCCGGGACATTTCACCCCTCCACTTT	CASRSFPTRDISPLHF	TRBV7-9	TRBJ1-6
TGCAGTGCTAGGATAACTAATGAAAAACTGTTTTTT	CSARITNEKLFF	TRBV20-1	TRBJ1-4
TGTGCCAGCAGCCAAGGGGGAAAACCCATGGGGAGCTCTGGAAACACCATATATTTT	CASSQGGKPMGSSGNTIYF	TRBV3-1	TRBJ1-3
TGTGCCAGCAGCTCCGGAGACACTGAAGCTTTCTTT	CASSSGDTEAFF	TRBV7-3	TRBJ1-1
TGCGCCAGCAGCGTCCAGGGGACTCACTACAATGAGCAGTTCTTC	CASSVQGTHYNEQFF	TRBV5-1	TRBJ2-1
TGTGCCAGCAGCCAAGGGGGCCGGGAAAATCAGCCCCAGCATTTT	CASSQGGRENQPQHF	TRBV3-1	TRBJ1-5
TGTGCCAGCAGTTTCCCCCAGGGGAACACTGAAGCTTTCTTT	CASSFPQGNTEAFF	TRBV28	TRBJ1-1
TGCGCCAGCAGCTTGGGACGACAGCCATTCCGCACAGATACGCAGTATTTT	CASSLGRQPFRTDTQYF	TRBV5-1	TRBJ2-3
TGCGCCAGCAGCCAAGATTTAAAACCAGGGGGAGGACGGGGCGGAAACACCATATATTTT	CASSQDLKPGGGRGGNTIYF	TRBV4-1	TRBJ1-3
TGTGCCAGCAGTATGAAGGAGACCCCGAATGAGCAGTTCTTC	CASSMKETPNEQFF	TRBV6-5	TRBJ2-1
TGTGCCAGCAGCCAAGAGCTATACAGGTGCTACGAGCAGTACTTC	CASSQELYRCYEQYF	TRBV3-1	TRBJ2-7
TGTGCCAGTAAAAGGGACGATCAGCCCCAGCATTTT	CASKRDDQPQHF	TRBV19	TRBJ1-5
TGTGCCAGCAGCTTCGAGCTTATAGATCAGCCCCAGCATTTT	CASSFELIDQPQHF	TRBV11-2	TRBJ1-5
TGTGCCAGCAGCCCTCGGGGAAATGAAAAACTGTTTTTT	CASSPRGNEKLFF	TRBV11-2	TRBJ1-4
TGTGCCAGCAGCCAAGTTCGTTCGGGACAATACTCCTACGAGCAGTACTTC	CASSQVRSGQYSYEQYF	TRBV4-2	TRBJ2-7
TGTGCCAGCAGTGCTCCGAGCTCAGGGAAGCCCCTCTCTGGAAACACCATATATTTT	CASSAPSSGKPLSGNTIYF	TRBV6-1	TRBJ1-3
TGTGCCAGCAGCTTACGGGACTTTAACTGGTCAGATACGCAGTATTTT	CASSLRDFNWSDTQYF	TRBV7-2	TRBJ2-3
TGTGCCACCACCTCCCCGGCCAAGGAAGTACAGAAAAACATTCAGTACTTC	CATTSPAKEVQKNIQYF	TRBV24-1	TRBJ2-4
TGTGCCAGCAGTCTTCGGGGGCAGGCCCAAGAGACCCAGTACTTC	CASSLRGQAQETQYF	TRBV27	TRBJ2-5
TGTGCCAGCAGTTTATCCCAACTGCCAGAGCAGTACTTC	CASSLSQLPEQYF	TRBV28	TRBJ2-7
TGTGCCATCATACAGAGGGCGACCTCCTACGAGCAGTACTTC	CAIIQRATSYEQYF	TRBV10-3	TRBJ2-7
TGCAGTGCTCACCTATTTAGGTACGGGACAGTAGCTAACTATGGCTACACCTTC	CSAHLFRYGTVANYGYTF	TRBV20-1	TRBJ1-2
TGTGCCAGCAGCGTAGTTCGGCAGAGACGACGGTACAATGAGCAGTTCTTC	CASSVVRQRRRYNEQFF	TRBV9	TRBJ2-1
TGTGCCAGCAGCGTAGGCGGGAGCTACAATACCGGGGAGCTGTTTTTT	CASSVGGSYNTGELFF	TRBV9	TRBJ2-2
TGTGCCAGCGAAGGGGGGACAGGGCGGGCCTACGAGCAGTACTTC	CASEGGTGRAYEQYF	TRBV6-1	TRBJ2-7
TGTGCCTGGAGTTCGTTAGGGCCGGGAGGGAACACCGGGGAGCTGTTTTTT	CAWSSLGPGGNTGELFF	TRBV30	TRBJ2-2
TGTGCCAGCAGCCACGCGGGACTAGCGTTCGAGCAGTACTTC	CASSHAGLAFEQYF	TRBV14	TRBJ2-7
TGTGCCAGCAGGGGGGGGGGGAAGACAGATACGCAGTATTTT	CASRGGGKTDTQYF	TRBV6-6	TRBJ2-3
TGTGCCAGCAGGGCGGGGGGGCCAATTTATCGCGAGCAGTACTTC	CASRAGGPIYREQYF	TRBV2	TRBJ2-7
TGTGCCAGCAGCCCTAAAACCAGGGGGCGGGGTTACGAGACCCAGTACTTC	CASSPKTRGRGYETQYF	TRBV5-5	TRBJ2-5
TGTGCCAGCAGTGATAGGAGTAAGCTAGACTACGAGCAGTACTTC	CASSDRSKLDYEQYF	TRBV6-1	TRBJ2-7
TGCGCCAGCAGCCGACTAGCGGGTTGCTCTGGGGCCAACGTCCTGACTTTC	CASSRLAGCSGANVLTF	TRBV5-1	TRBJ2-6
TGTGCCAGCAGCAGGATGCAGGGGGGCAATCAGCCCCAGCATTTT	CASSRMQGGNQPQHF	TRBV13	TRBJ1-5
TGCGCCAGCAGGGCTGGCCCTGATACGCAGTATTTT	CASRAGPDTQYF	TRBV10-1	TRBJ2-3
TGTGCCAGCACCCCCGACCTACCCAACGAGCAGTACTTC	CASTPDLPNEQYF	TRBV2	TRBJ2-7
TGTGCCAGCAGTAGACCTTACTATGGCTACACCTTC	CASSRPYYGYTF	TRBV6-4	TRBJ1-2
TGCGCCAGCAGCCACCCAGGACTAGCGGGAGGGCAGGATCAGTACTTC	CASSHPGLAGGQDQYF	TRBV4-3	TRBJ2-5
TGTGCCAGCAGTGATCACAACAGATGCAATGAGCAGTTCTTC	CASSDHNRCNEQFF	TRBV6-1	TRBJ2-1
TGCAGTGCAGCGGACAGGGGAGGAGCTGGTGGCTACACCTTC	CSAADRGGAGGYTF	TRBV20-1	TRBJ1-2
TGTGCCAGCAGCTTGCTGAGGAGGAACGAGCAGTACTTC	CASSLLRRNEQYF	TRBV5-5	TRBJ2-7
TGTGCCAGCAGCGGACAGGGGAATACTGAAGCTTTCTTT	CASSGQGNTEAFF	TRBV13	TRBJ1-1
TGTGCCAGCTCACCACCCGTCAGGGGAGCTACTAATGAAAAACTGTTTTTT	CASSPPVRGATNEKLFF	TRBV18	TRBJ1-4
TGTGCCTGCCAGGGGAGGCCGGCTAGCACAGATACGCAGTATTTT	CACQGRPASTDTQYF	TRBV30	TRBJ2-3
TGTGCCAGTAGTATATTTAGACAGGGGACTGGAAACACCATATATTTT	CASSIFRQGTGNTIYF	TRBV19	TRBJ1-3
TGTGCCAGCTCACCACTAGGGTTCGGGGGGGCCCCCGGATACGAGCAGTACTTC	CASSPLGFGGAPGYEQYF	TRBV18	TRBJ2-7
TGCAGTGCTAGACCGGGGGACAGGGGTAGGGGATATGATCAGCCCCAGCATTTT	CSARPGDRGRGYDQPQHF	TRBV20-1	TRBJ1-5
TGTGCCAGCAGCTTAGATGGAGGGGAGCGCATTCAGTACTTC	CASSLDGGERIQYF	TRBV11-2	TRBJ2-4
TGTGCCAGCAGTCCTAGAGGGTCAAGACCATACGAGCAGTACTTC	CASSPRGSRPYEQYF	TRBV28	TRBJ2-7
TGTGCCATCAGTGAAGGGGGCATGAGCTCCTACAATGAGCAGTTCTTC	CAISEGGMSSYNEQFF	TRBV10-3	TRBJ2-1
TGTGCCAGCAGCCAAGATTTCCAGATCTACGAGCAGTACTTC	CASSQDFQIYEQYF	TRBV3-1	TRBJ2-7
TGCAGTAGTTCCTACGACAGTCACGGAAACACCATATATTTT	CSSSYDSHGNTIYF	TRBV20-1	TRBJ1-3
TGTGCCAGCAGTGACTTCTACCCAGGTTGGAGCCTTTGGACAACTAATGAAAAACTGTTTTTT	CASSDFYPGWSLWTTNEKLFF	TRBV6-4	TRBJ1-4
TGCAGTGCGGACACCGAGAACACTGAAGCTTTCTTT	CSADTENTEAFF	TRBV20-1	TRBJ1-1
TGCAGTGCTGTTAAAGTGACCCAGTACTTC	CSAVKVTQYF	TRBV20-1	TRBJ2-5
TGTGCCAGGTTCCCCGGCCTCTCCTATAATTCACCCCTCCACTTT	CARFPGLSYNSPLHF	TRBV13	TRBJ1-6
TGTGCCAGCAGCCCGGGTGGACGGGATGAGCAGTTCTTC	CASSPGGRDEQFF	TRBV3-1	TRBJ2-1
TGTGCCAGCAACAGGGGGCAACATGAAAAACTGTTTTTT	CASNRGQHEKLFF	TRBV2	TRBJ1-4
TGTGCCAGTACGGGGACAGGGGAGACTGAAGCTTTCTTT	CASTGTGETEAFF	TRBV19	TRBJ1-1
TGTGCCAGCGGAGTTGATACGCAGTATTTT	CASGVDTQYF	TRBV7-3	TRBJ2-3
TGCGCCAGCGACGTGGACGGAAATGCCCCCCCCCAGAGTGCAACTAATGAAAAACTGTTTTTT	CASDVDGNAPPQSATNEKLFF	TRBV5-1	TRBJ1-4
TGTGCCAGCAGCCGCTTCTACCTCAGCCCATATCAGCCCCAGCATTTT	CASSRFYLSPYQPQHF	TRBV12-3	TRBJ1-5
TGTGCCAGCAGTGAGGCCAAAAACATTCAGTACTTC	CASSEAKNIQYF	TRBV27	TRBJ2-4
TGTGCCAGCCCCCTACCTTCTCAAAACACCGGGGAGCTGTTTTTT	CASPLPSQNTGELFF	TRBV7-9	TRBJ2-2
TGCGCCAGCACCAATGACAGAATGGGCACTGAAGCTTTCTTT	CASTNDRMGTEAFF	TRBV4-3	TRBJ1-1
TGTGCCAGCAGTTCCCTTTCCATTAACGAGCAGTACTTC	CASSSLSINEQYF	TRBV6-3	TRBJ2-7
TGTGCCAGCGGGGAGGGAAATGAAAAACTGTTTTTT	CASGEGNEKLFF	TRBV12-3	TRBJ1-4
TGTGCCAGCAGCCTGGGCCCCGGCGCACACTATAGCAATCAGCCCCAGCATTTT	CASSLGPGAHYSNQPQHF	TRBV3-1	TRBJ1-5
TGCAGTGCTAGAGTAAAAAAGACTCCCACTGAAGCTTTCTTT	CSARVKKTPTEAFF	TRBV20-1	TRBJ1-1
TGTGCCAGCAGTTTAATCGGACAGGTGGGGGACTCCTACAATGAGCAGTTCTTC	CASSLIGQVGDSYNEQFF	TRBV12-3	TRBJ2-1
TGTGCCAGCACCTGGAAGTCAGGGGGCGCCTACCCTCAGCCCCAGCATTTT	CASTWKSGGAYPQPQHF	TRBV6-5	TRBJ1-5
TGCAGTGCTAGAGGGAGCCCGGGACGGACGCCCTACGAGCAGTACTTC	CSARGSPGRTPYEQYF	TRBV20-1	TRBJ2-7
TGTGCCAGCAGTGATTTCAGGGTACGAGAGACCCAGTACTTC	CASSDFRVRETQYF	TRBV25-1	TRBJ2-5
TGTGCCATTTTGACCAATGAGCAGTTCTTC	CAILTNEQFF	TRBV27	TRBJ2-1
TGCAGTGCTAGAGATTACACAGAGGGGGCGAAGAAGAACACTGAAGCTTTCTTT	CSARDYTEGAKKNTEAFF	TRBV20-1	TRBJ1-1
TGCGCCAGCAGCTCGGGTTCGGTGACAGGGCAAGAGACCCAGTACTTC	CASSSGSVTGQETQYF	TRBV5-1	TRBJ2-5
TGTGCCAGCAGTGGTACGGACAGGGACTACGAGCAGTACTTC	CASSGTDRDYEQYF	TRBV12-4	TRBJ2-7
TGCGCCAGCCTAACACAAAGGGCTCAGCCCCAGCATTTT	CASLTQRAQPQHF	TRBV4-3	TRBJ1-5
TGCAGCGTTCTTCAGGGTCGCTCCTACGAGCAGTACTTC	CSVLQGRSYEQYF	TRBV29-1	TRBJ2-7
TGTGCCAGCAGCCAAATGGGACAGGGAGCCGATAGCAATCAGCCCCAGCATTTT	CASSQMGQGADSNQPQHF	TRBV7-3	TRBJ1-5
TGCGCCAGCAGCCAAGATTCTAGGAACTACGAGCAGTACTTC	CASSQDSRNYEQYF	TRBV4-1	TRBJ2-7
TGTGCCAGCAGTTACCCCTCCGGGACTCATCGTGAGCAGTTCTTC	CASSYPSGTHREQFF	TRBV6-2	TRBJ2-1
TGCGCCAGCAGCCGCAAAAATAGCTCAAATGGCTACACCTTC	CASSRKNSSNGYTF	TRBV5-1	TRBJ1-2
TGCGCCAGCAAGGTGGCTCGCCCCTCTGGAAACACCATATATTTT	CASKVARPSGNTIYF	TRBV10-2	TRBJ1-3
TGTGCCAGCAGCTTGAAGGTGGGACTAGCGGGGGTCGAGACCCAGTACTTC	CASSLKVGLAGVETQYF	TRBV5-6	TRBJ2-5
TGTGCCAGCAGTTACCCCCGTAAACAGGGGAAACTCGACTACGAGCAGTACTTC	CASSYPRKQGKLDYEQYF	TRBV6-6	TRBJ2-7
TGCGCCAGCAGCAATGGGGACAGTGGGAGCTCCTATAATTCACCCCTCCACTTT	CASSNGDSGSSYNSPLHF	TRBV5-1	TRBJ1-6
TGTGCCAGCAGTTACTTTAGTTCCTATGGCTACACCTTC	CASSYFSSYGYTF	TRBV27	TRBJ1-2
TGCGCCAGCAGCTTGGGACTAGCGGGAGATGGCTACACCTTC	CASSLGLAGDGYTF	TRBV5-1	TRBJ1-2
TGTGCCACCAGTGATTTAGTAGGGATAAGGACAGGGTCCCCCTACTATGGCTACACCTTC	CATSDLVGIRTGSPYYGYTF	TRBV24-1	TRBJ1-2
TGCAGTGCTAGATCCGTCGCTGGGGGCACAGGGGACTCTGGAAACACCATATATTTT	CSARSVAGGTGDSGNTIYF	TRBV20-1	TRBJ1-3
TGTGCCAGCAGTGAACGTAGCCATGGGCCTCGTTCTAACTATGGCTACACCTTC	CASSERSHGPRSNYGYTF	TRBV6-1	TRBJ1-2
TGTGCTAGCAGAATCCGGGACAGGGGAGAGTACTTC	CASRIRDRGEYF	TRBV7-7	TRBJ2-7
TGTGCTAGTGGTTACCCAAGAGAACGGAGCACAGATACGCAGTATTTT	CASGYPRERSTDTQYF	TRBV12-5	TRBJ2-3
TGTGCCAGCAGTTTCCGCAGGCCCAGGCGTATTAATGAAAAACTGTTTTTT	CASSFRRPRRINEKLFF	TRBV28	TRBJ1-4
TGTGCCAGCAGCCAAGACCACGGGGGACCGGGACAGGGGATGAACACTGAAGCTTTCTTT	CASSQDHGGPGQGMNTEAFF	TRBV3-1	TRBJ1-1
TGTGCCAGCAGTTTAGCCAGGACCAATCAGCCCCAGCATTTT	CASSLARTNQPQHF	TRBV28	TRBJ1-5
TGTGCCAGCAGCCACACGGCCACTTCCTGGGCAGCTTTCTTT	CASSHTATSWAAFF	TRBV11-3	TRBJ1-1
TGTGCCACCAGCAGAGATTTCGGACAAGGGGCCTACGAGCAGTACTTC	CATSRDFGQGAYEQYF	TRBV15	TRBJ2-7
TGTGCCAGCAACGGGCCCGACACTGAAGCTTTCTTT	CASNGPDTEAFF	TRBV5-6	TRBJ1-1
TGTGCCAGCAGTTCCGGCAAGGGGGATCTGCGGACCCAGTACTTC	CASSSGKGDLRTQYF	TRBV6-5	TRBJ2-5
TGTGCCAGCAGTTACCGACCACTAACGCGGGAGTTCGTGTATAATTCACCCCTCCACTTT	CASSYRPLTREFVYNSPLHF	TRBV6-2	TRBJ1-6
TGTGCCAGCAGCTTGGGGCCTGCAGTCGGGTATGGCTACACCTTC	CASSLGPAVGYGYTF	TRBV7-3	TRBJ1-2
TGTGCCAGCACTATTATGCCCAATGAGCAGTTCTTC	CASTIMPNEQFF	TRBV28	TRBJ2-1
TGTGCCAGCAGCAAGTCCCTACAGGGTGTTCATACTGAAGCTTTCTTT	CASSKSLQGVHTEAFF	TRBV14	TRBJ1-1
TGTGCTAGCAGCTTAGGCTCCCAGTCCTACGAGCAGTACTTC	CASSLGSQSYEQYF	TRBV7-7	TRBJ2-7
TGTGCCAGCACCACCAGGGTACATGGCTACACCTTC	CASTTRVHGYTF	TRBV28	TRBJ1-2
TGTGCCAGCAGCCGTTTCCGGGAGGATGAGCAGTTCTTC	CASSRFREDEQFF	TRBV5-4	TRBJ2-1
TGTGCCAGCAGATGGGTTGGGGATAATTCACCCCTCCACTTT	CASRWVGDNSPLHF	TRBV6-5	TRBJ1-6
TGTGCCATCAGTGAGTCGCCGAGAGCTCGGTTTAACAATGAGCAGTTCTTC	CAISESPRARFNNEQFF	TRBV10-3	TRBJ2-1
TGCGCCAGCAGCCCCCCGGACAGCTTGAACACCGGGGAGCTGTTTTTT	CASSPPDSLNTGELFF	TRBV5-1	TRBJ2-2
TGTGCCAGCAGTTCCGACGTTAACCCGACAGGGACGAATGAGCAGTTCTTC	CASSSDVNPTGTNEQFF	TRBV27	TRBJ2-1
TGCGCCAGCAGTGAATATGGGGGAGGAGTTCGGTTGAACACTGAAGCTTTCTTT	CASSEYGGGVRLNTEAFF	TRBV10-1	TRBJ1-1
TGTGCCAGCAGCTCGGAGGTCCTAGGGGAGTCTCAGGAGTACGAGCAGTACTTC	CASSSEVLGESQEYEQYF	TRBV5-6	TRBJ2-7
TGCAGTGCTAGTTCAGGGGGGGATGAAAAACTGTTTTTT	CSASSGGDEKLFF	TRBV20-1	TRBJ1-4
TGTGCCAGCAGTCTCGACAGGAGCCAAGAGACCCAGTACTTC	CASSLDRSQETQYF	TRBV9	TRBJ2-5
TGTGCCAGTAGGACGTTTCCGGATCTCGATGAGCAGTTCTTC	CASRTFPDLDEQFF	TRBV19	TRBJ2-1
TGCAGTGCTAGGAACGGGGCGCGAGATCTAGAGACCCAGTACTTC	CSARNGARDLETQYF	TRBV20-1	TRBJ2-5
TGTGCCTGGCAGGGCCGCATGAACACTGAAGCTTTCTTT	CAWQGRMNTEAFF	TRBV30	TRBJ1-1
TGTGCCAGCTCCGGGGGGGTGGAGACCCAGTACTTC	CASSGGVETQYF	TRBV25-1	TRBJ2-5
TGTGCCAGCAGCCTTCCAGGGCGCGGTCCTGGAAACCATGGCTACACCTTC	CASSLPGRGPGNHGYTF	TRBV9	TRBJ1-2
TGTGCCAGCAGCAACGGACTGTTAGTCAGCTCCTATAATTCACCCCTCCACTTT	CASSNGLLVSSYNSPLHF	TRBV7-3	TRBJ1-6
TGTGCCACCAGTGATTTGCATCTTGGACAGGGCGGGACTGACAATGAGCAGTTCTTC	CATSDLHLGQGGTDNEQFF	TRBV24-1	TRBJ2-1
TGTGCCAGCAGCGCCGTCCCGGGACTACTGACCTGGCCCTTC	CASSAVPGLLTWPF	TRBV7-3	TRBJ2-7
TGTGCCAGCAGTTTGCTTGGGAGCAACTACGAGCAGTACTTC	CASSLLGSNYEQYF	TRBV12-3	TRBJ2-7
TGTGCCAGCCCAGGAGACTACGAGCAGTACTTC	CASPGDYEQYF	TRBV7-6	TRBJ2-7
TGTGCCTCCCGGGAAAACTGTCGGAATGAGCAGTTCTTC	CASRENCRNEQFF	TRBV24-1	TRBJ2-1
TGTGCCAGCAGTTTATTCATAAGTCGAGCCTGGCCCCAGCATTTT	CASSLFISRAWPQHF	TRBV28	TRBJ1-5
TGTGCCAGCAGCTTAAAGCACCGGGACAGGGTCTGTGGTCTTCTTCGCTACGAGCAGTACTTC	CASSLKHRDRVCGLLRYEQYF	TRBV11-2	TRBJ2-7
TGCAGTGCGCCCCGGCTGCCTGTCTACACCGAGCAGTACTTC	CSAPRLPVYTEQYF	TRBV20-1	TRBJ2-7
TGTGCCAGCAGCGCCGCTAGCGGGGCGCGGAACGAGCAGTACTTC	CASSAASGARNEQYF	TRBV7-3	TRBJ2-7
TGTGCCACCAGTGCTGGGGGCTTCCGCTATGGCTACACCTTC	CATSAGGFRYGYTF	TRBV24-1	TRBJ1-2
TGTGCCAGACAGGGAATGCGGGCCAACGTCCTGACTTTC	CARQGMRANVLTF	TRBV7-8	TRBJ2-6
TGTGCCAGACGGCGACTTCCCACCTCCTACAATGAGCAGTTCTTC	CARRRLPTSYNEQFF	TRBV24-1	TRBJ2-1
TGTGTAGCGGGAATGCAGCCCCAGCATTTT	CVAGMQPQHF	TRBV28	TRBJ1-5
TGCACCGGTAAGAGAAGGGTAGAGACCCAGTACTTC	CTGKRRVETQYF	TRBV29-1	TRBJ2-5
TGCAGCGCAGGGGTAGGGGCTGGTCATGAGCAGTTCTTC	CSAGVGAGHEQFF	TRBV29-1	TRBJ2-1
TGTGCCAGCAGCCCCCCGGGTCAGGGCCGTGCAACTAATGAAAAACTGTTTTTT	CASSPPGQGRATNEKLFF	TRBV13	TRBJ1-4
TGTGCCAGCAGCTTAGGGGCTCGGAGCACAGATACGCAGTATTTT	CASSLGARSTDTQYF	TRBV11-3	TRBJ2-3
TGTGCCAGCAAACAGGGACCTGGTTACAATGAGCAGTTCTTC	CASKQGPGYNEQFF	TRBV3-1	TRBJ2-1
TGTGCCAGTAGTATGGAGGGGGGCATTGATACGCAGTATTTT	CASSMEGGIDTQYF	TRBV19	TRBJ2-3
TGTGCCAAGCAGGGCAATGAGCAGTTCTTC	CAKQGNEQFF	TRBV3-1	TRBJ2-1
TGTGCCAGCACCGGGAGGGAGGAGTACGAGCAGTACTTC	CASTGREEYEQYF	TRBV6-5	TRBJ2-7
TGCGCCAGCAGCCGTACGGCTCGAGGGGGCGTAATGCCCCAGCATTTT	CASSRTARGGVMPQHF	TRBV5-1	TRBJ1-5
TGTGCCAGCAGCGGTCTGCACTATGGCTACACCTTC	CASSGLHYGYTF	TRBV5-6	TRBJ1-2
TGTGCCAGCAGCTTAGCGGGACAGGGGGCTAGCAATCAGCCCCAGCATTTT	CASSLAGQGASNQPQHF	TRBV7-2	TRBJ1-5
TGTGCCAGCAGTCACCGGGACAAGGGGGAGCTGTTTTTT	CASSHRDKGELFF	TRBV6-4	TRBJ2-2
TGTGCCACATGGCCCGGGGCCCCGTACAATGAGCAGTTCTTC	CATWPGAPYNEQFF	TRBV2	TRBJ2-1
TGTGCCAGCAGCTTAGTCCAGTCGGGCCCCCCAACCTACGAGCAGTACTTC	CASSLVQSGPPTYEQYF	TRBV11-2	TRBJ2-7
TGCGCCAGCACGAGGGTGGGGCATGGGGCCAACGTCCTGACTTTC	CASTRVGHGANVLTF	TRBV4-3	TRBJ2-6
TGTGCCAGCAAGAGGGGCCGAAACGAGCAGTACTTC	CASKRGRNEQYF	TRBV25-1	TRBJ2-7
TGTGCTAGTGGGCAAATAAAACGGGGGCCCGGGAGATGGTGCCATCAGCCCCAGCATTTT	CASGQIKRGPGRWCHQPQHF	TRBV12-5	TRBJ1-5
TGTGCCAGCAGCCAAGGGTACCTTCGTCATTTGGGGACTTTTTCCACTGAAGCTTTCTTT	CASSQGYLRHLGTFSTEAFF	TRBV14	TRBJ1-1
TGCGCCAGCAGCCCGGGGAACACTGAAGCTTTCTTT	CASSPGNTEAFF	TRBV5-1	TRBJ1-1
TGTGCCAGCAGCGGGATCTGCGGCAATCAGCCCCAGCATTTT	CASSGICGNQPQHF	TRBV9	TRBJ1-5
TGTGCCAGCATCTACCGGGACAGGGGCGGGACCGGGGAGCTGTTTTTT	CASIYRDRGGTGELFF	TRBV6-5	TRBJ2-2
TGTGCCAGCAGCTTATTCCTAGGGGGGAATCAGCCCCAGCATTTT	CASSLFLGGNQPQHF	TRBV7-6	TRBJ1-5
TGTGCCAGCAGCGTCCTGGGGGAAGAAAAGGGGGTTAGGGGATCTTCCTACGAGCAGTACTTC	CASSVLGEEKGVRGSSYEQYF	TRBV5-6	TRBJ2-7
TGTGCCACCAGTGACAAGGACAGGGAGTTAGATACGCAGTATTTT	CATSDKDRELDTQYF	TRBV24-1	TRBJ2-3
TGTGCCAGCAGCGCCTGCAGGGTCCGGGATTCGCTTACCGGGGAGCTGTTTTTT	CASSACRVRDSLTGELFF	TRBV9	TRBJ2-2
TGTGCCAGCAGTTACCCCTGGACCTATGGCTACACCTTC	CASSYPWTYGYTF	TRBV6-2	TRBJ1-2
TGTGCCAGCAGTCAGGGGGAGGGTGAAGCTTTCTTT	CASSQGEGEAFF	TRBV9	TRBJ1-1
TGTGCCAGCAGCGGGCTGGCGGGGACAGGGACTACCACAGATACGCAGTATTTT	CASSGLAGTGTTTDTQYF	TRBV7-2	TRBJ2-3
TGTGCCTGGATTGGGATTCCGAACTATGGCTACACCTTC	CAWIGIPNYGYTF	TRBV30	TRBJ1-2
TGTGCCAGCAGCGAGGAGGAGAACACTGAAGCTTTCTTT	CASSEEENTEAFF	TRBV7-8	TRBJ1-1
TGTGCCAGCAGTGACTCAGGGGCTGAAGCTTTCTTT	CASSDSGAEAFF	TRBV6-4	TRBJ1-1
TGTGCCAGCAGGGTGTCCGACACCGGGGAGCTGTTTTTT	CASRVSDTGELFF	TRBV28	TRBJ2-2
TGCGCCAGCAGCCAAGAACGGAGGATAGGGGATGAGCAGTTCTTC	CASSQERRIGDEQFF	TRBV4-3	TRBJ2-1
TGTGCCTGCCCTAGCGCGACAAACTCCTACGAGCAGTACTTC	CACPSATNSYEQYF	TRBV30	TRBJ2-7
TGCGCCAGCAGCCGACACGAACCCCAGCATTTT	CASSRHEPQHF	TRBV4-1	TRBJ1-5
TGCACCCCGGGGGTGTTTGGGGATCAGCCCCAGCATTTT	CTPGVFGDQPQHF	TRBV20-1	TRBJ1-5
TGTGCCACCAGTGATTTGCCTACGCGGGAGGTCCGTCAGGCTTTCTTT	CATSDLPTREVRQAFF	TRBV24-1	TRBJ1-1
TGCGCCAGCAGTGAGTGGGGACAGGAGACCCAGTACTTC	CASSEWGQETQYF	TRBV10-2	TRBJ2-5
TGCAGTGCTACGAAACTTCCGGGACTAGCGGGAGAGACCCAGTACTTC	CSATKLPGLAGETQYF	TRBV20-1	TRBJ2-5
TGTGCCAGCAGCTTAGTTATCGGGACTAGCGGGGGGGCCCTTCGAATATCAGATACGCAGTATTTT	CASSLVIGTSGGALRISDTQYF	TRBV7-6	TRBJ2-3
TGTGCCAGCAGCCGACAGAAATCATGGATTAACTATGGCTACACCTTC	CASSRQKSWINYGYTF	TRBV3-1	TRBJ1-2
TGCGCCAGCAGCTTGGGACCACGAGGGGTCCGGCACCTGTTTTTT	CASSLGPRGVRHLFF	TRBV5-1	TRBJ1-4
TGTGCCAGGTTAGGGGGAGTTTCGTCGCAGTACTTC	CARLGGVSSQYF	TRBV27	TRBJ2-7
TGTGCCAGCAGCTTACCGGGACAGTCCAGCATGAACACTGAAGCTTTCTTT	CASSLPGQSSMNTEAFF	TRBV11-3	TRBJ1-1
TGTGCCAGCAGTTTATCGGTATTGCTGCCGGGACTAGCGGGAGACTACGGCGAGCAGTACTTC	CASSLSVLLPGLAGDYGEQYF	TRBV27	TRBJ2-7
TGTGCCAGCAGCCACGACGGGGGCAGTGAGCGGTTTACTAGCAATCAGCCCCAGCATTTT	CASSHDGGSERFTSNQPQHF	TRBV3-1	TRBJ1-5
TGTGCCAGCAGGCCACGGGACAGGGAGGTAAAACTGTTTTTT	CASRPRDREVKLFF	TRBV2	TRBJ1-4
TGCGCCAGCAGCTTGTCCCCCAGGGGGGGCCGAACAATACAGCAGGCTGAGCAGTTCTTC	CASSLSPRGGRTIQQAEQFF	TRBV5-1	TRBJ2-1
TGCGCCAGCAGGATCAGGGACAGGGGGGTGGTCCCAAATGAAAAACTGTTTTTT	CASRIRDRGVVPNEKLFF	TRBV10-2	TRBJ1-4
TGTGCCAGCAGCCCGGCGAAGAATGAGCAGTTCTTC	CASSPAKNEQFF	TRBV12-3	TRBJ2-1
TGTGCCAGCTCACGACGACAGGGTAAATTCACCATATATTTT	CASSRRQGKFTIYF	TRBV18	TRBJ1-3
TGTGCCAGCAGTTTGGGGCACCGTACAGGGGGCTACGGAGATACGCAGTATTTT	CASSLGHRTGGYGDTQYF	TRBV27	TRBJ2-3
TGTGCCAGCAGTTTGAAACAGGGGGCTGGGGGCACAGATACGCAGTATTTT	CASSLKQGAGGTDTQYF	TRBV28	TRBJ2-3
TGTGCCAGCCTCGGCGGGAGGGCACAAGGAAACACCATATATTTT	CASLGGRAQGNTIYF	TRBV9	TRBJ1-3
TGTGCCAGCAGAGAGTCGGGACCTTCCTACAATGAGCAGTTCTTC	CASRESGPSYNEQFF	TRBV9	TRBJ2-1
TGCAGTGCTATTCCCGGAGGCCCAGCGGGCACAGATACGCAGTATTTT	CSAIPGGPAGTDTQYF	TRBV20-1	TRBJ2-3
TGTGCCAGCAGCTCCTTAGACGGTTCGCTTTCGGAAGGTTCCTACAATGAGCAGTTCTTC	CASSSLDGSLSEGSYNEQFF	TRBV7-9	TRBJ2-1
TGTGCCAGTAACCACTGGGGGGGGGGGAGGCAGTTCTTC	CASNHWGGGRQFF	TRBV19	TRBJ2-1
TGTGCCATTAGTATTGATTCACCCCTCCACTTT	CAISIDSPLHF	TRBV3-1	TRBJ1-6
TGTGCCACCAGCAGTCTCTGCAGAGGGAAAAACAATGAGCAGTTCTTC	CATSSLCRGKNNEQFF	TRBV15	TRBJ2-1
TGTGCCAGCAGCCCAGGAACCAGGGGCACCATCACAGATACGCAGTATTTT	CASSPGTRGTITDTQYF	TRBV13	TRBJ2-3
TGTGCCAAGCCCCGCGTCAGAGTTGAGCCGGACGATCAGCCCCAGCATTTT	CAKPRVRVEPDDQPQHF	TRBV24-1	TRBJ1-5
TGCGCCAGCAGCAAGGGCGTTCTCGCGGAGACCCAGTACTTC	CASSKGVLAETQYF	TRBV5-1	TRBJ2-5
TGTGCCAGCAGGCTCGAAGGGCGGATCGACGAGCAGTACTTC	CASRLEGRIDEQYF	TRBV6-1	TRBJ2-7
TGTGCCAGTATCCCGAGCGATTGCCAGGAGCCCCAGCATTTT	CASIPSDCQEPQHF	TRBV19	TRBJ1-5
TGTGCCAGCAGATCGGGGGAATTGGTTAACACTGAAGCTTTCTTT	CASRSGELVNTEAFF	TRBV14	TRBJ1-1
TGCGCCAGCAGCAACTGCGGGGTGGCCTACGAGCAGTACTTC	CASSNCGVAYEQYF	TRBV4-3	TRBJ2-7
TGTGCCAGCAATAGACAGGTGAACACCGGGGAGCTGTTTTTT	CASNRQVNTGELFF	TRBV7-9	TRBJ2-2
TGTGCCAGCAGCACAGGGGGGGGGGGGGTGCGCTCCTACAATGAGCAGTTCTTC	CASSTGGGGVRSYNEQFF	TRBV7-4	TRBJ2-1
TGTGCCAGCTCACCGGCTCCGGGAGGGGTATCCTACGAGCAGTACTTC	CASSPAPGGVSYEQYF	TRBV18	TRBJ2-7
TGTGCCAGTAGCATCAGGGGGCGAGACGCTGAAGCTTTCTTT	CASSIRGRDAEAFF	TRBV19	TRBJ1-1
TGTGCCAGCAGCTTAACCGCTGCGGGAGCTGAAGCTTTCTTT	CASSLTAAGAEAFF	TRBV5-5	TRBJ1-1
TGTGCCAGCGAGACAGATAAACAGGTCGGGGGGGCCAACGTCCTGACTTTC	CASETDKQVGGANVLTF	TRBV7-3	TRBJ2-6
TGTGCCAGCAGCGGGCCGCATTATAGCAATCAGCCCCAGCATTTT	CASSGPHYSNQPQHF	TRBV7-3	TRBJ1-5
TGCGCCAGCAAGGCTTGTGGCTACACCTTC	CASKACGYTF	TRBV4-1	TRBJ1-2
TGTGCCAGCAGCAAACTAGCGGGCGATACGCAGTATTTT	CASSKLAGDTQYF	TRBV7-3	TRBJ2-3
TGCACCCTGGGGGGGCCCCGCACAGATACGCAGTATTTT	CTLGGPRTDTQYF	TRBV20-1	TRBJ2-3
TGCGCCAGCACTGGACAGGCGGGTCACAATCAGCCCCAGCATTTT	CASTGQAGHNQPQHF	TRBV4-1	TRBJ1-5
TGTGCCAGCAGCCAACCAATCCGGGACCCTTACGAGCAGTACTTC	CASSQPIRDPYEQYF	TRBV3-1	TRBJ2-7
TGTGCCAGCAGCGGAGTGGTCATTGACGTCCGGACAGCTGGAGGTGGGGCCAACGTCCTGACTTTC	CASSGVVIDVRTAGGGANVLTF	TRBV5-6	TRBJ2-6
TGTGCCAGCAGCTTCTCCCGGGCTCATCGCACAGATACGCAGTATTTT	CASSFSRAHRTDTQYF	TRBV11-3	TRBJ2-3
TGTGCCAGCCCAGACTCAAAGAGCAATCAGCCCCAGCATTTT	CASPDSKSNQPQHF	TRBV6-4	TRBJ1-5
TGTGCCAGCAGAGGGGGCGCAGGGGACTATGGCTACACCTTC	CASRGGAGDYGYTF	TRBV27	TRBJ1-2
TGTGCCAGCAGCCAAGACGGGGGAGGCTTCGCCGGGGAGCTGTTTTTT	CASSQDGGGFAGELFF	TRBV3-1	TRBJ2-2
TGTGCCACCAGTGGCAAGGGGCCGCAGCCCCAGCATTTT	CATSGKGPQPQHF	TRBV24-1	TRBJ1-5
TGCGCCAGCAGCTTGGTTGTCCGGGGTACAACTAATGAAAAACTGTTTTTT	CASSLVVRGTTNEKLFF	TRBV5-1	TRBJ1-4
TGTGCCAGCAGCGGGGATAAGACAGGGTTGGTGCATCAGCCCCAGCATTTT	CASSGDKTGLVHQPQHF	TRBV9	TRBJ1-5
TGTGCCAGCAGCCCCCCAGGAAGGCCTGGGGCCAACGTCCTGACTTTC	CASSPPGRPGANVLTF	TRBV13	TRBJ2-6
TGTGCCAGCAGCCGGGAAGGGGGGGAGCAGTTCTTC	CASSREGGEQFF	TRBV7-9	TRBJ2-1
TGCGCCAGCAGTGAGCCCCAGGCTAGTGACAGCGCGGGCAATCAGCCCCAGCATTTT	CASSEPQASDSAGNQPQHF	TRBV10-1	TRBJ1-5
TGTGCCAGCAGTTGGTACCGGGGGCGGGAAGGGGAGCTGTTTTTT	CASSWYRGREGELFF	TRBV6-2	TRBJ2-2
TGTGCCAGCACTTCGGGGCATGGCTACACCTTC	CASTSGHGYTF	TRBV6-2	TRBJ1-2
TGTGCCAGCAGCAAAGGGACTAGCGGGTACAGGGGCTACAATGAGCAGTTCTTC	CASSKGTSGYRGYNEQFF	TRBV11-3	TRBJ2-1
TGCAGTGCTCCGGGACTAGCGGGGGGGCGTGGAGAGACCCAGTACTTC	CSAPGLAGGRGETQYF	TRBV20-1	TRBJ2-5
TGCGCCAGCAGCATGCGGGACAGGCCATACAATGAGCAGTTCTTC	CASSMRDRPYNEQFF	TRBV5-1	TRBJ2-1
TGTGCCAGCAGTGACTCGAATAGGGACGGCGGGGGGGTCCATAACGAGCAGTACTTC	CASSDSNRDGGGVHNEQYF	TRBV6-4	TRBJ2-7
TGTGCCAAGGGACAGTTTAATGGCTACACCTTC	CAKGQFNGYTF	TRBV12-3	TRBJ1-2
TGTGCCAGCAGCTTGACAGGGTCCTACGAGCAGTACTTC	CASSLTGSYEQYF	TRBV12-4	TRBJ2-7
TGTGCCTGGCTTAGGGACAGGGCCATTGTGAACACTGAAGCTTTCTTT	CAWLRDRAIVNTEAFF	TRBV30	TRBJ1-1
TGTGCCAGCAGCGACAGGGGCCTGTCCTACGAGCAGTACTTC	CASSDRGLSYEQYF	TRBV7-3	TRBJ2-7
TGTGCCAGCAGTGTGGGACAGGGCTATGGCTACACCTTC	CASSVGQGYGYTF	TRBV27	TRBJ1-2
TGTGCCAGCAGCCAAAGGGGGACAGGGCCCTACGAGCAGTACTTC	CASSQRGTGPYEQYF	TRBV9	TRBJ2-7
TGTGCCAGCAGCCTACACGGGTATGAGCAGTTCTTC	CASSLHGYEQFF	TRBV3-1	TRBJ2-1
TGTGCCAGCAGTTTTTGTCCCGTGAGGACCCAGTACTTC	CASSFCPVRTQYF	TRBV28	TRBJ2-5
TGCGCCAGCAGCTCAGGGACTAGCGGCACAGATACGCAGTATTTT	CASSSGTSGTDTQYF	TRBV5-1	TRBJ2-3
TGTGCCAGCAGCTTAGGCGGGGATTCCCCGACAGGGGGCTACGAGCAGTACTTC	CASSLGGDSPTGGYEQYF	TRBV7-8	TRBJ2-7
TGTGCCAGCAGCTGGCCATCTAGCGGCACCGGGGAGCTGTTTTTT	CASSWPSSGTGELFF	TRBV7-9	TRBJ2-2
TGTGCCAGCAGTGACAGCCTCGGGACTGCAGGGGTAGAGACCCAGTACTTC	CASSDSLGTAGVETQYF	TRBV6-4	TRBJ2-5
TGTGCCAGCAGCAAACCGGTTACCTTAGCGGGTGAGGGGTACAGAGAAGATACGCAGTATTTT	CASSKPVTLAGEGYREDTQYF	TRBV7-9	TRBJ2-3
TGTGCCAGCAGCCCCCGGCCTCCAATTTTACAGGGCACTGGAAACACCATATATTTT	CASSPRPPILQGTGNTIYF	TRBV6-5	TRBJ1-3
TGCAGTGCTACTCAGGGGGCCCAGCAGTACTTC	CSATQGAQQYF	TRBV20-1	TRBJ2-7
TGTGTATTCGGACAGGCCCACGAGCAGTACTTC	CVFGQAHEQYF	TRBV6-4	TRBJ2-7
TGTCGGCGCGGGGAGAAAGATACGCAGTATTTT	CRRGEKDTQYF	TRBV29-1	TRBJ2-3
TGTGCCACCAGCAGACTACAGGAACAGCCCCAGCATTTT	CATSRLQEQPQHF	TRBV15	TRBJ1-5
TGCGCCAGCAGTGAGAGGGGGACGGGCTCTGGAAACACCATATATTTT	CASSERGTGSGNTIYF	TRBV10-1	TRBJ1-3
TGTGCCAGCAGCCCCCAAAAGCTTGACGATTCCTACGAGCAGTACTTC	CASSPQKLDDSYEQYF	TRBV13	TRBJ2-7
TGCAGTGCTAGCCTTGTTAAAGTCCCCTACGAGCAGTACTTC	CSASLVKVPYEQYF	TRBV20-1	TRBJ2-7
TGTGCGACACCGGGGGGGCGAGAGCAGTTCTTC	CATPGGREQFF	TRBV6-2	TRBJ2-1
TGTGCCAGCAGCTCCTCCAACTCAGGGACAGGGGTAGACTACGAGCAGTACTTC	CASSSSNSGTGVDYEQYF	TRBV13	TRBJ2-7
TGTGCCAGCAGCACTGCTATCGAGCAGTTCTTC	CASSTAIEQFF	TRBV7-9	TRBJ2-1
TGTGCCACCAGTGATGGGACAGAGAGGAGAGTTAATTCACCCCTCCACTTT	CATSDGTERRVNSPLHF	TRBV24-1	TRBJ1-6
TGCAGTGCACCCCAGCTCCAGCACGAGCAGTACTTC	CSAPQLQHEQYF	TRBV20-1	TRBJ2-7
TGTGCCAGAGACAAGGCGAACACTGAAGCTTTCTTT	CARDKANTEAFF	TRBV28	TRBJ1-1
TGTGCCAGCAGCCTTGGGGGGGCTTGGGTGAAAGAGACCCAGTACTTC	CASSLGGAWVKETQYF	TRBV13	TRBJ2-5
TGTGCCAGCAGAGCAGGGCAGAACACCGGGGAGCTGTTTTTT	CASRAGQNTGELFF	TRBV6-3	TRBJ2-2
TGTGCCAGCCCCCGGGGCGCAGGCGGGGAGCTGTTTTTT	CASPRGAGGELFF	TRBV6-1	TRBJ2-2
TGTGCCAGCAGCCCCCGGGCTAGAACTAACACTGAAGCTTTCTTT	CASSPRARTNTEAFF	TRBV14	TRBJ1-1
TGTGCCACCAGTGGGGACTTAGAGACCCAGTACTTC	CATSGDLETQYF	TRBV24-1	TRBJ2-5
TGTGCCACTCTGATCGCAGGCCGGAGTTGTGAGCAGTTCTTC	CATLIAGRSCEQFF	TRBV19	TRBJ2-1
TGTGCCAGCAGCAGCGACGCGGGACGAGATGAGCAGTTCTTC	CASSSDAGRDEQFF	TRBV6-5	TRBJ2-1
TGCGCCAGCAGTGAGGGACAGGGTCAGCCCCAGCATTTT	CASSEGQGQPQHF	TRBV10-1	TRBJ1-5
TGTGCCAGCAGCGTCGACAGGGGTTCGGGCTACACCTTC	CASSVDRGSGYTF	TRBV12-3	TRBJ1-2
TGTGCCAGCAGCTCAGGGTTGCCGGTGATAGGGTCTGAAAAACTGTTTTTT	CASSSGLPVIGSEKLFF	TRBV7-6	TRBJ1-4
TGTGCCTGGAGTGCGCCACCCAGCATATGGCGAAAACATACGCAGTATTTT	CAWSAPPSIWRKHTQYF	TRBV30	TRBJ2-3
TGTGCCATCGTGATTGAAAGCGGGAAGACAGAGACCCAGTACTTC	CAIVIESGKTETQYF	TRBV10-3	TRBJ2-5
TGCAGCGTGCTACTAGCGGGCAATGAGCAGTTCTTC	CSVLLAGNEQFF	TRBV29-1	TRBJ2-1
TGTGCCAGCAGGGGGTTGGATCTAGCGGGTCCCGGGGAGCTGTTTTTT	CASRGLDLAGPGELFF	TRBV7-2	TRBJ2-2
TGTGCCAGAGGACTAGCGGGCACCGGGGAGCTGTTTTTT	CARGLAGTGELFF	TRBV7-2	TRBJ2-2
TGCGCCAGCAGCCCTTTGATGGACAGCTCTGGAAACACCATATATTTT	CASSPLMDSSGNTIYF	TRBV4-3	TRBJ1-3
TGTGCCAGCAGTTCCCTCGGGACAGTACATGGCTCTGGAAACACCATATATTTT	CASSSLGTVHGSGNTIYF	TRBV7-3	TRBJ1-3
TGTGCCAGCAGTGGCTTTCTCAGAACCGAGAACTCTGGAAACACCATATATTTT	CASSGFLRTENSGNTIYF	TRBV28	TRBJ1-3
TGTGCCTGGAGCCTGGGCCCGCGAGACGAGCAGTACTTC	CAWSLGPRDEQYF	TRBV30	TRBJ2-7
TGTGCCAGCAGCGTAGTGGGACAGGGGCAGATCCATGGCTACACCTTC	CASSVVGQGQIHGYTF	TRBV9	TRBJ1-2
TGTGCCAGCAGCTCCCCGACAGGGCTTATAGAGACCCAGTACTTC	CASSSPTGLIETQYF	TRBV11-3	TRBJ2-5
TGTGCCAGCAGTTATAGAGTAGGGACAGGGGTAACCACAGATACGCAGTATTTT	CASSYRVGTGVTTDTQYF	TRBV6-2	TRBJ2-3
TGCGCCAGTGATAGGACAGTAAAACTGTTTTTT	CASDRTVKLFF	TRBV10-1	TRBJ1-4
TGTGCCAGCAGCTTCCGGGACAGGGACTACGAGCAGTACTTC	CASSFRDRDYEQYF	TRBV11-3	TRBJ2-7
TGTGCCAGCAGGGCGCAGGTCTGCTGCTACGAGCAGTACTTC	CASRAQVCCYEQYF	TRBV6-4	TRBJ2-7
TGTGCTAGCACACAGGGGGCAGAGCAAGGCTACGAGCAGTACTTC	CASTQGAEQGYEQYF	TRBV7-7	TRBJ2-7
TGCGCCAGCAGCTTGGTCTCCGGGACATGGCGGGACGGGGAGCTGTTTTTT	CASSLVSGTWRDGELFF	TRBV5-1	TRBJ2-2
TGTGCCGGGACAGGGGGAGGCAATCAGCCCCAGCATTTT	CAGTGGGNQPQHF	TRBV10-3	TRBJ1-5
TGCAGTGCTAGAGGTTTAATACCTAGGGGTTCGGAGAACACTGAAGCTTTCTTT	CSARGLIPRGSENTEAFF	TRBV20-1	TRBJ1-1
TGTGCCAGCAGCTTAGCGGGACATCGAAGGGAAAAACTGTTTTTT	CASSLAGHRREKLFF	TRBV7-9	TRBJ1-4
TGCGCCACCAAGTTGGCGACAGGGGCACCCCTCCACTTT	CATKLATGAPLHF	TRBV10-1	TRBJ1-6
TGTGCCAGCATGGTACTGACAGGGGGCCCGGTGTCAACTAATGAAAAACTGTTTTTT	CASMVLTGGPVSTNEKLFF	TRBV9	TRBJ1-4
TGCCTGCACAGGGATGAGGCCTACGAGCAGTACTTC	CLHRDEAYEQYF	TRBV20-1	TRBJ2-7
TGTGCCAGGGTGGACCACGAGAACTATGGCTACACCTTC	CARVDHENYGYTF	TRBV7-9	TRBJ1-2
TGTGCCAGCAAAAGAGGGGGGGGGGTTTCACCCCTCCACTTT	CASKRGGGVSPLHF	TRBV6-4	TRBJ1-6
TGTGCCAGCAGCCCGGGGAAGTGGGCCGGGGAGCTGTTTTTT	CASSPGKWAGELFF	TRBV7-2	TRBJ2-2
TGTGCCAGCAGGGACAGGTCTACCACTGGGTACGAGCAGTACTTC	CASRDRSTTGYEQYF	TRBV6-4	TRBJ2-7
TGTGCCAGCAATAAACTATCTATCTTCAAGGGTTCACCCCTCCACTTT	CASNKLSIFKGSPLHF	TRBV6-2	TRBJ1-6
TGTGCCAGCAGCGGTGTGGGACAGGGTGCTCAGACCCAGTACTTC	CASSGVGQGAQTQYF	TRBV13	TRBJ2-5
TGTGCCAGCAGCGTAGATTCCTCGAGAAACCGGCGGGCTGGACAGCCCCAGCATTTT	CASSVDSSRNRRAGQPQHF	TRBV9	TRBJ1-5
TGTGCCAGCAGCTTATGGAAGAGGGGGAGAGGGTCTGGAAACACCATATATTTT	CASSLWKRGRGSGNTIYF	TRBV7-3	TRBJ1-3
TGTGCCAGCAGCCTACCTTCCGGGGACACTGAAGCTTTCTTT	CASSLPSGDTEAFF	TRBV4-2	TRBJ1-1
TGTGCCAGCGGGGACAGGGGACCCACAGATACGCAGTATTTT	CASGDRGPTDTQYF	TRBV14	TRBJ2-3
TGTGCTAGTGGTTTGCGGGACAGCCCAACTAATGAAAAACTGTTTTTT	CASGLRDSPTNEKLFF	TRBV12-5	TRBJ1-4
TGTGCCAGCGAGCGGGGCCCGGGCCGGAACACTGAAGCTTTCTTT	CASERGPGRNTEAFF	TRBV14	TRBJ1-1
TGTGCCAGCAGTGACAAGGCCCCCTATGGCTACACCTTC	CASSDKAPYGYTF	TRBV6-4	TRBJ1-2
TGTGCCAGCAGCTTACCAGGACAGGGCCCCCGAGCCAAAAACATTCAGTACTTC	CASSLPGQGPRAKNIQYF	TRBV11-3	TRBJ2-4
TGTGCCAGCAGCCGGCGGGGCGGCGGCTACACCTTC	CASSRRGGGYTF	TRBV7-4	TRBJ1-2
TGTGCCAGCAGTTGGGACAGGGGAACAGGCAATCAGCCCCAGCATTTT	CASSWDRGTGNQPQHF	TRBV6-5	TRBJ1-5
TGTGCCAGCAGCGAAATAGGGTCAGGCTATAGCAATCAGCCCCAGCATTTT	CASSEIGSGYSNQPQHF	TRBV7-2	TRBJ1-5
TGTGCCAGCAGCGTCCCCCCGGGACTCAATGAGCAGTTCTTC	CASSVPPGLNEQFF	TRBV7-3	TRBJ2-1
TGTGCCAGCAGCCAAACCAGGGCGAAGGATAGCAATCAGCCCCAGCATTTT	CASSQTRAKDSNQPQHF	TRBV14	TRBJ1-5
TGTGCCAGCAGTTCAGGGGTGGTGGATACCCATGAAAAACTGTTTTTT	CASSSGVVDTHEKLFF	TRBV6-3	TRBJ1-4
TGTGCCAGCAGTGAATTAGGGTGCCCCGAGCAGTACTTC	CASSELGCPEQYF	TRBV2	TRBJ2-7
TGTGCCACCAGTGCCTCCAATTGGGGGGGCTACGAGCAGTACTTC	CATSASNWGGYEQYF	TRBV24-1	TRBJ2-7
TGCGCCCAGCCCGGGGGGTACCCGAACACCGGGGAGCTGTTTTTT	CAQPGGYPNTGELFF	TRBV4-3	TRBJ2-2
TGTGCCTGGATGACGGAGCCCCAGCATTTT	CAWMTEPQHF	TRBV30	TRBJ1-5
TGTGCCAGCAGCCCATCCCTTTCCCTAGCGGGGCATGGCAATGAGCAGTTCTTC	CASSPSLSLAGHGNEQFF	TRBV3-1	TRBJ2-1
TGCGCCAGCAGCTGGGAGGACAGGGAGGCCTGTAACTATGGCTACACCTTC	CASSWEDREACNYGYTF	TRBV5-1	TRBJ1-2
TGTGCCAGCAGCTTAGGGGTTTCACCCCTCCACTTT	CASSLGVSPLHF	TRBV11-3	TRBJ1-6
TGTGCCTGGAGTGTAGTGAGGGGAGGAAGGGGTTCGGCCTATAATTCACCCCTCCACTTT	CAWSVVRGGRGSAYNSPLHF	TRBV30	TRBJ1-6
TGCACGTACCTAAGTAAGGTAAGCTCCTACAATGAGCAGTTCTTC	CTYLSKVSSYNEQFF	TRBV20-1	TRBJ2-1
TGTGCCAGCAGCTTCCTGGGACAGGTGGGGACTGAAGCTTTCTTT	CASSFLGQVGTEAFF	TRBV11-2	TRBJ1-1
TGTGCCAGCAGCGGCCATGCCCCCACATGGGGGCTTGGCTACACCTTC	CASSGHAPTWGLGYTF	TRBV13	TRBJ1-2
TGTGCCATTACCGGGACAGGGGGGGAAGATACGCAGTATTTT	CAITGTGGEDTQYF	TRBV6-4	TRBJ2-3
TGTGCCAGCAGTTTATCGGGAAGGGGTCGAAACCCCAACACCGGGGAGCTGTTTTTT	CASSLSGRGRNPNTGELFF	TRBV28	TRBJ2-2
TGTGCCAGCACAAAGAGGGACGAGCAGTACTTC	CASTKRDEQYF	TRBV7-3	TRBJ2-7
TGCGCCAGCAGCTTAACCCTGTCAGGATTGGCCACAGATACGCAGTATTTT	CASSLTLSGLATDTQYF	TRBV5-1	TRBJ2-3
TGTGCCAGCAGCCCTGGGACAGACGAGCAGTACTTC	CASSPGTDEQYF	TRBV11-2	TRBJ2-7
TGTGCCAGCAGCCCCCTTCCCGGGACAGGGGGAAGTGAAAAACTGTTTTTT	CASSPLPGTGGSEKLFF	TRBV2	TRBJ1-4
TGTGCCAGCAAAGTTGGGACAGGTAATTCTGAAGCTTTCTTT	CASKVGTGNSEAFF	TRBV2	TRBJ1-1
TGTGCCAGCAGTTACTGCGGGGGATCAGATACGCAGTATTTT	CASSYCGGSDTQYF	TRBV6-5	TRBJ2-3
TGTGCCAGGACAGGGCATAACCAAGCTTTCTTT	CARTGHNQAFF	TRBV6-6	TRBJ1-1
TGTGCCAGCAGCTTCAGGAAGGCACCCCTCCACTTT	CASSFRKAPLHF	TRBV7-2	TRBJ1-6
TGTGCCAGCAGCTTAGCCGACAGCGAAAAACTGTTTTTT	CASSLADSEKLFF	TRBV11-2	TRBJ1-4
TGTGCCAGCAGCAGTGGACAGCGCCATAATGAAAAACTGTTTTTT	CASSSGQRHNEKLFF	TRBV9	TRBJ1-4
TGCGCCAGCAAGACGTTACAGCGGGAGGGCTCCTACGAGCAGTACTTC	CASKTLQREGSYEQYF	TRBV5-1	TRBJ2-7
TGTGCCACCAGCCGATGTGCGAACACTGAAGCTTTCTTT	CATSRCANTEAFF	TRBV15	TRBJ1-1
TGTGCCAGCAGCCTCAAGGTATTGGGGACTAGCGCGGACACAGATACGCAGTATTTT	CASSLKVLGTSADTDTQYF	TRBV3-1	TRBJ2-3
TGTGCCAGCAGCGTAACGGGTTGCCCGGGGCGCTACGAGCAGTACTTC	CASSVTGCPGRYEQYF	TRBV9	TRBJ2-7
TGTGCCAGCAGTGAATCTCTGCAGCCCGATAGAACGTCACGATTTGAGCAGTTCTTC	CASSESLQPDRTSRFEQFF	TRBV25-1	TRBJ2-1
TGCTCCCGGCTTGGGGGGTCCTACAATGAGCAGTTCTTC	CSRLGGSYNEQFF	TRBV20-1	TRBJ2-1
TGTGCCAGCAGCTGTAGGGAGACCCAGTACTTC	CASSCRETQYF	TRBV7-9	TRBJ2-5
TGTGCCAGCAGTGAAGAGGGGTCGGGACTCAGGACGGGGGCAACTAATGAAAAACTGTTTTTT	CASSEEGSGLRTGATNEKLFF	TRBV2	TRBJ1-4
TGTGCCAGCGACAGGGACGATGGCTACACCTTC	CASDRDDGYTF	TRBV5-6	TRBJ1-2
TGTGCCTGGAGTGGGACTAGCGGATTAAAGGGGAGTCAAGAGACCCAGTACTTC	CAWSGTSGLKGSQETQYF	TRBV30	TRBJ2-5
TGCAGCGGGGACAGGGAGGACGCAGATACGCAGTATTTT	CSGDREDADTQYF	TRBV29-1	TRBJ2-3
TGCGCCAGCAGCCCCCAGACAACCAATCAGCCCCAGCATTTT	CASSPQTTNQPQHF	TRBV5-1	TRBJ1-5
TGTGCCAGCAGATCGAAGGACAGGGGGCATCAGCCCCAGCATTTT	CASRSKDRGHQPQHF	TRBV2	TRBJ1-5
TGTGCCACCCGGACGCTGGGGTATAATTCACCCCTCCACTTT	CATRTLGYNSPLHF	TRBV11-2	TRBJ1-6
TGTGATGAAAGACCGACACAGGGGGAGACCCAGTACTTC	CDERPTQGETQYF	TRBV6-2	TRBJ2-5
TGTGCCAGCGCCCCAATGGACAGGGGGCGGATATGGTACGAGCAGTACTTC	CASAPMDRGRIWYEQYF	TRBV28	TRBJ2-7
TGTGCCAGCAGTGATCATTTAAACCGGGACAGGGGCCGATCCCATAGCAATCAGCCCCAGCATTTT	CASSDHLNRDRGRSHSNQPQHF	TRBV6-1	TRBJ1-5
TGCGCCAGCAGCTGGTTAAAATGTGGGCGCCAAGAGACCCAGTACTTC	CASSWLKCGRQETQYF	TRBV4-3	TRBJ2-5
TGTGCCAGCAGCGGTAGGGCAGATACGCAGTATTTT	CASSGRADTQYF	TRBV7-9	TRBJ2-3
TGCGCCAGCAGCTTGGTCTCCTTCCCGTCCTTGGACTGTTATCGTTCCTACGAGCAGTACTTC	CASSLVSFPSLDCYRSYEQYF	TRBV5-1	TRBJ2-7
TGTGCCAGCAGCGTAGCCAGGGCGGCCGAGACCCAGTACTTC	CASSVARAAETQYF	TRBV9	TRBJ2-5
TGCAGCGTTTTCCAGGCAGCGGAACCCTCGAACACCGGGGAGCTGTTTTTT	CSVFQAAEPSNTGELFF	TRBV29-1	TRBJ2-2
TGTGCCACCAAAGGGACAGGGGAAGAGACCCAGTACTTC	CATKGTGEETQYF	TRBV24-1	TRBJ2-5
TGTGCCAGCAGATACGGACAAGTCTCTGGAAACACCATATATTTT	CASRYGQVSGNTIYF	TRBV6-5	TRBJ1-3
TGCGCCAGCAGCCACCGGGACAGGACCCACACAGATACGCAGTATTTT	CASSHRDRTHTDTQYF	TRBV4-3	TRBJ2-3
TGTGCCAGCAGTTCCTTAACACTAGCGAAGGCAGATACGCAGTATTTT	CASSSLTLAKADTQYF	TRBV11-2	TRBJ2-3
TGTGCCAGCAGCCAAGGCGGCAGGGGCTACCGGCGGAATGAAAAACTGTTTTTT	CASSQGGRGYRRNEKLFF	TRBV3-1	TRBJ1-4
TGTGCCAGCAGCTACCCGGGGACTGAAGCTTTCTTT	CASSYPGTEAFF	TRBV5-4	TRBJ1-1
TGTGCCAGCAGTTTAAACCGGAGCGGGATTTCTAATGAAAAACTGTTTTTT	CASSLNRSGISNEKLFF	TRBV12-3	TRBJ1-4
TGTGCCAGCAGTTTAAGGGGCAACGGTCAGCCCCAGCATTTT	CASSLRGNGQPQHF	TRBV27	TRBJ1-5
TGCGCCAGCAGCTTTCGCCATCGATCCAGAGTAGGAAACACCATATATTTT	CASSFRHRSRVGNTIYF	TRBV5-1	TRBJ1-3
TGCAGTGCTGCCGGGACATCCACTGAAGCTTTCTTT	CSAAGTSTEAFF	TRBV20-1	TRBJ1-1
TGTGCCAGCAGTTTTTCGCGGGACAGTGTTTATTATGGCTACACCTTC	CASSFSRDSVYYGYTF	TRBV12-4	TRBJ1-2
TGTGCCACCACAGCTCAGCGGGGCTCCTACGAGCAGTACTTC	CATTAQRGSYEQYF	TRBV24-1	TRBJ2-7
TGTGCCAGCAGCCAAGAGGGGGGCCGGTCCTACAATCAGCCCCAGCATTTT	CASSQEGGRSYNQPQHF	TRBV14	TRBJ1-5
TGTGCCAGCAGCCAAAAACGGGAGCGGTTTCGGCAGTACTTC	CASSQKRERFRQYF	TRBV3-1	TRBJ2-7
TGCGCCAGCATTGTCCGGGACAGGGGGAGCACAGATACGCAGTATTTT	CASIVRDRGSTDTQYF	TRBV10-1	TRBJ2-3
TGTGCCAGCAGTCATAATGACACAGATACGCAGTATTTT	CASSHNDTDTQYF	TRBV2	TRBJ2-3
TGTGCCAGCAGCAACAAGGGACTAGCGGATGGCAGCACCGGGGAGCTGTTTTTT	CASSNKGLADGSTGELFF	TRBV13	TRBJ2-2
TGTGCCAGTAGTATCGACCGGGACAGGCTCCACACTGAAGCTTTCTTT	CASSIDRDRLHTEAFF	TRBV19	TRBJ1-1
TGCGCCAGCAGTGAGAGACGACAGGGGGCTGAAGCTTTCTTT	CASSERRQGAEAFF	TRBV10-2	TRBJ1-1
TGCGCCAGCAGCTTGGCACAGGGCTCTGGGGCCAACGTCCTGACTTTC	CASSLAQGSGANVLTF	TRBV5-1	TRBJ2-6
TGTGCCAGCAGCGCTGAACCCACCCCAGAGTCCGGCGTAACCTACGAGCAGTACTTC	CASSAEPTPESGVTYEQYF	TRBV11-2	TRBJ2-7
TGCGCCAGCAGCTTGAAGACCGGAGCCTGTAACTTC	CASSLKTGACNF	TRBV5-1	TRBJ2-5
TGCAGTGCTAGGAAAATAGCGGGGGGAGATACGCAGTATTTT	CSARKIAGGDTQYF	TRBV20-1	TRBJ2-3
TGCGCCAGCAGCTTGAGGACAGAGACGACCTACGAGCAGTACTTC	CASSLRTETTYEQYF	TRBV5-1	TRBJ2-7
TGTGCCAGCAGCCATCACCCTAAGGGAGGCACAGATACGCAGTATTTT	CASSHHPKGGTDTQYF	TRBV7-3	TRBJ2-3
TGCGCCTGGGGTAGCAGGATGCAGTACTTC	CAWGSRMQYF	TRBV10-1	TRBJ2-5
TGTGCCAGAACCGGGACTAGCGGGAGTCAGCCCCAGCATTTT	CARTGTSGSQPQHF	TRBV6-2	TRBJ1-5
TGTGCCAGCAGCTTTGGCGAGCTTTGCGGCTACGAGCAGTACTTC	CASSFGELCGYEQYF	TRBV7-9	TRBJ2-7
TGTGCCAGCAGTCGCCCACGAGGGAACACTGAAGCTTTCTTT	CASSRPRGNTEAFF	TRBV27	TRBJ1-1
TGTGCCTTAGCGGGACATATTGATACAGATACGCAGTATTTT	CALAGHIDTDTQYF	TRBV6-4	TRBJ2-3
TGTGCCTCGGGTCCGGGGGGCGGAAACGAGCAGTACTTC	CASGPGGGNEQYF	TRBV10-3	TRBJ2-7
TGTGCCAGCAGCTTAGCCGGGACAGGTAATGAAAAACTGTTTTTT	CASSLAGTGNEKLFF	TRBV7-8	TRBJ1-4
TGTGCCAGCAGTCTACGAAACCAGAGTAGCTCCTACAATGAGCAGTTCTTC	CASSLRNQSSSYNEQFF	TRBV6-4	TRBJ2-1
TGTGCCAGCAGCTTAGCGAGACAGGGGGGGCGCACAGATACGCAGTATTTT	CASSLARQGGRTDTQYF	TRBV7-8	TRBJ2-3
TGTGCCAGCAGTTCAAAAGAAGGACCGCAAGAGACCCAGTACTTC	CASSSKEGPQETQYF	TRBV28	TRBJ2-5
TGTGCCAGCAGCCGCGGCAGGGCACAAGTGAACACTGAAGCTTTCTTT	CASSRGRAQVNTEAFF	TRBV7-2	TRBJ1-1
TGTGCCAGCAGCTACTGGGAGACACAGGGAATTGTTCGCAATCAGCCCCAGCATTTT	CASSYWETQGIVRNQPQHF	TRBV11-1	TRBJ1-5
TGTGCCAGCAAACCCTTGGACAGGGGGCGGGGCACTGAAGCTTTCTTT	CASKPLDRGRGTEAFF	TRBV27	TRBJ1-1
TGTGCCAGCAGCCATGGCGGCACAGATACGCAGTATTTT	CASSHGGTDTQYF	TRBV7-9	TRBJ2-3
TGTGCCAGCAGCTTGGGGGGGGCCGGGCGGCCCAGCACAGATACGCAGTATTTT	CASSLGGAGRPSTDTQYF	TRBV5-6	TRBJ2-3
TGTGCCAGCAGTTTTGTGGGGACAGGGCCAGGAAGGAAAACCTACGAGCAGTACTTC	CASSFVGTGPGRKTYEQYF	TRBV28	TRBJ2-7
TGTGCCAGCAGTGAAGCGTGCCCCCCGGAGGGGGGAAAGATCGACGAGCAGTACTTC	CASSEACPPEGGKIDEQYF	TRBV6-1	TRBJ2-7
TGTGCCAGCAGCGGACCATCGGGGGGGGGGACTAGGGAGTACTTC	CASSGPSGGGTREYF	TRBV13	TRBJ2-5
TGTGCCAGCGACAGTCTGACAAACAATGAGCAGTTCTTC	CASDSLTNNEQFF	TRBV27	TRBJ2-1
TGTGCCAGCAGCATTAATAGCGGGTACGAGCAGTACTTC	CASSINSGYEQYF	TRBV11-2	TRBJ2-7
TGTGCCAGCAGCTTAGATCCCGGGACAGCGATTTCGATCCGCACTGAAGCTTTCTTT	CASSLDPGTAISIRTEAFF	TRBV7-2	TRBJ1-1
TGCAGTGAACTAATGAGGGGGTGGACCTACGAGCAGTACTTC	CSELMRGWTYEQYF	TRBV20-1	TRBJ2-7
TGCAGTGCTAGTCGTCGGGGCGACACTGAAGCTTTCTTT	CSASRRGDTEAFF	TRBV20-1	TRBJ1-1
TGTGCCAGCAGCAGTCATTCCATACGGGAGAACACTGAAGCTTTCTTT	CASSSHSIRENTEAFF	TRBV9	TRBJ1-1
TGCGCCAGCGTCACCCGGGACAGGGGTCATATCAACGGGGGCTACACCTTC	CASVTRDRGHINGGYTF	TRBV10-1	TRBJ1-2
TGTGCCACCAGTGAAGCGTCGGGGCGCCAGTCATCGTCCTACGAGCAGTACTTC	CATSEASGRQSSSYEQYF	TRBV24-1	TRBJ2-7
TGCAGTGACCCTAGCCCCTACAATGAGCAGTTCTTC	CSDPSPYNEQFF	TRBV20-1	TRBJ2-1
TGTGCCAGCAGCTTGAATTTGACTAGCGGGAGAAGCGAATACGAGCAGTACTTC	CASSLNLTSGRSEYEQYF	TRBV5-5	TRBJ2-7
TGCGCCAGCAGTGCCCAATTCGGGGGAAGCTCCTACGAGCAGTACTTC	CASSAQFGGSSYEQYF	TRBV10-1	TRBJ2-7
TGTGCCAGCAGCCAAGCCTACGAGCAGTACTTC	CASSQAYEQYF	TRBV14	TRBJ2-7
TGTGCCAGCAGCCAAGATGACGACAGGGGGCGCACAGATACGCAGTATTTT	CASSQDDDRGRTDTQYF	TRBV4-2	TRBJ2-3
TGTGCCAGCAGCGAGGGGCAAGGGGACACTGAAGCTTTCTTT	CASSEGQGDTEAFF	TRBV11-3	TRBJ1-1
TGTGCCAGCAGCCTCACCGGGGAGCTGTTTTTT	CASSLTGELFF	TRBV7-2	TRBJ2-2
TGTGCCAGCAGCTTAGCGAAGTCTCCCGACCACGGATTAATATTTCCAGACGTAGACGAGCAGTACTTC	CASSLAKSPDHGLIFPDVDEQYF	TRBV7-8	TRBJ2-7
TGTGCCAGCAAAGGAAGGTTTACAGATACGCAGTATTTT	CASKGRFTDTQYF	TRBV6-1	TRBJ2-3
TGCCAGGACAGGGATATTAATGAAAAACTGTTTTTT	CQDRDINEKLFF	TRBV20-1	TRBJ1-4
TGTGCCAGCAGTTTCCGTTCCAGGACGACACCCCTCCACTTT	CASSFRSRTTPLHF	TRBV27	TRBJ1-6
TGTGCCAGCAGCTTAGCCCACCTGCGACAGGGGGCGCATCCCGTTGAAGCTTTCTTT	CASSLAHLRQGAHPVEAFF	TRBV11-2	TRBJ1-1
TGTGCCAGCAGCTTAGTAGGGCGGGCGCACTATGGCTACACCTTC	CASSLVGRAHYGYTF	TRBV11-3	TRBJ1-2
TGTGCCAGCAGCGCCTTAGTCCAGGGGCGGAAGGGTGAAAAACTGTTTTTT	CASSALVQGRKGEKLFF	TRBV13	TRBJ1-4
TGTGCCACCGAACAGGGGGCGAACACTGAAGCTTTCTTT	CATEQGANTEAFF	TRBV24-1	TRBJ1-1
TGTGCCATCAGTGCCTCCGCGTGGGGGCGGCAACAAGAGACCCAGTACTTC	CAISASAWGRQQETQYF	TRBV10-3	TRBJ2-5
TGTGCCAGCAGTTCCGGACTAGCCCAATGGCGGGGCTCCTACAATGAGCAGTTCTTC	CASSSGLAQWRGSYNEQFF	TRBV6-9	TRBJ2-1
TGCAGTGCTAGTCGCGGAAGTAATGGGGTTCCGAACACCGGGGAGCTGTTTTTT	CSASRGSNGVPNTGELFF	TRBV20-1	TRBJ2-2
TGTGCCACCAGTGATAGAGACCCCGGGCTACGGGAGTTCTACGAGCAGTACTTC	CATSDRDPGLREFYEQYF	TRBV24-1	TRBJ2-7
TGTGCCAGCAGTTTTAGCCCCGTCGCTAATGAAAAACTGTTTTTT	CASSFSPVANEKLFF	TRBV27	TRBJ1-4
TGTGCCAGCAGCAGACTAGAGCCAGGGGTGGACTATGGCTACACCTTC	CASSRLEPGVDYGYTF	TRBV7-3	TRBJ1-2
TGCAGTGCTCCTAGTTGGGACTCACAGGGGAGGGATTTATCAGACGGAAGAACCTACAATGAGCAGTTCTTC	CSAPSWDSQGRDLSDGRTYNEQFF	TRBV20-1	TRBJ2-1
TGCGCCAGCGGGACAGAAATCTCTGGGGCCAACGTCCTGACTTTC	CASGTEISGANVLTF	TRBV10-1	TRBJ2-6
TGTGCCAGCAGTTACTCGACCACCCGGGGGGTTGGAAACACCATATATTTT	CASSYSTTRGVGNTIYF	TRBV6-2	TRBJ1-3
TGTGCCAGCACAAGCGGGACACACAAGAAGTCTGAGACCCAGTACTTC	CASTSGTHKKSETQYF	TRBV2	TRBJ2-5
TGCGCCAGCAGCTTCCACAGGGCGGGAGAGACCCAGTACTTC	CASSFHRAGETQYF	TRBV5-1	TRBJ2-5
TGTGCCAGCAGACCTAACAGGGAGGGAAATTCACCCCTCCACTTT	CASRPNREGNSPLHF	TRBV6-5	TRBJ1-6
TGTGCCAGTAGTGTCCGGGGGCACGTCTACGAGCAGTACTTC	CASSVRGHVYEQYF	TRBV19	TRBJ2-7
TGTGCCAGTGTAGGGAGTGGAGGCAGGGCGTATCAGCCCCAGCATTTT	CASVGSGGRAYQPQHF	TRBV19	TRBJ1-5
TGTGCCAGCAGCATTGCCCGGAGGAGGGGTGCCGCTTTCTTT	CASSIARRRGAAFF	TRBV7-9	TRBJ1-1
TGTGCCAGCAGCTTAGCGCTGGGACAGGGGTGGAACACCGGGGAGCTGTTTTTT	CASSLALGQGWNTGELFF	TRBV7-2	TRBJ2-2
TGTGCCAGGCGGGTGAGGGAGACGAACACTGAAGCTTTCTTT	CARRVRETNTEAFF	TRBV6-2	TRBJ1-1
TGTGCCAGCAGCTTATGGTCCGGGACAGTCTACTATGGCTACACCTTC	CASSLWSGTVYYGYTF	TRBV7-8	TRBJ1-2
TGTGCCAGCAGTCTAGCGGGGCCCTTTAACGAGCAGTACTTC	CASSLAGPFNEQYF	TRBV28	TRBJ2-7
TGTGCCAGCAGCCAAGGGCTCGCGGGAGTCGGAACCTACGAGCAGTACTTC	CASSQGLAGVGTYEQYF	TRBV14	TRBJ2-7
TGTGCCAGCAGCTCCCCTAGGGGGGGAAACACCATATATTTT	CASSSPRGGNTIYF	TRBV7-7	TRBJ1-3
TGTGCCAGCAGGGCCCAGGGGAACTATGGCTACACCTTC	CASRAQGNYGYTF	TRBV6-4	TRBJ1-2
TGTGCCAGCAGGGGTATGTACAATGAGCAGTTCTTC	CASRGMYNEQFF	TRBV9	TRBJ2-1
TGTGCCAGTAGTATTCGGGCGAAGGGGCCTACGCAGTATTTT	CASSIRAKGPTQYF	TRBV19	TRBJ2-3
TGTGCCACCAGTGACGGACTCCCGAACGAGCAGTACTTC	CATSDGLPNEQYF	TRBV24-1	TRBJ2-7
TGTGCCAGCAGCCAAGACCACAGGGGCCCCGCGGGAGCCGACGAGCAGTACTTC	CASSQDHRGPAGADEQYF	TRBV3-1	TRBJ2-7
TGTGCCAGCAGCCCCCCTAGCGGGGATCCCTACGAGCAGTACTTC	CASSPPSGDPYEQYF	TRBV13	TRBJ2-7
TGTGCCAGCAGTGATAAAGAGCGGGATGAGACCCAGTACTTC	CASSDKERDETQYF	TRBV6-4	TRBJ2-5
TGCGCCAGCAGCCACGACAGCCTCCAGGAGAAAGAGACCCAGTACTTC	CASSHDSLQEKETQYF	TRBV4-1	TRBJ2-5
TGTGCCAGGGGTCCCCCGGGGTCGCAAGAGACCCAGTACTTC	CARGPPGSQETQYF	TRBV6-4	TRBJ2-5
TGTGCCAGCACTCAACCGAGCGGGAGAAGAACCGGGGAGCTGTTTTTT	CASTQPSGRRTGELFF	TRBV5-4	TRBJ2-2
TGTGCCAGCAGCGGGTGGGGTTGGGCATTTGAAGCTTTCTTT	CASSGWGWAFEAFF	TRBV13	TRBJ1-1
TGTGCCAGCAGGCGCCATGCGGTGTGCTACGAGCAGTACTTC	CASRRHAVCYEQYF	TRBV6-5	TRBJ2-7
TGTGCCAGCACTCCGGGGTATGGCTACACCTTC	CASTPGYGYTF	TRBV6-3	TRBJ1-2
TGTGCCAGCACACAGGAGTGCCTAGTTCGAAATCAGCCCCAGCATTTT	CASTQECLVRNQPQHF	TRBV7-6	TRBJ1-5
TGTGCCAGCAGCTTGATGGGGGCTGACAGGGAATCAAGGGGCACAGATACGCAGTATTTT	CASSLMGADRESRGTDTQYF	TRBV5-4	TRBJ2-3
TGTGCCAGCAGCTTGGACCAGACAGAAATGAACACTGAAGCTTTCTTT	CASSLDQTEMNTEAFF	TRBV5-6	TRBJ1-1
TGTGCCAGCAGTCCGTTCTCAGGGGAGACAGTTCCGGGCAATCAGCCCCAGCATTTT	CASSPFSGETVPGNQPQHF	TRBV6-2	TRBJ1-5
TGTGCCAGTAAGGGGGATGGCTCCTACGAGCAGTACTTC	CASKGDGSYEQYF	TRBV19	TRBJ2-7
TGTGCCAGCAGGTCCGGTCAGACATTGGGCCCTGATTCGAACACCGGGGAGCTGTTTTTT	CASRSGQTLGPDSNTGELFF	TRBV7-9	TRBJ2-2
TGCGCCAGCAGCTTGGCAGACCCAGTCCGGGGCAATGGCTACACCTTC	CASSLADPVRGNGYTF	TRBV5-1	TRBJ1-2
TGTGCCACCGGGACCGGGTCTTTTCGACTAGCCAAAAACATTCAGTACTTC	CATGTGSFRLAKNIQYF	TRBV27	TRBJ2-4
TGTGCCAGCAGCTTCAACGACAGGGAGGGCTACACCTTC	CASSFNDREGYTF	TRBV7-3	TRBJ1-2
TGCGCCAGCACACTCAGATGGGGCTACACCTTC	CASTLRWGYTF	TRBV10-1	TRBJ1-2
TGTGCCACCAGCAGGACAGGGAAACTATGGATGTGCTCCTACGAGCAGTACTTC	CATSRTGKLWMCSYEQYF	TRBV15	TRBJ2-7
TGTGCCAGCAGTTTCCCTACCGGGACACTCTTCTCTGGAAACACCATATATTTT	CASSFPTGTLFSGNTIYF	TRBV28	TRBJ1-3
TGCAGCGCTAGCGGGTACCTCAATGAGCAGTTCTTC	CSASGYLNEQFF	TRBV29-1	TRBJ2-1
TGTGCTAGTGGTTTTCCGACAGCTGGGGCCAACGTCCTGACTTTC	CASGFPTAGANVLTF	TRBV12-5	TRBJ2-6
TGCGCCAGCAGCAGTCGGAGACAGGAGTCTAATGAAAAACTGTTTTTT	CASSSRRQESNEKLFF	TRBV4-1	TRBJ1-4
TGTGCCAGCAGCTTGCAGCCCAGGTTTATACCCCAACAGCCCCAGCATTTT	CASSLQPRFIPQQPQHF	TRBV5-6	TRBJ1-5
TGTGCCACCAGTGATTTGCCCAGGATAGTCCGAGTCGAGCAGTACTTC	CATSDLPRIVRVEQYF	TRBV24-1	TRBJ2-7
TGTGCCAGCAGCTGCCGAGGCCAAGAGACCCAGTACTTC	CASSCRGQETQYF	TRBV11-2	TRBJ2-5
TGTGCCAGCAGTTACCGGTCCGGGACAGGGTTAGCCAAAAACATTCAGTACTTC	CASSYRSGTGLAKNIQYF	TRBV6-5	TRBJ2-4
TGTGCCAGTAGTATATCGCGGGGGGGGGTTGTAAACAATGAGCAGTTCTTC	CASSISRGGVVNNEQFF	TRBV19	TRBJ2-1
TGCAGTGCTAGTTCGAGCGGGAGGGGGGGGGGGGGACACACTGAAGCTTTCTTT	CSASSSGRGGGGHTEAFF	TRBV20-1	TRBJ1-1
TGCGCCAGCAGTGTGCTAGCGGTTGAGCAGTTCTTC	CASSVLAVEQFF	TRBV10-1	TRBJ2-1
TGCAGTACTAGCGGGAGTGGTCAGCCCCAGCATTTT	CSTSGSGQPQHF	TRBV20-1	TRBJ1-5
TGTGCCAGCAGCCATGGGACAGGGAATCAGCCCCAGCATTTT	CASSHGTGNQPQHF	TRBV3-1	TRBJ1-5
TGTGCCAGCAGCGATAGCTGGGAAGAGACCCAGTACTTC	CASSDSWEETQYF	TRBV13	TRBJ2-5
TGTGCCAGCAGAATTCTCTGGGACAAGAAGACGCAAGAGACCCAGTACTTC	CASRILWDKKTQETQYF	TRBV6-6	TRBJ2-5
TGCGCCAGCAGTGAGTCGGGACTAGCGGGTCAGGACCGAGACAATGAGCAGTTCTTC	CASSESGLAGQDRDNEQFF	TRBV10-2	TRBJ2-1
TGTGCCAGCGGGGGGGAGCAGTTCTTC	CASGGEQFF	TRBV2	TRBJ2-1
TGTGCCAGCAGTTTACTTGTAGCAGGGGAGAGAGCGGCCTACGAGCAGTACTTC	CASSLLVAGERAAYEQYF	TRBV12-4	TRBJ2-7
TGTGCCAGCAGTTACTCGACCAGCGGGAGGGGGTGCGGGGAGCTGTTTTTT	CASSYSTSGRGCGELFF	TRBV6-5	TRBJ2-2
TGTGCCAGCAATTCGGCCGGGAGGGAGACAGATACGCAGTATTTT	CASNSAGRETDTQYF	TRBV12-4	TRBJ2-3
TGTGCCTGGAGTAATCCGGGACAGGGACAAGAGACCCAGTACTTC	CAWSNPGQGQETQYF	TRBV30	TRBJ2-5
TGTGCCAGCAGCCTAGGACAGGGATGCTTCCATGGCTACACCTTC	CASSLGQGCFHGYTF	TRBV13	TRBJ1-2
TGTGCCAGCAGTTACAAGGGACCCGGCTACGAGCAGTACTTC	CASSYKGPGYEQYF	TRBV6-5	TRBJ2-7
TGTGCCAGCAGTTACCCTAGCGGGTACAATGAGCAGTTCTTC	CASSYPSGYNEQFF	TRBV6-6	TRBJ2-1
TGTGCCAGCAGCTTGACCGCCTATCTTCACCCCTACGAGCAGTACTTC	CASSLTAYLHPYEQYF	TRBV13	TRBJ2-7
TGTGCCCCCGGGACAGGGAGTGGGGAGCAGGAAGCTTTCTTT	CAPGTGSGEQEAFF	TRBV6-4	TRBJ1-1
TGTGCCAGCAGTTTAGTCATTGGTCCCCCTAGAGAGACTAGCGGGCCCTACGAGCAGTACTTC	CASSLVIGPPRETSGPYEQYF	TRBV12-4	TRBJ2-7
TGTGCTAGTGGTTTGGTAAGCCCGCCAAGGGGTCGTCAGCCCCAGCATTTT	CASGLVSPPRGRQPQHF	TRBV12-5	TRBJ1-5
TGTGCCAGCAGCGTAGATACGGCCGTAGGTACACTCTTC	CASSVDTAVGTLF	TRBV5-8	TRBJ2-1
TGTGCCAGCAGTGAGCCAATGGCAGGGGGCACTGAAGCTTTCTTT	CASSEPMAGGTEAFF	TRBV6-4	TRBJ1-1
TGTGCCAGTAAACAGAGAAACACTGAAGCTTTCTTT	CASKQRNTEAFF	TRBV19	TRBJ1-1
TGTGCCAGCAGCCGGAACACAGTCTGGTGGGGAGAGGATCAGCCCCAGCATTTT	CASSRNTVWWGEDQPQHF	TRBV13	TRBJ1-5
TGCAGTGCAACACCCGGGGATTGGTATGGCTACACCTTC	CSATPGDWYGYTF	TRBV20-1	TRBJ1-2
TGTGCCAGCAGCTTGAGTCAACAGGGGGGTAGGCCCCAGCATTTT	CASSLSQQGGRPQHF	TRBV5-5	TRBJ1-5
TGCGCCAGCAGCTTGAGCCCGCCACGGGTGAGATTCGGGGAGCTGTTTTTT	CASSLSPPRVRFGELFF	TRBV5-1	TRBJ2-2
TGCAGCGCCCCTGCCTCGGGACAGGGGATTAGGCCAAACATTCAGTACTTC	CSAPASGQGIRPNIQYF	TRBV29-1	TRBJ2-4
TGTGCCAGCAGTTACGGGGAAGAGACCCAGTACTTC	CASSYGEETQYF	TRBV6-5	TRBJ2-5
TGTGCCAGCAGGAAAGCCAGGGCCAGACACCCCTATAATTCACCCCTCCACTTT	CASRKARARHPYNSPLHF	TRBV27	TRBJ1-6
TGTGCCAGAATAGGGAGCTCCTACAATGAGCAGTTCTTC	CARIGSSYNEQFF	TRBV11-3	TRBJ2-1
TGTGCCAGCATTCCCGGGACTAGCGGGCTCCAAGAGACCCAGTACTTC	CASIPGTSGLQETQYF	TRBV7-9	TRBJ2-5
TGTGCCAGCTCACCACGTTCCCCAGAAACCTTTGTCGAGGCATGGGCTGAAGCTTTCTTT	CASSPRSPETFVEAWAEAFF	TRBV18	TRBJ1-1
TGCGCCAGCAGCGCACAGGGAAGGCTGAACACTGAAGCTTTCTTT	CASSAQGRLNTEAFF	TRBV5-1	TRBJ1-1
TGCAGTGCTTCGGGACAGGGGCAAGAGACCCAGTACTTC	CSASGQGQETQYF	TRBV20-1	TRBJ2-5
TGTGCCAGCAGTTGGCCAGCCCTCCCCGGGACAGGGAGAGACTGCTCTGGAAACACCATATATTTT	CASSWPALPGTGRDCSGNTIYF	TRBV6-5	TRBJ1-3
TGCGCTTGTGGTCAGGCGTCTAGCTGGCAGTACTTC	CACGQASSWQYF	TRBV10-1	TRBJ2-7
TGCAGTGCTAGAGCGGTAAGGGACGCCCGTAACTATGGCTACACCTTC	CSARAVRDARNYGYTF	TRBV20-1	TRBJ1-2
TGCGCCAGCAGCTTCCCGGGACAGGGCTTGGGATCTGGAAACACCATATATTTT	CASSFPGQGLGSGNTIYF	TRBV5-1	TRBJ1-3
TGTGCCAGCAGTTTAACTATACATCAGCCCCAGCATTTT	CASSLTIHQPQHF	TRBV27	TRBJ1-5
TGTGCCTGTCGGGGGCACTATGGCTACACCTTC	CACRGHYGYTF	TRBV30	TRBJ1-2
TGCGCCAGCAGCTTCCCTTACGAGGAGCAGTACTTC	CASSFPYEEQYF	TRBV5-1	TRBJ2-7
TGCGCCAGCACCAGCGAGGTATGGACTAGCGGGGGGGCGCGGGAGGACAATGAGCAGTTCTTC	CASTSEVWTSGGAREDNEQFF	TRBV10-2	TRBJ2-1
TGCAGTGCTAGAGATAGTTTGGGACCGGAGTTGCACTCTGGAAACACCATATATTTT	CSARDSLGPELHSGNTIYF	TRBV20-1	TRBJ1-3
TGTGCCAGCAGCTTAAGGAGGAACTTAGATACGCAGTATTTT	CASSLRRNLDTQYF	TRBV5-8	TRBJ2-3
TGTGCCAGTACGCTAGATGAGCAGTTCTTC	CASTLDEQFF	TRBV6-4	TRBJ2-1
TGTGCCAGCAGTTCTCACAGTGAGCAGTACTTC	CASSSHSEQYF	TRBV6-5	TRBJ2-7
TGTGCCAGCAGCGTAGCCCCCTTCCATGTGCTTACCGGGGAGCTGTTTTTT	CASSVAPFHVLTGELFF	TRBV9	TRBJ2-2
TGTGCCACCAGTGCGCCCGGGACAGACGACACTGAAGCTTTCTTT	CATSAPGTDDTEAFF	TRBV24-1	TRBJ1-1
TGTGCCACCAGTGATTTCCGGGACAGGGGGCGCAGGGCTGGGGCCAACGTCCTGACTTTC	CATSDFRDRGRRAGANVLTF	TRBV24-1	TRBJ2-6
TGCGCCCGATCTCCCGCTACCGCCGACAGGGGCTCTGGAAACACCATATATTTT	CARSPATADRGSGNTIYF	TRBV10-1	TRBJ1-3
TGTGCCAGCAGCGTATTACAGGGGGCGGGAGGAGCTTTCTTT	CASSVLQGAGGAFF	TRBV9	TRBJ1-1
TGTGCCAGCATCTCTGAGGTCTACGAGCAGTACTTC	CASISEVYEQYF	TRBV9	TRBJ2-7
TGCAGTGCTAGGACAGGGCCCCCATATGGCTACACCTTC	CSARTGPPYGYTF	TRBV20-1	TRBJ1-2
TGTGCCAGCAAAAAGAAGGGAAACATTCAGTACTTC	CASKKKGNIQYF	TRBV6-4	TRBJ2-4
TGCGCCAGCAGCCCCTTAAGATACAATGAGCAGTTCTTC	CASSPLRYNEQFF	TRBV4-3	TRBJ2-1
TGTGCTAGTGGTTTCCTGCGGGAGACCAATCAGCCCCAGCATTTT	CASGFLRETNQPQHF	TRBV12-5	TRBJ1-5
TGTGCCAGCAGTATGCTTCAGACTAGCGGGGGCACAGATACGCAGTATTTT	CASSMLQTSGGTDTQYF	TRBV6-4	TRBJ2-3
TGCGCCAGCAGAGAGTGCAGGTACACAGATACGCAGTATTTT	CASRECRYTDTQYF	TRBV10-1	TRBJ2-3
TGTGCCAGCAGCCAAGAAGTCTCCCATGGGACATTGCGGGGTAGATTCCGCGAGCAGTACTTC	CASSQEVSHGTLRGRFREQYF	TRBV4-2	TRBJ2-7
TGTGCCAGCAGTTTACCCCCCCGTCAGGTTCTTAAGCCCCAGCATTTT	CASSLPPRQVLKPQHF	TRBV27	TRBJ1-5
TGCAGCGGGACTAGCGGGATTCACTCCTACAATGAGCAGTTCTTC	CSGTSGIHSYNEQFF	TRBV20-1	TRBJ2-1
TGTGCCAGTAGTATAGATCCCAACGGGACTAGCGGGGAAGAGACCCAGTACTTC	CASSIDPNGTSGEETQYF	TRBV19	TRBJ2-5
TGTGCCAGCAGTGAGGTGGGCCCGCAAGAGACCCAGTACTTC	CASSEVGPQETQYF	TRBV25-1	TRBJ2-5
TGTGCCAGCAGTCCAGACCCAGGGCGAGATCAGCCCCAGCATTTT	CASSPDPGRDQPQHF	TRBV6-3	TRBJ1-5
TGTGCCAGCAGTTCCATAGTCCCCAATCAGCCCCAGCATTTT	CASSSIVPNQPQHF	TRBV27	TRBJ1-5
TGTGCCAGCAGCTGGTCACTAGCGGGTGTCGACTCCTACAATGAGCAGTTCTTC	CASSWSLAGVDSYNEQFF	TRBV7-9	TRBJ2-1
TGTGCCAGCAGCGAAGGAAAAGAGACCCAGTACTTC	CASSEGKETQYF	TRBV7-3	TRBJ2-5
TGTGCCAGCAGCGTGGACGGGGGGAACACTGAAGCTTTCTTT	CASSVDGGNTEAFF	TRBV9	TRBJ1-1
TGCAGCGTTTGTCCCGGGGCAGAAGACACTGAAGCTTTCTTT	CSVCPGAEDTEAFF	TRBV29-1	TRBJ1-1
TGTGCCAGCAGTTACCTTAGGGACGAGCAGTACTTC	CASSYLRDEQYF	TRBV27	TRBJ2-7
TGTGCCAGCTCTGGACCGGGGGGGCACAATATCCGGAGCACAGATACGCAGTATTTT	CASSGPGGHNIRSTDTQYF	TRBV18	TRBJ2-3
TGCAGCGTTGAGGTTACTCGCAGGGCCCGGTCGGACGAGCAGTACTTC	CSVEVTRRARSDEQYF	TRBV29-1	TRBJ2-7
TGTGCCAGCAGTGAAGATGGATTAGCGGGGGATATAACCGTTACCTATGAGCAGTTCTTC	CASSEDGLAGDITVTYEQFF	TRBV6-1	TRBJ2-1
TGCAGTGCTCGGGACATTCTGGCGAACATTCAGTACTTC	CSARDILANIQYF	TRBV20-1	TRBJ2-4
TGTGCCAGCAGTCGGATAGGCTTTGAGCAGTTCTTC	CASSRIGFEQFF	TRBV27	TRBJ2-1
TGTGCCAGCAGCTTCCCCAAGGGAGGGCCTTCGGGGGGGGGCCAATTGGAGCAAGAGACCCAGTACTTC	CASSFPKGGPSGGGQLEQETQYF	TRBV6-5	TRBJ2-5
TGTGCCAGCGCGTTAACAGGGGTGGGCCCTTTTGAAGCTTTCTTT	CASALTGVGPFEAFF	TRBV6-4	TRBJ1-1
TGTGCCAGCCCAACGCGCTATCAGCCCCAGCATTTT	CASPTRYQPQHF	TRBV18	TRBJ1-5
TGCGCCAGCGTGCCGGGACAGGGGGTAGCCAAAAACATTCAGTACTTC	CASVPGQGVAKNIQYF	TRBV5-1	TRBJ2-4
TGTGCCAATATCCTGGGCCACAGGACCCAGTACTTC	CANILGHRTQYF	TRBV27	TRBJ2-5
TGTGCCATTGTAGGAAAGGGGTACTTC	CAIVGKGYF	TRBV7-9	TRBJ2-7
TGTGCCTGGAGTGTAGGTCGACAGTATAGCAATCAGCCCCAGCATTTT	CAWSVGRQYSNQPQHF	TRBV30	TRBJ1-5
TGTGCCAGCAGTCTCCGGGTTTTATATAATTCACCCCTCCACTTT	CASSLRVLYNSPLHF	TRBV6-4	TRBJ1-6
TGTGCCAGCAATCCGGGACTAGCGGGAAGGCAGTTCTTC	CASNPGLAGRQFF	TRBV11-3	TRBJ2-1
TGCAGTGCTAGAGGGGGGACAGGCAGCGAGACCGGCTATGGCTACACCTTC	CSARGGTGSETGYGYTF	TRBV20-1	TRBJ1-2
TGTGCCACCAGTAGCCTGAGCTACGGGACTAGCGGGTCCGGGGGCTACGAGCAGTACTTC	CATSSLSYGTSGSGGYEQYF	TRBV24-1	TRBJ2-7
TGTGCCAGTAGTATACCACGGACAGATAAAATAGACTATGGCTACACCTTC	CASSIPRTDKIDYGYTF	TRBV19	TRBJ1-2
TGTGCCACCAGCTCACTAGGGGGGAATAATTCACCCCTCCACTTT	CATSSLGGNNSPLHF	TRBV15	TRBJ1-6
TGTGCCAGTAAGAGGCCGGGAGGGCCCTATATTGGGGCCCCCTACGAGCAGTACTTC	CASKRPGGPYIGAPYEQYF	TRBV19	TRBJ2-7
TGTGCCAGCAGTTTACTACAGGGGGGTTCACCCCTCCACTTT	CASSLLQGGSPLHF	TRBV28	TRBJ1-6
TGTGCCAGCAGCAAGACTAGCCGGGGTGATACGCAGTATTTT	CASSKTSRGDTQYF	TRBV13	TRBJ2-3
TGTGCCAGCAGCAGAGACAGGGGATTTAATTCACCCCTCCACTTT	CASSRDRGFNSPLHF	TRBV13	TRBJ1-6
TGTGCCAGCAGCCGGGGGACAGGAAGATCAGATACGCAGTATTTT	CASSRGTGRSDTQYF	TRBV7-3	TRBJ2-3
TGTGCCAGCATAGTACCGGGACAGGGGGCGCGGGGGAATTCACCCCTCCACTTT	CASIVPGQGARGNSPLHF	TRBV12-3	TRBJ1-6
TGTGCCAGCAGCCCCCCCGACAGGGACCCGAACACTGAAGCTTTCTTT	CASSPPDRDPNTEAFF	TRBV7-2	TRBJ1-1
TGCAGTGCTAGAGATCCGGGGGCAGTTCAAGAGACCCAGTACTTC	CSARDPGAVQETQYF	TRBV20-1	TRBJ2-5
TGCAGTGCTATGTGGGGACAGGGTATTACTGCCAAAAACATTCAGTACTTC	CSAMWGQGITAKNIQYF	TRBV20-1	TRBJ2-4
TGTGCCAGCAGTTGCCCAGCGGGAGCGGGCAATGAGCAGTTCTTC	CASSCPAGAGNEQFF	TRBV27	TRBJ2-1
TGTGCCAGCAGCTTAAGTGCTAGCTCCTACGAGCAGTACTTC	CASSLSASSYEQYF	TRBV7-9	TRBJ2-7
TGCAGTGCTAGAGATCCAGACGGTTACAGGGATGAAAAACTGTTTTTT	CSARDPDGYRDEKLFF	TRBV20-1	TRBJ1-4
TGTGCCAGGACGGGAGGGGTCCATCCTGGCTACACCTTC	CARTGGVHPGYTF	TRBV7-3	TRBJ1-2
TGTGCCAGCAGCTTGGCCCGGGATACGCATTTT	CASSLARDTHF	TRBV5-6	TRBJ1-5
TGTGCCAGCTCACCACCGCCCAGGGGGGACCCCTACGAGCAGTACTTC	CASSPPPRGDPYEQYF	TRBV18	TRBJ2-7
TGTGCCAGTAGTTTACAGGGGGCGCTCGGCAATCAGCCCCAGCATTTT	CASSLQGALGNQPQHF	TRBV19	TRBJ1-5
TGTGCCAGCAGCGGAAATCAGGGACCCCTCTTATTCCCCGGGGAGCTGTTTTTT	CASSGNQGPLLFPGELFF	TRBV9	TRBJ2-2
TGTGCCCATCAGGACAGGGGGCGAGAACAGAGGAGACTAAACTACGAGCAGTACTTC	CAHQDRGREQRRLNYEQYF	TRBV2	TRBJ2-7
TGTGCCAGCAGCTTCACTCCCGGCTACACCTTC	CASSFTPGYTF	TRBV11-3	TRBJ1-2
TGTGTTCGGGACAGGGAACCCCCAATAAGCTCCTACAATGAGCAGTTCTTC	CVRDREPPISSYNEQFF	TRBV25-1	TRBJ2-1
TGCAGTGCTCTTCGACCCGTTGATGGCACATACAATGAGCAGTTCTTC	CSALRPVDGTYNEQFF	TRBV20-1	TRBJ2-1
TGTGCCAGTAGTGGGTATGGGGGCCCGATCAATCAGCCCCAGCATTTT	CASSGYGGPINQPQHF	TRBV19	TRBJ1-5
TGTGCCAGCAGCTACCGCCGTCAGGACCGAACTAATGAAAAACTGTTTTTT	CASSYRRQDRTNEKLFF	TRBV7-4	TRBJ1-4
TGTGCCAGCAGTGAATGTGTGGGGTGGGCAACTAATGAAAAACTGTTTTTT	CASSECVGWATNEKLFF	TRBV25-1	TRBJ1-4
TGTGCCAGCAGCCCCCTCCGGGACAGCTACGAGCAGTACTTC	CASSPLRDSYEQYF	TRBV12-3	TRBJ2-7
TGTGCCAGCAGTTATCCAGGGACCGAAGCGGATACGCAGTATTTT	CASSYPGTEADTQYF	TRBV6-6	TRBJ2-3
TGTGCCAGCAGCCGACCTCACTGGCCCGGGAACACCGGGGAGCTGTTTTTT	CASSRPHWPGNTGELFF	TRBV5-4	TRBJ2-2
TGTGCCAGTTTTGGCACTGAAGCTTTCTTT	CASFGTEAFF	TRBV28	TRBJ1-1
TGTGCCAGAATAAGGACAGGGGGGGTTAGGTTAGTGAAACCTGCCTACGAGCAGTACTTC	CARIRTGGVRLVKPAYEQYF	TRBV19	TRBJ2-7
TGTGCCAGCAGTGAACTCCCAGCTAGCGGCACCGGGGAGCTGTTTTTT	CASSELPASGTGELFF	TRBV6-1	TRBJ2-2
TGTGCCAGCAGCTCGGCGCGTCTCGCCGGGGTATGGGAGACCGGGGAGCTGTTTTTT	CASSSARLAGVWETGELFF	TRBV5-4	TRBJ2-2
TGTGCCAGCAGCCAAGGGGGGGAGGAGCAGTACTTC	CASSQGGEEQYF	TRBV14	TRBJ2-7
TGCGCCAGCAGCCAAGAGTTCAGGGACAGGGGTAACACAGATACGCAGTATTTT	CASSQEFRDRGNTDTQYF	TRBV4-1	TRBJ2-3
TGTGCCAGCAGTGAGACGGGGACTGAAGCTTTCTTT	CASSETGTEAFF	TRBV12-3	TRBJ1-1
TGTGCCAGCAGCTTAGGAAGACAGGGGCTCCAAGCTTTCTTT	CASSLGRQGLQAFF	TRBV11-2	TRBJ1-1
TGTGCCAGCAGCCTCCCTTGGACAGGGGGCCGCGGAGTCACCGGGGAGCTGTTTTTT	CASSLPWTGGRGVTGELFF	TRBV7-3	TRBJ2-2
TGTGCCAATCCCGGACAGGGGGCCTTGAACACTGAAGCTTTCTTT	CANPGQGALNTEAFF	TRBV6-1	TRBJ1-1
TGCAGCGTCCCGACGAGGAACACCGGGGAGCTGTTTTTT	CSVPTRNTGELFF	TRBV29-1	TRBJ2-2
TGTGCCAGCAGTTACTCTCACCGGGATGAGACCCAGTACTTC	CASSYSHRDETQYF	TRBV6-5	TRBJ2-5
TGCGCCAGCAGTTCCCCCAATTCCGACAGGGCGGGGTCACCCCTCCACTTT	CASSSPNSDRAGSPLHF	TRBV10-1	TRBJ1-6
TGTGCCAGCAGTGTTGGGATCCCTACCAAACGCAGGGAGCAGTACTTC	CASSVGIPTKRREQYF	TRBV6-4	TRBJ2-7
TGTGCCAGCAGCACCCGGGGCAAAGAACCCCAGCATTTT	CASSTRGKEPQHF	TRBV6-5	TRBJ1-5
TGTGCCAGCAGCCAAGAGTTACACCACTTCACAGAGACCCAGTACTTC	CASSQELHHFTETQYF	TRBV3-1	TRBJ2-5
TGCAGTGCTAGGTGTTTAATGGACAGGGAGGAAAAGGATAGCAATCAGCCCCAGCATTTT	CSARCLMDREEKDSNQPQHF	TRBV20-1	TRBJ1-5
TGTCTAGTATCAGGGCAACGGGAGAATGAAAAACTGTTTTTT	CLVSGQRENEKLFF	TRBV10-3	TRBJ1-4
TGTGCCGCCGAAGGGGCGCGGGCTTTCTTT	CAAEGARAFF	TRBV19	TRBJ1-1
TGTGCCAGCAGTTTATGGGCCCGCTCGAACACCGGGGAGCTGTTTTTT	CASSLWARSNTGELFF	TRBV27	TRBJ2-2
TGCAGCGTTGCGTACAGGGGAGGCCTTCCCCCCGGGGAGCTGTTTTTT	CSVAYRGGLPPGELFF	TRBV29-1	TRBJ2-2
TGTGCCAGCAACCTGGAGGGGCGACAATACAATGAGCAGTTCTTC	CASNLEGRQYNEQFF	TRBV3-1	TRBJ2-1
TGTGCCAGTCAATTCAGCAGCCAGGGAGACACTGAAGCTTTCTTT	CASQFSSQGDTEAFF	TRBV19	TRBJ1-1
TGTGCCTCGGTAGTAAGGGACAGGGTCTCCTATAGCAATCAGCCCCAGCATTTT	CASVVRDRVSYSNQPQHF	TRBV19	TRBJ1-5
TGTGCCAGCAGCTATGGGGGGGCGTCCCAGTACAATGAGCAGTTCTTC	CASSYGGASQYNEQFF	TRBV3-1	TRBJ2-1
TGTGCGTTTGGACGGACGGACGAGCAGTACTTC	CAFGRTDEQYF	TRBV28	TRBJ2-7
TGTGCCACTTGGACTAGGAACACCGGGGAGCTGTTTTTT	CATWTRNTGELFF	TRBV24-1	TRBJ2-2
TGTGCCAGTAGTATAGCTAGCGACTCCGGGGAGCTGTTTTTT	CASSIASDSGELFF	TRBV19	TRBJ2-2
TGTGCCAGCAGCTCCTCTAAGTGCTATCCGAGCGGGAGGGACTATGGCTACACCTTC	CASSSSKCYPSGRDYGYTF	TRBV11-2	TRBJ1-2
TGTGCCAGTAGGGCCCTAGGACAGGGATTGGAAGCTTTCTTT	CASRALGQGLEAFF	TRBV19	TRBJ1-1
TGTGCCAGCTCACCCTACGTCCACAGGGGGCCAATAAACACAGATACGCAGTATTTT	CASSPYVHRGPINTDTQYF	TRBV18	TRBJ2-3
TGCAGCGTGGAGGGCAGCTATGGCTACACCTTC	CSVEGSYGYTF	TRBV29-1	TRBJ1-2
TGTGCCAGCTTTCGCGACCGTCAGCCCCAGCATTTT	CASFRDRQPQHF	TRBV6-4	TRBJ1-5
TGTGCCAGCAATAAGGAACAGAGGATTGGGGCATCCTCACACACCGGGGAGCTGTTTTTT	CASNKEQRIGASSHTGELFF	TRBV7-2	TRBJ2-2
TGTGCCAGCAGCCCTCAGGAACGGAACACTGAAGCTTTCTTT	CASSPQERNTEAFF	TRBV7-3	TRBJ1-1
TGTGCCAGCAGCTCAAAGACAGGGATTGATCAGCCCCAGCATTTT	CASSSKTGIDQPQHF	TRBV11-3	TRBJ1-5
TGTGCCAGCAGCAATCTCGTAACCGGACTCTCCTACGAGCAGTACTTC	CASSNLVTGLSYEQYF	TRBV13	TRBJ2-7
TGTGCCAGCAGCTTGGCCTTTTGGGGCTACACCTTC	CASSLAFWGYTF	TRBV7-3	TRBJ1-2
TGTGCCAGCAGTTACTCCTGGACGAAAGCTGGAAACACCATATATTTT	CASSYSWTKAGNTIYF	TRBV6-5	TRBJ1-3
TGCGCCAGCGGGTTAGATACGCAGTATTTT	CASGLDTQYF	TRBV10-1	TRBJ2-3
TGTGCCAGCTCTTCAATCCAAGGTGGGGTCCGCACTGAAGCTTTCTTT	CASSSIQGGVRTEAFF	TRBV6-1	TRBJ1-1
TGCGCCAGCAGTGAGCACCCTTCCCCTTTGGCAGCCACTGAAGCTTTCTTT	CASSEHPSPLAATEAFF	TRBV10-2	TRBJ1-1
TGTGCCAGCAGCCCCGATCTGGGGGCCTGGTCTTGTGAAGCTTTCTTT	CASSPDLGAWSCEAFF	TRBV11-1	TRBJ1-1
TGTGCCAGCAGCTTGGCTGGGGGGCCCCCTGGTCTCGGGGTTCCTACAGATACGCAGTATTTT	CASSLAGGPPGLGVPTDTQYF	TRBV5-6	TRBJ2-3
TGTGCCAGCAGAAGGGAGGACGAGCAGTACTTC	CASRREDEQYF	TRBV9	TRBJ2-7
TGTGCCAGCAGCACAGAGCGGGATAGCTTGTACAATGAGCAGTTCTTC	CASSTERDSLYNEQFF	TRBV13	TRBJ2-1
TGCGCCAGCAGCCAAGCCTCGGGACTAGCGGAGACAGATACGCAGTATTTT	CASSQASGLAETDTQYF	TRBV4-3	TRBJ2-3
TGTGCCAGCAGCTACAAGGGGGTCGAGGAAGGGAACTATGGCTACACCTTC	CASSYKGVEEGNYGYTF	TRBV5-8	TRBJ1-2
TGCAGTGCTAGTAATGGGGGGGGGAGAACCTACAATGAGCAGTTCTTC	CSASNGGGRTYNEQFF	TRBV20-1	TRBJ2-1
TGTGCCAGCAGTTTGGAGGGGACAGTTTCATGCAATCAGCCCCAGCATTTT	CASSLEGTVSCNQPQHF	TRBV27	TRBJ1-5
TGTGCCTGGACGGGAGGGACTAGCGAAAGTTCCACCGGGGAGCTGTTTTTT	CAWTGGTSESSTGELFF	TRBV30	TRBJ2-2
TGTGCCAGCAGCGGGCGGGTCCAGGGGTTACCTAATCAGCCCCAGCATTTT	CASSGRVQGLPNQPQHF	TRBV9	TRBJ1-5
TGTGCCAGCAGCTTACTCCACAGGGCTGGCTACAATGAGCAGTTCTTC	CASSLLHRAGYNEQFF	TRBV11-3	TRBJ2-1
TGTGCCAGCAGCAAGGGGAGTGTGCGGGCCGATGAGACCCAGTACTTC	CASSKGSVRADETQYF	TRBV5-4	TRBJ2-5
TGTGCTAGCAGCTTTGGCAGGGTCGGGGGCTACGAGCAGTACTTC	CASSFGRVGGYEQYF	TRBV7-7	TRBJ2-7
TGCGCCAGCAGCTTGCAAATTACTAATGAAAAACTGTTTTTT	CASSLQITNEKLFF	TRBV5-1	TRBJ1-4
TGTGCCAGCAGCGCGCGGGCCTGGTTTCGGAACACTGAAGCTTTCTTT	CASSARAWFRNTEAFF	TRBV9	TRBJ1-1
TGTGCCAGCAGCTTAGTACATTCGGACAGGGCTGGGGTTTTGGGGCGTGCAACTAATGAAAAACTGTTTTTT	CASSLVHSDRAGVLGRATNEKLFF	TRBV7-2	TRBJ1-4
TGTGCCAGCAGCTCGACAGGGGGGGCCCTCCGAAACACCATATATTTT	CASSSTGGALRNTIYF	TRBV13	TRBJ1-3
TGTGCCAGCTCATTCCAGGGATACGTGGAGCAGTACTTC	CASSFQGYVEQYF	TRBV18	TRBJ2-7
TGTGCCAGCAGCCCCCGGGGAGAGATCCGCAATCAGCCCCAGCATTTT	CASSPRGEIRNQPQHF	TRBV6-4	TRBJ1-5
TGTGCCAGCAGTTACACCGGGACAGTGGAAGTTTTTAATCAGCCCCAGCATTTT	CASSYTGTVEVFNQPQHF	TRBV6-6	TRBJ1-5
TGTGCCAGCAGTTTAGGGGGGATTGGCTACACCTTC	CASSLGGIGYTF	TRBV12-4	TRBJ1-2
TGTGCCATCGGGCACAGGTTCGAACAGCCCCAGCATTTT	CAIGHRFEQPQHF	TRBV10-3	TRBJ1-5
TGTGCCAGCAGCCATACGGGTGGGACAGGTGAGACCCAGTACTTC	CASSHTGGTGETQYF	TRBV3-1	TRBJ2-5
TGTGCCATCAGTGGCCGTGGAAATGGGGGATTAACGCGGGCCGGGGAGCTGTTTTTT	CAISGRGNGGLTRAGELFF	TRBV10-3	TRBJ2-2
TGTGCCAGCAGCTTGGATAGATCCCGGACAGATGTCACTAATGAAAAACTGTTTTTT	CASSLDRSRTDVTNEKLFF	TRBV5-5	TRBJ1-4
TGTGCCAGCAGCCCTCAGCTTCTTCGTCAGCCCCAGCATTTT	CASSPQLLRQPQHF	TRBV5-6	TRBJ1-5
TGTGCCAGCAGAGAAGAGCCCGAACGCGACAGGGGCAATCAGCCCCAGCATTTT	CASREEPERDRGNQPQHF	TRBV6-1	TRBJ1-5
TGCAGCGTTGTAAGTCCCACAGGGGGGACGATTCTGGAGCAGTACTTC	CSVVSPTGGTILEQYF	TRBV29-1	TRBJ2-7
TGCGCCAGCAGCCAAGTGGGGGGGGCCAACGTCCTGACTTTC	CASSQVGGANVLTF	TRBV4-1	TRBJ2-6
TGTGCCAGCAGTGAGGGTCAGGGTTCGGGTAACTATGGCTACACCTTC	CASSEGQGSGNYGYTF	TRBV25-1	TRBJ1-2
TGCGCCAGCAGCCAAGAGCTTTCAAGGGACAGGGCCCCGGATCTTGGCTACACCTTC	CASSQELSRDRAPDLGYTF	TRBV4-1	TRBJ1-2
TGTGCCAGCAGCCAGGGCTGGAGCGGCACAGATACGCAGTATTTT	CASSQGWSGTDTQYF	TRBV7-6	TRBJ2-3
TGCAGCGTTGACAAGCGGGGCTCCTATAATTCACCCCTCCACTTT	CSVDKRGSYNSPLHF	TRBV29-1	TRBJ1-6
TGCGCCAGCGAGTACGGACAGTACGAGCAGTACTTC	CASEYGQYEQYF	TRBV10-1	TRBJ2-7
TGCGCCAGCAGCCAAGAATCAATTATTGGGGGGCAGCCCCAGCATTTT	CASSQESIIGGQPQHF	TRBV4-1	TRBJ1-5
TGCGCCAGCAGGGGGACCGGGACCGAAGAGACCCAGTACTTC	CASRGTGTEETQYF	TRBV4-3	TRBJ2-5
TGTGCCTGGCCAACAAGGTTGAACACTGAAGCTTTCTTT	CAWPTRLNTEAFF	TRBV30	TRBJ1-1
TGTGCCAGCAGCGTACTCCGACCCCTAGGCGGCAGCAATCAGCCCCAGCATTTT	CASSVLRPLGGSNQPQHF	TRBV9	TRBJ1-5
TGTGCCAGCAGCCAAGCGAACGGAATTAGGGGCTACGAGCAGTACTTC	CASSQANGIRGYEQYF	TRBV14	TRBJ2-7
TGCAGCGTTGAAGGGCGTAACTATGGCTACACCTTC	CSVEGRNYGYTF	TRBV29-1	TRBJ1-2
TGTGCCAGCAGCTTTCGAGGTCCCAGTGCGCCTGGAAACACCATATATTTT	CASSFRGPSAPGNTIYF	TRBV11-2	TRBJ1-3
TGCGCCAATGGGGACGACAATGAGCAGTTCTTC	CANGDDNEQFF	TRBV10-1	TRBJ2-1
TGTGCCAGCACGACAGGGGCCGAGCAGTACTTC	CASTTGAEQYF	TRBV6-1	TRBJ2-7
TGTGCCAGCAGTGAAGCCTTGACAGGGGGATCGGCCTATCAGCCCCAGCATTTT	CASSEALTGGSAYQPQHF	TRBV25-1	TRBJ1-5
TGTGCCAGCAGCGTAGCCAGGGGGCGGTCATACAATGAGCAGTTCTTC	CASSVARGRSYNEQFF	TRBV7-9	TRBJ2-1
TGTGCCAGCAGCTTAGCAGGGGAGGTGTCCTACACAGATACGCAGTATTTT	CASSLAGEVSYTDTQYF	TRBV7-9	TRBJ2-3
TGTGCCATCAGTGCCCCAGGGCTTTACGAGCAGTACTTC	CAISAPGLYEQYF	TRBV10-3	TRBJ2-7
TGTGCCAGCAGGGGCCGACAGGGCAGGATGAACACTGAAGCTTTCTTT	CASRGRQGRMNTEAFF	TRBV25-1	TRBJ1-1
TGTGCCAGCAGCGCTCCGACAGGGGGAAGCGAGCAGTACTTC	CASSAPTGGSEQYF	TRBV7-2	TRBJ2-7
TGTGCCGATCAGTTCGAGGGGATGGAGGGGGGCAATCAGCCCCAGCATTTT	CADQFEGMEGGNQPQHF	TRBV10-3	TRBJ1-5
TGCAGCGTTGAAGGGACAGGGATCATCTATGGCTACACCTTC	CSVEGTGIIYGYTF	TRBV29-1	TRBJ1-2
TGTGCCAGCAGGGTCTGTCCGAGCGTATACGAGCAGTACTTC	CASRVCPSVYEQYF	TRBV5-6	TRBJ2-7
TGTGCCAGCAGCTCAGGCCCCCTAGCGGGTCTGGCCTACAATGAGCAGTTCTTC	CASSSGPLAGLAYNEQFF	TRBV3-1	TRBJ2-1
TGTGCCAGCAGCGGTTCGTTCGTAGGACCAGAGAACACTGAAGCTTTCTTT	CASSGSFVGPENTEAFF	TRBV28	TRBJ1-1
TGTGCCAGCAGCACAGGGGCCTATGGCTACACCTTC	CASSTGAYGYTF	TRBV5-5	TRBJ1-2
TGTGCCAGCAGCGGGCTGACACCCCTCGACAGGTCCCGCGATACGCAGTATTTT	CASSGLTPLDRSRDTQYF	TRBV5-5	TRBJ2-3
TGTGCCAGCAGTGATATGCACTTGCCCGACGGGGAAGAAGAGACCCAGTACTTC	CASSDMHLPDGEEETQYF	TRBV2	TRBJ2-5
TGTGCCATCAGTGACCGGACTAGCGGGCCCGAGCAGTACTTC	CAISDRTSGPEQYF	TRBV10-3	TRBJ2-7
TGCGCCAGCAAGAGGGGAGGCGAGCAGTACTTC	CASKRGGEQYF	TRBV10-1	TRBJ2-7
TGTGCCAGCAGCATCCGGGACAATAATCTACATGAGCAGTTCTTC	CASSIRDNNLHEQFF	TRBV7-9	TRBJ2-1
TGTGCCAGCAGTTACTCCCACAGGGGTGTGAACACTGAAGCTTTCTTT	CASSYSHRGVNTEAFF	TRBV6-5	TRBJ1-1
TGTGCCAGCAGTTCCTCCCTAAGGGACGATAATTTGCATGGCTACACCTTC	CASSSSLRDDNLHGYTF	TRBV27	TRBJ1-2
TGTGCCAGCAGCCAACTCCCTAGTAAGCAGATGGAGACCCAGTACTTC	CASSQLPSKQMETQYF	TRBV3-1	TRBJ2-5
TGTGCCAGCAGCTTAGCGGTTCCAGTGAAAAGCAATCAGCCCCAGCATTTT	CASSLAVPVKSNQPQHF	TRBV7-9	TRBJ1-5
TGTGCCAGCAGGGTATGCGCAGAATACCATGGCTACACCTTC	CASRVCAEYHGYTF	TRBV6-5	TRBJ1-2
TGTGCCAGCAGCATTCGGGACTTCTTATCCGGGAACACTGAAGCTTTCTTT	CASSIRDFLSGNTEAFF	TRBV7-4	TRBJ1-1
TGCGCCAGCAGTGAGGGTGAGCAGGCGGGGATCTACGAGCAGTACTTC	CASSEGEQAGIYEQYF	TRBV10-1	TRBJ2-7
TGTGCCAGCGAGGGGGGGACAACTTGCTACAATGAGCAGTTCTTC	CASEGGTTCYNEQFF	TRBV27	TRBJ2-1
TGTGCCACCAGTGAGGTCACACAGGGCGTCTCACCCCTCCACTTT	CATSEVTQGVSPLHF	TRBV24-1	TRBJ1-6
TGTGCCAGCCCGACAGGGGTCGAGCAACCCCCGCAGTATTTT	CASPTGVEQPPQYF	TRBV2	TRBJ2-3
TGTGCCAGCAGTGTCGGAGACTCATCCTACGAGCAGTACTTC	CASSVGDSSYEQYF	TRBV12-3	TRBJ2-7
TGTGCCAGCAGTGAAACCCGCGGGAGGTGTTTCTACTACGAGCAGTACTTC	CASSETRGRCFYYEQYF	TRBV6-1	TRBJ2-7
TGTGCCAGCAGTGAATATCGGGTAGAGAGGGGGTATGGGAAGGACGAGCAGTACTTC	CASSEYRVERGYGKDEQYF	TRBV25-1	TRBJ2-7
TGTGCCAGCAGCCCGCCCGGGCCACCCGCTGACACTGAAGCTTTCTTT	CASSPPGPPADTEAFF	TRBV11-3	TRBJ1-1
TGTGCCAGCATAGCGGGAGGCTCCTACAATGAGCAGTTCTTC	CASIAGGSYNEQFF	TRBV6-3	TRBJ2-1
TGTGCCAGCAGCACGGGGCGAAATGGCTACACCTTC	CASSTGRNGYTF	TRBV7-4	TRBJ1-2
TGTGCCAGCAGGAAGTTGGGGGGAACAGATACGCAGTATTTT	CASRKLGGTDTQYF	TRBV12-4	TRBJ2-3
TGTGCCAGCAGCCAAGATCGACAGGGCTGCACAGATACGCAGTATTTT	CASSQDRQGCTDTQYF	TRBV14	TRBJ2-3
TGTGCCAGCAGCTTAGGCCTTGCAGGGTCGCACGAGACCCAGTACTTC	CASSLGLAGSHETQYF	TRBV7-2	TRBJ2-5
TGTGCCAGCAGCTTAGGGCGGGGCTTGCGTGCTAATGAAAAACTGTTTTTT	CASSLGRGLRANEKLFF	TRBV7-9	TRBJ1-4
TGTGCCAGCATTCAAAGAAGGGACAGGTCTGGGGCCAACGTCCTGACTTTC	CASIQRRDRSGANVLTF	TRBV6-3	TRBJ2-6
TGTGCCATGTCAGCTTGGACTGAAGCTTTCTTT	CAMSAWTEAFF	TRBV27	TRBJ1-1
TGCAGTGCTCCCGAGGGGAATAATGAGCAGTTCTTC	CSAPEGNNEQFF	TRBV20-1	TRBJ2-1
TGTGCCAGCAGCTTCCTTCGGGACAGGGACTATGGCTACACCTTC	CASSFLRDRDYGYTF	TRBV7-7	TRBJ1-2
TGTGCCAGCAGTGACCCAAGGCGCAGCGGTTGGGGGGACTCTGGAAACACCATATATTTT	CASSDPRRSGWGDSGNTIYF	TRBV6-4	TRBJ1-3
TGTGCCAGCAGCGCCCCCGGGGGCGCATTTTATGGCTACACCTTC	CASSAPGGAFYGYTF	TRBV13	TRBJ1-2
TGTGCCACCAGTGGTGGTATACCGTGGGCCAACAGGTACGAGCAGTACTTC	CATSGGIPWANRYEQYF	TRBV24-1	TRBJ2-7
TGTGCCAGCAGCTTCATCTTATTCATGAACACTGAAGCTTTCTTT	CASSFILFMNTEAFF	TRBV11-3	TRBJ1-1
TGCACTAGTGGGGAGACCCAGTACTTC	CTSGETQYF	TRBV20-1	TRBJ2-5
TGTGCCAGCAGTGAATGCACGGCCTTGCGGGTTCCGCAGTACTTC	CASSECTALRVPQYF	TRBV6-1	TRBJ2-7
TGCAGCAGCGAGGACAGGCGATCTGGAAACACCATATATTTT	CSSEDRRSGNTIYF	TRBV29-1	TRBJ1-3
TGTGCCAGCAGTATTAAGCAATATGGCTACACCTTC	CASSIKQYGYTF	TRBV6-8	TRBJ1-2
TGTGCCAGCAGTTATTTCCGTGGGACAGGGGCAGATACGCAGTATTTT	CASSYFRGTGADTQYF	TRBV6-2	TRBJ2-3
TGTGCCAGCAGTTCTAGTACCCCGTGCGGGGGCTACAATGAGCAGTTCTTC	CASSSSTPCGGYNEQFF	TRBV28	TRBJ2-1
TGTGCCAGCAGCTTAGCGCGACGGGAACGGGGAGAAGCTTTCTTT	CASSLARRERGEAFF	TRBV7-2	TRBJ1-1
TGTGCCAGCATGAATGCTAGCGCCGAGAACGAGCAGTACTTC	CASMNASAENEQYF	TRBV3-1	TRBJ2-7
TGTGCCAGCTCACCACTATCCGCTAGCGGCAGCTACAATGAGCAGTTCTTC	CASSPLSASGSYNEQFF	TRBV18	TRBJ2-1
TGTGCCAGCAGTGGCCTAAGGGACAATGAGCAGTTCTTC	CASSGLRDNEQFF	TRBV28	TRBJ2-1
TGTGCCAGCAGTTGCCTAATTGCCAAAAACATTCAGTACTTC	CASSCLIAKNIQYF	TRBV6-6	TRBJ2-4
TGTGCCAGCAGCTCGCTCCAGGGTGGATCCGGGGAGCTGTTTTTT	CASSSLQGGSGELFF	TRBV6-6	TRBJ2-2
TGTGCCAGCAGTTGGCCAGGTCTTACTAGCGGGAGGGGGGAAGCGAAGGAGCAGTTCTTC	CASSWPGLTSGRGEAKEQFF	TRBV6-5	TRBJ2-1
TGCAGTGCTACGCGACGTGCGACCCAGTACTTC	CSATRRATQYF	TRBV20-1	TRBJ2-5
TGCAGTGCCGCTTCAAATCCCGGGACAGGCACCGAAAAATACACTGAAGCTTTCTTT	CSAASNPGTGTEKYTEAFF	TRBV20-1	TRBJ1-1
TGCAGTGCTACTAGCGGGGGGGCCGGCTACGAGCAGTACTTC	CSATSGGAGYEQYF	TRBV20-1	TRBJ2-7
TGTGCCAGCAGCGTAGGGGCTAGCGGGGAGCAGTACTTC	CASSVGASGEQYF	TRBV9	TRBJ2-7
TGTGCCAGCAGCGACCGTCTGGGATACCAAGAGACCCAGTACTTC	CASSDRLGYQETQYF	TRBV11-2	TRBJ2-5
TGTGCCTGGAGACAGGGGGCGGAGGGCAATCAGCCCCAGCATTTT	CAWRQGAEGNQPQHF	TRBV30	TRBJ1-5
TGCGCCAGCAGCAAATCACCTCAGCCCCAGCATTTT	CASSKSPQPQHF	TRBV5-1	TRBJ1-5
TGCAGTGCTTCCGGGACTAGCGGGGGGAGGGACTACGAGCAGTACTTC	CSASGTSGGRDYEQYF	TRBV20-1	TRBJ2-7
TGTGCCAGCATCCTCAGGAAGGGTGGCTACACCTTC	CASILRKGGYTF	TRBV14	TRBJ1-2
TGTGCCACCAGTGATTCCCGAGAATGGACGCGCTACGAGCAGTACTTC	CATSDSREWTRYEQYF	TRBV24-1	TRBJ2-7
TGTGCCAGCAGCCGGGTCTTC	CASSRVF	TRBV7-3	TRBJ2-1
TGTGCCAGCAGTGGACCGGGACAGGGTCAGGTGGGCCAGTATGGCTACACCTTC	CASSGPGQGQVGQYGYTF	TRBV25-1	TRBJ1-2
TGTGCCAGCAGCCAAGACCATGGGACCGGAGGGGTAGCTGAAGCTTTCTTT	CASSQDHGTGGVAEAFF	TRBV3-1	TRBJ1-1
TGCGCCAGCAGCCCATCCAGTAAGAAAGAGACCCAGTACTTC	CASSPSSKKETQYF	TRBV4-1	TRBJ2-5
TGTGCCAGCATTCTTGTGCCATTACGTCGGGCTAGCTCCTACAATGAGCAGTTCTTC	CASILVPLRRASSYNEQFF	TRBV6-4	TRBJ2-1
TGTGCCACCAGTGCATGTCCCCCCTATCAGCCCCAGCATTTT	CATSACPPYQPQHF	TRBV24-1	TRBJ1-5
TGTGCCAGCAGCTATTTTAGCGGGAGTTTACGCATCGATACGCAGTATTTT	CASSYFSGSLRIDTQYF	TRBV5-4	TRBJ2-3
TGTGCCAGCAGCCAAGATCTGGTAGAATTAAGGGGAGGGGAACTATTTCAGCCCCAGCATTTT	CASSQDLVELRGGELFQPQHF	TRBV4-2	TRBJ1-5
TGCAGTGCTAGAGACAGGGGGCGAGGGGGGATATATTTT	CSARDRGRGGIYF	TRBV20-1	TRBJ1-3
TGCGCCAGCAGTGAGTCGCGACATAGGGCAGGGTTAGACTATGGCTACACCTTC	CASSESRHRAGLDYGYTF	TRBV10-1	TRBJ1-2
TGTGCCAGCAGGGTGGGGGACACTAAGAGGAATGAAAAACTGTTTTTT	CASRVGDTKRNEKLFF	TRBV28	TRBJ1-4
TGTGCCAGCAGGGAGCTAGCGGGCACTGAGACCCAGTACTTC	CASRELAGTETQYF	TRBV28	TRBJ2-5
TGTGCCAGCAGCCAAGAGCCCGAGGGGGTTTGGGGCGTATCCAAAAACATTCAGTACTTC	CASSQEPEGVWGVSKNIQYF	TRBV4-2	TRBJ2-4
TGCGCCAGCAGCTTCGGGGAGGGTGGGACCTACGAGCAGTACTTC	CASSFGEGGTYEQYF	TRBV5-1	TRBJ2-7
TGTGCCAGCAGCCAGAGCTCCTACGAGCAGTACTTC	CASSQSSYEQYF	TRBV3-1	TRBJ2-7
TGTGCCAGCAGTTTGCTGGGGGGGGCGTACTTGGTCAATGAGCAGTTCTTC	CASSLLGGAYLVNEQFF	TRBV28	TRBJ2-1
TGTGCCAGCAGTGGGGTTAGAGGGAAGTATAGCAATCAGCCCCAGCATTTT	CASSGVRGKYSNQPQHF	TRBV27	TRBJ1-5
TGTGCCAGCGAGCTTTCGTCGTTCTTCGAGTCTAACTATGGCTACACCTTC	CASELSSFFESNYGYTF	TRBV6-5	TRBJ1-2
TGTGCCAGCAGCGTGAGGGGGGGTATTCTAGAGACCCAGTACTTC	CASSVRGGILETQYF	TRBV3-1	TRBJ2-5
TGTGCCAGCAGGGGGGAAGCGGGAGTACTCGCCCGGGATGGCTACACCTTC	CASRGEAGVLARDGYTF	TRBV27	TRBJ1-2
TGTGCCAGCAGCAAAACACAGGGGAAGGACTACGAGCAGTACTTC	CASSKTQGKDYEQYF	TRBV13	TRBJ2-7
