TGTGCGCAGACCAGGGAGAATTCACCCCTCCACTTT	CAQTRENSPLHF	TRBV24-1	TRBJ1-6
TGTGCCAGCAGTGCGAGGGCTAACGAGCAGTACTTC	CASSARANEQYF	TRBV6-4	TRBJ2-7
TGCAGTGCTAGTCGACCGTTGAAGGTCCATGAGCAGTTCTTC	CSASRPLKVHEQFF	TRBV20-1	TRBJ2-1
TGCAGCGTTGAGTTCAGTAACGGGACAGGGGGAAACACCATATATTTT	CSVEFSNGTGGNTIYF	TRBV29-1	TRBJ1-3
TGTGCCAGCAGCTTAGCTTCGTATACAGAAACAAACCTGAACACCGGGGAGCTGTTTTTT	CASSLASYTETNLNTGELFF	TRBV7-9	TRBJ2-2
TGTGCCAGCAGCCACCCCAACCATGACAGAGGCTACGAGCAGTACTTC	CASSHPNHDRGYEQYF	TRBV3-1	TRBJ2-7
TGTGCCAGCAGCTTAACGGCCGGGGGGTGGGGGGGGGACAGCTCCTATAATTCACCCCTCCACTTT	CASSLTAGGWGGDSSYNSPLHF	TRBV7-3	TRBJ1-6
TGTGGACGGGGGTTAGGTTCTGGAAACACCATATATTTT	CGRGLGSGNTIYF	TRBV11-3	TRBJ1-3
TGTGCCAGCAGCTTGACCACTAGCGGGAGAGACAGGACCCCCCAAGAGACCCAGTACTTC	CASSLTTSGRDRTPQETQYF	TRBV7-9	TRBJ2-5
TGTGCTAGTGGTGGGCAGGATCGCGGCTCTGGAAACACCATATATTTT	CASGGQDRGSGNTIYF	TRBV12-5	TRBJ1-3
TGTGCCAGCAGTTACTCAAAAGGGCGGGAGCAGTACTTC	CASSYSKGREQYF	TRBV6-5	TRBJ2-7
TGTGCCACCCCACGCGTAGGCACAGATACGCAGTATTTT	CATPRVGTDTQYF	TRBV24-1	TRBJ2-3
TGTGCCAGCAGCTTGGCTGGGGATAGCAATCAGCCCCAGCATTTT	CASSLAGDSNQPQHF	TRBV7-9	TRBJ1-5
TGTGCCACGGGGGATTGGACTAGCGGGGGAGAGACCCAGTACTTC	CATGDWTSGGETQYF	TRBV24-1	TRBJ2-5
TGCAGTGCTAGAGAAAGGGCCGACGGAAGTCCCAGCACAGATACGCAGTATTTT	CSARERADGSPSTDTQYF	TRBV20-1	TRBJ2-3
TGTGCCAGCAGTTGTGGGACTAGCGGAGGCACAGATACGCAGTATTTT	CASSCGTSGGTDTQYF	TRBV6-5	TRBJ2-3
TGCGCCAGCAGTGAGTCTGCAAGTCGGGTTTTGTTAGGGAACACCGGGGAGCTGTTTTTT	CASSESASRVLLGNTGELFF	TRBV10-2	TRBJ2-2
TGTGCCAGCCCCCGGGACAGGGTGCGAACGGAAGAGACCCAGTACTTC	CASPRDRVRTEETQYF	TRBV27	TRBJ2-5
TGTGCCAGCAGCTTAGGGCCCAGGGGACAGGGGAAGGCCCATGGCTACACCTTC	CASSLGPRGQGKAHGYTF	TRBV7-2	TRBJ1-2
TGTGCCAGCAGCCAGGGGGAGGGGGTGGGAAACACCATATATTTT	CASSQGEGVGNTIYF	TRBV6-6	TRBJ1-3
TGCGCCAGCAGCCAACCGAGGGCCTACAATGAGCAGTTCTTC	CASSQPRAYNEQFF	TRBV4-1	TRBJ2-1
TGTGCCAGCAGCTGTTACGGGTTTGGCTCTGGGGCCAACGTCCTGACTTTC	CASSCYGFGSGANVLTF	TRBV7-9	TRBJ2-6
TGTGCCAGCAGCCTTGAAACAGGGCCTGGGGTGGGCACAGATACGCAGTATTTT	CASSLETGPGVGTDTQYF	TRBV7-9	TRBJ2-3
TGTGCCAGCAGCTTATCTAAAAGGGGAATAGATGGGGCCAACGTCCTGACTTTC	CASSLSKRGIDGANVLTF	TRBV7-9	TRBJ2-6
TGCGCCAGCAACAACAGACAGGTACCGGGCTACACCTTC	CASNNRQVPGYTF	TRBV10-2	TRBJ1-2
TGCAGTGCAGGGAAACGAGTCAGTCCCCTCGGGGAGCTGTTTTTT	CSAGKRVSPLGELFF	TRBV20-1	TRBJ2-2
TGTGCCAGCAGCTTGGCCACCGGGGGCTATCAGCCCCAGCATTTT	CASSLATGGYQPQHF	TRBV5-4	TRBJ1-5
TGTGCTAGTGGTTTGGGACGTCTCGGACCCTACAATGAGCAGTTCTTC	CASGLGRLGPYNEQFF	TRBV12-5	TRBJ2-1
TGCGCCAGCAGCTTGCCGACAGGGAAATGGGAAGGTGAAGCTTTCTTT	CASSLPTGKWEGEAFF	TRBV5-1	TRBJ1-1
TGTGCCAGCAGCTTAACGCGACAGGGGCCTGAAAAACTGTTTTTT	CASSLTRQGPEKLFF	TRBV7-3	TRBJ1-4
TGCGCCAACTCCGGGACGGGCTACACTGAAGCTTTCTTT	CANSGTGYTEAFF	TRBV10-1	TRBJ1-1
TGCAGTGCTAGAGCCGAGTGGGGGGGCGTGGATGAGCAGTTCTTC	CSARAEWGGVDEQFF	TRBV20-1	TRBJ2-1
TGTGCCATCAGTTGGACAGGGGCCGGGGAAACTGAAGCTTTCTTT	CAISWTGAGETEAFF	TRBV10-3	TRBJ1-1
TGTGCCAGCAGTTTATGCTCACAGGGATCACCCCTCCACTTT	CASSLCSQGSPLHF	TRBV27	TRBJ1-6
TGTGCCAGCAGCAAAGGGCAGGGTGATGAGCAGTTCTTC	CASSKGQGDEQFF	TRBV11-2	TRBJ2-1
TGTGCCATCAATGGGCAGGGGCCAGGGAATCAGCCCCAGCATTTT	CAINGQGPGNQPQHF	TRBV10-3	TRBJ1-5
TGCAGTGCTAGTAACGAGGCGGGCCGGGACCAAGAGACCCAGTACTTC	CSASNEAGRDQETQYF	TRBV20-1	TRBJ2-5
TGTGCCAGCAGCAAAGGTAACTATGGCTACACCTTC	CASSKGNYGYTF	TRBV7-9	TRBJ1-2
TGTGCCAGCAGCGTTAATCTGGGACCCCCCAAGGCTTTCTTT	CASSVNLGPPKAFF	TRBV9	TRBJ1-1
TGTGCCACCAGTGTCACACGCAGGGGACCCAATGAGCAGTTCTTC	CATSVTRRGPNEQFF	TRBV24-1	TRBJ2-1
TGCGCCAAACCAAGGACAGGGACTAGGTATGGCTACACCTTC	CAKPRTGTRYGYTF	TRBV10-2	TRBJ1-2
TGTGCCAACGACAGGCGTAAAAACATTCAGTACTTC	CANDRRKNIQYF	TRBV14	TRBJ2-4
TGCAGTGCTAGACGGACGGACACTGAAGCTTTCTTT	CSARRTDTEAFF	TRBV20-1	TRBJ1-1
TGTGCCAGCAGCAATTACAGGGAGCCCCAGCATTTT	CASSNYREPQHF	TRBV7-3	TRBJ1-5
TGCAGTGCTGTTTTTGGACAGGGGGGGAACACTGAAGCTTTCTTT	CSAVFGQGGNTEAFF	TRBV20-1	TRBJ1-1
TGCAGTGCTACACCCGTCCGGGACTTTGGGGCCAACGTCCTGACTTTC	CSATPVRDFGANVLTF	TRBV20-1	TRBJ2-6
TGTGCCACGAAGTCCCAGCCAGGGTGGAAGCAGTACTTC	CATKSQPGWKQYF	TRBV24-1	TRBJ2-7
TGTGCCTGGAGTGTTTACCTTGTACCGGGCTCCTACGAGCAGTACTTC	CAWSVYLVPGSYEQYF	TRBV30	TRBJ2-7
TGCGCCAGCAGCTTGGCCGTAACAGGGGGCAATCGTTCACCAGATACGCAGTATTTT	CASSLAVTGGNRSPDTQYF	TRBV5-1	TRBJ2-3
TGCAGTGCTAGAGAAGCGAGCTCTGGAAACACCATATATTTT	CSAREASSGNTIYF	TRBV20-1	TRBJ1-3
TGTGCCAGCAGCCATGGGGGGAAGGGCAACACCGGGGAGCTGTTTTTT	CASSHGGKGNTGELFF	TRBV3-1	TRBJ2-2
TGCAGTGCTAGAGTAGGTTTCATGGGGGGAGTTCTCTCACGCAATCAGCCCCAGCATTTT	CSARVGFMGGVLSRNQPQHF	TRBV20-1	TRBJ1-5
TGTGCCAGCAGCTTAGCCAATGGAGCAACTAATGAAAAACTGTTTTTT	CASSLANGATNEKLFF	TRBV7-9	TRBJ1-4
TGTGCCTGGCGGGGAACGGGGGGGGAGCCCCAGCATTTT	CAWRGTGGEPQHF	TRBV30	TRBJ1-5
TGCGCCAGCAGCTTTTCCCACAGGGCCGATCAGCCCCAGCATTTT	CASSFSHRADQPQHF	TRBV5-1	TRBJ1-5
TGTGCCAGCAGCTTTGGGGGCGATCAGCCCCAGCATTTT	CASSFGGDQPQHF	TRBV7-3	TRBJ1-5
TGTGCCAGCAGCTTACGGGGCTACGAGCAGTACTTC	CASSLRGYEQYF	TRBV7-9	TRBJ2-7
TGCGCCAGCAGCTCCACAGGGGGCTATGGCTACACCTTC	CASSSTGGYGYTF	TRBV5-1	TRBJ1-2
TGTGCCAGCAGCTTGGGAGGCCGGGACAATGGAAACACCATATATTTT	CASSLGGRDNGNTIYF	TRBV5-8	TRBJ1-3
TGCGCCAGCCCCCCAACGGATAGCAATCAGCCCCAGCATTTT	CASPPTDSNQPQHF	TRBV10-1	TRBJ1-5
TGTGCCAGCAGAGCGGGGCCCACCGGGGAGCTGTTTTTT	CASRAGPTGELFF	TRBV11-2	TRBJ2-2
TGTGCCAGCAGTTTCCATCGGAGGGATAAGAGGTACCAAGAGACCCAGTACTTC	CASSFHRRDKRYQETQYF	TRBV12-3	TRBJ2-5
TGTGCCAGCACCAGGGGGAGTGACACCATATATTTT	CASTRGSDTIYF	TRBV27	TRBJ1-3
TGCGCCAGCAGGGGTAGTATGAACACTGAAGCTTTCTTT	CASRGSMNTEAFF	TRBV5-1	TRBJ1-1
TGTGCCAGCCCGGGATACTCCTACGAGCAGTACTTC	CASPGYSYEQYF	TRBV6-5	TRBJ2-7
TGTGCCAGCAGCAGGGACACAGATACGCAGTATTTT	CASSRDTDTQYF	TRBV5-6	TRBJ2-3
TGTGCCAGCAGTTTGGGCGGTTTGAAAAACATTCAGTACTTC	CASSLGGLKNIQYF	TRBV28	TRBJ2-4
TGTGCCAGCAGTTCCCCGGAACGTCAGCCCCAGCATTTT	CASSSPERQPQHF	TRBV6-6	TRBJ1-5
TGTGCCACCAGTGCATTACAGGGTCCGGAGCAGTACTTC	CATSALQGPEQYF	TRBV24-1	TRBJ2-7
TGTGCCAGCAGCACAATCTACGCTCGCTACGAGCAGTACTTC	CASSTIYARYEQYF	TRBV6-5	TRBJ2-7
TGTGCCAGCAGAGTACCCAACCGGGACAGTATGAACACTGAAGCTTTCTTT	CASRVPNRDSMNTEAFF	TRBV6-4	TRBJ1-1
TGTGCCTTTAGTAGTACGGCCAGGAAAGTAGAAAAACTGTTTTTT	CAFSSTARKVEKLFF	TRBV10-3	TRBJ1-4
TGCGCCAGCAGCGTTAGGGGGGGCGGGTACGAGCAGTACTTC	CASSVRGGGYEQYF	TRBV5-1	TRBJ2-7
TGTGCCAGCTCACCATTAAACTCCGACAGGGTCCCGCAGTACTTC	CASSPLNSDRVPQYF	TRBV18	TRBJ2-7
TGTGCCAGCAGCTTTAGCCGGACAGGGGGCCGGCACGAGCAGTACTTC	CASSFSRTGGRHEQYF	TRBV11-3	TRBJ2-7
TGTGCCAGCAGTCCCAATGTTACAGGGCAAGAGACCCAGTACTTC	CASSPNVTGQETQYF	TRBV6-5	TRBJ2-5
TGTGCCAGCAGTTTCAGATCAAGGGGCGCCGATACCCAGTACTTC	CASSFRSRGADTQYF	TRBV27	TRBJ2-5
TGTGCCAGCAGTTCGAAGGGGGACTGTTGGTCCTACAATGAGCAGTTCTTC	CASSSKGDCWSYNEQFF	TRBV27	TRBJ2-1
TGTGCCACCAGTGAGGGGGAAGCCTCTGGGGCCAACGTCCTGACTTTC	CATSEGEASGANVLTF	TRBV24-1	TRBJ2-6
TGTGCCAGCAGCTTAGAGGCTAACGGCGGGGACGAGCAGTACTTC	CASSLEANGGDEQYF	TRBV7-9	TRBJ2-7
TGTGCCAGCAGCTTACGACAGGGAAGTGAAAAACTGTTTTTT	CASSLRQGSEKLFF	TRBV7-9	TRBJ1-4
TGCAGTCCGGGACTAGCGGCACGGACAGATACGCAGTATTTT	CSPGLAARTDTQYF	TRBV20-1	TRBJ2-3
TGTGCCAGCATAATTCCTAGTAATGAAAAACTGTTTTTT	CASIIPSNEKLFF	TRBV6-4	TRBJ1-4
TGTGCCAGCAGCTGGGGGGGGTTAGACTACGAGCAGTACTTC	CASSWGGLDYEQYF	TRBV5-6	TRBJ2-7
TGCGCCATCGGGCTCTCTAGATGCACTGAAGCTTTCTTT	CAIGLSRCTEAFF	TRBV10-1	TRBJ1-1
TGTGCCAGCAGCTTACAACACAGGGAAGTGTATGAGCAGTTCTTC	CASSLQHREVYEQFF	TRBV7-9	TRBJ2-1
TGTGCCAGCAGCCAAGATGGGGAGTTATGGACCGGGGAGCTGTTTTTT	CASSQDGELWTGELFF	TRBV14	TRBJ2-2
TGTGCCAGCAGCGGGGGGGGTTTCGGGGACACCGGGGAGCTGTTTTTT	CASSGGGFGDTGELFF	TRBV13	TRBJ2-2
TGTGCCAGCAGTAAACTGAAGGGGGGGAGCGCGAACACTGAAGCTTTCTTT	CASSKLKGGSANTEAFF	TRBV6-5	TRBJ1-1
TGTGCCAGCAGTGCTTCTGGGGCAGTTCTCGGGTTAAGAAGAGACAGGTTATGCTGTCACTATGGCTACACCTTC	CASSASGAVLGLRRDRLCCHYGYTF	TRBV27	TRBJ1-2
TGTGCCAGCAGCTTAAGGGGATACGGGACAGGGGTGGATAACACTGAAGCTTTCTTT	CASSLRGYGTGVDNTEAFF	TRBV11-1	TRBJ1-1
TGTGCCAGCAGCAAATTATGGCAGGGGGGCTATGGCTACACCTTC	CASSKLWQGGYGYTF	TRBV7-4	TRBJ1-2
TGCAGCGTTTTAGGACAGGACAATGAGCAGTTCTTC	CSVLGQDNEQFF	TRBV29-1	TRBJ2-1
TGTGCCAGTACGGACATTGCAGATACGCAGTATTTT	CASTDIADTQYF	TRBV19	TRBJ2-3
TGTGCCAGCAGTATCCCAGGGAGGAACACTGAAGCTTTCTTT	CASSIPGRNTEAFF	TRBV12-3	TRBJ1-1
TGTGCCACCAGTGAGGAGCCAGGGGTGAGCTCCTACGAGCAGTACTTC	CATSEEPGVSSYEQYF	TRBV24-1	TRBJ2-7
TGTGCCAGCAGTGGACAATTACTAGGAAGTCCCAATTCACCCCTCCACTTT	CASSGQLLGSPNSPLHF	TRBV6-1	TRBJ1-6
TGTGCCAGCAGCCTAGGCCTTACCTACGAGCAGTACTTC	CASSLGLTYEQYF	TRBV7-4	TRBJ2-7
TGTGCCAGAAGATGGGGGAGGACGAGCTCCTACAATGAGCAGTTCTTC	CARRWGRTSSYNEQFF	TRBV6-1	TRBJ2-1
TGTGCCACCAGCTTGGAGAGGGGGAGCTCCTACGAGCAGTACTTC	CATSLERGSSYEQYF	TRBV15	TRBJ2-7
TGCAGTGCTCGGCAACTGAATAACGAGCAGTACTTC	CSARQLNNEQYF	TRBV20-1	TRBJ2-7
TGTGCTAGTGGTTTGGTATGGGGGGGGGTCACGGTGAACACTGAAGCTTTCTTT	CASGLVWGGVTVNTEAFF	TRBV12-5	TRBJ1-1
TGTGCCAGCAGCTTAGGTGCCCCGTGCTATGGCTACACCTTC	CASSLGAPCYGYTF	TRBV11-2	TRBJ1-2
TGCGCCAGCAGCCACCGGGGGGGGCGACCCGCCAATGAGCAGTTCTTC	CASSHRGGRPANEQFF	TRBV4-1	TRBJ2-1
TGTGCCAGCAGTTTACATCCTAGTCGGACTAGCGGGGACAATGAGCAGTTCTTC	CASSLHPSRTSGDNEQFF	TRBV27	TRBJ2-1
TGTGCCAGCAGCCAAGACCACAGGGGAAATAGCAATCAGCCCCAGCATTTT	CASSQDHRGNSNQPQHF	TRBV14	TRBJ1-5
TGTGCCAGCAGCTTCCGGGACAGTCATGAAAAACTGTTTTTT	CASSFRDSHEKLFF	TRBV11-3	TRBJ1-4
TGTGCCAGCAGTTACAATCCGGGACTAGGAAACCCCTACGAGCAGTACTTC	CASSYNPGLGNPYEQYF	TRBV6-2	TRBJ2-7
TGTGCCAGCAGCTTAAATGGGGGGGGGCACGGGGGGAACACCGGGGAGCTGTTTTTT	CASSLNGGGHGGNTGELFF	TRBV11-3	TRBJ2-2
TGTGCCAGCAGTCTGACAGGGGGCGAGACCCAGTACTTC	CASSLTGGETQYF	TRBV25-1	TRBJ2-5
TGTGCCAGTAGTACACCCTCCAGGGATACGGAGTACTTC	CASSTPSRDTEYF	TRBV19	TRBJ2-7
TGTGCCAGCCTCAGGGGGCGAGGCACTGAAGCTTTCTTT	CASLRGRGTEAFF	TRBV27	TRBJ1-1
TGTGCCAGCAGCCCACCAGCTGTACGAAGGGGGGGGAGAGACAATGAGCAGTTCTTC	CASSPPAVRRGGRDNEQFF	TRBV5-8	TRBJ2-1
TGTGCCAGCACCACCCGACTAGCGACCTACAATGAGCAGTTCTTC	CASTTRLATYNEQFF	TRBV6-5	TRBJ2-1
TGTGCCACCAGCCGGGGGAGGGAAGAGCAGTACTTC	CATSRGREEQYF	TRBV24-1	TRBJ2-7
TGTGCCAGCAGTCACGCGGACAGGGGCTACACCTTC	CASSHADRGYTF	TRBV28	TRBJ1-2
TGTGCCAGCAGCGTAGGGGCCCCGACCCAGTACTTC	CASSVGAPTQYF	TRBV9	TRBJ2-5
TGCAGCGTTGGTTCCGACCTGCGCTACGAGCAGTACTTC	CSVGSDLRYEQYF	TRBV29-1	TRBJ2-7
TGTGCCAGCAGCAATGGGCGGGGCCGGTCTAATGAAAAACTGTTTTTT	CASSNGRGRSNEKLFF	TRBV7-3	TRBJ1-4
TGTGCCAGCAGTCAGGATGGACAGCGAATTGGCTACACCTTC	CASSQDGQRIGYTF	TRBV27	TRBJ1-2
TGTGCCAGTAGTACGCGGGAGGGGGTGCACCTGAACACTGAAGCTTTCTTT	CASSTREGVHLNTEAFF	TRBV19	TRBJ1-1
TGTGGATGGGGCGGCACTCGGTATAACTATGGCTACACCTTC	CGWGGTRYNYGYTF	TRBV3-1	TRBJ1-2
TGTGCCATCAGTGAACTTCAGAGGCTAGCGGGCGGGGGCACAGATACGCAGTATTTT	CAISELQRLAGGGTDTQYF	TRBV10-3	TRBJ2-3
TGTGCCAGCAGCGTATCCCCGGGACATCAGCCCCAGCATTTT	CASSVSPGHQPQHF	TRBV9	TRBJ1-5
TGTGCCAGCAGCGGCGACAGGGGGAGCTACAATGAGCAGTTCTTC	CASSGDRGSYNEQFF	TRBV6-4	TRBJ2-1
TGTGCCAGCACCAGCGGGACGAACCCAAGCTCGGTTCACGAGCAGTACTTC	CASTSGTNPSSVHEQYF	TRBV12-3	TRBJ2-7
TGTGCCAGCAGCTTAAGGGGGGGCCCTTCAACCCGGATGTACGAGCAGTACTTC	CASSLRGGPSTRMYEQYF	TRBV7-8	TRBJ2-7
TGTGCCAGCAAAGGGGGTTGTCAACCCGGGGCCCCGAACTATGGCTACACCTTC	CASKGGCQPGAPNYGYTF	TRBV6-1	TRBJ1-2
TGCGCCAGCAGCCAAGACAGGGGGCACAATTCACCCCTCCACTTT	CASSQDRGHNSPLHF	TRBV4-1	TRBJ1-6
TGTGCCAGCAGCCAAGATACGGTAGCCTACGAGCAGTACTTC	CASSQDTVAYEQYF	TRBV14	TRBJ2-7
TGTGCCAGTAGTATATACCATAGGGTAGCTATCGGCTACGAGCAGTACTTC	CASSIYHRVAIGYEQYF	TRBV19	TRBJ2-7
TGTGCCAGTAGTATAGAACTAGCCACAGGACAGGGCCAAGGGTACAATGAGCAGTTCTTC	CASSIELATGQGQGYNEQFF	TRBV19	TRBJ2-1
TGTGCCAGCACGTTCCAGGGGAACTCTGGAAACACCATATATTTT	CASTFQGNSGNTIYF	TRBV2	TRBJ1-3
TGCAGCGTTGTTATTCCCGGGACAGGGGCATATGATTTTAACACTGAAGCTTTCTTT	CSVVIPGTGAYDFNTEAFF	TRBV29-1	TRBJ1-1
TGCAGTGCTGGTTCGGTTAGGACAGAAGGGTCAGATACGCAGTATTTT	CSAGSVRTEGSDTQYF	TRBV20-1	TRBJ2-3
TGCGCCAGCAGCTTGACCCCGATGTCGGGAGGAGTCTACGAGCAGTACTTC	CASSLTPMSGGVYEQYF	TRBV5-1	TRBJ2-7
TGCAGCGTTGAGACACCCTACGAAAGAGCGGAAAACGAGCAGTACTTC	CSVETPYERAENEQYF	TRBV29-1	TRBJ2-7
TGTGCCAGCAGCTTGCGGTACAGGGGGCGCGCAGGCATCTTACAGAATGAAAAACTGTTTTTT	CASSLRYRGRAGILQNEKLFF	TRBV5-8	TRBJ1-4
TGTGCCAGCAGCCGGGGGGGGCCCCTGATACCAGATACGCAGTATTTT	CASSRGGPLIPDTQYF	TRBV3-1	TRBJ2-3
TGTGCCAGCAGCTTGGGGGGCTCTGGAAACACCATATATTTT	CASSLGGSGNTIYF	TRBV5-6	TRBJ1-3
TGCGCCAGCGCAAGCGGCGGGGCCAGCTCTGGGGCCAACGTCCTGACTTTC	CASASGGASSGANVLTF	TRBV5-1	TRBJ2-6
TGTGCCAGCAGCGACGATAGCGGGTTCCACGAGCAGTTCTTC	CASSDDSGFHEQFF	TRBV7-2	TRBJ2-1
TGTGCCAGATGGGACAGAACCACAGATACGCAGTATTTT	CARWDRTTDTQYF	TRBV5-4	TRBJ2-3
TGTGCCAGCAGCCAAGCCCTCACAGGGGGGGAGGGACGGGACAATGAGCAGTTCTTC	CASSQALTGGEGRDNEQFF	TRBV14	TRBJ2-1
TGCGCCAGCAGCCAAGATCCACCCAGGGGGGACCGGTACTACGAGCAGTACTTC	CASSQDPPRGDRYYEQYF	TRBV4-1	TRBJ2-7
TGTGCCAGCACCGGGAGGGGGGATGCACAGGATACGCAGTATTTT	CASTGRGDAQDTQYF	TRBV7-9	TRBJ2-3
TGTGCCAGCAGTTACTCGCCGACAGGGGCAAGAAACCACACCGGGGAGCTGTTTTTT	CASSYSPTGARNHTGELFF	TRBV6-5	TRBJ2-2
TGTGCCAGCAGCGTAGTCACGGGGGGTCGTATCTTC	CASSVVTGGRIF	TRBV9	TRBJ2-1
TGTGCCAGCAGCTTACGTCAAAAATTTTGTCTAGCACTCAATGAGCAGTTCTTC	CASSLRQKFCLALNEQFF	TRBV7-3	TRBJ2-1
TGTGCCAGCAGCTTAGGGGTTGGGCCCGGGACTAGCGGGGGGGATACGCAGTATTTT	CASSLGVGPGTSGGDTQYF	TRBV7-4	TRBJ2-3
TGTGCCCCCACAGGGGGAGCTAACTATGGCTACACCTTC	CAPTGGANYGYTF	TRBV14	TRBJ1-2
TGTGCCAGCAGCGAGGGACAGCCCTACGAGCAGTACTTC	CASSEGQPYEQYF	TRBV7-4	TRBJ2-7
TGTGCCGGGGGACTAGACTACGAGCAGTACTTC	CAGGLDYEQYF	TRBV6-5	TRBJ2-7
TGTGCCAGCAGCGAGGAGCTTCAACCTTATAGCAATCAGCCCCAGCATTTT	CASSEELQPYSNQPQHF	TRBV9	TRBJ1-5
TGTGCCAGCAGCTTAGTTGAGGCCGAAGGGACGCAGTTCTTC	CASSLVEAEGTQFF	TRBV11-2	TRBJ2-1
TGTGCCAGCAGCTTAGCAGGGAGGGACGGCGATACGCAGTATTTT	CASSLAGRDGDTQYF	TRBV11-1	TRBJ2-3
TGTGCCAGCAGTTACGGTAAAACAGGAAGAAATAGAGAGACCCAGTACTTC	CASSYGKTGRNRETQYF	TRBV6-6	TRBJ2-5
TGTGCCACCAGTGATTGGGGGGGGGGTGAGCAGTACTTC	CATSDWGGGEQYF	TRBV24-1	TRBJ2-7
TGCAGTGCTCCATATGGGCTCGAGACCCAGTACTTC	CSAPYGLETQYF	TRBV20-1	TRBJ2-5
TGTGCCAGCAGTACGGTGTCCGGGGCCAAGATGGACGAGCAGTACTTC	CASSTVSGAKMDEQYF	TRBV27	TRBJ2-7
TGTGCCTTTTCCCGCAAGGCGGGAGGGCTTGAAGCTTTCTTT	CAFSRKAGGLEAFF	TRBV24-1	TRBJ1-1
TGCGCCAGCAAAAGGGTAACGGCCTATGGCTACACCTTC	CASKRVTAYGYTF	TRBV4-1	TRBJ1-2
TGTGCCAGCACCAAGACAGGGTATGGCTACACCTTC	CASTKTGYGYTF	TRBV7-9	TRBJ1-2
TGCAGTGCTAGGTACAAGACAGGGCCGGTGACTAATCAGCCCCAGCATTTT	CSARYKTGPVTNQPQHF	TRBV20-1	TRBJ1-5
TGTGCCAGCAGATTGGGGGGGCACACTGAAGCTTTCTTT	CASRLGGHTEAFF	TRBV27	TRBJ1-1
TGTGCCACCAGCCCCCCTAGCATTTATGAGCAGTTCTTC	CATSPPSIYEQFF	TRBV15	TRBJ2-1
TGTGCCAGCAGCAACCTAGTCACCGAGCAGTTCTTC	CASSNLVTEQFF	TRBV7-9	TRBJ2-1
TGTGCCAGCAGTTCGAAGGGACTAGAGTACGAGCAGTACTTC	CASSSKGLEYEQYF	TRBV6-9	TRBJ2-7
TGTGCCAGCAGTGAGTGTGGGGTGTCCAGCTCCTACAATGAGCAGTTCTTC	CASSECGVSSSYNEQFF	TRBV27	TRBJ2-1
TGTGCCTGGAGTGTAGACCACTCCGTGACAGGGCCGGTGAACACTGAAGCTTTCTTT	CAWSVDHSVTGPVNTEAFF	TRBV30	TRBJ1-1
TGCGCCAGCAGCCGGCAGGGGGCCGAGGGCTATGGCTACACCTTC	CASSRQGAEGYGYTF	TRBV5-1	TRBJ1-2
TGTGCCAGCACCCCCCGGGACAGGGAGCTCAAAGGAAATCAGCCCCAGCATTTT	CASTPRDRELKGNQPQHF	TRBV25-1	TRBJ1-5
TGTGCCACCAGTGATTCACCCATACAACTAGCGTCCTACGAGCAGTACTTC	CATSDSPIQLASYEQYF	TRBV24-1	TRBJ2-7
TGTGCCACCAGTGACCGGGGGATCAATCAGCCCCAGCATTTT	CATSDRGINQPQHF	TRBV24-1	TRBJ1-5
TGTGCCATCAGGCCGGGACAGGGGTTGGAGACCCAGTACTTC	CAIRPGQGLETQYF	TRBV10-3	TRBJ2-5
TGTGCCAGCAGCTCGGGGTCAGATTCACCCCTCCACTTT	CASSSGSDSPLHF	TRBV7-2	TRBJ1-6
TGCGCCAGCACTCCCCGTAGCGGGAAGACAGCCTACGAGCAGTACTTC	CASTPRSGKTAYEQYF	TRBV10-1	TRBJ2-7
TGCAGCTTGGTCCCAGGGGCTGCAGATACGCAGTATTTT	CSLVPGAADTQYF	TRBV29-1	TRBJ2-3
TGCAGCGTTGTAGGGCGGGGGGCTGAGCAGTTCTTC	CSVVGRGAEQFF	TRBV29-1	TRBJ2-1
TGTGCAGAGTCAGGGCATAGAGCCTACGAGCAGTACTTC	CAESGHRAYEQYF	TRBV6-2	TRBJ2-7
TGTGCCAGTACAGGGGGGCGTCTTCGATTATCTGGAAACACCATATATTTT	CASTGGRLRLSGNTIYF	TRBV19	TRBJ1-3
TGTGCCATCTGGGACCGAGGGATAGTCAATGAGCAGTTCTTC	CAIWDRGIVNEQFF	TRBV10-3	TRBJ2-1
TGCGCCAGCAGCTTGTCCCCAGGGGAGCATACTGAAGCTTTCTTT	CASSLSPGEHTEAFF	TRBV5-1	TRBJ1-1
TGTGCCAGCAGTGAAGACCCCTCCCCGGGACAGGGCGGGGAGCTGTTTTTT	CASSEDPSPGQGGELFF	TRBV2	TRBJ2-2
TGTGCCAGCAGAGCCCCTAGCGGGGGCGGGGAGCTGTTTTTT	CASRAPSGGGELFF	TRBV28	TRBJ2-2
TGTGCCAGCAGCGCCGCTGACTCCAACACTGAAGCTTTCTTT	CASSAADSNTEAFF	TRBV3-1	TRBJ1-1
TGTGCCAGCAGTGAGTTGGGGGACAAACTGCCCCAGCATTTT	CASSELGDKLPQHF	TRBV6-4	TRBJ1-5
TGTGCCAGCAGCTGGGAGTTCCACTTTGGGGAGTCTGGGGCCAACGTCCTGACTTTC	CASSWEFHFGESGANVLTF	TRBV5-4	TRBJ2-6
TGTGCCAGCAGCATAAGGACTAGCGGGAGGAGCTCCTACAATGAGCAGTTCTTC	CASSIRTSGRSSYNEQFF	TRBV7-4	TRBJ2-1
TGCGCCAGCAGCCAAGAGAGCCCCCGGGACAGGGGCGCCGTGGGTGGCTACACCTTC	CASSQESPRDRGAVGGYTF	TRBV4-1	TRBJ1-2
TGCGCCAGCAGCTTGGCGGACAGCGACCAGGCCTACAATGAGCAGTTCTTC	CASSLADSDQAYNEQFF	TRBV5-1	TRBJ2-1
TGTGCCAGCAGCCAAGAGGAACCGGCGGACCACAATGAGCAGTTCTTC	CASSQEEPADHNEQFF	TRBV14	TRBJ2-1
TGCAGCGGGGACAGTGAGATTATACAGCCCCAGCATTTT	CSGDSEIIQPQHF	TRBV29-1	TRBJ1-5
TGTGCCAGCAGCTTGGGACCGGGACAGGAACTACACATTCAGTACTTC	CASSLGPGQELHIQYF	TRBV5-6	TRBJ2-4
TGCGCCAGCTGCGGGGTCCGGGAGAACACTGAAGCTTTCTTT	CASCGVRENTEAFF	TRBV10-1	TRBJ1-1
TGTGCCAGCAGTTATCCAGGGACACTCGAGCAGTACTTC	CASSYPGTLEQYF	TRBV6-9	TRBJ2-7
TGTGCCACCAGTGGGTCGACAGCGGCGGGCATGAACACTGAAGCTTTCTTT	CATSGSTAAGMNTEAFF	TRBV24-1	TRBJ1-1
TGCGCCAGCAGCCAAGGTAGGACAGGGTCTGGGCCCCAAGAGACCCAGTACTTC	CASSQGRTGSGPQETQYF	TRBV4-1	TRBJ2-5
TGTGCCACCAGCTATGCCGGTAGAAATGAGCAGTTCTTC	CATSYAGRNEQFF	TRBV15	TRBJ2-1
TGCGCCAGCAGCCCTACGAGCGCTTTCTTT	CASSPTSAFF	TRBV4-1	TRBJ1-1
TGTGCCAGCAGCTTTGGGGGGGTCCGGCGCACAGATACGCAGTATTTT	CASSFGGVRRTDTQYF	TRBV7-2	TRBJ2-3
TGCAGTGCTAGACCTGCGGGAGATTCGGACAATGAGCAGTTCTTC	CSARPAGDSDNEQFF	TRBV20-1	TRBJ2-1
TGTGCCAGCCCGGTCTGGGGGGGCGGCTATGGCTACACCTTC	CASPVWGGGYGYTF	TRBV6-5	TRBJ1-2
TGTGCCAGCAGCGAAAAAAGACACACTGAAGCTTTCTTT	CASSEKRHTEAFF	TRBV7-9	TRBJ1-1
TGTGCCAGCAGCTTGGGACAGGGGTCCCACTATGGCTACACCTTC	CASSLGQGSHYGYTF	TRBV5-6	TRBJ1-2
TGTGCCAGTAGCGGGACGGAGGGGAGCGGAAGAAGGAACACTGAAGCTTTCTTT	CASSGTEGSGRRNTEAFF	TRBV7-2	TRBJ1-1
TGTGCCAGCAGACCCCGAGCCCCTTACGAGCAGTACTTC	CASRPRAPYEQYF	TRBV6-1	TRBJ2-7
TGTGCCAGCAGCTGCAGGGGTGTGACTGAAGCTTTCTTT	CASSCRGVTEAFF	TRBV7-8	TRBJ1-1
TGTGCCAGCAGTGGGTCGGGACTAGTGTGGTCCCTTACCCAGTACTTC	CASSGSGLVWSLTQYF	TRBV27	TRBJ2-5
TGTGCCAGCAGCTTAGGACAGGGGGCGCCCTATGGCTACACCTTC	CASSLGQGAPYGYTF	TRBV7-2	TRBJ1-2
TGTGCCAGCCCATGGAGACTAGCCGCCCCCACAGATACGCAGTATTTT	CASPWRLAAPTDTQYF	TRBV6-5	TRBJ2-3
TGTGCCAGCAGCGCTGGCCCTATCTCCCCGTCCTACGAGCAGTACTTC	CASSAGPISPSYEQYF	TRBV9	TRBJ2-7
TGTGCCAGCCGGGACCCAGGGCCCGGCTACACCTTC	CASRDPGPGYTF	TRBV9	TRBJ1-2
TGCAGTGCTAGAGATCGGGTGACTAGCGGGGGGGCGAGGGTTTGTGCTCTGGGGATCGGGGAGCTGTTTTTT	CSARDRVTSGGARVCALGIGELFF	TRBV20-1	TRBJ2-2
TGCAGCGTTGGGGGACAGGCCTACGAGCAGTACTTC	CSVGGQAYEQYF	TRBV29-1	TRBJ2-7
TGTGCCAGCAGCCGCCAAAGCGGGAGGGAGTACTACAATGAGCAGTTCTTC	CASSRQSGREYYNEQFF	TRBV9	TRBJ2-1
TGTGCCAGCAGTTACTTCAGGGGGCCGAGCACAGATACGCAGTATTTT	CASSYFRGPSTDTQYF	TRBV6-5	TRBJ2-3
TGCGCCAGCAGAATGGGGGACAGGGATCCTAACTATGGCTACACCTTC	CASRMGDRDPNYGYTF	TRBV10-1	TRBJ1-2
TGTGCCACCAGTGACCTGGGACAGGGAGTAGCGGCCTACGAGCAGTACTTC	CATSDLGQGVAAYEQYF	TRBV24-1	TRBJ2-7
TGTGCCAGCATTGTAAGGACCCCCCAGGGAAGCAAGCCCCCTGGCTACACCTTC	CASIVRTPQGSKPPGYTF	TRBV27	TRBJ1-2
TGTGCATTCAGGGGGCCGGAAGCTTTCTTT	CAFRGPEAFF	TRBV30	TRBJ1-1
TGTGCCAGCAGCTTGAACAGGGGCCAACGAGATACGCAGTATTTT	CASSLNRGQRDTQYF	TRBV5-4	TRBJ2-3
TGTGCCAGCAGTTTACCCGGGACGGTGAACACTGAAGCTTTCTTT	CASSLPGTVNTEAFF	TRBV28	TRBJ1-1
TGTGCCAGCAGCTTTATGAGGGGATTTAGCACAGATACGCAGTATTTT	CASSFMRGFSTDTQYF	TRBV7-3	TRBJ2-3
TGTGCCAGAGCCAGACTAGGCACCGGGGAGCTGTTTTTT	CARARLGTGELFF	TRBV19	TRBJ2-2
TGTGCCAGCAGCGTAGAGGGTGAGGACAGGGGGGGCAATCAGCCCCAGCATTTT	CASSVEGEDRGGNQPQHF	TRBV9	TRBJ1-5
TGCGCCAGCTACGAACAGCCCTATGGCTACACCTTC	CASYEQPYGYTF	TRBV4-1	TRBJ1-2
TGTGCCAGCAGTTTGTGTGGGAGGGGCCCCTCTGGAAACACCATATATTTT	CASSLCGRGPSGNTIYF	TRBV27	TRBJ1-3
TGTGCCAGCAGCAAACGGGGTGTCCCCCAAGAGTCCAATCAGCCCCAGCATTTT	CASSKRGVPQESNQPQHF	TRBV13	TRBJ1-5
TGTGCCAGCATTCGGAGAGGGGAGCTGTTTTTT	CASIRRGELFF	TRBV11-3	TRBJ2-2
TGCAGTGCTAGAGCAAACCTGGCGTGCAATCAGCCCCAGCATTTT	CSARANLACNQPQHF	TRBV20-1	TRBJ1-5
TGTGCCAGCAGCGAGGTGACGAACGATCAGCCCTACGAGCAGTACTTC	CASSEVTNDQPYEQYF	TRBV13	TRBJ2-7
TGCAGTGCTAGAGATGATCGCGGGGAGGGCGGGGCTTTCTTT	CSARDDRGEGGAFF	TRBV20-1	TRBJ1-1
TGTGCCAGCAGTGAACGGAAAACAGACGGACAGGGCCTGAGGAATCAGCCCCAGCATTTT	CASSERKTDGQGLRNQPQHF	TRBV25-1	TRBJ1-5
TGCGCCAGCATAAGGGGGGCCAAAAACATTCAGTACTTC	CASIRGAKNIQYF	TRBV10-1	TRBJ2-4
TGCAGTGCTAGAGATAGAAGACGCTGTTCCGGCTACAATGAGCAGTTCTTC	CSARDRRRCSGYNEQFF	TRBV20-1	TRBJ2-1
TGTGCCACCATACAGGGGGTCCTAGCTTTCTTT	CATIQGVLAFF	TRBV24-1	TRBJ1-1
TGTGCCAGCAGAGGACGCCCGGGACACCTGGGGGTACGCACTGAAGCTTTCTTT	CASRGRPGHLGVRTEAFF	TRBV27	TRBJ1-1
TGTGCCCACGCACAGGGTAGAAGCGTGAACACTGAAGCTTTCTTT	CAHAQGRSVNTEAFF	TRBV9	TRBJ1-1
TGTGCCAGCAGTGTGCAGGGGCAACCTGAAAAACTGTTTTTT	CASSVQGQPEKLFF	TRBV27	TRBJ1-4
TGTGCCAGCAGCGACATGGCAGATACGCAGTATTTT	CASSDMADTQYF	TRBV9	TRBJ2-3
TGTGCCAGCCACCGGGACCCTGGCTACACCTTC	CASHRDPGYTF	TRBV7-3	TRBJ1-2
TGTGCCACCAGTGATTTGGAGGGGGCACACATGAACACTGAAGCTTTCTTT	CATSDLEGAHMNTEAFF	TRBV24-1	TRBJ1-1
TGTGCCAGCAGTTTCCCCGATTATCACAGGGGTCCCTACGAGCAGTACTTC	CASSFPDYHRGPYEQYF	TRBV27	TRBJ2-7
TGTGCCAGCAAGGGGGATCGGACAGGGGGCAATCAGCCCCAGCATTTT	CASKGDRTGGNQPQHF	TRBV6-4	TRBJ1-5
TGTGCCAGCAGCCCCTGGGGGGGCATGCAGTTCTTC	CASSPWGGMQFF	TRBV11-3	TRBJ2-1
TGCGCCAGCAGCTTGATAAGCAAATGGGATACGCAGTATTTT	CASSLISKWDTQYF	TRBV5-1	TRBJ2-3
TGTGCCAGCAGAAGGTTAATCCAGACAGGGCGTTCTGGAAACACCATATATTTT	CASRRLIQTGRSGNTIYF	TRBV3-1	TRBJ1-3
TGTGCCAGCAGCCAAGCCTCCAGGGTTCGAGAGCAGTACTTC	CASSQASRVREQYF	TRBV3-1	TRBJ2-7
TGTGCCAGCAGCTTAGCAATGGGGGCGATTACCTATGGCTACACCTTC	CASSLAMGAITYGYTF	TRBV7-9	TRBJ1-2
TGTGCCAGCAGCCCACGCTCTTGGGTTTTGGACGAGCAGTACTTC	CASSPRSWVLDEQYF	TRBV14	TRBJ2-7
TGTGCTAGTGGCCCTCCCGAAAGGGGCGAGCAGTACTTC	CASGPPERGEQYF	TRBV12-5	TRBJ2-7
TGTGCCAGCAGCTTAGACTTGACAGGGGGCGCGAATGATTATAGCAATCAGCCCCAGCATTTT	CASSLDLTGGANDYSNQPQHF	TRBV11-1	TRBJ1-5
TGTGCCAGCAGTGGGACAGTCTTGCTGTGGGTTTACGAGCAGTACTTC	CASSGTVLLWVYEQYF	TRBV11-2	TRBJ2-7
TGTGCCAGCAGCCGGGACGCCAGCGGGACACTTGGAAACACCATATATTTT	CASSRDASGTLGNTIYF	TRBV7-7	TRBJ1-3
TGTGCCAGCAGCAAGCATCGGAAGCAGGGGGCGATCTCTGGAAACACCATATATTTT	CASSKHRKQGAISGNTIYF	TRBV7-3	TRBJ1-3
TGTGCCAGCAGCTTAACAGCACCCCTCCACTTT	CASSLTAPLHF	TRBV7-4	TRBJ1-6
TGTGCCAGCAGCTTGTATGGTGAGACCCAGTACTTC	CASSLYGETQYF	TRBV5-4	TRBJ2-5
TGTGCCTGGAGTGTAACACCAGCGGGAGGGCTTAATGAGCAGTTCTTC	CAWSVTPAGGLNEQFF	TRBV30	TRBJ2-1
TGTGCCAGCAGCGTAACTCAGGAGTGGAGCTCCTACAATGAGCAGTTCTTC	CASSVTQEWSSYNEQFF	TRBV7-9	TRBJ2-1
TGTGCCAGCAGCTTAGCGGTGAGCAGGCAGCCCCAGCATTTT	CASSLAVSRQPQHF	TRBV7-9	TRBJ1-5
TGCGCCCCCATTGAGCGGGAGCACGGGGAGCTGTTTTTT	CAPIEREHGELFF	TRBV5-1	TRBJ2-2
TGCGCCAGCAGCTTGCGCCAGACTGGGAGGGGTTTGGGAAACACCATATATTTT	CASSLRQTGRGLGNTIYF	TRBV5-1	TRBJ1-3
TGTGCCAGCAGCTCCGTGGGACCGGCTAGCACAGATACGCAGTATTTT	CASSSVGPASTDTQYF	TRBV11-3	TRBJ2-3
TGCGCCAGCAGGGTTATCGGGGTAAAACTGTTTTTT	CASRVIGVKLFF	TRBV5-1	TRBJ1-4
TGTGCCAGCAGCCAAGAGTCAAACGTGAGAGGCTATGGCTACACCTTC	CASSQESNVRGYGYTF	TRBV14	TRBJ1-2
TGCGCCAGCAGTGACTTTCTGGGGTGGTATGGCTACACCTTC	CASSDFLGWYGYTF	TRBV10-1	TRBJ1-2
TGTGCCAGCAGGAGGGGCTCGTCGAACACTGAAGCTTTCTTT	CASRRGSSNTEAFF	TRBV2	TRBJ1-1
TGTGCCAGCAGCTTCTTACAGGGGTCGAGTTACACTGAAGCTTTCTTT	CASSFLQGSSYTEAFF	TRBV11-2	TRBJ1-1
TGCAGTGCTAGAGATTTTAGGACAGATACGCAGTATTTT	CSARDFRTDTQYF	TRBV20-1	TRBJ2-3
TGTGCCAGCAGTTTACCAGGCCGACGACTGTTTTTT	CASSLPGRRLFF	TRBV27	TRBJ1-4
TGTGCCATCAGGGGGGTACCGGGACAGGGATTAAACACCATATATTTT	CAIRGVPGQGLNTIYF	TRBV10-3	TRBJ1-3
TGTGCCAGCAGTGTCGAGGGTGAGTCCGTTAACGGTGAAGAGACCCAGTACTTC	CASSVEGESVNGEETQYF	TRBV6-5	TRBJ2-5
TGCGCCTGGCAAGGGGAAGAGACCCAGTACTTC	CAWQGEETQYF	TRBV10-2	TRBJ2-5
TGTGCCATCAGTGACAAGAGGAGTGCTTTCTTT	CAISDKRSAFF	TRBV10-3	TRBJ1-1
TGCGCCAGCAGTGAGCGGGGACTAGCGGCCACAGATACGCAGTATTTT	CASSERGLAATDTQYF	TRBV10-2	TRBJ2-3
TGCAGTGTGACCGAAGGGGTTACAAACACTGAAGCTTTCTTT	CSVTEGVTNTEAFF	TRBV20-1	TRBJ1-1
TGTGCCAGCAGCTTGACCCGGGAGACCGCTGGAAACACCATATATTTT	CASSLTRETAGNTIYF	TRBV7-2	TRBJ1-3
TGCGCCAGCAGTGACCCGGGACAGGGGCAGTACTTC	CASSDPGQGQYF	TRBV10-1	TRBJ2-7
TGTGCCAGCAGTTACACCCTATTCAGGGGCGGACAGGGTCAGCCCCAGCATTTT	CASSYTLFRGGQGQPQHF	TRBV6-5	TRBJ1-5
TGTGCCAGCAGTCACCTGGGTTTCTCCTACGAGCAGTACTTC	CASSHLGFSYEQYF	TRBV28	TRBJ2-7
TGTGCCAGCTCGGCGTTGAGGGGGCTCTCCTACGAGCAGTACTTC	CASSALRGLSYEQYF	TRBV7-6	TRBJ2-7
TGTGCCAGCAGCTTAGGACAGGGGTACAATGAGCAGTTCTTC	CASSLGQGYNEQFF	TRBV7-3	TRBJ2-1
TGTGCCAGCAGCTTAATACCACCCGATGACTGGGTCTTC	CASSLIPPDDWVF	TRBV7-9	TRBJ2-1
TGTGCCAGCAGCACCCCCCCTAGCGGGAGCTCCTACAATGAGCAGTTCTTC	CASSTPPSGSSYNEQFF	TRBV5-6	TRBJ2-1
TGTGCCAGCAGCCAAGAACACCCCGGGACAGGGGGGGGAACAGATACGCAGTATTTT	CASSQEHPGTGGGTDTQYF	TRBV3-1	TRBJ2-3
TGTGCCAGCAGCTTAGTAAAGAGGTCCCCCTACGAGCAGTACTTC	CASSLVKRSPYEQYF	TRBV11-3	TRBJ2-7
TGTGCCAGCAGCTTGGGGGGCCCGAACTATAATTCACCCCTCCACTTT	CASSLGGPNYNSPLHF	TRBV7-9	TRBJ1-6
TGTGCCAGCAGTGATAAACCCAGGGTCCCTTACAACACTGAAGCTTTCTTT	CASSDKPRVPYNTEAFF	TRBV6-1	TRBJ1-1
TGTGCTAGTGGTTTGACCCTCAGCAGACCCGGCTACACCTTC	CASGLTLSRPGYTF	TRBV12-5	TRBJ1-2
TGTGCCATCAGTGCGCAGAAGAGGGGTAACACCGGGGAGCTGTTTTTT	CAISAQKRGNTGELFF	TRBV10-3	TRBJ2-2
TGTGCCAGCAGTATTGGGGGTCTGGCTTTCTTT	CASSIGGLAFF	TRBV25-1	TRBJ1-1
TGTGCCAGCAGCTACCCCGAGGGGGCGGATCTCATGAATTCACCCCTCCACTTT	CASSYPEGADLMNSPLHF	TRBV5-6	TRBJ1-6
TGTGCCAGTAGTATACCAAGCGAGAGCTCCTACAATGAGCAGTTCTTC	CASSIPSESSYNEQFF	TRBV19	TRBJ2-1
TGTGCCAGCAGCGGCCTTTTCGGAACAGACAGGGGGGCCAATTCACCCCTCCACTTT	CASSGLFGTDRGANSPLHF	TRBV7-4	TRBJ1-6
TGTGCCAGCAGCATTGCCCAGGATGTAGCTGAACCGCAGCCCCAGCATTTT	CASSIAQDVAEPQPQHF	TRBV5-6	TRBJ1-5
TGTGCCAGCAGCTTCCCGGGACAGGGCCCTGAAGCTTTCTTT	CASSFPGQGPEAFF	TRBV5-8	TRBJ1-1
TGTGCCCTCCCTCTAGAGAGCGAGCAGTACTTC	CALPLESEQYF	TRBV10-3	TRBJ2-7
TGCAGTGCGCAGAATACCAAGGAAGAGACCCAGTACTTC	CSAQNTKEETQYF	TRBV20-1	TRBJ2-5
TGTGCCAGCAGCTTAGGGGAATCTGGGACAGAGACCCAGTACTTC	CASSLGESGTETQYF	TRBV7-2	TRBJ2-5
TGTGCCAGCAGTTACGGGGTGCGGAACACTGAAGCTTTCTTT	CASSYGVRNTEAFF	TRBV6-9	TRBJ1-1
TGTGCCAGCAGCGGGAGGGGGGGGAATGAGCAGTTCTTC	CASSGRGGNEQFF	TRBV28	TRBJ2-1
TGTGCCAGCAGATGGGGGGGGGCCCAAAGCTGCAATCAGCCCCAGCATTTT	CASRWGGAQSCNQPQHF	TRBV28	TRBJ1-5
TGCGCCAGCAGCCAAGAGGGTAAGGGCGGCAATGAAAAACTGTTTTTT	CASSQEGKGGNEKLFF	TRBV4-1	TRBJ1-4
TGTGCCAGCTCACCATGTCCCTGCCGGGAGGGGGGGGGGGTTCGAGACGAGCAGTACTTC	CASSPCPCREGGGVRDEQYF	TRBV18	TRBJ2-7
TGTGCCAGTAGTATCCACCTCAGCGCCCCGGGACAGGGCTGGTACGAGCAGTACTTC	CASSIHLSAPGQGWYEQYF	TRBV19	TRBJ2-7
TGTGCCAGCAGCTTCAGCGCTCTGCAAAGCTTATGGCCGGATGAGCAGTTCTTC	CASSFSALQSLWPDEQFF	TRBV7-3	TRBJ2-1
TGTGTCTCCGGGACAGGGGCTACAGATACGCAGTATTTT	CVSGTGATDTQYF	TRBV7-9	TRBJ2-3
TGCGCCAGCAGAAACAGTGGGGGGGAGGGAGGGAACACTGAAGCTTTCTTT	CASRNSGGEGGNTEAFF	TRBV5-1	TRBJ1-1
TGCAGTGCTAGAGCGGAGGGATTTGTCGAGACCCAGTACTTC	CSARAEGFVETQYF	TRBV20-1	TRBJ2-5
TGTGCCAGCAGCGCCGGGACAGGGCTCAGACACGAGCAGTACTTC	CASSAGTGLRHEQYF	TRBV7-9	TRBJ2-7
TGCGCCAGCAGCTTAGGGGGACAGCGTGAGCAGTACTTC	CASSLGGQREQYF	TRBV5-1	TRBJ2-7
TGTGCCAGCCCAATCCGGGACAGGGTCGAGAATCAGCCCCAGCATTTT	CASPIRDRVENQPQHF	TRBV6-4	TRBJ1-5
TGTGCCAGCAGGAGGGCTGAGACCCAGTACTTC	CASRRAETQYF	TRBV6-1	TRBJ2-5
TGCGCCAGCAATCTTGCCCGGCGACAGGGCACTGAAGCTTTCTTT	CASNLARRQGTEAFF	TRBV10-1	TRBJ1-1
TGTGCCAGCAGCGTAGCCCGACAGGACACTGAAGCTTTCTTT	CASSVARQDTEAFF	TRBV9	TRBJ1-1
TGTGCCGAAGGGGTAAACGTAGGGACATGGGGCCGGAACACCGGGGAGCTGTTTTTT	CAEGVNVGTWGRNTGELFF	TRBV30	TRBJ2-2
TGTGCCAGTTTCCTTGGACAGCCGGGCCGGGTAGGCACAGATACGCAGTATTTT	CASFLGQPGRVGTDTQYF	TRBV19	TRBJ2-3
TGTGCCACCAGTGACAGGGTTTCCGAGACCCAGTACTTC	CATSDRVSETQYF	TRBV24-1	TRBJ2-5
TGTGCCAGCCACGGGGGGGCTGGAACCTACGAGCAGTACTTC	CASHGGAGTYEQYF	TRBV2	TRBJ2-7
TGCAGTGCTAGATGGCCCAATCCGGGGGATCCGCCCCAGCATTTT	CSARWPNPGDPPQHF	TRBV20-1	TRBJ1-5
TGCGCCAGCAGCTTGCTCTCTAATGACAGGATGAAAGAGACCCAGTACTTC	CASSLLSNDRMKETQYF	TRBV5-1	TRBJ2-5
TGTGCCAGCAGTTGCGGGGGGGGACCCTACAATGAGCAGTTCTTC	CASSCGGGPYNEQFF	TRBV6-9	TRBJ2-1
TGTGCCATACCGGGGCTTCAGCCCCAGCATTTT	CAIPGLQPQHF	TRBV6-3	TRBJ1-5
TGCAGTGTAGGGACAGGGTTTGAAAAACTGTTTTTT	CSVGTGFEKLFF	TRBV20-1	TRBJ1-4
TGTGCCAGCAGCTTAGCACCCAGCGGGAGGGAAGGGGAGCTGTTTTTT	CASSLAPSGREGELFF	TRBV7-4	TRBJ2-2
TGTGCCAGCTCACCACCTGGACAGGGGGCTCATCAGCCCCAGCATTTT	CASSPPGQGAHQPQHF	TRBV18	TRBJ1-5
TGTGCCAGCAGCGAACCGGGCGCGTACTTC	CASSEPGAYF	TRBV7-3	TRBJ2-5
TGTGCCAGCACCCCCCTCGACAGCCAAGGCCCACAGGGGGCTGCCCCGAACTATGGCTACACCTTC	CASTPLDSQGPQGAAPNYGYTF	TRBV6-5	TRBJ1-2
TGTGCCAGCCCGACTGGTGAAAAACTGTTTTTT	CASPTGEKLFF	TRBV6-4	TRBJ1-4
TGTGCCACCAGGGGCCTCCTGAACACTGAAGCTTTCTTT	CATRGLLNTEAFF	TRBV24-1	TRBJ1-1
TGTGCCATCAGTCAGGGCCGTTGTGATACGCAGTATTTT	CAISQGRCDTQYF	TRBV10-3	TRBJ2-3
TGTGCCAGCAGCCACTGGACATCCCACGAGCAGTACTTC	CASSHWTSHEQYF	TRBV4-2	TRBJ2-7
TGTGCCAGCAGCCCAGGGGGGCTGGGTGGAGCAACTAATGAAAAACTGTTTTTT	CASSPGGLGGATNEKLFF	TRBV11-3	TRBJ1-4
TGCGCCAGCAGCTTTCGCGAGGAGGGTGTTGACATTCAGTACTTC	CASSFREEGVDIQYF	TRBV5-1	TRBJ2-4
TGTGCCAGCAGTGCACAGGAAACAGGGGCCGAAGCATGTCCCCAAGAGACCCAGTACTTC	CASSAQETGAEACPQETQYF	TRBV6-4	TRBJ2-5
TGTGCCATCAGTGAGTATCGGGGGGGGGCACCCCACACCGGGGAGCTGTTTTTT	CAISEYRGGAPHTGELFF	TRBV10-3	TRBJ2-2
TGTGCCAGCAGCTCCTCCTTTAGGGGGGGAGGGAACACCGGGGAGCTGTTTTTT	CASSSSFRGGGNTGELFF	TRBV7-2	TRBJ2-2
TGTGCCAGCAGCTATAAGGGGGGTTTGGAGCAGTTCTTC	CASSYKGGLEQFF	TRBV5-6	TRBJ2-1
TGTGCCAGCAGCCGGGTTCCCTGGCTGTACGAGCAGTACTTC	CASSRVPWLYEQYF	TRBV13	TRBJ2-7
TGTGCCAGCGGGGACAGGGGAAGGGCTAACTATGGCTACACCTTC	CASGDRGRANYGYTF	TRBV7-4	TRBJ1-2
TGCAGTGCTAGAGGTGGAGGACAGGTCATTGAAAAACTGTTTTTT	CSARGGGQVIEKLFF	TRBV20-1	TRBJ1-4
TGTGCCAGCAGCCAGGGGAGATCGAACACCGGGGAGCTGTTTTTT	CASSQGRSNTGELFF	TRBV7-3	TRBJ2-2
TGTGCCAGCAGTGACGATAATTCTCACAGGGGGCTCCCTGGCTACACCTTC	CASSDDNSHRGLPGYTF	TRBV6-4	TRBJ1-2
TGTGCCAGGATGATAGGGCGGACGGAGTATAGCAATCAGCCCCAGCATTTT	CARMIGRTEYSNQPQHF	TRBV19	TRBJ1-5
TGTGCCCCCCAGGTGGAGGGGGGGGGGGTCACCGGGGAGCTGTTTTTT	CAPQVEGGGVTGELFF	TRBV6-2	TRBJ2-2
TGTGCCAGCAGCGCGGCAGGGACGAACACCGGGGAGCTGTTTTTT	CASSAAGTNTGELFF	TRBV7-3	TRBJ2-2
TGTGCCAGCAGCTGTACTAGCGGGAGCGTGCCGCTGTTTTTT	CASSCTSGSVPLFF	TRBV9	TRBJ2-2
TGTGCCAGCAAGCCCGGGACTAGCCCTGAGCAGTTCTTC	CASKPGTSPEQFF	TRBV27	TRBJ2-1
TGTGCCAGCAGCCAAACAGACGGTCCCAACGAGCAGTACTTC	CASSQTDGPNEQYF	TRBV11-2	TRBJ2-7
TGTGCCAGCAGTTACTCGAAACCCGAGTCCCAAGAGACCCAGTACTTC	CASSYSKPESQETQYF	TRBV6-3	TRBJ2-5
TGTGCCAGCAGGAGGACAGGGAGCCCAAGCAATCAGCCCCAGCATTTT	CASRRTGSPSNQPQHF	TRBV19	TRBJ1-5
TGCGCCAGCAGCCCGGGGACAAACACCATATATTTT	CASSPGTNTIYF	TRBV5-1	TRBJ1-3
TGTGCCAGCAGTTACTCTCAGAGTAGGGGTGCCCAGTACTTC	CASSYSQSRGAQYF	TRBV6-2	TRBJ2-4
TGCAGCGTGGGGATTCCGGGGAGAGGAAGGGACACTGAAGCTTTCTTT	CSVGIPGRGRDTEAFF	TRBV29-1	TRBJ1-1
TGTGCCAGCAGCTTAAGGAGCGGTCTCAGGACAGCAGATACGCAGTATTTT	CASSLRSGLRTADTQYF	TRBV7-3	TRBJ2-3
TGTGCCAGCAGCGGCCACAGGGGGCGCATTAACTATGGCTACACCTTC	CASSGHRGRINYGYTF	TRBV9	TRBJ1-2
TGTGCCAGCAGTGCAACTGAAGCTTTCTTT	CASSATEAFF	TRBV28	TRBJ1-1
TGTGCCAGCAGCTTAGCTCCAGTCCATACAGGGGGCACAGATACGCAGTATTTT	CASSLAPVHTGGTDTQYF	TRBV7-7	TRBJ2-3
TGCGCCAGCAGGGGAGGACGGGTAGAAAAACTGTTTTTT	CASRGGRVEKLFF	TRBV10-1	TRBJ1-4
TGTGCCAGCAGTGGACTCCTACTAGCGGGAGGGCGCAACGAGCAGTACTTC	CASSGLLLAGGRNEQYF	TRBV12-3	TRBJ2-7
TGCGCCAGCAGCCGTGACGACAATGAGCAGTTCTTC	CASSRDDNEQFF	TRBV5-1	TRBJ2-1
TGTGCCAGCAGTTTATCGATTCCGACAGGGAGAATCTACGAGCAGTACTTC	CASSLSIPTGRIYEQYF	TRBV27	TRBJ2-7
TGTGCCAGCAGCTTAGCGCGCTTCCCCTTCAGAGCAGATACGCAGTATTTT	CASSLARFPFRADTQYF	TRBV11-3	TRBJ2-3
TGTGCCAGCAGCCAAGGAGCCGAGCGGGACTTCCAACACAATGAGCAGTTCTTC	CASSQGAERDFQHNEQFF	TRBV13	TRBJ2-1
TGCAGTGCTTCTCCCCAGGGCCTCACCGGGGAGCTGTTTTTT	CSASPQGLTGELFF	TRBV20-1	TRBJ2-2
TGTGCCAGCAGCTTGTTCAGAAGGGGGGGGGCTGGAAACACCATATATTTT	CASSLFRRGGAGNTIYF	TRBV11-2	TRBJ1-3
TGTGCCAGCACCACTAGCGGGGGCATCTCCTACAATGAGCAGTTCTTC	CASTTSGGISYNEQFF	TRBV7-2	TRBJ2-1
TGTGCCAGCAGTGATGCGACAGGGACGGAGTTCAGCACAGATACGCAGTATTTT	CASSDATGTEFSTDTQYF	TRBV6-4	TRBJ2-3
TGTGCCAGCAGCTCCTGGACAGGGCGGCCCCAGCATTTT	CASSSWTGRPQHF	TRBV11-2	TRBJ1-5
TGCAGTGCTAGAGATGGATGGCCCAGCCTAGCCAAAAACATTCAGTACTTC	CSARDGWPSLAKNIQYF	TRBV20-1	TRBJ2-4
TGCGCCAGCAGCACAGGGGCAGGTACCAATGAGCAGTTCTTC	CASSTGAGTNEQFF	TRBV5-1	TRBJ2-1
TGCGCCAGCAGTGAGTCGTTCCTATATGGGGGCCGCTATGGCTACACCTTC	CASSESFLYGGRYGYTF	TRBV10-1	TRBJ1-2
TGTGCCAGCAGCCAAGGGCCCCCAGATACAGTGGGCTATGGCTACACCTTC	CASSQGPPDTVGYGYTF	TRBV3-1	TRBJ1-2
TGTGCCAGCTCACCAGGGGGTGGGGCCAACGTCCTGACTTTC	CASSPGGGANVLTF	TRBV18	TRBJ2-6
TGTGCCAGCCGACAGGGCAGGACCGGGGAGCTGTTTTTT	CASRQGRTGELFF	TRBV7-2	TRBJ2-2
TGCAGTGCTAGAGCCGACAGGATCAGTAGGCTCTACGAGCAGTACTTC	CSARADRISRLYEQYF	TRBV20-1	TRBJ2-7
TGCGCCAGCAGCCAAGATCCATGGGGGGGGAATTCACCCCTCCACTTT	CASSQDPWGGNSPLHF	TRBV4-1	TRBJ1-6
TGCGCCAGCAGCCATTCCGGACGGGTCGCATACGAGCAGTACTTC	CASSHSGRVAYEQYF	TRBV4-3	TRBJ2-7
TGTGCCAGCAGCTCCGGGGGGACCTACGAGCAGTACTTC	CASSSGGTYEQYF	TRBV7-3	TRBJ2-7
TGTGCCAGCAGAACGATCGGACAGGGGGCCCAGCATTTT	CASRTIGQGAQHF	TRBV6-1	TRBJ1-5
TGCGCCAGCAGCGTCCGAGTAGAAAATACGACCTACGAGCAGTACTTC	CASSVRVENTTYEQYF	TRBV5-1	TRBJ2-7
TGTGCCAGCAGCCAAGGGCTGTGGCATGGCTACACCTTC	CASSQGLWHGYTF	TRBV3-1	TRBJ1-2
TGTGCCAGCAGCTTCCATCCTCATACGCAGTATTTT	CASSFHPHTQYF	TRBV7-4	TRBJ2-3
TGTGCCAGTAGTATCCCAGGGGCGGACCCCTACGAGCAGTACTTC	CASSIPGADPYEQYF	TRBV19	TRBJ2-7
TGTGCCAGAGTACCAATCTCTGGAAACACCATATATTTT	CARVPISGNTIYF	TRBV4-2	TRBJ1-3
TGCGCCAGCAGCTCTGACTTTAACAGGGGCACCGGGGAGCTGTTTTTT	CASSSDFNRGTGELFF	TRBV5-1	TRBJ2-2
TGTGCCAGCAGCGTGCAGCGGGCCCGGGGGCCTCCTGGGGCCAACGTCCTGACTTTC	CASSVQRARGPPGANVLTF	TRBV7-3	TRBJ2-6
TGCGCCAGCAGCCAAGATACGTCCGGGAGTAATCAGCCCCAGCATTTT	CASSQDTSGSNQPQHF	TRBV4-1	TRBJ1-5
TGTGCCAGCAGTTTAGAGGGACAGGGGCTCGATCAGCCCCAGCATTTT	CASSLEGQGLDQPQHF	TRBV28	TRBJ1-5
TGTGCCAGCAGCTTAGATCCGGACAGGGGGCGCAATCAGCCCCAGCATTTT	CASSLDPDRGRNQPQHF	TRBV11-2	TRBJ1-5
TGCGCCAGACTTACGCGCTTCGAGGGGATAAAGCGGATGAACACTGAAGCTTTCTTT	CARLTRFEGIKRMNTEAFF	TRBV5-1	TRBJ1-1
TGCAGCGTTGAAGCCAACAGGGACAGGGGAGAGGAAAAACTGTTTTTT	CSVEANRDRGEEKLFF	TRBV29-1	TRBJ1-4
TGCAGCGTTGAGCCGGGACTAGCGGTCCGGCACGAGCAGTACTTC	CSVEPGLAVRHEQYF	TRBV29-1	TRBJ2-7
TGTGCCACGAACAGGGCAAATTCGTATGGCTACACCTTC	CATNRANSYGYTF	TRBV25-1	TRBJ1-2
TGTGCCAGCAGGAGGACACGGGCGTGGACTGGTCAGCCCCAGCATTTT	CASRRTRAWTGQPQHF	TRBV6-3	TRBJ1-5
TGTGCCAGCAGCAAAGGGGGGCAAAGACCCGGCACAGATACGCAGTATTTT	CASSKGGQRPGTDTQYF	TRBV7-3	TRBJ2-3
TGTGCCAGCAGTTCTAGCGGGTTGGGGTACGAGCAGTACTTC	CASSSSGLGYEQYF	TRBV6-4	TRBJ2-7
TGTGCCAGCAGCTCCCGGGACAGACAGGGCACCGGGGAGCTGTTTTTT	CASSSRDRQGTGELFF	TRBV11-2	TRBJ2-2
TGTGCCAGCACTACGGGAGGTGTAGGACCGACGAACACTGAAGCTTTCTTT	CASTTGGVGPTNTEAFF	TRBV28	TRBJ1-1
TGTGCCAGCAGCTTAGTACCCTCCTACAATGAGCAGTTCTTC	CASSLVPSYNEQFF	TRBV7-9	TRBJ2-1
TGCGCCAGCAGCCAAGATTTCACGTCCCAGGGACAGGACCCCTACGAGCAGTACTTC	CASSQDFTSQGQDPYEQYF	TRBV4-1	TRBJ2-7
TGTGCCACCAGTGACCTTCCCTACGAGCAGTACTTC	CATSDLPYEQYF	TRBV24-1	TRBJ2-7
TGCGCCAGCAGCCAAGACGTCAGACAGGGTAGCGAGACCCAGTACTTC	CASSQDVRQGSETQYF	TRBV4-3	TRBJ2-5
TGTGCCAGCAGCGACCCGCTTGGCCAGCTGCTAACCCTCCACTTT	CASSDPLGQLLTLHF	TRBV7-9	TRBJ1-6
TGTGCCAGCAGCTCTCCGGGACTAGCGGTTTCCTACGAGCAGTACTTC	CASSSPGLAVSYEQYF	TRBV7-9	TRBJ2-7
TGCAGTGCTAGAGATAAATCGTTCGGCCTGGACAATGAGCAGTTCTTC	CSARDKSFGLDNEQFF	TRBV20-1	TRBJ2-1
TGTGCCACCAGCAGAGGGGTTCGTATCCCCTTGTACGAGCAGTACTTC	CATSRGVRIPLYEQYF	TRBV15	TRBJ2-7
TGTGCCAGTAGGTGGTCGACAGGGGGCGCCCGCTTCCCTTTTCTTCAGCCCCAGCATTTT	CASRWSTGGARFPFLQPQHF	TRBV19	TRBJ1-5
TGTGCCAGCAGTGGAGGTGGGGTTCCCACGAGCTCCTACGAGCAGTACTTC	CASSGGGVPTSSYEQYF	TRBV2	TRBJ2-7
TGTGCCAGCAGAAGGGGGGAGCTCGCAAAGGGCACAGATACGCAGTATTTT	CASRRGELAKGTDTQYF	TRBV27	TRBJ2-3
TGTGCCACCAGCAGAGATCCCAGGGACGGGACCTACGAGCAGTACTTC	CATSRDPRDGTYEQYF	TRBV15	TRBJ2-7
TGTGCCAGCAGCTTTCAGGGCCCACTCTTCTCTGGAAACACCATATATTTT	CASSFQGPLFSGNTIYF	TRBV7-7	TRBJ1-3
TGTGCCAGCAGTGACTCGGCCGGGCGGAGAATCTACGAGCAGTACTTC	CASSDSAGRRIYEQYF	TRBV6-4	TRBJ2-7
TGTGCCAGCAGCTACCGCCCTGGAACCGGGACACGGGGCTCCTACGAGCAGTACTTC	CASSYRPGTGTRGSYEQYF	TRBV11-3	TRBJ2-7
TGTGCCAGCAGCTTGCGGATGGCTGGGACAGGGTTACTGTTTTTT	CASSLRMAGTGLLFF	TRBV5-6	TRBJ1-4
TGCAGTGCTAGTACCCCAGTGATCCGCACAGATACGCAGTATTTT	CSASTPVIRTDTQYF	TRBV20-1	TRBJ2-3
TGTGCCAGCAGTCGCCTCCTTTGGGACAGGGGTTACCATTCACCCCTCCACTTT	CASSRLLWDRGYHSPLHF	TRBV6-6	TRBJ1-6
TGTGCCAGCAGTCCGACAGGGAACTATGGCTACACCTTC	CASSPTGNYGYTF	TRBV28	TRBJ1-2
TGTGCCAGCAGTGACAGGGATTCAGTCCAAACAAGGACAGGGATGTACTTGCAGTACTTC	CASSDRDSVQTRTGMYLQYF	TRBV6-4	TRBJ2-7
TGTGCCAGCAGCGGGGTTAATGACTCCTACGAGCAGTACTTC	CASSGVNDSYEQYF	TRBV7-3	TRBJ2-7
TGTGCCAGCAGCGCGGAGGACGGCATCTACGAGCAGTACTTC	CASSAEDGIYEQYF	TRBV9	TRBJ2-7
TGCGCCAGCAGCTTGGAGGGGCGTAGATATGAGCAGTTCTTC	CASSLEGRRYEQFF	TRBV5-1	TRBJ2-1
TGTGCCAGCAGCTTAGGCAGGGAGGGGAACACTGAAGCTTTCTTT	CASSLGREGNTEAFF	TRBV11-1	TRBJ1-1
TGTGCCACTCCGGGACAGGGGTTCTTC	CATPGQGFF	TRBV27	TRBJ2-1
TGTGCCAGTAGACCGGACAGGGGAAGGAACTATGGCTACACCTTC	CASRPDRGRNYGYTF	TRBV19	TRBJ1-2
TGTGCCAGCAGCTCGAATTGTTACCCGGGGGGCGCTGGATCCCAGTACTTC	CASSSNCYPGGAGSQYF	TRBV5-5	TRBJ2-5
TGTGCCAGCACAGGGGGTAACTACGAGCAGTACTTC	CASTGGNYEQYF	TRBV13	TRBJ2-7
TGCAGTGGACTAGGGGGGGAGACCCAGTACTTC	CSGLGGETQYF	TRBV20-1	TRBJ2-5
TGCGCCAGCACCGTTTTGGAGACAGGGTCAAACATTCAGTACTTC	CASTVLETGSNIQYF	TRBV10-1	TRBJ2-4
TGTGCCAGCTTGACCAAGAAGACAGGGGAGACCCAGTACTTC	CASLTKKTGETQYF	TRBV6-3	TRBJ2-5
TGCAGTGCTAGACGCCGGGACCATGCAACTAATGAAAAACTGTTTTTT	CSARRRDHATNEKLFF	TRBV20-1	TRBJ1-4
TGTGCCAGCAGCATACGTGTAGGCTACACCTTC	CASSIRVGYTF	TRBV9	TRBJ1-2
TGTGCCAGCAGCCCACCGATGGACCGCTCTGGGGCCAACGTCCTGACTTTC	CASSPPMDRSGANVLTF	TRBV14	TRBJ2-6
TGTGCCAGCAGCTTACAATTGGACAGGGAACTGGCGAACACCGGGGAGCTGTTTTTT	CASSLQLDRELANTGELFF	TRBV11-3	TRBJ2-2
TGTGCCAGCAGCTTAGTAGGTTCCGGGACAGGAGTTTACGAGCAGTACTTC	CASSLVGSGTGVYEQYF	TRBV7-6	TRBJ2-7
TGCAGTGCACCCAGCTCCGGATGCACCGGGGAGCTGTTTTTT	CSAPSSGCTGELFF	TRBV20-1	TRBJ2-2
TGTGCCAGCAGCCAAGTACCGACAGCTGAAGCTTTCTTT	CASSQVPTAEAFF	TRBV3-1	TRBJ1-1
TGTGCCAGCAGAGAGGCCGGGACCTGGTTCCCGGGGGCGAACACCGGGGAGCTGTTTTTT	CASREAGTWFPGANTGELFF	TRBV7-3	TRBJ2-2
TGTGCCAGCAGCACCGTTAGAGCACTAGCGGGAGAAGGCGAGCAGTACTTC	CASSTVRALAGEGEQYF	TRBV3-1	TRBJ2-7
TGTGCCACCAGTGATTTGCAAAAGGACAGGGTGCGAGGCACAGATACGCAGTATTTT	CATSDLQKDRVRGTDTQYF	TRBV24-1	TRBJ2-3
TGTGCCAGCAGCGTAGGGACTAGCGGGAGAATAGTGCAGTACTTC	CASSVGTSGRIVQYF	TRBV9	TRBJ2-7
TGCGCCAGCAGCCAAGATCCGAACCTAATCCGGGACAGGAGCTCTGGAAACACCATATATTTT	CASSQDPNLIRDRSSGNTIYF	TRBV4-1	TRBJ1-3
TGTGCCAGCAGTGGTGGGGGACAGAATGCTAGGACTGGTGAGCAGTTCTTC	CASSGGGQNARTGEQFF	TRBV6-4	TRBJ2-1
TGTGCCAGCAGCTACCGGGACAGGGACACCGGGGAGCTGTTTTTT	CASSYRDRDTGELFF	TRBV5-4	TRBJ2-2
TGTGCCAGCAGCCAAGGCGGGACTCTGAGTACAGGGGACAATGAGCAGTTCTTC	CASSQGGTLSTGDNEQFF	TRBV3-1	TRBJ2-1
TGCAGTGCTCGAGGGCCGAAGTACAATGAGCAGTTCTTC	CSARGPKYNEQFF	TRBV20-1	TRBJ2-1
TGTGCCAGCAGCTGTGGCCGAGACGGGGAGCTGTTTTTT	CASSCGRDGELFF	TRBV5-6	TRBJ2-2
TGTGCCAGCAGCCGCGGGACAGGGAGCAATCAGCCCCAGCATTTT	CASSRGTGSNQPQHF	TRBV13	TRBJ1-5
TGCGCCAGCAGCGTCCCAGGGAGGGACGCGAATCAGCCCCAGCATTTT	CASSVPGRDANQPQHF	TRBV5-1	TRBJ1-5
TGCGCCAGCAGCTGTGCCAATCAGCCCCAGCATTTT	CASSCANQPQHF	TRBV5-1	TRBJ1-5
TGTGCCACCAGCAGAGTCGGTGAGGACAGCCCCCGCACAGATACGCAGTATTTT	CATSRVGEDSPRTDTQYF	TRBV15	TRBJ2-3
TGTGCCAGTGGGGGGGGGCTAGCAACTAGTGAGCAGTTCTTC	CASGGGLATSEQFF	TRBV19	TRBJ2-1
TGTGCCATCAGGGGGAAAAAGGGATCCTACGAGCAGTACTTC	CAIRGKKGSYEQYF	TRBV10-3	TRBJ2-7
TGTGCCAGGTTGAACGACCGGCTAGGGATTGAAGCTTTCTTT	CARLNDRLGIEAFF	TRBV6-2	TRBJ1-1
TGTGCCACCAGCAGAAATCAGCCCCAGCATTTT	CATSRNQPQHF	TRBV24-1	TRBJ1-5
TGTGCCAGCAGCACTTCCCGGGAAACCGGGGAGCTGTTTTTT	CASSTSRETGELFF	TRBV27	TRBJ2-2
TGTGCCAGCAGCTTGAGACATTATGGACACGTAACTGAAGCTTTCTTT	CASSLRHYGHVTEAFF	TRBV7-9	TRBJ1-1
TGTGCCAGCAGCTTAGCGCGGGGGCATTACTATGGCTACACCTTC	CASSLARGHYYGYTF	TRBV7-9	TRBJ1-2
TGCAGTGCTCCGGGACTTTCCTCCTACGAGCAGTACTTC	CSAPGLSSYEQYF	TRBV20-1	TRBJ2-7
TGTGCCAGCAGTAGAGTCCCGGCTGAAGGGAGCTCCTACGAGCAGTACTTC	CASSRVPAEGSSYEQYF	TRBV6-1	TRBJ2-7
TGTGCCAGCAAGAGGGGGGGGAACACCGGGGAGCTGTTTTTT	CASKRGGNTGELFF	TRBV27	TRBJ2-2
TGTGCCAGCCCCCGGGAGAGGACGGAAGAGACCCAGTACTTC	CASPRERTEETQYF	TRBV5-6	TRBJ2-5
TGCGCCAGCAGTGTGTTTTATAGCACAATAGCCAAAAACATTCAGTACTTC	CASSVFYSTIAKNIQYF	TRBV10-1	TRBJ2-4
TGTGCCTGGAGAGGAATCAATCAGCGGGTATCAGATACGCAGTATTTT	CAWRGINQRVSDTQYF	TRBV30	TRBJ2-3
TGTGCTAGCAGCTTAGAACTCGGGAAGGGGGGGTTAGCCACAGATACGCAGTATTTT	CASSLELGKGGLATDTQYF	TRBV7-7	TRBJ2-3
TGTGCCAGCGATGCCTGGGTGGGGGGGGGCGACACTGAAGCTTTCTTT	CASDAWVGGGDTEAFF	TRBV7-6	TRBJ1-1
TGTGCCAGCAGCGTAGACCTACAGGGACAGCCCCAGCATTTT	CASSVDLQGQPQHF	TRBV9	TRBJ1-5
TGTGCCAGCTCACTGGGACAGGGGGAAGTCTACGAGCAGTACTTC	CASSLGQGEVYEQYF	TRBV18	TRBJ2-7
TGTGCCACCAGTGCTTACCCCCCCAACCATCCGGGGACCTATGGCTACACCTTC	CATSAYPPNHPGTYGYTF	TRBV24-1	TRBJ1-2
TGTGGAAAGGCTAAATGGGGTAAGCAAGAGACCCAGTACTTC	CGKAKWGKQETQYF	TRBV12-3	TRBJ2-5
TGTGCCAGCTCACCACTGGAGGATTTGGACGAGCAGTACTTC	CASSPLEDLDEQYF	TRBV18	TRBJ2-7
TGTGCCAGCAGCGATGGGGTTAGCAATCAGCCCCAGCATTTT	CASSDGVSNQPQHF	TRBV13	TRBJ1-5
TGTGCCAGCAGCTACGTTTCCCACGGGGCAATTCCCGGAATAGGGAACACTGAAGCTTTCTTT	CASSYVSHGAIPGIGNTEAFF	TRBV7-3	TRBJ1-1
TGCGCCAGCGGCCAACAGGGGTCTACCGGGGAGCTGTTTTTT	CASGQQGSTGELFF	TRBV5-1	TRBJ2-2
TGTGCCAGCATACCGACGACAGGGCAAGAGACCCAGTACTTC	CASIPTTGQETQYF	TRBV2	TRBJ2-5
TGTGCCAGCAGTGAGAGGGGGGGTCCCGGGGAGCTGTTTTTT	CASSERGGPGELFF	TRBV6-4	TRBJ2-2
TGTGCCAGCAGCAGTCATGGAAACACCATATATTTT	CASSSHGNTIYF	TRBV6-5	TRBJ1-3
TGTGCCAGCAGTGAGTTCCGTCGCTCTGGGAACACTGAAGCTTTCTTT	CASSEFRRSGNTEAFF	TRBV25-1	TRBJ1-1
TGTGCCAGCAGCTTAGGAGAGCCCATGAAAGGGACAGGCTCCAGAGTGTATAATTCACCCCTCCACTTT	CASSLGEPMKGTGSRVYNSPLHF	TRBV7-7	TRBJ1-6
TGTGCCAGGGGAGCCTCCTACGAGCAGTACTTC	CARGASYEQYF	TRBV28	TRBJ2-7
TGTGCCAGCAGTTTGGGGGGGGGAGAGGCTCCAGATACGCAGTATTTT	CASSLGGGEAPDTQYF	TRBV28	TRBJ2-3
TGCGCCAGCAAGGGACAGGGGGCAATGGAGAACACCGGGGAGCTGTTTTTT	CASKGQGAMENTGELFF	TRBV4-3	TRBJ2-2
TGTGCCAGCACATCTAATTCCGGGACTAGCGGGGGGGCACGACAAGAGACCCAGTACTTC	CASTSNSGTSGGARQETQYF	TRBV6-3	TRBJ2-5
TGTGCCAGCAGCAGAAACTGTTCCCCAAAACACCGGGGTTCACCCCTCCACTTT	CASSRNCSPKHRGSPLHF	TRBV5-5	TRBJ1-6
TGTGCCAGCGTCCACAGGGGGGATAATTCACCCCTCCACTTT	CASVHRGDNSPLHF	TRBV28	TRBJ1-6
TGTGCCAGCAGCTTACCTCCCCGGGGGAGGCAAGAGACCCAGTACTTC	CASSLPPRGRQETQYF	TRBV7-9	TRBJ2-5
TGTGCCAGCAGCAACGATGAAAAACTGTTTTTT	CASSNDEKLFF	TRBV9	TRBJ1-4
TGTGCCAGCCCCGGACCGGGCCCCCGCACAGATACGCAGTATTTT	CASPGPGPRTDTQYF	TRBV6-4	TRBJ2-3
TGTGCCAGCAGTGAATGGTCGGAGGGTGGGGGGGCCTACAATGAGCAGTTCTTC	CASSEWSEGGGAYNEQFF	TRBV6-1	TRBJ2-1
TGTGCCAGCAGTGCCAGAGAGCCGGAGCTGTTTTTT	CASSAREPELFF	TRBV25-1	TRBJ2-2
TGTGCGGACGAGTCTAGCTTATCGCTAGGGGAGCTGTTTTTT	CADESSLSLGELFF	TRBV6-2	TRBJ2-2
TGTGCCAGCAGTCCGCCTATACCGGGACAAGAGAACAATCAGCCCCAGCATTTT	CASSPPIPGQENNQPQHF	TRBV7-9	TRBJ1-5
TGTGCCAGCAGTTACCCCTGGGGGAGGCTATGGGGAACAGATACGCAGTATTTT	CASSYPWGRLWGTDTQYF	TRBV6-2	TRBJ2-3
TGTGCCAGCAGTGGCGAGAAAGGCTCCTACGAGCAGTACTTC	CASSGEKGSYEQYF	TRBV12-3	TRBJ2-7
TGTGCCAGCAGTAGTTGGGGGGCCACCCTGAACATTCAGTACTTC	CASSSWGATLNIQYF	TRBV6-2	TRBJ2-4
TGTGCCAGCAGCCAACCTTTCAGGGAGGGGGATTTGGAAAAACTGTTTTTT	CASSQPFREGDLEKLFF	TRBV3-1	TRBJ1-4
TGTGCCAGCAGCAGGGGGCGCGGTTCCTACAATGAGCAGTTCTTC	CASSRGRGSYNEQFF	TRBV7-3	TRBJ2-1
TGCGCCAGCAGCCAAGATAGGGTACCTGAGCAGTACTTC	CASSQDRVPEQYF	TRBV4-1	TRBJ2-7
TGTGCCACCAGCAGAGTGGGACAACGAGGCTATGGCTACACCTTC	CATSRVGQRGYGYTF	TRBV15	TRBJ1-2
TGTGCCACCAGCAGAGATCCGACAGTCGACAGCTTAAAAGATGGCAATCAGCCCCAGCATTTT	CATSRDPTVDSLKDGNQPQHF	TRBV15	TRBJ1-5
TGTGCCAGCACCCGAGGGACAGGGGGTGGTGACAATGAGCAGTTCTTC	CASTRGTGGGDNEQFF	TRBV27	TRBJ2-1
TGCAGTGCTAGCCGCCGGGGCGGGACCGGGGAGCTGTTTTTT	CSASRRGGTGELFF	TRBV20-1	TRBJ2-2
TGTGCCAGCAGCTGGGGGACGGAGAGCTACGAGCAGTACTTC	CASSWGTESYEQYF	TRBV7-2	TRBJ2-7
TGTGCCAGCAGCCAAGGAAGCACTCAACTAGCGGGAGTATCTGAAGCTTTCTTT	CASSQGSTQLAGVSEAFF	TRBV3-1	TRBJ1-1
TGTGCCAGCAGGCCGGACAGGGTCTCCGACAATCAGCCCCAGCATTTT	CASRPDRVSDNQPQHF	TRBV28	TRBJ1-5
TGTGCCACCAGTGATCTCCAAAGACTTTTTAACTATGGCTACACCTTC	CATSDLQRLFNYGYTF	TRBV24-1	TRBJ1-2
TGTGCCAGCAGCATTACAGGGAGTATTCACACTGAAGCTTTCTTT	CASSITGSIHTEAFF	TRBV13	TRBJ1-1
TGTGCCAGCAGCGAGTTTTGTAACAGGGGGGGTGACCGGTATGGCTACACCTTC	CASSEFCNRGGDRYGYTF	TRBV6-1	TRBJ1-2
TGTGCCAGCAGTTCTCATACTCAAAGGTCAACTAATGAAAAACTGTTTTTT	CASSSHTQRSTNEKLFF	TRBV28	TRBJ1-4
TGTGCCAGCAGCCCGGGTTACAGGGGGGAAGCCTATAATTCACCCCTCCACTTT	CASSPGYRGEAYNSPLHF	TRBV11-2	TRBJ1-6
TGTGCCAGCAGTCGTTCGACAGGAGGTGGCTACACCTTC	CASSRSTGGGYTF	TRBV12-4	TRBJ1-2
TGTGCCAGCAGTGACACAGAGGGGGAACGGGACAGGGAGTATCATGGCTACACCTTC	CASSDTEGERDREYHGYTF	TRBV6-4	TRBJ1-2
TGTGCCAGCAGTGAGAGTTTCTCGGGCAATGAGCAGTTCTTC	CASSESFSGNEQFF	TRBV2	TRBJ2-1
TGCAGTGCTAGAAGTCGGGGGGCCCAGTACTTC	CSARSRGAQYF	TRBV20-1	TRBJ2-5
TGTGCCAGCAGCCAAGATAGGGTGCCGGGACTAAATCCCAGCTCCTACGAGCAGTACTTC	CASSQDRVPGLNPSSYEQYF	TRBV4-2	TRBJ2-7
TGTGCCAGCAGCTTGGACCAGACAGGGGTTAGGGAGACCCAGTACTTC	CASSLDQTGVRETQYF	TRBV5-6	TRBJ2-5
TGTGCCTGGAGAGTCTACAATCAGCCCCAGCATTTT	CAWRVYNQPQHF	TRBV30	TRBJ1-5
TGTGCCAGCAGAACTGTATATGAGCAGTTCTTC	CASRTVYEQFF	TRBV6-4	TRBJ2-1
TGTGCCAGCAGCCAAGGGGACAGGGTCTACAATGAGCAGTTCTTC	CASSQGDRVYNEQFF	TRBV14	TRBJ2-1
TGTGCCTGGAGTGTACCACGGGGGTCACATAGCAATCAGCCCCAGCATTTT	CAWSVPRGSHSNQPQHF	TRBV30	TRBJ1-5
TGCGCCAGCAGATACCGGGGGGTTGATGAAAAACTGTTTTTT	CASRYRGVDEKLFF	TRBV4-1	TRBJ1-4
TGTGCCAGCAGCTTATCCCAGGAGGGCAATCAGCCCCAGCATTTT	CASSLSQEGNQPQHF	TRBV11-3	TRBJ1-5
TGTGCCTGGCCCCACAGGGCAGAAGCTAACTATGGCTACACCTTC	CAWPHRAEANYGYTF	TRBV30	TRBJ1-2
TGCACGGGGAAGGGGGGGTGTGAAGCTTTCTTT	CTGKGGCEAFF	TRBV20-1	TRBJ1-1
TGTGCCAGCAGTGACAGCCCAGGGGACAATCAGCCCCAGCATTTT	CASSDSPGDNQPQHF	TRBV6-4	TRBJ1-5
TGTGCCAGCGCGGGGGCATCAAATGAGGGTAATGAAAAACTGTTTTTT	CASAGASNEGNEKLFF	TRBV6-5	TRBJ1-4
TGTGCCAGCAGCTTGTCGGGACAGAGACACACTGAAGCTTTCTTT	CASSLSGQRHTEAFF	TRBV7-3	TRBJ1-1
TGTGCCAGCAGTTACGCAACCAAAGCAGGGGGCGCGGTCACTGAAGCTTTCTTT	CASSYATKAGGAVTEAFF	TRBV6-2	TRBJ1-1
TGTGCCAGCAGCGTTTCCAGTCCCCGGCTCTCCTACGAGCAGTACTTC	CASSVSSPRLSYEQYF	TRBV9	TRBJ2-7
TGTGCCAGCAGCTTGTCTAGACAGGGGAACACGGTCAGCTCCTATAATTCACCCCTCCACTTT	CASSLSRQGNTVSSYNSPLHF	TRBV5-6	TRBJ1-6
TGTGCCAGCAGTGAGACGACGGGTGTAGCCAAAAACATTCAGTACTTC	CASSETTGVAKNIQYF	TRBV6-1	TRBJ2-4
TGTGCCAGCAGCCTGCAAACGGGTGACAGTGCAACTAATGAAAAACTGTTTTTT	CASSLQTGDSATNEKLFF	TRBV6-1	TRBJ1-4
TGCCGGCGACAGGGGGGAGCTTTCTTT	CRRQGGAFF	TRBV20-1	TRBJ1-1
TGCGCCACAAGCGGGAAAAGGTGCACCGGGGAGCTGTTTTTT	CATSGKRCTGELFF	TRBV10-1	TRBJ2-2
TGCGCCAGCAGCCAATCGGACGGCGTCAGGAGGAGGAGCTACGAGCAGTACTTC	CASSQSDGVRRRSYEQYF	TRBV4-3	TRBJ2-7
TGTGCCAGCAGTGAGCCGGGACAGGGCGCTTTCGAGCAGTACTTC	CASSEPGQGAFEQYF	TRBV27	TRBJ2-7
TGTGCCAGTAGTATAGCGAGATTGGTCCTAAGGGGAGGGCTCAACGTCCACACCGGGGAGCTGTTTTTT	CASSIARLVLRGGLNVHTGELFF	TRBV19	TRBJ2-2
TGTGCCAGCAGCCAAGATAGAGGGAAGGATCGGGGGGCCTACAATGAGCAGTTCTTC	CASSQDRGKDRGAYNEQFF	TRBV4-2	TRBJ2-1
TGTGCCAGCAGCTTACTGAGCCACGGGGGCGCTGGCGGACAAGAGACCCAGTACTTC	CASSLLSHGGAGGQETQYF	TRBV7-3	TRBJ2-5
TGTGCTAGCAGCCCAAGGGACAAATCCGGTACGAACACCGGGGAGCTGTTTTTT	CASSPRDKSGTNTGELFF	TRBV7-7	TRBJ2-2
TGTGCCAGCAGCCAACTAGAGGACAGGGGTAGCAATCAGCCCCAGCATTTT	CASSQLEDRGSNQPQHF	TRBV3-1	TRBJ1-5
TGTGCCAGCAGCCAAGAAAACGAGTCCCCCCCAGGACTGAGTCCTGGCTACACCTTC	CASSQENESPPGLSPGYTF	TRBV3-1	TRBJ1-2
TGTGCCAGCAGCGGCCGGACAGACGTCACGGGGGAAGCTTTCTTT	CASSGRTDVTGEAFF	TRBV13	TRBJ1-1
TGTGCCAGCTCCGGGACAGCTTGGTCCTACAATGAGCAGTTCTTC	CASSGTAWSYNEQFF	TRBV2	TRBJ2-1
TGTGCCAGCAGCCAAGATCCGGGACCTATACGACTAGCGGGGTGTTCCTACAATGAGCAGTTCTTC	CASSQDPGPIRLAGCSYNEQFF	TRBV3-1	TRBJ2-1
TGTGCCAGCAGCAACAGGGGTCTGAACACCGGGGAGCTGTTTTTT	CASSNRGLNTGELFF	TRBV13	TRBJ2-2
TGTGCCAGCAGCCATCCCCGACAGGGCCTCCATCAGCCCCAGCATTTT	CASSHPRQGLHQPQHF	TRBV14	TRBJ1-5
TGTGCCAGCAGTGGGCCAGGCGAGACCCAGTACTTC	CASSGPGETQYF	TRBV6-1	TRBJ2-5
TGTGCCATCAGTGCATCCCGGGACAGGGGTTCAAGCTCCTATAATTCACCCCTCCACTTT	CAISASRDRGSSSYNSPLHF	TRBV10-3	TRBJ1-6
TGTGCCAGCAGACTAAGGGTTAAAGAGACCCAGTACTTC	CASRLRVKETQYF	TRBV5-6	TRBJ2-5
TGTGCCAGTTCCCCCATGACGACCAATGAGCAGTTCTTC	CASSPMTTNEQFF	TRBV12-3	TRBJ2-1
TGTGCCAGCAGCTGTCCGGGGGCCCCGCGAAACTTC	CASSCPGAPRNF	TRBV7-9	TRBJ2-7
TGTGCCAGCAGCGCGAGGGGTCTCGAGCAGTACTTC	CASSARGLEQYF	TRBV6-3	TRBJ2-7
TGTGCTAGTGGTTTGGTACGGCCGGGGCGCGATGCTTTCTTT	CASGLVRPGRDAFF	TRBV12-5	TRBJ1-1
TGTGCCATCAGCTCCCGTACACAGGGGCAGGGTTCACCCCTCCACTTT	CAISSRTQGQGSPLHF	TRBV10-3	TRBJ1-6
TGTGCCAGCAGTTTATGCCGGACAGGGCTCACGGAAGTGACGGGCGACACTGAAGCTTTCTTT	CASSLCRTGLTEVTGDTEAFF	TRBV27	TRBJ1-1
TGTGCCAGCAGCCTGGGCCGCCTCAACACTGAAGCTTTCTTT	CASSLGRLNTEAFF	TRBV13	TRBJ1-1
TGTGCCAGCAGCCATTCCAGACAGGTGGCACAGGCGAGGGTGATCGAGCAGTACTTC	CASSHSRQVAQARVIEQYF	TRBV7-9	TRBJ2-7
TGTGCCTGGAGTGTAATCGGACAGGGGTACACTGAAGCTTTCTTT	CAWSVIGQGYTEAFF	TRBV30	TRBJ1-1
TGTGCCAGCAGCTTTCTGCGGACATCTAACGGAAACACCATATATTTT	CASSFLRTSNGNTIYF	TRBV7-2	TRBJ1-3
TGTTATGGATATTGGCCCTACGAGCAGTACTTC	CYGYWPYEQYF	TRBV30	TRBJ2-7
TGTGCCAGCAGTTTGAGCAATCAGCCCCAGCATTTT	CASSLSNQPQHF	TRBV6-5	TRBJ1-5
TGTGCCAGCAGTGAGTCCGCAGGGGGCGCATGCACTGAAGCTTTCTTT	CASSESAGGACTEAFF	TRBV6-1	TRBJ1-1
TGCAGTGCCGAGGCCCCGACTAGCCCTCGGATCACCGGGGAGCTGTTTTTT	CSAEAPTSPRITGELFF	TRBV20-1	TRBJ2-2
TGTGCCAGCAGCGACGAACCTAGACATTCTGTGAACACTGAAGCTTTCTTT	CASSDEPRHSVNTEAFF	TRBV7-3	TRBJ1-1
TGCAGTGCAAGCCGATACTCTCGGGGGCGTATTAATGAAAAACTGTTTTTT	CSASRYSRGRINEKLFF	TRBV20-1	TRBJ1-4
TGTGCCAGCACCTCACCGACAGGGTCTGAAAAACTGTTTTTT	CASTSPTGSEKLFF	TRBV2	TRBJ1-4
TGTGCCAGCAGCTTAGGGGAGGCGGGCGTCAAGCACAGGAACAGGGGCATTTACGAGCAGTACTTC	CASSLGEAGVKHRNRGIYEQYF	TRBV11-3	TRBJ2-7
TGTGCCAGCAGCGGGGTGAGGGTGGGTAACTATGGCTACACCTTC	CASSGVRVGNYGYTF	TRBV11-3	TRBJ1-2
TGTGCCAGCAGTTACACAGGGGGTCATGACACTGAAGCTTTCTTT	CASSYTGGHDTEAFF	TRBV6-5	TRBJ1-1
TGCAGCTGCAGACCTACTTGTTACGAGCAGTACTTC	CSCRPTCYEQYF	TRBV29-1	TRBJ2-7
TGTGCCAGCAGTTCCTGGACAGTACCTTATGGCTACACCTTC	CASSSWTVPYGYTF	TRBV6-6	TRBJ1-2
TGTGCCAGCAGCGTAAGGCCTCGTAACACTGAAGCTTTCTTT	CASSVRPRNTEAFF	TRBV9	TRBJ1-1
TGTGCCAGCAGACAAGGTTACGCCCTAGCGGGAAGAACAGATACGCAGTATTTT	CASRQGYALAGRTDTQYF	TRBV27	TRBJ2-3
TGTGCCATCAGTAAAGATGGCAGTAAAGAGCAGTACTTC	CAISKDGSKEQYF	TRBV10-3	TRBJ2-7
TGTGCCAGCAGACGAGCGGGATTTAGGGAAAAACTGTTTTTT	CASRRAGFREKLFF	TRBV2	TRBJ1-4
TGTGCCTGGAGTGAGAAGGCGTACGAGCAGTACTTC	CAWSEKAYEQYF	TRBV30	TRBJ2-7
TGTGCCAGCAGTCAGGCTTACTATGGCTACACCTTC	CASSQAYYGYTF	TRBV2	TRBJ1-2
TGTGCCACCCACGGTAAGGACGAGCAGTACTTC	CATHGKDEQYF	TRBV24-1	TRBJ2-7
TGCAGCGTCAGAGGAACCTACGAGCAGTACTTC	CSVRGTYEQYF	TRBV29-1	TRBJ2-7
TGTGCCAGCAGGTATGACTATAATTCACCCCTCCACTTT	CASRYDYNSPLHF	TRBV6-5	TRBJ1-6
TGTGCCAGCAGTTGGTACAGGTCGAGTGAAAAACTGTTTTTT	CASSWYRSSEKLFF	TRBV27	TRBJ1-4
TGCGCCAGCAGCCAAATTGCGGGCAGGGAACCATCCTACGAGCAGTACTTC	CASSQIAGREPSYEQYF	TRBV4-3	TRBJ2-7
TGTGCCAGCAGTTATACCCCAGGGATGTCGAGCTCCTACGAGCAGTACTTC	CASSYTPGMSSSYEQYF	TRBV6-6	TRBJ2-7
TGTGCCACCAGTGATCCCTCGGCCGATGTCCGGGACAAGCTAGAGACCCAGTACTTC	CATSDPSADVRDKLETQYF	TRBV24-1	TRBJ2-5
TGCGCCAGCACAGGGGTTTACGAGCAGTACTTC	CASTGVYEQYF	TRBV4-3	TRBJ2-7
TGTGCCAGCAGCTTGAAAGCCGGGACTGTTACCTACGAGCAGTACTTC	CASSLKAGTVTYEQYF	TRBV5-5	TRBJ2-7
TGTGCCTGGACGTGCTTAACGGGACAGGGCGGGGAGCTGTTTTTT	CAWTCLTGQGGELFF	TRBV30	TRBJ2-2
TGTGCCAGCAGCGACAGAGGGGCCTACGAGCAGTACTTC	CASSDRGAYEQYF	TRBV9	TRBJ2-7
TGTGCCAGCACAGCTTATGTCCCTAGTGTTGCAACTGGCTACGAGCAGTACTTC	CASTAYVPSVATGYEQYF	TRBV3-1	TRBJ2-7
TGTGCTAGTGGTCACAGGGGTGGGACCGGGGAGCTGTTTTTT	CASGHRGGTGELFF	TRBV12-5	TRBJ2-2
TGCAGTGCTAGAGCCTTTGCCAAGCCGTATCTCTCTGGGGCCAACGTCCTGACTTTC	CSARAFAKPYLSGANVLTF	TRBV20-1	TRBJ2-6
TGCGCCAGCAGCTTGGTTACGAGGGGGGGAGGCTCCTACAATGAGCAGTTCTTC	CASSLVTRGGGSYNEQFF	TRBV5-1	TRBJ2-1
TGTGCCAGCAGTTGGGGGACAGGGAGCTACGAGCAGTACTTC	CASSWGTGSYEQYF	TRBV28	TRBJ2-7
TGTGCCAGCAGCCAGATCGACCCAGGGTACTATGGCTACACCTTC	CASSQIDPGYYGYTF	TRBV9	TRBJ1-2
TGTGCCAGCAGCGTCGGGACAGGGGGCGCGAAGCCCGGCTACACCTTC	CASSVGTGGAKPGYTF	TRBV9	TRBJ1-2
TGTGCCAGTAGTAGACCTAGGGGCTCCGGGGAGCTGTTTTTT	CASSRPRGSGELFF	TRBV19	TRBJ2-2
TGTGCCCACGCCAATCAGCCCCAGCATTTT	CAHANQPQHF	TRBV5-6	TRBJ1-5
TGTGCCAGCAGCTTAGGACCGGACAGTGGCTACACCTTC	CASSLGPDSGYTF	TRBV7-2	TRBJ1-2
TGCAGTGCTAGAGATGGGGGGCCCGGTGGAAACACCGGGGAGCTGTTTTTT	CSARDGGPGGNTGELFF	TRBV20-1	TRBJ2-2
TGCAGTGCTCATCGGCAGACTAGCGGGAGGGCCCACGAGCAGTACTTC	CSAHRQTSGRAHEQYF	TRBV20-1	TRBJ2-7
TGTGCCAGCAGACCGGGGCGGGCCAGCAATCAGCCCCAGCATTTT	CASRPGRASNQPQHF	TRBV12-4	TRBJ1-5
TGTGCCAGCAGTTTACGGACAGGGGGGGAGCCCCAGCATTTT	CASSLRTGGEPQHF	TRBV27	TRBJ1-5
TGCGCCAGCAGCATGGGAGGGGTATCCTATGGCTACACCTTC	CASSMGGVSYGYTF	TRBV4-3	TRBJ1-2
TGTGCCAGCAGCTGGGAGTGGGGGAATGAGACCCAGTACTTC	CASSWEWGNETQYF	TRBV7-9	TRBJ2-5
TGCGCCAGCAGTGAGGGACTAGCGGGAATGGGTCCCTACAATGAGCAGTTCTTC	CASSEGLAGMGPYNEQFF	TRBV10-1	TRBJ2-1
TGTGCCCCAAAACCTCAGAAGGGGCCTTCGAACACTGAAGCTTTCTTT	CAPKPQKGPSNTEAFF	TRBV5-4	TRBJ1-1
TGTGCCAGCAGTTGCGAACCCGGGGGGGGTCTGCAGTTCTTC	CASSCEPGGGLQFF	TRBV28	TRBJ2-1
TGCGCCAGCAGCCACCCATTAGGCAGGGATGGCTACACCTTC	CASSHPLGRDGYTF	TRBV4-3	TRBJ1-2
TGTGCCAGCAGGTTTCCGAACGGCAGGTCCAATCAGCCCCAGCATTTT	CASRFPNGRSNQPQHF	TRBV7-7	TRBJ1-5
TGTGCCAGCAGCTTGTTATGTACTCAGGGGGGGTTCTCAGATACGCAGTATTTT	CASSLLCTQGGFSDTQYF	TRBV5-6	TRBJ2-3
TGCGCCAGCAGCTTGCCGTCTCGGCGGGCCAAGGGTTCTAGGGCCTACGAGCAGTACTTC	CASSLPSRRAKGSRAYEQYF	TRBV5-1	TRBJ2-7
TGTGCCAGCAGCTTAGGTTCAGGGGGTCAGCCCCAGCATTTT	CASSLGSGGQPQHF	TRBV7-9	TRBJ1-5
TGTGCCAGCAGCATTCGCCGGCCAGCGGACAGGCAAGAGACCCAGTACTTC	CASSIRRPADRQETQYF	TRBV7-3	TRBJ2-5
TGTGCCAGCAGCCAAAAAACAGGGGGGGTGAACACTGAAGCTTTCTTT	CASSQKTGGVNTEAFF	TRBV14	TRBJ1-1
TGTGTCACTAAGCGGGACGAGCGCGAGCAGTACTTC	CVTKRDEREQYF	TRBV7-9	TRBJ2-7
TGTGCCAGCAGCTACCCAACAGGATATAGCAATCAGCCCCAGCATTTT	CASSYPTGYSNQPQHF	TRBV5-6	TRBJ1-5
TGTGCCAGCAGCTCTAGCGGGGGGGAAGAGACCCAGTACTTC	CASSSSGGEETQYF	TRBV6-6	TRBJ2-5
TGTGCCAGCGACGCCCCGGAGGTAGCTCGGTACTTC	CASDAPEVARYF	TRBV6-6	TRBJ2-4
TGTGCCAGCTTCTGGCACTATGGCTACACCTTC	CASFWHYGYTF	TRBV9	TRBJ1-2
TGTGCCAGCAGTGGAGATGTGGGGGTAACGAACACCGGGGAGCTGTTTTTT	CASSGDVGVTNTGELFF	TRBV2	TRBJ2-2
TGTGCCAGCAGCCAGAGACAGGGGATGGCAGGAGATACGCAGTATTTT	CASSQRQGMAGDTQYF	TRBV6-1	TRBJ2-3
TGTGCCAGCAGCTTGTTGAGAGCGGCCCACAGGAACTATGGCTACACCTTC	CASSLLRAAHRNYGYTF	TRBV5-6	TRBJ1-2
TGTGCCAGCAGTGACCCAATCGACAGGGGCTACACTGAAGCTTTCTTT	CASSDPIDRGYTEAFF	TRBV6-4	TRBJ1-1
TGCATCAGGGGCGTCCAAGAGACCCAGTACTTC	CIRGVQETQYF	TRBV20-1	TRBJ2-5
TGTGCGCCGGTATCCCCTGGGAGGAACAATGAGCAGTTCTTC	CAPVSPGRNNEQFF	TRBV5-4	TRBJ2-1
TGCAGTGCTAGCCTCGGGGATGAGGGCACAGAGACCCAGTACTTC	CSASLGDEGTETQYF	TRBV20-1	TRBJ2-5
TGTGCCAGCAGCGCAGGGGGCGTTTGGGTAGGTGATAGCAATCAGCCCCAGCATTTT	CASSAGGVWVGDSNQPQHF	TRBV12-4	TRBJ1-5
TGTGCCAGCACCAAGGGGGCCGGGGAGGGGCTTTGGGAACTCTATGGCTACACCTTC	CASTKGAGEGLWELYGYTF	TRBV6-1	TRBJ1-2
TGCAGTGGAGCGGGACAGGGCCCCAGCAATCAGCCCCAGCATTTT	CSGAGQGPSNQPQHF	TRBV20-1	TRBJ1-5
TGTGCCACCCAGTCCCCTAGGGGGGTTAATGAAAAACTGTTTTTT	CATQSPRGVNEKLFF	TRBV24-1	TRBJ1-4
TGTGCCAGCAGTTTATGGACAGGGAGGAGCAATCAGCCCCAGCATTTT	CASSLWTGRSNQPQHF	TRBV27	TRBJ1-5
TGTGCCTGGAGTGTACGACAGCTTTACAGGTCCTCCTACAATGAGCAGTTCTTC	CAWSVRQLYRSSYNEQFF	TRBV30	TRBJ2-1
TGTGCCAGCAGCGTAGCACCCCGGGACGGAGGTGAAAGCAATCAGCCCCAGCATTTT	CASSVAPRDGGESNQPQHF	TRBV9	TRBJ1-5
TGTGCCAGGGGTTGCCATTTGCCTGGAAACACCATATATTTT	CARGCHLPGNTIYF	TRBV10-3	TRBJ1-3
TGTGCCAGCAGTAAACCACCGAGGAGGGACGGAGAGAGCTATGGCTACACCTTC	CASSKPPRRDGESYGYTF	TRBV25-1	TRBJ1-2
TGTGCCAGCAGACTTGAGCAGTTCTTC	CASRLEQFF	TRBV6-6	TRBJ2-1
TGTGCCAGCAGCCAAGAGGGCAAAGGCTACGAGCAGTACTTC	CASSQEGKGYEQYF	TRBV3-1	TRBJ2-7
TGTGCCAGCAGCTTTGGACAGGGGGCGGGGGCACCCGGAAATGGGAAGGACGAGCAGTACTTC	CASSFGQGAGAPGNGKDEQYF	TRBV5-4	TRBJ2-7
TGTGCCAGCAGCCTCAAAGGGACGGGGTGCGGTACCACTGGGGCCAACGTCCTGACTTTC	CASSLKGTGCGTTGANVLTF	TRBV9	TRBJ2-6
TGTGCCATGACAGGGAGCGAGCAGTACTTC	CAMTGSEQYF	TRBV2	TRBJ2-7
TGTGCCAGCAGCGGTTCAGTTTGGGAACCTAGCGGGAATCCGAACACCGGGGAGCTGTTTTTT	CASSGSVWEPSGNPNTGELFF	TRBV5-6	TRBJ2-2
TGTGCCAGCAGTTTTATGGACAAAGATAGCGAAGGCCGGGCTGAAGCTTTCTTT	CASSFMDKDSEGRAEAFF	TRBV12-4	TRBJ1-1
TGTGCCAGCAGCCCGAGCAGGCTTTTGTACTTC	CASSPSRLLYF	TRBV5-4	TRBJ2-5
TGTGCTAGTGGTCCGGGGGGGGCGCAGTATTTT	CASGPGGAQYF	TRBV12-5	TRBJ2-3
TGTGCCAGCAGCCAGAAGGGTGGGGAGGGGGGGCCCGAGCAGTACTTC	CASSQKGGEGGPEQYF	TRBV14	TRBJ2-7
TGTGCCAGCAGTTACTCTCTGGCAAGGACAGTGTTAAACACTGAAGCTTTCTTT	CASSYSLARTVLNTEAFF	TRBV6-5	TRBJ1-1
TGTGCCAGCAGTTTATCGGTCCCGGGACTAGGTAACGAGCAGTACTTC	CASSLSVPGLGNEQYF	TRBV27	TRBJ2-7
TGTGCCTGGAGTGTATCGGGGACTCCGGGACATGCTTTCTTT	CAWSVSGTPGHAFF	TRBV30	TRBJ1-1
TGCGCCAGCAGTGAGCTTCCCCACGGGAGCTATGGCTACACCTTC	CASSELPHGSYGYTF	TRBV10-2	TRBJ1-2
TGTGCCAGCAGGTCCTGGACTAGCACCGGGGAGCTGTTTTTT	CASRSWTSTGELFF	TRBV28	TRBJ2-2
TGTGCCAGCAGTGACTCCCGTCCCAGGGGAGATACGCAGTATTTT	CASSDSRPRGDTQYF	TRBV6-4	TRBJ2-3
TGTGCTAGTGGTTTGGACAGGGGGCTTTACACTGAAGCTTTCTTT	CASGLDRGLYTEAFF	TRBV12-5	TRBJ1-1
TGTGCCAGCAGCGACAGGCCTACCGGGGAGCTGTTTTTT	CASSDRPTGELFF	TRBV13	TRBJ2-2
TGTGCCAGCGGGAGGGGGGCCGGGGCCGGGGAGCTGTTTTTT	CASGRGAGAGELFF	TRBV19	TRBJ2-2
TGTGCCAGCAGCTTCCGAGGTCGGGGACGGATCACAGATACGCAGTATTTT	CASSFRGRGRITDTQYF	TRBV13	TRBJ2-3
TGTGCCAGCAGCGTAGCTGGACTAGCGGGGCAGTTCTTC	CASSVAGLAGQFF	TRBV9	TRBJ2-1
TGTGCCAGCAGTCGTGGACAGGGCCGGCACACTGAAGCTTTCTTT	CASSRGQGRHTEAFF	TRBV6-3	TRBJ1-1
TGTGCCACCAGGATGGACAGTATGCTAACTAATGAAAAACTGTTTTTT	CATRMDSMLTNEKLFF	TRBV24-1	TRBJ1-4
TGCAGTGCTAGGTCCGACCGCTATGGCTACACCTTC	CSARSDRYGYTF	TRBV20-1	TRBJ1-2
TGCAGTGCGTTGGGGGCTACCTACGAGCAGTACTTC	CSALGATYEQYF	TRBV20-1	TRBJ2-7
TGTGCCAGCAGACTCCCCAGGGGGGCAGGCGGCCATTCACCCCTCCACTTT	CASRLPRGAGGHSPLHF	TRBV9	TRBJ1-6
TGTGCCAGCAGTTCCGCGCGGGAGTTGAAGTACGAGCAGTACTTC	CASSSARELKYEQYF	TRBV27	TRBJ2-7
TGTGCCAGGAGCAACTTCCAGCCCCAGCATTTT	CARSNFQPQHF	TRBV6-6	TRBJ1-5
TGTGCTAGCAGCGGAAGGGATCCAGGGGATTCCTACGAGCAGTACTTC	CASSGRDPGDSYEQYF	TRBV7-7	TRBJ2-7
TGTGCCAGCAGCGTGAAAAGTCCGGACAGGGGGACTGAGCAGTTCTTC	CASSVKSPDRGTEQFF	TRBV13	TRBJ2-1
TGCGCCAGCAGTGAGTCGACTAATTTAATGGGGGCGATGCGGTCTGGGGCCAACGTCCTGACTTTC	CASSESTNLMGAMRSGANVLTF	TRBV10-2	TRBJ2-6
TGTGCCAGCAGTTCAAAAACCACTGACTTCACTGAAGCTTTCTTT	CASSSKTTDFTEAFF	TRBV27	TRBJ1-1
TGCGCCAGCAGCTTGGGCAAATCCACTAGCACCGGGGAGCTGTTTTTT	CASSLGKSTSTGELFF	TRBV5-1	TRBJ2-2
TGTGCCAGGGGGACGGAGGGGGCCACCGGGGAGCTGTTTTTT	CARGTEGATGELFF	TRBV27	TRBJ2-2
TGTGCCAGTAGAGTTAAGGGTTCGGGCTACCCCGATACGCAGTATTTT	CASRVKGSGYPDTQYF	TRBV19	TRBJ2-3
TGCGCCAGCAGCCAAGAAGTAGCGGGTTCCTACGAGCAGTACTTC	CASSQEVAGSYEQYF	TRBV4-1	TRBJ2-7
TGCGCCAGCAGCCAAGATGTAGGTAAGGTTACGGGGACTAGCGGGTACCCAGATACGCAGTATTTT	CASSQDVGKVTGTSGYPDTQYF	TRBV4-1	TRBJ2-3
TGTGCCAGCAGTTTGGGGACTAGCGGGGTCGGGGAGCAGTACTTC	CASSLGTSGVGEQYF	TRBV28	TRBJ2-7
TGTGCCAGCAGCTTACGTGCCTCCTCTTACCAGATCAAAAACATTCAGTACTTC	CASSLRASSYQIKNIQYF	TRBV7-4	TRBJ2-4
TGTGCCAGCACGCCCGAGAGGGGAGATTCTGGGGCCAACGTCCTGACTTTC	CASTPERGDSGANVLTF	TRBV12-3	TRBJ2-6
TGTGCCAGCAGCCGCGGCGGGAGGGGAGTTACTGAAGCTTTCTTT	CASSRGGRGVTEAFF	TRBV7-8	TRBJ1-1
TGTGCCAGCAGTTGGACAGGGGGCGTCAATCAGCCCCAGCATTTT	CASSWTGGVNQPQHF	TRBV27	TRBJ1-5
TGCGCCATGACTACAAGGACAGGAGGGGCCTACGAGCAGTACTTC	CAMTTRTGGAYEQYF	TRBV10-1	TRBJ2-7
TGTGCCAGCAGCCTCAGGGGTACAAGCACAGATACGCAGTATTTT	CASSLRGTSTDTQYF	TRBV13	TRBJ2-3
TGTGCCGGGGGGGCCCCCTACCCAGATACGCAGTATTTT	CAGGAPYPDTQYF	TRBV10-3	TRBJ2-3
TGTGCCAGCATTTTACGCAGGAACATCTACGAGCAGTACTTC	CASILRRNIYEQYF	TRBV9	TRBJ2-7
TGTGCCAGCAGCGTCCCCGAACTTTCCTCCTACGAGCAGTACTTC	CASSVPELSSYEQYF	TRBV13	TRBJ2-7
TGCGCCAGGGAGGGGGCGCGGGCGACCCAGTACTTC	CAREGARATQYF	TRBV10-2	TRBJ2-5
TGTGCCAGTAGTAAGGTTGGGCCGGACAGGGGGTTCGTTGGGACCCAGTACTTC	CASSKVGPDRGFVGTQYF	TRBV19	TRBJ2-5
TGTGCCAGCAGCGTAGGCAACTTAGCGAGAGGCGGCACAGATACGCAGTATTTT	CASSVGNLARGGTDTQYF	TRBV9	TRBJ2-3
TGTGCCAGTAGTATATCAGGACAGGGTACGGTGAACACTGAAGCTTTCTTT	CASSISGQGTVNTEAFF	TRBV19	TRBJ1-1
TGCGCCAGCACACTAGCGGGAAACGAGACCCAGTACTTC	CASTLAGNETQYF	TRBV10-1	TRBJ2-5
TGTGCCAGCAGCTCCCCCCCATGGACTAGCGGGGGTAGCTCCTACGAGCAGTACTTC	CASSSPPWTSGGSSYEQYF	TRBV7-3	TRBJ2-7
TGTGCCAGCATGCGACTAGTAGCAGATACGCAGTATTTT	CASMRLVADTQYF	TRBV5-6	TRBJ2-3
TGTGCCAGCAGGGACAGCGAGCAGTACTTC	CASRDSEQYF	TRBV27	TRBJ2-7
TGTGCCAGCAGCACAGAATGCAATGAGCAGTTCTTC	CASSTECNEQFF	TRBV6-5	TRBJ2-1
TGTGCCAGCAGCCAAGACGGACGATACAATGAGCAGTTCTTC	CASSQDGRYNEQFF	TRBV4-2	TRBJ2-1
TGTGCCAGCCCGGTTAACACTGAAGCTTTCTTT	CASPVNTEAFF	TRBV7-4	TRBJ1-1
TGCGCCAGATGGCTGAGCGGTAAGACCCAGTACTTC	CARWLSGKTQYF	TRBV5-1	TRBJ2-5
TGTGCCAGCAGCCCAGGGGGCCCGTCGCAGTATTTT	CASSPGGPSQYF	TRBV13	TRBJ2-3
TGCAGTGCGGGACAGGGGGCTCGTCAGCCCCAGCATTTT	CSAGQGARQPQHF	TRBV20-1	TRBJ1-5
TGTGCCAGCAGCCCAGGCCCACTCACAGATACGCAGTATTTT	CASSPGPLTDTQYF	TRBV7-2	TRBJ2-3
TGCAGTGCCTCCATCGGCTCCTACAATGAGCAGTTCTTC	CSASIGSYNEQFF	TRBV20-1	TRBJ2-1
TGTGCCAGCAGCTTCCCCGGCCCTAGGCTGCTCTACGAGCAGTACTTC	CASSFPGPRLLYEQYF	TRBV5-8	TRBJ2-7
TGTGCCACCAGCAGAGGGGGAGACCAGCCCCAGCATTTT	CATSRGGDQPQHF	TRBV15	TRBJ1-5
TGTGCCAGGTTCCCCCCCGGGACAGACTATGGCTACACCTTC	CARFPPGTDYGYTF	TRBV6-6	TRBJ1-2
TGTGCCAGCAGACTCAGTGAGACAGGCTTTCAGCCCCAGCATTTT	CASRLSETGFQPQHF	TRBV2	TRBJ1-5
TGTGCCTGGACTTTTCAGGTTACAGGCTACACCTTC	CAWTFQVTGYTF	TRBV30	TRBJ1-2
TGTGCCAGAGGTTGTGGCTACGAGCAGTACTTC	CARGCGYEQYF	TRBV6-5	TRBJ2-7
TGTGCCAGCAAAAACCTCAGGGACAGGGGGGGGGGCTACACCTTC	CASKNLRDRGGGYTF	TRBV27	TRBJ1-2
TGCAGCGTTGAAGATCTCTCACTCGGGGGGGGGACCAATGAGCAGTTCTTC	CSVEDLSLGGGTNEQFF	TRBV29-1	TRBJ2-1
TGTGCCCAGCCACCGGGACAGGCACAGCCCCAGCATTTT	CAQPPGQAQPQHF	TRBV19	TRBJ1-5
TGTGCCAGCAGTAAACGGACTGAGCAGTTCTTC	CASSKRTEQFF	TRBV6-4	TRBJ2-1
TGTGCCAGCAGCCTAGGCGGCTACGAGCAGTACTTC	CASSLGGYEQYF	TRBV13	TRBJ2-7
TGTGCCAGTCGGACAGGGTGCACTGAAGCTTTCTTT	CASRTGCTEAFF	TRBV19	TRBJ1-1
TGTGCCAGCAGGTTCACCCGGGACGCCTACGAGCAGTACTTC	CASRFTRDAYEQYF	TRBV11-3	TRBJ2-7
TGTGCCAGCAGTGAAGCACCAAGGGGCCTAGGTAACTATGGCTACACCTTC	CASSEAPRGLGNYGYTF	TRBV6-1	TRBJ1-2
TGCGCCAGCAATGGACAGGGATTGCTTTCACCCCTCCACTTT	CASNGQGLLSPLHF	TRBV5-1	TRBJ1-6
TGTGCCAGCAGCCAAGATAAAGCTTTTCGTTCACGCAGTGGCTACACCTTC	CASSQDKAFRSRSGYTF	TRBV3-1	TRBJ1-2
TGTGCCAGCAGTAACGCTTTACAGGCAGGAGTTACCGTAGGCTACACCTTC	CASSNALQAGVTVGYTF	TRBV6-1	TRBJ1-2
TGTGCCAAAGTAAGTATTTCGGGAGGGCCCTTCCGGAAAGAGACCCAGTACTTC	CAKVSISGGPFRKETQYF	TRBV28	TRBJ2-5
TGTGCCAGCAGCACGGTTACGGGCGAGCAGTACTTC	CASSTVTGEQYF	TRBV7-3	TRBJ2-7
TGCAGTGCCTCGGGGTACGCTAAGTCAGATACGCAGTATTTT	CSASGYAKSDTQYF	TRBV20-1	TRBJ2-3
TGTGCCAGCAGCTTACCCCAGGGGGCTAATGAGCAGTTCTTC	CASSLPQGANEQFF	TRBV7-9	TRBJ2-1
TGCGCCAGCAGCCAAGACTACTCGGGCGAGGGCGGATATGGCTACACCTTC	CASSQDYSGEGGYGYTF	TRBV4-1	TRBJ1-2
TGCAGCGGCGGGCCCCGCCCCCCTCGGGTCTGGGTCTCCAAAAACATTCAGTACTTC	CSGGPRPPRVWVSKNIQYF	TRBV29-1	TRBJ2-4
TGTGCCATAGGCCTGTTAAGGGAGGCCTCCTATGGCTACACCTTC	CAIGLLREASYGYTF	TRBV12-3	TRBJ1-2
TGTGCCAGCAGCGGACAGGAACTGCACGAGCAGTACTTC	CASSGQELHEQYF	TRBV5-6	TRBJ2-7
TGTGCCAGCAGCTTGGGGGGGGAAGGGACAGTCAGCTCCTACAATGAGCAGTTCTTC	CASSLGGEGTVSSYNEQFF	TRBV7-9	TRBJ2-1
TGTGCCATCAGAGGGACAGGGGGCAGGGGGGGCACTGAAGCTTTCTTT	CAIRGTGGRGGTEAFF	TRBV10-3	TRBJ1-1
TGTGCCAGCGACAGGCTCGTCACAGATACGCAGTATTTT	CASDRLVTDTQYF	TRBV2	TRBJ2-3
TGTGCCAGCCCGGACAGGGAGACTTGCAATCAGCCCCAGCATTTT	CASPDRETCNQPQHF	TRBV11-1	TRBJ1-5
TGTGCCAGCAGTACGAACACGGAGGGGAACACTGAAGCTTTCTTT	CASSTNTEGNTEAFF	TRBV6-3	TRBJ1-1
TGCGCCAGCAGTGACTGGGTCGTCTCGAACACCGGGGAGCTGTTTTTT	CASSDWVVSNTGELFF	TRBV10-1	TRBJ2-2
TGTGCCACCAGTGTTCCGGGGGACAGGGGGAGGGGTCCTTACTTCATGAACACTGAAGCTTTCTTT	CATSVPGDRGRGPYFMNTEAFF	TRBV24-1	TRBJ1-1
TGCGCCAGCAGGAAGTCGAGTGACAGGGTAGACACAGATACGCAGTATTTT	CASRKSSDRVDTDTQYF	TRBV5-1	TRBJ2-3
TGTGCCAGCCACAGCCCGACAGGGATTCGAAATGAAAAACTGTTTTTT	CASHSPTGIRNEKLFF	TRBV7-3	TRBJ1-4
TGTGCCAGCAGTTTAGGTTTAGCTTACACTGAAGCTTTCTTT	CASSLGLAYTEAFF	TRBV27	TRBJ1-1
TGTGCCAGCTCACCAAAGCCACATAATTTTTTGTATGGCTACACCTTC	CASSPKPHNFLYGYTF	TRBV18	TRBJ1-2
TGTGCCAGTAGCGGGGACAGGGGACCTGATAACTATGGCTACACCTTC	CASSGDRGPDNYGYTF	TRBV19	TRBJ1-2
TGTGGTCTTCAGGGCCTGGACTCCTACGAGCAGTACTTC	CGLQGLDSYEQYF	TRBV6-4	TRBJ2-7
TGTGCCAGCCGGGACTCACGTAATGAAAAACTGTTTTTT	CASRDSRNEKLFF	TRBV27	TRBJ1-4
TGTGCCAGCAGCTTGGGAAGGGCAGACAGGGCGACTTACACCGGGGAGCTGTTTTTT	CASSLGRADRATYTGELFF	TRBV5-6	TRBJ2-2
TGTGCCAGCTCACGGGGGGGGGGATGGCCCTCTGGGGCCAACGTCCTGACTTTC	CASSRGGGWPSGANVLTF	TRBV18	TRBJ2-6
TGCAGTGCCCCCCGGGACAGGGGGGCTTCCAGGGTTCAGCCCCAGCATTTT	CSAPRDRGASRVQPQHF	TRBV20-1	TRBJ1-5
TGTGCCAGCAGCCGGGCCCCTTTAGAACAGGGAGCTGTTACCTATAATTCACCCCTCCACTTT	CASSRAPLEQGAVTYNSPLHF	TRBV11-2	TRBJ1-6
TGTGCCAGCATTCACCTTGAGACACAGGGATGGAACACTGAAGCTTTCTTT	CASIHLETQGWNTEAFF	TRBV6-1	TRBJ1-1
TGTGCCAGCAGTTTGACCCAGGGTGGGAATTCACCCCTCCACTTT	CASSLTQGGNSPLHF	TRBV12-3	TRBJ1-6
TGTGCCAGCATGGGGAAACGGGGCTACGAGCAGTACTTC	CASMGKRGYEQYF	TRBV6-8	TRBJ2-7
TGCGCCAGCAGCCAAGACAGAACTACGGATGAAAAACTGTTTTTT	CASSQDRTTDEKLFF	TRBV4-3	TRBJ1-4
TGTGCCAGCAGCTTAGCGCGAATGCAGGCGAGGACCTTCCCCTACGAGCAGTACTTC	CASSLARMQARTFPYEQYF	TRBV7-2	TRBJ2-7
TGTGCCAGCAGCCGGGGGGGGAATCGGTCCCTAGCCAAAAACATTCAGTACTTC	CASSRGGNRSLAKNIQYF	TRBV5-6	TRBJ2-4
TGTGCCAGCCTACCCGGGCCGTGTCAGCCCCAGCATTTT	CASLPGPCQPQHF	TRBV11-3	TRBJ1-5
TGTGCCAGCTCACCAATTAGAGCGGGAGGGCTGGGTTATGGCTACACCTTC	CASSPIRAGGLGYGYTF	TRBV18	TRBJ1-2
TGTGCCAGCAGCCCACCTAGCTATGGCTACACCTTC	CASSPPSYGYTF	TRBV11-1	TRBJ1-2
TGTGCCAGCAGCCAAGACAGGACCCGGGGTGCGCTCGGTAACACTGAAGCTTTCTTT	CASSQDRTRGALGNTEAFF	TRBV3-1	TRBJ1-1
TGTGCCAGCAGTTACCCCAGAAATTGGGAGGAGAGGACCGGGGAGCTGTTTTTT	CASSYPRNWEERTGELFF	TRBV6-5	TRBJ2-2
TGTGCCATCAGTGGTTGGGGGCGGCTGAACACTGAAGCTTTCTTT	CAISGWGRLNTEAFF	TRBV10-3	TRBJ1-1
TGTGCCAGCAGCGAGAACAATGAGCAGTTCTTC	CASSENNEQFF	TRBV7-3	TRBJ2-1
TGCGCCAGCAGCCCCAGACAGGGGACAAGAAACACCATATATTTT	CASSPRQGTRNTIYF	TRBV5-1	TRBJ1-3
TGTGCCAGCAGCCCGACAGGTTATGGCTACACCTTC	CASSPTGYGYTF	TRBV6-1	TRBJ1-2
TGTGCCAGCAGCTGGACAGGGGGGGCAACTAATGAAAAACTGTTTTTT	CASSWTGGATNEKLFF	TRBV13	TRBJ1-4
TGTGCCAGTAGTATAGAAGGGGGGCACACTGAAGCTTTCTTT	CASSIEGGHTEAFF	TRBV19	TRBJ1-1
TGCGCCAGCACCTACCAGGGGGACGGTGAAGCTTTCTTT	CASTYQGDGEAFF	TRBV10-1	TRBJ1-1
TGTGCCAGCAGCATAACCGGGGAAGACGAGCAGTACTTC	CASSITGEDEQYF	TRBV7-3	TRBJ2-7
TGTGCCAGCAGTTTACGATCGCTCTGTACAGATACGCAGTATTTT	CASSLRSLCTDTQYF	TRBV27	TRBJ2-3
TGTGCCAGCAGTTACGGTTGGACCGACAGGTGGCCTGAAGCTTTCTTT	CASSYGWTDRWPEAFF	TRBV6-5	TRBJ1-1
TGTGCCAGCAGTCTCAAGTCCACCCGCCGGGATACCTACGAGCAGTACTTC	CASSLKSTRRDTYEQYF	TRBV27	TRBJ2-7
TGCGCCAGCAGTGACGTCGGCAGGGGGTCAAACACTGAAGCTTTCTTT	CASSDVGRGSNTEAFF	TRBV10-2	TRBJ1-1
TGTGCCAGCAGTACCCCTATAGTCACTGACATTGGGAACACTGAAGCTTTCTTT	CASSTPIVTDIGNTEAFF	TRBV28	TRBJ1-1
TGTGCCAGCATGTCGGAGACCGGGGACAGCCCTGAGAACACTGAAGCTTTCTTT	CASMSETGDSPENTEAFF	TRBV5-6	TRBJ1-1
TGCGCCAGCAGCTTGGCCCGTCCCAGGGTGAAGGTCAATCAGCCCCAGCATTTT	CASSLARPRVKVNQPQHF	TRBV5-1	TRBJ1-5
TGCAGCGTTGGCGCCGACAGTAACTCTGGGGCCAACGTCCTGACTTTC	CSVGADSNSGANVLTF	TRBV29-1	TRBJ2-6
TGTGCCACCAGTGATCTGTTACCTACAGGACAGGGGCACTATGGCTACACCTTC	CATSDLLPTGQGHYGYTF	TRBV24-1	TRBJ1-2
TGTGCCACCGTCACAGGGGGCCTCCACTCCTACGAGCAGTACTTC	CATVTGGLHSYEQYF	TRBV19	TRBJ2-7
TGCGCCAGCAGCCAAGATGTCCAAATAAGGACAGAGTTTGGAGAGACCCAGTACTTC	CASSQDVQIRTEFGETQYF	TRBV4-1	TRBJ2-5
TGTGCCAGCAGCGGGAGCAATCAGCCCCAGCATTTT	CASSGSNQPQHF	TRBV14	TRBJ1-5
TGTGCCACCAGTGATTTCCCCAGGTCCGGACAGGGGCCCCAGCATTTT	CATSDFPRSGQGPQHF	TRBV24-1	TRBJ1-5
TGCGCCAGCAGCGAGGGACTAGCGGGCACAGATACGCAGTATTTT	CASSEGLAGTDTQYF	TRBV5-1	TRBJ2-3
TGTGCCAGCTCACCACCTTCGACGGGGACAGGGTTAACATACGAGCAGTACTTC	CASSPPSTGTGLTYEQYF	TRBV18	TRBJ2-7
TGCAGTGCTAGTCGGCTGACTATCGATAGCAATCAGCCCCAGCATTTT	CSASRLTIDSNQPQHF	TRBV20-1	TRBJ1-5
TGTGCCAGCACCCAGACAGGGAGCAATCAGCCCCAGCATTTT	CASTQTGSNQPQHF	TRBV6-4	TRBJ1-5
TGTGCCAGTAGTCTGGGGGCGAATAACTATGGCTACACCTTC	CASSLGANNYGYTF	TRBV19	TRBJ1-2
TGTGCCACCCGTCGCCGGAGCAATCAGCCCCAGCATTTT	CATRRRSNQPQHF	TRBV10-3	TRBJ1-5
TGTGCCTGGGCCCGGGACAGCTACACCTTC	CAWARDSYTF	TRBV30	TRBJ1-2
TGCGCCAGCAGCCTCGACTCCACTAGCGGGAGGACTGGCTACACCGGGGAGCTGTTTTTT	CASSLDSTSGRTGYTGELFF	TRBV5-1	TRBJ2-2
TGTGCCAGCAGTGGACGGGAAGAGACCCAGTACTTC	CASSGREETQYF	TRBV27	TRBJ2-5
TGTGCCAGCAGCCCCCCCCTACAGGACACTGAAGCTTTCTTT	CASSPPLQDTEAFF	TRBV7-3	TRBJ1-1
TGCAGCGTTGAGCTCATAGGAGGGCGCAAAAACATTCAGTACTTC	CSVELIGGRKNIQYF	TRBV29-1	TRBJ2-4
TGTGCCAGCAGTTACGAAAACCGGGAGCCCCAGCATTTT	CASSYENREPQHF	TRBV6-5	TRBJ1-5
TGTGCCACCAGTGATTTGACCACAATAATATACAGGAGACTCAATCAGCCCCAGCATTTT	CATSDLTTIIYRRLNQPQHF	TRBV24-1	TRBJ1-5
TGTGCCAGCAAGTCAAATATAGTGGGGTGCAATGAGCAGTTCTTC	CASKSNIVGCNEQFF	TRBV27	TRBJ2-1
TGCAGTGCCACCCGGGGGAACGAAGCTTTCTTT	CSATRGNEAFF	TRBV20-1	TRBJ1-1
TGCAGCGTGACAGGGGACGCCTACGAGCAGTACTTC	CSVTGDAYEQYF	TRBV29-1	TRBJ2-7
TGTGCCTGGCCCCGTTTAATGGACGGTTTTGAGACCCAGTACTTC	CAWPRLMDGFETQYF	TRBV30	TRBJ2-5
TGCAGTGCTAGAGATAAAGGGGGGGGGCAGCCCCAGCATTTT	CSARDKGGGQPQHF	TRBV20-1	TRBJ1-5
TGCGCCAGCAGCCACAGATGCACAGATACGCAGTATTTT	CASSHRCTDTQYF	TRBV4-3	TRBJ2-3
TGTGCCAGCAGTGACCCCCGCAGGGACAGTCAAGAGACCCAGTACTTC	CASSDPRRDSQETQYF	TRBV2	TRBJ2-5
TGTGCCAGCAGCCCAGACCCTGCACTCTACGAGCAGTACTTC	CASSPDPALYEQYF	TRBV11-2	TRBJ2-7
TGCGCCAGCTCCCGATACGAAGATGAAAAACTGTTTTTT	CASSRYEDEKLFF	TRBV5-1	TRBJ1-4
TGCAGTGCTAGAGCGGGGGCGTTTCCTAACTATGGCTACACCTTC	CSARAGAFPNYGYTF	TRBV20-1	TRBJ1-2
TGTGCCAGCTCACCCCCTAGACGAGAGCAGTTCTTC	CASSPPRREQFF	TRBV18	TRBJ2-1
TGCGCCAGCAGCCAAGAGCGGGGGTGGTACTCCTACGAGCAGTACTTC	CASSQERGWYSYEQYF	TRBV4-1	TRBJ2-7
TGTGCCAGCGGGACTAGCGGATCCTACAATGAGCAGTTCTTC	CASGTSGSYNEQFF	TRBV5-5	TRBJ2-1
TGTGCCAGCAACCAGGGGGGGTGCAATCAGCCCCAGCATTTT	CASNQGGCNQPQHF	TRBV25-1	TRBJ1-5
TGTGCCACCAGTGATTTCCTAAATCGGCGTTATCCGGGTTCTTACTACGAGCAGTACTTC	CATSDFLNRRYPGSYYEQYF	TRBV24-1	TRBJ2-7
TGTGCCAGCAGTGGGAGGGAGGGCCGAGCCGCCAAAAACATTCAGTACTTC	CASSGREGRAAKNIQYF	TRBV25-1	TRBJ2-4
TGTGCCAGCAGTCTCAGGACGATGCGTCCGATCAAGCAAGAGACCCAGTACTTC	CASSLRTMRPIKQETQYF	TRBV11-3	TRBJ2-5
TGTGCCAGCAGCGTAGCCCTGATGCCGTCTGAGACCCAGTACTTC	CASSVALMPSETQYF	TRBV9	TRBJ2-5
TGTGCCAAGTTTCAGGACGTACGCTACGAGCAGTACTTC	CAKFQDVRYEQYF	TRBV30	TRBJ2-7
TGCGCCAGCAGTGGAGGAACCACAGATACGCAGTATTTT	CASSGGTTDTQYF	TRBV10-1	TRBJ2-3
TGTGCCAGCTATACCCTTTTGGACAGGGGAACCTACGAGCAGTACTTC	CASYTLLDRGTYEQYF	TRBV19	TRBJ2-7
TGTGCCAGCAGCCAAGTATGGGACAGGGTTGGGCTCTATGGCTACACCTTC	CASSQVWDRVGLYGYTF	TRBV14	TRBJ1-2
TGTGCCAGCAGCCTCGAGCCCAACTATGGCTACACCTTC	CASSLEPNYGYTF	TRBV7-3	TRBJ1-2
TGCGCCAGCAAGCGGGACCGGAGCTCCTACAATGAGCAGTTCTTC	CASKRDRSSYNEQFF	TRBV10-1	TRBJ2-1
TGTGCCAGCAGCAAGATCGTCCGACGAGGCAATCAGCCCCAGCATTTT	CASSKIVRRGNQPQHF	TRBV11-2	TRBJ1-5
TGTGCCAGCAGACGGGGGCTCTTACAACCCCAAGAGACCCAGTACTTC	CASRRGLLQPQETQYF	TRBV6-3	TRBJ2-5
TGTGCCAGCAGTGCTGGACAGGGCATTAGGGGCGAGCAGTACTTC	CASSAGQGIRGEQYF	TRBV27	TRBJ2-7
TGTGCCAGCACCTACCACGGAATACAGGGAGGGTTAGGAGCCAAAAACATTCAGTACTTC	CASTYHGIQGGLGAKNIQYF	TRBV6-1	TRBJ2-4
TGTGCCATCAGTGAGAAAGGGGGAGTGCGGAGCTACGAGCAGTACTTC	CAISEKGGVRSYEQYF	TRBV10-3	TRBJ2-7
TGTGCCAGCAGTAATAACGGTAGCGACAGGACCCTCCACTTT	CASSNNGSDRTLHF	TRBV6-4	TRBJ1-6
TGTGCCACCAGGGGGGGACTAGTGGTCTACGAGCAGTACTTC	CATRGGLVVYEQYF	TRBV24-1	TRBJ2-7
TGTGCCAGCAGCCAAGGCCCTCCTCCTGGCTACACCTTC	CASSQGPPPGYTF	TRBV14	TRBJ1-2
TGTGCCAGCAGTTACTCAACGCGGGCCTACGAGCAGTACTTC	CASSYSTRAYEQYF	TRBV6-3	TRBJ2-7
TGTGCCAGCTCCCGGGACGCATTTTGCACAGATACGCAGTATTTT	CASSRDAFCTDTQYF	TRBV6-5	TRBJ2-3
TGTGCCAGCAGTCCGGTCCCGCACAGGGCTGAAGCTTTCTTT	CASSPVPHRAEAFF	TRBV6-4	TRBJ1-1
TGTGCTAGTGCCGATGGACTTAGGCTTCACGAGCAGTACTTC	CASADGLRLHEQYF	TRBV12-5	TRBJ2-7
TGTGCCAGCAGCACCAGGGATGAGACCCAGTACTTC	CASSTRDETQYF	TRBV5-6	TRBJ2-5
TGTGCCAGTGGGGCAGGTGGGACAGGGGGTGAGAACACTGAAGCTTTCTTT	CASGAGGTGGENTEAFF	TRBV3-1	TRBJ1-1
TGCAGCGAAGGGTCTGACAGGGGTCTCAATCAGCCCCAGCATTTT	CSEGSDRGLNQPQHF	TRBV29-1	TRBJ1-5
TGTGCCAGCAGCTTTCTAGCGGGGGGAGATACGCAGTATTTT	CASSFLAGGDTQYF	TRBV7-3	TRBJ2-3
TGTGCCACCAGTGATCAACGGGACCTGTATGGCTACACCTTC	CATSDQRDLYGYTF	TRBV24-1	TRBJ1-2
TGCAGTGCTAGAGGACAGGGGAGAAGACGGGGCTACACCTTC	CSARGQGRRRGYTF	TRBV20-1	TRBJ1-2
TGTGCCAGCTCACCCCTAGCTAATCGGGACAGGCGCTCCTACGAGCAGTACTTC	CASSPLANRDRRSYEQYF	TRBV18	TRBJ2-7
TGTGCTAGCAGCTTAGTTAGATGGGGGCGTTATGATGGAAACACCATATATTTT	CASSLVRWGRYDGNTIYF	TRBV7-7	TRBJ1-3
TGTGCCAGCAGCCAAGAGGCCGACATACCAAGCGAGCAGTACTTC	CASSQEADIPSEQYF	TRBV14	TRBJ2-7
TGTGCCAGCAGTTTTCGCAGGTCTGGGAACAATGAGCAGTTCTTC	CASSFRRSGNNEQFF	TRBV12-3	TRBJ2-1
TGTGCCAGCAGCCACGTAGCCAGGGGCCCACTCAATGAGCAGTTCTTC	CASSHVARGPLNEQFF	TRBV4-2	TRBJ2-1
TGTGCCAGCAGCTTACGGGGCCTGGGTCAGCCCCAGCATTTT	CASSLRGLGQPQHF	TRBV7-8	TRBJ1-5
TGTGCCAGCAGCTTAGGGCGTAAGGTATCTGTAAGGACTGAAGCTTTCTTT	CASSLGRKVSVRTEAFF	TRBV7-9	TRBJ1-1
TGTGCCAGCAGCTCCGAACACGTCGGGGAAAAACTGTTTTTT	CASSSEHVGEKLFF	TRBV13	TRBJ1-4
TGTGCCAGCAGCCCCCTGGGGACCTTCGAGCAGTACTTC	CASSPLGTFEQYF	TRBV14	TRBJ2-7
TGTGCCAGCAGCTTTCCAGAAGGGTACGAGCAGTACTTC	CASSFPEGYEQYF	TRBV5-8	TRBJ2-7
TGTGCCAGCAGTTTGATGGCGACCACTGAAGCTTTCTTT	CASSLMATTEAFF	TRBV12-3	TRBJ1-1
TGTGCCAGCAGTAAGGCCAAACGTGACAGGGGAGAAGAGACCCAGTACTTC	CASSKAKRDRGEETQYF	TRBV12-4	TRBJ2-5
TGCGCCAGCAGCCAAGACTCTTCACGGAACACTGAAGCTTTCTTT	CASSQDSSRNTEAFF	TRBV4-3	TRBJ1-1
TGTGCCAGCAGCTTTGGGAGGACTAGCGGGCTCAAGTTTCCGGGTAATGAGCAGTTCTTC	CASSFGRTSGLKFPGNEQFF	TRBV5-5	TRBJ2-1
TGCGCCAGCAGCAAGGCGGGAGGGGGCTACGAGCAGTACTTC	CASSKAGGGYEQYF	TRBV5-1	TRBJ2-7
TGCAGTGCCAAGCCCCCGGGACAATTCACTGAAGCTTTCTTT	CSAKPPGQFTEAFF	TRBV20-1	TRBJ1-1
TGCGCCACTGGGGAGGGTACGTCCTGCACTGAAGCTTTCTTT	CATGEGTSCTEAFF	TRBV5-1	TRBJ1-1
TGCGCCAGGGGACTTAGCTCCTATAATTCACCCCTCCACTTT	CARGLSSYNSPLHF	TRBV5-1	TRBJ1-6
TGTGCCAGCAGTTCCGGACAGGGGGTGCAAGAGACCCAGTACTTC	CASSSGQGVQETQYF	TRBV6-2	TRBJ2-5
TGTGCCAGCAGCGGGACCCTTGAGCAGTTCTTC	CASSGTLEQFF	TRBV13	TRBJ2-1
TGTGCCACCAGTGTGGGACCAGTGACCCAGTACTTC	CATSVGPVTQYF	TRBV24-1	TRBJ2-5
TGTAAAAGAGGGGACGAAAAACTGTTTTTT	CKRGDEKLFF	TRBV19	TRBJ1-4
TGCGCCAGCACGGCCAGGAGGGGCGTCCACTACGAGCAGTACTTC	CASTARRGVHYEQYF	TRBV5-1	TRBJ2-7
TGCAGCGATAAGGAGGCCTACGAGCAGTACTTC	CSDKEAYEQYF	TRBV29-1	TRBJ2-7
TGTGCCAGCAGTCGTTATTTTCAGCCCCAGCATTTT	CASSRYFQPQHF	TRBV27	TRBJ1-5
TGTGCTAGTGGTTTGCCCGGGGGGTTTGCCTACGAGCAGTACTTC	CASGLPGGFAYEQYF	TRBV12-5	TRBJ2-7
TGCGCCAGCAGCTCAGCGGACTACGAGCAGTACTTC	CASSSADYEQYF	TRBV5-1	TRBJ2-7
TGTGCCAGCAGCTTGGGCGCCGCCCGGGGGAACACTGAAGCTTTCTTT	CASSLGAARGNTEAFF	TRBV5-4	TRBJ1-1
TGTGCCAGCTCACCGGCGGGACTGAGGGGGGAGACCCAGTACTTC	CASSPAGLRGETQYF	TRBV18	TRBJ2-5
TGTGCCAGCAGCTTGGAGACCCAGGGAAGTTCACCCCTCCACTTT	CASSLETQGSSPLHF	TRBV5-6	TRBJ1-6
TGTGCCAGCAGGGGGACAGTCAGCCAGCCCCAGCATTTT	CASRGTVSQPQHF	TRBV27	TRBJ1-5
TGTGCCAGCAGTTACTACGATGGCTACACCTTC	CASSYYDGYTF	TRBV6-5	TRBJ1-2
TGTGCCAGCAGTTACGTGAACTCCCGGGCCCTTCAAGACACTGAAGCTTTCTTT	CASSYVNSRALQDTEAFF	TRBV6-6	TRBJ1-1
TGCAGTGCTAACCGTGCGGTGGACAGGGGGCTTACGAACACTGAAGCTTTCTTT	CSANRAVDRGLTNTEAFF	TRBV20-1	TRBJ1-1
TGTGCCAGCAGCTGGGGGGGATATTTGAATGAGCAGTTCTTC	CASSWGGYLNEQFF	TRBV9	TRBJ2-1
TGTGCCAGCAGTTACCTCAGACAGGGCAACTATGGCTACACCTTC	CASSYLRQGNYGYTF	TRBV6-5	TRBJ1-2
TGCGCCAGCAGCTTAATGAGGGCCTTTAGCTCCTACAATGAGCAGTTCTTC	CASSLMRAFSSYNEQFF	TRBV5-1	TRBJ2-1
TGTGCCAGCAGGAGGTCAGGTGACCTGAAAGAAAAACTGTTTTTT	CASRRSGDLKEKLFF	TRBV12-3	TRBJ1-4
TGTGCCAGCAGCTTAGGGGGGGGGACACTAAACACTGAAGCTTTCTTT	CASSLGGGTLNTEAFF	TRBV7-8	TRBJ1-1
TGTGCCAGCAGGACCAGCAGAAAAAACATTCAGTACTTC	CASRTSRKNIQYF	TRBV14	TRBJ2-4
TGTGCCAGCAGTAGTGGGTGGGGGTTTGGGCACTATGGCTACACCTTC	CASSSGWGFGHYGYTF	TRBV28	TRBJ1-2
TGTGCCAGCAGTCATAGGGTAATGGGCTACGAGCAGTACTTC	CASSHRVMGYEQYF	TRBV27	TRBJ2-7
TGCGCCAGCAGCTTGTGGCAGGGGACAGTTGATGGCTACACCTTC	CASSLWQGTVDGYTF	TRBV5-1	TRBJ1-2
TGTGCCACCACCCCGGCGGTTTCAGAGCTTCCCTACGAGCAGTACTTC	CATTPAVSELPYEQYF	TRBV15	TRBJ2-7
TGTGCCAGCATTTACGGGACGATTTTATGCCAGTACAATGAGCAGTTCTTC	CASIYGTILCQYNEQFF	TRBV7-4	TRBJ2-1
TGTGCCAGCAGCTGCCCTAGCGGGAACCACACTGAAGCTTTCTTT	CASSCPSGNHTEAFF	TRBV7-8	TRBJ1-1
TGTGCCAGCGTATTTACAGCGGGAAGGCTGCACGAGCAGTACTTC	CASVFTAGRLHEQYF	TRBV2	TRBJ2-7
TGTGCCAGCAGTTACCGGGGAGGACGGACTGGCTACACCTTC	CASSYRGGRTGYTF	TRBV6-5	TRBJ1-2
TGTGCCAGCAGCGTAGAGACAGGGAACACCGGGGAGCTGTTTTTT	CASSVETGNTGELFF	TRBV9	TRBJ2-2
TGTGCCAGCAGCTTGACGGGTCAGCCCCAGCATTTT	CASSLTGQPQHF	TRBV5-8	TRBJ1-5
TGTGCCAGCAGCCGGAGCCTCACAGGGTCACCCTACGAGCAGTACTTC	CASSRSLTGSPYEQYF	TRBV13	TRBJ2-7
TGTGCCTGGAGGACAGACACTGAAGCTTTCTTT	CAWRTDTEAFF	TRBV30	TRBJ1-1
TGCGCCACGACCAGGGTTATATCTCAAGAGACCCAGTACTTC	CATTRVISQETQYF	TRBV4-1	TRBJ2-5
TGCAGTGCTAGAGTTCGCCTGGGACCGGTCAACTATGGCTACACCTTC	CSARVRLGPVNYGYTF	TRBV20-1	TRBJ1-2
TGTGCCGCAGGCGGGAGCACCTACGAGCAGTACTTC	CAAGGSTYEQYF	TRBV6-1	TRBJ2-7
TGTGCCAGCACGGGGGACGATTCGTTCAAAAACATTCAGTACTTC	CASTGDDSFKNIQYF	TRBV6-5	TRBJ2-4
TGTGCCAGCAGCGTAGCCGGGACTAGGAGCTACAATGAGCAGTTCTTC	CASSVAGTRSYNEQFF	TRBV9	TRBJ2-1
TGTGCCAGCAGTTACGACAGAGAACACAATGAGCAGTTCTTC	CASSYDREHNEQFF	TRBV6-5	TRBJ2-1
TGTGCCAGCAGCATGTGTCAGGGGAGTGGCTACACCTTC	CASSMCQGSGYTF	TRBV7-6	TRBJ1-2
TGTGCCAGCAGGTCCGGTGGACTAGCGGGAGGTAATGAAAAACTGTTTTTT	CASRSGGLAGGNEKLFF	TRBV6-5	TRBJ1-4
TGTGCCAGCAGCGTGGGGGCCGAAGCTTTCTTT	CASSVGAEAFF	TRBV7-4	TRBJ1-1
TGTGCCACCAGTAGGGGCGGTCAGCCCCAGCATTTT	CATSRGGQPQHF	TRBV24-1	TRBJ1-5
TGCGCCAGCAGTGAGTCCCCCGAGACAGGGGGAGGGACCACCTTC	CASSESPETGGGTTF	TRBV10-1	TRBJ1-2
TGCAGTGCTAGTACGTTGCGCGAAGGAGATACGCAGTATTTT	CSASTLREGDTQYF	TRBV20-1	TRBJ2-3
TGTGCCTGGAGTGTTTGTAGGGGACAGGGGGCGAGTGCCAAAAACATTCAGTACTTC	CAWSVCRGQGASAKNIQYF	TRBV30	TRBJ2-4
TGTGCCAGCAGCTTGCATCATAGGGAGCAGTTCTTC	CASSLHHREQFF	TRBV5-5	TRBJ2-1
TGTGCCACCAGTGGGGGGGACCACACCTCCTACGAGCAGTACTTC	CATSGGDHTSYEQYF	TRBV24-1	TRBJ2-7
TGTGCCAGCAGCCCGACAGGCTGTAGTTATGGCTACACCTTC	CASSPTGCSYGYTF	TRBV7-3	TRBJ1-2
TGTGCCAGCAGTTACATACGGGGAGGCGCCTCCTACGAGCAGTACTTC	CASSYIRGGASYEQYF	TRBV6-3	TRBJ2-7
TGTGCCAGCAGCTTACCTTGGAGGGAAATACATGAGCAGTTCTTC	CASSLPWREIHEQFF	TRBV7-9	TRBJ2-1
TGTGCCAGCAGCAAGCCGGGACTTGAGCAGTTCTTC	CASSKPGLEQFF	TRBV5-4	TRBJ2-1
TGTGCCAGCAGCTTAGACCCGGGGACAGGGACTAATACCTACGAGCAGTACTTC	CASSLDPGTGTNTYEQYF	TRBV11-3	TRBJ2-7
TGTGCCAGCATCGGACAGGAGCCAAAACTGTTTTTT	CASIGQEPKLFF	TRBV6-1	TRBJ1-4
TGTGCCAGCAGTTGCGGAGAAATCACTGAAGCTTTCTTT	CASSCGEITEAFF	TRBV6-6	TRBJ1-1
TGTGCCAGCAGCTTGATTGTGGTAGGGGAGACCCAGTACTTC	CASSLIVVGETQYF	TRBV5-6	TRBJ2-5
TGTGCCAGCAGTTTGGATAAAACCCCGGAGGAGGGTTATGTCTATGGCTACACCTTC	CASSLDKTPEEGYVYGYTF	TRBV12-4	TRBJ1-2
TGCAGTGCAGTGGAAAGGGGGTACGAGCAGTACTTC	CSAVERGYEQYF	TRBV20-1	TRBJ2-7
TGCGCCAGTTCGACGGATAACTATGGCTACACCTTC	CASSTDNYGYTF	TRBV5-1	TRBJ1-2
TGTGCCAGCAGCTTGGTGTTGAAAAGCGGCCATTTCTTC	CASSLVLKSGHFF	TRBV5-4	TRBJ2-1
TGTGCCAGCAGTTACCTCCTAGCGGAGGATGAGCAGTTCTTC	CASSYLLAEDEQFF	TRBV6-2	TRBJ2-1
TGTGCCACCCCCACGCCGGGACAGGGGAGGTCCAATCAGCCCCAGCATTTT	CATPTPGQGRSNQPQHF	TRBV12-4	TRBJ1-5
TGTGCCAGCAGCGAGAGTATGTCTGAGGGGCTAGCCAAAAACATTCAGTACTTC	CASSESMSEGLAKNIQYF	TRBV13	TRBJ2-4
TGCGCCAGCAGCCAAGGGTTTTACCCGGGACAGGGACTCGTAATGGAGGGCGGCCGGCAGAATGAGCAGTTCTTC	CASSQGFYPGQGLVMEGGRQNEQFF	TRBV4-1	TRBJ2-1
TGTGCCAGCAGCGCCCACCCCAGACGCACAGATACGCAGTATTTT	CASSAHPRRTDTQYF	TRBV7-9	TRBJ2-3
TGTGCCAGCAGCTTAAGTGGGAGGGCCCTTGGCACAGATACGCAGTATTTT	CASSLSGRALGTDTQYF	TRBV7-3	TRBJ2-3
TGTGCGCCCCTGCAGGGTCAGCCCCAGCATTTT	CAPLQGQPQHF	TRBV11-3	TRBJ1-5
TGTGCCAGCAGCACTATGCCCGGGGTTAAGCCCCAGCATTTT	CASSTMPGVKPQHF	TRBV9	TRBJ1-5
TGTGCCAGCAGCGAGGGCTGCTACGAGCAGTACTTC	CASSEGCYEQYF	TRBV7-4	TRBJ2-7
TGTGCCAGCAAGTCCTACGACAGTCCCAACATTCAGTACTTC	CASKSYDSPNIQYF	TRBV11-2	TRBJ2-4
TGTGCCACCAGATCTGTACGGCCCCCCGTTGAAGCTTTCTTT	CATRSVRPPVEAFF	TRBV24-1	TRBJ1-1
TGTGCCAGCAGTCACGGGGCCTGGAGGGGTAACTTACAGAAGGCCGACACTGAAGCTTTCTTT	CASSHGAWRGNLQKADTEAFF	TRBV6-3	TRBJ1-1
TGTGCCACCAGTGATAGGACAGCGAGGAACACTGAAGCTTTCTTT	CATSDRTARNTEAFF	TRBV24-1	TRBJ1-1
TGTGCCAGCAGCCCCTGGGAGGGACGTAAGTATGGCTACACCTTC	CASSPWEGRKYGYTF	TRBV7-3	TRBJ1-2
TGCGCCAGCAGCTTGGGCCGGACAGGGGAGACCCAGTACTTC	CASSLGRTGETQYF	TRBV5-1	TRBJ2-5
TGTGCCAGCAGCGGCCTTTCGGTTGACAGGGGATCCCATCAGCCCCAGCATTTT	CASSGLSVDRGSHQPQHF	TRBV7-9	TRBJ1-5
TGTGCTAGTGGGTGGCCTAGTTCCCAAGAGACCCAGTACTTC	CASGWPSSQETQYF	TRBV12-5	TRBJ2-5
TGTGCCAGCAGCCAAGATCAAAAACCAGGACTGTCCTACGAGCAGTACTTC	CASSQDQKPGLSYEQYF	TRBV14	TRBJ2-7
TGTGCCAGCAGCTTTTGGTCAGGGGCCCTCGTGAACACTGAAGCTTTCTTT	CASSFWSGALVNTEAFF	TRBV7-3	TRBJ1-1
TGTGCCAGCAGTTTCGGGGGGCCCCTAGATACGCAGTATTTT	CASSFGGPLDTQYF	TRBV27	TRBJ2-3
TGTGCCAGCAGCTCGTTGACAGGGCCCTCGGAAGAATTACCTCTCGAAGAGACCCAGTACTTC	CASSSLTGPSEELPLEETQYF	TRBV5-4	TRBJ2-5
TGCAGTGCTAGAGATTCCCCCCCAATTGCTAGCGGGGACACCGGGGAGCTGTTTTTT	CSARDSPPIASGDTGELFF	TRBV20-1	TRBJ2-2
TGTGCCAGCAGCATTGTTGGCCGGAGATATTCACCCCTCCACTTT	CASSIVGRRYSPLHF	TRBV7-3	TRBJ1-6
TGTGCCAGCAGTTACGACGGACAGGAATCCGAGACCCAGTACTTC	CASSYDGQESETQYF	TRBV6-5	TRBJ2-5
TGTGCCAGCAGTGAAGGTTCTTACACAGATACGCAGTATTTT	CASSEGSYTDTQYF	TRBV25-1	TRBJ2-3
TGTGCCAGCAGTGATCGCACAGCGACTAGCGGGCACGAGACCCAGTACTTC	CASSDRTATSGHETQYF	TRBV6-1	TRBJ2-5
TGTGCCAGTAGATGCGACAGGGCGATCTTC	CASRCDRAIF	TRBV19	TRBJ2-1
TGTGCCAGCAGCTCTCGGGGCAACACTGAAGCTTTCTTT	CASSSRGNTEAFF	TRBV11-3	TRBJ1-1
TGTGCCAGCAGTGTGGGGGAGGGCGACCTCAAAAACATTCAGTACTTC	CASSVGEGDLKNIQYF	TRBV12-3	TRBJ2-4
TGTGCCCGCGGGACTAGCGGTTTATGTGAGACCCAGTACTTC	CARGTSGLCETQYF	TRBV6-5	TRBJ2-5
TGTGCCAGCAGCCGCCCAACAGGGGGGACCCGGCAGTACTTC	CASSRPTGGTRQYF	TRBV11-3	TRBJ2-7
TGTGCTAGTGGTTTGCCGGACAGGGGATACGAGCAGTACTTC	CASGLPDRGYEQYF	TRBV12-5	TRBJ2-7
TGTGCTAGTGGCTGTACAGGGACCTCCTACGAGCAGTACTTC	CASGCTGTSYEQYF	TRBV12-5	TRBJ2-7
TGTGCCAGTAGTATAGGGGTCAGGAGCGGGGCCCAAACAGGCGGTAGCACAGATACGCAGTATTTT	CASSIGVRSGAQTGGSTDTQYF	TRBV19	TRBJ2-3
TGCAGTGCTCAAGGCGGACTAGCGGGTTACCAAGAGACCCAGTACTTC	CSAQGGLAGYQETQYF	TRBV20-1	TRBJ2-5
TGTGCCAGCAGCTTAAAACCTGTGGGGTATGGCTACACCTTC	CASSLKPVGYGYTF	TRBV13	TRBJ1-2
TGTGCCACCAGTGATCTTGGCGGAGAGACCCAGTACTTC	CATSDLGGETQYF	TRBV24-1	TRBJ2-5
TGCAGTGCAAGAACAAATCGACTAACTTCGGAAGAGACCCAGTACTTC	CSARTNRLTSEETQYF	TRBV20-1	TRBJ2-5
TGTGCCAGCAGTTACGGCTCTGAGGGGAACTATGGCTACACCTTC	CASSYGSEGNYGYTF	TRBV6-6	TRBJ1-2
TGTGCCAGCAGCCATCTGATAAATAATTCACCCCTCCACTTT	CASSHLINNSPLHF	TRBV25-1	TRBJ1-6
TGCGCCAGCTACGGACTAGCGGGGTGGATTTCCTACGAGCAGTACTTC	CASYGLAGWISYEQYF	TRBV10-1	TRBJ2-7
TGTGCCAGCAGTATTCGCGGGGATCAGCCCCAGCATTTT	CASSIRGDQPQHF	TRBV6-3	TRBJ1-5
TGCGCCAGCAGAGGACAGTCCCTCCCCAACACTGAAGCTTTCTTT	CASRGQSLPNTEAFF	TRBV5-1	TRBJ1-1
TGCAGCGGACAAGTTGGACACTCTGGAAACACCATATATTTT	CSGQVGHSGNTIYF	TRBV29-1	TRBJ1-3
TGTCCTAGAAGAGGGACAGCGGGGTACGAGCAGTACTTC	CPRRGTAGYEQYF	TRBV10-3	TRBJ2-7
TGTGCCATCAGTGAGTCGACCCTCGGGACTAGCGGGAGTGAGCAGTTCTTC	CAISESTLGTSGSEQFF	TRBV10-3	TRBJ2-1
TGCGCCAGCCGGGACTTCTCTGGAAACACCATATATTTT	CASRDFSGNTIYF	TRBV5-1	TRBJ1-3
TGCGCCAGCAGCGTCCGGAGGAAGGGGAAAGTTTACTCTGGGGCCAACGTCCTGACTTTC	CASSVRRKGKVYSGANVLTF	TRBV5-1	TRBJ2-6
TGTGCCACCAGCAGAGCCGGGACTAGCGGAGGCGAGCAGTTCTTC	CATSRAGTSGGEQFF	TRBV15	TRBJ2-1
TGTGCCAGCAGACCACTAGCGGGAGGTACCGGGGAGCTGTTTTTT	CASRPLAGGTGELFF	TRBV6-5	TRBJ2-2
TGCGCCAGCAGCCCGGGGATCGGAGGGGCCAAAAACATTCAGTACTTC	CASSPGIGGAKNIQYF	TRBV5-1	TRBJ2-4
TGCGCCAGCAGCTCTGGGCAAGAGACCCAGTACTTC	CASSSGQETQYF	TRBV5-1	TRBJ2-5
TGCAGTGCTAGCCGCCAGCGGCCAGAGACCCAGTACTTC	CSASRQRPETQYF	TRBV20-1	TRBJ2-5
TGTGCTAGCAGCTTAGCGTGCCGCCGTCCCCGGGACAAGCACAATGAGCAGTTCTTC	CASSLACRRPRDKHNEQFF	TRBV7-7	TRBJ2-1
TGTGCCAGCAGCTTAGGGGGGGAAAATCAGCCCCAGCATTTT	CASSLGGENQPQHF	TRBV7-2	TRBJ1-5
TGTGCCAGCAGCGGGGAGCGTATGAACACTGAAGCTTTCTTT	CASSGERMNTEAFF	TRBV13	TRBJ1-1
TGTGCCAGCAGTGAATTACCCGGGACTAGCGGGAGCCGCCACTCCTACGAGCAGTACTTC	CASSELPGTSGSRHSYEQYF	TRBV6-4	TRBJ2-7
TGTGCCAGTAGTCCGGGACAGCCGGGGGACACCGGGGAGCTGTTTTTT	CASSPGQPGDTGELFF	TRBV19	TRBJ2-2
TGTGCCAGCAGTGACCTCAAGGACGGAGCCTCTGGGGCCAACGTCCTGACTTTC	CASSDLKDGASGANVLTF	TRBV6-4	TRBJ2-6
TGTGCCAGCAGTAGTCCGGGACAGGGGCCTAGCACAGATACGCAGTATTTT	CASSSPGQGPSTDTQYF	TRBV27	TRBJ2-3
TGTGCCAGCACGGACAGGGTGTGGGTTGGCTACACCTTC	CASTDRVWVGYTF	TRBV7-4	TRBJ1-2
TGTGCTAGTGGTTTGTCCTCAGGGGGCGGGAACGATACGCAGTATTTT	CASGLSSGGGNDTQYF	TRBV12-5	TRBJ2-3
TGTGCGGGACAGGGGGCCTACAATGAGCAGTTCTTC	CAGQGAYNEQFF	TRBV24-1	TRBJ2-1
TGTGCCAGCAGCTTAGCGTTCCGGGACAGGGTAATCCAAGAGACCCAGTACTTC	CASSLAFRDRVIQETQYF	TRBV7-6	TRBJ2-5
TGCAGTGCTAGAGGAGGGAAGCAGGGACTAGCGGGGCAGTACTTC	CSARGGKQGLAGQYF	TRBV20-1	TRBJ2-7
TGCGCCAGCAGCTTGGCGCACTGGACAGTTGGTGGGACTGAAGCTTTCTTT	CASSLAHWTVGGTEAFF	TRBV5-1	TRBJ1-1
TGTGCCAGCAGTGAACTCGGTTTCCCCCGGGAGGGACAGTCCGATTCTCACTATAATTCACCCCTCCACTTT	CASSELGFPREGQSDSHYNSPLHF	TRBV6-1	TRBJ1-6
TGTGCCAGTAGTATCGAGCTCCAAGAGACCCAGTACTTC	CASSIELQETQYF	TRBV19	TRBJ2-5
TGTGCCCCCAGACAGGGGCCCACCGGGGAGCTGTTTTTT	CAPRQGPTGELFF	TRBV30	TRBJ2-2
TGCGCCAGCAGCCAGCTGACACTCTACGAGCAGTACTTC	CASSQLTLYEQYF	TRBV4-1	TRBJ2-7
TGTGCCAGCTCCCTCCGCTGCGGGGATAGATACACTGAAGCTTTCTTT	CASSLRCGDRYTEAFF	TRBV18	TRBJ1-1
TGTGCCAGCAGCTCTAGCGGTCTGCTAGAGACCCAGTACTTC	CASSSSGLLETQYF	TRBV7-2	TRBJ2-5
TGTGCTAGTGGTCCCGGGACAGGGAATGAGCAGTTCTTC	CASGPGTGNEQFF	TRBV12-5	TRBJ2-1
TGTGCCAGCAGCGGTATCGGGGGACCACGGGAAAGGGATACGCAGTATTTT	CASSGIGGPRERDTQYF	TRBV7-3	TRBJ2-3
TGTGCCAGCAGCCAAGATATACACAGGGAGAGGGACACCGGGGAGCTGTTTTTT	CASSQDIHRERDTGELFF	TRBV4-2	TRBJ2-2
TGTGCCAGCAGCGGCCCCTTTTCCCAGCATTTT	CASSGPFSQHF	TRBV5-6	TRBJ1-5
TGTGCCAGCAGCCTTCGAGTCGAGATCTCCTGGGGTCCCACTGAAGCTTTCTTT	CASSLRVEISWGPTEAFF	TRBV5-5	TRBJ1-1
TGTGCCATCAGTGAGTCAAAGAGGGCAGATACGCAGTATTTT	CAISESKRADTQYF	TRBV10-3	TRBJ2-3
TGTGCCACCGAAGGGTCAAGTGAGCAGTTCTTC	CATEGSSEQFF	TRBV10-3	TRBJ2-1
TGTGCCAGCATGGGCGGGGGCCCAAGCCTCCCCTGCTATGGCTACACCTTC	CASMGGGPSLPCYGYTF	TRBV6-2	TRBJ1-2
TGTGCCAGCAGCTTCGGCAGCCATGACGACTACGAGCAGTACTTC	CASSFGSHDDYEQYF	TRBV7-6	TRBJ2-7
TGTGCCAGCAGCCACAGCGGGGAGCTGTTTTTT	CASSHSGELFF	TRBV13	TRBJ2-2
TGCGCCAGCCCCCTGACTGGGGGGCAAGAGACCCAGTACTTC	CASPLTGGQETQYF	TRBV10-1	TRBJ2-5
TGTGCCAGCAGCCAAGTCCGAACAGGGGGGGGCTACAAAAACATTCAGTACTTC	CASSQVRTGGGYKNIQYF	TRBV3-1	TRBJ2-4
TGTGCCACCAGTGATGTTTTATCTATCGGACAGGGGGCCCCAGACACTGAAGCTTTCTTT	CATSDVLSIGQGAPDTEAFF	TRBV24-1	TRBJ1-1
TGCAGTGCGGCAGGGGGCGAAATGCAGTACTTC	CSAAGGEMQYF	TRBV20-1	TRBJ2-7
TGCAGTCGGGAGGGCGAGCAGTACTTC	CSREGEQYF	TRBV20-1	TRBJ2-7
TGTGCCGGTTGCACTTCCCAGGGGCCTGCCTACAATGAGCAGTTCTTC	CAGCTSQGPAYNEQFF	TRBV10-3	TRBJ2-1
TGTGCCAGCAGTGTTGGCGCCGAGCAGTACTTC	CASSVGAEQYF	TRBV6-1	TRBJ2-7
TGTGCCAGCAGTGGGCCCAGGGGTGGGGAGGGGGGCAATCAGCCCCAGCATTTT	CASSGPRGGEGGNQPQHF	TRBV6-4	TRBJ1-5
TGTGCCACCAGTGATTTGGTAAGGGAGCCCCAGCATTTT	CATSDLVREPQHF	TRBV24-1	TRBJ1-5
