TGTGCCAGCAGTTATGGGCAGGAGCCGGACAAAAACATTCAGTACTTC	CASSYGQEPDKNIQYF	TRBV6-2	TRBJ2-4
TGTGCCAGCAGTCGGGTAGACAGGGGTAACGAACTTGAAGCTTTCTTT	CASSRVDRGNELEAFF	TRBV27	TRBJ1-1
TGTGCCAGCAGTCACCAAGGGACAGGGAAAGCTTTCTTT	CASSHQGTGKAFF	TRBV9	TRBJ1-1
TGCGCCAGCAGCTACCTGGGGCTGGGGCTGATGATCGTAGCCAAAAACATTCAGTACTTC	CASSYLGLGLMIVAKNIQYF	TRBV5-1	TRBJ2-4
TGTGCCAGCAGCTGGAGGACCCCGATCTACTCCTACAATGAGCAGTTCTTC	CASSWRTPIYSYNEQFF	TRBV7-2	TRBJ2-1
TGCAGTGCCCCCGGACTAGGAAGTAACTTCTTCTACGAGCAGTACTTC	CSAPGLGSNFFYEQYF	TRBV20-1	TRBJ2-7
TGTGCCAGCAGCGGGTCAGGGCTGTTTTTT	CASSGSGLFF	TRBV9	TRBJ1-4
TGCGCCAGCAGCCGGGGACTAGCGGGGGGTTCCAAAAACATTCAGTACTTC	CASSRGLAGGSKNIQYF	TRBV4-3	TRBJ2-4
TGTGCCAGCAGACAGGAGAGGAGCTATGGCTACACCTTC	CASRQERSYGYTF	TRBV12-3	TRBJ1-2
TGTGCCAGCAGCAGGGACAGGGGGAACCACACTGAAGCTTTCTTT	CASSRDRGNHTEAFF	TRBV5-6	TRBJ1-1
TGCAGCGTTGCAGGGTCTGAAGCTTTCTTT	CSVAGSEAFF	TRBV29-1	TRBJ1-1
TGTGCCTGGATCCGGGACAGCGGGGAGCTGTTTTTT	CAWIRDSGELFF	TRBV30	TRBJ2-2
TGTGCCAGTAAAGACTGTTGGCATGAGCAGTTCTTC	CASKDCWHEQFF	TRBV19	TRBJ2-1
TGTGCTAGTGGAAAGGGGGGGGGCACAGATACGCAGTATTTT	CASGKGGGTDTQYF	TRBV12-5	TRBJ2-3
TGCAGTGCGGCTCCCGTACAGGGGTTTGAGCAGTTCTTC	CSAAPVQGFEQFF	TRBV20-1	TRBJ2-1
TGCAGTGCTAGCCTTGCATACGAGCAGTACTTC	CSASLAYEQYF	TRBV20-1	TRBJ2-7
TGCGCCAGCAGCTCCCCCCGTCAAAACCGAGGGTACGAGCAGTACTTC	CASSSPRQNRGYEQYF	TRBV5-1	TRBJ2-7
TGTGCCAGCAGCTGGACGGACAGGAAGAAGCGGACTGAAGCTTTCTTT	CASSWTDRKKRTEAFF	TRBV13	TRBJ1-1
TGTGCCAGCAGTCTGGGGGGGCCTCTCGATACGCAGTATTTT	CASSLGGPLDTQYF	TRBV12-3	TRBJ2-3
TGTGCCAGCACTCCCCGTAGCGGGAGGTGCACGGCGAACACCGGGGAGCTGTTTTTT	CASTPRSGRCTANTGELFF	TRBV6-1	TRBJ2-2
TGTGCCAGCAGCGGCCCGCCCTCGTATAGCAATCAGCCCCAGCATTTT	CASSGPPSYSNQPQHF	TRBV7-2	TRBJ1-5
TGTGCCAGCAGCTTAGTCGCCGCGCCGGACAGGGTTATTGCCGGGGAGCTGTTTTTT	CASSLVAAPDRVIAGELFF	TRBV7-8	TRBJ2-2
TGCAGTGCTAGAGATTATCAGGCGGTACTTAATGAAAAACTGTTTTTT	CSARDYQAVLNEKLFF	TRBV20-1	TRBJ1-4
TGTGCCAGCGACTCGAATACGCAGTATTTT	CASDSNTQYF	TRBV7-6	TRBJ2-3
TGTGCCAGCAGCTTGGACTACACAGATACGCAGTATTTT	CASSLDYTDTQYF	TRBV7-9	TRBJ2-3
TGTGCCAGCAGTTCTTCCCCGGACGGGTACGAGCAGTACTTC	CASSSSPDGYEQYF	TRBV27	TRBJ2-7
TGTGCCAGCAGTTACTTGGTATCAGATACGCAGTATTTT	CASSYLVSDTQYF	TRBV6-2	TRBJ2-3
TGTGCCAGCAGCTTAGGTGGGGGGGGGGACAAGCCAGATACGCAGTATTTT	CASSLGGGGDKPDTQYF	TRBV7-6	TRBJ2-3
TGCAGTGCTAGAGATGGGGGCCTCGAGCAGTACTTC	CSARDGGLEQYF	TRBV20-1	TRBJ2-7
TGTGCCAGCAGTGCGGGGGATAGCTTC	CASSAGDSF	TRBV27	TRBJ1-2
TGTGCCAGCAGCTTAAACAGACAGGGGATCTTT	CASSLNRQGIF	TRBV11-2	TRBJ1-1
TGTGCCAGCAGTGTTGACGGGACAGGGATCCCCAACACTGAAGCTTTCTTT	CASSVDGTGIPNTEAFF	TRBV6-4	TRBJ1-1
TGTGCCAGCAGCAGTACAGGACTAACAGGCTACGAGCAGTACTTC	CASSSTGLTGYEQYF	TRBV13	TRBJ2-7
TGCAGTGCTACGTATAATTCACCCCTCCACTTT	CSATYNSPLHF	TRBV20-1	TRBJ1-6
TGTGCCATCAGTTTCCGAAAGCCCAGGATTCCTGAAGCTTTCTTT	CAISFRKPRIPEAFF	TRBV10-3	TRBJ1-1
TGTGCCAGCAGCTCAGGTTACTTAACAGGACCGAATTCACCCCTCCACTTT	CASSSGYLTGPNSPLHF	TRBV5-5	TRBJ1-6
TGTGCCAGCAGTTACAACGGCACGCAACCAGGGGTTGAGACCCAGTACTTC	CASSYNGTQPGVETQYF	TRBV6-5	TRBJ2-5
TGTGCCACACCCGGGACTGAGCAGTTCTTC	CATPGTEQFF	TRBV7-6	TRBJ2-1
TGTGCCAGCAGTTCCCCCAAACCAGGCCCTTCCCAGCATTTT	CASSSPKPGPSQHF	TRBV27	TRBJ1-5
TGCGCCAGCAGCTTGAACCCGCGTGGGGGCAACCTATATCACAATGAGCAGTTCTTC	CASSLNPRGGNLYHNEQFF	TRBV5-1	TRBJ2-1
TGTGCCAGCGTTCCCGGGACAGGGGCTAATGAAAAACTGTTTTTT	CASVPGTGANEKLFF	TRBV5-6	TRBJ1-4
TGTGCCAGCAGTTACTTAAACTGTAGCGGGAGCGTCCCGAACACTGAAGCTTTCTTT	CASSYLNCSGSVPNTEAFF	TRBV6-2	TRBJ1-1
TGTGCCAGCTTCACGACTAGCGGGGGGGCTCTGGGGTACCAAGAGACCCAGTACTTC	CASFTTSGGALGYQETQYF	TRBV28	TRBJ2-5
TGTGCCACCAGTGACGGTCGACAGGGAACCGGGGAGCTGTTTTTT	CATSDGRQGTGELFF	TRBV24-1	TRBJ2-2
TGTGCCACCAGCAGAGATCCTGAAAAGAATGGGGATACGCAGTATTTT	CATSRDPEKNGDTQYF	TRBV15	TRBJ2-3
TGTGCCACCAGTGATTTGCCGCGACTAGCGGGTAAGCCCAATGAGCAGTTCTTC	CATSDLPRLAGKPNEQFF	TRBV24-1	TRBJ2-1
TGCGCCAGCGGCGACACCGGGGAGCTGTTTTTT	CASGDTGELFF	TRBV10-1	TRBJ2-2
TGTGCCAGCGCGTTAGCGGGTCTCGAACTCTCCTACAATGAGCAGTTCTTC	CASALAGLELSYNEQFF	TRBV7-3	TRBJ2-1
TGTGCCAGCAGTGACTGGGTAGAGTGGGTCACAGATACGCAGTATTTT	CASSDWVEWVTDTQYF	TRBV2	TRBJ2-3
TGTGCCAGCAGTGAAGCCCTTAGCAGGGGGGTTATGAACACTGAAGCTTTCTTT	CASSEALSRGVMNTEAFF	TRBV6-1	TRBJ1-1
TGTGCCAGCAGCTTGCCCGGACTGCCGGGACATCGCAATCAGCCCCAGCATTTT	CASSLPGLPGHRNQPQHF	TRBV5-6	TRBJ1-5
TGTGCCAGCAGCTTGGCCGGGACTCCCTACGAGCAGTACTTC	CASSLAGTPYEQYF	TRBV5-4	TRBJ2-7
TGTGCCAGCAGTACGAGGACCCAGCCCCAGCATTTT	CASSTRTQPQHF	TRBV27	TRBJ1-5
TGTGCCAGCAGTTACTCGGAAAGGGGCCCGGCCCAGTACTTC	CASSYSERGPAQYF	TRBV6-3	TRBJ2-5
TGTGCCAGCAGGGTACGGGGAAGCTACGAGCAGTACTTC	CASRVRGSYEQYF	TRBV6-5	TRBJ2-7
TGTGCCAGCAGAAAGACAGGGGGCAGCGGGAATGAAAAACTGTTTTTT	CASRKTGGSGNEKLFF	TRBV7-3	TRBJ1-4
TGTGCCAGCAGCAAGGTCCCAGCGGGGGTATCCGGCACTGAAGCTTTCTTT	CASSKVPAGVSGTEAFF	TRBV11-3	TRBJ1-1
TGTGCCAGCAGTGACCGGAAAGACAGGGCGGAGGTCTACGAGCAGTACTTC	CASSDRKDRAEVYEQYF	TRBV2	TRBJ2-7
TGTGCCTGGACCTTGACAGGGCCTGAAGCTTTCTTT	CAWTLTGPEAFF	TRBV30	TRBJ1-1
TGTGCCAGTAGCAAACGGCGAGGGGGGGCTAACGAGCAGTACTTC	CASSKRRGGANEQYF	TRBV19	TRBJ2-7
TGTGCCAGCAGCTTGGACCAGGTAATGTACAATGAGCAGTTCTTC	CASSLDQVMYNEQFF	TRBV7-3	TRBJ2-1
TGTGCCAGTAGTATAGGTAATGGTAAGCTAGACGGAACAGTCGGGCAGTTCTTC	CASSIGNGKLDGTVGQFF	TRBV19	TRBJ2-1
TGCGCCAGCAGCGGGGGGGGGGTCTACAATGAGCAGTTCTTC	CASSGGGVYNEQFF	TRBV5-1	TRBJ2-1
TGTGCCAGCAGCAGCAAGGGACAGGGGAACTATGGCTACACCTTC	CASSSKGQGNYGYTF	TRBV13	TRBJ1-2
TGTGCCAGCAGTGCGCAGGGCGGGGCTGGGGCCAACGTCCTGACTTTC	CASSAQGGAGANVLTF	TRBV6-4	TRBJ2-6
TGTGCCAGCAGTTACCGGGACAGGGGCGCTGAAGCTTTCTTT	CASSYRDRGAEAFF	TRBV6-5	TRBJ1-1
TGTGCCAAATCCATATACGAGCAGTACTTC	CAKSIYEQYF	TRBV27	TRBJ2-7
TGTGCTCCCAGGGAGCCGGGTAACACCGGGGAGCTGTTTTTT	CAPREPGNTGELFF	TRBV12-5	TRBJ2-2
TGTGCTAGCAGCTTAACCCCCAAAGGACCAGATACGCAGTATTTT	CASSLTPKGPDTQYF	TRBV7-7	TRBJ2-3
TGCAGTGCTTACAGGAGGAATGAAAAACTGTTTTTT	CSAYRRNEKLFF	TRBV20-1	TRBJ1-4
TGCGCCAGCAGCCACCTTTCCGGGACAGATACGCAGTATTTT	CASSHLSGTDTQYF	TRBV4-3	TRBJ2-3
TGCAGCGTTGTTTCCGCGGGAACAAAGAAATACAATGAGCAGTTCTTC	CSVVSAGTKKYNEQFF	TRBV29-1	TRBJ2-1
TGTGCCAGCAGCGGACAGAGGGGGACAGGGGAGAACACTGAAGCTTTCTTT	CASSGQRGTGENTEAFF	TRBV13	TRBJ1-1
TGTGCCAGCAGTGGGGCTAGCGGGAGCGGGGAAGAGACCCAGTACTTC	CASSGASGSGEETQYF	TRBV6-4	TRBJ2-5
TGTGCCTTCCCCCGGGGGGGCACCTACAATGAGCAGTTCTTC	CAFPRGGTYNEQFF	TRBV30	TRBJ2-1
TGTGCCAGCTGCTGGCTCCAAGAGACCCAGTACTTC	CASCWLQETQYF	TRBV5-4	TRBJ2-5
TGTGCAAGTGGACGGAAGAACACTGAAGCTTTCTTT	CASGRKNTEAFF	TRBV6-2	TRBJ1-1
TGTGCCATACTATGCGTCCCGAACAGGAGTGGAGCGGCCTCTGGAAACACCATATATTTT	CAILCVPNRSGAASGNTIYF	TRBV10-3	TRBJ1-3
TGTGCCAGCAGTACAGGGAGCTGTAGCTACGAGCAGTACTTC	CASSTGSCSYEQYF	TRBV6-4	TRBJ2-7
TGTGCCAGCAGCGAGGTAAGCTCCTACAATGAGCAGTTCTTC	CASSEVSSYNEQFF	TRBV7-3	TRBJ2-1
TGTGCCAGCAGAAGGCAGGCCTGGACAGAGGGAAAGTCTAACTATGGCTACACCTTC	CASRRQAWTEGKSNYGYTF	TRBV12-4	TRBJ1-2
TGTGCCAGCAGTGGGGGGGACAGCAGGAGAATCTTGGAAACCTACGAGCAGTACTTC	CASSGGDSRRILETYEQYF	TRBV6-4	TRBJ2-7
TGTGCCAGCAGCCTGGACTCTCCAAATGGCTACACCTTC	CASSLDSPNGYTF	TRBV11-3	TRBJ1-2
TGTGCCAGCAGCGGTATCAGGGGGCCTAACTCTGGAAACACCATATATTTT	CASSGIRGPNSGNTIYF	TRBV7-9	TRBJ1-3
TGTGCCAGCAGTACCTGGGACAGAGAGTTCCCTAAATGCTCTGGAAACACCATATATTTT	CASSTWDREFPKCSGNTIYF	TRBV6-5	TRBJ1-3
TGTGCCAGCAGCCAAGATCGTCCCGGGAGAGACGGGGAGCAGTACTTC	CASSQDRPGRDGEQYF	TRBV14	TRBJ2-7
TGTGCCAGCATGAGCCCACGGACCGCTCGGGAAAAACTGTTTTTT	CASMSPRTAREKLFF	TRBV6-4	TRBJ1-4
TGTGCCAGCTTTTTGGGGCAGCCCCAGCATTTT	CASFLGQPQHF	TRBV13	TRBJ1-5
TGTGCCAGCAGTTTACCGAGAGGGGAGCTTGGCTACACCTTC	CASSLPRGELGYTF	TRBV27	TRBJ1-2
TGCGCCAGCAGCAAGAATTCCTCGGACGGGGACTACGAGCAGTACTTC	CASSKNSSDGDYEQYF	TRBV5-1	TRBJ2-7
TGTGCCAGCAGTTACTCTCAGAGCAATCAGCCCCAGCATTTT	CASSYSQSNQPQHF	TRBV6-6	TRBJ1-5
TGTGCCAGCAGCTATGCGACAGGGGGGGGTTGGGGGGTGAACACTGAAGCTTTCTTT	CASSYATGGGWGVNTEAFF	TRBV9	TRBJ1-1
TGTGCCACCAGTGATTGGGTCGTTACGGGGGGTAAACATCAGCCCCAGCATTTT	CATSDWVVTGGKHQPQHF	TRBV24-1	TRBJ1-5
TGTGCCAGCAGCATATCCCCCCTATATGGGGAGACCCAGTACTTC	CASSISPLYGETQYF	TRBV13	TRBJ2-5
TGCGCCAGCAGTCACGGGACAGGGCGGGGCAATGAGCAGTTCTTC	CASSHGTGRGNEQFF	TRBV10-2	TRBJ2-1
TGTGCCAGCAGGGGCGGGGACAGGGATGGGGGCTACACCTTC	CASRGGDRDGGYTF	TRBV7-4	TRBJ1-2
TGTGCCAGCAGTAGAGACAGGGGGAACAACTATGGCTACACCTTC	CASSRDRGNNYGYTF	TRBV6-5	TRBJ1-2
TGTGCCAGCAGCGCCCCCTGTCTTGGGGTTTGGCTTTGTGGAAACACCATATATTTT	CASSAPCLGVWLCGNTIYF	TRBV9	TRBJ1-3
TGTGCCTGGCGGGGTAAGCGAGAGACCCAGTACTTC	CAWRGKRETQYF	TRBV30	TRBJ2-5
TGTGCCAGCAGCTCCGACGGCAGGGTAGAGGGACATGAGCAGTTCTTC	CASSSDGRVEGHEQFF	TRBV11-1	TRBJ2-1
TGTGCCAGCAACCGAACTCACCGGGGACTTCATAGCAATCAGCCCCAGCATTTT	CASNRTHRGLHSNQPQHF	TRBV6-4	TRBJ1-5
TGTGCCAGCAGGGGAGATCAGCCCCAGCATTTT	CASRGDQPQHF	TRBV6-6	TRBJ1-5
TGTGCCAGCAGCTGGACCGGAACTGAAGCTTTCTTT	CASSWTGTEAFF	TRBV7-6	TRBJ1-1
TGTGCCAGCAGTGCGCTCCGACAGACTAGGGTACCCCTCCACTTT	CASSALRQTRVPLHF	TRBV2	TRBJ1-6
TGTGCCAGCAGTGAGGGAGGAAGAGGCTACACCTTC	CASSEGGRGYTF	TRBV25-1	TRBJ1-2
TGCGCCAGCAGCTTGGCTGACCCGGGACTCCTGGGGTACGAGCAGTACTTC	CASSLADPGLLGYEQYF	TRBV5-1	TRBJ2-7
TGTCCCCAGGGCGGACTTCCAGCTGAAGCTTTCTTT	CPQGGLPAEAFF	TRBV7-9	TRBJ1-1
TGTGCCAGCAGCTTAGCGTCGGACAGAAAAAACACTGAAGCTTTCTTT	CASSLASDRKNTEAFF	TRBV7-9	TRBJ1-1
TGTGCCTGGAGTATACTAGTTGAATACGAGCAGTACTTC	CAWSILVEYEQYF	TRBV30	TRBJ2-7
TGCGCCAGCAGGGGCGGTTCACCCCTCCACTTT	CASRGGSPLHF	TRBV10-2	TRBJ1-6
TGTGCCAGCAGACGAGGGAAACACGAGCAGTACTTC	CASRRGKHEQYF	TRBV7-2	TRBJ2-7
TGCGCTGCGTTGGAGGGCTATAGCAATCAGCCCCAGCATTTT	CAALEGYSNQPQHF	TRBV5-1	TRBJ1-5
TGTGCCAGCAGTGAGATGGGGGTACACACCGGGGAGCTGTTTTTT	CASSEMGVHTGELFF	TRBV2	TRBJ2-2
TGCAGTGCTAGAGAAGCGGAGCTCGGGGACACAGATACGCAGTATTTT	CSAREAELGDTDTQYF	TRBV20-1	TRBJ2-3
TGTGCCAGCAGCCCCCAGGAGTCCTATAACACTGAAGCTTTCTTT	CASSPQESYNTEAFF	TRBV13	TRBJ1-1
TGTGCCAGCAAGGGGAGGCGATCCCCAGCCAATCAGCCCCAGCATTTT	CASKGRRSPANQPQHF	TRBV5-5	TRBJ1-5
TGTGCCAGCAGTAATAATGGGTACGAGCAGTACTTC	CASSNNGYEQYF	TRBV6-5	TRBJ2-7
TGCGCCAGCAGCTTGGCCCAGCCTGGTCATGAAAAACTGTTTTTT	CASSLAQPGHEKLFF	TRBV5-1	TRBJ1-4
TGCAGCGTCGGCCCCCCGAGACCAGGTTGTGAAGCTTTCTTT	CSVGPPRPGCEAFF	TRBV29-1	TRBJ1-1
TGTGCCAGCAGCTACGAGGGGGGAGCCAAAAACATTCAGTACTTC	CASSYEGGAKNIQYF	TRBV5-5	TRBJ2-4
TGTGCCAGCAGTGAAACCCGGGAGGGAGTCCTAGCCAAAAACATTCAGTACTTC	CASSETREGVLAKNIQYF	TRBV6-1	TRBJ2-4
TGCAGTGCTCGGACGGCGAGTTGCGCTTTGGGGAGGTCCTACGAGCAGTACTTC	CSARTASCALGRSYEQYF	TRBV20-1	TRBJ2-7
TGTGCCAGCAGCGGCGACAGCCACGTAAACTACGAGCAGTACTTC	CASSGDSHVNYEQYF	TRBV13	TRBJ2-7
TGTGCCAGCAGCCCATCCTGCTTGACGCAAGAGACCCAGTACTTC	CASSPSCLTQETQYF	TRBV7-2	TRBJ2-5
TGTGCCTTCCCCATAGGGTTCGACTGCTACAATGAGCAGTTCTTC	CAFPIGFDCYNEQFF	TRBV25-1	TRBJ2-1
TGTGCCAGCAGCGGTCGGGTCACCATATATTTT	CASSGRVTIYF	TRBV5-4	TRBJ1-3
TGCGCCAGCAGCTCGTGGGGTACGCAGTATTTT	CASSSWGTQYF	TRBV5-1	TRBJ2-3
TGTGCCAGCAGTTGTCGCCGACACTCTAACTATGGCTACACCTTC	CASSCRRHSNYGYTF	TRBV6-1	TRBJ1-2
TGCGCCAGCAGTGGCGGCCCCACGTGTCACACTGAAGCTTTCTTT	CASSGGPTCHTEAFF	TRBV10-1	TRBJ1-1
TGTGCCTGGACCCCCCAGGGTGGGGGGAACACTGAAGCTTTCTTT	CAWTPQGGGNTEAFF	TRBV30	TRBJ1-1
TGTGCCAGCTCACATGCTATCATTCAGTACTTC	CASSHAIIQYF	TRBV18	TRBJ2-4
TGCGCCAGCAGTGAGTCCCGGGGGGGAAAGATGCAGTACTTC	CASSESRGGKMQYF	TRBV10-1	TRBJ2-7
TGTGCCAGCAGCCGGGGACCGTACAATGAGCAGTTCTTC	CASSRGPYNEQFF	TRBV4-2	TRBJ2-1
TGTGCCAGCAGCCAAGATTTGCGAATGAACACTGAAGCTTTCTTT	CASSQDLRMNTEAFF	TRBV3-1	TRBJ1-1
TGTGCCAGCAGCTTCCCGCCGGGACGAAGATCCTATGGCTACACCTTC	CASSFPPGRRSYGYTF	TRBV6-1	TRBJ1-2
TGTGCCAGCAGTTTAGCGGGGGCTAATGAAAAACTGTTTTTT	CASSLAGANEKLFF	TRBV27	TRBJ1-4
TGTGCCAGCAGCAGTGCCCGTAGGTACGAGCAGTACTTC	CASSSARRYEQYF	TRBV9	TRBJ2-7
TGTGCCACCAGCTACCAGAGGAGGAGTGAGCAGTTCTTC	CATSYQRRSEQFF	TRBV15	TRBJ2-1
TGTGCCAGCAGCCTCAGGGGGTACGAGCAGTACTTC	CASSLRGYEQYF	TRBV7-3	TRBJ2-7
TGTGCCAGCACAAGGGACAGAGAAAAACTGTTTTTT	CASTRDREKLFF	TRBV27	TRBJ1-4
TGTGCCAGCAGCGCCTGTCCCGGGACAGATCCGGAAGAGACCCAGTACTTC	CASSACPGTDPEETQYF	TRBV7-3	TRBJ2-5
TGTGCCACCAGTGACCCCCGGGACAGGGTCATTGGATCGGGGACCATATATTTT	CATSDPRDRVIGSGTIYF	TRBV24-1	TRBJ1-3
TGTGCCAGCAGTTGTGTTCCTTGGGGGGGGAGGCAAGAGACCCAGTACTTC	CASSCVPWGGRQETQYF	TRBV6-2	TRBJ2-5
TGTGCCAGCCGACGGTACAGAGATACGCAGTATTTT	CASRRYRDTQYF	TRBV2	TRBJ2-3
TGCAGCGTAACTCGGGAGAAAAGGCAGCGGGAAACCCAGGGCTCTGGAAACACCATATATTTT	CSVTREKRQRETQGSGNTIYF	TRBV29-1	TRBJ1-3
TGTGCCAGCACTAATCATATGCCCCAAACCGACAGGGCGCGGCTCGGTATCCGAGCTTTCTTT	CASTNHMPQTDRARLGIRAFF	TRBV6-8	TRBJ1-1
TGTGCCAGCAGCTTGCGGGAGCTTTCCTACGAGCAGTACTTC	CASSLRELSYEQYF	TRBV7-9	TRBJ2-7
TGCGCCAGCGACACAGGGCCGAAGAGCAATCAGCCCCAGCATTTT	CASDTGPKSNQPQHF	TRBV5-1	TRBJ1-5
TGCGCCAGCAGCTGGGAACCAGTAGCGGGACTAGTACCGGATACGCAGTATTTT	CASSWEPVAGLVPDTQYF	TRBV5-1	TRBJ2-3
TGTGCCAGCAGCGCCGTGACTAGCGGTTTACGGACAGATACGCAGTATTTT	CASSAVTSGLRTDTQYF	TRBV11-3	TRBJ2-3
TGTGCTAGTGGTTTGGTACAGCGGTGCGGGGAGCTGTTTTTT	CASGLVQRCGELFF	TRBV12-5	TRBJ2-2
TGTGCCAGCAGTGGTCCGGGACAGGGTGAAGAGACCCAGTACTTC	CASSGPGQGEETQYF	TRBV6-5	TRBJ2-5
TGTGCCAGCAGTTTCTCTAGGCCCACCGGGACGGACACAGATACGCAGTATTTT	CASSFSRPTGTDTDTQYF	TRBV28	TRBJ2-3
TGTGCCAGCAGCACAAGCCTATTTGAGCAGTTCTTC	CASSTSLFEQFF	TRBV13	TRBJ2-1
TGTGCCAGCAGAAGAAGTATCCCGGGACAGGGAACCAAGTACTTC	CASRRSIPGQGTKYF	TRBV5-6	TRBJ2-7
TGCGCCAGCAGCCCACTACTAGACGAGCAGTACTTC	CASSPLLDEQYF	TRBV4-1	TRBJ2-7
TGCAGCGTTGGAGGCAATGAGCAGTTCTTC	CSVGGNEQFF	TRBV29-1	TRBJ2-1
TGTGCCAGCAGCTGCGGAGGTGAAAAACTGTTTTTT	CASSCGGEKLFF	TRBV13	TRBJ1-4
TGTGCCAGTAGTATAGATTTTCTTCACAGTCGGAACACTGAAGCTTTCTTT	CASSIDFLHSRNTEAFF	TRBV19	TRBJ1-1
TGTGCCAGCAGCGGACCCGGGCCTTTCTTT	CASSGPGPFF	TRBV13	TRBJ1-1
TGTGCCAGCAGCTTAGACCCTACCCGGGGAACGTCCGGGGAGCTGTTTTTT	CASSLDPTRGTSGELFF	TRBV7-8	TRBJ2-2
TGTGCCAGCAGTTTAACCTCCCCCGCAGATACGCAGTATTTT	CASSLTSPADTQYF	TRBV28	TRBJ2-3
TGTGCCACCAGTGATAGACTAGCCTACAATGAGCAGTTCTTC	CATSDRLAYNEQFF	TRBV24-1	TRBJ2-1
TGCGCCAGCAGCCAAGATCAGCGAAGCAAAAACATTCAGTACTTC	CASSQDQRSKNIQYF	TRBV4-3	TRBJ2-4
TGTGCCTGGAGTGTAGTGAGGACTAGCCCGTCCTACGAGCAGTACTTC	CAWSVVRTSPSYEQYF	TRBV30	TRBJ2-7
TGTGCCAGCTCCCTGACGAAGGCTGGGGCCAACGTCCTGACTTTC	CASSLTKAGANVLTF	TRBV6-4	TRBJ2-6
TGTGCTAGTGGTTTGCCAGGGGACAGTTCCTACGAGCAGTACTTC	CASGLPGDSSYEQYF	TRBV12-5	TRBJ2-7
TGTGCCAGCAGCCAACACCCCGAAGGGTCTCATGAGCAGTTCTTC	CASSQHPEGSHEQFF	TRBV4-2	TRBJ2-1
TGTGCCACCGAGCCCTCGACGGACGACGGCTCCTACGAGCAGTACTTC	CATEPSTDDGSYEQYF	TRBV24-1	TRBJ2-7
TGTGCCAGCAGCTTGGCCCTTGGGCAGGAGAGGAGACGCACCGGGGAGCTGTTTTTT	CASSLALGQERRRTGELFF	TRBV5-6	TRBJ2-2
TGTGCCAGCAGCCAAGCGGGGAGGCGTGAATTCTGTGATACGCAGTATTTT	CASSQAGRREFCDTQYF	TRBV4-2	TRBJ2-3
TGTGCCAGTAGTTGTAGACCTGGTTTTTGTCGAAATGAGCAGTTCTTC	CASSCRPGFCRNEQFF	TRBV19	TRBJ2-1
TGTGCCAATCTACAGGGGGCTGGCTACACCTTC	CANLQGAGYTF	TRBV12-3	TRBJ1-2
TGTGCCAGCAGCGGGTGGGGGCGCTACAATGAGCAGTTCTTC	CASSGWGRYNEQFF	TRBV9	TRBJ2-1
TGCAGTGCGCATAAGGGGGGCCAACGCACAGATACGCAGTATTTT	CSAHKGGQRTDTQYF	TRBV20-1	TRBJ2-3
TGTGCCAGCAGTTACATCGGTAATGAAAAACTGTTTTTT	CASSYIGNEKLFF	TRBV6-6	TRBJ1-4
TGTGCCATCATCCTGGGCGGGGCAGGGTATCAGCCCCAGCATTTT	CAIILGGAGYQPQHF	TRBV10-3	TRBJ1-5
TGTGCCACCAGTGATTTTAGGGGGAACCTCTATGGCTACACCTTC	CATSDFRGNLYGYTF	TRBV24-1	TRBJ1-2
TGTGCCAGCAGCTTAGGGACAGGGGGAAGCAATCAGCCCCAGCATTTT	CASSLGTGGSNQPQHF	TRBV7-9	TRBJ1-5
TGTGCCAGCAGCTTAGATGTAGGGGGAAACACTGAAGCTTTCTTT	CASSLDVGGNTEAFF	TRBV7-2	TRBJ1-1
TGTGCCAGCAGCGAAGGAGGACCGAATCAGCCCCAGCATTTT	CASSEGGPNQPQHF	TRBV7-3	TRBJ1-5
TGTGCCAGCAGTTTCAGGGACAGGCCGAACACTGAAGCTTTCTTT	CASSFRDRPNTEAFF	TRBV27	TRBJ1-1
TGTGCCAGCAGCCACGGTAGGAGGGTCTCTGGAAACACCATATATTTT	CASSHGRRVSGNTIYF	TRBV7-3	TRBJ1-3
TGCAGTGCTTACCCTATCGGGGGGGGTCTCTCAACTAATGAAAAACTGTTTTTT	CSAYPIGGGLSTNEKLFF	TRBV20-1	TRBJ1-4
TGCGCCAGCAGCTTCGAAAAAGGGGTGGGGCAGCCCCAGCATTTT	CASSFEKGVGQPQHF	TRBV5-1	TRBJ1-5
TGTGCCAGACGAGGGGGGGCGGCCGGACCAGATACGCAGTATTTT	CARRGGAAGPDTQYF	TRBV19	TRBJ2-3
TGTGCCAGCAGTACCGGGACTAATGAGCAGTTCTTC	CASSTGTNEQFF	TRBV12-4	TRBJ2-1
TGTGCCAGTAGTCAGGGGTACTGGCAGCCCCAGCATTTT	CASSQGYWQPQHF	TRBV19	TRBJ1-5
TGTGCCAGCAGCCAGCGACAGGGATGGGCTGAAGCTTTCTTT	CASSQRQGWAEAFF	TRBV4-2	TRBJ1-1
TGTGCCAGCAGCCGTCGGGGCCCCGGGACACACTCTGGGGCCAACGTCCTGACTTTC	CASSRRGPGTHSGANVLTF	TRBV13	TRBJ2-6
TGTGCCAGCAGCTGTCCCAGAAGAGGCACTGAAGCTTTCTTT	CASSCPRRGTEAFF	TRBV11-2	TRBJ1-1
TGCGCCACGGGAGGCCGAATGAACACTGAAGCTTTCTTT	CATGGRMNTEAFF	TRBV10-2	TRBJ1-1
TGCGCCAGCAGCCATACCGCAGGGGGCGCCAGCACTGAAGCTTTCTTT	CASSHTAGGASTEAFF	TRBV4-1	TRBJ1-1
TGTGCCAGCAGCCACCTAGCGGGGTGGCTCACGCAGTATTTT	CASSHLAGWLTQYF	TRBV13	TRBJ2-3
TGTGCCTGGCTGAACCGGTTAAGTGGGGGTTCTTCCCAAGAGACCCAGTACTTC	CAWLNRLSGGSSQETQYF	TRBV30	TRBJ2-5
TGTGCCATCAGTGAGCCGTCAGGGAACACCGGGGAGCTGTTTTTT	CAISEPSGNTGELFF	TRBV10-3	TRBJ2-2
TGTGCTAGTGCCCCAGGGTACGAGCAGTACTTC	CASAPGYEQYF	TRBV12-5	TRBJ2-7
TGTGCCAGCAGCCATGGACAGGCGGACTATGGCTACACCTTC	CASSHGQADYGYTF	TRBV5-4	TRBJ1-2
TGTGCCAGCAGTTTCGACAGGGGAGGTCCTGAAGCTTTCTTT	CASSFDRGGPEAFF	TRBV27	TRBJ1-1
TGTGCCAGCAGCTCCTGTCCACCGGGACAGCTCGAGCAGTACTTC	CASSSCPPGQLEQYF	TRBV13	TRBJ2-7
TGCGCCAGCAGAAGGTACAAAAACATTCAGTACTTC	CASRRYKNIQYF	TRBV10-1	TRBJ2-4
TGCGCCAGCACTCCCAAAGCGGGAGGCAGGAATCAGCCCCAGCATTTT	CASTPKAGGRNQPQHF	TRBV4-1	TRBJ1-5
TGCAGTGCTGAGTGGTATGATGAGCAGTTCTTC	CSAEWYDEQFF	TRBV20-1	TRBJ2-1
TGTGCCAGCAGCGATCGGGACAGACGCTATGGCTACACCTTC	CASSDRDRRYGYTF	TRBV9	TRBJ1-2
TGCGCCAGCAGCGACGCTAGAATATGTTCTGAAGCTTTCTTT	CASSDARICSEAFF	TRBV5-1	TRBJ1-1
TGTGCCTGGAGTGTCTCTAAAAGAGGGGGCATGGAGAGCTCCTATAATTCACCCCTCCACTTT	CAWSVSKRGGMESSYNSPLHF	TRBV30	TRBJ1-6
TGTGAGGGGGTGAACACTGAAGCTTTCTTT	CEGVNTEAFF	TRBV2	TRBJ1-1
TGTGCCAGCAGTGATCCCGGGACAACGGCTGCCTGCTCTGGGGCCAACGTCCTGACTTTC	CASSDPGTTAACSGANVLTF	TRBV2	TRBJ2-6
TGTGCCAGCAGCGGACTAGCGGGGTTAATTCGGAAAGATACGCAGTATTTT	CASSGLAGLIRKDTQYF	TRBV5-4	TRBJ2-3
TGTGCCAGCAGCACACGACGGGTAGGGGTATGGCGTTATAGCAATCAGCCCCAGCATTTT	CASSTRRVGVWRYSNQPQHF	TRBV13	TRBJ1-5
TGTGCCACCAGTGATGTACGGACCGACGTTCCTGGCTACACCTTC	CATSDVRTDVPGYTF	TRBV24-1	TRBJ1-2
TGCGCCAGCAGTCACCAGAGACATCAGCCCCAGCATTTT	CASSHQRHQPQHF	TRBV5-1	TRBJ1-5
TGTGCCAGCAGCGCGGGGGACAGGACGGAAAAACTGTTTTTT	CASSAGDRTEKLFF	TRBV9	TRBJ1-4
TGTGCCAGCAGTTCTTTCGGGGGCTCCTACGAGCAGTACTTC	CASSSFGGSYEQYF	TRBV7-6	TRBJ2-7
TGTGCCACCAGTGATTTGGCAGGCCGTGGGTGGCACTATGGCTACACCTTC	CATSDLAGRGWHYGYTF	TRBV24-1	TRBJ1-2
TGTGCCAGCTTCACCCTACAGGGACAGCGGTGCTCCTACGAGCAGTACTTC	CASFTLQGQRCSYEQYF	TRBV19	TRBJ2-7
TGTGCCAGCAGTTCAGGGCCCCGGCCCTTCGAGCAGTACTTC	CASSSGPRPFEQYF	TRBV7-3	TRBJ2-7
TGTGCCAGCAGCCGTATAAAGGCTCAAAATTGCTACAGGACCGGGGAGCTGTTTTTT	CASSRIKAQNCYRTGELFF	TRBV7-3	TRBJ2-2
TGTGCCAGCAGCCAAGGTTCGTCCCACGAAGGTGAGCAGTTCTTC	CASSQGSSHEGEQFF	TRBV3-1	TRBJ2-1
TGTGCCAGCAGCTTAGAGGGGGGGGGTGGCGCTTTCTTT	CASSLEGGGGAFF	TRBV7-2	TRBJ1-1
TGCGCCAGCAGCTCTTATCGGGGCCCCCAGCATTTT	CASSSYRGPQHF	TRBV5-1	TRBJ1-5
TGTGCCAGCAGCTTAGACAGCCCCCAAGAGACCCAGTACTTC	CASSLDSPQETQYF	TRBV11-2	TRBJ2-5
TGCGCCAGCAGCCCTTCTAGGACCGTTAGCAATCAGCCCCAGCATTTT	CASSPSRTVSNQPQHF	TRBV4-1	TRBJ1-5
TGTGCCAGCAGAGGGGGTGGGGATCCCGCTTTCTTT	CASRGGGDPAFF	TRBV6-1	TRBJ1-1
TGTGCCAGCAGCGGGCAGAGAAGCTCCTACAATGAGCAGTTCTTC	CASSGQRSSYNEQFF	TRBV9	TRBJ2-1
TGTGCCAGCAGCCAAGTACGGCAGGGCATTAATGCCTACGAGCAGTACTTC	CASSQVRQGINAYEQYF	TRBV3-1	TRBJ2-7
TGTGCCAGCAGGATAGCGGGAGCCTGCATGAACACTGAAGCTTTCTTT	CASRIAGACMNTEAFF	TRBV11-3	TRBJ1-1
TGTGCCAGCACAAGGAAAAAGGCAAATCAGCCCCAGCATTTT	CASTRKKANQPQHF	TRBV9	TRBJ1-5
TGTGCCAGCAGCCAAGCAGGAGGGCCCCTTTACGAGCAGTACTTC	CASSQAGGPLYEQYF	TRBV14	TRBJ2-7
TGTGCCAGCAGCCGGACCCGTCCGGGCGGACAGGGAGGAGAGACCCAGTACTTC	CASSRTRPGGQGGETQYF	TRBV7-3	TRBJ2-5
TGTGCCAGCAGCGTAGGGAATGTCGCGGGGGACAATGAGCAGTTCTTC	CASSVGNVAGDNEQFF	TRBV9	TRBJ2-1
TGCAGTGCTAGAGATCTGGGGGGGAATCAGCCCCAGCATTTT	CSARDLGGNQPQHF	TRBV20-1	TRBJ1-5
TGTGCCAGTAGTATAGATCAGGGGCGCCGGGGGGCCAACGTCCTGACTTTC	CASSIDQGRRGANVLTF	TRBV19	TRBJ2-6
TGTGCCAGCAGCGTACAGGGGGAATTCACTAGCAATCAGCCCCAGCATTTT	CASSVQGEFTSNQPQHF	TRBV13	TRBJ1-5
TGTGCCAGCAGCGCCCGGGGGGTTTTATACGAGCAGTACTTC	CASSARGVLYEQYF	TRBV7-3	TRBJ2-7
TGTGCCAGCAGCTTAGACGTCCCGGGACAGGGTACGGATGAAGCTTTCTTT	CASSLDVPGQGTDEAFF	TRBV11-2	TRBJ1-1
TGTGCGGCCGGGGGGGGGCACGAAATCTCTGGGGCCAACGTCCTGACTTTC	CAAGGGHEISGANVLTF	TRBV6-2	TRBJ2-6
TGTGCCAGCAGATCGGGGGAGCCTCACTATGGCTACACCTTC	CASRSGEPHYGYTF	TRBV6-5	TRBJ1-2
TGCAGTGCTAGAGTCCCCCGGAGACCTTCACCCCTCCACTTT	CSARVPRRPSPLHF	TRBV20-1	TRBJ1-6
TGCGCCAGCAGCCAAGGGGGCAGCCGCAATCAGCCCCAGCATTTT	CASSQGGSRNQPQHF	TRBV4-3	TRBJ1-5
TGTGCCACCAGGGATCAGCCACAGGGGGACCATGGCTACACCTTC	CATRDQPQGDHGYTF	TRBV24-1	TRBJ1-2
TGTGCCAGCTCACCATCGACCAAATTCGGTACCGGGGAGCTGTTTTTT	CASSPSTKFGTGELFF	TRBV18	TRBJ2-2
TGTGCCAGCAGCTGTATTGCCGGGGACAGGGGGCCTGAAGACAACAATCAGCCCCAGCATTTT	CASSCIAGDRGPEDNNQPQHF	TRBV7-9	TRBJ1-5
TGTGCCAGCAGCTTAGCTTGCGGGAGCGATAACACTGAAGCTTTCTTT	CASSLACGSDNTEAFF	TRBV7-4	TRBJ1-1
TGCGCCAGCAGCCGGGGTCCCTCCTACGAGCAGTACTTC	CASSRGPSYEQYF	TRBV4-3	TRBJ2-7
TGTGCCAGCAGTCAGGGGTGGGGAGGCTACACCTTC	CASSQGWGGYTF	TRBV6-2	TRBJ1-2
TGTGCCAGCAGCGCCGGGACTAGCGGCAGGAGCCCTACCGGGGAGCTGTTTTTT	CASSAGTSGRSPTGELFF	TRBV7-3	TRBJ2-2
TGCAGTGCTAGGCAGAGGGGCAGGACAGATACGCAGTATTTT	CSARQRGRTDTQYF	TRBV20-1	TRBJ2-3
TGCGCCAGCAGCTTGAAAGGGGGGCCGCGGAACTATGGCTACACCTTC	CASSLKGGPRNYGYTF	TRBV5-1	TRBJ1-2
TGTGCCAGCAGTTATTACAACTCCAGCTACGAGCAGTACTTC	CASSYYNSSYEQYF	TRBV6-5	TRBJ2-7
TGTGCCAGCAGTTACTCGATAACTATATCCCGAACTAACTATGGCTACACCTTC	CASSYSITISRTNYGYTF	TRBV6-5	TRBJ1-2
TGTGCCAGCAGCTTATTGTTCCGGGCCTATGGAAACACCATATATTTT	CASSLLFRAYGNTIYF	TRBV7-6	TRBJ1-3
TGCAGCGTTGACCCAAGGGGCGCGGCCAATCAGCCCCAGCATTTT	CSVDPRGAANQPQHF	TRBV29-1	TRBJ1-5
TGTGCCAGCCCGGGGGCGACTGGAAACACCATATATTTT	CASPGATGNTIYF	TRBV11-3	TRBJ1-3
TGTGCCAGCACCTCCGGGACAGATGGGGGGGATCAGCCCCAGCATTTT	CASTSGTDGGDQPQHF	TRBV7-9	TRBJ1-5
TGTGCTACCACGAATCGAGAGACCCAGTACTTC	CATTNRETQYF	TRBV12-5	TRBJ2-5
TGTGCCAGCAGTTACCAGACACGACCCCGCTCTGCGGGTGAAAAACTGTTTTTT	CASSYQTRPRSAGEKLFF	TRBV6-2	TRBJ1-4
TGTGCCAGCAGTTTTGCTGCTAGACAGGGTGGGATGAACACTGAAGCTTTCTTT	CASSFAARQGGMNTEAFF	TRBV27	TRBJ1-1
TGTGCCAGCAGCCAATCTCCCCCAGGACAGGGGCGGGGAGCTGAAGCTTTCTTT	CASSQSPPGQGRGAEAFF	TRBV14	TRBJ1-1
TGTGCCAGCAGCCCCCCCCGGGACAGTTTAAAAGATACGCAGTATTTT	CASSPPRDSLKDTQYF	TRBV11-3	TRBJ2-3
TGCAGTGCTAGCAAAAGAGGTAGCAATCAGCCCCAGCATTTT	CSASKRGSNQPQHF	TRBV20-1	TRBJ1-5
TGTGCCAGCTCAGTTGAACGGGACAGAGACGAGCAGTACTTC	CASSVERDRDEQYF	TRBV18	TRBJ2-7
TGTGCCAGCAGGGGCTTTTACAATGAGCAGTTCTTC	CASRGFYNEQFF	TRBV7-3	TRBJ2-1
TGTGCCATCAGTGCATCTAGCGGGGGCACAGATACGCAGTATTTT	CAISASSGGTDTQYF	TRBV10-3	TRBJ2-3
TGTGCCAGCAGCTCCGGGACTAGCGGGGTAGAGACCCAGTACTTC	CASSSGTSGVETQYF	TRBV7-2	TRBJ2-5
TGTGCCAGCAACGGATTCACAGATACGCAGTATTTT	CASNGFTDTQYF	TRBV9	TRBJ2-3
TGTGCCAATGGACTAGTCTCCTACAATGAGCAGTTCTTC	CANGLVSYNEQFF	TRBV2	TRBJ2-1
TGTGCCAGCAGTTATTCACACAGGGGTAGGAGCTCCTACAATGAGCAGTTCTTC	CASSYSHRGRSSYNEQFF	TRBV6-9	TRBJ2-1
TGTGCCAGCAGCCAAGCGGGGGCTTACACCGGGGAGCTGTTTTTT	CASSQAGAYTGELFF	TRBV4-2	TRBJ2-2
TGTGCCAGCAGTGAAGCGCTGGGAGTCTATTGCTACGAGCAGTACTTC	CASSEALGVYCYEQYF	TRBV6-1	TRBJ2-7
TGCGCCAGCAGCCCGGGGAGGGTTGCTAAGAATGAGCAGTTCTTC	CASSPGRVAKNEQFF	TRBV4-1	TRBJ2-1
TGTGCCAGTAGTGTACCGTCCCGCCATGAGCAGTTCTTC	CASSVPSRHEQFF	TRBV19	TRBJ2-1
TGTGCCAGCAGCGTAGGCTACGAGCAGTACTTC	CASSVGYEQYF	TRBV7-3	TRBJ2-7
TGTGCCAGCAGCAAGGGAGGGGGGACTGACAATGAGCAGTTCTTC	CASSKGGGTDNEQFF	TRBV13	TRBJ2-1
TGTGCCTGGAGTGTCACCAGTTTTTGCAATCAGCCCCAGCATTTT	CAWSVTSFCNQPQHF	TRBV30	TRBJ1-5
TGTGCCATCAGTGAGAGCAGGGGTAGCTACGAGCAGTACTTC	CAISESRGSYEQYF	TRBV10-3	TRBJ2-7
TGTGCCAGCAGCCCTCCAACAGGGACAAATCAGCCCCAGCATTTT	CASSPPTGTNQPQHF	TRBV11-3	TRBJ1-5
TGCGCCAGCAGCCACCGGGGAACGAACACCGGGGAGCTGTTTTTT	CASSHRGTNTGELFF	TRBV4-1	TRBJ2-2
TGTGCCAGCAGCCTAGCGGGGAGCTCCTACGAGCAGTACTTC	CASSLAGSSYEQYF	TRBV6-3	TRBJ2-7
TGTGCCAGCAGCTTGAAACAGCTACTCCAGGGGGAGTACTCTCTAAGGCATCAGCCCCAGCATTTT	CASSLKQLLQGEYSLRHQPQHF	TRBV5-6	TRBJ1-5
TGTGCCAGCAGCGGACAGGGGTACAATGAGCAGTTCTTC	CASSGQGYNEQFF	TRBV13	TRBJ2-1
TGTGCCACCAGTGCTCAAGGGTATGAGCAGTTCTTC	CATSAQGYEQFF	TRBV24-1	TRBJ2-1
TGCGCCAGCAGTGAGTCGTCCAAACGCAGCTTACACATTCAGTACTTC	CASSESSKRSLHIQYF	TRBV10-1	TRBJ2-4
TGCGCCACTCCTTGGGACAGTAGTAATGAAAAACTGTTTTTT	CATPWDSSNEKLFF	TRBV4-3	TRBJ1-4
TGTGCCAGCAGCCAACGGGCCAGTACTATCACAGATACGCAGTATTTT	CASSQRASTITDTQYF	TRBV3-1	TRBJ2-3
TGTGCCAGCAGTTCCCCCGGGACAGGGGAAGCAGTTAATAATTCACCCCTCCACTTT	CASSSPGTGEAVNNSPLHF	TRBV6-2	TRBJ1-6
TGTGCCAGCAGCGCACTAGCGGGAGGGCGCAGCACAGATACGCAGTATTTT	CASSALAGGRSTDTQYF	TRBV13	TRBJ2-3
TGTGCCAGCAGTCGGGGGGACATGACTGAAGCTTTCTTT	CASSRGDMTEAFF	TRBV12-4	TRBJ1-1
TGTGCCGTGGTACCGGGACTAGTCGGGGTCCAGGGTGAGCAGTTCTTC	CAVVPGLVGVQGEQFF	TRBV24-1	TRBJ2-1
TGTGCCACCAGTGATTTCTCGACCACTAGCGGGATTGTAGATACGCAGTATTTT	CATSDFSTTSGIVDTQYF	TRBV24-1	TRBJ2-3
TGTGCCAGCAGCTGTTCCGGGGAGAGCTCCTACAATGAGCAGTTCTTC	CASSCSGESSYNEQFF	TRBV5-4	TRBJ2-1
TGTGCCAGCAGTTTAGCTTGGAGGGGGCGATTTCTAGACTACGAGCAGTACTTC	CASSLAWRGRFLDYEQYF	TRBV12-3	TRBJ2-7
TGTGCCAGCAGCTTCCAGGAGCAGTACTTC	CASSFQEQYF	TRBV7-9	TRBJ2-7
TGTGCCAACCCCGGGACAGGGTACTTC	CANPGTGYF	TRBV27	TRBJ2-4
TGTGCCAGCACCTACCAAGAGACCCAGTACTTC	CASTYQETQYF	TRBV25-1	TRBJ2-5
TGTGCCAGCAGCGTATGCAGCGAATGTAGAGATACGCAGTATTTT	CASSVCSECRDTQYF	TRBV9	TRBJ2-3
TGCGCCAGCAGCTGCTCTGGCCAGGCAACTAATGAAAAACTGTTTTTT	CASSCSGQATNEKLFF	TRBV5-1	TRBJ1-4
TGTGCCAGCAGCTTAGTTGAGGTCCCCCGTAACAGGGAGGCCGAGCAGTACTTC	CASSLVEVPRNREAEQYF	TRBV7-2	TRBJ2-7
TGTGCCAGCAGTGACTCGACCGGGACAAGGCGAACTGAAGCTTTCTTT	CASSDSTGTRRTEAFF	TRBV6-4	TRBJ1-1
TGTGCCAGCTCACCAAACCGGCCCCGGGCGAGGTACTTC	CASSPNRPRARYF	TRBV18	TRBJ2-5
TGTGCCAGCCAGGGGGAGTCACCCCTCCACTTT	CASQGESPLHF	TRBV6-5	TRBJ1-6
TGTGCCAGCAGTTACGGCTCCTCTAATAATGAGCAGTTCTTC	CASSYGSSNNEQFF	TRBV6-6	TRBJ2-1
TGTGCCACCAGCAGAGCCGAAGTAGGGGTCGAAAAACTGTTTTTT	CATSRAEVGVEKLFF	TRBV15	TRBJ1-4
TGTGCCAGCAGCTTAGTCAAGACAGGTGAAGCTTTCTTT	CASSLVKTGEAFF	TRBV7-9	TRBJ1-1
TGTGCCGAAGGGACGGGGTTTGGAAACACCATATATTTT	CAEGTGFGNTIYF	TRBV7-6	TRBJ1-3
TGTGCCAGCAGCGACCGGTTCCGGCCAATCCGCTACGAGCAGTACTTC	CASSDRFRPIRYEQYF	TRBV11-3	TRBJ2-7
TGCGCCAGCAGACGAGAGACTAGCGGCCCGCTGAGACACGAGCAGTACTTC	CASRRETSGPLRHEQYF	TRBV5-1	TRBJ2-7
TGTGCCAGCTTGGTAGGCTCCACAGATACGCAGTATTTT	CASLVGSTDTQYF	TRBV27	TRBJ2-3
TGTGCCAGCCCCCGCCGGGACAGGTCGCCTGAAGCTTTCTTT	CASPRRDRSPEAFF	TRBV27	TRBJ1-1
TGTGCCAGCAGCTTTCTCCATCGGTGTCAGCCCCAGCATTTT	CASSFLHRCQPQHF	TRBV7-9	TRBJ1-5
TGCGCCAGCAGCCAAGGAGCCTGCCCCAAGGCTCACATGAGGTGGTCCTATGGCTACACCTTC	CASSQGACPKAHMRWSYGYTF	TRBV4-1	TRBJ1-2
TGTGCCAGCAGCCTCCGGGGGGGCCTCGAGAGTTTCGGCTACGAGCAGTACTTC	CASSLRGGLESFGYEQYF	TRBV27	TRBJ2-7
TGTGCCACTTCCGATGACATGGGGTCCTGTCACCGGGGAAACACCATATATTTT	CATSDDMGSCHRGNTIYF	TRBV12-4	TRBJ1-3
TGTGCCAGCAGCTTGCTCCGGGACAGGGGTGAAGAGACCCAGTACTTC	CASSLLRDRGEETQYF	TRBV7-9	TRBJ2-5
TGTGCCAGCTCACCAGGGACTAGCGGGGTTTACAATGAGCAGTTCTTC	CASSPGTSGVYNEQFF	TRBV18	TRBJ2-1
TGCGCCAGCCGGGAGGGCACTGAAGCTTTCTTT	CASREGTEAFF	TRBV10-1	TRBJ1-1
TGTGCCAGCAGCTTGTCCGGGACTAGCGGGAGGGGGAATGAGCAGTTCTTC	CASSLSGTSGRGNEQFF	TRBV11-3	TRBJ2-1
TGTGCCATAAGGGGTGGCTCTGGGGCCAACGTCCTGACTTTC	CAIRGGSGANVLTF	TRBV5-6	TRBJ2-6
TGTGCCAGTTTTTCTCTAAGGGGGCGTGCCGAAAAACTGTTTTTT	CASFSLRGRAEKLFF	TRBV6-1	TRBJ1-4
TGTGCCAGCAGCCAAGACATTCATGGCTACACCTTC	CASSQDIHGYTF	TRBV3-1	TRBJ1-2
TGTGCCAGTAGTGAAACACATAGAAACATTCAGTACTTC	CASSETHRNIQYF	TRBV19	TRBJ2-4
TGTGCCAGCAGCGATAGCGGGACTTTACATGAGCAGTTCTTC	CASSDSGTLHEQFF	TRBV11-3	TRBJ2-1
TGTGCTAGTGGTAGGAAAGGATGGGGGTCGATACACCGATTTGAGCAGTTCTTC	CASGRKGWGSIHRFEQFF	TRBV12-5	TRBJ2-1
TGTGCCAGCAGTTTTAGGCTCGACTCAAATGAGCAGTTCTTC	CASSFRLDSNEQFF	TRBV27	TRBJ2-1
TGCGCCAGCAGTCCTTCCTACAATGAGCAGTTCTTC	CASSPSYNEQFF	TRBV10-1	TRBJ2-1
TGTGCCAGCTCACCTCCGAGGGGGGGCTTGGTAGGTGAGGGCTACGAGCAGTACTTC	CASSPPRGGLVGEGYEQYF	TRBV18	TRBJ2-7
TGCAGTGCTAGGATCCGGTGCCAGCGGCCCTCTCTAACTGAGCAGTTCTTC	CSARIRCQRPSLTEQFF	TRBV20-1	TRBJ2-1
TGTGCCAGCAGCTTACCCCGTGCGGGACAGCGGGACACTGAAGCTTTCTTT	CASSLPRAGQRDTEAFF	TRBV7-7	TRBJ1-1
TGTGCCAGCTCACCCCGGCCTACAGATACGCAGTATTTT	CASSPRPTDTQYF	TRBV18	TRBJ2-3
TGTGCCAGCAGCCTTTCACAGGGCAGGATGAACACTGAAGCTTTCTTT	CASSLSQGRMNTEAFF	TRBV13	TRBJ1-1
TGCGCCAGCACGGGACAGAGCTCCTACAATGAGCAGTTCTTC	CASTGQSSYNEQFF	TRBV10-1	TRBJ2-1
TGTGCCAGCAGCTTCCGGGGGGGAGACACCGGGGAGCTGTTTTTT	CASSFRGGDTGELFF	TRBV7-2	TRBJ2-2
TGCGCCAGCAGCTTAACAGGCTTCCACTATGGCTACACCTTC	CASSLTGFHYGYTF	TRBV5-1	TRBJ1-2
TGTGCCAGCAGTGTTACGTTTACTGAAGCTTTCTTT	CASSVTFTEAFF	TRBV27	TRBJ1-1
TGTGCCACCAGTGATCTAGACGAAGGAAGAAGAACCTACGAGCAGTACTTC	CATSDLDEGRRTYEQYF	TRBV24-1	TRBJ2-7
TGTGCCAGCAGCTCACCACGACCCTACGACACCTTC	CASSSPRPYDTF	TRBV13	TRBJ1-2
TGTGCCAGCAGTGAGAAGGGGGAACGCAATCAGCCCCAGCATTTT	CASSEKGERNQPQHF	TRBV25-1	TRBJ1-5
TGTGCCAGCAGCCCCCGCCGGGAGGGGGGCATGAACACTGAAGCTTTCTTT	CASSPRREGGMNTEAFF	TRBV9	TRBJ1-1
TGTGCCAGCAGCCCTTCGGGCCAGCCCCTCAGGGACGAGCAGTACTTC	CASSPSGQPLRDEQYF	TRBV9	TRBJ2-7
TGTGCCAGCAGCGTAGACTGTAAACTGTTTTTT	CASSVDCKLFF	TRBV9	TRBJ1-4
TGTGCCAGCAGCCAAGATGAACTAGCGGGAGCGGACGAGCAGTACTTC	CASSQDELAGADEQYF	TRBV14	TRBJ2-7
TGTGCCAGCAGGTTTAGGGTGGGAACAGGGGGCTACACCTTC	CASRFRVGTGGYTF	TRBV6-3	TRBJ1-2
TGTGCCAGTAGTCTACCAGATCTACAGATGTTGACCTACGAGCAGTACTTC	CASSLPDLQMLTYEQYF	TRBV19	TRBJ2-7
TGCGCCAGCAGCCGGGGGTCTCGGCCTGGAAACACCATATATTTT	CASSRGSRPGNTIYF	TRBV4-1	TRBJ1-3
TGTGCCGGGGGCCCGGTGATCTCTGGAAACACCATATATTTT	CAGGPVISGNTIYF	TRBV6-5	TRBJ1-3
TGTGCCAGCAGGTCAGGGGCGGGCAATGAGCAGTTCTTC	CASRSGAGNEQFF	TRBV6-4	TRBJ2-1
TGTGCCAGCAGTAGCGTGGGGCGTCCATGTGCAACTAATGAAAAACTGTTTTTT	CASSSVGRPCATNEKLFF	TRBV6-5	TRBJ1-4
TGTGCCAGCAGCTTAGATCGACTGGGCCCAAGTGAAGAGACCCAGTACTTC	CASSLDRLGPSEETQYF	TRBV11-3	TRBJ2-5
TGTGCCAGCAGCTTGTTTCTTCAGGGGCCAGGGAACACTGAAGCTTTCTTT	CASSLFLQGPGNTEAFF	TRBV5-6	TRBJ1-1
TGTGCCAGCAGCAAGTCTCTCCACAGGGGGACATATCAGCCCCAGCATTTT	CASSKSLHRGTYQPQHF	TRBV13	TRBJ1-5
TGTGCCAGCAGCCAAGATTTCCGGGGGCGTCCAGCGACATACACTGAAGCTTTCTTT	CASSQDFRGRPATYTEAFF	TRBV14	TRBJ1-1
TGCGCCAGCACAGGGGAGGCCCCCAATGAGCAGTTCTTC	CASTGEAPNEQFF	TRBV10-1	TRBJ2-1
TGCAGTGCTAGACTCCCCGCCTGGGGAACCTACAATGAGCAGTTCTTC	CSARLPAWGTYNEQFF	TRBV20-1	TRBJ2-1
TGTGCCAGCAGTTCCCGCGAGGCTCGCCTAGTGCCTGAAGCTTTCTTT	CASSSREARLVPEAFF	TRBV6-1	TRBJ1-1
TGCAGTGCTAGAGGGCTTCTCTGGACTAGCGGAGTGATCCGATTGGCCTACGAGCAGTACTTC	CSARGLLWTSGVIRLAYEQYF	TRBV20-1	TRBJ2-7
TGCGCCAGCAGCTTGGGGGGCGGAGAACTGTACGAGCAGTACTTC	CASSLGGGELYEQYF	TRBV5-1	TRBJ2-7
TGTGCCAGCAGCTCCTATGGTAGTGATGGCTACACCTTC	CASSSYGSDGYTF	TRBV13	TRBJ1-2
TGTGCCAGCTCACCACTTCCCAGGCGGCGTCCTCGCAATCAGCCCCAGCATTTT	CASSPLPRRRPRNQPQHF	TRBV18	TRBJ1-5
TGTGCCAGCAGTTACTATTCCGAAAGGACAGAGTGGGGGGGCTCTGGGGCCAACGTCCTGACTTTC	CASSYYSERTEWGGSGANVLTF	TRBV6-5	TRBJ2-6
TGCAGTGCGGCGACAGGGCCCCAAGAGACCCAGTACTTC	CSAATGPQETQYF	TRBV20-1	TRBJ2-5
TGTGCCAGCAGCTTAGACGGGGGGGGCGCCTACGAGCAGTACTTC	CASSLDGGGAYEQYF	TRBV7-8	TRBJ2-7
TGTGCCAGCAGTTTCCCACAGTACCGCAATGAGCAGTTCTTC	CASSFPQYRNEQFF	TRBV28	TRBJ2-1
TGCGCCAGCAGCAGAGATCGCCCCAGGGGGCCCCCCTCTGGGGCCAACGTCCTGACTTTC	CASSRDRPRGPPSGANVLTF	TRBV5-1	TRBJ2-6
TGTGCCAGGCCCCGGGACGGGGCCTATGGCTACACCTTC	CARPRDGAYGYTF	TRBV6-4	TRBJ1-2
TGCGCCAGCAGCTATACGAATGAGCAGTTCTTC	CASSYTNEQFF	TRBV5-1	TRBJ2-1
TGTGCCAGCAGCTTTACCGGGACTAGCGGCGACGAGCAGTACTTC	CASSFTGTSGDEQYF	TRBV7-3	TRBJ2-7
TGTGCCAGCAGCTTACCCCTTCTGGCTACAGATACGCAGTATTTT	CASSLPLLATDTQYF	TRBV7-2	TRBJ2-3
TGTGCCAGCAGTTCATCGTCCCCGGGAGGGGAGGGGGAAGGAAACGAGCAGTACTTC	CASSSSSPGGEGEGNEQYF	TRBV12-4	TRBJ2-7
TGTGCCAGCAGCCAAGACGGCGGCTACAATGAGCAGTTCTTC	CASSQDGGYNEQFF	TRBV14	TRBJ2-1
TGTGCCACCAGTGATTTAGAGCCGGGACAGTACAATGAGCAGTTCTTC	CATSDLEPGQYNEQFF	TRBV24-1	TRBJ2-1
TGTGCCAGCAGTGAGCCCGGGCCACTAGCGGGAGAGGCCACTAATTCACCCCTCCACTTT	CASSEPGPLAGEATNSPLHF	TRBV25-1	TRBJ1-6
TGTGCCCTTGACGGCCCAGGCTACACCTTC	CALDGPGYTF	TRBV9	TRBJ1-2
TGTGCCAGCAGAACATCTGGACTAGCGGTGTTCTTCTCCTACGAGCAGTACTTC	CASRTSGLAVFFSYEQYF	TRBV6-5	TRBJ2-7
TGCAGTGCTGATACTAGAGCTAGCACAGATACGCAGTATTTT	CSADTRASTDTQYF	TRBV20-1	TRBJ2-3
TGTGCCTGGATCAGGGCTGGCACTGAAGCTTTCTTT	CAWIRAGTEAFF	TRBV30	TRBJ1-1
TGCGCCACCCATTGGGCCTCGGAATTCGTAGGAGAGACCCAGTACTTC	CATHWASEFVGETQYF	TRBV5-1	TRBJ2-5
TGTGCCAGCGGCTACCCACTGAGGTACGAGCAGTACTTC	CASGYPLRYEQYF	TRBV6-2	TRBJ2-7
TGTGCCAGCAGCGACAGGGGGACTCCCTCTAGAACCTACAATGAGCAGTTCTTC	CASSDRGTPSRTYNEQFF	TRBV7-9	TRBJ2-1
TGTGCCAGCACCCGTGGGGGACGTATGAACACTGAAGCTTTCTTT	CASTRGGRMNTEAFF	TRBV6-6	TRBJ1-1
TGTGCCAGCTTCATAGCTGGCAATGAGCAGTTCTTC	CASFIAGNEQFF	TRBV6-6	TRBJ2-1
TGTGCCAGCAGCGGGGCCAGGGCCCGCTACGAGCAGTACTTC	CASSGARARYEQYF	TRBV6-4	TRBJ2-7
TGTGCCTGTTCCCCCGGGACTAGCGGGCAGTATTTT	CACSPGTSGQYF	TRBV30	TRBJ2-3
TGCAGTGCTTCCTGGGGACAGGGACCCAACTATGGCTACACCTTC	CSASWGQGPNYGYTF	TRBV20-1	TRBJ1-2
TGTGCCAGCAGCCTACCCCATACAGGGTACGAGCAGTACTTC	CASSLPHTGYEQYF	TRBV9	TRBJ2-7
TGTGCCATCAGTGTGCCCCACAGGGTCAGTTGGCGAAGACCTGATAATTCACCCCTCCACTTT	CAISVPHRVSWRRPDNSPLHF	TRBV10-3	TRBJ1-6
TGTGCCAGCAGCAGATCCCCCCGACGGCTGAACACTGAAGCTTTCTTT	CASSRSPRRLNTEAFF	TRBV7-3	TRBJ1-1
TGCGCCAGCAGCCAAATTTCCCAGGGCGACCGGACAGAGACCCAGTACTTC	CASSQISQGDRTETQYF	TRBV4-3	TRBJ2-5
TGTGCCAGCAGTACAAAGCCTGAGGGGCAATACAATGAGCAGTTCTTC	CASSTKPEGQYNEQFF	TRBV6-1	TRBJ2-1
TGTGCCGGCCGGTCTAGCGGGCCAGTCCAGTACTTC	CAGRSSGPVQYF	TRBV30	TRBJ2-5
TGTGCCAGCAGTGGGAGTAAAGGGGGAACGGTGCCCCAGCATTTT	CASSGSKGGTVPQHF	TRBV12-4	TRBJ1-5
TGTGCCAGCAGTCCCCGCAGGGGAGCAAATGAGCAGTTCTTC	CASSPRRGANEQFF	TRBV25-1	TRBJ2-1
TGTGCCAGCATTCGCACTAGCGGGTACAATGAGCAGTTCTTC	CASIRTSGYNEQFF	TRBV9	TRBJ2-1
TGCAGTGCTAGAGTTTTCCCCAGGGGCAATCAGCCCCAGCATTTT	CSARVFPRGNQPQHF	TRBV20-1	TRBJ1-5
TGCGCCAGCAGCATACAGTCAGCTTTCTTT	CASSIQSAFF	TRBV5-1	TRBJ1-1
TGTGCCAGCACCCCCGCCAACAGGGGGCGGGGCGGGAGCTATGGCTACACCTTC	CASTPANRGRGGSYGYTF	TRBV27	TRBJ1-2
TGTGCCAGCAGCTTCCCGACTAGCGGGGGTGAGCAGTACTTC	CASSFPTSGGEQYF	TRBV5-6	TRBJ2-7
TGTGCCAGCAGCCCCTCCGAGAACAGGGGTGTTGATGGCTACACCTTC	CASSPSENRGVDGYTF	TRBV11-3	TRBJ1-2
TGTGCCAGCAGCGTTGGCTCAACAATGAACACTGAAGCTTTCTTT	CASSVGSTMNTEAFF	TRBV13	TRBJ1-1
TGTGCCAGCAGTAGCCCACTCCCCGAGGACGGCAAAAACATTCAGTACTTC	CASSSPLPEDGKNIQYF	TRBV25-1	TRBJ2-4
TGCGCCAGCAAACTCCCCGAGGGGTGGATGATAAACCGTAGAGATACGCAGTATTTT	CASKLPEGWMINRRDTQYF	TRBV5-1	TRBJ2-3
TGTGCCACGGGACAGGTGTCAGCCAAAAACATTCAGTACTTC	CATGQVSAKNIQYF	TRBV5-4	TRBJ2-4
TGCGCCACGGAAGGGAGGGCTGGCTACACCTTC	CATEGRAGYTF	TRBV5-1	TRBJ1-2
TGTGCCAGCAGCCCCCATCGGAGGTCTCACACCAGGTACTTC	CASSPHRRSHTRYF	TRBV9	TRBJ2-5
TGTGCCAGCAGTTCTCTTCGGGGGCCCTGGCTCGTCTCTGGAAACACCATATATTTT	CASSSLRGPWLVSGNTIYF	TRBV12-4	TRBJ1-3
TGTGCCAGCAGCTTGAACGACAGGGGTGGTGAAAAACTGTTTTTT	CASSLNDRGGEKLFF	TRBV5-6	TRBJ1-4
TGTGCCAGCAGTTTAACAGCGGGACAGGGGGCATTAGAGATGAACACTGAAGCTTTCTTT	CASSLTAGQGALEMNTEAFF	TRBV28	TRBJ1-1
TGTGCCAGCAGTTTATACGCCGGGACAGGGACGTACGTGGACTATGGCTACACCTTC	CASSLYAGTGTYVDYGYTF	TRBV27	TRBJ1-2
TGTGCCACCAAGGGGGGCGGGTCCGGGGAGCTGTTTTTT	CATKGGGSGELFF	TRBV27	TRBJ2-2
TGTGCCACCAGTGATTTGCAACGAGGGGAGAGACCTTTCTTT	CATSDLQRGERPFF	TRBV24-1	TRBJ1-1
TGTGCCAGCAGCTCCCATCCCCCCGATGGGGGCCCCTCCTACAATGAGCAGTTCTTC	CASSSHPPDGGPSYNEQFF	TRBV13	TRBJ2-1
TGTGCCAGCAGCCAGAGTTCTAAAGGGGGGACTGAAGCTTTCTTT	CASSQSSKGGTEAFF	TRBV7-9	TRBJ1-1
TGTGCCAGCAGTTTCAGATCGGGTCTTGGCTACACCTTC	CASSFRSGLGYTF	TRBV12-3	TRBJ1-2
TGTGCTCTTGCCAAACTAGCGGGAGTAACCTTCGAGCAGTACTTC	CALAKLAGVTFEQYF	TRBV6-5	TRBJ2-7
TGTGCCAGCAGCTTACGCGACGGGGGGGGAAACCCACTTCGGGCCAGCTCCTATAATTCACCCCTCCACTTT	CASSLRDGGGNPLRASSYNSPLHF	TRBV7-4	TRBJ1-6
TGTGCCAGCAGGCCGGATTTCGCAAGCGGGAGCGAAGCAGATACGCAGTATTTT	CASRPDFASGSEADTQYF	TRBV2	TRBJ2-3
TGTGCCAGTAGTATACCACAGGGTATGGGGGCAGATACGCAGTATTTT	CASSIPQGMGADTQYF	TRBV19	TRBJ2-3
TGTGCCAGCAGTTACTCGACGGACACGCAGGGTGAAGCTTTCTTT	CASSYSTDTQGEAFF	TRBV6-5	TRBJ1-1
TGCGCCAGCAGTGAGCGGACAGAGACCCAGTACTTC	CASSERTETQYF	TRBV10-1	TRBJ2-5
TGTGCCAGCAGTTTAATGCAGCCCTCCTACGAGCAGTACTTC	CASSLMQPSYEQYF	TRBV27	TRBJ2-7
TGTGCCACTTACGTTTTGGAGACCCAGTACTTC	CATYVLETQYF	TRBV19	TRBJ2-5
TGCGCCAGCAGTGAACGGGGGAAGTCAGATACGCAGTATTTT	CASSERGKSDTQYF	TRBV10-2	TRBJ2-3
TGTGCCAGCAGCTTGGTTCGGGGAAGCTATGGCTACACCTTC	CASSLVRGSYGYTF	TRBV5-5	TRBJ1-2
TGTGCCAGAGCCAGTGATACGCAGTATTTT	CARASDTQYF	TRBV9	TRBJ2-3
TGTGCCACCAGTGATTTGACGACGGAGGGCACCGGGGAGCTGTTTTTT	CATSDLTTEGTGELFF	TRBV24-1	TRBJ2-2
TGTGCCAGCAGCGGGGGCTGGAACGGCTACACCTTC	CASSGGWNGYTF	TRBV13	TRBJ1-2
TGTGCCAGCAGTGAAGCGCTATTAACCGGGGGCCGACCAGTTAGCGAGCAGTACTTC	CASSEALLTGGRPVSEQYF	TRBV6-1	TRBJ2-7
TGTGCTAGTGGTCAATTACAGGGTTACGAGCAGTACTTC	CASGQLQGYEQYF	TRBV12-5	TRBJ2-7
TGTGCCAGCAGGCGTGGGCGCTACGAGCAGTACTTC	CASRRGRYEQYF	TRBV12-4	TRBJ2-7
TGTGCCAGCATCCCTACCGGGCACTATGGCTACACCTTC	CASIPTGHYGYTF	TRBV6-5	TRBJ1-2
TGTGCCAGTAGAGCTGGGCGGGAGGACAATCAGCCCCAGCATTTT	CASRAGREDNQPQHF	TRBV19	TRBJ1-5
TGTGCCATCAGTGAGTCGTTTAGTGCCGCCCCGACAGGGGGCAGTCGGCCACCTCATTCACCCCTCCACTTT	CAISESFSAAPTGGSRPPHSPLHF	TRBV10-3	TRBJ1-6
TGTGCCAGCAGCTTTAGGACTAGCGGGGAGCAGTTCTTC	CASSFRTSGEQFF	TRBV5-6	TRBJ2-1
TGCAGTGCTAGCGTAGGGAGGGGGAGCAATCAGCCCCAGCATTTT	CSASVGRGSNQPQHF	TRBV20-1	TRBJ1-5
TGTGCCAGCAGCTTAGATCGAGAAAAAGCCAGGGTGGATAATCAGCCCCAGCATTTT	CASSLDREKARVDNQPQHF	TRBV11-2	TRBJ1-5
TGTGCCAGCAGCCAAACCCGGGACTGGGATACGCAGTATTTT	CASSQTRDWDTQYF	TRBV4-2	TRBJ2-3
TGCGCCAGCCCCGGGGGCAATCAGCCCCAGCATTTT	CASPGGNQPQHF	TRBV10-1	TRBJ1-5
TGTGCCAGCAGCTTAGGGGCCGGGGAGCTGTTTTTT	CASSLGAGELFF	TRBV11-2	TRBJ2-2
TGTGCCTGGAAAGGGGGGCCACCCTATTATACGCAGTATTTT	CAWKGGPPYYTQYF	TRBV30	TRBJ2-3
TGTGCCCAGCAGGAAGGCTACACCTTC	CAQQEGYTF	TRBV9	TRBJ1-2
TGCAGCGTTGAAGGGACTAGCGGGGGCATCTCCGAGCAGTACTTC	CSVEGTSGGISEQYF	TRBV29-1	TRBJ2-7
TGTGCCAGCACAAAGGGGGCGCATGGCTACACCTTC	CASTKGAHGYTF	TRBV28	TRBJ1-2
TGTGCCATCAGTCCGGAGTTAGCCGATCAGCCCCAGCATTTT	CAISPELADQPQHF	TRBV10-3	TRBJ1-5
TGTGCCAGCAGAGACCCGGGGTATGAGCAGTTCTTC	CASRDPGYEQFF	TRBV27	TRBJ2-1
TGTGCCAGCAGCTTCCCGGAGACAGACTTC	CASSFPETDF	TRBV5-4	TRBJ2-7
TGCGCCAGCAGTGAGCGGGATATACTCGCAGATACGCAGTATTTT	CASSERDILADTQYF	TRBV10-1	TRBJ2-3
TGCGCCAGCAGCCCGGCTCAAGGGGAGGGAGCCTACGAGCAGTACTTC	CASSPAQGEGAYEQYF	TRBV4-1	TRBJ2-7
TGCAGTGCTAGAGAAGCTAGGTGGCAAGGACAGGGGTCTGGGGGAAACACCATATATTTT	CSAREARWQGQGSGGNTIYF	TRBV20-1	TRBJ1-3
TGCGCCAGCAGTGCTTCACATGGGACGGATGATGAGCAGTTCTTC	CASSASHGTDDEQFF	TRBV10-1	TRBJ2-1
TGTGCCAGCATTGGCCTAGAGGGAACTCCTGAGCAGTTCTTC	CASIGLEGTPEQFF	TRBV27	TRBJ2-1
TGTGCCAGCAGTTACAAAACAAGTTCAGATACGCAGTATTTT	CASSYKTSSDTQYF	TRBV6-2	TRBJ2-3
TGCGCCAGCAGACAAGGACAGGGGCTAAACAGTCTTAAGCTGGGCTACGAGCAGTACTTC	CASRQGQGLNSLKLGYEQYF	TRBV10-2	TRBJ2-7
TGTGCCAGCAGCCAAGATAGAGGGACAGGGGATCAGCCCCAGCATTTT	CASSQDRGTGDQPQHF	TRBV14	TRBJ1-5
TGTGCCAGCAGTTGGGCAGAACTGCCTGAAAAACTGTTTTTT	CASSWAELPEKLFF	TRBV27	TRBJ1-4
TGCGCCAGCAGCAATAGATTGGGCCCGGGGTCCAAAAACATTCAGTACTTC	CASSNRLGPGSKNIQYF	TRBV5-1	TRBJ2-4
TGTGCCAGCAGTAGCTTCAGGGCCAGAAAACATTCACCCCTCCACTTT	CASSSFRARKHSPLHF	TRBV28	TRBJ1-6
TGTGCCAGCAGCCAAGCCTTCGCGGCTGACACTGAAGCTTTCTTT	CASSQAFAADTEAFF	TRBV14	TRBJ1-1
TGTGCCAGCTCCCACAGGGAAACGTTGGAGTGCTCTGGAAACACCATATATTTT	CASSHRETLECSGNTIYF	TRBV28	TRBJ1-3
TGCGCCAGCAGCTTGCATGGGGGGCCCCTAAGCACCGGGGAGCTGTTTTTT	CASSLHGGPLSTGELFF	TRBV5-1	TRBJ2-2
TGTGCCGTAAGGGCTAGGACCCTATATAGCAATCAGCCCCAGCATTTT	CAVRARTLYSNQPQHF	TRBV28	TRBJ1-5
TGTGCCAGCAGCTTGCTTAGACAGCCCAGCAATGAGCAGTTCTTC	CASSLLRQPSNEQFF	TRBV7-3	TRBJ2-1
TGTGCCAGCAGCTTAGCAGTCAGGACACGGGCCTACGAGCAGTACTTC	CASSLAVRTRAYEQYF	TRBV7-6	TRBJ2-7
TGTGCCAGGGGAGGGGGCCTGCGGAACACTGAAGCTTTCTTT	CARGGGLRNTEAFF	TRBV6-4	TRBJ1-1
TGCGCCAGCAGCCCCAGGGATAGACTCTCCTACGAGCAGTACTTC	CASSPRDRLSYEQYF	TRBV5-1	TRBJ2-7
TGTGCCAGCAGCCCTTATGGCTACACCTTC	CASSPYGYTF	TRBV7-3	TRBJ1-2
TGTGCCAGCACCCGGTTACCCCAGGGGTCTTTTGAGCAGTACTTC	CASTRLPQGSFEQYF	TRBV13	TRBJ2-7
TGCAGTGCTAGAGATCTAAGTAGCGGCGAACTCTACAATGAGCAGTTCTTC	CSARDLSSGELYNEQFF	TRBV20-1	TRBJ2-1
TGTGCCATCAGTGAGTCATCAGGGTCGGGATCCTACGAGCAGTACTTC	CAISESSGSGSYEQYF	TRBV10-3	TRBJ2-7
TGTGCCAGCACGGTCGGGACAGGGTTTCGGCCGACCGGTTACGAGCAGTACTTC	CASTVGTGFRPTGYEQYF	TRBV27	TRBJ2-7
TGTGCCAGCAGCTTGTGTCCCTTAGACAGGTATGGCTACACCTTC	CASSLCPLDRYGYTF	TRBV5-6	TRBJ1-2
TGTGCCAGCAGCTCATGGAGCAGGACAGGGAATCAGCCCCAGCATTTT	CASSSWSRTGNQPQHF	TRBV7-3	TRBJ1-5
TGCGCCAGCAGTGAGGCCCTCCCTTGGGATTGGATATGGGTACGGATTTGTAATGAGCAGTTCTTC	CASSEALPWDWIWVRICNEQFF	TRBV10-1	TRBJ2-1
TGTGCCAGCAGCCAAGTTCCCGCGGAGTACTTC	CASSQVPAEYF	TRBV4-2	TRBJ2-5
TGCGCCAGCATGACTTTAGGCCCTACAATACTCTTC	CASMTLGPTILF	TRBV10-1	TRBJ2-1
TGTGCCAGCAAACATATAGGAGTAACAGTTCAAGGGCTTGAGACCCAGTACTTC	CASKHIGVTVQGLETQYF	TRBV6-1	TRBJ2-5
TGCGCCAGCAGCCAAGAGTTGGAAGAGACCCAGTACTTC	CASSQELEETQYF	TRBV4-1	TRBJ2-5
TGTGCCAGCAGCCTTCTCATGGACAGGGTTCAGCCCCAGCATTTT	CASSLLMDRVQPQHF	TRBV3-1	TRBJ1-5
TGTGCCATCCTCTCGGAGGGGGGGGCCCGGCCTTCGGGTTTGGAGCTGTTTTTT	CAILSEGGARPSGLELFF	TRBV10-3	TRBJ2-2
TGTGCCAGCAGCCCTAATAGGGGGGGCCCCTACGAGCAGTACTTC	CASSPNRGGPYEQYF	TRBV13	TRBJ2-7
TGTGCCAGCAGCCCGAGAGGCTCATACAATGAGCAGTTCTTC	CASSPRGSYNEQFF	TRBV13	TRBJ2-1
TGCGCCAGCAGCCCGACAGGGTTGAGGTGGGTGAACACTGAAGCTTTCTTT	CASSPTGLRWVNTEAFF	TRBV4-3	TRBJ1-1
TGTGCCAGCAGCCCTACGGCGAACACCGGGGAGCTGTTTTTT	CASSPTANTGELFF	TRBV5-8	TRBJ2-2
TGCGCCAGCAGCCAGGCAGGGCCGGGGGATCAGCCCCAGCATTTT	CASSQAGPGDQPQHF	TRBV4-1	TRBJ1-5
TGCAGTGCTCCTACAGGGTATGGCTACACCTTC	CSAPTGYGYTF	TRBV20-1	TRBJ1-2
TGTGCCAGCAGAGGGGACCGTCCGGTGTCCCCCTACGAGCAGTACTTC	CASRGDRPVSPYEQYF	TRBV9	TRBJ2-7
TGTGCCAGCAGCGCCCGGGGGGTCGGCTATTCACCCCTCCACTTT	CASSARGVGYSPLHF	TRBV27	TRBJ1-6
TGTGCCAGCAGCTTAGGGCGCAGGGGGCAGGTCTACGAGCAGTACTTC	CASSLGRRGQVYEQYF	TRBV11-3	TRBJ2-7
TGCGCCAGCAGTGTCACTGACAACTACGAGCAGTACTTC	CASSVTDNYEQYF	TRBV10-2	TRBJ2-7
TGTGCCAGCAGCGATTTCTCGGACAGTTGCTCAACTAATGAAAAACTGTTTTTT	CASSDFSDSCSTNEKLFF	TRBV9	TRBJ1-4
TGTGCCACCAGTGCGGGGGACGAGCAGTACTTC	CATSAGDEQYF	TRBV24-1	TRBJ2-7
TGCAGCGTTGAAATTTTACGACTAGGAGATCTTTACAATGAGCAGTTCTTC	CSVEILRLGDLYNEQFF	TRBV29-1	TRBJ2-1
TGTGCCAGCAGTGACCGTGACAAGGAGTTAGTCTACGAGCAGTACTTC	CASSDRDKELVYEQYF	TRBV6-1	TRBJ2-7
TGTGCCAGCAGGAAAGGGAGGCAGTTCGAGCAGTACTTC	CASRKGRQFEQYF	TRBV5-6	TRBJ2-7
TGTGCCAGCAGTTTAAAATTCCCCAGGGTAAATAATTCACCCCTCCACTTT	CASSLKFPRVNNSPLHF	TRBV12-3	TRBJ1-6
TGCAGCGGGAAAAACAGGGGGACTGTACGCTATGGCTACACCTTC	CSGKNRGTVRYGYTF	TRBV29-1	TRBJ1-2
TGTGCCAGCAGCGGGACTTCTGGCTACACCTTC	CASSGTSGYTF	TRBV6-3	TRBJ1-2
TGCAGTGCTAGGTTAGTGGGTAAGGGAAGCTCCTACGAGCAGTACTTC	CSARLVGKGSSYEQYF	TRBV20-1	TRBJ2-7
TGCGCCAGCAGTACTATCCCTCAGGGGCGGTGGGGAGGAAACACCATATATTTT	CASSTIPQGRWGGNTIYF	TRBV5-1	TRBJ1-3
TGCGCCAGCCTCCGCCCCAGCCCGAGCGAAAAACTGTTTTTT	CASLRPSPSEKLFF	TRBV10-1	TRBJ1-4
TGCAGTGCTAGAGATCAGGGGCGGGTGGGGAAACTGTTTTTT	CSARDQGRVGKLFF	TRBV20-1	TRBJ1-4
TGTGCCAGCAGCTTGCAGGGGCACGGGGAGCTGTTTTTT	CASSLQGHGELFF	TRBV5-6	TRBJ2-2
TGTGCCAGCAGCTTCACACCGGGACGAATTAGGGGGGAGACCCAGTACTTC	CASSFTPGRIRGETQYF	TRBV7-9	TRBJ2-5
TGTGCCAGTAGTCCGACAGATACTACGAACACTGAAGCTTTCTTT	CASSPTDTTNTEAFF	TRBV19	TRBJ1-1
TGTGCCAGCAGACGTCCCAGGGTTTTGAGGTTAAAGTACTTC	CASRRPRVLRLKYF	TRBV2	TRBJ2-7
TGTGCCAGCAGTCAACTGAATTGGGACAGGGACACTGAAGCTTTCTTT	CASSQLNWDRDTEAFF	TRBV25-1	TRBJ1-1
TGTGCCAGCAGCCCCCGGCAGGGGCTCTACGAGCAGTACTTC	CASSPRQGLYEQYF	TRBV7-9	TRBJ2-7
TGTGCCAGTATGGGCCTCGAGACCCAGTACTTC	CASMGLETQYF	TRBV2	TRBJ2-5
TGTGCCACCAGTTGGACAGGGAATCTTGACACTGAAGCTTTCTTT	CATSWTGNLDTEAFF	TRBV24-1	TRBJ1-1
TGCAGTGCACCAATGGACAGGGCGGTATGGGAGCAGTACTTC	CSAPMDRAVWEQYF	TRBV20-1	TRBJ2-7
TGCGCCAGCAGCCACCCAGGGGTCCGTAGAGGAGGGGACTCCTACGAGCAGTACTTC	CASSHPGVRRGGDSYEQYF	TRBV4-1	TRBJ2-7
TGCAGTGCACTGAGAGCGCAAGAGACCCAGTACTTC	CSALRAQETQYF	TRBV20-1	TRBJ2-5
TGCGCCAGCAGCGGACTAGCGGGGGGCAATGAGCAGTTCTTC	CASSGLAGGNEQFF	TRBV5-1	TRBJ2-1
TGCGCCAGCAGTGAGTCGCTCTCAGTGGGTGAAGCTTTCTTT	CASSESLSVGEAFF	TRBV10-1	TRBJ1-1
TGTGCCAGTAGCCGGGGCCGTGTATACAATGAGCAGTTCTTC	CASSRGRVYNEQFF	TRBV19	TRBJ2-1
TGTGCCACCAGTGATTGGGGGACAGGGGCAACTAATGAAAAACTGTTTTTT	CATSDWGTGATNEKLFF	TRBV24-1	TRBJ1-4
TGTGCCACCAGGCATGAGAAACCGGGACAGGGGTCACCCTCTGAGACCCAGTACTTC	CATRHEKPGQGSPSETQYF	TRBV24-1	TRBJ2-5
TGTGCCAGCAGCCTGGGGGGCTACAATGAGCAGTTCTTC	CASSLGGYNEQFF	TRBV5-4	TRBJ2-1
TGCAGTGCTAGCCACGGGAGGTCCAATGAGCAGTTCTTC	CSASHGRSNEQFF	TRBV20-1	TRBJ2-1
TGCGCCAGCAGTGGGGGGGACAGGGGGCGAGAAGAGACCCAGTACTTC	CASSGGDRGREETQYF	TRBV10-1	TRBJ2-5
TGTGCCAGCAGCCTAAAGAGACTGCTCCGGGGCGCCTACGAGCAGTACTTC	CASSLKRLLRGAYEQYF	TRBV7-3	TRBJ2-7
TGTGCCAGCATTTATGGCAGAGGGACAGCAGTTAGAGGAGAGTACTTC	CASIYGRGTAVRGEYF	TRBV6-5	TRBJ2-7
TGTGCCTCTTGGACGAAGAACACCATATATTTT	CASWTKNTIYF	TRBV27	TRBJ1-3
TGTGCCAGCAGTTGGCTTCAAATGTCGAACACCGGGGAGCTGTTTTTT	CASSWLQMSNTGELFF	TRBV27	TRBJ2-2
TGTGCCAGCAGCGGTGGGGCGGGGGCCGGAGGTAACTATGGCTACACCTTC	CASSGGAGAGGNYGYTF	TRBV9	TRBJ1-2
TGTGCCAGCAGTGAGAACTACACTGAAGCTTTCTTT	CASSENYTEAFF	TRBV27	TRBJ1-1
TGTGCCAGCAGTTGGGGAAACTATAATTCACCCCTCCACTTT	CASSWGNYNSPLHF	TRBV6-5	TRBJ1-6
TGCAGCGTAGACAGGGGAGATGAGACCCAGTACTTC	CSVDRGDETQYF	TRBV29-1	TRBJ2-5
TGTGGATGGGATGAGCAGTTCTTC	CGWDEQFF	TRBV12-3	TRBJ2-1
TGCAGTGCGTGCCTGACAGGGTACCCGGCTGAAGCTTTCTTT	CSACLTGYPAEAFF	TRBV20-1	TRBJ1-1
TGTGCCAGCACAAGGCCAGGAAGCTCTGGAAACACCATATATTTT	CASTRPGSSGNTIYF	TRBV19	TRBJ1-3
TGTGCCAGCAGCTTACGGGACGAGACCCAGTACTTC	CASSLRDETQYF	TRBV5-5	TRBJ2-5
TGTGCCAGCAGCTTTCGCGACGGGCACCATACCTGCACCTTC	CASSFRDGHHTCTF	TRBV11-3	TRBJ1-2
TGTGCCAGCAGTGATACGACAGAGTTATGCAGGACTGAAGCTTTCTTT	CASSDTTELCRTEAFF	TRBV2	TRBJ1-1
TGTGCCAGCTCACCGAAGGGCGAATGCAATCAGCCCCAGCATTTT	CASSPKGECNQPQHF	TRBV18	TRBJ1-5
TGTGCCAACCGGGGTGCTGAAGCTTTCTTT	CANRGAEAFF	TRBV6-6	TRBJ1-1
TGTGCCGACAGGCCCTGGTCCAGCTCCTATAATTCACCCCTCCACTTT	CADRPWSSSYNSPLHF	TRBV19	TRBJ1-6
TGTGCCAGCAGTTGTCGGGTTGGGGGTCTCTCAGAGCAGTACTTC	CASSCRVGGLSEQYF	TRBV28	TRBJ2-7
TGTGCCAGCAGTGAAAGCTTCCAGCCCCAGCATTTT	CASSESFQPQHF	TRBV6-4	TRBJ1-5
TGTGCCAGCAGTTTGGTTGGGACCCTCATTTTAGAGACCCAGTACTTC	CASSLVGTLILETQYF	TRBV28	TRBJ2-5
TGTGCCAGCAGAAAGCGGACGGAAGTTAACGATACGCAGTATTTT	CASRKRTEVNDTQYF	TRBV6-1	TRBJ2-3
TGTGCCAGCTGGGTTAGGGGCCGCAATCAGCCCCAGCATTTT	CASWVRGRNQPQHF	TRBV27	TRBJ1-5
TGTGCCAGCAGCCACCAGAAAAACATTCAGTACTTC	CASSHQKNIQYF	TRBV4-2	TRBJ2-4
TGCAGTGCTAGAGACAGAAATGCGGGGGGGGGTATCGACTATGGCTACACCTTC	CSARDRNAGGGIDYGYTF	TRBV20-1	TRBJ1-2
TGTGCCAGCAGCGTGGATCCCTCGAGGTATGAGCAGTTCTTC	CASSVDPSRYEQFF	TRBV9	TRBJ2-1
TGTGCCAGCAGGAGGGGACCAGGGAAGGAGAGGAGCTCTGGAAACACCATATATTTT	CASRRGPGKERSSGNTIYF	TRBV6-4	TRBJ1-3
TGTGCCAGCAGCCAAGATGAGAAGTCCGCCGGGACAGGGTTTACTGGGGCCAACGTCCTGACTTTC	CASSQDEKSAGTGFTGANVLTF	TRBV4-2	TRBJ2-6
TGCAGTGCTAGAGATCCACAGGAAGAGAATGGCTACACCTTC	CSARDPQEENGYTF	TRBV20-1	TRBJ1-2
TGTGCCAGCAGCCAACAGATGAACACTGAAGCTTTCTTT	CASSQQMNTEAFF	TRBV3-1	TRBJ1-1
TGCGCCAGCAGTTGGGGGACTAGCGGGAACACCGGGGAGCTGTTTTTT	CASSWGTSGNTGELFF	TRBV10-1	TRBJ2-2
TGCAGCGTGACCCAGTCCCGGGGTGACGAGCAGTACTTC	CSVTQSRGDEQYF	TRBV29-1	TRBJ2-7
TGTGCCAGCAGCGTAAATATAGGAAACACCATATATTTT	CASSVNIGNTIYF	TRBV11-2	TRBJ1-3
TGTGCCAGCAGGAGACAGGCCTATGGCTACACCTTC	CASRRQAYGYTF	TRBV2	TRBJ1-2
TGTGCCAGCAGCTTAGTTCTCTTGGCCTACGAGCAGTACTTC	CASSLVLLAYEQYF	TRBV7-2	TRBJ2-7
TGTGCCAGCAGCGGACCCGGAGGCTTTGATACGCAGTATTTT	CASSGPGGFDTQYF	TRBV6-5	TRBJ2-3
TGTGCCAGCAGACGCGGGACCTACTACGAGCAGTACTTC	CASRRGTYYEQYF	TRBV6-4	TRBJ2-7
TGCGCCAGCTCCCTGCGACAGGGGAGAGCTAACTATGGCTACACCTTC	CASSLRQGRANYGYTF	TRBV10-1	TRBJ1-2
TGCGCCAGCAGCTTCGTTGGGCTTCCCGGGACAGAACAAGAGACCCAGTACTTC	CASSFVGLPGTEQETQYF	TRBV5-1	TRBJ2-5
TGCGCCAGCAGCGCCGCGGGGAGCTCCTACAATGAGCAGTTCTTC	CASSAAGSSYNEQFF	TRBV5-1	TRBJ2-1
TGTGCCACCTCCCAGCAGGTTGAAAAACTGTTTTTT	CATSQQVEKLFF	TRBV24-1	TRBJ1-4
TGTGCCAGCTCCCAGTGGGGGGGCAATCAGCCCCAGCATTTT	CASSQWGGNQPQHF	TRBV6-1	TRBJ1-5
TGCAGTGCTAGGATGAGCGGGAGTGAGCGGACCCAGTACTTC	CSARMSGSERTQYF	TRBV20-1	TRBJ2-5
TGCAGTGCTAGAGGGTTCGACAGGGGGCGAGGGAGGGGGGATCAGCCCCAGCATTTT	CSARGFDRGRGRGDQPQHF	TRBV20-1	TRBJ1-5
TGCGCCAGCAGAGGGGGGGCCTTAGGAACAGAGACCCAGTACTTC	CASRGGALGTETQYF	TRBV5-1	TRBJ2-5
TGTGCCAGCAGCTGTTTTACTGGGAAGTATAGCAATCAGCCCCAGCATTTT	CASSCFTGKYSNQPQHF	TRBV5-6	TRBJ1-5
TGTGCCACCATTCTCAGGGGGCAGACCCAGTACTTC	CATILRGQTQYF	TRBV24-1	TRBJ2-5
TGTGCCAGCAGTGAATGGATTCTCGGGCACAGGGGGCACGAGCAGTACTTC	CASSEWILGHRGHEQYF	TRBV25-1	TRBJ2-7
TGCAGCGTTTCTTACCCGGGACACTCCTACGAGCAGTACTTC	CSVSYPGHSYEQYF	TRBV29-1	TRBJ2-7
TGTGCCAGCAGTGAACTGGTGGGACTAGCGGGGGGGGTACAAGGCACAGATACGCAGTATTTT	CASSELVGLAGGVQGTDTQYF	TRBV2	TRBJ2-3
TGTGCCAGCAGCTTAGTGGGCACGCCGAACACCGGGGAGCTGTTTTTT	CASSLVGTPNTGELFF	TRBV7-2	TRBJ2-2
TGTGCCAGCAGCTTAGACCCGGCCAGGGACAGGGATGGCTACACCTTC	CASSLDPARDRDGYTF	TRBV7-2	TRBJ1-2
TGTGCCAGCTCACCACCCACAGGGGGCGCAAGGGTTGTGGGCTACACCTTC	CASSPPTGGARVVGYTF	TRBV18	TRBJ1-2
TGTGCCAGCAGCTTGCGGACGGCGGGACGGGAGCAGTACTTC	CASSLRTAGREQYF	TRBV5-4	TRBJ2-7
TGTGCTAGCAGCTTACCCAGGGGGAACTTTAGTTATGGCTACACCTTC	CASSLPRGNFSYGYTF	TRBV7-7	TRBJ1-2
TGTGCCAGGGGGCGGCCCCAGCATTTT	CARGRPQHF	TRBV27	TRBJ1-5
TGTGCCACGGGCGCGGGGGACACCGGGGAGCTGTTTTTT	CATGAGDTGELFF	TRBV13	TRBJ2-2
TGTGCCAGCAGCCAAGTGAATCCCAAGCGGGATGCCAAAAACATTCAGTACTTC	CASSQVNPKRDAKNIQYF	TRBV11-3	TRBJ2-4
TGTGCCAGCAGTTTCGGCCCCCTAGGGGCACTTCCCTCTGGGGCCAACGTCCTGACTTTC	CASSFGPLGALPSGANVLTF	TRBV28	TRBJ2-6
TGTGCCAGCAGTAGGGGCATAGGGGTGGGTAACTATGGCTACACCTTC	CASSRGIGVGNYGYTF	TRBV27	TRBJ1-2
TGCGCCAGCAGCCAACCCCGTGGGGACAGGGAACCATACCCGGGCAATCAGCCCCAGCATTTT	CASSQPRGDREPYPGNQPQHF	TRBV4-1	TRBJ1-5
TGTGCCATCAGTCCCCGGGACAGGGAGGCCTACGAGCAGTACTTC	CAISPRDREAYEQYF	TRBV10-3	TRBJ2-7
TGCGCCAGCAGCTTGGCGGTGGACCATTTGGGACTCACCGGGGAGCTGTTTTTT	CASSLAVDHLGLTGELFF	TRBV5-1	TRBJ2-2
TGTGCCAGCAGCTTAGCCCTTTGCAGGGGCGAAAAACTGTTTTTT	CASSLALCRGEKLFF	TRBV11-1	TRBJ1-4
TGTGCCAGCAGCCCCTCTCAAATAATAGGCGAAGACGAGCAGTACTTC	CASSPSQIIGEDEQYF	TRBV7-4	TRBJ2-7
TGTGCCAGCAGTTTCTGTAAGGGCCCTCACGGAAGTCAATCAGGGGGTTCTCGCGGGGAGCTGTTTTTT	CASSFCKGPHGSQSGGSRGELFF	TRBV12-3	TRBJ2-2
TGTGCCAGCAGCTTAGCGAAACCAACAGAGTACTATGGCTACACCTTC	CASSLAKPTEYYGYTF	TRBV7-8	TRBJ1-2
TGCGCCAGCAGCCTGGGAGGTCACTGCTACGAGCAGTACTTC	CASSLGGHCYEQYF	TRBV5-1	TRBJ2-7
TGTGCCACTTCGGGACTAGGTAAGAGAATTGCCTACGAGCAGTACTTC	CATSGLGKRIAYEQYF	TRBV10-3	TRBJ2-7
TGCGCCAGCAGCTTGTTCCCGACAGGCCTACTAAAAGAGACCCAGTACTTC	CASSLFPTGLLKETQYF	TRBV5-1	TRBJ2-5
TGTGCCAGCAGCTATTCGGGGCCGGGGAAACCTGGAAACACCATATATTTT	CASSYSGPGKPGNTIYF	TRBV7-9	TRBJ1-3
TGTGCCAGCAGCGCGGTTTCAGGGCGCGCAAGCTACGAGCAGTACTTC	CASSAVSGRASYEQYF	TRBV5-6	TRBJ2-7
TGTGCCAGCAGTGACTCAGGGGCTGACACAGATACGCAGTATTTT	CASSDSGADTDTQYF	TRBV6-2	TRBJ2-3
TGTGCCAGCAGCTCAGGGGGACAGGCTTCACCCCTCCACTTT	CASSSGGQASPLHF	TRBV5-6	TRBJ1-6
TGTGCCAGCAGCTTAGTAGGAGAGGAAGAACCCCGGAACTATGGCTACACCTTC	CASSLVGEEEPRNYGYTF	TRBV11-2	TRBJ1-2
TGTGCCAGCAGCAGGAAAGGGACAGGGAGGACCTACAATGAGCAGTTCTTC	CASSRKGTGRTYNEQFF	TRBV6-4	TRBJ2-1
TGTGCCAGCAGCGGGGGATCCTACAATGAGCAGTTCTTC	CASSGGSYNEQFF	TRBV11-2	TRBJ2-1
TGTGCCAGCAGCCTAGGAGTAGACGAGCAGTACTTC	CASSLGVDEQYF	TRBV3-1	TRBJ2-7
TGTGCCAGCAGTGAGGGAGGGGTTGCACCAACTAATGAAAAACTGTTTTTT	CASSEGGVAPTNEKLFF	TRBV6-4	TRBJ1-4
TGTGCCAGCAGCAAAGGACAGGGCTGCGGCTACACCTTC	CASSKGQGCGYTF	TRBV7-4	TRBJ1-2
TGCAGCGCCAACAGGGTCCACACTGAAGCTTTCTTT	CSANRVHTEAFF	TRBV29-1	TRBJ1-1
TGTGCCAGCAGCTTAAACGGATTTGGGTATGGCTACACCTTC	CASSLNGFGYGYTF	TRBV11-1	TRBJ1-2
TGTGCCAGCAGCTTAGAAACAGGAACTTCCGTAGGTCAGCCCCAGCATTTT	CASSLETGTSVGQPQHF	TRBV11-3	TRBJ1-5
TGCAGTGCTAGTACGGGGTTTCCCGGGGAGCTGTTTTTT	CSASTGFPGELFF	TRBV20-1	TRBJ2-2
TGTGCCAGCAGTGAAGCGCAGGGGGACAGGGGTTCCTTCCGGTATGGCTACACCTTC	CASSEAQGDRGSFRYGYTF	TRBV6-1	TRBJ1-2
TGCGCCAGCAGTTACCCCGGCAATGAGCAGTTCTTC	CASSYPGNEQFF	TRBV10-1	TRBJ2-1
TGTGCCACCAGTGAATCAGCGGGAGACCAAGAGCAGTACTTC	CATSESAGDQEQYF	TRBV24-1	TRBJ2-7
TGTGCCTGGACGGACACGGATTACACCGGGGAGCTGTTTTTT	CAWTDTDYTGELFF	TRBV30	TRBJ2-2
TGTGCCAGCAGTTTCCCGGCACCGGGACGGCATGAGCAGTTCTTC	CASSFPAPGRHEQFF	TRBV28	TRBJ2-1
TGCGCCAGCAGTGCGCAGGGCCCTGTCAGGGTTTACGAGCAGTACTTC	CASSAQGPVRVYEQYF	TRBV10-1	TRBJ2-7
TGCGCCAGCATTCGGAACCCTACAGGCTACACCTTC	CASIRNPTGYTF	TRBV4-3	TRBJ1-2
TGTGCCAGCAGCCAAGACCCCCGACTAGCGGGCAATGAGCAGTTCTTC	CASSQDPRLAGNEQFF	TRBV14	TRBJ2-1
TGTGCCAGCAGCTTGGCTACTAGAGGCTACGAGCAGTACTTC	CASSLATRGYEQYF	TRBV5-4	TRBJ2-7
TGCAGTGCTAGTCGACGTAGGGGGTCAGAGATGAACACTGAAGCTTTCTTT	CSASRRRGSEMNTEAFF	TRBV20-1	TRBJ1-1
TGTGCCAGCAGTTACCCAGGGGGAACTGAAGCTTTCTTT	CASSYPGGTEAFF	TRBV6-5	TRBJ1-1
TGTGCCAGCAGTAGACCTAGCTCCCCTAATGAAAAACTGTTTTTT	CASSRPSSPNEKLFF	TRBV6-2	TRBJ1-4
TGTGCCAGCAGTTTAGCCCGACATGGGACCTACGAGCAGTACTTC	CASSLARHGTYEQYF	TRBV27	TRBJ2-7
TGCGCCAGCAAAACTGGGGCCTGCGGGAACACTGAAGCTTTCTTT	CASKTGACGNTEAFF	TRBV5-1	TRBJ1-1
TGTGCCAGCAGCTTAGGTCTGCCCCATTACAGGGGAGGGGCCCGCACTGAAGCTTTCTTT	CASSLGLPHYRGGARTEAFF	TRBV7-9	TRBJ1-1
TGTGCCAGCAGCTTACCGTTAGTTGGACAGGTGGTGGACACTGAAGCTTTCTTT	CASSLPLVGQVVDTEAFF	TRBV11-3	TRBJ1-1
TGCAGTGCCAGGTATCAGCCCCAGCATTTT	CSARYQPQHF	TRBV20-1	TRBJ1-5
TGTGCCAGCAGCTTTGTCGGGGGGCATTTTCGATTGAGCGAGACCCAGTACTTC	CASSFVGGHFRLSETQYF	TRBV7-9	TRBJ2-5
TGTGCCAGCAGCGTAACTGAAGCTTTCTTT	CASSVTEAFF	TRBV9	TRBJ1-1
TGTGCCAGCAGCGAGGGGATCCAAAGGGAAAAACTGTTTTTT	CASSEGIQREKLFF	TRBV13	TRBJ1-4
TGTGCCAGCAGAGAACTTAGGGGGACTAGCGGGAGGCAAGAGACCCAGTACTTC	CASRELRGTSGRQETQYF	TRBV6-6	TRBJ2-5
TGTGCCAACCAGGGGGAAGTATACTATGGCTACACCTTC	CANQGEVYYGYTF	TRBV10-3	TRBJ1-2
TGCAGTGCTAGAGATCCGGGACAGGGGAATTCACCCCTCCACTTT	CSARDPGQGNSPLHF	TRBV20-1	TRBJ1-6
TGTGCCAGCAGTAACAAAGGGGGGGCACCGAACACCGGGGAGCTGTTTTTT	CASSNKGGAPNTGELFF	TRBV6-3	TRBJ2-2
TGCAGTGCTCCTAGACCACATGGGGCCAACGTCCTGACTTTC	CSAPRPHGANVLTF	TRBV20-1	TRBJ2-6
TGTGCCAGCTCACCACGGAGGCGACTGGTCTACAATGAGCAGTTCTTC	CASSPRRRLVYNEQFF	TRBV18	TRBJ2-1
TGTGCCAGCAGTGAAGAACAGGGTAAGCGTCAAGAGACCCAGTACTTC	CASSEEQGKRQETQYF	TRBV6-1	TRBJ2-5
TGCAGTGCTAGAGTTTGTCGGGGACGGACTGAGCAGTACTTC	CSARVCRGRTEQYF	TRBV20-1	TRBJ2-7
TGCGCCAGCAGCCCATCTGGTGAAGCTTTCTTT	CASSPSGEAFF	TRBV5-1	TRBJ1-1
TGTGCCAGCAGCCAAGATTGGACAGCGACTGAAGCTTTCTTT	CASSQDWTATEAFF	TRBV14	TRBJ1-1
TGTGCCCTAGCCTTGACTAGCGGGCCAAGCGGGGGCACAGATACGCAGTATTTT	CALALTSGPSGGTDTQYF	TRBV28	TRBJ2-3
TGTGCCAGCAGGGTTCAGGGGGACTGCGGGGAGCTGTTTTTT	CASRVQGDCGELFF	TRBV14	TRBJ2-2
TGTGCCAGCAGCATATGGACAGGGGAGGAAATGAACACTGAAGCTTTCTTT	CASSIWTGEEMNTEAFF	TRBV7-8	TRBJ1-1
TGTGCCAGCAGCCCCGGGACAATCTCTGGGGCCAACGTCCTGACTTTC	CASSPGTISGANVLTF	TRBV7-6	TRBJ2-6
TGTGCCAGCAGCGAAGGTCCGGGGACCTACGAGCAGTACTTC	CASSEGPGTYEQYF	TRBV13	TRBJ2-7
TGTGCCAGCAGTTATCTTCCTAACCCGACAGGGGCGAATGAGCAGTTCTTC	CASSYLPNPTGANEQFF	TRBV6-5	TRBJ2-1
TGTGCCAGCCGACTTGGACAGTACATCTACGAGCAGTACTTC	CASRLGQYIYEQYF	TRBV13	TRBJ2-7
TGTGCCAGCAGCCAAGGGGTAAAGATCGACAGGACATTCGTTAGCTCCTACAATGAGCAGTTCTTC	CASSQGVKIDRTFVSSYNEQFF	TRBV14	TRBJ2-1
TGCAGTGCTATACTTCGTAACGAGCAGTACTTC	CSAILRNEQYF	TRBV20-1	TRBJ2-7
TGTGCCACCAGGCCCGGGGGTTTACGCAATGAGCAGTTCTTC	CATRPGGLRNEQFF	TRBV24-1	TRBJ2-1
TGCAGTGCAAACTGCCTCACTGGGGAAGGTAGCAATCAGCCCCAGCATTTT	CSANCLTGEGSNQPQHF	TRBV20-1	TRBJ1-5
TGTGCCAGCAGCCCCCCTAAGACAGAGGAGATGAACACTGAAGCTTTCTTT	CASSPPKTEEMNTEAFF	TRBV6-1	TRBJ1-1
TGTGCCAGCAGGGAGACGGCAATCACTGAAGCTTTCTTT	CASRETAITEAFF	TRBV4-2	TRBJ1-1
TGCAGCGTCACGGGGGGACTCAGGGGGGGGTGCCAAGAGACCCAGTACTTC	CSVTGGLRGGCQETQYF	TRBV29-1	TRBJ2-5
TGTGCCAGCAGTGAAGCTAGGGGAAATTGTGAGCAAGAGACCCAGTACTTC	CASSEARGNCEQETQYF	TRBV6-1	TRBJ2-5
TGCGCCAGCAGCTTGATAACCGCGGGTCCGAATGGCTACACCTTC	CASSLITAGPNGYTF	TRBV5-1	TRBJ1-2
TGTGCCAGCAGCTGTTCACAGGGGGCGCAGCTCTACACCTTC	CASSCSQGAQLYTF	TRBV5-4	TRBJ1-2
TGTGCCAGCAGTTTAGTTGCGGGGGCGGGTATCGTGAACACTGAAGCTTTCTTT	CASSLVAGAGIVNTEAFF	TRBV27	TRBJ1-1
TGCAGTGCTAGAGAATCTTCCGAGTCCCTTGGCTACACCTTC	CSARESSESLGYTF	TRBV20-1	TRBJ1-2
TGTAAACGACCCAGCGGGACTACTAACTATGGCTACACCTTC	CKRPSGTTNYGYTF	TRBV6-5	TRBJ1-2
TGTGCCAGCAGTTACGGGAGGAGGACAGGGGGCCGGCCTATCTATAGCAATCAGCCCCAGCATTTT	CASSYGRRTGGRPIYSNQPQHF	TRBV6-3	TRBJ1-5
TGTGCCAGCAGCACCCCTAGCGTCTCTGCAGGGACGCCCTACGAGCAGTACTTC	CASSTPSVSAGTPYEQYF	TRBV13	TRBJ2-7
TGCGCCAGCAACAGGGCCGGGACAGGAGGAAATGAGCAGTTCTTC	CASNRAGTGGNEQFF	TRBV5-1	TRBJ2-1
TGTGCCAGCAGCTTAGCGCCTCACAGGTACACCGGGGAGCTGTTTTTT	CASSLAPHRYTGELFF	TRBV7-9	TRBJ2-2
TGCAGTGCTAGTGCGAGCTCTGGAAACACCATATATTTT	CSASASSGNTIYF	TRBV20-1	TRBJ1-3
TGTGCCATCAGTGAGTCCCGACTAGCGGTTACAGGGCACGAGCAGTACTTC	CAISESRLAVTGHEQYF	TRBV10-3	TRBJ2-7
TGTGCCAGCAGCTTGGACCCCCGTTCGGTCTACTCCAAAAACATTCAGTACTTC	CASSLDPRSVYSKNIQYF	TRBV11-2	TRBJ2-4
TGTGCCAGCCAGATCCATGCGGGAGACGAGCAGTACTTC	CASQIHAGDEQYF	TRBV13	TRBJ2-7
TGCGCCAGCAGCCGTTCTAGCAGGAATGAGCAGTTCTTC	CASSRSSRNEQFF	TRBV4-1	TRBJ2-1
TGTGCCAGCAGTATGGGGGGGCCCGAGACCCAGTACTTC	CASSMGGPETQYF	TRBV27	TRBJ2-5
TGTGCCAGCAGCGTAGAACTACAGGGGGCAGTACCGACGCAGCCCCAGCATTTT	CASSVELQGAVPTQPQHF	TRBV9	TRBJ1-5
TGTGCCAGCAGTTTAGACTGCGTGGGGAGAGCCTACACAGAGACCCAGTACTTC	CASSLDCVGRAYTETQYF	TRBV27	TRBJ2-5
TGCGCCAGCAGCCGTTTCCGCCCGGGACAGGTCTTGTACGAGCAGTACTTC	CASSRFRPGQVLYEQYF	TRBV4-3	TRBJ2-7
TGTGCCAGTAGTATCCCCCAGGGAGATCAGCCCCAGCATTTT	CASSIPQGDQPQHF	TRBV19	TRBJ1-5
TGTGCCAGCAGCATATCGGCGGGAGGCGGAGCTTTCTTT	CASSISAGGGAFF	TRBV5-6	TRBJ1-1
TGTGCCAGCAGTCCTTCCGGGACAGGGGGCGGGCCTTACGGCTACGAGCAGTACTTC	CASSPSGTGGGPYGYEQYF	TRBV9	TRBJ2-7
TGTGCCAGCAGCAAGAGACAGGGGGAGGGTAAAGAGACCCAGTACTTC	CASSKRQGEGKETQYF	TRBV7-3	TRBJ2-5
TGTGCCAGCTCACCATCAACAGTCTACGAGCAGTACTTC	CASSPSTVYEQYF	TRBV18	TRBJ2-7
TGTGCCAGCAGGAGGCGCGGGACTAGCAAGGAGTTCACAGATACGCAGTATTTT	CASRRRGTSKEFTDTQYF	TRBV7-2	TRBJ2-3
TGTGCCACCAGCAGAGCAGTATGGGACAGGGACCTGGCCTATGGCTACACCTTC	CATSRAVWDRDLAYGYTF	TRBV15	TRBJ1-2
TGCGCCAGCAAGGGCGGGGACGTTAGCAATCAGCCCCAGCATTTT	CASKGGDVSNQPQHF	TRBV5-1	TRBJ1-5
TGTGCCAGCTCAAGCCCAGGGACATGCGGGGTGAACACTGAAGCTTTCTTT	CASSSPGTCGVNTEAFF	TRBV18	TRBJ1-1
TGCAGTGCTAGAGATCTCGAGCCCACTGCAGGGGGCTCCTACAATGAGCAGTTCTTC	CSARDLEPTAGGSYNEQFF	TRBV20-1	TRBJ2-1
TGTGCCAGCAGTGAATACCGACAGTATAATGAGCAGTTCTTC	CASSEYRQYNEQFF	TRBV25-1	TRBJ2-1
TGCGCCAGCAGCCAAGATCGAAGGGGGCTCTTGGGCTTATCCAATCAGCCCCAGCATTTT	CASSQDRRGLLGLSNQPQHF	TRBV4-3	TRBJ1-5
TGCGCCAGCAGCTTGGTCTCTAGCCAAGAGACCCAGTACTTC	CASSLVSSQETQYF	TRBV5-1	TRBJ2-5
TGCGCCAGCAGCTTGGTCCGGGACAGTAGGGGAGGGGCCTATAATTCACCCCTCCACTTT	CASSLVRDSRGGAYNSPLHF	TRBV5-1	TRBJ1-6
TGTGCCAGCAGCGTACCTCCCGGGACTAGTCGCAATGAGCAGTTCTTC	CASSVPPGTSRNEQFF	TRBV9	TRBJ2-1
TGTGCTAGCAGCTTTAGAGCGGGAGGTGAGCAGTACTTC	CASSFRAGGEQYF	TRBV7-7	TRBJ2-7
TGCAGTGCTCGACAGGAGTTCTTT	CSARQEFF	TRBV20-1	TRBJ1-1
TGCAGTGCTAGAGCTGATAGGGACAGGGGCTGGGTTGTAAACGAGCAGTACTTC	CSARADRDRGWVVNEQYF	TRBV20-1	TRBJ2-7
TGCAGTGCACTAGGCAGGCGTGAAGCTTTCTTT	CSALGRREAFF	TRBV20-1	TRBJ1-1
TGTGCCAGCAGCTGTCCCTGTAGTAAGTCAGTGGGAGACGAGCAGTACTTC	CASSCPCSKSVGDEQYF	TRBV5-4	TRBJ2-7
TGCGCCAGCCACGTCGCCTACGAGCAGTACTTC	CASHVAYEQYF	TRBV10-2	TRBJ2-7
TGTGCCAGCAGCAACAAGAGGTCCCCTAACAATGAGCAGTTCTTC	CASSNKRSPNNEQFF	TRBV7-6	TRBJ2-1
TGTGCCAGCAGGGTACCTCCGGGACTAGGACGCTACGAGCAGTACTTC	CASRVPPGLGRYEQYF	TRBV27	TRBJ2-7
TGCGCCAGCAGCCAAGAGTGCGCGGGAATAGGGGAGACAGCAACTAATGAAAAACTGTTTTTT	CASSQECAGIGETATNEKLFF	TRBV4-3	TRBJ1-4
TGTGCCAGCGGGGGGCCGGTGAGGCAAGAGACCCAGTACTTC	CASGGPVRQETQYF	TRBV18	TRBJ2-5
TGTGCCAGCAAGTTTAGCGGGAGGGGGGCGAACACCGGGGAGCTGTTTTTT	CASKFSGRGANTGELFF	TRBV25-1	TRBJ2-2
TGTGCCAGCAGCAGGGGAAGCTCCTACAATGAGCAGTTCTTC	CASSRGSSYNEQFF	TRBV28	TRBJ2-1
TGTGCCAGCAGCTGCGGTGAGTGCTCTGGGGCCAACGTCCTGACTTTC	CASSCGECSGANVLTF	TRBV7-8	TRBJ2-6
TGCGCCAGCAGCACGTGGGAGGGGGAGGGCAATCAGCCCCAGCATTTT	CASSTWEGEGNQPQHF	TRBV5-1	TRBJ1-5
TGTGCCAGCAGTTACAGGGAACGGAGTTCACCCCTCCACTTT	CASSYRERSSPLHF	TRBV6-2	TRBJ1-6
TGTGCCAGCAGTTACGGACCCTACAATGAGCAGTTCTTC	CASSYGPYNEQFF	TRBV27	TRBJ2-1
TGTGCCAGCAGCCAGACAGTGGGCAGGGCTGCCGAAAAACTGTTTTTT	CASSQTVGRAAEKLFF	TRBV7-3	TRBJ1-4
TGTGCCAGCAGTTACTCGATAAAGGACAGGGTCGGCGGCACAGATACGCAGTATTTT	CASSYSIKDRVGGTDTQYF	TRBV6-8	TRBJ2-3
TGTGCCAGCAGTATACCGGAACAGGGTCCGAAAAACACTGAAGCTTTCTTT	CASSIPEQGPKNTEAFF	TRBV6-1	TRBJ1-1
TGTGCCAGCAGCGTGGGACAGCAAACGAACACCGGGGAGCTGTTTTTT	CASSVGQQTNTGELFF	TRBV5-8	TRBJ2-2
TGTGAAGGAGGCAATCAGCCCCAGCATTTT	CEGGNQPQHF	TRBV7-9	TRBJ1-5
TGCGCCAGCACTCCCCGAGGGGCCAGGGACACAGATACGCAGTATTTT	CASTPRGARDTDTQYF	TRBV10-1	TRBJ2-3
TGTGCCAGCAGCTGTGACAGGTCCCAGGGCTACACCTTC	CASSCDRSQGYTF	TRBV13	TRBJ1-2
TGTGCCAGCAGCTTAACGGAACAGGGAGGAGCTTTCTTT	CASSLTEQGGAFF	TRBV7-9	TRBJ1-1
TGTGCCAGCAGCCCCGGGACTGATGAGCAGTTCTTC	CASSPGTDEQFF	TRBV13	TRBJ2-1
TGTGCCAGTAGTATAGATCACCCCGCCGACAGGGGCTACGAGCAGTACTTC	CASSIDHPADRGYEQYF	TRBV19	TRBJ2-7
TGTGCCAGCAGCCTTTCCAGAGGTAACACTGAAGCTTTCTTT	CASSLSRGNTEAFF	TRBV3-1	TRBJ1-1
TGCAGTGCTAGAGCTCGCCGACGGTGGGGCACAGATACGCAGTATTTT	CSARARRRWGTDTQYF	TRBV20-1	TRBJ2-3
TGTGCCACCAGTGATTTGGTGAGAGGGAAGCCCCAGCATTTT	CATSDLVRGKPQHF	TRBV24-1	TRBJ1-5
TGTGCCAGCGTCGTGGGGGGGTCTGGCTACACCTTC	CASVVGGSGYTF	TRBV6-4	TRBJ1-2
TGTGCCAGCAGCGGAGGGGCGGACCCAGAGACCCAGTACTTC	CASSGGADPETQYF	TRBV7-3	TRBJ2-5
TGCGCCAGCAGCCGGAAGAACGGCGGGGTCTACGAGCAGTACTTC	CASSRKNGGVYEQYF	TRBV4-1	TRBJ2-7
TGCAGCGTTACGGGCCCGAGGGGGAGTTGGGGCTCCTACAATGAGCAGTTCTTC	CSVTGPRGSWGSYNEQFF	TRBV29-1	TRBJ2-1
TGTGCCAGCAGCAGGTCGCCACGGGACGAAGATCAGCACGGTCAGCCCCAGCATTTT	CASSRSPRDEDQHGQPQHF	TRBV7-9	TRBJ1-5
TGTGCCAGCAGCAGACTAGCGGGAAATGAGCAGTTCTTC	CASSRLAGNEQFF	TRBV5-6	TRBJ2-1
TGTGCCAGCAGCTTAGGGAAGTACAATATTTGGAGACCCGGGGAGCTGTTTTTT	CASSLGKYNIWRPGELFF	TRBV13	TRBJ2-2
TGTGCCAGCAGCCGCTGGCCCAAAGGTGGCCATCAGCCCCAGCATTTT	CASSRWPKGGHQPQHF	TRBV3-1	TRBJ1-5
TGTGCCAGCAGCTGTAGCAGGGGGAACACTGAAGCTTTCTTT	CASSCSRGNTEAFF	TRBV5-6	TRBJ1-1
TGTGCCAGCAGCAGGGGATGGCTAGCAAGTTGGTGCTCCTACGAGCAGTACTTC	CASSRGWLASWCSYEQYF	TRBV7-2	TRBJ2-7
TGTGCCAGAACAGGTAAAGAGACCCAGTACTTC	CARTGKETQYF	TRBV28	TRBJ2-5
TGCGCCAGCAGTTCCGACAGGAAGAGACTCAAAGGGTATGGCTACACCTTC	CASSSDRKRLKGYGYTF	TRBV5-1	TRBJ1-2
TGCGCCAAAACAGATTTAGAGCCCCAGCATTTT	CAKTDLEPQHF	TRBV5-1	TRBJ1-5
TGTGCCAGCAGCTTGCTTAGTCAGCCCCAGCATTTT	CASSLLSQPQHF	TRBV5-4	TRBJ1-5
TGTGCTAGTGGTCGAGAGTGGGGACCCAAATATAGCAATCAGCCCCAGCATTTT	CASGREWGPKYSNQPQHF	TRBV12-5	TRBJ1-5
TGTGCCAGGGGAGACAGGAACTTCATAACTGAAGCTTTCTTT	CARGDRNFITEAFF	TRBV6-3	TRBJ1-1
TGCAGTGCTAGAGAGGCGGGAGCGGGACAGCCTACGCACGAGCAGTACTTC	CSAREAGAGQPTHEQYF	TRBV20-1	TRBJ2-7
TGCGCCAAGAGCGTTGACCCGGGACTAGCGTGGGATAGGGGCTACGAGCAGTACTTC	CAKSVDPGLAWDRGYEQYF	TRBV10-1	TRBJ2-7
TGCGCCAGCACTCCAATTTGGGAAAAACTGTTTTTT	CASTPIWEKLFF	TRBV5-1	TRBJ1-4
TGTGCCAGTAGTATGGATGAGGGATCCGAGCTTGACCGCAATCAGCCCCAGCATTTT	CASSMDEGSELDRNQPQHF	TRBV19	TRBJ1-5
TGTGCCAGCAGCCATCCGCGGACAGGGTACGGAGACGCTGAAGCTTTCTTT	CASSHPRTGYGDAEAFF	TRBV4-2	TRBJ1-1
TGTGCCAGCATCAGGACTAGCGGCACAGATACGCAGTATTTT	CASIRTSGTDTQYF	TRBV6-3	TRBJ2-3
TGCAGCGTACCTAAAGAGACCCAGTACTTC	CSVPKETQYF	TRBV29-1	TRBJ2-5
TGTGCCAGCAGTCCCAGGCAGGAGGCGGAGCAGTTCTTC	CASSPRQEAEQFF	TRBV27	TRBJ2-1
TGTGCCAGCAGCCAAGCCGGGGGTTGCTCCTACGAGCAGTACTTC	CASSQAGGCSYEQYF	TRBV3-1	TRBJ2-7
TGTGCCAGCAGTATCCCTAGCGGGCCCCGTTTTGAGCAGTTCTTC	CASSIPSGPRFEQFF	TRBV7-3	TRBJ2-1
TGTGCCAGCAGCCACCAGCTCTGGGGGCGCGGAAAGTATGGCTACACCTTC	CASSHQLWGRGKYGYTF	TRBV7-6	TRBJ1-2
TGTGCCAGCTCAAGGACAGGTCCAGGGCACGAGCAGTACTTC	CASSRTGPGHEQYF	TRBV6-5	TRBJ2-7
TGTGCCAGCAGCCACACGGGGAACACTGAAGCTTTCTTT	CASSHTGNTEAFF	TRBV13	TRBJ1-1
TGTGCCAGCAGCCCGCAGGGGGGGATTAACACTGAAGCTTTCTTT	CASSPQGGINTEAFF	TRBV5-8	TRBJ1-1
TGTGCCAGCAGTTACGACCTAACGGGACAGGGTATGACTGAAGCTTTCTTT	CASSYDLTGQGMTEAFF	TRBV6-5	TRBJ1-1
TGTGCCAGCAGCATCCGGGACAGGGGGTCCCAGGGGGAGCTGTTTTTT	CASSIRDRGSQGELFF	TRBV11-3	TRBJ2-2
TGTGCCAGGACCCGGCAAGATGAGCAGTTCTTC	CARTRQDEQFF	TRBV7-3	TRBJ2-1
TGTGCCAGCAGCTTGGCCGTAGAGGGGGGAGGTGATCAGCCCCAGCATTTT	CASSLAVEGGGDQPQHF	TRBV5-6	TRBJ1-5
TGTGCCAAAATTGGCACCACAGATACGCAGTATTTT	CAKIGTTDTQYF	TRBV6-4	TRBJ2-3
TGTGCCACCAGTGATTCAGCCCCGGCCAATCAGCCCCAGCATTTT	CATSDSAPANQPQHF	TRBV24-1	TRBJ1-5
TGTGCCAGCAGCTTATGTCAACAGTTCTCCCTCAGGAATGAGCAGTTCTTC	CASSLCQQFSLRNEQFF	TRBV7-9	TRBJ2-1
TGTGCCAGCAGACGAGGTAGTCCGACTAGCGGGCTTCAGAGTACCTACGAGCAGTACTTC	CASRRGSPTSGLQSTYEQYF	TRBV3-1	TRBJ2-7
TGTGCCAGCAGTGGGATTACATACGAGCAGTACTTC	CASSGITYEQYF	TRBV6-4	TRBJ2-7
TGTGCCAGCAGCCGGACGGTCCCGGGGGGGGCGCAGTATTTT	CASSRTVPGGAQYF	TRBV28	TRBJ2-3
TGTGCCAGTAGTATAGATACCTGGGACAGGATGGAAACAGATACGCAGTATTTT	CASSIDTWDRMETDTQYF	TRBV19	TRBJ2-3
TGTGCCGGTTTTACTGGACGGAACACTGAAGCTTTCTTT	CAGFTGRNTEAFF	TRBV27	TRBJ1-1
TGTGCCAGCCTGGGACAGCCCTCGCAAGAGACCCAGTACTTC	CASLGQPSQETQYF	TRBV5-8	TRBJ2-5
TGTGCCAGCAGTTACAAGGGGTACGAGCAGTACTTC	CASSYKGYEQYF	TRBV6-5	TRBJ2-7
TGTGCCAGCAGTGTCCGTGTGAGAGACAGGCTGGTTTGGGCTTTCTTT	CASSVRVRDRLVWAFF	TRBV27	TRBJ1-1
TGTGCTAGTGGGTCAGGGGATATGAACACTGAAGCTTTCTTT	CASGSGDMNTEAFF	TRBV12-5	TRBJ1-1
TGTGCCAGCAGTGATGCAAGACAGGGATGGTTTAATGAGCAGTTCTTC	CASSDARQGWFNEQFF	TRBV6-1	TRBJ2-1
TGTGCCATCAGTGGGGTGGAATGGGGGGCCGCCCCTACCGGGGAGCTGTTTTTT	CAISGVEWGAAPTGELFF	TRBV10-3	TRBJ2-2
TGTGCCAGCAGCACACCGGGACAGCTTCAGCCCCAGCATTTT	CASSTPGQLQPQHF	TRBV13	TRBJ1-5
TGTGCCAGCAGCGTACAGGGCTGTAGAGCCTACGAGCAGTACTTC	CASSVQGCRAYEQYF	TRBV9	TRBJ2-7
TGTGCCAGCCGGGGAGGCAGTGAAGCTTTCTTT	CASRGGSEAFF	TRBV6-3	TRBJ1-1
TGTGCCAGCAGTTACCGGTTCAGGGGCTATGGCTACACCTTC	CASSYRFRGYGYTF	TRBV6-2	TRBJ1-2
TGTGCCAGCAGTCATAGCTCCCCTAATGAGCAGTTCTTC	CASSHSSPNEQFF	TRBV27	TRBJ2-1
TGCAGTGCTAAGAGCGGGGGAAAGGTCACAGATACGCAGTATTTT	CSAKSGGKVTDTQYF	TRBV20-1	TRBJ2-3
TGTGCCAGCAGGACCGACCTGCGGGGGGGCGAGCAGTACTTC	CASRTDLRGGEQYF	TRBV7-6	TRBJ2-7
TGTGCAAGCGGGATATATGAGCAGTTCTTC	CASGIYEQFF	TRBV7-9	TRBJ2-1
TGTGCCAGCAGCTCTAGTGAGCAGTTCTTC	CASSSSEQFF	TRBV13	TRBJ2-1
TGTGCCAGCAGCGAAGGGGACAAGGCCAACGTCCTGACTTTC	CASSEGDKANVLTF	TRBV9	TRBJ2-6
TGCAGCTTCATCCCGGGGGGGCGTGGCCTCCAAGAGACCCAGTACTTC	CSFIPGGRGLQETQYF	TRBV29-1	TRBJ2-5
TGCGCCAGCAGTGGCGCCAAGACTAGTGGGGAGACCCAGTACTTC	CASSGAKTSGETQYF	TRBV10-1	TRBJ2-5
TGCGCCAGCAGTGAGCCCACTGGTACTGAAGCTTTCTTT	CASSEPTGTEAFF	TRBV10-2	TRBJ1-1
TGTGCCAGCGTAGATCACACTAGCGGGCCGCGCACAGATACGCAGTATTTT	CASVDHTSGPRTDTQYF	TRBV6-5	TRBJ2-3
TGTGCCAGCAGCTCTCCAGGGGTGCTAGATACGCAGTATTTT	CASSSPGVLDTQYF	TRBV11-3	TRBJ2-3
TGCAGTGCTAGAAGGACTAGTGAGCAGTTCTTC	CSARRTSEQFF	TRBV20-1	TRBJ2-1
TGTGCCACCAGTGATTTGACGGCCCAGTACGAGCAGTACTTC	CATSDLTAQYEQYF	TRBV24-1	TRBJ2-7
TGTGCCACGGACAGGGCTGTAGAAAACATTCAGTACTTC	CATDRAVENIQYF	TRBV12-3	TRBJ2-4
TGCAGTGCTAGAGGACTAGCGGTGAGAGGTAGCTCCTACAATGAGCAGTTCTTC	CSARGLAVRGSSYNEQFF	TRBV20-1	TRBJ2-1
TGTGCCAGTAGTATAGACGGGTGGGACAGAACAGACTACGAGCAGTACTTC	CASSIDGWDRTDYEQYF	TRBV19	TRBJ2-7
TGCAGTGCGCCCGGGACTAGCATAGATGAAGGAGGCCCCGGGGAGCTGTTTTTT	CSAPGTSIDEGGPGELFF	TRBV20-1	TRBJ2-2
TGTGCCTGGATGCCGGGGACTAGCTACGAGCAGTACTTC	CAWMPGTSYEQYF	TRBV30	TRBJ2-7
TGCGCCAGCAGCATTCCAGTGACGAAGACCAATGAGCAGTTCTTC	CASSIPVTKTNEQFF	TRBV5-1	TRBJ2-1
TGTGCCAGCAGTTCGGAGATGCCGGGACAGGGGGGTCCCTACGAGCAGTACTTC	CASSSEMPGQGGPYEQYF	TRBV6-2	TRBJ2-7
TGTGCCAGCAGCTTAGGTCATCCGGGACTAGCAGAGCAGTTCTTC	CASSLGHPGLAEQFF	TRBV11-3	TRBJ2-1
TGTGCCATTGGTAACAGGCATGGGTGTGAAGCTTTCTTT	CAIGNRHGCEAFF	TRBV25-1	TRBJ1-1
TGTGCCAGCAGCTTGCCTCGCGGGCAGGACACCGGGGAGCTGTTTTTT	CASSLPRGQDTGELFF	TRBV5-5	TRBJ2-2
TGTGCCATCAGGGGGAAGGACCTAGGACATGAAAAACTGTTTTTT	CAIRGKDLGHEKLFF	TRBV10-3	TRBJ1-4
TGTGCTAGCAGCTTAAGAGCGGGACAGGGAAGGTCTTTCGACACTGAAGCTTTCTTT	CASSLRAGQGRSFDTEAFF	TRBV7-7	TRBJ1-1
TGTGCCAGCAGGTTCCCCGACAGGGGGGCTCTCAATCAGCCCCAGCATTTT	CASRFPDRGALNQPQHF	TRBV6-5	TRBJ1-5
TGTGCCAGGACAGAGACTTCTGGAAACACCATATATTTT	CARTETSGNTIYF	TRBV6-6	TRBJ1-3
TGTGCTGTGCGGGGATACAATGAGCAGTTCTTC	CAVRGYNEQFF	TRBV30	TRBJ2-1
TGTGCCAGCGCCATCGTCCTTTGGCAAGAGACCCAGTACTTC	CASAIVLWQETQYF	TRBV25-1	TRBJ2-5
TGCGCCAGCAGCCAAGATGTATTCCCGGGAATGAACACTGAAGCTTTCTTT	CASSQDVFPGMNTEAFF	TRBV4-1	TRBJ1-1
TGTGCCAGCAGCCAAGATACGCCCAGGACCCAAGAGACCCAGTACTTC	CASSQDTPRTQETQYF	TRBV14	TRBJ2-5
TGTGCCAGCAGCGCGGGGACAGGGACCCTAAACAATGAGCAGTTCTTC	CASSAGTGTLNNEQFF	TRBV13	TRBJ2-1
TGTGCCAGCAGCCGAGAGGAGGGGGCGGACCACTTC	CASSREEGADHF	TRBV11-2	TRBJ2-7
TGTGCTAGGGGACAGGGGGCTGGGACAGCTAACTATGGCTACACCTTC	CARGQGAGTANYGYTF	TRBV12-5	TRBJ1-2
TGTGCCAGCAGCCCTCGAAGGGTTTTAGCTTTCTTT	CASSPRRVLAFF	TRBV11-3	TRBJ1-1
TGTGCCAGCAGCCTGGGGGGGGGCCCGGGCACAGATACGCAGTATTTT	CASSLGGGPGTDTQYF	TRBV7-9	TRBJ2-3
TGTGCTAGTGGTTTGGTACGACGACAGGGGGACTACGAGCAGTACTTC	CASGLVRRQGDYEQYF	TRBV12-5	TRBJ2-7
TGTGCCAGCAGCCAGCGTGGTCGGATCAAGTACTTC	CASSQRGRIKYF	TRBV14	TRBJ2-7
TGTGCCACCAGTGATGGGTATCGCTCATGGAACACTGAAGCTTTCTTT	CATSDGYRSWNTEAFF	TRBV24-1	TRBJ1-1
TGTGCCAGTAGTATACCGACAGGGGGTTTTAATGAAAAACTGTTTTTT	CASSIPTGGFNEKLFF	TRBV19	TRBJ1-4
TGTGCCATCAGTGAAACTATAGGGGGCGAGACCCAGTACTTC	CAISETIGGETQYF	TRBV10-3	TRBJ2-5
TGTGCCTGGAGTTTGACGGATCAGCCCCAGCATTTT	CAWSLTDQPQHF	TRBV30	TRBJ1-5
TGCGCCAGCAGTAAAGCCTGCCGGGACAGGGGTCAGGGCTATAGCAATCAGCCCCAGCATTTT	CASSKACRDRGQGYSNQPQHF	TRBV10-1	TRBJ1-5
TGTGCCAGCAGCCTAGAGGGGCACCCTGGGGCCAACGTCCTGACTTTC	CASSLEGHPGANVLTF	TRBV27	TRBJ2-6
TGCAGTGCTAGAGTTAAGCGGACAGGGTTCAACCCCCACACCGGGGAGCTGTTTTTT	CSARVKRTGFNPHTGELFF	TRBV20-1	TRBJ2-2
TGTGCCGGGAGCCGTTCTACGGACAGGACCAGCTCCTACGAGCAGTACTTC	CAGSRSTDRTSSYEQYF	TRBV11-3	TRBJ2-7
TGTGCCAGCAGCGTAGCTCGGGACAGAGTGAGGAACGAGCAGTACTTC	CASSVARDRVRNEQYF	TRBV13	TRBJ2-7
TGTGCCAGCAGCGACGGTAGCCCCCCTAGCACAGATACGCAGTATTTT	CASSDGSPPSTDTQYF	TRBV7-9	TRBJ2-3
TGCGCCAGCAGACCGGGCCAAGAGACCCAGTACTTC	CASRPGQETQYF	TRBV5-1	TRBJ2-5
TGTGCCAGACCGGGGGGGGGACCCTACGAGCAGTACTTC	CARPGGGPYEQYF	TRBV11-3	TRBJ2-7
TGTGCCAGCAGCTTACAAACCCGGACAGGGGATGAAAAACTGTTTTTT	CASSLQTRTGDEKLFF	TRBV11-3	TRBJ1-4
TGTGCCAGCAGCTCGAAACCTGGACAGGTGAATAGGGGCTCCAGCAATGAGCAGTTCTTC	CASSSKPGQVNRGSSNEQFF	TRBV11-2	TRBJ2-1
TGTGCCAGGACAGCTGAAGCTTTCTTT	CARTAEAFF	TRBV19	TRBJ1-1
TGTGCCAGCAGCCCCATGGGGCGATCCTACAATGAGCAGTTCTTC	CASSPMGRSYNEQFF	TRBV2	TRBJ2-1
TGTGCCAGCAGAGGCCAGGGTAAGGCTTTCTTT	CASRGQGKAFF	TRBV6-6	TRBJ1-1
TGCGCCAGCAGTGAATTTCAGGCCGGGACAGGGGGTCGGGGGGGCTACGAGCAGTACTTC	CASSEFQAGTGGRGGYEQYF	TRBV10-1	TRBJ2-7
TGTGCCAGCAGTTACTCTAAGAAGGGGACCCGAGTGTACAATGAGCAGTTCTTC	CASSYSKKGTRVYNEQFF	TRBV6-3	TRBJ2-1
TGTGCCACCGCAGGGCAATTCGAAGCTTTCTTT	CATAGQFEAFF	TRBV15	TRBJ1-1
TGTGCCAGCAGTGATGGTTGGCCAGACTCTGAAGCTTTCTTT	CASSDGWPDSEAFF	TRBV6-5	TRBJ1-1
TGTGCCAGCAGCAGACCCAGGCAGGGGCAGCAGCCCCAGCATTTT	CASSRPRQGQQPQHF	TRBV9	TRBJ1-5
TGTGCCAGCAGTTTACCCTCTATCAGCTCCTATAATTCACCCCTCCACTTT	CASSLPSISSYNSPLHF	TRBV28	TRBJ1-6
TGTGCCAGCAGTTTCAGAATGACCGGGTGGAGCTCCTACAATGAGCAGTTCTTC	CASSFRMTGWSSYNEQFF	TRBV27	TRBJ2-1
TGTGCCAGCAGCTTGTCCCGGGGAGCACACGACACCGGGGAGCTGTTTTTT	CASSLSRGAHDTGELFF	TRBV7-9	TRBJ2-2
TGTGCCAGCACCCTCGGGTTGGGCTACGAGCAGTACTTC	CASTLGLGYEQYF	TRBV28	TRBJ2-7
TGTGCCAGCAGAACCTCGGGAGGGGTGGTTAACGTCCTGACTTTC	CASRTSGGVVNVLTF	TRBV7-9	TRBJ2-6
TGTGCCAGCAGTTCACTTAGGGGGCACGAGCAGTACTTC	CASSSLRGHEQYF	TRBV27	TRBJ2-7
TGCAGTGCTTCGGTCGACAGGGGGATCAGGGTTCCCAGCAATCAGCCCCAGCATTTT	CSASVDRGIRVPSNQPQHF	TRBV20-1	TRBJ1-5
TGTGCCAGCAGCTTAAGGGGTGGGACAGGGAGGGTCCAGAGCTCCTACGAGCAGTACTTC	CASSLRGGTGRVQSSYEQYF	TRBV7-6	TRBJ2-7
TGTGCCAGCAGTGACTCCGGGACAGGGAGCTCCTACGAGCAGTACTTC	CASSDSGTGSSYEQYF	TRBV6-4	TRBJ2-7
TGCGCCAGCAGCTACCCGCCGGGACTTCCCCAGCGGGTCGAGACCCAGTACTTC	CASSYPPGLPQRVETQYF	TRBV5-1	TRBJ2-5
TGTGCCAGCAGTGAAGTATCCCGGGGTCAGGTCTACGAGCAGTACTTC	CASSEVSRGQVYEQYF	TRBV6-1	TRBJ2-7
TGCAGTGCTAGAGATCGTAAACAAACAGGATATCAGCCCCAGCATTTT	CSARDRKQTGYQPQHF	TRBV20-1	TRBJ1-5
TGTGCCAGCAGTTTGACAGGGGGCTACGAGCAGTACTTC	CASSLTGGYEQYF	TRBV27	TRBJ2-7
TGTGCCAGCAGCTTAATTAGGTACGAGCAGTACTTC	CASSLIRYEQYF	TRBV7-4	TRBJ2-7
TGTGCCAGCAGTTTAGGGACAGTCGTGAACACTGAAGCTTTCTTT	CASSLGTVVNTEAFF	TRBV12-3	TRBJ1-1
TGTGCCAGCAGCAAACCAGGGAACTACGAGCAGTACTTC	CASSKPGNYEQYF	TRBV7-2	TRBJ2-7
TGTGCCAGCAGTGTGGGGCCCGGGGACGGATACACTGAAGCTTTCTTT	CASSVGPGDGYTEAFF	TRBV6-4	TRBJ1-1
TGTGCCAGGGGACAGGAAATGACACAAATAGACACTGAAGCTTTCTTT	CARGQEMTQIDTEAFF	TRBV5-6	TRBJ1-1
TGTGCCAGCAGTGACTCCCCGGGGGGGGAAAATGCGCAGTTCTTC	CASSDSPGGENAQFF	TRBV6-4	TRBJ2-1
TGCGCCAGCAGCTTGAAGAAGGGACAGTCAGATACGCAGTATTTT	CASSLKKGQSDTQYF	TRBV5-1	TRBJ2-3
TGTGCCAGCAGCCCCACAGGCTCCTACGAGCAGTACTTC	CASSPTGSYEQYF	TRBV11-3	TRBJ2-7
TGTGCCACCAGTGAGTATAACTACGAGCAGTACTTC	CATSEYNYEQYF	TRBV24-1	TRBJ2-7
TGTGCCAGCAGCCAAGACAAGGGCTCGGGGTACGAGCAGTACTTC	CASSQDKGSGYEQYF	TRBV14	TRBJ2-7
TGCGCCAGCAGCTTGGCCAGTCCGGGACTAGCGGTGGGCGAGCAGTACTTC	CASSLASPGLAVGEQYF	TRBV5-1	TRBJ2-7
TGCAGTGCCCCTTACATCGGGACAGCTTCAGATACGCAGTATTTT	CSAPYIGTASDTQYF	TRBV20-1	TRBJ2-3
TGTGCCACCAGTGATCACACAGGGAACACCGGGGAGCTGTTTTTT	CATSDHTGNTGELFF	TRBV24-1	TRBJ2-2
TGTGCCAGCAGCTTGGGGCAGGGGGCCGGCTATGGCTACACCTTC	CASSLGQGAGYGYTF	TRBV7-4	TRBJ1-2
TGTGCCAGCAGCCAAGATATTAGTTACCGGAATCAGCCCCAGCATTTT	CASSQDISYRNQPQHF	TRBV14	TRBJ1-5
TGTGCCAGCAGCTGGGACGGGGTCTGTGGTCGGGGGGGTAATGAAAAACTGTTTTTT	CASSWDGVCGRGGNEKLFF	TRBV5-6	TRBJ1-4
TGTGCCAGCAGCCAAAAGGGACGCTCCTACGAGCAGTACTTC	CASSQKGRSYEQYF	TRBV7-9	TRBJ2-7
TGTGCCTGGAGTACCCCCTGGACAGGAGGGGTAGCCCTCCACTTT	CAWSTPWTGGVALHF	TRBV30	TRBJ1-6
TGTGCCACCAGCAGAGGACAGGGGGAGTCCTACGAGCAGTACTTC	CATSRGQGESYEQYF	TRBV15	TRBJ2-7
TGTGCCAGCAGTGACATTAAGGGACTAGCGGGAAACAACACAGATACGCAGTATTTT	CASSDIKGLAGNNTDTQYF	TRBV6-4	TRBJ2-3
TGCGCCAGCAGCTCGGTCAGGGGGGATCAGCCCCAGCATTTT	CASSSVRGDQPQHF	TRBV5-1	TRBJ1-5
TGTGCCATCAGTTCCGAAATACAACTAGCGGGAGAGGTTCAGCCCCAGCATTTT	CAISSEIQLAGEVQPQHF	TRBV10-3	TRBJ1-5
TGCGCCAGCAGCTCTCGGGCTAGCGGGCATCTTAGCTACGAGCAGTACTTC	CASSSRASGHLSYEQYF	TRBV5-1	TRBJ2-7
TGTGCCAGCAGCGTAGCAGGGTCGCCGCACTCTGGAAACACCATATATTTT	CASSVAGSPHSGNTIYF	TRBV9	TRBJ1-3
TGTGCCAGCAGTGAAGTCTTTTGGGGTGGGGCCAACGTCCTGACTTTC	CASSEVFWGGANVLTF	TRBV6-1	TRBJ2-6
TGTGCCACCAGTGATGAGTCACCGGGACAGGCTGGAAACACCATATATTTT	CATSDESPGQAGNTIYF	TRBV24-1	TRBJ1-3
TGTGCCAGCAGTTATTGGGCAGTCCGGACCACGAACACCGGGGAGCTGTTTTTT	CASSYWAVRTTNTGELFF	TRBV6-3	TRBJ2-2
TGTGCCAGCTCACACCTTGGGAGGGGCGGGACCTACGAGCAGTACTTC	CASSHLGRGGTYEQYF	TRBV18	TRBJ2-7
TGCAGTGCCGGGGGGGACAGGGCCAATGAAAAACTGTTTTTT	CSAGGDRANEKLFF	TRBV20-1	TRBJ1-4
TGTGCCAGCAGGGACAGGGTCCTGGAAAAACTGTTTTTT	CASRDRVLEKLFF	TRBV7-9	TRBJ1-4
TGTGCCAGCAGGTACGGCAGGTCGGAAAAACTGTTTTTT	CASRYGRSEKLFF	TRBV6-6	TRBJ1-4
TGCGCCAGCAGTTCTCTCTGGGGGACTGAAGCTTTCTTT	CASSSLWGTEAFF	TRBV10-2	TRBJ1-1
TGTGCCAGCAGCCCGCGAAGGCACGACAGTTCTATTCGTTTCCAAGAGACCCAGTACTTC	CASSPRRHDSSIRFQETQYF	TRBV12-4	TRBJ2-5
TGCAGTGCTAGGGTCGCATGGAATTCACCCCTCCACTTT	CSARVAWNSPLHF	TRBV20-1	TRBJ1-6
TGTGCCAGCAGCCATGTCTCAATTGACAGGGGCGTTGCTTTCTTT	CASSHVSIDRGVAFF	TRBV3-1	TRBJ1-1
TGTGCCAGCACCCCCCATAAAAGGGACGGGGACACTGAAGCTTTCTTT	CASTPHKRDGDTEAFF	TRBV27	TRBJ1-1
TGCAGTGCTAGAGATCAAGATAGGGCCATGGCCTACGAGCAGTACTTC	CSARDQDRAMAYEQYF	TRBV20-1	TRBJ2-7
TGTGCCACCAGTGAAGCCTGGTTCGGGACAAAGGCTAACTATGGCTACACCTTC	CATSEAWFGTKANYGYTF	TRBV24-1	TRBJ1-2
TGTGCCACCAGTGAATCACAGTGCATTCGGACTGGGAGACAAGAGACCCAGTACTTC	CATSESQCIRTGRQETQYF	TRBV24-1	TRBJ2-5
TGTGCCACCAGTGAGGGTCAGGGACTCGGGTCCCTGGCCAAAAACATTCAGTACTTC	CATSEGQGLGSLAKNIQYF	TRBV24-1	TRBJ2-4
TGCGCCAGCAGCTTGCCCCTTATGGGGGCCAGCCCCTCCACTGAAGCTTTCTTT	CASSLPLMGASPSTEAFF	TRBV5-1	TRBJ1-1
TGTGCCAGCTTTTTTACAACGACAGACGAGCAGTACTTC	CASFFTTTDEQYF	TRBV12-3	TRBJ2-7
TGTGCCAGCAGCGACCGGGGTAGCACAGATACGCAGTATTTT	CASSDRGSTDTQYF	TRBV27	TRBJ2-3
TGTGCCACCAGTGAACTGGCCCTGCGGGGCAGCAATCAGCCCCAGCATTTT	CATSELALRGSNQPQHF	TRBV24-1	TRBJ1-5
TGTGCCAGCAGCCAAGGAGGTACAGGGGGCAATTCACCCCTCCACTTT	CASSQGGTGGNSPLHF	TRBV3-1	TRBJ1-6
TGTGCCTGGAGTAGGAAACGCCCGGACAGGGGATCTGGAAACACCATATATTTT	CAWSRKRPDRGSGNTIYF	TRBV30	TRBJ1-3
TGTGCCACCATCCGACAGGGATTGAGAGAGACCCAGTACTTC	CATIRQGLRETQYF	TRBV24-1	TRBJ2-5
TGCAGCGCCGGAGTCTGCAATCAGCCCCAGCATTTT	CSAGVCNQPQHF	TRBV29-1	TRBJ1-5
TGTGCCAGCAGCTTCGGTCCTATATACGGGGGGGGGCTACGGAACACCGGGGAGCTGTTTTTT	CASSFGPIYGGGLRNTGELFF	TRBV7-8	TRBJ2-2
TGTGCCTGGACCGGGGTACAGGGCTACGAGCAGTACTTC	CAWTGVQGYEQYF	TRBV30	TRBJ2-7
TGCAGTGCTATACGGACAGGTGGGGAGACCCAGTACTTC	CSAIRTGGETQYF	TRBV20-1	TRBJ2-5
TGTGCCAGCAGTTACTCTCAACAGGGCGGCTCTCGGTATAGCTACGAGCAGTACTTC	CASSYSQQGGSRYSYEQYF	TRBV6-2	TRBJ2-7
TGTGCCAGCCAGGTTGAGACCCAGTACTTC	CASQVETQYF	TRBV6-3	TRBJ2-5
TGTGCCAGCAGTCCGCAGGGAATCCGGGAAGCTTTCTTT	CASSPQGIREAFF	TRBV25-1	TRBJ1-1
TGCGCCAGCAGCTTGCCGCAGGGCTGGTCCTACGAGCAGTACTTC	CASSLPQGWSYEQYF	TRBV5-1	TRBJ2-7
TGTGCCAGCAGTGAAGCCCTTACAGCGTGGAAGCAAGAGACCCAGTACTTC	CASSEALTAWKQETQYF	TRBV6-1	TRBJ2-5
TGCGCCTCTAGTGACAGGGGACGAGGCACTGAAGCTTTCTTT	CASSDRGRGTEAFF	TRBV10-1	TRBJ1-1
TGTGCCAGCAGATGGAGTAATAAATTGAAACAGTCCTACAATGAGCAGTTCTTC	CASRWSNKLKQSYNEQFF	TRBV7-8	TRBJ2-1
TGTGCCAGCAGCCGTCCGGTACAGGGGACAGATACGCAGTATTTT	CASSRPVQGTDTQYF	TRBV3-1	TRBJ2-3
TGTGCCAGCAGCCTGTACCGACAGCGACTTGTCTACAATGAGCAGTTCTTC	CASSLYRQRLVYNEQFF	TRBV14	TRBJ2-1
TGCAGCGTTATGCCCGGGACAGGTTTGAATGAAGCTTTCTTT	CSVMPGTGLNEAFF	TRBV29-1	TRBJ1-1
TGCAGTGCTAGAGATCGCACCAGACTAGCCGAAGAGACCCAGTACTTC	CSARDRTRLAEETQYF	TRBV20-1	TRBJ2-5
TGTGCCAGCAGTTTACTAGCGTACCCGAACACCGGGGAGCTGTTTTTT	CASSLLAYPNTGELFF	TRBV27	TRBJ2-2
TGCGCCAGCAGGCTCGGGCGCTTC	CASRLGRF	TRBV10-1	TRBJ2-7
TGTGCCTGGAGTTCGTTCGGACTAGCGGCCGGTGAGCAGTTCTTC	CAWSSFGLAAGEQFF	TRBV30	TRBJ2-1
TGTGCCAGTAAAAGATGCCGGACAGGCAATCAGCCCCAGCATTTT	CASKRCRTGNQPQHF	TRBV19	TRBJ1-5
TGTGCCAGCAGCGGACCAAGGGACTGGGTTCGGCGTCCTACCGGGGAGCTGTTTTTT	CASSGPRDWVRRPTGELFF	TRBV7-2	TRBJ2-2
TGTGCCTGGAGTCAGGGACTAGATTCCTACAATGAGCAGTTCTTC	CAWSQGLDSYNEQFF	TRBV30	TRBJ2-1
TGCGCCAGCAGTGGGTTTTCCCGGGAGGGTGGCTACACCTTC	CASSGFSREGGYTF	TRBV10-1	TRBJ1-2
TGCAGTGCTAGAGATCCGAACAAGCAGTTCTACGAGCAGTACTTC	CSARDPNKQFYEQYF	TRBV20-1	TRBJ2-7
TGTGCCAGCAGTCCCCACAGGTTTCATCAGCCCCAGCATTTT	CASSPHRFHQPQHF	TRBV27	TRBJ1-5
TGTGCCAGCAGCTTAGCCCCTCCCGTTACCTTGGGGGGGAAACGAAACACCGGGGAGCTGTTTTTT	CASSLAPPVTLGGKRNTGELFF	TRBV7-6	TRBJ2-2
TGTGCCCCGCCACGGGGGGCGGAGCAGTTCTTC	CAPPRGAEQFF	TRBV25-1	TRBJ2-1
TGTGCCAGCAGTCGGTCAGGAGCTTTACAAGAGACCCAGTACTTC	CASSRSGALQETQYF	TRBV7-3	TRBJ2-5
TGTGCCAGCAGCTGGTGTTACGGAAAAGCTGGTAATGAGCAGTTCTTC	CASSWCYGKAGNEQFF	TRBV7-9	TRBJ2-1
TGTGCCAGCAGTTGCGCGATGTCCGGGACTAGCGGGAGGACTGAAGCTTTCTTT	CASSCAMSGTSGRTEAFF	TRBV27	TRBJ1-1
TGTGCCAGCAGCCCACCATTCGGGATCAGAATCGGGTACGAGCAGTACTTC	CASSPPFGIRIGYEQYF	TRBV11-3	TRBJ2-7
TGCGCCAGCACCGGGGGGGCAACCCCAGATACGCAGTATTTT	CASTGGATPDTQYF	TRBV4-1	TRBJ2-3
TGCGCCAGCAGCTCAAACATCAAAGCGACAGCCTACGAGCAGTACTTC	CASSSNIKATAYEQYF	TRBV5-1	TRBJ2-7
TGTGCCACCAGTGATTTCCGACAGGGCCCGAGGACTGTTGGCTACACCTTC	CATSDFRQGPRTVGYTF	TRBV24-1	TRBJ1-2
TGTGCCAGCATCTGGGGGAAAGTAGACCCCGAGTTTTCGGGGGGGTTGAACACTGAAGCTTTCTTT	CASIWGKVDPEFSGGLNTEAFF	TRBV5-8	TRBJ1-1
TGTGCCAGCAGCAAACTAGCGGCTCCAGCCAAAAACATTCAGTACTTC	CASSKLAAPAKNIQYF	TRBV7-9	TRBJ2-4
TGTGCCAGCAGTTTACTAGCGGGAGGGCGTGAGCAGTTCTTC	CASSLLAGGREQFF	TRBV12-4	TRBJ2-1
TGTGCCAGCAGCTTAATGACAGGGACCCCGAAACCAACAAGGGCCAAAAACATTCAGTACTTC	CASSLMTGTPKPTRAKNIQYF	TRBV7-3	TRBJ2-4
TGTGCCAGCAGCCAACCTTCGGGGGGGGGCCGGGACAACACAGATACGCAGTATTTT	CASSQPSGGGRDNTDTQYF	TRBV3-1	TRBJ2-3
TGCAGCGATCTCGACAAAGGGTACCAAGAGACCCAGTACTTC	CSDLDKGYQETQYF	TRBV29-1	TRBJ2-5
TGTGCCAGCAGCTTAAGGTCAAGTAGTCCGGATGGCTACACCTTC	CASSLRSSSPDGYTF	TRBV5-6	TRBJ1-2
TGCGCCAGCAGCTTGCCAGGGCCCTGCATAAACACCATATATTTT	CASSLPGPCINTIYF	TRBV5-1	TRBJ1-3
TGTGCCAGCAGGGACGACACCCAGTACTTC	CASRDDTQYF	TRBV6-3	TRBJ2-5
TGTGCCAGCAGCCGTAACCCTGGGGGGCTTTCCGGCACAGATACGCAGTATTTT	CASSRNPGGLSGTDTQYF	TRBV14	TRBJ2-3
TGTGCCAGCCAGCTTCTACAGGGGTACGGGGAGCTGTTTTTT	CASQLLQGYGELFF	TRBV6-5	TRBJ2-2
TGTGCCAGCAGCCAAAGTTCCGGGACAGACACTGAAGCTTTCTTT	CASSQSSGTDTEAFF	TRBV3-1	TRBJ1-1
TGCGCCAGCAGCCAATTCGGTCACTACGAGCAGTACTTC	CASSQFGHYEQYF	TRBV4-1	TRBJ2-7
TGTGCCAGTAGTATAGATCAGAAGACCCTTGCCGGGACAGGGGGCCTTCATACGCAGTATTTT	CASSIDQKTLAGTGGLHTQYF	TRBV19	TRBJ2-3
TGTGCCAGCGTCGGTGCGGGTCTGCAGTTCTTC	CASVGAGLQFF	TRBV13	TRBJ2-1
TGCAGCGTTAGACGGGCCTCCTACGAGCAGTACTTC	CSVRRASYEQYF	TRBV29-1	TRBJ2-7
TGTGCCAGCAGTTACTCCGACAGGGGGCAAGGGCAACTTGGCTACACCTTC	CASSYSDRGQGQLGYTF	TRBV6-5	TRBJ1-2
TGTGCCAGCAGCGGGCTGGGAGAGGACGGGAGGGCCCTTTGGCGCTATGGCTACACCTTC	CASSGLGEDGRALWRYGYTF	TRBV7-2	TRBJ1-2
TGTGCCAGCAGTTACTGTCTGGACAGGGCGACTCGGGAGCTGTTTTTT	CASSYCLDRATRELFF	TRBV6-5	TRBJ2-2
TGTGCCAGCAGCCAGGGACAGGAAAAACTGTTTTTT	CASSQGQEKLFF	TRBV7-2	TRBJ1-4
TGTGCCAGCAGCGAGGTCAAAAACATTCAGTACTTC	CASSEVKNIQYF	TRBV11-2	TRBJ2-4
TGTGCCAGCAGAGGCAAGACGGTCAGTTTAAGCAATCAGCCCCAGCATTTT	CASRGKTVSLSNQPQHF	TRBV27	TRBJ1-5
TGTGCCAGCATTGGGGACCTGAACACTGAAGCTTTCTTT	CASIGDLNTEAFF	TRBV9	TRBJ1-1
TGCAGTGCTAGACAGGGGACAGTAATTTGCACTGAAGCTTTCTTT	CSARQGTVICTEAFF	TRBV20-1	TRBJ1-1
TGCGCCAGCAGCTTGAACAGGGGGGACACTGAAGCTTTCTTT	CASSLNRGDTEAFF	TRBV5-1	TRBJ1-1
TGTGCCAGCAGCAGAGGACAGGGGCACTGGACACATAATTCACCCCTCCACTTT	CASSRGQGHWTHNSPLHF	TRBV7-9	TRBJ1-6
TGTGCCAGCAGCCACCGCCAGGGGAAAACGGGTGAAGCTTTCTTT	CASSHRQGKTGEAFF	TRBV7-9	TRBJ1-1
TGTGCCAGCAGCTTAGACGAGTATTTTGGTGGGGCCAACGTCCTGACTTTC	CASSLDEYFGGANVLTF	TRBV13	TRBJ2-6
TGTGCCACCCCCTGGCCCCTTGGAAACACCATATATTTT	CATPWPLGNTIYF	TRBV24-1	TRBJ1-3
TGCAAAGGGGACAATGGAAACACCATATATTTT	CKGDNGNTIYF	TRBV20-1	TRBJ1-3
TGTGCCAGCAGTTTATCCCCCTCTTGTACGGGGGGGCGGTTTGGCTACGAGCAGTACTTC	CASSLSPSCTGGRFGYEQYF	TRBV28	TRBJ2-7
TGTGCCAGCAGCCCATGGTGGACAGTCTTC	CASSPWWTVF	TRBV7-3	TRBJ2-1
TGCAGTGCTAGAGCGGGCGGGGGGGCTGAGCAGTTCTTC	CSARAGGGAEQFF	TRBV20-1	TRBJ2-1
TGTGCCAGCAGCTTTAAGATGACAGATTCGGGGAACACCGGGGAGCTGTTTTTT	CASSFKMTDSGNTGELFF	TRBV5-6	TRBJ2-2
TGTGCCAGCGGAAAGAGGCCCATTCAGTACTTC	CASGKRPIQYF	TRBV19	TRBJ2-4
TGTGCCAGCAGTGACCCAGGGCTGGCCACCCAGCCCCAGCATTTT	CASSDPGLATQPQHF	TRBV6-4	TRBJ1-5
TGTGCCAGCAGTTTATTCTGGTTCGGGGAGCTGTTTTTT	CASSLFWFGELFF	TRBV27	TRBJ2-2
TGCAGTGCTAGAGACGGATACGGGGGGGTCACAGATACGCAGTATTTT	CSARDGYGGVTDTQYF	TRBV20-1	TRBJ2-3
TGTGCCAGCAGCATCGAGGGCAGGGTTAATGAGCAGTTCTTC	CASSIEGRVNEQFF	TRBV9	TRBJ2-1
TGTGCCAGCAGCGACTGTCCCCGCCAATTTTTCGAAAAACTGTTTTTT	CASSDCPRQFFEKLFF	TRBV13	TRBJ1-4
TGTGCCAGCAGCTCGGGAGGGCCCTTCGTTACCCAAGGCTACGAGCAGTACTTC	CASSSGGPFVTQGYEQYF	TRBV11-3	TRBJ2-7
TGTGCCAGCAGCTTAAACGGACAGGGACTAGGGGACCCCACTGAAGCTTTCTTT	CASSLNGQGLGDPTEAFF	TRBV7-3	TRBJ1-1
TGTGCCAGCAGCGGTCCCGGAGAGCAAGGAGGGGGGTTCTATGGCTACACCTTC	CASSGPGEQGGGFYGYTF	TRBV5-6	TRBJ1-2
TGTGCCAGCAGCTGGGTCGGGGTGTCCTACAATGAGCAGTTCTTC	CASSWVGVSYNEQFF	TRBV7-9	TRBJ2-1
TGTGCCTGGAGGGAGGACAGGGGAACTCTTAGGGTTTATGGGACCTACGAGCAGTACTTC	CAWREDRGTLRVYGTYEQYF	TRBV30	TRBJ2-7
TGTGCCAGCAGCTTACACTCAGGCCAAATGTACAATGAGCAGTTCTTC	CASSLHSGQMYNEQFF	TRBV7-4	TRBJ2-1
TGTGCCAGCAGCTTAGGACCGGGAGGAGAGGGAGATACGCAGTATTTT	CASSLGPGGEGDTQYF	TRBV7-9	TRBJ2-3
TGTGCCAGCAGTAAAGAGCGAATATGGGAAGAGACCCAGTACTTC	CASSKERIWEETQYF	TRBV28	TRBJ2-5
TGCGCCAGCAGCCAAGATGGTTTGGGACAGGCGGTAAATCAGCCCCAGCATTTT	CASSQDGLGQAVNQPQHF	TRBV4-1	TRBJ1-5
TGTGCCAGCAGTTTTTATGGGCCAGGGGAGTTGAACACTGAAGCTTTCTTT	CASSFYGPGELNTEAFF	TRBV28	TRBJ1-1
TGTGCCAGCAGCCCCTCTTCGGATTTAGACTACGAGCAGTACTTC	CASSPSSDLDYEQYF	TRBV3-1	TRBJ2-7
TGTGCCCCGGGACAGTCACCCAATCAGCCCCAGCATTTT	CAPGQSPNQPQHF	TRBV24-1	TRBJ1-5
TGTGCCAGCAGGAGGGAGATCAGGGGGTCGGCCAACGTCCTGACTTTC	CASRREIRGSANVLTF	TRBV6-3	TRBJ2-6
TGCAGTGCTAGCAGGGGCTATGGCTACACCTTC	CSASRGYGYTF	TRBV20-1	TRBJ1-2
TGCGCCAGCAGTGAGCGGTCAATAGCGGCGGCAGGGGTCACAGATACGCAGTATTTT	CASSERSIAAAGVTDTQYF	TRBV10-1	TRBJ2-3
TGTGCCAGTAGTATAAGAGTAGTGGCCGGGGCCTCCTACGAGCAGTACTTC	CASSIRVVAGASYEQYF	TRBV19	TRBJ2-7
TGTGCCAGCTCACCCGAAGTTTCAGAGACCCAGTACTTC	CASSPEVSETQYF	TRBV18	TRBJ2-5
TGTGCTAGTGGTGGAGGGGGGAATGAAAAACTGTTTTTT	CASGGGGNEKLFF	TRBV12-5	TRBJ1-4
TGTGCCAGCAGTTACTCGGGGCAGGGGGCAAAGCAAGAGACCCAGTACTTC	CASSYSGQGAKQETQYF	TRBV6-5	TRBJ2-5
TGTGCCAGCAGCCTAGCGGGGGACGAGCAGTACTTC	CASSLAGDEQYF	TRBV7-9	TRBJ2-7
TGTGCCAGTAGTATAGATAGTACAACGTCACCCCTCCACTTT	CASSIDSTTSPLHF	TRBV19	TRBJ1-6
TGTGCCAGCAGCAAAAGGGGGCTTATTGAGACCCAGTACTTC	CASSKRGLIETQYF	TRBV13	TRBJ2-5
TGTGCCAGCAGTTATCGGGGTGACAGGGAGAACACTGAAGCTTTCTTT	CASSYRGDRENTEAFF	TRBV6-9	TRBJ1-1
TGTGCCAGCAGTTACTATACCTCTGGAAACACCATATATTTT	CASSYYTSGNTIYF	TRBV6-2	TRBJ1-3
TGTGCCAGCCCTCCGGGACAGGGAGGAGGCTCCTACGAGCAGTACTTC	CASPPGQGGGSYEQYF	TRBV27	TRBJ2-7
TGTGCTAGCCACCTGGTCTCCTACGAGCAGTACTTC	CASHLVSYEQYF	TRBV12-5	TRBJ2-7
TGTGCCAGCAGCTTGAGGGAGAGCACAGATACGCAGTATTTT	CASSLRESTDTQYF	TRBV6-1	TRBJ2-3
TGCAGCGTACGGGACATTGCAACTAATGAAAAACTGTTTTTT	CSVRDIATNEKLFF	TRBV29-1	TRBJ1-4
TGTGCCACCAGTGAGGTACCCGCCCCCTTATCATTCTTAAAGCCAGAGCAGTTCTTC	CATSEVPAPLSFLKPEQFF	TRBV24-1	TRBJ2-1
TGTGCCAGCAGTTTATCCCTACTAGCGGGAGCAAGCACAGATACGCAGTATTTT	CASSLSLLAGASTDTQYF	TRBV12-4	TRBJ2-3
TGTGCCAGCAGCAAGACAGGTCCTGGCTACGAGCAGTACTTC	CASSKTGPGYEQYF	TRBV7-3	TRBJ2-7
TGTGCCAGCATATGGGGGGTTATTTCCTACGAGCAGTACTTC	CASIWGVISYEQYF	TRBV9	TRBJ2-7
TGCGCCAGCAGTGGGAGGGCCAACACCGGGGAGCTGTTTTTT	CASSGRANTGELFF	TRBV10-1	TRBJ2-2
TGTGCCAGCAGCCCGAGGGCAGGGGGCGCTGCCTACAATGAGCAGTTCTTC	CASSPRAGGAAYNEQFF	TRBV13	TRBJ2-1
TGTGCCACAAGCCAGGATCAGCCCCAGCATTTT	CATSQDQPQHF	TRBV6-1	TRBJ1-5
TGTGCCAGCAGCTACCGTTCGGGACTAGCGGGGCGCACAGATACGCAGTATTTT	CASSYRSGLAGRTDTQYF	TRBV7-9	TRBJ2-3
TGTGCCAGCAGCTTAACCTCCGGCTCTAGCGGGCCTAGCTCTGGGGCCAACGTCCTGACTTTC	CASSLTSGSSGPSSGANVLTF	TRBV11-2	TRBJ2-6
TGTGCCAGCAGCCAAACGGCTAGCGGGGGGCCATCCGAGCAGTACTTC	CASSQTASGGPSEQYF	TRBV13	TRBJ2-7
TGTGCCAGCAGCCAAGGACCGTCTGAAAAACTGTTTTTT	CASSQGPSEKLFF	TRBV14	TRBJ1-4
TGTGCCTGGAGTAGTCTCTCGGCCTACGAGCAGTACTTC	CAWSSLSAYEQYF	TRBV30	TRBJ2-7
TGTGCCAGCAGCGCGAAGGGCTTGTGCGAGCAGTACTTC	CASSAKGLCEQYF	TRBV13	TRBJ2-7
TGTGCCAGCTCACCTGGCCCTAGCGGCTACGAGCAGTACTTC	CASSPGPSGYEQYF	TRBV18	TRBJ2-7
TGTGCCAGCAGCAACCGAGCTAGTCAGAGGGGGGGGAGCTCCTACGAGCAGTACTTC	CASSNRASQRGGSSYEQYF	TRBV9	TRBJ2-7
TGTGCCAGCAGTGAAGGGGGCGGAGGACAAGCTACTGAGCAGTACTTC	CASSEGGGGQATEQYF	TRBV6-5	TRBJ2-7
TGTGCCATCAGTGAGTGCACTAGCGGGAGGACTTTAGGTGGAAACACCATATATTTT	CAISECTSGRTLGGNTIYF	TRBV10-3	TRBJ1-3
TGTGCCAGCAGTAGGGGACATTCTTTGTATAATTCACCCCTCCACTTT	CASSRGHSLYNSPLHF	TRBV6-1	TRBJ1-6
TGTGCCAGCAGCTTAGACAGAGGGGCATTGCGGAGAATGAACACTGAAGCTTTCTTT	CASSLDRGALRRMNTEAFF	TRBV11-2	TRBJ1-1
