TGTGCCAGCAGCCCAAGGGGACAGGGTTTCAGTAGCAATCAGCCCCAGCATTTT	CASSPRGQGFSSNQPQHF	TRBV13	TRBJ1-5
TGTGCCAGCAGCCAAGACCAAGTGACTAGCGGGAGGGTCTCCTACGAGCAGTACTTC	CASSQDQVTSGRVSYEQYF	TRBV3-1	TRBJ2-7
TGTGCCAGCAGCACCGGAGGGGGTGATGGAGCATACGAGCAGTACTTC	CASSTGGGDGAYEQYF	TRBV9	TRBJ2-7
TGTGCCAGCAGCCATCGGAGGGGACAAGGCTACACCTTC	CASSHRRGQGYTF	TRBV14	TRBJ1-2
TGTGCCAGCAGCTTAGGGAACGGGGGGGGAGGCTACACCTTC	CASSLGNGGGGYTF	TRBV7-9	TRBJ1-2
TGTGCCAGCAGCCATCGGACTAAGCTGTACAATGAGCAGTTCTTC	CASSHRTKLYNEQFF	TRBV5-6	TRBJ2-1
TGTGCCAGCAGGCCAACAGTCCTCGTTCGCTACGAGCAGTACTTC	CASRPTVLVRYEQYF	TRBV6-4	TRBJ2-7
TGTGCCAGCAGCTTGGACCGTTCAATGAACACTGAAGCTTTCTTT	CASSLDRSMNTEAFF	TRBV5-6	TRBJ1-1
TGTGCCAGCAGCTTAGCGCAAATTCAGGGCTATGGCTACACCTTC	CASSLAQIQGYGYTF	TRBV7-9	TRBJ1-2
TGTGCCAGCAGTGACCTTCCGCGGGAGTCACCCCTCCACTTT	CASSDLPRESPLHF	TRBV6-4	TRBJ1-6
TGTGCCAGCAGCGACAGGGGAATCTCTGGAAACACCATATATTTT	CASSDRGISGNTIYF	TRBV9	TRBJ1-3
TGTGCCAGCAGTTTCAATGGGGGGGCCAACACCGGGGAGCTGTTTTTT	CASSFNGGANTGELFF	TRBV27	TRBJ2-2
TGTGCCAGCAGCTGGGGGAGAGGGACAGGGTGGTACAATGAGCAGTTCTTC	CASSWGRGTGWYNEQFF	TRBV7-9	TRBJ2-1
TGCAGTGCTAGAGATCCGGGGGGTGCTATAGGGTTTGATACGCAGTATTTT	CSARDPGGAIGFDTQYF	TRBV20-1	TRBJ2-3
TGCGCCAGCAGCTTATTCGGGAACATTAGGGGATTAGCCAAAAACATTCAGTACTTC	CASSLFGNIRGLAKNIQYF	TRBV5-1	TRBJ2-4
TGCGCCAGCAGCTTCCCCGCGGGGGGGACGATGGAGACCCAGTACTTC	CASSFPAGGTMETQYF	TRBV5-1	TRBJ2-5
TGCGCCAGCAGCTGGACGATCGAGGATCAGCCCCAGCATTTT	CASSWTIEDQPQHF	TRBV5-1	TRBJ1-5
TGTGCCAGCAGTACTTCCCAGACCGGGACAGGGTACGGGTGCAATCAGCCCCAGCATTTT	CASSTSQTGTGYGCNQPQHF	TRBV6-2	TRBJ1-5
TGTGCCAGCATTTACAGGGGGCTAGCTTTCTTT	CASIYRGLAFF	TRBV13	TRBJ1-1
TGTGCCAGCAGCTTTAGCGGGTGCTCCTACAATGAGCAGTTCTTC	CASSFSGCSYNEQFF	TRBV11-3	TRBJ2-1
TGTGCCAGCACGAGACAACTTCCGAACCCCACTGAAGCTTTCTTT	CASTRQLPNPTEAFF	TRBV6-6	TRBJ1-1
TGTGCCAGCAGTTTATTGAGGGTTCTTGAAAAACTGTTTTTT	CASSLLRVLEKLFF	TRBV27	TRBJ1-4
TGCAGTGCTTCCTTAGGGACAGACCAAGGATCTGCAACTAATGAAAAACTGTTTTTT	CSASLGTDQGSATNEKLFF	TRBV20-1	TRBJ1-4
TGTGCCAGCAGCTTAGGCAGCACACACCGGGACTATGGCTACACCTTC	CASSLGSTHRDYGYTF	TRBV7-6	TRBJ1-2
TGTGCCAGCAGTGCAAGGACCATCAATCAGCCCCAGCATTTT	CASSARTINQPQHF	TRBV27	TRBJ1-5
TGTGCCAGCAGTTACCAGACGAGGAGTAACACTGAAGCTTTCTTT	CASSYQTRSNTEAFF	TRBV27	TRBJ1-1
TGTGCCAGCAGTGGGAACTCCCTCGGGAGGGGGGCCACTGAACTAGCCAAAAACATTCAGTACTTC	CASSGNSLGRGATELAKNIQYF	TRBV11-3	TRBJ2-4
TGTGCCAGCAGTTTAGAGATGTACCGAGGCTACGGCTACTTACAGCCCCAGCATTTT	CASSLEMYRGYGYLQPQHF	TRBV27	TRBJ1-5
TGTGCCAGTAGTATAGAAGCCGGGACAGTTAGATCGAACACTGAAGCTTTCTTT	CASSIEAGTVRSNTEAFF	TRBV19	TRBJ1-1
TGTGCTAGTGGTACCCCCTCCCCCTTACCGGGACAGGGGACTGGGGCCAACGTCCTGACTTTC	CASGTPSPLPGQGTGANVLTF	TRBV12-5	TRBJ2-6
TGTGCCAGCAGCTTTTGGTCGGCCGGGAAATCCTATAATTCACCCCTCCACTTT	CASSFWSAGKSYNSPLHF	TRBV7-4	TRBJ1-6
TGTGCCAGCAGCTCACCAGCGGGAGGGAGTTCTAACTATGGCTACACCTTC	CASSSPAGGSSNYGYTF	TRBV11-2	TRBJ1-2
TGTGCCAGCAGTGACTCACCCCAGGGGATGTTGTGGCGCAATCAGCCCCAGCATTTT	CASSDSPQGMLWRNQPQHF	TRBV6-4	TRBJ1-5
TGTGCCAGCAGCCCAGGGACAGGCGGGGAGCTGTTTTTT	CASSPGTGGELFF	TRBV11-3	TRBJ2-2
TGTGCAAGGACAGGGGTCTCTGGGGCCAACGTCCTGACTTTC	CARTGVSGANVLTF	TRBV7-9	TRBJ2-6
TGTGCCAGCAGCTTATATGGGCCCGGGACAGGTCGAAGTACCAATCAGCCCCAGCATTTT	CASSLYGPGTGRSTNQPQHF	TRBV7-9	TRBJ1-5
TGTGCCAGCAGCCCGAGCTCCCGTCGTCTCTCCTACGAGCAGTACTTC	CASSPSSRRLSYEQYF	TRBV7-3	TRBJ2-7
TGTGCCAGCAGCTTAGGGGGGGAGCCCACAGATACGCAGTATTTT	CASSLGGEPTDTQYF	TRBV13	TRBJ2-3
TGTGCCAGCAGCCAGGGCCCAGCGAACACTGAAGCTTTCTTT	CASSQGPANTEAFF	TRBV7-3	TRBJ1-1
TGCGCCAGCAGTGGGTTCAGGTATAGCAATCAGCCCCAGCATTTT	CASSGFRYSNQPQHF	TRBV10-1	TRBJ1-5
TGCGCCAGCAGCCAAGAGCTATCCGGGGACTCCGTAGAGACCCAGTACTTC	CASSQELSGDSVETQYF	TRBV4-3	TRBJ2-5
TGTGCCAGCAGTTACACGGGGGGCGGGGAGATCTACAATGAGCAGTTCTTC	CASSYTGGGEIYNEQFF	TRBV6-2	TRBJ2-1
TGCGCCAGCAGCCACGTGACAGGGAGGTGGTGCAATCAGCCCCAGCATTTT	CASSHVTGRWCNQPQHF	TRBV4-1	TRBJ1-5
TGTGCCAGCAGTCCGGTGAGCGACACTGAAGCTTTCTTT	CASSPVSDTEAFF	TRBV6-5	TRBJ1-1
TGTGCCAGCAGCCTCCTCGCCACCGGGGAGCTGTTTTTT	CASSLLATGELFF	TRBV13	TRBJ2-2
TGTGCCAGACGGTCGGGAGGTACGGAGCAGTACTTC	CARRSGGTEQYF	TRBV6-8	TRBJ2-7
TGCAGTGCTAGACCTTACGACAGGGTTATGGAACTGTTTTTT	CSARPYDRVMELFF	TRBV20-1	TRBJ1-4
TGCACCGGAGTCCGCGGGGGGCCGTGTACGCAGTATTTT	CTGVRGGPCTQYF	TRBV20-1	TRBJ2-3
TGTGCCAGCAGCTTGGGGGAGGGGAACAAAAACATTCAGTACTTC	CASSLGEGNKNIQYF	TRBV5-4	TRBJ2-4
TGTGCCAGCAGCTTACCCCGGACAGGGTCCACTGAAGCTTTCTTT	CASSLPRTGSTEAFF	TRBV11-3	TRBJ1-1
TGCGCCAGCAGCAACAGGGGGCGGGATGGCTACACCTTC	CASSNRGRDGYTF	TRBV5-1	TRBJ1-2
TGCGCCAGGCTAGACCTGGGATACCTCACAGATACGCAGTATTTT	CARLDLGYLTDTQYF	TRBV10-1	TRBJ2-3
TGTGCCAGCAGCTCTGCCCGGGGGAGCTCCTATAATTCACCCCTCCACTTT	CASSSARGSSYNSPLHF	TRBV7-9	TRBJ1-6
TGTGCCACCAGTGATTTGAGACTCCTCAATACAGCTCTTGAAGCTTTCTTT	CATSDLRLLNTALEAFF	TRBV24-1	TRBJ1-1
TGTGCCAGCATACAAGGGGGGAGGGATAGCAATCAGCCCCAGCATTTT	CASIQGGRDSNQPQHF	TRBV11-3	TRBJ1-5
TGCAGTGCTAGAGTGTCTAGGGGAGAGACCCAGTACTTC	CSARVSRGETQYF	TRBV20-1	TRBJ2-5
TGTGCCAGCAGTGACAATATCAAACTAGAGGGTGGGAGGGGGTACCAAGAGACCCAGTACTTC	CASSDNIKLEGGRGYQETQYF	TRBV6-4	TRBJ2-5
TGTGCCAGCAGCTGTCTTATGGACAGGGCCTATGGCTACACCTTC	CASSCLMDRAYGYTF	TRBV7-8	TRBJ1-2
TGTGCCAGCTGGGATGCGACAGATGTCTACGAGCAGTACTTC	CASWDATDVYEQYF	TRBV9	TRBJ2-7
TGTGCCACCAGCTTGAGACCCTCCTACGAGCAGTACTTC	CATSLRPSYEQYF	TRBV15	TRBJ2-7
TGTGCCAGCAGCAGCCTTTCGGACAGGGGAGGGGGCGAAAAACTGTTTTTT	CASSSLSDRGGGEKLFF	TRBV7-9	TRBJ1-4
TGTGCCAGGGCTAGGGTTAGGGGACCGTCCTGCCTCTATGGCTACACCTTC	CARARVRGPSCLYGYTF	TRBV6-2	TRBJ1-2
TGTGCCAGCAGTTTACTGGACTGGAGGGATACGCAGTATTTT	CASSLLDWRDTQYF	TRBV28	TRBJ2-3
TGTGCCACCAGCAGAGCTTCGACAGGGGATAGCCTGGTCGAGCAGTACTTC	CATSRASTGDSLVEQYF	TRBV15	TRBJ2-7
TGCGCCAGCAGCCCGAAATTGGGGACCTCTAGCACAGATACGCAGTATTTT	CASSPKLGTSSTDTQYF	TRBV5-1	TRBJ2-3
TGTGCCAGCAGTAACAGGGAGTTTTTTAATTCACCCCTCCACTTT	CASSNREFFNSPLHF	TRBV6-4	TRBJ1-6
TGTGCCAGCCAAGGACAGGACACTGAAGCTTTCTTT	CASQGQDTEAFF	TRBV5-6	TRBJ1-1
TGTGCCAGCAGAGGAGGAGTAAAATCCTACAATGAGCAGTTCTTC	CASRGGVKSYNEQFF	TRBV12-3	TRBJ2-1
TGCGCCAGCAGGTCTAAACAGGGGGCCTGGGCTGAAGCTTTCTTT	CASRSKQGAWAEAFF	TRBV10-1	TRBJ1-1
TGTGCCAGCAGTAAAACCAGTGTTTCTAGCGGGCGGGACAATGAGCAGTTCTTC	CASSKTSVSSGRDNEQFF	TRBV12-4	TRBJ2-1
TGTGCCAGCAGTGAAAACGGGGGGGTCTCTGGCTACACCTTC	CASSENGGVSGYTF	TRBV6-1	TRBJ1-2
TGTGCCAGCAGCTTAGTTAGGATTTGGGCAGAGCAGTACTTC	CASSLVRIWAEQYF	TRBV7-9	TRBJ2-7
TGTGCCGAAGCGGGAAGGAACGATACGCAGTATTTT	CAEAGRNDTQYF	TRBV6-4	TRBJ2-3
TGCAGTGCTAGTCGAAAAGCCGGGGAGGGAGGTGCCTACGAGCAGTACTTC	CSASRKAGEGGAYEQYF	TRBV20-1	TRBJ2-7
TGTGACCGACAGGGCCATAAAGATACGCAGTATTTT	CDRQGHKDTQYF	TRBV14	TRBJ2-3
TGTGCCAGCAGTTTAGTCAATCAAATCAAGCCCTCCTACAATGAGCAGTTCTTC	CASSLVNQIKPSYNEQFF	TRBV12-4	TRBJ2-1
TGTGCCAGCAGTCAAGGGGGGCGATATCAGCCCCAGCATTTT	CASSQGGRYQPQHF	TRBV6-4	TRBJ1-5
TGTGCCAGCAGTGATAGACACTACAATGAGCAGTTCTTC	CASSDRHYNEQFF	TRBV25-1	TRBJ2-1
TGTGCCAGCAGCTTTGGCCGGGACAGCGGCTCACCCCTCCACTTT	CASSFGRDSGSPLHF	TRBV7-9	TRBJ1-6
TGTGCCAGCAGTGAAGGAACGGAGAAGTTACCACCCCTCCACTTT	CASSEGTEKLPPLHF	TRBV2	TRBJ1-6
TGTGCCAGCAGCCAAGATTCGAACCACAGGGTGTCAACCAATGAGCAGTTCTTC	CASSQDSNHRVSTNEQFF	TRBV3-1	TRBJ2-1
TGTGCCAGCAGCTTACTGACAGGGAGATCGGATAGCTCCTACGAGCAGTACTTC	CASSLLTGRSDSSYEQYF	TRBV7-6	TRBJ2-7
TGTGCTAGTGGTTTGTGGGCTACAGGGAGAGTCTCTGGAAACACCATATATTTT	CASGLWATGRVSGNTIYF	TRBV12-5	TRBJ1-3
TGCGCCAGCAGCTCGGGTTCCGAGCACATGAACACTGAAGCTTTCTTT	CASSSGSEHMNTEAFF	TRBV5-1	TRBJ1-1
TGTGCCACCAGTGATGGGGGACCACATCAGCCCCAGCATTTT	CATSDGGPHQPQHF	TRBV24-1	TRBJ1-5
TGTGCCAGCTCACCAAAAATAGAGGGGGACTATACCACCGGGGAGCTGTTTTTT	CASSPKIEGDYTTGELFF	TRBV18	TRBJ2-2
TGTGCCACCCTATTTGACGGAGAATGGCCGGAGACCCAGTACTTC	CATLFDGEWPETQYF	TRBV24-1	TRBJ2-5
TGTGCCAGCTACAGGGGCTGTGCAACTAATGAAAAACTGTTTTTT	CASYRGCATNEKLFF	TRBV28	TRBJ1-4
TGTGCCCACCGGGACAGAGTCGTAAGCTCCTACGAGCAGTACTTC	CAHRDRVVSSYEQYF	TRBV2	TRBJ2-7
TGTGCCAGCAGCGCTAGCGGGGGGGCTACGCAGTATTTT	CASSASGGATQYF	TRBV5-8	TRBJ2-3
TGCGCCAGCAGCTTGGGAATGACAGTAGATAACAATGAGCAGTTCTTC	CASSLGMTVDNNEQFF	TRBV5-1	TRBJ2-1
TGTGCCAGCAGTCCCCGGGGACAGGGACACTATAATTCACCCCTCCACTTT	CASSPRGQGHYNSPLHF	TRBV27	TRBJ1-6
TGTGCCAGCAGAAGCAGGCAGGGGGGAGCTGAAGCTTTCTTT	CASRSRQGGAEAFF	TRBV11-3	TRBJ1-1
TGTGCCAGACCCCCCTGTCCCGGGACAGGGGGAGGACAGGAGCCCCAGCATTTT	CARPPCPGTGGGQEPQHF	TRBV6-2	TRBJ1-5
TGTGCCAGCCCCACAAGACAGGGAATAGCCAAAAACATTCAGTACTTC	CASPTRQGIAKNIQYF	TRBV6-1	TRBJ2-4
TGTGCCAGCAGCTTGGAGGAATCGCGGGCGCTCAATCAGCCCCAGCATTTT	CASSLEESRALNQPQHF	TRBV5-6	TRBJ1-5
TGTGCCAGTAGGACCTCTAGGGTCTACGAGCAGTACTTC	CASRTSRVYEQYF	TRBV19	TRBJ2-7
TGTGCCAGCAGTGAAAAGGCCAGGGGGCGGTTTGCCTACGAGCAGTACTTC	CASSEKARGRFAYEQYF	TRBV25-1	TRBJ2-7
TGTGCCAGCAGGAAGCGTACAGATACGCAGTATTTT	CASRKRTDTQYF	TRBV7-9	TRBJ2-3
TGTGCCACCAGTGAAGGGTTCGGGAGCCCAGATACTCAGCCCCAGCATTTT	CATSEGFGSPDTQPQHF	TRBV24-1	TRBJ1-5
TGTGCCAGCAGCGACCCCCACAGGGACTATGGCTACACCTTC	CASSDPHRDYGYTF	TRBV7-3	TRBJ1-2
TGTGCCAGCAGTTCCATGAAGGCAGGGGTTAAGGATGGCTACACCTTC	CASSSMKAGVKDGYTF	TRBV6-3	TRBJ1-2
TGCAGTGCTAGGGCCCGAGGGGGCAAAGGGCAGTACTTC	CSARARGGKGQYF	TRBV20-1	TRBJ2-7
TGTGCCTGGAGTGTACTTCGGGCCGGACTAGCGGGGGGTGCCTACAATGAGCAGTTCTTC	CAWSVLRAGLAGGAYNEQFF	TRBV30	TRBJ2-1
TGCAGCGTTCCAACACCAGATCAGCCCCAGCATTTT	CSVPTPDQPQHF	TRBV29-1	TRBJ1-5
TGCAGTGCTAGAGCCCGGGGGGGTATACCGCAGTTCTTC	CSARARGGIPQFF	TRBV20-1	TRBJ2-1
TGCAGTGCTAGACAGGTAACAGGGGCGATGCAGTTCTTC	CSARQVTGAMQFF	TRBV20-1	TRBJ2-1
TGTGCCAGCTCAAAAAGGACAATGCCATTCTCCTACGAGCAGTACTTC	CASSKRTMPFSYEQYF	TRBV18	TRBJ2-7
TGTGCCTGGAGTGGGATGCAGGGCAACTATGGCTACACCTTC	CAWSGMQGNYGYTF	TRBV30	TRBJ1-2
TGTGCCAGCAGTTTATTGACAGGCCCGGCCTACGAGCAGTACTTC	CASSLLTGPAYEQYF	TRBV27	TRBJ2-7
TGTGCCAGCAGCCACAGAGCGGGACAGGGTTTGAAAGGCTACACCTTC	CASSHRAGQGLKGYTF	TRBV14	TRBJ1-2
TGCAGTGCTAGACAGGAGTCCAATGAGCAGTTCTTC	CSARQESNEQFF	TRBV20-1	TRBJ2-1
TGTGCCACCAGCCCAAGGTCCGGGACAGCGCCGAGCACCGGGGAGCTGTTTTTT	CATSPRSGTAPSTGELFF	TRBV24-1	TRBJ2-2
TGTGCCATCAGGGGGACAGGGATGGAGGGTAACCCGATAATAATACAGTCACCCCTCCACTTT	CAIRGTGMEGNPIIIQSPLHF	TRBV10-3	TRBJ1-6
TGTGCCAGCAGTACGAGCAGGGGGGGAGTCAATCAGCCCCAGCATTTT	CASSTSRGGVNQPQHF	TRBV6-2	TRBJ1-5
TGCGCCAGTCAGGGGGCGCCAAGTTCCGATACGCAGTATTTT	CASQGAPSSDTQYF	TRBV10-1	TRBJ2-3
TGTGCCAGCAGCTGGATGGAGCAGTACTTC	CASSWMEQYF	TRBV28	TRBJ2-7
TGTGCCAGCAGCCGCATGGGTGAGTATAAAGGCGAGCAGTACTTC	CASSRMGEYKGEQYF	TRBV13	TRBJ2-7
TGTGCCAGCAGTCGGGGAGGGGTGCTAGGGAGCAATCAGCCCCAGCATTTT	CASSRGGVLGSNQPQHF	TRBV6-1	TRBJ1-5
TGTGCCAGCAGCTCCAATCCGGACAGGGACGGCAATCAGCCCCAGCATTTT	CASSSNPDRDGNQPQHF	TRBV7-4	TRBJ1-5
TGTGCCAGCAGTGGCATTGGGGTCACGCCGTACTTC	CASSGIGVTPYF	TRBV25-1	TRBJ2-7
TGTGCCAGAAGTTTCAGGGGAGACTCCTACGAGCAGTACTTC	CARSFRGDSYEQYF	TRBV6-4	TRBJ2-7
TGTGCCAGCTCGGCCGTAAATTCACCCCTCCACTTT	CASSAVNSPLHF	TRBV5-4	TRBJ1-6
TGTGCCAGCAGCAGTGATCTGAACACTGAAGCTTTCTTT	CASSSDLNTEAFF	TRBV12-3	TRBJ1-1
TGTGCCAGCAGTACCGGGACAGGGGTCGGGAAAAGAAACACCATATATTTT	CASSTGTGVGKRNTIYF	TRBV27	TRBJ1-3
TGCGCCAGCAGTGAGCACGGGGGCCCCGGTGCGCAGTTCTTC	CASSEHGGPGAQFF	TRBV10-2	TRBJ2-1
TGCAGCGATTCAGGGGGGCGACGGGTTGCAACTAATGAAAAACTGTTTTTT	CSDSGGRRVATNEKLFF	TRBV29-1	TRBJ1-4
TGTGCCAGCAGCAATCAGGGTTATAACACCGGGGAGCTGTTTTTT	CASSNQGYNTGELFF	TRBV6-4	TRBJ2-2
TGTGCCACCAGTGATGCGACGGATAGTGATGGCTACACCTTC	CATSDATDSDGYTF	TRBV24-1	TRBJ1-2
TGTGCCAGCCCCCACCAGGGGGCGCCCCAGCATTTT	CASPHQGAPQHF	TRBV27	TRBJ1-5
TGTGCCAGCCCGACGGGGACAGGGCTTGGCACCGGGGAGCTGTTTTTT	CASPTGTGLGTGELFF	TRBV7-3	TRBJ2-2
TGTGCCGGTCCCCCAGCCGGGACAGGGGAATACGGCGGGTTTTCACCCCTCCACTTT	CAGPPAGTGEYGGFSPLHF	TRBV19	TRBJ1-6
TGTGCCATCACTACAGGGTGGTACAGGACGTATGGCTACACCTTC	CAITTGWYRTYGYTF	TRBV10-3	TRBJ1-2
TGTGCCAGCAGCTTACACCGCAGGGACAGGGAGTTTGAAGCTTTCTTT	CASSLHRRDREFEAFF	TRBV7-9	TRBJ1-1
TGTGCCAGCAGCGGACTAGCGGGACAACCTTACACAGATACGCAGTATTTT	CASSGLAGQPYTDTQYF	TRBV4-2	TRBJ2-3
TGTGCCTGGAAGTCGGGACAGGGGTTTCCCTACGAGCAGTACTTC	CAWKSGQGFPYEQYF	TRBV30	TRBJ2-7
TGTGCCAGCAGCGAGGTCACAGGGACCGGGGAGCTGTTTTTT	CASSEVTGTGELFF	TRBV9	TRBJ2-2
TGTGCCAGCAGCCCGTGGCCCGGGACTAACGGTGACTCCTACAATGAGCAGTTCTTC	CASSPWPGTNGDSYNEQFF	TRBV14	TRBJ2-1
TGTGCCACAGTACAGGAGACAGTAAAATCGGCCTACGAGCAGTACTTC	CATVQETVKSAYEQYF	TRBV28	TRBJ2-7
TGTGCCACCAGTGATTGGAAAGGTAAGAGCGCTCAGAATCAGCCCCAGCATTTT	CATSDWKGKSAQNQPQHF	TRBV24-1	TRBJ1-5
TGTGCCAGCAGCTGCCTCCAACCGGGATTTGTCAATCAGCCCCAGCATTTT	CASSCLQPGFVNQPQHF	TRBV7-4	TRBJ1-5
TGTGCCAGCAGTGAATGGCCCTCCGCTTCCTCCTACAATGAGCAGTTCTTC	CASSEWPSASSYNEQFF	TRBV25-1	TRBJ2-1
TGTGCCTGGAGCCCTCGGACAGTCCGGCACTTC	CAWSPRTVRHF	TRBV30	TRBJ2-7
TGCGCCAACAGGCCCGGGACAGGTGGAGGGAATAGCAATCAGCCCCAGCATTTT	CANRPGTGGGNSNQPQHF	TRBV4-3	TRBJ1-5
TGTGCTAGTGGTTTGGTAGTAGAGGTCTTGGGGGGGTCTTCTGATGAGCAGTTCTTC	CASGLVVEVLGGSSDEQFF	TRBV12-5	TRBJ2-1
TGTGCCAGCAGCGTTAGGGCACCGAGCAATCAGCCCCAGCATTTT	CASSVRAPSNQPQHF	TRBV9	TRBJ1-5
TGTGCCAGCAGCCCTAGTGGGGGGCGGAGGAACACCGGGGAGCTGTTTTTT	CASSPSGGRRNTGELFF	TRBV14	TRBJ2-2
TGTGCCAGCATCTCCCAGGAGGGGAAGGGGGCCAAAAACATTCAGTACTTC	CASISQEGKGAKNIQYF	TRBV6-5	TRBJ2-4
TGCGCCAGCAGCCACCACATGGCGGGAGGCTACAATGAGCAGTTCTTC	CASSHHMAGGYNEQFF	TRBV4-1	TRBJ2-1
TGTGCCAGTAGTATCCCCTTCCTTGGACCTTCTCACACTGAAGCTTTCTTT	CASSIPFLGPSHTEAFF	TRBV19	TRBJ1-1
TGTGCCAGCAGTTGGACCGGGACAGGGGGTGAAAAACTGTTTTTT	CASSWTGTGGEKLFF	TRBV27	TRBJ1-4
TGCAGCGTGTGTACAGGGGGCGCAGGTACGCAGTATTTT	CSVCTGGAGTQYF	TRBV29-1	TRBJ2-3
TGTGCCAGCAGCCCCAAGTCCGAAGACACTGAAGCTTTCTTT	CASSPKSEDTEAFF	TRBV7-3	TRBJ1-1
TGTGCCAGCAGCCCGGGACAGTATTGGATTGGCTACACCTTC	CASSPGQYWIGYTF	TRBV13	TRBJ1-2
TGTGCCAGCTCACTGCGCATAATGCAGGGGGCGATCTATGGCTACACCTTC	CASSLRIMQGAIYGYTF	TRBV18	TRBJ1-2
TGTGCCAGCAGCTTAACTAGCGGGGGGGCGAGTGGAGAACGCACAGATACGCAGTATTTT	CASSLTSGGASGERTDTQYF	TRBV7-9	TRBJ2-3
TGTGCCAGCAGCAACCCCTCGACTAGCCGTAGCTCCTACAATGAGCAGTTCTTC	CASSNPSTSRSSYNEQFF	TRBV7-9	TRBJ2-1
TGTGCCAGTGAAAGGGCGACAGGGGGGACTAACTATGGCTACACCTTC	CASERATGGTNYGYTF	TRBV19	TRBJ1-2
TGCGCCAGCAATCCCCTGACTAGCATTGGTACCCGGACAGCTTCCTACGAGCAGTACTTC	CASNPLTSIGTRTASYEQYF	TRBV10-1	TRBJ2-7
TGTGCCAGCAGCTTCCTCTGCCTTACTAGCGGTCTTAGCTCCTACAATGAGCAGTTCTTC	CASSFLCLTSGLSSYNEQFF	TRBV7-2	TRBJ2-1
TGTGCCAGCAGTAGGACGGAGAGGGCCCAGCTATACAATGAGCAGTTCTTC	CASSRTERAQLYNEQFF	TRBV28	TRBJ2-1
TGTGCCAGCAGCAAATCTACTAGCGGGAGCGAGGATACGCAGTATTTT	CASSKSTSGSEDTQYF	TRBV9	TRBJ2-3
TGTGCCAGCAGTGAAGACAGATCCTACAATGAGCAGTTCTTC	CASSEDRSYNEQFF	TRBV6-1	TRBJ2-1
TGCAGTGCTAGGATACCCCCACGCCTGAACACTGAAGCTTTCTTT	CSARIPPRLNTEAFF	TRBV20-1	TRBJ1-1
TGTGCCAGCAGTTTAAAGTCAACGGAACGCTCCGAGAACGAGCAGTACTTC	CASSLKSTERSENEQYF	TRBV12-4	TRBJ2-7
TGTGCCAGCAGGGCAGATTCACCCCTCCACTTT	CASRADSPLHF	TRBV6-1	TRBJ1-6
TGTGCCAGTAGTATACCTCTGGGACAGGCCGACGGCTCTGGAAACACCATATATTTT	CASSIPLGQADGSGNTIYF	TRBV19	TRBJ1-3
TGCGCCAGCAGTGAGCGGACACCGACAGGGCGAGCGGCCCAGTACTTC	CASSERTPTGRAAQYF	TRBV10-1	TRBJ2-5
TGTGCCAGCAGCTACCTCCCCCGGGACAGCCAGACTGTTGACGAGCAGTACTTC	CASSYLPRDSQTVDEQYF	TRBV7-6	TRBJ2-7
TGCGCCAGCAGCTTAAGGGCTAGCGGAAATGAGCAGTTCTTC	CASSLRASGNEQFF	TRBV5-1	TRBJ2-1
TGTGCCAGCAGCACTGGGGCCCCGAAGGAACACAATGAGCAGTTCTTC	CASSTGAPKEHNEQFF	TRBV7-8	TRBJ2-1
TGTGCCAGCAGCTGTCCGCCAACTAGCGGGAGGGCCAACTACGAGCAGTACTTC	CASSCPPTSGRANYEQYF	TRBV7-2	TRBJ2-7
TGCGCCAGCCGGGTGGGACAGGGGGCTCATAATGAAAAACTGTTTTTT	CASRVGQGAHNEKLFF	TRBV10-1	TRBJ1-4
TGTGCCAGCAGCGTCCGACAGGCTTACAATCAGCCCCAGCATTTT	CASSVRQAYNQPQHF	TRBV5-5	TRBJ1-5
TGTGCCAGCAGCCCGGGGGACGAGAGCAATCAGCCCCAGCATTTT	CASSPGDESNQPQHF	TRBV13	TRBJ1-5
TGTGCCAGCAGCGGAAGTCAACCTACAGGGCCCCCATGGGACTATGGCTACACCTTC	CASSGSQPTGPPWDYGYTF	TRBV9	TRBJ1-2
TGTGCCAGCAGCTGTCGTCTGGGGGCGAGCTACACCTTC	CASSCRLGASYTF	TRBV5-8	TRBJ1-2
TGTGCCAGCAGCTCCTACCGGGACTTCACAGATACGCAGTATTTT	CASSSYRDFTDTQYF	TRBV7-4	TRBJ2-3
TGCAGTGCTAGAAACAGGGCTGAGGGCTACGAGCAGTACTTC	CSARNRAEGYEQYF	TRBV20-1	TRBJ2-7
TGTGCCAGCAGTTTAAATGGGACAGGGGGCGGTTCCCCCGAGCAGTACTTC	CASSLNGTGGGSPEQYF	TRBV28	TRBJ2-7
TGTGCCAGTAGTTCGAATGGACTAGCGGGGCGCACAGATACGCAGTATTTT	CASSSNGLAGRTDTQYF	TRBV19	TRBJ2-3
TGCAGTGCGTGGAGTTACGAGCAGTACTTC	CSAWSYEQYF	TRBV20-1	TRBJ2-7
TGTGCCAGCAGCGTTAATAAGTCGGGGACAGGATGCAATGAGCAGTTCTTC	CASSVNKSGTGCNEQFF	TRBV7-4	TRBJ2-1
TGTGCCACCAGTGATACACGGGACTACGAGCAGTACTTC	CATSDTRDYEQYF	TRBV24-1	TRBJ2-7
TGTGGGAGAGCCGGGGAGCTGTTTTTT	CGRAGELFF	TRBV24-1	TRBJ2-2
TGTATCGTGAGCGCAGGGTGGAGGAATAGCAATCAGCCCCAGCATTTT	CIVSAGWRNSNQPQHF	TRBV10-3	TRBJ1-5
TGTGCCAGCAGCTTTCCATTTCGGGGAAACACTGAAGCTTTCTTT	CASSFPFRGNTEAFF	TRBV6-4	TRBJ1-1
TGTGCCAGCAGCCCGCCTCGGGGCCGCTACGAGCAGTACTTC	CASSPPRGRYEQYF	TRBV4-2	TRBJ2-7
TGTGCCAGCAGCCGGACGGTAGACGACACTGAAGCTTTCTTT	CASSRTVDDTEAFF	TRBV7-3	TRBJ1-1
TGTGCCAGCAGCCAGCGGGGACAGGTACAGTCCTACGAGCAGTACTTC	CASSQRGQVQSYEQYF	TRBV13	TRBJ2-7
TGCAGTGCTCGGGGGACAGGGGGAAGATGTTGCGAGCAGTACTTC	CSARGTGGRCCEQYF	TRBV20-1	TRBJ2-7
TGCAGCGTTGACAGAGAAGGCAGGGAACAAGAGACCCAGTACTTC	CSVDREGREQETQYF	TRBV29-1	TRBJ2-5
TGCGCCAGCAGCCTAGGAATCGGCCCGGGCACAGATACGCAGTATTTT	CASSLGIGPGTDTQYF	TRBV5-1	TRBJ2-3
TGTGCCAGCAGCTTCAGAACCCGTTACATTTGCGATCTCACAGATACGCAGTATTTT	CASSFRTRYICDLTDTQYF	TRBV7-4	TRBJ2-3
TGTGCCAGCAGTTACAGTTATGCGGAATATTTGAATGAGCAGTTCTTC	CASSYSYAEYLNEQFF	TRBV6-5	TRBJ2-1
TGTGCCAGCAGTGACATAGGGTCGGAAGGACTCTACGAGCAGTACTTC	CASSDIGSEGLYEQYF	TRBV6-4	TRBJ2-7
TGTGCCAGCAGTCTAGGCGGAGCCGATCAGCCCCAGCATTTT	CASSLGGADQPQHF	TRBV27	TRBJ1-5
TGTGCCAGCAGCTTAGTTCCTCAGGAGAATGAAAAACTGTTTTTT	CASSLVPQENEKLFF	TRBV7-7	TRBJ1-4
TGTGCCAGCAGCCACCCCCCGGATGGCGGGGAGCTGTTTTTT	CASSHPPDGGELFF	TRBV14	TRBJ2-2
TGTGCCAGCAGCTTCCCCGCGGGAGGTTTGGACACAGATACGCAGTATTTT	CASSFPAGGLDTDTQYF	TRBV5-6	TRBJ2-3
TGTGCCATCAGACTGCCTTCACCGGCGGGGTATAGCAATCAGCCCCAGCATTTT	CAIRLPSPAGYSNQPQHF	TRBV10-3	TRBJ1-5
TGTGCCAGCAGTTTCAGTTCCAGGAATCAGCCCCAGCATTTT	CASSFSSRNQPQHF	TRBV27	TRBJ1-5
TGCGCCAGCAACAAGACAGTGGAGAACACCGGGGAGCTGTTTTTT	CASNKTVENTGELFF	TRBV10-1	TRBJ2-2
TGTGCCACCAGCAGAGATCGTCGAAGGGGGAATCCTGGAAACACCATATATTTT	CATSRDRRRGNPGNTIYF	TRBV15	TRBJ1-3
TGTGCCAGCACTATGGGGTATCATGGCTACACCTTC	CASTMGYHGYTF	TRBV7-3	TRBJ1-2
TGCGCCAGCAGCTTGGAGGGGTTGCTCGGGGAGCTGTTTTTT	CASSLEGLLGELFF	TRBV5-1	TRBJ2-2
TGCGCCAGCAGCCGTGTAGGTACTTGCACAGATACGCAGTATTTT	CASSRVGTCTDTQYF	TRBV5-1	TRBJ2-3
TGTGCCAGCAGTTTAGCGCCCCTAAAGGAGACTCTAGGCGGGGAGCTGTTTTTT	CASSLAPLKETLGGELFF	TRBV12-4	TRBJ2-2
TGTGCCAGCAGGGGGACAGAGGGGGTTCGCGAGCAGTACTTC	CASRGTEGVREQYF	TRBV27	TRBJ2-7
TGCGCCAGCCCCGACAGGGGGCGAGGCCGGATCAATCAGCCCCAGCATTTT	CASPDRGRGRINQPQHF	TRBV10-1	TRBJ1-5
TGTGCCAGCAGTGATGGCCCACTAGCGGGAGGGGGCACAGATACGCAGTATTTT	CASSDGPLAGGGTDTQYF	TRBV2	TRBJ2-3
TGTGCCAGCAGGATACCAGGAAGGAGTCTAGCGGGCTACACCTTC	CASRIPGRSLAGYTF	TRBV6-2	TRBJ1-2
TGCGCCAGCAGCATCGTCGACAGGTTTGGCTATGGAAACACCATATATTTT	CASSIVDRFGYGNTIYF	TRBV5-1	TRBJ1-3
TGCGCCAGCAGCTTAGAAACAGGGGGCCAAGAGACCCAGTACTTC	CASSLETGGQETQYF	TRBV5-1	TRBJ2-5
TGTGCCAGCAGCCCACCAGGGGGAGGTGGAAACACCATATATTTT	CASSPPGGGGNTIYF	TRBV11-2	TRBJ1-3
TGCGCCAGCAGCGTGCCCCATTCAGGGTGGAGCTCCTACGAGCAGTACTTC	CASSVPHSGWSSYEQYF	TRBV5-1	TRBJ2-7
TGTGCCAGCAGCCAGGGATCACAGGGAGGCACGCAGTATTTT	CASSQGSQGGTQYF	TRBV14	TRBJ2-3
TGCGCCAGCAGCCCTCCCTCACAGGGGGCACGGATGTTCACCGGGGAGCTGTTTTTT	CASSPPSQGARMFTGELFF	TRBV4-3	TRBJ2-2
TGCAGTGCTGCCGCCGGGACAGTAGTGGGAAACACCATATATTTT	CSAAAGTVVGNTIYF	TRBV20-1	TRBJ1-3
TGCGCCAGCAGTTGGGGGAGACAGGGAACACAGTACTTC	CASSWGRQGTQYF	TRBV4-1	TRBJ2-7
TGCAGCGTTGCGCGATGGAGCAATGAGCAGTTCTTC	CSVARWSNEQFF	TRBV29-1	TRBJ2-1
TGTGCCAGCAGCTTGGCGGAGGGGACTAGGAAAAACATTCAGTACTTC	CASSLAEGTRKNIQYF	TRBV5-4	TRBJ2-4
TGTGCCACCAGCAGAGATAGCGGAGTTAAAGGGGGTAGCTCCTACAATGAGCAGTTCTTC	CATSRDSGVKGGSSYNEQFF	TRBV15	TRBJ2-1
TGTGCCAGCACCCGAATTCTCCGACAGGGTGCTTCCTACGAGCAGTACTTC	CASTRILRQGASYEQYF	TRBV12-4	TRBJ2-7
TGCAGTGCAAGGACAGGGGGCCTCTCTGGAAACACCATATATTTT	CSARTGGLSGNTIYF	TRBV20-1	TRBJ1-3
TGTGCCAGCAACCCGGGACAGCCTGAAGCTTTCTTT	CASNPGQPEAFF	TRBV18	TRBJ1-1
TGCGCCAGCAGCTCTTTTGAGCAGTTCTTC	CASSSFEQFF	TRBV4-1	TRBJ2-1
TGTGCCAGCAGCTTGCGTAGGTCTCCCGGGGGGGGCCCCTACGAGCAGTACTTC	CASSLRRSPGGGPYEQYF	TRBV5-6	TRBJ2-7
TGTGCCAGCAGTTTACCCAGTACCGGGGAGCTGTTTTTT	CASSLPSTGELFF	TRBV28	TRBJ2-2
TGTGCCAGTAGTGTACATTCTGACTGTACAGATACGCAGTATTTT	CASSVHSDCTDTQYF	TRBV19	TRBJ2-3
TGTGCCATCAGTGAGTCCGGGACAGGTCGTCAGCCCCAGCATTTT	CAISESGTGRQPQHF	TRBV10-3	TRBJ1-5
TGTGCCATCAGTGACCGGCGACTAGCGGTCGATAGCACAGATACGCAGTATTTT	CAISDRRLAVDSTDTQYF	TRBV10-3	TRBJ2-3
TGTGCCAGCGACTCATGCGGGAGTGAGGCAACCACTGAAGCTTTCTTT	CASDSCGSEATTEAFF	TRBV6-3	TRBJ1-1
TGTGCCAGCAGTTATCACTGCCGCGGGAGTTGGAACAATGAGCAGTTCTTC	CASSYHCRGSWNNEQFF	TRBV6-2	TRBJ2-1
TGTGCCAGTAAAAGTCCGGAAACCGGGGCGGGACTAGCGGGGGGCGGGGAGCTGTTTTTT	CASKSPETGAGLAGGGELFF	TRBV19	TRBJ2-2
TGTGCCAGCAGCCATACAGCCGCGCGCTCCTATAATTCACCCCTCCACTTT	CASSHTAARSYNSPLHF	TRBV7-9	TRBJ1-6
TGCAGCGTTGGGCTTAGCAATCAGCCCCAGCATTTT	CSVGLSNQPQHF	TRBV29-1	TRBJ1-5
TGTGCCAGCAGCTTTGGTTCAAATGGCCCACAGGCAGATACGCAGTATTTT	CASSFGSNGPQADTQYF	TRBV7-3	TRBJ2-3
TGTGCCAGCAGTCCCCCGACGTCGCAGCCCCGTACCGGGGAGCTGTTTTTT	CASSPPTSQPRTGELFF	TRBV2	TRBJ2-2
TGTGCCAGCAGCTTAACCGACGGGGGACCGAACACTGAAGCTTTCTTT	CASSLTDGGPNTEAFF	TRBV7-3	TRBJ1-1
TGCAGCGTTACCCTGGGGACAAGTGGAGATACGCAGTATTTT	CSVTLGTSGDTQYF	TRBV29-1	TRBJ2-3
TGCGCCAGCAGCCGCAGGCCCGGAAACACCATATATTTT	CASSRRPGNTIYF	TRBV5-1	TRBJ1-3
TGTGCCAGCAGTATAGGTTCCTTTGAGCAGTTCTTC	CASSIGSFEQFF	TRBV6-6	TRBJ2-1
TGCGCCAGCATCTGGGACAGGGGTCAGCCCCAGCATTTT	CASIWDRGQPQHF	TRBV4-3	TRBJ1-5
TGTGCCAGCTCACCCGTCTCGAGAAGGCAGTTCTTC	CASSPVSRRQFF	TRBV18	TRBJ2-1
TGCGCCAGCAGTCACACTGGGGGGGCCATTGGCGAGACCCAGTACTTC	CASSHTGGAIGETQYF	TRBV10-1	TRBJ2-5
TGTGCCAGCAGCTTAGAACGATACGACAGGGTGACTTATGGCTACACCTTC	CASSLERYDRVTYGYTF	TRBV11-3	TRBJ1-2
TGCAGTGCTAGAGATACAGAGGGTCTGGCCTACGAGCAGTACTTC	CSARDTEGLAYEQYF	TRBV20-1	TRBJ2-7
TGTGCCAGCAGCGGGAGGTCCCGGGACAGGAGGAGAAGACTTACACGTAGCATTCAGTACTTC	CASSGRSRDRRRRLTRSIQYF	TRBV9	TRBJ2-4
TGTGCCACCAGTGGAGGGGGACCCACAGATACGCAGTATTTT	CATSGGGPTDTQYF	TRBV24-1	TRBJ2-3
TGTGCCACCAGTGATTTCTTTCTAACAGGGTTTACCGGGGAGCTGTTTTTT	CATSDFFLTGFTGELFF	TRBV24-1	TRBJ2-2
TGTGCCAGCAGCGTAGTCATGGGACAGGGGTACACCGGGGAGCTGTTTTTT	CASSVVMGQGYTGELFF	TRBV9	TRBJ2-2
TGTGCCAGCAGTTATTGGGGAAATCAGCCCCAGCATTTT	CASSYWGNQPQHF	TRBV6-5	TRBJ1-5
TGTGCCAGCAGTTATGCTTGGGAACGCCGCCAAGAGACCCAGTACTTC	CASSYAWERRQETQYF	TRBV6-5	TRBJ2-5
TGTGCCAGCAGCTTAGACGCGAGGAAAACCGAGCAGTACTTC	CASSLDARKTEQYF	TRBV7-9	TRBJ2-7
TGCAGTGCTAGAGCCAATTTGGGGGCAAACACTGAAGCTTTCTTT	CSARANLGANTEAFF	TRBV20-1	TRBJ1-1
TGTGCCAGCAGCGAACATGGACTAGCGGGAGAAGGGTCAGATACGCAGTATTTT	CASSEHGLAGEGSDTQYF	TRBV9	TRBJ2-3
TGTGCCAGCAGTCCCCCCAGGGACAGAAGTAAACCCCTCCACTTT	CASSPPRDRSKPLHF	TRBV28	TRBJ1-6
TGTGCCAGCAGCTTAACACACAGGGGGCCGGACCAATGTGAAGCTTTCTTT	CASSLTHRGPDQCEAFF	TRBV7-9	TRBJ1-1
TGTGCCAGCTTACCCGCGACCTCCTACGAGCAGTACTTC	CASLPATSYEQYF	TRBV9	TRBJ2-7
TGTGCCAGCAGCTGGCATCCAACGGGAGACTCTGGGGCCAACGTCCTGACTTTC	CASSWHPTGDSGANVLTF	TRBV5-5	TRBJ2-6
TGTGCCACCAGTGATTTGTCGGACAGGAGGGGCACCGGGGAGCTGTTTTTT	CATSDLSDRRGTGELFF	TRBV24-1	TRBJ2-2
TGCGCCAGCAGCCAAGAAAACCCCCCCCCGACAGGGAATAGCAATCAGCCCCAGCATTTT	CASSQENPPPTGNSNQPQHF	TRBV4-1	TRBJ1-5
TGTGCCAGCAGCCAAGATCTGGGGAAAGGGATTGGTTCCTACGAGCAGTACTTC	CASSQDLGKGIGSYEQYF	TRBV4-2	TRBJ2-7
TGTGCCAGGGGGGGGCTTAACAATGAGCAGTTCTTC	CARGGLNNEQFF	TRBV7-3	TRBJ2-1
TGTGCCAGCAGTGGGACCCCAAGGGACCACCACAATGAGCAGTTCTTC	CASSGTPRDHHNEQFF	TRBV28	TRBJ2-1
TGTGCCAGCAATTTAGCGGGGTGCCTATGGCAAGAGACCCAGTACTTC	CASNLAGCLWQETQYF	TRBV7-3	TRBJ2-5
TGCGCCAGCAGCCCGGGGACAGGGGTATGGAGCTATGGCTACACCTTC	CASSPGTGVWSYGYTF	TRBV5-1	TRBJ1-2
TGTGCCAGCAGCTTATCGACAGGTACGAGGACCGGGGAGCTGTTTTTT	CASSLSTGTRTGELFF	TRBV7-2	TRBJ2-2
TGTGCCAGCAGCGAGAATTCTAGCGGGGGCAATGAGCAGTTCTTC	CASSENSSGGNEQFF	TRBV13	TRBJ2-1
TGCAGTGCTTGGGGGACCCTCCACTTT	CSAWGTLHF	TRBV20-1	TRBJ1-6
TGTGCCAGCAGTTCTCCTGAGGACTCGAGGACCTCTGGAAACACCATATATTTT	CASSSPEDSRTSGNTIYF	TRBV6-2	TRBJ1-3
TGTGCCAGCAGCTCGGGACCCACAGGGAAGGAAAAACTGTTTTTT	CASSSGPTGKEKLFF	TRBV5-5	TRBJ1-4
TGTGCCAGCAGTTACCGGGGGGGCCCTAACAATGAGCAGTTCTTC	CASSYRGGPNNEQFF	TRBV6-5	TRBJ2-1
TGCGCCAGCGAAGAAAGTCGGGCGAAATACGAGCAGTACTTC	CASEESRAKYEQYF	TRBV10-1	TRBJ2-7
TGCAGTGCTAGTATAGCAGGACAGATCGGTCCCCTCCACTTT	CSASIAGQIGPLHF	TRBV20-1	TRBJ1-6
TGTGCCAGCAGTTTTCTTAGCAGTAACTTC	CASSFLSSNF	TRBV28	TRBJ2-7
TGTGCCAGCAGTTACCGGCCGACTAGAGGAAACACCGGGGAGCTGTTTTTT	CASSYRPTRGNTGELFF	TRBV6-5	TRBJ2-2
TGTGCCTCCCCCGGGAGGGGGGCAGCCTCGGACGTGAACACTGAAGCTTTCTTT	CASPGRGAASDVNTEAFF	TRBV19	TRBJ1-1
TGCGCCAGCAGCCATGTGTCCGACAGACGACCCCTCCACTTT	CASSHVSDRRPLHF	TRBV4-1	TRBJ1-6
TGTGCCAGCAGCTCTGGTGGACGGGACCCCTATGGCTACACCTTC	CASSSGGRDPYGYTF	TRBV12-3	TRBJ1-2
TGTGCCACCAGTGAGCGGGAAGGCTACGAGCAGTACTTC	CATSEREGYEQYF	TRBV24-1	TRBJ2-7
TGTGCCACCAGTGATTCCGGGAGCAATCAGCCCCAGCATTTT	CATSDSGSNQPQHF	TRBV24-1	TRBJ1-5
TGTGCCAGTAGTATGCGACAGGGGGCTAATGAAAAACTGTTTTTT	CASSMRQGANEKLFF	TRBV19	TRBJ1-4
TGTGCCAGCAGTGGACAGGGCGGCAGGGGCTACGAGCAGTACTTC	CASSGQGGRGYEQYF	TRBV12-4	TRBJ2-7
TGTGCCAGCTCACCACGACGGGGGTTCGAGACCCAGTACTTC	CASSPRRGFETQYF	TRBV18	TRBJ2-5
TGTGCCAGCACCGTCCGGGACAGGGGGATGCAGCCCCAGCATTTT	CASTVRDRGMQPQHF	TRBV6-4	TRBJ1-5
TGTGCCACCAAACAGACATATCAGCCCCAGCATTTT	CATKQTYQPQHF	TRBV19	TRBJ1-5
TGTGCCAGCAGCTCGCCCGGGACAGGGGAACCAGAGACCCAGTACTTC	CASSSPGTGEPETQYF	TRBV5-4	TRBJ2-5
TGTGCCAGCAGCCAGGGGAGGACGGAAGAGACCCAGTACTTC	CASSQGRTEETQYF	TRBV7-9	TRBJ2-5
TGTGCCAGCAGTCAGGGTGCAACTAATGAAAAACTGTTTTTT	CASSQGATNEKLFF	TRBV28	TRBJ1-4
TGTGCCAGCAGCTTACTGTTGACGACAGGGGGCGCACCATACGAGCAGTACTTC	CASSLLLTTGGAPYEQYF	TRBV7-2	TRBJ2-7
TGTGCCAGTAGTATAGCGCCAAGGACAGGGGGGGCCATGAACACTGAAGCTTTCTTT	CASSIAPRTGGAMNTEAFF	TRBV19	TRBJ1-1
TGTGCCAGCAGGGTTGGGGGGGGAACCTACAATGAGCAGTTCTTC	CASRVGGGTYNEQFF	TRBV5-8	TRBJ2-1
TGTGCCAGCAGCTCGAGGTATTCACCCCTCCACTTT	CASSSRYSPLHF	TRBV5-4	TRBJ1-6
TGTGCCAGCAGCTTAGAGATAGGCACAAGGGCTTGCAGGATGAACACTGAAGCTTTCTTT	CASSLEIGTRACRMNTEAFF	TRBV13	TRBJ1-1
TGTGCCAGCAGCTGGCGGCCCCGTAAAGAGACCCAGTACTTC	CASSWRPRKETQYF	TRBV7-9	TRBJ2-5
TGCAGTGCTAGAGCTCGACGGGCGCACAACACTGAAGCTTTCTTT	CSARARRAHNTEAFF	TRBV20-1	TRBJ1-1
TGTGCCAGTAGTAACCCGACAGGGGGTCCGATGAACACTGAAGCTTTCTTT	CASSNPTGGPMNTEAFF	TRBV19	TRBJ1-1
TGTGCCAGCACAGTTCGGAACGGCACAGATACGCAGTATTTT	CASTVRNGTDTQYF	TRBV6-1	TRBJ2-3
TGTGCCAGCAGCTTGCCGGCCTATTTGGGCTTACAGAGAGCCGAGCAGTACTTC	CASSLPAYLGLQRAEQYF	TRBV5-4	TRBJ2-7
TGTGCCAGCAGTGAATTACTAGAGCAGTACTTC	CASSELLEQYF	TRBV6-1	TRBJ2-7
TGTGCCAGTAGTAGGGGCCGCCAAGCTTTCTTT	CASSRGRQAFF	TRBV19	TRBJ1-1
TGTGCCAGCAGCTACGTTTCTGGGGTCAGATATGGCTACACCTTC	CASSYVSGVRYGYTF	TRBV5-4	TRBJ1-2
TGTGCCAGTAGTATCCACCCTGGTTTGAACACTGAAGCTTTCTTT	CASSIHPGLNTEAFF	TRBV19	TRBJ1-1
TGTGCCAGCAGCTTGGGCTCTCGGGGGTATACCGAGACCCAGTACTTC	CASSLGSRGYTETQYF	TRBV5-4	TRBJ2-5
TGTGCCAGCAGCTTACGATTCGTTCCGGTACGCGCTAGCACAGATACGCAGTATTTT	CASSLRFVPVRASTDTQYF	TRBV7-9	TRBJ2-3
TGTGCCAGCAGTCACGGCCTAGGTCAGCCCCAGCATTTT	CASSHGLGQPQHF	TRBV27	TRBJ1-5
TGTGCCAGCAGTGACGTCCATAACGGATTGAAAATCTACAATGAGCAGTTCTTC	CASSDVHNGLKIYNEQFF	TRBV25-1	TRBJ2-1
TGTGCCAGGGGGGGGCCGAACACCGGGGAGCTGTTTTTT	CARGGPNTGELFF	TRBV28	TRBJ2-2
TGCGCCAGCAGCCGTACAGGGCCAAATAACTATGGCTACACCTTC	CASSRTGPNNYGYTF	TRBV4-3	TRBJ1-2
TGTGCCAGCAGTTACTCTCAGGGAGCTCGAGGGGCTGAAGCTTTCTTT	CASSYSQGARGAEAFF	TRBV6-2	TRBJ1-1
TGTGCCACCAGCACCGATTTTCCAGATACGCAGTATTTT	CATSTDFPDTQYF	TRBV24-1	TRBJ2-3
TGTGCCAGCAGTGACGCCCGCGGGGCCAACGGGGAGCTGTTTTTT	CASSDARGANGELFF	TRBV6-4	TRBJ2-2
TGTGCCAGCAGAGGCCCGCCGGGACAGGGGGGGCCCACCCCTTGCACTGAAGCTTTCTTT	CASRGPPGQGGPTPCTEAFF	TRBV6-4	TRBJ1-1
TGTGCCAAGGTCCGGTCCTCCGCTGTACGCTCTGGAAACACCATATATTTT	CAKVRSSAVRSGNTIYF	TRBV13	TRBJ1-3
TGTGCCAGCAGTAGCCCGACTAGCGGGAGGGAAGGTATCTGGTTCAATCAGCCCCAGCATTTT	CASSSPTSGREGIWFNQPQHF	TRBV6-1	TRBJ1-5
TGCGCCAGCAATGGGGAGCGGGGGACCCAGTACTTC	CASNGERGTQYF	TRBV10-1	TRBJ2-5
TGCGCCAGCAGCACTTTGGGACACACTGAAGCTTTCTTT	CASSTLGHTEAFF	TRBV5-1	TRBJ1-1
TGTGCCAGCAGTGACAGCTCTCAAGAGACCCAGTACTTC	CASSDSSQETQYF	TRBV12-3	TRBJ2-5
TGTGCCAGCAGCTTGAACAGGATTACCACTGAAGCTTTCTTT	CASSLNRITTEAFF	TRBV5-8	TRBJ1-1
TGTGCCAGCAGCGGGGACCGACTAGCGGGCTTGGGCCATGCGCAGTTCTTC	CASSGDRLAGLGHAQFF	TRBV13	TRBJ2-1
TGTGCTAGTGGTCCAGGGGGGCAACAAGGCTATGGCTACACCTTC	CASGPGGQQGYGYTF	TRBV12-5	TRBJ1-2
TGTGCCAGCAGCCAAAGCTCTAATACGGAAAAACTGTTTTTT	CASSQSSNTEKLFF	TRBV3-1	TRBJ1-4
TGTGCCACCAGCTTGTCCGGGACTAGAGGAGAGACCCAGTACTTC	CATSLSGTRGETQYF	TRBV15	TRBJ2-5
TGTGCCAGCAGACAGACCGGGACAGGGGGACAGCCCCAGCATTTT	CASRQTGTGGQPQHF	TRBV6-5	TRBJ1-5
TGTGCCATCAGTGAGTCACGGGACAGAAGTTGGTCCTCTGGGGCCAACGTCCTGACTTTC	CAISESRDRSWSSGANVLTF	TRBV10-3	TRBJ2-6
TGTGCCAATAGGGGAATTACTGAAGCTTTCTTT	CANRGITEAFF	TRBV6-1	TRBJ1-1
TGTGCCAGCAGCTGGACCGGGCTGAACACTGAAGCTTTCTTT	CASSWTGLNTEAFF	TRBV7-3	TRBJ1-1
TGTGCCAGCAGCTTAGAAGCGGGCGAGCAGTACTTC	CASSLEAGEQYF	TRBV11-3	TRBJ2-7
TGTGCCAGCAGTCCCGCCTACTTAGCGGCGGGCCGGCAGTACTTC	CASSPAYLAAGRQYF	TRBV6-2	TRBJ2-7
TGTGCCAGCAGAGCCAGGGGAGGCAATCAGCCCCAGCATTTT	CASRARGGNQPQHF	TRBV6-1	TRBJ1-5
TGTGCCAGCAGCTCGGAGACTAGCCAGTTCACAGATACGCAGTATTTT	CASSSETSQFTDTQYF	TRBV7-9	TRBJ2-3
TGTGCCAGCCGGGGGGGGCCTGGGAACATTCAGTACTTC	CASRGGPGNIQYF	TRBV5-6	TRBJ2-4
TGTGCCAGCATGTCCCAAAACGGGACAGAGTGGGCCTACAATGAGCAGTTCTTC	CASMSQNGTEWAYNEQFF	TRBV9	TRBJ2-1
TGTGCCAGCAGCCAGTCGGTAAGAGGACAGACAGATACGCAGTATTTT	CASSQSVRGQTDTQYF	TRBV14	TRBJ2-3
TGTGCCAGCAGTTTCACATTCCTAGTAAGGCCCACAGATACGCAGTATTTT	CASSFTFLVRPTDTQYF	TRBV27	TRBJ2-3
TGTGCCAGCAGTTACGGGACAACTGAAGCTTTCTTT	CASSYGTTEAFF	TRBV6-5	TRBJ1-1
TGTGCCAGCAGCCAGATGTCCGGGACAACCTCCTACGAGCAGTACTTC	CASSQMSGTTSYEQYF	TRBV13	TRBJ2-7
TGTGCCAGTAGTAAATTACCCTTCGACCCGACCTACGAGCAGTACTTC	CASSKLPFDPTYEQYF	TRBV19	TRBJ2-7
TGTGCCAGCCCCCCTCGACAGTTGCCCCCAACTGGCTACACCTTC	CASPPRQLPPTGYTF	TRBV2	TRBJ1-2
TGTGCCACCAGCTCCGGGCCGTACAATGAGCAGTTCTTC	CATSSGPYNEQFF	TRBV24-1	TRBJ2-1
TGTGCCAGTAGACGTACGGGACACAAGCGCCGTCATGAGCAGTTCTTC	CASRRTGHKRRHEQFF	TRBV19	TRBJ2-1
TGTGCCAGCAGCCAAGGACCAAGGGCGGGGGGTGAGCAGTTCTTC	CASSQGPRAGGEQFF	TRBV3-1	TRBJ2-1
TGTGCCAGCCCAGGGGGCTTGAACGAGCAGTACTTC	CASPGGLNEQYF	TRBV6-1	TRBJ2-7
TGCAGTGCTAGAGAAGAGCGGGGGTTCACAGATACGCAGTATTTT	CSAREERGFTDTQYF	TRBV20-1	TRBJ2-3
TGTGCCAGCAGTTACAATTCCCCGATTAAACCCACAGATACGCAGTATTTT	CASSYNSPIKPTDTQYF	TRBV6-5	TRBJ2-3
TGTGCCAGCAGCTACGAGATGGACAGGGTCCCTGAGAACGAGCAGTACTTC	CASSYEMDRVPENEQYF	TRBV6-3	TRBJ2-7
TGTGCCAGCACTCGGGAATTTTACGAGCAGTACTTC	CASTREFYEQYF	TRBV28	TRBJ2-7
TGTGCCAGCAGTTACGACTTACGGGGCACAGATACGCAGTATTTT	CASSYDLRGTDTQYF	TRBV6-5	TRBJ2-3
TGTGCCAGCAGCTGGGCTGACAGGGTGGATAATGAAAAACTGTTTTTT	CASSWADRVDNEKLFF	TRBV7-3	TRBJ1-4
TGTGCCACCAGTGACGGGGCTACTAGTAAGGATGAGCAGTTCTTC	CATSDGATSKDEQFF	TRBV24-1	TRBJ2-1
TGTGCCAGCAGTCTGGTTAGCGGGCAATTCCCGGCGAACACCGGGGAGCTGTTTTTT	CASSLVSGQFPANTGELFF	TRBV6-4	TRBJ2-2
TGCAGTGCTTACTTCGGACTAAAACATTGGACCCAGTACTTC	CSAYFGLKHWTQYF	TRBV20-1	TRBJ2-5
TGTGCCAGAACGTGGGAGGGTGAGACCCAGTACTTC	CARTWEGETQYF	TRBV6-4	TRBJ2-5
TGTGCCATCAGTGAGAACCCTATTCCCCGGGAGGACAGGGAAAAACTGTTTTTT	CAISENPIPREDREKLFF	TRBV10-3	TRBJ1-4
TGCAGTGCTAGGGGGGGGCCGGAGACCCAGTACTTC	CSARGGPETQYF	TRBV20-1	TRBJ2-5
TGTGCCACCGGGATATCATGTTACTATGGCTACACCTTC	CATGISCYYGYTF	TRBV24-1	TRBJ1-2
TGCGCCAGCAGCGCCTTTAAGCCCCAGCATTTT	CASSAFKPQHF	TRBV5-1	TRBJ1-5
TGCAGCGATCTAGGCCAGTACGAGCAGTACTTC	CSDLGQYEQYF	TRBV29-1	TRBJ2-7
TGTGCCAGCAGCTTAGTCCAACCCCCTGGACGATGGAAGATAGCTTTCTTT	CASSLVQPPGRWKIAFF	TRBV7-2	TRBJ1-1
TGTGCCAGCAGCCAAGACCATCCTAGCGGGCGGTTCTTC	CASSQDHPSGRFF	TRBV14	TRBJ2-1
TGTGCCACCCCCGGAGGTGGGTATGGCTACACCTTC	CATPGGGYGYTF	TRBV19	TRBJ1-2
TGTGCCACCAGCCCAACTCTGCAAAGGAACTCCTACGAGCAGTACTTC	CATSPTLQRNSYEQYF	TRBV24-1	TRBJ2-7
TGTGCCAGCTCCGGGAACTTGGGGACAGGGTACGTTGGGGTCGCATACGGGGAGCTGTTTTTT	CASSGNLGTGYVGVAYGELFF	TRBV7-3	TRBJ2-2
TGTGCCAGCAGCAATCCGTCCCACGGACAGGGTCAACGATCGTCTGGGGCCAACGTCCTGACTTTC	CASSNPSHGQGQRSSGANVLTF	TRBV13	TRBJ2-6
TGTGCCAGCAGCTTAGGCCTTGTGTACACCGGGGAGCTGTTTTTT	CASSLGLVYTGELFF	TRBV11-2	TRBJ2-2
TGTGCCAGCAGTCGAGTCACCGGGGAGCTGTTTTTT	CASSRVTGELFF	TRBV27	TRBJ2-2
TGTAGGCTATTATCTCAGCCCCAGCATTTT	CRLLSQPQHF	TRBV14	TRBJ1-5
TGCGCCAGCAGTGAGCGGGCCCGAAACACCATATATTTT	CASSERARNTIYF	TRBV10-1	TRBJ1-3
TGTGCCAGTAGTATAGACAGGGAAACCAATGCACCCCTCCACTTT	CASSIDRETNAPLHF	TRBV19	TRBJ1-6
TGTGCTAGTGGTTTGGTAAGGGGGCGCGCCAATGAGCAGTTCTTC	CASGLVRGRANEQFF	TRBV12-5	TRBJ2-1
TGTGCCAGCAGCTTAGTCCGTATAGGGACTCACTACGAGCAGTACTTC	CASSLVRIGTHYEQYF	TRBV11-2	TRBJ2-7
TGTGCCAGCAGCTCGAAGGAGGACTCCTACGAGCAGTACTTC	CASSSKEDSYEQYF	TRBV11-3	TRBJ2-7
TGTGCCAGCAGCTCTATCGGGGTGTTGGCTTTCGAGCAGTACTTC	CASSSIGVLAFEQYF	TRBV7-9	TRBJ2-7
TGTGCCAGCAGCTTCCTACTTAAACTGGGATTTCAGCCCCAGCATTTT	CASSFLLKLGFQPQHF	TRBV7-9	TRBJ1-5
TGTGCCAGCAGCTTAGACCGGGACAGGGGTGGCTCCTACGAGCAGTACTTC	CASSLDRDRGGSYEQYF	TRBV11-2	TRBJ2-7
TGTGCCAGCAGCGAGGGGGGCAAACCGCCGAAGCAGTACTTC	CASSEGGKPPKQYF	TRBV11-3	TRBJ2-7
TGTGCCAGCAGTAATGGAGCACAGGTGATGAACACCATATATTTT	CASSNGAQVMNTIYF	TRBV28	TRBJ1-3
TGTGCCAGCAGCTTGGTCCCATTCCGCCGGGGGCCCGAGCAGTTCTTC	CASSLVPFRRGPEQFF	TRBV5-4	TRBJ2-1
TGTGCCAGCAGCTTGCCGGGGGCGCCCTTGTACGAGCAGTACTTC	CASSLPGAPLYEQYF	TRBV5-4	TRBJ2-7
TGCGCCAGCAGCCAAGATAACGGTAAAACGGGGACGATACTAGCCAAAAACATTCAGTACTTC	CASSQDNGKTGTILAKNIQYF	TRBV4-1	TRBJ2-4
TGTGCCAGCAGCTTAAGGGGCTATTTCATTCAGTACTTC	CASSLRGYFIQYF	TRBV7-3	TRBJ2-4
TGTGCCAGCAGGACCCGAACACTAGGGCCTTCCTACAATGAGCAGTTCTTC	CASRTRTLGPSYNEQFF	TRBV6-3	TRBJ2-1
TGTGCCAGCAGTATTGACCAGGGAGGTAATCACAAACTGTTTTTT	CASSIDQGGNHKLFF	TRBV6-3	TRBJ1-4
TGTGCCAGCAGTTACTCGCATATATCCGGGCCGTGTAGGAACACTGAAGCTTTCTTT	CASSYSHISGPCRNTEAFF	TRBV6-6	TRBJ1-1
TGTGCCAGCAGCCAACCCCCAGGGGACAACTATGGCTACACCTTC	CASSQPPGDNYGYTF	TRBV4-2	TRBJ1-2
TGTGCCAGCAGGACCGGACAGTGCACTGAAGCTTTCTTT	CASRTGQCTEAFF	TRBV7-4	TRBJ1-1
TGTGCCACTTTGAGGGGCAGCTCCTACGAGCAGTACTTC	CATLRGSSYEQYF	TRBV24-1	TRBJ2-7
TGTGCCAGCAGCCCGTATACCCCAGCTTTCTTT	CASSPYTPAFF	TRBV5-5	TRBJ1-1
TGTGCCAGCAGCCGCCGGCGGTGGGGGGGTTACTATGGCTACACCTTC	CASSRRRWGGYYGYTF	TRBV9	TRBJ1-2
TGTGCCAGTAGTTCCGGGGACAGGGGCCGAAATAATTCACCCCTCCACTTT	CASSSGDRGRNNSPLHF	TRBV19	TRBJ1-6
TGCAGCGGGGGTGACGAGCAGTACTTC	CSGGDEQYF	TRBV29-1	TRBJ2-7
TGTGCCAGCCCGCTAGCGGGGATGGAGAGTTGCACAGATACGCAGTATTTT	CASPLAGMESCTDTQYF	TRBV11-3	TRBJ2-3
TGCGCCAGCAGCATAATGGGTAGGGGGGGTCCAGAGCAGTACTTC	CASSIMGRGGPEQYF	TRBV5-1	TRBJ2-7
TGTGCCACCAGCAGAGCTCCTTTAGGCAACACCGGGGAGCTGTTTTTT	CATSRAPLGNTGELFF	TRBV15	TRBJ2-2
TGCAGTGCTAGAGCCGTACGTATTGTTATCACCTATGGCTACACCTTC	CSARAVRIVITYGYTF	TRBV20-1	TRBJ1-2
TGCGCCAGCTCCCGCGGGACAGAGGCAAATTCACCCCTCCACTTT	CASSRGTEANSPLHF	TRBV5-1	TRBJ1-6
TGCAGTGCTAGATTAAGCAGGGGGACTGAAGCTTTCTTT	CSARLSRGTEAFF	TRBV20-1	TRBJ1-1
TGTGCCAGCAGTGAATATGGGGGGGTAGGGCGGGACATAATAGAAAAACTGTTTTTT	CASSEYGGVGRDIIEKLFF	TRBV25-1	TRBJ1-4
TGTGCCAGCAGTTTCAGAAACGAAAAACTGTTTTTT	CASSFRNEKLFF	TRBV27	TRBJ1-4
TGTGCCCGGGACAGTGGTCCAGAGACCCAGTACTTC	CARDSGPETQYF	TRBV6-4	TRBJ2-5
TGTGCCAGCAGCTTGATTACTTGGCCTCAGCATGCTGGAAACACCATATATTTT	CASSLITWPQHAGNTIYF	TRBV7-2	TRBJ1-3
TGTGCCAGCACGTCAAACGAAGAGACCCAGTACTTC	CASTSNEETQYF	TRBV6-3	TRBJ2-5
TGTGCCAGCAGTGACAGAATTCTAGGGGGAGAGACCCAGTACTTC	CASSDRILGGETQYF	TRBV6-4	TRBJ2-5
TGTGCCAGCAGAACCACAACTAGGAGGCTCTCCTACAATGAGCAGTTCTTC	CASRTTTRRLSYNEQFF	TRBV6-2	TRBJ2-1
TGTGCCAGCAGCTTACGTAGCGAAAGGGTCTTC	CASSLRSERVF	TRBV7-2	TRBJ2-1
TGCGCCAGAACCACTCCCAGGCTTAGCAATCAGCCCCAGCATTTT	CARTTPRLSNQPQHF	TRBV10-1	TRBJ1-5
TGCGCCAGCAGCCCTGGGTGGGACTCCTACAATGAGCAGTTCTTC	CASSPGWDSYNEQFF	TRBV4-3	TRBJ2-1
TGTGCCAGCAGTTATTACCCAGGGGGCGAACAGCCCCAGCATTTT	CASSYYPGGEQPQHF	TRBV12-3	TRBJ1-5
TGTGCCAGCAGCGGGTCAGGGCCGGATCAGCCCCAGCATTTT	CASSGSGPDQPQHF	TRBV7-3	TRBJ1-5
TGTGCCAGCAGCTGTACGGGACAGCAGACCTGCCTAGCTTTCTTT	CASSCTGQQTCLAFF	TRBV5-5	TRBJ1-1
TGTGCCAGCAGTTCGGGGCCTCACGAGCAGTACTTC	CASSSGPHEQYF	TRBV6-2	TRBJ2-7
TGCGCCAGCAGCTTTAGCCCGGGAACCGGGACAGAGTTCACAGATACGCAGTATTTT	CASSFSPGTGTEFTDTQYF	TRBV5-1	TRBJ2-3
TGTGCCAGCAGGAGGGATATCGGGTGGCCAGATACGCAGTATTTT	CASRRDIGWPDTQYF	TRBV12-3	TRBJ2-3
TGTGCCAGCAGCGGGGGAGATCGCCCGCGAGAAGAGTACGAGCAGTACTTC	CASSGGDRPREEYEQYF	TRBV7-3	TRBJ2-7
TGTGCCACCAGCGAAGAGGGGACCAATCCGGAGCAGCCCCAGCATTTT	CATSEEGTNPEQPQHF	TRBV15	TRBJ1-5
TGCAGTGCTAGAGTCGGGCACAGCACAGATACGCAGTATTTT	CSARVGHSTDTQYF	TRBV20-1	TRBJ2-3
TGCGCCAGCAGCGCCCAGGGCCGGGAAGCTTTCTTT	CASSAQGREAFF	TRBV5-1	TRBJ1-1
TGTGCCATCAGTGAGTCGTCGCTCCGCCCGGACTTC	CAISESSLRPDF	TRBV10-3	TRBJ2-5
TGTGCCAGCAGTTTACTCAACGGGGTGAGCGAGCAGTACTTC	CASSLLNGVSEQYF	TRBV27	TRBJ2-7
TGTGCCAGCAGTTATTCACCTGGGAGGGGGCTTAGCTCCTACGAGCAGTACTTC	CASSYSPGRGLSSYEQYF	TRBV6-9	TRBJ2-7
TGTGCCAGCAGTCACAGGGCCGTCTATGGCTACACCTTC	CASSHRAVYGYTF	TRBV27	TRBJ1-2
TGTGCCATCAGCAACACCGGGACAGGGGGCTATTTTGCTGAAGCTTTCTTT	CAISNTGTGGYFAEAFF	TRBV10-3	TRBJ1-1
TGTGCCACCAGCAGAGGCAAAGGTTACCCGTTCGTCAGGGCCAAAAAACTGTTTTTT	CATSRGKGYPFVRAKKLFF	TRBV15	TRBJ1-4
TGCAGTGCTCGGTCGGACGGGGGAAGCTCTGGGGCCAACGTCCTGACTTTC	CSARSDGGSSGANVLTF	TRBV20-1	TRBJ2-6
TGTGCCAGCACTAGGGGTCTAGCGGGGGTCTACGAGCAGTACTTC	CASTRGLAGVYEQYF	TRBV5-5	TRBJ2-7
TGTGCCAGCAGCGGTCCCGGGACTAGCACAGATACGCAGTATTTT	CASSGPGTSTDTQYF	TRBV13	TRBJ2-3
TGTGCCAGCAGTTACAGATGGGACAGCTACGAGCAGTACTTC	CASSYRWDSYEQYF	TRBV6-5	TRBJ2-7
TGTGCCAGCGGACAGGGCTTC	CASGQGF	TRBV6-1	TRBJ2-7
TGCGCCAGCAGCTTGAGTCCAGGGGACAGCACAGATACGCAGTATTTT	CASSLSPGDSTDTQYF	TRBV5-1	TRBJ2-3
TGTGCCACCAGCAGAGATAACCTTGTCATGGACTACGAGCAGTACTTC	CATSRDNLVMDYEQYF	TRBV15	TRBJ2-7
TGTGCCAGTAGGGGAGGGTCTTGGCGCTATGGCTACACCTTC	CASRGGSWRYGYTF	TRBV19	TRBJ1-2
TGTGCCAGCAGCTTAGCGCCCGGGACAGGGCCCTCCGGTGGCTACACCTTC	CASSLAPGTGPSGGYTF	TRBV7-9	TRBJ1-2
TGTGCCAGCAGCTTGACATATTTACGGCTATCATTTTCCTACGAGCAGTACTTC	CASSLTYLRLSFSYEQYF	TRBV5-5	TRBJ2-7
TGTGCCAGCAGTGACTCCGGACAGGGTCAGCCCCAGCATTTT	CASSDSGQGQPQHF	TRBV6-4	TRBJ1-5
TGTGCCAGCAGTTATCAGGGTACGACTAGCTCACATGAGCAGTTCTTC	CASSYQGTTSSHEQFF	TRBV6-5	TRBJ2-1
TGTGCCAGCAGCTCCAGTATAGACAGGGGGTCCTCCTACGAGCAGTACTTC	CASSSSIDRGSSYEQYF	TRBV11-2	TRBJ2-7
TGCAGCCCCTGTCGACAGTTGCCTGGAAACACCATATATTTT	CSPCRQLPGNTIYF	TRBV29-1	TRBJ1-3
TGCGCCAGCAGCCAAGAGGCACTAGCGGGAGCCGCCGGGGAGCTGTTTTTT	CASSQEALAGAAGELFF	TRBV4-1	TRBJ2-2
TGCGCCAGCAGCTCTCGGACAGAGCGTAACATTCAGTACTTC	CASSSRTERNIQYF	TRBV4-1	TRBJ2-4
TGCGCCAGCAGTGAGAGGAGGGGCCGTGGCTACACCTTC	CASSERRGRGYTF	TRBV10-1	TRBJ1-2
TGCAGCGTTGGGAGGGGCAATCAGCCCCAGCATTTT	CSVGRGNQPQHF	TRBV29-1	TRBJ1-5
TGTGCCAGCAGCCGACTGTGCCATCAGCCCCAGCATTTT	CASSRLCHQPQHF	TRBV9	TRBJ1-5
TGTGCCAGCAGCGTACGGAGAGACTATGGCTACACCTTC	CASSVRRDYGYTF	TRBV9	TRBJ1-2
TGTGCCAGCAGTTTGGGGCTACTTTCACCCCTCCACTTT	CASSLGLLSPLHF	TRBV12-4	TRBJ1-6
TGCAGTGCTAGAGCACCGCTGGACGGGGGAGAGACCCAGTACTTC	CSARAPLDGGETQYF	TRBV20-1	TRBJ2-5
TGTGCCAGCAGCTTCCTGTTCGGGACAGGGCGGCTCCAGAACACCGGGGAGCTGTTTTTT	CASSFLFGTGRLQNTGELFF	TRBV7-8	TRBJ2-2
TGTGCCAGCAGCTTCCCTTATAAGGAGATTTCTCCCGAGCAGTACTTC	CASSFPYKEISPEQYF	TRBV7-4	TRBJ2-7
TGTGCCACGAGGACAGCTGCAACTAATGAAAAACTGTTTTTT	CATRTAATNEKLFF	TRBV6-4	TRBJ1-4
TGTGCCAGCAGCCAAGAGCCACTCAGGGAGGACGACGAGCAGTTCTTC	CASSQEPLREDDEQFF	TRBV3-1	TRBJ2-1
TGTGCCAGCAGTTACCGGGGGGGCAGCAATCAGCCCCAGCATTTT	CASSYRGGSNQPQHF	TRBV27	TRBJ1-5
TGTGCCAGCAGCCGGGGGGGGGACTATGGCTACACCTTC	CASSRGGDYGYTF	TRBV7-3	TRBJ1-2
TGTGCCAGTGGTTGGGGAAAACGGGACGGGAACACTGAAGCTTTCTTT	CASGWGKRDGNTEAFF	TRBV4-2	TRBJ1-1
TGTGCCACCAGTGATTTGAAGACAGGGTCCGGCTACACCTTC	CATSDLKTGSGYTF	TRBV24-1	TRBJ1-2
TGTGCCAGCAGGGGAGAACGCGGTAGCACCGGGGAGCTGTTTTTT	CASRGERGSTGELFF	TRBV5-6	TRBJ2-2
TGCGCCAGCAGCCTGGCGGCGGCAGATACGCAGTATTTT	CASSLAAADTQYF	TRBV4-1	TRBJ2-3
TGTGCCAGCAGCTTACGGACAGGGGTTGGTGAAAAACTGTTTTTT	CASSLRTGVGEKLFF	TRBV7-4	TRBJ1-4
TGTGCCAGCAGCCCAAAGGGGGCGCTGAACACTGAAGCTTTCTTT	CASSPKGALNTEAFF	TRBV13	TRBJ1-1
TGTGCCAGTAGGGGCCAGGACTCCTACGAGCAGTACTTC	CASRGQDSYEQYF	TRBV19	TRBJ2-7
TGTGCCAGCAGCGGACTAGCGGGGGGCACCGGGGAGCTGTTTTTT	CASSGLAGGTGELFF	TRBV7-4	TRBJ2-2
TGTGCCAGCAGTTACCCGCGATGGAAAATGGGACAGGAAAAACTGTTTTTT	CASSYPRWKMGQEKLFF	TRBV6-2	TRBJ1-4
TGTGCCAGCAGCTTAGCGTGGACAGTTTCTGAAAAACTGTTTTTT	CASSLAWTVSEKLFF	TRBV7-9	TRBJ1-4
TGTGCCAGCAGCGCAAAACAGGGGCAGCCCCAGCATTTT	CASSAKQGQPQHF	TRBV7-3	TRBJ1-5
TGCGCCAGCAGCTGCAATCAGGTTCTCAGCACAGATACGCAGTATTTT	CASSCNQVLSTDTQYF	TRBV5-1	TRBJ2-3
TGTGCCAGCAGTTGGGGACAGTACGGCGGTGGCTACACCTTC	CASSWGQYGGGYTF	TRBV6-2	TRBJ1-2
TGTGCCAGCAGCCATCCCATCTCTAGTTCATGGGGGGCCCGAGCAGATACGCAGTATTTT	CASSHPISSSWGARADTQYF	TRBV5-6	TRBJ2-3
TGCGCCAGCAGCCAAGATCCCTGGGACAGGGCCCAGACCTATTACGCTAGCACAGATACGCAGTATTTT	CASSQDPWDRAQTYYASTDTQYF	TRBV4-1	TRBJ2-3
TGTGCCAGCAGCTCGCCAGGGCCACGTTCGCACTATGGCTACACCTTC	CASSSPGPRSHYGYTF	TRBV7-9	TRBJ1-2
TGTGCTAGTGGAGGTCAACAAAGGGAGCTGTTTTTT	CASGGQQRELFF	TRBV12-5	TRBJ2-2
TGTGCCAGCACAATTGTCCCAGGCCTCCAGGGGGCTCATGGCTACACCTTC	CASTIVPGLQGAHGYTF	TRBV9	TRBJ1-2
TGTGCCAGCAGGAAGGCGCCGACTGAAGCTTTCTTT	CASRKAPTEAFF	TRBV6-8	TRBJ1-1
TGCAGTGCTAGCCCGACAGGGGGCGGACACGAGCAGTACTTC	CSASPTGGGHEQYF	TRBV20-1	TRBJ2-7
TGTGCCACCAGTGGGGGGATGATGAGGGACACTGAAGCTTTCTTT	CATSGGMMRDTEAFF	TRBV24-1	TRBJ1-1
TGCAGCGTTGACTTGGGGGAGACCCAGTACTTC	CSVDLGETQYF	TRBV29-1	TRBJ2-5
TGTGCCAGCAGCATCGGCGGAGACACAGATACGCAGTATTTT	CASSIGGDTDTQYF	TRBV11-3	TRBJ2-3
TGTGCCAGCAGCGCGACCCTAGGGCCGGGACAGGGTAATCAGCCCCAGCATTTT	CASSATLGPGQGNQPQHF	TRBV6-4	TRBJ1-5
TGCGCCAGCAGCTCCCTCCTTAGGCCGGACCCACAGTTCAACTATGGCTACACCTTC	CASSSLLRPDPQFNYGYTF	TRBV5-1	TRBJ1-2
TGCGCCAGCAGGTACGGATGGACAGGAAAAGCCACAGATACGCAGTATTTT	CASRYGWTGKATDTQYF	TRBV10-1	TRBJ2-3
TGTGCCAGCAGTTTAATATCAGGTCGGAAGGAAGAGACCCAGTACTTC	CASSLISGRKEETQYF	TRBV27	TRBJ2-5
TGCAGCGTTACGGGGGGGGAGCAGTACTTC	CSVTGGEQYF	TRBV29-1	TRBJ2-7
TGTGCCAGCAGTTTACCTTACGCCCAACAGGGGAACAATGATAGCAATCAGCCCCAGCATTTT	CASSLPYAQQGNNDSNQPQHF	TRBV27	TRBJ1-5
TGTGCCAGCAGCGTCTACCCGGGACAGCGCTCCTACGAGCAGTACTTC	CASSVYPGQRSYEQYF	TRBV7-4	TRBJ2-7
TGCAGTGCTAGAGTGTCCAGTCACTCTGGGGCCAACGTCCTGACTTTC	CSARVSSHSGANVLTF	TRBV20-1	TRBJ2-6
TGTGCCAGCAGAGGGGTCACGGCTAAGGTTTGTCAAGGCTATGGCTACACCTTC	CASRGVTAKVCQGYGYTF	TRBV27	TRBJ1-2
TGTGCCAGCAGCTTAGGCGCCTACAGGAGGACCTACGAGCAGTACTTC	CASSLGAYRRTYEQYF	TRBV7-9	TRBJ2-7
TGTGCCAGCAGTTTCGACTGTTCAAGCACCTACAATGAGCAGTTCTTC	CASSFDCSSTYNEQFF	TRBV28	TRBJ2-1
TGTGCCAGCAGCCCCCCTGGACCCAGGACAGGCAAACGAAGCACCTTC	CASSPPGPRTGKRSTF	TRBV27	TRBJ1-2
TGCAGTGCTAGAGATACCTCGGGAAATCCCTACAATGAGCAGTTCTTC	CSARDTSGNPYNEQFF	TRBV20-1	TRBJ2-1
TGCGCCAGCAGTGGGGAAGCCAAGGGCCGGGGGGTTTGTGAGCAGTTCTTC	CASSGEAKGRGVCEQFF	TRBV10-1	TRBJ2-1
TGTGCCAGCAGTTACGGGAGCCAAGAGACCCAGTACTTC	CASSYGSQETQYF	TRBV6-5	TRBJ2-5
TGTGCCAGCAAACCAAGGGCTGGCGACACTGAAGCTTTCTTT	CASKPRAGDTEAFF	TRBV25-1	TRBJ1-1
TGCGCCAGCAGCCAAGATCCGTGGGGCTCTGGGGCCAACGTCCTGACTTTC	CASSQDPWGSGANVLTF	TRBV4-1	TRBJ2-6
TGCGCCAGCAGTGCCACCCTGCCAGGGCTCTTGAGCTCCTACGAGCAGTACTTC	CASSATLPGLLSSYEQYF	TRBV10-1	TRBJ2-7
TGTGCCAGCACAGGGGCTTTCTTT	CASTGAFF	TRBV9	TRBJ1-1
TGTGCCACCAGTGATGGAGGCTTGTCACCCCTCCACTTT	CATSDGGLSPLHF	TRBV24-1	TRBJ1-6
TGTGCCAGCAGAGCGAATGAGCAGTTCTTC	CASRANEQFF	TRBV3-1	TRBJ2-1
TGTGCCACCAGTGAGATTCGATCTCTAGGACAGGGGAATCAGCCCCAGCATTTT	CATSEIRSLGQGNQPQHF	TRBV24-1	TRBJ1-5
TGTGCCAGCACCGACAGCGTCGATACGCAGTATTTT	CASTDSVDTQYF	TRBV6-3	TRBJ2-3
TGTGCCAGCAGCCATAACCCATTAGCCTACGAGCAGTACTTC	CASSHNPLAYEQYF	TRBV14	TRBJ2-7
TGTGCCAGCAGTGAATGGGTGAGGGCCGAGCAGTACTTC	CASSEWVRAEQYF	TRBV2	TRBJ2-7
TGTGCCACCAGCAGAGGGACCGCGGTTACAGATACGCAGTATTTT	CATSRGTAVTDTQYF	TRBV15	TRBJ2-3
TGCAGTGCTAGAGCTTTAAAGCCCAGGGGGGTCGTCGGGATTAATGAAAAACTGTTTTTT	CSARALKPRGVVGINEKLFF	TRBV20-1	TRBJ1-4
TGCAGCGTTGGAAAGATCTGTCTAGCGGTCGACAATGAGCAGTTCTTC	CSVGKICLAVDNEQFF	TRBV29-1	TRBJ2-1
TGTGCCAGCAGTTACTCACTTCCCAGACAGGGGGGGATGACCCAGTACTTC	CASSYSLPRQGGMTQYF	TRBV6-5	TRBJ2-5
TGCGCCAGCAGCCGGGGGGGGGCCAATCAGCCCCAGCATTTT	CASSRGGANQPQHF	TRBV5-1	TRBJ1-5
TGTGCCATCAGTGACCGGAGTCACTTGGGTAGATTCTATGGCTACACCTTC	CAISDRSHLGRFYGYTF	TRBV10-3	TRBJ1-2
TGTGCCAGCAATCCCCTTTACCTTTCAGCACGGGCCCCCGGGGGCGAGCAGTACTTC	CASNPLYLSARAPGGEQYF	TRBV28	TRBJ2-7
TGCAGTGCTAGCGGGTGGGACGAGCAGTACTTC	CSASGWDEQYF	TRBV20-1	TRBJ2-7
TGTGCCAGCAGCGGGGGGGGGACCAAAAACATTCAGTACTTC	CASSGGGTKNIQYF	TRBV13	TRBJ2-4
TGCGCCAGCAGTGCCCCAGGGGATGGCAGCAATCAGCCCCAGCATTTT	CASSAPGDGSNQPQHF	TRBV10-1	TRBJ1-5
TGTGCCAGCAGCCAACCAGAGAGCGCCTCTGGAAACACCATATATTTT	CASSQPESASGNTIYF	TRBV14	TRBJ1-3
TGTGCCAGCACAACCCCCGACAGGGGCAAAACCGGGGAGCTGTTTTTT	CASTTPDRGKTGELFF	TRBV7-3	TRBJ2-2
TGTGCCAGCAGTAGCCCCGTGGGGCCGGATGAAAAACTGTTTTTT	CASSSPVGPDEKLFF	TRBV6-5	TRBJ1-4
TGTGCCTGGAGTAGCCCCTGGGCCCGCAATCAGCCCCAGCATTTT	CAWSSPWARNQPQHF	TRBV30	TRBJ1-5
TGTGCCAGCAGCATTATTCCAGGTCGGGGTCAGGCCTCCTACGAGCAGTACTTC	CASSIIPGRGQASYEQYF	TRBV12-4	TRBJ2-7
TGTGCCAGCAGCTCGCAGCGGAACACCATATATTTT	CASSSQRNTIYF	TRBV6-6	TRBJ1-3
TGTGCCAGCAGTGCACCGGGGGGTCCCAGCTCCTACAATGAGCAGTTCTTC	CASSAPGGPSSYNEQFF	TRBV27	TRBJ2-1
TGTGCCAGCAGCTTAGTGGGAGGGGGCGCCAGAGAGACCCAGTACTTC	CASSLVGGGARETQYF	TRBV11-2	TRBJ2-5
TGTGCCAGCAGCTCCATAAGCCCGACCAGGGTCCCAACGAACACCATATATTTT	CASSSISPTRVPTNTIYF	TRBV5-6	TRBJ1-3
TGTGCCAGCAGCCGAGGGTCAGGGATTGCCTACGAGCAGTACTTC	CASSRGSGIAYEQYF	TRBV13	TRBJ2-7
TGTGCCAGCAGTTCGGGGAGGATGAACACCGGGGAGCTGTTTTTT	CASSSGRMNTGELFF	TRBV25-1	TRBJ2-2
TGTGCCAGCAGCTCTGAGACAGGGATCGAGACCCAGTACTTC	CASSSETGIETQYF	TRBV9	TRBJ2-5
TGCAGTCTCATCACCTCTGGAAACACCATATATTTT	CSLITSGNTIYF	TRBV20-1	TRBJ1-3
TGTGCCATGGTAGAGGGGGCGAGCGGGTACCTCCCCTTATCACCCCTCCACTTT	CAMVEGASGYLPLSPLHF	TRBV28	TRBJ1-6
TGTGCCAGCTCACCACGGCCCTCCACTGAAGCTTTCTTT	CASSPRPSTEAFF	TRBV18	TRBJ1-1
TGTGCCAGCAGCTGTCGGGGGACGGGCCACACCGGGGAGCTGTTTTTT	CASSCRGTGHTGELFF	TRBV7-2	TRBJ2-2
TGCGCCAGCAGTGAGGGCACGTTGACCCGTTCTAGAGGAAACACCATATATTTT	CASSEGTLTRSRGNTIYF	TRBV10-1	TRBJ1-3
TGTGCCAGTAGTATAGAACCTAGGGGGTTTTCCTACGAGCAGTACTTC	CASSIEPRGFSYEQYF	TRBV19	TRBJ2-7
TGTGCCAGCAGTCGGCGACTAGCGGGGGGGCTGTGCCAAGAGACCCAGTACTTC	CASSRRLAGGLCQETQYF	TRBV12-4	TRBJ2-5
TGTGCCAGCAGTTTATGCCAATCCGGGACAGGGGAACCTGAAGCTTTCTTT	CASSLCQSGTGEPEAFF	TRBV28	TRBJ1-1
TGTGCCAGCAGTGACTCCCGGTCTCATACGCAGTATTTT	CASSDSRSHTQYF	TRBV6-1	TRBJ2-3
TGCAGTGCTAGGACTCCCAGAGCGAACACCGGGGAGCTGTTTTTT	CSARTPRANTGELFF	TRBV20-1	TRBJ2-2
TGTGCCAGCAGTCCCGGTCTTAGGGGAGGGGGTCGCACCGGGGAGCTGTTTTTT	CASSPGLRGGGRTGELFF	TRBV6-1	TRBJ2-2
TGCAGTGCTAGAGGGGTGTGGAGGAACACTGAAGCTTTCTTT	CSARGVWRNTEAFF	TRBV20-1	TRBJ1-1
TGTGCCAGCAGTTTATGCGCCGGTATGGTGAACACTGAAGCTTTCTTT	CASSLCAGMVNTEAFF	TRBV28	TRBJ1-1
TGTGCCAGCAGTGACTCTTGGGGTCTCCCCTATGGCTACACCTTC	CASSDSWGLPYGYTF	TRBV6-4	TRBJ1-2
TGCGCCAGCAGCATAAAGGGGGGTGAAGCTTTCTTT	CASSIKGGEAFF	TRBV5-1	TRBJ1-1
TGTGCCAGCAGCTTAGCACTACAAACCCCCTCCCCCATGAACACTGAAGCTTTCTTT	CASSLALQTPSPMNTEAFF	TRBV7-4	TRBJ1-1
TGTGCCAGCAGTTTCGTTCTAGCGGCCTACGAGCAGTACTTC	CASSFVLAAYEQYF	TRBV27	TRBJ2-7
TGCAGTGCTAGAGGGGACAGGGGAGGTTATGAGCAGTTCTTC	CSARGDRGGYEQFF	TRBV20-1	TRBJ2-1
TGCACAACCGAGGGGTGGACCTACGAGCAGTACTTC	CTTEGWTYEQYF	TRBV20-1	TRBJ2-7
TGTGCCAGCAGCCCGGGACTTTGCATGGCGAACACTGAAGCTTTCTTT	CASSPGLCMANTEAFF	TRBV5-6	TRBJ1-1
TGTGCCAGCAGCTTCACATGCAGGGTGCGTGAAGCTTTCTTT	CASSFTCRVREAFF	TRBV7-3	TRBJ1-1
TGTGCCAGCAGCGTAGGGGCGCGCTATGGCTACACCTTC	CASSVGARYGYTF	TRBV9	TRBJ1-2
TGTGCCAGCAGCTCGGCTGGACTAGCGGGAAAAGAGACCCAGTACTTC	CASSSAGLAGKETQYF	TRBV7-3	TRBJ2-5
TGCGCCAGCAGCTTCCATACCGGTAAACTAGCGGGAGCCTACAATGAGCAGTTCTTC	CASSFHTGKLAGAYNEQFF	TRBV5-1	TRBJ2-1
TGCGCCAGCAGCCTTAACAGCGGCCAAGAGACCCAGTACTTC	CASSLNSGQETQYF	TRBV4-1	TRBJ2-5
TGTGCACGGGTGACAGATACGCAGTATTTT	CARVTDTQYF	TRBV12-3	TRBJ2-3
TGTGCCAGCAGCCGCGGGAGCTCTGGGGCCAACGTCCTGACTTTC	CASSRGSSGANVLTF	TRBV7-2	TRBJ2-6
TGTGCCAGCAGGGAGGGAGGGCCGTCGGTGACTAGGTACCTAGAGCAGTTCTTC	CASREGGPSVTRYLEQFF	TRBV7-2	TRBJ2-1
TGTGCCAGCGAACAGGGACAGGCTCAGTACTTC	CASEQGQAQYF	TRBV7-9	TRBJ2-4
TGTGCCAGCAGCCACCATATTTGCTGCACAGATACGCAGTATTTT	CASSHHICCTDTQYF	TRBV7-3	TRBJ2-3
TGTGCCAGTAGTAGTCAGAGAAATGAGCAGTTCTTC	CASSSQRNEQFF	TRBV19	TRBJ2-1
TGCGCCAGCAGCCAAGACGTGGGGCGGGGGTGGCTATACGAGCAGTACTTC	CASSQDVGRGWLYEQYF	TRBV4-1	TRBJ2-7
TGTGCCAGCAGCTTAGCGAGTTACGCCGGGACTGACACCGGGGAGCTGTTTTTT	CASSLASYAGTDTGELFF	TRBV7-2	TRBJ2-2
TGTGCCAGCAGTGGGGGAAATCAGCCCCAGCATTTT	CASSGGNQPQHF	TRBV12-4	TRBJ1-5
TGTGCCAGGTCGGAAAGAAAGCGGGGTCCAGAGACCCAGTACTTC	CARSERKRGPETQYF	TRBV2	TRBJ2-5
TGTGCCACCAGCCCTTGGCGGACAGGGCCGGGTGCGAACACTGAAGCTTTCTTT	CATSPWRTGPGANTEAFF	TRBV15	TRBJ1-1
TGTGCCAGCATTGATATCGGGGGACGACGGCACACTGAAGCTTTCTTT	CASIDIGGRRHTEAFF	TRBV11-3	TRBJ1-1
TGTGCTAGTGGTTACTGGACCTACGAGCAGTACTTC	CASGYWTYEQYF	TRBV12-5	TRBJ2-7
TGTGCCAGCAGCTCCGACAGGGGGAACCAAGCTTTCTTT	CASSSDRGNQAFF	TRBV11-2	TRBJ1-1
TGTGCCACCAGTACTCAGGGACAGGGGCCCCTCTCCTACGAGCAGTACTTC	CATSTQGQGPLSYEQYF	TRBV24-1	TRBJ2-7
TGTGCCTGGTTGTGGGATTCGGCAGGAGGGGGGGGAAACACTGAAGCTTTCTTT	CAWLWDSAGGGGNTEAFF	TRBV30	TRBJ1-1
TGTGCCAGCAGCTTAGCCATTCAGGGGAAACACACTGAAGCTTTCTTT	CASSLAIQGKHTEAFF	TRBV7-8	TRBJ1-1
TGTGCCACCAGTGACGGGACAGGGCCCCCGAACACCGGGGAGCTGTTTTTT	CATSDGTGPPNTGELFF	TRBV24-1	TRBJ2-2
TGTGCCAGCAGGAGGGATGAGCAGTTCTTC	CASRRDEQFF	TRBV6-1	TRBJ2-1
TGCGCCAGCAGCTTGCGAACAGCGAGGGGGCTTGCTACAACCTCTGGAAACACCATATATTTT	CASSLRTARGLATTSGNTIYF	TRBV5-1	TRBJ1-3
TGTGCCAGCAGCGTCCTGACAGGGAAGTATAGCAATCAGCCCCAGCATTTT	CASSVLTGKYSNQPQHF	TRBV13	TRBJ1-5
TGTGCCAGCAAAACAACCTCCTATGGCTACACCTTC	CASKTTSYGYTF	TRBV13	TRBJ1-2
TGTGCCAGCTCACGCTTTACCCGAGGGACCTACGAGCAGTACTTC	CASSRFTRGTYEQYF	TRBV9	TRBJ2-7
TGTGCCAGGTCAGGGGAGACCCAGTACTTC	CARSGETQYF	TRBV6-5	TRBJ2-5
TGTGCCAGCAGTTTACAATCGGGGGGGCAACCTCATGCCTACGAGCAGTACTTC	CASSLQSGGQPHAYEQYF	TRBV12-3	TRBJ2-7
TGTGCCAGCAGCCCCACGGAGCGAAACACCATATATTTT	CASSPTERNTIYF	TRBV7-7	TRBJ1-3
TGTGCCAGCAGTACCCCAAAGACAGGGGAGACAGATACGCAGTATTTT	CASSTPKTGETDTQYF	TRBV27	TRBJ2-3
TGTGCCAGCAGCTTAGATGCAGGGGCCGGCTCTGGAAACACCATATATTTT	CASSLDAGAGSGNTIYF	TRBV11-3	TRBJ1-3
TGTGCCAGCAGTCATCGCGTAGATGATACGCAGTATTTT	CASSHRVDDTQYF	TRBV6-4	TRBJ2-3
TGTGCCAGCAGCTTGGCCCGGGACAGGGGCGGTAACTATGGCTACACCTTC	CASSLARDRGGNYGYTF	TRBV13	TRBJ1-2
TGTGCCAGCAGCTTTACGGGTAGGGGGGTAGTCTCCTACAATGAGCAGTTCTTC	CASSFTGRGVVSYNEQFF	TRBV5-6	TRBJ2-1
TGTGCCATCAGTGAGCGACCCACAGGGGAAAAACTGTTTTTT	CAISERPTGEKLFF	TRBV10-3	TRBJ1-4
TGTGCCAGCTTAGACCGGGACAGGCTCTATGAGCAGTTCTTC	CASLDRDRLYEQFF	TRBV9	TRBJ2-1
TGTGCCAGTTGTCCTGGGCGAAGCACAGATACGCAGTATTTT	CASCPGRSTDTQYF	TRBV19	TRBJ2-3
TGCGCCAGCAGTGAGGCGGGAGGATTAGCCAAAAACATTCAGTACTTC	CASSEAGGLAKNIQYF	TRBV10-1	TRBJ2-4
TGTGCCAGCAGTTTTCCTACTAGCGGATGGCACACCGGGGAGCTGTTTTTT	CASSFPTSGWHTGELFF	TRBV6-3	TRBJ2-2
TGTGCTAGTGGTTTGGTACAACTTGTCCTCTACGAGCAGTACTTC	CASGLVQLVLYEQYF	TRBV12-5	TRBJ2-7
TGTGCCAGCCATCTTTCGCAGTATTTT	CASHLSQYF	TRBV7-8	TRBJ2-3
TGTGCCAGCAGTGACCCCCCCCCGGGACTAGCGGGGGGGCCCCCCTACTCCTACGAGCAGTACTTC	CASSDPPPGLAGGPPYSYEQYF	TRBV6-4	TRBJ2-7
TGTGCCAGCAGCTGCTTGGGGGGAGACACTGAAGCTTTCTTT	CASSCLGGDTEAFF	TRBV5-6	TRBJ1-1
TGTGCCAGCAGTTTAGCTAGCGGGAAATACGAGCAGTACTTC	CASSLASGKYEQYF	TRBV12-3	TRBJ2-7
TGCAGTGCTAGTCCAGGGAGCCTTCACTCCTACAATGAGCAGTTCTTC	CSASPGSLHSYNEQFF	TRBV20-1	TRBJ2-1
TGCAGTGCTAGCGGGGTAATAAGCACTGAAGCTTTCTTT	CSASGVISTEAFF	TRBV20-1	TRBJ1-1
TGCAGCGTTGCGGGGAGGGGGAGGGAGGGATCCTACGAGCAGTACTTC	CSVAGRGREGSYEQYF	TRBV29-1	TRBJ2-7
TGTGCCAGCAGAGGGCGAGGGACCTATAATTCACCCCTCCACTTT	CASRGRGTYNSPLHF	TRBV7-9	TRBJ1-6
TGTGCCAGCAGCCGGTTGCCCATCTACAATGAGCAGTTCTTC	CASSRLPIYNEQFF	TRBV13	TRBJ2-1
TGCGCCAGCAGCACTACGTTGACCGGGACTAGATTGACCAGCTCCTACAATGAGCAGTTCTTC	CASSTTLTGTRLTSSYNEQFF	TRBV5-1	TRBJ2-1
TGTGCCATCAGTGAGTTAGGGGCAGGCACAGATACGCAGTATTTT	CAISELGAGTDTQYF	TRBV10-3	TRBJ2-3
TGTGCCAGCAGCTTAGCGACGCATCGGAATGACGGAACAGATACGCAGTATTTT	CASSLATHRNDGTDTQYF	TRBV7-2	TRBJ2-3
TGTGCCTGGAGCCAGGGACAGGGGTGCCGTCAGCCCCAGCATTTT	CAWSQGQGCRQPQHF	TRBV30	TRBJ1-5
TGTGCCCCGACAGGGGGATATCAGCCCCAGCATTTT	CAPTGGYQPQHF	TRBV2	TRBJ1-5
TGCGCCAGCAGTCTAATAGAGACCCAGTACTTC	CASSLIETQYF	TRBV10-1	TRBJ2-5
TGTGCCACCAGTGGACTAGGGACGAGTAGCTCCTACAATGAGCAGTTCTTC	CATSGLGTSSSYNEQFF	TRBV24-1	TRBJ2-1
TGTGCCAGCAGCGTTAGGGGTCCACCGAGTGGCTACACCTTC	CASSVRGPPSGYTF	TRBV7-6	TRBJ1-2
TGTGCCAGCAGCTTAATATTCACTTACCTTTCCTACGAGCAGTACTTC	CASSLIFTYLSYEQYF	TRBV7-6	TRBJ2-7
TGTGCCAGCCAACCCCCCCCAGAGCAGCCCCAGCATTTT	CASQPPPEQPQHF	TRBV28	TRBJ1-5
TGTGCCAGCAGTTTCCCGAAACCGGGGGGGATAGAGACCCAGTACTTC	CASSFPKPGGIETQYF	TRBV27	TRBJ2-5
TGCGCCAGCTCGGACAGCGGGTCCTCACCCCTCCACTTT	CASSDSGSSPLHF	TRBV5-1	TRBJ1-6
TGTGCCAGCAGCTCTAAAAGAGGGGTTAATGAGCAGTTCTTC	CASSSKRGVNEQFF	TRBV13	TRBJ2-1
TGTGCCAGCAGTGACGGTAAGCGTCCCTACGAGCAGTACTTC	CASSDGKRPYEQYF	TRBV6-4	TRBJ2-7
TGTGCCAGCAGTTACCCCCTATTTGGCACGTCAACCTACAATGAGCAGTTCTTC	CASSYPLFGTSTYNEQFF	TRBV6-5	TRBJ2-1
TGTGCCAGCAGTCGACCCGGGGGGAGCAATGAGCAGTTCTTC	CASSRPGGSNEQFF	TRBV6-1	TRBJ2-1
TGTGCCAGCAGCGTAATGGGCAGCGGGCCAGGCACAGATACGCAGTATTTT	CASSVMGSGPGTDTQYF	TRBV11-2	TRBJ2-3
TGTGCCAGCAGTGATAAGGGACAGGGGGAGGTAGCAAACTATGGCTACACCTTC	CASSDKGQGEVANYGYTF	TRBV6-4	TRBJ1-2
TGTGCCAGCAGCGCTTACAGGTTCTCTGGGGCCAACGTCCTGACTTTC	CASSAYRFSGANVLTF	TRBV5-4	TRBJ2-6
TGTGCCAGCAGTAAGAGTAGGGCGGAAAGGCCGGTTGTTAGCAATCAGCCCCAGCATTTT	CASSKSRAERPVVSNQPQHF	TRBV27	TRBJ1-5
TGCGCCAGCAGTGGGGGGGCCAGGGGGATTTACTATGGCTACACCTTC	CASSGGARGIYYGYTF	TRBV5-1	TRBJ1-2
TGTGCCAGTAGTATCCGGCCTCGGGGCTACGAGCAGTACTTC	CASSIRPRGYEQYF	TRBV19	TRBJ2-7
TGTGCCAGCGAAGGGACTAGCGGGGGGGCCATCAATGAGCAGTTCTTC	CASEGTSGGAINEQFF	TRBV19	TRBJ2-1
TGTGCCAGCAGCAGGAACTACCAAGAGACCCAGTACTTC	CASSRNYQETQYF	TRBV6-5	TRBJ2-5
TGTGCCAGCAGTTTAGATGCCACCTCGGGCCGGGAGACCCAGTACTTC	CASSLDATSGRETQYF	TRBV27	TRBJ2-5
TGTGCCAGCAGCGTAGAGCCGGGACTGGTGGACGGTAGCTACATTCAGTACTTC	CASSVEPGLVDGSYIQYF	TRBV9	TRBJ2-4
TGTGCCAGCAGTGAAGGCGAGGGAGATGAGCAGTTCTTC	CASSEGEGDEQFF	TRBV6-1	TRBJ2-1
TGTGCCAGCAGCTTTACAGGGGGCTACTTC	CASSFTGGYF	TRBV11-3	TRBJ1-2
TGTGCCAGCAGCGACGGGACAGGTCGGTACGAGCAGTACTTC	CASSDGTGRYEQYF	TRBV6-8	TRBJ2-7
TGTGCCAGCATTGGACAGGGGCGCTCCTACGAGCAGTACTTC	CASIGQGRSYEQYF	TRBV6-5	TRBJ2-7
TGTGCCAGCAGTCTCGCAGGTTCTGCTTGGGAAAAACTGTTTTTT	CASSLAGSAWEKLFF	TRBV27	TRBJ1-4
TGTGCCAGTAGTATCAGGAAAGTAAACACCGGGGAGCTGTTTTTT	CASSIRKVNTGELFF	TRBV19	TRBJ2-2
TGTGCCAGCAGCAAACTGGAGGCTGAAGGGCGTGGCGGGGAGCTGTTTTTT	CASSKLEAEGRGGELFF	TRBV9	TRBJ2-2
TGTGCCTGGACCGGGGGGTTAATCACGCGGGAAGACTACGAGCAGTACTTC	CAWTGGLITREDYEQYF	TRBV30	TRBJ2-7
TGCGCCAGCAGCCAAGAAGAAAGGACAGGCCTCAATGCCTACGAGCAGTACTTC	CASSQEERTGLNAYEQYF	TRBV4-1	TRBJ2-7
TGTGCCAGCAGCCGAGACGACAGGGGGGAGAAGGGTGAGACCCAGTACTTC	CASSRDDRGEKGETQYF	TRBV7-9	TRBJ2-5
TGTGCCAGCAAGGGGGGGTCTCCCTACAATGAGCAGTTCTTC	CASKGGSPYNEQFF	TRBV28	TRBJ2-1
TGCAGTGCAACCCCGGGACGGTCGGACACCGGGGAGCTGTTTTTT	CSATPGRSDTGELFF	TRBV20-1	TRBJ2-2
TGTGCCTGGAGGTCTAGCGGACTCCTCCGGAGCACCTACGAGCAGTACTTC	CAWRSSGLLRSTYEQYF	TRBV30	TRBJ2-7
TGTGCCAGCAGCTTCTCACAGGGGTGCACAGATACGCAGTATTTT	CASSFSQGCTDTQYF	TRBV11-2	TRBJ2-3
TGTGCCAGCAGCCGTCCAGAAGACGGATTCTACGAGCAGTACTTC	CASSRPEDGFYEQYF	TRBV9	TRBJ2-7
TGTGCCAGCAGTTCCATAGCGGGCTTCTACGAGCAGTACTTC	CASSSIAGFYEQYF	TRBV7-8	TRBJ2-7
TGTGCCAGCAGTGAAGTAGTCTTTACTAGCGGGAGGTGGAGGCAGTACTTC	CASSEVVFTSGRWRQYF	TRBV6-1	TRBJ2-7
TGCGCCCAGGGCAGCGGCACAGATACGCAGTATTTT	CAQGSGTDTQYF	TRBV10-2	TRBJ2-3
TGTGCCAGCAGTGTGGCCGGGACAGGGAGAGTGATACAGCCCCAGCATTTT	CASSVAGTGRVIQPQHF	TRBV12-3	TRBJ1-5
TGCAGTGCTAGAGCTGGGCCTGAGACCCAGTACTTC	CSARAGPETQYF	TRBV20-1	TRBJ2-5
TGTGCCAGCAGCTTGCGGGCAAGGGTCGTCCCAGGGCGGGACACACAAGAGACCCAGTACTTC	CASSLRARVVPGRDTQETQYF	TRBV5-6	TRBJ2-5
TGCAGTGCTCCTACACTGGGCACAGATACGCAGTATTTT	CSAPTLGTDTQYF	TRBV20-1	TRBJ2-3
TGTGCCACGCAGGGGTCCGGGGAGCTGTTTTTT	CATQGSGELFF	TRBV6-3	TRBJ2-2
TGTGCCAGCAGTTTATTGGCGAGATCACAGGGGAAAACCTACGAGCAGTACTTC	CASSLLARSQGKTYEQYF	TRBV27	TRBJ2-7
TGTGCCAGCAGCCGGTTCGGGATAGGGGTACTTCAGCCCCAGCATTTT	CASSRFGIGVLQPQHF	TRBV3-1	TRBJ1-5
TGCAGTGCCTTTAAGGGGCGACGGTTCTACGAGCAGTACTTC	CSAFKGRRFYEQYF	TRBV20-1	TRBJ2-7
TGTGCCAGCAGTGAAAAGATCGACCTAGGGGGGCTTACCCTGAACACCGGGGAGCTGTTTTTT	CASSEKIDLGGLTLNTGELFF	TRBV6-1	TRBJ2-2
TGTGCCAGCAGCTCCAATACAGATACGCAGTATTTT	CASSSNTDTQYF	TRBV11-2	TRBJ2-3
TGTGCCAGCAGTTGTCCTACCGTAAGAGGCTATGGCTACACCTTC	CASSCPTVRGYGYTF	TRBV12-3	TRBJ1-2
TGCAGTGCAACAATACCAGGCCCGCATGAGCAGTTCTTC	CSATIPGPHEQFF	TRBV20-1	TRBJ2-1
TGCAGTGCTAGGACTAGCGGGCAGCGACGTACAGAGCAGTTCTTC	CSARTSGQRRTEQFF	TRBV20-1	TRBJ2-1
TGTGCCAGCAGACCACTAGCGGGAGTGGAAGATACGCAGTATTTT	CASRPLAGVEDTQYF	TRBV6-4	TRBJ2-3
TGTGCCAGCAGCTGGGAGGGCCCAGGACGGATGAACACTGAAGCTTTCTTT	CASSWEGPGRMNTEAFF	TRBV11-3	TRBJ1-1
TGTGATCCGCAGACTAGCGGGAGGTGCTACGAGCAGTACTTC	CDPQTSGRCYEQYF	TRBV27	TRBJ2-7
TGTGCCAGACCAGGGGATGGCTACACCTTC	CARPGDGYTF	TRBV7-6	TRBJ1-2
TGTGCCAGCAGCTTACGGGGGGGCTCTTCTGAGCAGTTCTTC	CASSLRGGSSEQFF	TRBV6-6	TRBJ2-1
TGTGCCAGCAGTCGTAAGGGGGGACTTAATGAAAAACTGTTTTTT	CASSRKGGLNEKLFF	TRBV7-9	TRBJ1-4
TGCGCCAGCAAAATTCTCAGGGGGATGAACACTGAAGCTTTCTTT	CASKILRGMNTEAFF	TRBV10-1	TRBJ1-1
TGTGCCATCCGGCGACAGGGCTACGAGCAGTACTTC	CAIRRQGYEQYF	TRBV10-3	TRBJ2-7
TGTGCCATCAGGGGGGCGGAGCTTGAAGCTTTCTTT	CAIRGAELEAFF	TRBV10-3	TRBJ1-1
TGCGCCAGCAGTCGGACCGACTACGAGCAGTACTTC	CASSRTDYEQYF	TRBV10-1	TRBJ2-7
TGTGCCAGCAGTGAGACCCCGTTGGCCACCGGGGAGCTGTTTTTT	CASSETPLATGELFF	TRBV25-1	TRBJ2-2
TGTGCCAGCAGTTACTCCGGACACATTCAGTACTTC	CASSYSGHIQYF	TRBV6-3	TRBJ2-4
TGTGCCAGCAGTTTAAGAGGTAGCGGACTCTCCTACGAGCAGTACTTC	CASSLRGSGLSYEQYF	TRBV28	TRBJ2-7
TGCGCCAGCAGCTTGAGACAGCGCCCCAGGCTTGCAACTAATGAAAAACTGTTTTTT	CASSLRQRPRLATNEKLFF	TRBV5-1	TRBJ1-4
TGCGCCAGCAGCTCGTGCGGGAGGTTCCGGGATACGCAGTATTTT	CASSSCGRFRDTQYF	TRBV5-1	TRBJ2-3
TGTGCCAGCAGTGGGGACAGGCTTATGAACACTGAAGCTTTCTTT	CASSGDRLMNTEAFF	TRBV27	TRBJ1-1
TGTGCCTGGAGTTTGGACGAGACTCTGAGCACAGATACGCAGTATTTT	CAWSLDETLSTDTQYF	TRBV30	TRBJ2-3
TGTGCCAGCAGTTACTGCGGGGGCTCCGGGACCTACGAGCAGTACTTC	CASSYCGGSGTYEQYF	TRBV6-2	TRBJ2-7
TGTGCCAGCAGTTACAACTATGCGGACAGGGGGGCGGGTGAAAATCAGCCCCAGCATTTT	CASSYNYADRGAGENQPQHF	TRBV6-6	TRBJ1-5
TGTGCCAGCAGCTTGGAGCCAGGGGGGAACCGGTACGAGCAGTACTTC	CASSLEPGGNRYEQYF	TRBV5-6	TRBJ2-7
TGTGCCAGCAGCATCCTTAATTGCGGGAGGTTTAATCAGCCCCAGCATTTT	CASSILNCGRFNQPQHF	TRBV5-6	TRBJ1-5
TGTGCCAGCAGTTACCCCAGAATGAACACTGAAGCTTTCTTT	CASSYPRMNTEAFF	TRBV6-6	TRBJ1-1
TGTGCCAGCAGTGACTCCCGCCCGGGACTAGTCCTGGAAGAGACCCAGTACTTC	CASSDSRPGLVLEETQYF	TRBV6-4	TRBJ2-5
TGCGCCAGCAGCCAAGGGACAGCCCTCAATATCTCTGGGGCCAACGTCCTGACTTTC	CASSQGTALNISGANVLTF	TRBV5-1	TRBJ2-6
TGTGCTAGTGGTTCTACAGGGCAAGGTAGGTTGAACACTGAAGCTTTCTTT	CASGSTGQGRLNTEAFF	TRBV12-5	TRBJ1-1
TGTGCCAGCAGCTGTTCCCCAGGAGGGGAAACCTACGAGCAGTACTTC	CASSCSPGGETYEQYF	TRBV7-6	TRBJ2-7
TGTGCCAGCTCACCACAACGACAAAGTCGAAGGGAGCAGTTCTTC	CASSPQRQSRREQFF	TRBV18	TRBJ2-1
TGTGCCAGCAGCTTAGAGTCGGGGCACCGGAGCTACGAGCAGTACTTC	CASSLESGHRSYEQYF	TRBV7-4	TRBJ2-7
TGCAGTGCTAGGTACCCAGTAGCAGGGAGGGAGGGTAACACTGAAGCTTTCTTT	CSARYPVAGREGNTEAFF	TRBV20-1	TRBJ1-1
TGCGCCAGCAGCCGAAGTGGGGGCCGGCAGTTCTTC	CASSRSGGRQFF	TRBV4-1	TRBJ2-1
TGTGCCAGCAGCTTTCAGGGGGGATATTGTCAGCCCCAGCATTTT	CASSFQGGYCQPQHF	TRBV11-3	TRBJ1-5
TGTGCCAGCAGCCATAAGGGGCTCAATGAGCAGTTCTTC	CASSHKGLNEQFF	TRBV3-1	TRBJ2-1
TGCGCCAGCAGCTATAACGAGGGGATGTCCCATGGCTACACCTTC	CASSYNEGMSHGYTF	TRBV5-1	TRBJ1-2
TGTGCCAGCAGCGGGGGGCGGGAGGCGGCAGCGGCCTACGAGCAGTACTTC	CASSGGREAAAAYEQYF	TRBV9	TRBJ2-7
TGTGCTAGTGGTTTACCCAGGGGTGATCCCTTGCGACGAGAGACCCAGTACTTC	CASGLPRGDPLRRETQYF	TRBV12-5	TRBJ2-5
TGTGCCAGCACCAAGGATATCGAGGGTTCTGGAAACACCATATATTTT	CASTKDIEGSGNTIYF	TRBV28	TRBJ1-3
TGTGCCAGCAGCTTGCAGGAGAAGTCACAAATAACTAATGAAAAACTGTTTTTT	CASSLQEKSQITNEKLFF	TRBV7-2	TRBJ1-4
TGTGCCAGCAGCCTAGCGGGTCAAATGCCCGGGGAGCTGTTTTTT	CASSLAGQMPGELFF	TRBV5-4	TRBJ2-2
TGTGCCTGGAGTGGGACGGGCGGGTACGAGCAGTACTTC	CAWSGTGGYEQYF	TRBV30	TRBJ2-7
TGCGCCAGCAGAATGTGCTTTCCCGGGACGAGGGAGAATGAGCAGTTCTTC	CASRMCFPGTRENEQFF	TRBV5-1	TRBJ2-1
TGTGCCATCAGACAACTCGGGGGCCCGGACGAGCAGTACTTC	CAIRQLGGPDEQYF	TRBV10-3	TRBJ2-7
TGTGCCAGTGGAATTAAGGACGACACTGAAGCTTTCTTT	CASGIKDDTEAFF	TRBV6-4	TRBJ1-1
TGCGCCAGCAGCTTGGAGGTGAGAGTTGAAAAACTGTTTTTT	CASSLEVRVEKLFF	TRBV5-1	TRBJ1-4
TGTGCCAGCAGCCAAGTTAAACGACAGGGTCTGAGCAATCAGCCCCAGCATTTT	CASSQVKRQGLSNQPQHF	TRBV4-2	TRBJ1-5
TGTGCCAGCAGCCCCCCCCCACAGGGTAAAGGGTACTGGTCCTACGAGCAGTACTTC	CASSPPPQGKGYWSYEQYF	TRBV11-2	TRBJ2-7
TGTGCCAGCAGTTTAGTGGTGCCACGGGGGTCGAGCACCTACGAGCAGTACTTC	CASSLVVPRGSSTYEQYF	TRBV27	TRBJ2-7
TGTGCCAGCAGCTTATCTGGTCAGGGTGGCTACGAGCAGTACTTC	CASSLSGQGGYEQYF	TRBV11-1	TRBJ2-7
TGTGCCAGCAGCTTTCCACTAGCGGGAGGGCGGGGGGCAGATACGCAGTATTTT	CASSFPLAGGRGADTQYF	TRBV7-2	TRBJ2-3
TGCGCCAGCAGCTTTTCAGGGGAGGGGGATCAGCCCCAGCATTTT	CASSFSGEGDQPQHF	TRBV5-1	TRBJ1-5
TGTGCCAGCAGCCCAATGAACAGGGGCAGAGGAGGGGAGCTGTTTTTT	CASSPMNRGRGGELFF	TRBV7-3	TRBJ2-2
TGCAGTGTAAGAGACGGGACAGGGCTCGACATGAACACTGAAGCTTTCTTT	CSVRDGTGLDMNTEAFF	TRBV20-1	TRBJ1-1
TGTGCCATCCATACTTGCGGGGAGCTGTTTTTT	CAIHTCGELFF	TRBV6-4	TRBJ2-2
TGTGCCAGCAGTTTAGGTCTCCAGAAGAACACTGAAGCTTTCTTT	CASSLGLQKNTEAFF	TRBV12-3	TRBJ1-1
TGTGCCAGCAGTTCGGGGACCCCGGGTGAGCAGTTCTTC	CASSSGTPGEQFF	TRBV28	TRBJ2-1
TGTGCCAGCAGTCTCTCCGGGACAGGGACGAATGGAAGCAATCAGCCCCAGCATTTT	CASSLSGTGTNGSNQPQHF	TRBV2	TRBJ1-5
TGCAGTGCTAGAGATATTGTAGCGCCGGGACAGGGTATGACAGCTTTCTTT	CSARDIVAPGQGMTAFF	TRBV20-1	TRBJ1-1
TGTGCCAGCACTCCAAACTATGGCTACACCTTC	CASTPNYGYTF	TRBV28	TRBJ1-2
TGCGCCATATGGACGGGACAGGGGGCAGGGATGAACACTGAAGCTTTCTTT	CAIWTGQGAGMNTEAFF	TRBV10-2	TRBJ1-1
TGTGCCACCAGTATCGCTACCGGCGCAGCCTCCTATAATTCACCCCTCCACTTT	CATSIATGAASYNSPLHF	TRBV24-1	TRBJ1-6
TGTGCCAGCAGCCTTTCGGGCCGGGACAGGGACGTAGATACGCAGTATTTT	CASSLSGRDRDVDTQYF	TRBV7-3	TRBJ2-3
TGTGCCAGCAGCCGACCGATGGGAGGGTACGAGCAGTACTTC	CASSRPMGGYEQYF	TRBV7-3	TRBJ2-7
TGTGCCATAGGGCAAACGGGGGGTGAGCAGTACTTC	CAIGQTGGEQYF	TRBV6-2	TRBJ2-7
TGTGCCACCAGTGAAAGCCAGGCAGCTTTCTTT	CATSESQAAFF	TRBV24-1	TRBJ1-1
TGTGCCACCAGTGCCCGGAGGGTCACTGAAGCTTTCTTT	CATSARRVTEAFF	TRBV24-1	TRBJ1-1
TGTGCCAGCAGTTACATTGCCGGGACAGGGAGCAACTATGGCTACACCTTC	CASSYIAGTGSNYGYTF	TRBV6-5	TRBJ1-2
TGTGCCACCAGTGATCCGCAGGGGTGGCCTGAAGCTTTCTTT	CATSDPQGWPEAFF	TRBV24-1	TRBJ1-1
TGTGCCAGCAGTGGGTGGGGCTGGTCTTTGTACGAGCAGTACTTC	CASSGWGWSLYEQYF	TRBV6-1	TRBJ2-7
TGTGCCATCAAGGCGGGACAAGGGGATCAGCCCCAGCATTTT	CAIKAGQGDQPQHF	TRBV10-3	TRBJ1-5
TGTGCCAGCAGCTGGGGTGACGTTGTGTACGAGCAGTACTTC	CASSWGDVVYEQYF	TRBV5-6	TRBJ2-7
TGTAAATTCGAGCCGGGACCCCGGCCCCAGCATTTT	CKFEPGPRPQHF	TRBV7-9	TRBJ1-5
TGTGCCTGGAGTGCCCTGGGACAGAGCAATCAGCCCCAGCATTTT	CAWSALGQSNQPQHF	TRBV30	TRBJ1-5
TGTGCCAGCAGTTTCACCCTGGGACTAGCGGGCTACGAGCAGTACTTC	CASSFTLGLAGYEQYF	TRBV12-4	TRBJ2-7
TGTGCCAGCAATAGTCAGGGCCGAGGAAACTACGAGCAGTACTTC	CASNSQGRGNYEQYF	TRBV6-5	TRBJ2-7
TGTGCCAGCAGCCGCGGACAGGGGGATGGCTACACCTTC	CASSRGQGDGYTF	TRBV7-8	TRBJ1-2
TGTGCCATCAGTGAGTTTGTAATTAGCGGGTACGAGCAGTACTTC	CAISEFVISGYEQYF	TRBV10-3	TRBJ2-7
TGCAGCGTTGAAGCCGGGACAGCTGGCGCTTTCTTT	CSVEAGTAGAFF	TRBV29-1	TRBJ1-1
TGTGCCAACGGGCCCCGGGTAAGACATTCCTACGAGCAGTACTTC	CANGPRVRHSYEQYF	TRBV18	TRBJ2-7
TGTGCCAGCAGTTACTCGACCCCCGAAGGACAGGGAAAGGGCTTCTACGAGCAGTACTTC	CASSYSTPEGQGKGFYEQYF	TRBV6-6	TRBJ2-7
TGTGCCAGTTGCGTAACGGGCTGTTGGTCCCAGCATTTT	CASCVTGCWSQHF	TRBV2	TRBJ1-5
TGTGCCAGCAGTTATTGGGATCTGCAGTACTTC	CASSYWDLQYF	TRBV6-3	TRBJ2-7
TGCGCCAGCAGCCAAGAGTTGGGGGGGGCTAGCACAGATACGCAGTATTTT	CASSQELGGASTDTQYF	TRBV4-1	TRBJ2-3
TGTGCCAGCAGGGTTATGGGGGGGACCGGGGAGCTGTTTTTT	CASRVMGGTGELFF	TRBV6-4	TRBJ2-2
TGTGCCAGCAGCTGTCGGGGGGCTCGGGGTGAGACCCAAGAGACCCAGTACTTC	CASSCRGARGETQETQYF	TRBV11-3	TRBJ2-5
TGTGCCAGCAGCTTGGACCTGGAGCGTAACATTCAGTACTTC	CASSLDLERNIQYF	TRBV5-5	TRBJ2-4
TGTGCTAGCAGCTTAGCGGTTAATGGACAGGGGGTAAAACTGTTTTTT	CASSLAVNGQGVKLFF	TRBV7-7	TRBJ1-4
TGTGCCAGCAGCTTCCGCCCGGGACATGGGAGCTCCTACGAGCAGTACTTC	CASSFRPGHGSSYEQYF	TRBV7-6	TRBJ2-7
TGTGCCAGCAGTTACACCCCTAGAATCCCCGGGGAGCTGTTTTTT	CASSYTPRIPGELFF	TRBV6-5	TRBJ2-2
TGTGCCAGCAGCCAAGATACAGGGGGCCTAAGGGATAGCAATCAGCCCCAGCATTTT	CASSQDTGGLRDSNQPQHF	TRBV4-2	TRBJ1-5
TGTGCCAGCTCACCGGGGGCTTCTCGGGTAGGGTGCTACAATGAGCAGTTCTTC	CASSPGASRVGCYNEQFF	TRBV18	TRBJ2-1
TGCAGTGCTAGAGATCCACCCGACGCGGGACTAGCGGGTACTGACCAAGATGAGCAGTTCTTC	CSARDPPDAGLAGTDQDEQFF	TRBV20-1	TRBJ2-1
TGTGCCAGCAGCCGTGGGGCCCAGATCGAGTACTTC	CASSRGAQIEYF	TRBV13	TRBJ2-7
TGCGCCAGCAGTGTGCCCTGGACGGGTTGGGTTTCCTATGGCTACACCTTC	CASSVPWTGWVSYGYTF	TRBV10-2	TRBJ1-2
TGTGCCAGCAGTGACCAGACACACGGAAACGAGAACTCCTACGAGCAGTACTTC	CASSDQTHGNENSYEQYF	TRBV6-4	TRBJ2-7
TGTGCCAGCAGCCAAGACGGCATTCCGGGCTACACCTTC	CASSQDGIPGYTF	TRBV14	TRBJ1-2
TGCGCCAGCAGCACAGAGCCCCAGCATTTT	CASSTEPQHF	TRBV5-1	TRBJ1-5
TGTGCCAGCTCACCCCGCGGCCGGGAAAAACTGTTTTTT	CASSPRGREKLFF	TRBV18	TRBJ1-4
TGTGCCAGCAGCGGGACAGGGAATAGCTCTGGGGCCAACGTCCTGACTTTC	CASSGTGNSSGANVLTF	TRBV7-2	TRBJ2-6
TGTGCCAGCAGCTTGGGGGCGTCGGTCGACGAGCAGTACTTC	CASSLGASVDEQYF	TRBV5-6	TRBJ2-7
TGTGCCAGCACCAGGGAAGAGACCCAGTACTTC	CASTREETQYF	TRBV28	TRBJ2-5
TGTGCCAGCAGTTACAGGGTCTCCTCCTACGAGCAGTACTTC	CASSYRVSSYEQYF	TRBV12-4	TRBJ2-7
TGCGCCAGCAGGGCCGCGACAGACGGCGCACGCTATGGCTACACCTTC	CASRAATDGARYGYTF	TRBV10-1	TRBJ1-2
TGTGCCAGCAGCGCGGGTGACAGGCCATACGGGGAGCTGTTTTTT	CASSAGDRPYGELFF	TRBV9	TRBJ2-2
TGTGCCAGCACCAACCTGGAGAGACAGGGGGCAGCTTTCTTT	CASTNLERQGAAFF	TRBV7-3	TRBJ1-1
TGTGCCAGTAGGGGGCTGGATGACACAGATACGCAGTATTTT	CASRGLDDTDTQYF	TRBV19	TRBJ2-3
TGTGCCAGCACAGGGGCCTCCTACGAGCAGTACTTC	CASTGASYEQYF	TRBV28	TRBJ2-7
TGCGCCAGCAGTGAGCCCCGGGACACTTCAGAAGCTTTCTTT	CASSEPRDTSEAFF	TRBV10-2	TRBJ1-1
TGTGCCAGCAGCAACTTATCGGCGATTCGGGACGGGACTAGCGGGGGATACGAGCAGTACTTC	CASSNLSAIRDGTSGGYEQYF	TRBV7-9	TRBJ2-7
TGTGCCAGCAGTTACCCGTGGTCACCGTCCGGGACAGGGAGGAATGAAAAACTGTTTTTT	CASSYPWSPSGTGRNEKLFF	TRBV6-6	TRBJ1-4
TGTGCCAGCAGCTTAGCTAGGGGGCGGAAGGCATATTATGGCTACACCTTC	CASSLARGRKAYYGYTF	TRBV11-3	TRBJ1-2
TGTGCCAGCAGCCAAGACGTTGTACAGGGGGCACGCGGTAACTATGGCTACACCTTC	CASSQDVVQGARGNYGYTF	TRBV3-1	TRBJ1-2
TGTGCCAGCAGCTTGAAAAAAAAAAACAGGGGCTCCTACGAGCAGTACTTC	CASSLKKKNRGSYEQYF	TRBV5-4	TRBJ2-7
TGTGCCAGCAGTTTAGCTAGCGGGCCCAATGAGCAGTTCTTC	CASSLASGPNEQFF	TRBV12-3	TRBJ2-1
TGCGCCAGCATTCTGTGCAGGGGGAACACTGAAGCTTTCTTT	CASILCRGNTEAFF	TRBV5-1	TRBJ1-1
TGTGCCACCGGCCTGAGTTGGGGTGAGCAGTTCTTC	CATGLSWGEQFF	TRBV24-1	TRBJ2-1
TGCGCCAGCAGCCAAGCAAGGCGGGGAGGGAGAATACCTGACACTGAAGCTTTCTTT	CASSQARRGGRIPDTEAFF	TRBV4-1	TRBJ1-1
TGCGCCAGCAGCCCTTGGCCGGGGGGAGAGCAGTACTTC	CASSPWPGGEQYF	TRBV5-1	TRBJ2-7
TGTGCCAGATCCCAGGACCCGGTGACTTTTGCCGAATATAGCACAGATACGCAGTATTTT	CARSQDPVTFAEYSTDTQYF	TRBV27	TRBJ2-3
TGCGCCAGCAGCCCGGGGGTGAACACTGAAGCTTTCTTT	CASSPGVNTEAFF	TRBV10-1	TRBJ1-1
TGCGCCAGCAGCTTGGTGGACATCTACGAGCAGTACTTC	CASSLVDIYEQYF	TRBV5-1	TRBJ2-7
TGTGCCAGCCCCAAGCGGGAGGATGAAAAACTGTTTTTT	CASPKREDEKLFF	TRBV7-4	TRBJ1-4
TGCAGCGTTGAAGATAGACCAAGCTGGACAGACCGCGAGACCCAGTACTTC	CSVEDRPSWTDRETQYF	TRBV29-1	TRBJ2-5
TGTGCCTGGGTCAAGGGACAGGGGCATCGTGGCTACACCTTC	CAWVKGQGHRGYTF	TRBV30	TRBJ1-2
TGCAGTGCCACAGCGGGAAGGGGCAATGAGCAGTTCTTC	CSATAGRGNEQFF	TRBV20-1	TRBJ2-1
TGTGCCGCACAGGGCCACTATGGCTACACCTTC	CAAQGHYGYTF	TRBV6-2	TRBJ1-2
TGTGCCAGCAGTGGACGGGAGCTTTATGGCTACACCTTC	CASSGRELYGYTF	TRBV28	TRBJ1-2
TGTGCCAGCAGTTACGACCGGCGGGGCAAGACGGAGACCCAGTACTTC	CASSYDRRGKTETQYF	TRBV6-5	TRBJ2-5
TGTGCCTGGAGTGTCACGTCCGGGGCCGATGAAGCTTTCTTT	CAWSVTSGADEAFF	TRBV30	TRBJ1-1
TGTGCCAGCAGAACGGCCGGGGACAGGAGCGGTGTAAATCAGCCCCAGCATTTT	CASRTAGDRSGVNQPQHF	TRBV9	TRBJ1-5
TGTGCCAGCATGGTCGGGACAGGTACGGAACATAATTCACCCCTCCACTTT	CASMVGTGTEHNSPLHF	TRBV6-1	TRBJ1-6
TGTGCCAGCAGTGAACATTCTAAGTCTAGCGGGGGGGCCCACAATGAGCAGTTCTTC	CASSEHSKSSGGAHNEQFF	TRBV6-1	TRBJ2-1
TGTGCCATCAGTGACGTAAGGGGCCCTAACCGGGAGTACTTC	CAISDVRGPNREYF	TRBV10-3	TRBJ2-4
TGTGCCAGCACACCGGGACTAGCGGGAGTATCCAGGGAAGGCCATTCACCCCTCCACTTT	CASTPGLAGVSREGHSPLHF	TRBV6-1	TRBJ1-6
TGTGCCAGCAGCAAAGGCCACTCCTACGAGCAGTACTTC	CASSKGHSYEQYF	TRBV28	TRBJ2-7
TGTGCCAGCAGGGTAGTGCACGGACTAGGGATAGCAGATACGCAGTATTTT	CASRVVHGLGIADTQYF	TRBV6-6	TRBJ2-3
TGTGCCAGCAGCGCTGGGGGGCCAAAGAATCAGCCCCAGCATTTT	CASSAGGPKNQPQHF	TRBV7-3	TRBJ1-5
TGTGCCAGCAGTTTAAAGCCCAGGGCATATTCACCCCTCCACTTT	CASSLKPRAYSPLHF	TRBV27	TRBJ1-6
TGTGCCAGCTCGGAGGTAGGGCATCGGGACAGGGGATCTAGCAATCAGCCCCAGCATTTT	CASSEVGHRDRGSSNQPQHF	TRBV18	TRBJ1-5
TGTGCCACTACAGCGGGAGGTTACGAGCAGTACTTC	CATTAGGYEQYF	TRBV6-8	TRBJ2-7
TGTGCCAGCAGTGTGAGGGCGGGGGGGGTGCGCAATGAGCAGTTCTTC	CASSVRAGGVRNEQFF	TRBV6-5	TRBJ2-1
TGCGCCAGTCTAGGCCCAAAGGGGACGCACACCGGGGAGCTGTTTTTT	CASLGPKGTHTGELFF	TRBV10-1	TRBJ2-2
TGTGCCAGCAGTGATCCAGCGGATAATTCACCCCTCCACTTT	CASSDPADNSPLHF	TRBV2	TRBJ1-6
TGTGCCACCAGTGATTGCCACACCGCCAGGAGGCAGTACTTC	CATSDCHTARRQYF	TRBV24-1	TRBJ2-5
TGTGCCAGCAGGAGGTCTGGGACTACTCTTAGCACAGATACGCAGTATTTT	CASRRSGTTLSTDTQYF	TRBV12-3	TRBJ2-3
TGTGCCTTAGGGCCCGGTATCACAGATACGCAGTATTTT	CALGPGITDTQYF	TRBV30	TRBJ2-3
TGTGCCAGCTCTCCTCTTAACAGTGCCGACTATGGCTACACCTTC	CASSPLNSADYGYTF	TRBV6-6	TRBJ1-2
TGTGCCAGCAGAAGGGCCGGCCCGCGCGAGACCCAGTACTTC	CASRRAGPRETQYF	TRBV6-3	TRBJ2-5
TGTGCCATACATAGGGACACGAGTGCCTCTGGGGCCAACGTCCTGACTTTC	CAIHRDTSASGANVLTF	TRBV27	TRBJ2-6
TGCGCCAGCAGCTATTCGACAGGGGGAGCAAAACTGTTTTTT	CASSYSTGGAKLFF	TRBV5-1	TRBJ1-4
TGTGCCACCCTGGGGAGGGTCTCTGGGGCCAACGTCCTGACTTTC	CATLGRVSGANVLTF	TRBV27	TRBJ2-6
TGTGCCAGCAGTTACACAGGGGGGGCCAATCAGCCCCAGCATTTT	CASSYTGGANQPQHF	TRBV28	TRBJ1-5
TGCGCCATTCCTTTGGGGACAGGGCCAGCTTTCTTT	CAIPLGTGPAFF	TRBV10-1	TRBJ1-1
TGTGCCAGCAGTAGCAACCAGGACAGGGACCCTAACTATGGCTACACCTTC	CASSSNQDRDPNYGYTF	TRBV6-1	TRBJ1-2
TGTGCCATCTTGACAGGGGGCAGGGATCAGCCCCAGCATTTT	CAILTGGRDQPQHF	TRBV19	TRBJ1-5
TGTGCCAGCAGCTGGGGGGGCGTCTATACGCAGTATTTT	CASSWGGVYTQYF	TRBV7-3	TRBJ2-3
TGTGCCAGCAGCTTCAGGGGGTCTAACTATGGCTACACCTTC	CASSFRGSNYGYTF	TRBV13	TRBJ1-2
TGTGCCAGCAGCGTAGCGGGGGCTAGGGCTGGGGCCAACGTCCTGACTTTC	CASSVAGARAGANVLTF	TRBV9	TRBJ2-6
TGTGCCAGCAGGGCGCCGGGCCCGTCCTACGAGCAGTACTTC	CASRAPGPSYEQYF	TRBV14	TRBJ2-7
TGCGCCAGCAGTGAGTCCAGGGCCCCCCAGGGGGGGAACACTGAAGCTTTCTTT	CASSESRAPQGGNTEAFF	TRBV10-1	TRBJ1-1
TGCAGTGCTAGAGCAGGGGGGAGGACAAACATTGTAAATCAGCCCCAGCATTTT	CSARAGGRTNIVNQPQHF	TRBV20-1	TRBJ1-5
TGCAGTGCTATCCGGGGGCTAACTAGCACAGATACGCAGTATTTT	CSAIRGLTSTDTQYF	TRBV20-1	TRBJ2-3
TGTGCCAGCAGCGTTAGGTGGGACCTAGGCTACACCTTC	CASSVRWDLGYTF	TRBV7-8	TRBJ1-2
TGTGCCAGCAGTGACTCGACGGCCAATATCCAGGGGGGGGGGTGTTACTATGGCTACACCTTC	CASSDSTANIQGGGCYYGYTF	TRBV6-4	TRBJ1-2
TGCGCCAGCAGTTCGGCACTAGCGGGAGGCAATGAGCAGTTCTTC	CASSSALAGGNEQFF	TRBV10-1	TRBJ2-1
TGCGCCAGCAGCGTCTCAGGTTGCAGGGGGGGGAGGAGCAATCAGCCCCAGCATTTT	CASSVSGCRGGRSNQPQHF	TRBV5-1	TRBJ1-5
TGTGCCAGCAGCGGACTCAGGGCGCACTTC	CASSGLRAHF	TRBV7-9	TRBJ2-7
TGCGCCAGCAGCCAAGATGATAGGACAGGTGAAGGCAATCAGCCCCAGCATTTT	CASSQDDRTGEGNQPQHF	TRBV4-3	TRBJ1-5
TGTGCCAGCAGCCCAGGGGGGCCCGACGATACGCAGTATTTT	CASSPGGPDDTQYF	TRBV7-3	TRBJ2-3
TGTGCCAGCATTCCGGACAGGGGGGGTAATTCACCCCTCCACTTT	CASIPDRGGNSPLHF	TRBV6-4	TRBJ1-6
TGTGCCAGCAGTGGGACTATATCAGATACGCAGTATTTT	CASSGTISDTQYF	TRBV6-5	TRBJ2-3
TGTGTGTACAAGAGTGGGAACACTGAAGCTTTCTTT	CVYKSGNTEAFF	TRBV12-3	TRBJ1-1
TGTGCCAGCAGTGAAGGTCATCGGGGGGTAAACTATGGCTACACCTTC	CASSEGHRGVNYGYTF	TRBV25-1	TRBJ1-2
TGCGCCAGCAGCCAAGATATAGACAGGGATTGGACTGAAGCTTTCTTT	CASSQDIDRDWTEAFF	TRBV4-1	TRBJ1-1
TGCGCCAGCAGCCATCGAGGCGACACCGGGGAGCTGTTTTTT	CASSHRGDTGELFF	TRBV4-3	TRBJ2-2
TGTGCCAGCAGCCTGGGACGACTAGCGGGCCGCGGATTGTACAATGAGCAGTTCTTC	CASSLGRLAGRGLYNEQFF	TRBV28	TRBJ2-1
TGTGCCAGCAGCTTAACGCCGGGGGGGATATACGAGCAGTACTTC	CASSLTPGGIYEQYF	TRBV7-3	TRBJ2-7
TGTGCCAGCAGCTTAGGGCATACAGCTAACTATGGCTACACCTTC	CASSLGHTANYGYTF	TRBV11-2	TRBJ1-2
TGTGCCAGCAGCCCCCGACTGCGGGATTTGTCCAATCAGCCCCAGCATTTT	CASSPRLRDLSNQPQHF	TRBV14	TRBJ1-5
TGTGCCAGCAGTGAAGCGAAATGGGGGGGCTACAATGAGCAGTTCTTC	CASSEAKWGGYNEQFF	TRBV2	TRBJ2-1
TGTGCCATCAGTGAGTCGTACGGGGGGAACTCCTACGAGCAGTACTTC	CAISESYGGNSYEQYF	TRBV10-3	TRBJ2-7
TGTGCCAGCAGGGAGGGACCCACAGATACGCAGTATTTT	CASREGPTDTQYF	TRBV27	TRBJ2-3
TGTGCCAGCAGTGAAGGGGAGGTGGACGAGCAGTACTTC	CASSEGEVDEQYF	TRBV2	TRBJ2-7
TGTGCCAGCAGTTATGGCTTCGAAGGGAGGAAATCGCAGCCCCAGCATTTT	CASSYGFEGRKSQPQHF	TRBV6-3	TRBJ1-5
TGTGCCAGTAGTAGGCCGAGGAGATTCGGGGGGAATGAGCAGTTCTTC	CASSRPRRFGGNEQFF	TRBV19	TRBJ2-1
TGTGCCAGCAGTGACAGGGGTGGTGAGCAGTTCTTC	CASSDRGGEQFF	TRBV6-1	TRBJ2-1
TGTGCCAGCGGTATTGGCTACACCTTC	CASGIGYTF	TRBV28	TRBJ1-2
TGTGCCAGCAGCGTGACAGGGGGTAGGTCCTACGAGCAGTACTTC	CASSVTGGRSYEQYF	TRBV9	TRBJ2-7
TGTGCCAGCGGGGTAGCGGGAGAGAACACTGAAGCTTTCTTT	CASGVAGENTEAFF	TRBV7-2	TRBJ1-1
TGTGCCAGCAGCCAAGATCCCGGGACTAGAAATGAGCAGTTCTTC	CASSQDPGTRNEQFF	TRBV14	TRBJ2-1
TGTGCCAGCAGCCGAGGGGAGGGCTCTGGGGCCAACGTCCTGACTTTC	CASSRGEGSGANVLTF	TRBV6-5	TRBJ2-6
TGTGCCAGCATTCGTTTGGGACTAGCGGAAAGGATCACCGGGGAGCTGTTTTTT	CASIRLGLAERITGELFF	TRBV7-6	TRBJ2-2
TGTGCCAGCAGTCCCGTACAGAGTCCGGGAGGCTACACCTTC	CASSPVQSPGGYTF	TRBV28	TRBJ1-2
TGTGCCAGCAGAGGACAAGGGGAATACGAGCAGTACTTC	CASRGQGEYEQYF	TRBV7-9	TRBJ2-7
TGTGCCAGCAGCTTAGCCTCGGACGAAAATATCCGGGAGCCTTACGAGCAGTACTTC	CASSLASDENIREPYEQYF	TRBV11-2	TRBJ2-7
TGTGCCAGCAGTTGGCCAGGGGGGACCAAAAACAATGAGCAGTTCTTC	CASSWPGGTKNNEQFF	TRBV27	TRBJ2-1
TGTGCCAGCAGCCAAGAACCCTCTGGGGGCAGGAGCCATTATGGCTACACCTTC	CASSQEPSGGRSHYGYTF	TRBV14	TRBJ1-2
TGTGCCTGGACGCGGGGGGGGGAAACAGATACGCAGTATTTT	CAWTRGGETDTQYF	TRBV30	TRBJ2-3
TGTGCCAGCCCGGGGGGACACTATGGCTACACCTTC	CASPGGHYGYTF	TRBV28	TRBJ1-2
TGCGCCAGCAGCCCCTACAGACAAGAGACCCAGTACTTC	CASSPYRQETQYF	TRBV5-1	TRBJ2-5
TGTGCCAGCAGCTTTGTTCCCCTAGCGGGAGCCGGGATCACAGATACGCAGTATTTT	CASSFVPLAGAGITDTQYF	TRBV7-9	TRBJ2-3
TGTGCCAGCAGCTCAGGGTGTTCCTATAGCAATCAGCCCCAGCATTTT	CASSSGCSYSNQPQHF	TRBV9	TRBJ1-5
TGTGCCAGCAGTCGGGGGACGGACATGAACACTGAAGCTTTCTTT	CASSRGTDMNTEAFF	TRBV7-9	TRBJ1-1
TGTGCCAGCAGCACGGGAAGGGGTCACACTGAAAAACTGTTTTTT	CASSTGRGHTEKLFF	TRBV5-4	TRBJ1-4
TGTGCCACCAGCAGAGATGGCCGGGACAGGGTGTCTAGCACAGATACGCAGTATTTT	CATSRDGRDRVSSTDTQYF	TRBV15	TRBJ2-3
TGCAGCGTCCAGAGAAGGCTGTTTTTT	CSVQRRLFF	TRBV29-1	TRBJ1-4
TGTGCCAGCAGCGGGAGGCCCTACGAGCAGTACTTC	CASSGRPYEQYF	TRBV7-9	TRBJ2-7
TGTGCTAGTGCAGGGAATTCTGAAGCTTTCTTT	CASAGNSEAFF	TRBV12-5	TRBJ1-1
TGTGCCAGAACGGGGGGAAAGTACTTC	CARTGGKYF	TRBV6-3	TRBJ2-7
TGTGCCAGCAGAGCCCCCATCGGGACAGGAAGCTACTATGGCTACACCTTC	CASRAPIGTGSYYGYTF	TRBV9	TRBJ1-2
TGCGCCAGCTGTAGGGACTGGTACGAGCAGTACTTC	CASCRDWYEQYF	TRBV10-1	TRBJ2-7
TGTGCCAGCAGCCTGGCATCTAATCAGCCCCAGCATTTT	CASSLASNQPQHF	TRBV5-6	TRBJ1-5
TGTGCCAGCAGGTGCTGGGCGGTAGACCGTAACACCGGGGAGCTGTTTTTT	CASRCWAVDRNTGELFF	TRBV6-4	TRBJ2-2
TGCGCCAGCAGCCAGTGGATTCGGAGATGTCGGTACGAGCAGTACTTC	CASSQWIRRCRYEQYF	TRBV4-3	TRBJ2-7
TGTGCCAGTAGTATAGGCGTCATCTGGGACAGGGTCGTAGAGACCCAGTACTTC	CASSIGVIWDRVVETQYF	TRBV19	TRBJ2-5
TGCGCCAGCCGGTTTAAGCAGGGCCTGTGGGAACATGAGCAGTTCTTC	CASRFKQGLWEHEQFF	TRBV5-1	TRBJ2-1
TGTGCCAGCACCCTGGGACTGGACGAGCAGTACTTC	CASTLGLDEQYF	TRBV6-3	TRBJ2-7
TGCGCCAAGGTAGGGACAGACTATGGCTACACCTTC	CAKVGTDYGYTF	TRBV4-1	TRBJ1-2
TGTGCCAGCAGCCAAGATCCCACAGGGGGCCTAACCAGCTACGAGCAGTACTTC	CASSQDPTGGLTSYEQYF	TRBV4-2	TRBJ2-7
TGTGCTAGTGGTTTTTCCAAGGGGGGCGAAAGCACCGATGAGCAGTTCTTC	CASGFSKGGESTDEQFF	TRBV12-5	TRBJ2-1
TGTGCCAGCAGCACCCGAGAGGCCCATGGCTACACCTTC	CASSTREAHGYTF	TRBV13	TRBJ1-2
TGCGCCAGCAGCTTATCAGGGGGAAATGGCTACACCTTC	CASSLSGGNGYTF	TRBV5-1	TRBJ1-2
TGTGCCAGCAGTTTATCCCGGCAAGTGCGGACGTCACCTCAGCCCCAGCATTTT	CASSLSRQVRTSPQPQHF	TRBV28	TRBJ1-5
TGTGCCTGGAGTGCTTCCCAGGGGTTCCTAGATGAGCAGTTCTTC	CAWSASQGFLDEQFF	TRBV30	TRBJ2-1
TGTGCCAGCCCGAGGGGCCGGAACTCCTACAATGAGCAGTTCTTC	CASPRGRNSYNEQFF	TRBV9	TRBJ2-1
TGTGCCAAAAGACAGGGCATTAAATCCTACGAGCAGTACTTC	CAKRQGIKSYEQYF	TRBV27	TRBJ2-7
TGTGCCACCAGTGATTTGCAACTTGACCAGGGACTAGTGGGGAAAGGTCAGCCCCAGCATTTT	CATSDLQLDQGLVGKGQPQHF	TRBV24-1	TRBJ1-5
TGTGCCAGCAGCGTGAGCCCCGGGCGGACCCAGTACTTC	CASSVSPGRTQYF	TRBV9	TRBJ2-5
TGTGCCAGCAGCCTTCTTAGGGGAGAAGGCACCTTC	CASSLLRGEGTF	TRBV3-1	TRBJ1-2
TGTGCCAAAATTGGGGAGGGGAAAGTTATCGGCTACACCTTC	CAKIGEGKVIGYTF	TRBV6-3	TRBJ1-2
TGTGCCAGCGAGACAGGGCCTGAAGCTTTCTTT	CASETGPEAFF	TRBV27	TRBJ1-1
TGTGCCAGCAGTTACGTTTACAGGGGGGGTTGGAATTACTGTCCGGGAGAGACCCAGTACTTC	CASSYVYRGGWNYCPGETQYF	TRBV6-5	TRBJ2-5
TGTGCCAGTAGAAAGCGTCGGAGGGACACTGAAGCTTTCTTT	CASRKRRRDTEAFF	TRBV28	TRBJ1-1
TGCAGTGCCAGGGTAATCGGAGAGACCCAGTACTTC	CSARVIGETQYF	TRBV20-1	TRBJ2-5
TGTGCCAGCAGCACTCCCCAAGTCCGGGCTTACGAGCAGTACTTC	CASSTPQVRAYEQYF	TRBV11-2	TRBJ2-7
TGTGCCAGCAGTTCGAAACGGACAGTTTATGAGCAGTTCTTC	CASSSKRTVYEQFF	TRBV28	TRBJ2-1
TGTGCCAGCAGTCCGGGCAGACAGGGGGGACGAGCCAAAAACATTCAGTACTTC	CASSPGRQGGRAKNIQYF	TRBV9	TRBJ2-4
TGTGCCAGCAGCCGAGGCTTTTTAAGGGGCTACACCTTC	CASSRGFLRGYTF	TRBV7-3	TRBJ1-2
TGCAGTGCTAGAGATAGAACGGACAGTAGGGACTATGGCTACACCTTC	CSARDRTDSRDYGYTF	TRBV20-1	TRBJ1-2
TGTGCCAGCAGGTGTTCGGTAGCGGGAGGTAAAAGCAATCAGCCCCAGCATTTT	CASRCSVAGGKSNQPQHF	TRBV6-4	TRBJ1-5
TGTGCCAGCAGCGTCGGGGGTCTTATTGAGCAGTTCTTC	CASSVGGLIEQFF	TRBV7-9	TRBJ2-1
TGTGCCAGCAGTGTACCTAGCAGGGTGTTCGTTAGCACAGATACGCAGTATTTT	CASSVPSRVFVSTDTQYF	TRBV2	TRBJ2-3
TGTGCCAGTATGAGAACGACCCTCCAGGGGGGGGTGTCCGCGGTTTTGACCCAGTACTTC	CASMRTTLQGGVSAVLTQYF	TRBV19	TRBJ2-5
TGTGCGTCCTTAGCGGGAACAAGCTCCTACAATGAGCAGTTCTTC	CASLAGTSSYNEQFF	TRBV25-1	TRBJ2-1
TGTGCCAGCAGGGGGACAGATACGCAGTATTTT	CASRGTDTQYF	TRBV6-6	TRBJ2-3
TGTGCCAGCAGTTACTCCCCCCGGCGCCGCGGAGATTGTTTCTTCGCCTCCTACAATGAGCAGTTCTTC	CASSYSPRRRGDCFFASYNEQFF	TRBV6-5	TRBJ2-1
TGTGCCAGCAGGCCCGACCCATTTGCCTACGAGCAGTACTTC	CASRPDPFAYEQYF	TRBV6-2	TRBJ2-7
TGTGCCTGGAGTGAACCCATTCCCGGGACAGGGGGAAAAGAGACCCAGTACTTC	CAWSEPIPGTGGKETQYF	TRBV30	TRBJ2-5
TGTGCCAAGGGGGGGGAAAACATTCAGTACTTC	CAKGGENIQYF	TRBV7-8	TRBJ2-4
TGTGCCAGCAGCTTGGGGCAGGAGTTACCTAAGGGAAACACCATATATTTT	CASSLGQELPKGNTIYF	TRBV5-4	TRBJ1-3
TGTGCCAGCAGTCTAGCGGGGCAGGAGACAGATACGCAGTATTTT	CASSLAGQETDTQYF	TRBV11-3	TRBJ2-3
TGTGCCAGTCCCGGGGGGCTTGCTTGTAGGAACACCGGGGAGCTGTTTTTT	CASPGGLACRNTGELFF	TRBV7-2	TRBJ2-2
TGTGCCAGCAGTTTTAACGGACGGGGCTACACCTTC	CASSFNGRGYTF	TRBV12-4	TRBJ1-2
TGTGCCAGCAGTCAGGTAGGGTCTGCCTCCTACAATGAGCAGTTCTTC	CASSQVGSASYNEQFF	TRBV6-4	TRBJ2-1
TGTGCCAGCAGTTCCTTCTGTGACAGCGAAAGCGAGCCACTAGGCTACACCTTC	CASSSFCDSESEPLGYTF	TRBV28	TRBJ1-2
TGCAGTGCGGGGGGACTGCCCCAGCATTTT	CSAGGLPQHF	TRBV20-1	TRBJ1-5
TGCGCCAGCAGTGATCTTAGTGTGGAGCAGTACTTC	CASSDLSVEQYF	TRBV10-2	TRBJ2-7
TGTGCCAGCAGTGAACCCCCTTATCGCCCGAACCAGTTCGCGGCATCCTACAATGAGCAGTTCTTC	CASSEPPYRPNQFAASYNEQFF	TRBV6-1	TRBJ2-1
TGCGCCAGCAGCTCAATTAAGGGGGCGGAGCAGTACTTC	CASSSIKGAEQYF	TRBV5-1	TRBJ2-7
TGCGCCAGCAGCCAAGGGCAAGGGCCCGTCTACGAGCAGTACTTC	CASSQGQGPVYEQYF	TRBV4-3	TRBJ2-7
TGTGCCACCAGGGCCTCGGACAGGGTCGCATTAAGAAGAAACTATGGCTACACCTTC	CATRASDRVALRRNYGYTF	TRBV15	TRBJ1-2
TGTGCCAGCAGTTGCGAGGCACAGGGAGAAGGGGCTAACTATGGCTACACCTTC	CASSCEAQGEGANYGYTF	TRBV27	TRBJ1-2
TGTGCCAGCAGCGGAGGGGAATCCGATGGCTACACCTTC	CASSGGESDGYTF	TRBV7-3	TRBJ1-2
TGTGCCAGTAGTCCTACCTTCTCCTACGAGCAGTACTTC	CASSPTFSYEQYF	TRBV19	TRBJ2-7
TGTGCCAGCAGCCGATCCTCTAAGCCCAGAGCGAACACCGGGGAGCTGTTTTTT	CASSRSSKPRANTGELFF	TRBV3-1	TRBJ2-2
TGTGCCAGCAGTGTAGAATACCATGGCTACACCTTC	CASSVEYHGYTF	TRBV27	TRBJ1-2
TGTGCCAGCAGTTACCCAGAGTTCGAGGTGCTAGCCAAAAACATTCAGTACTTC	CASSYPEFEVLAKNIQYF	TRBV6-5	TRBJ2-4
TGTGCCAGCAGTGAAGAACACGATAAAAGTTACTCCTACAATGAGCAGTTCTTC	CASSEEHDKSYSYNEQFF	TRBV6-1	TRBJ2-1
TGTGCCTCCGTGTTGCCTGTAAACAGGGAAAGAGATACGCAGTATTTT	CASVLPVNRERDTQYF	TRBV10-3	TRBJ2-3
TGCAGCGGGGATGACAGGGATGCCTCCTACGAGCAGTACTTC	CSGDDRDASYEQYF	TRBV29-1	TRBJ2-7
TGTGCCAGTACAAAACGAAGGTGGAACACTGAAGCTTTCTTT	CASTKRRWNTEAFF	TRBV19	TRBJ1-1
TGTGCCAGCAGCCCGGGGAGGGGAAACCCCCGAAGCAATCAGCCCCAGCATTTT	CASSPGRGNPRSNQPQHF	TRBV5-5	TRBJ1-5
TGTGCCAGCAGCTTACTGGGGCATAACTCTACTGGGGCCAACGTCCTGACTTTC	CASSLLGHNSTGANVLTF	TRBV11-1	TRBJ2-6
TGTGCCAGCAGTTTAGCAATTCGCGGGACAAACCCGGGACAGGGCCGTGATACGCAGTATTTT	CASSLAIRGTNPGQGRDTQYF	TRBV27	TRBJ2-3
TGTGCCAGCGGGTTTGCAGGGGTTGGTTACGAGCAGTACTTC	CASGFAGVGYEQYF	TRBV19	TRBJ2-7
TGTGCCAGCAGTTTAGTCTACCCCCTGGTGTGGACAGGGATTGGCTACACCTTC	CASSLVYPLVWTGIGYTF	TRBV28	TRBJ1-2
TGCAGCGTTGGGAACATGTGGACAGGGGGCCTTTCTAACTATGGCTACACCTTC	CSVGNMWTGGLSNYGYTF	TRBV29-1	TRBJ1-2
TGTGCCAGCAGCCAAGATGTCGGGGAGGGTCCCTACAATGAGCAGTTCTTC	CASSQDVGEGPYNEQFF	TRBV4-2	TRBJ2-1
TGTGCCAGCTCAGTATATGGCTACACCTTC	CASSVYGYTF	TRBV12-4	TRBJ1-2
TGTGCCACCAGTGATGTTACGGGACGGACCGGGGAGCTGTTTTTT	CATSDVTGRTGELFF	TRBV24-1	TRBJ2-2
TGCGCCAGCAGCCAAGAACCTCTATACACTGAAGCTTTCTTT	CASSQEPLYTEAFF	TRBV4-1	TRBJ1-1
TGTGCCAGCAGTTACGGGGGGGCCGAACATGAGCAGTTCTTC	CASSYGGAEHEQFF	TRBV6-2	TRBJ2-1
TGTGCTAGTGGTTTGGTAACCGGGACAGGGCTCACAGATACGCAGTATTTT	CASGLVTGTGLTDTQYF	TRBV12-5	TRBJ2-3
TGTGCCATCAAAAGGACTAGCGGGAGCTTCTACGAGCAGTACTTC	CAIKRTSGSFYEQYF	TRBV10-3	TRBJ2-7
TGTGCCAGCAGTCCACTCGGGCGTGAAAAACTGTTTTTT	CASSPLGREKLFF	TRBV27	TRBJ1-4
TGTGCCCCACCGAAATCCTCTGGAAACACCATATATTTT	CAPPKSSGNTIYF	TRBV7-8	TRBJ1-3
TGCGCCAGCAGGACCCGTCCTCCAAGGGACCAGTACTTC	CASRTRPPRDQYF	TRBV10-1	TRBJ2-4
TGCGCCAGCAGCTTATATTACACTAACGTCGAGACCCAGTACTTC	CASSLYYTNVETQYF	TRBV5-1	TRBJ2-5
TGTGCCAGGAAACCCCGTGGGGGGTTCGGCTACGAGCAGTACTTC	CARKPRGGFGYEQYF	TRBV27	TRBJ2-7
TGTGCCAGCAGCAAAATTCGGACTACCCCTCGCACAGATACGCAGTATTTT	CASSKIRTTPRTDTQYF	TRBV13	TRBJ2-3
TGTGCCAGCTTCGACAGGGGAATTGCCTTCCTTAATCAGCCCCAGCATTTT	CASFDRGIAFLNQPQHF	TRBV9	TRBJ1-5
TGCGCCAGCAGCTTGGCTAATGGCGGGAGGGACCCGGGAGGCGGGGAGCTGTTTTTT	CASSLANGGRDPGGGELFF	TRBV5-1	TRBJ2-2
TGTGCCAGCAGCGGACTAGGCAATCAGCCCCAGCATTTT	CASSGLGNQPQHF	TRBV6-5	TRBJ1-5
TGCGCCAGCACCCCTAGTGGGGCCGGACCTGAAGCTTTCTTT	CASTPSGAGPEAFF	TRBV5-1	TRBJ1-1
TGTGCCACCAGTGGAACGTGTGTTCACACTGAAGCTTTCTTT	CATSGTCVHTEAFF	TRBV24-1	TRBJ1-1
TGTGCCAGCAGCCAACCCCTGGCCCTACGGAGTCAGCCCCAGCATTTT	CASSQPLALRSQPQHF	TRBV3-1	TRBJ1-5
TGTGCCACCCGGGACAGGATTAGCAATCAGCCCCAGCATTTT	CATRDRISNQPQHF	TRBV24-1	TRBJ1-5
TGTGCCAGCAGCCCATCCCGAGGACCCCGGAGCACCGGGGAGCTGTTTTTT	CASSPSRGPRSTGELFF	TRBV3-1	TRBJ2-2
TGTGCCAGCAGTTTTAGGGTAGAAAGCAGGCGGAGCTCCTACGAGCAGTACTTC	CASSFRVESRRSSYEQYF	TRBV27	TRBJ2-7
TGTGCCAGCCCTCTAAGGGACTTGAGAAGCCAAGAGACCCAGTACTTC	CASPLRDLRSQETQYF	TRBV6-5	TRBJ2-5
TGTGCCAGACCTCCCAGGCGGTCTAATGAAAAACTGTTTTTT	CARPPRRSNEKLFF	TRBV2	TRBJ1-4
TGCAGTGCCGGGTCGGGGGGGGAAGAAAAACTGTTTTTT	CSAGSGGEEKLFF	TRBV20-1	TRBJ1-4
TGTGCTAGTGGTTTGTATCTTTTGCCCCAGCATTTT	CASGLYLLPQHF	TRBV12-5	TRBJ1-5
TGCGCCAGCATACTTAAGACCCAGTACTTC	CASILKTQYF	TRBV10-1	TRBJ2-5
TGTGCCAGCAGTTTATGCGATCGAGCGGGGTGGGTTACCCCTGCGAACACTGAAGCTTTCTTT	CASSLCDRAGWVTPANTEAFF	TRBV27	TRBJ1-1
TGTGCCAGCATCCCTACTAGCGGGAGTGGGGCTGAAGCTTTCTTT	CASIPTSGSGAEAFF	TRBV14	TRBJ1-1
TGTGCCAGCAGCCGTAGTCCGGGACCATTTAGTACCAATCAGCCCCAGCATTTT	CASSRSPGPFSTNQPQHF	TRBV11-3	TRBJ1-5
TGTGCCAGCAGAACGAGGGCGTCGGGACTTTATGGCTACACCTTC	CASRTRASGLYGYTF	TRBV6-2	TRBJ1-2
TGTGCCAGCAGCGTAGCGAGGACAGGGTGGGCGTACGAGCAGTACTTC	CASSVARTGWAYEQYF	TRBV9	TRBJ2-7
TGTGCCAGCAGCCGGCACCTCTCTAGCAATCAGCCCCAGCATTTT	CASSRHLSSNQPQHF	TRBV7-2	TRBJ1-5
TGCGCCAGCAGCCACCGAGTCCCGCGGGGGGGCTCCTACAATGAGCAGTTCTTC	CASSHRVPRGGSYNEQFF	TRBV4-3	TRBJ2-1
TGTGCCAGCAGCTTGGCCGGTCCGACAGATACGCAGTATTTT	CASSLAGPTDTQYF	TRBV5-6	TRBJ2-3
TGTGCCGAAACCCGTCTCCCGGGGGTTAACACCGGGGAGCTGTTTTTT	CAETRLPGVNTGELFF	TRBV11-2	TRBJ2-2
TGTGCCAGTAAAAAAAAGGACCGAACGCCCCAGCATTTT	CASKKKDRTPQHF	TRBV19	TRBJ1-5
TGCGCCAGCAGCTTGGCGGGGGACCCGTGGGAAGAAGCTTTCTTT	CASSLAGDPWEEAFF	TRBV5-1	TRBJ1-1
TGTGCCAGCAGCCGGGGCATAAGAGAGACCCAGTACTTC	CASSRGIRETQYF	TRBV12-4	TRBJ2-5
TGTGCCAGAGATACGGGGGGAGGGACTAACACCATATATTTT	CARDTGGGTNTIYF	TRBV19	TRBJ1-3
TGTGCCAGCAGCTTTGACAGGGGGCAAGGGACTGAAGCTTTCTTT	CASSFDRGQGTEAFF	TRBV7-4	TRBJ1-1
TGCAGTGCTCTAGAAACCGGACTAGGGACCCCCTCCTACAATGAGCAGTTCTTC	CSALETGLGTPSYNEQFF	TRBV20-1	TRBJ2-1
TGTGCCAGTAGTAGAAGAAGGGACAGCCTCGGTGCAACTAATGAAAAACTGTTTTTT	CASSRRRDSLGATNEKLFF	TRBV19	TRBJ1-4
TGCGCCAGCAGGGCGGACGTCAGGGATTCCTACGAGCAGTACTTC	CASRADVRDSYEQYF	TRBV5-1	TRBJ2-7
TGTGCCAGCAGTGACGGCAGCCCTCTTCAAGGCTATAACTATGGCTACACCTTC	CASSDGSPLQGYNYGYTF	TRBV25-1	TRBJ1-2
TGTGCCAGCAGCGGGGAGGGGGGGCACCGCTACAATGAGCAGTTCTTC	CASSGEGGHRYNEQFF	TRBV7-3	TRBJ2-1
TGTGCCAGCAGCCGGAGTGGGATATACGAGCAGTACTTC	CASSRSGIYEQYF	TRBV7-3	TRBJ2-7
TGTGCCACCAGTGATTTGCCGACCTCGAGCTACAATGAGCAGTTCTTC	CATSDLPTSSYNEQFF	TRBV24-1	TRBJ2-1
TGTGCCACCAGTGAGTTTGAGATATCCCAGCATTTT	CATSEFEISQHF	TRBV24-1	TRBJ1-5
TGTGCCAGCAGTCGGATTCCACTTCGGGTCATGGCCTACGAGCAGTACTTC	CASSRIPLRVMAYEQYF	TRBV7-4	TRBJ2-7
TGCGCCAGCAGCCAAGATATCCTTGGACTTCAGAACGAGCAGTACTTC	CASSQDILGLQNEQYF	TRBV4-3	TRBJ2-7
TGTGCCAGCAGTCGGGGACAGGGGGCTGGAAAACTGTTTTTT	CASSRGQGAGKLFF	TRBV27	TRBJ1-4
TGTGCCACCGGACTAGCGGGAGATAAAGAGACCCAGTACTTC	CATGLAGDKETQYF	TRBV24-1	TRBJ2-5
TGTGCCAGCAGCAAGAGGGGGTGCAATCAGCCCCAGCATTTT	CASSKRGCNQPQHF	TRBV7-3	TRBJ1-5
TGCAGTGCGTGGCTTAAAGGCTACACCTTC	CSAWLKGYTF	TRBV20-1	TRBJ1-2
TGTGCCAGAGGACAGGTCGCTTTCTTT	CARGQVAFF	TRBV6-1	TRBJ1-1
TGTGCCAGCAGTGACACCACACCCAAGACAGCGACAGCTTTCTTT	CASSDTTPKTATAFF	TRBV6-4	TRBJ1-1
TGTGCCACCAGTCCCACCCCACGGTTATTTTCCTACGAGCAGTACTTC	CATSPTPRLFSYEQYF	TRBV24-1	TRBJ2-7
TGCGCCAGCAGCCAAGGGGCGAACACTGAAGCTTTCTTT	CASSQGANTEAFF	TRBV4-1	TRBJ1-1
TGTGCCAGCAGTCTCGTTGCCAGTCTAGATCAGCGCAATCAGCCCCAGCATTTT	CASSLVASLDQRNQPQHF	TRBV6-5	TRBJ1-5
TGTGCCAGCAGCAAGACCGCGGAAAACATTCAGTACTTC	CASSKTAENIQYF	TRBV13	TRBJ2-4
TGTGCCAGCAGCTTACTGAACCAGGGGATTCACGATGGCTACACCTTC	CASSLLNQGIHDGYTF	TRBV7-2	TRBJ1-2
TGTGCCAGCAGCAACCGTGGAGTGGCCTCTAACTATGGCTACACCTTC	CASSNRGVASNYGYTF	TRBV13	TRBJ1-2
TGTGCCAGCAGCCACGATCGACACTCGGTAGCGTACGAGCAGTACTTC	CASSHDRHSVAYEQYF	TRBV4-2	TRBJ2-7
TGCGCCAGCAGAAACAGGGGCTGGGCCAACGTCCTGACTTTC	CASRNRGWANVLTF	TRBV5-1	TRBJ2-6
TGTGCCACCGGGGGGGGGGCTTACAACTACAATGAGCAGTTCTTC	CATGGGAYNYNEQFF	TRBV24-1	TRBJ2-1
TGTGCCAGCAGCTTAGGAACAAAGGGACAGGGGAGTCTCACTGAAGCTTTCTTT	CASSLGTKGQGSLTEAFF	TRBV11-1	TRBJ1-1
TGTGCCAGCAGCAATCGACAGGGTGGGTATAGCAATCAGCCCCAGCATTTT	CASSNRQGGYSNQPQHF	TRBV5-4	TRBJ1-5
TGTGCCAGCAGGCTACAGGCGGGCGAGGGCTACACCTTC	CASRLQAGEGYTF	TRBV6-1	TRBJ1-2
TGTGCCAGCAGTTTTACTTATACAGGGAGGAAGGACACCGGGGAGCTGTTTTTT	CASSFTYTGRKDTGELFF	TRBV6-6	TRBJ2-2
TGTGCCTGGAGTGGCCCCGTCAAATGGACGGGGGAAAAACTGTTTTTT	CAWSGPVKWTGEKLFF	TRBV30	TRBJ1-4
TGCAGTGCTAGAGTGCGGGCGGGGGGGGACTACGAGCAGTACTTC	CSARVRAGGDYEQYF	TRBV20-1	TRBJ2-7
TGCAGTGCAGGCGGGACACTTTCCTACGAGCAGTACTTC	CSAGGTLSYEQYF	TRBV20-1	TRBJ2-7
TGTGCCAGCAGTTACTTTAGGGGGGATGAGCAGTTCTTC	CASSYFRGDEQFF	TRBV6-6	TRBJ2-1
