TGCGCCAGCAGCTTGGTAGGCGGCGGTTCACCCCTCCACTTT	CASSLVGGGSPLHF	TRBV5-1	TRBJ1-6
TGTGCCATCACTGGGGAGTACGAGCAGTACTTC	CAITGEYEQYF	TRBV10-3	TRBJ2-7
TGTGCCACGCCAATGAATGGATACGAGCAGTACTTC	CATPMNGYEQYF	TRBV27	TRBJ2-7
TGTGCCAGCAGCCAAGACTCGGTCCGGGACCCTTGCACTGAAGCTTTCTTT	CASSQDSVRDPCTEAFF	TRBV3-1	TRBJ1-1
TGCAGTGCTGGACAGGGCACTGAAGCTTTCTTT	CSAGQGTEAFF	TRBV20-1	TRBJ1-1
TGTGCCACCGAGGGTCAAACCTACGAGCAGTACTTC	CATEGQTYEQYF	TRBV24-1	TRBJ2-7
TGCAGTGCAAGGGTCGTCGACTCCTTCCCTCTCCGGACTGAAGCTTTCTTT	CSARVVDSFPLRTEAFF	TRBV20-1	TRBJ1-1
TGCAGTGCTACCCCATATACAGGTCTGAACACTGAAGCTTTCTTT	CSATPYTGLNTEAFF	TRBV20-1	TRBJ1-1
TGTGCCATGAGGGTATTAGCAGGCGTACAAAAGAACACTGAAGCTTTCTTT	CAMRVLAGVQKNTEAFF	TRBV2	TRBJ1-1
TGCGCCAGCAGCTGCAGGGGTGGCAATCAGCCCCAGCATTTT	CASSCRGGNQPQHF	TRBV5-1	TRBJ1-5
TGTGCCAGCAGCCCGACAGGGGCTCAAAATCAGCCCCAGCATTTT	CASSPTGAQNQPQHF	TRBV7-3	TRBJ1-5
TGTGCCAGCAGCTTAGTAAAGGGGGGGTCACCCCTCCACTTT	CASSLVKGGSPLHF	TRBV7-6	TRBJ1-6
TGTGCCAGCTCATTTGGACAGCCATTCTCTGGAAACACCATATATTTT	CASSFGQPFSGNTIYF	TRBV18	TRBJ1-3
TGCGCCAGCAGTGCTCAGGGCATTGACAATGAGCAGTTCTTC	CASSAQGIDNEQFF	TRBV10-1	TRBJ2-1
TGTGCCAGCAGTCCGGAGTCTGCTAGCGGCTACGAGCAGTACTTC	CASSPESASGYEQYF	TRBV6-5	TRBJ2-7
TGTGCCAGCAGCCAAGTTAGCGCCCGCAATCAGCCCCAGCATTTT	CASSQVSARNQPQHF	TRBV6-1	TRBJ1-5
TGTGCCAGCAGCGTCAGAGCCGGGACTAGCGGGGGGGCGCGATTTCGCTACGAGCAGTACTTC	CASSVRAGTSGGARFRYEQYF	TRBV13	TRBJ2-7
TGTGACAAGGACAGGGTAGAATGCAGAAGATACGAGCAGTACTTC	CDKDRVECRRYEQYF	TRBV12-3	TRBJ2-7
TGTGCCAGCAGCCCCCAGGCCAGGGATGAAGCTTTCTTT	CASSPQARDEAFF	TRBV7-2	TRBJ1-1
TGTGCCAGCAGCGGACCGCTATTCGGTAATGAAAAACTGTTTTTT	CASSGPLFGNEKLFF	TRBV13	TRBJ1-4
TGTGCCAGCAGCAACTTAGGACAGGGCTCGAACACTGAAGCTTTCTTT	CASSNLGQGSNTEAFF	TRBV11-2	TRBJ1-1
TGTGCCAGCAGCTCGCTAAGACTAGCGGTGCCGGCCTACGAGCAGTACTTC	CASSSLRLAVPAYEQYF	TRBV7-2	TRBJ2-7
TGTGCCACCGAGGGGACGACTGAAGCTTTCTTT	CATEGTTEAFF	TRBV24-1	TRBJ1-1
TGTGCCAGCACGTTCAGGGGGCCCGACGATTCGATGGCCCAGCATTTT	CASTFRGPDDSMAQHF	TRBV5-4	TRBJ1-5
TGTGCCAGCAGCCCCCTACTTGACTTAGAGACCCAGTACTTC	CASSPLLDLETQYF	TRBV12-3	TRBJ2-5
TGCGCCAGCAGCTCCCGGGGTGGGACGGTGAACACCGGGGAGCTGTTTTTT	CASSSRGGTVNTGELFF	TRBV5-1	TRBJ2-2
TGTGCCAGCAGTGAATACGGGCGGGGCTCTGGGGCCAACGTCCTGACTTTC	CASSEYGRGSGANVLTF	TRBV25-1	TRBJ2-6
TGTGCCAGCAGCCGGGACAGGGGGTATGAGACCCAGTACTTC	CASSRDRGYETQYF	TRBV7-9	TRBJ2-5
TGTGCCACCAGTGATCCGGGACTTATCAAAGAGACCCAGTACTTC	CATSDPGLIKETQYF	TRBV24-1	TRBJ2-5
TGTGCCAGCAGCCTTCCTGGGCGACGGGGAGACTACGAGCAGTACTTC	CASSLPGRRGDYEQYF	TRBV5-6	TRBJ2-7
TGTGCCAGCAGACTACCGGCGTCTGCAGATACGCAGTATTTT	CASRLPASADTQYF	TRBV6-3	TRBJ2-3
TGTGCCAGCAGTTACGAAAGTAACGGACAGTCCGAGCCTATTGTGAACACTGAAGCTTTCTTT	CASSYESNGQSEPIVNTEAFF	TRBV6-5	TRBJ1-1
TGTGCCAGCAGTTGGACAGTCTACGAGCAGTACTTC	CASSWTVYEQYF	TRBV9	TRBJ2-7
TGTGCCAGCAGCCAAGAAAGCATCGGGACTAGGGGAGGCCAGTACTTC	CASSQESIGTRGGQYF	TRBV14	TRBJ2-5
TGTGCCAGCAGCAGAGGGTTACCCTACGAGCAGTACTTC	CASSRGLPYEQYF	TRBV6-6	TRBJ2-7
TGCGCCAGCAGCTTGGTCGGCGGACCTTGGAACACTGAAGCTTTCTTT	CASSLVGGPWNTEAFF	TRBV5-1	TRBJ1-1
TGTGCCAGCAGCTTAACCCCCTATCCTCACAGGCCGGGGCATGAGCAGTTCTTC	CASSLTPYPHRPGHEQFF	TRBV7-3	TRBJ2-1
TGTGCCAGCAGTTTTGCAACCGGGGGAGGATACGGCCTTAACCGAAGAACTGGGGCCAACGTCCTGACTTTC	CASSFATGGGYGLNRRTGANVLTF	TRBV27	TRBJ2-6
TGTGCCAGCAAATCCAGAACAGGGTTAGGCTATGGCTACACCTTC	CASKSRTGLGYGYTF	TRBV7-9	TRBJ1-2
TGTGCCAGCGGACCGAGGGTTGGGGGGGAGCAGTACTTC	CASGPRVGGEQYF	TRBV27	TRBJ2-7
TGTGCTAGTGGTTCACAAACAGAGGGGAGGGTCTTC	CASGSQTEGRVF	TRBV12-5	TRBJ2-1
TGTGCCAGCAGCGTCACCGCGGGGGGCATCTATGGCTACACCTTC	CASSVTAGGIYGYTF	TRBV9	TRBJ1-2
TGTGCCAGCAGCCAAGATATCGCACCCCGACAGGGAGGTTCGGCGCAGTACTTC	CASSQDIAPRQGGSAQYF	TRBV3-1	TRBJ2-7
TGTGCCAGCAGCTTGCGGTGGGGGCGCGGTGGCTACACCTTC	CASSLRWGRGGYTF	TRBV5-5	TRBJ1-2
TGTGCCAGCAGCAGGGGAGTCTCCTATAATTCACCCCTCCACTTT	CASSRGVSYNSPLHF	TRBV27	TRBJ1-6
TGTGCCAGCACGGACAGGGCCTACGAGCAGTACTTC	CASTDRAYEQYF	TRBV5-6	TRBJ2-7
TGTGCCAGCAGGCCAGGGGTCTACCAGCCCCAGCATTTT	CASRPGVYQPQHF	TRBV27	TRBJ1-5
TGCGCCAGCAGCTTGGGCCCCCCTACGACGGGGAGGTCAAAAGAGACCCAGTACTTC	CASSLGPPTTGRSKETQYF	TRBV5-1	TRBJ2-5
TGTGCCAGCAGTTACAGCCGGGACAGGGGGGGTCGCACCATATATTTT	CASSYSRDRGGRTIYF	TRBV6-2	TRBJ1-3
TGTGCCAGCACTCGGCTTAACAATGAGCAGTTCTTC	CASTRLNNEQFF	TRBV11-2	TRBJ2-1
TGCAGTGCTGTTAGGGGGACGGCTCCGCTCGGCCATAATTCACCCCTCCACTTT	CSAVRGTAPLGHNSPLHF	TRBV20-1	TRBJ1-6
TGTGCCAGCAGCGGGGGTCTGGATACGCAGTATTTT	CASSGGLDTQYF	TRBV9	TRBJ2-3
TGCGCCAGCGCAGGGGGCGAGTTGGCTTTCTTT	CASAGGELAFF	TRBV4-1	TRBJ1-1
TGTGCCAGCAGTTACGCCCAAGTCTCGACAGGGCCTGGGTTGAACACTGAAGCTTTCTTT	CASSYAQVSTGPGLNTEAFF	TRBV6-6	TRBJ1-1
TGTGCCAGCAGCGTAGCTGGGGGGGCCCTCTACGAGCAGTACTTC	CASSVAGGALYEQYF	TRBV9	TRBJ2-7
TGTGCCAGCAGCAGCGGGGGCGACGCAGATACGCAGTATTTT	CASSSGGDADTQYF	TRBV7-3	TRBJ2-3
TGCAGCGTTGAAGGCCAAGACGGACCGGACGTCAGTTCACCCCTCCACTTT	CSVEGQDGPDVSSPLHF	TRBV29-1	TRBJ1-6
TGTGCCAGCAGCGTGAAGCCCACCCTGACAGGGGTGCCCCAGCATTTT	CASSVKPTLTGVPQHF	TRBV13	TRBJ1-5
TGTGCCAGCAGCGCCGGCGTTTACGCCTACGAGCAGTACTTC	CASSAGVYAYEQYF	TRBV28	TRBJ2-7
TGTGCCAGTACCAGGACAGGGGACCGTGGTGTATCAACTAATGAAAAACTGTTTTTT	CASTRTGDRGVSTNEKLFF	TRBV19	TRBJ1-4
TGTGCCAGCATAGGACAGGAGCTCTACGAGCAGTACTTC	CASIGQELYEQYF	TRBV6-4	TRBJ2-7
TGTGCCAGCAGCCAAGACAGGGGACACGAAAACTATGGCTACACCTTC	CASSQDRGHENYGYTF	TRBV14	TRBJ1-2
TGTGCCAGTAGTCCGGGACAGGAAGATTACGAGCAGTACTTC	CASSPGQEDYEQYF	TRBV19	TRBJ2-7
TGCGCCAGCAGTGGGACAGGGGCACTGCTAGCCTACAATGAGCAGTTCTTC	CASSGTGALLAYNEQFF	TRBV10-2	TRBJ2-1
TGTGCCACCCTAGAATGGGGCACCTACGAGCAGTACTTC	CATLEWGTYEQYF	TRBV7-9	TRBJ2-7
TGTGCCAGCAGTTTACTAGCGGGAGGGTCGGAGACCCAGTACTTC	CASSLLAGGSETQYF	TRBV27	TRBJ2-5
TGTGCCAGCAGTTTGTTCAAGTATCGGCGGGAGATGGAGTCCGAGCAGTACTTC	CASSLFKYRREMESEQYF	TRBV28	TRBJ2-7
TGTGCCAGCAGCAGTGAAGGAAAGAATAACACTGAAGCTTTCTTT	CASSSEGKNNTEAFF	TRBV13	TRBJ1-1
TGTGCCAGTACCCAGTGGGGCTACCTGGGTCGGCGAGCGACTAACTATGGCTACACCTTC	CASTQWGYLGRRATNYGYTF	TRBV19	TRBJ1-2
TGTGCCAGCAGCAAAAAGGACAGGGGGGCAACTAATGAAAAACTGTTTTTT	CASSKKDRGATNEKLFF	TRBV7-9	TRBJ1-4
TGTGCCAGCAGCCATCGGGTTCCCAGGGGACAGGGGAAGTTCAGGTTGAACACTGAAGCTTTCTTT	CASSHRVPRGQGKFRLNTEAFF	TRBV14	TRBJ1-1
TGTGCCAGTATCCGGGACCCTACCCTTCAGCCCCAGCATTTT	CASIRDPTLQPQHF	TRBV19	TRBJ1-5
TGTGCCAGCAGTTACACCAGTAATCGGGACGGGAACGTTGCAACTAATGAAAAACTGTTTTTT	CASSYTSNRDGNVATNEKLFF	TRBV6-5	TRBJ1-4
TGCGCCGCCTTGGAAAAAGAGACCCAGTACTTC	CAALEKETQYF	TRBV10-1	TRBJ2-5
TGTGCCAGCAGCTTGACAAGGGACAGTTTGCCCGAGCAGTACTTC	CASSLTRDSLPEQYF	TRBV5-8	TRBJ2-7
TGTGCCAGCAGTCGCGCTAGCGGGAATGAGCAGTTCTTC	CASSRASGNEQFF	TRBV7-3	TRBJ2-1
TGCGCCAGTGTTACAGGGGTCGGCTATGGCTACACCTTC	CASVTGVGYGYTF	TRBV10-1	TRBJ1-2
TGTGCCAGCAGTGACCCACGAACGACTGTAGAGACCCAGTACTTC	CASSDPRTTVETQYF	TRBV6-1	TRBJ2-5
TGTGCCAGCTCAGTTAACCGGGACAGGGCACCTTCCTATGGCTACACCTTC	CASSVNRDRAPSYGYTF	TRBV18	TRBJ1-2
TGTGCCAGCAGCCATCCCACCCTTTTCGAGCAGTACTTC	CASSHPTLFEQYF	TRBV28	TRBJ2-7
TGCCCGGACAGGGGGCAGGGGGAGCCCCAGCATTTT	CPDRGQGEPQHF	TRBV18	TRBJ1-5
TGTGCCAGCAAGAGGGAGGGACAGAATGAGCAGTTCTTC	CASKREGQNEQFF	TRBV25-1	TRBJ2-1
TGTGCCAGCAGTTTCCATGGGACAGGGAGGTATGGCTACACCTTC	CASSFHGTGRYGYTF	TRBV6-5	TRBJ1-2
TGTGCCAGCAGCCGATCGGGACGGTCACCAGAGACCCAGTACTTC	CASSRSGRSPETQYF	TRBV14	TRBJ2-5
TGTGCCAGCAGTTATGAAGACCTAGCTGGGTTATACAATGAGCAGTTCTTC	CASSYEDLAGLYNEQFF	TRBV6-3	TRBJ2-1
TGTGCCAGCAGCTGGGTTGAGCCGGGACAGGGCAGTACTGAAGCTTTCTTT	CASSWVEPGQGSTEAFF	TRBV5-4	TRBJ1-1
TGTGCTAGCAGCTTACTAGCCAGTCGGGACAGGGTCGCTTTCTTT	CASSLLASRDRVAFF	TRBV7-7	TRBJ1-1
TGTGCCAGCAGTTATGGTGGGGCATCCTACGAGCAGTACTTC	CASSYGGASYEQYF	TRBV6-4	TRBJ2-7
TGTGCCAGCATGACAGGGAACACTGAAGCTTTCTTT	CASMTGNTEAFF	TRBV6-1	TRBJ1-1
TGTGCCAGCAGTTTACAGATAGAGACCGGGTATCAGCCCCAGCATTTT	CASSLQIETGYQPQHF	TRBV28	TRBJ1-5
TGCGCCAGCAGCTGGCAGCACAGGGAGAAGAACACTGAAGCTTTCTTT	CASSWQHREKNTEAFF	TRBV5-1	TRBJ1-1
TGTGCTAGCAGCTTAGGAAGGGGGGACAGGGGAGATGAAAAACTGTTTTTT	CASSLGRGDRGDEKLFF	TRBV7-7	TRBJ1-4
TGTGCCAGCAGTTTATGGGCTGGAACGGGGGTGACTAGCAATCAGCCCCAGCATTTT	CASSLWAGTGVTSNQPQHF	TRBV28	TRBJ1-5
TGTGCCAGCAGCCTTCTGGGACAGGGCTCCTACGAGCAGTACTTC	CASSLLGQGSYEQYF	TRBV9	TRBJ2-7
TGTGCCAGCAGTGAATGGTGGGGGGTCCCGGCTGAAGCTTTCTTT	CASSEWWGVPAEAFF	TRBV6-1	TRBJ1-1
TGTGCCACCAGTGATAGTGGGGTTGAGCAGTACTTC	CATSDSGVEQYF	TRBV24-1	TRBJ2-7
TGCAGTGCTCAGGGCACTAGCAATCAGCCCCAGCATTTT	CSAQGTSNQPQHF	TRBV20-1	TRBJ1-5
TGCAGTGCTACATTAAATAGTCCTGAGCAGTTCTTC	CSATLNSPEQFF	TRBV20-1	TRBJ2-1
TGCGCCAGCAGCGCGGGAGGGCTCCATAACTACGAGCAGTACTTC	CASSAGGLHNYEQYF	TRBV10-2	TRBJ2-7
TGCAGTGCTGGCAGGGGGCTCACAGATACGCAGTATTTT	CSAGRGLTDTQYF	TRBV20-1	TRBJ2-3
TGCAGTGCTACCTCCGGGACGGGGAACACTGAAGCTTTCTTT	CSATSGTGNTEAFF	TRBV20-1	TRBJ1-1
TGTGCCAGCAGTTCGCGGGACAGGGCTTTAGGGGTTGTTGAAGCTTTCTTT	CASSSRDRALGVVEAFF	TRBV27	TRBJ1-1
TGTGCCAGCAGCAGAGTTTCTAGAGGCACAGATACGCAGTATTTT	CASSRVSRGTDTQYF	TRBV13	TRBJ2-3
TGTGCCAGCAGCTTACCACGGGACACCGGGGAGCTGTTTTTT	CASSLPRDTGELFF	TRBV7-3	TRBJ2-2
TGTGCCAGCAGCTTGAGGGACAAAGCAGAGACCCAGTACTTC	CASSLRDKAETQYF	TRBV7-3	TRBJ2-5
TGCAGTGCTAGAGACGCAGGGGGGATTGTCTCTGGAAACACCATATATTTT	CSARDAGGIVSGNTIYF	TRBV20-1	TRBJ1-3
TGTGCCTGGGTCATAGCGGGTAAATGCTACGAGCAGTACTTC	CAWVIAGKCYEQYF	TRBV30	TRBJ2-7
TGTGCCACCAGTTGTCGGGACAGGGATTCCTACGAGCAGTACTTC	CATSCRDRDSYEQYF	TRBV24-1	TRBJ2-7
TGTGCCAGCAGCCTGGGCGGGAGAGATGGCCACGAGCAGTACTTC	CASSLGGRDGHEQYF	TRBV7-3	TRBJ2-7
TGTGCCAGCAGTTTTGCTAGCGGGGGAATGGATACGCAGTATTTT	CASSFASGGMDTQYF	TRBV12-4	TRBJ2-3
TGCGCCAGCAGCTTGGTAGGAAGTAAGGGGGCGCCTCCCAATGAGCAGTTCTTC	CASSLVGSKGAPPNEQFF	TRBV5-1	TRBJ2-1
TGTGCCAGCAGCTTACATAGGGGACAGATACTCAATGAAAAACTGTTTTTT	CASSLHRGQILNEKLFF	TRBV7-8	TRBJ1-4
TGTGCCAGGCTACCTTGCAAGAATCAGCCCCAGCATTTT	CARLPCKNQPQHF	TRBV19	TRBJ1-5
TGTGCCAGCAGTTCCGGACAGACTAATGAAAAACTGTTTTTT	CASSSGQTNEKLFF	TRBV25-1	TRBJ1-4
TGTGCCAGCAGTTTAACTAGCGGGAGGTTGATAGATACGCAGTATTTT	CASSLTSGRLIDTQYF	TRBV28	TRBJ2-3
TGTGCCAGCAGTTTATGTGGACAGGGGGACTACAATGAGCAGTTCTTC	CASSLCGQGDYNEQFF	TRBV27	TRBJ2-1
TGTGCCAGCAGTTTCCAGCCACTAGCGGGTGGGTTCTCGAACACCGGGGAGCTGTTTTTT	CASSFQPLAGGFSNTGELFF	TRBV6-6	TRBJ2-2
TGTGCCAATAGAGGGGCTTCCATAGACACCTACGAGCAGTACTTC	CANRGASIDTYEQYF	TRBV18	TRBJ2-7
TGTGCCGTACCTGGACAGCCCCAGCATTTT	CAVPGQPQHF	TRBV27	TRBJ1-5
TGTGCCAGCAGTGACAGGGGTCGGGGGCCAGAGACCCAGTACTTC	CASSDRGRGPETQYF	TRBV6-4	TRBJ2-5
TGTGCCAGCAGCTTCCCAGGGGTTCCCTACGAGCAGTACTTC	CASSFPGVPYEQYF	TRBV7-4	TRBJ2-7
TGTGCCAGCAGCTCTGTCGGGGGAGTGGTGGGAAACACCATATATTTT	CASSSVGGVVGNTIYF	TRBV9	TRBJ1-3
TGCGCCAGCAGCAGGAGATTCAGGGTTTGGGAGAGAAGCTACACCTTC	CASSRRFRVWERSYTF	TRBV5-1	TRBJ1-2
TGTGCCAGCAGCCAGGTCGTCCGACAGGGGAAGCTCACCTTC	CASSQVVRQGKLTF	TRBV3-1	TRBJ1-2
TGCAGTGCTAGAGGCAAAAGGGACACAAGATGCTCTGGGGCCAACGTCCTGACTTTC	CSARGKRDTRCSGANVLTF	TRBV20-1	TRBJ2-6
TGTGCCAGCACCTTCCCGGGACTAGCGGGAGGGTCGTATAGCAATCAGCCCCAGCATTTT	CASTFPGLAGGSYSNQPQHF	TRBV7-4	TRBJ1-5
TGTGCCAGCAGTGACTCTAAACTTTCAGTGCCCCAGCATTTT	CASSDSKLSVPQHF	TRBV6-4	TRBJ1-5
TGTGCCAGCAGCCGATACAGGGCTAGCGGGTCGTACTTC	CASSRYRASGSYF	TRBV7-3	TRBJ2-5
TGTGCCACACTAGCGGGAGGTTTGCGGCCGGTAGCCAAAAACATTCAGTACTTC	CATLAGGLRPVAKNIQYF	TRBV24-1	TRBJ2-4
TGTGCCAGCAGCTTAGACACTAGCGGGTATCAGTACTTC	CASSLDTSGYQYF	TRBV11-1	TRBJ2-5
TGCGCCAGACGTCCAAGGTACGCTGAGCAGTTCTTC	CARRPRYAEQFF	TRBV5-1	TRBJ2-1
TGTGCCAGTAGTCCAGACTACAGGCAGATCATCCAGAACACTGAAGCTTTCTTT	CASSPDYRQIIQNTEAFF	TRBV19	TRBJ1-1
TGTGCCAGCAGCCAGGGCCACACAGATACGCAGTATTTT	CASSQGHTDTQYF	TRBV13	TRBJ2-3
TGTGCCAGCACCCGGACTCCCATACGGCAAGAGACCCAGTACTTC	CASTRTPIRQETQYF	TRBV27	TRBJ2-5
TGCGCCAGCAGCTTGGCCCCATCTCCAAGGGACCCGATGAAGACCCAGTACTTC	CASSLAPSPRDPMKTQYF	TRBV5-1	TRBJ2-5
TGTGCCAGCAGGTCTGACCGGGACAGGGCGTACTCTGGAAACACCATATATTTT	CASRSDRDRAYSGNTIYF	TRBV12-4	TRBJ1-3
TGTGCCAGCAGCTTGGGTTATACTTATATGGACAATGAGCAGTTCTTC	CASSLGYTYMDNEQFF	TRBV7-4	TRBJ2-1
TGTGCCAGCAGCTTAAGCTCAACTAGCGGGTTCTACTATGAGCAGTTCTTC	CASSLSSTSGFYYEQFF	TRBV7-3	TRBJ2-1
TGTGCCAGCAGCTGCGGACGCTGCTCTGGGGCCAACGTCCTGACTTTC	CASSCGRCSGANVLTF	TRBV7-9	TRBJ2-6
TGTGCCATCAGCTCCCGAGTAGGCTGGTGGGAGACCCAGTACTTC	CAISSRVGWWETQYF	TRBV10-3	TRBJ2-5
TGTGAACCCAGGGCCTATGAGCAGTTCTTC	CEPRAYEQFF	TRBV6-1	TRBJ2-1
TGTGCCAGCACTCTAGAAAGTGTTCCATTTACAGATACGCAGTATTTT	CASTLESVPFTDTQYF	TRBV6-4	TRBJ2-3
TGTGCCAGCAGCTTAACCGCGGCCTGTAGTAAGCCAGGCGAGCAGTACTTC	CASSLTAACSKPGEQYF	TRBV7-2	TRBJ2-7
TGTGCCAGCAGCCCGGGCGGAACAGGCTATGAGCAGTTCTTC	CASSPGGTGYEQFF	TRBV7-3	TRBJ2-1
TGTGCCATAAAGGGCCCTGAAGCTTTCTTT	CAIKGPEAFF	TRBV19	TRBJ1-1
TGTGACCGTCAGGGGGGCCATGGCTACACCTTC	CDRQGGHGYTF	TRBV11-3	TRBJ1-2
TGTGCCAGCAGCGGCCAGGCCCTGAACACTGAAGCTTTCTTT	CASSGQALNTEAFF	TRBV13	TRBJ1-1
TGTGCCAGCAGCCACAGGGACCTGGACTATGACTACGAGCAGTACTTC	CASSHRDLDYDYEQYF	TRBV7-7	TRBJ2-7
TGTGCCAGCAGCGAACGGGTGGGAACTTTCTTT	CASSERVGTFF	TRBV11-1	TRBJ1-1
TGTGCCACCAGTGATTTTCCCTCCTTGGGGCCTGAGCAGTTCTTC	CATSDFPSLGPEQFF	TRBV24-1	TRBJ2-1
TGTGCCAGCAGCGCCGGGACAGGGCCTCGCAATCAGCCCCAGCATTTT	CASSAGTGPRNQPQHF	TRBV11-3	TRBJ1-5
TGTGCCAGCAGCTCCCCGCAGCGGTGGGAGACCCAGTACTTC	CASSSPQRWETQYF	TRBV5-5	TRBJ2-5
TGCAGTGCTAGAAAGGGTTACGGGACACGGGGGAACACTGAAGCTTTCTTT	CSARKGYGTRGNTEAFF	TRBV20-1	TRBJ1-1
TGTGCCAGCAGCTTAGCGAGGCGTCATCTGGCAAACTACGAGCAGTACTTC	CASSLARRHLANYEQYF	TRBV7-2	TRBJ2-7
TGTGCCAGCATCTGGGACAGGGGGCGCTTAAACTATGGCTACACCTTC	CASIWDRGRLNYGYTF	TRBV6-3	TRBJ1-2
TGTGCCAGCAGCTGTAAGAAAACAGGGTTGCGGTCAAATGAAAAACTGTTTTTT	CASSCKKTGLRSNEKLFF	TRBV5-6	TRBJ1-4
TGCGCCAGCCAACTCCCAACGACAGGGGGCGTCTACGAGCAGTACTTC	CASQLPTTGGVYEQYF	TRBV10-2	TRBJ2-7
TGTGCCAGCAGTGAATATATTGGAGGGTACGACTATGGCTACACCTTC	CASSEYIGGYDYGYTF	TRBV25-1	TRBJ1-2
TGTGCCAGCAGCGCAGGGGGCCAATCCTACGAGCAGTACTTC	CASSAGGQSYEQYF	TRBV9	TRBJ2-7
TGTGCCAGCAGTTACTCGAGGTTGAGAGTCAGTGGCTACACCTTC	CASSYSRLRVSGYTF	TRBV6-5	TRBJ1-2
TGTGCCAGCAGCGTAGAAACGACTAGGGGACAGGGAGGCAATCAGCCCCAGCATTTT	CASSVETTRGQGGNQPQHF	TRBV9	TRBJ1-5
TGTGCCAGCAGCTTAATTGCGGGAGTCTCTGGAAACACCATATATTTT	CASSLIAGVSGNTIYF	TRBV7-3	TRBJ1-3
TGTGCCAGCAGCCCCCCTCCGAAGGGGGGGCTATACACCGGGGAGCTGTTTTTT	CASSPPPKGGLYTGELFF	TRBV13	TRBJ2-2
TGTGCCAGCAGCTCCCGGGACCGGAGTGCGCTGTTTTTT	CASSSRDRSALFF	TRBV5-6	TRBJ2-2
TGTGCCAGCATGGTACAGGCTTCGAACACCGGGGAGCTGTTTTTT	CASMVQASNTGELFF	TRBV12-4	TRBJ2-2
TGTGCCAGCACCCGGTACGCGTTCATGGGACAGGCCACAGATACGCAGTATTTT	CASTRYAFMGQATDTQYF	TRBV6-2	TRBJ2-3
TGTGCCACCAGTGTGATGACTTGGATGGAATATGGCTACACCTTC	CATSVMTWMEYGYTF	TRBV24-1	TRBJ1-2
TGTGCCAGCAGCACCAGACTAGCGGGAAACGGGGAGCTGTTTTTT	CASSTRLAGNGELFF	TRBV7-3	TRBJ2-2
TGTGCCAGCAGCCCCGACAGAAGCGGGACCTACGAGCAGTACTTC	CASSPDRSGTYEQYF	TRBV7-9	TRBJ2-7
TGTGCCAGCAGCGGGGGTGGCTACACCTTC	CASSGGGYTF	TRBV7-3	TRBJ1-2
TGTGCCAGCAGTTACTCGGGGACAAGTGGTGCTTGTCCAGATACGCAGTATTTT	CASSYSGTSGACPDTQYF	TRBV6-3	TRBJ2-3
TGTGCCAGCAGTTTACGGTCCGGACAGGGGGTCAGCAATCAGCCCCAGCATTTT	CASSLRSGQGVSNQPQHF	TRBV27	TRBJ1-5
TGTGCCAGCAGTTGGATTTCTAGAAACCTCCTCCGCGGGGAGCTGTTTTTT	CASSWISRNLLRGELFF	TRBV6-5	TRBJ2-2
TGTGCCAGCAGCTTGGTCTCGGCCTCGTACGAGCAGTACTTC	CASSLVSASYEQYF	TRBV5-6	TRBJ2-7
TGCAGTGCTTACTGGGGGGAACCGAGGAACTATGGCTACACCTTC	CSAYWGEPRNYGYTF	TRBV20-1	TRBJ1-2
TGTGCCAGTGACAGCACCGTGTCGAATTCACCCCTCCACTTT	CASDSTVSNSPLHF	TRBV19	TRBJ1-6
TGTGCCAGCCCGCAGCTTGGTCGGAGTGAGCAGTACTTC	CASPQLGRSEQYF	TRBV12-3	TRBJ2-7
TGTGCCACCAGTGATTGCTGGGACAGGGCCAAGAACACTGAAGCTTTCTTT	CATSDCWDRAKNTEAFF	TRBV24-1	TRBJ1-1
TGCGCCAGCAGCGGGGTCCTGAGCTACAATGAGCAGTTCTTC	CASSGVLSYNEQFF	TRBV5-1	TRBJ2-1
TGTGCCAGCGGACTAGCGGGCAATGAGCAGTTCTTC	CASGLAGNEQFF	TRBV6-2	TRBJ2-1
TGTGCCAGCAGTTTAAGAAGCCCCTTTCCAGGGGAGAGCTCCTACAATGAGCAGTTCTTC	CASSLRSPFPGESSYNEQFF	TRBV27	TRBJ2-1
TGTGCCAGCTCACCATCGAGGGCGGAAGCTTTCTTT	CASSPSRAEAFF	TRBV18	TRBJ1-1
TGTGCTAGCAGCCTTCCTCGGGACTACGAGACCCAGTACTTC	CASSLPRDYETQYF	TRBV7-7	TRBJ2-5
TGCAGCGTTCCGCTAGCGGGGAAGGACTCCTACAATGAGCAGTTCTTC	CSVPLAGKDSYNEQFF	TRBV29-1	TRBJ2-1
TGTGCCAGTAGTACGGGCCGGGACGGCCGAAACACCATATATTTT	CASSTGRDGRNTIYF	TRBV19	TRBJ1-3
TGTGCCACTGCCCGCGAGGCAGATACGCAGTATTTT	CATAREADTQYF	TRBV15	TRBJ2-3
TGTGCCAGCACCGTAGCGGGCCCAACCGGGGAGCTGTTTTTT	CASTVAGPTGELFF	TRBV7-3	TRBJ2-2
TGCGCCAGCAGCCAAGCAAAAGGCCGAGGTCTCCCACGTGTACACATTCAGTACTTC	CASSQAKGRGLPRVHIQYF	TRBV4-1	TRBJ2-4
TGTGCCAGCAGCTTAGGGTGGCGGGACAGCTACACCTTC	CASSLGWRDSYTF	TRBV7-6	TRBJ1-2
TGTGCCAGCAGCCTTCGCGGGGAGCTGTTTTTT	CASSLRGELFF	TRBV13	TRBJ2-2
TGTGCCAGCAGCAACCATAGTGACCACACAGATACGCAGTATTTT	CASSNHSDHTDTQYF	TRBV6-3	TRBJ2-3
TGTGCCACGAAGGACAGGGAATTACATAGCAATCAGCCCCAGCATTTT	CATKDRELHSNQPQHF	TRBV19	TRBJ1-5
TGTGCCAGCAGTCAGGACAGGGACCGTGGGGTTAGCTCTGGGGCCAACGTCCTGACTTTC	CASSQDRDRGVSSGANVLTF	TRBV6-5	TRBJ2-6
TGTGCCAGCAGATGGACAGGGGGGACTTATAGCAATCAGCCCCAGCATTTT	CASRWTGGTYSNQPQHF	TRBV6-5	TRBJ1-5
TGTGCCAGCAGCGCCGGAGCGATGAACACTGAAGCTTTCTTT	CASSAGAMNTEAFF	TRBV7-7	TRBJ1-1
TGTGCCAGCAGCCACGGGGACAGGGGGCTCGAGGAATCTGGGGCCAACGTCCTGACTTTC	CASSHGDRGLEESGANVLTF	TRBV4-2	TRBJ2-6
TGTGCCAGCAGGGGACTAGCGGCAGTCGATGAGCAGTTCTTC	CASRGLAAVDEQFF	TRBV12-4	TRBJ2-1
TGTGCCAATAGCACAGGGGGCGTCCACCCCCTCCACTTT	CANSTGGVHPLHF	TRBV6-4	TRBJ1-6
TGTGCCAGCCACTACGCCGGGAAGGATAGCAATCAGCCCCAGCATTTT	CASHYAGKDSNQPQHF	TRBV7-8	TRBJ1-5
TGTGCCATCAGGCCCCTCAGATTGGGGGCCAGACTATATGGCTACACCTTC	CAIRPLRLGARLYGYTF	TRBV10-3	TRBJ1-2
TGTGCCAGCAGAAAAGGGGTCGGCACAGATACGCAGTATTTT	CASRKGVGTDTQYF	TRBV12-4	TRBJ2-3
TGTGCTAGTGGTACAGGGGGCAGCACAGATACGCAGTATTTT	CASGTGGSTDTQYF	TRBV12-5	TRBJ2-3
TGTGCCAGCAGCCCGATATTTGAGACCCAGTACTTC	CASSPIFETQYF	TRBV12-3	TRBJ2-5
TGCGCCAGCAGCTCATTGAGGGGGAGACACGCAGATACGCAGTATTTT	CASSSLRGRHADTQYF	TRBV5-1	TRBJ2-3
TGTGCCAGCAGTGACTCGGAACAGCCCCAAGAGACCCAGTACTTC	CASSDSEQPQETQYF	TRBV6-4	TRBJ2-5
TGTGCCAGTAGCCCGGGACAACTGACCTCCTACGAGCAGTACTTC	CASSPGQLTSYEQYF	TRBV19	TRBJ2-7
TGTGCCAGCAGCAGACCTCCACGACCGGATGGCTACACCTTC	CASSRPPRPDGYTF	TRBV13	TRBJ1-2
TGTGCCAGCAGCTCACCCTCATATGGCTACACCTTC	CASSSPSYGYTF	TRBV7-3	TRBJ1-2
TGCGCCAGCAGCGATGTAGGGCCCGCCTACAATGAGCAGTTCTTC	CASSDVGPAYNEQFF	TRBV5-1	TRBJ2-1
TGTGCCAGCATGGACAGGGGGGGCCAGCCCCAGCATTTT	CASMDRGGQPQHF	TRBV6-1	TRBJ1-5
TGTGCCAGCAGCCTAACGGCTTTGCCCTACGAGCAGTACTTC	CASSLTALPYEQYF	TRBV14	TRBJ2-7
TGTGCCAGCAAAAAAGGGGGGACGAACGAGCAGTACTTC	CASKKGGTNEQYF	TRBV19	TRBJ2-7
TGTGCCAGCAGTACTCGGGGACCCTTGCGGGACAGGGGGCAAACTCGCTCTGGGGCCAACGTCCTGACTTTC	CASSTRGPLRDRGQTRSGANVLTF	TRBV7-9	TRBJ2-6
TGTGCCAGCAGCCAAGATCCCCAGTTGCAGCCCCAGCATTTT	CASSQDPQLQPQHF	TRBV4-2	TRBJ1-5
TGTGCCAGCATGAATCTCAATGAGCAGTTCTTC	CASMNLNEQFF	TRBV6-5	TRBJ2-1
TGTGCCAGCAGCCAAGATTCCGAAAATTCGGGCTACGAGCAGTACTTC	CASSQDSENSGYEQYF	TRBV4-2	TRBJ2-7
TGTGCCAGCAGCTTGCGACAGGTTGAAAAACTGTTTTTT	CASSLRQVEKLFF	TRBV11-2	TRBJ1-4
TGCAGTGCTAGAGCCGGGACACCTGTCGAGCAGTACTTC	CSARAGTPVEQYF	TRBV20-1	TRBJ2-7
TGTGCCAGCAGCCAAGGGCTTAGCCAAGAGACCCAGTACTTC	CASSQGLSQETQYF	TRBV14	TRBJ2-5
TGCAATCGTTTTGACAGGGAAATTCAGCCCCAGCATTTT	CNRFDREIQPQHF	TRBV20-1	TRBJ1-5
TGTGCCAGCAGTTATGCAGCGGGGGGCTACACCTTC	CASSYAAGGYTF	TRBV28	TRBJ1-2
TGTGCCAGCAGCCCTAACGAGCAGTACTTC	CASSPNEQYF	TRBV28	TRBJ2-7
TGTGCCATGAACGGATCAAGAAACACCATATATTTT	CAMNGSRNTIYF	TRBV27	TRBJ1-3
TGTGCCAGCAGCTTTTCGGGGTTAAACACCATATATTTT	CASSFSGLNTIYF	TRBV7-6	TRBJ1-3
TGTGCCAGCAGCCCCCGGGACAGGGGCCTGGGAGATGGCTACACCTTC	CASSPRDRGLGDGYTF	TRBV7-6	TRBJ1-2
TGTGCCAGCAGTCGGAGTGACTATGGCTACACCTTC	CASSRSDYGYTF	TRBV12-4	TRBJ1-2
TGTGCCAGCTCACCGCCAGGGACTAGCGGAGAGGAGACCACCTACGAGCAGTACTTC	CASSPPGTSGEETTYEQYF	TRBV18	TRBJ2-7
TGCACTAGGTGGGAGATTTTCAGCTCCTACAATGAGCAGTTCTTC	CTRWEIFSSYNEQFF	TRBV20-1	TRBJ2-1
TGTGCCACCAGTGATTTGGGGGGTGGAAATGAGCAGTTCTTC	CATSDLGGGNEQFF	TRBV24-1	TRBJ2-1
TGTGCCAGCAGCACAGGACAGGGCGTTGATACGCAGTATTTT	CASSTGQGVDTQYF	TRBV7-3	TRBJ2-3
TGTGCCAGTAGTATACCACCACGGAACATTTTGACAGGGCCTCAAGCTTTCTTT	CASSIPPRNILTGPQAFF	TRBV19	TRBJ1-1
TGCAGCGGGACCTACGAGCAGTACTTC	CSGTYEQYF	TRBV29-1	TRBJ2-7
TGTGCCAGCAGTTACACGAAAGGGAACTCCTACGAGCAGTACTTC	CASSYTKGNSYEQYF	TRBV6-5	TRBJ2-7
TGTGCCAGCAGCTTCCAGGGGACCCTTAAACACACCGGGGAGCTGTTTTTT	CASSFQGTLKHTGELFF	TRBV5-8	TRBJ2-2
TGCGCCAGCAGCTCCTTAGACTACGAGCAGTACTTC	CASSSLDYEQYF	TRBV5-1	TRBJ2-7
TGCAGTGCTAGAGGGAGGTGGGGAGGAGATCAGCCCCAGCATTTT	CSARGRWGGDQPQHF	TRBV20-1	TRBJ1-5
TGTGCCAGCAGCCATGGGGCGGGACCCCCCTACGAGCAGTACTTC	CASSHGAGPPYEQYF	TRBV12-4	TRBJ2-7
TGTGCCAGCAGCTCCGAGGGCTACGAGCAGTACTTC	CASSSEGYEQYF	TRBV11-2	TRBJ2-7
TGCAGTGCTAGAGAAACTGGAGCCAAAAACCTGGGGCGACAAGAGACCCAGTACTTC	CSARETGAKNLGRQETQYF	TRBV20-1	TRBJ2-5
TGTGCCAGCAGCGCGCAGAACTATGGCTACACCTTC	CASSAQNYGYTF	TRBV6-4	TRBJ1-2
TGTGCCAGCAGTTACTGCGGACAGAGCCGCAATCAGCCCCAGCATTTT	CASSYCGQSRNQPQHF	TRBV6-5	TRBJ1-5
TGTGCCAGCAGCTTTTTGGGGACCTTCTTC	CASSFLGTFF	TRBV7-4	TRBJ2-1
TGCAGTGCTCAGGCAGGGGAGGCCTACGAGCAGTACTTC	CSAQAGEAYEQYF	TRBV20-1	TRBJ2-7
TGCAGACGGACTACCAGCTCCTACGAGCAGTACTTC	CRRTTSSYEQYF	TRBV20-1	TRBJ2-7
TGTGCCACCAGTGACTCAGACCCCTCTCCGGGCGGGCTTTCACCCCTCCACTTT	CATSDSDPSPGGLSPLHF	TRBV24-1	TRBJ1-6
TGCGCCAGCAGCCAAGAAGAACAGGCGGGGAGTGGCTACACCTTC	CASSQEEQAGSGYTF	TRBV4-1	TRBJ1-2
TGTGCCAGCAGCTTGTCCCACAGGGAAGGCACAGATACGCAGTATTTT	CASSLSHREGTDTQYF	TRBV5-8	TRBJ2-3
TGTGCCAGATCCGAATTGGGACACACCGGGGAGCTGTTTTTT	CARSELGHTGELFF	TRBV14	TRBJ2-2
TGTGCCAGCAGTGGCAGTGGCTACACCTTC	CASSGSGYTF	TRBV25-1	TRBJ1-2
TGCGCCAGCAGCCCTCAATTTGAAAAACTGTTTTTT	CASSPQFEKLFF	TRBV4-3	TRBJ1-4
TGCAGCGTGACGGAAGTGGGAGCGGGAAAAGACTACGAGCAGTACTTC	CSVTEVGAGKDYEQYF	TRBV29-1	TRBJ2-7
TGCGCCAGCAGCTTGACCGAGAGCCAGCCAGCGTTGTACAATGAGCAGTTCTTC	CASSLTESQPALYNEQFF	TRBV5-1	TRBJ2-1
TGCAGTGCGTACGGAAACACCATATATTTT	CSAYGNTIYF	TRBV20-1	TRBJ1-3
TGTGCCAGCAGTATCTCAGCTAGCGGGTTGTACGAGCAGTACTTC	CASSISASGLYEQYF	TRBV27	TRBJ2-7
TGTGCCAGCAGTCGGCAGGGGTACATTCAGTACTTC	CASSRQGYIQYF	TRBV2	TRBJ2-4
TGTGCCAGCAGCGGTGACAGGGGCAGAGTTTGCGGTAATGAAAAACTGTTTTTT	CASSGDRGRVCGNEKLFF	TRBV7-2	TRBJ1-4
TGCAGTGGACTAGCGGGCAGACCCGGGGAGCTGTTTTTT	CSGLAGRPGELFF	TRBV20-1	TRBJ2-2
TGTGCCACCAGCGAGGGGGTGAGCAGACACAATGAGCAGTTCTTC	CATSEGVSRHNEQFF	TRBV24-1	TRBJ2-1
TGTGCCAGCTCACGGGGAACTGGAAACACCATATATTTT	CASSRGTGNTIYF	TRBV18	TRBJ1-3
TGTGCTAGTGGGGCCCAGGGCCTGGATCAGCCCCAGCATTTT	CASGAQGLDQPQHF	TRBV12-5	TRBJ1-5
TGTGCCAGCAGCAGCCTCGTAGCGGGCTCCTACGAGCAGTACTTC	CASSSLVAGSYEQYF	TRBV11-3	TRBJ2-7
TGCGCCAGCAGCTCTGGACAGTCAATAAACCATGGCTACACCTTC	CASSSGQSINHGYTF	TRBV5-1	TRBJ1-2
TGTGCCAGCTCAGAAACCGGGAGCAATCAGCCCCAGCATTTT	CASSETGSNQPQHF	TRBV27	TRBJ1-5
TGCACCCTTTGGGTCATTAGTGAGTACTTC	CTLWVISEYF	TRBV20-1	TRBJ2-7
TGTGCCAGCAGCCTTGGGAGGGGCTCAGATACGCAGTATTTT	CASSLGRGSDTQYF	TRBV7-9	TRBJ2-3
TGCGCCAGCAGTGAGTTTTCAGACAGGGGGGCCTACGAGCAGTACTTC	CASSEFSDRGAYEQYF	TRBV10-2	TRBJ2-7
TGTGCCAGCAGCCCACTCTTCTTCGGGGCGCTCAATTCACCCCTCCACTTT	CASSPLFFGALNSPLHF	TRBV3-1	TRBJ1-6
TGTGCCAGCAGTGTAGTGGCAGGCTATGGCTACACCTTC	CASSVVAGYGYTF	TRBV12-4	TRBJ1-2
TGCAGTGCACCCGGGGGGGCCAACGACAAAGAGACCCAGTACTTC	CSAPGGANDKETQYF	TRBV20-1	TRBJ2-5
TGTGCCAGCAGCCTCCTAGCGGGCACCAGGGAGCAGTACTTC	CASSLLAGTREQYF	TRBV9	TRBJ2-7
TGTGCCAGCAGCCAAGATTTCGAGGGGGGTTATAGCAATCAGCCCCAGCATTTT	CASSQDFEGGYSNQPQHF	TRBV3-1	TRBJ1-5
TGCGCCAGCATATGCCGGGACGTTCGGAACACTGAAGCTTTCTTT	CASICRDVRNTEAFF	TRBV10-1	TRBJ1-1
TGTGCCAGCGCCGGCCGTTATAACGGGGAGCTGTTTTTT	CASAGRYNGELFF	TRBV11-2	TRBJ2-2
TGTGCCAGCACTGGACCGGGACATGGTTCGAGGTTTTACAATGAGCAGTTCTTC	CASTGPGHGSRFYNEQFF	TRBV7-6	TRBJ2-1
TGCAGCGACACCGGGAACTACGAGCAGTACTTC	CSDTGNYEQYF	TRBV29-1	TRBJ2-7
TGTGCCAGCAGTTCCCCCTGGGATGGCGGCACCGGGGAGCTGTTTTTT	CASSSPWDGGTGELFF	TRBV27	TRBJ2-2
TGTGCCAGCAGCCCAAGACCGACCGTCCTCAATGAGCAGTTCTTC	CASSPRPTVLNEQFF	TRBV3-1	TRBJ2-1
TGTGCCTGGAGTGTAGTACCTAGCGGCGGATACGAGCAGTACTTC	CAWSVVPSGGYEQYF	TRBV30	TRBJ2-7
TGTGCCAGCAGCCCCGGAGGAGGGCAAGAGACCCAGTACTTC	CASSPGGGQETQYF	TRBV7-9	TRBJ2-5
TGCGCCAGCAGCCAAGATATGCTAGCGGGCTTTGGGTACGAGCAGTACTTC	CASSQDMLAGFGYEQYF	TRBV4-3	TRBJ2-7
TGTGCCAGCAGCGGTATAGTGGGGCCTGCAGATGAGCAGTTCTTC	CASSGIVGPADEQFF	TRBV5-6	TRBJ2-1
TGTGCCAGCGGCCGCTCCTACGAGCAGTACTTC	CASGRSYEQYF	TRBV6-5	TRBJ2-7
TGTGCCAGCGAAGGAAACACTGAAGCTTTCTTT	CASEGNTEAFF	TRBV11-3	TRBJ1-1
TGCGCCAGCAGCTTGCAACCTCCTCGGACTAGCGGGGCCTACAATGAGCAGTTCTTC	CASSLQPPRTSGAYNEQFF	TRBV5-1	TRBJ2-1
TGTGCCAGCAAGGCCCGGACAGGACACACTGAAGCTTTCTTT	CASKARTGHTEAFF	TRBV6-4	TRBJ1-1
TGTGCCAGCAGTTTTGGCGCTAGGTGCTACGAGCAGTACTTC	CASSFGARCYEQYF	TRBV27	TRBJ2-7
TGTGCCAGCAGCCGGGAGGAAATAGCTTCGTGCGAGCAGTACTTC	CASSREEIASCEQYF	TRBV14	TRBJ2-7
TGTGCCAGTAGTACGCAGGCGGAGAACACTGAAGCTTTCTTT	CASSTQAENTEAFF	TRBV19	TRBJ1-1
TGCGCCAGCAGCTACGTACCACAGGGGCTGGGCAACCCGGTTCACACCGGGGAGCTGTTTTTT	CASSYVPQGLGNPVHTGELFF	TRBV5-1	TRBJ2-2
TGTGCCAGCACTCTTGGTAATTCACCCCTCCACTTT	CASTLGNSPLHF	TRBV6-5	TRBJ1-6
TGCAGTGCTTGCGGAGCCGGGACATACCGTCAGCCCCAGCATTTT	CSACGAGTYRQPQHF	TRBV20-1	TRBJ1-5
TGCGCCAGCTCCGACAAGATCACTGAAGCTTTCTTT	CASSDKITEAFF	TRBV10-1	TRBJ1-1
TGCAGTGCAGTGTCGTCCGAGTTTTATGGCTACACCTTC	CSAVSSEFYGYTF	TRBV20-1	TRBJ1-2
TGTGCCAGCAGCTTAGCGCCCGTACCCTACGAGCAGTACTTC	CASSLAPVPYEQYF	TRBV11-2	TRBJ2-7
TGCAGTGCTCCCCCATCAGGGGTGTTGAAGAGCACAGATACGCAGTATTTT	CSAPPSGVLKSTDTQYF	TRBV20-1	TRBJ2-3
TGTGCCACCAGGCCTGGACTAGCGGACGAAAACATTCAGTACTTC	CATRPGLADENIQYF	TRBV24-1	TRBJ2-4
TGTGCCAGCAGCCAAGAACCTTCAAACAGGGGGGCGGCGGGATACACCGGGGAGCTGTTTTTT	CASSQEPSNRGAAGYTGELFF	TRBV3-1	TRBJ2-2
TGTGCCAGCAGTGAATGGAAATACGAGCAGTACTTC	CASSEWKYEQYF	TRBV25-1	TRBJ2-7
TGCGCCAGCAGGGTATCGGACAGGGGGTCCTACAATGAGCAGTTCTTC	CASRVSDRGSYNEQFF	TRBV5-1	TRBJ2-1
TGTGCCAGCAGCTTGGGACTACTCTCGGGGCGACCCTACGAGCAGTACTTC	CASSLGLLSGRPYEQYF	TRBV11-3	TRBJ2-7
TGTGCCAGCAGTTGGACCCCCCCCGGGGGAGCTGAGCAGTACTTC	CASSWTPPGGAEQYF	TRBV11-2	TRBJ2-7
TGTGCCAGTTCCGCAGGGGTGGACTCTGAGCAGTACTTC	CASSAGVDSEQYF	TRBV7-9	TRBJ2-7
TGCGCCAGCAGAGGTCGGGGGGCCAACCGACCCACCGGGGAGCTGTTTTTT	CASRGRGANRPTGELFF	TRBV5-1	TRBJ2-2
TGTGCCAGCAGTTTAAGGGGCTACAATGAGCAGTTCTTC	CASSLRGYNEQFF	TRBV28	TRBJ2-1
TGTGCCAGCAGCTCCTGGACGAGCTCCTACAATGAGCAGTTCTTC	CASSSWTSSYNEQFF	TRBV7-2	TRBJ2-1
TGTGCTAGTGGTTCGGGGGTAAAAAGCCTTTCACCCCTCCACTTT	CASGSGVKSLSPLHF	TRBV12-5	TRBJ1-6
TGCGCCAGCAGTCGGATGGACAGGGATGGTCCCAATCAGCCCCAGCATTTT	CASSRMDRDGPNQPQHF	TRBV5-1	TRBJ1-5
TGCGCCAGCAGCCAAGATGCGTCAGGGGGCAATGAAAAACTGTTTTTT	CASSQDASGGNEKLFF	TRBV4-1	TRBJ1-4
TGTGCCACCAGCAGCGATTTGGACAGGTACAAAAACTATAATTCACCCCTCCACTTT	CATSSDLDRYKNYNSPLHF	TRBV15	TRBJ1-6
TGTGCCAGCACTAGGACGGCGAACACTGAAGCTTTCTTT	CASTRTANTEAFF	TRBV7-3	TRBJ1-1
TGTGCCAGCAGCTTAGACCGAGACGGGGGGGCCCACCTGGGGTCCTACGAGCAGTACTTC	CASSLDRDGGAHLGSYEQYF	TRBV11-2	TRBJ2-7
TGTGCCAGCAGCTTAGTCTCCTCACGACCCACAGATACGCAGTATTTT	CASSLVSSRPTDTQYF	TRBV7-8	TRBJ2-3
TGTGCCAGCAGCCCTTTACCCCCCCCCGGGACAGAATCCTACGAGCAGTACTTC	CASSPLPPPGTESYEQYF	TRBV13	TRBJ2-7
TGTGCCAGCAGCGCCCCCGAAAACTACGAGCAGTACTTC	CASSAPENYEQYF	TRBV9	TRBJ2-7
TGCGCCAGCAGCGATATAGGGGGAAGCACAGATACGCAGTATTTT	CASSDIGGSTDTQYF	TRBV5-1	TRBJ2-3
TGTGCCAGCAGCGCCAGGGGGCGTGAAGGAGCGAACACTGAAGCTTTCTTT	CASSARGREGANTEAFF	TRBV7-3	TRBJ1-1
TGTGCCAGCAGTTTAGGTAGCGGGAGGAAAGGGTTCGGTCCTCAGCCCCAGCATTTT	CASSLGSGRKGFGPQPQHF	TRBV27	TRBJ1-5
TGTGCCAGCAGTGAACCCAGGGGGACCAATGAGCAGTTCTTC	CASSEPRGTNEQFF	TRBV27	TRBJ2-1
TGTGCCAGCAGCTTAGAGGGGGGGGGTTATGGCTACACCTTC	CASSLEGGGYGYTF	TRBV7-7	TRBJ1-2
TGTGCCACCAGCAGACTCCCCGCGGCATACTATGGCTACACCTTC	CATSRLPAAYYGYTF	TRBV15	TRBJ1-2
TGTGCCAGCAGCGCACCATCCTACGAGCAGTACTTC	CASSAPSYEQYF	TRBV6-5	TRBJ2-7
TGTGCCAGCGACCAAGCCCCTCGGGACAGGGGGGAAAAACTGTTTTTT	CASDQAPRDRGEKLFF	TRBV12-4	TRBJ1-4
TGTGCCAGCAGTTACGGACCGGGACAGGGGTTGACTGAAGCTTTCTTT	CASSYGPGQGLTEAFF	TRBV6-2	TRBJ1-1
TGCGCCAGCAGCTTGGGGGTTCCCCACCCGAATAATCAGCCCCAGCATTTT	CASSLGVPHPNNQPQHF	TRBV5-1	TRBJ1-5
TGTGCCAGCAGTTACACGAGGACGGAGAAGTCACCCCTCCACTTT	CASSYTRTEKSPLHF	TRBV6-5	TRBJ1-6
TGTGCCAGCAGCTTCGGGGGCTACGAGCAGTACTTC	CASSFGGYEQYF	TRBV7-9	TRBJ2-7
TGTGCCAGCAGTGACCACCCGGGTACGAAGCCCAAAAACATTCAGTACTTC	CASSDHPGTKPKNIQYF	TRBV6-4	TRBJ2-4
TGTGCCACCACGGGAGGGCGGGGTTCACCCCTCCACTTT	CATTGGRGSPLHF	TRBV24-1	TRBJ1-6
TGTGCCACCAGTGTTGGGTGTTGGGGTTCTGGAAACACCATATATTTT	CATSVGCWGSGNTIYF	TRBV24-1	TRBJ1-3
TGCAGTGCTAGACCTGCGGGGAACGGGGAGCTGTTTTTT	CSARPAGNGELFF	TRBV20-1	TRBJ2-2
TGTGCCAGCAGCCTTGAGGATCACGAGCAGTACTTC	CASSLEDHEQYF	TRBV13	TRBJ2-7
TGCAGTGTTGGGACCAAAGGAGGACTAGTGGGGTGGCCCGACAATGAGCAGTTCTTC	CSVGTKGGLVGWPDNEQFF	TRBV20-1	TRBJ2-1
TGCGCCAGCAGCCATCTGAGAAGACAGTATGATACTGAAGCTTTCTTT	CASSHLRRQYDTEAFF	TRBV4-3	TRBJ1-1
TGTGCCAGCAGCCGGCCCGGACGGGGGTACGAGCAGTACTTC	CASSRPGRGYEQYF	TRBV3-1	TRBJ2-7
TGTGCCAGCAGACGACAGAGCAATCAGCCCCAGCATTTT	CASRRQSNQPQHF	TRBV6-4	TRBJ1-5
TGTGCCTGGGGTCGGGGCGTGGGGAACCAGCATTTT	CAWGRGVGNQHF	TRBV30	TRBJ1-5
TGTGCCACCGGCGTTATTCTAGACTACAATGAGCAGTTCTTC	CATGVILDYNEQFF	TRBV24-1	TRBJ2-1
TGTGCCAGCACTTCTTCTAACCTGTCCTACAATGAGCAGTTCTTC	CASTSSNLSYNEQFF	TRBV7-9	TRBJ2-1
TGTGCCAGCAAACCTCACGCAAACTATGGCTACACCTTC	CASKPHANYGYTF	TRBV6-4	TRBJ1-2
TGTGCCAGCAGTACACTCCCTGCGGAACGGATCTCCTACAATGAGCAGTTCTTC	CASSTLPAERISYNEQFF	TRBV25-1	TRBJ2-1
TGCAGTGCTAGAGATCGAGGCTACGAGCAGTACTTC	CSARDRGYEQYF	TRBV20-1	TRBJ2-7
TGTGCCAGCAGCGTAGCCGCGCCGTACTATGAGCAGTTCTTC	CASSVAAPYYEQFF	TRBV9	TRBJ2-1
TGTGCCAGCAGCTCCTCCCGGAGGGGGGGTGAGCAGTACTTC	CASSSSRRGGEQYF	TRBV5-4	TRBJ2-7
TGTGCCAGCAGTTCCCTGGGACGCCATCTTCTAGGGAAGACCTACGAGCAGTACTTC	CASSSLGRHLLGKTYEQYF	TRBV6-5	TRBJ2-7
TGTGCCAGAAGCCCCAGGGCCTTTTCCTACGAGCAGTACTTC	CARSPRAFSYEQYF	TRBV19	TRBJ2-7
TGTGCCAGCTCCGCAGCGGGACTAGATGAGCAGTTCTTC	CASSAAGLDEQFF	TRBV27	TRBJ2-1
TGCAGTGGGGACAGGCTTTCAAACTACAATGAGCAGTTCTTC	CSGDRLSNYNEQFF	TRBV20-1	TRBJ2-1
TGTGCCAGCAGTTCCCGGAGCACAGATACGCAGTATTTT	CASSSRSTDTQYF	TRBV28	TRBJ2-3
TGCGCCAGCAGCTCCAACGAGAGTCGCACTAGCGGGAGTGAGTACGAGCAGTACTTC	CASSSNESRTSGSEYEQYF	TRBV5-1	TRBJ2-7
TGTGCCAGCGCTCACTCCCGGAGGAATCAGCCCCAGCATTTT	CASAHSRRNQPQHF	TRBV6-1	TRBJ1-5
TGTGCCAGCAGCCTCGGGACAGAGGATCGAAATGGCTACACCTTC	CASSLGTEDRNGYTF	TRBV3-1	TRBJ1-2
TGTGCCAGCAGCTATCCTTTCCCGGGAGGGATGGGGGATACGCAGTATTTT	CASSYPFPGGMGDTQYF	TRBV11-3	TRBJ2-3
TGCGCCAGCAGCCGGACAGGGGACTATGGCTACACCTTC	CASSRTGDYGYTF	TRBV4-3	TRBJ1-2
TGCGCCAGCAAAAAGGTACTAGCGGGGAGCGGGGAGCTGTTTTTT	CASKKVLAGSGELFF	TRBV5-1	TRBJ2-2
TGTGCCAGTAGTATAGATGACAGGGACAGCACAGATACGCAGTATTTT	CASSIDDRDSTDTQYF	TRBV19	TRBJ2-3
TGCGCCAGCAGCCAAGGAGGACAGGGGAACTTCTCTGGGGCCAACGTCCTGACTTTC	CASSQGGQGNFSGANVLTF	TRBV4-1	TRBJ2-6
TGTGCCAGCAGTCCTGGCGAGAAGAGAGGACAGCGCTCCTACGAGCAGTACTTC	CASSPGEKRGQRSYEQYF	TRBV2	TRBJ2-7
TGTGCCAGCAGCGTAATGACGACTCTGCGCGAGCAGTACTTC	CASSVMTTLREQYF	TRBV13	TRBJ2-7
TGCGCCAGCAGCCAAGTGGTAACAGCGGGACAGGGACTCGGCTACACCTTC	CASSQVVTAGQGLGYTF	TRBV4-3	TRBJ1-2
TGCGCCAGCATCCAGAAGGCAGGGGAGGATGGGGCCAACGTCCTGACTTTC	CASIQKAGEDGANVLTF	TRBV10-2	TRBJ2-6
TGTGCCACCAGTGATTTGCGAGGGCAGGGGCGAAACACTGAAGCTTTCTTT	CATSDLRGQGRNTEAFF	TRBV24-1	TRBJ1-1
TGCGCCAGCAGCCAAGGCCTTCCGCCGGGACAGGGGTTCGTTGAAGCTTTCTTT	CASSQGLPPGQGFVEAFF	TRBV4-1	TRBJ1-1
TGTGCCAGCAGCGTCGCCTTTCAGGGGGAGACCGGCACAGATACGCAGTATTTT	CASSVAFQGETGTDTQYF	TRBV9	TRBJ2-3
TGCGCCAGCAGCCAAGCGTACCGCAGGACAGGGAAGCAGCCCCAGCATTTT	CASSQAYRRTGKQPQHF	TRBV4-3	TRBJ1-5
TGCGCCAGCAGCCAAGTGAGGGGGACTAGCGGGGGGGTGTACAATGAGCAGTTCTTC	CASSQVRGTSGGVYNEQFF	TRBV4-1	TRBJ2-1
TGTGCCAGCAGCTGCGACAGGGGCTCCCACTATGGCTACACCTTC	CASSCDRGSHYGYTF	TRBV9	TRBJ1-2
TGTGCCAGCAGCGGGTATGCTTTCTTT	CASSGYAFF	TRBV11-3	TRBJ1-1
TGTGCCACATTAGGGCCCGGTTATGGCTACACCTTC	CATLGPGYGYTF	TRBV24-1	TRBJ1-2
TGCGCCAGCAGCTTAAACCGTCCAGGGACTAGCGGGGCGGCGCACGGCTTTTTTGGCACAGATACGCAGTATTTT	CASSLNRPGTSGAAHGFFGTDTQYF	TRBV5-1	TRBJ2-3
TGCAGTGCAAGTATGGACAGGGGAGGGCAGACCCAGTACTTC	CSASMDRGGQTQYF	TRBV20-1	TRBJ2-5
TGCAGTGCTAGAGCGGCGAGACAGAAGAACACTGAAGCTTTCTTT	CSARAARQKNTEAFF	TRBV20-1	TRBJ1-1
TGCGCCAGCAGTGAGTATAAGGGCAGGAAGGGTTTTGGACAGAGGGGAATACATCAGCCCCAGCATTTT	CASSEYKGRKGFGQRGIHQPQHF	TRBV10-1	TRBJ1-5
TGTGCCAGCAGTGACGAAGGAGAAGGGAACACTGAAGCTTTCTTT	CASSDEGEGNTEAFF	TRBV6-4	TRBJ1-1
TGTGCCAGCAGCCAGGGGTGGAGTAACTATGGCTACACCTTC	CASSQGWSNYGYTF	TRBV11-2	TRBJ1-2
TGTGCTAGTGGTTTGGTCCCAAAACGCCCCACAGGGGGGTTCAGGAGAGCTAATGAAAAACTGTTTTTT	CASGLVPKRPTGGFRRANEKLFF	TRBV12-5	TRBJ1-4
TGTGCCAGCAGCCGACAGGGGGCGAGAGACTACAATGAGCAGTTCTTC	CASSRQGARDYNEQFF	TRBV6-4	TRBJ2-1
TGTGCCAGTAGTGACCCAAGAGGGACACTCGGCTACACCTTC	CASSDPRGTLGYTF	TRBV19	TRBJ1-2
TGTGCCAGCAGTTTTTGTTACGGACAGGGGGATTGTATGCCGGAGACCCAGTACTTC	CASSFCYGQGDCMPETQYF	TRBV27	TRBJ2-5
TGTGCCAGCAGTTACTGGATGCTACCCTTTGAGGTCGCCAAAAACATTCAGTACTTC	CASSYWMLPFEVAKNIQYF	TRBV6-5	TRBJ2-4
TGTGCCAGCAGCTGGGGGGCGGAGTCCTACGAGCAGTACTTC	CASSWGAESYEQYF	TRBV13	TRBJ2-7
TGTGCCAGCAGCACCCCGGGACAGGGGGCCGGGGGTGGCTACACCTTC	CASSTPGQGAGGGYTF	TRBV11-2	TRBJ1-2
TGTGCCCCAGGGCGGTCGGGACTAAAAAATCAGCCCCAGCATTTT	CAPGRSGLKNQPQHF	TRBV27	TRBJ1-5
TGCGCCAGCAGCTCGGTCCGAATGAATGAAAAACTGTTTTTT	CASSSVRMNEKLFF	TRBV5-1	TRBJ1-4
TGTGCCAGCAGCTTAGAGGTCTTTCCCGGGGAGGTGGGCGTCGACACTGAAGCTTTCTTT	CASSLEVFPGEVGVDTEAFF	TRBV7-6	TRBJ1-1
TGTGCCAGCAGCCAAGACCGGGGGCGAGCTTCACCCCTCCACTTT	CASSQDRGRASPLHF	TRBV3-1	TRBJ1-6
TGTGCCAGCAGCCCTAAGGGGGCTTCCGAGCAGTACTTC	CASSPKGASEQYF	TRBV13	TRBJ2-7
TGTGCCAGCAGCTTACCAACGTCCGGGACTAGCGGGAACATTCAGTACTTC	CASSLPTSGTSGNIQYF	TRBV11-3	TRBJ2-4
TGTGCCAGCCCGGCGGGGGGGCCTTTGTACGAGCAGTACTTC	CASPAGGPLYEQYF	TRBV7-9	TRBJ2-7
TGTGCCATCAGTGCTATGACAGGGGGCGGGAACACTGAAGCTTTCTTT	CAISAMTGGGNTEAFF	TRBV10-3	TRBJ1-1
TGTGCCAGCAGCTGTGAGGGGGGGGGTTCACCCCTCCACTTT	CASSCEGGGSPLHF	TRBV11-3	TRBJ1-6
TGTGCCAGCAGCTTAGACCGCTGGGGGGGGGACAGCAGAAGGAACACCGGGGAGCTGTTTTTT	CASSLDRWGGDSRRNTGELFF	TRBV11-3	TRBJ2-2
TGTGCCGCGGGGGGTTTGGACACCATATATTTT	CAAGGLDTIYF	TRBV28	TRBJ1-3
TGTGCCAGCAGCTTAGGGACTAGCGGCGAGCAGTACTTC	CASSLGTSGEQYF	TRBV7-2	TRBJ2-7
TGCAGTGCTTGGACAGGTGGTGAAAAACTGTTTTTT	CSAWTGGEKLFF	TRBV20-1	TRBJ1-4
TGCGCCAGCAGCAGGCCACGGCGACTAGCGGGAGGGGCTCAAGAGACCCAGTACTTC	CASSRPRRLAGGAQETQYF	TRBV5-1	TRBJ2-5
TGTGCCAGCAGCAGAGAGTTAAGCCTCCAAGAGACCCAGTACTTC	CASSRELSLQETQYF	TRBV7-3	TRBJ2-5
TGTGCCAGCAGCGAGGACCCTAGCAATCAGCCCCAGCATTTT	CASSEDPSNQPQHF	TRBV9	TRBJ1-5
TGTGCCAGCAGCCAAGGATGGGGGAGCCCTGCTCAGCCCCAGCATTTT	CASSQGWGSPAQPQHF	TRBV3-1	TRBJ1-5
TGTGCTAGTGGAGTACACCGGGGGGCGGTCGAGCCCCAGCATTTT	CASGVHRGAVEPQHF	TRBV12-5	TRBJ1-5
TGCAGTGCTAGGGGAAGCTCCTACGAGCAGTACTTC	CSARGSSYEQYF	TRBV20-1	TRBJ2-7
TGTGCCAGCAGTGAACCCCCGCGGACAGGGCGCAGGGGTTCTAACTATGGCTACACCTTC	CASSEPPRTGRRGSNYGYTF	TRBV2	TRBJ1-2
TGTGCCAGCAGTGACCTGGGAGGGAGCCTCACAGATACGCAGTATTTT	CASSDLGGSLTDTQYF	TRBV6-4	TRBJ2-3
TGTGCTAGTGGTTTGGGGGGGCACTATGGCTACACCTTC	CASGLGGHYGYTF	TRBV12-5	TRBJ1-2
TGTGCCAGCAGCCAACCGGGGGGAGGCCTTAACACCGGGGAGCTGTTTTTT	CASSQPGGGLNTGELFF	TRBV3-1	TRBJ2-2
TGTGCCAGCAGCTTGGCTGCCGGGACAGGGGCTGAATTACGCGAGCAGTACTTC	CASSLAAGTGAELREQYF	TRBV5-4	TRBJ2-7
TGCAGCGTTGACCCGGGCTGGGTTCGACACAGAATGCGCTACGAGCAGTACTTC	CSVDPGWVRHRMRYEQYF	TRBV29-1	TRBJ2-7
TGTGCCAGCAGTTACCCCTTCACTAGCGGGAGTGAAGTGGAGCCCCAGCATTTT	CASSYPFTSGSEVEPQHF	TRBV6-6	TRBJ1-5
TGTGCCAGCAGGCGTAATATACAGGGGCCGAGGGGTAAGGCTTTCTTT	CASRRNIQGPRGKAFF	TRBV6-3	TRBJ1-1
TGTGCCTGGATTGTGGACAGGGGGGCCTACGAGCAGTACTTC	CAWIVDRGAYEQYF	TRBV30	TRBJ2-7
TGTGCCTCAACCGGGACAGGGATTGAGCAGTTCTTC	CASTGTGIEQFF	TRBV28	TRBJ2-1
TGCGCCAGCAGTCCCAACAAGGGGACTAGCGGGAACTTAACGACCCAGTACTTC	CASSPNKGTSGNLTTQYF	TRBV10-1	TRBJ2-5
TGTGCCAGCAGCCGTGTCGTGTATTTT	CASSRVVYF	TRBV4-2	TRBJ2-3
TGTGCCAGCAGCTCAGGGGGGGCCGGCACAGATACGCAGTATTTT	CASSSGGAGTDTQYF	TRBV7-2	TRBJ2-3
TGTGCTAGAATGAGGCTAGTCTCGGATCGGAGGTGGCGCAATGAGCAGTTCTTC	CARMRLVSDRRWRNEQFF	TRBV12-5	TRBJ2-1
TGTGCCAGCAACAGGACAACTAATGAAAAACTGTTTTTT	CASNRTTNEKLFF	TRBV6-5	TRBJ1-4
TGCAGTGCTAGAGATACGGCCGGGGTCGCGTGGAGGTACGAGCAGTACTTC	CSARDTAGVAWRYEQYF	TRBV20-1	TRBJ2-7
TGTGCCACCAGTGCTTGCGGTAGGACCCAGTACTTC	CATSACGRTQYF	TRBV24-1	TRBJ2-5
TGTGCCAGCAGCGGCCCGGGGCGGGAGGGCCCAGAGACCCAGTACTTC	CASSGPGREGPETQYF	TRBV13	TRBJ2-5
TGTGCCAGCAGCTCTCCCGGTCACCTCCCCGGCGCCAAAAACATTCAGTACTTC	CASSSPGHLPGAKNIQYF	TRBV7-2	TRBJ2-4
TGTGCCAGCAGAGGGGGCACAGATACGCAGTATTTT	CASRGGTDTQYF	TRBV12-3	TRBJ2-3
TGTGCCAGCCAGGCCAGGGTAGAAGAGACCCAGTACTTC	CASQARVEETQYF	TRBV5-4	TRBJ2-5
TGTGCCAGCAGCCGTCGGGACAGGAGAAACATTCAGTACTTC	CASSRRDRRNIQYF	TRBV14	TRBJ2-4
TGTGCCAGATTAGTGTTTTCGGCGGGAGAAGTCTTGTATGGCTACACCTTC	CARLVFSAGEVLYGYTF	TRBV28	TRBJ1-2
TGTGCCACCAGTGATTTGGGGGGGATATTCTTTCGCGATGGCTACACCTTC	CATSDLGGIFFRDGYTF	TRBV24-1	TRBJ1-2
TGTGCCACCAAAGGGGGGAACACTGAAGCTTTCTTT	CATKGGNTEAFF	TRBV15	TRBJ1-1
TGTGCCAGCAGTTTAAGGACCAATGAGCAGTTCTTC	CASSLRTNEQFF	TRBV27	TRBJ2-1
TGTGCCAGCAGCGGGTTGATGCCTTTTTTACACTATGGCTACACCTTC	CASSGLMPFLHYGYTF	TRBV14	TRBJ1-2
TGTGCCAGCAGTGATCTCCCGAAGACTACCGACAGGGCGGCCCCTGAGGCCTACGAGCAGTACTTC	CASSDLPKTTDRAAPEAYEQYF	TRBV6-1	TRBJ2-7
TGTGCCAGCAGTTTAGTCCACGATACGGAGGGCGGGGACTACTACGAGCAGTACTTC	CASSLVHDTEGGDYYEQYF	TRBV28	TRBJ2-7
TGCAGTGCTAGAGAAACACTAGCGGGAGGGCCAGGCTCCTACGAGCAGTACTTC	CSARETLAGGPGSYEQYF	TRBV20-1	TRBJ2-7
TGTGCCAGCAGTTTCCAAGAATCTCGGGAAAAACTGTTTTTT	CASSFQESREKLFF	TRBV6-2	TRBJ1-4
TGTGCCAGCAGCGTAGATACAGGGGTGGGACACACTGAAGCTTTCTTT	CASSVDTGVGHTEAFF	TRBV9	TRBJ1-1
TGTGCCAGCTTACCGAGGGGGTACACTGAAGCTTTCTTT	CASLPRGYTEAFF	TRBV13	TRBJ1-1
TGTGCCAGCAGTACCCAGGGTGCGTTAGACGAGCAGTACTTC	CASSTQGALDEQYF	TRBV27	TRBJ2-7
TGTGCCAGCAGTTACTGGGACATGGCCTTC	CASSYWDMAF	TRBV6-6	TRBJ1-2
TGTGCCAGCACGGGGGGGCAGTACTTC	CASTGGQYF	TRBV2	TRBJ2-7
TGTGCCAGCAGCGATAGACTAGCGGGAGGGGTCTACGAGCAGTACTTC	CASSDRLAGGVYEQYF	TRBV7-9	TRBJ2-7
TGCGCCAGCAGCTCCCCCAGGGACAGGGGTAGCAATCAGCCCCAGCATTTT	CASSSPRDRGSNQPQHF	TRBV5-1	TRBJ1-5
TGCAGTGCTAGGGGAGACCCGCAGTTCTTC	CSARGDPQFF	TRBV20-1	TRBJ2-1
TGTGCCAGCAGCCTTCGGTGGGACAGTATGCCCGTCGCGAACACCGGGGAGCTGTTTTTT	CASSLRWDSMPVANTGELFF	TRBV13	TRBJ2-2
TGTGCCAGCAGCGCCAAAGGGGGGGCCAAGCGAGATACGCAGTATTTT	CASSAKGGAKRDTQYF	TRBV9	TRBJ2-3
TGTGCGGAAGACGAACGCCCGGAATCACCCCTCCACTTT	CAEDERPESPLHF	TRBV27	TRBJ1-6
TGCGCCACTTGGAGGGGACGGCCTCTGGACACTGAAGCTTTCTTT	CATWRGRPLDTEAFF	TRBV4-1	TRBJ1-1
TGTGCCAGCAGTTCGGGGACCGGAACATACGAGCAGTACTTC	CASSSGTGTYEQYF	TRBV2	TRBJ2-7
TGTGCCAGTAGAAGAACCGCAACCAGGGGGGGCGCTAATGAAAAACTGTTTTTT	CASRRTATRGGANEKLFF	TRBV19	TRBJ1-4
TGCAGTGCGGAGGCCCGGGGGTTAAATGAAAAACTGTTTTTT	CSAEARGLNEKLFF	TRBV20-1	TRBJ1-4
TGCGCCAGCAGCTTGGGGACAGGGTCCTACGAGCAGTACTTC	CASSLGTGSYEQYF	TRBV5-1	TRBJ2-7
TGTGCCAGCAGTTTACTTCCCGGGACTAGCGGGACCAAAGAGACCCAGTACTTC	CASSLLPGTSGTKETQYF	TRBV28	TRBJ2-5
TGTGCCAGCAGGAGTAGAGAGGATCAGCCCCAGCATTTT	CASRSREDQPQHF	TRBV6-3	TRBJ1-5
TGTGCCAGCTCCGTGGGCTCTAACCGGGACAGTGGGGATACGCAGTATTTT	CASSVGSNRDSGDTQYF	TRBV6-2	TRBJ2-3
TGTGCCAGCAGCCGGGGGGAGGCGGGAGACGAGCAGTACTTC	CASSRGEAGDEQYF	TRBV13	TRBJ2-7
TGTGCCAGCAGCCATGGAGAATATGGCTACACCTTC	CASSHGEYGYTF	TRBV9	TRBJ1-2
TGCGCCAGCAGCCAAGACAAGTTCGTTCCTATCTACGAGCAGTACTTC	CASSQDKFVPIYEQYF	TRBV4-1	TRBJ2-7
TGTGCCAGCGGTCCACAGGATACGCAGTATTTT	CASGPQDTQYF	TRBV5-4	TRBJ2-3
TGTGCCTTCGGGGCTAGCAATCAGCCCCAGCATTTT	CAFGASNQPQHF	TRBV6-5	TRBJ1-5
TGCAGTGCTACCAGAAAATACACTGAAGCTTTCTTT	CSATRKYTEAFF	TRBV20-1	TRBJ1-1
TGTGCCAGCAGTGAGCCGGTTCCCGGGACAGGGGGGCAGCCCCAGCATTTT	CASSEPVPGTGGQPQHF	TRBV6-4	TRBJ1-5
TGTGCCAGATTTGGGGCAACCGAGCAGTACTTC	CARFGATEQYF	TRBV19	TRBJ2-7
TGTGCCAGCTCAAATCACAGGGAACCTGAAAAACTGTTTTTT	CASSNHREPEKLFF	TRBV18	TRBJ1-4
TGTGCCAGCAGCGGGCAGATTGGGGGAGGCGAAGCCTACGAGCAGTACTTC	CASSGQIGGGEAYEQYF	TRBV7-4	TRBJ2-7
TGTGCCAGCAGTTACTTCGGTGGCCTAGGGCACGGGGAGCTGTTTTTT	CASSYFGGLGHGELFF	TRBV6-5	TRBJ2-2
TGTGCCAGCAGCCGAGACGGTGGACAGGAGAATAATGAAAAACTGTTTTTT	CASSRDGGQENNEKLFF	TRBV7-3	TRBJ1-4
TGTGCCAGTAGTGCCCCTAGCGGCAACAATGAGCAGTTCTTC	CASSAPSGNNEQFF	TRBV19	TRBJ2-1
TGTGCCAGCAGCCGCGGGAGAGGGCAAGAGACCCAGTACTTC	CASSRGRGQETQYF	TRBV7-4	TRBJ2-5
TGCGCCAGCAGCCGGAGGCCGGACAGGGGAGAAGAGACCCAGTACTTC	CASSRRPDRGEETQYF	TRBV4-1	TRBJ2-5
TGTGCCATCAGCTCTAGGGGTCCAAACGAGCAGTACTTC	CAISSRGPNEQYF	TRBV10-3	TRBJ2-7
TGTGCCAGCAGCAGGGGGCGAGATTTCCGTTCTGAAGCTTTCTTT	CASSRGRDFRSEAFF	TRBV13	TRBJ1-1
TGCAGTGCTAGAAGACTACAAGCGGGAATGCGCACAGATACGCAGTATTTT	CSARRLQAGMRTDTQYF	TRBV20-1	TRBJ2-3
TGTGCCAGCGTTTCAGGGGGACTGGGTGGCACAGCTTTCTTT	CASVSGGLGGTAFF	TRBV7-9	TRBJ1-1
TGTGCCACTTTAAAGGGGGCGAAGCCCTACGAGCAGTACTTC	CATLKGAKPYEQYF	TRBV19	TRBJ2-7
TGTGCCAGCAGCCCCCGGGACAGGGGGTATGGCTACACCTTC	CASSPRDRGYGYTF	TRBV13	TRBJ1-2
TGCAATCCGCCTAGATCGGACAGGGGGAGTGATACTGGCTACACCTTC	CNPPRSDRGSDTGYTF	TRBV20-1	TRBJ1-2
TGCAGCGCGTTGGACCCTGTTTCCAGCAATCAGCCCCAGCATTTT	CSALDPVSSNQPQHF	TRBV29-1	TRBJ1-5
TGTGCCAGCAGTTACTCGACAGGGAGAGATCAGCCCCAGCATTTT	CASSYSTGRDQPQHF	TRBV6-5	TRBJ1-5
TGTGCCAGCAGACAGGTGAAGGAGACCCAGTACTTC	CASRQVKETQYF	TRBV27	TRBJ2-5
TGTGCCAGCAGGAACGACGGGGGATCCGAGACCCAGTACTTC	CASRNDGGSETQYF	TRBV6-6	TRBJ2-5
TGCGCCAGCAGCCGGGGGGGGTCCGACTGCCCAGATACGCAGTATTTT	CASSRGGSDCPDTQYF	TRBV4-1	TRBJ2-3
TGCGCCAGCAGGGGGGGAGGATACGAGCAGTACTTC	CASRGGGYEQYF	TRBV10-1	TRBJ2-7
TGTGCCAGCAGGGACCCCGAGGGTATCTTTTCCAAAAACATTCAGTACTTC	CASRDPEGIFSKNIQYF	TRBV25-1	TRBJ2-4
TGTGCCAGCAGTGAAGGGACAGGCGCAGATACGCAGTATTTT	CASSEGTGADTQYF	TRBV6-1	TRBJ2-3
TGTGCCAGCAGTCAGGGACTAGCGGAAGAGACCCAGTACTTC	CASSQGLAEETQYF	TRBV9	TRBJ2-5
TGTGCCAGTAGTACTGGGGGGAGCGCTGGAAACACCATATATTTT	CASSTGGSAGNTIYF	TRBV19	TRBJ1-3
TGTGCCAGTCCCAGGGCCTTC	CASPRAF	TRBV19	TRBJ1-2
TGTGCCAGCAGCTTTAAGGGACAGGGCTACGAGCAGTACTTC	CASSFKGQGYEQYF	TRBV7-8	TRBJ2-7
TGTGCCAGCAGCTCCCTATTGACAGTCGAAGAGACCCAGTACTTC	CASSSLLTVEETQYF	TRBV9	TRBJ2-5
TGTGCCAGCAGTGCCCGCAGCACTGAAGCTTTCTTT	CASSARSTEAFF	TRBV6-1	TRBJ1-1
TGTGCCAGCAGCTTTCGCGGGACGGCTGCGGCGAACACCGGGGAGCTGTTTTTT	CASSFRGTAAANTGELFF	TRBV7-9	TRBJ2-2
TGCAGTGCTAAAGACACACAGGGCCCCTACGAGCAGTACTTC	CSAKDTQGPYEQYF	TRBV20-1	TRBJ2-7
TGTGCCAGCACGCGGACTGATGCGAGGCCCACAGATACGCAGTATTTT	CASTRTDARPTDTQYF	TRBV2	TRBJ2-3
TGTGCCACGCCTTGGGGAACCGGCAATCAGCCCCAGCATTTT	CATPWGTGNQPQHF	TRBV7-9	TRBJ1-5
TGCGCCAGCAGCTGGGGTATAAGCTCCTATAATTCACCCCTCCACTTT	CASSWGISSYNSPLHF	TRBV5-1	TRBJ1-6
TGTGCCAGCAGCTGGGACGGTGTGGGGGCTATCGATGATGGCTCTGGGGCCAACGTCCTGACTTTC	CASSWDGVGAIDDGSGANVLTF	TRBV7-2	TRBJ2-6
TGCGCCAGCAGTGAAACTCAGGGGGAAAAGCCCCAGCATTTT	CASSETQGEKPQHF	TRBV10-1	TRBJ1-5
TGTGCCAGCAGCTTAGAAACCATAGGGGGGCTACCATGGAGATATGGCTACACCTTC	CASSLETIGGLPWRYGYTF	TRBV7-9	TRBJ1-2
TGTGCCAGCAGCGTAGGAATCGACAGGGGATTCCCGTTCTTGTCGGATGGCTACACCTTC	CASSVGIDRGFPFLSDGYTF	TRBV9	TRBJ1-2
TGTGCCAGCAGTTACCCCCCCGTAGGGGGGCGGCTCTCCTACAATGAGCAGTTCTTC	CASSYPPVGGRLSYNEQFF	TRBV6-6	TRBJ2-1
TGTGCCAGCAGCAAGGTCCCCTCGCTAGCGGGCAGGGCCTACAATGAGCAGTTCTTC	CASSKVPSLAGRAYNEQFF	TRBV7-6	TRBJ2-1
TGTGCCAGCAGTTTTGGAGGGAGGGGGGCGGCCTACGAGCAGTACTTC	CASSFGGRGAAYEQYF	TRBV12-4	TRBJ2-7
TGCAGTGCAGACATGGGTTATGGCTACACCTTC	CSADMGYGYTF	TRBV20-1	TRBJ1-2
TGTGCCAGCAGTGTTTCCAGACGCGGTGAAAAACTGTTTTTT	CASSVSRRGEKLFF	TRBV2	TRBJ1-4
TGTGCCAGCAGGACCGGGATTGGAAACACCATATATTTT	CASRTGIGNTIYF	TRBV6-2	TRBJ1-3
TGTGCCTGGCCTGGTCCTAGCGGGGTGGGTGGTGGCGAGCAGTACTTC	CAWPGPSGVGGGEQYF	TRBV30	TRBJ2-7
TGTGCCAGCGTAGGAACCTTGGGAGAGGAGATGAACACTGAAGCTTTCTTT	CASVGTLGEEMNTEAFF	TRBV9	TRBJ1-1
TGTGCCAGCAGTTTTGACCGAGGCGGGGAGCTGTTTTTT	CASSFDRGGELFF	TRBV12-4	TRBJ2-2
TGTGCCAGCAGGGGCCGGGACCAATCCACTGAAGCTTTCTTT	CASRGRDQSTEAFF	TRBV12-4	TRBJ1-1
TGTGCCAGCAGCTTAAATATGTCCACTCAAGCTTTCTTT	CASSLNMSTQAFF	TRBV11-2	TRBJ1-1
TGTGCCAGCAGCGTGTGTGTCCACGGAGGGTACGGGTACGAGCAGTACTTC	CASSVCVHGGYGYEQYF	TRBV9	TRBJ2-7
TGTGCCAGCAAGGCTCCCCCCGTGGGGGGCCAAAGCAAAAACATTCAGTACTTC	CASKAPPVGGQSKNIQYF	TRBV7-3	TRBJ2-4
TGTGCCAGCTCATCCCGAGAGCAGCCCCAGCATTTT	CASSSREQPQHF	TRBV18	TRBJ1-5
TGCGCCAGCAGCGACATCAGGAGCCACCGTAAGGACTATGGCTACACCTTC	CASSDIRSHRKDYGYTF	TRBV5-1	TRBJ1-2
TGTGCCACCGGTCTCCCCAAAAGGGGAATGAACACTGAAGCTTTCTTT	CATGLPKRGMNTEAFF	TRBV10-3	TRBJ1-1
TGTGCCAGCAGCCTAAGGACCTCTCCCGAGCAGTACTTC	CASSLRTSPEQYF	TRBV6-1	TRBJ2-7
TGCGCCAGCAGCCAAGACGGCCCGGACTCCTACAATGAGCAGTTCTTC	CASSQDGPDSYNEQFF	TRBV4-3	TRBJ2-1
TGTGCCACCAAAGCTCGGGGGCCGACGTGGAACACTGAAGCTTTCTTT	CATKARGPTWNTEAFF	TRBV5-5	TRBJ1-1
TGTGCCAGCAGTGAATTCGGACTAGCGGGTCAGGACCAAGAGACCCAGTACTTC	CASSEFGLAGQDQETQYF	TRBV25-1	TRBJ2-5
TGTGCCCCGGGGGCAAATTCACCCCTCCACTTT	CAPGANSPLHF	TRBV9	TRBJ1-6
TGTGCCAGCAGCCTTTTAATGACAGGGGCATCCTACTACGAGCAGTACTTC	CASSLLMTGASYYEQYF	TRBV5-8	TRBJ2-7
TGTGCCAGCTCACCACCCACCCGAACAGGGTGCTATGGCTACACCTTC	CASSPPTRTGCYGYTF	TRBV18	TRBJ1-2
TGTGCCAGCAGCTTAGAGTCCACAGAGATTTATACGCAGTATTTT	CASSLESTEIYTQYF	TRBV7-8	TRBJ2-3
TGCGCCAGCAGCCAAGCGGTCGGGTACACCGGGAAGCGAAACACCATATATTTT	CASSQAVGYTGKRNTIYF	TRBV4-1	TRBJ1-3
TGCGCCAGCAGCTTAACAGGGGATACGCAGTATTTT	CASSLTGDTQYF	TRBV5-1	TRBJ2-3
TGTGCCAGCAGCTTCAAGCGCCTTCAGCCCCAGCATTTT	CASSFKRLQPQHF	TRBV7-9	TRBJ1-5
TGTGCCAGTCAGGGGCACACTGAAGCTTTCTTT	CASQGHTEAFF	TRBV7-4	TRBJ1-1
TGTGCCACCAAAAGGACGGGACCGAACACTGAAGCTTTCTTT	CATKRTGPNTEAFF	TRBV24-1	TRBJ1-1
TGTGCCAGCAGCTTAGGCCCGGTGGGATACCGGAGTAGGAATGGCTACACCTTC	CASSLGPVGYRSRNGYTF	TRBV7-2	TRBJ1-2
TGTGCCAGCAGTGACCTATTAAGAGTACCCGGGACAGGGGGTTCGTACGAGCAGTACTTC	CASSDLLRVPGTGGSYEQYF	TRBV6-4	TRBJ2-7
TGTGCCAGCAGCTATGGGACAGACGTAATGTACTTC	CASSYGTDVMYF	TRBV9	TRBJ2-4
TGTGCCAGCAGCTGCCCCCACAGGGAGAGGGAAGTTTCACCCCTCCACTTT	CASSCPHREREVSPLHF	TRBV5-4	TRBJ1-6
TGTGCTAGCAGCTTAGCAATACCCCCCGATGATTTACCAGGACAGGGGGGTAGGAAAGCAGATACGCAGTATTTT	CASSLAIPPDDLPGQGGRKADTQYF	TRBV7-7	TRBJ2-3
TGTGCCAGCAGTCGGACAGTGGACGAGCAGTACTTC	CASSRTVDEQYF	TRBV27	TRBJ2-7
TGTGCCAGCAGCCAAGATGCAGCTACCGTGGCGGATACGCAGTATTTT	CASSQDAATVADTQYF	TRBV3-1	TRBJ2-3
TGTGCCAGCAGGGAGGGGACAGGGTTAAACAAGAGCTCCTATAATTCACCCCTCCACTTT	CASREGTGLNKSSYNSPLHF	TRBV6-3	TRBJ1-6
TGTGCCAGCAGCCCACAGTTTGGACAGGGGCATGGCTACACCTTC	CASSPQFGQGHGYTF	TRBV7-8	TRBJ1-2
TGTGCCAGCAGTAGCAGCTCCTACAATGAGCAGTTCTTC	CASSSSSYNEQFF	TRBV6-1	TRBJ2-1
TGCGCCAGCAGAGCCCGGACTAGGGGGGTTCACAATGAGCAGTTCTTC	CASRARTRGVHNEQFF	TRBV5-1	TRBJ2-1
TGCGCCACCGACAGGGTCTGGGTTGAAGCTTTCTTT	CATDRVWVEAFF	TRBV4-1	TRBJ1-1
TGTGCCAGCCCCCGGGGGCAAGGGGCCAACGTCCTGACTTTC	CASPRGQGANVLTF	TRBV6-1	TRBJ2-6
TGTGCCAGCAGCCCCCAGAGTGAAGAGACCCAGTACTTC	CASSPQSEETQYF	TRBV4-2	TRBJ2-5
TGCGCCAGCAGCCGTATGGGGGTTTATCATCAGCCCCAGCATTTT	CASSRMGVYHQPQHF	TRBV4-1	TRBJ1-5
TGTGCCAGCTGCCGGGTGCCAATGTCGTATAGCAATCAGCCCCAGCATTTT	CASCRVPMSYSNQPQHF	TRBV5-8	TRBJ1-5
TGTGCCAGCAGCGAGGGAAATCGATCCGCCAAAAACATTCAGTACTTC	CASSEGNRSAKNIQYF	TRBV6-5	TRBJ2-4
TGTGCCAGCAGTACCTATAGATGCAGGGGGAATGAAAAACTGTTTTTT	CASSTYRCRGNEKLFF	TRBV28	TRBJ1-4
TGTGCCAGGCACAGGGGTTGGCACACTGAAGCTTTCTTT	CARHRGWHTEAFF	TRBV13	TRBJ1-1
TGTGCCAGCAGCTTGCAGGGATTGGAGGAGACCCAGTACTTC	CASSLQGLEETQYF	TRBV5-6	TRBJ2-5
TGTGCCAGCAGCCCACAGGGGGGGTACGAGCAGTACTTC	CASSPQGGYEQYF	TRBV7-9	TRBJ2-7
TGCAGTGCTAGAGCTAGCATAACCGGGGAGCTGTTTTTT	CSARASITGELFF	TRBV20-1	TRBJ2-2
TGTGCCAGCAGCTTGGAGTATGGGACAGGGGGGAGCTACGAGCAGTACTTC	CASSLEYGTGGSYEQYF	TRBV5-4	TRBJ2-7
TGTGCCAGCAGCGGGCAGCGCAGCAATCAGCCCCAGCATTTT	CASSGQRSNQPQHF	TRBV7-3	TRBJ1-5
TGTGCCAGCAGTTACTCTCGAGAGGGACAGATGAGCAATCAGCCCCAGCATTTT	CASSYSREGQMSNQPQHF	TRBV6-5	TRBJ1-5
TGTGCCGACCCAGCGGGAGGGCGTAGGGTCGGGGAGCTGTTTTTT	CADPAGGRRVGELFF	TRBV2	TRBJ2-2
TGTGCCAGCAGCCCACCCGGGGTAAGCTACGAGCAGTACTTC	CASSPPGVSYEQYF	TRBV7-9	TRBJ2-7
TGTGCCAGCAGCTCCCTCAAGGTTGACTCCTACGAGCAGTACTTC	CASSSLKVDSYEQYF	TRBV7-9	TRBJ2-7
TGTGCCAGCACTCGGAGAGTTGATACGCAGTATTTT	CASTRRVDTQYF	TRBV14	TRBJ2-3
TGCGCCAGCAGCCACACGTGGCGTAACGAGCAGTACTTC	CASSHTWRNEQYF	TRBV4-1	TRBJ2-7
TGCAGTGCTAGAGTTCAGGCGCGACAGGGGAGCCTGGCGACAGATACGCAGTATTTT	CSARVQARQGSLATDTQYF	TRBV20-1	TRBJ2-3
TGTGCCAGCAGCTTGGGACTAGCGGGGGGGCCGAACACCGGGGAGCTGTTTTTT	CASSLGLAGGPNTGELFF	TRBV7-6	TRBJ2-2
TGTGCCACCAGTGATTCATTCCATCTGGGGCCGAGCTACGAGCAGTACTTC	CATSDSFHLGPSYEQYF	TRBV24-1	TRBJ2-7
TGTGCCAGCAGTGAGAAGAGGGGGAGGTACACAGATACGCAGTATTTT	CASSEKRGRYTDTQYF	TRBV25-1	TRBJ2-3
TGCAGTGCAAACAGCAATGAGCAGTTCTTC	CSANSNEQFF	TRBV20-1	TRBJ2-1
TGTGCCAGCAGTCTGGATAACCCGGGACAGGGACCGATTAACGAGCAGTACTTC	CASSLDNPGQGPINEQYF	TRBV6-3	TRBJ2-7
TGTGCCAGCGGACAGGGTAACACAGATACGCAGTATTTT	CASGQGNTDTQYF	TRBV6-8	TRBJ2-3
TGTGCCAGCACTTCTCCAATCCTAACTAATGAAAAACTGTTTTTT	CASTSPILTNEKLFF	TRBV11-3	TRBJ1-4
TGTGCCAGCAGTTTGGTCGTGGGGAACGGTTCCTATGGCTACACCTTC	CASSLVVGNGSYGYTF	TRBV6-5	TRBJ1-2
TGTGCCAGCAGTTTTATGGCGGGAGGCTTAGATACGCAGTATTTT	CASSFMAGGLDTQYF	TRBV12-4	TRBJ2-3
TGTGCCAGTAGTTTTAGAGGGTTCAGGTTGGCTAACTATGGCTACACCTTC	CASSFRGFRLANYGYTF	TRBV19	TRBJ1-2
TGCGCCAGGGCGGGGGCAGCCTCTGGGGCCAACGTCCTGACTTTC	CARAGAASGANVLTF	TRBV5-1	TRBJ2-6
TGCGCCAGCAGCAAGGACAGGAGATATCAGCCCCAGCATTTT	CASSKDRRYQPQHF	TRBV5-1	TRBJ1-5
TGCGCCAGCAGTGAAGGACAGGGGCAGGCTTACGAGCAGTACTTC	CASSEGQGQAYEQYF	TRBV10-1	TRBJ2-7
TGTGCCAGCAGCGAGAGGCATCTTATACGAGCCCAGCTGTACTTC	CASSERHLIRAQLYF	TRBV13	TRBJ2-5
TGTGCCAGTAAACATCTTAGGGCGACCCAGTACTTC	CASKHLRATQYF	TRBV2	TRBJ2-5
TGTGCCAGCAGCGTAGCCATGACTAGCGGGCTCACAGATACGCAGTATTTT	CASSVAMTSGLTDTQYF	TRBV9	TRBJ2-3
TGTGCCAGCAGTAATCAGCCTGGACAGGAGCATGACTATGGCTACACCTTC	CASSNQPGQEHDYGYTF	TRBV12-4	TRBJ1-2
TGCGCCAGGTACTTGGACTCCGGGACAGGGACTTACACAGATACGCAGTATTTT	CARYLDSGTGTYTDTQYF	TRBV10-1	TRBJ2-3
TGTGCCAGCAGGGCGGGACATTGCTACGAGCAGTACTTC	CASRAGHCYEQYF	TRBV6-5	TRBJ2-7
TGTGCCACCAGTGATTTGCAATACCAGGGGTGTTTCGCGGGAAACTATGGCTACACCTTC	CATSDLQYQGCFAGNYGYTF	TRBV24-1	TRBJ1-2
TGCAGCGTTGAAGCCGCACTTCGGATGGCGGCCTCTGGGGCCAACGTCCTGACTTTC	CSVEAALRMAASGANVLTF	TRBV29-1	TRBJ2-6
TGTGCCAGCAGTGACAGGCCGGACGTTCGGTTCTATGGCTACACCTTC	CASSDRPDVRFYGYTF	TRBV6-4	TRBJ1-2
TGTGCCACCAGTGATTTGGAAGGACATTTCTCTGGAAACACCATATATTTT	CATSDLEGHFSGNTIYF	TRBV24-1	TRBJ1-3
TGCAGCGAAATCCATACACGGAGGCCTGGAAACACCATATATTTT	CSEIHTRRPGNTIYF	TRBV29-1	TRBJ1-3
TGTGCCAGCAGCCAGGGCCGGGACGGGGGTCAGCCCCAGCATTTT	CASSQGRDGGQPQHF	TRBV5-5	TRBJ1-5
TGTGCCAGCAGTCAGGGTTCAACCCTAGCGGGCCCCGACAATGAGCAGTTCTTC	CASSQGSTLAGPDNEQFF	TRBV6-3	TRBJ2-1
TGCGCCAGCAGCTTGGGGACCCGGGGAATACACACAGATACGCAGTATTTT	CASSLGTRGIHTDTQYF	TRBV5-1	TRBJ2-3
TGTGCCAGCAGTGGAGAGGGTGCGAAGACCTATGAGCAGTTCTTC	CASSGEGAKTYEQFF	TRBV27	TRBJ2-1
TGTGCCAGCAGTTCACCCCCCCCCAAAGCCGGGAAGGCCCAGTACTTC	CASSSPPPKAGKAQYF	TRBV27	TRBJ2-5
TGCGCCAGCAGAGTTGGGGCGATTCATGAGCAGTTCTTC	CASRVGAIHEQFF	TRBV10-1	TRBJ2-1
TGCGCCAGCAGTACTGGCAAAGCGAACATTCAGTACTTC	CASSTGKANIQYF	TRBV10-1	TRBJ2-4
TGTGCCAGCAGATGGGGTTGGTCCCATGAGCAGTTCTTC	CASRWGWSHEQFF	TRBV6-5	TRBJ2-1
TGTGCCAGCAGCTCGGGGTGGACTGGGAATGAGCAGTTCTTC	CASSSGWTGNEQFF	TRBV5-6	TRBJ2-1
TGTGCCAGCAGTCCGGACAGTTACTCTGGAAACACCATATATTTT	CASSPDSYSGNTIYF	TRBV6-2	TRBJ1-3
TGTGCCAGCAGCTTATTAGGGGGGGAACCAGATACGCAGTATTTT	CASSLLGGEPDTQYF	TRBV7-7	TRBJ2-3
TGTGCCAGCAGCTTAGGACAGGGGAATGAGCAGTTCTTC	CASSLGQGNEQFF	TRBV7-4	TRBJ2-1
TGTGCCAGCAGTTTACGTCGGGACAGGAAAGGGAACGAGCAGTACTTC	CASSLRRDRKGNEQYF	TRBV28	TRBJ2-7
TGTGCCAGCAGCTTAGATGACAGGGGGGCGTATAATTCACCCCTCCACTTT	CASSLDDRGAYNSPLHF	TRBV7-8	TRBJ1-6
TGTGCCAGCAGCTTGCCGTCGGAAAGGACAGGGGAGTGGGAGTATAGCAATCAGCCCCAGCATTTT	CASSLPSERTGEWEYSNQPQHF	TRBV5-5	TRBJ1-5
TGTGCCAGCAGCTGTAGGGAGACCCAGTACTTC	CASSCRETQYF	TRBV5-6	TRBJ2-5
TGTGCCAGCCGCTATAATTGCCCCATGAACACCGGGGAGCTGTTTTTT	CASRYNCPMNTGELFF	TRBV28	TRBJ2-2
TGTGCCAGCAGCCAAGACCTGGACAGGGCCGTTTCCTACAATGAGCAGTTCTTC	CASSQDLDRAVSYNEQFF	TRBV3-1	TRBJ2-1
TGTGCCAGCGCCTTATCCGGGAGACCCACTGAAGCTTTCTTT	CASALSGRPTEAFF	TRBV7-3	TRBJ1-1
TGTGCCAGCAGCTTTGTGGGGGGCAAGTACCAAGAGACCCAGTACTTC	CASSFVGGKYQETQYF	TRBV7-8	TRBJ2-5
TGCGCCAGCAGCCTTCCAGTCAGGGCTCAGCCCCAGCATTTT	CASSLPVRAQPQHF	TRBV4-1	TRBJ1-5
TGTGCCAGCCGGAACAGGGGCTTTTTATCGAACACCGGGGAGCTGTTTTTT	CASRNRGFLSNTGELFF	TRBV25-1	TRBJ2-2
TGTGCCAGCAGCTTCGGGACAGGGGGGGGGCGCACAGATACGCAGTATTTT	CASSFGTGGGRTDTQYF	TRBV2	TRBJ2-3
TGTGCCAGCAGCTTCTCAAGACCGACTGAAGCTTTCTTT	CASSFSRPTEAFF	TRBV5-6	TRBJ1-1
TGTGCCATAGGGCACGACGGTCTAGCTAATGGCTACACCTTC	CAIGHDGLANGYTF	TRBV12-3	TRBJ1-2
TGTGCCAGCAGCTTGCCCCAGAGAAGGTACGAGCAGTACTTC	CASSLPQRRYEQYF	TRBV5-5	TRBJ2-7
TGTGCCAGCAGCAAAGACAGTCTCCCGACGACTCCCCAGCATTTT	CASSKDSLPTTPQHF	TRBV6-8	TRBJ1-5
TGTGCCAGCAGTCAAGGGACTCCCTCTTATAGCAATCAGCCCCAGCATTTT	CASSQGTPSYSNQPQHF	TRBV12-3	TRBJ1-5
TGTGCCAGCAGTGAATCGTCTCCCTTTGGGGGGGGGGGCTACACCTTC	CASSESSPFGGGGYTF	TRBV25-1	TRBJ1-2
TGTGCCAGCAGCTTAGACCCTCGGACTTCTCTAAATGAAAAACTGTTTTTT	CASSLDPRTSLNEKLFF	TRBV7-2	TRBJ1-4
TGTGCCAGTAGTATCCAAAACTACCGAGGGGATTCACCCCTCCACTTT	CASSIQNYRGDSPLHF	TRBV19	TRBJ1-6
TGTGCTAGTGGTTTGAGTCGATCCCCTTCTCAGTTTGTTCACGCTGGGGCCAACGTCCTGACTTTC	CASGLSRSPSQFVHAGANVLTF	TRBV12-5	TRBJ2-6
TGTGCCAGCAGCTTAACGCTAGAGTGGGCCTATGGCTACACCTTC	CASSLTLEWAYGYTF	TRBV7-3	TRBJ1-2
TGCAGCGTTGCCCGTTCCCGACCGGGACCTAGCACAGATACGCAGTATTTT	CSVARSRPGPSTDTQYF	TRBV29-1	TRBJ2-3
TGTGCCAGTGCCGGGACAGGCGAAACCTACAATGAGCAGTTCTTC	CASAGTGETYNEQFF	TRBV10-3	TRBJ2-1
TGCAGCGTTGGAGATGGTAGCTCCTACGAGCAGTACTTC	CSVGDGSSYEQYF	TRBV29-1	TRBJ2-7
TGTGCCAGTAGCCGGGGCAGGGAAGATACGCAGTATTTT	CASSRGREDTQYF	TRBV19	TRBJ2-3
TGTGCCAGCAGCCGCACTCCGGATAGCAATCAGCCCCAGCATTTT	CASSRTPDSNQPQHF	TRBV3-1	TRBJ1-5
TGTGCCAGCAGCCACCTCCCCTGGTGGATCACAGATACGCAGTATTTT	CASSHLPWWITDTQYF	TRBV14	TRBJ2-3
TGTGCCAGCAGCTTGAGCGGGGACAGGGGGGGGACCGGGGAGCTGTTTTTT	CASSLSGDRGGTGELFF	TRBV5-4	TRBJ2-2
TGTGCCAGCACACAGGAGGGTGGCTACACCTTC	CASTQEGGYTF	TRBV7-2	TRBJ1-2
TGTGCCAGCATAACTAGCGGGAGATTCACCTACGAGCAGTACTTC	CASITSGRFTYEQYF	TRBV27	TRBJ2-7
TGTGCCACCCCAGGGCAACAGCCCCAGCATTTT	CATPGQQPQHF	TRBV24-1	TRBJ1-5
TGTGCCAGCAGTTTAACGTTAGCGGCGACAGATACGCAGTATTTT	CASSLTLAATDTQYF	TRBV27	TRBJ2-3
TGTGCCAGCAGCCAACCCCGGGAGGGGGGGCCGAACACTGAAGCTTTCTTT	CASSQPREGGPNTEAFF	TRBV14	TRBJ1-1
TGTGCCAGCAGCCTCCTGGACAGGGGGGGGCATTTT	CASSLLDRGGHF	TRBV13	TRBJ1-5
TGTGCCAGCAGCGACGGTGAAGCTTTCTTT	CASSDGEAFF	TRBV7-3	TRBJ1-1
TGCGCCAGCAAGTTAAGGCGGGACAGGTACTATGGCTACACCTTC	CASKLRRDRYYGYTF	TRBV10-1	TRBJ1-2
TGTGCCACCAGTGATCCCCATTTTTACTATGGCTACACCTTC	CATSDPHFYYGYTF	TRBV24-1	TRBJ1-2
TGTGCCAGCAGTTCCCATGACCCAGGGACTAGCGGGCAGGGATGCAATGAGCAGTTCTTC	CASSSHDPGTSGQGCNEQFF	TRBV6-8	TRBJ2-1
TGTGCCAGCGGACAGGGCTCTGGGGCCAACGTCCTGACTTTC	CASGQGSGANVLTF	TRBV6-4	TRBJ2-6
TGTGCCAGCAGCTTGCGTAAAGCGGGAGGGTTAGATACGCAGTATTTT	CASSLRKAGGLDTQYF	TRBV5-6	TRBJ2-3
TGTGCTAGCAGCCCCTGGACTAGCGGGCTCTATTCCTACGAGCAGTACTTC	CASSPWTSGLYSYEQYF	TRBV7-7	TRBJ2-7
TGTGCCAGCAGAGGGGGGCCCCTGCTAGCCAAAAACATTCAGTACTTC	CASRGGPLLAKNIQYF	TRBV25-1	TRBJ2-4
TGCAGTGCTAGAGATCCTGAAAGCGAGCAGTACTTC	CSARDPESEQYF	TRBV20-1	TRBJ2-7
TGTGCCAGCAGTTCGGGGGCAGGAAACATTCAGTACTTC	CASSSGAGNIQYF	TRBV28	TRBJ2-4
TGTGCCAGCAGCGGGGGTAGACAGGGGGCCCGGGACTACGAGCAGTACTTC	CASSGGRQGARDYEQYF	TRBV11-3	TRBJ2-7
TGTGCCAGCAGTCCCAACAGGGGGGGTGCCGGGGAGCTGTTTTTT	CASSPNRGGAGELFF	TRBV6-4	TRBJ2-2
TGTGCCAGCAGCATGACCCTAACGACAGTAGCCTATGGCTACACCTTC	CASSMTLTTVAYGYTF	TRBV13	TRBJ1-2
TGTGCCTGGAGCGCCGGGCACGGTGAAGCTTTCTTT	CAWSAGHGEAFF	TRBV30	TRBJ1-1
TGCAGTGCTAGACGGCACGATGAAAAACTGTTTTTT	CSARRHDEKLFF	TRBV20-1	TRBJ1-4
TGTGCCAGCAGTTACTCGAAGGTTCCAGGGGACCGGAAGGCCTATGGCTACACCTTC	CASSYSKVPGDRKAYGYTF	TRBV6-5	TRBJ1-2
TGCGCCAGCAGCTTGGAAACGTCTCCCAGGGGAAATCAGCCCCAGCATTTT	CASSLETSPRGNQPQHF	TRBV5-1	TRBJ1-5
TGTGCCAGCAGACAGGAGAACTATACTGAAGCTTTCTTT	CASRQENYTEAFF	TRBV2	TRBJ1-1
TGTGCCAGCAGACAGGGGGTGGGAAACACCATATATTTT	CASRQGVGNTIYF	TRBV12-3	TRBJ1-3
TGTGCCAGCTGGGGACAGGGGGCGAGGAACTATGGCTACACCTTC	CASWGQGARNYGYTF	TRBV2	TRBJ1-2
TGCGCCAGCAGCCAAGACCAGACTAGCGGGTTCCCCTACGAGCAGTACTTC	CASSQDQTSGFPYEQYF	TRBV4-1	TRBJ2-7
TGTGCCAGCAGTTTCCTGACTAGTGCCGATACGCAGTATTTT	CASSFLTSADTQYF	TRBV28	TRBJ2-3
TGTGCCAGCAGTTCCGCCGACAGGCCGACCCTTTTAGGCTCCTACAATGAGCAGTTCTTC	CASSSADRPTLLGSYNEQFF	TRBV27	TRBJ2-1
TGTGCCAGCAGCGCCGGGACTAGCGGGAGACGATGGGACGAGCAGTACTTC	CASSAGTSGRRWDEQYF	TRBV9	TRBJ2-7
TGCAGTGCTAGTTGCGGGTCTTACTATGGCTACACCTTC	CSASCGSYYGYTF	TRBV20-1	TRBJ1-2
TGTGCCAGCCTGGACAGGGCTGGCCAATTGAACACTGAAGCTTTCTTT	CASLDRAGQLNTEAFF	TRBV6-1	TRBJ1-1
TGTGCCAGCAGTTACAGGGGGGACCAGCCCCAGCATTTT	CASSYRGDQPQHF	TRBV12-4	TRBJ1-5
TGTGCCAGCAGCCGATTGAAACTTCCTAGGGGGGCGTCCTCGCAGGGCAATCAGCCCCAGCATTTT	CASSRLKLPRGASSQGNQPQHF	TRBV9	TRBJ1-5
TGCGCCACCCCTGGGGGAGACACCGGGGAGCTGTTTTTT	CATPGGDTGELFF	TRBV5-1	TRBJ2-2
TGTGCCAGCAGCGTAGCACGAGGGGCCACCCTGGCGGAGACCCAGTACTTC	CASSVARGATLAETQYF	TRBV9	TRBJ2-5
TGCGCCAGCAGTGTAGGGACAGGGCAGCCCCAGCATTTT	CASSVGTGQPQHF	TRBV10-1	TRBJ1-5
TGTGCCAGCAGTACAAGGACTGACAGGGGGGAGTTTTGGGGCACAGATACGCAGTATTTT	CASSTRTDRGEFWGTDTQYF	TRBV7-6	TRBJ2-3
TGTGCCATCAGGGTGTCTGTTAGATTATATGGCTACACCTTC	CAIRVSVRLYGYTF	TRBV10-3	TRBJ1-2
TGCAGTGCTAGGAATCCCCCACGGGGAATGAACACTGAAGCTTTCTTT	CSARNPPRGMNTEAFF	TRBV20-1	TRBJ1-1
TGTGCCAGCAGCAATCCCGCCACCCCCAGGGAGTATGGCTACACCTTC	CASSNPATPREYGYTF	TRBV11-2	TRBJ1-2
TGCGCCAGCAACCGAAAGGGTTACCAAGAGACCCAGTACTTC	CASNRKGYQETQYF	TRBV10-1	TRBJ2-5
TGTGCCACCAGTAGGGCCGGACCACCTGCAACTAATGAAAAACTGTTTTTT	CATSRAGPPATNEKLFF	TRBV24-1	TRBJ1-4
TGTGCCAGCTCACCACCAGGGGGGGGGGGCTACGAGCAGTACTTC	CASSPPGGGGYEQYF	TRBV18	TRBJ2-7
TGTGCCAGCCGGCGGACAATTGCCTACGAGCAGTACTTC	CASRRTIAYEQYF	TRBV5-8	TRBJ2-7
TGTGCCAGCAGCCAGCCGTGGATTACAAAAACAGGGGGCGGGACCGGCGCCTACGAGCAGTACTTC	CASSQPWITKTGGGTGAYEQYF	TRBV7-3	TRBJ2-7
TGTGCCAGCAGCGGACTCCCAGGGAACGAGCAGTACTTC	CASSGLPGNEQYF	TRBV7-9	TRBJ2-7
TGTGCCAGCAGCTTAGGACCTGCTAGATACTTGGCGGCTAGCACAGATACGCAGTATTTT	CASSLGPARYLAASTDTQYF	TRBV7-6	TRBJ2-3
TGCAGTGCTAGAGAGTTCGCCAACATTGCCACCGGCTACACCTTC	CSAREFANIATGYTF	TRBV20-1	TRBJ1-2
TGTGCCAGCAAAAGACAGGGAGAAAAACCAAGCTATGGCTACACCTTC	CASKRQGEKPSYGYTF	TRBV7-9	TRBJ1-2
TGTGCCAGCAGCTCCATGGACAGGAGCGAGCAGTACTTC	CASSSMDRSEQYF	TRBV11-2	TRBJ2-7
TGTGCCAGCAGTTATGAAGGGCCCTGTGAGAGCCTTCAGCCCCAGCATTTT	CASSYEGPCESLQPQHF	TRBV6-5	TRBJ1-5
TGTGCCAGCAGCCCTGCACCTCGGTCCTTGAGTTTCTCTGGAAACACCATATATTTT	CASSPAPRSLSFSGNTIYF	TRBV14	TRBJ1-3
TGTGCCTGGACCCAAAAGGGACAGAGCACTGAAGCTTTCTTT	CAWTQKGQSTEAFF	TRBV30	TRBJ1-1
TGTGCCAGCAGCGTAGTACCGGGACTGGGGGGTTTGGAAAACAATGAGCAGTTCTTC	CASSVVPGLGGLENNEQFF	TRBV9	TRBJ2-1
TGCGCCAGCAGCTCAAGGGGGCACGAGCAGTACTTC	CASSSRGHEQYF	TRBV5-1	TRBJ2-7
TGTGCCAGCAGACTCCGGACAGGGGACGAGACCCAGTACTTC	CASRLRTGDETQYF	TRBV11-2	TRBJ2-5
TGTGCCAGCAGCTTCGCCGGGAACGGGGGAAACATTCAGTACTTC	CASSFAGNGGNIQYF	TRBV7-9	TRBJ2-4
TGTGCCAGCCAAGGCCGGGACAGGGGACTCTTGGGCTACGAGCAGTACTTC	CASQGRDRGLLGYEQYF	TRBV6-6	TRBJ2-7
TGTGCCACCAGCAGAGTTCGGAAGGAGGTGTTGGTTGGCTTCACCGGGGAGCTGTTTTTT	CATSRVRKEVLVGFTGELFF	TRBV15	TRBJ2-2
TGTGCCAGCAGTGAGGGGTTCCAACGACGGGGGGAGCCCCAGCATTTT	CASSEGFQRRGEPQHF	TRBV6-1	TRBJ1-5
TGTGCCAGCAGCTTAGATCGGTACAAACGGACCTGGGGGAACACTGAAGCTTTCTTT	CASSLDRYKRTWGNTEAFF	TRBV11-2	TRBJ1-1
TGTGCCAGCAGCTCCAGACCGCAGTATTTT	CASSSRPQYF	TRBV11-1	TRBJ2-3
TGTGCCACCAGCAGAATGGGACAGCACACCGGGGAGCTGTTTTTT	CATSRMGQHTGELFF	TRBV15	TRBJ2-2
TGTGCCAGCAGGTCACGGAGATACAATGAGCAGTTCTTC	CASRSRRYNEQFF	TRBV11-3	TRBJ2-1
TGTGCCAGCAGCCTCAGGGTCGGAAACACCATATATTTT	CASSLRVGNTIYF	TRBV3-1	TRBJ1-3
TGCGCCAGCAGCCCTTCGTTGGGGTTGAAGGTAGCAACTAATGAAAAACTGTTTTTT	CASSPSLGLKVATNEKLFF	TRBV4-1	TRBJ1-4
TGCAGTGCTAGAGAGACTTGGGACAGGTACGAGCAGTACTTC	CSARETWDRYEQYF	TRBV20-1	TRBJ2-7
TGCGCCAGCAGCCAAGACCCTAAAGGTTACAATGAGCAGTTCTTC	CASSQDPKGYNEQFF	TRBV4-1	TRBJ2-1
TGTGCCAGCAGTTGTAATAGCGGGAAGACGGGCTCCTACGAGCAGTACTTC	CASSCNSGKTGSYEQYF	TRBV6-9	TRBJ2-7
TGTGCCAGCAGAGCGACGAAAGGGGGGCAAGAGACCCAGTACTTC	CASRATKGGQETQYF	TRBV6-5	TRBJ2-5
TGTGCCAGCAGCACGTCCCGGGACAGGCCTGAAGCTTTCTTT	CASSTSRDRPEAFF	TRBV13	TRBJ1-1
TGTGCCAGCAGCTTAGCCCGGGGCTCGGAAGCTAACTATGGCTACACCTTC	CASSLARGSEANYGYTF	TRBV11-1	TRBJ1-2
TGTGCCAGCAGCTTAAGGGACAGTCAGCCCCAGCATTTT	CASSLRDSQPQHF	TRBV7-9	TRBJ1-5
TGTGCCATCAGTGAGGCCCCAGATTCTAACTATGGCTACACCTTC	CAISEAPDSNYGYTF	TRBV10-3	TRBJ1-2
TGTGCCTGGATTATCAGGGGGCGCTACGAGCAGTACTTC	CAWIIRGRYEQYF	TRBV30	TRBJ2-7
TGTGCCAGCAGCCTAGTCGGACTGGAGACCCAGTACTTC	CASSLVGLETQYF	TRBV3-1	TRBJ2-5
TGTGCCAGCAGTCCAAGGGCCAGCGTCATCGGGGAGCTGTTTTTT	CASSPRASVIGELFF	TRBV6-4	TRBJ2-2
TGTGCCAGCAGTGAATACAAGGAAGGGACACGAAAGCCCCAGCATTTT	CASSEYKEGTRKPQHF	TRBV25-1	TRBJ1-5
TGTGAATCGGGACGCCCGCAGTTCTTC	CESGRPQFF	TRBV24-1	TRBJ2-1
TGTGCCAGTAGTATGCTCGGAGCTGAGCAGTACTTC	CASSMLGAEQYF	TRBV19	TRBJ2-7
TGCGCCAGCAGCCACAAGGGGTCAACGGGAGGGAGCGGGGGTCAGCCCCAGCATTTT	CASSHKGSTGGSGGQPQHF	TRBV4-1	TRBJ1-5
TGTGCCAGCAGCGAAATTAGGCGGGGCTATGGCTACACCTTC	CASSEIRRGYGYTF	TRBV5-5	TRBJ1-2
TGCGCCAGCAGCGAGATAACGGCCGGGACAGGGAGCTATAATTCACCCCTCCACTTT	CASSEITAGTGSYNSPLHF	TRBV5-1	TRBJ1-6
TGTGCCAGCAGTTGGTTGGGGACTAAGGGGGTGGAGTACTTC	CASSWLGTKGVEYF	TRBV6-5	TRBJ2-5
TGTGCCAGCAGCCAAATCCACATCACCTATGGCTACACCTTC	CASSQIHITYGYTF	TRBV14	TRBJ1-2
TGTGCCACCAGTGATTTCCTAGAGACAGGGCCGTGGTACCAAGAGACCCAGTACTTC	CATSDFLETGPWYQETQYF	TRBV24-1	TRBJ2-5
TGCAGTGCTAGTGAAAGTACGAGGCCGGATACGCAGTATTTT	CSASESTRPDTQYF	TRBV20-1	TRBJ2-3
TGCAGCGTCCCCGGACAGCATGGAGCCTACGAGCAGTACTTC	CSVPGQHGAYEQYF	TRBV29-1	TRBJ2-7
TGTGCCAGTAGTATGACTAGGGTCGCCCAAGAGACCCAGTACTTC	CASSMTRVAQETQYF	TRBV19	TRBJ2-5
TGTGCCAGCAGCTCTGGACTAGCGGGGGGGCCATCATTTAAAAACATTCAGTACTTC	CASSSGLAGGPSFKNIQYF	TRBV6-5	TRBJ2-4
TGTGCCAGCAGCTTAGGAACTCGGGACAGTCCCACCCATCAGCCCCAGCATTTT	CASSLGTRDSPTHQPQHF	TRBV11-3	TRBJ1-5
TGCGCCAGCAGCTGCCGGACGGCTCGCCCCGGGACTAGCGGATTCACGGGGACCCAGTACTTC	CASSCRTARPGTSGFTGTQYF	TRBV5-1	TRBJ2-5
TGCGCCAGCAGCTTGGGTCTAGCCTCCGGGGGGAAAGGCGTCCTGACTTTC	CASSLGLASGGKGVLTF	TRBV5-1	TRBJ2-6
TGCACCCTTCGGACAGGGCCCGGGGCACCTGATCAGCCCCAGCATTTT	CTLRTGPGAPDQPQHF	TRBV20-1	TRBJ1-5
TGCAGTGCTCCGTCTAAGAAACTAGCGGGAGGGGGTACGCAGTATTTT	CSAPSKKLAGGGTQYF	TRBV20-1	TRBJ2-3
TGTGCCAGCAGCTTAGGGCGGGGGGGGTACTACGAGCAGTACTTC	CASSLGRGGYYEQYF	TRBV7-4	TRBJ2-7
TGTGCCACCAGTGATGACGACAGGGATCAGCCCCAGCATTTT	CATSDDDRDQPQHF	TRBV24-1	TRBJ1-5
TGTGCCACCAACCCCACGACAGTGCGGAGTTTCTTT	CATNPTTVRSFF	TRBV24-1	TRBJ1-1
TGCGCCAGCAGCCAAGGACCCCGGGGCTGGAAAAATGAGCAGTTCTTC	CASSQGPRGWKNEQFF	TRBV4-1	TRBJ2-1
TGTGCCAGCAGTTACCCCTGGGACAGGGTGGACGGCCAGAGCAATCAGCCCCAGCATTTT	CASSYPWDRVDGQSNQPQHF	TRBV6-6	TRBJ1-5
TGCAGTGCTAGCCACAGGTTGGAGCAGTACTTC	CSASHRLEQYF	TRBV20-1	TRBJ2-7
TGTGCCAGCAGCAGCCCGATCCGGGACAGGGGGACGACTGAAGCTTTCTTT	CASSSPIRDRGTTEAFF	TRBV7-3	TRBJ1-1
TGCGCCAGGTTATCCAGGGGGCTATTTGGAAACACCATATATTTT	CARLSRGLFGNTIYF	TRBV10-1	TRBJ1-3
TGTGCCAGCAGTCCCAAACAGCCCCAAGAGACCCAGTACTTC	CASSPKQPQETQYF	TRBV6-3	TRBJ2-5
TGTGCCACCAAAATCGGGACTAGCGTAAGGGGGCAGTACTTC	CATKIGTSVRGQYF	TRBV24-1	TRBJ2-7
TGTGCCAGCAGTTACTCTAGCGGCACCTACGAGCAGTACTTC	CASSYSSGTYEQYF	TRBV6-6	TRBJ2-7
TGTGCCAGCATGGGTGCCGATTGTCACACTGAAGCTTTCTTT	CASMGADCHTEAFF	TRBV5-6	TRBJ1-1
TGTGCCAGCAGGGACCCAGGACCGGGACGGATAGCTTTCTTT	CASRDPGPGRIAFF	TRBV6-5	TRBJ1-1
TGCAGTGCTAACCGGGTCAGGGTGGTCTACGAGCAGTACTTC	CSANRVRVVYEQYF	TRBV20-1	TRBJ2-7
TGTGCCAGCACCCACACTAGCGGGGCTTACTACAATGAGCAGTTCTTC	CASTHTSGAYYNEQFF	TRBV28	TRBJ2-1
TGTGCCGACAGGGTTGCTGCCGGCTACACCTTC	CADRVAAGYTF	TRBV2	TRBJ1-2
TGTGCCAGCACCCATATGGGGAGGGGGCCTAACTATGGCTACACCTTC	CASTHMGRGPNYGYTF	TRBV9	TRBJ1-2
TGCGCCAGCAGTGGACAGGTTAAACAGCCCCAGCATTTT	CASSGQVKQPQHF	TRBV10-1	TRBJ1-5
TGCAGTGTCAGGGATAGCAATCAGCCCCAGCATTTT	CSVRDSNQPQHF	TRBV20-1	TRBJ1-5
TGCAGTGCTAGAGATTACTGGAGGGGGGATAGCAATCAGCCCCAGCATTTT	CSARDYWRGDSNQPQHF	TRBV20-1	TRBJ1-5
TGCAGTGCTGGCGTACCAGGGACTTATATGAACACTGAAGCTTTCTTT	CSAGVPGTYMNTEAFF	TRBV20-1	TRBJ1-1
TGTGCCAGCAGCGTTTCGAAGGGACAGAAGGGGGCACTGAACACTGAAGCTTTCTTT	CASSVSKGQKGALNTEAFF	TRBV9	TRBJ1-1
TGCAGTGCTAGAGATCATCGACAAATGGGACTAGTTGGCACTGAAGCTTTCTTT	CSARDHRQMGLVGTEAFF	TRBV20-1	TRBJ1-1
TGTGCCAGCAGCTTAGCTGACGCAGGGGACTCCTATAATTCACCCCTCCACTTT	CASSLADAGDSYNSPLHF	TRBV7-3	TRBJ1-6
TGTGCCACCAGTGATTTGCGGACAGGGCAAATGAACACTGAAGCTTTCTTT	CATSDLRTGQMNTEAFF	TRBV24-1	TRBJ1-1
TGTGCCAGCACATCTTCTCGGCTTGCCTACGAGCAGTACTTC	CASTSSRLAYEQYF	TRBV6-5	TRBJ2-7
TGTGCCAGCAGCCCGGCGAACACCGGGGAGCTGTTTTTT	CASSPANTGELFF	TRBV13	TRBJ2-2
TGTGCCAGCAGCTGCGTGGGGGGGCGCATGCAGTTCTTC	CASSCVGGRMQFF	TRBV3-1	TRBJ2-1
TGTGCCAGCAGCTTAGTTTCCATGACAGGGGTTCCTACTAACTATGGCTACACCTTC	CASSLVSMTGVPTNYGYTF	TRBV7-4	TRBJ1-2
TGCGCCAGGGCGGGAATCGGCCGCTACACCTTC	CARAGIGRYTF	TRBV10-2	TRBJ1-2
TGTGCCTGGAAGAGGGGGTTTGTTAATTCACCCCTCCACTTT	CAWKRGFVNSPLHF	TRBV30	TRBJ1-6
TGCGCCAGCAGTGAGTGGGAATACAGGGGCAAAAACATTCAGTACTTC	CASSEWEYRGKNIQYF	TRBV10-1	TRBJ2-4
TGTGCCAGACACACAGGGGGAGGGGATCAGCCCCAGCATTTT	CARHTGGGDQPQHF	TRBV6-1	TRBJ1-5
TGTGCCAGCAGCCTCGGCTATAGCAATCAGCCCCAGCATTTT	CASSLGYSNQPQHF	TRBV7-3	TRBJ1-5
TGCGCCAGCAGCGGCTGGGGGCTAGAGTACCAAGAGACCCAGTACTTC	CASSGWGLEYQETQYF	TRBV5-1	TRBJ2-5
TGTGCCAGCAGTGGAACTAGAGCCGAGAACACCGGGGAGCTGTTTTTT	CASSGTRAENTGELFF	TRBV2	TRBJ2-2
TGCAGTGCTTCAGGGGAGGCTGGCTACACCTTC	CSASGEAGYTF	TRBV20-1	TRBJ1-2
TGTGCCAGCAGCTTCCCACCTTCAGCCGACTACGAGCAGTACTTC	CASSFPPSADYEQYF	TRBV5-6	TRBJ2-7
TGCAGTGCTAGCCCTCACCCAGACAGGGCGAATTCTAGCACAGATACGCAGTATTTT	CSASPHPDRANSSTDTQYF	TRBV20-1	TRBJ2-3
TGTGCCAGCCGGGGCCGGTGGCCCGGGGAGCTGTTTTTT	CASRGRWPGELFF	TRBV19	TRBJ2-2
TGTGCCAGCAGCCCGAGGGGGAACGAGCAGTACTTC	CASSPRGNEQYF	TRBV7-4	TRBJ2-7
TGTGCCGGTCAGGACCCTGGCTACACCTTC	CAGQDPGYTF	TRBV6-2	TRBJ1-2
TGTGCCAGGAACACCAGGGGCACTCGCAATCAGCCCCAGCATTTT	CARNTRGTRNQPQHF	TRBV12-3	TRBJ1-5
TGTGCCAGCAGTGGGACAGGGGCCACTGAAGCTTTCTTT	CASSGTGATEAFF	TRBV27	TRBJ1-1
TGTGCCAGCAGTTTCCTTGACAGGCCGCCTAATTCACCCCTCCACTTT	CASSFLDRPPNSPLHF	TRBV28	TRBJ1-6
TGTGCCAGCAGAAAACTAAAGCCCGAGACCCAGTACTTC	CASRKLKPETQYF	TRBV6-1	TRBJ2-5
TGTGCCAGCAGTGGGGAGGGAGGGTCTGGGGCCAACGTCCTGACTTTC	CASSGEGGSGANVLTF	TRBV6-5	TRBJ2-6
TGTGCCAGCAGCGAGAACACCCCCTTCTATAGCAATCAGCCCCAGCATTTT	CASSENTPFYSNQPQHF	TRBV11-3	TRBJ1-5
TGTGCCAGCAGCTCTGAGGGGGGAAGGAGAACTAGCAATCAGCCCCAGCATTTT	CASSSEGGRRTSNQPQHF	TRBV13	TRBJ1-5
TGTGCCAGCTCACCAGGCAACTCGGGCGCCTACGAGCAGTACTTC	CASSPGNSGAYEQYF	TRBV18	TRBJ2-7
TGTGCCAGCAGCTTACCCACAGACCGTGAAGCTTTCTTT	CASSLPTDREAFF	TRBV7-9	TRBJ1-1
TGTGCCAGCAGCTTAGCGCGGCTGAACATTCAGTACTTC	CASSLARLNIQYF	TRBV7-6	TRBJ2-4
TGTGCCAGTAGAGTTCCATTTCGTAGCGGGAAGGTGGAGCAGTTCTTC	CASRVPFRSGKVEQFF	TRBV19	TRBJ2-1
TGTGCCAGCAAACCTGGGTATACCGGGACAGGGGGGACCACTGAAGCTTTCTTT	CASKPGYTGTGGTTEAFF	TRBV27	TRBJ1-1
TGTGCCAGTGAAATTGGACAGGATGAGCAGTTCTTC	CASEIGQDEQFF	TRBV13	TRBJ2-1
TGTGCCAGTAGTATGTCCTATACCTACGAGCAGTACTTC	CASSMSYTYEQYF	TRBV19	TRBJ2-7
TGTGCCACAACAGGGGGCCTTCAGCCCCAGCATTTT	CATTGGLQPQHF	TRBV7-3	TRBJ1-5
TGTGCCAGCAGCTTAGTGGGGGCTTCCACAGATACGCAGTATTTT	CASSLVGASTDTQYF	TRBV7-9	TRBJ2-3
TGTGCCAGCAGTCCTAACGTGACAGGGACCTTCACTGAAGCTTTCTTT	CASSPNVTGTFTEAFF	TRBV6-5	TRBJ1-1
TGCAGTGCTAGAGATACAGTTGTAAACGAGCAGTACTTC	CSARDTVVNEQYF	TRBV20-1	TRBJ2-7
TGCAGGACCTACGCCTACGAGCAGTACTTC	CRTYAYEQYF	TRBV20-1	TRBJ2-7
TGTGCCAGTAGCCAAACGGACAGGGGGCAAGATCAGCCCCAGCATTTT	CASSQTDRGQDQPQHF	TRBV19	TRBJ1-5
TGTGCCAGCAGCTTAAAAAGTTGGGTATCCACTAATGAAAAACTGTTTTTT	CASSLKSWVSTNEKLFF	TRBV11-3	TRBJ1-4
TGCGCCAGCAGCCAAGATGCCGGGACAGGGGGTTGGGAGAGCTCCTACGAGCAGTACTTC	CASSQDAGTGGWESSYEQYF	TRBV4-1	TRBJ2-7
TGTGCCAGCAGTTCTCAGGGTCTTCAGGGGAAGCCCCAGCATTTT	CASSSQGLQGKPQHF	TRBV12-3	TRBJ1-5
TGCGCCAGCAGCAGAAGAGGAATTACCTACGAGCAGTACTTC	CASSRRGITYEQYF	TRBV5-1	TRBJ2-7
TGTGCCAGCAGCTTGGGTCTAGCGGCGATTTTCACCGGGGAGCTGTTTTTT	CASSLGLAAIFTGELFF	TRBV5-4	TRBJ2-2
TGTGCCAGCAGCCACAGGACAGCGTTCGAAAAACTGTTTTTT	CASSHRTAFEKLFF	TRBV4-2	TRBJ1-4
TGCGCTGAGCAGGGCTATGGCTACACCTTC	CAEQGYGYTF	TRBV5-1	TRBJ1-2
TGTGCCAGCAGCGACAGCGCCCAGGGCACCAATGGCTACACCTTC	CASSDSAQGTNGYTF	TRBV3-1	TRBJ1-2
TGTGCCAGCAGTGATGATCAGGGCGGGATCTCTGGAAACACCATATATTTT	CASSDDQGGISGNTIYF	TRBV6-4	TRBJ1-3
TGTGCTAGTGGTTTCCCGGTGATACTATCTGCCCTCCACTTT	CASGFPVILSALHF	TRBV12-5	TRBJ1-6
TGTGCCATCAGTTCGTGGGGGGGTAATAACTATGGCTACACCTTC	CAISSWGGNNYGYTF	TRBV10-3	TRBJ1-2
TGTGCCAGCAGCCAAGGGCCTTCTGCGGGAGGAGGCACTGAAGCTTTCTTT	CASSQGPSAGGGTEAFF	TRBV3-1	TRBJ1-1
TGCGCCAGCGCGGGAGTGGACACCGGGGAGCTGTTTTTT	CASAGVDTGELFF	TRBV5-1	TRBJ2-2
TGTGCCAGTAGTAGCAGGGGGCCGAACTATGGCTACACCTTC	CASSSRGPNYGYTF	TRBV19	TRBJ1-2
TGTGCCAGCTCATGCGGGCCCTCCTACAATGAGCAGTTCTTC	CASSCGPSYNEQFF	TRBV18	TRBJ2-1
TGCGCCAGCAGTGAACCCCGGGACATGGGCTCCTACGAGCAGTACTTC	CASSEPRDMGSYEQYF	TRBV10-1	TRBJ2-7
TGTGCCAGCTCACGGGGGCCTAAAGGTCAGCCCCAGCATTTT	CASSRGPKGQPQHF	TRBV18	TRBJ1-5
TGTGCCAGCAGTTCTGCCCCGTTTGGGGGGGACTATGGCTACACCTTC	CASSSAPFGGDYGYTF	TRBV6-2	TRBJ1-2
TGCAGTCGAGGGACAGGGGGCTACGAGCAGTACTTC	CSRGTGGYEQYF	TRBV20-1	TRBJ2-7
TGTGCCAGCTCACCTTCCGGGGGCCGACATCGAGGATTTTCGGGGAACACTGAAGCTTTCTTT	CASSPSGGRHRGFSGNTEAFF	TRBV18	TRBJ1-1
TGTGCCAGCAGCTTGGGGGCCACAGGGACGGGCAATCAGCCCCAGCATTTT	CASSLGATGTGNQPQHF	TRBV5-4	TRBJ1-5
TGTGCCACCAGACCGAGGGACCCAGAGGAGGAGACCCAGTACTTC	CATRPRDPEEETQYF	TRBV24-1	TRBJ2-5
TGTGCCACCCGTATCCTAGAAAATCCGACGGTCTACGAGCAGTACTTC	CATRILENPTVYEQYF	TRBV24-1	TRBJ2-7
TGCGCCAGCAGCTTGGACCGTATTCTGGGGGGGCCGCCTTGGACTCGATCCGGGGAGCTGTTTTTT	CASSLDRILGGPPWTRSGELFF	TRBV5-1	TRBJ2-2
TGTGCCAGCAGGGGGACAGGGCATTCACCCCTCCACTTT	CASRGTGHSPLHF	TRBV7-2	TRBJ1-6
TGTGCCATCAGTGGGGACAGGGGTCTGGGCCACGAGCAGTACTTC	CAISGDRGLGHEQYF	TRBV10-3	TRBJ2-7
TGCAGTGCTAGACCCCATGAAAGAGGGAATAGGTACAATGAGCAGTTCTTC	CSARPHERGNRYNEQFF	TRBV20-1	TRBJ2-1
TGTGCCATGCCCCGGGAGACCCAGTACTTC	CAMPRETQYF	TRBV7-6	TRBJ2-5
TGTGCCAGCAGGACGGGTATCGGGACTAGCGGGGAAGTAGGAGGAAAGCCCTACGAGCAGTACTTC	CASRTGIGTSGEVGGKPYEQYF	TRBV6-1	TRBJ2-7
TGTGCCATCAATCGTTCCCTTTTATGGGGGCCAGATACGCAGTATTTT	CAINRSLLWGPDTQYF	TRBV10-3	TRBJ2-3
TGCGCCAGCAGCCGAGAACCGGGACAGGGTCGTCAGCCCCAGCATTTT	CASSREPGQGRQPQHF	TRBV4-1	TRBJ1-5
TGTGCCAGCAGCTACGGCAGCGGGATCGAGCAGTTCTTC	CASSYGSGIEQFF	TRBV13	TRBJ2-1
TGTGCCAGCAGCCAGGACCGGCGCCGCCTGTGCTCTGGAAACACCATATATTTT	CASSQDRRRLCSGNTIYF	TRBV13	TRBJ1-3
TGTGCCAGCAGCTTCTCTAGCTCCTACGAGCAGTACTTC	CASSFSSSYEQYF	TRBV7-9	TRBJ2-7
TGCGCCAGCAGCCATTTTTGTTGCCTACAGGGAGCTCGAAACACTGAAGCTTTCTTT	CASSHFCCLQGARNTEAFF	TRBV4-1	TRBJ1-1
TGCGCCAGCAGCCCGAGGGGCGGCACTGAAGCTTTCTTT	CASSPRGGTEAFF	TRBV5-1	TRBJ1-1
TGCGCCAGCAGCTTGCTAGGTGGGTACTACGAGCAGTACTTC	CASSLLGGYYEQYF	TRBV5-1	TRBJ2-7
TGTGCCACCAGCAGATTCTGGGGGGACCAAGAGACCCAGTACTTC	CATSRFWGDQETQYF	TRBV15	TRBJ2-5
TGTGCCAGCAGCGTGGGACAGGGGGATGGCTACACCTTC	CASSVGQGDGYTF	TRBV9	TRBJ1-2
TGTGCCAGCAAGGCCCGGGCGGGAGGGGTGAACACTGAAGCTTTCTTT	CASKARAGGVNTEAFF	TRBV2	TRBJ1-1
TGTGCCAGCAGCGCCTCAGGGCCAAGTAGTTGTCCAAGGGTCCCTATTAATGAAAAACTGTTTTTT	CASSASGPSSCPRVPINEKLFF	TRBV9	TRBJ1-4
TGTGCCAGCAGCCAAGGGAGGAGGGGGGTACCGAAGCAGTTCTTC	CASSQGRRGVPKQFF	TRBV3-1	TRBJ2-1
TGCGCCAGCAAAAAGCGGGAGGGGGGAAAGTATTTT	CASKKREGGKYF	TRBV4-3	TRBJ2-3
TGTGCCACCAGTGATCCGGTCAGCGGAAACACCATATATTTT	CATSDPVSGNTIYF	TRBV24-1	TRBJ1-3
TGTGCCAGGCAGCCCAATCAGCCCCAGCATTTT	CARQPNQPQHF	TRBV10-3	TRBJ1-5
TGTGCCAGCAGCCGTCGCGGGGGTCAGGGCACAGATACGCAGTATTTT	CASSRRGGQGTDTQYF	TRBV3-1	TRBJ2-3
TGTGCCATCAGTGATAGTCCAATAAGTTGCAATGAGCAGTTCTTC	CAISDSPISCNEQFF	TRBV10-3	TRBJ2-1
TGTGCCAGCAGCGGAAAGTTCCGGACAGCCAAAAGACACACTGAAGCTTTCTTT	CASSGKFRTAKRHTEAFF	TRBV7-8	TRBJ1-1
TGTGCCAGTTTAGGTGGACAGAGAATTAACTCCTACGAGCAGTACTTC	CASLGGQRINSYEQYF	TRBV19	TRBJ2-7
TGTGCCTCGGAGGGGGAGAAACGGATTATTAACTATGGCTACACCTTC	CASEGEKRIINYGYTF	TRBV19	TRBJ1-2
TGTGCCAGCAGCCAAGGGGACAGCCTAGGCTCCTACGAGCAGTACTTC	CASSQGDSLGSYEQYF	TRBV14	TRBJ2-7
TGTGCCAGCAGCGGGGCTTCGTGTGAAGCTTTCTTT	CASSGASCEAFF	TRBV13	TRBJ1-1
TGTGCCAGCAGCAACACTGGACTAGCGGGCAGTCCAGATACGCAGTATTTT	CASSNTGLAGSPDTQYF	TRBV7-3	TRBJ2-3
TGTGCCAGCAGTGAATATAGGGACGGAAACACTGAAGCTTTCTTT	CASSEYRDGNTEAFF	TRBV25-1	TRBJ1-1
TGTGCCAGCAGTTTACGGATTGGGGAGAGAGTTGAAGCTTTCTTT	CASSLRIGERVEAFF	TRBV27	TRBJ1-1
TGCGATTTTAAGCGGCTAAACATTCAGTACTTC	CDFKRLNIQYF	TRBV5-1	TRBJ2-4
TGTGCCAGCAGCCAAGCGCAAAGGGGGGGAGTACAGCCCCAGCATTTT	CASSQAQRGGVQPQHF	TRBV4-2	TRBJ1-5
TGCGCCAGCAGTGAGTCGGGCCCAGGCAGAGAGGCTAGGAGCTACACCTTC	CASSESGPGREARSYTF	TRBV10-1	TRBJ1-2
TGCGCCAGCAGCTATGCCGGGACAGCCGACTACGAGCAGTACTTC	CASSYAGTADYEQYF	TRBV5-1	TRBJ2-7
TGTGCCAGCAGCTTTAGAGGAAGGGACCATAACGCCCAGTACTTC	CASSFRGRDHNAQYF	TRBV7-2	TRBJ2-5
TGTGCCAGCAGTGTGAGGGGACTATATAGCAATCAGCCCCAGCATTTT	CASSVRGLYSNQPQHF	TRBV27	TRBJ1-5
TGTGCCAGCAGCCGATCGAAACCGGGGTCGGGGGGGCTCCAGACCCAGTACTTC	CASSRSKPGSGGLQTQYF	TRBV3-1	TRBJ2-5
TGCGCCAGCAGCACCGCGGGACTAGCGAGCCAAATTGTCGGGGAGCTGTTTTTT	CASSTAGLASQIVGELFF	TRBV5-1	TRBJ2-2
TGTGCCAGCTCACAAATCCTGAGGGTTTCTGGGTATCAGCCCCAGCATTTT	CASSQILRVSGYQPQHF	TRBV18	TRBJ1-5
TGTGCCAGCAGCTGCTCTATCACAGGGGGGGGATCTGGAAACACCATATATTTT	CASSCSITGGGSGNTIYF	TRBV7-8	TRBJ1-3
TGTGCCAGCAGCTTGACTAGACTAGCAATCGGCTCCTACGAGCAGTACTTC	CASSLTRLAIGSYEQYF	TRBV5-5	TRBJ2-7
TGTGCCAGCAGCTGGGGAACCCTAAGTTCCGAGCAGTACTTC	CASSWGTLSSEQYF	TRBV11-1	TRBJ2-7
TGTGCCAGCAGCTTAGCTCGGGACAGGGTGCCAACTAATGAAAAACTGTTTTTT	CASSLARDRVPTNEKLFF	TRBV7-4	TRBJ1-4
TGTGCCAGCAGCTGGTACAGGAACGTGGGAGAGAACTATGGCTACACCTTC	CASSWYRNVGENYGYTF	TRBV12-4	TRBJ1-2
TGTGCCAGCAGTTTCGGGCGGCTGTTGATCTGTTACGAGCAGTACTTC	CASSFGRLLICYEQYF	TRBV6-5	TRBJ2-7
TGTGCCAGCAGTTACGACAGCCGGAAGAGGGAGACCCAGTACTTC	CASSYDSRKRETQYF	TRBV6-5	TRBJ2-5
TGTGCCAGCAGTTTTATTAAGGGGGGTTGCCCCTACGAGCAGTACTTC	CASSFIKGGCPYEQYF	TRBV27	TRBJ2-7
TGTGCCAGCAGCACAGGGGGCCAAGAGACCCAGTACTTC	CASSTGGQETQYF	TRBV11-2	TRBJ2-5
TGTGCCAGCAGTTACTCGAGTACGGGGCGCATATCCGAGCAGTACTTC	CASSYSSTGRISEQYF	TRBV6-2	TRBJ2-7
TGCAGTGCTAGATCCAGACTAGCGGGGTACCAAGAGACCCAGTACTTC	CSARSRLAGYQETQYF	TRBV20-1	TRBJ2-5
TGTGCCAGCAGCTTTTGTAGAAGGATTCTCCAACAGGGCGTCCGAAGGGTTGGGGCGGCGAATCAGCCCCAGCATTTT	CASSFCRRILQQGVRRVGAANQPQHF	TRBV7-3	TRBJ1-5
TGTGCCAGCAGCAAAAAGGGGCACGGAGACCAACCCGATGTTACCGGGGAGCTGTTTTTT	CASSKKGHGDQPDVTGELFF	TRBV7-9	TRBJ2-2
TGCAGTGCTCCTAGGTGGGTAGTTAGGGGGGAGCTGTTTTTT	CSAPRWVVRGELFF	TRBV20-1	TRBJ2-2
TGTGCCAGCAGCTCGTGGTCCCACAGGGGGGGAAGGGGAGTGGGAAGCAATCAGCCCCAGCATTTT	CASSSWSHRGGRGVGSNQPQHF	TRBV11-2	TRBJ1-5
TGTGCTAGTGGCCATCGAGTCACTGAAGCTTTCTTT	CASGHRVTEAFF	TRBV12-5	TRBJ1-1
TGCAGCGTGGACAGTCGGGGTTACTATGGCTACACCTTC	CSVDSRGYYGYTF	TRBV29-1	TRBJ1-2
TGCGCCAGCATCATCGGGGTACTCGGTACTGAAGCTTTCTTT	CASIIGVLGTEAFF	TRBV5-1	TRBJ1-1
TGTGCCAGTAGTACCAGTACCGGGATGGAGTTGGAACGAACTGAAGCTTTCTTT	CASSTSTGMELERTEAFF	TRBV19	TRBJ1-1
TGTGCCAGCAGTTTTTCCGGGACGCTGTTGAACACTGAAGCTTTCTTT	CASSFSGTLLNTEAFF	TRBV28	TRBJ1-1
TGTGCCAGCACGGTAGCGGGTAAAGAGACCCAGTACTTC	CASTVAGKETQYF	TRBV5-6	TRBJ2-5
TGTGCCAGCAGCCCGGACTACGAGCAGTACTTC	CASSPDYEQYF	TRBV9	TRBJ2-7
TGTGCCAGCAGCGGGACAGGGGAGACCCAGTACTTC	CASSGTGETQYF	TRBV7-4	TRBJ2-5
TGTGCTACCAGGACCGGGGGACAGGGCACTGAAGCTTTCTTT	CATRTGGQGTEAFF	TRBV12-5	TRBJ1-1
TGCGCCAGCAGCCCCGCGTTCTGGGGCCGGATGAACACTGAAGCTTTCTTT	CASSPAFWGRMNTEAFF	TRBV4-1	TRBJ1-1
TGTGCCAGCAGTTACGTTGGAGGTCGTTGCTCCTACAATGAGCAGTTCTTC	CASSYVGGRCSYNEQFF	TRBV6-5	TRBJ2-1
TGTGCCAGCAGTTACTCGCTAGACAGTTGTTACGAGCAGTACTTC	CASSYSLDSCYEQYF	TRBV6-5	TRBJ2-7
TGTGCCAGCAGTTGGGGGAGCCGACTAGAGGAGACCCAGTACTTC	CASSWGSRLEETQYF	TRBV6-1	TRBJ2-5
TGTGCCAGCAGCGGTCGCCGGGACATAGCCCTGAACACTGAAGCTTTCTTT	CASSGRRDIALNTEAFF	TRBV7-4	TRBJ1-1
TGTGCCAGCAGTGCGGCAATCTACGAGCAGTACTTC	CASSAAIYEQYF	TRBV6-1	TRBJ2-7
TGTGCCAGCAGTTTATCCCCGCAATCCGCACAGGGCAATGAGCAGTACTTC	CASSLSPQSAQGNEQYF	TRBV27	TRBJ2-7
TGTGCCAGCAGCTTAGATGTCCCCTGGGCGAAGAAAGAGACCCAGTACTTC	CASSLDVPWAKKETQYF	TRBV11-2	TRBJ2-5
TGTGCCAGCAGACGACCCTACGAGCAGTACTTC	CASRRPYEQYF	TRBV27	TRBJ2-7
TGTGCCACCAGTGAGGGGGGTGGCGCCAATCAGCCCCAGCATTTT	CATSEGGGANQPQHF	TRBV24-1	TRBJ1-5
TGTGCCAGCAGCACTGACAGGGGGCGCGAAAAACTGTTTTTT	CASSTDRGREKLFF	TRBV9	TRBJ1-4
TGTGCCAGCAACGGGTACAGGAGCGAGCAGTACTTC	CASNGYRSEQYF	TRBV6-4	TRBJ2-7
TGTGCCAGCAGCCCTCCGGGACAGGGGAGGAAGCCCCAGCATTTT	CASSPPGQGRKPQHF	TRBV14	TRBJ1-5
TGTGCCAGCAGCTCCCGACAGGGAATCCAAAAGCCCCAGCATTTT	CASSSRQGIQKPQHF	TRBV7-9	TRBJ1-5
TGTGCCAGCAGTTTCCGTCAAGGTCGGACAGGGCTCCGGGAGACCCAGTACTTC	CASSFRQGRTGLRETQYF	TRBV28	TRBJ2-5
TGCAGTGCTGGACTCGGACAGTACTTC	CSAGLGQYF	TRBV20-1	TRBJ2-5
TGTGCCAGCAGCCCCCGGGGCCCACCCTACGAGCAGTACTTC	CASSPRGPPYEQYF	TRBV2	TRBJ2-7
TGCGCCAGCAGGGAGAGCTACGAGCAGTACTTC	CASRESYEQYF	TRBV5-1	TRBJ2-7
TGTACATCTCTTGTTCGGGATGAGCAGTTCTTC	CTSLVRDEQFF	TRBV6-5	TRBJ2-1
TGTGCCACCAGCAGCTACCGACTGTCCACAGATACGCAGTATTTT	CATSSYRLSTDTQYF	TRBV15	TRBJ2-3
TGTGCCAGCCTCCCGCGGGGGGTATTCTTCGATACGCAGTATTTT	CASLPRGVFFDTQYF	TRBV5-5	TRBJ2-3
TGTGCCAGCAGCTTGGCCGTCCCGGGGGGGGGGGCCGGGGAGACCCAGTACTTC	CASSLAVPGGGAGETQYF	TRBV5-4	TRBJ2-5
TGTGCCAGCAGAAACCCACGAATGACAGGGTACGAGCAGTACTTC	CASRNPRMTGYEQYF	TRBV27	TRBJ2-7
TGTGCCAGCAGCGTTCCCGAGAGCTTTTGGACTAGCGGGGACCATGAGCAGTTCTTC	CASSVPESFWTSGDHEQFF	TRBV13	TRBJ2-1
TGTGCCAGCAGTGGACCCTTGCGGCTGGGGACCCAGTACTTC	CASSGPLRLGTQYF	TRBV6-5	TRBJ2-5
TGTGCCAGCAGTTACCCCTCAGACAGAGTCTCCTACAATGAGCAGTTCTTC	CASSYPSDRVSYNEQFF	TRBV6-5	TRBJ2-1
TGCGCCATAGGTCAGCCCCAGCATTTT	CAIGQPQHF	TRBV10-1	TRBJ1-5
TGTGCCAGCAGTAACTGGGGGGACGAGCAGTTCTTC	CASSNWGDEQFF	TRBV6-5	TRBJ2-1
TGTGCCAGCAGTCATCATACGCTTTATAATCAGCCCCAGCATTTT	CASSHHTLYNQPQHF	TRBV28	TRBJ1-5
TGCGCCAGCATTACCCACGGGCGGGGTGAAAAACTGTTTTTT	CASITHGRGEKLFF	TRBV10-1	TRBJ1-4
TGTGCCAGCAGTACGGGTGGACGGGCGCTCTACACCGGGGAGCTGTTTTTT	CASSTGGRALYTGELFF	TRBV6-1	TRBJ2-2
TGTGCCAGCAGTGAATGCATATACGGGGACAGGACCAGATACGAGCAGTACTTC	CASSECIYGDRTRYEQYF	TRBV2	TRBJ2-7
TGTGCCAGCAGCCGGGATAGGCCATTGCTAGCGGGGGTGGTATCCTACGAGCAGTACTTC	CASSRDRPLLAGVVSYEQYF	TRBV13	TRBJ2-7
TGTGCCAGCAGCGCCCCGGGACACTACGAGCAGTACTTC	CASSAPGHYEQYF	TRBV5-4	TRBJ2-7
TGTGCCAGCGTGGGGGGGAGGTCCCTGTCCTACAATGAGCAGTTCTTC	CASVGGRSLSYNEQFF	TRBV7-3	TRBJ2-1
TGTGCCATCCAACTAGACAGGAATAGGTGTGAAAAACTGTTTTTT	CAIQLDRNRCEKLFF	TRBV10-3	TRBJ1-4
TGCAGCGTTGAAGATCCCCAAGGCTTGGCCGGGACAGGGCCCGTGCAAACTGAAGCTTTCTTT	CSVEDPQGLAGTGPVQTEAFF	TRBV29-1	TRBJ1-1
TGCAGTGCTAGAGATAAAGGGGGAGTTTACCGGGAGTACAATGAGCAGTTCTTC	CSARDKGGVYREYNEQFF	TRBV20-1	TRBJ2-1
TGCAGTGCTAGACAGGAGTGTCAGCCCCAGCATTTT	CSARQECQPQHF	TRBV20-1	TRBJ1-5
TGTGCCAGCAAGACCCGGGACAGGGAAGATGAAAAACTGTTTTTT	CASKTRDREDEKLFF	TRBV12-4	TRBJ1-4
TGTGCCAGGATTAATTCAGGGAAGCCCTACGAGCAGTACTTC	CARINSGKPYEQYF	TRBV28	TRBJ2-7
TGTGCCAGCAACAGGGTAGATAGCAATCAGCCCCAGCATTTT	CASNRVDSNQPQHF	TRBV2	TRBJ1-5
TGTGCCCCGGTTGTCAGGCGTACTGGGAACTATGGCTACACCTTC	CAPVVRRTGNYGYTF	TRBV2	TRBJ1-2
TGTGCCAGCAGTTCTGGGACTAGCGGGTATTGCGGCTCCTACGAGCAGTACTTC	CASSSGTSGYCGSYEQYF	TRBV6-5	TRBJ2-7
TGTGCCAGCATACAGGGCGGCTCCTACGAGCAGTACTTC	CASIQGGSYEQYF	TRBV14	TRBJ2-7
TGTGCTAGTGGTTTGCCGCAGTTCCCCCGGAATCTAGCGGGGGAGAGCTCCTACAATGAGCAGTTCTTC	CASGLPQFPRNLAGESSYNEQFF	TRBV12-5	TRBJ2-1
TGTGCCAGCAGTGGCCATCGAAGGGACAGAGGTTACACCGGGGAGCTGTTTTTT	CASSGHRRDRGYTGELFF	TRBV25-1	TRBJ2-2
TGTGCCATCAGTCGTCAAATCGGACAGGGGGGGAGCTCCTATAATTCACCCCTCCACTTT	CAISRQIGQGGSSYNSPLHF	TRBV10-3	TRBJ1-6
TGCGCCAGCAGCAAGAGAGTCGAGCAGTTCTTC	CASSKRVEQFF	TRBV5-1	TRBJ2-1
TGCGCCAGCGTCGGAGGCGGGAGTCTACAAGAGACCCAGTACTTC	CASVGGGSLQETQYF	TRBV10-1	TRBJ2-5
TGTGCCAGCAGTGGGGGCCAAGAAAAACTGTTTTTT	CASSGGQEKLFF	TRBV6-4	TRBJ1-4
TGTGCCAGCAGCCAAGGGGAGTTTGGGGGGGGAGGCTACAATGAGCAGTTCTTC	CASSQGEFGGGGYNEQFF	TRBV3-1	TRBJ2-1
TGTGCCAGCAGCCCCACGGGCGTGACGGTAAGGGATGGCTACACCTTC	CASSPTGVTVRDGYTF	TRBV13	TRBJ1-2
TGTGCCAGCATTTTTTTAACGCAACGGGTATACCCCCCTAATGAAAAACTGTTTTTT	CASIFLTQRVYPPNEKLFF	TRBV6-3	TRBJ1-4
TGTGCCAGCAGCTTCAACACCCCAACAGGGAGACTGTTTTTT	CASSFNTPTGRLFF	TRBV7-9	TRBJ1-4
TGTGCCAGCAGTGATGGGGGGGGCCTGAACACTGAAGCTTTCTTT	CASSDGGGLNTEAFF	TRBV6-1	TRBJ1-1
TGTGCCAGCAGTTACTCTTCACCCGGACTAAGTGAGACCCAGTACTTC	CASSYSSPGLSETQYF	TRBV6-5	TRBJ2-5
TGCGCCAGCACTCCCAGGCTTGTAGATCGAAGACCGCTCCCTGAAGCTTTCTTT	CASTPRLVDRRPLPEAFF	TRBV10-1	TRBJ1-1
TGTGCCAGCTCCTTAGGGACTAGCGGGAACATCACAGATACGCAGTATTTT	CASSLGTSGNITDTQYF	TRBV6-5	TRBJ2-3
TGCAGCGTCCCAAGTGGAGACGAGCAGTACTTC	CSVPSGDEQYF	TRBV29-1	TRBJ2-7
TGTGCCACCAGCAGAGATGTCCCGTCAGGGGAAACCTACGAGCAGTACTTC	CATSRDVPSGETYEQYF	TRBV15	TRBJ2-7
TGTGCCAGCAGCGCGGCCCCCGAAGGATCGGGGGGACACATTTTTAGCTCTGGGGCCAACGTCCTGACTTTC	CASSAAPEGSGGHIFSSGANVLTF	TRBV7-8	TRBJ2-6
TGTGCCAGCAGTTTAGAGTATGGACGCAGGGGGCTCTACGAGCAGTACTTC	CASSLEYGRRGLYEQYF	TRBV12-3	TRBJ2-7
TGTGCCACTAGATTCCCCCCGGGACTAGCGGCCTACAATGAGCAGTTCTTC	CATRFPPGLAAYNEQFF	TRBV4-2	TRBJ2-1
TGTGCCAGCAGGGGTCCCGACGTAGATGGAAACACCATATATTTT	CASRGPDVDGNTIYF	TRBV27	TRBJ1-3
TGTGCCAGCAGTGATGACGGGGTTATCTACAATGAGCAGTTCTTC	CASSDDGVIYNEQFF	TRBV6-4	TRBJ2-1
TGTGCCAGCAGCTTAAAGCGGGGTATAAACTCCTATAATTCACCCCTCCACTTT	CASSLKRGINSYNSPLHF	TRBV7-3	TRBJ1-6
TGTGCCAGCAGCTGTAAAAAAGGGGGGAAGAGGGAGCTGTTTTTT	CASSCKKGGKRELFF	TRBV7-2	TRBJ2-2
TGTGCTAACAGGGAGACTCGCACTGAAGCTTTCTTT	CANRETRTEAFF	TRBV9	TRBJ1-1
TGTGCCAGCAGCTTAGGTACTGGCAGGCCTGAAGCTTTCTTT	CASSLGTGRPEAFF	TRBV11-3	TRBJ1-1
TGTGCCAGCAGTTTTTGGGGGGCCGCCAATGAGCAGTTCTTC	CASSFWGAANEQFF	TRBV28	TRBJ2-1
TGTGCCAGCAGTTTGCTTGACAGGGGGCATAACTATGGCTACACCTTC	CASSLLDRGHNYGYTF	TRBV28	TRBJ1-2
TGTGCCAGCAGGGTCATCTCTGATACGCAGTATTTT	CASRVISDTQYF	TRBV2	TRBJ2-3
TGCAGTGCTAGAGGTTGGCTTCCTACAAAGGGTGCTGAAGCTTTCTTT	CSARGWLPTKGAEAFF	TRBV20-1	TRBJ1-1
TGCGCCAGCGGGTTAGACCCATCTAGCGGGTACAATGAGCAGTTCTTC	CASGLDPSSGYNEQFF	TRBV5-1	TRBJ2-1
TGTGCCAGCACGGCCTTAGGACCGCATGAGCAGTTCTTC	CASTALGPHEQFF	TRBV27	TRBJ2-1
TGTGCCATCCCGGGCTCTGGGGCCAACGTCCTGACTTTC	CAIPGSGANVLTF	TRBV10-3	TRBJ2-6
TGTGCCCGGACAGGGTACAATGAGCAGTTCTTC	CARTGYNEQFF	TRBV19	TRBJ2-1
TGCAGTGCTAGGACAGCCTCGGAAATGAACACTGAAGCTTTCTTT	CSARTASEMNTEAFF	TRBV20-1	TRBJ1-1
TGTGCCAGCAGTTTATCGGCGACAGGGGGACAAGATACGCAGTATTTT	CASSLSATGGQDTQYF	TRBV27	TRBJ2-3
TGTGCCACCCAACCGGCTCTCTCCTACGAGCAGTACTTC	CATQPALSYEQYF	TRBV6-6	TRBJ2-7
TGTGCCAGCAGCCTGGGCTCCCCTCACACCGGGGAGCTGTTTTTT	CASSLGSPHTGELFF	TRBV13	TRBJ2-2
TGCAGTGCTCCGGGACAGGGGGCCCCTAATAGCAATCAGCCCCAGCATTTT	CSAPGQGAPNSNQPQHF	TRBV20-1	TRBJ1-5
TGTGCCAGCAGCCTGACTGTAGGGGATGTAGAGGCTGAAGCTTTCTTT	CASSLTVGDVEAEAFF	TRBV7-9	TRBJ1-1
TGTGCCAGCAGCTGTGGACAGGGAGGCTACACCTTC	CASSCGQGGYTF	TRBV11-3	TRBJ1-2
TGCGCCAGCAGCCAAGGAAGGGGGGGCCTGGGAGAGCAGTTCTTC	CASSQGRGGLGEQFF	TRBV4-3	TRBJ2-1
TGTGCCATCAGATGTTCGGCTGGGGCGGTCTACGAGCAGTACTTC	CAIRCSAGAVYEQYF	TRBV10-3	TRBJ2-7
TGTGCCAGCAGCCAGCGGACAGGTTTCCCAAGCTCCTACGAGCAGTACTTC	CASSQRTGFPSSYEQYF	TRBV6-4	TRBJ2-7
TGTGCCAGCAGCTTGTCCTTCGGGACAGGGGACTCCGGGGAGCTGTTTTTT	CASSLSFGTGDSGELFF	TRBV7-3	TRBJ2-2
TGTGCCAGTATCCCGTACGCGAGGGACGAGCAGTACTTC	CASIPYARDEQYF	TRBV19	TRBJ2-7
TGTGCCAGCAGTTACCCCCCGGGGGGGCGGTCCTACGAGCAGTACTTC	CASSYPPGGRSYEQYF	TRBV6-6	TRBJ2-7
TGCGCCAGCAGCTTGAATAGGCTTCCATATGGCTACACCTTC	CASSLNRLPYGYTF	TRBV5-1	TRBJ1-2
TGTGCCAGCAGACCCGCACCTATATTCCTACAAGAGACCCAGTACTTC	CASRPAPIFLQETQYF	TRBV28	TRBJ2-5
TGTGCCAGCAGATGGGGAGGGGCCGAGCAGTACTTC	CASRWGGAEQYF	TRBV11-2	TRBJ2-7
TGTGCCAGCAGTTTCGGGGGGGAGCCGGGAGCTTTCTTT	CASSFGGEPGAFF	TRBV27	TRBJ1-1
TGTGCCAGCAGTTTACCTCGTCGGGTGGGGAAGGGGCCGTATAGCAATCAGCCCCAGCATTTT	CASSLPRRVGKGPYSNQPQHF	TRBV28	TRBJ1-5
TGTGCCAGCAGTTCCGCCTTCGGCTATGGCTACACCTTC	CASSSAFGYGYTF	TRBV12-3	TRBJ1-2
TGTGCCAGCTACGTGTGTAATCAGCCCCAGCATTTT	CASYVCNQPQHF	TRBV19	TRBJ1-5
TGTGCCAACCTTAGGGACCGAGTCGATACGCAGTATTTT	CANLRDRVDTQYF	TRBV10-3	TRBJ2-3
TGTGCCAGCAGCTTAGGGCGGCACTACGAGCAGTACTTC	CASSLGRHYEQYF	TRBV7-3	TRBJ2-7
TGTGCCAGCAGCTTACGGGACAGACAACTCCCGTCTGGAAACACCATATATTTT	CASSLRDRQLPSGNTIYF	TRBV7-4	TRBJ1-3
TGTGCCAGCAGCACAGGGGCGAACACCGGGGAGCTGTTTTTT	CASSTGANTGELFF	TRBV9	TRBJ2-2
TGTGCCAGCAGAACGGACAATGAGCAGTTCTTC	CASRTDNEQFF	TRBV7-3	TRBJ2-1
TGTGCCAGCAGCCAGGGGACAGGTCTCTTGCCCCAGCATTTT	CASSQGTGLLPQHF	TRBV6-1	TRBJ1-5
TGCGCCAGCAGCCAAGAGGCGGGTTCCAATTCGAATCCCAGGCGCAGAGCTAACTATGGCTACACCTTC	CASSQEAGSNSNPRRRANYGYTF	TRBV4-1	TRBJ1-2
TGTGCCAGCAGCTGGAACGGGACTAGCGGCCCAGATACGCAGTATTTT	CASSWNGTSGPDTQYF	TRBV13	TRBJ2-3
TGTGCCAGCAGGGGGACTGGCGGAGAGACCCAGTACTTC	CASRGTGGETQYF	TRBV9	TRBJ2-5
TGTGCCAGCTCACCATCCTTTTTGGGGGCATTTCCGATTGGTGAGTACTTC	CASSPSFLGAFPIGEYF	TRBV18	TRBJ2-7
TGCGCCAGCAGCCAAGAGCCGGCACAGGGAGGAGCAATCAGCTCCTACAATGAGCAGTTCTTC	CASSQEPAQGGAISSYNEQFF	TRBV4-3	TRBJ2-1
TGTGCCAGCAGCTTAGGGGGACAGAGGGCGGGCTACACCTTC	CASSLGGQRAGYTF	TRBV5-5	TRBJ1-2
TGTGCCAGTAGTACCATCAGTAGTTATAGCAATCAGCCCCAGCATTTT	CASSTISSYSNQPQHF	TRBV19	TRBJ1-5
TGTGCCAGCACCCACTTC	CASTHF	TRBV11-3	TRBJ1-2
TGTGCCACCAGCAGAGATAGTAATTCAGCAGCCGTAAACAATGAGCAGTTCTTC	CATSRDSNSAAVNNEQFF	TRBV15	TRBJ2-1
TGCAGCGTTGAAGCTAGCGGGCTTGACCGCTCCTACAATGAGCAGTTCTTC	CSVEASGLDRSYNEQFF	TRBV29-1	TRBJ2-1
TGTGCCATCAGAGGTAACGGCCCCCAGACCCAGTACTTC	CAIRGNGPQTQYF	TRBV10-3	TRBJ2-5
TGTGCCAGCATGGGGCGGGAATTCACCGGGGAGCTGTTTTTT	CASMGREFTGELFF	TRBV6-4	TRBJ2-2
TGTGCCAGCAGTCTCAGACAGGTCCCGATTCACTATGGCTACACCTTC	CASSLRQVPIHYGYTF	TRBV6-2	TRBJ1-2
TGTGCCAGCAGATGCATCCAAGAGGGGGGCACAGGTGAAAAACTGTTTTTT	CASRCIQEGGTGEKLFF	TRBV6-2	TRBJ1-4
TGTGCCAGCAGTTTACGGAAAAGGGGGGGGGGGTACACCTTC	CASSLRKRGGGYTF	TRBV12-4	TRBJ1-2
TGTGCCAGCAGCCCGGAGCTGGGGGGGGGGACAGCTCACGAGCAGTACTTC	CASSPELGGGTAHEQYF	TRBV6-3	TRBJ2-7
TGTGCCAGCAGAAACGGGACAGGGCGGACCTACGAGCAGTACTTC	CASRNGTGRTYEQYF	TRBV2	TRBJ2-7
TGTGCCAGCAGCCAAGAAAGGGGGTACGGCTACGAGCAGTACTTC	CASSQERGYGYEQYF	TRBV3-1	TRBJ2-7
TGTGCCAGCAGCCAGGGCGAGGGCAGTAGCTCCTACGAGCAGTACTTC	CASSQGEGSSSYEQYF	TRBV7-3	TRBJ2-7
TGTGCCAGCAGGTCAGGGGAGGGAGGTTACAATGAGCAGTTCTTC	CASRSGEGGYNEQFF	TRBV13	TRBJ2-1
TGCGCCAGCAGATACCAGGGGAGCTCCTATAATTCACCCCTCCACTTT	CASRYQGSSYNSPLHF	TRBV10-1	TRBJ1-6
TGTGCCAGCAGCTTAAAGGAAGCACGGGGACGATGCCATGAAAAACTGTTTTTT	CASSLKEARGRCHEKLFF	TRBV7-2	TRBJ1-4
TGTGCCAGCAGCCACCCCCGGGATGGCTACACCTTC	CASSHPRDGYTF	TRBV13	TRBJ1-2
TGTGCCAGCAGCCAAGCGTGTCCAGGGCCTGAAGCTTTCTTT	CASSQACPGPEAFF	TRBV3-1	TRBJ1-1
TGTGCCAGCAGCTTCCTTCACGCGCGGGACAATGAGCAGTTCTTC	CASSFLHARDNEQFF	TRBV5-4	TRBJ2-1
TGTGCCACCAGCAGAGACACACTAGCGGGGACTGGAGAGACCCAGTACTTC	CATSRDTLAGTGETQYF	TRBV15	TRBJ2-5
TGTGCCAGCATAAAGGGACCTGAAGCTTTCTTT	CASIKGPEAFF	TRBV6-8	TRBJ1-1
TGTGCCAGCAGCGTAGGAGGTAGTTTCGCCTACAATGAGCAGTTCTTC	CASSVGGSFAYNEQFF	TRBV7-7	TRBJ2-1
TGTGCCAGCAGCATAGGGGACGGCGGGAAGACCCAGTACTTC	CASSIGDGGKTQYF	TRBV7-3	TRBJ2-5
TGTGCCAGCACCCCTGCGGTTCGGGGTCCTGCGAACACCGGGGAGCTGTTTTTT	CASTPAVRGPANTGELFF	TRBV2	TRBJ2-2
TGCGCCAGCAGCTACCGCCCAGGAACGTGCTCTGGAAACACCATATATTTT	CASSYRPGTCSGNTIYF	TRBV5-1	TRBJ1-3
