TGTGCCAGCAGCCAAGACAGGGGGTATGAAAAACTGTTTTTT	CASSQDRGYEKLFF	TRBV14	TRBJ1-4
TGTGCCAGCAGTTACCCGAGCCCGGGACCCTACGAGCAGTACTTC	CASSYPSPGPYEQYF	TRBV6-5	TRBJ2-7
TGTGCCACCACATACTGCTCCTACGAGCAGTACTTC	CATTYCSYEQYF	TRBV24-1	TRBJ2-7
TGTGCCAGCAGCTCAGTAGGGGGGGAGCCGTGCGAGCAGTACTTC	CASSSVGGEPCEQYF	TRBV7-3	TRBJ2-7
TGTGCCAGCAGTAATGGGGACAACGGAAACACCATATATTTT	CASSNGDNGNTIYF	TRBV27	TRBJ1-3
TGCAGGCGGACAGGGACTAACTATGGCTACACCTTC	CRRTGTNYGYTF	TRBV20-1	TRBJ1-2
TGTGCCAGCAGATCCCCCCGGGACAGGGATGACCAGGCTGAAAAACTGTTTTTT	CASRSPRDRDDQAEKLFF	TRBV27	TRBJ1-4
TGCGCCAGCAGAAGTTCGGACAAAGAGACCCAGTACTTC	CASRSSDKETQYF	TRBV10-2	TRBJ2-5
TGTGCTAGTGGTTTGGCGCGGGCCGGCTCTGGGGCCAACGTCCTGACTTTC	CASGLARAGSGANVLTF	TRBV12-5	TRBJ2-6
TGTGCCAGCAGCCACCGGGGGCTATACAATGAGCAGTTCTTC	CASSHRGLYNEQFF	TRBV7-3	TRBJ2-1
TGCGCCAGCAGCCAAGGTCAGGGTGGCTACACCTTC	CASSQGQGGYTF	TRBV4-1	TRBJ1-2
TGTGCCAGCAGCTTAGTCCGTGCTAGCGGGGGGAGAGCCCCCTACAATGAGCAGTTCTTC	CASSLVRASGGRAPYNEQFF	TRBV11-3	TRBJ2-1
TGTGCCAGCAGGACTGGGGGTTTCACTGAAGCTTTCTTT	CASRTGGFTEAFF	TRBV6-5	TRBJ1-1
TGTGCCAGCAGCGGGAGACTAGCGTCATCCTACGAGCAGTACTTC	CASSGRLASSYEQYF	TRBV7-9	TRBJ2-7
TGTGCCAGCAGCTTAGACCCCCCCCTAGCCACTGAAGCTTTCTTT	CASSLDPPLATEAFF	TRBV11-2	TRBJ1-1
TGCAGTGCTAGAGATCCCGGCAGGGGGGTCGGAAGTACCGGGGAGCTGTTTTTT	CSARDPGRGVGSTGELFF	TRBV20-1	TRBJ2-2
TGTGCCAGCCGCCGGCTAAGTTTTGGCTACAATGAGCAGTTCTTC	CASRRLSFGYNEQFF	TRBV11-3	TRBJ2-1
TGTGCCATCAGTGACCTTGGCGGGACAGGGGAGACGTATAGCAATCAGCCCCAGCATTTT	CAISDLGGTGETYSNQPQHF	TRBV10-3	TRBJ1-5
TGTGCCAGGCCCCTGCCGGGACAGGACGAGCAGTACTTC	CARPLPGQDEQYF	TRBV28	TRBJ2-7
TGCGCCAGCAGCTTGGAGAAAAACAGGGGGAGTTCAGCCAAAAACATTCAGTACTTC	CASSLEKNRGSSAKNIQYF	TRBV5-1	TRBJ2-4
TGTGCCAGCAGTTACAGTAGGACGTCCTACAATGAGCAGTTCTTC	CASSYSRTSYNEQFF	TRBV6-5	TRBJ2-1
TGTGCCGCGCCCCTAACTCAGAACACTGAAGCTTTCTTT	CAAPLTQNTEAFF	TRBV6-4	TRBJ1-1
TGCAGTGCTGCCATCGACAGGGGCTCTGGAAACACCATATATTTT	CSAAIDRGSGNTIYF	TRBV20-1	TRBJ1-3
TGTGCCACCAGTGGGTACCGCGAAAGGGAGCAGTTCTTC	CATSGYREREQFF	TRBV24-1	TRBJ2-1
TGCGCCAGCAGCCAAGAGTCATCAACAGGGGGACTCAATCAGCCCCAGCATTTT	CASSQESSTGGLNQPQHF	TRBV4-3	TRBJ1-5
TGCGCCAGCAGCCTAGCGGTACCTAGGAGTGAGCAGTACTTC	CASSLAVPRSEQYF	TRBV5-1	TRBJ2-7
TGCAGCGTATTCCCCCCGGGACGACTCACTGAAGCTTTCTTT	CSVFPPGRLTEAFF	TRBV29-1	TRBJ1-1
TGTGCCTGGAGTACTGCTAACTATGGCTACACCTTC	CAWSTANYGYTF	TRBV30	TRBJ1-2
TGTGCCAGCTTTAGCGGAGTGACTAGCGGGAATGAGCAGTTCTTC	CASFSGVTSGNEQFF	TRBV12-4	TRBJ2-1
TGTGCCAGCAGCTTGCCCCAGCGGACAGGTTTTGTCAATTCACCCCTCCACTTT	CASSLPQRTGFVNSPLHF	TRBV5-5	TRBJ1-6
TGTGCCAGCACGAAGACGACAGGGAGCACAGATACGCAGTATTTT	CASTKTTGSTDTQYF	TRBV6-1	TRBJ2-3
TGTGCCAGCAGCTTCGGGGTCTACGAGCAGTACTTC	CASSFGVYEQYF	TRBV13	TRBJ2-7
TGCAGTGCTTCGGTGGGACTCCAAGAGACCCAGTACTTC	CSASVGLQETQYF	TRBV20-1	TRBJ2-5
TGTGCCAGCAGCCAAAACCTGGGAGGGGGCAATCAGCCCCAGCATTTT	CASSQNLGGGNQPQHF	TRBV4-2	TRBJ1-5
TGTGCCAGCAGTGAACAACCTCAGGGGGGGACTGAAGCTTTCTTT	CASSEQPQGGTEAFF	TRBV25-1	TRBJ1-1
TGCGCCAGCAGCCAAGATGGCGACAGGGGTCAGCCCCAGCATTTT	CASSQDGDRGQPQHF	TRBV4-1	TRBJ1-5
TGCGCCAGCAGCTATCGACACATTCAGTACTTC	CASSYRHIQYF	TRBV5-1	TRBJ2-4
TGCAGTGCTAGTTCCCATGGGGGCCGGGACAGTCAGCTCAAAGAGACCCAGTACTTC	CSASSHGGRDSQLKETQYF	TRBV20-1	TRBJ2-5
TGTGCCAGTAGTATGACTGGGGGCGGACCCCCTAATCAGCCCCAGCATTTT	CASSMTGGGPPNQPQHF	TRBV19	TRBJ1-5
TGTGCCAGCAGTGCGGGAGGGGAGGCGTGCGGGGAGCTGTTTTTT	CASSAGGEACGELFF	TRBV6-1	TRBJ2-2
TGTGCCACCAGTGATTTAGGGGATGGTGGCCACTATGGCTACACCTTC	CATSDLGDGGHYGYTF	TRBV24-1	TRBJ1-2
TGTGCCAGCAGTTACTGCGCCAAGCAGGGGAGCTACGAGCAGTACTTC	CASSYCAKQGSYEQYF	TRBV6-5	TRBJ2-7
TGTGCCAGCAGCACGACTAGCGGGGGGGCCCACACCGGGGAGCTGTTTTTT	CASSTTSGGAHTGELFF	TRBV13	TRBJ2-2
TGTGCCAGCAGGGGGAGACAGAATAATCAGCCCCAGCATTTT	CASRGRQNNQPQHF	TRBV6-2	TRBJ1-5
TGTGCCAGCACAGGGGACGATGGCTACACCTTC	CASTGDDGYTF	TRBV6-6	TRBJ1-2
TGTGCCAGCAGGACACCTTACAATGAGCAGTTCTTC	CASRTPYNEQFF	TRBV28	TRBJ2-1
TGCAGTGCTGTTCGGGACACCTACGAGCAGTACTTC	CSAVRDTYEQYF	TRBV20-1	TRBJ2-7
TGTGCCAGCAGTAAAACACAGGGACCTAGCGAGCAGTACTTC	CASSKTQGPSEQYF	TRBV6-5	TRBJ2-7
TGTGCCAGCAGTTTACCCGGACAGGGGAGCAATCAGCCCCAGCATTTT	CASSLPGQGSNQPQHF	TRBV28	TRBJ1-5
TGTGCCAGCAGTGTCCAGCGTTATGGCTACACCTTC	CASSVQRYGYTF	TRBV6-6	TRBJ1-2
TGCAGTGCTAGACCCCGGCTGGAGACCGGGGAGCTGTTTTTT	CSARPRLETGELFF	TRBV20-1	TRBJ2-2
TGTGCCAGTAGTCGTACCAGTAACCCGACCTACGAGCAGTACTTC	CASSRTSNPTYEQYF	TRBV19	TRBJ2-7
TGTGCTAGTGGTACTCTTAATTCCTATGACACAGGGGATGAAAAACTGTTTTTT	CASGTLNSYDTGDEKLFF	TRBV12-5	TRBJ1-4
TGCGCCAGCAGCTCTCCCCGTAACAGGGCCGGCTACACCTTC	CASSSPRNRAGYTF	TRBV5-1	TRBJ1-2
TGTGCCAGCGGGGAGGCCCAGCATTTT	CASGEAQHF	TRBV7-9	TRBJ1-5
TGTGCCAGCAGCCAAGCCGAAGAAGGGACAGGGTTCCGCGTTGTGAGCACTGAAGCTTTCTTT	CASSQAEEGTGFRVVSTEAFF	TRBV3-1	TRBJ1-1
TGTGCCAGCAGTTTAAGCGGGAACGAGATATATTTT	CASSLSGNEIYF	TRBV28	TRBJ1-3
TGTGCCAGCAGCTTAGTGGGGGCGAACTACGAGCAGTACTTC	CASSLVGANYEQYF	TRBV7-3	TRBJ2-7
TGTGCCAGCAGCCCAGGACGAGCCGCTTTCTTT	CASSPGRAAFF	TRBV6-3	TRBJ1-1
TGTGCCAGCAGCGTAGTACCAGGGGGGAACCCTCATCAGCCCCAGCATTTT	CASSVVPGGNPHQPQHF	TRBV9	TRBJ1-5
TGTGCCAGCAGTGCCACAGGGTTGGAGCAGTACTTC	CASSATGLEQYF	TRBV6-1	TRBJ2-7
TGTGCCAGCAGTTCGGGACGGGGGGACACTGAAGCTTTCTTT	CASSSGRGDTEAFF	TRBV28	TRBJ1-1
TGTGCCAGCAGCGCCTGGACAGTTGACACCTACGAGCAGTACTTC	CASSAWTVDTYEQYF	TRBV6-6	TRBJ2-7
TGTGCCACCAGTGAAACTAGGACAGGGGGGCTCAATCAGCCCCAGCATTTT	CATSETRTGGLNQPQHF	TRBV24-1	TRBJ1-5
TGTGCCAGCAGCCAAGATTCAAGGGGGGGGGAAGCTTTCTTT	CASSQDSRGGEAFF	TRBV3-1	TRBJ1-1
TGTGCCAGCAGCGGGGGGGCCTACGAGCAGTACTTC	CASSGGAYEQYF	TRBV11-2	TRBJ2-7
TGTGCCAGTAGTATAGGGGTTCGCGGCTGGGCTGAAGCTTTCTTT	CASSIGVRGWAEAFF	TRBV19	TRBJ1-1
TGTGCCAGCAGCTTGGTTCCCACTCTAGGGGGGGATTCCCTCCACTTT	CASSLVPTLGGDSLHF	TRBV5-4	TRBJ1-6
TGTGCCAGCAGCTTACATATCCGAGGGAAGCGGGACGTTGCCAAAAACATTCAGTACTTC	CASSLHIRGKRDVAKNIQYF	TRBV11-2	TRBJ2-4
TGCGCCAGCAGCTTGGGTAGGGAGGGAGGTGAGCAGTTCTTC	CASSLGREGGEQFF	TRBV5-1	TRBJ2-1
TGTGCCATCGGCGACTCTTTCGGCACAGATACGCAGTATTTT	CAIGDSFGTDTQYF	TRBV10-3	TRBJ2-3
TGTGCCAGCAGTTTATCGCTAGCGGGTGCCTCCCGGGTAGAGCAGTACTTC	CASSLSLAGASRVEQYF	TRBV27	TRBJ2-7
TGCGCCAGCAGCCAAGCAGGGTTTGACGGGTCCTACGAGCAGTACTTC	CASSQAGFDGSYEQYF	TRBV4-1	TRBJ2-7
TGTGCCAGCAGCATGTGGCGGGACAGGGGGGTCCTGGCGGCCAACTATGGCTACACCTTC	CASSMWRDRGVLAANYGYTF	TRBV7-4	TRBJ1-2
TGTGCCACCAGCAGCCTGGGGGGGGACCCTGAGCAGTTCTTC	CATSSLGGDPEQFF	TRBV24-1	TRBJ2-1
TGCGCCAGCTTGGCGAGACAGGGGTTAGGCACTGGGGCCAACGTCCTGACTTTC	CASLARQGLGTGANVLTF	TRBV5-1	TRBJ2-6
TGCGCCAGCAGCCAAGATCAGGCGCGCAGGGGGCGCGGGAAGACCCAGTACTTC	CASSQDQARRGRGKTQYF	TRBV4-1	TRBJ2-5
TGTGCCAGCAGCTTACCGTGGGGGCTATCCTCCAACCGCTCCTACGAGCAGTACTTC	CASSLPWGLSSNRSYEQYF	TRBV11-2	TRBJ2-7
TGTGCCAGCAGCTTACAGTTAGGGGGCAGGGAGGTGAACACTGAAGCTTTCTTT	CASSLQLGGREVNTEAFF	TRBV7-3	TRBJ1-1
TGTGCCAGCAGTGCCGGGGCTAATGAAAAACTGTTTTTT	CASSAGANEKLFF	TRBV25-1	TRBJ1-4
TGTGCCAGAACAGGAAGGGGGTACGAGCAGTACTTC	CARTGRGYEQYF	TRBV19	TRBJ2-7
TGTGCCAGCAGCGGGGTATATGGCTACACCTTC	CASSGVYGYTF	TRBV14	TRBJ1-2
TGTGCCAGCATACCCCTGGGTCCCCAGTTAGTGAACACTGAAGCTTTCTTT	CASIPLGPQLVNTEAFF	TRBV25-1	TRBJ1-1
TGCGCCAGCAGCTTGGCAGCATGGGACGAGCAGTACTTC	CASSLAAWDEQYF	TRBV5-1	TRBJ2-7
TGCGCCAGCAGGTGGCTTTACACTGAAGCTTTCTTT	CASRWLYTEAFF	TRBV10-1	TRBJ1-1
TGTGCCAGCAGCGTCGGGGGGGGACAAGAGACCCAGTACTTC	CASSVGGGQETQYF	TRBV6-4	TRBJ2-5
TGTGCCAGCAGCATTCACCTACTAGCGGGAGGGCATCTGAACACTGAAGCTTTCTTT	CASSIHLLAGGHLNTEAFF	TRBV6-4	TRBJ1-1
TGTGCCAGCAGTAAGCGGGAACCAGGGCTCTCTGGAAACACCATATATTTT	CASSKREPGLSGNTIYF	TRBV27	TRBJ1-3
TGTGCCAGCAGCGTACTAAACTGGGCCGGGAGCTCCTACAATGAGCAGTTCTTC	CASSVLNWAGSSYNEQFF	TRBV9	TRBJ2-1
TGTGCCAGCAGCTTTTCGGGACAGGGGGGGGACAATCAGCCCCAGCATTTT	CASSFSGQGGDNQPQHF	TRBV5-6	TRBJ1-5
TGCGCCAGCAGCTCGTTTTGTACGGGAGAGACCCAGTACTTC	CASSSFCTGETQYF	TRBV5-1	TRBJ2-5
TGTGCCAGCAGCTTAGCCCGGGCCCGGTCGTACGAGCAGTACTTC	CASSLARARSYEQYF	TRBV7-6	TRBJ2-7
TGTGCCAGCAGAATGAGTGCGAACACCGGGGAGCTGTTTTTT	CASRMSANTGELFF	TRBV6-6	TRBJ2-2
TGTGCCAGCAGTGAATGGGGGACACGGGGCCGGCCTAGCACAGATACGCAGTATTTT	CASSEWGTRGRPSTDTQYF	TRBV6-8	TRBJ2-3
TGTGCCAGCAGTTATAGCGGGGCCGGGGAGCTGTTTTTT	CASSYSGAGELFF	TRBV28	TRBJ2-2
TGTGCCAGCAGATCCATGGGCAGTGAGGGCGTATCCTACGAGCAGTACTTC	CASRSMGSEGVSYEQYF	TRBV12-3	TRBJ2-7
TGCGCCAGCAACCCCCTTAGGGACCGGTACTCCTACGAGCAGTACTTC	CASNPLRDRYSYEQYF	TRBV4-1	TRBJ2-7
TGTGCCAGAAGTCCGGGACAGGGCCTCAACTATGGCTACACCTTC	CARSPGQGLNYGYTF	TRBV19	TRBJ1-2
TGTGCCAGCAGCGGGCAGGGGGCGCCATCCTACGAGCAGTACTTC	CASSGQGAPSYEQYF	TRBV7-4	TRBJ2-7
TGTGCCAGCAGCCACAGAATGTCCGGACAGGGGATCTCTGGAAACACCATATATTTT	CASSHRMSGQGISGNTIYF	TRBV14	TRBJ1-3
TGTGCCACCAGAGATAGGGAAACTTCCTACGAGCAGTACTTC	CATRDRETSYEQYF	TRBV24-1	TRBJ2-7
TGTGCCAGCTCCCTAAAGGTCCGGATCAGCAGGGGGCTAAGCAAGAACTATGGCTACACCTTC	CASSLKVRISRGLSKNYGYTF	TRBV27	TRBJ1-2
TGCAGTGCTAGAGAGAGGGGCCGCACAGATACGCAGTATTTT	CSARERGRTDTQYF	TRBV20-1	TRBJ2-3
TGTGCCACCGACCGGGAACCGAGGGGCTATGAGCAGTTCTTC	CATDREPRGYEQFF	TRBV24-1	TRBJ2-1
TGTGCCAGCAGTTGGGACAGAGAGGGGGGCAATCAGCCCCAGCATTTT	CASSWDREGGNQPQHF	TRBV28	TRBJ1-5
TGTGCCAGCAGCTTAGTAGGGACTAGGGATTTAGCAGATACGCAGTATTTT	CASSLVGTRDLADTQYF	TRBV11-2	TRBJ2-3
TGTGCCAGCTTAGGAAGACAGGGGAGCTACGAGCAGTACTTC	CASLGRQGSYEQYF	TRBV13	TRBJ2-7
TGCGCCAGCAGCTGTGGGTCCAATCGCCATGAAGCTTTCTTT	CASSCGSNRHEAFF	TRBV5-1	TRBJ1-1
TGTGCCAGCAGAGGGCATTTGACTAGAGAGGCAAAGACAGATACGCAGTATTTT	CASRGHLTREAKTDTQYF	TRBV6-5	TRBJ2-3
TGTGCCAGCAGCTTAGGCGTTAGCAGGGGAACCGGAAACACCATATATTTT	CASSLGVSRGTGNTIYF	TRBV7-4	TRBJ1-3
TGTGCCTCTGCAAGACGGAAAAACATTCAGTACTTC	CASARRKNIQYF	TRBV28	TRBJ2-4
TGTGCCAGCAGCTTAGTCCAAGGGTTAGGTGAAAAACTGTTTTTT	CASSLVQGLGEKLFF	TRBV7-6	TRBJ1-4
TGCGCCAGCAGTGTAAGTGGACGGGAGACCCAGTACTTC	CASSVSGRETQYF	TRBV10-1	TRBJ2-5
TGCAGTGCTAGCTGGGGTGACTACGAGCAGTACTTC	CSASWGDYEQYF	TRBV20-1	TRBJ2-7
TGTGCCAGCAGCGCCACGGGTCAGGGGGAAAAACTGTTTTTT	CASSATGQGEKLFF	TRBV13	TRBJ1-4
TGTGCCAGTAGTATTCCGACCGGACGATTAGCTAGCACAGATACGCAGTATTTT	CASSIPTGRLASTDTQYF	TRBV19	TRBJ2-3
TGTGCCAGCAGTTACAGGGACAGACCTCTCGCATTTCCAGAATATAATAATTCACCCCTCCACTTT	CASSYRDRPLAFPEYNNSPLHF	TRBV6-5	TRBJ1-6
TGTGCCAGCAGTGTCCCGGGACTAGCCTCCTACGAGCAGTACTTC	CASSVPGLASYEQYF	TRBV6-1	TRBJ2-7
TGTGCCAGCACCCAGATCTTGGCAGGGCTGCCGCAAGAGACCCAGTACTTC	CASTQILAGLPQETQYF	TRBV6-1	TRBJ2-5
TGTGGAAGGGACAGATACTACTCCTACGAGCAGTACTTC	CGRDRYYSYEQYF	TRBV12-3	TRBJ2-7
TGTGCCAGCAGCTTAAACGGCGGGGCCCCGTATGGCTACACCTTC	CASSLNGGAPYGYTF	TRBV11-2	TRBJ1-2
TGTGCCAGCAGCTGGACTCCGGGACGGAACAATCAGCCCCAGCATTTT	CASSWTPGRNNQPQHF	TRBV11-2	TRBJ1-5
TGTGCCAGCAGCCAGCCAAGGGAGGGAGGGGAACCCGGTGAAGCTTTCTTT	CASSQPREGGEPGEAFF	TRBV14	TRBJ1-1
TGCGCCAGCAGCGTTCGGGGGGGCAGGCTGGGGGAGCTGTTTTTT	CASSVRGGRLGELFF	TRBV5-1	TRBJ2-2
TGTGCCAGCAGCTCTAGGGACAGAGGCGTGGCAGATACGCAGTATTTT	CASSSRDRGVADTQYF	TRBV5-6	TRBJ2-3
TGTGCCAGCAGCTCGGGGGACAGGGGCTACGAGCAGTACTTC	CASSSGDRGYEQYF	TRBV7-2	TRBJ2-7
TGTGCCAGCAGTTTTAAGTTCAGGCGGCCCCAGCATTTT	CASSFKFRRPQHF	TRBV27	TRBJ1-5
TGTGCCAGCACCGGGGGGGGGGCTGCCCAGTACTTC	CASTGGGAAQYF	TRBV7-9	TRBJ2-5
TGTGCCAGCAGCTGGACCGACAACCGAAAGAGTACTGAAGCTTTCTTT	CASSWTDNRKSTEAFF	TRBV7-9	TRBJ1-1
TGTGCCAGCAGCTCCCCTCGGGACAGGGACGTAAACACTGAAGCTTTCTTT	CASSSPRDRDVNTEAFF	TRBV7-3	TRBJ1-1
TGTGCCAGCAGCCAGCAGCGGCCAGACAATGAGCAGTTCTTC	CASSQQRPDNEQFF	TRBV14	TRBJ2-1
TGTGCCAGCAGAAAATCCGGGACAGGGGCAGTAACCGGGGAGCTGTTTTTT	CASRKSGTGAVTGELFF	TRBV25-1	TRBJ2-2
TGTGCCAAAGCGGGAACGGAATTGAACACTGAAGCTTTCTTT	CAKAGTELNTEAFF	TRBV6-4	TRBJ1-1
TGCGCCAGCAGTGAGTGGAGGACAGGGGCGCAGTACTTC	CASSEWRTGAQYF	TRBV10-1	TRBJ2-7
TGTGCCAGCTCACCATACTATGGAGGTTGCCAGCCCCAGCATTTT	CASSPYYGGCQPQHF	TRBV18	TRBJ1-5
TGTGCCAGAACCCAACCGGGACTAGCGGTGGCCGGGGAGCTGTTTTTT	CARTQPGLAVAGELFF	TRBV19	TRBJ2-2
TGCGCCAGCAGCCAAGATCTCGGGTTACGCTACGAGCAGTACTTC	CASSQDLGLRYEQYF	TRBV4-3	TRBJ2-7
TGCGCCAGCAGCTTGCAGGGTGACGAGCAGTACTTC	CASSLQGDEQYF	TRBV5-1	TRBJ2-7
TGTGCCAGCAGCTTAAGGAGGCTCGGACAGGGGGCAAATACCAGGGCCAACGTCCTGACTTTC	CASSLRRLGQGANTRANVLTF	TRBV7-9	TRBJ2-6
TGCGCCAGCAGTGCTGGGACTGCAACTAATGAAAAACTGTTTTTT	CASSAGTATNEKLFF	TRBV10-1	TRBJ1-4
TGTGCCAGCAGTTATGTAGCGGGTAAACCTTACAATGAGCAGTTCTTC	CASSYVAGKPYNEQFF	TRBV6-9	TRBJ2-1
TGCGCCAGCAGCCAAACCTATGGCGGGAGCTTCCAACACTATGGCTACACCTTC	CASSQTYGGSFQHYGYTF	TRBV4-3	TRBJ1-2
TGTGCCAGCAGCGTCCAACGGGACTTTATTGCTCAGCCCCAGCATTTT	CASSVQRDFIAQPQHF	TRBV9	TRBJ1-5
TGCGCCAGCAGCTTGGTAGCAGAGCAGTACTTC	CASSLVAEQYF	TRBV5-1	TRBJ2-7
TGTGCCACCAGTGCCCCGGGGAGGCATGAGCAGTTCTTC	CATSAPGRHEQFF	TRBV24-1	TRBJ2-1
TGTGCCAGCAGCTGGGACTGGGCCACTGAAGCTTTCTTT	CASSWDWATEAFF	TRBV7-2	TRBJ1-1
TGTGCCAGCAGCGAAGAGGACAGGGAAGGTAAGCTAGCTTTCTTT	CASSEEDREGKLAFF	TRBV7-9	TRBJ1-1
TGTGCCAGCAGTCAGGGGCTACCCTCCTACGAGCAGTACTTC	CASSQGLPSYEQYF	TRBV12-3	TRBJ2-7
TGTGCCCCGCCGGACAGACGAGGTGGCTACACCTTC	CAPPDRRGGYTF	TRBV15	TRBJ1-2
TGTGCCAGCAGGTATAGCGGGGGGCTATATACGCAGTATTTT	CASRYSGGLYTQYF	TRBV6-2	TRBJ2-3
TGCGCCAGCAGATTTGACCTATTGAACACTGAAGCTTTCTTT	CASRFDLLNTEAFF	TRBV10-1	TRBJ1-1
TGCAGTGCTAGAGGAAGAAGAGGGTACGAGCAGTACTTC	CSARGRRGYEQYF	TRBV20-1	TRBJ2-7
TGCAGTGCTAGAGACCCCCCGGGCACAGATACGCAGTATTTT	CSARDPPGTDTQYF	TRBV20-1	TRBJ2-3
TGTGCCAGCAGCGAAAGCGAAGGAACAGTTTCCATAGACAATGAGCAGTTCTTC	CASSESEGTVSIDNEQFF	TRBV9	TRBJ2-1
TGCAGCGTTGAGGTCCGGGACAGGGGACAAAAACTGTTTTTT	CSVEVRDRGQKLFF	TRBV29-1	TRBJ1-4
TGCAGTAGTAGAGTAAGAGAAAAACTGTTTTTT	CSSRVREKLFF	TRBV20-1	TRBJ1-4
TGTGCCAGCAGTTATGTCGGCTGGCTAGCCCGTACGCAGTATTTT	CASSYVGWLARTQYF	TRBV6-5	TRBJ2-3
TGCAGTGCTCTAGCCTACGAGCAGTACTTC	CSALAYEQYF	TRBV20-1	TRBJ2-7
TGTGCCAGCAGCCGTTACCAGGGGTGGAACTATGGCTACACCTTC	CASSRYQGWNYGYTF	TRBV7-2	TRBJ1-2
TGCAGCGTTGAGCGCGGGAGGAGACCCCCCGAGGGGGCCAACGTCCTGACTTTC	CSVERGRRPPEGANVLTF	TRBV29-1	TRBJ2-6
TGTGCTAGTGGTTTGGTACGCAATCGTAGCGGGTTCCATAACAACACCGGGGAGCTGTTTTTT	CASGLVRNRSGFHNNTGELFF	TRBV12-5	TRBJ2-2
TGTGCCAGCACCGGGACACATGGCTACACCTTC	CASTGTHGYTF	TRBV7-3	TRBJ1-2
TGTGCCAGCAGCAACCCTCCAACTAGCGGGAGCACGCTTCACGAGCAGTACTTC	CASSNPPTSGSTLHEQYF	TRBV5-5	TRBJ2-7
TGCAGTGCTAGAGATGCCGGTTCTTACACTAGCGGGAGTCTCGGTTATTACGAGCAGTACTTC	CSARDAGSYTSGSLGYYEQYF	TRBV20-1	TRBJ2-7
TGTGCCAGCAGTGAAACACCGACAGGGGCCAACGTCCTGACTTTC	CASSETPTGANVLTF	TRBV6-1	TRBJ2-6
TGTGCCAGCAGCTCCCTATTTGGCGAGACCCAGTACTTC	CASSSLFGETQYF	TRBV7-6	TRBJ2-5
TGTGCCAGCAGTGAAGGACAGAGGTGTGAGCAGTTCTTC	CASSEGQRCEQFF	TRBV25-1	TRBJ2-1
TGTGCCAGCTCACCACGAGCGGGATTGGCAGATACGCAGTATTTT	CASSPRAGLADTQYF	TRBV18	TRBJ2-3
TGCGCCAGCGAAGACAGGGGGCAACCTTCCCACGGAGACTCCTACAATGAGCAGTTCTTC	CASEDRGQPSHGDSYNEQFF	TRBV4-1	TRBJ2-1
TGTGCCAGCAGCAGTATGATCCGCAGGGGCACAGATACGCAGTATTTT	CASSSMIRRGTDTQYF	TRBV13	TRBJ2-3
TGTGCCAGCAGTAGTCGTCGGGCGCGGGTTGGAAACACCATATATTTT	CASSSRRARVGNTIYF	TRBV28	TRBJ1-3
TGTGCCAGCAGTCCCCCGAGCGGGAGAGTTCAGCCCCAGCATTTT	CASSPPSGRVQPQHF	TRBV27	TRBJ1-5
TGTGCCAGCAGGCGGGACGGGGTGCAGTATTTT	CASRRDGVQYF	TRBV6-1	TRBJ2-3
TGTGCCAGCAGCTTAATCGGGAAGCGGGTCCGCTTATGTGAAGCTTTCTTT	CASSLIGKRVRLCEAFF	TRBV11-2	TRBJ1-1
TGTGCCAGCAGCAGGCTTATCGGCTACACCTTC	CASSRLIGYTF	TRBV7-3	TRBJ1-2
TGTGCCACAAAGGAGGGGGAGCAGTACTTC	CATKEGEQYF	TRBV7-6	TRBJ2-7
TGCGCCAGCAGTGAGTGGCTAGCGGGCTTCACAGATACGCAGTATTTT	CASSEWLAGFTDTQYF	TRBV10-1	TRBJ2-3
TGTGCCAGCAGCCTAGAAGGTTATACGCAGTATTTT	CASSLEGYTQYF	TRBV11-2	TRBJ2-3
TGTGCCAGTGATCGAGAGCGGGAGAAGCAAGAGACCCAGTACTTC	CASDREREKQETQYF	TRBV6-2	TRBJ2-5
TGTGCCAGCAGACTAGCGGGCGGGGAGGGAGGGGACAATGAGCAGTTCTTC	CASRLAGGEGGDNEQFF	TRBV11-3	TRBJ2-1
TGTGCCAGCAGCCCGGGGGGACTCCTTAATGAAAAACTGTTTTTT	CASSPGGLLNEKLFF	TRBV7-8	TRBJ1-4
TGCGCCAGCAGCTTCCCGGACAGGGCGGACACTGAAGCTTTCTTT	CASSFPDRADTEAFF	TRBV5-1	TRBJ1-1
TGTGCCAGCAGCACCTGCGGGACACCCCATTCACCCCTCCACTTT	CASSTCGTPHSPLHF	TRBV9	TRBJ1-6
TGTGCCAGCAGCTTAACGGTACCCGGAGGGGGCACTGAAGCTTTCTTT	CASSLTVPGGGTEAFF	TRBV7-3	TRBJ1-1
TGTGCCAGCAGTTATGACCATCAGCCCCAGCATTTT	CASSYDHQPQHF	TRBV5-5	TRBJ1-5
TGTGCCAGCAACATTACCTACCGTGGAGACAATGAGCAGTTCTTC	CASNITYRGDNEQFF	TRBV5-5	TRBJ2-1
TGTGCCAGCAGCTCAAGTAGGATCACTAGAAGCACAGATACGCAGTATTTT	CASSSSRITRSTDTQYF	TRBV7-2	TRBJ2-3
TGTGCCAGTAGTATGGCAACAAATTCACCCCTCCACTTT	CASSMATNSPLHF	TRBV19	TRBJ1-6
TGTGCCAGCAGTCCTCTAAAGGGGATTAGGTCGAGGATAGTTAACTATGGCTACACCTTC	CASSPLKGIRSRIVNYGYTF	TRBV7-3	TRBJ1-2
TGTGCCAGCATAGAACAACCGGGACAGGGAGGAGAGACCCAGTACTTC	CASIEQPGQGGETQYF	TRBV9	TRBJ2-5
TGCGCCAGCAGATTTCGGGGGACAGGGTTGGACACTGAAGCTTTCTTT	CASRFRGTGLDTEAFF	TRBV5-1	TRBJ1-1
TGCGCCAGGGTAAAGCTTCCGGAAGGGGCGGGGGAGACCCAGTACTTC	CARVKLPEGAGETQYF	TRBV10-1	TRBJ2-5
TGTGCCAGCAGTTTAATTCCCGGGGGACGGTATGAAGCTTTCTTT	CASSLIPGGRYEAFF	TRBV28	TRBJ1-1
TGTGCCAGCAGTAGGTGGCCAACAGGACTAGTACTATTTACCAATGAGCAGTTCTTC	CASSRWPTGLVLFTNEQFF	TRBV6-1	TRBJ2-1
TGTGGAGGACAGGGGGGCTACGAGCAGTACTTC	CGGQGGYEQYF	TRBV24-1	TRBJ2-7
TGTGCCAGCAGCAGTTTAGGACTAGCGGGACCCCCCTCCTACAATGAGCAGTTCTTC	CASSSLGLAGPPSYNEQFF	TRBV7-9	TRBJ2-1
TGCAGCGTTGAGGACAGGGCCCGGAATTCACCCCTCCACTTT	CSVEDRARNSPLHF	TRBV29-1	TRBJ1-6
TGTGCCAGCAGCGGGGGACCGACCCCCCATAATTCACCCCTCCACTTT	CASSGGPTPHNSPLHF	TRBV5-4	TRBJ1-6
TGTGCCAGTAGTATAGGGAGGGGGATATGGGAATTCGCCTACGAGCAGTACTTC	CASSIGRGIWEFAYEQYF	TRBV19	TRBJ2-7
TGTGCCAGCAGCCAAGCGCTGAGCGTGATGAAAAACACCATATATTTT	CASSQALSVMKNTIYF	TRBV14	TRBJ1-3
TGTGCCAGGATCCGGACCGCCCCAGGGCCCATTGAAGTAACTAATGAAAAACTGTTTTTT	CARIRTAPGPIEVTNEKLFF	TRBV19	TRBJ1-4
TGTGCCCAGACAGGGAGATTCTATGGCTACACCTTC	CAQTGRFYGYTF	TRBV19	TRBJ1-2
TGTGCCAGCAGCTTCGGGACTAGCGGGAGGATGTACGAGCAGTACTTC	CASSFGTSGRMYEQYF	TRBV11-3	TRBJ2-7
TGCGCCAGCAGCCTTCGACACCCATGGCGCTCTGGGGCCAACGTCCTGACTTTC	CASSLRHPWRSGANVLTF	TRBV5-1	TRBJ2-6
TGTGCCACCAGCAGAGCCCGTTTCCGGGACAATCAGCCCCAGCATTTT	CATSRARFRDNQPQHF	TRBV15	TRBJ1-5
TGCCCTCTATATGGGCATAGCAATCAGCCCCAGCATTTT	CPLYGHSNQPQHF	TRBV5-1	TRBJ1-5
TGTGCCAGCAGCTTAGCGCTCCCCGGGACAGGTAGCAATCAGCCCCAGCATTTT	CASSLALPGTGSNQPQHF	TRBV7-9	TRBJ1-5
TGTGCCAGCAGTGAAGACGGGGGGCTGGAAGATAATTCACCCCTCCACTTT	CASSEDGGLEDNSPLHF	TRBV6-1	TRBJ1-6
TGTGCCATCCACGGACATAGCAATCAGCCCCAGCATTTT	CAIHGHSNQPQHF	TRBV10-3	TRBJ1-5
TGCAGTGGAATCACAGATACGCAGTATTTT	CSGITDTQYF	TRBV20-1	TRBJ2-3
TGTGCCAGCAGGAGGACAGGGCTTTCACCCCTCCACTTT	CASRRTGLSPLHF	TRBV6-5	TRBJ1-6
TGTGCCAGCAGTTTTAGCACAGATACGCAGTATTTT	CASSFSTDTQYF	TRBV28	TRBJ2-3
TGTGCCAGCAGCCAAGCCCGAACAGGGATAGGGGGAAATGTCAACTTC	CASSQARTGIGGNVNF	TRBV14	TRBJ2-7
TGTGCCAGCAGTTTATTGCACGGGACGGGCTACGAGCAGTACTTC	CASSLLHGTGYEQYF	TRBV28	TRBJ2-7
TGTGCCAGCAGCTCCCGGGACAGCCGATCGAACTATGGCTACACCTTC	CASSSRDSRSNYGYTF	TRBV7-3	TRBJ1-2
TGTGCCATTACCATGGCCGGGACAGGGCAGCCCCAGCATTTT	CAITMAGTGQPQHF	TRBV6-4	TRBJ1-5
TGTGCCAGCAGAACTGCGACGAGACCGGGCGATGAAGCTTTCTTT	CASRTATRPGDEAFF	TRBV6-6	TRBJ1-1
TGTGCCAGCAGCCAAGATTTATTCCCGGGACACTATGGCTACACCTTC	CASSQDLFPGHYGYTF	TRBV3-1	TRBJ1-2
TGTGCCAGCTCCAGTAGTCGGGGTGGGGCCAACGTCCTGACTTTC	CASSSSRGGANVLTF	TRBV7-4	TRBJ2-6
TGTGCCAGCAGCAATTTTAGGGGAGGGCAAGAGACCCAGTACTTC	CASSNFRGGQETQYF	TRBV5-4	TRBJ2-5
TGTGCCAGCAGCTTAGTTTCGGCACGGGACGGAAAGCAGCCCCAGCATTTT	CASSLVSARDGKQPQHF	TRBV11-3	TRBJ1-5
TGTGCCAGCAGTGACACACCGTTATGCGGGAGGGGGGTCCCTAACTATGGCTACACCTTC	CASSDTPLCGRGVPNYGYTF	TRBV6-4	TRBJ1-2
TGTGCCAGCAGTTTCGTATCCTACAATGAGCAGTTCTTC	CASSFVSYNEQFF	TRBV28	TRBJ2-1
TGTGCCAGCTCACCACCCGGGACTAGCGGGGGCAAAAACATTCAGTACTTC	CASSPPGTSGGKNIQYF	TRBV18	TRBJ2-4
TGTGCCAGCAATCGAGACCAGGGCCTATTGACCCAGTACTTC	CASNRDQGLLTQYF	TRBV7-3	TRBJ2-5
TGTGCCAGCTCGGCTAGGTTATACGAGCAGTACTTC	CASSARLYEQYF	TRBV9	TRBJ2-7
TGTGCCAGCAGCGACATCAGGGGGCGGTTAGTGAAAGAGACCCAGTACTTC	CASSDIRGRLVKETQYF	TRBV9	TRBJ2-5
TGCGCCAGCAGCCAAGATTGGACACCTTTCTATGGCTACACCTTC	CASSQDWTPFYGYTF	TRBV4-1	TRBJ1-2
TGTGCCAGTAGTATTTCAATACACGAGCAGTACTTC	CASSISIHEQYF	TRBV19	TRBJ2-7
TGTGCCAGCAGCTTAACCTTACTAGCGGGAGACGAGCAGTACTTC	CASSLTLLAGDEQYF	TRBV5-4	TRBJ2-7
TGTGCCAGCAGCCAAGACCCCGGGTTCAGCTCCTACGAGCAGTACTTC	CASSQDPGFSSYEQYF	TRBV3-1	TRBJ2-7
TGTGCCAGCAGTCATGGGCACCAGGGCTGCTACGAGCAGTACTTC	CASSHGHQGCYEQYF	TRBV27	TRBJ2-7
TGCAGCGTTGAAGAGAGGAAGGGGCAAGAGACCCAGTACTTC	CSVEERKGQETQYF	TRBV29-1	TRBJ2-5
TGTGCCAGCAGCGTGGACAGGGCCTACAATGAGCAGTTCTTC	CASSVDRAYNEQFF	TRBV9	TRBJ2-1
TGTGCCAGCAGTGGGGACTCGGCCCAGTACTTC	CASSGDSAQYF	TRBV6-4	TRBJ2-5
TGTGCCAGTAGTATAATGAATAGGCCTCAGCCCCAGCATTTT	CASSIMNRPQPQHF	TRBV19	TRBJ1-5
TGCGCCAGCAGCATCTCTAGCGGGGGGAATGAGCAGTTCTTC	CASSISSGGNEQFF	TRBV5-1	TRBJ2-1
TGTGCCAGCAGCGTCGTGGACAGGGATCAGGCCTACGAGCAGTACTTC	CASSVVDRDQAYEQYF	TRBV9	TRBJ2-7
TGTGCCAGCAGCTGTCCACCGGGACAGACGAAGTACCAAGAGACCCAGTACTTC	CASSCPPGQTKYQETQYF	TRBV7-4	TRBJ2-5
TGTGCCAGCAGCTTGGGGACCGACAGGGGCTACGAGCAGTACTTC	CASSLGTDRGYEQYF	TRBV5-8	TRBJ2-7
TGTGCCAGCAGCAACCAATTGACAGGGCTGGCTGGCTACACCTTC	CASSNQLTGLAGYTF	TRBV11-3	TRBJ1-2
TGTGCTAGTGGTTCTCCTAGACAGGGGGCGGGCAATCAGCCCCAGCATTTT	CASGSPRQGAGNQPQHF	TRBV12-5	TRBJ1-5
TGTGCCAGCAGCCCCGACTGGCTACTAGCGGGAGGGCACTGGCAAGAGACCCAGTACTTC	CASSPDWLLAGGHWQETQYF	TRBV5-4	TRBJ2-5
TGTGCCAGCCGAGGGACTAGCGGGCGGGAGCAGTACTTC	CASRGTSGREQYF	TRBV6-1	TRBJ2-7
TGTGCCAGCAAGATCCCGGCGGGACTAGCGGTTTCGGGCACAGATACGCAGTATTTT	CASKIPAGLAVSGTDTQYF	TRBV6-5	TRBJ2-3
TGTGCCACCAGCCAGCGGGATAATGCCACAGATACGCAGTATTTT	CATSQRDNATDTQYF	TRBV24-1	TRBJ2-3
TGTGCTAGTGGTTTTATAGAGACCTACGACTACGAGCAGTACTTC	CASGFIETYDYEQYF	TRBV12-5	TRBJ2-7
TGCGCCAGCAGTGAGTCGGTTGGGGGGACAGCCTATGGCTACACCTTC	CASSESVGGTAYGYTF	TRBV10-1	TRBJ1-2
TGTGCCAGCAGCGAATGTACGAGGGGAGTTATGAACACTGAAGCTTTCTTT	CASSECTRGVMNTEAFF	TRBV7-3	TRBJ1-1
TGTGCTAGCAGCTTCAATGCGGGACTAGAGACCCAGTACTTC	CASSFNAGLETQYF	TRBV7-7	TRBJ2-5
TGTGCCAGCAGCTTTACCCCCGTGAAAACATCCGAAGAGACCCAGTACTTC	CASSFTPVKTSEETQYF	TRBV7-7	TRBJ2-5
TGTGCCAGCAGCCTCGCCAAAAGGACGCGCCACCAGCCCCAGCATTTT	CASSLAKRTRHQPQHF	TRBV7-2	TRBJ1-5
TGTGCCAGCAGTGAGTTGGGACAGGAAAAACTGTTTTTT	CASSELGQEKLFF	TRBV6-2	TRBJ1-4
TGCAGCGTGGTACAGAGCTACGAGCAGTACTTC	CSVVQSYEQYF	TRBV29-1	TRBJ2-7
TGTGCCAGCAGCGAGGGGGGGAACACTGAAGCTTTCTTT	CASSEGGNTEAFF	TRBV13	TRBJ1-1
TGTGCCAGCATGCTAGCGGGCTACAATGAGCAGTTCTTC	CASMLAGYNEQFF	TRBV11-1	TRBJ2-1
TGTGCCAGCAGAGGATTGAGTGCAACTAATGAAAAACTGTTTTTT	CASRGLSATNEKLFF	TRBV28	TRBJ1-4
TGTGCCAGCAGTGTGACAGGGGGCAATCAGCCCCAGCATTTT	CASSVTGGNQPQHF	TRBV25-1	TRBJ1-5
TGTGCCAGCAGCACCGGGGGGGCCAGCTCCTACAATGAGCAGTTCTTC	CASSTGGASSYNEQFF	TRBV7-2	TRBJ2-1
TGTGCCAGCAGCCAAAGAAGCCAGGGGGCCGAGAACCAAGAGACCCAGTACTTC	CASSQRSQGAENQETQYF	TRBV7-7	TRBJ2-5
TGTGCCAGCATCGGCCGAGCGGGAGCTCCGGAGGGCTACGAGCAGTACTTC	CASIGRAGAPEGYEQYF	TRBV28	TRBJ2-7
TGTGCCAGCAGCCCAAATCGTCCGGGCGACACTAGCTCTGGGGCCAACGTCCTGACTTTC	CASSPNRPGDTSSGANVLTF	TRBV7-3	TRBJ2-6
TGTGCCAGCAGTGACCCGGGGACTAGCGGGCGCAATGAGCAGTTCTTC	CASSDPGTSGRNEQFF	TRBV6-4	TRBJ2-1
TGTGCCAGCAGCTTGTCCAGGGCAGAGCAGTACTTC	CASSLSRAEQYF	TRBV5-8	TRBJ2-5
TGTGCCAGCTCACCCTTGCGAGTCTGGGGGGGGGATATGAACTATGGCTACACCTTC	CASSPLRVWGGDMNYGYTF	TRBV18	TRBJ1-2
TGTGCCAGCCAGGCCGGGAGACTAGGTCAAATCTACGAGCAGTACTTC	CASQAGRLGQIYEQYF	TRBV28	TRBJ2-7
TGTGCCAGCAGCAGTCAAGCCTACGGTTTGTATGGCTACACCTTC	CASSSQAYGLYGYTF	TRBV7-3	TRBJ1-2
TGTGCCAGCGCAACGGGACAGACACAACGGCACCCGAAAGAAAAACTGTTTTTT	CASATGQTQRHPKEKLFF	TRBV5-4	TRBJ1-4
TGTGCTGACGCGGGACAGGTCTCCTACGAGCAGTACTTC	CADAGQVSYEQYF	TRBV6-5	TRBJ2-7
TGTGCCAGCAGCTTATCGACCCCACAATCCGGGGATTTCTGCAGAGCCAAAAACATTCAGTACTTC	CASSLSTPQSGDFCRAKNIQYF	TRBV7-2	TRBJ2-4
TGCACGCAGGACTGGGGCCCCCGCACAGATACGCAGTATTTT	CTQDWGPRTDTQYF	TRBV20-1	TRBJ2-3
TGTGCCACCAGTGATTTGCATTGCAGTCCTAGGACGTGCACAGATACGCAGTATTTT	CATSDLHCSPRTCTDTQYF	TRBV24-1	TRBJ2-3
TGCAGTGCCTATCCTTACTCCCCCAATCAGCCCCAGCATTTT	CSAYPYSPNQPQHF	TRBV20-1	TRBJ1-5
TGTGCCTGGAGTGAGGATTGCCCTCTCAATGGCTACACCTTC	CAWSEDCPLNGYTF	TRBV30	TRBJ1-2
TGTGCCAGCAGTGACTCACCACTAGCGGGAGCTTACACCATATATTTT	CASSDSPLAGAYTIYF	TRBV6-4	TRBJ1-3
TGTGCCAGCAGCAAGCAAGTTCGGACATTTGGCCTGAACACTGAAGCTTTCTTT	CASSKQVRTFGLNTEAFF	TRBV7-3	TRBJ1-1
TGTGCCAGCAGTGCGACGGGAGACACCACAGATACGCAGTATTTT	CASSATGDTTDTQYF	TRBV6-4	TRBJ2-3
TGTGCCAGCAGCCCTAGGGAATGCTCCTACGAGCAGTACTTC	CASSPRECSYEQYF	TRBV4-2	TRBJ2-7
TGTGCCAGCAGTCCGTGGGACGAGAATTCACCCCTCCACTTT	CASSPWDENSPLHF	TRBV9	TRBJ1-6
TGTGCCAGCAGTCGCTGGGGACAGTTGCCACAGGGGTCCTACAATGAGCAGTTCTTC	CASSRWGQLPQGSYNEQFF	TRBV12-3	TRBJ2-1
TGTGCTAGCAGAGTCAAGACAGGGAAGGACCACTCCTACGAGCAGTACTTC	CASRVKTGKDHSYEQYF	TRBV7-7	TRBJ2-7
TGCGCCAGCAGGCTAGTGGGAAGCACAGATACGCAGTATTTT	CASRLVGSTDTQYF	TRBV5-1	TRBJ2-3
TGCGCCAGCAGCCAAGGCGGGGAACGGTGCACTGGGAACTATGGCTACACCTTC	CASSQGGERCTGNYGYTF	TRBV4-1	TRBJ1-2
TGTGCCAGCAGTTGTTCCTCCACGGGAGGCGTAAGGTCCCAGTACTTC	CASSCSSTGGVRSQYF	TRBV28	TRBJ2-5
TGCAGTGCGACGGACACTGAAGCTTTCTTT	CSATDTEAFF	TRBV20-1	TRBJ1-1
TGTGCCAGCAAGTTGGACTTCCCAAGCACAGATACGCAGTATTTT	CASKLDFPSTDTQYF	TRBV7-9	TRBJ2-3
TGTGCCAGCTCACCGGAGGCGGTAATCCACGAGCAGTACTTC	CASSPEAVIHEQYF	TRBV18	TRBJ2-7
TGTGCCAGCAGCTCGATTATCCTCGAGCAGTACTTC	CASSSIILEQYF	TRBV7-3	TRBJ2-7
TGTGCCAGCAGCCACTTCGGTCCAGATACGCAGTATTTT	CASSHFGPDTQYF	TRBV7-3	TRBJ2-3
TGTGCCACCAGTGATGCCCCCGGGACAGGGTCAAGAGATACGCAGTATTTT	CATSDAPGTGSRDTQYF	TRBV24-1	TRBJ2-3
TGTGCCAGCAGTCTGGAGGTAGGACAGGGGAACACCGGGGAGCTGTTTTTT	CASSLEVGQGNTGELFF	TRBV28	TRBJ2-2
TGTGCCAGCAGCTGTCAGGGGGGTACATCATACGAGCAGTACTTC	CASSCQGGTSYEQYF	TRBV7-3	TRBJ2-7
TGCGCCAGCACCACCAGCGGGGGGGGTGAAATTCAGCCCCAGCATTTT	CASTTSGGGEIQPQHF	TRBV10-1	TRBJ1-5
TGCGCCAGCAGTGGGCATTCCCAGCATTTT	CASSGHSQHF	TRBV10-1	TRBJ1-5
TGTGCCAGCAGGTCGCAGCGTTTCTCCTACGAGCAGTACTTC	CASRSQRFSYEQYF	TRBV2	TRBJ2-7
TGTGCCAGCAGTGACCAGGGACCAGATACGCAGTATTTT	CASSDQGPDTQYF	TRBV6-4	TRBJ2-3
TGTGCCAGCAGTTACCGAGGACAGGTCTTATGCAATCAGCCCCAGCATTTT	CASSYRGQVLCNQPQHF	TRBV6-5	TRBJ1-5
TGTGCCAGCAGTTCCCCTTTGGGGGTTCAAGCTTATGGCTACACCTTC	CASSSPLGVQAYGYTF	TRBV6-1	TRBJ1-2
TGTGCCAGCAGTCCGAGCGGAGACACAGATACGCAGTATTTT	CASSPSGDTDTQYF	TRBV6-4	TRBJ2-3
TGTGCCAGCAGCTCGCAGTCTCATCAGCCCCAGCATTTT	CASSSQSHQPQHF	TRBV7-7	TRBJ1-5
TGCGCCAGCATCCAGACAGGGCCCATGAACACTGAAGCTTTCTTT	CASIQTGPMNTEAFF	TRBV5-1	TRBJ1-1
TGTGCCAGCAGTTCATCGTTCAGGGCCACGAGCTCCTACGAGCAGTACTTC	CASSSSFRATSSYEQYF	TRBV6-1	TRBJ2-7
TGCAGTGCTAGGAGGGGTGGCTACACCTTC	CSARRGGYTF	TRBV20-1	TRBJ1-2
TGTGCCAGCAGTGCCCTGGGACAGGGGGGTAATGAAAAACTGTTTTTT	CASSALGQGGNEKLFF	TRBV2	TRBJ1-4
TGTGCCAGCAGCCAAGAATCCTTTAGGGGAACCGGGGAGCTGTTTTTT	CASSQESFRGTGELFF	TRBV13	TRBJ2-2
TGTGCCAGCAGCTTGAAGCGGGAGGGGGGGCGGGGGGGAGCTTTCTTT	CASSLKREGGRGGAFF	TRBV5-5	TRBJ1-1
TGCGCCAGCAGCTTCGGGACAGGGGACCCAAGCAATCAGCCCCAGCATTTT	CASSFGTGDPSNQPQHF	TRBV5-1	TRBJ1-5
TGTGCCTGGAGTGTACCGGATTCGACAGCGGGAGCAGGGGATACGCAGTATTTT	CAWSVPDSTAGAGDTQYF	TRBV30	TRBJ2-3
TGTGCCAGCAGCTTACCCCCCGGGACTAGTCCTGATACGCAGTATTTT	CASSLPPGTSPDTQYF	TRBV7-2	TRBJ2-3
TGTGCCAGCAGAGACAGGGGTCGGCCCAAAAACATTCAGTACTTC	CASRDRGRPKNIQYF	TRBV6-5	TRBJ2-4
TGTGCCAGCAGGGGAGACAGGGGGCCCCTTGGGAATCAGCCCCAGCATTTT	CASRGDRGPLGNQPQHF	TRBV9	TRBJ1-5
TGCGCCAGCAGCCGGGTGACTAGCGGGAGCGTAGCGGGGGAGGTAGCCAAAAACATTCAGTACTTC	CASSRVTSGSVAGEVAKNIQYF	TRBV4-1	TRBJ2-4
TGTGCCAGCAGTCCGGGACAATCCGAGCAGTACTTC	CASSPGQSEQYF	TRBV27	TRBJ2-7
TGCAGTGCACTAGCGGGGGGTGAGTACTTC	CSALAGGEYF	TRBV20-1	TRBJ2-7
TGTGCCAGCAGGATCACCCAAGGGAGGGCGCGAGGGACAGATACGCAGTATTTT	CASRITQGRARGTDTQYF	TRBV7-9	TRBJ2-3
TGTGCCAGCAACCCCGGACGGAATCAGCCCCAGCATTTT	CASNPGRNQPQHF	TRBV6-5	TRBJ1-5
TGTGCCAGCAGCCCGCACAACGGGGGGGCCGATACGCAGTATTTT	CASSPHNGGADTQYF	TRBV7-3	TRBJ2-3
TGTGCCTGGAGTCGGCCGGGGGGGCGACAGGAGCAGTTCTTC	CAWSRPGGRQEQFF	TRBV30	TRBJ2-1
TGCAGTGCTAGAGTTAGGGACTATGGCTACACCTTC	CSARVRDYGYTF	TRBV20-1	TRBJ1-2
TGTGCCAGCAGTTTATTCGGGACAGCTCCTTCGTTTGCCCAGTACTTC	CASSLFGTAPSFAQYF	TRBV27	TRBJ2-5
TGCGCCAGCATATGCAGGCGTACCTACGAGCAGTACTTC	CASICRRTYEQYF	TRBV5-1	TRBJ2-7
TGCGCCAGCAGCTTGGACGAGTCCCCCCAGGGCTGTTCTGGAAACACCATATATTTT	CASSLDESPQGCSGNTIYF	TRBV5-1	TRBJ1-3
TGTGCCAGCAGCCGTGGTTTACGAGGGGTTCAGCCCCAGCATTTT	CASSRGLRGVQPQHF	TRBV12-3	TRBJ1-5
TGTGCCAGCAGTGAAGGTATCCTAGGGGGGCCTACTACGATGAACACTGAAGCTTTCTTT	CASSEGILGGPTTMNTEAFF	TRBV25-1	TRBJ1-1
TGCAGTGCTACTTTTCAGGGGAGGGTCACTGAAGCTTTCTTT	CSATFQGRVTEAFF	TRBV20-1	TRBJ1-1
TGTGCCAGCAGCGGAATGGGGGCAAATTCCGTCCACTATGGCTACACCTTC	CASSGMGANSVHYGYTF	TRBV6-6	TRBJ1-2
TGTGCCAGCAGTCAACGACTAGCGGGATCTTACGAGCAGTACTTC	CASSQRLAGSYEQYF	TRBV27	TRBJ2-7
TGTGCCAGCAGCGCTGGGGAGGTTTTGAACACCGGGGAGCTGTTTTTT	CASSAGEVLNTGELFF	TRBV9	TRBJ2-2
TGTGCCAGCAGTTACTCGATGAAACGTGCGGACTTAGAGACCCAGTACTTC	CASSYSMKRADLETQYF	TRBV6-5	TRBJ2-5
TGTGCCAGTAGTATTCTCCAAGGGGGTATTCGTCTAGAGACCCAGTACTTC	CASSILQGGIRLETQYF	TRBV19	TRBJ2-5
TGTGCCAGCAGCTTGGCAAACAGTGGGAGCTCCTACAATGAGCAGTTCTTC	CASSLANSGSSYNEQFF	TRBV5-4	TRBJ2-1
TGTGCCAGCAGCCAAGATGGTACCTCAAGGGACAGGGGTTACGAGCAGTACTTC	CASSQDGTSRDRGYEQYF	TRBV3-1	TRBJ2-7
TGTGCCAGCAGCCAAGGCGTGGTCGCGGGGCCGGGGAATCAGCCCCAGCATTTT	CASSQGVVAGPGNQPQHF	TRBV14	TRBJ1-5
TGTGCCAGCAGCCAAGCAGGGAAGTCGGGCACAGATACGCAGTATTTT	CASSQAGKSGTDTQYF	TRBV14	TRBJ2-3
TGCGCCATAAAGGGGAAGTGGGACACAGATACGCAGTATTTT	CAIKGKWDTDTQYF	TRBV10-1	TRBJ2-3
TGCGCCAGCAGCAAACTCACCCACGTGGACAGCGGCTCTGGAAACACCATATATTTT	CASSKLTHVDSGSGNTIYF	TRBV5-1	TRBJ1-3
TGTGCCAGCAGCGCAAGGAACTTGAGCACCAACACTGAAGCTTTCTTT	CASSARNLSTNTEAFF	TRBV13	TRBJ1-1
TGTGCCAGCAGCTTCCAAGGCCCGGTAGACACCGGGGAGCTGTTTTTT	CASSFQGPVDTGELFF	TRBV7-6	TRBJ2-2
TGTGCCAGCAGCCCTGTTACCGGGCTCACCTACGAGCAGTACTTC	CASSPVTGLTYEQYF	TRBV9	TRBJ2-7
TGTGCCAGCAGCCACGCAGGGGGCCGGGCCTCCTACGAGCAGTACTTC	CASSHAGGRASYEQYF	TRBV4-2	TRBJ2-7
TGCGCCAGCAGCCCTCCCCGGGACAGAAGTGCGGAGACCCAGTACTTC	CASSPPRDRSAETQYF	TRBV4-3	TRBJ2-5
TGTGCCAGCAGCTTCCACGGCAGGGTGGCCCAGCATTTT	CASSFHGRVAQHF	TRBV13	TRBJ1-5
TGTGCCAGCAGTTGGGAACCCCACAGGGACACCTTC	CASSWEPHRDTF	TRBV6-6	TRBJ1-2
TGTGCCAGTAAAATTCACAGGGCCGAAAAACTGTTTTTT	CASKIHRAEKLFF	TRBV19	TRBJ1-4
TGCGCCAGCAGCCAAGCGACAATGGTCAGGCAAGAGACCCAGTACTTC	CASSQATMVRQETQYF	TRBV4-1	TRBJ2-5
TGTGCCAGTAAAATCCCTGGGAGGCCCGATGAGCAGTTCTTC	CASKIPGRPDEQFF	TRBV19	TRBJ2-1
TGTGCCAGCAGTGAAGGCCCCAGGGACAGGGGAAACTATGGCTACACCTTC	CASSEGPRDRGNYGYTF	TRBV2	TRBJ1-2
TGTGCCAGCTCTATCCGATGGGACCCCTACGAGCAGTACTTC	CASSIRWDPYEQYF	TRBV18	TRBJ2-7
TGTGCCAGCAGCGGGGGCTTTTCAGCTTTCTTT	CASSGGFSAFF	TRBV7-9	TRBJ1-1
TGTGCCAGCAGCCTCCGACAGGGAAACACTGAAGCTTTCTTT	CASSLRQGNTEAFF	TRBV6-4	TRBJ1-1
TGCAGTGCCCCATATGTACCCGACCTCTACGAGCAGTACTTC	CSAPYVPDLYEQYF	TRBV20-1	TRBJ2-7
TGTGCCACCACCGACTTCTGCACAGATACGCAGTATTTT	CATTDFCTDTQYF	TRBV24-1	TRBJ2-3
TGTGCCATCAGTGAGTCCCCCTCCAATGCCACGACGGGCTCCTACAATGAGCAGTTCTTC	CAISESPSNATTGSYNEQFF	TRBV10-3	TRBJ2-1
TGCGCCAGCAGCCAAGACGGATTCGGGAAACCAGGGGGAGAAAAACTGTTTTTT	CASSQDGFGKPGGEKLFF	TRBV4-1	TRBJ1-4
TGTGCCAGCAGCACCCACAGGGGAATTGAAAAACTGTTTTTT	CASSTHRGIEKLFF	TRBV13	TRBJ1-4
TGTGCCAGCAGTTTAGGTCGGACAGGGACTAACAACTATGGCTACACCTTC	CASSLGRTGTNNYGYTF	TRBV12-4	TRBJ1-2
TGTGCCAGCAGTCCACTAGCGGGAGCCTGGGAGCAGTTCTTC	CASSPLAGAWEQFF	TRBV27	TRBJ2-1
TGTGCCAGCAGGAGGGGGGTTGGATACAATGAGCAGTTCTTC	CASRRGVGYNEQFF	TRBV28	TRBJ2-1
TGTGCCAGCAGCAATGGCCTCCGACCCTACGAGCAGTACTTC	CASSNGLRPYEQYF	TRBV9	TRBJ2-7
TGTGCCAGCTCACCCATGGAAAAATCCTACAATGAGCAGTTCTTC	CASSPMEKSYNEQFF	TRBV18	TRBJ2-1
TGTGCCTCAGGCACTTCCTACAATGAGCAGTTCTTC	CASGTSYNEQFF	TRBV28	TRBJ2-1
TGTGCCAGCAGGGCCGGACGGTACATCAGGGAGAGTACAGATACGCAGTATTTT	CASRAGRYIRESTDTQYF	TRBV2	TRBJ2-3
TGTGCCAGCAGCGGGCTCGGCACTGGAAACACCATATATTTT	CASSGLGTGNTIYF	TRBV7-8	TRBJ1-3
TGTGCCACCAGTGACCCAAGCGGGAGGGCGGTATTAGCCAAAAACATTCAGTACTTC	CATSDPSGRAVLAKNIQYF	TRBV24-1	TRBJ2-4
TGTGCCAGCAGCTTAGCGGGCGAGGCCCAGACCCCTTCTCCCTACGAGCAGTACTTC	CASSLAGEAQTPSPYEQYF	TRBV7-6	TRBJ2-7
TGCGCCAGCAGCTTGGGTACCTGGACAGTTGACAGCAATCAGCCCCAGCATTTT	CASSLGTWTVDSNQPQHF	TRBV5-1	TRBJ1-5
TGTGCCAGTAGACAGGGGGGCCCTCCGGAGAAAGAGACCCAGTACTTC	CASRQGGPPEKETQYF	TRBV19	TRBJ2-5
TGTGCCAGCAGCTTAGCCAAGGGGCGGCACGAGCAGTACTTC	CASSLAKGRHEQYF	TRBV7-9	TRBJ2-7
TGTGCCAGCAAAGGGAGGGAAGAGACCCAGTACTTC	CASKGREETQYF	TRBV27	TRBJ2-5
TGTGCCACCAGTGAACTCTCGCAGGTGAACAGATACGAGCAGTACTTC	CATSELSQVNRYEQYF	TRBV24-1	TRBJ2-7
TGCGCCAGCAGTGTAGGTGTAGCGGGTGTCTCCTACGAGCAGTACTTC	CASSVGVAGVSYEQYF	TRBV10-1	TRBJ2-7
TGTGCCAGCAGTCGGGAGGGCCAAGAGACCCAGTACTTC	CASSREGQETQYF	TRBV3-1	TRBJ2-5
TGTGCCAGCAGGCAAGCGGGGGGCCCCTGCTCCTACGAGCAGTACTTC	CASRQAGGPCSYEQYF	TRBV6-1	TRBJ2-7
TGTGCCAGCAGCTTTATCATCTCCGGGACCTATGGGGGCGAGCAGTTCTTC	CASSFIISGTYGGEQFF	TRBV7-2	TRBJ2-1
TGTGCCAGCGGACAGGGGGGGCATGAGCAGTTCTTC	CASGQGGHEQFF	TRBV6-4	TRBJ2-1
TGTGCACTGGGACTCCTAAGCTATGGCTACACCTTC	CALGLLSYGYTF	TRBV6-5	TRBJ1-2
TGTGCCAGCAGCTTCGGGGACGGACCCGGGAACACTGAAGCTTTCTTT	CASSFGDGPGNTEAFF	TRBV11-1	TRBJ1-1
TGTGCCAGCAGCCAAGCCTACAGCTACGAGCAGTACTTC	CASSQAYSYEQYF	TRBV3-1	TRBJ2-7
TGTGCCAGCAGCTCCGCAGTAGCGGACTACGAGCAGTACTTC	CASSSAVADYEQYF	TRBV13	TRBJ2-7
TGCGCCAGCAGCCAAACCAGGGGGTTGAGCAACTATGGCTACACCTTC	CASSQTRGLSNYGYTF	TRBV4-3	TRBJ1-2
TGTGCCAGCAGGACTAGCGGGGCACACAATGAGCAGTTCTTC	CASRTSGAHNEQFF	TRBV9	TRBJ2-1
TGTGCCAGCAGCCAAGGCCGGGGGGTTGAGCAGTTCTTC	CASSQGRGVEQFF	TRBV3-1	TRBJ2-1
TGTGCCAGCAGCCCTGGGACCGCTGGACTAGCGGGTCTTCGCGAGCAGTACTTC	CASSPGTAGLAGLREQYF	TRBV7-3	TRBJ2-7
TGCGCCAGCAGTGGTAGCGGGGACACCGGGGAGCTGTTTTTT	CASSGSGDTGELFF	TRBV10-1	TRBJ2-2
TGTGCCAGCAGTTTATCGGCGGGGACAGGGGCCTACGAGCAGTACTTC	CASSLSAGTGAYEQYF	TRBV27	TRBJ2-7
TGTGCCAGCAGAAATCCGTGGGGGCGGGGGGCCGAGCAGTACTTC	CASRNPWGRGAEQYF	TRBV7-3	TRBJ2-7
TGTGCCACCAGTGATTTGCAACCCGGACTAGCGGGCTCCTACGAGCAGTACTTC	CATSDLQPGLAGSYEQYF	TRBV24-1	TRBJ2-7
TGTGCCAGCAGCTATTTCAGGGCGCGGACTAAAGCTTTCTTT	CASSYFRARTKAFF	TRBV5-6	TRBJ1-1
TGTGCCAGCAGCTTAAGACGAAACACTGAAGCTTTCTTT	CASSLRRNTEAFF	TRBV7-2	TRBJ1-1
TGTGCCAGCAGTTTATGCAGGAGGCCTACGAATTCTTTTGAGCAGTTCTTC	CASSLCRRPTNSFEQFF	TRBV28	TRBJ2-1
TGCGCCAGCAGCCAATCGAAACTAGCGGGTCAGACGTACAATGAGCAGTTCTTC	CASSQSKLAGQTYNEQFF	TRBV4-1	TRBJ2-1
TGTGCCAGCAGCCATGATGACCCCCGGGACAGGGGATATAGCAATCAGCCCCAGCATTTT	CASSHDDPRDRGYSNQPQHF	TRBV3-1	TRBJ1-5
TGTGCCAGCAATTCCGTACTGGGACAGGGTAACGAGCAGTACTTC	CASNSVLGQGNEQYF	TRBV7-9	TRBJ2-7
TGTGCCATCCCAGGGGGGTTCACCGGGGAGCTGTTTTTT	CAIPGGFTGELFF	TRBV10-3	TRBJ2-2
TGCAGCGTTGAGGTAGGGACCGGGACGAGTGGGCTTGGGAACACTGAAGCTTTCTTT	CSVEVGTGTSGLGNTEAFF	TRBV29-1	TRBJ1-1
TGTGCCAGCAGCGGTTTTTCAGAGGGACGGGGGAATCAGCCCCAGCATTTT	CASSGFSEGRGNQPQHF	TRBV7-3	TRBJ1-5
TGTGCCAGCAGCCAAGCAGCTCGGGGGCGCCCGTGGGGAAAGCAGCCCCAGCATTTT	CASSQAARGRPWGKQPQHF	TRBV3-1	TRBJ1-5
TGCAGTGCTTCAGCAACGGGGGCCAAAAACATTCAGTACTTC	CSASATGAKNIQYF	TRBV20-1	TRBJ2-4
TGTGCCAGCAACCGAGACAGATGGGGGGATACGCAGTATTTT	CASNRDRWGDTQYF	TRBV11-3	TRBJ2-3
TGTGCCAGCAGTTTGCGGGGGGGCGGGGAGCTGTTTTTT	CASSLRGGGELFF	TRBV28	TRBJ2-2
TGTGCCAGCAGCTGGACAGGGCATAGGAACACTGAAGCTTTCTTT	CASSWTGHRNTEAFF	TRBV5-6	TRBJ1-1
TGTGCCAGCAGCCGCCCCGTACAGGGGGGGGGTCAGCCCCAGCATTTT	CASSRPVQGGGQPQHF	TRBV14	TRBJ1-5
TGTGCCAGCTCGGGGGACGGCTACGAGCAGTACTTC	CASSGDGYEQYF	TRBV7-4	TRBJ2-7
TGCGCCAGCAGCCAAGCCAATTGGACAGGGAACACTGAAGCTTTCTTT	CASSQANWTGNTEAFF	TRBV4-1	TRBJ1-1
TGCAGCGTCCGGGGACACGGGGAGCTGTTTTTT	CSVRGHGELFF	TRBV29-1	TRBJ2-2
TGTGAAGAAGGAAATGGTGGAAACACCATATATTTT	CEEGNGGNTIYF	TRBV10-3	TRBJ1-3
TGTGCCAGCACCCCCAGGGATAAATACTACGAGCAGTACTTC	CASTPRDKYYEQYF	TRBV28	TRBJ2-7
TGCGCCAGCAAGTGTTCCAGATGGTTCGACGGGGGCTATAAAGTTGGAGACGAGCAGTACTTC	CASKCSRWFDGGYKVGDEQYF	TRBV10-1	TRBJ2-7
TGTGCCAGCAGCTCCCCTCGGGCGGACACTGAAGCTTTCTTT	CASSSPRADTEAFF	TRBV7-6	TRBJ1-1
TGTGCCAGCAGTTTATCAGGCAGTCCCCGTCACATTCAGTACTTC	CASSLSGSPRHIQYF	TRBV27	TRBJ2-4
TGTGCCAGCAGCTTGGCAATGACCGGCCGTCCCATGAACACTGAAGCTTTCTTT	CASSLAMTGRPMNTEAFF	TRBV5-6	TRBJ1-1
TGTGCCACCGAACAGGGGGGATACAATGAGCAGTTCTTC	CATEQGGYNEQFF	TRBV24-1	TRBJ2-1
TGTGCCAGCAGCAGGCGGGGACAAGAGACCCAGTACTTC	CASSRRGQETQYF	TRBV13	TRBJ2-5
TGCGCCAGCAGTGAGTTGGACGCCTTCGGTGTTAGCACAGATACGCAGTATTTT	CASSELDAFGVSTDTQYF	TRBV10-1	TRBJ2-3
TGTGCCAGCCCCCTCCCTAAAGACAGGCGGGGAAAAAATTCACCCCTCCACTTT	CASPLPKDRRGKNSPLHF	TRBV6-2	TRBJ1-6
TGTGCCAGCGTGACCCTTTGGGCCTATGGCTACACCTTC	CASVTLWAYGYTF	TRBV7-9	TRBJ1-2
TGCAGCGTTGAAAGGGGGACGAATCAGCCCCAGCATTTT	CSVERGTNQPQHF	TRBV29-1	TRBJ1-5
TGCGCCAGCATCCCCTGCTACAATGAGCAGTTCTTC	CASIPCYNEQFF	TRBV4-1	TRBJ2-1
TGTGCCAGCAGACCTTCAGACAGGGGACGACCCCAGCCCCAGCATTTT	CASRPSDRGRPQPQHF	TRBV6-5	TRBJ1-5
TGTGCCAGCAGTTACCGATACCGATCGCGGACAGGGCCTCAGAGGGGGGAGTCACCCCTCCACTTT	CASSYRYRSRTGPQRGESPLHF	TRBV6-5	TRBJ1-6
TGCAGTGCTACTAGCGGGAGGGCCCCGAATGAGCAGTTCTTC	CSATSGRAPNEQFF	TRBV20-1	TRBJ2-1
TGTGCCAGCAGTTCCCACAGGAACGTAGGGCAAGAGACCCAGTACTTC	CASSSHRNVGQETQYF	TRBV7-4	TRBJ2-5
TGCGGAGCCGGGCCTGACTATGGCTACACCTTC	CGAGPDYGYTF	TRBV20-1	TRBJ1-2
TGTGCCAGCAGCGTTTGGGGGGGGGAGCATGAGCAGTTCTTC	CASSVWGGEHEQFF	TRBV13	TRBJ2-1
TGTGCCAGCAGTGAGACCCGGGATCCCCTCAAAACTAATGAAAAACTGTTTTTT	CASSETRDPLKTNEKLFF	TRBV6-1	TRBJ1-4
TGTGCCAGTAGTGGTTCGGAGAGCGCGAGCTCCTACGAGCAGTACTTC	CASSGSESASSYEQYF	TRBV19	TRBJ2-7
TGTGCCAGCAGTACACCTGGACTAGTGCCCTCCTACAATGAGCAGTTCTTC	CASSTPGLVPSYNEQFF	TRBV12-3	TRBJ2-1
TGTGCCAGCAGCGTTATCCGACCATCAGGGGAACTTTACGAGCAGTACTTC	CASSVIRPSGELYEQYF	TRBV13	TRBJ2-7
TGTGCCAGCAGTGGGACTAGCGGGCTGGGAGCCTACGAGCAGTACTTC	CASSGTSGLGAYEQYF	TRBV6-1	TRBJ2-7
TGTGCTAGTGGTTGTTGCGACTACAGGGGGCGTTACACTGAAGCTTTCTTT	CASGCCDYRGRYTEAFF	TRBV12-5	TRBJ1-1
TGCGCCAGCACCCCGGGACTAGGGTGCAATGAGCAGTTCTTC	CASTPGLGCNEQFF	TRBV10-1	TRBJ2-1
TGTGCCAGCAGCGAGGACAGGAAATATCAGCCCCAGCATTTT	CASSEDRKYQPQHF	TRBV7-9	TRBJ1-5
TGTGCCAGCAGCGTCCCTAAAAGGACAGGGTACTCCTACGAGCAGTACTTC	CASSVPKRTGYSYEQYF	TRBV9	TRBJ2-7
TGTGCCTGGCGAGGGAGATGGACAGATACGCAGTATTTT	CAWRGRWTDTQYF	TRBV30	TRBJ2-3
TGTGCCAGCAGCTTGGCCTCCTCAGGATGCAGGCCCTTTGACCCCGGCACAGATACGCAGTATTTT	CASSLASSGCRPFDPGTDTQYF	TRBV5-5	TRBJ2-3
TGTGCCAGCAGCCATCCAGGGGAAGCTTTCTTT	CASSHPGEAFF	TRBV25-1	TRBJ1-1
TGCAGTGCTCCCGCTAGCGGGTCTGAGCAGTTCTTC	CSAPASGSEQFF	TRBV20-1	TRBJ2-1
TGTGCCAGGGCCAGGGGGGGATATGGCTACACCTTC	CARARGGYGYTF	TRBV11-3	TRBJ1-2
TGCGCCAGCAGCTTGGTTTTCCCGCCCACTCCCCGCAATCAGCCCCAGCATTTT	CASSLVFPPTPRNQPQHF	TRBV5-1	TRBJ1-5
TGCGCCAGCAGCATAAGGCGCCGGGACAGGGGGTCCTCCTATATCCCGAACACTGAAGCTTTCTTT	CASSIRRRDRGSSYIPNTEAFF	TRBV5-1	TRBJ1-1
TGTGCCAGCAGCAGGCGTCGCGGGAGACTTTCCTATAATTCACCCCTCCACTTT	CASSRRRGRLSYNSPLHF	TRBV7-3	TRBJ1-6
TGTGCCTGGAATTACCTAGTGACCACTAGCGGGAGATCCGAGCAGTACTTC	CAWNYLVTTSGRSEQYF	TRBV30	TRBJ2-7
TGTGCCAGCCAGCTCTATGGCTACACCTTC	CASQLYGYTF	TRBV6-3	TRBJ1-2
TGTGCCAGCAGAGAGGACAGGGTCGATGAGCCACGCACGAGTGAAAAACTGTTTTTT	CASREDRVDEPRTSEKLFF	TRBV6-6	TRBJ1-4
TGTGCCAGCAGCATTCCATCGGCGACAGGTTCTGACATTCAGTACTTC	CASSIPSATGSDIQYF	TRBV7-2	TRBJ2-4
TGTGCCAGCTCCACCAGGTGGGGGGCCCACAGCACAGATACGCAGTATTTT	CASSTRWGAHSTDTQYF	TRBV18	TRBJ2-3
TGTGCCAGCAGTGCAAAAGGGGGGCCGGATGACACCGGGGAGCTGTTTTTT	CASSAKGGPDDTGELFF	TRBV25-1	TRBJ2-2
TGTGCCACTCAGGGGGGGTACGAGCAGTACTTC	CATQGGYEQYF	TRBV10-3	TRBJ2-7
TGTGCCAGCAGTGGACCGACAGGGAAGGGGGTAGGGAGCAATCAGCCCCAGCATTTT	CASSGPTGKGVGSNQPQHF	TRBV6-4	TRBJ1-5
TGCAGTGCTAGAACCCGACCGGGACAGGCCCAGGGGCAGTACTTC	CSARTRPGQAQGQYF	TRBV20-1	TRBJ2-7
TGTGCCAGCAGCCAGGGAACCTATGGCTACACCTTC	CASSQGTYGYTF	TRBV5-4	TRBJ1-2
TGTGCCAGCAGCCAGCACAGGGTCAAGCAGTTCTTC	CASSQHRVKQFF	TRBV13	TRBJ2-1
TGTGCCAGCAGCTCCACAGGGGGGTATAGCAATCAGCCCCAGCATTTT	CASSSTGGYSNQPQHF	TRBV13	TRBJ1-5
TGTGCCAGCAGCGGGCACAGAAGGCACACTGAAGCTTTCTTT	CASSGHRRHTEAFF	TRBV11-3	TRBJ1-1
TGTGCCAGCAGCCAAGGGGGTGGGGGCGGCTCCGGCAATCAGCCCCAGCATTTT	CASSQGGGGGSGNQPQHF	TRBV14	TRBJ1-5
TGTGCCAGCAGCAGGTTTTCCTACGAGCAGTACTTC	CASSRFSYEQYF	TRBV5-5	TRBJ2-7
TGTGCCAGCAGTTACCTGCGGGGGCCAAGCTCCTACGAGCAGTACTTC	CASSYLRGPSSYEQYF	TRBV6-2	TRBJ2-7
TGCGCCAGCAGCTTGGTTTTTTCGGGGGGGACGGGGGGGCGCACAGATACGCAGTATTTT	CASSLVFSGGTGGRTDTQYF	TRBV5-1	TRBJ2-3
TGCAGTGCTAGAGAGGGACAGGGCCAATGTGTCCCATTAAAGGTGTATCCTTTCTTT	CSAREGQGQCVPLKVYPFF	TRBV20-1	TRBJ1-1
TGTGCCAGCAGGTCTAAGGGACAGGCCACCGGGGAGCTGTTTTTT	CASRSKGQATGELFF	TRBV2	TRBJ2-2
TGCAGTGCGGGACCAACTAAAAATTCACCCCTCCACTTT	CSAGPTKNSPLHF	TRBV20-1	TRBJ1-6
TGCGCCAGCAGCTTGGCTTCCTTGACTGGGGCCTACGAGCAGTACTTC	CASSLASLTGAYEQYF	TRBV5-1	TRBJ2-7
TGTGCCAGCTCGAGCGGATTTTCCTACGAGCAGTACTTC	CASSSGFSYEQYF	TRBV18	TRBJ2-7
TGTGCCAGGTTGGACGGCCCTAATGAAAAACTGTTTTTT	CARLDGPNEKLFF	TRBV27	TRBJ1-4
TGTGCCAGCCCGGACAGGGGGTTCTTT	CASPDRGFF	TRBV27	TRBJ1-1
TGCGCCAGCAGCGCCGTAGACATTTGGGACAGGGCCTATGGCTACACCTTC	CASSAVDIWDRAYGYTF	TRBV5-1	TRBJ1-2
TGTGCCAGCTCACGGTTACTCTGGGACGAGTGGGAGGAAGAGACCCAGTACTTC	CASSRLLWDEWEEETQYF	TRBV18	TRBJ2-5
TGTGCCGCCCGAGGGCCGGGACTGGAAGAGACCCAGTACTTC	CAARGPGLEETQYF	TRBV7-2	TRBJ2-5
TGTGCCAGCAGCTTGCGCTTTGCGGGACTAAACCACTACGAGCAGTACTTC	CASSLRFAGLNHYEQYF	TRBV5-6	TRBJ2-7
TGTGCCAGCTCGGTGAGGGGGGCTTGGGGGTCCTACGAGCAGTACTTC	CASSVRGAWGSYEQYF	TRBV27	TRBJ2-7
TGTGCCAGCAGTTTGTGGATTTCCTCTGTGAAAGAGACCCAGTACTTC	CASSLWISSVKETQYF	TRBV12-4	TRBJ2-5
TGTGCCAGTAGTCAGGGGCTTAGGTCTCCCTACGAGCAGTACTTC	CASSQGLRSPYEQYF	TRBV19	TRBJ2-7
TGTGCCAGCAGAGGGAGACTAGCGGGAGGGCAGGCATACGAGCAGTACTTC	CASRGRLAGGQAYEQYF	TRBV7-6	TRBJ2-7
TGTGCCAGCAGCTGGGACACTAGCGGGGCCTACGAGCAGTACTTC	CASSWDTSGAYEQYF	TRBV13	TRBJ2-7
TGTGCCAGCAGCGAGTTGGGGACAGGGTCTGGAAACACCATATATTTT	CASSELGTGSGNTIYF	TRBV6-6	TRBJ1-3
TGCAGTGCTAGAGATCGGGTGGGGGGGAATGAGCAGTTCTTC	CSARDRVGGNEQFF	TRBV20-1	TRBJ2-1
TGTGCCAGCAGTGAAGCGGGGGGGGGGACCGGAAACACCATATATTTT	CASSEAGGGTGNTIYF	TRBV2	TRBJ1-3
TGTGCCAGCAGTAACGGGTACAATGAGCAGTTCTTC	CASSNGYNEQFF	TRBV27	TRBJ2-1
TGTGCCAGCAGGGAGACGAGCGGAACCTCTGGAAACACCATATATTTT	CASRETSGTSGNTIYF	TRBV7-2	TRBJ1-3
TGTGCCATCAGTGCCCTTAGGTGTTTGACGACAGGAAGAACCAACAATGAGCAGTTCTTC	CAISALRCLTTGRTNNEQFF	TRBV10-3	TRBJ2-1
TGTGCCACCAGGTCCCCACCGGGACAGGAGGGGAGCAATCAGCCCCAGCATTTT	CATRSPPGQEGSNQPQHF	TRBV24-1	TRBJ1-5
TGTGCCAGCAGCCAAGCATTAGGGGGGATTAGCACAGATACGCAGTATTTT	CASSQALGGISTDTQYF	TRBV3-1	TRBJ2-3
TGCAGCGTTGAACCCCGGAGGAGGGGTCTTGAGACCCAGTACTTC	CSVEPRRRGLETQYF	TRBV29-1	TRBJ2-5
TGTGCCAGCAGTTACTCGCGGGACGGGGGCAATCAGCCCCAGCATTTT	CASSYSRDGGNQPQHF	TRBV6-6	TRBJ1-5
TGTGCCAGACTAGCGGGAGCTAGGGGCTACGAGCAGTACTTC	CARLAGARGYEQYF	TRBV6-5	TRBJ2-7
TGTGCCAGCAGTCCGGGGGGGCCTTACAATGAGCAGTTCTTC	CASSPGGPYNEQFF	TRBV6-5	TRBJ2-1
TGTGCCACCAGCAGAGTAGCAGAGATCTATGGCTACACCTTC	CATSRVAEIYGYTF	TRBV15	TRBJ1-2
TGTGCCAGCAGCTTGAGGTGGAAATTTCGCACCTGTCATGGGGACAGGGGCCTCTATGGCTACACCTTC	CASSLRWKFRTCHGDRGLYGYTF	TRBV5-6	TRBJ1-2
TGTGCCAGCATCCAGAGGTCCAATGAGCAGTTCTTC	CASIQRSNEQFF	TRBV6-5	TRBJ2-1
TGTGCCAGTAGTATAGGAACCCCCTCCGCAGGGTTAAGCAGCTCCTATAATTCACCCCTCCACTTT	CASSIGTPSAGLSSSYNSPLHF	TRBV19	TRBJ1-6
TGCGCCAGCAGGCCCTCCGATAAGCAGGCGACCTACGAGCAGTACTTC	CASRPSDKQATYEQYF	TRBV10-2	TRBJ2-7
TGTGCCAGCAGCTCTCGGTTGTCCCGCGTGTGGGGAGTGTTAGCTAGCGGGGAGCTGTTTTTT	CASSSRLSRVWGVLASGELFF	TRBV9	TRBJ2-2
TGTGCCAGCAGCCGTGTGGGGTCACAGAGCTCTGGAAACACCATATATTTT	CASSRVGSQSSGNTIYF	TRBV13	TRBJ1-3
TGTAACGGGGGGGGGCCTCGTTTAGATACGCAGTATTTT	CNGGGPRLDTQYF	TRBV19	TRBJ2-3
TGTGCCAGCGGCCGAGGGGCGAATGAAAAACTGTTTTTT	CASGRGANEKLFF	TRBV12-3	TRBJ1-4
TGTGCCTCTCCCGGACCCTCCACCCTGCGGCCTGGACTAGCCAAAAACATTCAGTACTTC	CASPGPSTLRPGLAKNIQYF	TRBV6-5	TRBJ2-4
TGTGCCAGCAGCTTGGCCCAGTCGGTTGCTTTGTACGAGCAGTACTTC	CASSLAQSVALYEQYF	TRBV5-8	TRBJ2-7
TGTGCCAGCAGCCCCGACCCCGCCCTAGGATGGGACCCGGGCCAAGAGACCCAGTACTTC	CASSPDPALGWDPGQETQYF	TRBV7-3	TRBJ2-5
TGTGCCAGTAGTACTGGGAGGGGATATGAAAAACTGTTTTTT	CASSTGRGYEKLFF	TRBV19	TRBJ1-4
TGTGCCAGCAGCTACCAGGGATGGCGACCGAGGAATGGCTACACCTTC	CASSYQGWRPRNGYTF	TRBV7-4	TRBJ1-2
TGCAGTGCTGGGGAAAGAGGCAGAGTGGAGAAGGGTAACTATGGCTACACCTTC	CSAGERGRVEKGNYGYTF	TRBV20-1	TRBJ1-2
TGTGCCAGCAGCAAAGGCAGGGCCCCACGGGGTCTGAAAAGAGACTATGGCTACACCTTC	CASSKGRAPRGLKRDYGYTF	TRBV13	TRBJ1-2
TGTGCCAGCAGTGAAGTACGACCCCCTAGCGGGGGTGAGCAGTTCTTC	CASSEVRPPSGGEQFF	TRBV6-1	TRBJ2-1
TGTGCCAGCAGGGAACATGGACAGGGACAAGAGACCCAGTACTTC	CASREHGQGQETQYF	TRBV6-5	TRBJ2-5
TGTGCCAGTAGTATGGAGTCCGGACTAGCGGGCTGGCTAAGCACAGATACGCAGTATTTT	CASSMESGLAGWLSTDTQYF	TRBV19	TRBJ2-3
TGCGCCAATACAACCGCGAACACCGGGGAGCTGTTTTTT	CANTTANTGELFF	TRBV10-1	TRBJ2-2
TGTGCCCACCTAGTCAACACTGAAGCTTTCTTT	CAHLVNTEAFF	TRBV6-6	TRBJ1-1
TGCAGCGTTGATACTCGGGACAGGGGGTGGCAGTTCTTC	CSVDTRDRGWQFF	TRBV29-1	TRBJ2-1
TGTGCCACCAGTGCGGGGGGCTACACCTTC	CATSAGGYTF	TRBV24-1	TRBJ1-2
TGTGCCAGCAGTTACGGGACTCCCGGACAGGGACCCTACGAGCAGTACTTC	CASSYGTPGQGPYEQYF	TRBV6-5	TRBJ2-7
TGTGCCAGCTCACCAGCCGACGACAGTGGGTTCGGGGAGCTGTTTTTT	CASSPADDSGFGELFF	TRBV18	TRBJ2-2
TGCGCCAGCAGCCCCCGCGGGAGTGAAGGTGGCACCGGGGAGCTGTTTTTT	CASSPRGSEGGTGELFF	TRBV4-1	TRBJ2-2
TGTGCCAGCAGCAACCTGCGGGGTAATTCACCCCTCCACTTT	CASSNLRGNSPLHF	TRBV5-5	TRBJ1-6
TGTGCCAGAGTGACAGTTAACTATGGCTACACCTTC	CARVTVNYGYTF	TRBV19	TRBJ1-2
TGTGCCAGCAGCACCAGGACAGAAGCTAACTATGGCTACACCTTC	CASSTRTEANYGYTF	TRBV7-2	TRBJ1-2
TGTGCCAGCAGCAACTTAGGGGTTGATACGCAGTATTTT	CASSNLGVDTQYF	TRBV13	TRBJ2-3
TGCGCCAGCAGTGAGTCTCGCTCCGGGACGGCCTACGAGCAGTACTTC	CASSESRSGTAYEQYF	TRBV10-1	TRBJ2-7
TGCACACCGGGACAGGGGCTCCTCACTGAAGCTTTCTTT	CTPGQGLLTEAFF	TRBV20-1	TRBJ1-1
TGCAGTGCTAGTCGGGAGACAGGGGGGGGGCCCCAGCATTTT	CSASRETGGGPQHF	TRBV20-1	TRBJ1-5
TGTGCCAGCAGTCCGCGGGGGGGATGGATCCCAGTTTCTGGAAACACCATATATTTT	CASSPRGGWIPVSGNTIYF	TRBV6-6	TRBJ1-3
TGCGCCAGCAAAGGGGCTGCTGGGGCCAACGTCCTGACTTTC	CASKGAAGANVLTF	TRBV10-1	TRBJ2-6
TGTGCCAGCATAACGGGGGGGCTCGAGACCCAGTACTTC	CASITGGLETQYF	TRBV6-8	TRBJ2-5
TGTGCCAGCAGCTTACCCGGGACAGAAAAGGAGACCCAGTACTTC	CASSLPGTEKETQYF	TRBV5-4	TRBJ2-5
TGTGCCAGCAGCAAATTAACAGGGGACTCCTACGAGCAGTACTTC	CASSKLTGDSYEQYF	TRBV7-9	TRBJ2-7
TGTGCCACCAGTGATCCCCCGGGGGTAATTGGGAAGGCCGAGCAGTACTTC	CATSDPPGVIGKAEQYF	TRBV24-1	TRBJ2-7
TGCAGTGCTCCCCACCGGGGAGTAACCGGGGAGCTGTTTTTT	CSAPHRGVTGELFF	TRBV20-1	TRBJ2-2
TGTGCCAGCACTGAGGGGGGTGGGCCTCCAGATACGCAGTATTTT	CASTEGGGPPDTQYF	TRBV12-3	TRBJ2-3
TGTGCCAGCAGCTCCTCGATAAACAACACCGGGGAGCTGTTTTTT	CASSSSINNTGELFF	TRBV6-4	TRBJ2-2
TGTGCCACCAGTGTGCCGGGACTAGCCACCTACGAGCAGTACTTC	CATSVPGLATYEQYF	TRBV24-1	TRBJ2-7
TGTGCCAGCAGCCCAATGGGGGGGGATAGCAATCAGCCCCAGCATTTT	CASSPMGGDSNQPQHF	TRBV3-1	TRBJ1-5
TGTGCCACCAGTGAAAGAGACGGCGGAAACACCATATATTTT	CATSERDGGNTIYF	TRBV24-1	TRBJ1-3
TGTGCCAGCAGTTACCCCAGGGGGGGTGCCCTCTCCCGCCAGTACTTC	CASSYPRGGALSRQYF	TRBV6-2	TRBJ2-5
TGTGCCACCAGCTGCCTTGTCTCCCCAGATACGCAGTATTTT	CATSCLVSPDTQYF	TRBV15	TRBJ2-3
TGTGCCAGTAGTACCCCCCTCGGGCAGAGACATGGCTACACCTTC	CASSTPLGQRHGYTF	TRBV19	TRBJ1-2
TGTGCCAGCAGGGTTGGGGGGACAGCGAGTGAAAAACTGTTTTTT	CASRVGGTASEKLFF	TRBV28	TRBJ1-4
TGTGCCAGCAGCGGGCCCGGGACTATGAGAAGACTGTACGAGCAGTACTTC	CASSGPGTMRRLYEQYF	TRBV7-3	TRBJ2-7
TGTGCCAGCAGCTTGGGCCCGGAGCTGTTTTTT	CASSLGPELFF	TRBV5-5	TRBJ2-2
TGTGCCAGCAGTTTATGGGGGGGGTGGGACAATGAGCAGTTCTTC	CASSLWGGWDNEQFF	TRBV27	TRBJ2-1
TGCAGTGCTCCTATCCCCCAGGATAGATACAATGAGCAGTTCTTC	CSAPIPQDRYNEQFF	TRBV20-1	TRBJ2-1
TGTGCCAGCAGTCCGTCCCAACTCCGGGACCGACAAAGCTCCTACAATGAGCAGTTCTTC	CASSPSQLRDRQSSYNEQFF	TRBV6-5	TRBJ2-1
TGTGCCGGGTTAAGGGACCAGGGGGGAAACACCATATATTTT	CAGLRDQGGNTIYF	TRBV7-9	TRBJ1-3
TGTGCCAGCAGCACTTCCGGGACAGGCTACGAGCAGTACTTC	CASSTSGTGYEQYF	TRBV5-6	TRBJ2-7
TGTGCCAGCAGCTTAAGACAGGGGGCTCACTCCTACAATGAGCAGTTCTTC	CASSLRQGAHSYNEQFF	TRBV7-3	TRBJ2-1
TGCAGCGCCCAAACAGGGGGGGAAAACATTCAGTACTTC	CSAQTGGENIQYF	TRBV29-1	TRBJ2-4
TGTGCCAGCATTGGTTCCGTCGGGGGAAGCAATCAGCCCCAGCATTTT	CASIGSVGGSNQPQHF	TRBV7-3	TRBJ1-5
TGCGCCAGCAGTGAGTCGCGTACGATGGGACTAGCGAATGAGCAGTTCTTC	CASSESRTMGLANEQFF	TRBV10-1	TRBJ2-1
TGCAGTTATTCCCCAGCGGCCGGGGAGCTGTTTTTT	CSYSPAAGELFF	TRBV20-1	TRBJ2-2
TGTGCCAGCAGTTTCCACGGGGGGCGAGAGCAAGAGACCCAGTACTTC	CASSFHGGREQETQYF	TRBV27	TRBJ2-5
TGTGCCGCGCGAGACGCAGGGGGTTCTGGGGATGAGCAGTTCTTC	CAARDAGGSGDEQFF	TRBV19	TRBJ2-1
TGCAGCGATCCAGGCGGTAGCACAGATACGCAGTATTTT	CSDPGGSTDTQYF	TRBV29-1	TRBJ2-3
TGTGCCATCTATAGCCTCTCTGGGGCCAACGTCCTGACTTTC	CAIYSLSGANVLTF	TRBV10-3	TRBJ2-6
TGCAGTGCTACACAGGGTCGGAATGATCAGCCCCAGCATTTT	CSATQGRNDQPQHF	TRBV20-1	TRBJ1-5
TGTGCCAGCAGGTGGCCCAGTCGGAGCTCCTACGAGCAGTACTTC	CASRWPSRSSYEQYF	TRBV27	TRBJ2-7
TGTGCCAGCAGCAGGCGCAGGGGGGGGAAAGTCACAGATACGCAGTATTTT	CASSRRRGGKVTDTQYF	TRBV13	TRBJ2-3
TGTGCCACCAGTGATTTGTCTGAGAGCTCTGGGGCCAACGTCCTGACTTTC	CATSDLSESSGANVLTF	TRBV24-1	TRBJ2-6
TGCGCCAGCAGCCGCATACCCCGGACTAATGAGCAGTTCTTC	CASSRIPRTNEQFF	TRBV4-1	TRBJ2-1
TGTGCCAGCAGTAGAAAGTTCCTGGGCCCGACGGCGGGGAGGACCTACGAGCAGTACTTC	CASSRKFLGPTAGRTYEQYF	TRBV12-4	TRBJ2-7
TGTGCCAGCAGTGAGACAGTGAGGGGCTACACCTTC	CASSETVRGYTF	TRBV6-4	TRBJ1-2
TGTGCCAGCAGTTACAGGGAGAGCTCCTACGAGCAGTACTTC	CASSYRESSYEQYF	TRBV27	TRBJ2-7
TGTGCCAGCAGCTTGTCCCGGACAGGTAGCGGCTACACCTTC	CASSLSRTGSGYTF	TRBV5-4	TRBJ1-2
TGTGCCAGCAGTTGGTTTCTCTCCCCGGACAATGAGCAGTTCTTC	CASSWFLSPDNEQFF	TRBV2	TRBJ2-1
TGTGCCAGCAGCTTAGAGGGGGCGGGACTAGCGGGATTGCGTCCCTACGAGCAGTACTTC	CASSLEGAGLAGLRPYEQYF	TRBV7-8	TRBJ2-7
TGTGCCAGCAGTGAGACTGCTGGGGCCAACGTCCTGACTTTC	CASSETAGANVLTF	TRBV2	TRBJ2-6
TGTGCCAGCAGCAAAGGGCCCAAGCTGGGACTAGCGGAATCGTATAACTACGAGCAGTACTTC	CASSKGPKLGLAESYNYEQYF	TRBV7-4	TRBJ2-7
TGTGCCAGCAGGACCAGGAGGGGCACAGATACGCAGTATTTT	CASRTRRGTDTQYF	TRBV27	TRBJ2-3
TGCAGTGCTAGAGATGGCCCCCACTTTAGGCCGCCTCAGCCCCAGCATTTT	CSARDGPHFRPPQPQHF	TRBV20-1	TRBJ1-5
TGCGCCAGCAGTGGGATATGCCGACTGAGCAATCAGCCCCAGCATTTT	CASSGICRLSNQPQHF	TRBV10-1	TRBJ1-5
TGTGCCAGCAGCAGATTCGCCATTAACAGTTTTAAATATGGCTACACCTTC	CASSRFAINSFKYGYTF	TRBV6-4	TRBJ1-2
TGCAGTGCTAGCAGGGGGAGGAATAGCAATCAGCCCCAGCATTTT	CSASRGRNSNQPQHF	TRBV20-1	TRBJ1-5
TGTGCCACCATGGAGATCCCGACGTCTACCTCTGGAAACACCATATATTTT	CATMEIPTSTSGNTIYF	TRBV24-1	TRBJ1-3
TGTGCCAGCAGTTCCCCCGAGCCGACTAGGGGCAATGAGCAGTTCTTC	CASSSPEPTRGNEQFF	TRBV6-2	TRBJ2-1
TGTGCCACCAGCAGAGATTTACAGGGTAACCACGAGCAGTACTTC	CATSRDLQGNHEQYF	TRBV15	TRBJ2-7
TGCGCCATCCGAGGGAAGGACACTGAAGCTTTCTTT	CAIRGKDTEAFF	TRBV4-1	TRBJ1-1
TGTGCCAGCGATACTAGCGGGAGCGATACGCAGTATTTT	CASDTSGSDTQYF	TRBV28	TRBJ2-3
TGTGCCAGCAGTTCCGGACCGGCGGGCAATCAGCCCCAGCATTTT	CASSSGPAGNQPQHF	TRBV9	TRBJ1-5
TGCGCCAGCAGCCGGCGAGGACTAGCGGCCTACGAGCAGTACTTC	CASSRRGLAAYEQYF	TRBV4-1	TRBJ2-7
TGTGCCAGCAGCCAACTGAGGGAGTTCACAGGGGGCGCTAATGAAAAACTGTTTTTT	CASSQLREFTGGANEKLFF	TRBV3-1	TRBJ1-4
TGCAGTGCTAGAAACCCTAGCGGAGTTTTATATACGCAGTATTTT	CSARNPSGVLYTQYF	TRBV20-1	TRBJ2-3
TGCGACCGGAACAGGGATTACGAGCAGTACTTC	CDRNRDYEQYF	TRBV10-1	TRBJ2-7
TGTGCCAGCCGAGGGCGGGGGGGGGGGGGAGGCTTCACTGAAGCTTTCTTT	CASRGRGGGGGFTEAFF	TRBV6-4	TRBJ1-1
TGTGCCAGCTCACCATCATTACAGGGCTGGGTCAATGACAACTATGGCTACACCTTC	CASSPSLQGWVNDNYGYTF	TRBV18	TRBJ1-2
TGTGCCAGTAGTAAACCGAGATTGGACAGTGTTACCCGCCTACATGAGCAGTTCTTC	CASSKPRLDSVTRLHEQFF	TRBV19	TRBJ2-1
TGTGCCAGCAGCGGTTCCGAGGACAGGGCAGATACGCAGTATTTT	CASSGSEDRADTQYF	TRBV3-1	TRBJ2-3
TGCAGTGCTAGACCAGGGACACTAGCGGGAGGGCTGACTGCCCCCTACGAGCAGTACTTC	CSARPGTLAGGLTAPYEQYF	TRBV20-1	TRBJ2-7
TGTGCCAGCAGAAGGATATCTAGCGGGCAAGACACCGGGGAGCTGTTTTTT	CASRRISSGQDTGELFF	TRBV6-6	TRBJ2-2
TGCAGTGCTGCTAAGGGGAGGGACTCTGGAAACACCATATATTTT	CSAAKGRDSGNTIYF	TRBV20-1	TRBJ1-3
TGTGCCAGCAGCGGTCTAGCGGGCGATCGGAACAATGAGCAGTTCTTC	CASSGLAGDRNNEQFF	TRBV13	TRBJ2-1
TGCGCCAGCAGAGGGGGCCTCTACGAGCAGTACTTC	CASRGGLYEQYF	TRBV5-1	TRBJ2-7
TGCGCCAGCAGAGGACAGGCGGTTGGAAACACCATATATTTT	CASRGQAVGNTIYF	TRBV5-1	TRBJ1-3
TGTGCCAGCAGCTCGAGGAAGGGGGCTGATCAGCCCCAGCATTTT	CASSSRKGADQPQHF	TRBV13	TRBJ1-5
TGTGCCAGCAGTTACACAGGGTCCCGAGGGCAGTTCTTC	CASSYTGSRGQFF	TRBV11-3	TRBJ2-1
TGTGCCAGCAGTTTAGCGGGACTAGTTAATGAGCAGTTCTTC	CASSLAGLVNEQFF	TRBV12-3	TRBJ2-1
TGCGCCAGCAGTAACACTAGCGGGAGTGCTCCACCCCTCCACTTT	CASSNTSGSAPPLHF	TRBV10-1	TRBJ1-6
TGTGCCTGGAGTGGCCCCAGGGTCTTAGTGTGCATTCAGTACTTC	CAWSGPRVLVCIQYF	TRBV30	TRBJ2-4
TGTGCCAGCAGTTTGGACAGCCATGGCAATCAGCCCCAGCATTTT	CASSLDSHGNQPQHF	TRBV6-5	TRBJ1-5
TGTGCCATCTACCATGAGGGAGGCCGCGTGCGCCACATTCAGTACTTC	CAIYHEGGRVRHIQYF	TRBV27	TRBJ2-4
TGTGCCAGCAGTTTGGGAAGGGAGCCCTCCTACGAGCAGTACTTC	CASSLGREPSYEQYF	TRBV6-5	TRBJ2-7
TGTGCCAGCAGCTTCAGACGGGCTAGCGGGGGTAGGGGCTACAATGAGCAGTTCTTC	CASSFRRASGGRGYNEQFF	TRBV5-4	TRBJ2-1
TGTGCCAGCAGCTTAAGGCCAGTAGAAGCTTTCTTT	CASSLRPVEAFF	TRBV7-7	TRBJ1-1
TGTGCCAGCAGCTTAGTGCACAGGGGGCCAGGCACAGATACGCAGTATTTT	CASSLVHRGPGTDTQYF	TRBV7-9	TRBJ2-3
TGTGCTAGTGGTTTGACTAGCGGAGATACGCAGTATTTT	CASGLTSGDTQYF	TRBV12-5	TRBJ2-3
TGTGCCAGCAGACCGCGGGAGGGACCCCAAGAGACCCAGTACTTC	CASRPREGPQETQYF	TRBV14	TRBJ2-5
TGTGCCACCCGGGACAGGGTAAAAGAGCAGTACTTC	CATRDRVKEQYF	TRBV7-2	TRBJ2-7
TGTGCCAGCAGCTTTGGTGCGGCCGAAGAGACCCAGTACTTC	CASSFGAAEETQYF	TRBV5-6	TRBJ2-5
TGTGCCAGCAGTAGCCAATCCCGGGGACAGGAAGAGGAGACCCAGTACTTC	CASSSQSRGQEEETQYF	TRBV28	TRBJ2-5
TGTGCCAGCAGGACCCAGGGCTACGAGCAGTACTTC	CASRTQGYEQYF	TRBV7-2	TRBJ2-7
TGTGCCATCAGTGAGGTAGAGGGACGCAACGAGCAGTACTTC	CAISEVEGRNEQYF	TRBV10-3	TRBJ2-7
TGTGCCAGCAGTTTCGGCAATGAGCAGTTCTTC	CASSFGNEQFF	TRBV28	TRBJ2-1
TGCGCCAGCAGTGTTCTGACAGGTTCATCCTACGAGCAGTACTTC	CASSVLTGSSYEQYF	TRBV10-1	TRBJ2-7
TGTGCTCATGCTAGAAACACCGGGGAGCTGTTTTTT	CAHARNTGELFF	TRBV7-2	TRBJ2-2
TGTGCCACCAGCAGAGAAACCAGGGACAACAGGGGTTGGAGTAACACCGGGGAGCTGTTTTTT	CATSRETRDNRGWSNTGELFF	TRBV15	TRBJ2-2
TGTGCCAGCAGCCCCGTCCGCGGGGGGGGGGCCACAGATACGCAGTATTTT	CASSPVRGGGATDTQYF	TRBV13	TRBJ2-3
TGTGCCAGCAGCGTCAGGGTGGTCTATGGCTACACCTTC	CASSVRVVYGYTF	TRBV9	TRBJ1-2
TGTGCCAGCAGCTTGGTAGCAGGGGGGGGGGGCGCTTTATACGAGCAGTACTTC	CASSLVAGGGGALYEQYF	TRBV5-4	TRBJ2-7
TGCAGCGTTGGCCCCGACAGGGGGCGCGACAGGGAGCAGTACTTC	CSVGPDRGRDREQYF	TRBV29-1	TRBJ2-7
TGTGCCACCAGTGATAATAAAGGGACAGCTCAAGAGACCCAGTACTTC	CATSDNKGTAQETQYF	TRBV24-1	TRBJ2-5
TGTGCCAGCAGTCCGTCCCGGACAGGGGAGATAGGCTACACCTTC	CASSPSRTGEIGYTF	TRBV28	TRBJ1-2
TGTGCCAGCAGCACTTCACAGGGGGCTTGGGTTGCTGAAGCTTTCTTT	CASSTSQGAWVAEAFF	TRBV5-4	TRBJ1-1
TGCATGATCCAGCGGGATGAGCAGTTCTTC	CMIQRDEQFF	TRBV20-1	TRBJ2-1
TGTGCCAGCAGCTCAGGGGGGGGCCTAGGAAATCAGCCCCAGCATTTT	CASSSGGGLGNQPQHF	TRBV5-6	TRBJ1-5
TGTGCCAGCAGAGGCGCTAGGACCTACGAGCAGTACTTC	CASRGARTYEQYF	TRBV9	TRBJ2-7
TGCGCCAGCAAAACTAGCGGGAGGGTCTCTAATCAGCCCCAGCATTTT	CASKTSGRVSNQPQHF	TRBV5-1	TRBJ1-5
TGTGCCAGCAGGTCCCCTAGGGGGGGTACGGAGCAGTACTTC	CASRSPRGGTEQYF	TRBV4-2	TRBJ2-7
TGTGCCAGCAGTCCCGGCTTTCCTCATTTCACAGATACGCAGTATTTT	CASSPGFPHFTDTQYF	TRBV12-4	TRBJ2-3
TGCGCCAGCAGCCCGGGTATGACTAGCGGGTCAGAGGGAGGCTGTGTCTTC	CASSPGMTSGSEGGCVF	TRBV4-3	TRBJ2-1
TGTGCCAGCAACTGCAACCTAAACACTAGCGGGGCTTGGTATGAGCAGTTCTTC	CASNCNLNTSGAWYEQFF	TRBV2	TRBJ2-1
TGTGCCAGCAGCAAGGACAGGGCGGGGTATGGCTACACCTTC	CASSKDRAGYGYTF	TRBV2	TRBJ1-2
TGTGCCAGCAGTTTTCGAACCCAAAATTCACCCCTCCACTTT	CASSFRTQNSPLHF	TRBV28	TRBJ1-6
TGCAGCGCCCCCGGGACAGGGGTTGTTAACTATGGCTACACCTTC	CSAPGTGVVNYGYTF	TRBV29-1	TRBJ1-2
TGCGCCAGCAGGGGGGGCTACACCTTC	CASRGGYTF	TRBV10-1	TRBJ1-2
TGTGCCAGCAGCCACTTGCGGGGGGGCGTCAATCAGCCCCAGCATTTT	CASSHLRGGVNQPQHF	TRBV4-2	TRBJ1-5
TGCAGTGCTAGAGATCTCCCCTCCCGGGTGTCTTGGGGCCCTGGCTACACCTTC	CSARDLPSRVSWGPGYTF	TRBV20-1	TRBJ1-2
TGTGCCAGCAGCCGGGCGGACCTATTAAATTCACCCCTCCACTTT	CASSRADLLNSPLHF	TRBV7-4	TRBJ1-6
TGCCCCTCGAGAGGCTCTGGAAACACCATATATTTT	CPSRGSGNTIYF	TRBV5-1	TRBJ1-3
TGTGCCAGCAGCCAGGAAGGGAGGGACCTGGGCTCCTACGAGCAGTACTTC	CASSQEGRDLGSYEQYF	TRBV3-1	TRBJ2-7
TGTGCCAGCAGCTTCCGGACAGACTACGAGCAGTACTTC	CASSFRTDYEQYF	TRBV5-5	TRBJ2-7
TGTGCCAGCAGCTTCCGGACAGGGCCAGCTTTCTTT	CASSFRTGPAFF	TRBV11-3	TRBJ1-1
TGTGCCAGCAGCTTATCCGATCCTAATGAAAAACTGTTTTTT	CASSLSDPNEKLFF	TRBV7-9	TRBJ1-4
TGCAGTGCGGGACCGGGGGAGAGATATCGGAGCAATCAGCCCCAGCATTTT	CSAGPGERYRSNQPQHF	TRBV20-1	TRBJ1-5
TGTGCCAGCAGCCAAGGACCCCCCCTTAGGCGTAATGAGCAGTTCTTC	CASSQGPPLRRNEQFF	TRBV3-1	TRBJ2-1
TGTGCCTGGAGCCCACGCCGGGACGGTGACTATGGCTACACCTTC	CAWSPRRDGDYGYTF	TRBV30	TRBJ1-2
TGTGCCAGCAGTTTATTAGCGGCCTCCTACGAGCAGTACTTC	CASSLLAASYEQYF	TRBV27	TRBJ2-7
TGTGCCAGCAGCAGAAATGGAACGCGGGGCACAGATACGCAGTATTTT	CASSRNGTRGTDTQYF	TRBV7-2	TRBJ2-3
TGTGCCAGCAGCCGGGCAGGGGGCACATGGCTGTGCAGCACAGATACGCAGTATTTT	CASSRAGGTWLCSTDTQYF	TRBV11-2	TRBJ2-3
TGTGCCAGCAGTCTAGGGGGGCCCTGCAATCAGCCCCAGCATTTT	CASSLGGPCNQPQHF	TRBV28	TRBJ1-5
TGTGCCAGCAGCGAGGGGGACAGGGGTTGGTCCTACAATGAGCAGTTCTTC	CASSEGDRGWSYNEQFF	TRBV9	TRBJ2-1
TGTGCCAGCAGGCATACGGGGGGACAGGGGGATACTTCCTACGAGCAGTACTTC	CASRHTGGQGDTSYEQYF	TRBV6-6	TRBJ2-7
TGTGCCACAGCGGGAGCACCCTACGAGCAGTACTTC	CATAGAPYEQYF	TRBV24-1	TRBJ2-7
TGTGCCAGCAGCCAAGAGAGGACTAGCCTGCAGTTCTTC	CASSQERTSLQFF	TRBV4-2	TRBJ2-1
TGTGCCAGCAGCCTTGCGGGAGCTACTGGGGCCAACGTCCTGACTTTC	CASSLAGATGANVLTF	TRBV7-6	TRBJ2-6
TGCGCCAGCAGCCAGGGGAACACTGAAGCTTTCTTT	CASSQGNTEAFF	TRBV4-1	TRBJ1-1
TGTGCCAGCAGCAAAGGGACAGGGGGCTCGAGTTATGGCTACACCTTC	CASSKGTGGSSYGYTF	TRBV7-2	TRBJ1-2
TGTGCCAGCAGCTTATGGGGGCGGGGGAATAACACTGAAGCTTTCTTT	CASSLWGRGNNTEAFF	TRBV7-3	TRBJ1-1
TGTGCCAGCAGTTTATTCGGCTACCCCACCGGGACAGGGGGACGGACTGAAGCTTTCTTT	CASSLFGYPTGTGGRTEAFF	TRBV28	TRBJ1-1
TGTGCCAGCAAGGGGAGGGGGCTGGGAGGGTACGAGCAGTACTTC	CASKGRGLGGYEQYF	TRBV7-2	TRBJ2-7
TGTGCCCCAAGGACAGGGACCTACGAGCAGTACTTC	CAPRTGTYEQYF	TRBV10-3	TRBJ2-7
TGTGCCAGCAGCCAAAAGGGGGAGGAAACCCGCTCTGGGGCCAACGTCCTGACTTTC	CASSQKGEETRSGANVLTF	TRBV4-2	TRBJ2-6
TGTGCCAGCAGTGCACGAGATGGCTACACCTTC	CASSARDGYTF	TRBV27	TRBJ1-2
TGTGCCAGCAGCTTACAGGAGGGAAGCTCCTACGAGCAGTACTTC	CASSLQEGSSYEQYF	TRBV7-9	TRBJ2-7
TGCAGTTTCAACACCCGAGGAGGGTCTTATAGCAATCAGCCCCAGCATTTT	CSFNTRGGSYSNQPQHF	TRBV20-1	TRBJ1-5
TGCAGTGCGGTGTTCGTTTCTACTAGCCGAGGCGGCACAGATACGCAGTATTTT	CSAVFVSTSRGGTDTQYF	TRBV20-1	TRBJ2-3
TGTGCCAGCAGTATCGGGGACAGGGAGGATACGCAGTATTTT	CASSIGDREDTQYF	TRBV12-4	TRBJ2-3
TGTGCCAGCAGTGACCCGAGGGACGAGCAGTACTTC	CASSDPRDEQYF	TRBV6-4	TRBJ2-7
TGTGCCACCAGTGATTTGGGACTAGCGGGTCGCTGCACAGATACGCAGTATTTT	CATSDLGLAGRCTDTQYF	TRBV24-1	TRBJ2-3
TGCAGCAACCCCGCTTCGACAGGGGTCACTGAAGCTTTCTTT	CSNPASTGVTEAFF	TRBV29-1	TRBJ1-1
TGCGCCAGCAGTGAGGTGCAGGGGAGCAGCTACGAGCAGTACTTC	CASSEVQGSSYEQYF	TRBV10-1	TRBJ2-7
TGCACATTTTTGACTAGCGGTAGGGAAAACATTCAGTACTTC	CTFLTSGRENIQYF	TRBV29-1	TRBJ2-4
TGTGCCAGCAGCGCCCGGGGGCCCCCAACTAATGAAAAACTGTTTTTT	CASSARGPPTNEKLFF	TRBV13	TRBJ1-4
TGTGCCAGCAGCTTAGGATCCACAGGGGAGGGCGAGCAGTACTTC	CASSLGSTGEGEQYF	TRBV11-2	TRBJ2-7
TGTGCCAGCAGCCCCGGGACCCAATATGGACAGGGGCATTACACTGAAGCTTTCTTT	CASSPGTQYGQGHYTEAFF	TRBV6-4	TRBJ1-1
TGCAGCGTTGCCCTGGGGGCAACTGAAGCTTTCTTT	CSVALGATEAFF	TRBV29-1	TRBJ1-1
TGTGCCAGCAGTGACGGGACGGACTGTGGAATGAACACTGAAGCTTTCTTT	CASSDGTDCGMNTEAFF	TRBV6-4	TRBJ1-1
TGTGCCAGCATACGCGACACCATATATTTT	CASIRDTIYF	TRBV28	TRBJ1-3
TGTGCCAGCTCACCACTATCACTAGCGAGGGGCACAGATACGCAGTATTTT	CASSPLSLARGTDTQYF	TRBV18	TRBJ2-3
TGTGCCAGCAACCGCCCGGGACAAGACGAGGGTGGAAACACCATATATTTT	CASNRPGQDEGGNTIYF	TRBV12-3	TRBJ1-3
TGTGCCAGGGCGAGTGGGAATGAAAAACTGTTTTTT	CARASGNEKLFF	TRBV6-4	TRBJ1-4
TGCGCCAGCAGCCAAGTTAAGCGGCTTCGGACAGATACGCAGTATTTT	CASSQVKRLRTDTQYF	TRBV4-1	TRBJ2-3
TGTGCCAGCAGTTTACAACATTTTGCAGGGGGCTGGAGAAAACTGTTTTTT	CASSLQHFAGGWRKLFF	TRBV27	TRBJ1-4
TGTGCCAGCAGCTTGGAGCCGGGACAGGGCTCTCATCCCGGGGATACGCAGTATTTT	CASSLEPGQGSHPGDTQYF	TRBV5-5	TRBJ2-3
TGTGCCAGCAGGAGGGGGCGACCTCCAACTAATGAAAAACTGTTTTTT	CASRRGRPPTNEKLFF	TRBV6-4	TRBJ1-4
TGTGCCAGCAGTGCCGGACAGGAAGGTGAAGCTTTCTTT	CASSAGQEGEAFF	TRBV6-1	TRBJ1-1
TGCAGTGCTAGACCCAGGGGTTTAGGTGGCTACACCTTC	CSARPRGLGGYTF	TRBV20-1	TRBJ1-2
TGTGCCAGCAGTTTTCCTATAGAGGGGGACCGAGCCTACGAGCAGTACTTC	CASSFPIEGDRAYEQYF	TRBV27	TRBJ2-7
TGTGCCAGTAGTATAGGGGTGTTCGAGCAGTACTTC	CASSIGVFEQYF	TRBV19	TRBJ2-7
TGTGCCAAAGGGATCGGGGCACGGGGGCATACGCAGTATTTT	CAKGIGARGHTQYF	TRBV6-4	TRBJ2-3
TGTGCCAGTAATCAGGAGCAGTACTTC	CASNQEQYF	TRBV19	TRBJ2-7
TGCAGTGCTAGAGGTATGCAACAGGGTAATTCACCCCTCCACTTT	CSARGMQQGNSPLHF	TRBV20-1	TRBJ1-6
TGCAGTGCTCACCCCCAACAGGTACTGAAGGAGAGCTCCTACGAGCAGTACTTC	CSAHPQQVLKESSYEQYF	TRBV20-1	TRBJ2-7
TGTGCCAGCAGTTTATACACTAGCGGTTTCCCGGGGGCCGGGGAGCTGTTTTTT	CASSLYTSGFPGAGELFF	TRBV12-3	TRBJ2-2
TGTGCCACCAGTGATTGGGTCCAACCCGGGACAGGCTATAGAAACACCATATATTTT	CATSDWVQPGTGYRNTIYF	TRBV24-1	TRBJ1-3
TGTGCCAGCTCCCGGACCTATGAGCAGTTCTTC	CASSRTYEQFF	TRBV18	TRBJ2-1
TGTGCCACCAGTGATCGGGCGGGGCACTGGCACGAGCAGTACTTC	CATSDRAGHWHEQYF	TRBV24-1	TRBJ2-7
TGCAGTGCTAGGCCCGCAGGGGGGCAGCCCCAGCATTTT	CSARPAGGQPQHF	TRBV20-1	TRBJ1-5
TGTGCCAGCAGTGAAGGGGCGGGAGATCAGCCCCAGCATTTT	CASSEGAGDQPQHF	TRBV6-4	TRBJ1-5
TGTGCCAGCAGCCCTATCGGAGAGCTAGCGGGAACCCAAGAGACCCAGTACTTC	CASSPIGELAGTQETQYF	TRBV3-1	TRBJ2-5
TGTGCCAGTTGGGACGAAAGCTACGAGCAGTACTTC	CASWDESYEQYF	TRBV19	TRBJ2-7
TGTGCCAGCAGTACTAGCGGGAGAAACCGGGGGTACGAGCAGTACTTC	CASSTSGRNRGYEQYF	TRBV6-3	TRBJ2-7
TGCAGTGCTAGAGATGCGGACAGCAATGAGCAGTTCTTC	CSARDADSNEQFF	TRBV20-1	TRBJ2-1
TGTGCCAGCAGAGCCAGGGGGGGTTTATCTGGAAACACCATATATTTT	CASRARGGLSGNTIYF	TRBV6-4	TRBJ1-3
TGTGCCAGCAGTGACCCCAGGGCACCTATTTGCGCCGAGCAGTACTTC	CASSDPRAPICAEQYF	TRBV2	TRBJ2-7
TGCAGTGCTAGAGATCTTCGGGGGCGGGCGGACGAGCAGTACTTC	CSARDLRGRADEQYF	TRBV20-1	TRBJ2-7
TGTGCCAGCAGCCAATCCGGGTTGACAGGGGGAGATAATTCACCCCTCCACTTT	CASSQSGLTGGDNSPLHF	TRBV4-2	TRBJ1-6
TGTGCCAGCAGCTTACTAGATCGAGATACGCAGTATTTT	CASSLLDRDTQYF	TRBV7-2	TRBJ2-3
TGCGCCAGCAGCTCCGGACAGGGCATTAACAATGAGCAGTTCTTC	CASSSGQGINNEQFF	TRBV5-1	TRBJ2-1
TGTGCCAGCAGATACAGGGGGCGTACTGAAGCTTTCTTT	CASRYRGRTEAFF	TRBV6-4	TRBJ1-1
TGTGCCAGCAGCGGAACGGAAAACGAGCAGTACTTC	CASSGTENEQYF	TRBV5-4	TRBJ2-7
TGCGCCAGCAGTGGGGGGCCCTCGAACTTCAAAAACATTCAGTACTTC	CASSGGPSNFKNIQYF	TRBV10-1	TRBJ2-4
TGCAGTGCTAGTGGACTAGCGGCGAGGAGACACAATGAGCAGTTCTTC	CSASGLAARRHNEQFF	TRBV20-1	TRBJ2-1
TGTGCCAGCAGATGGGACGGGGCCGGGGAGCTGTTTTTT	CASRWDGAGELFF	TRBV6-2	TRBJ2-2
TGTGCCTGGGGACAGAGCGGCTATGGCTACACCTTC	CAWGQSGYGYTF	TRBV30	TRBJ1-2
TGTGCCAGCAGCTCACGTCGCTTTGAATATGAGCAGTTCTTC	CASSSRRFEYEQFF	TRBV7-9	TRBJ2-1
TGCAGTGCTGGGACAGGGGGAAGCAATCAGCCCCAGCATTTT	CSAGTGGSNQPQHF	TRBV20-1	TRBJ1-5
TGTGCCAGCAGCACTCAGTCGCGGAGCTCCTACGAGCAGTACTTC	CASSTQSRSSYEQYF	TRBV7-3	TRBJ2-7
TGTGCCAGCTCACGTCCCTGGGGTGATCATACGCAGTATTTT	CASSRPWGDHTQYF	TRBV18	TRBJ2-3
TGTGCCAGCAGTGATGGGCAGGGGTATCAGGTGAACACTGAAGCTTTCTTT	CASSDGQGYQVNTEAFF	TRBV6-4	TRBJ1-1
TGTGCCAGCAGTGAACGCCACAGGGTGGGCAATCAGCCCCAGCATTTT	CASSERHRVGNQPQHF	TRBV25-1	TRBJ1-5
TGCACTAGCGCCGTGAAAGTTAAGTTCTTC	CTSAVKVKFF	TRBV20-1	TRBJ2-1
TGTGCCAGCAGTTTCCGGTTCAGGGGCACTGGGGCCAACGTCCTGACTTTC	CASSFRFRGTGANVLTF	TRBV12-4	TRBJ2-6
TGTGCCAGCAGGTTAGCGGGCACAGATACGCAGTATTTT	CASRLAGTDTQYF	TRBV6-5	TRBJ2-3
TGTGCCACCAGTGTGTTTCGGGGACTAGCGTGGGAACCCACAGATACGCAGTATTTT	CATSVFRGLAWEPTDTQYF	TRBV24-1	TRBJ2-3
TGCGCCAGGGGGTTTTCGGGAGTCACCGGGGAGCTGTTTTTT	CARGFSGVTGELFF	TRBV10-2	TRBJ2-2
TGTGCCAGCAGCTCATACGGTACTGATGAGCAGTTCTTC	CASSSYGTDEQFF	TRBV6-5	TRBJ2-1
TGCGCCAGCAGCCGGAGAGGGGGGGGTAACACCGGGGAGCTGTTTTTT	CASSRRGGGNTGELFF	TRBV4-1	TRBJ2-2
TGTGCCAGCAGCAGCCAACCGACAGGGATCCGCGGGTACGAGCAGTACTTC	CASSSQPTGIRGYEQYF	TRBV7-9	TRBJ2-7
TGTGCCAGCCAAGGGCCGGGACAGGGGGTTAGGACAGAGACCCAGTACTTC	CASQGPGQGVRTETQYF	TRBV7-4	TRBJ2-5
TGTGCCAATCAAGGCGGGTCCGGCTCCTACGAGCAGTACTTC	CANQGGSGSYEQYF	TRBV25-1	TRBJ2-7
TGTGCCAGTAGTATCATAAGGGCCTACGAGCAGTACTTC	CASSIIRAYEQYF	TRBV19	TRBJ2-7
TGTGCCAGTAGTGTCGCCCGGGACAGGGAGCCTCCCACTGAAGCTTTCTTT	CASSVARDREPPTEAFF	TRBV19	TRBJ1-1
TGTGCCAGCAGTTCAGGCGGCCGAGTCGGGGTCTTC	CASSSGGRVGVF	TRBV6-1	TRBJ2-1
TGTGCCAGCAGTGAATATAGTCAGACCGGGGCCTCCTACAATGAGCAGTTCTTC	CASSEYSQTGASYNEQFF	TRBV25-1	TRBJ2-1
TGTGCCAGCAGCTTAACGCCTACAAGGGGGGGCGGGTCCTACGAGCAGTACTTC	CASSLTPTRGGGSYEQYF	TRBV7-3	TRBJ2-7
TGTGCCAGCAGCTTAGACCCAAGGGATATTGGGAACACTGAAGCTTTCTTT	CASSLDPRDIGNTEAFF	TRBV11-2	TRBJ1-1
TGTGCCAGCAGCTCCGGGGTGCCGGGCTTGAAGGGAGACTCTGGAAACACCATATATTTT	CASSSGVPGLKGDSGNTIYF	TRBV7-8	TRBJ1-3
TGTGCCAGCAGTGATAGGGCCCCGGGACTAGCGGGAGCCCCCTCCTACAATGAGCAGTTCTTC	CASSDRAPGLAGAPSYNEQFF	TRBV25-1	TRBJ2-1
TGCGCCAGCAGTGAGTCGACAGGGGGGGGGGCCAACGTCCTGACTTTC	CASSESTGGGANVLTF	TRBV10-1	TRBJ2-6
TGTGCCAGCAGCCGACAGGGAGCTGGAAACACCATATATTTT	CASSRQGAGNTIYF	TRBV14	TRBJ1-3
TGTGCCAGCAGTTACGGCAGTGATGAGCAGTTCTTC	CASSYGSDEQFF	TRBV6-2	TRBJ2-1
TGTGCCAGCAGGGGGGGGCTCGACGGGTCTAACGAGCAGTACTTC	CASRGGLDGSNEQYF	TRBV7-9	TRBJ2-7
TGCAGTGCTTGGCGGTTTTTGGTTGGTTTCCGTGGCTACACCTTC	CSAWRFLVGFRGYTF	TRBV20-1	TRBJ1-2
TGCAGCACGAACCCGGGGGGCATGAACACTGAAGCTTTCTTT	CSTNPGGMNTEAFF	TRBV29-1	TRBJ1-1
TGCGCCAGCCGGACAGGACAGTCTAATGAAAAACTGTTTTTT	CASRTGQSNEKLFF	TRBV5-1	TRBJ1-4
TGTGCCAGCAGCGGCCCGAAAAAACAGGCTTACTACGAGCAGTACTTC	CASSGPKKQAYYEQYF	TRBV7-3	TRBJ2-7
TGTGCCACCAGTGATGGCGGGGGGAGCTCTGGAAACACCATATATTTT	CATSDGGGSSGNTIYF	TRBV24-1	TRBJ1-3
TGTGCCAGTGTAGTAGGCACAGATACGCAGTATTTT	CASVVGTDTQYF	TRBV2	TRBJ2-3
TGTGCCAGCAGCGTCCGGGACCAAGGGTTGAACACTGAAGCTTTCTTT	CASSVRDQGLNTEAFF	TRBV11-2	TRBJ1-1
TGTGCCAGCAGCTCTACGGGGACTGAAATACCTTCGAACACCGGGGAGCTGTTTTTT	CASSSTGTEIPSNTGELFF	TRBV7-9	TRBJ2-2
TGTGCCAGCAGCTTGGTCCCTAAAGGGCCACCCCTCCACTTT	CASSLVPKGPPLHF	TRBV11-3	TRBJ1-6
TGTGCCAGACAGGACAGGGAGTCCTACGAGCAGTACTTC	CARQDRESYEQYF	TRBV19	TRBJ2-7
TGTGCCAGCAGTTACTCGACAGGACGGGATTCCCCTTCACCCCTCCACTTT	CASSYSTGRDSPSPLHF	TRBV6-2	TRBJ1-6
TGTGCCACCAGTGATTATCCGGGACAGGGGAATAGCAATCAGCCCCAGCATTTT	CATSDYPGQGNSNQPQHF	TRBV24-1	TRBJ1-5
TGTGCCAGCAGCTTCCTGGACAGGGTTCTGGAAAAACTGTTTTTT	CASSFLDRVLEKLFF	TRBV11-3	TRBJ1-4
TGTGCCACCAGTGGACTAATCCACGGACAGTCCCCGAACACTGAAGCTTTCTTT	CATSGLIHGQSPNTEAFF	TRBV24-1	TRBJ1-1
TGTGCCTGGAGTGAAGGGCCCTGGCCCACTGAAGCTTTCTTT	CAWSEGPWPTEAFF	TRBV30	TRBJ1-1
TGTGCCAGCAGTTACATCAATGAGCAGTTCTTC	CASSYINEQFF	TRBV6-9	TRBJ2-1
TGTGCCAGCAGGGCTAAAGTAAGCACAGATACGCAGTATTTT	CASRAKVSTDTQYF	TRBV7-9	TRBJ2-3
TGTGCCTGGAGTAAGTGGAGACAGGGGGCAAGGGGGTATGGCTACACCTTC	CAWSKWRQGARGYGYTF	TRBV30	TRBJ1-2
TGCGCCAGCTCCACTTCGCACCCGCTGTTTTTT	CASSTSHPLFF	TRBV5-1	TRBJ2-2
TGTGCCAGCAGCCAAGATAAAGGGGGGATGGCCAGCAATCAGCCCCAGCATTTT	CASSQDKGGMASNQPQHF	TRBV3-1	TRBJ1-5
TGTGCCAGCAGCTTAGGACAGGGAAACATTCAGTACTTC	CASSLGQGNIQYF	TRBV7-3	TRBJ2-4
TGCAGCGTTGAAGGCGATCCTAGCGGGCCCCGGGGAAACACCGGGGAGCTGTTTTTT	CSVEGDPSGPRGNTGELFF	TRBV29-1	TRBJ2-2
TGTGCCAGCCTCCCTGGGGGGCAGGAGACCCAGTACTTC	CASLPGGQETQYF	TRBV27	TRBJ2-5
TGTGCCAGCAGCTTCGAACAGCCCTGGGGACCCTCTGGAAACACCATATATTTT	CASSFEQPWGPSGNTIYF	TRBV7-8	TRBJ1-3
TGCGCCAGCAGCCGGGGACAAGAGACCCAGTACTTC	CASSRGQETQYF	TRBV4-1	TRBJ2-5
TGTGCCAGCAGCTTAGACGGGAGAGCCTCCCCGAACACCGGGGAGCTGTTTTTT	CASSLDGRASPNTGELFF	TRBV7-4	TRBJ2-2
TGTGCCAGCAGCCCTCCAGGGGGATACAAGTACCTTCGGAGCCAAAGGGAGGGCTACACCTTC	CASSPPGGYKYLRSQREGYTF	TRBV11-2	TRBJ1-2
TGTGCCATCAGAGTGGGACTGGAGACCCAGTACTTC	CAIRVGLETQYF	TRBV10-3	TRBJ2-5
TGTGCCAGCAGTTGGTCTTCAGGAGCAAACACTGAAGCTTTCTTT	CASSWSSGANTEAFF	TRBV6-5	TRBJ1-1
TGCAGCGTTGACCTGGACGGGAAAGATACGCAGTATTTT	CSVDLDGKDTQYF	TRBV29-1	TRBJ2-3
TGCGCCAGCAGTGTTACAGGGGGGGCGTTGAAAGTGCAGCATTTT	CASSVTGGALKVQHF	TRBV10-1	TRBJ1-5
TGTGCCAGCAGTTACACCGGGGGGGCAAACAATGAGCAGTTCTTC	CASSYTGGANNEQFF	TRBV6-5	TRBJ2-1
TGCAGTGCGCGGGAGAGGGCCTACGAGCAGTACTTC	CSARERAYEQYF	TRBV20-1	TRBJ2-7
TGTGCCAGCAGGGCCTTTCAAGGCACCGCAGGGGGCGGTGCTAATGAAAAACTGTTTTTT	CASRAFQGTAGGGANEKLFF	TRBV28	TRBJ1-4
TGTGCCAGCAGCTTAGGAAAAGGACAGGGGTCACCCCTCCACTTT	CASSLGKGQGSPLHF	TRBV5-4	TRBJ1-6
TGTGCCAGCCGACCCGTGTACGAGCAGTACTTC	CASRPVYEQYF	TRBV10-3	TRBJ2-7
TGCGCCAGCAGCCAAGATAGGGGTAGAAAAGAGACCCAGTACTTC	CASSQDRGRKETQYF	TRBV4-1	TRBJ2-5
TGTGCCAGCAGCTTAGAACCGAGGGGTCTAGATGAGACCCAGTACTTC	CASSLEPRGLDETQYF	TRBV11-3	TRBJ2-5
TGTGCCAGCAGCTACTACGTTCACAGGACGGAGATGCGCCGCTGCTCTGGGGCCAACGTCCTGACTTTC	CASSYYVHRTEMRRCSGANVLTF	TRBV7-4	TRBJ2-6
TGTGCCAGCAGTCCCCCCCGGGGGGGGGGACAGTCGAATTCACCCCTCCACTTT	CASSPPRGGGQSNSPLHF	TRBV6-5	TRBJ1-6
TGCAGTGCTAGAGCCCCCCCGGACAGCAACCAAGAGACCCAGTACTTC	CSARAPPDSNQETQYF	TRBV20-1	TRBJ2-5
TGTGCCAGCAGCATAGTGCTAGCGGGGGTACGGTTTGGGGATGAGCAGTTCTTC	CASSIVLAGVRFGDEQFF	TRBV13	TRBJ2-1
TGTGCCAGCAGCGACAGGGGGCTTCAGCCCCAGCATTTT	CASSDRGLQPQHF	TRBV7-2	TRBJ1-5
TGTGCCATCAGTGCTGAGGCTAGCACTAACCCCTACGAGCAGTACTTC	CAISAEASTNPYEQYF	TRBV10-3	TRBJ2-7
TGTGCCACCAGTGATATTCCGAAATCGGACCGGGGACAGTCCTACTATGGCTACACCTTC	CATSDIPKSDRGQSYYGYTF	TRBV24-1	TRBJ1-2
TGTGCCAGCAGCTCGCCTGACGGACGGTCCCTCCTCAATGAGCAGTTCTTC	CASSSPDGRSLLNEQFF	TRBV7-3	TRBJ2-1
TGTGCCAGCAGCTTGGGAGACACAGATACGCAGTATTTT	CASSLGDTDTQYF	TRBV5-5	TRBJ2-3
TGTGCCAGCAGCTTACCAGGGGGCTCTGAAGCTTTCTTT	CASSLPGGSEAFF	TRBV11-1	TRBJ1-1
TGTGCCAGCAGTTTCCCCCGCGCCCGAATGAGACAGTCGGCTGCAACTAATGAAAAACTGTTTTTT	CASSFPRARMRQSAATNEKLFF	TRBV27	TRBJ1-4
TGCGCCAGCAGCAAGACGAATTCCGCGACAGGGGGGAAGCATCAGCCCCAGCATTTT	CASSKTNSATGGKHQPQHF	TRBV5-1	TRBJ1-5
TGTGCCAGCGGCCCCGCTGCTGAAGCTTTCTTT	CASGPAAEAFF	TRBV6-5	TRBJ1-1
TGTGCCAGCAGTGAGAATCCGGGGGGGGGGACCGTCTACAATGAGCAGTTCTTC	CASSENPGGGTVYNEQFF	TRBV12-3	TRBJ2-1
TGTGCCACCAGCAGAGGTAAACATACAGGGGATGGCTACACCTTC	CATSRGKHTGDGYTF	TRBV15	TRBJ1-2
TGTGCCAGTAGTATGGAGGGGGGCTATGGCTACACCTTC	CASSMEGGYGYTF	TRBV19	TRBJ1-2
TGTGCCAGCAGTTATAGGCACGGGTACACTGAAGCTTTCTTT	CASSYRHGYTEAFF	TRBV6-5	TRBJ1-1
TGTGCCACCAGTGATTCCAACCTGAGGGCACTGGACTACGAGCAGTACTTC	CATSDSNLRALDYEQYF	TRBV24-1	TRBJ2-7
TGTGCCAGCAGACCGGGGAGACCCTCCTACGAGCAGTACTTC	CASRPGRPSYEQYF	TRBV27	TRBJ2-7
TGTGCCAGCTGGCGGACAGGGTACGAGCAGTACTTC	CASWRTGYEQYF	TRBV28	TRBJ2-7
TGTGCCAGCAGCGGGACTAGCGGGGGGGCCAAAAACATTCAGTACTTC	CASSGTSGGAKNIQYF	TRBV5-6	TRBJ2-4
TGTGCCAGCAGCCCCAACGGGCCGGAGGGATCTGAAGCTTTCTTT	CASSPNGPEGSEAFF	TRBV7-6	TRBJ1-1
TGTGCCAGCAGCATTCCCCCGTTTGGTGGGACAGGGTGCGGCACCTACGAGCAGTACTTC	CASSIPPFGGTGCGTYEQYF	TRBV5-4	TRBJ2-7
TGTGCCAGCAGTTTAGTGGGGACCATTCCGGGACTCTACCTTACTGAAGCTTTCTTT	CASSLVGTIPGLYLTEAFF	TRBV12-3	TRBJ1-1
TGTGCCACCCCTGCCTCTAGAGGGACAGAGAGCTCCTACAATGAGCAGTTCTTC	CATPASRGTESSYNEQFF	TRBV24-1	TRBJ2-1
TGTGCCAGCACGACGGGACAGCGATTTTCTGGGGCCAACGTCCTGACTTTC	CASTTGQRFSGANVLTF	TRBV6-6	TRBJ2-6
TGTGCCAGCAGTCGAAAAAGGCAGCCCGGACGCTTTGTTGGACCAGATACGCAGTATTTT	CASSRKRQPGRFVGPDTQYF	TRBV6-3	TRBJ2-3
TGCGCCAGCACAAGACAGGGCTCGGAGACCCAGTACTTC	CASTRQGSETQYF	TRBV10-1	TRBJ2-5
TGTGCCAGCAGCTTTAACAGGGGGGGAGGGTTTGAAAAACTGTTTTTT	CASSFNRGGGFEKLFF	TRBV11-2	TRBJ1-4
TGCAGCGTTCTAGAGAATATGAGGGGGTTTTACACCGGGGAGCTGTTTTTT	CSVLENMRGFYTGELFF	TRBV29-1	TRBJ2-2
TGTGCCAGCAGCCCCCATGAGGGAGCAGGGACTAGCACAGATACGCAGTATTTT	CASSPHEGAGTSTDTQYF	TRBV13	TRBJ2-3
TGTGCCACGGTCAGGGGGACGGGTAGCTATGGCTACACCTTC	CATVRGTGSYGYTF	TRBV6-5	TRBJ1-2
TGTGCCAGCATTAGAGACAGGGGTTCTCAAGAGACCCAGTACTTC	CASIRDRGSQETQYF	TRBV9	TRBJ2-5
TGTGCCACCATCCAGGTCGAGTCTGGGGGGCTGAAAGGCACAGATACGCAGTATTTT	CATIQVESGGLKGTDTQYF	TRBV24-1	TRBJ2-3
TGCGCCAGCAGCCAAGAGGCGGGGGGGGAATGCACAGATACGCAGTATTTT	CASSQEAGGECTDTQYF	TRBV4-1	TRBJ2-3
TGTGCCAGTAGACTACCCCCGGGACTAGCGGACTCCTACGAGCAGTACTTC	CASRLPPGLADSYEQYF	TRBV19	TRBJ2-7
TGTGCCAGCAGTTCAGGGGGCCTCGGCAATCAGCCCCAGCATTTT	CASSSGGLGNQPQHF	TRBV6-3	TRBJ1-5
TGTGCCAGCAGCTTGGCTGCGGGACTAGGGTTCCAAGAGACCCAGTACTTC	CASSLAAGLGFQETQYF	TRBV5-5	TRBJ2-5
TGTGCCAGCAGTTCTAACGGACAGGGATTGGGATATGGCTACACCTTC	CASSSNGQGLGYGYTF	TRBV12-3	TRBJ1-2
TGTGCCTGGAGTGGTAGGGATTTCAATCAGCCCCAGCATTTT	CAWSGRDFNQPQHF	TRBV30	TRBJ1-5
TGTGCCAGCAGTAGGAGACTAGGTGTAAGGGGGTACCAAGAGACCCAGTACTTC	CASSRRLGVRGYQETQYF	TRBV6-1	TRBJ2-5
TGTGCCAGCAGTGGTAGCGGGCCCAATGAGCAGTTCTTC	CASSGSGPNEQFF	TRBV27	TRBJ2-1
TGTGCCAGCAGTTTCCGGCAAGAGACCCAGTACTTC	CASSFRQETQYF	TRBV12-4	TRBJ2-5
TGTGCCAGCAGCGATTACAATCGGGTGCGGAACGAGCAGTACTTC	CASSDYNRVRNEQYF	TRBV13	TRBJ2-7
TGTGCCAGCAGCCACCAGGCCCGCGCCCGGACTAGCGGGGCGCAGTACTTC	CASSHQARARTSGAQYF	TRBV7-3	TRBJ2-7
TGTGCCAGCAGTGAATGGTTGTGTCTCAAGGGGGGAGGCTCCTACGAGCAGTACTTC	CASSEWLCLKGGGSYEQYF	TRBV25-1	TRBJ2-7
TGTGCCAGCAGGAAGACAGGAGGGTCTCGAAATGAGCAGTTCTTC	CASRKTGGSRNEQFF	TRBV27	TRBJ2-1
TGCAGTGCTAGAGCTTACAGGGTAATCTATGGCTACACCTTC	CSARAYRVIYGYTF	TRBV20-1	TRBJ1-2
TGCGCCAGCAGCGTCGGGGGGAACCCCCAAGAGACCCAGTACTTC	CASSVGGNPQETQYF	TRBV5-1	TRBJ2-5
TGCGCCAGCAGCTTGCAGAATCAGCCCCAGCATTTT	CASSLQNQPQHF	TRBV5-1	TRBJ1-5
TGTGCCAGCAGCTTGGGTCGGCCGGGATGGAGGACCCAGTACTTC	CASSLGRPGWRTQYF	TRBV6-5	TRBJ2-5
TGTGCCAGCAGCTTGGGCAGGGGATCGGACTACGAGCAGTACTTC	CASSLGRGSDYEQYF	TRBV11-2	TRBJ2-7
TGTGCCAGCAGTTTGACTAGGGATAATGAGCAGTTCTTC	CASSLTRDNEQFF	TRBV12-3	TRBJ2-1
TGCGCCAGCAGCTTGGTCCCCCAGGGGAGGAACACTGAAGCTTTCTTT	CASSLVPQGRNTEAFF	TRBV5-1	TRBJ1-1
TGTGCCAGTAGTGTACCCTCCGAGGGTAGCTCCTACGAGCAGTACTTC	CASSVPSEGSSYEQYF	TRBV19	TRBJ2-7
TGCAGTGCTAGAGAACAACCTCGGGACAGGATCTACGAGCAGTACTTC	CSAREQPRDRIYEQYF	TRBV20-1	TRBJ2-7
TGTGCAAAGCGGGACAGACGGCCCTATGGCTACACCTTC	CAKRDRRPYGYTF	TRBV9	TRBJ1-2
TGTGCCAGCAGTCAGGGCTCGCCTAGCGGGGGCACAGATACGCAGTATTTT	CASSQGSPSGGTDTQYF	TRBV27	TRBJ2-3
TGTGCCAGCCTGGGACAGGGAGAGACCCAGTACTTC	CASLGQGETQYF	TRBV2	TRBJ2-5
TGTGCCAGCAGAGTCAGGACTAGTAGGAGGGCCAACGTCCTGACTTTC	CASRVRTSRRANVLTF	TRBV13	TRBJ2-6
TGCGCCAGCAGCCAAGAACCATGGACGCCTGGAAACACCATATATTTT	CASSQEPWTPGNTIYF	TRBV4-1	TRBJ1-3
TGTGCCAGCAGCCCTCCAATGTACACCGGGGAGCTGTTTTTT	CASSPPMYTGELFF	TRBV7-4	TRBJ2-2
TGCAGTGGACCTGGCCCAAGAGATTCCTACGAGCAGTACTTC	CSGPGPRDSYEQYF	TRBV20-1	TRBJ2-7
TGTGCCAGCTCAGGGGGGGGCGTATCCTACGAGCAGTACTTC	CASSGGGVSYEQYF	TRBV18	TRBJ2-7
TGTGCCAGTAGTATGAGGTCACCGGGACAGGATGAAAAACTGTTTTTT	CASSMRSPGQDEKLFF	TRBV19	TRBJ1-4
TGTGTCTCTCTGGGCTCAGATACGCAGTATTTT	CVSLGSDTQYF	TRBV27	TRBJ2-3
TGCGCCAGCAGCTTGGAACTACTTAGCAATCAGCCCCAGCATTTT	CASSLELLSNQPQHF	TRBV5-1	TRBJ1-5
TGCGCCAGCAGCCAAGATATATTCCTCGACAGGGAGGCCCCCTATGGCTACACCTTC	CASSQDIFLDREAPYGYTF	TRBV4-3	TRBJ1-2
TGTGCCAGATTGCCGGCGGTAAAACTCACAGATACGCAGTATTTT	CARLPAVKLTDTQYF	TRBV10-3	TRBJ2-3
TGTGCCATCAGTGCGAACACTAGCGGGAGTTCGCCCACCGGGGAGCTGTTTTTT	CAISANTSGSSPTGELFF	TRBV10-3	TRBJ2-2
TGTGCCAGCAGCCAAAAAATAGCACGTAGCAGACAGGAAGCTTTCTTT	CASSQKIARSRQEAFF	TRBV3-1	TRBJ1-1
TGTGCCACCAGCAGGGTATTGAGCGAGCAGTACTTC	CATSRVLSEQYF	TRBV15	TRBJ2-7
TGTGCCAGCAGCTCTGAGACTAGCGGGTCGTACCAGACCCAGTACTTC	CASSSETSGSYQTQYF	TRBV5-4	TRBJ2-5
TGCGCCAGCAGCCCCTCGTATCTGTCGGGGGGGGATAGTAATGAAAAACTGTTTTTT	CASSPSYLSGGDSNEKLFF	TRBV4-1	TRBJ1-4
TGTGCCTGGAGCCGGGGACAGTGGTCCTACAATGAGCAGTTCTTC	CAWSRGQWSYNEQFF	TRBV30	TRBJ2-1
TGTGCCAGCAACAGGGAGGGCCCGAGGGTAGCCTACGAGCAGTACTTC	CASNREGPRVAYEQYF	TRBV27	TRBJ2-7
TGTGCCAGTAGTACTATGGGGGCTTCCGAGCAGTACTTC	CASSTMGASEQYF	TRBV19	TRBJ2-7
TGCAGCGTTGACAACCCGGGCACTCTAACCAATCAGCCCCAGCATTTT	CSVDNPGTLTNQPQHF	TRBV29-1	TRBJ1-5
TGTGCCAGCAGCCAAGACAGTTTTGACGCTCTGTACTATGAAAAACTGTTTTTT	CASSQDSFDALYYEKLFF	TRBV14	TRBJ1-4
TGTGCCAGCCGTCCGGGACGGAGCTACACTGAAGCTTTCTTT	CASRPGRSYTEAFF	TRBV11-2	TRBJ1-1
TGTGCCAGCAGTCCTAGTGTGGTAATGCCTTGCTGTCGTACCGGGGAGCTGTTTTTT	CASSPSVVMPCCRTGELFF	TRBV7-3	TRBJ2-2
TGTGCCAGCAGTTTCTTCCCAGACACCGGGAGCTCCTACGAGCAGTACTTC	CASSFFPDTGSSYEQYF	TRBV28	TRBJ2-7
TGTGCCAGCAGTCCAAATCGACAGGGGAACTATGGCTACACCTTC	CASSPNRQGNYGYTF	TRBV12-3	TRBJ1-2
TGTGCCAGCAGTGGTCCACTCCGAAAACAGGGATTGGGGGTTAACTATGGCTACACCTTC	CASSGPLRKQGLGVNYGYTF	TRBV27	TRBJ1-2
TGCAGCGTTGAACAGGGGGACAATCAGCCCCAGCATTTT	CSVEQGDNQPQHF	TRBV29-1	TRBJ1-5
TGCAGACAGAGCAATCAGCCCCAGCATTTT	CRQSNQPQHF	TRBV20-1	TRBJ1-5
TGTGCCAGCAGCGACAGGGGGCAACAAGCTTTCTTT	CASSDRGQQAFF	TRBV7-7	TRBJ1-1
TGCGCCAGCACTTGGGGGGCGGAAGTAAGGATTGAGCAGTACTTC	CASTWGAEVRIEQYF	TRBV5-1	TRBJ2-7
TGTGCCATGAGAGCCGAAAAGAACACTGAAGCTTTCTTT	CAMRAEKNTEAFF	TRBV25-1	TRBJ1-1
TGTGCCAGCAGTATGGGACTCTACGAGCAGTACTTC	CASSMGLYEQYF	TRBV27	TRBJ2-7
TGCAGTGCTAGAGATCAGACCAATCAGCCCCAGCATTTT	CSARDQTNQPQHF	TRBV20-1	TRBJ1-5
TGTGCCAGCAGTGACATCGACAGGGAAAGCACAGATACGCAGTATTTT	CASSDIDRESTDTQYF	TRBV6-4	TRBJ2-3
TGTGCCAGCAGTTCGGGGGGGGGCTACAATGAGCAGTTCTTC	CASSSGGGYNEQFF	TRBV12-3	TRBJ2-1
TGTGCCAGCAGCGCCCCCGCGCTTAACAGGGACTGGAACACTGAAGCTTTCTTT	CASSAPALNRDWNTEAFF	TRBV7-3	TRBJ1-1
TGTGCCAGCAGCTTTAGCAGGAACACTGAAGCTTTCTTT	CASSFSRNTEAFF	TRBV7-3	TRBJ1-1
TGTGCCAGCACTGGAGCCCGAAACACCATATATTTT	CASTGARNTIYF	TRBV6-2	TRBJ1-3
TGTGCCAGCTTGAGGGACAATGAAAAACTGTTTTTT	CASLRDNEKLFF	TRBV28	TRBJ1-4
TGTGCCAGCAGTTTAACAGGGGGCTTCAATCAGCCCCAGCATTTT	CASSLTGGFNQPQHF	TRBV12-3	TRBJ1-5
TGTGCCAGCAGCTTACTGTACAGCTGGGGAAACACCGGGGAGCTGTTTTTT	CASSLLYSWGNTGELFF	TRBV11-3	TRBJ2-2
TGCGCCAGCAGATTGCTGTCTGATGAGGTGAACACTGAAGCTTTCTTT	CASRLLSDEVNTEAFF	TRBV5-1	TRBJ1-1
TGTGCCAGCAGCTTTGTAGGGTGCAGGGAGGTTCAGCCCCAGCATTTT	CASSFVGCREVQPQHF	TRBV11-2	TRBJ1-5
TGTGCCAGCAGCGTAGGGACAGTGGGAACCTACGAGCAGTACTTC	CASSVGTVGTYEQYF	TRBV7-9	TRBJ2-7
TGTGCCAGCAGCGAGGCGGCAAGGCTGACCTACGAGCAGTACTTC	CASSEAARLTYEQYF	TRBV13	TRBJ2-7
TGTGCCAGCAGCTTAAGCATAAGTGGTCCCGGGACTAGCACCGGGGAGCTGTTTTTT	CASSLSISGPGTSTGELFF	TRBV7-3	TRBJ2-2
TGTGCCAGCAGCGATATATATAAGGGGGGGCCACGTTCAGGGTTGGGCAGTGATACGCAGTATTTT	CASSDIYKGGPRSGLGSDTQYF	TRBV11-3	TRBJ2-3
TGTGCCAGCAGCTTTCTCGAACCCCGGGGTGAGACCCAGTACTTC	CASSFLEPRGETQYF	TRBV11-3	TRBJ2-5
TGTGCCAGCAACCCCGGGACACCGAGGACCTACGAGCAGTACTTC	CASNPGTPRTYEQYF	TRBV2	TRBJ2-7
TGTGCCAGTAGCCGGGAAGGGGACTATGGCTACACCTTC	CASSREGDYGYTF	TRBV19	TRBJ1-2
TGTGCCAGCAGTTACCCCGACTTTTGTTGTTTCCGCTCCTACAATGAGCAGTTCTTC	CASSYPDFCCFRSYNEQFF	TRBV6-5	TRBJ2-1
TGTGCCAGCAGTTACTCGGTCAAGGCTGACTCGACTAGCCGTGGAGATACGCAGTATTTT	CASSYSVKADSTSRGDTQYF	TRBV6-6	TRBJ2-3
TGCAGTGCTAGAGAAGGGCCGGGACAGGGCTTCGGGACAGATACGCAGTATTTT	CSAREGPGQGFGTDTQYF	TRBV20-1	TRBJ2-3
TGTGCCCCGGGACTACTGTACGAGCAGTACTTC	CAPGLLYEQYF	TRBV27	TRBJ2-7
TGTGCCAGCTCACCCTCGGACAGGGGGGCCTCTGGAAACACCATATATTTT	CASSPSDRGASGNTIYF	TRBV18	TRBJ1-3
TGTGCCATCTGCCGGGACGGGGAGCTGTTTTTT	CAICRDGELFF	TRBV10-3	TRBJ2-2
TGTGCCAGCAGCGCGGGAGGTGCTATCAGTATCCAAGAGACCCAGTACTTC	CASSAGGAISIQETQYF	TRBV7-8	TRBJ2-5
TGTGCCAGCAGTGAAGTCGGGGGACTAGCCTACGAGCAGTACTTC	CASSEVGGLAYEQYF	TRBV6-4	TRBJ2-7
TGTGCCAGCAGCCCAGACAGGGACAATTCACCCCTCCACTTT	CASSPDRDNSPLHF	TRBV6-2	TRBJ1-6
TGTGCCAGCAGCCGTGGACTCGGAAATTTTGCTCATGAAGCTTTCTTT	CASSRGLGNFAHEAFF	TRBV5-5	TRBJ1-1
TGCAGCGCATCCTTGAGGGGACCACTCTCTGGGGTGGCGAACACCGGGGAGCTGTTTTTT	CSASLRGPLSGVANTGELFF	TRBV29-1	TRBJ2-2
TGTGCCCAGAAACCTCAGGGGAACACCGGGGAGCTGTTTTTT	CAQKPQGNTGELFF	TRBV10-3	TRBJ2-2
TGCGCCAGCGGGAGGGAGACCCAGTACTTC	CASGRETQYF	TRBV10-1	TRBJ2-5
TGCGCCAGCAGCCGGAAAAAGGGGGGGGTAAATTGCACCCTCCACTTT	CASSRKKGGVNCTLHF	TRBV4-1	TRBJ1-6
TGCAGCGTTGTGGCAACCGGGACATCCTACGAGCAGTACTTC	CSVVATGTSYEQYF	TRBV29-1	TRBJ2-7
TGTGCCAGCAGCTTGAGGGGCTGCTATGGCTACACCTTC	CASSLRGCYGYTF	TRBV5-6	TRBJ1-2
TGTGCCAGCAGCTTGGCCGATGGACACGCTAGCTCCTACGAGCAGTACTTC	CASSLADGHASSYEQYF	TRBV5-6	TRBJ2-7
TGTGCCAGCACTATCCAAGATTCTGGATACGAGCAGTACTTC	CASTIQDSGYEQYF	TRBV27	TRBJ2-7
TGTGCCAGCAGCCAAGTGGGGCCGGATCAACAGCCCCAGCATTTT	CASSQVGPDQQPQHF	TRBV3-1	TRBJ1-5
TGCAGCGTTGAAGCCTCGCTTCTAGCGGAGGCCTACAATGAGCAGTTCTTC	CSVEASLLAEAYNEQFF	TRBV29-1	TRBJ2-1
TGTGCCAGCAGCAATGGACAGGGTATCGGAAACACCATATATTTT	CASSNGQGIGNTIYF	TRBV7-4	TRBJ1-3
TGTGCCAGCAGTTTATCGGGGCACCAGGGGATCACGGTTTTCGCCGCTGAGCAGTTCTTC	CASSLSGHQGITVFAAEQFF	TRBV27	TRBJ2-1
TGTGCCAGCAGTGGGGTTACCAGAGAGCAGTACTTC	CASSGVTREQYF	TRBV2	TRBJ2-7
TGTGCCAGCTCTGAGGGCAATCAGCCCCAGCATTTT	CASSEGNQPQHF	TRBV19	TRBJ1-5
TGTGCCAGCAGTTACTCCTATGAGCAGTTCTTC	CASSYSYEQFF	TRBV6-5	TRBJ2-1
TGTGCCAGCAGCCCACATGGGAACTCCTACGAGCAGTACTTC	CASSPHGNSYEQYF	TRBV28	TRBJ2-7
TGTGCCAGCAGCTTCCGGGACAGATACGGAGGCTACACCTTC	CASSFRDRYGGYTF	TRBV7-6	TRBJ1-2
TGTGCCAGCAGAGTAGCTCACACTGAAGCTTTCTTT	CASRVAHTEAFF	TRBV28	TRBJ1-1
TGTGCCAGGCTGGGGTCGGCCAATCAGCCCCAGCATTTT	CARLGSANQPQHF	TRBV5-6	TRBJ1-5
TGCGCCAGCAGCAAAGCAGACCAGGGAGGGATAGATCAGCCCCAGCATTTT	CASSKADQGGIDQPQHF	TRBV5-1	TRBJ1-5
TGTGCCTGGAGTGTACACACAGGGGCCTCTGGGGCCAACGTCCTGACTTTC	CAWSVHTGASGANVLTF	TRBV30	TRBJ2-6
TGTGCCAGCAGCTTAACGATACCGCCTAGCGTCGGCGGGAACACCGGGGAGCTGTTTTTT	CASSLTIPPSVGGNTGELFF	TRBV7-3	TRBJ2-2
TGTGCCACTAGATATTATACCTACGAGCAGTACTTC	CATRYYTYEQYF	TRBV5-5	TRBJ2-7
TGCGCCAGCAGACCTCGGGACCTTCTGGGGCAGCCCCAGCATTTT	CASRPRDLLGQPQHF	TRBV5-1	TRBJ1-5
TGCGCCAGCATAACCGGGACAGGCTGCACTGAAGCTTTCTTT	CASITGTGCTEAFF	TRBV10-1	TRBJ1-1
TGCAGTGCTAGCCCTGGGGGGAGCTACGAGCAGTACTTC	CSASPGGSYEQYF	TRBV20-1	TRBJ2-7
TGCGCCAGCAGTGAGACTAGCGGGGTGGCCTACAATGAGCAGTTCTTC	CASSETSGVAYNEQFF	TRBV10-1	TRBJ2-1
TGTGCCCCGGGACTGGGGGGGGCTAAGGCCTACGAGCAGTACTTC	CAPGLGGAKAYEQYF	TRBV12-3	TRBJ2-7
TGTGCCTGGACCCGAATGAGGCGGAACTATGGCTACACCTTC	CAWTRMRRNYGYTF	TRBV30	TRBJ1-2
TGTGCGTACCGGTGGGGAAAACTGTTTTTT	CAYRWGKLFF	TRBV6-2	TRBJ1-4
TGTGCCAGCAGCCAAGATTCGGACGAAGGGGCCTACGAGCAGTACTTC	CASSQDSDEGAYEQYF	TRBV14	TRBJ2-7
TGCAGTGCATTAAGCGGGAAACTCTCTTCGAACACCGGGGAGCTGTTTTTT	CSALSGKLSSNTGELFF	TRBV20-1	TRBJ2-2
TGCGCCAGCAGCCGATCGGGGGACAGGCGTCCTGTTCGGGAGAACACTGAAGCTTTCTTT	CASSRSGDRRPVRENTEAFF	TRBV4-3	TRBJ1-1
TGTGCCATCAGTGAGGGACAGGCCAAAAACATTCAGTACTTC	CAISEGQAKNIQYF	TRBV10-3	TRBJ2-4
TGTGCCAGCAGTGACCCAAGAACAGGGGGAATCGGCTACACCTTC	CASSDPRTGGIGYTF	TRBV2	TRBJ1-2
TGTGCCAGCAGTAAGGCCTACAATGAGCAGTTCTTC	CASSKAYNEQFF	TRBV2	TRBJ2-1
TGTGCCAGCAGTGATGCCCGTTACACAGATACGCAGTATTTT	CASSDARYTDTQYF	TRBV6-4	TRBJ2-3
TGTGCCAGCAGAGAAGGGTTAACGTTCAATCAGCCCCAGCATTTT	CASREGLTFNQPQHF	TRBV4-2	TRBJ1-5
TGTGCCAGCAGCGGCACAGATACGCAGTATTTT	CASSGTDTQYF	TRBV7-9	TRBJ2-3
TGTGCCAGCCTTGGGGGGGCCTATAATTCACCCCTCCACTTT	CASLGGAYNSPLHF	TRBV25-1	TRBJ1-6
TGTGCCACCAGGGGACTAGATAGTGGGGTCACAGATACGCAGTATTTT	CATRGLDSGVTDTQYF	TRBV24-1	TRBJ2-3
TGCAGTGCTAGAGTCTTACGGGAATTGACAAGGCTGGGGGTTAACTATGGCTACACCTTC	CSARVLRELTRLGVNYGYTF	TRBV20-1	TRBJ1-2
TGCGCCAGCAGCCAAGTAGCAATATATCCGACCCAGTACTTC	CASSQVAIYPTQYF	TRBV4-1	TRBJ2-5
TGTGCTGGGGCTGTAATCGAGCAGTACTTC	CAGAVIEQYF	TRBV5-4	TRBJ2-7
TGTGCCAGCAGCCGAACAGGGGGCGAGGATACGCAGTATTTT	CASSRTGGEDTQYF	TRBV27	TRBJ2-3
TGCAGCGTTGTAAGGGGAAGCACAGATACGCAGTATTTT	CSVVRGSTDTQYF	TRBV29-1	TRBJ2-3
TGCAGTGCTGGACTGAACACTGAAGCTTTCTTT	CSAGLNTEAFF	TRBV20-1	TRBJ1-1
TGTGCCAGCAGCTACGACGTGGACAGGGTCGAGTCTGGAAACACCATATATTTT	CASSYDVDRVESGNTIYF	TRBV11-2	TRBJ1-3
TGCGCCAGCCAAAGCAGGGGGCGGAACTCTGGGGCCAACGTCCTGACTTTC	CASQSRGRNSGANVLTF	TRBV5-1	TRBJ2-6
TGTGCCAGCTCACTAGCGGGAGTTGTGTCGAACGAGCAGTACTTC	CASSLAGVVSNEQYF	TRBV6-4	TRBJ2-7
TGTGCCACCAGTGCTCGGACCGAGAATAGCAATCAGCCCCAGCATTTT	CATSARTENSNQPQHF	TRBV24-1	TRBJ1-5
TGTGCCAGTCCCCACCATCACGAGCAGTACTTC	CASPHHHEQYF	TRBV6-5	TRBJ2-7
TGTGCCAGCAGCTTAATTAGGGCAGTATTGTTGGAGACCCAGTACTTC	CASSLIRAVLLETQYF	TRBV7-3	TRBJ2-5
TGTGCCAGCAGCTTGTCAGGCTGGCATTATGGCTACACCTTC	CASSLSGWHYGYTF	TRBV7-6	TRBJ1-2
TGTGCCACCACCCCTGGCGAATTTGAAAAACTGTTTTTT	CATTPGEFEKLFF	TRBV24-1	TRBJ1-4
TGTGCCACCAGTGATTTCTGGGAGTCACACAGGGGGACGTCTGGGGCCAACGTCCTGACTTTC	CATSDFWESHRGTSGANVLTF	TRBV24-1	TRBJ2-6
TGTGCCAGCAGCCAAGGGCTTCCATATGTAAGAGAGACCCAGTACTTC	CASSQGLPYVRETQYF	TRBV14	TRBJ2-5
TGTGCCAGCAGTGACTCCTCCGGGACTAGCGGGTACAATGAGCAGTTCTTC	CASSDSSGTSGYNEQFF	TRBV6-4	TRBJ2-1
TGTGCCAGTAGTATCCCAGGGGGGGGCTACGAGCAGTACTTC	CASSIPGGGYEQYF	TRBV19	TRBJ2-7
TGTGGAATTACGGGGGGGCGCAATCAGCCCCAGCATTTT	CGITGGRNQPQHF	TRBV12-3	TRBJ1-5
TGCGCCAGCAGCTTGAAGTGGAGGCCCCTCAATCAGCCCCAGCATTTT	CASSLKWRPLNQPQHF	TRBV5-1	TRBJ1-5
TGTGCCAGCAGCGTAGGGCAGGGGGAAAAACTGTTTTTT	CASSVGQGEKLFF	TRBV9	TRBJ1-4
TGTGCCAGCAGTTACAGGACTAGCGGGCGTACGTACGAGCAGTACTTC	CASSYRTSGRTYEQYF	TRBV6-3	TRBJ2-7
TGTGCCAGCAGTTCGACAGGGGAAGTACCGCTCAAAAACATTCAGTACTTC	CASSSTGEVPLKNIQYF	TRBV27	TRBJ2-4
TGTGCGGCCAGGACAGGGGCGGCTTCCTACGAGCAGTACTTC	CAARTGAASYEQYF	TRBV11-3	TRBJ2-7
TGCGCCACAAGCTGGAGGGAGTACGAGCAGTACTTC	CATSWREYEQYF	TRBV10-1	TRBJ2-7
TGCGCCAGCAGCCAAGATCCCCGCGGGAGGGCTGAAGCTTTCTTT	CASSQDPRGRAEAFF	TRBV4-1	TRBJ1-1
TGTGCCAGCAGCGACGGTAACCGGGGGCAAAGGGCCACTGGGGCCAACGTCCTGACTTTC	CASSDGNRGQRATGANVLTF	TRBV11-2	TRBJ2-6
TGTGCCAGCAGTTACGGGAGCTTGATGGGAACCGGGGAGCTGTTTTTT	CASSYGSLMGTGELFF	TRBV6-2	TRBJ2-2
TGTGCCAGCAGTGAAGCCGGGGGGACGGGCAAATGTCCCTATGGCTACACCTTC	CASSEAGGTGKCPYGYTF	TRBV2	TRBJ1-2
TGTGCCAGCAGCCTCAGGGGAGACAATGAGCAGTTCTTC	CASSLRGDNEQFF	TRBV13	TRBJ2-1
TGTGCCAGCAGCCGTAAGGGGAAAAGTGACAATGAGCAGTTCTTC	CASSRKGKSDNEQFF	TRBV7-3	TRBJ2-1
TGCGCCAGCAAGGGGGGTTGCTACGAGCAGTACTTC	CASKGGCYEQYF	TRBV5-1	TRBJ2-7
TGTGCCAGCAGTTTGGGCTGCGAGACCCAGTACTTC	CASSLGCETQYF	TRBV12-3	TRBJ2-5
TGTGCCAGCAGCGCTGGACTATCTGACGGGGGTTTTGAAAAACTGTTTTTT	CASSAGLSDGGFEKLFF	TRBV7-9	TRBJ1-4
TGTGCCATCAGTGCCCCGGGACAGCTATGGGCAGCTTTCTTT	CAISAPGQLWAAFF	TRBV10-3	TRBJ1-1
TGTGCCAGCAGCAAAACCGGGAATCGTGGAGAGCCCAATCAGCCCCAGCATTTT	CASSKTGNRGEPNQPQHF	TRBV5-6	TRBJ1-5
TGCAGTGCTAGACCCCTTGCCAGAGGAAGCCAAGAGACCCAGTACTTC	CSARPLARGSQETQYF	TRBV20-1	TRBJ2-5
TGTGCCAGCAGCAGCCTTAGCTGGCAGCCCCAGCATTTT	CASSSLSWQPQHF	TRBV13	TRBJ1-5
TGCGCCAGCAGCTTCCCCCTTGGTGGACCGTCTGGCTACACCTTC	CASSFPLGGPSGYTF	TRBV5-1	TRBJ1-2
TGTGCCAGCAGTTACCCTCCTACAGGATCCCAGCATTTT	CASSYPPTGSQHF	TRBV6-5	TRBJ1-5
TGCAGTGCTTCGGGACTCCTTCAGTACTTC	CSASGLLQYF	TRBV20-1	TRBJ2-5
TGTGCCAGCAGTGACCTGATGTTAAAGGGACTAGCGGGAGGTGAGCAGTTCTTC	CASSDLMLKGLAGGEQFF	TRBV6-4	TRBJ2-1
TGTGCCAGCAGTTGGGCAGGTAACTATGGCTACACCTTC	CASSWAGNYGYTF	TRBV7-3	TRBJ1-2
TGCAGCGAATACAGGGCAACCTCTGGGGCCAACGTCCTGACTTTC	CSEYRATSGANVLTF	TRBV29-1	TRBJ2-6
TGCGCCAGCAGCTGGCTAGCGGGGAACAATGAGCAGTTCTTC	CASSWLAGNNEQFF	TRBV5-1	TRBJ2-1
TGTGCCAGCAGTTTCCCCAGGTGCGGAGAGACCCAGTACTTC	CASSFPRCGETQYF	TRBV6-6	TRBJ2-5
TGTGCCATCACCCCCCCCAGGAACACTGAAGCTTTCTTT	CAITPPRNTEAFF	TRBV10-3	TRBJ1-1
TGCGCCAGCAGCCAGAGTTACCACAGGGCAGGAGGGAACTATGGCTACACCTTC	CASSQSYHRAGGNYGYTF	TRBV4-1	TRBJ1-2
TGCGCCAGCAGCCAGAGAATTAGCAGGTCAGAGACTTCCCGCTCTGGAAACACCATATATTTT	CASSQRISRSETSRSGNTIYF	TRBV5-1	TRBJ1-3
TGTGCCAGCAGCGGTTGTCTGACAGATACGCAGTATTTT	CASSGCLTDTQYF	TRBV13	TRBJ2-3
TGTGCCAGCAGTAACCAGGGGGTATTTGAAAAACTGTTTTTT	CASSNQGVFEKLFF	TRBV6-5	TRBJ1-4
TGTGCCAGCAGCTGGAGGGTAGGCTCCTACAATGAGCAGTTCTTC	CASSWRVGSYNEQFF	TRBV7-3	TRBJ2-1
TGCGCCAGCAGCCACAAAAGGGAGGCCTCGTATAGCAATCAGCCCCAGCATTTT	CASSHKREASYSNQPQHF	TRBV4-1	TRBJ1-5
TGCAGTGCTAGTAAGACCCAGGGACGGGAAGAGACCCAGTACTTC	CSASKTQGREETQYF	TRBV20-1	TRBJ2-5
TGTGCCAGCAGCGACACGCGGGAGGTTCGCTCTGGAAACACCATATATTTT	CASSDTREVRSGNTIYF	TRBV7-9	TRBJ1-3
TGTGCCACCAGGTGGGGACAGGGGGTACAGGTTTCTGGAAACACCATATATTTT	CATRWGQGVQVSGNTIYF	TRBV24-1	TRBJ1-3
TGCGCCAGCGAGCTAGTAAGCTACGAGCAGTACTTC	CASELVSYEQYF	TRBV5-1	TRBJ2-7
TGTGCCAGCAGCTTAGAGGAAGTGACAGGCCAAGAGACCCAGTACTTC	CASSLEEVTGQETQYF	TRBV11-2	TRBJ2-5
TGTGCCAGCAGCTTCACACTGAACACTGAAGCTTTCTTT	CASSFTLNTEAFF	TRBV14	TRBJ1-1
TGTGCCAGCGGTGCAGGGGGCCCTCCTGGCTACACCTTC	CASGAGGPPGYTF	TRBV7-9	TRBJ1-2
TGTGCCAGCAGTTACAATTCAGGAACCTACAATGAGCAGTTCTTC	CASSYNSGTYNEQFF	TRBV6-5	TRBJ2-1
TGTGCCAGCAGCGGGGACAGGGGGCGAATCTATGGCTACACCTTC	CASSGDRGRIYGYTF	TRBV7-3	TRBJ1-2
TGTGCCAGCAGCTTAGCGCACGAACAGGGCTATGGCTACACCTTC	CASSLAHEQGYGYTF	TRBV7-9	TRBJ1-2
TGTGCCAGCAGAGACCCGGCTGAAGCTTTCTTT	CASRDPAEAFF	TRBV4-2	TRBJ1-1
TGTGCCAGCAGAGAAGACAGTGGCCGGGCCAATCAGCCCCAGCATTTT	CASREDSGRANQPQHF	TRBV7-3	TRBJ1-5
