TGTGCCACCAGTGAACATAAACGCCAGGGCTCGAGCTATGGCTACACCTTC	CATSEHKRQGSSYGYTF	TRBV24-1	TRBJ1-2
TGTGCCAGCAGTACGCTAGGGGATGGCTACACCTTC	CASSTLGDGYTF	TRBV6-5	TRBJ1-2
TGCGCCGGTGAGGGGCGGGGTCCTCACCCCGGGGAGCTGTTTTTT	CAGEGRGPHPGELFF	TRBV5-1	TRBJ2-2
TGTGCCAGCAGTCCACGGGTAGGGATGAACACTGAAGCTTTCTTT	CASSPRVGMNTEAFF	TRBV6-2	TRBJ1-1
TGTGCCAGCAGGAATAGGGTAGTAAGAGACGGGGAGCTGTTTTTT	CASRNRVVRDGELFF	TRBV12-3	TRBJ2-2
TGTGCTAGCAGCGACCAGGGGCCCTACGAGCAGTACTTC	CASSDQGPYEQYF	TRBV7-7	TRBJ2-7
TGTGCCAGCAGTTACTCGGACGAGGGAAACACCGGGGAGCTGTTTTTT	CASSYSDEGNTGELFF	TRBV6-5	TRBJ2-2
TGTGCCAGCAGTTTAGACAGGATGAATTGGAATGAGCAGTTCTTC	CASSLDRMNWNEQFF	TRBV27	TRBJ2-1
TGTGCCAGCAGCGACAGGGGGAGTTCACCCCTCCACTTT	CASSDRGSSPLHF	TRBV25-1	TRBJ1-6
TGTGCCAGCAGTTACCGTCGGGACAGGGGGCACATGAACACTGAAGCTTTCTTT	CASSYRRDRGHMNTEAFF	TRBV6-3	TRBJ1-1
TGCAGTGCTAGACAGTGCCAGACTAGCCCTGTTCGTACCAGCTCCTACAATGAGCAGTTCTTC	CSARQCQTSPVRTSSYNEQFF	TRBV20-1	TRBJ2-1
TGTGCCAGCAGCTTAGCACAGGGCGCCCGTGAAAAACTGTTTTTT	CASSLAQGAREKLFF	TRBV7-9	TRBJ1-4
TGTGCCATCAGGTTAGCCCCCCGGGGACGACCTAGCACAGATACGCAGTATTTT	CAIRLAPRGRPSTDTQYF	TRBV10-3	TRBJ2-3
TGTGCCAGCAGGGATGAGGACAGGCAAGCAGATACGCAGTATTTT	CASRDEDRQADTQYF	TRBV6-4	TRBJ2-3
TGCGCCAGCAGCCAAAAAGGACAGGCCCATGGCTACACCTTC	CASSQKGQAHGYTF	TRBV4-1	TRBJ1-2
TGTGCCAGCAGTTACTCGGCGGGCAAACGAACACTGGCCTACGAGCAGTACTTC	CASSYSAGKRTLAYEQYF	TRBV6-2	TRBJ2-7
TGTGCCTGGAGTGCCCGGAGGCGAGCAGATACGCAGTATTTT	CAWSARRRADTQYF	TRBV30	TRBJ2-3
TGCAGTGCTAGCGGCTACACAGGGGACACCTTC	CSASGYTGDTF	TRBV20-1	TRBJ1-2
TGCGCCAGCATATGGTGGAGGACGCCCGGAGGCAATCAGCCCCAGCATTTT	CASIWWRTPGGNQPQHF	TRBV10-2	TRBJ1-5
TGCGCCTGGGACAGTGGCACTGAAGCTTTCTTT	CAWDSGTEAFF	TRBV10-2	TRBJ1-1
TGTGCCAGCAGCGGTTGGACAGGGCTGGCCTACGAGCAGTACTTC	CASSGWTGLAYEQYF	TRBV7-3	TRBJ2-7
TGTGCCAGCAGCCCCACAGGCCGGGGGACTAGGGGTTATAGCTCCTACAATGAGCAGTTCTTC	CASSPTGRGTRGYSSYNEQFF	TRBV13	TRBJ2-1
TGTGCCAGCAGTGGCACAATTTCCGACAGACTCAGGCGAAAAGTAGATGAGGAGGGCTACACCTTC	CASSGTISDRLRRKVDEEGYTF	TRBV25-1	TRBJ1-2
TGCAGTGCAACACAGGGAGGGGAGCAGTATTTT	CSATQGGEQYF	TRBV20-1	TRBJ2-3
TGTGCCAGCAGCATAGCGGGACAGGATTATGGGAACTATGGCTACACCTTC	CASSIAGQDYGNYGYTF	TRBV9	TRBJ1-2
TGTGGGGAGCTAGAGAACACCATATATTTT	CGELENTIYF	TRBV24-1	TRBJ1-3
TGTGCCAGCAGTACAGGGCATGAGCTAGCCAAAAACATTCAGTACTTC	CASSTGHELAKNIQYF	TRBV6-6	TRBJ2-4
TGCAGTGCTAGAGATTCGTCCGAGGCGCGAGATACGCAGTATTTT	CSARDSSEARDTQYF	TRBV20-1	TRBJ2-3
TGTGCCACCAGCAGGACCCAGTTCCTACAAGAGACCCAGTACTTC	CATSRTQFLQETQYF	TRBV15	TRBJ2-5
TGTGCCCCCGAACGGGCGAGAAGAACAGAGACCCAGTACTTC	CAPERARRTETQYF	TRBV25-1	TRBJ2-5
TGTGCCAGCAGTAGCGGGTGTTGGGATGAGCAGTTCTTC	CASSSGCWDEQFF	TRBV27	TRBJ2-1
TGTGCCACCAGCAGACAGGGGAGACAGCCCCAGCATTTT	CATSRQGRQPQHF	TRBV15	TRBJ1-5
TGTGCCAAGAAATCACGGGCAGGCTATGGCTACACCTTC	CAKKSRAGYGYTF	TRBV6-8	TRBJ1-2
TGCGCCAGCAGCACCAGGAGGACACTTACTAACTATGGCTACACCTTC	CASSTRRTLTNYGYTF	TRBV5-1	TRBJ1-2
TGTGCCAGCAGTTTACGTGTAGTCAGCACAGATACGCAGTATTTT	CASSLRVVSTDTQYF	TRBV12-4	TRBJ2-3
TGTGCCAGCAGCGACAGTCCGGGCCATATGAACACTGAAGCTTTCTTT	CASSDSPGHMNTEAFF	TRBV5-4	TRBJ1-1
TGTGCCAGCAACGGACTAGCGGGGGGGCCCCGCTACTACGAGCAGTACTTC	CASNGLAGGPRYYEQYF	TRBV9	TRBJ2-7
TGTGCCAGCAGCCAGGGGCGGACAGATACGCAGTATTTT	CASSQGRTDTQYF	TRBV13	TRBJ2-3
TGTGCCAGCAGTGGGACAGCAGAAAAACTGTTTTTT	CASSGTAEKLFF	TRBV27	TRBJ1-4
TGTGCCAGCAGCCAATCACGGGACAGGCCTGAAGCTTTCTTT	CASSQSRDRPEAFF	TRBV14	TRBJ1-1
TGTGCCAGCAGCACACGGGAGGGCCCTGGGTACAATGAGCAGTTCTTC	CASSTREGPGYNEQFF	TRBV7-8	TRBJ2-1
TGTGCCAGCAGCTTACTTGGTCTAGTAGATACGCAGTATTTT	CASSLLGLVDTQYF	TRBV7-2	TRBJ2-3
TGTGCCAGCAGCTTAGCGAGGGGGGGGGCAGGAGTGGCCTACGAGCAGTACTTC	CASSLARGGAGVAYEQYF	TRBV7-2	TRBJ2-7
TGCGCCAGCAGCCACCGGAGAGGGATTGAAGCTTTCTTT	CASSHRRGIEAFF	TRBV4-1	TRBJ1-1
TGTGCCAGCAGCGGGCGGGACAGGGTACGCTACGAGCAGTACTTC	CASSGRDRVRYEQYF	TRBV13	TRBJ2-7
TGTGCCAGCAAGAAGACTAGCGGAGGGAATGAGCAGTTCTTC	CASKKTSGGNEQFF	TRBV12-3	TRBJ2-1
TGCAGTGCTCGAGGGTCCTACGAGCAGTACTTC	CSARGSYEQYF	TRBV20-1	TRBJ2-7
TGTGCCAGCGGGACAGGGGGCGGAACATCTATAGAGACCCAGTACTTC	CASGTGGGTSIETQYF	TRBV6-1	TRBJ2-5
TGTGCCAGCAGTAGGACCAATCAGCCCCAGCATTTT	CASSRTNQPQHF	TRBV28	TRBJ1-5
TGTGCCAGCAGCCAGTTTTCCAAAGGCAGGATGAACACTGAAGCTTTCTTT	CASSQFSKGRMNTEAFF	TRBV14	TRBJ1-1
TGTGCCAGCAGACCGGGAAGGTCCTACGAGCAGTACTTC	CASRPGRSYEQYF	TRBV6-2	TRBJ2-7
TGTGCCAGCGTGGCAATCGGGGGGGGGGCCGCACGGGGGGACAATGAGCAGTTCTTC	CASVAIGGGAARGDNEQFF	TRBV9	TRBJ2-1
TGTGCCAGCAGTTACCTTCACAGACGGGACAGGGCCTACAATGAGCAGTTCTTC	CASSYLHRRDRAYNEQFF	TRBV6-6	TRBJ2-1
TGTGCCAGCAGCTTAGACGGTAAGACTGTATCAACTAATGAAAAACTGTTTTTT	CASSLDGKTVSTNEKLFF	TRBV13	TRBJ1-4
TGTGCCACCAGTGACCCCGACAGCCTAGCCGCCGGGGAGCTGTTTTTT	CATSDPDSLAAGELFF	TRBV24-1	TRBJ2-2
TGTGCCAGCAGCCAACGTCACAGGGCACAAGAGACCCAGTACTTC	CASSQRHRAQETQYF	TRBV3-1	TRBJ2-5
TGTGCCAGCAGCTTCCTTGGACAGGGGCGATACGAGCAGTACTTC	CASSFLGQGRYEQYF	TRBV7-8	TRBJ2-7
TGTGCCAGACTAGCGGGGGGGCGCTTTGACGAGCAGTACTTC	CARLAGGRFDEQYF	TRBV7-3	TRBJ2-7
TGTGCCAGCAGCGGGCGGATCAATGAGCAGTTCTTC	CASSGRINEQFF	TRBV13	TRBJ2-1
TGTGCCAGCAGTCCTCCCCCGACGGCGACAGGGGTTGTCTACGAGCAGTACTTC	CASSPPPTATGVVYEQYF	TRBV27	TRBJ2-7
TGTGCCAGCAGTCCGGCCCCTGCTCAGGTCCAAGAGACCCAGTACTTC	CASSPAPAQVQETQYF	TRBV6-1	TRBJ2-5
TGTGCCACCAGCTCCCGCAACCGACAGGGGAAAACCTACGAGCAGTACTTC	CATSSRNRQGKTYEQYF	TRBV15	TRBJ2-7
TGTGCCAGGGACGGGGGCTACGAGCAGTACTTC	CARDGGYEQYF	TRBV6-6	TRBJ2-7
TGCAGCGTACAGGGGGCCAACGAAGCTTTCTTT	CSVQGANEAFF	TRBV29-1	TRBJ1-1
TGTGCCAGCAGCTGGGATCCTGGTTACAGGGACGAACTCGGGGTTCCCACTGAAGCTTTCTTT	CASSWDPGYRDELGVPTEAFF	TRBV13	TRBJ1-1
TGCGCCAGCAGCCAAGATAAGCAGGTAGGGGGTGAAAAACTGTTTTTT	CASSQDKQVGGEKLFF	TRBV4-1	TRBJ1-4
TGTGCCAGCAGCTTCTGGGTCCAGGGCAGGGTGGGCAATCAGCCCCAGCATTTT	CASSFWVQGRVGNQPQHF	TRBV7-4	TRBJ1-5
TGTGCCAGCACTAACAGGGTTTATGAAGCTTTCTTT	CASTNRVYEAFF	TRBV7-7	TRBJ1-1
TGCGCCAGCAGCCAAGTTGGGGGGACTAGCCCCTCCTACGAGCAGTACTTC	CASSQVGGTSPSYEQYF	TRBV4-1	TRBJ2-7
TGCGCCAGCAATCGGGCATGGACAGGTGAAGCTTTCTTT	CASNRAWTGEAFF	TRBV10-1	TRBJ1-1
TGCAGTGCCGCTGATCAACTAGCGAGAGGAGAGACCCAGTACTTC	CSAADQLARGETQYF	TRBV20-1	TRBJ2-5
TGTGCCAGCAGCGTAGGACCGACAGGGGGCGGACTCTGGCAGCCCCAGCATTTT	CASSVGPTGGGLWQPQHF	TRBV9	TRBJ1-5
TGCGCCAGCAGTGAAGTCCAGGCCCGGTCTGCCCAAGAGACCCAGTACTTC	CASSEVQARSAQETQYF	TRBV10-1	TRBJ2-5
TGTGCCATCAGGCAGGGGGGGCGTGAGCAGTTCTTC	CAIRQGGREQFF	TRBV10-3	TRBJ2-1
TGTGCCAGCAGTGGGACTAGCGGGGGGGCACCCTCCATTCAGTACTTC	CASSGTSGGAPSIQYF	TRBV12-3	TRBJ2-4
TGTGCCAGCAGGAAGAAGGGACAGGGGCTCCTCGGCTACACCTTC	CASRKKGQGLLGYTF	TRBV12-3	TRBJ1-2
TGTGCCAGCAGAACGGGACAGGGCTCTGGGGCCAACGTCCTGACTTTC	CASRTGQGSGANVLTF	TRBV6-1	TRBJ2-6
TGTGCCAGCTCAGGGCACAGGTCCCTAGGAGAGACCCAGTACTTC	CASSGHRSLGETQYF	TRBV5-5	TRBJ2-5
TGTGCCAGCAGCTTCGCGGGAGGCCCCAATCAGCCCCAGCATTTT	CASSFAGGPNQPQHF	TRBV5-5	TRBJ1-5
TGCGCCAGCGATGGGGACATGGGAAGCTCCTATAATTCACCCCTCCACTTT	CASDGDMGSSYNSPLHF	TRBV5-1	TRBJ1-6
TGCAGTGCTAGTCCAATGGGGGACAGGGACACCGGGGAGCTGTTTTTT	CSASPMGDRDTGELFF	TRBV20-1	TRBJ2-2
TGTGCCATAGTAGCGGGGGATGAGCAGTTCTTC	CAIVAGDEQFF	TRBV6-5	TRBJ2-1
TGTGCCAGCAGTGGCCGCGGGGACCAGGACGAGCAGTACTTC	CASSGRGDQDEQYF	TRBV6-3	TRBJ2-7
TGTGCCAGCAGTGACCTGTCCAGTAACCGAGATCCGGCCGCTAAGGAGTACGAGCAGTACTTC	CASSDLSSNRDPAAKEYEQYF	TRBV6-4	TRBJ2-7
TGCAGTGGGGGCCGAGATCAGCCCCAGCATTTT	CSGGRDQPQHF	TRBV20-1	TRBJ1-5
TGTGCCAGCAGCTTGGTAGGAAAGAGTTATAGCAATCAGCCCCAGCATTTT	CASSLVGKSYSNQPQHF	TRBV5-8	TRBJ1-5
TGTGCCAGCCACAAAAGTGTACGGTTGAACACTGAAGCTTTCTTT	CASHKSVRLNTEAFF	TRBV14	TRBJ1-1
TGTGTCAGATATGATGAGCAGTTCTTC	CVRYDEQFF	TRBV12-3	TRBJ2-1
TGCGCCCGCCGCTCCTACGAGCAGTACTTC	CARRSYEQYF	TRBV5-1	TRBJ2-7
TGTGCCACCAGCAGAGATGCTCCCAGGGGCCTTACCCTCCACTTT	CATSRDAPRGLTLHF	TRBV15	TRBJ1-6
TGTGCCAGCAGTTACGCGCCAAGGTGGAGGGCCTACGAGCAGTACTTC	CASSYAPRWRAYEQYF	TRBV6-3	TRBJ2-7
TGTGCCAGCAGCCAGGGAAACCCAAATGAGCAGTTCTTC	CASSQGNPNEQFF	TRBV3-1	TRBJ2-1
TGTGCCAGATGGGACAGGGTCCGTGAGGCCAACGTCCTGACTTTC	CARWDRVREANVLTF	TRBV19	TRBJ2-6
TGTGCCAGCAGCGAGGGACAGGCTAACTATGGCTACACCTTC	CASSEGQANYGYTF	TRBV9	TRBJ1-2
TGTGCCAGCAGTTACAGAAGGGAGGGGGGTAGAGAGACCCAGTACTTC	CASSYRREGGRETQYF	TRBV6-5	TRBJ2-5
TGTGCCAGCAGTTTCCGGGACAGACTGAGAGGAAGGATGGGTAACACTGAAGCTTTCTTT	CASSFRDRLRGRMGNTEAFF	TRBV6-5	TRBJ1-1
TGTGCCACCGACAGGGGACAATACTATGGCTACACCTTC	CATDRGQYYGYTF	TRBV24-1	TRBJ1-2
TGTGCCAGCAGCGGCCCCCCACCGGGACCCAGTAATTCACCCCTCCACTTT	CASSGPPPGPSNSPLHF	TRBV13	TRBJ1-6
TGTGCCAGCAGCTGTTCTGAAGGGGGGAATGAAAAACTGTTTTTT	CASSCSEGGNEKLFF	TRBV13	TRBJ1-4
TGCGCCAGCAGTTCGGGGGGGGACGAGCAGTACTTC	CASSSGGDEQYF	TRBV10-1	TRBJ2-7
TGTGCCAGCAGCTTATGCCAGGGACAGACAGATACGCAGTATTTT	CASSLCQGQTDTQYF	TRBV5-8	TRBJ2-3
TGTGCCAGCAGCTTAGTGGGCCAGGGGGAGGGGAGAGCTGGGGCCAACGTCCTGACTTTC	CASSLVGQGEGRAGANVLTF	TRBV9	TRBJ2-6
TGTGCCAGCAGTGAATGGACGGACAGGAGTACAGATACGCAGTATTTT	CASSEWTDRSTDTQYF	TRBV25-1	TRBJ2-3
TGCAGCGTCGATCCGGGACAGGGCACTGAAGCTTTCTTT	CSVDPGQGTEAFF	TRBV29-1	TRBJ1-1
TGTGCCAGCAGGTCCGGACAGCACATGAACACTGAAGCTTTCTTT	CASRSGQHMNTEAFF	TRBV7-3	TRBJ1-1
TGTGCTAGTGGTTTGGTACTCCGGGACAGGTTTATTACGGCGGGGATGAACACTGAAGCTTTCTTT	CASGLVLRDRFITAGMNTEAFF	TRBV12-5	TRBJ1-1
TGTGCCAGCAGTGTGGGGAACTCCTACGAGCAGTACTTC	CASSVGNSYEQYF	TRBV6-5	TRBJ2-7
TGTGCCGGGAGAACAGGGAGGGTCGAGCAGTACTTC	CAGRTGRVEQYF	TRBV7-9	TRBJ2-7
TGTGCCAGCGCGAGCCGCGGGGTTTTCTACGAGCAGTACTTC	CASASRGVFYEQYF	TRBV19	TRBJ2-7
TGTGCCAGCCCCCGACTAGAGGACACCGGGGAGCTGTTTTTT	CASPRLEDTGELFF	TRBV7-8	TRBJ2-2
TGTGCCAGCAGTTATAGACAGGGAGACATTCAGTACTTC	CASSYRQGDIQYF	TRBV12-3	TRBJ2-4
TGTGCCAGCAGCGACCAACCTACCGGTGAGAACACTGAAGCTTTCTTT	CASSDQPTGENTEAFF	TRBV7-3	TRBJ1-1
TGTGCCAGCAGCCCCCAGTTCTACGAGCAGTACTTC	CASSPQFYEQYF	TRBV7-4	TRBJ2-7
TGTGCCAGCACCTCCAGCGCTGAGCAGTTCTTC	CASTSSAEQFF	TRBV6-4	TRBJ2-1
TGTGCCTGGAGGCGGCGGGACAGCTATGGCTACACCTTC	CAWRRRDSYGYTF	TRBV30	TRBJ1-2
TGTGGAGAATCTGCGGGGGGGGACAGCTCCTACAATGAGCAGTTCTTC	CGESAGGDSSYNEQFF	TRBV28	TRBJ2-1
TGTGCTAGCAGCTACGTCGGTAATTTCGGCACAGATACGCAGTATTTT	CASSYVGNFGTDTQYF	TRBV7-7	TRBJ2-3
TGTGCCAGCAGCAAGAGTAACGAGCAGTTCTTC	CASSKSNEQFF	TRBV11-2	TRBJ2-1
TGTGCCAGCAGCTTGGGACAGGATCGCTCTGGGGCCAACGTCCTGACTTTC	CASSLGQDRSGANVLTF	TRBV5-6	TRBJ2-6
TGTGCCAGTAGTATCGAAAGCACTATGGACACCGGGGAGCTGTTTTTT	CASSIESTMDTGELFF	TRBV19	TRBJ2-2
TGTGCGGACAGGGTGGATGGCTACACCTTC	CADRVDGYTF	TRBV15	TRBJ1-2
TGTGCCAGCAGCTCCTCAGGAAACCTGTTTTTT	CASSSSGNLFF	TRBV9	TRBJ1-4
TGTGCCAGCTCACCTTCTGTTCCGGACAGGGCTGGGACAGATCAGCCCCAGCATTTT	CASSPSVPDRAGTDQPQHF	TRBV18	TRBJ1-5
TGCGCCAGCAGCTTGCTTCTAGCGGGGCAAGAGACCCAGTACTTC	CASSLLLAGQETQYF	TRBV5-1	TRBJ2-5
TGTGCCAGCACTTCCCAAGGCAGCTCTGGAAACACCATATATTTT	CASTSQGSSGNTIYF	TRBV27	TRBJ1-3
TGTGCCAGCAGCCGTGGTCCAGGACAGGGGGAGGTAAGTAGCAATCAGCCCCAGCATTTT	CASSRGPGQGEVSSNQPQHF	TRBV7-3	TRBJ1-5
TGTGCCAGCAGCAGGGACAGGGGATTGAACACCGGGGAGCTGTTTTTT	CASSRDRGLNTGELFF	TRBV7-2	TRBJ2-2
TGTGCCAGCAGTTCGGGGCTTACCGAAAAACTGTTTTTT	CASSSGLTEKLFF	TRBV6-8	TRBJ1-4
TGTGCCAGCAGCGCCTCCTTTTCATCCCCCCTCCACTTT	CASSASFSSPLHF	TRBV9	TRBJ1-6
TGCGCCAGCAGCTTGTTCAGGGAATTCGCCAAAAACATTCAGTACTTC	CASSLFREFAKNIQYF	TRBV5-1	TRBJ2-4
TGTGCCAGCAGCTTAGAAATACGTGGACTGAGTTTACATGAAGCTTTCTTT	CASSLEIRGLSLHEAFF	TRBV11-3	TRBJ1-1
TGTGCACCCAGCGGGAGGTTGAACACCGGGGAGCTGTTTTTT	CAPSGRLNTGELFF	TRBV6-5	TRBJ2-2
TGCGCCAGCAGTGAAGCCCCAAATACAATGGGGGACAAACCTAATATCAATCAGCCCCAGCATTTT	CASSEAPNTMGDKPNINQPQHF	TRBV10-1	TRBJ1-5
TGTGCCAGCAGAACGTCAATGAGGGTTTCAGATCAGAACACCGGGGAGCTGTTTTTT	CASRTSMRVSDQNTGELFF	TRBV27	TRBJ2-2
TGTGCCAGCTCACCTACGTGGCTCCCGGAGACCCAGTACTTC	CASSPTWLPETQYF	TRBV18	TRBJ2-5
TGCGCCAGCCGTGCGGGAGATGAGCAGTTCTTC	CASRAGDEQFF	TRBV10-1	TRBJ2-1
TGTATTTGGCGGGACGGCTACACCTTC	CIWRDGYTF	TRBV7-9	TRBJ1-2
TGTGCCACCAGCAGAGGTCCCTGGACAGGTCCCACCCAGTACTTC	CATSRGPWTGPTQYF	TRBV15	TRBJ2-5
TGTGTACTTAGTGCGCCCAACACCGGGGAGCTGTTTTTT	CVLSAPNTGELFF	TRBV7-9	TRBJ2-2
TGTGCCAGCAGTAGGGGGACAGGTGGCACCGGGGAGCTGTTTTTT	CASSRGTGGTGELFF	TRBV12-3	TRBJ2-2
TGTGCCAGCATCAGAGGATACTATGGCTACACCTTC	CASIRGYYGYTF	TRBV3-1	TRBJ1-2
TGTGCCAGCAGTGGAGGGAGCAGGGGCAATGAGCAGTTCTTC	CASSGGSRGNEQFF	TRBV6-4	TRBJ2-1
TGTGCCAGCGGGGGCTTCAACACCGGGGAGCTGTTTTTT	CASGGFNTGELFF	TRBV6-5	TRBJ2-2
TGTGCCAGCAGGCAACTCAGCGCAGACGAGCAGTACTTC	CASRQLSADEQYF	TRBV5-5	TRBJ2-7
TGTGCCAGCAGCAATGGCCCACGGGGGCGGGTCAATCAGCCCCAGCATTTT	CASSNGPRGRVNQPQHF	TRBV7-6	TRBJ1-5
TGTGCCAGCAGTAGGGATGGGACCAATAGCAATCAGCCCCAGCATTTT	CASSRDGTNSNQPQHF	TRBV27	TRBJ1-5
TGTGCCAGCAGTCGTAGACAGTATTTT	CASSRRQYF	TRBV6-6	TRBJ2-3
TGTGCCAGCAGCCTTAGGGACAGGGGGGATGGCTACACCTTC	CASSLRDRGDGYTF	TRBV3-1	TRBJ1-2
TGCGCCAGCAGAGCGACAGGAAGGAACACCGGGGAGCTGTTTTTT	CASRATGRNTGELFF	TRBV10-1	TRBJ2-2
TGTGCCAGCATGGCGCCTAACCCCGCAGGGGGGGGGGGGACGGAGCAGTACTTC	CASMAPNPAGGGGTEQYF	TRBV5-6	TRBJ2-7
TGCGCCAGCAGTGCTAACGGGACAGGCTATAATTCACCCCTCCACTTT	CASSANGTGYNSPLHF	TRBV10-1	TRBJ1-6
TGCGCCAGCAGCTTGGACAGGGATAGCAATCAGCCCCAGCATTTT	CASSLDRDSNQPQHF	TRBV5-1	TRBJ1-5
TGTGCCAGCAAGCCAGCTGGACATGAGCAGTTCTTC	CASKPAGHEQFF	TRBV6-8	TRBJ2-1
TGCAGTGCTAGTCATTTAGATGAGCAGTTCTTC	CSASHLDEQFF	TRBV20-1	TRBJ2-1
TGTGCCAGCAGCGTTCCCCCGACAGGGGCTGAAGCTTTCTTT	CASSVPPTGAEAFF	TRBV6-2	TRBJ1-1
TGTGCCAGCAGCGGCCTCAACGAGCAGTACTTC	CASSGLNEQYF	TRBV6-2	TRBJ2-7
TGTGCCAGCAGTTTTCCGCGGGAGGGGGCCTACGAGCAGTACTTC	CASSFPREGAYEQYF	TRBV6-3	TRBJ2-7
TGTGCCAGCAGTCGACACTATCAGCCCCAGCATTTT	CASSRHYQPQHF	TRBV6-4	TRBJ1-5
TGTGCCAGCAGCCAAGCTCCAAGGCTCCGACAACGGCCCACGAGCTCTGGGGCCAACGTCCTGACTTTC	CASSQAPRLRQRPTSSGANVLTF	TRBV3-1	TRBJ2-6
TGCGCCAGCAGCTTGGTAAAAACACGGCAGACAGGGGGCTACGAGCAGTACTTC	CASSLVKTRQTGGYEQYF	TRBV5-1	TRBJ2-7
TGTGCCAGCAGAAACCATACAGGGTATGAAAAACTGTTTTTT	CASRNHTGYEKLFF	TRBV6-5	TRBJ1-4
TGCGCCAGCAGCCACCCGACGCGGGCCGGCTACACCTTC	CASSHPTRAGYTF	TRBV4-3	TRBJ1-2
TGTGCCACCATTGACACCTGGGACAGAAGTCACTACGAGCAGTACTTC	CATIDTWDRSHYEQYF	TRBV24-1	TRBJ2-7
TGCGCCAGCACCGGGAGGGTGGTAGTCCCCCGAGAGGATGAGCAGTTCTTC	CASTGRVVVPREDEQFF	TRBV10-2	TRBJ2-1
TGTGCCAGCAGTTACATCTGGGCCGGGACAGGGCAGACCCAGTACTTC	CASSYIWAGTGQTQYF	TRBV6-5	TRBJ2-5
TGTGCCATCAGTGAAGCTGGGCGACCGGGACTAGCATGGACCCGCTACGAGCAGTACTTC	CAISEAGRPGLAWTRYEQYF	TRBV10-3	TRBJ2-7
TGTGCCAGCAGGAGGACAGGGTCGAACACCGGGGAGCTGTTTTTT	CASRRTGSNTGELFF	TRBV12-4	TRBJ2-2
TGTGCCAGCAGCCAAGACAGGGGGGGGTATAGCAATCAGCCCCAGCATTTT	CASSQDRGGYSNQPQHF	TRBV3-1	TRBJ1-5
TGCAGTGCGGGCGGTTCCTATAATTCACCCCTCCACTTT	CSAGGSYNSPLHF	TRBV20-1	TRBJ1-6
TGTGCCAGCAGCCATCTCCATTGGGAGACCCAGTACTTC	CASSHLHWETQYF	TRBV5-6	TRBJ2-5
TGCGCCAGCACACCTGAAGCTTTCTTT	CASTPEAFF	TRBV4-1	TRBJ1-1
TGCGCCAGCGTCTCATTCCTAAGCCCGGGACTAGCACGGCAAGAGACCCAGTACTTC	CASVSFLSPGLARQETQYF	TRBV5-1	TRBJ2-5
TGTGCCAGTATCGGAATTCGCAGGGGCTCGGACTCCTACGAGCAGTACTTC	CASIGIRRGSDSYEQYF	TRBV19	TRBJ2-7
TGTGCCAGCAGGCGAGACCGGGGGGGCCTCACTGGGGCCAACGTCCTGACTTTC	CASRRDRGGLTGANVLTF	TRBV6-4	TRBJ2-6
TGTGCCAAATACGACATCCCTGTTCCGACTAGGAGAAGGAACCAAGAGACCCAGTACTTC	CAKYDIPVPTRRRNQETQYF	TRBV6-1	TRBJ2-5
TGTGCCAGCAGCTCCGGGACAGGGGCGGCGGAGACCCAGTACTTC	CASSSGTGAAETQYF	TRBV7-9	TRBJ2-5
TGTGGCTACCTGACAGGGTTGTGCACAGATACGCAGTATTTT	CGYLTGLCTDTQYF	TRBV5-4	TRBJ2-3
TGTGCCAGCAGTTTATCCACAGGGGGCAATGAGCAGTTCTTC	CASSLSTGGNEQFF	TRBV28	TRBJ2-1
TGCGCCAGCAGCCAAGACGGGACAGGGACTTCCTATAATTCACCCCTCCACTTT	CASSQDGTGTSYNSPLHF	TRBV4-3	TRBJ1-6
TGTGCCAGCAGACCTCTAGGACAGACATACGAGCAGTACTTC	CASRPLGQTYEQYF	TRBV27	TRBJ2-7
TGTGCCAGTAGTATCCCTCTGGGAGATACGCAGTATTTT	CASSIPLGDTQYF	TRBV19	TRBJ2-3
TGCGCCAGCAGCCAGACTAGCGGGGGTAGCTCCTACAATGAGCAGTTCTTC	CASSQTSGGSSYNEQFF	TRBV4-1	TRBJ2-1
TGCAGTGCTGGACAGGGGCGCAATGAGCAGTTCTTC	CSAGQGRNEQFF	TRBV20-1	TRBJ2-1
TGTGCCAGCAGCCAACCCGGGGAGGAGGGAACTAATGAAAAACTGTTTTTT	CASSQPGEEGTNEKLFF	TRBV4-2	TRBJ1-4
TGTGCTAGTGGTTTGAATATACGTCAAAGGGTCATCGAGACCCAGTACTTC	CASGLNIRQRVIETQYF	TRBV12-5	TRBJ2-5
TGCGCCAGCAGCCCTGGCAACAATGAGCAGTTCTTC	CASSPGNNEQFF	TRBV5-1	TRBJ2-1
TGTGCCAGCAGCTTAGAAGGGGTGGCTGAAGCTTTCTTT	CASSLEGVAEAFF	TRBV11-3	TRBJ1-1
TGTGCCAGCAGCCTAGCGGGAATGGGATTCAATGAGCAGTTCTTC	CASSLAGMGFNEQFF	TRBV5-6	TRBJ2-1
TGTGCCATTTGTGACCAGAGAGGGACTCAAGAGACCCAGTACTTC	CAICDQRGTQETQYF	TRBV25-1	TRBJ2-5
TGTGCCAGCAGTGACCGGGGGGACAGGAGATGTTACCGAGAAAACATTCAGTACTTC	CASSDRGDRRCYRENIQYF	TRBV6-4	TRBJ2-4
TGTGCCAGCAGCCCCGGGGAGCCCCAGCATTTT	CASSPGEPQHF	TRBV27	TRBJ1-5
TGTGCCAGCAGCCAGGTTCAAGGACAGCCCGGCCACTATGGCTACACCTTC	CASSQVQGQPGHYGYTF	TRBV9	TRBJ1-2
TGTGCCAGCAGCTTAGAGGGGGGGAACGCATCCAATCAGCCCCAGCATTTT	CASSLEGGNASNQPQHF	TRBV7-2	TRBJ1-5
TGCGCCAGCAGTGTGGAGGGGTCCTACGAGCAGTACTTC	CASSVEGSYEQYF	TRBV10-1	TRBJ2-7
TGTGCCAGCATCCGGCACCCGCCGGGGGGGGGCCGGTATGAGCAGTTCTTC	CASIRHPPGGGRYEQFF	TRBV6-5	TRBJ2-1
TGTGCCAGGCTGTATCCCCTGGCGGGCTATGGCTACACCTTC	CARLYPLAGYGYTF	TRBV6-3	TRBJ1-2
TGTGCCAGCAGCTTAATGGAAGCCTACGAGCAGTACTTC	CASSLMEAYEQYF	TRBV11-3	TRBJ2-7
TGTGCCAGCAGCTTTGCCCGGGGACAGGGGGCGGGAAACCAAGAGACCCAGTACTTC	CASSFARGQGAGNQETQYF	TRBV7-6	TRBJ2-5
TGTGCTAGTGGTTTGGTACGAGGTGAAGGACCCTCCTACGAGCAGTACTTC	CASGLVRGEGPSYEQYF	TRBV12-5	TRBJ2-7
TGCGCCAGCAGCCAAGCAGGTCCCCAAGAGACCCAGTACTTC	CASSQAGPQETQYF	TRBV4-1	TRBJ2-5
TGTGCCAGCAGTCTCCACTTCATCCCGGGGGGCGGGTCGAATTCTAACTATGGCTACACCTTC	CASSLHFIPGGGSNSNYGYTF	TRBV6-2	TRBJ1-2
TGTGCCTGGGACAGGGGGAATACCTCTGGAAACACCATATATTTT	CAWDRGNTSGNTIYF	TRBV30	TRBJ1-3
TGTCTGGTAGATCGGATAGAGACCCAGTACTTC	CLVDRIETQYF	TRBV27	TRBJ2-5
TGTGCCAGCAGCTTTAGAAAACCTGCTGAAAGTGAGCAGTACTTC	CASSFRKPAESEQYF	TRBV5-5	TRBJ2-7
TGTGCCAGCAGTACTAGAGGGGTGTTCCCGGAGACCCAGTACTTC	CASSTRGVFPETQYF	TRBV6-1	TRBJ2-5
TGTGCCGCACAAGGGGGTGGCTACACCTTC	CAAQGGGYTF	TRBV19	TRBJ1-2
TGCGCCAGCAGCTTGTATAGCGGGTGTCGGCAAGAGACCCAGTACTTC	CASSLYSGCRQETQYF	TRBV5-1	TRBJ2-5
TGCGCCAGCAGCTTAAAGGGCCACCAGGAACACAATGAGCAGTTCTTC	CASSLKGHQEHNEQFF	TRBV5-1	TRBJ2-1
TGTGCCACCAGCAGATGCCTCGGCACCGGTGAAGCTTTCTTT	CATSRCLGTGEAFF	TRBV15	TRBJ1-1
TGTGCCTGGAAAGTGGACTACGAGCAGTACTTC	CAWKVDYEQYF	TRBV30	TRBJ2-7
TGTGCCAGCAGGGCGCTTTCAATAGGGACGAGTGGCTACACCTTC	CASRALSIGTSGYTF	TRBV7-9	TRBJ1-2
TGTGCCAGCAGTTCCTACAGGGTAATCACTGAAGCTTTCTTT	CASSSYRVITEAFF	TRBV6-2	TRBJ1-1
TGCGCCAGCAGTGAGTTACTGGGCCTGACTGAAGCTTTCTTT	CASSELLGLTEAFF	TRBV10-1	TRBJ1-1
TGTGCCAGCAGCTTAGTACTAGAGACCCAGTACTTC	CASSLVLETQYF	TRBV7-9	TRBJ2-5
TGCGCCATGAAGGACGGTAATAACACCGGGGAGCTGTTTTTT	CAMKDGNNTGELFF	TRBV5-1	TRBJ2-2
TGTGCCAGCAGCCTCCAGGGGGCGGATGGGGGTTCACCCCTCCACTTT	CASSLQGADGGSPLHF	TRBV13	TRBJ1-6
TGTGCCAGCAGCAGCAGAGGGAAAGGACAGGGGGCCCACACTGAAGCTTTCTTT	CASSSRGKGQGAHTEAFF	TRBV9	TRBJ1-1
TGTGCCAGCAGCCATAAATACAGCGCTTTCTTT	CASSHKYSAFF	TRBV5-4	TRBJ1-1
TGTGCCAGCAGCCGTGAACTGGGGGGGGAAACTGAAGCTTTCTTT	CASSRELGGETEAFF	TRBV7-9	TRBJ1-1
TGTGCCAGCAGTTACCCGACAGGAGCGGGCTACGAGCAGTACTTC	CASSYPTGAGYEQYF	TRBV6-5	TRBJ2-7
TGTGCCAGCAGTTGTTTGGATAGCAATCAGCCCCAGCATTTT	CASSCLDSNQPQHF	TRBV6-2	TRBJ1-5
TGCAGTGCTAGAGGGGTGTCCGGGACTAGCGGGGGGGCAGAAGATACGCAGTATTTT	CSARGVSGTSGGAEDTQYF	TRBV20-1	TRBJ2-3
TGCGCCAGCAGTGAGAGACCCCCGAACACCGGGGAGCTGTTTTTT	CASSERPPNTGELFF	TRBV10-1	TRBJ2-2
TGTGCCAGCAGCTTAGGGGCAAATAGGGCAGATACGCAGTATTTT	CASSLGANRADTQYF	TRBV7-8	TRBJ2-3
TGTGCCAGCAGTTCCCAGGGGGTGAGCAATCAGCCCCAGCATTTT	CASSSQGVSNQPQHF	TRBV6-5	TRBJ1-5
TGCAGTCTTTGGGCGGGGTATGGCTACACCTTC	CSLWAGYGYTF	TRBV20-1	TRBJ1-2
TGCAGGGGGTCTGAAGCTTTCTTT	CRGSEAFF	TRBV20-1	TRBJ1-1
TGTGCCAGCACTGGAGGACAGGACTACGAGCAGTACTTC	CASTGGQDYEQYF	TRBV7-8	TRBJ2-7
TGCGCCAGCAGTGGCTGGACTAGCACAGATACGCAGTATTTT	CASSGWTSTDTQYF	TRBV10-1	TRBJ2-3
TGTGCTAGCACTCCGGACAGGGGCCCAGATGTGTACTTC	CASTPDRGPDVYF	TRBV7-7	TRBJ2-7
TGTGCCAGCAGGAAGCCTAGTCAAAACAATGAGCAGTTCTTC	CASRKPSQNNEQFF	TRBV7-6	TRBJ2-1
TGTGCCAGCAGTTCGAACGGAGGGTACTTC	CASSSNGGYF	TRBV27	TRBJ2-5
TGCAGCGATGCAGGGGGGCCGGAAGCTTTCTTT	CSDAGGPEAFF	TRBV29-1	TRBJ1-1
TGTGCCAGCAGCCCCCCCCCAGGGGGTGATGGCTACACCTTC	CASSPPPGGDGYTF	TRBV14	TRBJ1-2
TGTGCCAGCAGCTCATTCGGGACAGGGTCGTATAGCAATCAGCCCCAGCATTTT	CASSSFGTGSYSNQPQHF	TRBV13	TRBJ1-5
TGTGCCAGCAGTTTTAGCTATCAGCCCCAGCATTTT	CASSFSYQPQHF	TRBV27	TRBJ1-5
TGTGCCAGCAGCCCGGGGGGGAACACCGGGGAGCTGTTTTTT	CASSPGGNTGELFF	TRBV27	TRBJ2-2
TGCGCCAGCAGCCCAACCACAGGGGGCGTCAGAGGGCGGGTTTCACCCCTCCACTTT	CASSPTTGGVRGRVSPLHF	TRBV4-1	TRBJ1-6
TGTGCCAGCAGCGGGGGACAAGAGACCCAGTACTTC	CASSGGQETQYF	TRBV11-3	TRBJ2-5
TGTGCCAGCAGCCCTCACCGGGGTGCCCACACTGAAGCTTTCTTT	CASSPHRGAHTEAFF	TRBV11-2	TRBJ1-1
TGCAGCGTTCAAGCAGACTATGGCTACACCTTC	CSVQADYGYTF	TRBV29-1	TRBJ1-2
TGTGCCAGGTTCCCGGGACCGGAATCCTCTGGAAACACCATATATTTT	CARFPGPESSGNTIYF	TRBV2	TRBJ1-3
TGTGCCAGCAGCTTAAGAAAGTGGGGAACTAGCAATCAGCCCCAGCATTTT	CASSLRKWGTSNQPQHF	TRBV5-4	TRBJ1-5
TGTGCCAGTAGTGTGCAGGGAGTACTGTTCAATCAGCCCCAGCATTTT	CASSVQGVLFNQPQHF	TRBV19	TRBJ1-5
TGTGCCAGCAGCGGGAGGGGGGATGTTCACCCCATATATTTT	CASSGRGDVHPIYF	TRBV7-4	TRBJ1-3
TGTGCCAGCAGTAAGGGAGGGAGCACCGGGGAGCTGTTTTTT	CASSKGGSTGELFF	TRBV2	TRBJ2-2
TGTGCCAGCAGTGGCGCCGGGGGCCTCGCCTTATCCGGAAACACCATATATTTT	CASSGAGGLALSGNTIYF	TRBV25-1	TRBJ1-3
TGTGCCAGCAGCGTAGGGGGGAAGTTGTACGAGCAGTACTTC	CASSVGGKLYEQYF	TRBV9	TRBJ2-7
TGTGCCAGCAGAGTGAGGTGGGTAGGCACAAATGATAACTTC	CASRVRWVGTNDNF	TRBV28	TRBJ2-5
TGTGCCAGCAGCCTCGAGGGAGCTAACCGGGGCTACACCTTC	CASSLEGANRGYTF	TRBV7-4	TRBJ1-2
TGTGCCAGCAGTTTATCCTTATTGTGCACAGATACGCAGTATTTT	CASSLSLLCTDTQYF	TRBV27	TRBJ2-3
TGTGCCTGGAGAGGGGCCTACGAGCAGTACTTC	CAWRGAYEQYF	TRBV30	TRBJ2-7
TGTGCCAGCAGTTACTCGCGTACTAGCGGCTGCACAGATACGCAGTATTTT	CASSYSRTSGCTDTQYF	TRBV6-5	TRBJ2-3
TGCGCCAGCAGCTCCTCCCTAGGTTGGGCCAAAAACATTCAGTACTTC	CASSSSLGWAKNIQYF	TRBV5-1	TRBJ2-4
TGCGCCAGCAGCAGGGGGGAGGCTCAAAACATTCAGTACTTC	CASSRGEAQNIQYF	TRBV5-1	TRBJ2-4
TGCAGTGCTAGAGATGGGTCGACCAGGAGGGATACCCCCCACGAGCAGTACTTC	CSARDGSTRRDTPHEQYF	TRBV20-1	TRBJ2-7
TGTGCCACCAGTGACCAGCAGGGAACGGTCACTGAAGCTTTCTTT	CATSDQQGTVTEAFF	TRBV24-1	TRBJ1-1
TGCGCCAGCAGTGCCGTATTCGGGTCCTATAGCAATCAGCCCCAGCATTTT	CASSAVFGSYSNQPQHF	TRBV10-1	TRBJ1-5
TGTGCCAGCCTCACTAGCGGGAGAATGGGACGGTACGAGCAGTACTTC	CASLTSGRMGRYEQYF	TRBV11-3	TRBJ2-7
TGTGCCAGCAGCTTAGGGACAGGGGGCTCCGCCGGGGAGCTGTTTTTT	CASSLGTGGSAGELFF	TRBV7-8	TRBJ2-2
TGTGCCAGCAGAGAGGGACAGGGTTGTAGAGCCTCCAATCAGCCCCAGCATTTT	CASREGQGCRASNQPQHF	TRBV6-5	TRBJ1-5
TGCGCCAGCAGCCAAGATCCGGGGGGCCTCAACGAGCAGTACTTC	CASSQDPGGLNEQYF	TRBV4-3	TRBJ2-7
TGTGCCAGCAGACTCCCTCTCCGGGACAGGGGTTGGTACGAGCAGTACTTC	CASRLPLRDRGWYEQYF	TRBV2	TRBJ2-7
TGTGCCAGGAAACCGCCCTACGAGCAGTACTTC	CARKPPYEQYF	TRBV12-3	TRBJ2-7
TGTGCCAGCAGGACTTCGGTGAACACTGAAGCTTTCTTT	CASRTSVNTEAFF	TRBV28	TRBJ1-1
TGTGCCAGCAGACGGACAGCCCCCAGAAACACCGGGGAGCTGTTTTTT	CASRRTAPRNTGELFF	TRBV12-3	TRBJ2-2
TGCGCCAGCAGCCACCTTCTGACAGGGGCAACTAATGAAAAACTGTTTTTT	CASSHLLTGATNEKLFF	TRBV4-1	TRBJ1-4
TGTGCCAGCATCCGTTCATCGGGGGGGAGGGGGCAGTACTTC	CASIRSSGGRGQYF	TRBV6-4	TRBJ2-7
TGTGCCAGCAGTGAGATGAAACGACAGGGCTGTACGTTCTATGGCTACACCTTC	CASSEMKRQGCTFYGYTF	TRBV25-1	TRBJ1-2
TGTGCCTGGCCACTCGGGGGGAACACTGAAGCTTTCTTT	CAWPLGGNTEAFF	TRBV30	TRBJ1-1
TGCGCCAGCAGAAATAGTCTCAGGTACAATGAGCAGTTCTTC	CASRNSLRYNEQFF	TRBV10-1	TRBJ2-1
TGTGCCATGGGACTGGGTAGCACAGATACGCAGTATTTT	CAMGLGSTDTQYF	TRBV9	TRBJ2-3
TGTGCCAGCAGCCGTCTAAAGCACGCCCTACGCTACGAGCAGTACTTC	CASSRLKHALRYEQYF	TRBV6-5	TRBJ2-7
TGTGCCAGTACGGGAGGGGCTCTTGGGCATGAGCAGTTCTTC	CASTGGALGHEQFF	TRBV19	TRBJ2-1
TGCGCCAGCACCCGAAATGAGCAGTTCTTC	CASTRNEQFF	TRBV10-1	TRBJ2-1
TGTGCCAGCAGCTTAGTCCCTCGTTTACTTCGATACAATGAGCAGTTCTTC	CASSLVPRLLRYNEQFF	TRBV7-2	TRBJ2-1
TGTGCCAGCAGTTCGGGGGGGCGAGCCCTCCACTTT	CASSSGGRALHF	TRBV6-5	TRBJ1-6
TGTGCCAGCAGCTTAGGGACAGAGATACCTTACGAGCAGTACTTC	CASSLGTEIPYEQYF	TRBV7-8	TRBJ2-7
TGTGCCAGCAGTTTGACCGAACGAGGGTGCTGGAGATACGAGCAGTACTTC	CASSLTERGCWRYEQYF	TRBV6-3	TRBJ2-7
TGTGCCAGCTCACCAACGAACTATAGCGGGTTTACCACCGGGTGCAATGAGCAGTTCTTC	CASSPTNYSGFTTGCNEQFF	TRBV18	TRBJ2-1
TGTGCCAGCAGCCTGCCGATCAAACAGGAGACCTATGGCTACACCTTC	CASSLPIKQETYGYTF	TRBV28	TRBJ1-2
TGTGCCAGCAGTCGGGACAGGGGTTTTTCCCAGTACTTC	CASSRDRGFSQYF	TRBV6-1	TRBJ2-5
TGTGCCAGCAGTGACTCGATGACATGGGCGGGGGGCTCTGGCGAGCAGTACTTC	CASSDSMTWAGGSGEQYF	TRBV6-4	TRBJ2-7
TGTGCCACCAGTGATCGCGGAGAGCTCCACACACTGTTTTTT	CATSDRGELHTLFF	TRBV24-1	TRBJ1-4
TGTGCCAGCAGCTTAGGAAGGGCTAGCGATGGCTACACCTTC	CASSLGRASDGYTF	TRBV7-3	TRBJ1-2
TGTGCCAGCAGTTTAGGGCTCAAGAGTCAGCCCCAGCATTTT	CASSLGLKSQPQHF	TRBV12-3	TRBJ1-5
TGTGCCAGCAGCCCCCCCCCCACAGGCGACGGAGGGAGGAACACCGGGGAGCTGTTTTTT	CASSPPPTGDGGRNTGELFF	TRBV7-9	TRBJ2-2
TGTGCCAGCAGCTGTAGACCAAGCGGCAAAGCGACTGAAGCTTTCTTT	CASSCRPSGKATEAFF	TRBV7-3	TRBJ1-1
TGTGCCAGCAGCCCCCGACAGGGGAGCTCCTACGAGCAGTACTTC	CASSPRQGSSYEQYF	TRBV4-2	TRBJ2-7
TGTGCCAGCGGTCACAGGGAGGCCGAGGGCTACACCTTC	CASGHREAEGYTF	TRBV28	TRBJ1-2
TGCGCCAGCATAAAGACAGGGCATAGCAATCAGCCCCAGCATTTT	CASIKTGHSNQPQHF	TRBV5-1	TRBJ1-5
TGCAGCGTACGAGTTCCCAGGGGACAGGGGAAATCCTATGGCTACACCTTC	CSVRVPRGQGKSYGYTF	TRBV29-1	TRBJ1-2
TGTGCCAGCAGCAACTTTCCTTCCGGTATACCCGGAGTCGAGCAGTACTTC	CASSNFPSGIPGVEQYF	TRBV5-4	TRBJ2-7
TGCGCCAGCCCGAGGGGGACAGGGTCTGAGCTGAACACCGGGGAGCTGTTTTTT	CASPRGTGSELNTGELFF	TRBV10-1	TRBJ2-2
TGTGCCAGCAGTTGTTGTGGAGAGTACAGGGTCTGCTACGAGCAGTACTTC	CASSCCGEYRVCYEQYF	TRBV28	TRBJ2-7
TGTGCTAGTGGTTTAAAGCTGGGAGCAGAGTCCTACGAGCAGTACTTC	CASGLKLGAESYEQYF	TRBV12-5	TRBJ2-7
TGTGCCTTGGACAGGGGGAGCAATCAGCCCCAGCATTTT	CALDRGSNQPQHF	TRBV10-3	TRBJ1-5
TGTGCCAGCAGCTTGGCTTTCCGGGGGGGCCGCGTTCACACCGGGGAGCTGTTTTTT	CASSLAFRGGRVHTGELFF	TRBV5-8	TRBJ2-2
TGTGCCAGCAGCGACGACCCGGGACGTGAGCAGTTCTTC	CASSDDPGREQFF	TRBV5-6	TRBJ2-1
TGTGCCAGCAGCTTAGCCTTAGCGGGTCCCAACGTACAAGAGACCCAGTACTTC	CASSLALAGPNVQETQYF	TRBV7-7	TRBJ2-5
TGTGCCAGCAGTGTGCAGGGGAGGACCTACGAGCAGTACTTC	CASSVQGRTYEQYF	TRBV6-4	TRBJ2-7
TGTGCCAGCAGAACAGGGGGGGTGGGCAATCAGCCCCAGCATTTT	CASRTGGVGNQPQHF	TRBV6-1	TRBJ1-5
TGTGCCATCAGTGGGGTTAAGCTTCCCCACAACTACAATGAGCAGTTCTTC	CAISGVKLPHNYNEQFF	TRBV10-3	TRBJ2-1
TGTGCCAGCAGTTTGTTCTCCAGGGCTCTAGAGACCCAGTACTTC	CASSLFSRALETQYF	TRBV27	TRBJ2-5
TGTGCCAGCAGCCCGGGGGGCCCGCAGCCCCAGCATTTT	CASSPGGPQPQHF	TRBV6-1	TRBJ1-5
TGTGCCAGCAGTCTCGGGGAGGGAACAAACATTCAGTACTTC	CASSLGEGTNIQYF	TRBV6-1	TRBJ2-4
TGCGCCAGCAGCGGCCGACAGATCACTGAAGCTTTCTTT	CASSGRQITEAFF	TRBV5-1	TRBJ1-1
TGTGCCGCCAGGCAAAAGGTTGATACGCAGTATTTT	CAARQKVDTQYF	TRBV3-1	TRBJ2-3
TGTGCCAGCAGGGGGGAAAACTACGAGCAGTACTTC	CASRGENYEQYF	TRBV6-1	TRBJ2-7
TGTGCCAGCAGCGTACCCCCTGGTTTGAGTAATTCACCCCTCCACTTT	CASSVPPGLSNSPLHF	TRBV9	TRBJ1-6
TGTGCCAGCAGCAACGGCGCCACAACTTGGACAGGGTATAACACAGATACGCAGTATTTT	CASSNGATTWTGYNTDTQYF	TRBV7-3	TRBJ2-3
TGCAGTGCTAGAGATCCTTTAGAGAGTGGGATTGAGACCCAGTACTTC	CSARDPLESGIETQYF	TRBV20-1	TRBJ2-5
TGTGCCAGCACATCAAGACGGGTCGGCGAGCAGTACTTC	CASTSRRVGEQYF	TRBV28	TRBJ2-7
TGTGCCAGCAGCTTAGGAATACAGGTCGCGGGACTAGCGGGTGAGCAGTACTTC	CASSLGIQVAGLAGEQYF	TRBV7-2	TRBJ2-7
TGCGCCACCCTACGTTTAGAGACCCAGTACTTC	CATLRLETQYF	TRBV5-1	TRBJ2-5
TGTGCCAGCAGCTTAAGACTGAGAGGGGGCTCCTACGAGCAGTACTTC	CASSLRLRGGSYEQYF	TRBV7-2	TRBJ2-7
TGTGCCAGCAGCCAAGATCGTCCCCAATCCACTCTAGCGGGCCGCACAGATACGCAGTATTTT	CASSQDRPQSTLAGRTDTQYF	TRBV3-1	TRBJ2-3
TGTGCCATAAGCCGGGACAGAGTTACTGAAGCTTTCTTT	CAISRDRVTEAFF	TRBV7-9	TRBJ1-1
TGTGCCAGCAGTTTAGACAGGGTATCTGCGAACACCGGGGAGCTGTTTTTT	CASSLDRVSANTGELFF	TRBV27	TRBJ2-2
TGTGCCAGCAGCCGGCATTTTAACTTC	CASSRHFNF	TRBV5-6	TRBJ2-5
TGTGCCAGTAGTATTTTCGGGGTACAAGAGACCCAGTACTTC	CASSIFGVQETQYF	TRBV19	TRBJ2-5
TGTGCCAGCAGTGTCAGGGGGCTTCTCGATAGCAATCAGCCCCAGCATTTT	CASSVRGLLDSNQPQHF	TRBV25-1	TRBJ1-5
TGTGCCATGGTGATGGACGGTGCGATCAATCAGCCCCAGCATTTT	CAMVMDGAINQPQHF	TRBV6-4	TRBJ1-5
TGTGCCAGCAGGGAAATTACAGATACGCAGTATTTT	CASREITDTQYF	TRBV7-9	TRBJ2-3
TGCAGTGCTAGGGCTAAGCGGGACGGGAAGACCTACGAGCAGTACTTC	CSARAKRDGKTYEQYF	TRBV20-1	TRBJ2-7
TGTGCCATCAGTGAGGTACGGAGGGGAGGGGGGGCACGTAGGTTAGACTACGAGCAGTACTTC	CAISEVRRGGGARRLDYEQYF	TRBV10-3	TRBJ2-7
TGTGCCACCAGTGATTTGCAAGTGGCAGGGCTCCGAGCACCTGACTACGAGCAGTACTTC	CATSDLQVAGLRAPDYEQYF	TRBV24-1	TRBJ2-7
TGTGCCAGCAGCGGGGGTTGGGCGCACTGGGACAGCGGCTATGGCTACACCTTC	CASSGGWAHWDSGYGYTF	TRBV7-9	TRBJ1-2
TGCACAGGGAGGGACCACTATGGCTACACCTTC	CTGRDHYGYTF	TRBV5-1	TRBJ1-2
TGTGCCAGCAGCCGTGGCGCGGCCGAGGGGGGAATTTGCACAGATACGCAGTATTTT	CASSRGAAEGGICTDTQYF	TRBV7-8	TRBJ2-3
TGTGCCAGCAGCGGAGAAGCGGAGGTGACCTACAATGAGCAGTTCTTC	CASSGEAEVTYNEQFF	TRBV7-9	TRBJ2-1
TGTGCCAGCTCACCACCGGTAAAGGGTTCAGGCCCCTACGAGCAGTACTTC	CASSPPVKGSGPYEQYF	TRBV18	TRBJ2-7
TGTGCCAGCAGCACCTTAGACCCCGAGCAGTACTTC	CASSTLDPEQYF	TRBV11-3	TRBJ2-7
TGTGCCAGCAGCCAAGAGGGGGGCCAATTCTACGAGCAGTACTTC	CASSQEGGQFYEQYF	TRBV3-1	TRBJ2-7
TGTGCCATAAAGGGGTGCCATAGCAATCAGCCCCAGCATTTT	CAIKGCHSNQPQHF	TRBV10-3	TRBJ1-5
TGCGCCAGCAGCTTGGCACAGGGAATAGGCAATCAGCCCCAGCATTTT	CASSLAQGIGNQPQHF	TRBV5-1	TRBJ1-5
TGTGCCAGCAGTTACTCGACGGAGGGGTTATCCGGTCGGGGAGTGGGTCAAGAGACCCAGTACTTC	CASSYSTEGLSGRGVGQETQYF	TRBV6-5	TRBJ2-5
TGCGCCAGCAGCCGGGGGGGGCTAGCTTTCTTT	CASSRGGLAFF	TRBV5-1	TRBJ1-1
TGTGCCAGCCCAGGGAGGAGTGGTTCGAACACTGAAGCTTTCTTT	CASPGRSGSNTEAFF	TRBV24-1	TRBJ1-1
TGTGCCAGCAGCGTGGAGGGACACACTGAAGCTTTCTTT	CASSVEGHTEAFF	TRBV7-6	TRBJ1-1
TGTGCCAGCAGTTACAGGCAACACAGGGGGCATGGCTACACCTTC	CASSYRQHRGHGYTF	TRBV6-9	TRBJ1-2
TGTGCCAGCAGCTCCGGGGTTTGGAGCTCCTACGAGCAGTACTTC	CASSSGVWSSYEQYF	TRBV7-7	TRBJ2-7
TGTGCCAGCAGTGACAGTGTAAGGGACAGCTATGGCTACACCTTC	CASSDSVRDSYGYTF	TRBV6-4	TRBJ1-2
TGTGCCAGCCTAAAGCCGGGACAGGGGTGTAACACTGAAGCTTTCTTT	CASLKPGQGCNTEAFF	TRBV7-3	TRBJ1-1
TGTGCCAGCAGACGGGGGCCAACTAATGAAAAACTGTTTTTT	CASRRGPTNEKLFF	TRBV7-3	TRBJ1-4
TGCGCCAGCAGTGTTCTTGGAGGAGGGGGGAAGACCAATGAGCAGTTCTTC	CASSVLGGGGKTNEQFF	TRBV10-1	TRBJ2-1
TGCGCCAGCAGTGAGTCAACACTCTACGTCACAGATACGCAGTATTTT	CASSESTLYVTDTQYF	TRBV10-1	TRBJ2-3
TGCTTCGCACCTGGGGTGGGGACCGACACAAACATTCAGTACTTC	CFAPGVGTDTNIQYF	TRBV10-1	TRBJ2-4
TGTGCCCGTACGGGACTAGCGGCTGTCTACAATGAGCAGTTCTTC	CARTGLAAVYNEQFF	TRBV2	TRBJ2-1
TGTGCCAGCAGCGGGACTAGGGGGGTTGCTCACAATGAGCAGTTCTTC	CASSGTRGVAHNEQFF	TRBV13	TRBJ2-1
TGTGCCAGCAGCGAGAGCGGCGGGTTGGCGGAGCAGTACTTC	CASSESGGLAEQYF	TRBV7-9	TRBJ2-7
TGTGCCAGCAGCCAAGAGTCCAGGCCGCGGTACGAGCAGTACTTC	CASSQESRPRYEQYF	TRBV4-2	TRBJ2-7
TGTGCCACCTCCCCACCCGGGACAGGGAGGGACACCGGGGAGCTGTTTTTT	CATSPPGTGRDTGELFF	TRBV24-1	TRBJ2-2
TGTGCCAGCAGCCAAAGGGAAACGAATACATTGGTTAGGACTAGCCCAACCTACGAGCAGTACTTC	CASSQRETNTLVRTSPTYEQYF	TRBV14	TRBJ2-7
TGTGCCGTCGGGAACTATGGCTACACCTTC	CAVGNYGYTF	TRBV27	TRBJ1-2
TGCAGTGCTAGAGACCTGGGACAGGGTGGCTATTCCAACGTCCTGACTTTC	CSARDLGQGGYSNVLTF	TRBV20-1	TRBJ2-6
TGTGCCAGCTCTCATTCTTGTGGACAGGGAGGGGCCAGCACTGAAGCTTTCTTT	CASSHSCGQGGASTEAFF	TRBV7-9	TRBJ1-1
TGTGCCAGCAGTTTATGTGTCTCTCTCGGGCCACCTTCTAACTATGGCTACACCTTC	CASSLCVSLGPPSNYGYTF	TRBV28	TRBJ1-2
TGTGCCAGCAGCGAGGGCCACGAGCAGTACTTC	CASSEGHEQYF	TRBV7-3	TRBJ2-7
TGTGCCAGCAGAAACGGAAACACCGGGGAGCTGTTTTTT	CASRNGNTGELFF	TRBV25-1	TRBJ2-2
TGTGCCAGCAGTTTATCCATTCGACTAGTGGGGGGGTCTCAAGAGACCCAGTACTTC	CASSLSIRLVGGSQETQYF	TRBV27	TRBJ2-5
TGTGCCAGCAGTTTAGTGGCTAAAGGGGGGGAGAGTGGTATCACAGATACGCAGTATTTT	CASSLVAKGGESGITDTQYF	TRBV27	TRBJ2-3
TGTGCCAGCAGCTTCATAGCCACTACACAGGGGGACGAGCAGTACTTC	CASSFIATTQGDEQYF	TRBV5-5	TRBJ2-7
TGTGCCAGCAGGGGGGCGCTGCACCCCGGGGAGCTGTTTTTT	CASRGALHPGELFF	TRBV14	TRBJ2-2
TGTGCCACCAAGTGGCAGTATAGCAATCAGCCCCAGCATTTT	CATKWQYSNQPQHF	TRBV24-1	TRBJ1-5
TGCAGTGCTGAGTATTTGGGGGACCCTTGCTACGAGCAGTACTTC	CSAEYLGDPCYEQYF	TRBV20-1	TRBJ2-7
TGTGCCAGCAAACTAGCGGGAGCCGACTATGGCTACACCTTC	CASKLAGADYGYTF	TRBV11-2	TRBJ1-2
TGCGCCAGCAGCCGGACCAGGGAAAATCAGCCCCAGCATTTT	CASSRTRENQPQHF	TRBV4-1	TRBJ1-5
TGCGCCAGCAGCTCCCAGAGGGGGGAGAATAATTCACCCCTCCACTTT	CASSSQRGENNSPLHF	TRBV5-1	TRBJ1-6
TGTGCCAGCAGCTTACTACCACTATTTCGGGGGGCCAACGTCCTGACTTTC	CASSLLPLFRGANVLTF	TRBV7-9	TRBJ2-6
TGTGCCAGCAGTGACTTACAACAGCCAGATGGGGCCAACGTCCTGACTTTC	CASSDLQQPDGANVLTF	TRBV6-4	TRBJ2-6
TGCGCCAGCATAGCTCCGGGACCTAGTGGCTACACCTTC	CASIAPGPSGYTF	TRBV5-1	TRBJ1-2
TGTGCCACCAGCAGAGATTGGTCAGCGGGATTCTCTCGCAATCAGCCCCAGCATTTT	CATSRDWSAGFSRNQPQHF	TRBV15	TRBJ1-5
TGTGCCACCAGTGGGAGTGAGAAGGGACACAACACCGGGGAGCTGTTTTTT	CATSGSEKGHNTGELFF	TRBV24-1	TRBJ2-2
TGTGCCAGCAGTCATGGGGGGCAGCCCCAGCATTTT	CASSHGGQPQHF	TRBV6-3	TRBJ1-5
TGTGCCAGCAGTTATGGACAGGGGTGGGGAAGAGATACGCAGTATTTT	CASSYGQGWGRDTQYF	TRBV6-5	TRBJ2-3
TGCAGTGCTAGCTCCTGCCCCGGGACAGGGGGCTACACCTTC	CSASSCPGTGGYTF	TRBV20-1	TRBJ1-2
TGTGCCAGCAGCCATTGGGCTGCTTTGAATGAGCAGTTCTTC	CASSHWAALNEQFF	TRBV5-6	TRBJ2-1
TGTGCCAGCAGTGCAGGGGGGGCTCGGGGGACCGAGACCCAGTACTTC	CASSAGGARGTETQYF	TRBV25-1	TRBJ2-5
TGTGCCAGCAGTCAGGCTGTCCCGGGGCGGACGAGACGCGCCTTC	CASSQAVPGRTRRAF	TRBV6-2	TRBJ1-2
TGCAGTGCGACTGGGACAGGGTCCGCTGTCTCTGGAAACACCATATATTTT	CSATGTGSAVSGNTIYF	TRBV20-1	TRBJ1-3
TGCAGTGCTAGAGATTCCTGGGAGCTGTTTTTT	CSARDSWELFF	TRBV20-1	TRBJ2-2
TGTGCCAGCAGCTTTCCAGGGTCAATCTTC	CASSFPGSIF	TRBV7-9	TRBJ2-1
TGTGCCAGCAGCCACAACCGGGGCCGCAATCAGCCCCAGCATTTT	CASSHNRGRNQPQHF	TRBV14	TRBJ1-5
TGTGCCAGCAGTAAACTAGCGGGAGACGGGCGCACAGATACGCAGTATTTT	CASSKLAGDGRTDTQYF	TRBV6-5	TRBJ2-3
TGTGCCAGCAGCTGCGGGGGACACGATTACACCGGGGAGCTGTTTTTT	CASSCGGHDYTGELFF	TRBV5-4	TRBJ2-2
TGCAGTGCTAGAGATCTATTCTCCCCTAGCGACAGGGGTACGCAGTATTTT	CSARDLFSPSDRGTQYF	TRBV20-1	TRBJ2-3
TGCGCCAGCAGACCTAAGGGACTAGCGGGGATCGAGCAGTACTTC	CASRPKGLAGIEQYF	TRBV10-1	TRBJ2-7
TGTGCCAGCAGTTTAGGGGACTCCTACAATGAGCAGTTCTTC	CASSLGDSYNEQFF	TRBV6-5	TRBJ2-1
TGTGCCATCAGCCATCTAGGGCGGGTAGGATCCTACGAGCAGTACTTC	CAISHLGRVGSYEQYF	TRBV10-3	TRBJ2-7
TGTGCCAGCAGCCACGGGAACAATGAGCAGTTCTTC	CASSHGNNEQFF	TRBV11-1	TRBJ2-1
TGTGCCACCAGCAGAGATCGACTCTGTTCCAGGGGGGGGAGGCGGGAGACCCAGTACTTC	CATSRDRLCSRGGRRETQYF	TRBV15	TRBJ2-5
TGTGCCAGCAGCTTGGCGAGGGTTTACGAGCAGTACTTC	CASSLARVYEQYF	TRBV5-6	TRBJ2-7
TGTGCCAGCAGGGTGGTAACAGGGTTATATGGCTACACCTTC	CASRVVTGLYGYTF	TRBV6-5	TRBJ1-2
TGTGCCAGCAGACGTCCGGGGGCTCGCAAAGGCCACTCTGGAAACACCATATATTTT	CASRRPGARKGHSGNTIYF	TRBV7-2	TRBJ1-3
TGTGCCAGCAGCTCTTCCTGCTCCTTACGCCAGAGGAGTAACACAGATACGCAGTATTTT	CASSSSCSLRQRSNTDTQYF	TRBV7-8	TRBJ2-3
TGTGCCAGCAGCCAAGAGAGAACCACCGTTCGGGGGCCCCTCTACGAGCAGTACTTC	CASSQERTTVRGPLYEQYF	TRBV14	TRBJ2-7
TGTGCCAGCAGCGTTACAGGGAGGGACTACGAGCAGTACTTC	CASSVTGRDYEQYF	TRBV9	TRBJ2-7
TGTGCCAGCAGCCAGGGCGGGGGCACAGATACGCAGTATTTT	CASSQGGGTDTQYF	TRBV7-9	TRBJ2-3
TGCGCCAGCAGCTTGGCTTGGACACTAGCCCCTTTGCAGCCCCAGCATTTT	CASSLAWTLAPLQPQHF	TRBV5-1	TRBJ1-5
TGCGCCAGCAGGACTAGCGGCAGGGGGAATGAGCAGTTCTTC	CASRTSGRGNEQFF	TRBV5-1	TRBJ2-1
TGCAGTGCGCTAGGGGCCTACGAGCAGTACTTC	CSALGAYEQYF	TRBV20-1	TRBJ2-7
TGTCCCCTAGCGGGGCCGGGTGAGCAGTTCTTC	CPLAGPGEQFF	TRBV19	TRBJ2-1
TGTGCCAGCAGACATCAAGGGGCCTATAATTCACCCCTCCACTTT	CASRHQGAYNSPLHF	TRBV7-9	TRBJ1-6
TGTGCCAGCAGCTTTCACCTGCGGTGGTTAGGGATAGCTAGCACAGATACGCAGTATTTT	CASSFHLRWLGIASTDTQYF	TRBV5-6	TRBJ2-3
TGTGCCAGCAGTTTTCCCCCTGGCAAGTATTTAAACACCGGGGAGCTGTTTTTT	CASSFPPGKYLNTGELFF	TRBV28	TRBJ2-2
TGTGCCAGCAGTTCTCCGGGCGGAATTAACGAGACCCAGTACTTC	CASSSPGGINETQYF	TRBV9	TRBJ2-5
TGTGCCAGCAGCTCGGGGGGCAGCTCCTACAATGAGCAGTTCTTC	CASSSGGSSYNEQFF	TRBV13	TRBJ2-1
TGTTCTCAGTCTAGCGGGCGTCATTACGAGCAGTACTTC	CSQSSGRHYEQYF	TRBV19	TRBJ2-7
TGCGCCAGCAGCTTGGGGCCGGAGTGCGAGTACGAGCAGTACTTC	CASSLGPECEYEQYF	TRBV5-1	TRBJ2-7
TGTGCCAGCAGCCGGGGAATGAACACCGGGGAGCTGTTTTTT	CASSRGMNTGELFF	TRBV5-6	TRBJ2-2
TGTGCTTCCGTGAAACAGGAGAACACTGAAGCTTTCTTT	CASVKQENTEAFF	TRBV27	TRBJ1-1
TGTGCCAGTAGTATTTTAGGGACAGGAAGCACTGAAGCTTTCTTT	CASSILGTGSTEAFF	TRBV19	TRBJ1-1
TGTGCCAGCAGCGTAGTCGGCCCGGTTTTTTTACCCCAAGAGACCCAGTACTTC	CASSVVGPVFLPQETQYF	TRBV9	TRBJ2-5
TGTGCCTCGGGGACAGGGCGCAGGGCCTACGAGCAGTACTTC	CASGTGRRAYEQYF	TRBV28	TRBJ2-7
TGCAGTGCTAGAGGAGATACACAGTACGAGCAGTACTTC	CSARGDTQYEQYF	TRBV20-1	TRBJ2-7
TGTGCCAGCAGTGGGGTTGACCCGGGACAGGGTGAAAAACTGTTTTTT	CASSGVDPGQGEKLFF	TRBV6-1	TRBJ1-4
TGCAGTGCGGACAGGAGAGGGAGGCCCACAGATACGCAGTATTTT	CSADRRGRPTDTQYF	TRBV20-1	TRBJ2-3
TGTGCCAGTAGTGGGCAGTACAACTATGGCTACACCTTC	CASSGQYNYGYTF	TRBV19	TRBJ1-2
TGTGCCAGCAGCGCCCACGGAAACACCAAAGAGACCCAGTACTTC	CASSAHGNTKETQYF	TRBV9	TRBJ2-5
TGCAGTGCTAGCCGACAGGGACCCCTCCACTTT	CSASRQGPLHF	TRBV20-1	TRBJ1-6
TGTGCCAGAATAGGGGGCAGCTCCTACGAGCAGTACTTC	CARIGGSSYEQYF	TRBV27	TRBJ2-7
TGTGCCAGCAGCTATTGGAAGGGGGACCCGGCACTGCAGTTCTTC	CASSYWKGDPALQFF	TRBV5-8	TRBJ2-1
TGTGCCAGCAGCCGACCGTGGGGGACAGGGGGCGTGACAGCCTACGAGCAGTACTTC	CASSRPWGTGGVTAYEQYF	TRBV5-6	TRBJ2-7
TGTGCCAGCAGCGACCCAATCAGCCGGCAACCCTACGAGCAGTACTTC	CASSDPISRQPYEQYF	TRBV13	TRBJ2-7
TGTGCCAGCAGCTTAGATCTAGGGTTCCGGGTCGGGAACACTGAAGCTTTCTTT	CASSLDLGFRVGNTEAFF	TRBV11-2	TRBJ1-1
TGCGCCAGCAGCCCCCTAAAGCGGGGAGTGGCCGGGGAGCTGTTTTTT	CASSPLKRGVAGELFF	TRBV4-1	TRBJ2-2
TGCGCCAGCAGTGAGTCGTCGCGAACTAGAACCGGGGAGCTGTTTTTT	CASSESSRTRTGELFF	TRBV10-1	TRBJ2-2
TGTGCCAGCAGTTGCCTGGTAGGGCAAGTCTACGAGCAGTACTTC	CASSCLVGQVYEQYF	TRBV27	TRBJ2-7
TGTGCCAGCAGTTTTTCGACAGGGGGGGCGACTGGAAACACCATATATTTT	CASSFSTGGATGNTIYF	TRBV27	TRBJ1-3
TGCGCCAGCAGCCGGGGGGGGAAATCCAATGAGCAGTTCTTC	CASSRGGKSNEQFF	TRBV4-1	TRBJ2-1
TGTGCGGACAGGGACCCAGGGGAGACCCAGTACTTC	CADRDPGETQYF	TRBV6-4	TRBJ2-5
TGTGCCAGCAGCCAGGATAACTATGGCTACACCTTC	CASSQDNYGYTF	TRBV7-8	TRBJ1-2
TGTGCCAGCGTCACAGATACGCAGTATTTT	CASVTDTQYF	TRBV6-6	TRBJ2-3
TGTGCCAGCAGCTTGAAAGGGGGGGCCTACGAGCAGTACTTC	CASSLKGGAYEQYF	TRBV5-8	TRBJ2-7
TGTGCCAGCAGGAACCCGAAGACAGGGACGGGTTGGGGGTCTGGGGCCAACGTCCTGACTTTC	CASRNPKTGTGWGSGANVLTF	TRBV28	TRBJ2-6
TGTGCCAGCGGGAGTGTTGAGACCCAGTACTTC	CASGSVETQYF	TRBV19	TRBJ2-5
TGTGCCAGCAGTTACTCCCGGGAGGATGGCTACACCTTC	CASSYSREDGYTF	TRBV6-3	TRBJ1-2
TGTGCCAGCAGCTGGGACGTGCCCAACTATGGCTACACCTTC	CASSWDVPNYGYTF	TRBV5-6	TRBJ1-2
TGTGCCAGCACCAGTAAAGGGGGCGGGTCCTACGAGCAGTACTTC	CASTSKGGGSYEQYF	TRBV6-4	TRBJ2-7
TGTGCCAGCAGCCCTTGGGGGTCGCGACCCTTC	CASSPWGSRPF	TRBV3-1	TRBJ1-2
TGTGCCACCAGTGATAGGGCGGGGAATGGCTACACCTTC	CATSDRAGNGYTF	TRBV24-1	TRBJ1-2
TGTGCCAGCCGACAGGGACGCTACGAGCAGTACTTC	CASRQGRYEQYF	TRBV25-1	TRBJ2-7
TGCGCCAGCAGCTTGGCCCCCGGGACAGGGTTTAAGAGGAGCGAGCAGTACTTC	CASSLAPGTGFKRSEQYF	TRBV5-1	TRBJ2-7
TGCGCCAGCAGTGAGGAGACAGGTAATGAAAAACTGTTTTTT	CASSEETGNEKLFF	TRBV10-1	TRBJ1-4
TGTGCCAGCAGCCCGGGGGACAGAAAGGATTCACCCCTCCACTTT	CASSPGDRKDSPLHF	TRBV7-9	TRBJ1-6
TGTGCCAGCTCACCATCCGAAAATCCCAGGGGGGGGTCCTACGAGCAGTACTTC	CASSPSENPRGGSYEQYF	TRBV18	TRBJ2-7
TGTGCCAGCAGCGACAGGGGGAAAGATACGCAGTATTTT	CASSDRGKDTQYF	TRBV13	TRBJ2-3
TGCGCCAGCAGTGAGAGGCAATGGGTCCGTTCACCCCTCCACTTT	CASSERQWVRSPLHF	TRBV10-1	TRBJ1-6
TGTGCCAGCAGCTTAACAAAGCCCCCGCCGATCAACACCGGGGAGCTGTTTTTT	CASSLTKPPPINTGELFF	TRBV7-8	TRBJ2-2
TGTGCCAGCACTAGCGGGTTCGAGCAGTACTTC	CASTSGFEQYF	TRBV28	TRBJ2-7
TGTGCCAGTAGTACGGACAGGGCGGTCCAAGAGACCCAGTACTTC	CASSTDRAVQETQYF	TRBV19	TRBJ2-5
TGTGCCAGCAGTTCCCTCCCCTTCGGGGAGGTGGAGAACACCGGGGAGCTGTTTTTT	CASSSLPFGEVENTGELFF	TRBV2	TRBJ2-2
TGTGCCAGCAGAGCCCAGTCTTTTCTCAAGTCCTACGAGCAGTACTTC	CASRAQSFLKSYEQYF	TRBV11-2	TRBJ2-7
TGCAGTGCTAGAACAGGGAACGACACTGAAGCTTTCTTT	CSARTGNDTEAFF	TRBV20-1	TRBJ1-1
TGCAGTGCGGTGGGCTCATGGGGAAACACCATATATTTT	CSAVGSWGNTIYF	TRBV20-1	TRBJ1-3
TGTGCCAGCAGCCCCGTTATGGGACAGGACCTGGCCTACGAGCAGTACTTC	CASSPVMGQDLAYEQYF	TRBV13	TRBJ2-7
TGCGCCAGCAGCCAAGAGACACTAGATGAGCAGTTCTTC	CASSQETLDEQFF	TRBV4-1	TRBJ2-1
TGTGCCACCACTTTAGGGGGCCCCCCGCGGGACACTGAGCAGTTCTTC	CATTLGGPPRDTEQFF	TRBV24-1	TRBJ2-1
TGCGCCAGCAGCTTGGTGGACTACAGGGAGCAGTTCTTC	CASSLVDYREQFF	TRBV5-1	TRBJ2-1
TGTGCCAGCAGCCAGCACGGACGGGAAGACGAGCAGTACTTC	CASSQHGREDEQYF	TRBV6-4	TRBJ2-7
TGTGCCAGCAGTGACTCCGTGCAGGGACAGGGCCGTGAGCAGTTCTTC	CASSDSVQGQGREQFF	TRBV6-4	TRBJ2-1
TGTGCCAGCAGTTTAGGTATGGACAGGGGGTACGAGCAGTACTTC	CASSLGMDRGYEQYF	TRBV27	TRBJ2-7
TGCGCCAGCAGCCAAGATTCCAGGGGGGATCCCCTGGACAGCACAGATACGCAGTATTTT	CASSQDSRGDPLDSTDTQYF	TRBV4-1	TRBJ2-3
TGTGCCAGCAGCATCAGGGTTGGCTACACCTTC	CASSIRVGYTF	TRBV7-3	TRBJ1-2
TGCGCCAGCAGCCAGCAAGGAGCGGGAGTAGGTAAGGCGAACACTGAAGCTTTCTTT	CASSQQGAGVGKANTEAFF	TRBV4-1	TRBJ1-1
TGTGCCAGCAAAACGGCGGATGAAAAACTGTTTTTT	CASKTADEKLFF	TRBV6-4	TRBJ1-4
TGCGCCAGCAGCTTGAATCGGGAGGGCCCTTCCTACGAGCAGTACTTC	CASSLNREGPSYEQYF	TRBV5-1	TRBJ2-7
TGTGCCAGCAGCTTTCTCGCTGAGAGACGCAATCAGCCCCAGCATTTT	CASSFLAERRNQPQHF	TRBV5-6	TRBJ1-5
TGTGCCAGCAGCTTAGTAGCGGGAGGCCCGAACACCGGGGAGCTGTTTTTT	CASSLVAGGPNTGELFF	TRBV11-2	TRBJ2-2
TGTGCCAGCAGCGGCCCAGCCGGGACAGGGATGGAAGCTTTCTTT	CASSGPAGTGMEAFF	TRBV4-2	TRBJ1-1
TGCGCCAGCAGCCAAGATCGTGGAAGGGGACCTGAGCAGTTCTTC	CASSQDRGRGPEQFF	TRBV4-1	TRBJ2-1
TGTACCCGACAGGGCCGGGGAATTCAAGATACGCAGTATTTT	CTRQGRGIQDTQYF	TRBV11-2	TRBJ2-3
TGTGCCAGCAGTACGGGGGCGGACAGGAGGGGTCAGCCCCAGCATTTT	CASSTGADRRGQPQHF	TRBV6-5	TRBJ1-5
TGCGCCAGCAGTGAGATTAGACCGTATCAGCCCCAGCATTTT	CASSEIRPYQPQHF	TRBV10-1	TRBJ1-5
TGTGCCAGCACGAATACACAGCACGAATATAATTCACCCCTCCACTTT	CASTNTQHEYNSPLHF	TRBV6-5	TRBJ1-6
TGCGCCAGCAGTGAGAGATGGATAGTCAGCAATCAGCCCCAGCATTTT	CASSERWIVSNQPQHF	TRBV10-1	TRBJ1-5
TGTGCCAGCAGCAGGAGGCGGGCACTCTACGAGCAGTACTTC	CASSRRRALYEQYF	TRBV13	TRBJ2-7
TGTGCCAGCAGTTACTCGACGGGGGGAAAAGGCAATGAGCAGTTCTTC	CASSYSTGGKGNEQFF	TRBV6-6	TRBJ2-1
TGCGCCAGCAGTGAGAGCGATAGGGGGCGATATTCACCCCTCCACTTT	CASSESDRGRYSPLHF	TRBV10-1	TRBJ1-6
TGTGCCAGCAGCGGGGGGCATGCCAGCTCCTACGAGCAGTACTTC	CASSGGHASSYEQYF	TRBV9	TRBJ2-7
TGTGCCAGCTCAGACGTGACTAGCGGGAGGCTAACGTCCACTTTCTACGAGCAGTACTTC	CASSDVTSGRLTSTFYEQYF	TRBV18	TRBJ2-7
TGCAGCGTTGACCCCCGGACAGGGGCCTCTGGAAACACCATATATTTT	CSVDPRTGASGNTIYF	TRBV29-1	TRBJ1-3
TGCGCCAGCAGCTTGGCCCCACTAGAACCTAACTTC	CASSLAPLEPNF	TRBV5-1	TRBJ2-7
TGTGCCAGTAGTGGGGCGGGACTCGGTGAGGGAGTGTATGCCTACAATGAGCAGTTCTTC	CASSGAGLGEGVYAYNEQFF	TRBV19	TRBJ2-1
TGTGCCAGCATAGGTCACAGGCAAGAGACCCAGTACTTC	CASIGHRQETQYF	TRBV6-1	TRBJ2-5
TGTGCCAGCCAGCGGGAGAAATACGAGCAGTACTTC	CASQREKYEQYF	TRBV9	TRBJ2-7
TGTGCCAGCAGTTACCGACACGAGGGGGCCGGCACTGAAGCTTTCTTT	CASSYRHEGAGTEAFF	TRBV6-2	TRBJ1-1
TGTGCCAGCAGTGAACCATTTCCGAAGACTGAAGCTTTCTTT	CASSEPFPKTEAFF	TRBV6-4	TRBJ1-1
TGTGCCAGTTCGGCGAACTCTGGGGCCAACGTCCTGACTTTC	CASSANSGANVLTF	TRBV28	TRBJ2-6
TGCGCCAGCAGTATACGGGGTCCCTATGGCTACACCTTC	CASSIRGPYGYTF	TRBV10-1	TRBJ1-2
TGTGCCAGCAGTTACAAAGATCCGACAGGGGGATTCTCGGGTGAAAAACTGTTTTTT	CASSYKDPTGGFSGEKLFF	TRBV6-5	TRBJ1-4
TGTGCCAGCAGCGTAGATTCCTCACAGGGCATCTTCGAGCCCCAGCATTTT	CASSVDSSQGIFEPQHF	TRBV9	TRBJ1-5
TGTGCCAGCAGCGTAGCGAAGGGAGGTTCACCGTACGAGCAGTACTTC	CASSVAKGGSPYEQYF	TRBV9	TRBJ2-7
TGTGCCAGCAGTGAATTTCAAACAGGGACTACCTACGAGCAGTACTTC	CASSEFQTGTTYEQYF	TRBV25-1	TRBJ2-7
TGCGCCAGCAGCTTGGGGGCAGCTGGGACAGGGCTTGATGAAAAACTGTTTTTT	CASSLGAAGTGLDEKLFF	TRBV5-1	TRBJ1-4
TGCGCCAGCAGCTTCGATTTAATTGATACGCAGTATTTT	CASSFDLIDTQYF	TRBV5-1	TRBJ2-3
TGTGCCAGCAGCCCGCAGGAGGGCACAGATACGCAGTATTTT	CASSPQEGTDTQYF	TRBV5-8	TRBJ2-3
TGTGCCAGCAGCGGGCCTAGCTCCTACGAGCAGTACTTC	CASSGPSSYEQYF	TRBV5-6	TRBJ2-7
TGTGCCACCAGTGGTGGGGGGCCTATCGAGCAGTACTTC	CATSGGGPIEQYF	TRBV24-1	TRBJ2-7
TGTGCCATCAGTGTCCGAGGGGGAAATGAAAAACTGTTTTTT	CAISVRGGNEKLFF	TRBV10-3	TRBJ1-4
TGTGCCAGCATGGGACAGGGGACTGGCTACACCTTC	CASMGQGTGYTF	TRBV27	TRBJ1-2
TGTGCCAGCAGTTCGCTTGGGCCGGGACGGAATGAGCAGTTCTTC	CASSSLGPGRNEQFF	TRBV27	TRBJ2-1
TGTGCCAGCAGCCATGAACGGGGCCACCAGCCCCAGCATTTT	CASSHERGHQPQHF	TRBV13	TRBJ1-5
TGTGCCAGCAGCACTTACTCCGTGAGTTGTGCAACTAATGAAAAACTGTTTTTT	CASSTYSVSCATNEKLFF	TRBV5-6	TRBJ1-4
TGTGCCAGCTCCGGACAGGGTTATACGGGAAACACCATATATTTT	CASSGQGYTGNTIYF	TRBV6-1	TRBJ1-3
TGTGCCAGCAGTTTATCAGGGTCTGGATTTGATCAGCCCCAGCATTTT	CASSLSGSGFDQPQHF	TRBV27	TRBJ1-5
TGTGCCAGCAGCTTGGCCCTGGGACAGGGCTACACCTTC	CASSLALGQGYTF	TRBV5-8	TRBJ1-2
TGTGCCAGTAGTATAGGTCTGGGAGGTACCACAGATACGCAGTATTTT	CASSIGLGGTTDTQYF	TRBV19	TRBJ2-3
TGTGCCAGCAGACCCTGTTTTGACAAAGATGGCTACACCTTC	CASRPCFDKDGYTF	TRBV7-9	TRBJ1-2
TGTGCCACCAGTGAGAAAATCCAGGACTATGGCTACACCTTC	CATSEKIQDYGYTF	TRBV24-1	TRBJ1-2
TGCGCCAGCAGCCAAGAACAGGGGGTTTGCTCTGGAAACACCATATATTTT	CASSQEQGVCSGNTIYF	TRBV4-1	TRBJ1-3
TGTGCCAGTAGTAAGACTAGCGGGCCGAATGAGCAGTTCTTC	CASSKTSGPNEQFF	TRBV19	TRBJ2-1
TGCGCCAGCAGCCAATTAGATGGCTTTGACAGGTTGATCGGCATTCAGTACTTC	CASSQLDGFDRLIGIQYF	TRBV4-3	TRBJ2-4
TGTGCCAGCAGTCGGGACAGGGGGGGGCGCTCCTACGAGCAGTACTTC	CASSRDRGGRSYEQYF	TRBV6-5	TRBJ2-7
TGTGCCAGCAGTCGTGGACAGGGGGCAGGGAGTGAAGCTTTCTTT	CASSRGQGAGSEAFF	TRBV5-4	TRBJ1-1
TGTGCCAGCAGCTTGCTGGGACCGGATCAGCCCCAGCATTTT	CASSLLGPDQPQHF	TRBV5-5	TRBJ1-5
TGTGCCAGCAGTTTTCACCCCCCGCGCCTGACAGGGCCTCGCACAGATACGCAGTATTTT	CASSFHPPRLTGPRTDTQYF	TRBV27	TRBJ2-3
TGTGCCAGCAGACCGGGGACAGACTACGAGCAGTACTTC	CASRPGTDYEQYF	TRBV6-1	TRBJ2-7
TGTGCCAGCAAAGGGGGGGCCGAATACAGCACCGGGGAGCTGTTTTTT	CASKGGAEYSTGELFF	TRBV25-1	TRBJ2-2
TGCAGCTGCGGCCCTCGCGGGGAGCTGTTTTTT	CSCGPRGELFF	TRBV29-1	TRBJ2-2
TGTGCCAGCAGTTACCCGCCGGGACTAGCGGGGGTCTCCTACGAGCAGTACTTC	CASSYPPGLAGVSYEQYF	TRBV6-6	TRBJ2-7
TGTGCCAGCAGGTGGCCCGAGGGTTCCAATGAGCAGTTCTTC	CASRWPEGSNEQFF	TRBV28	TRBJ2-1
TGTGCCAGCTCACCCCCGACCGGGACTAGCGGGAGCCCATTGCATTTT	CASSPPTGTSGSPLHF	TRBV18	TRBJ1-5
TGTGCCAGCAGCTTTTCCGCCTCTTACAATGAGCAGTTCTTC	CASSFSASYNEQFF	TRBV7-4	TRBJ2-1
TGTGCCAGTAGTCGTTTCCTAGCCTTTCCCGGCTCCTATAATTCACCCCTCCACTTT	CASSRFLAFPGSYNSPLHF	TRBV19	TRBJ1-6
TGTGCCAGCAGCGCCCCTACAGAGAACTATAGCAATCAGCCCCAGCATTTT	CASSAPTENYSNQPQHF	TRBV9	TRBJ1-5
TGTGCCAGCAGTGACCCCTTACGGGACAGGGGCCTAGCCAAAAACATTCAGTACTTC	CASSDPLRDRGLAKNIQYF	TRBV6-4	TRBJ2-4
TGTGCCAGCAGTTGCCCAGAGGGGGATGAAAGTCACCAGGGTGGTGCAGATACGCAGTATTTT	CASSCPEGDESHQGGADTQYF	TRBV27	TRBJ2-3
TGTGCCAGCAGCTTAAGACAGGGGAACTATGGCTACACCTTC	CASSLRQGNYGYTF	TRBV7-9	TRBJ1-2
TGTGCCACCAGTGAGTTGACAGGGGTAAGGGAGCTGTTTTTT	CATSELTGVRELFF	TRBV24-1	TRBJ2-2
TGTGCCAGCAGCTTACATGAGGGGGGCAATGAGCAGTTCTTC	CASSLHEGGNEQFF	TRBV11-2	TRBJ2-1
TGTGCCAGCAGCTTAGCGCCAGGTGAGCAGTTCTTC	CASSLAPGEQFF	TRBV7-6	TRBJ2-1
TGTGCCACCAGCAGAGCCCAAAATGGATGTATCAGACGAAACACCATATATTTT	CATSRAQNGCIRRNTIYF	TRBV15	TRBJ1-3
TGTGCCTGGTTTAGACCCCGTAATACGTACTTC	CAWFRPRNTYF	TRBV30	TRBJ2-7
TGTGCCAGCAGTTGGGGCGGAATGCATTTT	CASSWGGMHF	TRBV27	TRBJ1-5
TGTGCCAAGGCCAGGGATGCCAACTATGGCTACACCTTC	CAKARDANYGYTF	TRBV7-9	TRBJ1-2
TGTGCCAGCAGTTACGGCGAGTACGAGCAGTACTTC	CASSYGEYEQYF	TRBV6-4	TRBJ2-7
TGCAGTGCTAGAGTTCCCCGGTGTCCGGGACAGAAACAGCCTTCACCCCTCCACTTT	CSARVPRCPGQKQPSPLHF	TRBV20-1	TRBJ1-6
TGTGCCAGCAGCTCCCCTCCAGGGGGCGGTAGCAATCAGCCCCAGCATTTT	CASSSPPGGGSNQPQHF	TRBV6-5	TRBJ1-5
TGTGCCAGCAGCCGGGGCTCTGGGGCGCATTTT	CASSRGSGAHF	TRBV12-4	TRBJ1-5
TGTGCCAGCAGCCAAGATATAAACCCCCGGACAGGGGGCCAGGACTACAGCTCCTACGAGCAGTACTTC	CASSQDINPRTGGQDYSSYEQYF	TRBV3-1	TRBJ2-7
TGTGCCAGCAGCTTAGGTCACCGTGAGACTGAAGCTTTCTTT	CASSLGHRETEAFF	TRBV7-4	TRBJ1-1
TGTGCCAGCCTGCACATCGGGCGACGTGATACGCAGTATTTT	CASLHIGRRDTQYF	TRBV5-8	TRBJ2-3
TGTGCCACCCCAAACAGGTGGTTTTTGTCCCTCCAGCCCCAGCATTTT	CATPNRWFLSLQPQHF	TRBV27	TRBJ1-5
TGTGCCAGCAGGGGCGGTGTCGGGCTCTTTTATGGCTACACCTTC	CASRGGVGLFYGYTF	TRBV7-4	TRBJ1-2
TGTGCCAGCAGGCGGACAGGGTTCCACTATGGCTACACCTTC	CASRRTGFHYGYTF	TRBV6-1	TRBJ1-2
TGTGCCAGCAGCTTACCCGGACAGGGCACAAATTCACCCCTCCACTTT	CASSLPGQGTNSPLHF	TRBV11-3	TRBJ1-6
TGCAGTGCTAGAGATCTAGCCGGGACAGGGCCTGTGTTCCTGGGGTACGAGCAGTACTTC	CSARDLAGTGPVFLGYEQYF	TRBV20-1	TRBJ2-7
TGTGCCAGCAGCTTAGGGGCAAGCGGGTCACTGTTTTTT	CASSLGASGSLFF	TRBV7-9	TRBJ1-4
TGTGCCAGCAGTCCCAGGGGTAGGTACGAGCAGTACTTC	CASSPRGRYEQYF	TRBV6-4	TRBJ2-7
TGCGCGGTTGGGACTAGGGGCACAGATACGCAGTATTTT	CAVGTRGTDTQYF	TRBV10-2	TRBJ2-3
TGCGCCAGCAGCTTGTTAAGCACCGGGACGTATGGCTACACCTTC	CASSLLSTGTYGYTF	TRBV5-1	TRBJ1-2
TGTGCCAGCAGCAGCCCCTCTAGCGGGAGAAACAATGAGCAGTTCTTC	CASSSPSSGRNNEQFF	TRBV7-3	TRBJ2-1
TGTGCCAGCAGCCTTTGGACAGGGTACAATGAGCAGTTCTTC	CASSLWTGYNEQFF	TRBV5-4	TRBJ2-1
TGTGCCAGCAGCTCCAGCCACGGGGGAGCTTTCTTT	CASSSSHGGAFF	TRBV7-3	TRBJ1-1
TGTGCCAGCAGAATGACAGGGGTTCGAGGTGAGCACTACGAGCAGTACTTC	CASRMTGVRGEHYEQYF	TRBV5-5	TRBJ2-7
TGTGCCAGCAGCTTAGGGGCACCGGTCGGGAAATTCACCGGGGAGCTGTTTTTT	CASSLGAPVGKFTGELFF	TRBV11-3	TRBJ2-2
TGTGCCAGCTCGACGTTCTACGAGCAGTACTTC	CASSTFYEQYF	TRBV18	TRBJ2-7
TGCGCCAGCAGCCAGCCTTGCCGGGGGGAAAGTTACCAAGAGACCCAGTACTTC	CASSQPCRGESYQETQYF	TRBV4-1	TRBJ2-5
TGTGCCACCAGTGATTTGCACCCGGGGACAGGGAGGAACAATCAGCCCCAGCATTTT	CATSDLHPGTGRNNQPQHF	TRBV24-1	TRBJ1-5
TGTGCCAGCAGCCAAGAGTGTGTCCCCAGGAGCCAGAACACTGAAGCTTTCTTT	CASSQECVPRSQNTEAFF	TRBV3-1	TRBJ1-1
TGTGCCAGCAGTGCGGTCGGGACTAGCGGGAGGGCTGAGAACTATGGCTACACCTTC	CASSAVGTSGRAENYGYTF	TRBV6-4	TRBJ1-2
TGTGCCAGCTCACCCCTCCACAGCTACGAGCAGTACTTC	CASSPLHSYEQYF	TRBV18	TRBJ2-7
TGTGCCAGCAGCTTAGCGGCCCTCCATCAATCTCTCGGTGGCTACACCTTC	CASSLAALHQSLGGYTF	TRBV7-8	TRBJ1-2
TGCGCCAGCAGCCAAGACGGGACAGAAGATGGCTACACCTTC	CASSQDGTEDGYTF	TRBV4-3	TRBJ1-2
TGTGCCAGCATGGAGGACAGAAGAAAGAACACTGAAGCTTTCTTT	CASMEDRRKNTEAFF	TRBV9	TRBJ1-1
TGTGCCAATTCAGGACTAGCGGGGGTTGGGGCGGGGGACAATGAGCAGTTCTTC	CANSGLAGVGAGDNEQFF	TRBV25-1	TRBJ2-1
TGTGCCAGCAGCGCCACCGGGACTAGCGACACCGGGGAGCTGTTTTTT	CASSATGTSDTGELFF	TRBV13	TRBJ2-2
TGTGCCTCCCCCCAGGGTTGCGATCAGCCCCAGCATTTT	CASPQGCDQPQHF	TRBV10-3	TRBJ1-5
TGTGCCAGCATAGCCGGGCGACAGGGGGTCGACTATGGCTACACCTTC	CASIAGRQGVDYGYTF	TRBV9	TRBJ1-2
TGTGCCAGCAGCTTAGAGGAACAGGGACAGTATAGAGCCTTCGAAAAACTGTTTTTT	CASSLEEQGQYRAFEKLFF	TRBV7-9	TRBJ1-4
TGTGCCACCAAGGCCGGGACTAGCGGGGGGGCACGAAATAATCTCTACGAGCAGTACTTC	CATKAGTSGGARNNLYEQYF	TRBV24-1	TRBJ2-7
TGTGCCAGCAGCCCAATCACCTTTTGGGGACAGACCGAGCAGTACTTC	CASSPITFWGQTEQYF	TRBV7-3	TRBJ2-7
TGTGCCAGCAATCCCCCCCCCAGGGAAGCGCAGCCCCAGCATTTT	CASNPPPREAQPQHF	TRBV28	TRBJ1-5
TGCGCCAGCCCTACAGGGGGCTATGGCTACACCTTC	CASPTGGYGYTF	TRBV5-1	TRBJ1-2
TGTGCCAGCAGCTTAGAGGCGCTTAACTATGGCTACACCTTC	CASSLEALNYGYTF	TRBV7-3	TRBJ1-2
TGCGCCAGCAGCTTGCCCTTCGTCCCCTCGGCCTACGAGCAGTACTTC	CASSLPFVPSAYEQYF	TRBV5-1	TRBJ2-7
TGTGCCAGCAGCCGGGGGAAGGGCTACGAGCAGTACTTC	CASSRGKGYEQYF	TRBV9	TRBJ2-7
TGTGCCAGCAGTGACCCCCGGTCGAACACCGGGGAGCTGTTTTTT	CASSDPRSNTGELFF	TRBV6-1	TRBJ2-2
TGTGCCATCACTGGGGCAGGGGATTGTAGCACAGATACGCAGTATTTT	CAITGAGDCSTDTQYF	TRBV10-3	TRBJ2-3
TGTGCCAGCATTCCGGGGGGCACCTTC	CASIPGGTF	TRBV7-2	TRBJ1-2
TGTGCCAGTTCGACCTTTACCGGGGAGCTGTTTTTT	CASSTFTGELFF	TRBV19	TRBJ2-2
TGCAGCGTTGAAGCACAACCTCAGAGAGATCCTCCAGGCAATCAGCCCCAGCATTTT	CSVEAQPQRDPPGNQPQHF	TRBV29-1	TRBJ1-5
TGTGCTAGTGGTTTGGAAGCCCGGGGAGACCCCCGTGAGCAGTTCTTC	CASGLEARGDPREQFF	TRBV12-5	TRBJ2-1
TGTGCCAGTAGTATCGGCCTCAGCGGGGGGATAAATTCCGGCGAGCAGTACTTC	CASSIGLSGGINSGEQYF	TRBV19	TRBJ2-7
TGTGCCAGCAGCAAGGGACGCTGCTCCTACGAGCAGTACTTC	CASSKGRCSYEQYF	TRBV7-3	TRBJ2-7
TGTGCCCGGACTAGCGGGCGGCCCAATGAGCAGTTCTTC	CARTSGRPNEQFF	TRBV12-3	TRBJ2-1
TGCGCCAGCAGCTTCGGGCTCTGCACAGATACGCAGTATTTT	CASSFGLCTDTQYF	TRBV10-1	TRBJ2-3
TGTGCCAGCAGTGATTGGAAGCCAGCTGGAGGGGGACACGAGCAGTACTTC	CASSDWKPAGGGHEQYF	TRBV6-1	TRBJ2-7
TGTGCCAGCAGCCACCTCGGGACGGTAGGCTACACCTTC	CASSHLGTVGYTF	TRBV7-3	TRBJ1-2
TGTGCCATTGGACAGTTGCCCCAGCATTTT	CAIGQLPQHF	TRBV10-3	TRBJ1-5
TGTGCCAGCAGACAGACCTATGGCTACACCTTC	CASRQTYGYTF	TRBV12-4	TRBJ1-2
TGCGCCAGCAGTACTAGCGGGAGGGCCGCTATGTACGAGCAGTACTTC	CASSTSGRAAMYEQYF	TRBV10-2	TRBJ2-7
TGTGCCAGCAGTTACCCCCCCCGGTCGGTCCGGGACGTGAACACTGAAGCTTTCTTT	CASSYPPRSVRDVNTEAFF	TRBV6-5	TRBJ1-1
TGTGCCAGCATGGTTACAGGGGTTTGCCCAGGTGAAGCTTTCTTT	CASMVTGVCPGEAFF	TRBV14	TRBJ1-1
TGTGCCAGCAGTGAACACGGGGAGCTGTTTTTT	CASSEHGELFF	TRBV12-3	TRBJ2-2
TGTGCCACCGGTTCTAGCGAGTCCAATGAGCAGTTCTTC	CATGSSESNEQFF	TRBV10-3	TRBJ2-1
TGTGCCAGCAGCTTAAGGGATACAAGCACTGAAGCTTTCTTT	CASSLRDTSTEAFF	TRBV7-8	TRBJ1-1
TGTGCCAGCACAGTTGCAGGGGAAGGCCGGGTGAACACTGAAGCTTTCTTT	CASTVAGEGRVNTEAFF	TRBV6-5	TRBJ1-1
TGTGCCAGCAGCGACAGAACTAACACCATATATTTT	CASSDRTNTIYF	TRBV7-7	TRBJ1-3
TGTGCCCGGGGACTAGCGGGGCCGTGCTCCCAGTATTTT	CARGLAGPCSQYF	TRBV6-1	TRBJ2-3
TGCGCCAGCAGTGAGTGGTCCGGGAGGGCGTATGAGCAGTTCTTC	CASSEWSGRAYEQFF	TRBV10-1	TRBJ2-1
TGTGCCAGCCCCGGAGGCTTTTGGGGTGACTATGGCTACACCTTC	CASPGGFWGDYGYTF	TRBV27	TRBJ1-2
TGCGCCAGCAGTGCCTCGATAGCGGGTCCAGCAGATACGCAGTATTTT	CASSASIAGPADTQYF	TRBV10-2	TRBJ2-3
TGTGCCACCAGCACTAGGGACAGGGGAACTGAAGCTTTCTTT	CATSTRDRGTEAFF	TRBV24-1	TRBJ1-1
TGTGCCAGCAGTACGGCTAGTGCGGTGTACAATGAGCAGTTCTTC	CASSTASAVYNEQFF	TRBV28	TRBJ2-1
TGTGCCAGCGGGAGGGATTTTCCGGCCTACGAGCAGTACTTC	CASGRDFPAYEQYF	TRBV12-3	TRBJ2-7
TGTGCCAGCAGTTTACGCCGGGACAGAGCTGCTAACTATGGCTACACCTTC	CASSLRRDRAANYGYTF	TRBV12-4	TRBJ1-2
TGTGCCAGCACCCCAATAAAACTTTACAGGGACTCCTACGAGCAGTACTTC	CASTPIKLYRDSYEQYF	TRBV6-3	TRBJ2-7
TGCGCCAGCAGCTTCAGGGGGCGGGCCGAGACCCAGTACTTC	CASSFRGRAETQYF	TRBV10-1	TRBJ2-5
TGTGCCAGCAGCAACCCAAGAAGGGGGAGGTACAATGAGCAGTTCTTC	CASSNPRRGRYNEQFF	TRBV7-3	TRBJ2-1
TGTGCCAGCAGCTCTTTCCGGCCGGAAGAGACCCAGTACTTC	CASSSFRPEETQYF	TRBV5-6	TRBJ2-5
TGTGCCACCAGCAGAGAGTCCCCCGGTTTAGCCAAAAACATTCAGTACTTC	CATSRESPGLAKNIQYF	TRBV15	TRBJ2-4
TGTGCCAGCAGCCGGGGGACTAGCGGGGGGGCCCAAGAAGACACCGGGGAGCTGTTTTTT	CASSRGTSGGAQEDTGELFF	TRBV6-4	TRBJ2-2
TGCGCCAGCAGCTTGGGGACAGGATGGAACTCCTACGAGCAGTACTTC	CASSLGTGWNSYEQYF	TRBV5-1	TRBJ2-7
TGTGCCACCTTCCAAAGGGACAGGGGGGGGAAAGAAAATCAGCCCCAGCATTTT	CATFQRDRGGKENQPQHF	TRBV24-1	TRBJ1-5
TGTGCCTGGAGCAGGGGGGAAAAACTGTTTTTT	CAWSRGEKLFF	TRBV30	TRBJ1-4
TGTGCCAGCAGCTTAGCCGACCTACCGACTAGCGGGAGGAAAATAACGCAGTACTTC	CASSLADLPTSGRKITQYF	TRBV7-9	TRBJ2-7
TGTGCCAGCAGCACCGGCGAGGGGACTGTTGTCATGCAAGAGACCCAGTACTTC	CASSTGEGTVVMQETQYF	TRBV4-2	TRBJ2-5
TGTGCCAGCAGGGATGGGAAGACTAGCGGGGGGGCGGGGGGTTCTGAGCAGTTCTTC	CASRDGKTSGGAGGSEQFF	TRBV12-3	TRBJ2-1
TGTGCCAGCAGTGAAGGGGGGCCGGGCGAGCAGTACTTC	CASSEGGPGEQYF	TRBV2	TRBJ2-7
TGTGCCAGCAGCCAAGAGTCTCCACGGAAGTACACTGAAGCTTTCTTT	CASSQESPRKYTEAFF	TRBV14	TRBJ1-1
TGTGCCGCAAGGGGGGTAGGGGGAGTTGAAGCTTTCTTT	CAARGVGGVEAFF	TRBV7-8	TRBJ1-1
TGTGCCAGCAGCGTGGGACAGAGCAGGGCCTACAATGAGCAGTTCTTC	CASSVGQSRAYNEQFF	TRBV11-3	TRBJ2-1
TGTGCCAGCTTTGGGTACGAGCAGTACTTC	CASFGYEQYF	TRBV19	TRBJ2-7
TGTGCCAGCAGTTTGGACAGGGGTATATCTGGACAACTGTTTTTT	CASSLDRGISGQLFF	TRBV3-1	TRBJ1-4
TGTGCCAGCAGCGAGACAGGCAGGGAAGGCTACACCTTC	CASSETGREGYTF	TRBV6-5	TRBJ1-2
TGTGCTAGTGGTTTGTTAGGCCGACGAGAGACCCAGTACTTC	CASGLLGRRETQYF	TRBV12-5	TRBJ2-5
TGTGCCAGCAGCGCCCCGACTAGAGCAGATACGCAGTATTTT	CASSAPTRADTQYF	TRBV11-3	TRBJ2-3
TGTGCCAGCAGACCCGAGGCGGGAGCCCTCACTTCGAACACTGAAGCTTTCTTT	CASRPEAGALTSNTEAFF	TRBV6-5	TRBJ1-1
TGTGCCAGTAGAGCCCAGGGTCTCTACGAGCAGTACTTC	CASRAQGLYEQYF	TRBV19	TRBJ2-7
TGTGCCAGCAGTCGCCGATCCCAACCAGGGGGGAACTATGGCTACACCTTC	CASSRRSQPGGNYGYTF	TRBV6-4	TRBJ1-2
TGTGCCAGCAGCCGGATAAAAATGAACACTGAAGCTTTCTTT	CASSRIKMNTEAFF	TRBV13	TRBJ1-1
TGTGCCAGCAGCTTGCGGGGTCTCTACGAGCAGTACTTC	CASSLRGLYEQYF	TRBV5-6	TRBJ2-7
TGCTTTTACAGGGGGTTTGAGAACACTGAAGCTTTCTTT	CFYRGFENTEAFF	TRBV20-1	TRBJ1-1
TGTGCCAGCAGTTACTGCCGGGACAGGGGGCCCACAGATACGCAGTATTTT	CASSYCRDRGPTDTQYF	TRBV27	TRBJ2-3
TGTGCCAGCAGTGAATCCCGACAGAATCATGGCTACACCTTC	CASSESRQNHGYTF	TRBV6-1	TRBJ1-2
TGTGCCAGCAGTTACTGTGCTAGCGGCTCCGACGAGCAGTACTTC	CASSYCASGSDEQYF	TRBV6-5	TRBJ2-7
TGTGCCAGTAGTCCGGCGCGTAGGAGCCACTATGGCTACACCTTC	CASSPARRSHYGYTF	TRBV6-2	TRBJ1-2
TGTGCCAGCAGCGCCCTGAAACTACGGGACTACACCGGGGAGCTGTTTTTT	CASSALKLRDYTGELFF	TRBV7-4	TRBJ2-2
TGTGCCATCAACTGCCCAGGGATTGACAACCTGGTTGGTAACTATGGCTACACCTTC	CAINCPGIDNLVGNYGYTF	TRBV10-3	TRBJ1-2
TGTGCCAGCAGCCAAGGGAGACTAGCGGGAATTCTTTGCACAGATACGCAGTATTTT	CASSQGRLAGILCTDTQYF	TRBV3-1	TRBJ2-3
TGTGCCAGCAGCTTAGCGCCCGATTGGGTCAATCCGGGGGTCAGACAGCAGTACTTC	CASSLAPDWVNPGVRQQYF	TRBV7-6	TRBJ2-7
TGTGCCAGCAGCCCCAGGTGGGCAGCAGATACGCAGTATTTT	CASSPRWAADTQYF	TRBV9	TRBJ2-3
TGTGCCAGCAGCTTAGCCTGCGGGTCCAAAAACATTCAGTACTTC	CASSLACGSKNIQYF	TRBV7-8	TRBJ2-4
TGTGCCAGCAGCATCAACCATGGATCCTACGAGCAGTACTTC	CASSINHGSYEQYF	TRBV11-3	TRBJ2-7
TGTGCCAGCAGCAAGGGGCAACGGAAAAACATTCAGTACTTC	CASSKGQRKNIQYF	TRBV5-6	TRBJ2-4
TGTGCCAAGGGGGGAACAGGGGGCTATGGGATTAACACCGGGGAGCTGTTTTTT	CAKGGTGGYGINTGELFF	TRBV7-9	TRBJ2-2
TGTGCCAGCAGTAATTCTGCGGGCTACACCTTC	CASSNSAGYTF	TRBV6-1	TRBJ1-2
TGCAGTGATGAAGGCTCCATTAATGAGCAGTTCTTC	CSDEGSINEQFF	TRBV20-1	TRBJ2-1
TGTGCCAGCAGCTTCTCCCGGGACAGGGGAGATAGCAATCAGCCCCAGCATTTT	CASSFSRDRGDSNQPQHF	TRBV11-2	TRBJ1-5
TGTGCCAGTGGGGGGCCAGAGACCCAGTACTTC	CASGGPETQYF	TRBV6-4	TRBJ2-5
TGTGCCAGCAGCATCGCGGCTAGGTACTTC	CASSIAARYF	TRBV13	TRBJ2-7
TGCGCCAGGACAGGATTTCAGCCCCAGCATTTT	CARTGFQPQHF	TRBV10-2	TRBJ1-5
TGTGCCAGCAGTGACGAACACAGCATCTACGAGCAGTACTTC	CASSDEHSIYEQYF	TRBV6-4	TRBJ2-7
TGTGCCAGCAGCTTAGAGTCGGCCCGGAGGCCCTCAGGGGCTCATTCACCCCTCCACTTT	CASSLESARRPSGAHSPLHF	TRBV7-2	TRBJ1-6
TGCAGTGCTAGAGTGAAGCCGGGACTGGCTACCTACAATGAGCAGTTCTTC	CSARVKPGLATYNEQFF	TRBV20-1	TRBJ2-1
TGTGCCAGCAGCGGTTCCACTGTAAGAGGCAGCTCCTATAATTCACCCCTCCACTTT	CASSGSTVRGSSYNSPLHF	TRBV13	TRBJ1-6
TGTGCCAGCAGCAGTATTATGTCTTCACCCCTCCACTTT	CASSSIMSSPLHF	TRBV6-4	TRBJ1-6
TGTGCTAGTGGTTTGTCGCTAGCGCTCACAGATACGCAGTATTTT	CASGLSLALTDTQYF	TRBV12-5	TRBJ2-3
TGTGCCAGCAGCTTACCTGGGGACGCCCCAAGGGGAAGTGAGGGTGAAAAACTGTTTTTT	CASSLPGDAPRGSEGEKLFF	TRBV11-3	TRBJ1-4
TGTGCCAGCAGTTTCGGACAGGTAGAATATGGCTACACCTTC	CASSFGQVEYGYTF	TRBV28	TRBJ1-2
TGTGCCTGGAGCTGCTTGGGAGGAGGGGACAGGGTCTATGGCTACACCTTC	CAWSCLGGGDRVYGYTF	TRBV30	TRBJ1-2
TGCGCCAGCACGACAACTCTTGCGGGAGCTCGCACAGATACGCAGTATTTT	CASTTTLAGARTDTQYF	TRBV5-1	TRBJ2-3
TGTGCCAGCAGGGGTTGCAAGTACACTGAAGCTTTCTTT	CASRGCKYTEAFF	TRBV10-3	TRBJ1-1
TGTGCCAGCAGCGTAGAAATAGCGGGCCCCCCCGCCTACGAGCAGTACTTC	CASSVEIAGPPAYEQYF	TRBV9	TRBJ2-7
TGTGACGGAGACTATGGCTACACCTTC	CDGDYGYTF	TRBV25-1	TRBJ1-2
TGTGCCAGCAGTTACGAGGCTACTGACGCAGGCACAGATACGCAGTATTTT	CASSYEATDAGTDTQYF	TRBV6-5	TRBJ2-3
TGTGCCAGCAGTGAAGCACGCATCCCTTGGGGGCGCCTGAATTCACCCCTCCACTTT	CASSEARIPWGRLNSPLHF	TRBV6-1	TRBJ1-6
TGCGCCAGCAGCCAACTAGCGGCCACAACCGGGGAGCTGTTTTTT	CASSQLAATTGELFF	TRBV4-1	TRBJ2-2
TGCAGCGAGTCCCAGAGGCTCAGGGGTTACTATGGCTACACCTTC	CSESQRLRGYYGYTF	TRBV29-1	TRBJ1-2
TGCGCCAGCAGCTTCGACCCCCGGGAGGAGCAGTTCTTC	CASSFDPREEQFF	TRBV5-1	TRBJ2-1
TGTGCCAGCTCACCTAGGAAACGGACTAGCGGAGTTAACACCGGGGAGCTGTTTTTT	CASSPRKRTSGVNTGELFF	TRBV18	TRBJ2-2
TGTGCCAGCAGCGTACCCGTTACTAGCGGTTGGACCGAGCAGTACTTC	CASSVPVTSGWTEQYF	TRBV9	TRBJ2-7
TGCGCCAGCATTTGCGCATTCTCCTTTACCTCCTACGAGCAGTACTTC	CASICAFSFTSYEQYF	TRBV5-1	TRBJ2-7
TGTGAATTCCATCCCTCCGGGACAGGGGCCTGGAATCACACCGGGGAGCTGTTTTTT	CEFHPSGTGAWNHTGELFF	TRBV24-1	TRBJ2-2
TGCAGTGCTACGGCAGGGTTCGGAGGCCAAGAGACCCAGTACTTC	CSATAGFGGQETQYF	TRBV20-1	TRBJ2-5
TGTGCCAGGGGACATCGAGGCGATGACTCCTACAATGAGCAGTTCTTC	CARGHRGDDSYNEQFF	TRBV6-5	TRBJ2-1
TGTGCCAGCAGCTTAATCCCCGGGGCCATGACGCAGTATTTT	CASSLIPGAMTQYF	TRBV11-2	TRBJ2-3
TGTGCCAGCAGCTTAGCGGAACCCTTGTCTAGCGGGGGCGACCCTCGCAATGAGCAGTTCTTC	CASSLAEPLSSGGDPRNEQFF	TRBV7-6	TRBJ2-1
TGCAGTGCTAGAGATCAGGGGCCCTACGAGCAGTACTTC	CSARDQGPYEQYF	TRBV20-1	TRBJ2-7
TGCAGGTGGTTCAGCTTTGGGACAGAGAGCTCCTATAATTCACCCCTCCACTTT	CRWFSFGTESSYNSPLHF	TRBV20-1	TRBJ1-6
TGTGCCAGCAGTGTCTTATCCCACACTGAAGCTTTCTTT	CASSVLSHTEAFF	TRBV27	TRBJ1-1
TGTGCCAGGGGCCACCGTACGGCAACTAATGAAAAACTGTTTTTT	CARGHRTATNEKLFF	TRBV19	TRBJ1-4
TGTGCCAGCAGTTTGTTCGGGGAAACCGAGCAGTACTTC	CASSLFGETEQYF	TRBV27	TRBJ2-7
TGTGCCATTAATAAGAACTATTGGGACAGATATAGCAATCAGCCCCAGCATTTT	CAINKNYWDRYSNQPQHF	TRBV19	TRBJ1-5
TGTGCCAGCAGGCTGTACGCGAGCACAGATACGCAGTATTTT	CASRLYASTDTQYF	TRBV12-4	TRBJ2-3
TGTGCCAGCAGCACAGCCCCAACCAGACCCTACGAGCAGTACTTC	CASSTAPTRPYEQYF	TRBV7-3	TRBJ2-7
TGCGCCAGCAGCTTGGAGCCCGGGGGAACCGAGCAGTACTTC	CASSLEPGGTEQYF	TRBV5-1	TRBJ2-7
TGTGCCAGACCGACTAGCGGGACAGATACGCAGTATTTT	CARPTSGTDTQYF	TRBV6-4	TRBJ2-3
TGTGCCAGCAGCTTAATCCTCGTCCACAAGACTAGCGGGGGGGCATCAGGCACAGATACGCAGTATTTT	CASSLILVHKTSGGASGTDTQYF	TRBV5-6	TRBJ2-3
TGTGCCAGCAGCGTCGACCCTGAAGCTTTCTTT	CASSVDPEAFF	TRBV28	TRBJ1-1
TGTGCCAGCAGTTCCGGGACTAGCAATGACCAAGAGACCCAGTACTTC	CASSSGTSNDQETQYF	TRBV6-5	TRBJ2-5
TGTGCCAGCAGTTCGACAGGGGACGAGAAAGGGGATGGCTACACCTTC	CASSSTGDEKGDGYTF	TRBV27	TRBJ1-2
TGTGCCAGCAGTAAGCGACAGGGCGAGGGGGGACTGAACACTGAAGCTTTCTTT	CASSKRQGEGGLNTEAFF	TRBV27	TRBJ1-1
TGTGCCAGCACCGGGGACAATCCCTATGGCTACACCTTC	CASTGDNPYGYTF	TRBV7-3	TRBJ1-2
TGCAGTGCTAGCCACGGCCTGGATTGCTACGAGCAGTACTTC	CSASHGLDCYEQYF	TRBV20-1	TRBJ2-7
TGTGCCACCAGCTACCGGAGGTCATACGAGCAGTACTTC	CATSYRRSYEQYF	TRBV24-1	TRBJ2-7
TGCAGCGTTGATCTAGCGGGACTAGCTCACGAGCAGTACTTC	CSVDLAGLAHEQYF	TRBV29-1	TRBJ2-7
TGTGCCAGCAGTTTGGAAGGTGAGGGACTGAAGTACTTC	CASSLEGEGLKYF	TRBV12-3	TRBJ2-7
TGTGCCAGAAAGAATATCTATGGCTACACCTTC	CARKNIYGYTF	TRBV27	TRBJ1-2
TGTGCCAGTCGCGAAAAGGGGTCTTACGAGCAGTACTTC	CASREKGSYEQYF	TRBV19	TRBJ2-7
TGTGCCAGTAGTATAGCAAACGCCCGCCGCGACAGCGAGAATTTGAACACTGAAGCTTTCTTT	CASSIANARRDSENLNTEAFF	TRBV19	TRBJ1-1
TGTGCCAGCAGCCAAGATCTTTCTTATGGCAGGGGGCCCCGGAACAATGAGCAGTTCTTC	CASSQDLSYGRGPRNNEQFF	TRBV4-2	TRBJ2-1
TGTGCCAGCAGTTATGCGGGGACGCCCGCAGATACGCAGTATTTT	CASSYAGTPADTQYF	TRBV6-6	TRBJ2-3
TGTGCCAGACCCCAACAGGGGGAGAACGAGCAGTACTTC	CARPQQGENEQYF	TRBV7-2	TRBJ2-7
TGTGCCAGCAGGAGATTTGCAGATACGCAGTATTTT	CASRRFADTQYF	TRBV5-6	TRBJ2-3
TGCAGCGTTTCAGTTGCGGGAGGGTACCAAGAGACCCAGTACTTC	CSVSVAGGYQETQYF	TRBV29-1	TRBJ2-5
TGTGCCAGCAGCATGGGATACCGCGCTAGCACAGATACGCAGTATTTT	CASSMGYRASTDTQYF	TRBV13	TRBJ2-3
TGTGCCAGCAGCTTCCTAAACCCGGGGCCCCTCGGTGGTTACACCGGGGAGCTGTTTTTT	CASSFLNPGPLGGYTGELFF	TRBV11-2	TRBJ2-2
TGTGCCAGCAGCTTAAAACGAAGGAATGACAATGAGCAGTTCTTC	CASSLKRRNDNEQFF	TRBV11-2	TRBJ2-1
TGTGCTAGTGGTACCGGTACGATAAGATCTGAAGCTTTCTTT	CASGTGTIRSEAFF	TRBV12-5	TRBJ1-1
TGTGCCAGCAGCTGGGAATGGACTAGCGGTTACTACGAGCAGTACTTC	CASSWEWTSGYYEQYF	TRBV9	TRBJ2-7
TGTGCCAGCAGAATACGGGAGTTCGAGCAGTACTTC	CASRIREFEQYF	TRBV6-1	TRBJ2-7
TGTGCCAGCAGGGGGCGGAATTCACCCCTCCACTTT	CASRGRNSPLHF	TRBV27	TRBJ1-6
TGTGCCAGCTCAACCGGGACTAGGAGCGGGGAGCTGTTTTTT	CASSTGTRSGELFF	TRBV18	TRBJ2-2
TGTGCCAGCAGCGTAATAGGGGGCCCCACCGGGAAAGCTTTCTTT	CASSVIGGPTGKAFF	TRBV9	TRBJ1-1
TGTGCCAGCAGCTTATCACTGACTAGCGGGAGGTGTGAAAAACTGTTTTTT	CASSLSLTSGRCEKLFF	TRBV11-2	TRBJ1-4
TGCCGCGGAGCCTACGAGCAGTACTTC	CRGAYEQYF	TRBV20-1	TRBJ2-7
TGTGCCAGCAGGGGCGGGGCTGGCTACGAGCAGTACTTC	CASRGGAGYEQYF	TRBV27	TRBJ2-7
TGCGCCAGCAGCTTGTCGTTGGAGGGGAACACTGAAGCTTTCTTT	CASSLSLEGNTEAFF	TRBV5-1	TRBJ1-1
TGTGCCAGCAGTTGGGGAGGGACCTACGAGCAGTACTTC	CASSWGGTYEQYF	TRBV12-3	TRBJ2-7
TGTGCCAGCAGCTTAGACCGGGACAGGGGAAAAGGGGTGGGCTACACCTTC	CASSLDRDRGKGVGYTF	TRBV7-4	TRBJ1-2
TGCGCCAGCAGCGCCCCGCTTTGGGGTCTTAAGGATAGCACAGATACGCAGTATTTT	CASSAPLWGLKDSTDTQYF	TRBV5-1	TRBJ2-3
TGTGCCAGCAGCCCACGGGGTTCCTTATATAGCAATCAGCCCCAGCATTTT	CASSPRGSLYSNQPQHF	TRBV13	TRBJ1-5
TGCAGTCCCTTAGGAAGGGGGGCCTATTACTACAATGAGCAGTTCTTC	CSPLGRGAYYYNEQFF	TRBV20-1	TRBJ2-1
TGTGCCAGCAGCTTAGCTAGCGGTGGAGATGAGCAGTTCTTC	CASSLASGGDEQFF	TRBV11-2	TRBJ2-1
TGCGCCAGCAGTGCCCCCGGCACAAGCATGAACACTGAAGCTTTCTTT	CASSAPGTSMNTEAFF	TRBV10-1	TRBJ1-1
TGTGCCGACCGGATGCTCCCGGGACTAGGCCAAGAGACCCAGTACTTC	CADRMLPGLGQETQYF	TRBV30	TRBJ2-5
TGTGCCAGCAGCCCCCCGGACAGCTCGGAAAAACTGTTTTTT	CASSPPDSSEKLFF	TRBV5-4	TRBJ1-4
TGCAGTGCTAGCCAAACAACATACACCATATATTTT	CSASQTTYTIYF	TRBV20-1	TRBJ1-3
TGTGCCAGCAGCGGCGCAGGGGAGTCCATCACAGATACGCAGTATTTT	CASSGAGESITDTQYF	TRBV6-5	TRBJ2-3
TGCGCCAGCAGCAAAAACCCATCGACAGAGACCCAGTACTTC	CASSKNPSTETQYF	TRBV5-1	TRBJ2-5
TGTGCCAGCAGGACCCGGGCACAGGGAAACACCATATATTTT	CASRTRAQGNTIYF	TRBV6-2	TRBJ1-3
TGTGCCAGTAGTAGGGGCCCCGGGACGGACGTATTGCGATCGAATGAGCAGTTCTTC	CASSRGPGTDVLRSNEQFF	TRBV19	TRBJ2-1
TGCGCCAGCAGGGACAGGGAGCCCCAGCATTTT	CASRDREPQHF	TRBV5-1	TRBJ1-5
TGCGCCAGCAGTGAGAAGCTATGGGGGGGTATAGAAATCAGCAATCAGCCCCAGCATTTT	CASSEKLWGGIEISNQPQHF	TRBV10-1	TRBJ1-5
TGTGCCAGCAGCTTGCCTGGGACTAGCGGGAGCGCCTACGAGCAGTACTTC	CASSLPGTSGSAYEQYF	TRBV7-3	TRBJ2-7
TGTGCCAGTGTCACCAGCGGGAACTACGAGCAGTACTTC	CASVTSGNYEQYF	TRBV9	TRBJ2-7
TGTGCCAGCACCGGACTAGCGGGCGAGCAGTACTTC	CASTGLAGEQYF	TRBV28	TRBJ2-7
TGTGCCAGCAGCGTCTCTAACCCAGATACGCAGTATTTT	CASSVSNPDTQYF	TRBV7-6	TRBJ2-3
TGTGCCAGCAGTTCTCCTGACAGGAAGGATAATTCACCCCTCCACTTT	CASSSPDRKDNSPLHF	TRBV6-3	TRBJ1-6
TGTGCCACCAGTGACAGGCGCGATCAGCCCCAGCATTTT	CATSDRRDQPQHF	TRBV24-1	TRBJ1-5
TGTGCCAGCAGGACTGTACAACAGGGTAAGGGACGGAACACTGAAGCTTTCTTT	CASRTVQQGKGRNTEAFF	TRBV14	TRBJ1-1
TGTGCCAGCAGCTCCCGGGGGGGCTACGAGCAGTACTTC	CASSSRGGYEQYF	TRBV27	TRBJ2-7
TGTGCCAGCGAGGGCTGGGGCTACGAGCAGTACTTC	CASEGWGYEQYF	TRBV27	TRBJ2-7
TGTGCCAGTAACCCCGGGACAGGGGAACCAGATACGCAGTATTTT	CASNPGTGEPDTQYF	TRBV19	TRBJ2-3
TGTGCCCCGGAGGGCGGCTTCACAGATACGCAGTATTTT	CAPEGGFTDTQYF	TRBV7-9	TRBJ2-3
TGTGCCAGCAGACGGACAGGGCAGTTTTCCACAGATACGCAGTATTTT	CASRRTGQFSTDTQYF	TRBV11-2	TRBJ2-3
TGTGCCATCAGTCCCCGGGGGTTGAGGGTGAACACTGAAGCTTTCTTT	CAISPRGLRVNTEAFF	TRBV10-3	TRBJ1-1
TGTGCCAGCAGCCAAGCCCCGCTAGCGGGTAGTCGAGGCTACAATGAGCAGTTCTTC	CASSQAPLAGSRGYNEQFF	TRBV3-1	TRBJ2-1
TGTGCCAGCAGTGAAGCGCTCCTACAAGGGACTAGCCCCCGGAATCCCACAGATACGCAGTATTTT	CASSEALLQGTSPRNPTDTQYF	TRBV2	TRBJ2-3
TGCAGTGCTGGGCCTCTCACAGAAAGTAGGGGGGGGTCCTACACTGAAGCTTTCTTT	CSAGPLTESRGGSYTEAFF	TRBV20-1	TRBJ1-1
TGTGCTGCAAAGCTGAGGGGCCCAACCTACGAGCAGTACTTC	CAAKLRGPTYEQYF	TRBV15	TRBJ2-7
TGTGCCAGCAGCCTTACAGGGTTACATGGGGCAACTAATGAAAAACTGTTTTTT	CASSLTGLHGATNEKLFF	TRBV9	TRBJ1-4
TGTGCCAGCAGCGGGCGGTACAATGAGCAGTTCTTC	CASSGRYNEQFF	TRBV9	TRBJ2-1
TGTGCCACCAGTGATTTGCTCCCAACCGGGGAGCTGTTTTTT	CATSDLLPTGELFF	TRBV24-1	TRBJ2-2
TGTGCCAGCAGTGTACAGGCCCCAAGCTACGAGCAGTACTTC	CASSVQAPSYEQYF	TRBV25-1	TRBJ2-7
TGCGCCAGCAGCTTGGTGGGGTGTGAAGCTTTCTTT	CASSLVGCEAFF	TRBV5-1	TRBJ1-1
TGCAGCGTTGACGGGAGCGGGACTAGCGGGTTGAGTGGCTCCTACAATGAGCAGTTCTTC	CSVDGSGTSGLSGSYNEQFF	TRBV29-1	TRBJ2-1
TGTGCCAGCAGCTTAACGTTCGCGACAGGGGTGAAGGCTTTCTTT	CASSLTFATGVKAFF	TRBV7-9	TRBJ1-1
TGTGCCAGCAGTGTTTGGGGGCCCCGGAATTCCTACGAGCAGTACTTC	CASSVWGPRNSYEQYF	TRBV6-4	TRBJ2-7
TGTGTAAGACGTTGGGGGAGCACTGAAGCTTTCTTT	CVRRWGSTEAFF	TRBV25-1	TRBJ1-1
TGTGCATGGGGTTTGGAAAAACTGTTTTTT	CAWGLEKLFF	TRBV11-3	TRBJ1-4
TGTGCCAGCAGCATACACACTTACCAAGAGACCCAGTACTTC	CASSIHTYQETQYF	TRBV7-2	TRBJ2-5
TGTGCCAGCAGCCAAGAACTTCGACTAGCGGGAGGGTTGGAGCAGTACTTC	CASSQELRLAGGLEQYF	TRBV4-2	TRBJ2-7
TGTGCCAGCAGCTGGAATCCCTCGGGGCCAGATACGCAGTATTTT	CASSWNPSGPDTQYF	TRBV5-5	TRBJ2-3
TGTGCCATCCCCCCCGTGGACTATGGCTACACCTTC	CAIPPVDYGYTF	TRBV10-3	TRBJ1-2
TGTGCCAGCTCACACCAGGGGTCGTTAACCCAGCATTTT	CASSHQGSLTQHF	TRBV18	TRBJ1-5
TGTGCCAGCAGTGACTCGTATGGGAGGCCGGGACAGGGCCCAACGGAGCCGCAGTTCTTC	CASSDSYGRPGQGPTEPQFF	TRBV6-4	TRBJ2-1
TGTGCCAGCACCAGGAATTATGGCTACACCTTC	CASTRNYGYTF	TRBV14	TRBJ1-2
TGTGCCAGCAGTTTATTTTCAGGCCACGAGCAGTACTTC	CASSLFSGHEQYF	TRBV28	TRBJ2-7
TGCAGTGCGACAGGGATAAACACCGGGGAGCTGTTTTTT	CSATGINTGELFF	TRBV20-1	TRBJ2-2
TGTGCCAGCGCTATCAGGGGCTTCAATCAGCCCCAGCATTTT	CASAIRGFNQPQHF	TRBV28	TRBJ1-5
TGTGCCAGCAGCAGATGGGGAGGGACAGCCTCCAGCAATCAGCCCCAGCATTTT	CASSRWGGTASSNQPQHF	TRBV7-2	TRBJ1-5
TGTGCCACCAGTGAGCAGGGGGCGTTTAGGAGCAATCAGCCCCAGCATTTT	CATSEQGAFRSNQPQHF	TRBV24-1	TRBJ1-5
TGTGCTAGTGGTTTGATGGGGCGGTCCGGTCGGAAGGGTAGAGGGGAGCTGTTTTTT	CASGLMGRSGRKGRGELFF	TRBV12-5	TRBJ2-2
TGTGCCAGCAGCTTGCCCAGAAGGGCGAATGAGCAGTTCTTC	CASSLPRRANEQFF	TRBV5-4	TRBJ2-1
TGCGCCAGCAGCCTGTCGGGAATGGGACCATGGGAGACTGAAGCTTTCTTT	CASSLSGMGPWETEAFF	TRBV4-1	TRBJ1-1
TGTGCCAGCTCGACTGACAACACAGATACGCAGTATTTT	CASSTDNTDTQYF	TRBV6-5	TRBJ2-3
TGTGCCAGCAGCTATCCTGGGTCAGGGCGAGACTCTGGGGCCAACGTCCTGACTTTC	CASSYPGSGRDSGANVLTF	TRBV14	TRBJ2-6
TGTGCCAGCAGCCAATCGTACGCCAAAAACATTCAGTACTTC	CASSQSYAKNIQYF	TRBV3-1	TRBJ2-4
TGTGCTAGTGGCCCCCCGGTACCTGTTGACACTGAAGCTTTCTTT	CASGPPVPVDTEAFF	TRBV12-5	TRBJ1-1
TGCAGTGCGATAGGGACTAGCACCGGGGAGCTGTTTTTT	CSAIGTSTGELFF	TRBV20-1	TRBJ2-2
TGCGCCAGCAGTGACCCAAGAGGCCAGCCCTACAATGAGCAGTTCTTC	CASSDPRGQPYNEQFF	TRBV10-1	TRBJ2-1
TGTGCCAGCAGCTTACTACGGGGACTAGCGGGGAGGAACACCGGGGAGCTGTTTTTT	CASSLLRGLAGRNTGELFF	TRBV7-9	TRBJ2-2
TGTGCCAGCAGCACGAACCGGGACAGGGAGGAACTACCGGGCTCCTACGAGCAGTACTTC	CASSTNRDREELPGSYEQYF	TRBV13	TRBJ2-7
TGTGCCAGCAGCACGACAGGGCCTGGAGAGAACACTGAAGCTTTCTTT	CASSTTGPGENTEAFF	TRBV5-8	TRBJ1-1
TGCGCCAGCAGAAACCACAGGGCCGGGACAGGGGGAATCACCTCCTACGAGCAGTACTTC	CASRNHRAGTGGITSYEQYF	TRBV5-1	TRBJ2-7
TGTGCCAGCAGCGTATCCCACAGGGGGCGGGCGCAGTACTTC	CASSVSHRGRAQYF	TRBV9	TRBJ2-7
TGTGCCCCGGCGCTCTCCTACGAGCAGTACTTC	CAPALSYEQYF	TRBV5-6	TRBJ2-7
TGTGCCAGCAGCCTTTGCGGGAGTAGGGGTAGCTACGAGCAGTACTTC	CASSLCGSRGSYEQYF	TRBV5-6	TRBJ2-7
TGTGCCAGCAGTGTCCCAGGGGGCACTAATGAAAAACTGTTTTTT	CASSVPGGTNEKLFF	TRBV6-4	TRBJ1-4
TGTGCCAGCACGTCGCCGGGACAGGGCTTTTACACTGAAGCTTTCTTT	CASTSPGQGFYTEAFF	TRBV27	TRBJ1-1
TGCAGCGGTGTTAAACGGGGGGGAATTATAGACGAGCAGTACTTC	CSGVKRGGIIDEQYF	TRBV29-1	TRBJ2-7
TGTGCCAGCAGTTGGGGACAGGGTTGTGAAAAACTGTTTTTT	CASSWGQGCEKLFF	TRBV6-9	TRBJ1-4
TGTGCCAGCAGCGGTGGGGACTATGACCACGGCACAGATACGCAGTATTTT	CASSGGDYDHGTDTQYF	TRBV9	TRBJ2-3
TGTGCCAGCAGCCACAGGGCCAGCTCCTACGAGCAGTACTTC	CASSHRASSYEQYF	TRBV2	TRBJ2-7
TGTGCCAGCAGTTACGGGAGGGAGGGGAAGGAGACCCAGTACTTC	CASSYGREGKETQYF	TRBV6-2	TRBJ2-5
TGCAGTGCGGATTTTCTCGCGGACAGGGGCTGGAGGGGCACAGATACGCAGTATTTT	CSADFLADRGWRGTDTQYF	TRBV20-1	TRBJ2-3
TGTGCCAGCAGCTCCGGGACAGGGTGCTGTTTTCAGCCCCAGCATTTT	CASSSGTGCCFQPQHF	TRBV9	TRBJ1-5
TGTGCCAGCAGCCTGGCCGGCCAGGGACAGGGAGAAAGCTACGAGCAGTACTTC	CASSLAGQGQGESYEQYF	TRBV7-6	TRBJ2-7
TGTGCCAGCAGAGGGCGGGGGGTCCTACAGACGGGATGGGTTGAGCAGTTCTTC	CASRGRGVLQTGWVEQFF	TRBV7-9	TRBJ2-1
TGTGCCAGCAGTCCTCTGGACCGCACAGATACGCAGTATTTT	CASSPLDRTDTQYF	TRBV27	TRBJ2-3
TGTGCCAGCAGTTGGAGTTCAGGGCGCAATGAGCAGTTCTTC	CASSWSSGRNEQFF	TRBV6-5	TRBJ2-1
TGTGCCAGTAGTATAGGGAACAGGGGCGTTGGGAAGACCCAGTACTTC	CASSIGNRGVGKTQYF	TRBV19	TRBJ2-5
TGTGCCAGCATCCCACTAGCGTCTTCAGATACGCAGTATTTT	CASIPLASSDTQYF	TRBV25-1	TRBJ2-3
TGTGCCAGCAGACCCACAAAATCCGGGGAGCTGTTTTTT	CASRPTKSGELFF	TRBV13	TRBJ2-2
TGTGCCAGCAGCGGGGCTGTAGAATATAGCAATCAGCCCCAGCATTTT	CASSGAVEYSNQPQHF	TRBV2	TRBJ1-5
TGTGCCAGCAGTAGGGGGGGTAATCAGCCCCAGCATTTT	CASSRGGNQPQHF	TRBV6-6	TRBJ1-5
TGCGCCAGCAGCGTACTAGACCCCTACGAGCAGTACTTC	CASSVLDPYEQYF	TRBV5-1	TRBJ2-7
TGCAGCGTTGGGGACAGGGGCCTTGGCTACGAGCAGTACTTC	CSVGDRGLGYEQYF	TRBV29-1	TRBJ2-7
TGTGCCAGCAGCGCCCCACCACGCGGACAGGTGCACTGCTCCTACGAGCAGTACTTC	CASSAPPRGQVHCSYEQYF	TRBV13	TRBJ2-7
TGTGCCAGCAGTTATTCCGGGTATTCAGGGCCCTACGAGCAGTACTTC	CASSYSGYSGPYEQYF	TRBV6-9	TRBJ2-7
TGTGCCAGCAGCAGCGGGCAGGGGAAGGATCAGCCCCAGCATTTT	CASSSGQGKDQPQHF	TRBV7-8	TRBJ1-5
TGTGCCAGCAGTTACCCTCCCAGGGGGAATCAGCCCCAGCATTTT	CASSYPPRGNQPQHF	TRBV6-2	TRBJ1-5
TGTGCCAGCAGCCCCGCCCGGACAGGGTATATCAGTGACACTGAAGCTTTCTTT	CASSPARTGYISDTEAFF	TRBV5-4	TRBJ1-1
TGTGCCTGTCTATCGGGGGGGACTAGCACAGATACGCAGTATTTT	CACLSGGTSTDTQYF	TRBV30	TRBJ2-3
TGTGCCAGCAGTGCATGGACAGGGCTTAACTATGGCTACACCTTC	CASSAWTGLNYGYTF	TRBV2	TRBJ1-2
TGTGCCACCACCTATTCCCCAAGGGGAGGGAACACTGAAGCTTTCTTT	CATTYSPRGGNTEAFF	TRBV24-1	TRBJ1-1
TGTGCCAGCCCAGGGTGGTCCTCTGGGGCCAACGTCCTGACTTTC	CASPGWSSGANVLTF	TRBV5-5	TRBJ2-6
TGTGCCAGCATTTCGGGGGGTGGCTACACCTTC	CASISGGGYTF	TRBV27	TRBJ1-2
TGTGCCAGCAGGTCTACCCACAGGAATCAGCCCCAGCATTTT	CASRSTHRNQPQHF	TRBV6-5	TRBJ1-5
TGTGCCAGCAGTTACTCGAGGGGCGGGAGTGTCGGATATGGCTACACCTTC	CASSYSRGGSVGYGYTF	TRBV6-5	TRBJ1-2
TGTGCCAGCAGCGGACAGAGAAGGAGCTACGAGCAGTACTTC	CASSGQRRSYEQYF	TRBV5-5	TRBJ2-7
TGTGCTAGCAGCTTAGCCCGGGCCGGGACCACCTACAATGAGCAGTTCTTC	CASSLARAGTTYNEQFF	TRBV7-7	TRBJ2-1
TGTGCCAGCAGCGTAGGGGACAGGGGAAAAAACGAGCAGTACTTC	CASSVGDRGKNEQYF	TRBV13	TRBJ2-7
TGTGCCAGCAGTGACTCGAGAGGAGACCAGCCCCAGCATTTT	CASSDSRGDQPQHF	TRBV6-4	TRBJ1-5
TGCGCCAGCAGTGAGACCACAAGACAGGGAGGCCTTCAGCCCCAGCATTTT	CASSETTRQGGLQPQHF	TRBV10-2	TRBJ1-5
TGTGCCAGCAGCTCGACCGGGACAGGGGCCACTGAAGCTTTCTTT	CASSSTGTGATEAFF	TRBV5-6	TRBJ1-1
TGTGCCAGCACTATAGCCAGGACAGGGCTAAAATCATTCGCAGATACGCAGTATTTT	CASTIARTGLKSFADTQYF	TRBV6-1	TRBJ2-3
TGTGCCAGCAGCTTAGGCATCCCCGGGACAGGGGGGGGGAACACTGAAGCTTTCTTT	CASSLGIPGTGGGNTEAFF	TRBV7-8	TRBJ1-1
TGTGCCACTCCGGGACTAGCGTGCGAGCAGTACTTC	CATPGLACEQYF	TRBV6-8	TRBJ2-7
TGCAGTGCTCCGACGTGCACCGGGGAGCTGTTTTTT	CSAPTCTGELFF	TRBV20-1	TRBJ2-2
TGTGCCAGCAACACCCGTAATTCCTACAATGAGCAGTTCTTC	CASNTRNSYNEQFF	TRBV9	TRBJ2-1
TGTGCCAGCTTGAGGTTGACCCAGTACTTC	CASLRLTQYF	TRBV9	TRBJ2-5
TGTGCCAGCAGCCCTAGAGAGATGAGGAACAATGAGCAGTTCTTC	CASSPREMRNNEQFF	TRBV28	TRBJ2-1
TGTGCCAGCAGTTCCCACGGCCATGAGCAGTACTTC	CASSSHGHEQYF	TRBV6-5	TRBJ2-7
TGCGCCAGCAGCCAAGACTCCATGCTCCGTCTCCATCAGCCCCAGCATTTT	CASSQDSMLRLHQPQHF	TRBV4-1	TRBJ1-5
TGTGCCAGCAGTGTTAGCGGGCATGAGGATACGCAGTATTTT	CASSVSGHEDTQYF	TRBV5-6	TRBJ2-3
TGTGCCACCAAACAATCCTACCGCATCTTC	CATKQSYRIF	TRBV24-1	TRBJ2-1
TGTGCCAGCAGCGTAGCCCTCGCTCCTCCTCGGACTAAAGCTGGCCGTGAGCAGTTCTTC	CASSVALAPPRTKAGREQFF	TRBV9	TRBJ2-1
TGTGCCAGCAGTTACTGGAAGGGGGGGGACCGCACTGAAGCTTTCTTT	CASSYWKGGDRTEAFF	TRBV6-8	TRBJ1-1
TGTGCCAGCAGTTTAGTATCCCTGGGGCTGTGGAACACCGGGGAGCTGTTTTTT	CASSLVSLGLWNTGELFF	TRBV27	TRBJ2-2
TGTTCTGGGAGGAGTTATGAGCAGTTCTTC	CSGRSYEQFF	TRBV14	TRBJ2-1
TGTGCCACTTTCTCAGGGGGCAACCAAGAGACCCAGTACTTC	CATFSGGNQETQYF	TRBV7-2	TRBJ2-5
TGTGCTAGTGGTTTGGTTTTAAGGGCCGGACAAAGGCAAGAGACCCAGTACTTC	CASGLVLRAGQRQETQYF	TRBV12-5	TRBJ2-5
TGTGCCAGCAGAGCCTATGACACCTTC	CASRAYDTF	TRBV14	TRBJ1-2
TGTGCCAGCAGTACCCGAGGACTAGCGGGCCTGGGGCCCGGGTCCTACAATGAGCAGTTCTTC	CASSTRGLAGLGPGSYNEQFF	TRBV6-1	TRBJ2-1
TGTGCCAGCAGCCAGACTAGGGGCGAGCAGTACTTC	CASSQTRGEQYF	TRBV7-9	TRBJ2-7
TGTGCCAGCGGGAGGAGAGAGACCCAGTACTTC	CASGRRETQYF	TRBV14	TRBJ2-5
TGTGCCAGCAGTTGGACCGGAGTGACCGGTGAGCAGTTCTTC	CASSWTGVTGEQFF	TRBV27	TRBJ2-1
TGCAGTGACAGGACAGATAACTATGGCTACACCTTC	CSDRTDNYGYTF	TRBV20-1	TRBJ1-2
TGTGCCAGCAGCGGACAGGACAAGGTTGAGCAGTACTTC	CASSGQDKVEQYF	TRBV11-2	TRBJ2-7
TGTGCCAGCAGGGGGGGGGACTGGGGCGACACTGAAGCTTTCTTT	CASRGGDWGDTEAFF	TRBV6-5	TRBJ1-1
TGCAGTGCTAGCCCGACAGGGGGCACGGATAGCTCTGGAAACACCATATATTTT	CSASPTGGTDSSGNTIYF	TRBV20-1	TRBJ1-3
TGTGCCAGCAGCCAAGATCTACGGGGGTCTGGAAACACCATATATTTT	CASSQDLRGSGNTIYF	TRBV4-2	TRBJ1-3
TGCAGTGCTAGAGATCAGGCGGGACGCTACAATGAGCAGTTCTTC	CSARDQAGRYNEQFF	TRBV20-1	TRBJ2-1
TGTGCCAGCAGTGTCCAACCGCCCGGGACTAGTTGCAAAAACATTCAGTACTTC	CASSVQPPGTSCKNIQYF	TRBV2	TRBJ2-4
TGCAGTGCTCTACGAGGGGGCTACAATGAGCAGTTCTTC	CSALRGGYNEQFF	TRBV20-1	TRBJ2-1
TGTGCCAGCAGCTTGGCGGATGGGACAGGGGGGGTAAACACTGAAGCTTTCTTT	CASSLADGTGGVNTEAFF	TRBV5-4	TRBJ1-1
TGTGCCGGTCCACAGGGGGCTATCAATCAGCCCCAGCATTTT	CAGPQGAINQPQHF	TRBV6-2	TRBJ1-5
TGTGCCAGCAGCTTAGAAGGGGATCCCACAGATACGCAGTATTTT	CASSLEGDPTDTQYF	TRBV7-9	TRBJ2-3
TGTGCCAGCAGTTTAAGGAAAGCAATACAGGGGGCAAAAGAAAAACTGTTTTTT	CASSLRKAIQGAKEKLFF	TRBV27	TRBJ1-4
TGTGCCAGCAGTTACTGTCGGGGGCACACAGATACGCAGTATTTT	CASSYCRGHTDTQYF	TRBV6-2	TRBJ2-3
TGTGCCAGCACCACAGGGATCAGGGGCTACACCTTC	CASTTGIRGYTF	TRBV12-3	TRBJ1-2
TGTGCCAGCAGCGCAGGGGGCGTCCTCAGTTCAGATACGCAGTATTTT	CASSAGGVLSSDTQYF	TRBV9	TRBJ2-3
TGCAGCGCCGAGATGGGGACTAGCGGGGGAGAGCAGTTCTTC	CSAEMGTSGGEQFF	TRBV29-1	TRBJ2-1
TGCAGTGCTAGAGGGGGGGCCGACCGGGACAGGGGAGATTCAGATACGCAGTATTTT	CSARGGADRDRGDSDTQYF	TRBV20-1	TRBJ2-3
TGTGCCAGCAGGTTTATGTCCCCCCAGTGGGACGAAACCGGGGAGCTGTTTTTT	CASRFMSPQWDETGELFF	TRBV6-6	TRBJ2-2
TGCAGTGCAAGACAGTCGGCCCGTGAAAAACTGTTTTTT	CSARQSAREKLFF	TRBV20-1	TRBJ1-4
TGTGCCAGCAGTCTGTCCACGCCATACTATGGCTACACCTTC	CASSLSTPYYGYTF	TRBV2	TRBJ1-2
TGTGCCAGCCCGAAGGACAGGGGCGAGCAGTACTTC	CASPKDRGEQYF	TRBV6-2	TRBJ2-7
TGTGCCAGCAGCTTCCCCTCCGGGGGGGCCGGAGGTACTGAGACCCAGTACTTC	CASSFPSGGAGGTETQYF	TRBV7-9	TRBJ2-5
TGTGCCAGCAAAATGGGAGGGGACGCCCACAATGAGCAGTTCTTC	CASKMGGDAHNEQFF	TRBV6-6	TRBJ2-1
TGTGCCTGGATCCGGACAGTGAACACTGAAGCTTTCTTT	CAWIRTVNTEAFF	TRBV30	TRBJ1-1
TGCGCCAGCAGCCCTACGGGACTAGCGGGAAGGATGGCAATTTCCAATGAGCAGTTCTTC	CASSPTGLAGRMAISNEQFF	TRBV5-1	TRBJ2-1
TGTGCCAGCAGCCATACGTTTTCTAGCGGAGGATGCTCCTACGAGCAGTACTTC	CASSHTFSSGGCSYEQYF	TRBV13	TRBJ2-7
TGTGCCAGCAGCTTAATGGACCCGACGTTTCTAGCTAACTATGGCTACACCTTC	CASSLMDPTFLANYGYTF	TRBV7-3	TRBJ1-2
TGTGCCAGCAGTGACTCGAGGAGAGTCAGGGGTCAGCCCCAGCATTTT	CASSDSRRVRGQPQHF	TRBV6-4	TRBJ1-5
TGTGCCAGCAGCTTGTATCAGCAGAGGGACCTTCGCACTGAAGCTTTCTTT	CASSLYQQRDLRTEAFF	TRBV5-6	TRBJ1-1
TGTGCCAGCAGCCCGGGAGATAGCAATCAGCCCCAGCATTTT	CASSPGDSNQPQHF	TRBV6-5	TRBJ1-5
TGTGCCATCTTCCATTGGGACAGCTCCCGGGCTCCGGGTAACTATGGCTACACCTTC	CAIFHWDSSRAPGNYGYTF	TRBV10-3	TRBJ1-2
TGTGCCAGCAGAATGTCGGATAAGTCACCCCTCCACTTT	CASRMSDKSPLHF	TRBV12-3	TRBJ1-6
TGTGCCAGCAGCGCGATCCATCCCTACGAGCAGTACTTC	CASSAIHPYEQYF	TRBV13	TRBJ2-7
TGTGCCAGAACTAAAAGGGGGCAAAACATTCAGTACTTC	CARTKRGQNIQYF	TRBV27	TRBJ2-4
TGTGCCAGCACGACTCCCTGCTACGAGCAGTACTTC	CASTTPCYEQYF	TRBV6-5	TRBJ2-7
TGTGCCAGCAGCTCCGTTGGGGGAGGGCACGAGCAGTACTTC	CASSSVGGGHEQYF	TRBV4-2	TRBJ2-7
TGTGCCAGCAGTCCGGACAGGGGAAACGCTAACTATGGCTACACCTTC	CASSPDRGNANYGYTF	TRBV9	TRBJ1-2
TGTGCCAGCCCGGAAGGGGGGGCCCGCGGGGAGCTGTTTTTT	CASPEGGARGELFF	TRBV6-5	TRBJ2-2
TGTGCCAGCAGCCCAGTGGGGGGGGGATCAACTGAAGCTTTCTTT	CASSPVGGGSTEAFF	TRBV7-8	TRBJ1-1
TGTGCCAGCAGCGGGGCCCCCAGGGATAGGGGGGAGCTGTTTTTT	CASSGAPRDRGELFF	TRBV13	TRBJ2-2
TGTGCCAGCAGTGCCTGGACAGGGCCAGATACGCAGTATTTT	CASSAWTGPDTQYF	TRBV6-3	TRBJ2-3
TGTGCCAGCCCTCCTGCGGACAGGGTCCGGTACTTC	CASPPADRVRYF	TRBV25-1	TRBJ2-5
TGTGCCAGCAGCGGACAGAGGAGGCCCTACGAGCAGTACTTC	CASSGQRRPYEQYF	TRBV9	TRBJ2-7
TGTGCCAGCAGCCTGCACCCCCGGGGGTGGCAGGTTTATAGCACTGAAGCTTTCTTT	CASSLHPRGWQVYSTEAFF	TRBV4-2	TRBJ1-1
TGCAGTGGCAGGGGATCCCCGGCCACTGAAGCTTTCTTT	CSGRGSPATEAFF	TRBV20-1	TRBJ1-1
TGTGCCAGCCGGCGTTGGGACAGGATCTCCTACGAGCAGTACTTC	CASRRWDRISYEQYF	TRBV7-7	TRBJ2-7
TGCGCCAGCAGCCCCCCCGAAGGCTCCTACAATGAGCAGTTCTTC	CASSPPEGSYNEQFF	TRBV5-1	TRBJ2-1
TGTGCCAGCAGCTTGTGCGGGGATACGCAGTATTTT	CASSLCGDTQYF	TRBV5-4	TRBJ2-3
TGTGCCAGCAGCCCCCGTTCGGGGACTCGCCAGTACTTC	CASSPRSGTRQYF	TRBV3-1	TRBJ2-4
TGTGCCAGCAGCAGGGACTTGAACACTGAAGCTTTCTTT	CASSRDLNTEAFF	TRBV7-3	TRBJ1-1
TGTGCCAGCAGTGACTACCCTTCTAACAGGGCCTACGAGCAGTACTTC	CASSDYPSNRAYEQYF	TRBV6-4	TRBJ2-7
TGTGCGGAGGGACAGGGTAACTATGGCTACACCTTC	CAEGQGNYGYTF	TRBV27	TRBJ1-2
TGTGCCAGCAGTGACGGGGAGGACAGGGGGCATATCGAGACCCAGTACTTC	CASSDGEDRGHIETQYF	TRBV6-4	TRBJ2-5
TGTGCCAGCAGCCATTGGGGGGGCCCCCGGCAGTTCTTC	CASSHWGGPRQFF	TRBV13	TRBJ2-1
TGTGCCAGCAGCGCCCCTGGGTCCTACGAGCAGTACTTC	CASSAPGSYEQYF	TRBV9	TRBJ2-7
TGTGCTAGCAGCGAAAAGTTCCTATTATTTCCGGGACTGGCCTACAATGAGCAGTTCTTC	CASSEKFLLFPGLAYNEQFF	TRBV7-7	TRBJ2-1
TGTGCCACCAGCCCAGTTTGGGACAGAGGGTGCGAGCAGTACTTC	CATSPVWDRGCEQYF	TRBV15	TRBJ2-7
TGTGCCAGCAGCCGGGACAGTGCAAGGTACGAGCAGTACTTC	CASSRDSARYEQYF	TRBV14	TRBJ2-7
TGTGCCAGCAGCTACCCCCAAACAGGGGAGACACATGAGCAGTTCTTC	CASSYPQTGETHEQFF	TRBV7-2	TRBJ2-1
TGTGCCAGCACCGTAGTAGCGGGGGCCTACGAGCAGTACTTC	CASTVVAGAYEQYF	TRBV2	TRBJ2-7
TGTGCCAGCAGCCAAGACAGGGGGGGCTCCGATACGCAGTATTTT	CASSQDRGGSDTQYF	TRBV3-1	TRBJ2-3
TGTGCCAGCAGCGTCGGGACTAGCGGGACTCCAGAGACCCAGTACTTC	CASSVGTSGTPETQYF	TRBV9	TRBJ2-5
TGTGCCAGTAGTATAGATCGACTATCGCCGGGACAGACCCTGAACACTGAAGCTTTCTTT	CASSIDRLSPGQTLNTEAFF	TRBV19	TRBJ1-1
TGCGCCAGCAGTAAAGGGGACGAGCAGTACTTC	CASSKGDEQYF	TRBV10-1	TRBJ2-7
TGTGCCAGCAGTTCTCGTTATTACAGCAGGGGTTCAAGCTCCTATAATTCACCCCTCCACTTT	CASSSRYYSRGSSSYNSPLHF	TRBV6-4	TRBJ1-6
TGCGCCAGCAGTGCAGGACAGGGAAGAGAAAAACTGTTTTTT	CASSAGQGREKLFF	TRBV10-1	TRBJ1-4
TGTGCCAGCAGCCGTGGACAGGGCAATCAGCCCCAGCATTTT	CASSRGQGNQPQHF	TRBV7-3	TRBJ1-5
TGTGCTAGCAGCAAAGACAGGGTTGGTGACGAGCAGTACTTC	CASSKDRVGDEQYF	TRBV7-7	TRBJ2-7
TGTGCCAGTGCTGTTGACAGGGGTAATCCCCAGCATTTT	CASAVDRGNPQHF	TRBV19	TRBJ1-5
TGCAGTGCTACCGGGCCGGACTACGAGCAGTACTTC	CSATGPDYEQYF	TRBV20-1	TRBJ2-7
TGTGCCAGCTCAGGTCGGGGCCGACACTATGGCTACACCTTC	CASSGRGRHYGYTF	TRBV18	TRBJ1-2
TGTGCCAGCAGCTTAGATCGGGGCGTCCAGCCCCAGCATTTT	CASSLDRGVQPQHF	TRBV11-2	TRBJ1-5
TGCGCCAGCAGCCCGAGGGAGGGGGTCCGGGAGGTGAGCAATCAGCCCCAGCATTTT	CASSPREGVREVSNQPQHF	TRBV4-3	TRBJ1-5
TGTGCCACCAGCCCGGGGACAGGGTTCTTATCCCAGCATTTT	CATSPGTGFLSQHF	TRBV15	TRBJ1-5
TGTGCCAGCTTAGAAAGCAATGAGCAGTTCTTC	CASLESNEQFF	TRBV9	TRBJ2-1
TGTGCCAGCAGCGGACTAGCGGGGAATGGGGAGACCCAGTACTTC	CASSGLAGNGETQYF	TRBV11-3	TRBJ2-5
TGCAGCGTTGAAGGAGAGGGGGGCCGGACAGATACGCAGTATTTT	CSVEGEGGRTDTQYF	TRBV29-1	TRBJ2-3
TGTGCCAGTAGTATATTCGGGGCAAACCTAAATCAGCCCCAGCATTTT	CASSIFGANLNQPQHF	TRBV19	TRBJ1-5
TGCGCCAGCAGAAAAAAGACAGGGCCTCCCTCGGGTTGTGCCCACAAGAACTATAGCAATCAGCCCCAGCATTTT	CASRKKTGPPSGCAHKNYSNQPQHF	TRBV5-1	TRBJ1-5
TGCAGTGCTAGGGACAGGGGCCAGCCCCAGCATTTT	CSARDRGQPQHF	TRBV20-1	TRBJ1-5
TGTGCCAGTAGGCCCAGTCAAACCGGGGAGCTGTTTTTT	CASRPSQTGELFF	TRBV19	TRBJ2-2
TGTGCCAGCAGAGGGGGACGGCGGAATTCACCCCTCCACTTT	CASRGGRRNSPLHF	TRBV12-4	TRBJ1-6
TGTGCCCGGATCACAGGGGGATCTAGTGGAAACACCATATATTTT	CARITGGSSGNTIYF	TRBV10-3	TRBJ1-3
TGCAGTGCTCTTCCTAAACGGAGGACCGGGGAGCTGTTTTTT	CSALPKRRTGELFF	TRBV20-1	TRBJ2-2
TGCAGTGCTAGAGGATGGGACGGCTCTGGAAACACCATATATTTT	CSARGWDGSGNTIYF	TRBV20-1	TRBJ1-3
TGTGCCAGTAGTATAGTCCTCAAGACCGGGACAGAGAGCTCCTACGAGCAGTACTTC	CASSIVLKTGTESSYEQYF	TRBV19	TRBJ2-7
TGTGCCAGCAGCGGTGTGACAGGGAACTACGAGCAGTACTTC	CASSGVTGNYEQYF	TRBV7-4	TRBJ2-7
TGTGCCAGCAGGGGTAATTGGACGGGAGGTGGTGGCGAGCAGTACTTC	CASRGNWTGGGGEQYF	TRBV6-2	TRBJ2-7
TGTGCCAGCAGGGCCGGGACGATCACTGAAGCTTTCTTT	CASRAGTITEAFF	TRBV6-4	TRBJ1-1
TGCAGCGCCCGCCAACATTGTCGCAACACTGAAGCTTTCTTT	CSARQHCRNTEAFF	TRBV29-1	TRBJ1-1
TGTGCCAGCAGCGGGCCCCGGGGACCCACACCCCTCCACTTT	CASSGPRGPTPLHF	TRBV13	TRBJ1-6
TGTGCCAGCAGCTGGGATTACCGGACCGCCTTCTACGAGCAGTACTTC	CASSWDYRTAFYEQYF	TRBV7-2	TRBJ2-7
TGTGCCAGTAGTATAGGACCCCGGGACCCTCCAGATACGCAGTATTTT	CASSIGPRDPPDTQYF	TRBV19	TRBJ2-3
TGTGCCAGCCCCCTACAGGGCACAGATACGCAGTATTTT	CASPLQGTDTQYF	TRBV6-3	TRBJ2-3
TGCAGGACTGGGGGGGGCGTCTACGAGCAGTACTTC	CRTGGGVYEQYF	TRBV29-1	TRBJ2-7
TGTGCCAGCCCCACAGTAGAGTACTACGAGCAGTACTTC	CASPTVEYYEQYF	TRBV6-5	TRBJ2-7
TGTGCCAGCAGTTGGGGTACAGGGGAGACCCAGTACTTC	CASSWGTGETQYF	TRBV27	TRBJ2-5
TGCAGTGCTAGAGCCCGAACCCTCGCTGAAGCTTTCTTT	CSARARTLAEAFF	TRBV20-1	TRBJ1-1
TGTGCCAGCAGCGAGGGTCGCCAGCCCCAGCATTTT	CASSEGRQPQHF	TRBV13	TRBJ1-5
TGTGCCAGCAGCCGGAGGACTGGGTCCAGAGATACGCAGTATTTT	CASSRRTGSRDTQYF	TRBV7-9	TRBJ2-3
TGTGCCAGCAGCTCCTTTAGCGGGACCTATGGGAATGGCTACACCTTC	CASSSFSGTYGNGYTF	TRBV7-2	TRBJ1-2
TGTGCCAGCAGTGAATCCCAGTTAGCGGGACGATACGAGCAGTACTTC	CASSESQLAGRYEQYF	TRBV25-1	TRBJ2-7
TGCGCCAGCAGCTTCGCGGGGACTCATGAGCAGTTCTTC	CASSFAGTHEQFF	TRBV5-1	TRBJ2-1
TGTGCCAGCAGCCAATCAGAAAGGGGGGGGGTCACAGATACGCAGTATTTT	CASSQSERGGVTDTQYF	TRBV11-3	TRBJ2-3
TGTGCCAGCAGCTTAGCCCTAGCGGGGACCTACGAGCAGTACTTC	CASSLALAGTYEQYF	TRBV11-3	TRBJ2-7
TGTGCCAGCAGAGGACGGACTACTGGGCTCGGGGAGCTGTTTTTT	CASRGRTTGLGELFF	TRBV6-8	TRBJ2-2
TGTGCCAGCAGACCTAGAACAGGGGGCACGAACACTGAAGCTTTCTTT	CASRPRTGGTNTEAFF	TRBV12-3	TRBJ1-1
TGTGCCACCAGTGATTCCCAGTCGGGACATGAAGCTTTCTTT	CATSDSQSGHEAFF	TRBV24-1	TRBJ1-1
TGCAATAAGACATTAAGCAATCAGCCCCAGCATTTT	CNKTLSNQPQHF	TRBV29-1	TRBJ1-5
TGCGCCAGAATGGGGGCTGGAGGGAATTCACCCCTCCACTTT	CARMGAGGNSPLHF	TRBV5-1	TRBJ1-6
TGTGCCAGCAGCTCCTCTATCCCCAGCGGGATCCCTTCGACCTATGGCTACACCTTC	CASSSSIPSGIPSTYGYTF	TRBV12-3	TRBJ1-2
TGTGCCAGCAGCCAAGAGGTCCAGGGGTTGCGCTACGAGCAGTACTTC	CASSQEVQGLRYEQYF	TRBV3-1	TRBJ2-7
TGCGCCAGCAGCTTTAACAGGGGTGGGGAGAGAGATACGCAGTATTTT	CASSFNRGGERDTQYF	TRBV5-1	TRBJ2-3
TGCGCCAGCAGCTTGGGCAGAATAGCCAAAAACATTCAGTACTTC	CASSLGRIAKNIQYF	TRBV5-1	TRBJ2-4
TGCGCCAGCAGCTTGAAGGTCAAAAATGAAAAACTGTTTTTT	CASSLKVKNEKLFF	TRBV5-1	TRBJ1-4
TGTGCCGAGCGTAGCGGGCAAGCCTCCAATGAGCAGTTCTTC	CAERSGQASNEQFF	TRBV27	TRBJ2-1
TGTGCCAGCAGCCAGCGCCGGGACGGAAACACCATATATTTT	CASSQRRDGNTIYF	TRBV14	TRBJ1-3
TGTGCCAGCAGCCAATTTAGAGGGGCTAATGCTGGAAACACCATATATTTT	CASSQFRGANAGNTIYF	TRBV14	TRBJ1-3
TGTGCCAGCAGTAACCGGGACATCTCCTACAATGAGCAGTTCTTC	CASSNRDISYNEQFF	TRBV6-4	TRBJ2-1
TGTGCCACCAGTGACCCCCCCTGCGGGGAAAGACTAGATCAGCCCCAGCATTTT	CATSDPPCGERLDQPQHF	TRBV24-1	TRBJ1-5
TGTGCCAGCAGCGTAGCTAAACTAGCCGAGCAGTACTTC	CASSVAKLAEQYF	TRBV9	TRBJ2-7
TGTGCCTGGTTAGGGACAGGGAGCACCTACAATGAGCAGTTCTTC	CAWLGTGSTYNEQFF	TRBV30	TRBJ2-1
TGTGCCAGCAGTCGGTATTATGCCCAGCATTTT	CASSRYYAQHF	TRBV6-1	TRBJ1-5
TGTGCCAGCAGCTACCCCGAGGGGTTTGTGGCGGGAGCTTTCTTT	CASSYPEGFVAGAFF	TRBV5-6	TRBJ1-1
TGTGCCACAGAGGGCACGTCTGAGACCCAGTACTTC	CATEGTSETQYF	TRBV27	TRBJ2-5
TGTGCCAGCAGTTTATACTGGGACAGGTGCCGTGGCTACACCTTC	CASSLYWDRCRGYTF	TRBV27	TRBJ1-2
TGCGCCAGCAGTGAGTCAGCCAGGGCGTTTTATGAGCAGTTCTTC	CASSESARAFYEQFF	TRBV10-1	TRBJ2-1
TGTGCCAGCCCCTCGACCACTGAAGCTTTCTTT	CASPSTTEAFF	TRBV27	TRBJ1-1
TGTGCCAGCAGCCCAGCAGGACAGGGGGAGAATAGCAATCAGCCCCAGCATTTT	CASSPAGQGENSNQPQHF	TRBV5-5	TRBJ1-5
TGTGCCAGCAGCTTCACACAGGACAGTCAGTCTACGACCACAGATACGCAGTATTTT	CASSFTQDSQSTTTDTQYF	TRBV5-4	TRBJ2-3
TGTGCCAGCAGCCAAGATATCGAGGGTGGGCAAGAGACCCAGTACTTC	CASSQDIEGGQETQYF	TRBV14	TRBJ2-5
TGTGCCAGCAGCCAGCTCGACAATGAGCAGTTCTTC	CASSQLDNEQFF	TRBV28	TRBJ2-1
TGTGCCAGCAGGAGTCAGGGACATCCGGCAGGGAACACTGAAGCTTTCTTT	CASRSQGHPAGNTEAFF	TRBV6-6	TRBJ1-1
TGTGCCAGCTCACCTGGCTCCACAACCCCCGGGGGTGGCTACACCTTC	CASSPGSTTPGGGYTF	TRBV18	TRBJ1-2
TGTGCCAGCAGCCCTGGGCAGGGCTATGGCTACACCTTC	CASSPGQGYGYTF	TRBV14	TRBJ1-2
TGTGCCAGCAGCTTAGATAGTTGGGGGGGCACTGAAGCTTTCTTT	CASSLDSWGGTEAFF	TRBV11-3	TRBJ1-1
TGTGCCAGCAGTTTACCATTAGGCTGCAACACTGAAGCTTTCTTT	CASSLPLGCNTEAFF	TRBV28	TRBJ1-1
TGTGCCAGCAGTTTACTAAACCACACCATATATTTT	CASSLLNHTIYF	TRBV12-3	TRBJ1-3
TGTGCCAGCAGCCACCCGACAGAAGAGTCTCCTGAAGCTTTCTTT	CASSHPTEESPEAFF	TRBV14	TRBJ1-1
TGTGCCACCTGGAGCCCGTGCAATCAGCCCCAGCATTTT	CATWSPCNQPQHF	TRBV6-5	TRBJ1-5
TGTGCCAGCAGTTACGACCCCCACGGGTATAGCAATCAGCCCCAGCATTTT	CASSYDPHGYSNQPQHF	TRBV6-5	TRBJ1-5
TGTGCCAGCAGTGGGCCGGGACATTACTTGATCTACGAGCAGTACTTC	CASSGPGHYLIYEQYF	TRBV12-3	TRBJ2-7
TGCGCCAGCAGTGAGTCGGGTCGGGCGGGACAGGTTGGCTACACCTTC	CASSESGRAGQVGYTF	TRBV10-1	TRBJ1-2
TGTGCCAGCCGCCGGGACAGACTATACGAGCAGTACTTC	CASRRDRLYEQYF	TRBV7-9	TRBJ2-7
TGTGCCAGCAGCCCCAGCCGGGACCCAGATACGCAGTATTTT	CASSPSRDPDTQYF	TRBV7-3	TRBJ2-3
TGCAGTGCTAGAGAGGATTGGGGCGCGAGACCCTTTTCTGGAAACACCATATATTTT	CSAREDWGARPFSGNTIYF	TRBV20-1	TRBJ1-3
TGCAGTGCTAGAGTGAGAGAGGGAGGGGGTCGGCCCCATGGCTACACCTTC	CSARVREGGGRPHGYTF	TRBV20-1	TRBJ1-2
