TGTGCCAGGGGACTAGCGGGCACAGATACGCAGTATTTT	CARGLAGTDTQYF	TRBV2	TRBJ2-3
TGCGCCAGCCAGGTTCGACGGGACACTGAAGCTTTCTTT	CASQVRRDTEAFF	TRBV10-1	TRBJ1-1
TGTGCCAGCAGCAACCCCCCCAGGGAAGCCCAAGAGACCCAGTACTTC	CASSNPPREAQETQYF	TRBV13	TRBJ2-5
TGTGCCGCCTTACGTACCTCTGGGGCCAACGTCCTGACTTTC	CAALRTSGANVLTF	TRBV6-4	TRBJ2-6
TGTGCCAGCATCCCAGGGGGCGGTGGTACCGGGGAGCTGTTTTTT	CASIPGGGGTGELFF	TRBV27	TRBJ2-2
TGTGCCAGCAGCGGACCGGGACAGGGCTACACCGGGGAGCTGTTTTTT	CASSGPGQGYTGELFF	TRBV9	TRBJ2-2
TGTGCCAGCAGGGTACTAGCGGGAGGACGTTCACCCCTCCACTTT	CASRVLAGGRSPLHF	TRBV7-3	TRBJ1-6
TGCGCCAGCAGTGAGCAGGGACTAGCGGGGTGGTGGTTTCAAGAGACCCAGTACTTC	CASSEQGLAGWWFQETQYF	TRBV10-1	TRBJ2-5
TGCGCCAGCAGTGATGGGCGCCGGGACAGGGGGCGGTCGAGAGTCACCTACGAGCAGTACTTC	CASSDGRRDRGRSRVTYEQYF	TRBV10-1	TRBJ2-7
TGCGCCAGCAGGGATGTGTCGTGGGAAGGGGGCTACGAGCAGTACTTC	CASRDVSWEGGYEQYF	TRBV10-2	TRBJ2-7
TGTGCCTGGAGTGTACAGGACCCAGGGGAAAACACCGGGGAGCTGTTTTTT	CAWSVQDPGENTGELFF	TRBV30	TRBJ2-2
TGTGCCAGCAGCGTAGAACCGGGGTTCAATCAGCCCCAGCATTTT	CASSVEPGFNQPQHF	TRBV9	TRBJ1-5
TGTGCCAGCAGCACCTTTCTCCTGGGGGGGCATATAAACATTCAGTACTTC	CASSTFLLGGHINIQYF	TRBV5-4	TRBJ2-4
TGTGCCAGCAGTTACTCGATGGGACAGCGGGGTAAATTAAACACCATATATTTT	CASSYSMGQRGKLNTIYF	TRBV6-5	TRBJ1-3
TGTGCCAGCAGCTTAGGCCCCCCGGGTTGGGCTAGCACAGATACGCAGTATTTT	CASSLGPPGWASTDTQYF	TRBV7-2	TRBJ2-3
TGTGCCAGCTCACGCTTTAGCGGGGTAGGGCAGGAGTGGGAGCTGTTTTTT	CASSRFSGVGQEWELFF	TRBV18	TRBJ2-2
TGTGCCAGCAGCTTATCCGAGACTGGGAACGAGCAGTACTTC	CASSLSETGNEQYF	TRBV11-3	TRBJ2-7
TGTGCCAGCAGCCAGCCGGGGGAGAACACCTTC	CASSQPGENTF	TRBV3-1	TRBJ1-2
TGTGCCAGCAGCTTAGTAAGACTCCAGGTTGGTAACTCCTACGAGCAGTACTTC	CASSLVRLQVGNSYEQYF	TRBV11-2	TRBJ2-7
TGTGCCAGCAGCTTCCGGACAGGGACACAGAAATATGGCTACACCTTC	CASSFRTGTQKYGYTF	TRBV7-9	TRBJ1-2
TGTGCCAGCGTCAGGGATTCGTCCTACGAGCAGTACTTC	CASVRDSSYEQYF	TRBV5-4	TRBJ2-7
TGTGCCAGCAGCGCAGGAACCGGACGGAGAGGGCCTTCAAGCTCTGGGGCCAACGTCCTGACTTTC	CASSAGTGRRGPSSSGANVLTF	TRBV9	TRBJ2-6
TGTGCCAGCAGCCGGAGCTACGAGCAGTACTTC	CASSRSYEQYF	TRBV11-2	TRBJ2-7
TGTGCCAGCAGTTTATGGGGGGGGAGGAGCACCGGGGAGCTGTTTTTT	CASSLWGGRSTGELFF	TRBV28	TRBJ2-2
TGTGCCACCGGGGTGTGGGGCAATCAGCCCCAGCATTTT	CATGVWGNQPQHF	TRBV7-9	TRBJ1-5
TGTGCCAGCCCGAAAAAGCTAGCGGGGTGCGAGCAGTACTTC	CASPKKLAGCEQYF	TRBV6-2	TRBJ2-7
TGCAGCGCTCGGGACAGGGATGGCTACACCTTC	CSARDRDGYTF	TRBV29-1	TRBJ1-2
TGTGCCAGCAGGGCCTGCTACAATGAGCAGTTCTTC	CASRACYNEQFF	TRBV27	TRBJ2-1
TGTGCCACCAGTGATTTCCCCAGGGTCGGGAAGACCCAGTACTTC	CATSDFPRVGKTQYF	TRBV24-1	TRBJ2-5
TGTGCCAGCAGCTTAGCCCAGGGGGCCTACGAGCAGTACTTC	CASSLAQGAYEQYF	TRBV7-9	TRBJ2-7
TGTGCCAGCAGTGAAGGACCGGGACAGTCCAGGAACCCGACCCAGTACTTC	CASSEGPGQSRNPTQYF	TRBV6-4	TRBJ2-5
TGTGCCACCAGAGATACTAGCGGGAGAACCTCTGGGGCCAACGTCCTGACTTTC	CATRDTSGRTSGANVLTF	TRBV24-1	TRBJ2-6
TGCGCCGGGGACCAACCGTACACTGAAGCTTTCTTT	CAGDQPYTEAFF	TRBV5-1	TRBJ1-1
TGTGCCAGCAGTGGCCGTCCCCGGACTAGCGGGGTCCACTACGAGCAGTACTTC	CASSGRPRTSGVHYEQYF	TRBV28	TRBJ2-7
TGTGCCACCAGTGATTTGAACCAGTTTAGCAATCAGCCCCAGCATTTT	CATSDLNQFSNQPQHF	TRBV24-1	TRBJ1-5
TGTCTACTATCGGCAGGGGGGAATGAGCAGTTCTTC	CLLSAGGNEQFF	TRBV30	TRBJ2-1
TGTGCCAGCAGCCAAGATACTCTACAGGGATATATTGAAAAACTGTTTTTT	CASSQDTLQGYIEKLFF	TRBV14	TRBJ1-4
TGCGCCAGCAGCCACCCAACAGGGGGGAAGCCCCAGCATTTT	CASSHPTGGKPQHF	TRBV4-1	TRBJ1-5
TGTGCCAGCAGCTTAGGGACAGGGGCCAAAAACATTCAGTACTTC	CASSLGTGAKNIQYF	TRBV11-2	TRBJ2-4
TGTGCCAGCAGCCCTTCCAGGGGGGGCTACACCTTC	CASSPSRGGYTF	TRBV13	TRBJ1-2
TGTGCCAGCAGCCAAGAAACCGGGACAGCCGGCTACACCTTC	CASSQETGTAGYTF	TRBV3-1	TRBJ1-2
TGCAGTGCGGGACTAACCCATGAGCAGTTCTTC	CSAGLTHEQFF	TRBV20-1	TRBJ2-1
TGTGCCAGTACCGGGACTGTGCTAGCCGGCTCCTACGAGCAGTACTTC	CASTGTVLAGSYEQYF	TRBV19	TRBJ2-7
TGCAGTGCTAGCCGGAGGGAGGGGTATAGCAATCAGCCCCAGCATTTT	CSASRREGYSNQPQHF	TRBV20-1	TRBJ1-5
TGTGCCAGCAGCAGGAGGGACGAGCAGTACTTC	CASSRRDEQYF	TRBV13	TRBJ2-7
TGTGCCAGCAGAACGGAGGAGCGGGGCTCCTACAATGAGCAGTTCTTC	CASRTEERGSYNEQFF	TRBV28	TRBJ2-1
TGTGCCAGCAGTTGGGGGGCGTACGGCTACACCTTC	CASSWGAYGYTF	TRBV12-3	TRBJ1-2
TGTGCCATCAACGAGTCTCCAGGGGATGCAACTAATGAAAAACTGTTTTTT	CAINESPGDATNEKLFF	TRBV10-3	TRBJ1-4
TGTGCCAGCAGCCCGGACAGGGACGAGCAGTACTTC	CASSPDRDEQYF	TRBV7-6	TRBJ2-7
TGTGCCAGCAGCTTGCGGGTTCGAGCGGGAGCCTACGAGCAGTACTTC	CASSLRVRAGAYEQYF	TRBV5-6	TRBJ2-7
TGTGCCAGCCCCCAAAGGAACACTGAAGCTTTCTTT	CASPQRNTEAFF	TRBV19	TRBJ1-1
TGTGCCAGCAGTGACTCAAATCGACTGGGACTGACCCACACCGGGGAGCTGTTTTTT	CASSDSNRLGLTHTGELFF	TRBV6-4	TRBJ2-2
TGTGCCACCAGTGATCTCTCCCCGGGACTAGCGGGAGATGAGCAGTTCTTC	CATSDLSPGLAGDEQFF	TRBV24-1	TRBJ2-1
TGTGCCAGCAGCGAAAAGGGGCTGAACTATGGCTACACCTTC	CASSEKGLNYGYTF	TRBV7-8	TRBJ1-2
TGTGCCAGCAGCGAGAGCCATAGCAATCAGCCCCAGCATTTT	CASSESHSNQPQHF	TRBV11-3	TRBJ1-5
TGTGCCAGCAGCTCCAGGGGTAAGGTGAACACTGAAGCTTTCTTT	CASSSRGKVNTEAFF	TRBV7-9	TRBJ1-1
TGTGCCAGCAGCTTGGGCAGGGAGGGCTGGAGAAACACCATATATTTT	CASSLGREGWRNTIYF	TRBV5-5	TRBJ1-3
TGTGCCAGCAGTTTGCCAGGGAAACAGAAGGCAACTAATGAAAAACTGTTTTTT	CASSLPGKQKATNEKLFF	TRBV28	TRBJ1-4
TGTGCCAGCAGCCTGGCTCGGTACGGCTACGAGCAGTACTTC	CASSLARYGYEQYF	TRBV28	TRBJ2-7
TGTGCCAGCATGGAGTTACATTATGGCTACACCTTC	CASMELHYGYTF	TRBV28	TRBJ1-2
TGTGCCAGCAGTTTTCGGCGTCCTCCCGATTCGGTACCTGGCACAGATACGCAGTATTTT	CASSFRRPPDSVPGTDTQYF	TRBV28	TRBJ2-3
TGTGCCAGCAGCCTACCAATCGGGGGCAATTCACCCCTCCACTTT	CASSLPIGGNSPLHF	TRBV11-2	TRBJ1-6
TGTGCCAGCAGCCTCCCCCTCACAGGGCCCGAGCAGTACTTC	CASSLPLTGPEQYF	TRBV13	TRBJ2-7
TGTGCCACCAGTGAGAGAGCAAGCGGGAGGATGATGAACACTGAAGCTTTCTTT	CATSERASGRMMNTEAFF	TRBV24-1	TRBJ1-1
TGCGCCAGCAGAGACCCCCGACAGGGTGGATGTGAGACCCAGTACTTC	CASRDPRQGGCETQYF	TRBV10-1	TRBJ2-5
TGCGCCAGCAACCCCGAGAAATTCCCAATCCTGGGGGGGATACAGTACGAGCAGTACTTC	CASNPEKFPILGGIQYEQYF	TRBV10-2	TRBJ2-7
TGTGCCAGCAGTGCCCCCTACCGGGACAGGGATGATCAGCCCCAGCATTTT	CASSAPYRDRDDQPQHF	TRBV6-1	TRBJ1-5
TGTGCCAGTAGTACTCGGGAGGGGGGCGTCCGCACAGATACGCAGTATTTT	CASSTREGGVRTDTQYF	TRBV19	TRBJ2-3
TGTGCCACCAGTGTGGGCCGGATAGCCGGGGAGCTGTTTTTT	CATSVGRIAGELFF	TRBV24-1	TRBJ2-2
TGTGCCAGCAGTTTAGTAGAACCGGGACCTGGTGTCCAAGAGACCCAGTACTTC	CASSLVEPGPGVQETQYF	TRBV12-3	TRBJ2-5
TGTGCCATCAGTGAGTCTCTAGTTGTTTGGGTTTTGAACACTGAAGCTTTCTTT	CAISESLVVWVLNTEAFF	TRBV10-3	TRBJ1-1
TGTGCCAGCAGCCCAAAGACAGGTACCTACGAGCAGTACTTC	CASSPKTGTYEQYF	TRBV3-1	TRBJ2-7
TGTGCCAGCAGTTTATGGACTAAACGCCGGAGCAATCAGCCCCAGCATTTT	CASSLWTKRRSNQPQHF	TRBV27	TRBJ1-5
TGTGCCAGCAGGGTGACCGAGGAAATCCGACAGGCCAATGAGCAGTTCTTC	CASRVTEEIRQANEQFF	TRBV27	TRBJ2-1
TGTGCCAGCAGTGCCGGGCTCTACGAGCAGTACTTC	CASSAGLYEQYF	TRBV25-1	TRBJ2-7
TGTGCCAGCAGCCCAAGGGAGACACTAGCGGGCGATCACTACGAGCAGTACTTC	CASSPRETLAGDHYEQYF	TRBV12-3	TRBJ2-7
TGTGCCAGCAGCCATCCGAGGGGGGGGGAGTACGAGCAGTACTTC	CASSHPRGGEYEQYF	TRBV5-6	TRBJ2-7
TGTGCCAGCAGCTTAAATCAGGGAAATCAGCCCCAGCATTTT	CASSLNQGNQPQHF	TRBV11-2	TRBJ1-5
TGTGCCAGCAGTGAACCCACAGGGGGCGGCTACACCTTC	CASSEPTGGGYTF	TRBV6-4	TRBJ1-2
TGTGCCAGCAGCTTAGATTCCCGCACGAACACCGGGGAGCTGTTTTTT	CASSLDSRTNTGELFF	TRBV11-2	TRBJ2-2
TGTGCCAGCAGCTCGACAGGATACTCTGGGGCCAACGTCCTGACTTTC	CASSSTGYSGANVLTF	TRBV13	TRBJ2-6
TGCAGTGCTAGAGATGGGGAAGGAGGACCTGGGGCTGAGCAGTACTTC	CSARDGEGGPGAEQYF	TRBV20-1	TRBJ2-7
TGCGCCAGCCTAGACAGGGATAGGAACACTGAAGCTTTCTTT	CASLDRDRNTEAFF	TRBV10-1	TRBJ1-1
TGTGCCAGCGACTGGACAGGGTCGGTCTACAATGAGCAGTTCTTC	CASDWTGSVYNEQFF	TRBV9	TRBJ2-1
TGTGCCGCAGGGGAGGAGGACTACGAGCAGTACTTC	CAAGEEDYEQYF	TRBV19	TRBJ2-7
TGTGCCAGCAAGGGGGGCTTTTCACCCCTCCACTTT	CASKGGFSPLHF	TRBV6-8	TRBJ1-6
TGTGCCAGCAGTGACCTCCGTGGGACCAAGGCTGAGCAGTTCTTC	CASSDLRGTKAEQFF	TRBV6-4	TRBJ2-1
TGTGCCTGTCGGGGGGGCGGAGACTACGAGCAGTACTTC	CACRGGGDYEQYF	TRBV6-2	TRBJ2-7
TGCGCCAGCAGCTGGGGACTAGGTAATACGCAGTATTTT	CASSWGLGNTQYF	TRBV5-1	TRBJ2-3
TGTGCCAGCATGGGAGTAACTGAAGCTTTCTTT	CASMGVTEAFF	TRBV7-9	TRBJ1-1
TGTGCCAGCAGCCACACTAGCGGGAGAGAGAACACTGAAGCTTTCTTT	CASSHTSGRENTEAFF	TRBV9	TRBJ1-1
TGCGCCAGCAGCTTGACCCCCCGCGGGGTAGAGACCCAGTACTTC	CASSLTPRGVETQYF	TRBV5-1	TRBJ2-5
TGTGCCACCACGGGGGACCGGGACCTAACCGGGGAGCTGTTTTTT	CATTGDRDLTGELFF	TRBV24-1	TRBJ2-2
TGCGCCAGCAGCTTAGGGGGTTTTGCGTACAATGAGCAGTTCTTC	CASSLGGFAYNEQFF	TRBV4-3	TRBJ2-1
TGTGCCAGCAGCTTAAGTCAGGGCCGGGGCTATGGCTACACCTTC	CASSLSQGRGYGYTF	TRBV7-9	TRBJ1-2
TGTGCCAGCAGCTTAAAAGGGGTCGAACATATCGCTTATGGCTACACCTTC	CASSLKGVEHIAYGYTF	TRBV7-6	TRBJ1-2
TGTGCCAGCAGCAAAGTGGGACAGGGCCCTACTGAAGCTTTCTTT	CASSKVGQGPTEAFF	TRBV7-2	TRBJ1-1
TGTGCCAGCAGTGAACCAGGGAGGTCTTTGGCTTTCTTT	CASSEPGRSLAFF	TRBV6-1	TRBJ1-1
TGTGCCACCAGTCCTCGGCAGCAGTTCTTC	CATSPRQQFF	TRBV24-1	TRBJ2-1
TGTGCCAGCAGTTTCGCTGGAAGGGACCAAGCCCCACGCTACGAGCAGTACTTC	CASSFAGRDQAPRYEQYF	TRBV27	TRBJ2-7
TGTGCCAGCAGTACGGACAGCCGGAATGGCTACACCTTC	CASSTDSRNGYTF	TRBV12-3	TRBJ1-2
TGCGCCAGCACAGGCCCCAGAGCGGGTATTTATATCTCTGGAAACACCATATATTTT	CASTGPRAGIYISGNTIYF	TRBV10-1	TRBJ1-3
TGTGCCAGCAGCTTGGCCTACGGGGGCGTCCAGCCCCAGCATTTT	CASSLAYGGVQPQHF	TRBV5-4	TRBJ1-5
TGTGCCAGTAGATGGACCTTGAACCACTACGAGCAGTACTTC	CASRWTLNHYEQYF	TRBV19	TRBJ2-7
TGTGCCAGCAGCCCCGGACAGGGAAGGCACGCTAATGAAAAACTGTTTTTT	CASSPGQGRHANEKLFF	TRBV5-6	TRBJ1-4
TGCAGTGCTCTAGCGGGCCAAGAGACCCAGTACTTC	CSALAGQETQYF	TRBV20-1	TRBJ2-5
TGTGCCACCAGCAGCCCCCGGGTATGTAACTATGGCTACACCTTC	CATSSPRVCNYGYTF	TRBV15	TRBJ1-2
TGTGCCAGCAGGACCCAGGACCCCGGAGAGACCCAGTACTTC	CASRTQDPGETQYF	TRBV6-4	TRBJ2-5
TGCGCCAGCAGCCAACAGATAGGGACAGTAATTGGCTACACCTTC	CASSQQIGTVIGYTF	TRBV4-3	TRBJ1-2
TGTGCCAGCAGTAAAGAAAGACAGGGGGCAGCCTACGAGCAGTACTTC	CASSKERQGAAYEQYF	TRBV27	TRBJ2-7
TGCGCCAGCAGCTGGGGGCCTCCGCGGGCGGGGGAGAACACTGAAGCTTTCTTT	CASSWGPPRAGENTEAFF	TRBV5-1	TRBJ1-1
TGTGCCAGCAGCATTGCAAAGGGGGAGGACCTAGACACTGAAGCTTTCTTT	CASSIAKGEDLDTEAFF	TRBV13	TRBJ1-1
TGCGCCAGCAGCTTGGTACAGGATATGAAAGCCAAAAACATTCAGTACTTC	CASSLVQDMKAKNIQYF	TRBV5-1	TRBJ2-4
TGTGCCAGCAGTTACGAGACGGACAGGGGGGACTATGGCTACACCTTC	CASSYETDRGDYGYTF	TRBV6-5	TRBJ1-2
TGTGCCAGCAGCCTCAGTTTCTGCACCGAGCAGTACTTC	CASSLSFCTEQYF	TRBV7-3	TRBJ2-7
TGTGCCACCAGTGATTTGAGAGGGACAGGAAGCGCCGGGGAGCTGTTTTTT	CATSDLRGTGSAGELFF	TRBV24-1	TRBJ2-2
TGCAGTGCCAAAAGCCTTACGGGGACGGTAGAGTACGAGCAGTACTTC	CSAKSLTGTVEYEQYF	TRBV20-1	TRBJ2-7
TGTGCCAGCAGTACTTTAGGGGAGCAGTACAATGAGCAGTTCTTC	CASSTLGEQYNEQFF	TRBV6-4	TRBJ2-1
TGTGCCAGCAGCAACCGGACGGCAGCCAAAAACATTCAGTACTTC	CASSNRTAAKNIQYF	TRBV13	TRBJ2-4
TGTGCCAGCAGCTATTCGAAGTCCTTTGGACGGGCCTACGAGCAGTACTTC	CASSYSKSFGRAYEQYF	TRBV11-2	TRBJ2-7
TGTGCCGGAAGCGGGCCCTATAATTCACCCCTCCACTTT	CAGSGPYNSPLHF	TRBV30	TRBJ1-6
TGTGCCAGCAGTTACGTGGACAGGAACGAGCAGTACTTC	CASSYVDRNEQYF	TRBV6-5	TRBJ2-7
TGTGCCAGCAGCTTTTACGACCTCACCGGGGAGCTGTTTTTT	CASSFYDLTGELFF	TRBV7-8	TRBJ2-2
TGTGCCAGCAGCACCCAGGGCGGAGACGAGCAGTACTTC	CASSTQGGDEQYF	TRBV7-3	TRBJ2-7
TGTGCCAGTCGGCCTAGCGGATCCGGTTCCTACAATGAGCAGTTCTTC	CASRPSGSGSYNEQFF	TRBV7-8	TRBJ2-1
TGTGCCAGCAGTTTAGAACAACATATCAGGGCCGTCCTTTCCCATAGCAATCAGCCCCAGCATTTT	CASSLEQHIRAVLSHSNQPQHF	TRBV12-3	TRBJ1-5
TGTGCCAGCAGAAGCCGGGACAGGGAATATGGCTACACCTTC	CASRSRDREYGYTF	TRBV2	TRBJ1-2
TGCAGTGCACGACAGATAAGGGAGACCCAGTACTTC	CSARQIRETQYF	TRBV20-1	TRBJ2-5
TGTGCCAGCAGTGACTCCACCAGGGCCGAACCAGGTCTGCTTAACACTGAAGCTTTCTTT	CASSDSTRAEPGLLNTEAFF	TRBV6-4	TRBJ1-1
TGTGCCAGCACCTTCCCTACCTCACCCCTCCACTTT	CASTFPTSPLHF	TRBV6-5	TRBJ1-6
TGTGCCAGCAGTTTGAAGGGCGGCACTGAAGCTTTCTTT	CASSLKGGTEAFF	TRBV12-3	TRBJ1-1
TGTGCTAGTGGTTGGTGGACAGGGGGCTACGAGCAGTACTTC	CASGWWTGGYEQYF	TRBV12-5	TRBJ2-7
TGTGCCAGCATGGTGACAGGGGATGGCTACACCTTC	CASMVTGDGYTF	TRBV2	TRBJ1-2
TGTGCCAGCAGCCCCGGGGCCGGGACAGGTATGGGAACAGATACGCAGTATTTT	CASSPGAGTGMGTDTQYF	TRBV7-9	TRBJ2-3
TGTGCCAGCAGTTACTCGACCCACATCACCACAGATACGCAGTATTTT	CASSYSTHITTDTQYF	TRBV6-5	TRBJ2-3
TGCGCCAGCAGCTTGGCCAGGTCGTGCAATGAGCAGTTCTTC	CASSLARSCNEQFF	TRBV5-1	TRBJ2-1
TGTGCCAGCAGCTTAGAAACGCCTCAGGAGACCCAGTACTTC	CASSLETPQETQYF	TRBV11-1	TRBJ2-5
TGTGCCAGCTCACCACCTTGTGACTGTCGTTCGTGTAATGAGCAGTTCTTC	CASSPPCDCRSCNEQFF	TRBV18	TRBJ2-1
TGTGCCAGCAGCTGCGCCGGGACTCATGAGCAGTTCTTC	CASSCAGTHEQFF	TRBV7-9	TRBJ2-1
TGCAGTGCAATAGAGGAGGTCGCCTACGAGCAGTACTTC	CSAIEEVAYEQYF	TRBV20-1	TRBJ2-7
TGTGCCAGAACACCCTACGAGCAGTACTTC	CARTPYEQYF	TRBV19	TRBJ2-7
TGTGCCAGCAGCGGGCCCACCGGGACAGGGCAAGAGACCCAGTACTTC	CASSGPTGTGQETQYF	TRBV9	TRBJ2-5
TGTGCCAGCAGCGTAGTTTCCGGGACAAGAGCTTTCTTT	CASSVVSGTRAFF	TRBV9	TRBJ1-1
TGCAGTGCCGGTACCGGCGACCAGGTGTCCTACGAGCAGTACTTC	CSAGTGDQVSYEQYF	TRBV20-1	TRBJ2-7
TGCAGTGCTAACAGGCCCATGAACACTGAAGCTTTCTTT	CSANRPMNTEAFF	TRBV20-1	TRBJ1-1
TGTGCCAGCAGCGAACCCGGGGGGGGATACGAGCAGTACTTC	CASSEPGGGYEQYF	TRBV3-1	TRBJ2-7
TGTGCTAGCAGCTTACATGGACGGGGCCAACACTCGAACACCGGGGAGCTGTTTTTT	CASSLHGRGQHSNTGELFF	TRBV7-7	TRBJ2-2
TGTGCCAGTAGCGTTCCCAGTACAGGGATTTCTCAGCCCCAGCATTTT	CASSVPSTGISQPQHF	TRBV19	TRBJ1-5
TGTGCCAGTAGGAACGGTTGGGGAGGAACTAATGAAAAACTGTTTTTT	CASRNGWGGTNEKLFF	TRBV19	TRBJ1-4
TGTGCCAGCAGCAAAGGGAACACAGATACGCAGTATTTT	CASSKGNTDTQYF	TRBV5-6	TRBJ2-3
TGTGCCAGCAGTTACTCGAGAGCGGGGTGGTCTCCCTACGAGCAGTACTTC	CASSYSRAGWSPYEQYF	TRBV6-5	TRBJ2-7
TGTGCCAGCATTACCCAGACCCAGTACTTC	CASITQTQYF	TRBV7-4	TRBJ2-5
TGTGCCAGCAGTTTATCGCCTCGGCCCGGGAACACTGAAGCTTTCTTT	CASSLSPRPGNTEAFF	TRBV27	TRBJ1-1
TGTGCCAGCAGCCAGGAGGGCAATGAGCAGTTCTTC	CASSQEGNEQFF	TRBV5-4	TRBJ2-1
TGTGCCAGTAGTATGGGGGGGGCCCAATGGAGCGCTAGGACCTCTGAGACCTACGAGCAGTACTTC	CASSMGGAQWSARTSETYEQYF	TRBV19	TRBJ2-7
TGTGCCAGGCCACGAGTACCCAAGAGTGGACTAGCGGGCGAGCAGTACTTC	CARPRVPKSGLAGEQYF	TRBV2	TRBJ2-7
TGTGCCAGCAGCGCCGGCGGGAGGCGTGAAGCTTTCTTT	CASSAGGRREAFF	TRBV7-4	TRBJ1-1
TGTGCCAGCATGGACAGCCAAGAGACCCAGTACTTC	CASMDSQETQYF	TRBV6-1	TRBJ2-5
TGTGCCAGCAGCTTGTCGACCGCAGTGGACACCGGGGAGCTGTTTTTT	CASSLSTAVDTGELFF	TRBV5-4	TRBJ2-2
TGTGCCAGCAGCAAACCTCCGATGGTGGGGACAGGGGGATTGAACACTGAAGCTTTCTTT	CASSKPPMVGTGGLNTEAFF	TRBV7-3	TRBJ1-1
TGCAGGCCCGGGGGGACAGGGGTGCAGCCCCAGCATTTT	CRPGGTGVQPQHF	TRBV20-1	TRBJ1-5
TGTGCCAGCAGCCCAATCGACAGGGGTAAGCCGTTCAATCAGCCCCAGCATTTT	CASSPIDRGKPFNQPQHF	TRBV5-5	TRBJ1-5
TGTGCCAGCAGAAGGGGGAGGCAGTTCTTC	CASRRGRQFF	TRBV6-5	TRBJ2-1
TGTGCCAGCTCACCGGGCTTAAAAGGGGGGTGGAACACTGAAGCTTTCTTT	CASSPGLKGGWNTEAFF	TRBV18	TRBJ1-1
TGCGCCAGCAGCCAAGATCCCGCACAGGGGGATACGCAGTATTTT	CASSQDPAQGDTQYF	TRBV4-1	TRBJ2-3
TGTGCCAGCATTCAAGTCGGCGGACGAGGTACGTACACCATATATTTT	CASIQVGGRGTYTIYF	TRBV27	TRBJ1-3
TGCGCCAGCAGTCTAGCGCACGAAATTGAGCAGTTCTTC	CASSLAHEIEQFF	TRBV10-2	TRBJ2-1
TGTGCCAGCAGCACCTTGACTAGGGCCACAGATACGCAGTATTTT	CASSTLTRATDTQYF	TRBV7-2	TRBJ2-3
TGTGCCAGCAGTTCGGTGGGGGGGCCGTCTAGCACAGATACGCAGTATTTT	CASSSVGGPSSTDTQYF	TRBV6-5	TRBJ2-3
TGTGCCAGTAGTCAGGGGTATCCCTCTGGGGCCAACGTCCTGACTTTC	CASSQGYPSGANVLTF	TRBV19	TRBJ2-6
TGTGCCAGCAGTTATATTTGGGTTCCGGGACAGGGGGGAGACAATTCACCCCTCCACTTT	CASSYIWVPGQGGDNSPLHF	TRBV6-5	TRBJ1-6
TGTGCCAGCAGCTTCCGGCCCCCGGGACAGGGGGCCTCGCCCTACGAGCAGTACTTC	CASSFRPPGQGASPYEQYF	TRBV7-2	TRBJ2-7
TGCAGTGCTCCTACAGTGTACCAAGAGACCCAGTACTTC	CSAPTVYQETQYF	TRBV20-1	TRBJ2-5
TGCAGCGTTGCAGACAGGCACGAGCAGTACTTC	CSVADRHEQYF	TRBV29-1	TRBJ2-7
TGCAGCGAATCTAGAAGCAAGGGCAGGGGCGACTGGAACACTGAAGCTTTCTTT	CSESRSKGRGDWNTEAFF	TRBV29-1	TRBJ1-1
TGTGCCAGCAGCGTAGCGGCAGAGTTGAACACTGAAGCTTTCTTT	CASSVAAELNTEAFF	TRBV9	TRBJ1-1
TGCAGCTGGGGAGGATGTCAGCCCCAGCATTTT	CSWGGCQPQHF	TRBV29-1	TRBJ1-5
TGTGCCAGCAGTATAGGGACAGGGGCCACTAATGAAAAACTGTTTTTT	CASSIGTGATNEKLFF	TRBV6-4	TRBJ1-4
TGCAGTGCTAGGGACAGGAACGCCGGGAACACTGAAGCTTTCTTT	CSARDRNAGNTEAFF	TRBV20-1	TRBJ1-1
TGTGCCAGCATCCAGGACAGGATAGCAACTAATGAAAAACTGTTTTTT	CASIQDRIATNEKLFF	TRBV6-1	TRBJ1-4
TGCAGTGCTAGTGGACAGTACGAGCAGTACTTC	CSASGQYEQYF	TRBV20-1	TRBJ2-7
TGTGCCACCAGCAGTAGTGTTGACAGGGTAGATTCACCCCTCCACTTT	CATSSSVDRVDSPLHF	TRBV15	TRBJ1-6
TGCGCCAGCAAAACCGCAGGGGGCGCCTCCAACACTGAAGCTTTCTTT	CASKTAGGASNTEAFF	TRBV10-1	TRBJ1-1
TGCAGTGCTAGAGATAAAGTAAGGCCAGGACAGAAGCAGCCCCAGCATTTT	CSARDKVRPGQKQPQHF	TRBV20-1	TRBJ1-5
TGTGCCAGCAGTGACCCAGCAGGGTCCAATGAGCAGTTCTTC	CASSDPAGSNEQFF	TRBV25-1	TRBJ2-1
TGTGCCAGCAGTAAGAGGAGACAGGGCTCCTACGAGCAGTACTTC	CASSKRRQGSYEQYF	TRBV28	TRBJ2-7
TGTGCCAGCAGAGGTCCGGGACAGGGAGGACCTAATGAAAAACTGTTTTTT	CASRGPGQGGPNEKLFF	TRBV11-2	TRBJ1-4
TGTGCCACCAGTGATGTGCGGGGACCCCCGGACAAAGAGACCCAGTACTTC	CATSDVRGPPDKETQYF	TRBV24-1	TRBJ2-5
TGCAGTGCGAGGCTACATCAGCCCCAGCATTTT	CSARLHQPQHF	TRBV20-1	TRBJ1-5
TGTGCCAGCAGCCCCCCTGCCCTAGGAGGGGGGGCATCTGCCGAGACCCAGTACTTC	CASSPPALGGGASAETQYF	TRBV3-1	TRBJ2-5
TGTGCCAGCAGCCCAAAAGGACAGGGGGTCTACGAGCAGTACTTC	CASSPKGQGVYEQYF	TRBV7-3	TRBJ2-7
TGTGCCAGCAGTGGCGTGGGGAACACTGAAGCTTTCTTT	CASSGVGNTEAFF	TRBV6-4	TRBJ1-1
TGCGCCAGCAGCTTGGCCAGGTTGGACAGGCATAGGGAGCACAATCAGCCCCAGCATTTT	CASSLARLDRHREHNQPQHF	TRBV5-1	TRBJ1-5
TGTGCCAGCTCACACCCCAAATCCCCCGGGACAACCAATTCACCCCTCCACTTT	CASSHPKSPGTTNSPLHF	TRBV18	TRBJ1-6
TGTGCCAGCAGCTTGCCATCCTATGAGCAGTTCTTC	CASSLPSYEQFF	TRBV5-6	TRBJ2-1
TGTGCCAGCGACACTGACAGGGAAAAGAACACTGAAGCTTTCTTT	CASDTDREKNTEAFF	TRBV7-3	TRBJ1-1
TGCGCCAGCATGACAGGGATGCAGCCCCAGCATTTT	CASMTGMQPQHF	TRBV10-2	TRBJ1-5
TGTGCCGCTATCCCCCTAGCGGGGCCTAATTTAGAGACCCAGTACTTC	CAAIPLAGPNLETQYF	TRBV10-3	TRBJ2-5
TGTGCCAGCAGCGTATTCCTACAGGGGGCTGGCTACACCTTC	CASSVFLQGAGYTF	TRBV9	TRBJ1-2
TGTGCCAGCAGGTACCAGCGAAAAGTTGGGTACTCCTACGAGCAGTACTTC	CASRYQRKVGYSYEQYF	TRBV27	TRBJ2-7
TGTGCCAGCAGCTCCCGGCCAGGAAACTATGGCTACACCTTC	CASSSRPGNYGYTF	TRBV14	TRBJ1-2
TGTGCCGGGAGGCGGCATGAGCAGTTCTTC	CAGRRHEQFF	TRBV2	TRBJ2-1
TGCAGTGCTCCTGTCAAGAGGGGGGGGGGGTACTCCTACGAGCAGTACTTC	CSAPVKRGGGYSYEQYF	TRBV20-1	TRBJ2-7
TGTGCCAGCAGCGGGGAACCTCGGGGACTCAACACTGAAGCTTTCTTT	CASSGEPRGLNTEAFF	TRBV7-3	TRBJ1-1
TGTGCCAGCAGTTTGCACGCTAAGCTGGGGGCCAACGTCCTGACTTTC	CASSLHAKLGANVLTF	TRBV27	TRBJ2-6
TGTGCCAGCAGCCAAGATTTCCCCAGCGGGACGTTGCAAGAGACCCAGTACTTC	CASSQDFPSGTLQETQYF	TRBV3-1	TRBJ2-5
TGCGCCAGCATCTTGGGGTCCAGGAATAATTCACCCCTCCACTTT	CASILGSRNNSPLHF	TRBV10-1	TRBJ1-6
TGTGCCAGCAGTCTGGACAGGGTTGACTTC	CASSLDRVDF	TRBV27	TRBJ2-7
TGTGCCAGCAGCAGCATTACCAATCAGCCCCAGCATTTT	CASSSITNQPQHF	TRBV7-3	TRBJ1-5
TGTGCCAGTAGTCCCGGGGGGGCTATCTCCTACGAGCAGTACTTC	CASSPGGAISYEQYF	TRBV19	TRBJ2-7
TGTGCCAGCAGTTTATTCTTATCCCTGTGGGGTTGCACAGATACGCAGTATTTT	CASSLFLSLWGCTDTQYF	TRBV27	TRBJ2-3
TGTGCCATGGTAAGATCCCAGCCCAGCTCCTACGAGCAGTACTTC	CAMVRSQPSSYEQYF	TRBV19	TRBJ2-7
TGTGCCACCAGTGGACTAATGACCAGGGTTACGTACCAAGAGACCCAGTACTTC	CATSGLMTRVTYQETQYF	TRBV24-1	TRBJ2-5
TGTGCCAGCAGCTTAACACGGGACACACGACTACTAGCCAAAAACATTCAGTACTTC	CASSLTRDTRLLAKNIQYF	TRBV5-6	TRBJ2-4
TGCGCCAGACACGCACCAGCGAGTTTGGCACAAGAGACCCAGTACTTC	CARHAPASLAQETQYF	TRBV10-1	TRBJ2-5
TGTGCCAGCAGTACGTGGGACTTAAGCTACGAGCAGTACTTC	CASSTWDLSYEQYF	TRBV27	TRBJ2-7
TGTGCCAGCTCACCCGGGCACTACGAGCAGTACTTC	CASSPGHYEQYF	TRBV18	TRBJ2-7
TGCGCCAGGCCGGTGGACAGTCCCTATAATTCACCCCTCCACTTT	CARPVDSPYNSPLHF	TRBV10-1	TRBJ1-6
TGTGCCAGCAGCCAAACAGGGGGTTACGAGCAGTACTTC	CASSQTGGYEQYF	TRBV14	TRBJ2-7
TGTGCCAGCACTGGCGCACTAGCGGGAGCAGATACGCAGTATTTT	CASTGALAGADTQYF	TRBV9	TRBJ2-3
TGCGCCAGCACCCACGGGACCCGATCCCCCCAAGAGACCCAGTACTTC	CASTHGTRSPQETQYF	TRBV10-1	TRBJ2-5
TGCGCCAGCAGCTTGGGGGGCTACGAGCAGTACTTC	CASSLGGYEQYF	TRBV5-1	TRBJ2-7
TGTGCCAGCAGTTACCCCAATCAGGCGTCGCCCCAGCATTTT	CASSYPNQASPQHF	TRBV6-2	TRBJ1-5
TGTGCCAGCAGTCCTGAGGGACAGGGCGATTGCCAAGAGACCCAGTACTTC	CASSPEGQGDCQETQYF	TRBV28	TRBJ2-5
TGTGCCTGGAGTCGGACTAGGAGGAGCAGCACAGATACGCAGTATTTT	CAWSRTRRSSTDTQYF	TRBV30	TRBJ2-3
TGTGCCTGGCCGGGACAGGGGACTTGGAACAATCAGCCCCAGCATTTT	CAWPGQGTWNNQPQHF	TRBV30	TRBJ1-5
TGTGCCAGCAGCGTACGACAGGGGACCTTC	CASSVRQGTF	TRBV9	TRBJ1-2
TGTGCCAGCAGTTACGCTCAGGGGGGCGAGCAGTACTTC	CASSYAQGGEQYF	TRBV6-5	TRBJ2-7
TGTGCCAGCAGTGCATGGCTTACCCAGCATTTT	CASSAWLTQHF	TRBV6-4	TRBJ1-5
TGTGCCATCAGCCCGACCCGGCCGGACGTACGCAATCAGCCCCAGCATTTT	CAISPTRPDVRNQPQHF	TRBV10-3	TRBJ1-5
TGTGCCAGCAGCGAGCGGGAGAGGGGGGGGACATGCACAGATACGCAGTATTTT	CASSERERGGTCTDTQYF	TRBV7-9	TRBJ2-3
TGTGCCAGCAGCTTAGCAACTAGCGGGAGGGCGAAGAACTCCTACGAGCAGTACTTC	CASSLATSGRAKNSYEQYF	TRBV11-2	TRBJ2-7
TGCGCCAGCAGCCCTAGCGGGAATTACAATGAGCAGTTCTTC	CASSPSGNYNEQFF	TRBV5-1	TRBJ2-1
TGTGCCAGCGTTCGGTTAGCCAAAAACATTCAGTACTTC	CASVRLAKNIQYF	TRBV13	TRBJ2-4
TGTGCCAGCAGTGAAATCCCGATTTCCTACGAGCAGTACTTC	CASSEIPISYEQYF	TRBV6-1	TRBJ2-7
TGTGCCAGCAGTGGGAGGGGGGAGCAGTACTTC	CASSGRGEQYF	TRBV6-4	TRBJ2-7
TGTGCCATGCTCGGGGAGAATGAGCAGTTCTTC	CAMLGENEQFF	TRBV27	TRBJ2-1
TGTGGGGGGCCCTCTGGAAACACCATATATTTT	CGGPSGNTIYF	TRBV19	TRBJ1-3
TGTGCCAGCAGCGTCGAAAGACAGGGGCGTTCCTATAATTCACCCCTCCACTTT	CASSVERQGRSYNSPLHF	TRBV9	TRBJ1-6
TGTGCCACAGGGGGGTATAATTCACCCCTCCACTTT	CATGGYNSPLHF	TRBV18	TRBJ1-6
TGTGCCAGCAGCCAACGGGGGATACGCGCGGATACCTACGAGCAGTACTTC	CASSQRGIRADTYEQYF	TRBV14	TRBJ2-7
TGTGCCAGTAGTAGGGACCCCCGGGTGGACGAGCAGTACTTC	CASSRDPRVDEQYF	TRBV19	TRBJ2-7
TGTGCTAGTGGTTTGGTACACCGGGGGCCCTCTGGAAACACCATATATTTT	CASGLVHRGPSGNTIYF	TRBV12-5	TRBJ1-3
TGTGCCTCCGGGACAGCACGAACTGAAGCTTTCTTT	CASGTARTEAFF	TRBV27	TRBJ1-1
TGTGCCAGCAGCTTAGCTCAGTCCGCCATCGTCCATATAGGCGAGACCCAGTACTTC	CASSLAQSAIVHIGETQYF	TRBV11-3	TRBJ2-5
TGTGCCAGCAGCCCCAGGGTTGGGTACAATGAGCAGTTCTTC	CASSPRVGYNEQFF	TRBV12-3	TRBJ2-1
TGTGCCAGCGATGTTGAAGGACAGGGCACAGATACGCAGTATTTT	CASDVEGQGTDTQYF	TRBV7-3	TRBJ2-3
TGTGCCAGCAGCCAACGAGGACAAAATGAAAAACTGTTTTTT	CASSQRGQNEKLFF	TRBV3-1	TRBJ1-4
TGTGCCAGCTTACAGGGGAACACCGGGGAGCTGTTTTTT	CASLQGNTGELFF	TRBV2	TRBJ2-2
TGTGCCAGCAGTAAATACAGGGGTGGGACTTCCTACAATGAGCAGTTCTTC	CASSKYRGGTSYNEQFF	TRBV7-9	TRBJ2-1
TGCGCCAGCAGTGCCTCAAAGACTAGCGGGAGCCTCGAACTAGCCAAAAACATTCAGTACTTC	CASSASKTSGSLELAKNIQYF	TRBV10-1	TRBJ2-4
TGTGCCAGCAGTGAAGGCCGAATGGGCCCAAGGGACAATGAGCAGTTCTTC	CASSEGRMGPRDNEQFF	TRBV2	TRBJ2-1
TGTGCCAGCCCGTGGGGGTTAAAACTGTTTTTT	CASPWGLKLFF	TRBV6-1	TRBJ1-4
TGTGCCAGCAGTGACATCGAAATGAGGGAGTCCAACACCGGGGAGCTGTTTTTT	CASSDIEMRESNTGELFF	TRBV6-4	TRBJ2-2
TGTGCCACCAGTGACATATGGCGACAGGGGTCCTACGAGCAGTACTTC	CATSDIWRQGSYEQYF	TRBV24-1	TRBJ2-7
TGTGCCAGCAGGTCAACAGGGGACTATGGCTACACCTTC	CASRSTGDYGYTF	TRBV9	TRBJ1-2
TGTGCCACCAGCAACGGTAAGGCCTCTGGGGCCAACGTCCTGACTTTC	CATSNGKASGANVLTF	TRBV15	TRBJ2-6
TGCAGTGCTGGGTTACTCATCACTATAGAGACCCAGTACTTC	CSAGLLITIETQYF	TRBV20-1	TRBJ2-5
TGTGCCAGCAGTGAAGCGGCGGACAATGAGCAGTTCTTC	CASSEAADNEQFF	TRBV28	TRBJ2-1
TGTGCCAGCAGCTTTACCTCCCGCCCGGGAGGACAGGCAAGCTACGAGCAGTACTTC	CASSFTSRPGGQASYEQYF	TRBV11-3	TRBJ2-7
TGCAGCGCCTCACCCAAAAAGACTCCCAATGAGCAGTTCTTC	CSASPKKTPNEQFF	TRBV29-1	TRBJ2-1
TGTGCCAGCAGCCCCACAGCCGGGACAGAGAGCTCCTACGAGCAGTACTTC	CASSPTAGTESSYEQYF	TRBV3-1	TRBJ2-7
TGTGCCATCAGTGTGACAGAACGTCGGGGCTACACCTTC	CAISVTERRGYTF	TRBV10-3	TRBJ1-2
TGTGCCAGCAGTTTAACTAAGGAGGGATTTCAGGAGGGGGAGCTGTTTTTT	CASSLTKEGFQEGELFF	TRBV12-3	TRBJ2-2
TGCGCCAGAGTGCCGGACGGGATATCGGTGGGCTACACCTTC	CARVPDGISVGYTF	TRBV10-1	TRBJ1-2
TGCAGTGCTACCCAAAGTCGGGACAGAAGGAATGAAAAACTGTTTTTT	CSATQSRDRRNEKLFF	TRBV20-1	TRBJ1-4
TGTGCCAGCAGTCCTGGGGGTAGAGGCTCCTACAATGAGCAGTTCTTC	CASSPGGRGSYNEQFF	TRBV6-1	TRBJ2-1
TGTGCCAGCAGTTACCATTCGACAGGAGCGAGCGGATACAGGCCCTACGAGCAGTACTTC	CASSYHSTGASGYRPYEQYF	TRBV6-5	TRBJ2-7
TGTGCCAGCAGCTTGATTCGGGGGGCGAAACACGAGCAGTACTTC	CASSLIRGAKHEQYF	TRBV5-4	TRBJ2-7
TGTGCCAGCAGCTTAGGGGCGGGGGGCCTAGGATACAATGAGCAGTTCTTC	CASSLGAGGLGYNEQFF	TRBV13	TRBJ2-1
TGTGCCAGCAGCTTAGACGATCCGGGGGGCTACACCTTC	CASSLDDPGGYTF	TRBV7-9	TRBJ1-2
TGTGCCAGCAGCTTATCCCTAGCTCCCCCGAACTTTACAGATACGCAGTATTTT	CASSLSLAPPNFTDTQYF	TRBV7-2	TRBJ2-3
TGTGCCACCATCGTGTGGGACAGACATAGCAATCAGCCCCAGCATTTT	CATIVWDRHSNQPQHF	TRBV24-1	TRBJ1-5
TGTGAAGGCCACAGGGGTTGCTCCTACGAGCAGTACTTC	CEGHRGCSYEQYF	TRBV2	TRBJ2-7
TGTGCCAGCAGGGACTCTGCGGGAGGGGGAAATTCACCCCTCCACTTT	CASRDSAGGGNSPLHF	TRBV6-3	TRBJ1-6
TGCGCCAGCAGCCGTAGGGTGATCTACGAGCAGTACTTC	CASSRRVIYEQYF	TRBV5-1	TRBJ2-7
TGTGCCAGCAGCGTTCGGGACAGCGACAATCAGCCCCAGCATTTT	CASSVRDSDNQPQHF	TRBV7-9	TRBJ1-5
TGTGCCAGCAGTGACCGAGCCCGAAGAAACATTCAGTACTTC	CASSDRARRNIQYF	TRBV6-4	TRBJ2-4
TGTGCCAGCAGCCCCCCCCTCCTAGCGGGGGAAGATACGCAGTATTTT	CASSPPLLAGEDTQYF	TRBV7-2	TRBJ2-3
TGTGCCAGCAGTCCCCAATCACTGACGGTTCGGGTAAGGAATGAAAAACTGTTTTTT	CASSPQSLTVRVRNEKLFF	TRBV12-3	TRBJ1-4
TGCAGCGTTGCTAGCGGGAAGAATGGGAGCGGAGCAGAGACCCAGTACTTC	CSVASGKNGSGAETQYF	TRBV29-1	TRBJ2-5
TGTTTCCACCAGGGCTTCCGCTACGAGCAGTACTTC	CFHQGFRYEQYF	TRBV30	TRBJ2-7
TGTGCCAGCAGCTCACCTGCGAAAAAACGAAGTGCAACTAATGAAAAACTGTTTTTT	CASSSPAKKRSATNEKLFF	TRBV13	TRBJ1-4
TGTGCCAAAGGCCCGGGACAGGGGAGCAATCAGCCCCAGCATTTT	CAKGPGQGSNQPQHF	TRBV10-3	TRBJ1-5
TGTGCCAGCAGTACACTAGGTCTTCCCGGGGAGCTGTTTTTT	CASSTLGLPGELFF	TRBV27	TRBJ2-2
TGTGCCAGCAGCTTCAGTCCCCTCATCTGTTCCAGTCAAGGGGTGTTGAACACTGAAGCTTTCTTT	CASSFSPLICSSQGVLNTEAFF	TRBV11-3	TRBJ1-1
TGTGCCAGCTCACCAGACCCTCCTTCCCGGGACAGGCGGTCTAACTTC	CASSPDPPSRDRRSNF	TRBV18	TRBJ1-2
TGCGCCAGCAGCCAAGCCCCCCGAAGTTACAGCCCCTACAAAAACATTCAGTACTTC	CASSQAPRSYSPYKNIQYF	TRBV4-3	TRBJ2-4
TGCAGTGCTAGTCGACAGCTCGACAGGGGGACGAACACTGAAGCTTTCTTT	CSASRQLDRGTNTEAFF	TRBV20-1	TRBJ1-1
TGTGCCAGCAGTTCGTTCTACGAGCAGTACTTC	CASSSFYEQYF	TRBV9	TRBJ2-7
TGTGCCAGCAGTTTAATAGGGCCGTTGTACTACGAGCAGTACTTC	CASSLIGPLYYEQYF	TRBV28	TRBJ2-7
TGTGCCAGCAGTGACTCCTATAGCTATGGCTACACCTTC	CASSDSYSYGYTF	TRBV6-4	TRBJ1-2
TGTGCCAGCAGCGTTTGGAGGACAAGGGGCTCTGGGGCCAACGTCCTGACTTTC	CASSVWRTRGSGANVLTF	TRBV13	TRBJ2-6
TGCGCCAGCAGCTTTCACAAGCGGAACACTGAAGCTTTCTTT	CASSFHKRNTEAFF	TRBV5-1	TRBJ1-1
TGTGCCAGCTCACCAAACAGGGGGCAACTCAACATTCAGTACTTC	CASSPNRGQLNIQYF	TRBV18	TRBJ2-4
TGTGCTAGTGGTTTGGTACTAGGACAACCTAGAGCCAAAAACATTCAGTACTTC	CASGLVLGQPRAKNIQYF	TRBV12-5	TRBJ2-4
TGTGCCAGCAGCCTAGGGGATGAGCAGTTCTTC	CASSLGDEQFF	TRBV6-4	TRBJ2-1
TGTGCCTGGAGTGTACTACGGGACAGGGGGTACGAGCAGTACTTC	CAWSVLRDRGYEQYF	TRBV30	TRBJ2-7
TGTGCCATCACTCTCTCCTACGAGCAGTACTTC	CAITLSYEQYF	TRBV10-3	TRBJ2-7
TGCAGTGCTGGACAGGGCAATCAGCCCCAGCATTTT	CSAGQGNQPQHF	TRBV20-1	TRBJ1-5
TGTGCCACCAGTGAAGGGGGCCGCTGGATTTTCTCTGGAAACACCATATATTTT	CATSEGGRWIFSGNTIYF	TRBV24-1	TRBJ1-3
TGTGCCAGCAGCGTACGCAGATCACCCCTCCACTTT	CASSVRRSPLHF	TRBV7-9	TRBJ1-6
TGCAGCGTTGAGCCCGAAGAGACCCAGTACTTC	CSVEPEETQYF	TRBV29-1	TRBJ2-5
TGTGCCAGCAGCTTAGGAGTCGGTGAGCAGTTCTTC	CASSLGVGEQFF	TRBV7-6	TRBJ2-1
TGTGCTAGCAGCCGGTCCCGGGACAGGAAACCCATTCAGTACTTC	CASSRSRDRKPIQYF	TRBV7-7	TRBJ2-4
TGTGCCAGCAGTTACGAACTAGCGACAGATACGCAGTATTTT	CASSYELATDTQYF	TRBV6-2	TRBJ2-3
TGTGCCAGCAGTGCAGGTATACGTTGGCCCGGAGGGGGGGACTCCTACGAGCAGTACTTC	CASSAGIRWPGGGDSYEQYF	TRBV2	TRBJ2-7
TGTGCCACCAGAGCCAGGGTGAGGGGGATGAACACTGAAGCTTTCTTT	CATRARVRGMNTEAFF	TRBV24-1	TRBJ1-1
TGCGCCAGCAGTGCCATAGACAGTATGGGGAACACAATCGAGCAGTACTTC	CASSAIDSMGNTIEQYF	TRBV10-2	TRBJ2-7
TGTGCCAGCAGCCAAGATACTGGGGGGGCCGGATACGAGCAGTACTTC	CASSQDTGGAGYEQYF	TRBV3-1	TRBJ2-7
TGTGCCACCCCAAGAGGGCGGCAAACCTCCTACAATGAGCAGTTCTTC	CATPRGRQTSYNEQFF	TRBV14	TRBJ2-1
TGTGCCAGCAGCATTGAGCAGTACTTC	CASSIEQYF	TRBV5-5	TRBJ2-7
TGCGCCAGCAGCCAAAACCAAGACAGGGGGCACAGGGGGACTAACTATGGCTACACCTTC	CASSQNQDRGHRGTNYGYTF	TRBV4-3	TRBJ1-2
TGTGCCAGCAGCTCCCGGGTGCCGGGATGTACTGAAGCTTTCTTT	CASSSRVPGCTEAFF	TRBV5-5	TRBJ1-1
TGTGCCACCTTTTGCGAAAGACCCTACGAGCAGTACTTC	CATFCERPYEQYF	TRBV24-1	TRBJ2-7
TGTGCCAGCAGCATCGGGGGGGACTACGAGCAGTACTTC	CASSIGGDYEQYF	TRBV3-1	TRBJ2-7
TGTGCCAGCTCCCTACAGTTAAGCTCCTATAATTCACCCCTCCACTTT	CASSLQLSSYNSPLHF	TRBV18	TRBJ1-6
TGTGCCAGCAGTTTATCCAGGGGGTGGACAACTAATGAAAAACTGTTTTTT	CASSLSRGWTTNEKLFF	TRBV27	TRBJ1-4
TGTGCCAGCAGCCAAGAAACCCGCCGTCTCGAGCAGTACTTC	CASSQETRRLEQYF	TRBV14	TRBJ2-7
TGTGCCAGCAGTTTACCGGGGAGGGCTAGAGAGGAGACCCAGTACTTC	CASSLPGRAREETQYF	TRBV12-3	TRBJ2-5
TGCAGTGCTAGGGGGGGGCCCCCAGATACGCAGTATTTT	CSARGGPPDTQYF	TRBV20-1	TRBJ2-3
TGTGCCAGCAGTGAAGAACTGGGGACGCCCGTATATGGCTACACCTTC	CASSEELGTPVYGYTF	TRBV6-1	TRBJ1-2
TGTGCCAGCAGCCGGGTGAACACCGGGGAGCTGTTTTTT	CASSRVNTGELFF	TRBV7-6	TRBJ2-2
TGTGCCACCATAGCACACACCGACGAGCAGTACTTC	CATIAHTDEQYF	TRBV24-1	TRBJ2-7
TGTGCCGGCAAGGACAGCCGGGTAGCCAAAAACATTCAGTACTTC	CAGKDSRVAKNIQYF	TRBV9	TRBJ2-4
TGTGCCAGCAGCTTAGAAGGAACTAGCGGGGGCAATGAGCAGTTCTTC	CASSLEGTSGGNEQFF	TRBV11-2	TRBJ2-1
TGCGCCAGCAGTTGCTGCGACACTACCCTCCACTTT	CASSCCDTTLHF	TRBV10-2	TRBJ1-6
TGTGCCAGCAGTTACGTGGGACTAGCGGTAAGATCCGGGGAGCTGTTTTTT	CASSYVGLAVRSGELFF	TRBV6-5	TRBJ2-2
TGTGCCAGCGCGAGGAGGGAACTGAATCAGCCCCAGCATTTT	CASARRELNQPQHF	TRBV6-6	TRBJ1-5
TGTGCCAGCAGCTTAACTATGGACAGGGAGAAAACCTCGAAGCATGGCTACACCTTC	CASSLTMDREKTSKHGYTF	TRBV11-1	TRBJ1-2
TGTGCCAGCAGCGGGGGCGGCTGGAGTCGGGGTTCACCCCTCCACTTT	CASSGGGWSRGSPLHF	TRBV7-9	TRBJ1-6
TGTGCCAAACCGGCACGGGCCGAGCAGTTCTTC	CAKPARAEQFF	TRBV6-5	TRBJ2-1
TGTGCCAGTAGTACGGGCCGGTTTAAACGGGAAACGGGGCAGTACTTC	CASSTGRFKRETGQYF	TRBV19	TRBJ2-7
TGCAGCCCCACAGGGACGAACGCCTACGAGCAGTACTTC	CSPTGTNAYEQYF	TRBV29-1	TRBJ2-7
TGTGCCAGCAGTCCGACTGGCTACAATGAGCAGTTCTTC	CASSPTGYNEQFF	TRBV6-1	TRBJ2-1
TGTGCCAGCAGTGACTCGAGGGCAGCAACTAATGAAAAACTGTTTTTT	CASSDSRAATNEKLFF	TRBV6-4	TRBJ1-4
TGTGCCAGCAGCTTGGGGGCTGGATACAATGAGCAGTTCTTC	CASSLGAGYNEQFF	TRBV7-7	TRBJ2-1
TGTGCCAGCATCGCCGGACGGTATGGCTACACCTTC	CASIAGRYGYTF	TRBV6-5	TRBJ1-2
TGTGCCAGCAGCCGGCTGCTTCCGAGCTCCTACGAGCAGTACTTC	CASSRLLPSSYEQYF	TRBV7-3	TRBJ2-7
TGCAGTGCTAGAGAAACACGGACACTCGGGGGGCACTACGAGCAGTACTTC	CSARETRTLGGHYEQYF	TRBV20-1	TRBJ2-7
TGTGCCAGCAAGCGTTCCCGCCCGCGACAGGCTCTACCGAACACTGAAGCTTTCTTT	CASKRSRPRQALPNTEAFF	TRBV6-5	TRBJ1-1
TGTGCCAGCAGTAGGATCTCCATCCGGGACAGGGAGGGTGAAAAACTGTTTTTT	CASSRISIRDREGEKLFF	TRBV27	TRBJ1-4
TGCGCCAGCAGCTACCCCGTCATAGAGGAGTACTTC	CASSYPVIEEYF	TRBV5-1	TRBJ2-7
TGTGCCAGCAGGAGGATGGGGGGACTAGATACGCAGTATTTT	CASRRMGGLDTQYF	TRBV12-4	TRBJ2-3
TGTTGTGGCACCCTGACAGGGGCTCAGCCCCAGCATTTT	CCGTLTGAQPQHF	TRBV10-3	TRBJ1-5
TGTGCCAGCAGCTACAGGCCAACGAACACCGGGGAGCTGTTTTTT	CASSYRPTNTGELFF	TRBV11-2	TRBJ2-2
TGCGCCCTAGACAGGGGAGAAGCTGGTAATCAGCCCCAGCATTTT	CALDRGEAGNQPQHF	TRBV10-1	TRBJ1-5
TGTGCCAGCAGTGGAACGACCTACAATGAGCAGTTCTTC	CASSGTTYNEQFF	TRBV27	TRBJ2-1
TGTGCCAGCAGTTACAGGATTCTCCCTTTACCCCGCTCCTACGAGCAGTACTTC	CASSYRILPLPRSYEQYF	TRBV6-5	TRBJ2-7
TGTGCCAGCAGCCTCGAGGGTGGCTACACCTTC	CASSLEGGYTF	TRBV7-7	TRBJ1-2
TGTGCTAGCAGCTTAGCGCTACAGCGGGAGGGGTACACCTTC	CASSLALQREGYTF	TRBV7-7	TRBJ1-2
TGTGCCAGCAGCCAAGACGCCGGTGACAAAAACATTCAGTACTTC	CASSQDAGDKNIQYF	TRBV3-1	TRBJ2-4
TGTGCCACCGGGTTGAGAGACGAGCAGTACTTC	CATGLRDEQYF	TRBV24-1	TRBJ2-7
TGTGCCAGCAGAAAGCCCCTAGCGTACAATGAGCAGTTCTTC	CASRKPLAYNEQFF	TRBV7-2	TRBJ2-1
TGCCGTGGGGGGGGTTGCTACGAGCAGTACTTC	CRGGGCYEQYF	TRBV5-1	TRBJ2-7
TGTGCCAGCAGGGGAAAGCAAGAGACCCAGTACTTC	CASRGKQETQYF	TRBV7-6	TRBJ2-5
TGTGCCAGCAGTTACCAGGTACCCTACAATGAGCAGTTCTTC	CASSYQVPYNEQFF	TRBV6-5	TRBJ2-1
TGTGCCAGCAGCTCTCCGGGAAGCAATGAGCAGTTCTTC	CASSSPGSNEQFF	TRBV14	TRBJ2-1
TGTGCCAGCAGCTTCGGGAGCGGGGAAACCGAACAAGAGACCCAGTACTTC	CASSFGSGETEQETQYF	TRBV5-6	TRBJ2-5
TGTGCCAGCAGTTATAAGACCGGACAGGAGTATTTT	CASSYKTGQEYF	TRBV6-2	TRBJ2-3
TGCGCCAGCAGTGAGTCGGGGCCGGTCTACGAGCAGTACTTC	CASSESGPVYEQYF	TRBV10-1	TRBJ2-7
TGTGCCGGTTTAACGGGACTAGGGGATAATGAGCAGTTCTTC	CAGLTGLGDNEQFF	TRBV6-5	TRBJ2-1
TGTGCCAGCAGCTTGCGGGGGGGGAAGGGTTACACTGAAGCTTTCTTT	CASSLRGGKGYTEAFF	TRBV11-3	TRBJ1-1
TGCAGCGTTGATAAGCGGACTAGCAGCTACGAGCAGTACTTC	CSVDKRTSSYEQYF	TRBV29-1	TRBJ2-7
TGTGCCAGCAGTGAAGCGGGATTTGACTGGGGGAACACCGGGGAGCTGTTTTTT	CASSEAGFDWGNTGELFF	TRBV6-1	TRBJ2-2
TGTGCCAGCAGTTTATTCCGCCTGACTAGTCTCTACGAGCAGTACTTC	CASSLFRLTSLYEQYF	TRBV28	TRBJ2-7
TGCGCCAGCAGTGACCGCCGAGGCCCGGAAATAGGCCCCTCCTACGAGCAGTACTTC	CASSDRRGPEIGPSYEQYF	TRBV10-1	TRBJ2-7
TGTGCCAGTAGTTCCGGGGCACTCGTCCTGACTTTC	CASSSGALVLTF	TRBV19	TRBJ2-6
TGTGCCAGCAGCTTGGCATCCTCAGGTATCTACGAGCAGTACTTC	CASSLASSGIYEQYF	TRBV5-4	TRBJ2-7
TGCGCCAGCCCCCGACGTCCAGGGGGGGAACTCTATGGCTACACCTTC	CASPRRPGGELYGYTF	TRBV10-1	TRBJ1-2
TGTGCTAGCAGCTTAGTTAATCTCAGGGGAGAAGCTTTCTTT	CASSLVNLRGEAFF	TRBV7-7	TRBJ1-1
TGTGCCAGCAGTGAGGGGGACCTATATAGTTGCACCGGGGAGCTGTTTTTT	CASSEGDLYSCTGELFF	TRBV28	TRBJ2-2
TGTGCCGTAACAGGGGAGTACGAGCAGTACTTC	CAVTGEYEQYF	TRBV6-5	TRBJ2-7
TGTGCCAGCAGCCTAAGCTGGGACAGGACAAATTCACCCCTCCACTTT	CASSLSWDRTNSPLHF	TRBV13	TRBJ1-6
TGTGCCAGCAGCCCCGCGAATCACAGGGGGCTAAGGTACGAGCAGTACTTC	CASSPANHRGLRYEQYF	TRBV7-3	TRBJ2-7
TGTGCCAGCAGTCCGGAGTTCCCCTACAATGAGCAGTTCTTC	CASSPEFPYNEQFF	TRBV7-2	TRBJ2-1
TGTGCCAGCAGTGAGGGATATCCCCCCTTTCCGGACAGACTACTTTCCACTGAAGCTTTCTTT	CASSEGYPPFPDRLLSTEAFF	TRBV2	TRBJ1-1
TGCAGTGCTAGGGTGGGCGCTGAGGGGCTTGGAAACACCATATATTTT	CSARVGAEGLGNTIYF	TRBV20-1	TRBJ1-3
TGTGCCACCAATAGTGAGGGGGCCACTGAAGCTTTCTTT	CATNSEGATEAFF	TRBV24-1	TRBJ1-1
TGTGCCAGCTCGCTAGCGGGAGTAAACACTGAAGCTTTCTTT	CASSLAGVNTEAFF	TRBV18	TRBJ1-1
TGTGCCAGCAGCGCCGACAGGGGCCCGGGGTACAATGAGCAGTTCTTC	CASSADRGPGYNEQFF	TRBV6-2	TRBJ2-1
TGTGCCAGCAGGGGGGAAGTGGGGACTAGCGGGTACCAGCAGACCCAGTACTTC	CASRGEVGTSGYQQTQYF	TRBV14	TRBJ2-5
TGCGCCAGCAGCTTGGAGCTCAGGGAAGGGGACAATCAGCCCCAGCATTTT	CASSLELREGDNQPQHF	TRBV5-1	TRBJ1-5
TGTGCCAAACCGGGACTAGCGGGGGTGAACAATGAGCAGTTCTTC	CAKPGLAGVNNEQFF	TRBV13	TRBJ2-1
TGTGCCAGCAGCAGGACGATTTATGGAAACACCATATATTTT	CASSRTIYGNTIYF	TRBV13	TRBJ1-3
TGTGCCAGCTACGGACGGCCTAGCACAGATACGCAGTATTTT	CASYGRPSTDTQYF	TRBV5-6	TRBJ2-3
TGTGCCAGCAGCTTAGCCTTAGGGTGGTTAGCCCAGTACTTC	CASSLALGWLAQYF	TRBV7-2	TRBJ2-5
TGTGCCAGCAGCGCCAACCTACAGGGGGAAAGCGGGGAGCTGTTTTTT	CASSANLQGESGELFF	TRBV13	TRBJ2-2
TGCGCCAGCAGCTTGGGGGGGATCTTTGAGCAGTTCTTC	CASSLGGIFEQFF	TRBV5-1	TRBJ2-1
TGTGCCAGCAGTAGAGACGGTACCGGCTACACCTTC	CASSRDGTGYTF	TRBV12-3	TRBJ1-2
TGTGCCAGCAGTGGGCCCAATATAGCCAAAAACATTCAGTACTTC	CASSGPNIAKNIQYF	TRBV28	TRBJ2-4
TGTGCTAGTGGTTTGGTAAGTACCTTTGAAATCTTC	CASGLVSTFEIF	TRBV12-5	TRBJ2-1
TGTGCCAGCAGAGGCCGACGGACATCCTTGCACAATGAGCAGTTCTTC	CASRGRRTSLHNEQFF	TRBV7-4	TRBJ2-1
TGTGCCACCAGTGGGGACAGCAGGGATTCCTACGAGCAGTACTTC	CATSGDSRDSYEQYF	TRBV24-1	TRBJ2-7
TGCGCCAGCAGCCAAGATACCGTCGGTTTGGGGGCCGGGGAGACCCAGTACTTC	CASSQDTVGLGAGETQYF	TRBV4-1	TRBJ2-5
TGTGCCAGCAGTTCCGGTGCCCAGGGGAATGCTGAAGCTTTCTTT	CASSSGAQGNAEAFF	TRBV28	TRBJ1-1
TGTGCCAGCAGCGTCCGCGGCCGGTCTGGAAACACCATATATTTT	CASSVRGRSGNTIYF	TRBV7-6	TRBJ1-3
TGTGCCAGCAGCCAAGACCCCGAGGACTTGTACACTGAAGCTTTCTTT	CASSQDPEDLYTEAFF	TRBV3-1	TRBJ1-1
TGTGCCAGCAGCTGGGGGGAAAAAGATACGCAGTATTTT	CASSWGEKDTQYF	TRBV5-4	TRBJ2-3
TGTGCCAGCAGCTTTTCCCGCGGCAGGAACACTGAAGCTTTCTTT	CASSFSRGRNTEAFF	TRBV11-3	TRBJ1-1
TGTGCCAGCAGCTTGCATAGAGAGGGAAACACCATATATTTT	CASSLHREGNTIYF	TRBV7-8	TRBJ1-3
TGCGCCAGTCGGGGGGGTATTGTCTTC	CASRGGIVF	TRBV5-1	TRBJ2-1
TGTGCCAGCAGCAAATCCAGGGGGGGAAACACCATATATTTT	CASSKSRGGNTIYF	TRBV7-4	TRBJ1-3
TGTGCCAGCAGGGGACGCTACGAGCAGTACTTC	CASRGRYEQYF	TRBV28	TRBJ2-7
TGTGCCAGCAGCGGTCAGGAGGAAGTTGACTGCTATAGCAATCAGCCCCAGCATTTT	CASSGQEEVDCYSNQPQHF	TRBV7-8	TRBJ1-5
TGTGCCAGCAGCCAACCCCCAGGGACTGGGCAAGAGACCCAGTACTTC	CASSQPPGTGQETQYF	TRBV3-1	TRBJ2-5
TGTGCCAGCAGCCAAGATCCGCCGGGGGGAGCTTTCTTT	CASSQDPPGGAFF	TRBV3-1	TRBJ1-1
TGTGCCACCAGCAGAGACCTCCAACCCGACAAGCAAGAGACCCAGTACTTC	CATSRDLQPDKQETQYF	TRBV15	TRBJ2-5
TGTGCCAGACGGGGGTCCCATGAAAAACTGTTTTTT	CARRGSHEKLFF	TRBV7-9	TRBJ1-4
TGTGCCAGCAGTTTGCGGGGGGCGCTCTACACCTTC	CASSLRGALYTF	TRBV27	TRBJ1-2
TGTGCCAGCAGGGTAGGGACAGGGCCTTACGAGCAGTACTTC	CASRVGTGPYEQYF	TRBV6-5	TRBJ2-7
TGTGCCTGGAGGACAGGTGAAAAACTGTTTTTT	CAWRTGEKLFF	TRBV30	TRBJ1-4
TGCATGGGGACAGTTTGCTATGGCTACACCTTC	CMGTVCYGYTF	TRBV20-1	TRBJ1-2
TGTGCCAGCAGTTATAACCGGGACAGGGGGGAGTATCGCTATGGCTACACCTTC	CASSYNRDRGEYRYGYTF	TRBV6-5	TRBJ1-2
TGTGCCACAGTTACTGCAATCGGACAGGGCCGTTTTCCCTACGAGCAGTACTTC	CATVTAIGQGRFPYEQYF	TRBV7-9	TRBJ2-7
TGTGCCAGCAGCCCAGTAGGGAGTGCTGAGACCCAGTACTTC	CASSPVGSAETQYF	TRBV13	TRBJ2-5
TGTGCCAGCAGCCGATCTTTGACAGGGGGATACGAGCAGTACTTC	CASSRSLTGGYEQYF	TRBV7-3	TRBJ2-7
TGCAGTGCTCGGTGGGGGGGATACGAGCAGTACTTC	CSARWGGYEQYF	TRBV20-1	TRBJ2-7
TGCGCCAGGGACAGGCACACTGAAGCTTTCTTT	CARDRHTEAFF	TRBV10-1	TRBJ1-1
TGTGCCCTGGATCTGTATTACGGATCCTACGAGCAGTACTTC	CALDLYYGSYEQYF	TRBV11-2	TRBJ2-7
TGTGCCAGCAGCTTATTCCCCGGGTGTCCGGACAATTGCACCTTC	CASSLFPGCPDNCTF	TRBV7-2	TRBJ1-2
TGTGCCAGCAGCATGGGGGAAGAGGGCGGGGAGCTGTTTTTT	CASSMGEEGGELFF	TRBV7-3	TRBJ2-2
TGTGCCAGCAGCGTATATCCCCGCGGGAGCACCTACGAGCAGTACTTC	CASSVYPRGSTYEQYF	TRBV7-9	TRBJ2-7
TGTGCCAGCAGCAGGAGGATCTACAATGAGCAGTTCTTC	CASSRRIYNEQFF	TRBV12-4	TRBJ2-1
TGCAGTGCTAGCCTCCTCAATAGGGGCGCCAACGAGCAGTACTTC	CSASLLNRGANEQYF	TRBV20-1	TRBJ2-7
TGTGCCACCAGAAACGAGCTTGACAAGGAGCTGTTTTTT	CATRNELDKELFF	TRBV24-1	TRBJ2-2
TGTGCCACCAGTGATTTGAGAGGGTTCCCAGGCCAAAGCTCCTACGAGCAGTACTTC	CATSDLRGFPGQSSYEQYF	TRBV24-1	TRBJ2-7
TGCAGTGCACTCAACAGGGGGGGAGGCAGCTACGAGCAGTACTTC	CSALNRGGGSYEQYF	TRBV20-1	TRBJ2-7
TGTGCCAGCAGCCAAGGTTCTAGCGGGGGCGAGGATGAGCAGTTCTTC	CASSQGSSGGEDEQFF	TRBV3-1	TRBJ2-1
TGTGCCAGCTCACCAAAAGTCGACACGCGGATGAACACTGAAGCTTTCTTT	CASSPKVDTRMNTEAFF	TRBV18	TRBJ1-1
TGTGCCAGCAGCTTAGACCGACTAGCGGGCACGGTAGAGACCCAGTACTTC	CASSLDRLAGTVETQYF	TRBV7-4	TRBJ2-5
TGTGCCAGCAGCCAAGATCAACTATCCAACGCAGCCCCTAGGGCCCGGGACAAAAATGAGCAGTTCTTC	CASSQDQLSNAAPRARDKNEQFF	TRBV3-1	TRBJ2-1
TGCGCCAGCAGCTTGGCCGTACCGGGACGGATCACAGATACGCAGTATTTT	CASSLAVPGRITDTQYF	TRBV5-1	TRBJ2-3
TGTGCCAGCAGCTTCGACAACGGGGGGGGCACTGAAGCTTTCTTT	CASSFDNGGGTEAFF	TRBV4-2	TRBJ1-1
TGTGCCAGCAGTTATGGTCCTGGGGGAATTGACAATGAGCAGTTCTTC	CASSYGPGGIDNEQFF	TRBV27	TRBJ2-1
TGTGCCAGCAGCCCCCGGGGGGCCTACAATGAGCAGTTCTTC	CASSPRGAYNEQFF	TRBV7-3	TRBJ2-1
TGTGCCAGCGGGGGGGGAGACGAGCAGTACTTC	CASGGGDEQYF	TRBV6-4	TRBJ2-7
TGTGCCAGCAGCACCCGTACTAATCATGAGCAGTTCTTC	CASSTRTNHEQFF	TRBV7-8	TRBJ2-1
TGTGCCAGCAGTCCAGAGGGCTTC	CASSPEGF	TRBV2	TRBJ2-7
TGTGCCAGCAGTGACTCGAGTAAAGACACCACAGCGTACGAGCAGTACTTC	CASSDSSKDTTAYEQYF	TRBV6-4	TRBJ2-7
TGCAGTGCTAGACCTCGAAGGACCAGGTACTGCACTGAAGCTTTCTTT	CSARPRRTRYCTEAFF	TRBV20-1	TRBJ1-1
TGTGCCAGCAGCCAAGGCGGTAGCTTGGTTCGGGGGCTGATCTACAATGAGCAGTTCTTC	CASSQGGSLVRGLIYNEQFF	TRBV14	TRBJ2-1
TGTGCCAGCAGCACCTCCGGGACAGCCAAAAACATTCAGTACTTC	CASSTSGTAKNIQYF	TRBV13	TRBJ2-4
TGTGCCAGCAGTTTAGGGGGCGGAGGCCCGGGAAACACCATATATTTT	CASSLGGGGPGNTIYF	TRBV27	TRBJ1-3
TGCGCCAGCAGCCAAGGTCCGGGGATCTACGAGCAGTACTTC	CASSQGPGIYEQYF	TRBV4-1	TRBJ2-7
TGTGCCAGCTCCAAGCGCCCCAGTTGCAACAGGGGCAAAAACATTCAGTACTTC	CASSKRPSCNRGKNIQYF	TRBV18	TRBJ2-4
TGTGCCAGCAGCGGTCGCCGGGGCCGGGACAGTAGGGATTACGAGCAGTACTTC	CASSGRRGRDSRDYEQYF	TRBV5-8	TRBJ2-7
TGCGCCAGGGGAGGGGGCCCTTCATCACCCCTCCACTTT	CARGGGPSSPLHF	TRBV5-1	TRBJ1-6
TGTGCCAGCAGCCCGGACAAAAGCAATCAGCCCCAGCATTTT	CASSPDKSNQPQHF	TRBV7-9	TRBJ1-5
TGTGCCAGCAGCCAGCAGGGTGTGGTCAGCGAGCAGTACTTC	CASSQQGVVSEQYF	TRBV7-4	TRBJ2-7
TGCGCCAGCAGCCAAGCGACTCGGATTGACTCTGGAAACACCATATATTTT	CASSQATRIDSGNTIYF	TRBV4-1	TRBJ1-3
TGTGCCACCAGTGATCTGTACAAAGAACTCTCCGCAGGGGGGGCCAACCGGGGCAATGAGCAGTTCTTC	CATSDLYKELSAGGANRGNEQFF	TRBV24-1	TRBJ2-1
TGTGCCAGCAGCCCCAATGACGGTCTAGCTTTCTTT	CASSPNDGLAFF	TRBV7-3	TRBJ1-1
TGTGCCACCAGTGAAGGCGGAAAGGACTATGGCTACACCTTC	CATSEGGKDYGYTF	TRBV24-1	TRBJ1-2
TGTGCCAGCAGTTTCACCGGGGCTCGGGGCGCTCCTGAAGCTTTCTTT	CASSFTGARGAPEAFF	TRBV27	TRBJ1-1
TGTGCCAGCACACACCGGGACAGGGGGAGGTTTGGTCTCGGGCAGTACTTC	CASTHRDRGRFGLGQYF	TRBV6-3	TRBJ2-7
TGTGCCAGCAGCCTGCTAGTGTACAATGAGCAGTTCTTC	CASSLLVYNEQFF	TRBV7-4	TRBJ2-1
TGTGCCAGCGGGGACAGGGGAGGGTACGAGCAGTACTTC	CASGDRGGYEQYF	TRBV12-4	TRBJ2-7
TGTGCCAGCACTAACGCAGGGGGTGGCTCCTACGAGCAGTACTTC	CASTNAGGGSYEQYF	TRBV6-5	TRBJ2-7
TGCGCCAGCAGCCATTTTAGCGGAAGAGAGACCCAGTACTTC	CASSHFSGRETQYF	TRBV4-1	TRBJ2-5
TGTGCCAGCAGTTACCTCTCCGGACTCGGCAATCAGCCCCAGCATTTT	CASSYLSGLGNQPQHF	TRBV27	TRBJ1-5
TGTGCCAGCAGCGTATCGAACGGGGGGTCTCATGAAAAACTGTTTTTT	CASSVSNGGSHEKLFF	TRBV9	TRBJ1-4
TGTGCCAGCAGTTACATTAATACCGTAGGGTCGCAGTTCTTC	CASSYINTVGSQFF	TRBV6-5	TRBJ2-1
TGTGCCAGCAGCCAAGCCGGGACAGTGGGTGAGCAGTTCTTC	CASSQAGTVGEQFF	TRBV5-4	TRBJ2-1
TGTGCCAGCAGCTTATTCCCAGGAGAGTTCTACGAGCAGTACTTC	CASSLFPGEFYEQYF	TRBV7-9	TRBJ2-7
TGTGCCAGTAGTATATCAAGGCGGGTTCTAGCCAAAAACATTCAGTACTTC	CASSISRRVLAKNIQYF	TRBV19	TRBJ2-4
TGTGCCAGCAGAGCCACTTCCCTAGCGGGAGGCAGCTCCTACGAGCAGTACTTC	CASRATSLAGGSSYEQYF	TRBV27	TRBJ2-7
TGTGCCAGCAGTTTTCCATTGGACCCAGGGGATACGCAGTATTTT	CASSFPLDPGDTQYF	TRBV27	TRBJ2-3
TGCGCCAGCGATCGCCTGAGGGGGGGACGAGACACAGATACGCAGTATTTT	CASDRLRGGRDTDTQYF	TRBV10-1	TRBJ2-3
TGTGCCAGCTCCGACGGACGTGGAAGGGAGACCCAGTACTTC	CASSDGRGRETQYF	TRBV18	TRBJ2-5
TGTGCCAGCAGCTTAGCTAGGGGGGAGCTGTTTTTT	CASSLARGELFF	TRBV7-2	TRBJ2-2
TGTGCCAGCAGCTTGGACAGGGAGGCAGATCCTAATCAGCCCCAGCATTTT	CASSLDREADPNQPQHF	TRBV5-8	TRBJ1-5
TGTGCCAGCAGCCAAGGGGGAGGAAGACGTGAAGCTTTCTTT	CASSQGGGRREAFF	TRBV4-2	TRBJ1-1
TGTGCCACGGGGGGGAAGGTCTACGAGCAGTACTTC	CATGGKVYEQYF	TRBV6-5	TRBJ2-7
TGTGCCAGCAGTAGAGTAGACAGGGCTCGGGTCTATGGCTACACCTTC	CASSRVDRARVYGYTF	TRBV6-4	TRBJ1-2
TGTGCCAGCAGTCCGCGGGAGCCCGTGGAAGAGACCCAGTACTTC	CASSPREPVEETQYF	TRBV2	TRBJ2-5
TGTGCCAGCAGCCGGGTGGGGGGGATGGACGAGCAGTACTTC	CASSRVGGMDEQYF	TRBV5-8	TRBJ2-7
TGTGCCAGCAGTTATCAACTTCCCTGGGACAGAGTTATTCCTTTTTCCTACGAGCAGTACTTC	CASSYQLPWDRVIPFSYEQYF	TRBV6-3	TRBJ2-7
TGTGCCAGCAGTGAAAAAGGGGGGCTCATGAACACTGAAGCTTTCTTT	CASSEKGGLMNTEAFF	TRBV6-1	TRBJ1-1
TGTGCCTGTCCCAGGGACAATGAGCAGTTCTTC	CACPRDNEQFF	TRBV30	TRBJ2-1
TGTGCCAGTAGTTGTAGGGGCGAATATGGCTACACCTTC	CASSCRGEYGYTF	TRBV19	TRBJ1-2
TGTGCCAGCAAGAAAAAGCCGGGCGCGGCCCACTCCTACGAGCAGTACTTC	CASKKKPGAAHSYEQYF	TRBV6-5	TRBJ2-7
TGCGCCAGCAGCTCTAGCGGGGAGCAGTACTTC	CASSSSGEQYF	TRBV5-1	TRBJ2-7
TGTGCCAGCAGTGGACAGGGTAGGGGAAACACCATATATTTT	CASSGQGRGNTIYF	TRBV6-4	TRBJ1-3
TGTGCCAGCAGCACCGGGACAGGGGGGGCCAATCAGCCCCAGCATTTT	CASSTGTGGANQPQHF	TRBV13	TRBJ1-5
TGTGGGGGATTTAGCAATCAGCCCCAGCATTTT	CGGFSNQPQHF	TRBV25-1	TRBJ1-5
TGTGCCAGCAGCAACCTTCTAGCGGAGGCATGGTCCTACGAGCAGTACTTC	CASSNLLAEAWSYEQYF	TRBV6-1	TRBJ2-7
TGTGCCAGCACCTTGGGAGATTACAATGAGCAGTTCTTC	CASTLGDYNEQFF	TRBV6-1	TRBJ2-1
TGCGCCAGCAGCTTGGATAGCGGGAGAGCCTCCTACGAGCAGTACTTC	CASSLDSGRASYEQYF	TRBV5-1	TRBJ2-7
TGTGCCAGCAGTTATCGAGGCTTGGATGAGACCCAGTACTTC	CASSYRGLDETQYF	TRBV6-9	TRBJ2-5
TGTGCCTGGCCAAATACGGAAGACATTTACGAGCAGTACTTC	CAWPNTEDIYEQYF	TRBV30	TRBJ2-7
TGTGCCACCAGTTGTGTTTGTCCGACAGGGAGAAACACCATATATTTT	CATSCVCPTGRNTIYF	TRBV24-1	TRBJ1-3
TGCGCCAGCAGCCAAGGGACAGGGTCCTACGAGCAGTACTTC	CASSQGTGSYEQYF	TRBV4-1	TRBJ2-7
TGTGCCAGCCCCCCCCCAGGGGTCACAGATACGCAGTATTTT	CASPPPGVTDTQYF	TRBV27	TRBJ2-3
TGTGCCAGCAGCTTAGCTCCGAATAGGGAATCCTACGAGCAGTACTTC	CASSLAPNRESYEQYF	TRBV7-2	TRBJ2-7
TGCGCCAGCAGTGAGAAGGGGTGTGGGGGCACAGATACGCAGTATTTT	CASSEKGCGGTDTQYF	TRBV10-1	TRBJ2-3
TGTGCCAGCAGCTTCCCGCCCAGCCCCCGATCGGGGCGAGGGGAGCTGTTTTTT	CASSFPPSPRSGRGELFF	TRBV11-3	TRBJ2-2
TGTGCCAGCAGTTACACAAGACTAGCTAGGACCCAGTACTTC	CASSYTRLARTQYF	TRBV6-6	TRBJ2-5
TGTGCCAGCAGCGATGGAGTGACTAGCGGGCGTGACCCATCCTACGAGCAGTACTTC	CASSDGVTSGRDPSYEQYF	TRBV27	TRBJ2-7
TGCAGTGCGCCCAGGGTGAACACTGAAGCTTTCTTT	CSAPRVNTEAFF	TRBV20-1	TRBJ1-1
TGTGCCATCCGGACTAGGAACGGGGACGAGCAGTACTTC	CAIRTRNGDEQYF	TRBV10-3	TRBJ2-7
TGCGCCAGCAGCCAACTTAAGAAGTCGAAGAATTCACAGGGGAATGAGCAGTTCTTC	CASSQLKKSKNSQGNEQFF	TRBV4-1	TRBJ2-1
TGTGCCAGCAGTGATGCGTTATCCGGGACAGGGAATTCCCAGGACGAGCAGTACTTC	CASSDALSGTGNSQDEQYF	TRBV6-5	TRBJ2-7
TGCAGTGCTAGACAAAAATACCGGACAGGGCGAGAGACCCAGTACTTC	CSARQKYRTGRETQYF	TRBV20-1	TRBJ2-5
TGTGCCAGCAGCAACACAACTGGGACCGGGGAGCTGTTTTTT	CASSNTTGTGELFF	TRBV9	TRBJ2-2
TGTGCCAGAAGGGACAGTCCCAACACTGAAGCTTTCTTT	CARRDSPNTEAFF	TRBV2	TRBJ1-1
TGTGCCAGCAGTTTATCGGGACAGGGTAGCAATCAGCCCCAGCATTTT	CASSLSGQGSNQPQHF	TRBV27	TRBJ1-5
TGTGCCAGCAGCGGGGAGGGGCCCCAGCATTTT	CASSGEGPQHF	TRBV13	TRBJ1-5
TGTGCCAGCAGCTTACTCCAGGGCAAGAACACTGAAGCTTTCTTT	CASSLLQGKNTEAFF	TRBV7-3	TRBJ1-1
TGCGCCAGCAGCTCCGGGTCCGGACAGTATCCGCACAATGAGCAGTTCTTC	CASSSGSGQYPHNEQFF	TRBV5-1	TRBJ2-1
TGTGCCAGCAGTAAGAGTAACACCACTGAAGCTTTCTTT	CASSKSNTTEAFF	TRBV6-1	TRBJ1-1
TGTGCCAGCATAAAACTAGCGGGAGTTTGTCTTTACCCCCCGACCTACAATGAGCAGTTCTTC	CASIKLAGVCLYPPTYNEQFF	TRBV6-1	TRBJ2-1
TGTGCCAGCAGCTCACATGCGGGAGGTTATAGCAATCAGCCCCAGCATTTT	CASSSHAGGYSNQPQHF	TRBV11-3	TRBJ1-5
TGCGCCAGCAGCTTGGTTCAGGGGCATAATCAGCCCCAGCATTTT	CASSLVQGHNQPQHF	TRBV5-1	TRBJ1-5
TGTGCCAGTAGTATACCACTAAAGATTGAAGAGACCCAGTACTTC	CASSIPLKIEETQYF	TRBV19	TRBJ2-5
TGTGCCAGCAGCCAACCCCGGGACAACTACAATGAGCAGTTCTTC	CASSQPRDNYNEQFF	TRBV4-2	TRBJ2-1
TGTGCCAGCAGTTCCTCATCCGGGGGCTACGAGCAGTACTTC	CASSSSSGGYEQYF	TRBV6-5	TRBJ2-7
TGTGCCAGCAGTGAAAGGGGGATTTACAATGAGCAGTTCTTC	CASSERGIYNEQFF	TRBV6-1	TRBJ2-1
TGTGCCACCAGTGATTTCTGGGAGGACAGGGCCCTAGAAACCTACGAGCAGTACTTC	CATSDFWEDRALETYEQYF	TRBV24-1	TRBJ2-7
TGTGCCAGCAGTCTACCTAGCGGGGGCGGGGATACGCAGTATTTT	CASSLPSGGGDTQYF	TRBV2	TRBJ2-3
TGCAGCCCCGGACTAAACACCGGGGAGCTGTTTTTT	CSPGLNTGELFF	TRBV29-1	TRBJ2-2
TGCGCCAGCAGCCACCCGGGACAGGGGAAGAAAAGCTCCTACGAGCAGTACTTC	CASSHPGQGKKSSYEQYF	TRBV5-1	TRBJ2-7
TGTGCCAGCAGCCCTACGGGGTACTTC	CASSPTGYF	TRBV14	TRBJ2-5
TGTGCCAGCAGGCAGTATACTAGCGGGTCCTACAATGAGCAGTTCTTC	CASRQYTSGSYNEQFF	TRBV27	TRBJ2-1
TGTGCCAGCTGGCCTGAAAATTCACCCCTCCACTTT	CASWPENSPLHF	TRBV28	TRBJ1-6
TGTGCCAGCAGCGCGCTAGCAATTTACACTGAAGCTTTCTTT	CASSALAIYTEAFF	TRBV7-3	TRBJ1-1
TGTGCCAGCAGCCAGCGGAAGACCTCCTATAATTCACCCCTCCACTTT	CASSQRKTSYNSPLHF	TRBV7-3	TRBJ1-6
TGCGCCAGCAGCTTACTAGCGGGAGGTACACCCTACGAGCAGTACTTC	CASSLLAGGTPYEQYF	TRBV5-1	TRBJ2-7
TGTGCCAGCAGCCAAGAGGAGGGCCCCAATGAGACCCAGTACTTC	CASSQEEGPNETQYF	TRBV14	TRBJ2-5
TGTGCCAGCAGCTTAGGACAGGGGAGGAAGTACCGTCAGCCCCAGCATTTT	CASSLGQGRKYRQPQHF	TRBV7-9	TRBJ1-5
TGTGCCAGCAGCAACCGAAACCTACAGGGGGCGGACCTACCTGAAGCTTTCTTT	CASSNRNLQGADLPEAFF	TRBV5-4	TRBJ1-1
TGTGCCAGCAGCATCTGGGCAGGGGTCGAGACCGATCAGCCCCAGCATTTT	CASSIWAGVETDQPQHF	TRBV13	TRBJ1-5
TGTGCCAGCAGTTTCGGGACTAGAGGTGATACGCAGTATTTT	CASSFGTRGDTQYF	TRBV27	TRBJ2-3
TGTGCCATCACGGAATGTATGTTTAGCGGAGGTTCATATTCACCCCTCCACTTT	CAITECMFSGGSYSPLHF	TRBV10-3	TRBJ1-6
TGTGCCAGCAGGGAGGGGAGGACTCTCGGGGAGCTGTTTTTT	CASREGRTLGELFF	TRBV6-1	TRBJ2-2
TGTGCCACCAGAAAATTCCCTGGACGACACGAGCAGTACTTC	CATRKFPGRHEQYF	TRBV24-1	TRBJ2-7
TGCAGTGCTAGAGTTAGGGAATGCCCCCCCACTGAAGCTTTCTTT	CSARVRECPPTEAFF	TRBV20-1	TRBJ1-1
TGTGCCACCAGCCTGAGGAAATCTCAGAAGCGGGCTAGCACAGATACGCAGTATTTT	CATSLRKSQKRASTDTQYF	TRBV24-1	TRBJ2-3
TGTGCCAGCAGTCCCTTGTTTAAGCGGACAGGGGGCGTGGAGCCAAGGCCCTACGAGCAGTACTTC	CASSPLFKRTGGVEPRPYEQYF	TRBV27	TRBJ2-7
TGTGCCAGCACTAGTGATACGCAGTATTTT	CASTSDTQYF	TRBV11-1	TRBJ2-3
TGTGCCAGCAGTTTCCCGGGGATCGAGCAGTTCTTC	CASSFPGIEQFF	TRBV27	TRBJ2-1
TGTGCCAGCAGCGTAGACGCGGTCCAGGGGGGTTACACAGATACGCAGTATTTT	CASSVDAVQGGYTDTQYF	TRBV9	TRBJ2-3
TGCAGTGCTAGACCTTCACGACCTAGGAAGTCCTACGAGCAGTACTTC	CSARPSRPRKSYEQYF	TRBV20-1	TRBJ2-7
TGTGCCAGCAGCTTCCCAGGGTCCCCCACCGGGGAGCTGTTTTTT	CASSFPGSPTGELFF	TRBV7-9	TRBJ2-2
TGTGCCAGCAGTTACTCGAGAAAGGACTATCTGGACACAGATACGCAGTATTTT	CASSYSRKDYLDTDTQYF	TRBV6-5	TRBJ2-3
TGTACCTCCTCCCCGGGACCAGACTATGGCTACACCTTC	CTSSPGPDYGYTF	TRBV30	TRBJ1-2
TGTGCCACCAGTGATTTCTCCCGGCCCCCCCGGCAGGGAGTCTATCAGCCCCAGCATTTT	CATSDFSRPPRQGVYQPQHF	TRBV24-1	TRBJ1-5
TGCAGTGCTCTTCCGAGCTTGAACGGCTTTTTAAGTCCCACCATATATTTT	CSALPSLNGFLSPTIYF	TRBV20-1	TRBJ1-3
TGCGCCAGCAGCCAAGAGGTAAGACAAACCACAGATACGCAGTATTTT	CASSQEVRQTTDTQYF	TRBV4-3	TRBJ2-3
TGTGCCAGCAGCACCGGGGATGGCTACACCTTC	CASSTGDGYTF	TRBV13	TRBJ1-2
TGTGCCAGCAGCGAGGTACAGGGGAATGGCTACACCTTC	CASSEVQGNGYTF	TRBV13	TRBJ1-2
TGTGCCAGCAGATTCGGAGACAGGATAACCTACGAGCAGTACTTC	CASRFGDRITYEQYF	TRBV6-2	TRBJ2-7
TGTGCCAGCAGCGGGGGGCTTCCAGATACGCAGTATTTT	CASSGGLPDTQYF	TRBV7-9	TRBJ2-3
TGTGCCAGCAGCTTAGAAGCGGGAAGGGTGCCCTCAAATCAGCCCCAGCATTTT	CASSLEAGRVPSNQPQHF	TRBV11-3	TRBJ1-5
TGTGCCAGCTCACCAAGGTTGGCCTATGGCTACACCTTC	CASSPRLAYGYTF	TRBV18	TRBJ1-2
TGTGCCAGCAGCCAAGCCAAGGGACAGAATGGCTACACCTTC	CASSQAKGQNGYTF	TRBV3-1	TRBJ1-2
TGTGCCAGCAGTGCCCCCCGGGAAGGGTTGACAGGGGCTACAGGAAACACCATATATTTT	CASSAPREGLTGATGNTIYF	TRBV2	TRBJ1-3
TGTGCCAGCAGCAGGGGCCGGGACAGCCCCTCTGGAAACACCATATATTTT	CASSRGRDSPSGNTIYF	TRBV13	TRBJ1-3
TGTGCCAGCAGCCCCCCTAGCGGGCACCAAGAGACCCAGTACTTC	CASSPPSGHQETQYF	TRBV11-3	TRBJ2-5
TGTGCCAGCAGCCAAGGGAGGGGGGGGGGGGACCGGTTATCCATTGGAGAGGCCTACGAGCAGTACTTC	CASSQGRGGGDRLSIGEAYEQYF	TRBV3-1	TRBJ2-7
TGTGCCAGCAGTCGGGGAAGGGGACAGCCAGAGAAGGTCTTC	CASSRGRGQPEKVF	TRBV5-6	TRBJ2-1
TGCAGTGCTAGTGAAAAACTGTTTTTT	CSASEKLFF	TRBV20-1	TRBJ1-4
TGTGCCAGAGGCAGGGGGCGCGGGTATGGCTACACCTTC	CARGRGRGYGYTF	TRBV2	TRBJ1-2
TGTGCCAGCAGCTTAGCCCCTCCCAGGGCCTTTTATGGCTACACCTTC	CASSLAPPRAFYGYTF	TRBV7-9	TRBJ1-2
TGTGCCAGTAGCTCTGGGACAGTGGGAGCTTTCTTT	CASSSGTVGAFF	TRBV19	TRBJ1-1
TGTGCCAGCAGCCGTAAGAATGAAAAACTGTTTTTT	CASSRKNEKLFF	TRBV3-1	TRBJ1-4
TGTGCCAGCAGCCAAGACTGCTGCTTGAACACCGGGGAGCTGTTTTTT	CASSQDCCLNTGELFF	TRBV14	TRBJ2-2
TGTGCCAGCAGAACTAGCGGGAGTCTTCAAAGGGGGGCGAACACCGGGGAGCTGTTTTTT	CASRTSGSLQRGANTGELFF	TRBV7-2	TRBJ2-2
TGTGCCAGCAGCTTAGCGGAGGGCTCCCGGGGGCCCCAGTCCAGCTCCTACGAGCAGTACTTC	CASSLAEGSRGPQSSSYEQYF	TRBV7-4	TRBJ2-7
TGTGCCAGCAGCTATGCGAACCCGGGACAGGGGCGAGAGACCCAGTACTTC	CASSYANPGQGRETQYF	TRBV11-2	TRBJ2-5
TGTGCCACCAGTGATGGGGGCGGACCTGGCTACGAGCAGTACTTC	CATSDGGGPGYEQYF	TRBV24-1	TRBJ2-7
TGTGCCAGCGTAGTGGAGGGGGGGAATGAAAAACTGTTTTTT	CASVVEGGNEKLFF	TRBV2	TRBJ1-4
TGTGCCAGCAGTGAGGTTTCCAGGGGCTGGGGATTCTTCCTCTATAATTCACCCCTCCACTTT	CASSEVSRGWGFFLYNSPLHF	TRBV6-1	TRBJ1-6
TGCAGCGTTGAAACAGGACAGGGAGCCTACGAGCAGTACTTC	CSVETGQGAYEQYF	TRBV29-1	TRBJ2-7
TGTGCCAGCAGTTTGTCCTCCACTAGCGGGAGACATGCTGAAGCTTTCTTT	CASSLSSTSGRHAEAFF	TRBV28	TRBJ1-1
TGCGCCAGTAGCCCCCAGGGAGTCCGAGGTCCTAGCGGGGCATTCAATGAGCAGTTCTTC	CASSPQGVRGPSGAFNEQFF	TRBV10-2	TRBJ2-1
TGTGCCAGTATCGGACATTATGAGCAGTTCTTC	CASIGHYEQFF	TRBV19	TRBJ2-1
TGTGCCAGCAGCTGTGGGACAGGGTATTGGAAATTTAGCACAGATACGCAGTATTTT	CASSCGTGYWKFSTDTQYF	TRBV7-6	TRBJ2-3
TGTGCCAGCAGAGATAGCGCAGATGAGCAGTTCTTC	CASRDSADEQFF	TRBV5-4	TRBJ2-1
TGTGCCAGCAGACTAGTTCGCAATGAGCAGTTCTTC	CASRLVRNEQFF	TRBV2	TRBJ2-1
TGTGCCAGCAGCTTACGAACCGGGACATGGCTCACTGAAGCTTTCTTT	CASSLRTGTWLTEAFF	TRBV7-2	TRBJ1-1
TGTGCCTGTCCTCACCGACAGGGAACCTACGAGCAGTACTTC	CACPHRQGTYEQYF	TRBV30	TRBJ2-7
TGTGCCAGCAGCGCCAGCAACACTGAAGCTTTCTTT	CASSASNTEAFF	TRBV7-4	TRBJ1-1
TGTGCCAGCAGTTTCTTGCCCCAGGGGGGGAATTCACCCCTCCACTTT	CASSFLPQGGNSPLHF	TRBV6-2	TRBJ1-6
TGTGCCAGCAGCCATTACACAGGGAATCAGCCCCAGCATTTT	CASSHYTGNQPQHF	TRBV13	TRBJ1-5
TGTGCCAGCAGTAGTTTAGGGCCTTACGAGCAGTACTTC	CASSSLGPYEQYF	TRBV27	TRBJ2-7
TGTGCCAGCAGCCTGGAGCATTGGGGGCGAGCTAATGCCTACGAGCAGTACTTC	CASSLEHWGRANAYEQYF	TRBV7-3	TRBJ2-7
TGTGCCAGCAGCTCCCCCATATTAGGGGGATGGGACGCTAATGAAAAACTGTTTTTT	CASSSPILGGWDANEKLFF	TRBV7-2	TRBJ1-4
TGCGCCAGCAGTGAGTCGGCGGGAGGAGATGAGCAGTTCTTC	CASSESAGGDEQFF	TRBV10-1	TRBJ2-1
TGTGCCAGCAGCTTATCAAGTGTTACTAGCGGGAGAGCCAAAAACATTCAGTACTTC	CASSLSSVTSGRAKNIQYF	TRBV11-3	TRBJ2-4
TGTGCCAGCATGGGGGCCGTTAGCCGCAATCAGCCCCAGCATTTT	CASMGAVSRNQPQHF	TRBV27	TRBJ1-5
TGCGCCAGCAGCCAAGACTACCCGGGGGGGGAGATAAGCTCCTACGAGCAGTACTTC	CASSQDYPGGEISSYEQYF	TRBV4-3	TRBJ2-7
TGCGCCAGCAGCAAAGGGGGCCGATACACCGGGGAGCTGTTTTTT	CASSKGGRYTGELFF	TRBV5-1	TRBJ2-2
TGTGCCAGCAGTTTAGAAGGGGGCAGGGTCGAAACCCGCTACGAGCAGTACTTC	CASSLEGGRVETRYEQYF	TRBV12-3	TRBJ2-7
TGTGCCAGCAGTTTATCTCCAGGGATCTACGAGCAGTACTTC	CASSLSPGIYEQYF	TRBV27	TRBJ2-7
TGCAGCGACGGACGAAATGGAGATACGCAGTATTTT	CSDGRNGDTQYF	TRBV29-1	TRBJ2-3
TGCAGATGGGGCCGGGGGTGCCAAGAGACCCAGTACTTC	CRWGRGCQETQYF	TRBV20-1	TRBJ2-5
TGCGCCAGCAGCCAAGATCCCCTAGGGGGGGCAAGAGAGACCCAGTACTTC	CASSQDPLGGARETQYF	TRBV4-3	TRBJ2-5
TGTGCCAGCAGCGGGTGGAGACTACAGGGGTTACACAGAGGGGCTGAAGCTTTCTTT	CASSGWRLQGLHRGAEAFF	TRBV13	TRBJ1-1
TGTGCCAGCAGTGACCTAGCGGAGTATTTT	CASSDLAEYF	TRBV6-5	TRBJ2-3
TGTGCCAGCCCCCGACCCTACGAGCAGTACTTC	CASPRPYEQYF	TRBV5-8	TRBJ2-7
TGTGCCAGCAGCCGTAGTCTGACAGTAGGCCAAGGGGAAGAGACCCAGTACTTC	CASSRSLTVGQGEETQYF	TRBV7-9	TRBJ2-5
TGTGCCAGCAGCTTAATGGTAAGGGTATGGGCGGACTACCTCTTGGGACAGCCCCAGCATTTT	CASSLMVRVWADYLLGQPQHF	TRBV7-3	TRBJ1-5
TGCGCCAGCAGCGGGGCACTCAATCAGCCCCAGCATTTT	CASSGALNQPQHF	TRBV4-3	TRBJ1-5
TGCAGCGTTGACATCCGGGACAGGGGACTGGGCTACGAGCAGTACTTC	CSVDIRDRGLGYEQYF	TRBV29-1	TRBJ2-7
TGTGCCAGCCCTGGGCCCAGGAACACCGGGGAGCTGTTTTTT	CASPGPRNTGELFF	TRBV6-4	TRBJ2-2
TGCGCCAGCAGCTTGCCACACGACCTTTATAATTCACCCCTCCACTTT	CASSLPHDLYNSPLHF	TRBV5-1	TRBJ1-6
TGTGCCAGCAGCTGGACGAACACTGAAGCTTTCTTT	CASSWTNTEAFF	TRBV7-4	TRBJ1-1
TGTGCCAGCAGCTTAGACAGGGAGTCCTATGGCTACACCTTC	CASSLDRESYGYTF	TRBV11-2	TRBJ1-2
TGTGATAAGAGGACTAGCGGTCTGACCCAGTACTTC	CDKRTSGLTQYF	TRBV3-1	TRBJ2-5
TGTGCCAGCAGTGGGGGACAGTCGGGTAAGGAGAACACTGAAGCTTTCTTT	CASSGGQSGKENTEAFF	TRBV7-9	TRBJ1-1
TGTGCCAGCAGCCCCGACATTTCGGCCTCTCGGGGGAATGGCTACACCTTC	CASSPDISASRGNGYTF	TRBV9	TRBJ1-2
TGTGCCATCAGTGAGTGGGGGACAGATCAGCCCCAGCATTTT	CAISEWGTDQPQHF	TRBV10-3	TRBJ1-5
TGTGCCAGCAGCTTGTCTAGCGGGCACTCCTACAATGAGCAGTTCTTC	CASSLSSGHSYNEQFF	TRBV7-4	TRBJ2-1
TGTGCCAGCAGTATTTGGACAGGGGGTTATGGCTACACCTTC	CASSIWTGGYGYTF	TRBV6-5	TRBJ1-2
TGTGCCAGTCTATACTGGACCCAGTACTTC	CASLYWTQYF	TRBV19	TRBJ2-5
TGTGCCAGTAGTAAACAGGGGCGCGGGAGCTCTGGAAACACCATATATTTT	CASSKQGRGSSGNTIYF	TRBV19	TRBJ1-3
TGTGCCAGCAGTGACTCGATTCACCAGCAAGAGACCCAGTACTTC	CASSDSIHQQETQYF	TRBV6-4	TRBJ2-5
TGTGCCAGCAGCGAGACAGGAGGGAACATTCAGTACTTC	CASSETGGNIQYF	TRBV7-4	TRBJ2-4
TGTGCCAGCAGTGAAGCGCGCGGGACAGGTGCTTCTGAAGCTTTCTTT	CASSEARGTGASEAFF	TRBV6-1	TRBJ1-1
TGTGCCAGCAGCCGCAGGGCCCGAACGAACACTGAAGCTTTCTTT	CASSRRARTNTEAFF	TRBV7-6	TRBJ1-1
TGTGCCAGCAGGACGCTGGCCTACGAGCAGTACTTC	CASRTLAYEQYF	TRBV6-1	TRBJ2-7
TGTGCCAGCAGTTACGATAGGGGGATGGAAAAACTGTTTTTT	CASSYDRGMEKLFF	TRBV6-3	TRBJ1-4
TGCAGTGCTAGAGCACCCTGGGGCGGGGAGCTGTTTTTT	CSARAPWGGELFF	TRBV20-1	TRBJ2-2
TGTGCCACCAGAAAGGGGGCCCACATTCAGTACTTC	CATRKGAHIQYF	TRBV24-1	TRBJ2-4
TGCAGTGCACAACGGGACAAACGGGGTTCCTACGAGCAGTACTTC	CSAQRDKRGSYEQYF	TRBV20-1	TRBJ2-7
TGCAGTGCTACCCCTCGGACCCACAGGGGTGCTGATGAAAAACTGTTTTTT	CSATPRTHRGADEKLFF	TRBV20-1	TRBJ1-4
TGCAGTGCTCCCCGGTACAGGGGGCGGCATCCGAACACTGAAGCTTTCTTT	CSAPRYRGRHPNTEAFF	TRBV20-1	TRBJ1-1
TGTGCCAGCAGCAACGGGACAGGGCACTACGAGCAGTACTTC	CASSNGTGHYEQYF	TRBV2	TRBJ2-7
TGTGCCTGGCAAAATAGGGGACAACGCTCCTACGAGCAGTACTTC	CAWQNRGQRSYEQYF	TRBV30	TRBJ2-7
TGTGCCGCCCGGACAGGTATGGACAATGAGCAGTTCTTC	CAARTGMDNEQFF	TRBV10-3	TRBJ2-1
TGTGCCAGCAGCAGACCCCCCCCGCCGGGGACGGAGAGCTCCTACAATGAGCAGTTCTTC	CASSRPPPPGTESSYNEQFF	TRBV13	TRBJ2-1
TGTGCCAGCAGTTACTCAAACGAGCAGTACTTC	CASSYSNEQYF	TRBV27	TRBJ2-7
TGTGCCACCAGTGATCGGGGACTAGCGGGCTCCTACGAGCAGTACTTC	CATSDRGLAGSYEQYF	TRBV24-1	TRBJ2-7
TGTGCCAGCACAGGGACTAGCGGGGCGGAGCAGTTCTTC	CASTGTSGAEQFF	TRBV11-2	TRBJ2-1
TGTGCCAGCAGTTTATCCGCCGGGACAGGGGGCCAGCGAGACGCTTTCTTT	CASSLSAGTGGQRDAFF	TRBV27	TRBJ1-1
TGTGCCAGCAGCTTGACGGGGTTCCCCAACAATCAGCCCCAGCATTTT	CASSLTGFPNNQPQHF	TRBV11-2	TRBJ1-5
TGTGCCAGCAGCTTAGATCGGGTAGTTTGCTCTGGGGCCAACGTCCTGACTTTC	CASSLDRVVCSGANVLTF	TRBV11-2	TRBJ2-6
TGTGCCAGCAGCCTTCGGACTAATGAAAAACTGTTTTTT	CASSLRTNEKLFF	TRBV3-1	TRBJ1-4
TGCAGTGCTCAATCGACAAGGATAGGAGAGACCCAGTACTTC	CSAQSTRIGETQYF	TRBV20-1	TRBJ2-5
TGTGCCAGCAGCCGGGTCAGCGGGGGGGGCTACGAGCAGTACTTC	CASSRVSGGGYEQYF	TRBV7-3	TRBJ2-7
TGTGCCAGCAGCTTAAAGAACGAGCAGTACTTC	CASSLKNEQYF	TRBV11-2	TRBJ2-7
TGTGCCAGCAGCTTGGACAGGGGCAATCAGCCCCAGCATTTT	CASSLDRGNQPQHF	TRBV5-6	TRBJ1-5
TGTGCCAGCAGCGGGAGGGCATGTAAATCCTACAATGAGCAGTTCTTC	CASSGRACKSYNEQFF	TRBV6-1	TRBJ2-1
TGCGTGACAGGGGGCGCCCCCTATCTCGCTAACTATGGCTACACCTTC	CVTGGAPYLANYGYTF	TRBV29-1	TRBJ1-2
TGTGCCAGCAGAGGGAGGGGCAATGAGCAGTTCTTC	CASRGRGNEQFF	TRBV27	TRBJ2-1
TGTGCCAGCAGTGACTCGACCGCTTATCACACTGAAGCTTTCTTT	CASSDSTAYHTEAFF	TRBV6-4	TRBJ1-1
TGTGCCAGCACGGAACTAAGGACGGGGAATGAAAAACTGTTTTTT	CASTELRTGNEKLFF	TRBV6-1	TRBJ1-4
TGTGCCACCAGTGACCCCGGGGGCGCAGGGGGTAGCTCCTATAATTCACCCCTCCACTTT	CATSDPGGAGGSSYNSPLHF	TRBV24-1	TRBJ1-6
TGCGCCAGCAGCTTGAGACTAGCGGGCGAGTACAATGAGCAGTTCTTC	CASSLRLAGEYNEQFF	TRBV5-1	TRBJ2-1
TGTGCCAGCGGGACAGGGGATGGCTACACCTTC	CASGTGDGYTF	TRBV6-4	TRBJ1-2
TGCAGTGCTAGCCCAGCGGGAGATATAAATGAGCAGTTCTTC	CSASPAGDINEQFF	TRBV20-1	TRBJ2-1
TGTGCCAGCAGTGGAAACGCCCCTCTCTGCACAGATACGCAGTATTTT	CASSGNAPLCTDTQYF	TRBV6-2	TRBJ2-3
TGTGCCAGCAGCGCGGGACAGGGGGGAAGCGACGGGACCTGGGCCGGGGAGCTGTTTTTT	CASSAGQGGSDGTWAGELFF	TRBV9	TRBJ2-2
TGCAGTGCTGCGGGGAAAAATCAGCCCCAGCATTTT	CSAAGKNQPQHF	TRBV20-1	TRBJ1-5
TGTGCCAGTCGGGACACGAGCAATGAAAAACTGTTTTTT	CASRDTSNEKLFF	TRBV6-8	TRBJ1-4
TGCGCCAGCAGATTGGGATCGGCTGAAGCTTTCTTT	CASRLGSAEAFF	TRBV10-1	TRBJ1-1
TGTGCCAGGGTGAGTGGCAGCACAGATACGCAGTATTTT	CARVSGSTDTQYF	TRBV28	TRBJ2-3
TGTGCCAGCAGACAAGACAGGGTATTTCCCTACGAGCAGTACTTC	CASRQDRVFPYEQYF	TRBV27	TRBJ2-7
TGCGCCAGCAGTGTTCGCCCGTCCCTACTACTAGCGGGAGGTGGTGACACCGGGGAGCTGTTTTTT	CASSVRPSLLLAGGGDTGELFF	TRBV10-2	TRBJ2-2
TGTGCCAGCAGCGTTCTAGGGGTTCAGCCCCAGCATTTT	CASSVLGVQPQHF	TRBV7-2	TRBJ1-5
TGTGCCAGGGTCGGACCCCCAAATGAGCAGTTCTTC	CARVGPPNEQFF	TRBV19	TRBJ2-1
TGTGCCAGCAGTGGTCCCATACGGGGACATGGGTTAAATCAGCCCCAGCATTTT	CASSGPIRGHGLNQPQHF	TRBV5-6	TRBJ1-5
TGTGCCAGCAGTTGCTGGACAGGGAGTCAGCCCCAGCATTTT	CASSCWTGSQPQHF	TRBV6-2	TRBJ1-5
TGTGCTAGTGGAGAGGGGCAGAACACTGAAGCTTTCTTT	CASGEGQNTEAFF	TRBV12-5	TRBJ1-1
TGTGCCAGCAGTTGTCGGAACACTGAAGCTTTCTTT	CASSCRNTEAFF	TRBV28	TRBJ1-1
TGTGCCAGCAGCTTAACAGGGGAATCAGATACGCAGTATTTT	CASSLTGESDTQYF	TRBV11-2	TRBJ2-3
TGTGCCAGCAGCCCAGGGAGCCGAGATACGCAGTATTTT	CASSPGSRDTQYF	TRBV3-1	TRBJ2-3
TGCGCCAGCAGCAAGGTCTATGGCTACACCTTC	CASSKVYGYTF	TRBV10-1	TRBJ1-2
TGTGCCAGCAGCTTGCTCCAGTACTATGGCTACACCTTC	CASSLLQYYGYTF	TRBV5-6	TRBJ1-2
TGTGCCAGCAGTCCCGGACAGGGGGCCTCCTACGAGCAGTACTTC	CASSPGQGASYEQYF	TRBV6-4	TRBJ2-7
TGTGCCAGCAGCCAAGACTTTGCCGGGACAGGGTCTGACTTC	CASSQDFAGTGSDF	TRBV3-1	TRBJ1-2
TGCGCCAGCACCGAAAGGACATGGGGCTTGAATGAAAAACTGTTTTTT	CASTERTWGLNEKLFF	TRBV10-1	TRBJ1-4
TGTGCCAGCAGCCAAGACGGGACGTCCGACTACGAGCAGTACTTC	CASSQDGTSDYEQYF	TRBV3-1	TRBJ2-7
TGTGCCAGCAGCTTCCTCGACCCGGACAGGGGAGCTGCGAACACCGGGGAGCTGTTTTTT	CASSFLDPDRGAANTGELFF	TRBV5-6	TRBJ2-2
TGTGCCACAGGGGGGAACACTGAAGCTTTCTTT	CATGGNTEAFF	TRBV3-1	TRBJ1-1
TGTGCCAGCAGCTTTATCCGGGACAGGGGGCGCGATTACGAGCAGTACTTC	CASSFIRDRGRDYEQYF	TRBV9	TRBJ2-7
TGTGCCAGCAGCTTAACCGCCGTAGGGGGCGCCTACGAGCAGTACTTC	CASSLTAVGGAYEQYF	TRBV7-3	TRBJ2-7
TGTGCCAGCAGTGAGTTTTTACGGGGAAGGGTAACTGAAGCTTTCTTT	CASSEFLRGRVTEAFF	TRBV6-4	TRBJ1-1
TGTGCCAGCAGCCCCTTACGAGCTGAAGCTTTCTTT	CASSPLRAEAFF	TRBV3-1	TRBJ1-1
TGTGCCAGCAGCTTTTGCGGGGGGAACAATGAGCAGTTCTTC	CASSFCGGNNEQFF	TRBV7-3	TRBJ2-1
TGTGCCAGCAGTACCTGGCGACAGGACTATAACACTGAAGCTTTCTTT	CASSTWRQDYNTEAFF	TRBV2	TRBJ1-1
TGCGCCAGCAGCTACTCCGGACAGGGCGCATCAGACACTGAAGCTTTCTTT	CASSYSGQGASDTEAFF	TRBV5-1	TRBJ1-1
TGTGCCAGCTCCCCAACTAGCGGGGGGGCCTGCTTGGGAGACAATGAGCAGTTCTTC	CASSPTSGGACLGDNEQFF	TRBV6-5	TRBJ2-1
TGTGCCAGCAGCCTAGGAGCGGAGGGGTCGGGGGCCGAGCAGTACTTC	CASSLGAEGSGAEQYF	TRBV7-3	TRBJ2-7
TGTGCCGGTGGGGAGCAGTACTTC	CAGGEQYF	TRBV5-4	TRBJ2-7
TGCAGCGTCCCCGGGGGCGGAGTGGCCAACGTCCTGACTTTC	CSVPGGGVANVLTF	TRBV29-1	TRBJ2-6
TGCGCCCTGGTGACATGCTATGGCTACACCTTC	CALVTCYGYTF	TRBV10-2	TRBJ1-2
TGTGCCAGCAGCTTCCTCCCTAACGGGGGGGGGACTAACCACTACGAGCAGTACTTC	CASSFLPNGGGTNHYEQYF	TRBV11-3	TRBJ2-7
TGTGCCAGCAGTTACGGCCCCGGGACAGGGTACGAGCAGTACTTC	CASSYGPGTGYEQYF	TRBV6-6	TRBJ2-7
TGTGCCAGTAGTTCCTGGACAACAACTAATGAAAAACTGTTTTTT	CASSSWTTTNEKLFF	TRBV19	TRBJ1-4
TGCGCCAGCAGCTTGCGGGGACAGGGGGGAAATGAAAAACTGTTTTTT	CASSLRGQGGNEKLFF	TRBV5-1	TRBJ1-4
TGTGCCAGCAGCTCTAGCGGGGAAGTTTCCGGTCACACCGGGGAGCTGTTTTTT	CASSSSGEVSGHTGELFF	TRBV7-2	TRBJ2-2
TGTGCCAGCAGATCTCATTTAGCGGGCTCCTACGAGCAGTACTTC	CASRSHLAGSYEQYF	TRBV25-1	TRBJ2-7
TGTGCCAGCAGCGGGCTTAAGTCCTACAATGAGCAGTTCTTC	CASSGLKSYNEQFF	TRBV12-4	TRBJ2-1
TGTGCCAGCAGTTTGGACAGGGACATAGGGGGCTACACCTTC	CASSLDRDIGGYTF	TRBV28	TRBJ1-2
TGTGCCAGCAGCTGGGCCCACAGCCTTTACCAGCACTCCTACGAGCAGTACTTC	CASSWAHSLYQHSYEQYF	TRBV5-6	TRBJ2-7
TGTGCCAGCAGCTTGGCCCACCCGGGAGACAAATTCAATGAGCAGTTCTTC	CASSLAHPGDKFNEQFF	TRBV5-4	TRBJ2-1
TGTGCCACCAGGTCTCCAGGGTCAAATACGCAGTATTTT	CATRSPGSNTQYF	TRBV24-1	TRBJ2-3
TGTGCCAGCAAGGGCTACGAGCAGTACTTC	CASKGYEQYF	TRBV6-4	TRBJ2-7
TGCAGTCGGGGGCGTAACTATGGCTACACCTTC	CSRGRNYGYTF	TRBV20-1	TRBJ1-2
TGTGCCAGCAGCTGGCAGCGAGGACAGGGCTACCCCGGGGAGCTGTTTTTT	CASSWQRGQGYPGELFF	TRBV5-6	TRBJ2-2
TGTGCCAGCAGCCAAGGTCCAGGCTTTTGCGGGCCCGAGCAGTACTTC	CASSQGPGFCGPEQYF	TRBV4-2	TRBJ2-7
TGTGCCAGCAGTTTGTCCTCTAGAATAAGCAACATTCAGTACTTC	CASSLSSRISNIQYF	TRBV28	TRBJ2-4
TGTGCCAAAGGCTGGACAGACTCCTACGAGCAGTACTTC	CAKGWTDSYEQYF	TRBV6-4	TRBJ2-7
TGTGCCACCAGCGACCAACGGGTTTCCTACGAGCAGTACTTC	CATSDQRVSYEQYF	TRBV15	TRBJ2-7
TGTGCCAGCAGCGACAGGGGGTACACGGTCCGCAATCAGCCCCAGCATTTT	CASSDRGYTVRNQPQHF	TRBV7-4	TRBJ1-5
TGTGCCAGCAGCTTACTGTCTAGCGGGCGGGAGCTAGAGACCCAGTACTTC	CASSLLSSGRELETQYF	TRBV11-2	TRBJ2-5
TGTGCCAGCAGTTCCGGAGGCGCGGGAGGTTTAAGCAATCAGCCCCAGCATTTT	CASSSGGAGGLSNQPQHF	TRBV6-5	TRBJ1-5
TGTGCCATCAGGCCCAGCGACAGGGGCCACTATGGCTACACCTTC	CAIRPSDRGHYGYTF	TRBV10-3	TRBJ1-2
TGTGCCAGCACGTCTGGGGACGAGCAGTACTTC	CASTSGDEQYF	TRBV6-2	TRBJ2-7
TGCGCCAGCCGGGAGGACTCCTACGAGCAGTACTTC	CASREDSYEQYF	TRBV5-1	TRBJ2-7
TGTGCCAGCAGTTATTCAATCGGGGCAGACGCCAAAAACATTCAGTACTTC	CASSYSIGADAKNIQYF	TRBV6-9	TRBJ2-4
TGTGCCAGCAGGAAGGGCCATAGGGGGTCAACTAATGAAAAACTGTTTTTT	CASRKGHRGSTNEKLFF	TRBV27	TRBJ1-4
TGTGCCAGCAGTAATCACAGGCGGGTGGGGGGAAACACTGAAGCTTTCTTT	CASSNHRRVGGNTEAFF	TRBV12-4	TRBJ1-1
TGTGCCAGCAGTGCCCGGGACCCGTTAAGCTCTGGAAACACCATATATTTT	CASSARDPLSSGNTIYF	TRBV6-1	TRBJ1-3
TGCAGTGCTAGAGATGTCCTGGGACGGGAAGCCAAAAACATTCAGTACTTC	CSARDVLGREAKNIQYF	TRBV20-1	TRBJ2-4
TGCGCCAGCAGCCAACCCCGGGACAGGGAGGATGGAGGCTACGAGCAGTACTTC	CASSQPRDREDGGYEQYF	TRBV4-1	TRBJ2-7
TGTGCCAGCAGTCCCGAGGGGGGCCAGAATCAGCCCCAGCATTTT	CASSPEGGQNQPQHF	TRBV6-3	TRBJ1-5
TGCAGTGCTAGAGATCGGGGACAGGGGGCCTTGTCAGCCGCCTCAACTAATGAAAAACTGTTTTTT	CSARDRGQGALSAASTNEKLFF	TRBV20-1	TRBJ1-4
TGCGCCAGCAGCATCGGACGCCACGACGAGCAGTACTTC	CASSIGRHDEQYF	TRBV5-1	TRBJ2-7
TGCGCCAGCGGCGGGGGAAACACCATATATTTT	CASGGGNTIYF	TRBV5-1	TRBJ1-3
TGCGCCAGCAGCAACCTCGAGAATCAGCCCCAGCATTTT	CASSNLENQPQHF	TRBV5-1	TRBJ1-5
TGCGCCAGCAGCTTGGGCAGGCTAAAGTCAAGCTCCTACAATGAGCAGTTCTTC	CASSLGRLKSSSYNEQFF	TRBV5-1	TRBJ2-1
TGTGCCAGCATAATCCAGAAAAACATCGAAGCTTTCTTT	CASIIQKNIEAFF	TRBV6-5	TRBJ1-1
TGCGCCAGCAGCCAAACAAGAGCGGGCCCCGGGGAGCTGTTTTTT	CASSQTRAGPGELFF	TRBV4-1	TRBJ2-2
TGTGCCAGCAGCGTCATGCAGGGGGTAGTCTCTGGGGCCAACGTCCTGACTTTC	CASSVMQGVVSGANVLTF	TRBV12-3	TRBJ2-6
TGCGCCAGCAGCTTGGCGGCGGAGGGACAGGGGGCACGGGTTACGGAGCAGTACTTC	CASSLAAEGQGARVTEQYF	TRBV5-1	TRBJ2-7
TGTGCCAGCAGGGGGGAGGCCACCTACGAGCAGTACTTC	CASRGEATYEQYF	TRBV7-9	TRBJ2-7
TGTGCCACCAGTGGGGGCACAGATGAGCAGTTCTTC	CATSGGTDEQFF	TRBV24-1	TRBJ2-1
TGCGCCAGCAGCCAAGGGTTGGGACCGCTCCTAGCTTTTCACACTGAAGCTTTCTTT	CASSQGLGPLLAFHTEAFF	TRBV4-1	TRBJ1-1
TGTGCCAGCAGCCGGAGGAGTGAGGATAACTATGGCTACACCTTC	CASSRRSEDNYGYTF	TRBV7-2	TRBJ1-2
TGCAGTGCTAGAGGAATCTCGGGACAGAGAAATCAGCCCCAGCATTTT	CSARGISGQRNQPQHF	TRBV20-1	TRBJ1-5
TGTGCCAGCAATACCCACACCATAGAGCAGTACTTC	CASNTHTIEQYF	TRBV27	TRBJ2-7
TGCGCCAGCAGTCTTTTCTTCACAGGGGGCGACGGACCGGGGGAGGTATACGTAAAAAGCGGCTACACCTTC	CASSLFFTGGDGPGEVYVKSGYTF	TRBV5-1	TRBJ1-2
TGTGCCAGCAGCCTTTCCTTACGGGGGCCGAACACTGAAGCTTTCTTT	CASSLSLRGPNTEAFF	TRBV11-3	TRBJ1-1
TGTGCCAGCAGCTTAGATCGTAGGACGATGCAAGAGACCCAGTACTTC	CASSLDRRTMQETQYF	TRBV11-2	TRBJ2-5
TGTGCCAGCAGTTACTCTTGGGGGTACGAGCAGTACTTC	CASSYSWGYEQYF	TRBV6-2	TRBJ2-7
TGTGCCAGCAGCCAGACAGGGGCGATGCAGCCCCAGCATTTT	CASSQTGAMQPQHF	TRBV28	TRBJ1-5
TGTGCTTCGAGTTATCGGGACAGGGTTACTAATGAAAAACTGTTTTTT	CASSYRDRVTNEKLFF	TRBV9	TRBJ1-4
TGTGCCAGCAGTTTTCTCCCCGGCGTTGCTGAGCAGTTCTTC	CASSFLPGVAEQFF	TRBV12-3	TRBJ2-1
TGCAGTGCTAGAGATGGGGGGGCAAGGGGAAGAGACGGGGAGCTGTTTTTT	CSARDGGARGRDGELFF	TRBV20-1	TRBJ2-2
TGTGCTAGTGGTTTGCCCGCTCGACAGGGGGCGCATCGCTCTGGGGCCAACGTCCTGACTTTC	CASGLPARQGAHRSGANVLTF	TRBV12-5	TRBJ2-6
TGCAGTGCTAGTTCCACACCCACTCCGACCCAGTACTTC	CSASSTPTPTQYF	TRBV20-1	TRBJ2-5
TGTGCCAGCAGCGGGACTCGAACTGCCTCCTACGAGCAGTACTTC	CASSGTRTASYEQYF	TRBV13	TRBJ2-7
TGTGCCACCAGTGATAAAGTAAGCAATCAGCCCCAGCATTTT	CATSDKVSNQPQHF	TRBV24-1	TRBJ1-5
TGTGCCAGCAGCTTCGAGGGGGAAAACACCATATATTTT	CASSFEGENTIYF	TRBV6-5	TRBJ1-3
TGTGCCAGCTCACGCTTCCCTGGAGACAGGGCCATAGGATCCTACAATGAGCAGTTCTTC	CASSRFPGDRAIGSYNEQFF	TRBV18	TRBJ2-1
TGTGCCAGCAGAGTAAAGACTAGCGGGGCCGCCTACGAGCAGTACTTC	CASRVKTSGAAYEQYF	TRBV5-6	TRBJ2-7
TGTGCCAGCTCACTCGGACTAGCGGGAGGGCAAGATCCAGGATACGAGCAGTACTTC	CASSLGLAGGQDPGYEQYF	TRBV12-4	TRBJ2-7
TGTGCCAGCAGCTTAACAGGTCCGGAAAAACTGTTTTTT	CASSLTGPEKLFF	TRBV7-8	TRBJ1-4
TGTGCCATCAGTGAGTGGACAGCGGGCACAGATACGCAGTATTTT	CAISEWTAGTDTQYF	TRBV10-3	TRBJ2-3
TGTGCCAGCATGGACAGTGAGGGACCTTTTGAAGCTTTCTTT	CASMDSEGPFEAFF	TRBV7-9	TRBJ1-1
TGCAGTGCTCCGGGACTAGACGTGTACACCGGGGAGCTGTTTTTT	CSAPGLDVYTGELFF	TRBV20-1	TRBJ2-2
TGCGCCAAGACCCTTCCCTACGAGCAGTACTTC	CAKTLPYEQYF	TRBV10-1	TRBJ2-7
TGTGCCAGCAGCCGGGTGGCAGACAGAAGGCCGAACACTGAAGCTTTCTTT	CASSRVADRRPNTEAFF	TRBV7-3	TRBJ1-1
TGTGCCAGCAGGGGCCGGGACAGGGGACGGCATGGCTACACCTTC	CASRGRDRGRHGYTF	TRBV27	TRBJ1-2
TGTGCCAGCAGCCTCGGGGGGCCCCGTCCAGACCAAGAGACCCAGTACTTC	CASSLGGPRPDQETQYF	TRBV7-9	TRBJ2-5
TGCGCCAGCAGTGATCCTCCCCTGAGCACCGGGGAGCTGTTTTTT	CASSDPPLSTGELFF	TRBV10-1	TRBJ2-2
TGTGCCAGCAGTTTTAATATCCTGGGGTGGGCAATCAGACGACACAAGGAATCCTACAATGAGCAGTTCTTC	CASSFNILGWAIRRHKESYNEQFF	TRBV12-4	TRBJ2-1
TGTGCCAGCAGTTACTCGAGGGGGAATCAGCCCCAGCATTTT	CASSYSRGNQPQHF	TRBV6-5	TRBJ1-5
TGTGCCAGCAGCCCTGCCTTACCGTACCGAAGGTGGGGGGGATGGCCAAGCTCCTACAATGAGCAGTTCTTC	CASSPALPYRRWGGWPSSYNEQFF	TRBV7-2	TRBJ2-1
TGTGCCAGCCCCCGGGGGGCCTACACCTTC	CASPRGAYTF	TRBV2	TRBJ1-2
TGTGCCAGCAGCTTAGGAGCAGACACTGAAGCTTTCTTT	CASSLGADTEAFF	TRBV11-3	TRBJ1-1
TGTGCCAGCAGTTATAAGAAAGACAGGTATAGCAATCAGCCCCAGCATTTT	CASSYKKDRYSNQPQHF	TRBV6-6	TRBJ1-5
TGCAGTGCGCGGGAGGACTATGGCTACACCTTC	CSAREDYGYTF	TRBV20-1	TRBJ1-2
TGTGCCAGCAGTTTATCTACAGAGGCTAATGAAAAACTGTTTTTT	CASSLSTEANEKLFF	TRBV27	TRBJ1-4
TGTGCCAGCAGCCACAGGGGCCGTTGGGGCTACACCTTC	CASSHRGRWGYTF	TRBV5-4	TRBJ1-2
TGTGCCACTCCATGGACAGGGGGGCCCCAGCATTTT	CATPWTGGPQHF	TRBV10-3	TRBJ1-5
TGTGCCAGCAGCCGGACTAGCGGGCCTCTCACAGATACGCAGTATTTT	CASSRTSGPLTDTQYF	TRBV6-5	TRBJ2-3
TGTGCCAGCAGCGACAGGGGGCCATCCCTTAATTCACCCCTCCACTTT	CASSDRGPSLNSPLHF	TRBV7-9	TRBJ1-6
TGTGCCAGCAGTTCATATTATCGGACAGGCGTTAGGTGGAGCTCCTACGAGCAGTACTTC	CASSSYYRTGVRWSSYEQYF	TRBV12-4	TRBJ2-7
TGTGCCAGCAGCCCTCTATCAGGCAATGAGCAGTTCTTC	CASSPLSGNEQFF	TRBV11-3	TRBJ2-1
TGTGCCAGCAGCCTTAGGACTAGCGGGGGTGAGCAGTTCTTC	CASSLRTSGGEQFF	TRBV5-4	TRBJ2-1
TGCGCCAGCAGCATCCCCAGCGGCTACGAGCAGTACTTC	CASSIPSGYEQYF	TRBV5-1	TRBJ2-7
TGTGCCAGCAGCAAGACAGGAACTGAAAAACTGTTTTTT	CASSKTGTEKLFF	TRBV11-3	TRBJ1-4
TGTGCCAGCAGCGTAAGCGGGGGCCTGGTAGTTATTCTGTTTTTT	CASSVSGGLVVILFF	TRBV7-3	TRBJ1-4
TGTGCCAGCAGATGGACAGGTAGAGCAGATCAGCCCCAGCATTTT	CASRWTGRADQPQHF	TRBV6-1	TRBJ1-5
TGTGCCAGCAGCAGGAGGGCCCGAAATTGGGTTTCAACCTATAATTCACCCCTCCACTTT	CASSRRARNWVSTYNSPLHF	TRBV7-2	TRBJ1-6
TGTGCCAGCAGTTTGAAGCCGACTAGCGTGGACACCGGGGAGCTGTTTTTT	CASSLKPTSVDTGELFF	TRBV28	TRBJ2-2
TGTGCCAGCAGCTTAGTCCCCCCGCAGGGCGGAGGTGAGCAGTTCTTC	CASSLVPPQGGGEQFF	TRBV11-2	TRBJ2-1
TGCAGTGCTAGCCTCCAGGCAGGGGGCACCTCCTACGAGCAGTACTTC	CSASLQAGGTSYEQYF	TRBV20-1	TRBJ2-7
TGTGCCAGCTGGGTCACAGGCGTTGAACGGATCTACGAGCAGTACTTC	CASWVTGVERIYEQYF	TRBV6-5	TRBJ2-7
TGTGCCAGCAGTGAACCCCGGGCGGGAGCCAGACCCTACGAGCAGTACTTC	CASSEPRAGARPYEQYF	TRBV6-1	TRBJ2-7
TGTGCTAGCAGCTTATCAAGTGTGACTACCGGGACAGGGGGAGAAAATGAAAAACTGTTTTTT	CASSLSSVTTGTGGENEKLFF	TRBV7-7	TRBJ1-4
TGCGCCAGCAGCTTGTACCAGCGGACTAGCGGGGGGGCCGAACTGATCTACGAGCAGTACTTC	CASSLYQRTSGGAELIYEQYF	TRBV5-1	TRBJ2-7
TGTGCCAGCAGCTCACAGCCAGACACTGAAGCTTTCTTT	CASSSQPDTEAFF	TRBV7-2	TRBJ1-1
TGCAGTGCTAGCATTCGGGGAAACTATGGCTACACCTTC	CSASIRGNYGYTF	TRBV20-1	TRBJ1-2
TGTGCCAGCAGTACACCCAGAGTGGGCTCTGGAAACACCATATATTTT	CASSTPRVGSGNTIYF	TRBV5-4	TRBJ1-3
TGTGCCAGCAAGATGACAGGGTCGTTTAATGAGCAGTTCTTC	CASKMTGSFNEQFF	TRBV12-3	TRBJ2-1
TGTGCCAGCAGGATTAGTTCCAGGGCCTGTCGGCGGCGGAACACCGGGGAGCTGTTTTTT	CASRISSRACRRRNTGELFF	TRBV6-2	TRBJ2-2
TGCAGTGCCCCCGACAGGACCCAGCATTTT	CSAPDRTQHF	TRBV20-1	TRBJ1-5
TGTGCCTGGAGTGGACAGGACAACTATGGCTACACCTTC	CAWSGQDNYGYTF	TRBV30	TRBJ1-2
TGTGCCGGGTCGACAGGAGATGCCTCTGACTATGGCTACACCTTC	CAGSTGDASDYGYTF	TRBV6-5	TRBJ1-2
TGTGCCAGTAGCGCAGGGGGCGTCGACTACGAGCAGTACTTC	CASSAGGVDYEQYF	TRBV19	TRBJ2-7
TGCAGTTTGAAGGACGGGGGACAGCCCCAGCATTTT	CSLKDGGQPQHF	TRBV20-1	TRBJ1-5
TGTGCCAGCAGCAACGACTTCGGGGACAATGAGCAGTTCTTC	CASSNDFGDNEQFF	TRBV9	TRBJ2-1
TGCGCCAGCAGCCAAGATCTTCGACTAGCGGGCAAGTTCGAGCAGTACTTC	CASSQDLRLAGKFEQYF	TRBV4-1	TRBJ2-7
TGCACCCGAGTTCACGCTAGAGAGGGTCTGTCCTACAATGAGCAGTTCTTC	CTRVHAREGLSYNEQFF	TRBV20-1	TRBJ2-1
TGTGCCAGCAGCCCAGGGGCTCGCACAAGCTCCTATAATTCACCCCTCCACTTT	CASSPGARTSSYNSPLHF	TRBV13	TRBJ1-6
TGCGCCAGCAGTGAAGGATCAGACTGGTGGACAGGGGGGACACACGAGCAGTACTTC	CASSEGSDWWTGGTHEQYF	TRBV10-1	TRBJ2-7
TGTGCCACCAGTACTAACGTTGACAATGAGCAGTTCTTC	CATSTNVDNEQFF	TRBV24-1	TRBJ2-1
TGTGCCAGCAGCGCGGACAGGGGCGGGAACGAGCAGTACTTC	CASSADRGGNEQYF	TRBV3-1	TRBJ2-7
TGTGCCAGCAGTTTACTAGGGGGGAGCTCCTACAATGAGCAGTTCTTC	CASSLLGGSSYNEQFF	TRBV12-3	TRBJ2-1
TGTGCCACCAACCACCCAAGCGAGACCCAGTACTTC	CATNHPSETQYF	TRBV15	TRBJ2-5
TGTGCCAGCTCAAGGGGACAGAGCTACGAGCAGTACTTC	CASSRGQSYEQYF	TRBV18	TRBJ2-7
TGCAGTGCTAGTTCTAGCGGTACCAACGAGCAGTACTTC	CSASSSGTNEQYF	TRBV20-1	TRBJ2-7
TGTGCCAGCAGTTACCCAAGACCACGGGGACTAGGGGACAATGAGCAGTTCTTC	CASSYPRPRGLGDNEQFF	TRBV6-2	TRBJ2-1
TGTGCCAGCAGCCACATAACAGGGTGGGCAGTAGACACCGGGGAGCTGTTTTTT	CASSHITGWAVDTGELFF	TRBV3-1	TRBJ2-2
TGTGCCAGCAGTGGTTCCGGGACTAGCGGGACTGGAAACACCATATATTTT	CASSGSGTSGTGNTIYF	TRBV6-4	TRBJ1-3
TGTGCCAGCAGCTTGGCCTTTAGGGTACTAGCGGGCTACGAGCAGTACTTC	CASSLAFRVLAGYEQYF	TRBV5-4	TRBJ2-7
TGTGCCAGCAGCTTGGCAGCGGGAAATGAGCAGTTCTTC	CASSLAAGNEQFF	TRBV5-6	TRBJ2-1
TGTGCTAGTGGTTTACTAGCGGGAGGGCACGAGCAGTACTTC	CASGLLAGGHEQYF	TRBV12-5	TRBJ2-7
TGTGCCCTGCCTTCTCCTAGGCCGACCTCCTACGAGCAGTACTTC	CALPSPRPTSYEQYF	TRBV14	TRBJ2-7
TGCGCCAGCAGCCAAGAGTGGGGCTCCTACGAGCAGTACTTC	CASSQEWGSYEQYF	TRBV4-1	TRBJ2-7
TGTGCCAGCAGGGGGTTAAAAGGGGGCGGAAAAAACACCGGGGAGCTGTTTTTT	CASRGLKGGGKNTGELFF	TRBV4-2	TRBJ2-2
TGTGCCAGCAGCTTAGAATATGACGAGCAGTACTTC	CASSLEYDEQYF	TRBV11-3	TRBJ2-7
TGTGCCACCATCTCCGGGGGGGCTAATGAGCAGTTCTTC	CATISGGANEQFF	TRBV24-1	TRBJ2-1
TGCAGCGGTTCCAGACTAGGTTCGAACACCGGGGAGCTGTTTTTT	CSGSRLGSNTGELFF	TRBV29-1	TRBJ2-2
TGCAGTAGACAGCGACTAGACGGCTACGAGCAGTACTTC	CSRQRLDGYEQYF	TRBV20-1	TRBJ2-7
TGTGCCAGCTACCGGACAGGGTGGAATCAGCCCCAGCATTTT	CASYRTGWNQPQHF	TRBV27	TRBJ1-5
TGCGCCAGCAGCCCCCTCGGGCGACGGGGTTACTCACCCCTCCACTTT	CASSPLGRRGYSPLHF	TRBV4-1	TRBJ1-6
TGTGCCAGCAGTGAAATTATACCTCCCGGGACGGGTAGACGAGAGACCCAGTACTTC	CASSEIIPPGTGRRETQYF	TRBV6-1	TRBJ2-5
TGCGCCAGCAGCCGGGACTGGAGCAATCAGCCCCAGCATTTT	CASSRDWSNQPQHF	TRBV5-1	TRBJ1-5
TGTGCCAGGGACTTCAGTGAAAATAATTCACCCCTCCACTTT	CARDFSENNSPLHF	TRBV6-3	TRBJ1-6
TGTGCCAGTAGTACAACAGCGAATAACCAAGAGACCCAGTACTTC	CASSTTANNQETQYF	TRBV19	TRBJ2-5
TGCGCCAGCAGCCAAACAGGGAATGAGCAGTTCTTC	CASSQTGNEQFF	TRBV4-3	TRBJ2-1
TGTGCCATCAGTGAGTCGCTGAGGAGAGGGGCCCCGGGGAGCTCCTACGAGCAGTACTTC	CAISESLRRGAPGSSYEQYF	TRBV10-3	TRBJ2-7
TGTGCCAGCAGTTTCAGTCAGAGGGACCGGGTCTCCGAGCAGTACTTC	CASSFSQRDRVSEQYF	TRBV27	TRBJ2-7
TGTGCCAGCAGCGAACTCCATCATGGCTACACCTTC	CASSELHHGYTF	TRBV7-3	TRBJ1-2
TGCAGTGCTGCCGGGACAGTAGCTGGGGCCAACGTCCTGACTTTC	CSAAGTVAGANVLTF	TRBV20-1	TRBJ2-6
TGTGCCAGCAGCAATGCAACAACGGGCTATGGCTACACCTTC	CASSNATTGYGYTF	TRBV7-6	TRBJ1-2
TGCAGTGCTAGAGGGGACAGGATTGGAAACACCATATATTTT	CSARGDRIGNTIYF	TRBV20-1	TRBJ1-3
TGTGCCAGCAGCGCGCAGGGGCTCAATCAGCCCCAGCATTTT	CASSAQGLNQPQHF	TRBV13	TRBJ1-5
TGTGCCAGCAGCTCGGTGAGCGGGAATGAAAAACTGTTTTTT	CASSSVSGNEKLFF	TRBV7-3	TRBJ1-4
TGTGCCAGCCCCCCCGCGGGAGCGATCTCCTACGAGCAGTACTTC	CASPPAGAISYEQYF	TRBV9	TRBJ2-7
TGCAGTGCTTCCCTGACAGGGCTTCCGCCCCAGCATTTT	CSASLTGLPPQHF	TRBV20-1	TRBJ1-5
TGTGCCAGCAGCCAAGACAGTCCGTCACCCCTCCACTTT	CASSQDSPSPLHF	TRBV3-1	TRBJ1-6
TGTGCCAGCAGCGAAGGCAAATGGACAGGGATCACAGATACGCAGTATTTT	CASSEGKWTGITDTQYF	TRBV13	TRBJ2-3
TGTGCCAGCAGCCCCGGGACAGGGACTGAAGCTTTCTTT	CASSPGTGTEAFF	TRBV13	TRBJ1-1
TGTGCCAGCAGCCGGTGCCTCGGGTACCGCCGAGTGATATATAGCAATCAGCCCCAGCATTTT	CASSRCLGYRRVIYSNQPQHF	TRBV3-1	TRBJ1-5
TGTGCCAGCAGCCAAGTCTCCCTAGCCTGCTATGGCTACACCTTC	CASSQVSLACYGYTF	TRBV3-1	TRBJ1-2
TGCAGCGTTTGTTTCCGACAGGGGTGTGGTCAGCCCCAGCATTTT	CSVCFRQGCGQPQHF	TRBV29-1	TRBJ1-5
TGTGCCAGCAGCTTGAAACCCCCTACAGATGAAAAACTGTTTTTT	CASSLKPPTDEKLFF	TRBV5-4	TRBJ1-4
TGTAAAGGGGGAGGAAACACTGAAGCTTTCTTT	CKGGGNTEAFF	TRBV30	TRBJ1-1
TGTGCCAGCAGTGACGCCCCAGGGGACAGGCCGGACCCCTACGAGCAGTACTTC	CASSDAPGDRPDPYEQYF	TRBV6-4	TRBJ2-7
TGCAGCGTTCCGATAGGAGATCCAGAGGTGCCCCAGCATTTT	CSVPIGDPEVPQHF	TRBV29-1	TRBJ1-5
TGTGCAATGGGGCCCCGGACAGGGCCCTACTATAATTCACCCCTCCACTTT	CAMGPRTGPYYNSPLHF	TRBV9	TRBJ1-6
TGTGCTAGTGGCCTCCGCCAGGGACGTCTACCGAACACCGGGGAGCTGTTTTTT	CASGLRQGRLPNTGELFF	TRBV12-5	TRBJ2-2
TGTGCCAGCAGCGCACCAGGGAGGGGTCCTAACTATGGCTACACCTTC	CASSAPGRGPNYGYTF	TRBV9	TRBJ1-2
TGTGCCAGCAGTGACAAAGTCGACGGGGAAACCTACGAGCAGTACTTC	CASSDKVDGETYEQYF	TRBV6-4	TRBJ2-7
TGTGCCAGCAGCCTTCGGGACAGGGGGTCTGGGGCCAACGTCCTGACTTTC	CASSLRDRGSGANVLTF	TRBV3-1	TRBJ2-6
TGTGCCAGCAGTGCTGAACAAGCAGATGAGCGCTCCTACAATGAGCAGTTCTTC	CASSAEQADERSYNEQFF	TRBV27	TRBJ2-1
TGTGCCAGCAGCAACAAAGCGGGACTAGGGGGGACTGAAGCTTTCTTT	CASSNKAGLGGTEAFF	TRBV12-4	TRBJ1-1
TGCGCCAGCAGCCAGGCCCTAGCGGAGTGGATATACGAGCAGTACTTC	CASSQALAEWIYEQYF	TRBV4-3	TRBJ2-7
TGTGCCAGCAGCTACGTGAATGGGACAGGGTTGAACTATGGCTACACCTTC	CASSYVNGTGLNYGYTF	TRBV7-9	TRBJ1-2
TGTGCCAGCAGCTATCTGACAGGGGCCTACGAGCAGTACTTC	CASSYLTGAYEQYF	TRBV28	TRBJ2-7
TGTGCCACCAGTGATTTGTCTGGGGGCTCCTACGAGCAGTACTTC	CATSDLSGGSYEQYF	TRBV24-1	TRBJ2-7
TGTGCCAGCAGCCAAGATATCAGGGGCTATGGCTACACCTTC	CASSQDIRGYGYTF	TRBV3-1	TRBJ1-2
TGTGCACCTACAGGGGAGGAGGGGTACGAGCAGTACTTC	CAPTGEEGYEQYF	TRBV6-2	TRBJ2-7
TGTGCCAGTAGTATTGTGAGTAGACAGGCGCTCTTC	CASSIVSRQALF	TRBV19	TRBJ2-1
TGTGCCAGCAGCTTAGGGAGGGGAGGAGCCTACGAGCAGTACTTC	CASSLGRGGAYEQYF	TRBV7-6	TRBJ2-7
TGTGCCAGCAGCGTAGCCGGGACAGGCAACGACATTCAGTACTTC	CASSVAGTGNDIQYF	TRBV9	TRBJ2-4
TGTGCCAGCAGCGCGAAGACAGGGGAATATTCACCCCTCCACTTT	CASSAKTGEYSPLHF	TRBV9	TRBJ1-6
TGTGCCAGTAGTATAGTCACAGGGGAGAGCTCCTACGAGCAGTACTTC	CASSIVTGESSYEQYF	TRBV19	TRBJ2-7
TGTGCCAGCTCACCACCTCAGGGATCTGGAAACACCATATATTTT	CASSPPQGSGNTIYF	TRBV18	TRBJ1-3
TGTGCCACATTAGGTGGCTACACCTTC	CATLGGYTF	TRBV6-6	TRBJ1-2
TGTGCCAGCAGGCTTCCCTGGAGCCTTGAAAAACTGTTTTTT	CASRLPWSLEKLFF	TRBV14	TRBJ1-4
TGTGCCAGCAAAGGACGTGGGCCGACTGAAAAACTGTTTTTT	CASKGRGPTEKLFF	TRBV28	TRBJ1-4
TGTGCCTGGAGTGTGATGTGTGACAGGGGGCCGAAGGGCCCGGATCAGCCCCAGCATTTT	CAWSVMCDRGPKGPDQPQHF	TRBV30	TRBJ1-5
TGTGCCAGCAGCTTGGCCTGGCGACGAACCCAGCATTTT	CASSLAWRRTQHF	TRBV5-6	TRBJ1-5
TGTGCCATCAGTGAGTCGGCCAGAATTTGTTCTCATGAAGCTTTCTTT	CAISESARICSHEAFF	TRBV10-3	TRBJ1-1
TGTGCCAGCAGCTTGCCCCGCTGTACTGGGCAGCCCCAGCATTTT	CASSLPRCTGQPQHF	TRBV5-4	TRBJ1-5
TGTGCCAGCAGCTGGACACGCAATGGGTACGAGCAGTACTTC	CASSWTRNGYEQYF	TRBV7-6	TRBJ2-7
TGCGCCAGCAGCTTCGCTAAAGAGACCCAGTACTTC	CASSFAKETQYF	TRBV5-1	TRBJ2-5
TGCAGTGCTAGACCGATCATCTATGGCTACACCTTC	CSARPIIYGYTF	TRBV20-1	TRBJ1-2
TGCGCCACCTGCGGGAGGATAAGGTTAGAGACCCAGTACTTC	CATCGRIRLETQYF	TRBV5-1	TRBJ2-5
TGTGCCAGCAGCCATTCCACAGGGCCGGAACTCAACACTGAAGCTTTCTTT	CASSHSTGPELNTEAFF	TRBV3-1	TRBJ1-1
TGTGCAAATGGCGGAAGGGCTCCCTACGAGCAGTACTTC	CANGGRAPYEQYF	TRBV28	TRBJ2-7
TGTGCTAGCAGCTTCCCGTCACGGGACTCCGCTAACACCGGGGAGCTGTTTTTT	CASSFPSRDSANTGELFF	TRBV7-7	TRBJ2-2
TGCAGTGCTAGGTCGTCCCCGGGACAGGGACCCTACGAGCAGTACTTC	CSARSSPGQGPYEQYF	TRBV20-1	TRBJ2-7
TGCGCCAGCACGGGGGACACCGGGGAGCTGTTTTTT	CASTGDTGELFF	TRBV10-1	TRBJ2-2
TGCAGTGCTTGGTCTTGGGGAAGGAAAGCTTTCTTT	CSAWSWGRKAFF	TRBV20-1	TRBJ1-1
TGCGCCAGCAAAGAGGACAGGATTAAGTACTTC	CASKEDRIKYF	TRBV10-1	TRBJ2-5
TGCAGTGCTCAGATTGGCTATGGCTACACCTTC	CSAQIGYGYTF	TRBV20-1	TRBJ1-2
TGTGCTAGCAGCTTAGAGACGCACGAGCAGTACTTC	CASSLETHEQYF	TRBV7-7	TRBJ2-7
TGTGCCAGCTCACCAACGTCGTCGCGATCGCGCACAGATACGCAGTATTTT	CASSPTSSRSRTDTQYF	TRBV18	TRBJ2-3
TGCGCCAGCAGTGAGTCGGGGGCAACCTATAATTCACCCCTCCACTTT	CASSESGATYNSPLHF	TRBV10-1	TRBJ1-6
TGTGCCAGCAGGTCGGAGTTAGGTAATTCACCCCTCCACTTT	CASRSELGNSPLHF	TRBV5-4	TRBJ1-6
TGCAGCGTCCAGGGAGGGAACACCGGGGAGCTGTTTTTT	CSVQGGNTGELFF	TRBV29-1	TRBJ2-2
TGTGCCAGCAGTTTATGGTCGATCCCCGGGACATACACAGATACGCAGTATTTT	CASSLWSIPGTYTDTQYF	TRBV27	TRBJ2-3
TGCGCCAGCAGTGAGTCTGGGGGACTTTATTTTTATAATTCACCCCTCCACTTT	CASSESGGLYFYNSPLHF	TRBV10-1	TRBJ1-6
TGTGCCAGCAGCGCGCCACTCAGGGAGAGGGGGGGTGGGGCGATGAACACTGAAGCTTTCTTT	CASSAPLRERGGGAMNTEAFF	TRBV7-9	TRBJ1-1
TGTGCCATTGGGGAGCGGTTCGGACCCCTCTCTGGAAACACCATATATTTT	CAIGERFGPLSGNTIYF	TRBV6-5	TRBJ1-3
TGCAGCGTTCTCCGGACAGGGAGGGAGCAGTACTTC	CSVLRTGREQYF	TRBV29-1	TRBJ2-7
TGCAGTGCTAGAGATGACACTAGCGGGGGAGGGAATACGCAGTATTTT	CSARDDTSGGGNTQYF	TRBV20-1	TRBJ2-3
TGTGCCAGCAGCCAAGACCGACCCCGACACAATGAGCAGTTCTTC	CASSQDRPRHNEQFF	TRBV4-2	TRBJ2-1
TGTGCCAGCAGCGGTGGTCGACAGGGCCGTCCCGCTTCCTACGAGCAGTACTTC	CASSGGRQGRPASYEQYF	TRBV7-9	TRBJ2-7
TGTGCCAGCAGTTACTGGGGGGCAGGTCAGCCCCAGCATTTT	CASSYWGAGQPQHF	TRBV6-5	TRBJ1-5
TGTGCCAGCAGTGTGGGGCCGCTTGGCTACACCTTC	CASSVGPLGYTF	TRBV2	TRBJ1-2
TGTGCCAGCAGTGACTCAATGGAGTGGTGGGACAGGGCTGGAAACACCATATATTTT	CASSDSMEWWDRAGNTIYF	TRBV6-4	TRBJ1-3
TGTGCCAGCAGAGAGTTTCTGGGGGGGGTTCCTGCTAGTACGCAGTATTTT	CASREFLGGVPASTQYF	TRBV9	TRBJ2-3
TGTGCCAGCAGCGTAGAATTGGGCGAAGAAAGGGGATTCCGAACTTCCCAGCTGGGAAATCACATTCAGTACTTC	CASSVELGEERGFRTSQLGNHIQYF	TRBV9	TRBJ2-4
TGCGCCAGCAGCCAAGTTGAGGGGGGGGAGACCCAGTACTTC	CASSQVEGGETQYF	TRBV4-1	TRBJ2-5
TGTGCCAGCAGCTTGGATTTCTCAAAGACAGGGGGCGGGGCCTACGAGCAGTACTTC	CASSLDFSKTGGGAYEQYF	TRBV5-4	TRBJ2-7
TGTGCCAGCAGACTTCCCAGGGGTAGCGCGATCTCCTATAATTCACCCCTCCACTTT	CASRLPRGSAISYNSPLHF	TRBV6-5	TRBJ1-6
TGTGCCAGCAGCCTGCCTGGGACTAGCGGTTTTTGTATGAAGAACACCGGGGAGCTGTTTTTT	CASSLPGTSGFCMKNTGELFF	TRBV3-1	TRBJ2-2
TGTGCCACCAGCAGAGGTTCCATTCGGGAGGAAGCTACTGAAGCTTTCTTT	CATSRGSIREEATEAFF	TRBV15	TRBJ1-1
TGTGCCAGCATCTCGGTTCAAGCTGGAAACACCATATATTTT	CASISVQAGNTIYF	TRBV28	TRBJ1-3
TGCAGTGCTAGTGGTAGACAGGGAAACACCGGGGAGCTGTTTTTT	CSASGRQGNTGELFF	TRBV20-1	TRBJ2-2
TGTGCCAGCAGTACCCCTTGGGGACCAACTAATGAAAAACTGTTTTTT	CASSTPWGPTNEKLFF	TRBV6-3	TRBJ1-4
TGCAGTGCTAGCTCGGCTCGGGATGGCTACACCTTC	CSASSARDGYTF	TRBV20-1	TRBJ1-2
TGTGCCAGCAGTTACGCGGGAGACAATCAGCCCCAGCATTTT	CASSYAGDNQPQHF	TRBV6-5	TRBJ1-5
TGTGCCAGCAGCTGGGAGTGGGGGGACAAGCAAGAGACCCAGTACTTC	CASSWEWGDKQETQYF	TRBV7-8	TRBJ2-5
TGTGCCGACAGGGGGGTCGTGGTAGAGACCCAGTACTTC	CADRGVVVETQYF	TRBV6-2	TRBJ2-5
TGCGCCAGCAGCAACATCGACAGGCGAGGTAATTCACCCCTCCACTTT	CASSNIDRRGNSPLHF	TRBV5-1	TRBJ1-6
TGCGCCAGCAGCTGGCGGGAAAAAGGCACTGAGCAGTTCTTC	CASSWREKGTEQFF	TRBV5-1	TRBJ2-1
TGTGCCTGGGGGGACGAGCAGTACTTC	CAWGDEQYF	TRBV30	TRBJ2-7
TGTGCCAGCAGGTGGGACAGGGGAGGGAGGTGTGGGGCCAACGTCCTGACTTTC	CASRWDRGGRCGANVLTF	TRBV6-5	TRBJ2-6
TGCAGTGCTAGAGGGGGTCCTCCGGGACAGGGGGGTGGCTACACCTTC	CSARGGPPGQGGGYTF	TRBV20-1	TRBJ1-2
TGTGCCACCACGGACACTCAAAACTATGGCTACACCTTC	CATTDTQNYGYTF	TRBV24-1	TRBJ1-2
TGCGCCAGCAGTGAAAACGGGCTTAGTCTGGCTCCAGAAAAACTGTTTTTT	CASSENGLSLAPEKLFF	TRBV10-2	TRBJ1-4
TGTGCCAGCAGCCCTCCGCGGGACAGGGGGGATGGCTACACCTTC	CASSPPRDRGDGYTF	TRBV7-9	TRBJ1-2
TGTGCCAGTATACGGGGGCGGTATAATGAAAAACTGTTTTTT	CASIRGRYNEKLFF	TRBV19	TRBJ1-4
TGCGCCAGCGGGACAGGGACCTACGAGCAGTACTTC	CASGTGTYEQYF	TRBV5-1	TRBJ2-7
TGCAGTGCGCTAGGAGGGACAGAGACCCAGTACTTC	CSALGGTETQYF	TRBV20-1	TRBJ2-5
TGTGCCAGCCGGACTAGCGGCTCCTACGAGCAGTACTTC	CASRTSGSYEQYF	TRBV27	TRBJ2-7
TGTGCCAGCGACAGCACTCAGCACACCGGGGAGCTGTTTTTT	CASDSTQHTGELFF	TRBV2	TRBJ2-2
TGTCACGTTGGGAGGGACGGGGAAGCATACGCCTACGAGCAGTACTTC	CHVGRDGEAYAYEQYF	TRBV19	TRBJ2-7
TGTGCCATCAGTGTGGGTGAGCCTCCGGGACACTATGGCTACACCTTC	CAISVGEPPGHYGYTF	TRBV10-3	TRBJ1-2
TGTGCCAGCAGCTTAGCACGTAGACAGGATCAGCCCCAGCATTTT	CASSLARRQDQPQHF	TRBV7-9	TRBJ1-5
TGCAGCGTGATAAGGGTACTACCACAGGGGAGTCGGTCGTGTGGCTACACCTTC	CSVIRVLPQGSRSCGYTF	TRBV29-1	TRBJ1-2
TGTGCCAGCAGTGACTCGAACAGAGGGCATACGAACACTGAAGCTTTCTTT	CASSDSNRGHTNTEAFF	TRBV6-4	TRBJ1-1
TGTGCCAGCAGCTTGAGGGCGGACACCATATATTTT	CASSLRADTIYF	TRBV7-6	TRBJ1-3
TGCGCCAGCAGAGAAGAAGGAGCCCGACACACCGGGGAGCTGTTTTTT	CASREEGARHTGELFF	TRBV5-1	TRBJ2-2
TGTGCCAGCAGCCAAGACTCGGAACGGGACAGTCAGCCCCAGCATTTT	CASSQDSERDSQPQHF	TRBV3-1	TRBJ1-5
TGCGCCAGCAGCGGTAAGCGGCGGGACAGGGGGGGTAATGAAAAACTGTTTTTT	CASSGKRRDRGGNEKLFF	TRBV10-1	TRBJ1-4
TGTGCCAGCACCGCGCTCGGGGAGGGGAGCTCCTACGAGCAGTACTTC	CASTALGEGSSYEQYF	TRBV5-4	TRBJ2-7
TGTGCCAGCAGTTTCGGTTCTAGCGGAAGGGCCTGGGTAGAGACCCAGTACTTC	CASSFGSSGRAWVETQYF	TRBV12-3	TRBJ2-5
TGTGCCAGCAGCCCGGGACGGGTCTCCTACAATGAGCAGTTCTTC	CASSPGRVSYNEQFF	TRBV13	TRBJ2-1
TGTGCCACCAGCAGAGATATTTGTTCCCAACCTGGACAGGGCTACGAGCAGTACTTC	CATSRDICSQPGQGYEQYF	TRBV15	TRBJ2-7
TGTGCCAGCAGCAAACTAAGACCGCACATTCAGTACTTC	CASSKLRPHIQYF	TRBV7-6	TRBJ2-4
TGTGCCAGCAGTGACCCCCCAGTTGGGGGGAATAGCACAGATACGCAGTATTTT	CASSDPPVGGNSTDTQYF	TRBV6-1	TRBJ2-3
TGTGCCAGCAGTGCAGTCAGCGGTATCGAGCAGTACTTC	CASSAVSGIEQYF	TRBV6-3	TRBJ2-7
TGTGCCAGCAGTTACGGGGCGCAGGGGAGGTTAAACTATGGCTACACCTTC	CASSYGAQGRLNYGYTF	TRBV6-5	TRBJ1-2
TGTGCCAGCATAGGCAGGGATGGCTACACCTTC	CASIGRDGYTF	TRBV9	TRBJ1-2
TGTGCCAGCAGCAAAGTCAGACTGTTCTATGAGCAGTACTTC	CASSKVRLFYEQYF	TRBV5-6	TRBJ2-7
TGTGCCAGCAGTAGGAAACATAGCAATCAGCCCCAGCATTTT	CASSRKHSNQPQHF	TRBV6-1	TRBJ1-5
TGTGCCTGGAGTGTAAAGGGGGTACATGGCTACACCTTC	CAWSVKGVHGYTF	TRBV30	TRBJ1-2
TGTGCCAGCAGCCAAATCACTCCTTACACTGAAGCTTTCTTT	CASSQITPYTEAFF	TRBV3-1	TRBJ1-1
TGTGCCAGCAGCCGAGGGGACAGGGGGCGGAACACTGAAGCTTTCTTT	CASSRGDRGRNTEAFF	TRBV7-9	TRBJ1-1
TGCGCCAGCAGTACCCAGGGAGGGCCTGGAAACACCATATATTTT	CASSTQGGPGNTIYF	TRBV10-1	TRBJ1-3
TGTGCCAGTAGTATAGGAGACAAGGAAAAACTGTTTTTT	CASSIGDKEKLFF	TRBV19	TRBJ1-4
TGTGCCAGCAGCGGGGATAATTCACCCCTCCACTTT	CASSGDNSPLHF	TRBV2	TRBJ1-6
TGTGCCTGGAAACCCAGGTGGGAAACAACTAATGAAAAACTGTTTTTT	CAWKPRWETTNEKLFF	TRBV30	TRBJ1-4
TGTGCCAGCAGCCACGCAGCTGGTAAGAAGGACAATCAGCCCCAGCATTTT	CASSHAAGKKDNQPQHF	TRBV3-1	TRBJ1-5
TGTGCCACCAGGTCGGGGGGCGGAGGCTACACCTTC	CATRSGGGGYTF	TRBV24-1	TRBJ1-2
TGCGCCAGCAGATTTCGCAGGCCGAGCGAGCAGTACTTC	CASRFRRPSEQYF	TRBV10-2	TRBJ2-7
TGTGCCAGCATGAACTCCTCCTACAATGAGCAGTTCTTC	CASMNSSYNEQFF	TRBV6-5	TRBJ2-1
TGTGCCAGCAGCTTACCGGGGGCGTACGAAAAACTGTTTTTT	CASSLPGAYEKLFF	TRBV27	TRBJ1-4
TGCGCCAGCAGCCAAGAGTCCCTCTGGATTCCCTACGAGCAGTACTTC	CASSQESLWIPYEQYF	TRBV4-1	TRBJ2-7
TGTGCCAGCAGTGGAATCCGGGACAGTCCGGAGAACACTGAAGCTTTCTTT	CASSGIRDSPENTEAFF	TRBV6-4	TRBJ1-1
TGTGCCAGCAGCTTCTATCTGGTATTTCAGCCCCAGCATTTT	CASSFYLVFQPQHF	TRBV7-2	TRBJ1-5
TGTGCCAGCAGCTTAAGAGGGGAGACCCAGTACTTC	CASSLRGETQYF	TRBV5-5	TRBJ2-5
TGTGCCAGCAGCTTCCCGGGAGGGCATTCACCCCTCCACTTT	CASSFPGGHSPLHF	TRBV7-9	TRBJ1-6
TGTGCCAGCAGTTTACCACGACTAGAGTATAGGATATACAATGAGCAGTTCTTC	CASSLPRLEYRIYNEQFF	TRBV12-4	TRBJ2-1
TGCAGCGCCCGGGACAGGGAGACCCAGTACTTC	CSARDRETQYF	TRBV29-1	TRBJ2-5
TGTGCCAGCTCAGGGGGAGGGACAGGGATTATGTGTGAAGATACGCAGTATTTT	CASSGGGTGIMCEDTQYF	TRBV18	TRBJ2-3
TGTGCCAGCAGTCGGGGGATCACAGATACGCAGTATTTT	CASSRGITDTQYF	TRBV6-5	TRBJ2-3
TGTGCCATCATTCTGGGACAGGTACTGGATAATCAGCCCCAGCATTTT	CAIILGQVLDNQPQHF	TRBV10-3	TRBJ1-5
TGTGCCAGCAGCGCTCTGGGAGCTAACTGGAACACCGGGGAGCTGTTTTTT	CASSALGANWNTGELFF	TRBV13	TRBJ2-2
TGTGCCAGCAGCCCGACAGGGGCAAAGAACACCGGGGAGCTGTTTTTT	CASSPTGAKNTGELFF	TRBV11-3	TRBJ2-2
TGTGCCAGCAGCCAAGATAGTCTCGTTAGAAACTCCAGGGCGCCTGGGGAGCTGTTTTTT	CASSQDSLVRNSRAPGELFF	TRBV14	TRBJ2-2
TGTGCCAGCAGTGCCCAAATCCACAGGGTCTGGGGTCATCAGCCCCAGCATTTT	CASSAQIHRVWGHQPQHF	TRBV2	TRBJ1-5
TGTGCCAGCAGGACTGCTTTCTTT	CASRTAFF	TRBV5-4	TRBJ1-1
TGCAGTGCTTTGGGGGATAGCAATCAGCCCCAGCATTTT	CSALGDSNQPQHF	TRBV20-1	TRBJ1-5
TGTGCCAGCAGTGAAGTAAAGGACGGCATCGAGCAGTACTTC	CASSEVKDGIEQYF	TRBV2	TRBJ2-7
TGTGCCAGCAGTGACCCTTTATTGGGACTTCCTGGCTACACCTTC	CASSDPLLGLPGYTF	TRBV6-4	TRBJ1-2
TGTGCCACCCCTTTCCCCGGGAATAATAGCAATCAGCCCCAGCATTTT	CATPFPGNNSNQPQHF	TRBV24-1	TRBJ1-5
TGTGCCAGCGGTGTAGGGGGGTTAGTGAACACTGAAGCTTTCTTT	CASGVGGLVNTEAFF	TRBV11-2	TRBJ1-1
TGTGCCATCAGGACTTTCAACTGGATCTCTTACAATTCACCCCTCCACTTT	CAIRTFNWISYNSPLHF	TRBV10-3	TRBJ1-6
TGTGCCAGCAGCGGACAGGGCCCTGGGGCCAACGTCCTGACTTTC	CASSGQGPGANVLTF	TRBV7-3	TRBJ2-6
TGCAGTGCTGACGTATTAGTGGCTAGCACAGATACGCAGTATTTT	CSADVLVASTDTQYF	TRBV20-1	TRBJ2-3
TGCGCCAGCAGTGAACCAAGGGGGATTAGGGGGTACGAGCAGTACTTC	CASSEPRGIRGYEQYF	TRBV10-1	TRBJ2-7
TGTGCCAGCAGTGATAAGGGATGCAACACTGAAGCTTTCTTT	CASSDKGCNTEAFF	TRBV25-1	TRBJ1-1
TGTGCCAGCAGTCACAGGACGGATCAGCCCCAGCATTTT	CASSHRTDQPQHF	TRBV6-1	TRBJ1-5
TGCAGTGCTAGAGACGTGGGGCGGCGCTCCACAGATACGCAGTATTTT	CSARDVGRRSTDTQYF	TRBV20-1	TRBJ2-3
TGTGCACCCCTTGGACAGTGTTTTGAGAACACTGAAGCTTTCTTT	CAPLGQCFENTEAFF	TRBV30	TRBJ1-1
TGTGCCAGCAGGACTAGCGGGATCGGGGGCACAGATACGCAGTATTTT	CASRTSGIGGTDTQYF	TRBV27	TRBJ2-3
TGTGCCAGCAGCATGGGGGAGACCTACAATGAGCAGTTCTTC	CASSMGETYNEQFF	TRBV5-6	TRBJ2-1
TGTGCCAGCAGCTTTCGGAACCGGGACAGCAATGAAAAACTGTTTTTT	CASSFRNRDSNEKLFF	TRBV5-6	TRBJ1-4
TGTGCCAGCAGCTTGGCATGTGGGGCTTACACCGGGGAGCTGTTTTTT	CASSLACGAYTGELFF	TRBV5-4	TRBJ2-2
TGTGCTAGTGGTTTAGGGGGGAGGGACAATGAGCAGTTCTTC	CASGLGGRDNEQFF	TRBV12-5	TRBJ2-1
TGTGCCAGCCTGCGAGGGGGACTATCACCCCTCCACTTT	CASLRGGLSPLHF	TRBV9	TRBJ1-6
TGTGCCAGCAGCTTCCCACCAGACAGGGGGACCTACGAGCAGTACTTC	CASSFPPDRGTYEQYF	TRBV5-6	TRBJ2-7
TGTGGGGCGAGGGCATCTGAAGCTTTCTTT	CGARASEAFF	TRBV5-4	TRBJ1-1
TGCGCCAGCAGCCATGCCGGACGGGTAGACACTGAAGCTTTCTTT	CASSHAGRVDTEAFF	TRBV4-1	TRBJ1-1
TGTGCCACCAGTGATATCGGACAGGGTACTCCTGAAAAACTGTTTTTT	CATSDIGQGTPEKLFF	TRBV24-1	TRBJ1-4
TGTGCCAGCCCTGACGGTCAGCGCAATCAGCCCCAGCATTTT	CASPDGQRNQPQHF	TRBV6-5	TRBJ1-5
TGCAGCGTTGAGTGCCGTAGTGGGGGGACGCGATACGAGCAGTACTTC	CSVECRSGGTRYEQYF	TRBV29-1	TRBJ2-7
