TGTGCCAGCAGTTTGAAAGCATCATCCAGCCGGTCGTGCAATCAGCCCCAGCATTTT	CASSLKASSSRSCNQPQHF	TRBV6-8	TRBJ1-5
TGTGCCACCAGTGGATCGGAGACCGGGGAGCTGTTTTTT	CATSGSETGELFF	TRBV24-1	TRBJ2-2
TGCAGCGCAGACCTGACAGGGGGCTTTGCTTTCAAACCCCTCCACTTT	CSADLTGGFAFKPLHF	TRBV29-1	TRBJ1-6
TGCTGGAACACCGGGGATAGCAGGAGCTCCTACGAGCAGTACTTC	CWNTGDSRSSYEQYF	TRBV19	TRBJ2-7
TGTGCCAGCAGTGCCAGCCGTAATAGGGGGAGCACAGATACGCAGTATTTT	CASSASRNRGSTDTQYF	TRBV6-5	TRBJ2-3
TGTGCCAGCTCACCACCCTGGACTAGCGGGAGGGAAGTCACCGGGGAGCTGTTTTTT	CASSPPWTSGREVTGELFF	TRBV18	TRBJ2-2
TGTGCCAGCAGGGTCCTCCGGGACAGTTCAACTGGAAACACCATATATTTT	CASRVLRDSSTGNTIYF	TRBV12-3	TRBJ1-3
TGTGCCAGCAGCGTACCATTGGAGATAGGCAGGGGCGGGGCGGCCGGTTCCTACGAGCAGTACTTC	CASSVPLEIGRGGAAGSYEQYF	TRBV9	TRBJ2-7
TGTGCCAGCAGCTTAGATGGGGGGAGGCCACCCCTCCACTTT	CASSLDGGRPPLHF	TRBV11-3	TRBJ1-6
TGTGCCAGCTCACTCCCGTACGGGGTAGGGGGGAGCAATCAGCCCCAGCATTTT	CASSLPYGVGGSNQPQHF	TRBV18	TRBJ1-5
TGCGCCAGCAGCGTAAGACAGGGGGGAAACACCATATATTTT	CASSVRQGGNTIYF	TRBV5-1	TRBJ1-3
TGTGCCAGCCTATCAGAGGAGCGAAGCAATCAGCCCCAGCATTTT	CASLSEERSNQPQHF	TRBV6-4	TRBJ1-5
TGTGCCAGTAGTGACAATGAGCAGTTCTTC	CASSDNEQFF	TRBV19	TRBJ2-1
TGTGCCAGCAGCTTAGCCGGCGAAGACAGGATGCCCCAGCATTTT	CASSLAGEDRMPQHF	TRBV11-2	TRBJ1-5
TGTGCCAGCGAGGGGGGGCAGGGGCCCGGGCCAACTAATGAAAAACTGTTTTTT	CASEGGQGPGPTNEKLFF	TRBV9	TRBJ1-4
TGTGCCAGCAGCGGGCCGGGATTTACGCAGTATTTT	CASSGPGFTQYF	TRBV9	TRBJ2-3
TGTGCCAGCCCTTCGAGGGGAAATGACTATGGCTACACCTTC	CASPSRGNDYGYTF	TRBV13	TRBJ1-2
TGTGCCAGCAGCCAAGAACAATGCGTTACGCTAGCGGGAGACAAAAACACCGGGGAGCTGTTTTTT	CASSQEQCVTLAGDKNTGELFF	TRBV14	TRBJ2-2
TGTGCCAGCAGCATCCCGTGCGAAGGCTCGACCTACGAGCAGTACTTC	CASSIPCEGSTYEQYF	TRBV13	TRBJ2-7
TGTGCCAGCAGCCCTTATGTAAACGACAATGAGCAGTTCTTC	CASSPYVNDNEQFF	TRBV7-9	TRBJ2-1
TGCAGCGTTGAATCTTCCAGCGGGAGTCTGACTTTTTGGGATCAGCCCCAGCATTTT	CSVESSSGSLTFWDQPQHF	TRBV29-1	TRBJ1-5
TGTGCCAGCAGTGGGCATCTCAGGGAGCAGCCCCAGCATTTT	CASSGHLREQPQHF	TRBV2	TRBJ1-5
TGTGCCACCAGCAGGACCTCCGCAGACTACGAGCAGTACTTC	CATSRTSADYEQYF	TRBV15	TRBJ2-7
TGTGCCAGCAGTTCTAGCGGCTTGTCTAGCACAGATACGCAGTATTTT	CASSSSGLSSTDTQYF	TRBV28	TRBJ2-3
TGCGCCAGCAGCCGCGATTCGGGGGCGGGGGGGGTAGACTACGAGCAGTACTTC	CASSRDSGAGGVDYEQYF	TRBV4-1	TRBJ2-7
TGTGCCAGCAGCCTCAGGGACAGGGCGGTTGCAGATACGCAGTATTTT	CASSLRDRAVADTQYF	TRBV3-1	TRBJ2-3
TGTGCCAGCAGCGCTCCGGACAGGGAGTACGAGCAGTACTTC	CASSAPDREYEQYF	TRBV9	TRBJ2-7
TGTGCCAGCAGCTTGTTCAGGGGGCTGGGCGGCACAGATACGCAGTATTTT	CASSLFRGLGGTDTQYF	TRBV7-9	TRBJ2-3
TGTGCCAGCAGAGGTGACAATGAGCAGTTCTTC	CASRGDNEQFF	TRBV6-1	TRBJ2-1
TGTGCCAGTAGTGGAAGCCGGGACAGCCCATTTGGGCCCCAGCATTTT	CASSGSRDSPFGPQHF	TRBV19	TRBJ1-5
TGTGCCACCAGTGATCGGCTTATGACGGTGTACAATGAGCAGTTCTTC	CATSDRLMTVYNEQFF	TRBV24-1	TRBJ2-1
TGTGCCACGGGGGACAGTCAAGAGCAGTTCTTC	CATGDSQEQFF	TRBV24-1	TRBJ2-1
TGTGCCAGCAGCTTGTGCCACCTCCAGGCTATTACCTCTGGAAACACCATATATTTT	CASSLCHLQAITSGNTIYF	TRBV5-8	TRBJ1-3
TGTGCCAGCAGGAGAATCAAGGGAGAAGGGGGCTACACCTTC	CASRRIKGEGGYTF	TRBV13	TRBJ1-2
TGTGCCAGCAGCGGACGCTACGAGCAGTACTTC	CASSGRYEQYF	TRBV6-5	TRBJ2-7
TGTGCCAGCAGCCGCAGATCCGAAAATGGCTACACCTTC	CASSRRSENGYTF	TRBV12-3	TRBJ1-2
TGTGCCACCAGCAGAGAGGGTCTAGTGCTTGGAAACATTCAGTACTTC	CATSREGLVLGNIQYF	TRBV15	TRBJ2-4
TGTGCCAGCAGCAGCGGGGGGGACTCCTACGAGCAGTACTTC	CASSSGGDSYEQYF	TRBV13	TRBJ2-7
TGTGCCGGAGCAGGTCTTCGCTTCTATGGCTACACCTTC	CAGAGLRFYGYTF	TRBV6-5	TRBJ1-2
TGCGCCAGCAAGGTACAAAGGCTGTACGAGCAGTACTTC	CASKVQRLYEQYF	TRBV10-1	TRBJ2-7
TGCGCCAGCATACCGACAGGCGACGAAAAACTGTTTTTT	CASIPTGDEKLFF	TRBV10-1	TRBJ1-4
TGTGCCAGCAGCCAAGACTGGGGAAGGAACACTGAAGCTTTCTTT	CASSQDWGRNTEAFF	TRBV3-1	TRBJ1-1
TGTGCCAGTACTCCCCTATTAGCTGAAGCTTTCTTT	CASTPLLAEAFF	TRBV19	TRBJ1-1
TGCGCCAGCAGCTTGTCTCGCGTTCTCTCCTACGAGCAGTACTTC	CASSLSRVLSYEQYF	TRBV5-1	TRBJ2-7
TGTGCCAGCAGGACCGGGACAGGTAACACCATATATTTT	CASRTGTGNTIYF	TRBV16	TRBJ1-3
TGCGCCAGCAGTGAGGGAACCCAGGGATCTCTCCGGGGTATGAACACTGAAGCTTTCTTT	CASSEGTQGSLRGMNTEAFF	TRBV10-2	TRBJ1-1
TGTGCCAGCAGCGTCATTCAGGCTATGGACAATTCACCCCTCCACTTT	CASSVIQAMDNSPLHF	TRBV7-3	TRBJ1-6
TGTGCCAGCTCACCACCGGAGGGCGCCTACGAGCAGTACTTC	CASSPPEGAYEQYF	TRBV18	TRBJ2-7
TGTGCCAGCAGCTTACCCAGGACAGAGTACGACTATGGCTACACCTTC	CASSLPRTEYDYGYTF	TRBV7-2	TRBJ1-2
TGTGCCAGCAGTTTCATTCGCTACAAAGGGACAGGGGCCCCTTTCCGCAATCAGCCCCAGCATTTT	CASSFIRYKGTGAPFRNQPQHF	TRBV6-6	TRBJ1-5
TGCCTAGAAAACGACCCAACAATGAATGAAAAACTGTTTTTT	CLENDPTMNEKLFF	TRBV20-1	TRBJ1-4
TGTGCCAGCAGGGGGGTAGGCAACACCGGGGAGCTGTTTTTT	CASRGVGNTGELFF	TRBV6-6	TRBJ2-2
TGTGCCACCAGTGTCGGGTTCTATGGCTACACCTTC	CATSVGFYGYTF	TRBV24-1	TRBJ1-2
TGTGCCAGCAGCGAACACCCGGGGGGCAGTGGAAAGAATGAAAAACTGTTTTTT	CASSEHPGGSGKNEKLFF	TRBV11-3	TRBJ1-4
TGTGCCAGCAGTTGGAAAAATCGGAATGAGCAGTTCTTC	CASSWKNRNEQFF	TRBV6-9	TRBJ2-1
TGCGCCAGCAGCTCACCCGGGCGGGAATCTGGGGCCAACGTCCTGACTTTC	CASSSPGRESGANVLTF	TRBV5-1	TRBJ2-6
TGCGCCAGCAGCCCCGACCTTACCGCGGGACTCCATGAGCAGTTCTTC	CASSPDLTAGLHEQFF	TRBV4-3	TRBJ2-1
TGTGCCAGAGACGACACTGAAGCTTTCTTT	CARDDTEAFF	TRBV28	TRBJ1-1
TGTGCCAGCAGTCCCGGCTTTGGGACAGACACTGAAGCTTTCTTT	CASSPGFGTDTEAFF	TRBV12-3	TRBJ1-1
TGCGCCAGCAGCCTTGGGTTCCCGGGACAGGGTCTGAACACTGAAGCTTTCTTT	CASSLGFPGQGLNTEAFF	TRBV4-1	TRBJ1-1
TGCGCCAGGTGTCGGAGGGGGAACACTGAAGCTTTCTTT	CARCRRGNTEAFF	TRBV10-1	TRBJ1-1
TGTGCCAGCAGCGTAAGACAGGAGTACACTGAAGCTTTCTTT	CASSVRQEYTEAFF	TRBV9	TRBJ1-1
TGTGCCAGCAGCGTAACTAGCGGGAGGCGCAATCAGCCCCAGCATTTT	CASSVTSGRRNQPQHF	TRBV12-4	TRBJ1-5
TGTGCCAGCAGCGGTGCAGACAACACTGAAGCTTTCTTT	CASSGADNTEAFF	TRBV7-3	TRBJ1-1
TGTGCCAGCAGCCACGACGAGCAGTACTTC	CASSHDEQYF	TRBV7-6	TRBJ2-7
TGTGCCAGCAGTTCCGCCCGGGTAGAGGTCCTGTACAATGAGCAGTTCTTC	CASSSARVEVLYNEQFF	TRBV27	TRBJ2-1
TGTGCCAGCAGCTTAGCTGCCAGCGGGCAGAGCTCCTACAATGAGCAGTTCTTC	CASSLAASGQSSYNEQFF	TRBV7-8	TRBJ2-1
TGTGCCAGCAGCTGTCACAGGGGAGAAAGGTATGGCTACACCTTC	CASSCHRGERYGYTF	TRBV13	TRBJ1-2
TGTGCCAGCAGCCAAGCAGGAGGGGACACTGAAGCTTTCTTT	CASSQAGGDTEAFF	TRBV3-1	TRBJ1-1
TGTGCCAGCAGCTTCCCTTTGAAAGCGGGAAGAGAGGACACAGATACGCAGTATTTT	CASSFPLKAGREDTDTQYF	TRBV7-9	TRBJ2-3
TGTGCCTGGGATGTGACAGGGATTTGCAATCAGCCCCAGCATTTT	CAWDVTGICNQPQHF	TRBV30	TRBJ1-5
TGTGCCAGCAGCTGGGGGGCGTGCAACACAGATACGCAGTATTTT	CASSWGACNTDTQYF	TRBV5-4	TRBJ2-3
TGTGCGTTCCCCTATACGCCGGGAAACACCATATATTTT	CAFPYTPGNTIYF	TRBV5-6	TRBJ1-3
TGTGCCAGCAGTTTTAGGGAAATGAACACTGAAGCTTTCTTT	CASSFREMNTEAFF	TRBV27	TRBJ1-1
TGTGCCAGCAGTTATCCGGGGGAATCGTTAGCTAACTATGGCTACACCTTC	CASSYPGESLANYGYTF	TRBV6-3	TRBJ1-2
TGTGCCAGCAGCATTTGGAGGGACAGCCTGGGTACACACTACGAGCAGTACTTC	CASSIWRDSLGTHYEQYF	TRBV7-3	TRBJ2-7
TGTGCCATCAACGTATGCGGGAGGGGGGGTGAGCAGTTCTTC	CAINVCGRGGEQFF	TRBV10-3	TRBJ2-1
TGTGCCAGCAGCTTCTCGACCCACTTGGGTAGCTCCTATAATTCACCCCTCCACTTT	CASSFSTHLGSSYNSPLHF	TRBV5-6	TRBJ1-6
TGTGCCAGCAGCCAAGATAAACTAGCGGGGGGGCCCTACGAGCAGTACTTC	CASSQDKLAGGPYEQYF	TRBV3-1	TRBJ2-7
TGTGCTAGTGGTTTGGTAGAGACAGGGGGCCGCACTGAAGCTTTCTTT	CASGLVETGGRTEAFF	TRBV12-5	TRBJ1-1
TGTGCCAGACTTAGCCCTGTTCCCTTTAGCTCTGGGGCCAACGTCCTGACTTTC	CARLSPVPFSSGANVLTF	TRBV19	TRBJ2-6
TGTGCCTGGAGTGTACCGGGACTAGTATCTTCCTACAATGAGCAGTTCTTC	CAWSVPGLVSSYNEQFF	TRBV30	TRBJ2-1
TGTGCCATCAGCGGGGGGCCCAGATGCACAGATACGCAGTATTTT	CAISGGPRCTDTQYF	TRBV10-3	TRBJ2-3
TGTGCCAGCAGGACCTGCCCGGGCCCGGGTCAAGAGACCCAGTACTTC	CASRTCPGPGQETQYF	TRBV6-8	TRBJ2-5
TGTGCCACCAGCGTCGGGAGGGCCCTAACGGATCGGACACCCCTCCACTTT	CATSVGRALTDRTPLHF	TRBV24-1	TRBJ1-6
TGTGCCAGCAGCCAACACAGGGGGTACAGGTTCGAGACCCAGTACTTC	CASSQHRGYRFETQYF	TRBV3-1	TRBJ2-5
TGTGCCACCAGCAGAGATGTGGGGGGGCCTGGGAACACCGGGGAGCTGTTTTTT	CATSRDVGGPGNTGELFF	TRBV15	TRBJ2-2
TGTGCCAGCAGCTTATCTGATCAGCTTTCCTACGAGCAGTACTTC	CASSLSDQLSYEQYF	TRBV5-8	TRBJ2-7
TGCGCCAGCAGCCAAGATCCGTTGGCGACAGGGGATGGGAAAGTGAACACTGAAGCTTTCTTT	CASSQDPLATGDGKVNTEAFF	TRBV4-1	TRBJ1-1
TGCAGCGGTTTACTCTGCAGGGTGATTAATGAAAAACTGTTTTTT	CSGLLCRVINEKLFF	TRBV29-1	TRBJ1-4
TGTGCCACCAGTGATTCACGCGGGAGGTATTTAGAGACCCAGTACTTC	CATSDSRGRYLETQYF	TRBV24-1	TRBJ2-5
TGTGCCACCAGCTTTGGGGCTCCTGAAGCTTTCTTT	CATSFGAPEAFF	TRBV24-1	TRBJ1-1
TGTGCCAGCAGTTACACTAGCGGGTCCTCCTACAATGAGCAGTTCTTC	CASSYTSGSSYNEQFF	TRBV6-3	TRBJ2-1
TGTGCCAGCAGCAATGCCAGACAGGGGAGTGCGATTTATAATTCACCCCTCCACTTT	CASSNARQGSAIYNSPLHF	TRBV13	TRBJ1-6
TGTGCCAGCAGCGGGGAAGTGGAGGGGGCTCCCTTCAACGAGCAGTACTTC	CASSGEVEGAPFNEQYF	TRBV13	TRBJ2-7
TGTGCCAGCAGCCATAGTACAATGAACACTGAAGCTTTCTTT	CASSHSTMNTEAFF	TRBV3-1	TRBJ1-1
TGTGCCACCAGTAAAGGGGGGCCGGATGTAGCCAAAAACATTCAGTACTTC	CATSKGGPDVAKNIQYF	TRBV24-1	TRBJ2-4
TGTGCCAGCAGCTTAGTTTTTTTTCGGACTAGCGGGGTCGGATCCTACGAGCAGTACTTC	CASSLVFFRTSGVGSYEQYF	TRBV7-2	TRBJ2-7
TGTGCTAGTCCCCGGGGGGAGTTGGGTCAAGCTTTCTTT	CASPRGELGQAFF	TRBV12-5	TRBJ1-1
TGCGCCAGCAGTGGACAGGCCTACGAGCAGTACTTC	CASSGQAYEQYF	TRBV10-1	TRBJ2-7
TGCGCCAGCAGCTTGGAAGTCCGTACGGGGGCCCAAGGACCCTCTGGAAACACCATATATTTT	CASSLEVRTGAQGPSGNTIYF	TRBV5-1	TRBJ1-3
TGTGCCAGCAGCCAAGATTCTTTCCTCGGACAGGACTATGGCTACACCTTC	CASSQDSFLGQDYGYTF	TRBV4-2	TRBJ1-2
TGTGCCAATCCGCCGGCAGGGTTTGGCAATCAGCCCCAGCATTTT	CANPPAGFGNQPQHF	TRBV11-3	TRBJ1-5
TGTGCCAGCAGCCGGGGGGGCTGGTTCTTC	CASSRGGWFF	TRBV7-6	TRBJ2-1
TGTGCCAGCAGCCCGGGAGGCGGTGGAGGTAATCAGCCCCAGCATTTT	CASSPGGGGGNQPQHF	TRBV13	TRBJ1-5
TGTGCCAGCAGCTTGAACGAAAGTTCCACAGATACGCAGTATTTT	CASSLNESSTDTQYF	TRBV5-5	TRBJ2-3
TGTGCCAGCAGCTCTGATTTCCAGGGGGGGAATGAAAAACTGTTTTTT	CASSSDFQGGNEKLFF	TRBV7-3	TRBJ1-4
TGTGCCAGCAGGGGACACGAGCAGTACTTC	CASRGHEQYF	TRBV6-4	TRBJ2-7
TGTGCCAGCTCACCACGAGGAGGGTCCTCCTACGAGCAGTACTTC	CASSPRGGSSYEQYF	TRBV18	TRBJ2-7
TGTGCCAGCGGGAGGGGTTCGGCCACTGAAGCTTTCTTT	CASGRGSATEAFF	TRBV28	TRBJ1-1
TGTGCCAGCAGCTGGGTGGGGCATAAATTGCTTGAAGCTTTCTTT	CASSWVGHKLLEAFF	TRBV13	TRBJ1-1
TGCAGTGCTACACCCGGGACCCCCTACGAGCAGTACTTC	CSATPGTPYEQYF	TRBV20-1	TRBJ2-7
TGTGCCAGCAGCCAAGAAGGCAGGGTGAACACTGAAGCTTTCTTT	CASSQEGRVNTEAFF	TRBV3-1	TRBJ1-1
TGTGCCTGGAGTTATAGGCGAAACCACCGGAATGAGCAGTTCTTC	CAWSYRRNHRNEQFF	TRBV30	TRBJ2-1
TGTGCCTGGAGTGTACGGACAGGGGCCGGAAACACCATATATTTT	CAWSVRTGAGNTIYF	TRBV30	TRBJ1-3
TGTGCCCGCGGAGAAGGACAGGGAGGTTACGAGCAGTACTTC	CARGEGQGGYEQYF	TRBV25-1	TRBJ2-7
TGTGCCAACCGGCCCAGGGGGTTGTTTGAAGCTTTCTTT	CANRPRGLFEAFF	TRBV7-7	TRBJ1-1
TGTGCCAGCAGTGGGGGCGTGAAGGCCAAAAACATTCAGTACTTC	CASSGGVKAKNIQYF	TRBV6-5	TRBJ2-4
TGCGCCAGCATTGGCTATGGTGGACGTTTCGAGCAGTACTTC	CASIGYGGRFEQYF	TRBV10-2	TRBJ2-7
TGTGCCAGCAGTTTCGGGGGTATGAACACTGAAGCTTTCTTT	CASSFGGMNTEAFF	TRBV12-3	TRBJ1-1
TGTGCCAGCAGCGACCCGACTAGCGGGGGGGTCTTC	CASSDPTSGGVF	TRBV7-3	TRBJ2-1
TGTGCCAGCAAAGGTACCCCCTACTTAATGTACTTC	CASKGTPYLMYF	TRBV6-8	TRBJ2-5
TGTGCCTCGAGGGGACTAGGAAAGGGGGCCTACAATGAGCAGTTCTTC	CASRGLGKGAYNEQFF	TRBV19	TRBJ2-1
TGTGCCAGCAGTGACCCACCAGGGAAGGACGAGCAGTACTTC	CASSDPPGKDEQYF	TRBV6-4	TRBJ2-7
TGCGCCCTAACACCGGGACAGAATGAGCAGTTCTTC	CALTPGQNEQFF	TRBV10-1	TRBJ2-1
TGTGCCAGCAGCTTAAACGCGGACTCCACAGATACGCAGTATTTT	CASSLNADSTDTQYF	TRBV7-3	TRBJ2-3
TGCAGTGCCACAGCTGGACATAATTCACCCCTCCACTTT	CSATAGHNSPLHF	TRBV20-1	TRBJ1-6
TGTGCCAGCAGTGGTAGGGGTAGCGGCCGGCTGTTTTTT	CASSGRGSGRLFF	TRBV12-3	TRBJ1-4
TGTGCCAGCGAGCGTCCGGGCACAAAGTGGGGGAGGCCTGAAAAACTGTTTTTT	CASERPGTKWGRPEKLFF	TRBV5-4	TRBJ1-4
TGTGCCAGCAGTTACTCAACCCTAGGACGTTTCTACGAGCAGTACTTC	CASSYSTLGRFYEQYF	TRBV6-5	TRBJ2-7
TGTGCCAGCAGCTCGAGAGAAGGGGGAGCCCATACAGATACGCAGTATTTT	CASSSREGGAHTDTQYF	TRBV9	TRBJ2-3
TGTGCCAGCAGCTTCGGACAGGACTCCTATAATTCACCCCTCCACTTT	CASSFGQDSYNSPLHF	TRBV11-3	TRBJ1-6
TGTGCCAGGAGCACAGGGACAAAGTATAATTCACCCCTCCACTTT	CARSTGTKYNSPLHF	TRBV19	TRBJ1-6
TGTGCCAGCAGTGAAGTCGGGGGCCGGATTGAGACCCAGTACTTC	CASSEVGGRIETQYF	TRBV6-4	TRBJ2-5
TGTGCCAGCAGCCAAGACCACAGGCTATGTGAGCAGTTCTTC	CASSQDHRLCEQFF	TRBV3-1	TRBJ2-1
TGTGCCAGCAGGTCTGAAGGGGTTCTCAAGAACACTGAAGCTTTCTTT	CASRSEGVLKNTEAFF	TRBV14	TRBJ1-1
TGTGCCAGCACGGCCGACAGGGTATGGACCGGCTACACCTTC	CASTADRVWTGYTF	TRBV9	TRBJ1-2
TGTGCCACCAGGCTAGCGGGTAGCTCCTACGAGCAGTACTTC	CATRLAGSSYEQYF	TRBV24-1	TRBJ2-7
TGTGCCAGTAGTATCCCATCCAAGGGACAGGGGCGGTACAATGAGCAGTTCTTC	CASSIPSKGQGRYNEQFF	TRBV19	TRBJ2-1
TGCGCCAGCAGCCCAGACAGGTCGCACGAGCAGTACTTC	CASSPDRSHEQYF	TRBV4-3	TRBJ2-7
TGTGCCAGCAGTGCCATCCGGGACAGGGGTAACGAGCAGTACTTC	CASSAIRDRGNEQYF	TRBV2	TRBJ2-7
TGTGCCAGCAGCTCGACAGGGAGCGGAAACACCATATATTTT	CASSSTGSGNTIYF	TRBV5-4	TRBJ1-3
TGTGCCATCAGTGGTAGGGCCTCCTACATTCAGTACTTC	CAISGRASYIQYF	TRBV10-3	TRBJ2-4
TGTGCCAGCAGCTTACCTCCGATACCTAAGTATAACGAGCAGTACTTC	CASSLPPIPKYNEQYF	TRBV7-9	TRBJ2-7
TGCGCCAGCTATGGCCTTGTTCAGCCCCAGCATTTT	CASYGLVQPQHF	TRBV5-1	TRBJ1-5
TGTGCCAGCAGCGGGAGGCCCCAAGAGACCCAGTACTTC	CASSGRPQETQYF	TRBV6-6	TRBJ2-5
TGTGCCAGAGAGTCAGATATCGCGAACACTGAAGCTTTCTTT	CARESDIANTEAFF	TRBV4-2	TRBJ1-1
TGTGCCACCAGTCTTCTTCGGGGAGGGGCTTATAATTCACCCCTCCACTTT	CATSLLRGGAYNSPLHF	TRBV24-1	TRBJ1-6
TGCGCCAGCAGTAGGGGGGCCGCCTCCTACGAGCAGTACTTC	CASSRGAASYEQYF	TRBV10-1	TRBJ2-7
TGTGCCAGCATAACTAGAGAGAACTACGAGCAGTACTTC	CASITRENYEQYF	TRBV9	TRBJ2-7
TGCGCCAGCAGCTCAGCCCTATCACTAGCCAAAAACATTCAGTACTTC	CASSSALSLAKNIQYF	TRBV5-1	TRBJ2-4
TGTGCCAGCAGTCACGGGGCGGGGACTGAAGCTTTCTTT	CASSHGAGTEAFF	TRBV6-5	TRBJ1-1
TGTGTCATGGCGGGGCCATTTGCAGAGACCCAGTACTTC	CVMAGPFAETQYF	TRBV28	TRBJ2-5
TGTGCCAGCAGTCCGGCCGGGCAGCTGGGAGGTCGAACCTACGAGCAGTACTTC	CASSPAGQLGGRTYEQYF	TRBV7-9	TRBJ2-7
TGTGCCAGCAGCGTAGCCCGGATCACTAGCGGGAGGGCCGGTAGTGAGCAGTTCTTC	CASSVARITSGRAGSEQFF	TRBV9	TRBJ2-1
TGTGCCAGCAGCGTAGTCCGGGGTGGCTACGAGCAGTACTTC	CASSVVRGGYEQYF	TRBV9	TRBJ2-7
TGTGCCAGCATAAAGGGACAGGGGAATTTGTTTGGGTACAATCAGCCCCAGCATTTT	CASIKGQGNLFGYNQPQHF	TRBV27	TRBJ1-5
TGTGCCAGCAGCCGACCGGGACGGGAGATCTTC	CASSRPGREIF	TRBV7-3	TRBJ2-1
TGTGCCAGCAGTGACTCGATTTTGAACCAGTTTGACCGGGGTGAGACCCAGTACTTC	CASSDSILNQFDRGETQYF	TRBV6-4	TRBJ2-5
TGTGCCAGCTCACACTTGGGCCCCTACGAGCAGTACTTC	CASSHLGPYEQYF	TRBV6-5	TRBJ2-7
TGTGCCAGGGGGGCGAGAGGGGATCCAGAGACCCAGTACTTC	CARGARGDPETQYF	TRBV13	TRBJ2-5
TGTGCCAGCATCCGCAGTTTCCGCACAGATACGCAGTATTTT	CASIRSFRTDTQYF	TRBV13	TRBJ2-3
TGTGCCAGCAGTTACGTACGAAGGGACCAGACAGATACGCAGTATTTT	CASSYVRRDQTDTQYF	TRBV6-5	TRBJ2-3
TGTGCCAGCAGTTCCCGGGAGAACGGGCTTGAAAAACTGTTTTTT	CASSSRENGLEKLFF	TRBV28	TRBJ1-4
TGCAGTGCCCTAACACGGTGCAATCAGCCCCAGCATTTT	CSALTRCNQPQHF	TRBV20-1	TRBJ1-5
TGCATGGTTCCACTTAGGAGGGGTAAACGCGAGCAGTACTTC	CMVPLRRGKREQYF	TRBV20-1	TRBJ2-7
TGTGCCAGCAGCAGGGGACAGGGGGAGCCCGGGAACACTGAAGCTTTCTTT	CASSRGQGEPGNTEAFF	TRBV7-3	TRBJ1-1
TGTGCCAGCAGCCAGGGACAACCAGCCTACGAGCAGTACTTC	CASSQGQPAYEQYF	TRBV11-3	TRBJ2-7
TGTGCCAGCGCAGGGGCCACTGAAGCTTTCTTT	CASAGATEAFF	TRBV18	TRBJ1-1
TGCAGTGCTAGACCTCAGAGGAATGAAAAACTGTTTTTT	CSARPQRNEKLFF	TRBV20-1	TRBJ1-4
TGTGCCAGCAGTTGGGCCTGCGGAGAACACGAGCAGTACTTC	CASSWACGEHEQYF	TRBV6-6	TRBJ2-7
TGTGCCAGCAGCTTTATCCTGGACAGGGGAGCGTATAATTCACCCCTCCACTTT	CASSFILDRGAYNSPLHF	TRBV11-3	TRBJ1-6
TGTGCCAGCAGCCCTAGGCGGGGATTGAGCTCCTACAATGAGCAGTTCTTC	CASSPRRGLSSYNEQFF	TRBV13	TRBJ2-1
TGTGCCAGCAGCTTAGCCATTGGGGCCCGGGACACCCTGTTTTTT	CASSLAIGARDTLFF	TRBV7-6	TRBJ1-4
TGTGCCTGGCTTGACAGGGTCCATCCCTTCTGCACCGGGGAGCTGTTTTTT	CAWLDRVHPFCTGELFF	TRBV30	TRBJ2-2
TGCAGCGTTGAAGAAGTACAGGGGGCGGGCAAAAACATTCAGTACTTC	CSVEEVQGAGKNIQYF	TRBV29-1	TRBJ2-4
TGTGCCAGCAGCCTACCAGGGGGAGTCTATGGCTACACCTTC	CASSLPGGVYGYTF	TRBV3-1	TRBJ1-2
TGCAGCGTTGGTAACCGGGACGGGGGTAGTCCCTACGAGCAGTACTTC	CSVGNRDGGSPYEQYF	TRBV29-1	TRBJ2-7
TGTGCCAGCAGCGCAGTTGGCACTGAAGCTTTCTTT	CASSAVGTEAFF	TRBV13	TRBJ1-1
TGTGCCAGCAGTCCGGAACAGGGCGATCAGCCCCAGCATTTT	CASSPEQGDQPQHF	TRBV25-1	TRBJ1-5
TGTGCCACCCGCCCGGGACAGTACGAGCAGTACTTC	CATRPGQYEQYF	TRBV24-1	TRBJ2-7
TGCGCCAGCAGCTTGGAGGGTACTAAGGAAGCGGGAGGGCAAGAGACCCAGTACTTC	CASSLEGTKEAGGQETQYF	TRBV5-1	TRBJ2-5
TGTGCCAGCAGCTTAACGTGTGACAAGCCCCAGCATTTT	CASSLTCDKPQHF	TRBV7-3	TRBJ1-5
TGTGCCATCAGTGGACAGGGAGCTTTCTTT	CAISGQGAFF	TRBV10-3	TRBJ1-1
TGTGCCAGCAGTGAAGACAGGGGACCCGCTCAGCCCCAGCATTTT	CASSEDRGPAQPQHF	TRBV6-4	TRBJ1-5
TGTGCCAGCCCGTGTAGCGGGGAGGGGGATACGCAGTATTTT	CASPCSGEGDTQYF	TRBV18	TRBJ2-3
TGTGCCAGCAGCAGGGACAGGGTTGGATCCTCCGGGGAGCTGTTTTTT	CASSRDRVGSSGELFF	TRBV7-3	TRBJ2-2
TGCAGTGCTCGAGGGGGGGGAGGTAGCAATCAGCCCCAGCATTTT	CSARGGGGSNQPQHF	TRBV20-1	TRBJ1-5
TGTGCCAGTATACCACTACCTAGAGATACGCAGTATTTT	CASIPLPRDTQYF	TRBV19	TRBJ2-3
TGTGCCAGCAGTTACACCGGACTAGGTGAAGTATACAATGAGCAGTTCTTC	CASSYTGLGEVYNEQFF	TRBV6-6	TRBJ2-1
TGTGCCAGCTCACCCAGCTTCGGGCTTCCGTTCACTGAAGCTTTCTTT	CASSPSFGLPFTEAFF	TRBV18	TRBJ1-1
TGTGCCAGTAGTCGTCCCCCCTCGAGGGGGGGTGCACGCGTATACGAGCAGTACTTC	CASSRPPSRGGARVYEQYF	TRBV19	TRBJ2-7
TGTGCCAGCCTACCCGACGGGGTCCTTTCCTACGAGCAGTACTTC	CASLPDGVLSYEQYF	TRBV6-2	TRBJ2-7
TGTGCCAGCAGCGTCCCGGGACGCACAGATACGCAGTATTTT	CASSVPGRTDTQYF	TRBV7-9	TRBJ2-3
TGCGCCACTTGGGGCCAAGAGACCCAGTACTTC	CATWGQETQYF	TRBV10-1	TRBJ2-5
TGTGCCAGCAGCCGCGATTGGGGGCACACTGAAGCTTTCTTT	CASSRDWGHTEAFF	TRBV13	TRBJ1-1
TGTGCCTGGAGTGTCACCCAGGGGGGCACAGATACGCAGTATTTT	CAWSVTQGGTDTQYF	TRBV30	TRBJ2-3
TGCACTAGAAGCAGGGTCCTTGAGGGTTTTTTCTTC	CTRSRVLEGFFF	TRBV20-1	TRBJ2-1
TGTGCCACCAGTATGGACAGGCGTAGGGAAAACGTCCTGACTTTC	CATSMDRRRENVLTF	TRBV24-1	TRBJ2-6
TGCGCCAGCAGCACCAGGACTAGCGGGGGGTATTTT	CASSTRTSGGYF	TRBV5-1	TRBJ2-3
TGTGCCAGCAGTGACAGGGGGGGTTCCTACGAGCAGTACTTC	CASSDRGGSYEQYF	TRBV6-4	TRBJ2-7
TGTGCCAGCAGCCCGAATAGGCGGTCCTACGAGCAGTACTTC	CASSPNRRSYEQYF	TRBV7-2	TRBJ2-7
TGTGCCAGCAGCTTTCAGGGGCTTTGCCCCGATTTGAACACTGAAGCTTTCTTT	CASSFQGLCPDLNTEAFF	TRBV11-3	TRBJ1-1
TGCAGTGCTAGCCATCTGGATGGCTACACCTTC	CSASHLDGYTF	TRBV20-1	TRBJ1-2
TGCGCCAGCAGCTTGGGTCACCAAGGGACAGGTAGGGCGAACACTGAAGCTTTCTTT	CASSLGHQGTGRANTEAFF	TRBV5-1	TRBJ1-1
TGTGCCAGCAGTGGTTTCAGGGCGAGTTACAATGAGCAGTTCTTC	CASSGFRASYNEQFF	TRBV6-1	TRBJ2-1
TGTGCCAGCAGCTCCCCGGGACAGGGGCCCTCTCATAGCAATCAGCCCCAGCATTTT	CASSSPGQGPSHSNQPQHF	TRBV7-3	TRBJ1-5
TGTGCCAGCTCACCATCCGCCGTAAGAGGTCTTACCACTGAAGCTTTCTTT	CASSPSAVRGLTTEAFF	TRBV18	TRBJ1-1
TGCGCCAGCAGCGGTAGGCCCCACGAGCAGTTCTTC	CASSGRPHEQFF	TRBV4-1	TRBJ2-1
TGTGCCAGCAGCTTAGATAGACTAGGGGGGGGAGAGACCCAGTACTTC	CASSLDRLGGGETQYF	TRBV7-2	TRBJ2-5
TGCAGTGCTGCGGGACAGACCCCTACTGAAGCTTTCTTT	CSAAGQTPTEAFF	TRBV20-1	TRBJ1-1
TGTGCCAGCAGCCAAGATACCCCTAGGGAGTGCCCAGATACGCAGTATTTT	CASSQDTPRECPDTQYF	TRBV14	TRBJ2-3
TGTGCCAGCAGCTTAGGGGGGGGAAGGGGTCCGGGCAATCAGCCCCAGCATTTT	CASSLGGGRGPGNQPQHF	TRBV7-3	TRBJ1-5
TGTGCCAGCAGCTTGGCCTTCCTAGGGAGGGTACGGGAAGGACAGGGATGGAGAGAGAGGAGGCAGCCCCAGCATTTT	CASSLAFLGRVREGQGWRERRQPQHF	TRBV5-4	TRBJ1-5
TGTGCCACCAGTGATTTTCAAGGCACTAACAGGGTTATTTACACCATATATTTT	CATSDFQGTNRVIYTIYF	TRBV24-1	TRBJ1-3
TGTGCCAGCAGTGAATATTATTTGGGGGGAGGGACAGATACGCAGTATTTT	CASSEYYLGGGTDTQYF	TRBV25-1	TRBJ2-3
TGTGCCTGGAGTAGGGGGGGACAGCCCCAGCATTTT	CAWSRGGQPQHF	TRBV30	TRBJ1-5
TGTGCCAGCAGTTACGAGAGCGGGAGAATGATCCTCTACATTCAGTACTTC	CASSYESGRMILYIQYF	TRBV6-5	TRBJ2-4
TGTGCCAGCTCACCACGGGGATTCGTGAGAGATACGCAGTATTTT	CASSPRGFVRDTQYF	TRBV18	TRBJ2-3
TGTGCCAGCAGCTTGTCGGCTCGAGGGAGCAATCAGCCCCAGCATTTT	CASSLSARGSNQPQHF	TRBV5-6	TRBJ1-5
TGTGCCAGCACCGCAGGGGGGGGAGATGGCTACACCTTC	CASTAGGGDGYTF	TRBV11-2	TRBJ1-2
TGTGCCAGCAGCTCTTGCGGGACGGGCAATCAGCCCCAGCATTTT	CASSSCGTGNQPQHF	TRBV7-9	TRBJ1-5
TGTGCCAGCAGGTCTGGATATAGCAATCAGCCCCAGCATTTT	CASRSGYSNQPQHF	TRBV12-3	TRBJ1-5
TGTGCTAGTGGTTTGGAACTAGCGGGAGGCGCTAGCACAGATACGCAGTATTTT	CASGLELAGGASTDTQYF	TRBV12-5	TRBJ2-3
TGCAGCGTGGCCTCAGGGGCCGACGGGGAGCTGTTTTTT	CSVASGADGELFF	TRBV29-1	TRBJ2-2
TGTGCCAGCAGTGACCTTATGGGCCCATATCAGCCCCAGCATTTT	CASSDLMGPYQPQHF	TRBV25-1	TRBJ1-5
TGTGCCAGCTCACCACCCGAGGGGTGGGGCACAGATACGCAGTATTTT	CASSPPEGWGTDTQYF	TRBV18	TRBJ2-3
TGTGCTAGTGGTTTAACAACTAGCGGGAGTTATGAAAAACTGTTTTTT	CASGLTTSGSYEKLFF	TRBV12-5	TRBJ1-4
TGTGCCAGCAGCAGGGGAACCAGGAGAAGCTGTTCGACCCGCAATCAGCCCCAGCATTTT	CASSRGTRRSCSTRNQPQHF	TRBV5-4	TRBJ1-5
TGTGCCAGCAGTGCCCGGGACACCAATCAGCCCCAGCATTTT	CASSARDTNQPQHF	TRBV6-1	TRBJ1-5
TGTGCCAGCAGTTTAGTCCGAGACAGGCAAATTCCGACCCAGTACTTC	CASSLVRDRQIPTQYF	TRBV27	TRBJ2-5
TGTGCCAGCAGCTTAGACAGGGGTGTTACAGATACGCAGTATTTT	CASSLDRGVTDTQYF	TRBV11-3	TRBJ2-3
TGCGCCAGCTCCACCGGGACGAACCGGGGGTACGAGCAGTACTTC	CASSTGTNRGYEQYF	TRBV10-2	TRBJ2-7
TGTGCCACGGACAGGAGGCACTGGCAGCCCCAGCATTTT	CATDRRHWQPQHF	TRBV6-1	TRBJ1-5
TGCAGTGCGCTCACCGGAAGCTACAATGAGCAGTTCTTC	CSALTGSYNEQFF	TRBV20-1	TRBJ2-1
TGTGCCAGCAGTGAGATCGTGGGACAGGAACTAGAGACCCAGTACTTC	CASSEIVGQELETQYF	TRBV6-4	TRBJ2-5
TGCGCCAGCAGCTTGGCCGCCTACCTCGGGGGGTATGGCTACACCTTC	CASSLAAYLGGYGYTF	TRBV5-1	TRBJ1-2
TGTGCCAGCAGCCAGGCGGGAGTTCGTTCAAGGTATAGCAATCAGCCCCAGCATTTT	CASSQAGVRSRYSNQPQHF	TRBV14	TRBJ1-5
TGTGCCAGCAGCACCCCGTGCGGGAGGGGCGTCACAGATACGCAGTATTTT	CASSTPCGRGVTDTQYF	TRBV7-6	TRBJ2-3
TGTGCCAGCAATTTGGGGTGTCGACCCGAAGGCTACGAGCAGTACTTC	CASNLGCRPEGYEQYF	TRBV6-2	TRBJ2-7
TGTGCCAGCAGTGAACTCCGGGACAGGGTTACAGATACGCAGTATTTT	CASSELRDRVTDTQYF	TRBV6-1	TRBJ2-3
TGCGCCAGCAGCTTGGCCGACAGGGTCCGCTACGAGCAGTACTTC	CASSLADRVRYEQYF	TRBV5-1	TRBJ2-7
TGTGCCAGCAGGGGGGAATCCGTTGGTGAGCAGTACTTC	CASRGESVGEQYF	TRBV7-2	TRBJ2-7
TGTGCCAGCAGTTACCTGAGAAGGAAATGGGGCGTATTCCCGGCACCGGGACAGGGGGTATACGCTAACTATGGCTACACCTTC	CASSYLRRKWGVFPAPGQGVYANYGYTF	TRBV6-6	TRBJ1-2
TGTGCCATCAAGGGACAGTACCACTTTATAGATACGCAGTATTTT	CAIKGQYHFIDTQYF	TRBV10-3	TRBJ2-3
TGTGCCACCAGTCACCGGGACAGGGCTGGGTACCTCTACGAGCAGTACTTC	CATSHRDRAGYLYEQYF	TRBV15	TRBJ2-7
TGCGCCAGCAGCTTTCCCCAGAGAAGAACAGATACGCAGTATTTT	CASSFPQRRTDTQYF	TRBV5-1	TRBJ2-3
TGTGCCACCAGTGATGAGCGGGCAGGGACAAGTAAAATTCAGCATTTT	CATSDERAGTSKIQHF	TRBV24-1	TRBJ1-5
TGTGCCAGCAAGCTAGGTCAAGTGGGCAATGAGCAGTTCTTC	CASKLGQVGNEQFF	TRBV2	TRBJ2-1
TGTGCCAGCAGTTTCATAGATCCACCGGACAGGGCCTTAGCGTGCTATGGCTACACCTTC	CASSFIDPPDRALACYGYTF	TRBV27	TRBJ1-2
TGCAGTGCTAGGCACGACAGGGAGGTGACGACCGGGGAGCTGTTTTTT	CSARHDREVTTGELFF	TRBV20-1	TRBJ2-2
TGTGCCAGCAGAGAGGGGGGACCAAGGAGGGAAGCTTTCTTT	CASREGGPRREAFF	TRBV11-3	TRBJ1-1
TGTGCCAGCAGTGTAAAACAGGGAGAAGCTTTCTTT	CASSVKQGEAFF	TRBV28	TRBJ1-1
TGCGCCAGCAGTGGGGATCGAAAAACGGCGCTAAACATTCAGTACTTC	CASSGDRKTALNIQYF	TRBV10-1	TRBJ2-4
TGTGCCAGCAGCCAATTGAAGTACGAGCAGTACTTC	CASSQLKYEQYF	TRBV14	TRBJ2-7
TGTGCCAGCAGCTTTAGGGGGGGGGGTTACAATGAGCAGTTCTTC	CASSFRGGGYNEQFF	TRBV7-4	TRBJ2-1
TGCAGTGCTAGAGATAATTCAGGGGGCTCGATTCGAACTGAAGCTTTCTTT	CSARDNSGGSIRTEAFF	TRBV20-1	TRBJ1-1
TGCGCCAGCAGCTTGCCAGGGACAACTTATAATTCACCCCTCCACTTT	CASSLPGTTYNSPLHF	TRBV5-1	TRBJ1-6
TGTGCCAGCAGCTTGGCAGTTGGGGGACAGACCTCTGGGGCCAACGTCCTGACTTTC	CASSLAVGGQTSGANVLTF	TRBV5-8	TRBJ2-6
TGCGCCAGCAGTGAGCCCATTCGAAGAATCAGTAGGGCCCGTTATTCACCCCTCCACTTT	CASSEPIRRISRARYSPLHF	TRBV10-2	TRBJ1-6
TGTGCCAGCAGCTTAACAGCCGGAAACACCGGGGAGCTGTTTTTT	CASSLTAGNTGELFF	TRBV5-5	TRBJ2-2
TGTGCCAGCCCTATACGACGGGACAGGGGGGGGGTGAACACTGAAGCTTTCTTT	CASPIRRDRGGVNTEAFF	TRBV7-4	TRBJ1-1
TGTGCCAGCAGGGCCCCGCATCAGTTTAACTATGGCTACACCTTC	CASRAPHQFNYGYTF	TRBV28	TRBJ1-2
TGCGCCAGCAGCCAGGGGGGGGGCCGAGTCTACAATGAGCAGTTCTTC	CASSQGGGRVYNEQFF	TRBV4-3	TRBJ2-1
TGCAGTGCTAGAGCTCAAAAGAAGGGTCTCCACGAGCAGTACTTC	CSARAQKKGLHEQYF	TRBV20-1	TRBJ2-7
TGTGCCAGCAGCCCCCCCGTTCGGGTTACGAACACTGAAGCTTTCTTT	CASSPPVRVTNTEAFF	TRBV13	TRBJ1-1
TGTGCCAGCTCACTAGCAGGGGGCTACAATCAGCCCCAGCATTTT	CASSLAGGYNQPQHF	TRBV12-4	TRBJ1-5
TGTGCCAGCAGTGAATCGCACGACAATGACAGGGATGTAGAAGATACGCAGTATTTT	CASSESHDNDRDVEDTQYF	TRBV6-1	TRBJ2-3
TGTGCCAGCAGGACAGGGATGCTTAATCAGCCCCAGCATTTT	CASRTGMLNQPQHF	TRBV6-2	TRBJ1-5
TGTGCCTGGAGTGGAGCGGATGGCTACACCTTC	CAWSGADGYTF	TRBV30	TRBJ1-2
TGTGCTAGTGGTCTAGGAACGGACAGGGGGGGAAGTAACTATGGCTACACCTTC	CASGLGTDRGGSNYGYTF	TRBV12-5	TRBJ1-2
TGCAGTGCTAGAGATCTTCCGTGGACAGGGCCAGAAGCTTTCTTT	CSARDLPWTGPEAFF	TRBV20-1	TRBJ1-1
TGCGCCAGCAGCCATACTGAAAATGAGCAGTTCTTC	CASSHTENEQFF	TRBV4-1	TRBJ2-1
TGTGCCAGCAGCCACGGGAGGGGTGATGAGCAGTTCTTC	CASSHGRGDEQFF	TRBV5-8	TRBJ2-1
TGTGCCAGCAGCCATTTATGGGATGGCTACACCTTC	CASSHLWDGYTF	TRBV5-8	TRBJ1-2
TGTGCCAGCAGCTTGGGACCCCCCTATGACGCGCCAGATACGCAGTATTTT	CASSLGPPYDAPDTQYF	TRBV5-5	TRBJ2-3
TGTGCCAGCAGCCCAAAAAAGCGGGGAAAAGCCAAAAACATTCAGTACTTC	CASSPKKRGKAKNIQYF	TRBV4-2	TRBJ2-4
TGTGCCAGCAGCCAAAGATCCGGGACAGGGAAATGGGTAATTAGGGCTGAAGCTTTCTTT	CASSQRSGTGKWVIRAEAFF	TRBV7-9	TRBJ1-1
TGTGCCAGCAGTGAAGGTAGGCCGCGGGAGGGTTCATATGAAAAACTGTTTTTT	CASSEGRPREGSYEKLFF	TRBV6-1	TRBJ1-4
TGTGCCAGCAGCTTGCCTCAACTGGGACAGAACTCCTACGAGCAGTACTTC	CASSLPQLGQNSYEQYF	TRBV5-6	TRBJ2-7
TGTGCCAGCAGCCCCGTACGGAATTCTAACACCGGGGAGCTGTTTTTT	CASSPVRNSNTGELFF	TRBV13	TRBJ2-2
TGCGCCAGCAGCTTCTACAGGGGGCGATCTAATGAAAAACTGTTTTTT	CASSFYRGRSNEKLFF	TRBV5-1	TRBJ1-4
TGTGCCAGCAGTCAGGAGTCCCAAGAGACCCAGTACTTC	CASSQESQETQYF	TRBV6-4	TRBJ2-5
TGTGCCAGCAGCTTAACGGAAGGGGATCTATCACCCCTCCACTTT	CASSLTEGDLSPLHF	TRBV7-9	TRBJ1-6
TGTGCCAGCAGCACGGTAACCGAGACCCAGTACTTC	CASSTVTETQYF	TRBV13	TRBJ2-5
TGTGCCAGCGGTACACCGGGACGGGGCTACGAGCAGTACTTC	CASGTPGRGYEQYF	TRBV7-9	TRBJ2-7
TGTGCCACCAGCAGAGATAGGACTCGGAACACTGAAGCTTTCTTT	CATSRDRTRNTEAFF	TRBV15	TRBJ1-1
TGTGCCACCAGCAGATGGTGGAAGGGGGCACCAGCTGAAGCTTTCTTT	CATSRWWKGAPAEAFF	TRBV15	TRBJ1-1
TGTGCCAGCATATCCCCCGGGGACAGGGGGCAAATTGGTTCACCCCTCCACTTT	CASISPGDRGQIGSPLHF	TRBV12-3	TRBJ1-6
TGTGCCAGCAGTGATTACTCCCGGACAGGAGACCCTGAAGCTTTCTTT	CASSDYSRTGDPEAFF	TRBV6-4	TRBJ1-1
TGTGCCAGCAGCACGGACAGGGTTGACTCCTCACCCCTCCACTTT	CASSTDRVDSSPLHF	TRBV7-3	TRBJ1-6
TGTGCCACCAGTGATTTGCCCTCAGGGACGGATGAAAAACTGTTTTTT	CATSDLPSGTDEKLFF	TRBV24-1	TRBJ1-4
TGTGCCAGCAGCGGATTCCTTGCGGGAGACCCGTACAATGAGCAGTTCTTC	CASSGFLAGDPYNEQFF	TRBV6-5	TRBJ2-1
TGTGCCAGTAGTCGGGGAGGGAGGGATGAGCAGTTCTTC	CASSRGGRDEQFF	TRBV19	TRBJ2-1
TGTGCCAGCAGCTTAGTACCGGACACTCCGAACTATGGCTACACCTTC	CASSLVPDTPNYGYTF	TRBV11-3	TRBJ1-2
TGTGCCAGCAGCTTAGCGCTCTCACAGGGCTTGAACACTGAAGCTTTCTTT	CASSLALSQGLNTEAFF	TRBV7-9	TRBJ1-1
TGTGCCAGCAATAGACTAACGCAGTATTTT	CASNRLTQYF	TRBV6-6	TRBJ2-3
TGTGCCAGCAGCCAAGGTCCGGGACAGGGAACCACTGAAGCTTTCTTT	CASSQGPGQGTTEAFF	TRBV3-1	TRBJ1-1
TGTGCCAGCAGGTACCAGGGATTTTCTGAAGCTTTCTTT	CASRYQGFSEAFF	TRBV11-2	TRBJ1-1
TGCGCCAGCAGCTTGGTCAGGGCGTACGACCTCCACTTT	CASSLVRAYDLHF	TRBV5-1	TRBJ1-6
TGTGCCAGCAGCTTAGGGGGGAACACTGAAGCTTTCTTT	CASSLGGNTEAFF	TRBV5-5	TRBJ1-1
TGCGCCAGCAGCTTGCTGACCAGGTCCAATTCACCCCTCCACTTT	CASSLLTRSNSPLHF	TRBV5-1	TRBJ1-6
TGTGCCAGCAGCCCGAGAAGGGGGGACAATGAGCAGTTCTTC	CASSPRRGDNEQFF	TRBV7-8	TRBJ2-1
TGTGCCAGCAGCGTCGTAGCGGGCGGCAACAATGAGCAGTTCTTC	CASSVVAGGNNEQFF	TRBV9	TRBJ2-1
TGTGCCAGCAGTTATGGGGGGGGCCAAAGTGATACGCAGTATTTT	CASSYGGGQSDTQYF	TRBV27	TRBJ2-3
TGTGCCAGCAGCGCACTAGCGGGAGGGCGGTATGAGCAGTTCTTC	CASSALAGGRYEQFF	TRBV7-7	TRBJ2-1
TGTGCCAGTAAAGTGACAGGTTACACTGAAGCTTTCTTT	CASKVTGYTEAFF	TRBV5-5	TRBJ1-1
TGTGCCAGTAAAAGGGATGGGACTAGCGGGTCTATCTTC	CASKRDGTSGSIF	TRBV19	TRBJ2-1
TGTGCCACCAGCGAACGGACTAGCGGTTATATCTACAATGAGCAGTTCTTC	CATSERTSGYIYNEQFF	TRBV24-1	TRBJ2-1
TGTGCCAGCAGCTTAAATATGACAGGGGTAGGAAACTACGAGCAGTACTTC	CASSLNMTGVGNYEQYF	TRBV7-3	TRBJ2-7
TGCAGTGCTAGAGGTATCCGGGACAACCTTCCCAATCAGCCCCAGCATTTT	CSARGIRDNLPNQPQHF	TRBV20-1	TRBJ1-5
TGTGCCAGCAGCCGCGCGGATCGTCTCTCTGGAAACACCATATATTTT	CASSRADRLSGNTIYF	TRBV7-9	TRBJ1-3
TGTGCCAAATGGAACGTACCGGAGGGAAAGGGGGTCCACGAGCAGTACTTC	CAKWNVPEGKGVHEQYF	TRBV6-4	TRBJ2-7
TGTGCCAGTATAGGGCGGGGGACTAGCGGGTGCAATGAGCAGTTCTTC	CASIGRGTSGCNEQFF	TRBV19	TRBJ2-1
TGTGCCAGCAGTTTCCCAGGGTTCTATGGCTACACCTTC	CASSFPGFYGYTF	TRBV27	TRBJ1-2
TGCACCGGAGCCCGCAACACCGGGGAGCTGTTTTTT	CTGARNTGELFF	TRBV29-1	TRBJ2-2
TGCGCCAGCGGGACAGGAGGCAATCAGCCCCAGCATTTT	CASGTGGNQPQHF	TRBV10-1	TRBJ1-5
TGTGCCAGCAGCTTGAAATTACGGCGCTACGAGCAGTACTTC	CASSLKLRRYEQYF	TRBV5-6	TRBJ2-7
TGTGCCACCAGTGATTTAGGGGGCGGGTCTGGGGCCAACGTCCTGACTTTC	CATSDLGGGSGANVLTF	TRBV24-1	TRBJ2-6
TGTGCTAGTGGTTTCCCCCGACAGGAGGGGGCCTACGAGCAGTACTTC	CASGFPRQEGAYEQYF	TRBV12-5	TRBJ2-7
TGTGCCAGCAGCAATTCCCCCGGGACAGGGGGATCTTCTAATGAAAAACTGTTTTTT	CASSNSPGTGGSSNEKLFF	TRBV7-8	TRBJ1-4
TGTGCCAGCAGTTCTACACGGCGACGAATAAGCTCCTACAATGAGCAGTTCTTC	CASSSTRRRISSYNEQFF	TRBV12-3	TRBJ2-1
TGTGCCAGCAGTCACCCGGGACAGGCACATAGAAGGAATGAAAAACTGTTTTTT	CASSHPGQAHRRNEKLFF	TRBV6-6	TRBJ1-4
TGTGCCAGCAGTGCCCAGGCTCGGAACACCGGGGAGCTGTTTTTT	CASSAQARNTGELFF	TRBV12-4	TRBJ2-2
TGCAAATCTGGGGGGTACGAGCAGTACTTC	CKSGGYEQYF	TRBV29-1	TRBJ2-7
TGTGCCAGCAGCCGAGGGACTAGCAATCAGCCCCAGCATTTT	CASSRGTSNQPQHF	TRBV12-3	TRBJ1-5
TGCGCCAGCAGCGTTACCAGCCAAGAGACCCAGTACTTC	CASSVTSQETQYF	TRBV5-1	TRBJ2-5
TGTGCCAGCAGCGCGAATAGGGACACGGGTTACAATGAGCAGTTCTTC	CASSANRDTGYNEQFF	TRBV13	TRBJ2-1
TGCGCCAGCAGCTTGTATACTCCAGGACAGGGGGCGGGACGCAATCAGCCCCAGCATTTT	CASSLYTPGQGAGRNQPQHF	TRBV5-1	TRBJ1-5
TGTGCCAGTAGAGGGACAGGGGACAGGAACACTGAAGCTTTCTTT	CASRGTGDRNTEAFF	TRBV27	TRBJ1-1
TGTGCCAGCAGCTTGCCCGGGGGCAAGAAATACGAGCAGTACTTC	CASSLPGGKKYEQYF	TRBV5-8	TRBJ2-7
TGTGCCAGCAGCTGGGTAGGCCCGGAGCGGAAGATGACAGATACGCAGTATTTT	CASSWVGPERKMTDTQYF	TRBV5-6	TRBJ2-3
TGCAGTGCAAAGCCTCGTTGTACTAGCGGGGGGGTTACAGATACGCAGTATTTT	CSAKPRCTSGGVTDTQYF	TRBV20-1	TRBJ2-3
TGTGCCAGCAGCGTTCAAGGGACTAGAGGGGTGCTGGATGAGCAGTTCTTC	CASSVQGTRGVLDEQFF	TRBV7-4	TRBJ2-1
TGTGCCAGCAGCCAAGCAGACTTATCCCGGGACAGGGGGGCCAAAAACATTCAGTACTTC	CASSQADLSRDRGAKNIQYF	TRBV3-1	TRBJ2-4
TGTGCCAGCAGTTACCCGAGTTTGGTTACCACTGAAGCTTTCTTT	CASSYPSLVTTEAFF	TRBV6-3	TRBJ1-1
TGTGCCAGCAGCCAAGACTACGGACAGGGGTTTGGCTACACCTTC	CASSQDYGQGFGYTF	TRBV3-1	TRBJ1-2
TGCGCCAGCAGTGACTCTTTCTACGAGCAGTACTTC	CASSDSFYEQYF	TRBV10-1	TRBJ2-7
TGTGCCAGCAGCTTGGGTATCCACAGATTGGGTTACGAGCAGTACTTC	CASSLGIHRLGYEQYF	TRBV5-4	TRBJ2-7
TGCATCCTGGGACGAAATGAGCAGTTCTTC	CILGRNEQFF	TRBV20-1	TRBJ2-1
TGTGCCATCAGTGAGTTATTCCGGGACAGGGGTTCGGATAGCAATCAGCCCCAGCATTTT	CAISELFRDRGSDSNQPQHF	TRBV10-3	TRBJ1-5
TGCAGTGCGACAGGGGGCCAGCCCCAGCATTTT	CSATGGQPQHF	TRBV20-1	TRBJ1-5
TGTGCCAGCAGGGGTCTAGCGGAAGACAATGAGCAGTTCTTC	CASRGLAEDNEQFF	TRBV12-4	TRBJ2-1
TGTGCCACCAGTGATTTGCAGGACAGGGGGAACACAGATACGCAGTATTTT	CATSDLQDRGNTDTQYF	TRBV24-1	TRBJ2-3
TGTGCCAGTAGTATAGATCAGCTTAGCGGGGGGACAGATACGCAGTATTTT	CASSIDQLSGGTDTQYF	TRBV19	TRBJ2-3
TGTGCCAGCAGACAGGGCGGCAATCAGCCCCAGCATTTT	CASRQGGNQPQHF	TRBV7-3	TRBJ1-5
TGTGCCAGCACCCCTTCGTTGCCCGGGACAGGGTCAGAGAGGTATAGCAATCAGCCCCAGCATTTT	CASTPSLPGTGSERYSNQPQHF	TRBV6-6	TRBJ1-5
TGTGCCAGCTCACCACCGAGGGGCACAGATACGCAGTATTTT	CASSPPRGTDTQYF	TRBV18	TRBJ2-3
TGTGCCAGCAGTGCTAGCGGGCAAAGGATTGAAACAGATACGCAGTATTTT	CASSASGQRIETDTQYF	TRBV27	TRBJ2-3
TGCAGTGCTGGACAGATCTCCTACGAGCAGTACTTC	CSAGQISYEQYF	TRBV20-1	TRBJ2-7
TGTGCCAGCAGTGACAAGACCTACAATGAAAAACTGTTTTTT	CASSDKTYNEKLFF	TRBV6-4	TRBJ1-4
TGCAGTGCTAGACCGGGAGGGCGGCAGCCGAACACCGAGCAGTACTTC	CSARPGGRQPNTEQYF	TRBV20-1	TRBJ2-7
TGTGCCAGCAAACGACTGCGGACAGACCCGGTATGTCATCAGCCCCAGCATTTT	CASKRLRTDPVCHQPQHF	TRBV9	TRBJ1-5
TGTGCCAGCAGCTTGATCTCCCCCTTTCTCGCCGTCACTGAAGCTTTCTTT	CASSLISPFLAVTEAFF	TRBV5-5	TRBJ1-1
TGTGCCAGCAGCCATTCGGAAAGGGGGCGGTGCAATCAGCCCCAGCATTTT	CASSHSERGRCNQPQHF	TRBV5-6	TRBJ1-5
TGCAGCGTTTCCCAGGGAGATCAGCCCCAGCATTTT	CSVSQGDQPQHF	TRBV29-1	TRBJ1-5
TGTGCCAGCCTAAACGCCCCCTACGAGCAGTACTTC	CASLNAPYEQYF	TRBV6-5	TRBJ2-7
TGTGCCAGCAGCGTTAGTCGGACAGGGGGCGAACGAGCTGAAGCTTTCTTT	CASSVSRTGGERAEAFF	TRBV7-8	TRBJ1-1
TGTGCCAGCAGTGAAGGGGTTATCGGCTACACCTTC	CASSEGVIGYTF	TRBV6-4	TRBJ1-2
TGTGGGTCACTTAGGAATGGTACCTACGAGCAGTACTTC	CGSLRNGTYEQYF	TRBV27	TRBJ2-7
TGTGCCAGCAGACCGGGACTAGCCTACGAGCAGTACTTC	CASRPGLAYEQYF	TRBV12-4	TRBJ2-7
TGTGCCACCAGTGATTCAAACTCTCTTTGGGAGATCCAGCCCCAGCATTTT	CATSDSNSLWEIQPQHF	TRBV24-1	TRBJ1-5
TGTGCCACCACGAAACGCACTGAAGCTTTCTTT	CATTKRTEAFF	TRBV15	TRBJ1-1
TGTGCCACAACAGTCTACCTGACTAACGAGCAGTACTTC	CATTVYLTNEQYF	TRBV18	TRBJ2-7
TGCGCCAGCAGCCAAGCTACACTAGCGGGAGTAACCTACGAGCAGTACTTC	CASSQATLAGVTYEQYF	TRBV4-1	TRBJ2-7
TGTGCCAGCAGCTTAGTCTCAGTGGGCGGGAGACCTTCGTACAATGAGCAGTTCTTC	CASSLVSVGGRPSYNEQFF	TRBV11-1	TRBJ2-1
TGTGCCAGCAGCGAGCTCGATGGACGAGAAGTCTACGAGCAGTACTTC	CASSELDGREVYEQYF	TRBV7-3	TRBJ2-7
TGTGCCAGCAGTGAGAAGGGACAGGTTTGGAAGCCAGCCAAAAACATTCAGTACTTC	CASSEKGQVWKPAKNIQYF	TRBV6-1	TRBJ2-4
TGCGCCAGCAGCACCCGGCCGGGGCCCTGGGGGAACACTGAAGCTTTCTTT	CASSTRPGPWGNTEAFF	TRBV5-1	TRBJ1-1
TGTGCCAGCAGTGCATCCTGGGAAAGACAGGGAGGCTACGAGCAGTACTTC	CASSASWERQGGYEQYF	TRBV28	TRBJ2-7
TGTGCCAGCACTACCAAAGGGACAGGGGATTCACCCCTCCACTTT	CASTTKGTGDSPLHF	TRBV6-4	TRBJ1-6
TGCGCCAGCAGTTGGTCCTCGGGGGAAGGGGGGTATGAAAAACTGTTTTTT	CASSWSSGEGGYEKLFF	TRBV10-1	TRBJ1-4
TGTGCCAGCAGTGACCACCTGGACAGGGGGCGCGTTAAGTTGGATACTAATGAAAAACTGTTTTTT	CASSDHLDRGRVKLDTNEKLFF	TRBV27	TRBJ1-4
TGTGCCAGCAGTTACATGACTAGTACGGAATATGAGCAGTTCTTC	CASSYMTSTEYEQFF	TRBV6-8	TRBJ2-1
TGTGCCAGCAGCCAAGATAGGGCGAACACTGAAGCTTTCTTT	CASSQDRANTEAFF	TRBV14	TRBJ1-1
TGTGCCAGCAGCAATCAAACTAGCGGCCAGTTCGATACGCAGTATTTT	CASSNQTSGQFDTQYF	TRBV13	TRBJ2-3
TGTGCCACCAGGGCTATGGCGGTTGGAGAGACCCAGTACTTC	CATRAMAVGETQYF	TRBV24-1	TRBJ2-5
TGTGCCAGCAGCTTTTTCGGACAGCTAGGGAACACTGAAGCTTTCTTT	CASSFFGQLGNTEAFF	TRBV11-2	TRBJ1-1
TGTGCCACCAGACAGGCAGGCAATGAGCAGTTCTTC	CATRQAGNEQFF	TRBV10-3	TRBJ2-1
TGTGCCAGCAGCGACTGGTTCCCGCTGCCACCGGTTCCAGATACGCAGTATTTT	CASSDWFPLPPVPDTQYF	TRBV9	TRBJ2-3
TGTGCCAGCAGCATACAGTTGGTTGAAAAACTGTTTTTT	CASSIQLVEKLFF	TRBV7-8	TRBJ1-4
TGTGCCAGCAGCCACAGGGGGATTAGGGCCGGCTACACCTTC	CASSHRGIRAGYTF	TRBV3-1	TRBJ1-2
TGTGCCAGCAGCCCGAGGGACAGCCCTGGACGCCGTAACTATGGCTACACCTTC	CASSPRDSPGRRNYGYTF	TRBV5-6	TRBJ1-2
TGTGCCAGCAGCCTTTCGAATGGCTACACCTTC	CASSLSNGYTF	TRBV13	TRBJ1-2
TGTGCCAGCAGTGAAGATCCGGACAGCTACATTCAGTACTTC	CASSEDPDSYIQYF	TRBV6-1	TRBJ2-4
TGTGCCAGCAGCCAAGTTGTAAGGAGGACCTACGAGCAGTACTTC	CASSQVVRRTYEQYF	TRBV14	TRBJ2-7
TGTGCCAGCAGTTTGTTGGGACTAGTCCTTGGCTCCTACGAGCAGTACTTC	CASSLLGLVLGSYEQYF	TRBV28	TRBJ2-7
TGTGCCAGCTCACGGCAGCGGGCCCATAGGCCGGAGCTGTTTTTT	CASSRQRAHRPELFF	TRBV18	TRBJ2-2
TGTGCCAGCAGTGATCTCCGCTCGAGGGGCACAGATACGCAGTATTTT	CASSDLRSRGTDTQYF	TRBV6-1	TRBJ2-3
TGTGCCAGCAGCATAGAAGGGCGACAGTATTCACCCCTCCACTTT	CASSIEGRQYSPLHF	TRBV13	TRBJ1-6
TGTGCTAGTGATCCGGGGGGGCGCAGATGTGAGCAGTTCTTC	CASDPGGRRCEQFF	TRBV12-5	TRBJ2-1
TGTGCCAGCAGCCAAGATTTCGGGGGGGCCGGCACCGGGGAGCTGTTTTTT	CASSQDFGGAGTGELFF	TRBV14	TRBJ2-2
TGTGCCAGCAGAATCTTCTCATCCATTCAGTACTTC	CASRIFSSIQYF	TRBV9	TRBJ2-4
TGTGCCAGCCCCGGGACTAGCGGGGGGCGGGCCTCCTACAATGAGCAGTTCTTC	CASPGTSGGRASYNEQFF	TRBV25-1	TRBJ2-1
TGTGCCAGCCAGGAGTACTTC	CASQEYF	TRBV7-9	TRBJ2-4
TGTGCCAGCAGCTTAGCGGCGGACAGGGGGCACAAACACACTGAAGCTTTCTTT	CASSLAADRGHKHTEAFF	TRBV7-6	TRBJ1-1
TGTGCGTCAGCGGGGGGCGGCTACGAGCAGTACTTC	CASAGGGYEQYF	TRBV7-2	TRBJ2-7
TGTGCCAGCAGCGGTACAGGGCTATGTTTCGAGCCCCAGCATTTT	CASSGTGLCFEPQHF	TRBV7-2	TRBJ1-5
TGTGCCACCAGCGGAGTCTACGAGCAGTACTTC	CATSGVYEQYF	TRBV24-1	TRBJ2-7
TGTGCCAGCAGTGACGAAGTGTACGGGGGGCTCTCCAATCAGCCCCAGCATTTT	CASSDEVYGGLSNQPQHF	TRBV25-1	TRBJ1-5
TGTGCCAGCAGCTTAGCAATTCATCACCGGACCGGGGAGCTGTTTTTT	CASSLAIHHRTGELFF	TRBV7-6	TRBJ2-2
TGCAGCGTTTCCAGGGCTAACTATGGCTACACCTTC	CSVSRANYGYTF	TRBV29-1	TRBJ1-2
TGCGCCAGCATCCCCCGGACACGCCGGGCCTCTGGGGCCAACGTCCTGACTTTC	CASIPRTRRASGANVLTF	TRBV10-1	TRBJ2-6
TGCGCCAGACAGGGGTCAAATGAAAAACTGTTTTTT	CARQGSNEKLFF	TRBV5-1	TRBJ1-4
TGTGCCAGCTCCCAGTCCACGGGAAACTGCTACGAGCAGTACTTC	CASSQSTGNCYEQYF	TRBV5-6	TRBJ2-7
TGTGCCAGCAGCGGTGGGGACAGGGGGGATCAGCCCCAGCATTTT	CASSGGDRGDQPQHF	TRBV7-4	TRBJ1-5
TGTGCCAGCAGCTTAGACAGGGGATTAGACAACTATGGCTACACCTTC	CASSLDRGLDNYGYTF	TRBV11-3	TRBJ1-2
TGTGCCAGCAGCTTAAAGCCAGCGACTAGCGGACCCTACGAGCAGTACTTC	CASSLKPATSGPYEQYF	TRBV7-9	TRBJ2-7
TGCAGTGCTAGAGATGGGAGCAGGTTGAACGGGGGGACCGAGCAGTACTTC	CSARDGSRLNGGTEQYF	TRBV20-1	TRBJ2-7
TGTGCCATTAACACTGGGACGCGACAGCCCCAGCATTTT	CAINTGTRQPQHF	TRBV12-3	TRBJ1-5
TGTGCCAGCAGCTCCCTGGGGTCAGATACGCAGTATTTT	CASSSLGSDTQYF	TRBV14	TRBJ2-3
TGCGCCAGCAGATCTGAGCTGTTCGAGCAGTACTTC	CASRSELFEQYF	TRBV10-1	TRBJ2-7
TGTGCCAGCAGCTTACAATCAGATGAGCAGTTCTTC	CASSLQSDEQFF	TRBV7-2	TRBJ2-1
TGTGCCAGCAGCTGGATCGGGGGGGGAGGAGGGGGGTCCTATGGCTACACCTTC	CASSWIGGGGGGSYGYTF	TRBV11-2	TRBJ1-2
TGTGCCAGCAGTTCCTGGAATTCACCCCTCCACTTT	CASSSWNSPLHF	TRBV11-2	TRBJ1-6
TGTGCCAGCAGTGAAGCCCGTGGAGGGGAGACCCAGTACTTC	CASSEARGGETQYF	TRBV6-1	TRBJ2-5
TGTGCCAGCAGCTTGGCCGCATTGGGGGGGGTAGCCTACAATGAGCAGTTCTTC	CASSLAALGGVAYNEQFF	TRBV5-6	TRBJ2-1
TGTGCCAGCAGCCTACAGGGCAGGACAGATACGCAGTATTTT	CASSLQGRTDTQYF	TRBV3-1	TRBJ2-3
TGTGCCAGCAGGCGGGGGGCATGGGGGGATTCACCCCTCCACTTT	CASRRGAWGDSPLHF	TRBV11-2	TRBJ1-6
TGCGCCAGCAGCTTGGTTTCTGTCGATCACTACGGGGAGCTGTTTTTT	CASSLVSVDHYGELFF	TRBV5-1	TRBJ2-2
TGTGCCTGGAGTCTAGCGGGAGAGACCCAGTACTTC	CAWSLAGETQYF	TRBV30	TRBJ2-5
TGTGCCAGCAGAATTACATCATCCTTAGACGGCCGGAGGGCCTACGAGCAGTACTTC	CASRITSSLDGRRAYEQYF	TRBV6-4	TRBJ2-7
TGTGCCTGGAGTGTGGTTACTAGCGGGAGCCCGACCTACAATGAGCAGTTCTTC	CAWSVVTSGSPTYNEQFF	TRBV30	TRBJ2-1
TGCAGTGCAGGGCAAGCGAAAGGACAGGGGATTTCTGAAGCTTTCTTT	CSAGQAKGQGISEAFF	TRBV20-1	TRBJ1-1
TGTGCCACCAGTGACCGGACTGGGGATCGCGGCTCTGAAGCTTTCTTT	CATSDRTGDRGSEAFF	TRBV24-1	TRBJ1-1
TGTGCCAGCAGTGGTTTGGACAGGGTGGTAAGGGGCTACGAGCAGTACTTC	CASSGLDRVVRGYEQYF	TRBV27	TRBJ2-7
TGTGCCAGCAGCCAAAGGGGGATGAGGAGCTCCTATAATTCACCCCTCCACTTT	CASSQRGMRSSYNSPLHF	TRBV3-1	TRBJ1-6
TGTGCCAGCAGCCCAAGGCGGTTCCTGGGTCAGCCCCAGCATTTT	CASSPRRFLGQPQHF	TRBV9	TRBJ1-5
TGTGCCAGCAGTCCGTCCGACAGGGGGCAGTTACACTTC	CASSPSDRGQLHF	TRBV25-1	TRBJ2-7
TGTGCCACCAGTGAAACCCCCAGCGGGAAGACCCAGTACTTC	CATSETPSGKTQYF	TRBV24-1	TRBJ2-5
TGTGCCAGCAGCCAAGTGAGGCGATTCTACCGGAACACTGAAGCTTTCTTT	CASSQVRRFYRNTEAFF	TRBV14	TRBJ1-1
TGCAGTGCTATGGGAGGGCCGGGCAATCAGCCCCAGCATTTT	CSAMGGPGNQPQHF	TRBV20-1	TRBJ1-5
TGCAGTGCTAGAACTTTTCGACAGCTCCCACCGCTGGGCGAGCAGTACTTC	CSARTFRQLPPLGEQYF	TRBV20-1	TRBJ2-7
TGTGCCACCGAAAGGACCGGGGAGCTGTTTTTT	CATERTGELFF	TRBV14	TRBJ2-2
TGTGCCAGCAGAAAACGGATATCTGGGGCCAACGTCCTGACTTTC	CASRKRISGANVLTF	TRBV6-5	TRBJ2-6
TGTGCCAGCAGGTTGGGACTAGCGGACAGATACCAAGAGACCCAGTACTTC	CASRLGLADRYQETQYF	TRBV5-4	TRBJ2-5
TGTGCCAGCAGTTACAACCCTGGCCGGTTCGGAAGGGCTAGCCAAGAGACCCAGTACTTC	CASSYNPGRFGRASQETQYF	TRBV6-6	TRBJ2-5
TGTGCCACCAGTTATGTAGCGGGGAGCTCCTACGAGCAGTACTTC	CATSYVAGSSYEQYF	TRBV24-1	TRBJ2-7
TGTGCCAGCAGCCAAGATCGTACAGGACAGGGGATCAACTATGGCTACACCTTC	CASSQDRTGQGINYGYTF	TRBV3-1	TRBJ1-2
TGTGCCAGCAGCAGTCCATCGCGACAGGGGCCCCGGAACGAGCAGTACTTC	CASSSPSRQGPRNEQYF	TRBV13	TRBJ2-7
TGTGCCAGCAATAGGGGTGGCAGGGTCCCCCCCTTGACCCAGTACTTC	CASNRGGRVPPLTQYF	TRBV2	TRBJ2-5
TGTGCCAGCAGTCCCTCTACGCTAGGACAGGTCAAAAACATTCAGTACTTC	CASSPSTLGQVKNIQYF	TRBV6-1	TRBJ2-4
TGCAGTGGGGGGGCCAATCAGCCCCAGCATTTT	CSGGANQPQHF	TRBV20-1	TRBJ1-5
TGTGCCAGCAGCTACGAGCATAATTCACCCCTCCACTTT	CASSYEHNSPLHF	TRBV7-4	TRBJ1-6
TGTGCCAGCAGCTCGGGACTAGCAGGGAAGCAGTTCTTC	CASSSGLAGKQFF	TRBV7-9	TRBJ2-1
TGTGCCAGCAGTTACATGAGACGAGCTTTCTTT	CASSYMRRAFF	TRBV6-2	TRBJ1-1
TGTGCCAGCAGCTTAGAGGGCCCAGGGCATGAAGCTTTCTTT	CASSLEGPGHEAFF	TRBV7-8	TRBJ1-1
TGTGCCAGCAGCCTGGGAAGCAGGGGTGAAAAACTGTTTTTT	CASSLGSRGEKLFF	TRBV25-1	TRBJ1-4
TGTGCCAGCAGACGGGACAGGGGCGGTGGCTACACCTTC	CASRRDRGGGYTF	TRBV6-4	TRBJ1-2
TGTGCCAGCAGTTACTCGAAGTCACCGGGGGGGGACAACACCGGGGAGCTGTTTTTT	CASSYSKSPGGDNTGELFF	TRBV6-2	TRBJ2-2
TGCGCCAGCAGCAGGACTAGACGCCGGGAGACCCAGTACTTC	CASSRTRRRETQYF	TRBV5-1	TRBJ2-5
TGTGCCAGCAGTATATGGACAGGGGCGAGCTCCTATAATTCACCCCTCCACTTT	CASSIWTGASSYNSPLHF	TRBV6-3	TRBJ1-6
TGCGCCAGCAGCTTAGGGATGGGGGTAGCGCGCACAGATACGCAGTATTTT	CASSLGMGVARTDTQYF	TRBV5-1	TRBJ2-3
TGTGCCAGCAGTGACGGGGGACAGGGAGGTAGCGGGGAGCTGTTTTTT	CASSDGGQGGSGELFF	TRBV6-4	TRBJ2-2
TGTGCCAGCAGCGAGGACAGGAACACCGGGGAGCTGTTTTTT	CASSEDRNTGELFF	TRBV5-6	TRBJ2-2
TGTGCCAGCAGCAGCCCCCACAAAAACATTCAGTACTTC	CASSSPHKNIQYF	TRBV5-6	TRBJ2-4
TGTGCCAGCAGCTCCTCAGGGGGGCAGCCCCAGCATTTT	CASSSSGGQPQHF	TRBV7-2	TRBJ1-5
TGTGCCAGTAGGACAGGGGGCGCTAGATCCTACGAGCAGTACTTC	CASRTGGARSYEQYF	TRBV19	TRBJ2-7
TGTGCCAGCAGTGATAAACAAAGCGGGAGCCCTTACGAGCAGTACTTC	CASSDKQSGSPYEQYF	TRBV6-4	TRBJ2-7
TGTGCCAGCAGTACATTAATGGGGGGGAGGGAGACCCAGTACTTC	CASSTLMGGRETQYF	TRBV6-5	TRBJ2-5
TGTGCCATCCCGAGGGGCGCCGAGCAGTACTTC	CAIPRGAEQYF	TRBV10-3	TRBJ2-7
TGCGCCAGCAGCTCACCGGGACAGCGCTACGAGCAGTACTTC	CASSSPGQRYEQYF	TRBV5-1	TRBJ2-7
TGTGCCAGCATCTTACAACTCACTGAAGCTTTCTTT	CASILQLTEAFF	TRBV6-3	TRBJ1-1
TGCGCCAGCAGCAGGGGGGAAGGTAATTATGAAGCTTTCTTT	CASSRGEGNYEAFF	TRBV5-1	TRBJ1-1
TGTGCCAGCACACCCGTTCAGCGGGAGAGGGCCTACAATGAGCAGTTCTTC	CASTPVQRERAYNEQFF	TRBV27	TRBJ2-1
TGCAGCGTTGCCAGGCTAGCTACTACCCTCATGCCCCAGCATTTT	CSVARLATTLMPQHF	TRBV29-1	TRBJ1-5
TGTGCCAGCACTCCTAGGGACAGGGGAGGAGAGCAGTACTTC	CASTPRDRGGEQYF	TRBV6-3	TRBJ2-7
TGTGCCAGCAGTTTTAGGACACGCTCCTACGAGCAGTACTTC	CASSFRTRSYEQYF	TRBV6-1	TRBJ2-7
TGTGCCAGGCCCCCCAGGGGAATTTACGAGCAGTACTTC	CARPPRGIYEQYF	TRBV6-1	TRBJ2-7
TGCAGTGCTAGCCCGGGCCCCCACTATAGCAATCAGCCCCAGCATTTT	CSASPGPHYSNQPQHF	TRBV20-1	TRBJ1-5
TGCGCCAGCAGCTCTCATGCGGGAACCCCCTACGAGCAGTACTTC	CASSSHAGTPYEQYF	TRBV5-1	TRBJ2-7
TGTGCCAGCAGTGACGGATTAGGACCAAAGCAATACGAGCAGTACTTC	CASSDGLGPKQYEQYF	TRBV6-4	TRBJ2-7
TGTGCCAGCAGCCGGGGGGACATTCAGTACTTC	CASSRGDIQYF	TRBV5-6	TRBJ2-4
TGTGCCAGCTTCAGGATGCAGGGGACGGGTTATCAGCCCCAGCATTTT	CASFRMQGTGYQPQHF	TRBV14	TRBJ1-5
TGTGCCTGGAGGGGTTTTTATGGCTACACCTTC	CAWRGFYGYTF	TRBV30	TRBJ1-2
TGTGCCTGGAGTGCCCCCCGGCTAGCGGGAAATGATACGCAGTATTTT	CAWSAPRLAGNDTQYF	TRBV30	TRBJ2-3
TGTGCCAGCAGCTTATGGCGGACTAGGCAGTATGGCTACACCTTC	CASSLWRTRQYGYTF	TRBV7-4	TRBJ1-2
TGTGCCAGCAGGGGGTGCTGGGCAAATCAGCCCCAGCATTTT	CASRGCWANQPQHF	TRBV27	TRBJ1-5
TGTGCCAGCTCTCGTGAGACAGGGGGCTCCCGAGAGACCCAGTACTTC	CASSRETGGSRETQYF	TRBV18	TRBJ2-5
TGTGCCACCTCGCAGGTTGGGGGGGATATAGGAGAAGAGACCCAGTACTTC	CATSQVGGDIGEETQYF	TRBV24-1	TRBJ2-5
TGTGCCAGCAGCCATCCACCAGTGGACAGCTACGAGCAGTACTTC	CASSHPPVDSYEQYF	TRBV14	TRBJ2-7
TGTGCCAGCAGCCACTGGGGACAGAACCCTGAAGCTTTCTTT	CASSHWGQNPEAFF	TRBV3-1	TRBJ1-1
TGTGCCAGGGTCCGAGTGTGTATGAACACTGAAGCTTTCTTT	CARVRVCMNTEAFF	TRBV12-3	TRBJ1-1
TGTGCCAGCAGTTTAGAACCAGGATTTAACTATGGCTACACCTTC	CASSLEPGFNYGYTF	TRBV27	TRBJ1-2
TGTGCCAGCAGTGACACGGTCAGTCCCAACGTAGGCACAGATACGCAGTATTTT	CASSDTVSPNVGTDTQYF	TRBV6-4	TRBJ2-3
TGTGCCAGCAGTTACCGGTCAAAGGCGGACACAGTTTGGAGCAATCAGCCCCAGCATTTT	CASSYRSKADTVWSNQPQHF	TRBV6-3	TRBJ1-5
TGTGCCAGCAGTTACGGACTAGCGGTCTCCTACGAGCAGTACTTC	CASSYGLAVSYEQYF	TRBV6-2	TRBJ2-7
TGTGCCAGCAGCAGACGGGGACTTGCTTTCTTT	CASSRRGLAFF	TRBV7-2	TRBJ1-1
TGTGCCAGCAGTTCCCCCCTCGGGCGGGGGGAGGTACCGTGGGGCGACTCTGGGGCCAACGTCCTGACTTTC	CASSSPLGRGEVPWGDSGANVLTF	TRBV6-9	TRBJ2-6
TGCGCCAGCAGCTCCGGGACAGGGTCGTTCCATTCACCCCTCCACTTT	CASSSGTGSFHSPLHF	TRBV5-1	TRBJ1-6
TGCAGTGCTAGAGATCGGAAATGGGGGCGCGGTGATTTTAATCAGCCCCAGCATTTT	CSARDRKWGRGDFNQPQHF	TRBV20-1	TRBJ1-5
TGTGCCAGCAGTTACCATGCAGGGGGATACGAGCAGTACTTC	CASSYHAGGYEQYF	TRBV6-5	TRBJ2-7
TGTGCCTGGAGTGTACCGACCCTAGCGGAGTCCTACGAGCAGTACTTC	CAWSVPTLAESYEQYF	TRBV30	TRBJ2-7
TGTGCCAGCAGTGAATTGACCCCGGGACAGGGGGATGGCTACACCTTC	CASSELTPGQGDGYTF	TRBV25-1	TRBJ1-2
TGTGCCACCAGTAACCGCGACCCTTGGACTGAAGCTTTCTTT	CATSNRDPWTEAFF	TRBV24-1	TRBJ1-1
TGCGCCAGCAGCTTATACCTCGGGGACAGGCAAAACACCATATATTTT	CASSLYLGDRQNTIYF	TRBV5-1	TRBJ1-3
TGTGCCAGCTCACCTCAACCCCAGGGAGGGCTCTCCTACGAGCAGTACTTC	CASSPQPQGGLSYEQYF	TRBV18	TRBJ2-7
TGCGCCAGCAGCCCGAGGACAGATACGCAGTATTTT	CASSPRTDTQYF	TRBV5-1	TRBJ2-3
TGCGCCAGCAGCTCCCGGCCCCCTGGACAGAAAGGGCTTGGCTACACCTTC	CASSSRPPGQKGLGYTF	TRBV5-1	TRBJ1-2
TGTGCCAGTAGTATTCAGCACGGGGACCAAGAGACCCAGTACTTC	CASSIQHGDQETQYF	TRBV19	TRBJ2-5
TGTGCCAGCCCGCATTTCAGCTATGGCTACACCTTC	CASPHFSYGYTF	TRBV9	TRBJ1-2
TGCAGCGTTGAAGATCACTATCGAAAGGAAGGGGACAGGGGGCGGACTAATGAAAAACTGTTTTTT	CSVEDHYRKEGDRGRTNEKLFF	TRBV29-1	TRBJ1-4
TGTGCCAGCAGAGGCGGGGAACAGCCCCAGCATTTT	CASRGGEQPQHF	TRBV28	TRBJ1-5
TGTGCCAGCAGCTTGGCGGCAAGGGCCAAAAACATTCAGTACTTC	CASSLAARAKNIQYF	TRBV5-6	TRBJ2-4
TGTGCCAGCAGTATTTATCTAGCGGGAAAGGGATACGAGCAGTACTTC	CASSIYLAGKGYEQYF	TRBV6-1	TRBJ2-7
TGTGCCAGCAGTTTATGGACAGGGCCCAGAGCCACTGAAGCTTTCTTT	CASSLWTGPRATEAFF	TRBV28	TRBJ1-1
TGCGCCAGCAGCTTTTCTATAAAAAACGCCACAGATACGCAGTATTTT	CASSFSIKNATDTQYF	TRBV5-1	TRBJ2-3
TGTGCCAGCAGTTACTCATTCGGACCAGGCTCTCAGCCCCAGCATTTT	CASSYSFGPGSQPQHF	TRBV6-5	TRBJ1-5
TGCAGCGGACAAAAGGAGGGGAGTTACGAGCAGTACTTC	CSGQKEGSYEQYF	TRBV29-1	TRBJ2-7
TGTGCCAGCAGTTTACCGGGGACCGTAGCTTTCTTT	CASSLPGTVAFF	TRBV27	TRBJ1-1
TGTGCCAGTAGCCTCGGGGGACCCGACAGGGAGCGGACTAATGAAAAACTGTTTTTT	CASSLGGPDRERTNEKLFF	TRBV19	TRBJ1-4
TGTGCCAGCAGCGGTCAGAACATTCAGCCCCAGCATTTT	CASSGQNIQPQHF	TRBV9	TRBJ1-5
TGCAGTGCAGCCGGGACTAGCGGGGTCTACAATGAGCAGTTCTTC	CSAAGTSGVYNEQFF	TRBV20-1	TRBJ2-1
TGTGCCAGCAGCTGCCAGGGGGCGCGATTGGGGGAGAATGAAAAACTGTTTTTT	CASSCQGARLGENEKLFF	TRBV13	TRBJ1-4
TGTGCCAGCAGTTACGGGGACAGGGCTCGGCCCCAGCATTTT	CASSYGDRARPQHF	TRBV6-5	TRBJ1-5
TGTGCCAGCAGTCACCTAGAGGGGTGCGGGGAGCTGTTTTTT	CASSHLEGCGELFF	TRBV27	TRBJ2-2
TGCAGTGCTAGACCAGGACCCACAGATACGCAGTATTTT	CSARPGPTDTQYF	TRBV20-1	TRBJ2-3
TGTGCCAGCAGCTATCGGGAGCCTCACTACGAGCAGTACTTC	CASSYREPHYEQYF	TRBV7-9	TRBJ2-7
TGTGCCACCAGTGATATATTGTTCCGGCCCAGGGATCGGACCCAAGAGACCCAGTACTTC	CATSDILFRPRDRTQETQYF	TRBV24-1	TRBJ2-5
TGTGCCAGCAGCCCCAGAGTTGGGCGCGTGGGCTACACCTTC	CASSPRVGRVGYTF	TRBV13	TRBJ1-2
TGTGCCAGCAGCCAAGAACTTCCGACAACACAAGATGGCTACACCTTC	CASSQELPTTQDGYTF	TRBV4-2	TRBJ1-2
TGTGCCAGCAGTGAACTACAGGGGGCCGACTTCCACACTGAAGCTTTCTTT	CASSELQGADFHTEAFF	TRBV6-1	TRBJ1-1
TGTGCCAGCAGCCAAGCCCCTTTGGGACTAGCGGGAGATTTTTACGAGCAGTACTTC	CASSQAPLGLAGDFYEQYF	TRBV4-2	TRBJ2-7
TGTGCCACCAGGGCCGACAGGGATGGTGAAAACATTCAGTACTTC	CATRADRDGENIQYF	TRBV24-1	TRBJ2-4
TGTGCCAGCAGTGAGAAAGGGGGGGTGGTAGCCAAAAACATTCAGTACTTC	CASSEKGGVVAKNIQYF	TRBV6-1	TRBJ2-4
TGCGCCAGGGATGAGGGAGTTTCCCAGCATTTT	CARDEGVSQHF	TRBV10-1	TRBJ1-5
TGTGCTAGTGGTTTGTGGGATCTGTCTTACAATGAGCAGTTCTTC	CASGLWDLSYNEQFF	TRBV12-5	TRBJ2-1
TGTGCCGATTCCAGGGTCATAGTTCTCTCCTACGAGCAGTACTTC	CADSRVIVLSYEQYF	TRBV11-2	TRBJ2-7
TGTGCCAGTAAAAACAGGGTCAGTAAGTCACCCCTCCACTTT	CASKNRVSKSPLHF	TRBV19	TRBJ1-6
TGCAGTGCTAGAGATCCCGGGGATGGAGGGGTAAGGGGGGGTCTTAATCAGCCCCAGCATTTT	CSARDPGDGGVRGGLNQPQHF	TRBV20-1	TRBJ1-5
TGTGCCAGCGGCTGGGACAGGGTTGTAGGGGAGCTGTTTTTT	CASGWDRVVGELFF	TRBV27	TRBJ2-2
TGTGCCAGCAGTTTTGGGGGGGAGGGTGATCAGCCCCAGCATTTT	CASSFGGEGDQPQHF	TRBV27	TRBJ1-5
TGTGCCAGTAAGTCCGGGACTAGCTTTAGCTGTTCCGGGGAGCTGTTTTTT	CASKSGTSFSCSGELFF	TRBV27	TRBJ2-2
TGTGCCAGCAGCCCGGCTCTTGCCTACGAGCAGTACTTC	CASSPALAYEQYF	TRBV9	TRBJ2-7
TGTGCCTGGAGTGTAAACCGGGCTGATAATGAAAAACTGTTTTTT	CAWSVNRADNEKLFF	TRBV30	TRBJ1-4
TGTGCCAGCAAGCGGGAGAAAGAGATAAACGAGCAGTACTTC	CASKREKEINEQYF	TRBV6-4	TRBJ2-7
TGTGCCAGCAGCTTAACTAAGAACGTCACAGATACGCAGTATTTT	CASSLTKNVTDTQYF	TRBV7-3	TRBJ2-3
TGTGCCAGCATGGAATCAGGGAGTGAGACCCAGTACTTC	CASMESGSETQYF	TRBV6-4	TRBJ2-5
TGTGCCAGCAGCTCAATTGGACAGGGCGAATTTGGGCTTCAAGAGACCCAGTACTTC	CASSSIGQGEFGLQETQYF	TRBV13	TRBJ2-5
TGTGCCAGCAGCGTTGGTGGGGGCTTGCCCCCGTCAGGGATCCTATTTGAAGCTTTCTTT	CASSVGGGLPPSGILFEAFF	TRBV5-6	TRBJ1-1
TGTGCCAGCAGTGAAGTAATACGTTCTACACTTACGAACACCGGGGAGCTGTTTTTT	CASSEVIRSTLTNTGELFF	TRBV25-1	TRBJ2-2
TGTGCCAGCAGCTTAGCCAGCGGGGACAGGAACACTGAAGCTTTCTTT	CASSLASGDRNTEAFF	TRBV7-2	TRBJ1-1
TGTGCCAGCAGCAGACCCAGTGGGACAGGGCTGAACACTGAAGCTTTCTTT	CASSRPSGTGLNTEAFF	TRBV2	TRBJ1-1
TGCAGCGTTGAATTGGGGGGAGGGAATGAGCAGTTCTTC	CSVELGGGNEQFF	TRBV29-1	TRBJ2-1
TGTGCCAGCAGTTATGGCGAGACCCAGTACTTC	CASSYGETQYF	TRBV27	TRBJ2-5
TGTGCCAGCTACGGGCTCAACACTGAAGCTTTCTTT	CASYGLNTEAFF	TRBV6-8	TRBJ1-1
TGTGCCAGAGGTGTCCAGGGGAACACCGGGGAGCTGTTTTTT	CARGVQGNTGELFF	TRBV6-2	TRBJ2-2
TGTGCCAGCCTATTCGGACAGGTCCCGGGCAATCAGCCCCAGCATTTT	CASLFGQVPGNQPQHF	TRBV9	TRBJ1-5
TGTGCCAGCAGGGGGTCCAGCAATCAGCCCCAGCATTTT	CASRGSSNQPQHF	TRBV7-3	TRBJ1-5
TGTGCCAGCAGCCGGGGCAGGGGCCTTCCTGAAAAACTGTTTTTT	CASSRGRGLPEKLFF	TRBV27	TRBJ1-4
TGTGCCAGCAGCTTACTGGGACAGGGGATGAACACTGAAGCTTTCTTT	CASSLLGQGMNTEAFF	TRBV7-9	TRBJ1-1
TGTGCCAGTAGGACAGGGCTGCCCAGGGGTTCGATGAACACTGAAGCTTTCTTT	CASRTGLPRGSMNTEAFF	TRBV19	TRBJ1-1
TGTGCCAGCAGTGAAGTGAGGGGCTATAATTCACCCCTCCACTTT	CASSEVRGYNSPLHF	TRBV2	TRBJ1-6
TGTGCCAGCAGCCCAGACCCCAGGGGGCCATTCCTGCCCCAGCATTTT	CASSPDPRGPFLPQHF	TRBV14	TRBJ1-5
TGTGCCAGCAGCTCACCCCTTATTTCCTACAATGAGCAGTTCTTC	CASSSPLISYNEQFF	TRBV7-3	TRBJ2-1
TGTGCCAGCAGCCAAGATGCACCTCGGACAGGGTTGACAGCTTTCTTT	CASSQDAPRTGLTAFF	TRBV14	TRBJ1-1
TGTGCCAGCACCAAGTCAGGGCTACGAGGGACTGAAGCTTTCTTT	CASTKSGLRGTEAFF	TRBV28	TRBJ1-1
TGTGCGAGCGAGCAGTACTTC	CASEQYF	TRBV24-1	TRBJ2-7
TGTGCCAGCAGTGAATTTGACTGGTTCCCCCAGACCCAGTACTTC	CASSEFDWFPQTQYF	TRBV25-1	TRBJ2-5
TGTGCCAGCAGCCCTTTAAAAAGCCCCCTAGCGGGACGCCGGACGCAGTATTTT	CASSPLKSPLAGRRTQYF	TRBV7-2	TRBJ2-3
TGTGCCACCGACTCTGGGTGGCGGGGTCACTACGAGCAGTACTTC	CATDSGWRGHYEQYF	TRBV24-1	TRBJ2-7
TGTGCCCTTAAGGTTACTGAAGCTTTCTTT	CALKVTEAFF	TRBV7-7	TRBJ1-1
TGCGCCAGCAGCGCCCCGGGACAGGGTAGCTCCTATAATTCACCCCTCCACTTT	CASSAPGQGSSYNSPLHF	TRBV5-1	TRBJ1-6
TGTGCCAGCAGCTTCCCAGTTTCTAGCGGGAGCCTCTACAATGAGCAGTTCTTC	CASSFPVSSGSLYNEQFF	TRBV7-2	TRBJ2-1
TGTGCCAGCAGTTACTCGTGGCCGGGAGGACATGAAAAACTGTTTTTT	CASSYSWPGGHEKLFF	TRBV6-2	TRBJ1-4
TGCAGTGCTAGCCGATCATCGGGGAATGAAAAACTGTTTTTT	CSASRSSGNEKLFF	TRBV20-1	TRBJ1-4
TGTGCCACCAGTGAGAAGGGACTAGCGGTCAGAGCCGACACAGATACGCAGTATTTT	CATSEKGLAVRADTDTQYF	TRBV24-1	TRBJ2-3
TGTGCCAGCAGCTGGCCCTGCGGTGAGCAGTTCTTC	CASSWPCGEQFF	TRBV7-3	TRBJ2-1
TGTGCCACCCGCTGCGAGCGCCGGTACTTC	CATRCERRYF	TRBV24-1	TRBJ2-4
TGTGCCAGCAGTTACGCCGGGACAGTGAACACTGAAGCTTTCTTT	CASSYAGTVNTEAFF	TRBV6-5	TRBJ1-1
TGTGCCAGCAGCTATCAGGGGGTTATAACTAGCAATCAGCCCCAGCATTTT	CASSYQGVITSNQPQHF	TRBV11-3	TRBJ1-5
TGCAGTGCTAGTGGTCAGCCGGGACGATTGCCTGAAGCTTTCTTT	CSASGQPGRLPEAFF	TRBV20-1	TRBJ1-1
TGTGCCACCAGCTCGCTTTCAGGCAAGGCTGCAACTAATGAAAAACTGTTTTTT	CATSSLSGKAATNEKLFF	TRBV15	TRBJ1-4
TGCGCCAGCAGCTTGCCGTTTTATAGGGTAGAAAAACGAGAGACCCAGTACTTC	CASSLPFYRVEKRETQYF	TRBV5-1	TRBJ2-5
TGTGCCAGCAGTTTAAACGGACAGGGGTATAATGAAAAACTGTTTTTT	CASSLNGQGYNEKLFF	TRBV27	TRBJ1-4
TGCGCCAAGACTAGCGGGCCAGATTACTACGAGCAGTACTTC	CAKTSGPDYYEQYF	TRBV10-1	TRBJ2-7
TGCAGTGCTATAAGGGGAGGGATGAACACTGAAGCTTTCTTT	CSAIRGGMNTEAFF	TRBV20-1	TRBJ1-1
TGCGCCAGCAGCCAAGATGCCCTTAGGACAGGGAACTATGGCTACACCTTC	CASSQDALRTGNYGYTF	TRBV4-1	TRBJ1-2
TGTGCCAGTAGGGGCGGGACGGGTACTCCGGAGACCCAGTACTTC	CASRGGTGTPETQYF	TRBV19	TRBJ2-5
TGCGCCAGTCGGCCGGGACTAGCGGGAGCCTACGAGCAGTACTTC	CASRPGLAGAYEQYF	TRBV10-1	TRBJ2-7
TGTGCCACCAGGTCCGCGAGCGGGAGTACGGAAGGAACCGGGGAGCTGTTTTTT	CATRSASGSTEGTGELFF	TRBV24-1	TRBJ2-2
TGCAGTGCTAGAGATCACGGGACACCACACACTGAAGCTTTCTTT	CSARDHGTPHTEAFF	TRBV20-1	TRBJ1-1
TGTGCCTGGAGATTAAAGGCCGGGACAGGGACGAACACCGGGGAGCTGTTTTTT	CAWRLKAGTGTNTGELFF	TRBV30	TRBJ2-2
TGTGCCAGCAGCTTAGGCGGCGCGGTAGCCAAAAACATTCAGTACTTC	CASSLGGAVAKNIQYF	TRBV11-2	TRBJ2-4
TGCGCCAGCAGTGACCACCGGGGGGGTGACACCGGGGAGCTGTTTTTT	CASSDHRGGDTGELFF	TRBV10-2	TRBJ2-2
TGTGCTAGCAGCTTAGCCCCCGTCCCAGTAGCGAGGAGTAACGAGCAGTACTTC	CASSLAPVPVARSNEQYF	TRBV7-7	TRBJ2-7
TGCGCCAGCAGCTTGGCCAGAAAGGACAGGGAACTGGCTTTCTTT	CASSLARKDRELAFF	TRBV5-1	TRBJ1-1
TGCGCCAGCAGCTTGGCAGGGCGGGAGACCCAGTACTTC	CASSLAGRETQYF	TRBV5-1	TRBJ2-5
TGCAGCGTTGTTAGGGGGTGGTGTCACTATGGCTACACCTTC	CSVVRGWCHYGYTF	TRBV29-1	TRBJ1-2
TGTGCCAGCAGCCTTCCCGGCCCAGGGAACACCGGGGAGCTGTTTTTT	CASSLPGPGNTGELFF	TRBV7-2	TRBJ2-2
TGTGCCATCAGTGAGGGGACACAGGGGGCTCGATCCGGGGAGCTGTTTTTT	CAISEGTQGARSGELFF	TRBV10-3	TRBJ2-2
TGTGCCAGCAGCCAAGAACAGGACTACGAGCAGTACTTC	CASSQEQDYEQYF	TRBV4-2	TRBJ2-7
TGTGCCAGCAGTGAATCAGCCGGGACATACGAGCAGTACTTC	CASSESAGTYEQYF	TRBV6-1	TRBJ2-7
TGTGCCAGCAGCGTTGACCCGATCCGGGACGACGTCGAGACCCAGTACTTC	CASSVDPIRDDVETQYF	TRBV28	TRBJ2-5
TGTGCCACACGAACCCTACAGAATACGCAGTATTTT	CATRTLQNTQYF	TRBV24-1	TRBJ2-3
TGCAGTGCTTCCGGGGACGAGCAGTACTTC	CSASGDEQYF	TRBV20-1	TRBJ2-7
TGTGCCAGCCCTTGGGGCTCTGATGAGACCCAGTACTTC	CASPWGSDETQYF	TRBV2	TRBJ2-5
TGTGCCAGCAGTGAAAGCCTTTGGGGGGGGAGAGTCACTGAAGCTTTCTTT	CASSESLWGGRVTEAFF	TRBV6-1	TRBJ1-1
TGTGCCAGCAGCAAAGGGGTTAGGACCCAGTACTTC	CASSKGVRTQYF	TRBV7-3	TRBJ2-5
TGCAGCGTCGCCCCGGGACTAGGGTCCTACGAGCAGTACTTC	CSVAPGLGSYEQYF	TRBV29-1	TRBJ2-7
TGTGCCACCGGACTATCGCCCACCTACGAGCAGTACTTC	CATGLSPTYEQYF	TRBV4-2	TRBJ2-7
TGTGCCAGCAGTCGGGGGGGCTACGAGCAGTACTTC	CASSRGGYEQYF	TRBV6-6	TRBJ2-7
TGTGCCAGCCGAACTACTAGCGGGAGAGCGTCAGGACGGGGTCCTCAGCCCCAGCATTTT	CASRTTSGRASGRGPQPQHF	TRBV28	TRBJ1-5
TGTGCCAGCAGTTCATGGGCCCCGGGACAATGGCTGAACACCGGGGAGCTGTTTTTT	CASSSWAPGQWLNTGELFF	TRBV6-2	TRBJ2-2
TGCGCCAGCAGCCAAGAGACAGGGCGGGGCTACGAGCAGTACTTC	CASSQETGRGYEQYF	TRBV4-1	TRBJ2-7
TGTGCTAGTGGTTTGGGTACAGGGGCTGAAAAACTGTTTTTT	CASGLGTGAEKLFF	TRBV12-5	TRBJ1-4
TGTGCCAGCAGTGAGTCCCCCTGGGGACCCCAGCATTTT	CASSESPWGPQHF	TRBV2	TRBJ1-5
TGTGCCAGCAGTGAGCGGTTACCAGTCGGGGTCACCGGGGAGCTGTTTTTT	CASSERLPVGVTGELFF	TRBV2	TRBJ2-2
TGTGCCACCAGTGATAAGCGGGGGGGCTACAATGAGCAGTTCTTC	CATSDKRGGYNEQFF	TRBV24-1	TRBJ2-1
TGTGCCAGCAGCCGGGGGGGGGGGGACTACAATGAGCAGTTCTTC	CASSRGGGDYNEQFF	TRBV7-3	TRBJ2-1
TGTGCCAGCAGCACAGGCATTGCCAATGAGCAGTTCTTC	CASSTGIANEQFF	TRBV2	TRBJ2-1
TGTGCCAGCAGCGACCCAAATGGTGAACCCGCAGATACGCAGTATTTT	CASSDPNGEPADTQYF	TRBV13	TRBJ2-3
TGTGCCACCAGTCCAGGGGCCGGCTATGGCTACACCTTC	CATSPGAGYGYTF	TRBV24-1	TRBJ1-2
TGTGCCAGCCCGGCCGGGACAGGGACGATGAACACTGAAGCTTTCTTT	CASPAGTGTMNTEAFF	TRBV19	TRBJ1-1
TGTGCCAGCAGCTTAGGTGCTGGCGACTATGGCTACACCTTC	CASSLGAGDYGYTF	TRBV11-2	TRBJ1-2
TGTGCCAGCAGCTCCTTGTCAGGGGTACCGTACGAGCAGTACTTC	CASSSLSGVPYEQYF	TRBV7-9	TRBJ2-7
TGTGCCAGCTATCCTGTGGGACAGTGTTACGAGCAGTACTTC	CASYPVGQCYEQYF	TRBV19	TRBJ2-7
TGTGCCAGCTCAGTCCGGCGGGAGAAGCGGGGCGAGCAGTACTTC	CASSVRREKRGEQYF	TRBV18	TRBJ2-7
TGTGCCAGCAGCCCCGTTGCGGGGGGAGCCACCCAGCATTTT	CASSPVAGGATQHF	TRBV14	TRBJ1-5
TGTGCCAGCAGTTACGGGGCCCACGACACTGAAGCTTTCTTT	CASSYGAHDTEAFF	TRBV6-6	TRBJ1-1
TGTGCCAGCAGTGAGGGGGGGACCAAATACAATGAGCAGTTCTTC	CASSEGGTKYNEQFF	TRBV25-1	TRBJ2-1
TGTGCCAGCAGCCGGACGCCCTACGAGCAGTACTTC	CASSRTPYEQYF	TRBV27	TRBJ2-7
TGTGCCACCAGGTTGGGGACAGGGGAGAGCTATGGCTACACCTTC	CATRLGTGESYGYTF	TRBV24-1	TRBJ1-2
TGTGCCAGTAGGCGGGGGGGGCCACCTAATCAGCCCCAGCATTTT	CASRRGGPPNQPQHF	TRBV19	TRBJ1-5
TGCGCCAGCACGATGGGGAGTAGCAATCAGCCCCAGCATTTT	CASTMGSSNQPQHF	TRBV10-2	TRBJ1-5
TGTGCCAGCAGCGTAGAAAAGGGGACGGCGAACACCGGGGAGCTGTTTTTT	CASSVEKGTANTGELFF	TRBV9	TRBJ2-2
TGTGCCAGCAGAGAAGGCTTCGGAGACAATGAGCAGTTCTTC	CASREGFGDNEQFF	TRBV6-1	TRBJ2-1
TGTGCCAGCAGCCTAACGGAGGATCAGCCCCAGCATTTT	CASSLTEDQPQHF	TRBV13	TRBJ1-5
TGTGCCAGCAGTCGGGGGTCGGGTAGGGGCGATGGCTACACCTTC	CASSRGSGRGDGYTF	TRBV6-4	TRBJ1-2
TGTGCCAGCAGGCGTGGGAGGACAGGGGGCGCGACTTGTCAGCCCCAGCATTTT	CASRRGRTGGATCQPQHF	TRBV6-6	TRBJ1-5
TGTGCCAGCAGCCAAGAGAGTCCCGGACAGGGTGCGGCGATAGGGAACACTGAAGCTTTCTTT	CASSQESPGQGAAIGNTEAFF	TRBV14	TRBJ1-1
TGTGCCAGCATAACGCTCAGGGGCCCCGACTATAGCAATCAGCCCCAGCATTTT	CASITLRGPDYSNQPQHF	TRBV7-2	TRBJ1-5
TGTGCCAGCAGCTTCCTTGGACTAGCGGGGAACAATGAGCAGTTCTTC	CASSFLGLAGNNEQFF	TRBV5-4	TRBJ2-1
TGCGCCAGCAGCTTAACGAAAGGGGACAACACCATATATTTT	CASSLTKGDNTIYF	TRBV5-1	TRBJ1-3
TGTGCCAGGGTGGACAGGGGGACCGGGAACACTGAAGCTTTCTTT	CARVDRGTGNTEAFF	TRBV27	TRBJ1-1
TGTGCCAGTAGTATCCGGGGGGGACATAATTCACCCCTCCACTTT	CASSIRGGHNSPLHF	TRBV19	TRBJ1-6
TGTGCCAGCAGCCAAGATTGGACAGGGACTAGAGATAATTCACCCCTCCACTTT	CASSQDWTGTRDNSPLHF	TRBV14	TRBJ1-6
TGTGCCAGCATAGACGAGCAGTACTTC	CASIDEQYF	TRBV25-1	TRBJ2-7
TGCAGCGTTGAAGAGCCAGGGAGTAATGGGGGATTCGGCTCCTACGAGCAGTACTTC	CSVEEPGSNGGFGSYEQYF	TRBV29-1	TRBJ2-7
TGCGCCAGCAGCGACTATTTCGAGCAGTACTTC	CASSDYFEQYF	TRBV5-1	TRBJ2-7
TGCAGTGCTGCTGAGCATAACGGGACAGGGCCCTATGGCTACACCTTC	CSAAEHNGTGPYGYTF	TRBV20-1	TRBJ1-2
TGTGCCACCAGTGATTTGCTCCTGTCGGACAGTTCTAGCAATCAGCCCCAGCATTTT	CATSDLLLSDSSSNQPQHF	TRBV24-1	TRBJ1-5
TGCGCCAGCAGCTTGGCGGAGGGGGGGGGGGGAGATACGCAGTATTTT	CASSLAEGGGGDTQYF	TRBV5-1	TRBJ2-3
TGCGCCAGCAGCTTGGCCCTGCAGGGTTGGGGCTACACCTTC	CASSLALQGWGYTF	TRBV5-1	TRBJ1-2
TGCGCCAGCAGCTCCAACAGGGGGCTCCTTCTGGAATATAGCAATCAGCCCCAGCATTTT	CASSSNRGLLLEYSNQPQHF	TRBV5-1	TRBJ1-5
TGTGCCAGCAGCCAACAGGACAGGGATGGCTACACCTTC	CASSQQDRDGYTF	TRBV28	TRBJ1-2
TGTGCCTGGAGTGTACGGGGGAGCACTAATCAGCCCCAGCATTTT	CAWSVRGSTNQPQHF	TRBV30	TRBJ1-5
TGTGCCAGCAGCTTAGCGCCCTGGGATCTTGAGCTTCGGTTGACGGCTTACTACGAGCAGTACTTC	CASSLAPWDLELRLTAYYEQYF	TRBV7-8	TRBJ2-7
TGTGCCAGCATCCATCGGACAGGGGGCCCTTTAAGGGCCAACGTCCTGACTTTC	CASIHRTGGPLRANVLTF	TRBV28	TRBJ2-6
TGTGCCAGCAGCTTTGGGGCCTCGAACACTGAAGCTTTCTTT	CASSFGASNTEAFF	TRBV7-3	TRBJ1-1
TGTGCCTGGAGTGGCGCCAAGACTGGGGCCAACGTCCTGACTTTC	CAWSGAKTGANVLTF	TRBV30	TRBJ2-6
TGTGCCAGCAGTCCCGAGAGGGGGCCCCAGCATTTT	CASSPERGPQHF	TRBV27	TRBJ1-5
TGTGCCAGCAGCCAAGATTTCAGGGGGTATTGCAATCAGCCCCAGCATTTT	CASSQDFRGYCNQPQHF	TRBV4-2	TRBJ1-5
TGTGCCAGCAGAGGGACAGGGGGGCTTAACTATGGCTACACCTTC	CASRGTGGLNYGYTF	TRBV28	TRBJ1-2
TGTGCCAGCAGCGAGGGCGACAGAGCCCGCTATGGCTACACCTTC	CASSEGDRARYGYTF	TRBV13	TRBJ1-2
TGCGCCAGCAGCTTAGGGTCCCCCCAAGGAAACACCATATATTTT	CASSLGSPQGNTIYF	TRBV5-1	TRBJ1-3
TGTGCCAGCAGTTTTGGGGGGACGCAGCCCCAGCATTTT	CASSFGGTQPQHF	TRBV27	TRBJ1-5
TGCGCCAGCAGCTTAGGGGGCAATCAGCCCCAGCATTTT	CASSLGGNQPQHF	TRBV5-1	TRBJ1-5
TGTGCCAGCAGTTTAGAGGACTCCTACGAGCAGTACTTC	CASSLEDSYEQYF	TRBV27	TRBJ2-7
TGCGCCAGCAACGAGTTCCTCTGGGCTAATGAAAAACTGTTTTTT	CASNEFLWANEKLFF	TRBV10-1	TRBJ1-4
TGTGCCAGCACCCGGAGCTCTGGAAACACCATATATTTT	CASTRSSGNTIYF	TRBV7-9	TRBJ1-3
TGTGCCAGCAGCTTCTGGGACAGGTGCTCTGGGGCCAACGTCCTGACTTTC	CASSFWDRCSGANVLTF	TRBV11-3	TRBJ2-6
TGTGCCAGCAGCCCCGGACAGGGCGTCAATCAGCCCCAGCATTTT	CASSPGQGVNQPQHF	TRBV14	TRBJ1-5
TGTGCCCGCCGACAGTCTACCATGAACACTGAAGCTTTCTTT	CARRQSTMNTEAFF	TRBV28	TRBJ1-1
TGTGCCAGCAGCTCTAGCGGGCGATCCTACAATGAGCAGTTCTTC	CASSSSGRSYNEQFF	TRBV11-3	TRBJ2-1
TGTGCCAGCAGCTTAGCTCATCACGGACAGGGGCAACACGAGCAGTACTTC	CASSLAHHGQGQHEQYF	TRBV11-2	TRBJ2-7
TGTGCCAGCAGCAGGAGACAGGGAGCTTTCTTT	CASSRRQGAFF	TRBV7-2	TRBJ1-1
TGTGCCAGCAGCACCCCCCGGGACGCGAACACTGAAGCTTTCTTT	CASSTPRDANTEAFF	TRBV7-8	TRBJ1-1
TGTGCCAATGGGGCCACCTTC	CANGATF	TRBV24-1	TRBJ1-2
TGTGCCAGCTCTAAAAACGGATTTGCTAGCACAGATACGCAGTATTTT	CASSKNGFASTDTQYF	TRBV28	TRBJ2-3
TGCAGTGCCAGGGACACAAATAGCAATCAGCCCCAGCATTTT	CSARDTNSNQPQHF	TRBV20-1	TRBJ1-5
TGTGCCAGCATGGGGGCCCTTACTGAAGCTTTCTTT	CASMGALTEAFF	TRBV6-3	TRBJ1-1
TGTGCCAGCAGTTTGGATGTACCAACTAATGAAAAACTGTTTTTT	CASSLDVPTNEKLFF	TRBV27	TRBJ1-4
TGTGCCAGCAGCTTGAAGGGGGCCTTCTACGAGCAGTACTTC	CASSLKGAFYEQYF	TRBV5-4	TRBJ2-7
TGCGCCAGCAGCTTGCCTGTAGATCCCCGACTAACGAACACTGAAGCTTTCTTT	CASSLPVDPRLTNTEAFF	TRBV5-1	TRBJ1-1
TGCGCCAGCAGCAATCGCCGACGAATGGGGCAGTACTTC	CASSNRRRMGQYF	TRBV5-1	TRBJ2-7
TGTGCCAGCACGGACAGGGGACCGGCAGATACGCAGTATTTT	CASTDRGPADTQYF	TRBV7-9	TRBJ2-3
TGTGCCAGCAGAGTCGGGCTTACTAACGAGCAGTACTTC	CASRVGLTNEQYF	TRBV6-4	TRBJ2-7
TGCGCCAGCAGCCAAGAAGTCAGGGGGTTCTGCGCTTTCTTT	CASSQEVRGFCAFF	TRBV4-3	TRBJ1-1
TGCGCCAGCAGCCAGGAGACTAGCGGGGACAGTACGCAGTATTTT	CASSQETSGDSTQYF	TRBV4-1	TRBJ2-3
TGCAGTGCTCACCACCTATACGAGCAGTACTTC	CSAHHLYEQYF	TRBV20-1	TRBJ2-7
TGTGCCAGCAGCCAAGGAAAGGGACTAGCGGGGCTTCACAATGAGCAGTTCTTC	CASSQGKGLAGLHNEQFF	TRBV4-2	TRBJ2-1
TGTGCCACCGGAGGGGAGGACAGGGGTACGCGAAGCACAGATACGCAGTATTTT	CATGGEDRGTRSTDTQYF	TRBV24-1	TRBJ2-3
TGTGCCAGCAGCAGGTCCCCGACAATGTTCTCCTGTTATCAGCCCCAGCATTTT	CASSRSPTMFSCYQPQHF	TRBV13	TRBJ1-5
TGCGCCAGCAGCTTCCAAGGACGCACAGATACGCAGTATTTT	CASSFQGRTDTQYF	TRBV5-1	TRBJ2-3
TGTGCCACTGACCGGGGGGGCAGTCGAGAGACCCAGTACTTC	CATDRGGSRETQYF	TRBV24-1	TRBJ2-5
TGCGCCAGCAGGAAACAGGGAACCCTCCACTTT	CASRKQGTLHF	TRBV5-1	TRBJ1-6
TGTGCCACCAGCAGTCAGTTGGAGACCCAGTACTTC	CATSSQLETQYF	TRBV15	TRBJ2-5
TGCGCCAGCAGTGAGCCTCCCTGGGGGGGGGCGAACACCGGGGAGCTGTTTTTT	CASSEPPWGGANTGELFF	TRBV10-1	TRBJ2-2
TGTGCCAGCAGCTCAGGGGCTAACTACGAGCAGTACTTC	CASSSGANYEQYF	TRBV7-3	TRBJ2-7
TGTGCCATCAGTCCAAGACAGGGTCCATGTAACTATGGCTACACCTTC	CAISPRQGPCNYGYTF	TRBV10-3	TRBJ1-2
TGTGCCAAAGGGACAACCTACAATGAGCAGTTCTTC	CAKGTTYNEQFF	TRBV10-3	TRBJ2-1
TGCGCCAGCAGCCAAGACCCCGGGGGGTTTTTCAATGAGCAGTTCTTC	CASSQDPGGFFNEQFF	TRBV4-1	TRBJ2-1
TGCAGTGCTAGAGATCTCCGAGGCAATCAGCCCCAGCATTTT	CSARDLRGNQPQHF	TRBV20-1	TRBJ1-5
TGTGCCGAGGGGGGGCGACCCTACGAGCAGTACTTC	CAEGGRPYEQYF	TRBV7-2	TRBJ2-7
TGTGCCAGCAGCCCCAGGACTTCACCCCTCCACTTT	CASSPRTSPLHF	TRBV13	TRBJ1-6
TGTGCCAGTGACGCCTCAAACGGGGATGGCTACACCTTC	CASDASNGDGYTF	TRBV19	TRBJ1-2
TGTGCCAGCAGACTTGACAGGGACAATGAGCAGTTCTTC	CASRLDRDNEQFF	TRBV28	TRBJ2-1
TGTGCCAGCAGTTCCAGTGTTTGGCGGTATCCCCTCCACTTT	CASSSSVWRYPLHF	TRBV6-5	TRBJ1-6
TGTGCCAGCAGCTTATACGGGGCAACGTATGGCTACACCTTC	CASSLYGATYGYTF	TRBV7-9	TRBJ1-2
TGCACCCCATTCAACTCTCCGCACGAGCAGTACTTC	CTPFNSPHEQYF	TRBV20-1	TRBJ2-7
TGTGCCAGTAGTATCCGACCTTGCACTGAAGCTTTCTTT	CASSIRPCTEAFF	TRBV19	TRBJ1-1
TGTGCCATCTTTTGGGGACTTGTCACCGGGGAGCTGTTTTTT	CAIFWGLVTGELFF	TRBV10-3	TRBJ2-2
TGTGCCAGCAGTGACCTCAGCGTCTACGAGCAGTACTTC	CASSDLSVYEQYF	TRBV6-4	TRBJ2-7
TGTGCCAGTCGCTGTTCTACCTACAACACCGGGGAGCTGTTTTTT	CASRCSTYNTGELFF	TRBV3-1	TRBJ2-2
TGCGCCAGCAGCCAGGGGGCTGACTCTGGAAACACCATATATTTT	CASSQGADSGNTIYF	TRBV5-1	TRBJ1-3
TGTGCCAGCAGCCGAACCCCCAGAGGGGCGCCATGCAATCAGCCCCAGCATTTT	CASSRTPRGAPCNQPQHF	TRBV7-4	TRBJ1-5
TGTGCCACCAGCAGGGGACAGGCGGGTGGAAATGAGCAGTTCTTC	CATSRGQAGGNEQFF	TRBV15	TRBJ2-1
TGTGCCAGCAGTTTCGTCTTGGAGGAATCGGACAGGGGCAATCAGCCCCAGCATTTT	CASSFVLEESDRGNQPQHF	TRBV12-4	TRBJ1-5
TGTGCTAGTGGGGTGACAGACAGGGGGGACCCCTATAGCAATCAGCCCCAGCATTTT	CASGVTDRGDPYSNQPQHF	TRBV12-5	TRBJ1-5
TGTGCCAGCAGCCCCGACGTTGGCTACACCTTC	CASSPDVGYTF	TRBV28	TRBJ1-2
TGTGCCAGCAGGCGGGACAGCGGGGCCTACGAGCAGTACTTC	CASRRDSGAYEQYF	TRBV25-1	TRBJ2-7
TGTGCCAGCCGAGGGGGGAAGGGCCAAGAGACCCAGTACTTC	CASRGGKGQETQYF	TRBV7-8	TRBJ2-5
TGTGCCAGCGGGGGCCCAGTACTACCGCCGGAGCAGTACTTC	CASGGPVLPPEQYF	TRBV5-6	TRBJ2-7
TGTGCCATCAGTGTGGGGATCGTTAACTATGGCTACACCTTC	CAISVGIVNYGYTF	TRBV10-3	TRBJ1-2
TGTGCCAGCAGTTTCCATGGGCGACAGCCCCAGCATTTT	CASSFHGRQPQHF	TRBV27	TRBJ1-5
TGTGCCACCATAAAAGAATCGGACAGGGCCTATGGCTACACCTTC	CATIKESDRAYGYTF	TRBV24-1	TRBJ1-2
TGTGCCAGCAGTTTGAGGGGAAACGGGGAGCTGTTTTTT	CASSLRGNGELFF	TRBV12-3	TRBJ2-2
TGTGCCTGGAAACAGGGAGGGGCTCCTAACTATGGCTACACCTTC	CAWKQGGAPNYGYTF	TRBV30	TRBJ1-2
TGTGCCAGCAGTCTCCTCAACACAACAGATACGCAGTATTTT	CASSLLNTTDTQYF	TRBV12-3	TRBJ2-3
TGTGCCAGCAGGACAGTCTTCAGGAAACTGTTTTTT	CASRTVFRKLFF	TRBV6-5	TRBJ1-4
TGTGCCAGCAGCTGCCCCAGGGCCCGGTGGGTACAAGAGACCCAGTACTTC	CASSCPRARWVQETQYF	TRBV11-2	TRBJ2-5
TGTGCCAGCTCACCACCGCGCCCCTCTCGGGCCTACGAGCAGTACTTC	CASSPPRPSRAYEQYF	TRBV18	TRBJ2-7
TGTGCCAGCAGCTTAAGGGCCACCGGGGAGCTGTTTTTT	CASSLRATGELFF	TRBV7-2	TRBJ2-2
TGTGCCACCCGGACTGGGGGTCCAACTAGGAGCACAGATACGCAGTATTTT	CATRTGGPTRSTDTQYF	TRBV27	TRBJ2-3
TGTGCCTGGATTCGTCTAGACAGGGATAGCAATCAGCCCCAGCATTTT	CAWIRLDRDSNQPQHF	TRBV30	TRBJ1-5
TGTGCCTGGATTTGGCCGAGTGGGACAGGGGGATCTGTAAAAATGAACACTGAAGCTTTCTTT	CAWIWPSGTGGSVKMNTEAFF	TRBV30	TRBJ1-1
TGTGCCAGCAGCTTCTGGAGCCCGTCACAGAAGGCCAAAAACATTCAGTACTTC	CASSFWSPSQKAKNIQYF	TRBV7-9	TRBJ2-4
TGTGCCAGCAGCAGGAACGAGCAGTACTTC	CASSRNEQYF	TRBV7-9	TRBJ2-7
TGTGCCAGCAGTCTACGGGAGGGCAATGAGCAGTTCTTC	CASSLREGNEQFF	TRBV6-4	TRBJ2-1
TGTGCCAGCAGCTTAAGTAGGTCGAACACTTCGGGGGGGTACTTC	CASSLSRSNTSGGYF	TRBV11-3	TRBJ2-7
TGTGCCAGCAGCTATGGGAGGAACACCGGGGAGCTGTTTTTT	CASSYGRNTGELFF	TRBV5-6	TRBJ2-2
TGCGCCAGCAGCCAAGATTCACGGGGGCGCACTAGCAATCAGCCCCAGCATTTT	CASSQDSRGRTSNQPQHF	TRBV4-1	TRBJ1-5
TGTGCCAGCAGTTACTCTACCAGGGTTGGGAAGTTATTCACTGAAGCTTTCTTT	CASSYSTRVGKLFTEAFF	TRBV6-5	TRBJ1-1
TGTGCCAGAACTTCCGGGGCCAGCAATCAGCCCCAGCATTTT	CARTSGASNQPQHF	TRBV19	TRBJ1-5
TGTGCCAGCAGCTCCATCGGGGGCTTGAGGGGAAACACTGAAGCTTTCTTT	CASSSIGGLRGNTEAFF	TRBV7-2	TRBJ1-1
TGTGCCAGCAGCCCCCCCCAGGGACGCGCTTTCTTT	CASSPPQGRAFF	TRBV7-3	TRBJ1-1
TGCAGTGCCAGCCGGGGGCAATTCAATGAAAAACTGTTTTTT	CSASRGQFNEKLFF	TRBV20-1	TRBJ1-4
TGCGCCAGCAGCCAAGTCCCACAGGGAGGTTATCAGCCCCAGCATTTT	CASSQVPQGGYQPQHF	TRBV4-1	TRBJ1-5
TGTGCCAGCAGGGTAATTTACAGGGTGGAGACCTACGAGCAGTACTTC	CASRVIYRVETYEQYF	TRBV6-5	TRBJ2-7
TGTGCCAGCAGTTACTCTGTGAACCACAGCACAGATACGCAGTATTTT	CASSYSVNHSTDTQYF	TRBV6-5	TRBJ2-3
TGCAGCGTTGTCTTTGCTGACGAGCAGTACTTC	CSVVFADEQYF	TRBV29-1	TRBJ2-7
TGTGCCACCAGCTGGGAGGGTCTAGCCCAGCAGTTCTTC	CATSWEGLAQQFF	TRBV24-1	TRBJ2-1
TGTGCCAGCAGTTGGCCCAAGAAACCTCCAGTCTCCTATAATTCACCCCTCCACTTT	CASSWPKKPPVSYNSPLHF	TRBV6-4	TRBJ1-6
TGTGCCAGCAGCTGGGGGGGGGGAGATGAGCAGTTCTTC	CASSWGGGDEQFF	TRBV13	TRBJ2-1
TGTGCCAGCAGCGGTGGACAGGGGGCAAACAATCAGCCCCAGCATTTT	CASSGGQGANNQPQHF	TRBV7-3	TRBJ1-5
TGTGCCAGCATTATGTTGCAGGGACTAGGTTACAATGAGCAGTTCTTC	CASIMLQGLGYNEQFF	TRBV6-4	TRBJ2-1
TGTGCCAGCAGTCCCAGGACGGGTGGCTACACCTTC	CASSPRTGGYTF	TRBV6-2	TRBJ1-2
TGTGCCAGCATAAAAAAAGGGACATATGGCTACACCTTC	CASIKKGTYGYTF	TRBV28	TRBJ1-2
TGTGCCAGACCTATTCCTAGCACAGATACGCAGTATTTT	CARPIPSTDTQYF	TRBV7-9	TRBJ2-3
TGTGCCAGCAGCGTCTTAGATCAGCCCCAGCATTTT	CASSVLDQPQHF	TRBV13	TRBJ1-5
TGTGCCAGCAGTACATGGCCGCGGAACAGGGACCTAACATTCTACGAGCAGTACTTC	CASSTWPRNRDLTFYEQYF	TRBV6-4	TRBJ2-7
TGTGCCAGCAGCTTTCCAGGGAGCAACTACTATGGCTACACCTTC	CASSFPGSNYYGYTF	TRBV11-2	TRBJ1-2
TGTGCCTGGCAGACCTATGGCTACACCTTC	CAWQTYGYTF	TRBV30	TRBJ1-2
TGCAGTGCAGGGGGTTCAGGGGACCCTTACGAGCAGTACTTC	CSAGGSGDPYEQYF	TRBV20-1	TRBJ2-7
TGTGCCAGCAGCGCTAAAGGGGAGACAGGGGCTAACTATGGCTACACCTTC	CASSAKGETGANYGYTF	TRBV9	TRBJ1-2
TGTGCCAGCAGTAAGGGACAGCCGAGCTCCTACAATGAGCAGTTCTTC	CASSKGQPSSYNEQFF	TRBV6-4	TRBJ2-1
TGCGCCAGCAGCTTGCATAGAATCACAGATACGCAGTATTTT	CASSLHRITDTQYF	TRBV5-1	TRBJ2-3
TGTGCCACCCTCCACACTAGCGGGAGCGAGCAGTACTTC	CATLHTSGSEQYF	TRBV24-1	TRBJ2-7
TGTGCCAGCAGCCAAGCCTCCTCCGACGGGGGAAGGTTGGAGGAGCAGTACTTC	CASSQASSDGGRLEEQYF	TRBV4-2	TRBJ2-7
TGTGCCAGCAGCTTGGCAAACAGGGTAGGACAGCCCCAGCATTTT	CASSLANRVGQPQHF	TRBV5-6	TRBJ1-5
TGTGCCAGCAGCGTGACGGGATTAGCTAACTATGGCTACACCTTC	CASSVTGLANYGYTF	TRBV13	TRBJ1-2
TGCAGCGTCCCCCCTGGACGACCCAATTCACCCCTCCACTTT	CSVPPGRPNSPLHF	TRBV29-1	TRBJ1-6
TGTGCCAGCAGCTCAGGCCGGCCCTGGGCTAATGAAAAACTGTTTTTT	CASSSGRPWANEKLFF	TRBV7-9	TRBJ1-4
TGTGCCAGTGCCCCGGGGGCTTACGAGCAGTACTTC	CASAPGAYEQYF	TRBV6-2	TRBJ2-7
TGTGCTAGTGGTTTCCCGGGACAGGGCCCGTGTAGCAATCAGCCCCAGCATTTT	CASGFPGQGPCSNQPQHF	TRBV12-5	TRBJ1-5
TGTGCCAGCAGTCAGGGGAGGTACGAGCAGTACTTC	CASSQGRYEQYF	TRBV6-3	TRBJ2-7
TGTGCCAGCTACGTCAGTATCTGTAATTCACCCCTCCACTTT	CASYVSICNSPLHF	TRBV6-1	TRBJ1-6
TGCAGTGCTAGAGTAGGGGGGGGAGGGGGGGCCGAGCAGTACTTC	CSARVGGGGGAEQYF	TRBV20-1	TRBJ2-7
TGTGCCACCAGTGACTCTGGGACTAGCGGACACCTGGGCTACGAGCAGTACTTC	CATSDSGTSGHLGYEQYF	TRBV24-1	TRBJ2-7
TGTGCCAGCAGCATGTCCCGGGACAGGGACTACACCTTC	CASSMSRDRDYTF	TRBV7-9	TRBJ1-2
TGTGCCAGCAGCTTAACCGAGACAGCAAACACCATATATTTT	CASSLTETANTIYF	TRBV7-3	TRBJ1-3
TGTGCCACCAGTCAAGACCAGGGACAGGGGAGCTCCTACGAGCAGTACTTC	CATSQDQGQGSSYEQYF	TRBV24-1	TRBJ2-7
TGTGCCAGCAGCTGTTGGACAGCTAGCGGTCCTGAAGCTTTCTTT	CASSCWTASGPEAFF	TRBV5-6	TRBJ1-1
TGCGCCAGCAGCCAAGACACCACAGGGGTTAGCTCTGGGGCCAACGTCCTGACTTTC	CASSQDTTGVSSGANVLTF	TRBV4-3	TRBJ2-6
TGTGCCAGCAGCTTAGTGGGCACAGCTTTCTTT	CASSLVGTAFF	TRBV11-3	TRBJ1-1
TGTGCCAGCAGTGGTAAACAGGGCGCGTATAGCAATCAGCCCCAGCATTTT	CASSGKQGAYSNQPQHF	TRBV6-4	TRBJ1-5
TGTGCCAGCAGCGGCAGCCTAAGAGAGTACTTC	CASSGSLREYF	TRBV5-6	TRBJ2-7
TGCAGTGCTACCCGGGACTCCTACGAGCAGTACTTC	CSATRDSYEQYF	TRBV20-1	TRBJ2-7
TGTGCCTGGAGTCAAATACTAGCAGAACACATTCAGTACTTC	CAWSQILAEHIQYF	TRBV30	TRBJ2-4
TGTGCCAGCAGCTTCGGCGCGGAGGGGCAAGAGACCCAGTACTTC	CASSFGAEGQETQYF	TRBV7-9	TRBJ2-5
TGTGCCAGCAGCAATTTCGAGGGAAGAGGGAAGCAAGAGACCCAGTACTTC	CASSNFEGRGKQETQYF	TRBV7-2	TRBJ2-5
TGTGCCCACCCTTACGAGCAGTACTTC	CAHPYEQYF	TRBV10-3	TRBJ2-7
TGTGCCAGCAGTTTACGGCGGTCCAGCAATGAGCAGTTCTTC	CASSLRRSSNEQFF	TRBV27	TRBJ2-1
TGCGCCAGCATGGTTCTAGGGGCCCCGGATAGGGGGGCCAAAAACATTCAGTACTTC	CASMVLGAPDRGAKNIQYF	TRBV10-1	TRBJ2-4
TGTGCCAGCAGTTGTGGGACAGGCACCGGGGAGCTGTTTTTT	CASSCGTGTGELFF	TRBV6-9	TRBJ2-2
TGTGCCAGCAGCCCTCGGGACAGGGGGGCCACTGAAGCTTTCTTT	CASSPRDRGATEAFF	TRBV14	TRBJ1-1
TGTGCCAGCAGCGGTAATACTGAAGCTTTCTTT	CASSGNTEAFF	TRBV7-4	TRBJ1-1
TGTGCCAGGAACAAAGGGCCCCCGCATGGTCAGCCCCAGCATTTT	CARNKGPPHGQPQHF	TRBV6-2	TRBJ1-5
TGTGCCAGTACCAAAATCCCAGAGACGGGAAAAGAGCAGTACTTC	CASTKIPETGKEQYF	TRBV19	TRBJ2-7
TGTGCCAGCAGCCACCCCCGTTTAGGCGCCGGACTAGGAACTGAGCAGTTCTTC	CASSHPRLGAGLGTEQFF	TRBV3-1	TRBJ2-1
TGTGCCAGCTACAGCGGGACGAACTATGGCTACACCTTC	CASYSGTNYGYTF	TRBV6-1	TRBJ1-2
TGTGCCACCAGTGACCCACGGGGACTGGACTATGGCTACACCTTC	CATSDPRGLDYGYTF	TRBV24-1	TRBJ1-2
TGCGCCATCCACTCGGACAGGGGCTGGAGCTCTGGAAACACCATATATTTT	CAIHSDRGWSSGNTIYF	TRBV5-1	TRBJ1-3
TGTGCCAGCAGCTTAGCCGACAGCAAACAGGATGGCTACACCTTC	CASSLADSKQDGYTF	TRBV7-2	TRBJ1-2
TGCAGTGAGGCTGAGACCCAGTACTTC	CSEAETQYF	TRBV20-1	TRBJ2-5
TGTGCCAGCAGGTGGCTCACCGGGACAGGGGTCACTAAGAACACTGAAGCTTTCTTT	CASRWLTGTGVTKNTEAFF	TRBV7-6	TRBJ1-1
TGCGCCAGCACGGGGCTCCGGATTGGTGGGGCGAACACCGGGGAGCTGTTTTTT	CASTGLRIGGANTGELFF	TRBV10-2	TRBJ2-2
TGTGCCAGCAGCGGACGAGACAGGGGGCAAGGATACTACGAGCAGTACTTC	CASSGRDRGQGYYEQYF	TRBV9	TRBJ2-7
TGTGCCAGCAGCCCACGGGCTCCGGGACCCAATCAGCCCCAGCATTTT	CASSPRAPGPNQPQHF	TRBV27	TRBJ1-5
TGCGCCAGCAGCCAAGGCTCCGGGACATACGAGCAGTACTTC	CASSQGSGTYEQYF	TRBV4-3	TRBJ2-7
TGTGCCAGCAGCGGGCAGGAGAGTTACGAGCAGTACTTC	CASSGQESYEQYF	TRBV12-4	TRBJ2-7
TGCAGTGCTAAGGGCTACGAGCAGTACTTC	CSAKGYEQYF	TRBV20-1	TRBJ2-7
TGCAGTGCTAGTCCCAGGGCTAACTATGGCTACACCTTC	CSASPRANYGYTF	TRBV20-1	TRBJ1-2
TGTGCCAGCAGCTTAGCCCAGGAGTGGCCAACGGGGGCCCCGAGAAATGAGCAGTTCTTC	CASSLAQEWPTGAPRNEQFF	TRBV7-4	TRBJ2-1
TGTGCCAGCAGTTTACCCGGGTCGAGCGAGCAGTACTTC	CASSLPGSSEQYF	TRBV27	TRBJ2-7
TGTGCCAGCTCAAACACACCACTTCCTGTGGGGGTGGGGGAAAAACTGTTTTTT	CASSNTPLPVGVGEKLFF	TRBV18	TRBJ1-4
TGCGCCAGCAGCTTCATGTTTGCCATCCGGGTTCCGGGTCAGCCCCAGCATTTT	CASSFMFAIRVPGQPQHF	TRBV5-1	TRBJ1-5
TGTGCCATCATGACAGGGTTCCAGACCCAGTACTTC	CAIMTGFQTQYF	TRBV10-3	TRBJ2-5
TGTGCCAGCAGCGGACTCCGGGACAGCCCAGAGACCCAGTACTTC	CASSGLRDSPETQYF	TRBV7-3	TRBJ2-5
TGTGCCAGCACATACTCGAAGGCCTACGAGCAGTACTTC	CASTYSKAYEQYF	TRBV9	TRBJ2-7
TGTGCCTGGAGGACAGGGGGCTCTGGGGCCAACGTCCTGACTTTC	CAWRTGGSGANVLTF	TRBV30	TRBJ2-6
TGTGCCAGCAGCTTGGGTACGGGACTGGTGTGGATGTACAATGAGCAGTTCTTC	CASSLGTGLVWMYNEQFF	TRBV5-6	TRBJ2-1
TGTGCCAGTTTCCAAATCTGTGGGAGGGGAGTTAATGAGCAGTTCTTC	CASFQICGRGVNEQFF	TRBV19	TRBJ2-1
TGTGCCAGCAGCCAAGTAAATATCCCGGGAACCGGGACTAGCGGGAGTGGGGCGTGGGACGGGGAGCTGTTTTTT	CASSQVNIPGTGTSGSGAWDGELFF	TRBV14	TRBJ2-2
TGTGCCAGCAGTTGGCAGAACCAGCAGGGCGGCAACTATGGCTACACCTTC	CASSWQNQQGGNYGYTF	TRBV12-4	TRBJ1-2
TGCAGTGCTGCCGGAGGGGGCGAGTCTCTAGACAATGAGCAGTTCTTC	CSAAGGGESLDNEQFF	TRBV20-1	TRBJ2-1
TGTGCCAGCAGTGATCTGGCTTGCCAGGCCTCCAATGAGCAGTTCTTC	CASSDLACQASNEQFF	TRBV6-4	TRBJ2-1
TGTGCCAACTGCCAGGTAGGTGGAAGGGCACCTAATGAAAAACTGTTTTTT	CANCQVGGRAPNEKLFF	TRBV5-4	TRBJ1-4
TGTGCCAGCTCACCTTTGCGGAAAAGAACGCAGTATTTT	CASSPLRKRTQYF	TRBV18	TRBJ2-3
TGTGCCAGCAGTTTGGGTAGGGCAGTAGATCAGCCCCAGCATTTT	CASSLGRAVDQPQHF	TRBV12-3	TRBJ1-5
TGTGCCAGCAGAGGGGGGGGAGGGTCCACCGGGGAGCTGTTTTTT	CASRGGGGSTGELFF	TRBV6-6	TRBJ2-2
TGTGCCAGCAGCCGCCGGACAGGGGAATATAATCAGCCCCAGCATTTT	CASSRRTGEYNQPQHF	TRBV7-3	TRBJ1-5
TGTGCCAGCAGCCAATCTGCACAGTGGTGGGATGGCTACACCTTC	CASSQSAQWWDGYTF	TRBV3-1	TRBJ1-2
TGTGCCAGCCGGGCAGGGTTGAGAAAGACCCAGTACTTC	CASRAGLRKTQYF	TRBV7-9	TRBJ2-5
TGTGCCAGCAGCCTTCCCCAGCCTTCCTACAATGAGCAGTTCTTC	CASSLPQPSYNEQFF	TRBV13	TRBJ2-1
TGCGCCAGCAGTGATGAGGACAGGTACGAGACCCAGTACTTC	CASSDEDRYETQYF	TRBV10-1	TRBJ2-5
TGTGCCACCAGCAGGGGTACGCGGGGGAACATTCAGTACTTC	CATSRGTRGNIQYF	TRBV15	TRBJ2-4
TGCAGTGCTAGAGATAGGCCGACGAACACTGAAGCTTTCTTT	CSARDRPTNTEAFF	TRBV20-1	TRBJ1-1
TGTGCCTGGAGTGTATCCGCTCTGTCCAGGGGACAGGTTCGAAACACTGAAGCTTTCTTT	CAWSVSALSRGQVRNTEAFF	TRBV30	TRBJ1-1
TGTGCCAGCAGTTATTGGACGGCGGGACAGGGACGGTTTGGGGTTGCTTTCTTT	CASSYWTAGQGRFGVAFF	TRBV6-3	TRBJ1-1
TGTGCCAGCTCACTGTTTCCGGGTCTACCCAGAACGGATTCCAGCTCCTACAATGAGCAGTTCTTC	CASSLFPGLPRTDSSSYNEQFF	TRBV18	TRBJ2-1
TGTGCCAGCAGCCTCAAGGGGGCTCAGCCCCAGCATTTT	CASSLKGAQPQHF	TRBV9	TRBJ1-5
TGCATCATACGGGACAGTGAGCAGTTCTTC	CIIRDSEQFF	TRBV29-1	TRBJ2-1
TGCAGTGCTAGAGGGTGGGCCAGCGAGCAGTACTTC	CSARGWASEQYF	TRBV20-1	TRBJ2-7
TGCAGCGCAAACAGGGCCCCAAGCTACACCTTC	CSANRAPSYTF	TRBV29-1	TRBJ1-2
TGTGCCTGGAGTGTACGCCAAGGGCATTTAAATGAGCAGTTCTTC	CAWSVRQGHLNEQFF	TRBV30	TRBJ2-1
TGTGCCAGCAGTGACGGCTCCGGACTAGCGGGTTACTACAATGAGCAGTTCTTC	CASSDGSGLAGYYNEQFF	TRBV6-4	TRBJ2-1
TGTGCCAGCACCGGTCGGGGACTAGCGGGGACCTACAATGAGCAGTTCTTC	CASTGRGLAGTYNEQFF	TRBV7-2	TRBJ2-1
TGTGCCAGCAAGCCCGGACAGGGGTACAATGAGCAGTTCTTC	CASKPGQGYNEQFF	TRBV2	TRBJ2-1
TGTGCCAGCAGCGAAGGGAGGGGAAGGACCCAGTACTTC	CASSEGRGRTQYF	TRBV7-7	TRBJ2-5
TGTGCCAGCAGCTTACCAACGAACCGTAACTATGGCTACACCTTC	CASSLPTNRNYGYTF	TRBV13	TRBJ1-2
TGTGCCAGCAGCCCGCAGGGCTGGGGTAACACCGGGGAGCTGTTTTTT	CASSPQGWGNTGELFF	TRBV12-4	TRBJ2-2
TGCAGTGCTCCTACAGGGGGCCTAGATGGCTACACCTTC	CSAPTGGLDGYTF	TRBV20-1	TRBJ1-2
TGTGCCAGCAGCACCCCGGGACTGAACACCGGGGAGCTGTTTTTT	CASSTPGLNTGELFF	TRBV13	TRBJ2-2
TGTGCCAGCAGCAAAAGGTACGGGGAGCTGTTTTTT	CASSKRYGELFF	TRBV7-2	TRBJ2-2
TGTGCCTGGAGTGACAAGGAACTAACAGGGGTGGCTTTCTTT	CAWSDKELTGVAFF	TRBV30	TRBJ1-1
TGTGCTAGTGGTCGGGACAGGGGAGCTCAGCCCCAGCATTTT	CASGRDRGAQPQHF	TRBV12-5	TRBJ1-5
TGTGCCAGTAGTACTAAAGTGCCTTATGAGCAGTTCTTC	CASSTKVPYEQFF	TRBV19	TRBJ2-1
TGTGCCAGCAGCAAAGGGGGCAGACAAAACTACGAGCAGTACTTC	CASSKGGRQNYEQYF	TRBV5-6	TRBJ2-7
TGTGCCAGCAGCTTAGCAGAACTGAATGTCAGGGCGGTAACCGTCACTGAAGCTTTCTTT	CASSLAELNVRAVTVTEAFF	TRBV11-2	TRBJ1-1
TGTGCCAGCAGCAGAGGGGATAACTATGGCTACACCTTC	CASSRGDNYGYTF	TRBV13	TRBJ1-2
TGCGCCAGCAGTGAGATGGGCTACAATGAGCAGTTCTTC	CASSEMGYNEQFF	TRBV10-1	TRBJ2-1
TGTGCCATCAGTCCTAGTGGGATGGACTATGGCTACACCTTC	CAISPSGMDYGYTF	TRBV10-3	TRBJ1-2
TGTGCCAGCAGCGGGGGGGGACTCCCAGATACGCAGTATTTT	CASSGGGLPDTQYF	TRBV13	TRBJ2-3
TGTGCCAGCAGCCCACTAGCGGCTTCCGGGGCCAACGTCCTGACTTTC	CASSPLAASGANVLTF	TRBV13	TRBJ2-6
TGTGCCAGCAGTTCCGGGGGGGTGTGGCGAGGCACAGATACGCAGTATTTT	CASSSGGVWRGTDTQYF	TRBV27	TRBJ2-3
TGTGCCACCAGTGACCGACCCCCGTGGGCCATATTGGGAGAGACCCAGTACTTC	CATSDRPPWAILGETQYF	TRBV24-1	TRBJ2-5
TGTGCCAGCTCCTCGGGAGGGGGGACCCGGTACGAGCAGTACTTC	CASSSGGGTRYEQYF	TRBV6-1	TRBJ2-7
TGCGCCAGCAGCTCCTTGATGTTGGTAAGAACAATTAGGGGGCACGAGCAGTACTTC	CASSSLMLVRTIRGHEQYF	TRBV5-1	TRBJ2-7
TGCAGTGCTGACAAAGAGACCCAGTACTTC	CSADKETQYF	TRBV20-1	TRBJ2-5
TGTGCCAGCAGCTTGATAGGGGGGCCCGGGACCTACGAGCAGTACTTC	CASSLIGGPGTYEQYF	TRBV5-6	TRBJ2-7
TGTGCCAGCTCACCAGCCGGGACAGGGGGCCGAGTCCTGACTTTC	CASSPAGTGGRVLTF	TRBV18	TRBJ2-6
TGTGCCAGCAGTTTGGTATCTTACAATGAGCAGTTCTTC	CASSLVSYNEQFF	TRBV12-3	TRBJ2-1
TGCAGTGCTATCGGGGTAGACGGAAGATCGGAGCAGTACTTC	CSAIGVDGRSEQYF	TRBV20-1	TRBJ2-7
TGTGCCACCAGTGAGAGAGTCCGGGGCCATGGCTACACCTTC	CATSERVRGHGYTF	TRBV24-1	TRBJ1-2
TGTGCCACCAGTGATTGCATGACAGGGGGCCCCTACAATGAGCAGTTCTTC	CATSDCMTGGPYNEQFF	TRBV24-1	TRBJ2-1
TGTGCCAGCAAGGTAACTCCCATTCGGATCGCCGAGCAGTACTTC	CASKVTPIRIAEQYF	TRBV6-4	TRBJ2-7
TGTGCCAGCAGCCGCGGTAGGGAAGGAAAAAACATTCAGTACTTC	CASSRGREGKNIQYF	TRBV3-1	TRBJ2-4
TGTGCCAGCAGCCAAGCCCACCACGAGAGTTTCACAGATACGCAGTATTTT	CASSQAHHESFTDTQYF	TRBV14	TRBJ2-3
TGTGCCAGCAGTCCCACCACTAGCGGGCGGACAGAGACCCAGTACTTC	CASSPTTSGRTETQYF	TRBV27	TRBJ2-5
TGTGCCAGCAGCAGGGGGGCGGGCTACGAGCAGTACTTC	CASSRGAGYEQYF	TRBV27	TRBJ2-7
TGTGCTAGTGGTTTGGTACGGTGGGACAACATCGGGGAGCTGTTTTTT	CASGLVRWDNIGELFF	TRBV12-5	TRBJ2-2
TGTGCCAGCAGTCCACTAACTCGCTATGGCTACACCTTC	CASSPLTRYGYTF	TRBV7-9	TRBJ1-2
TGTGCCAGCAGCGCACTGACAGGGGGGAATCAGCCCCAGCATTTT	CASSALTGGNQPQHF	TRBV9	TRBJ1-5
TGTGCCAGCAGCCAAGACCACAGTGGGGACAGGGTGGGGAACACTGAAGCTTTCTTT	CASSQDHSGDRVGNTEAFF	TRBV3-1	TRBJ1-1
TGCGCCAGCAGCCAAGATAGACCCGGGACAGATAAGCCCCAGCATTTT	CASSQDRPGTDKPQHF	TRBV4-1	TRBJ1-5
TGTGCCATCAGTGGGCTCGGGAGGGGACCTAGCACAGATACGCAGTATTTT	CAISGLGRGPSTDTQYF	TRBV10-3	TRBJ2-3
TGCGCCAGCAGTGGTAGTAGCGGGAACCAAGAGACCCAGTACTTC	CASSGSSGNQETQYF	TRBV10-1	TRBJ2-5
TGTGCCAGCAGCTTAATAGGGGGACACTGTTGGGGCAATGAGCAGTTCTTC	CASSLIGGHCWGNEQFF	TRBV7-3	TRBJ2-1
TGTGCCACCCAAAGGGTCGCTAACTATGGCTACACCTTC	CATQRVANYGYTF	TRBV9	TRBJ1-2
TGTGCCAGCAGCTGGAGTACTAGAAACGTGGAAGAGACCCAGTACTTC	CASSWSTRNVEETQYF	TRBV11-3	TRBJ2-5
TGTGCCAGCATTAAGCGGGATTTTCCCCTCACCGGGGAGCTGTTTTTT	CASIKRDFPLTGELFF	TRBV11-2	TRBJ2-2
TGTGCCAGCAGCTTAATCTGGGGGCAAATCGAAAAACTGTTTTTT	CASSLIWGQIEKLFF	TRBV5-4	TRBJ1-4
TGCAGTGCTAGAGGGCAGGGGTTCAATCCAGGGCCGTGGGATGAGCAGTTCTTC	CSARGQGFNPGPWDEQFF	TRBV20-1	TRBJ2-1
TGTGCCAGCAGTTCGCGTAGAGAAGAGACCCAGTACTTC	CASSSRREETQYF	TRBV6-9	TRBJ2-5
TGTGCCAGCAAGGGGGTTAAGAACTATGGCTACACCTTC	CASKGVKNYGYTF	TRBV6-4	TRBJ1-2
TGTGAGGGGGCGGGAGGCTATATGGTAGGCACAGATACGCAGTATTTT	CEGAGGYMVGTDTQYF	TRBV28	TRBJ2-3
TGTGCCAGCAGCTTAAGTGTTCCCTGTCGGACAGGGCAAGAAAAACTGTTTTTT	CASSLSVPCRTGQEKLFF	TRBV7-9	TRBJ1-4
TGCGCCAGCAGTATGCTACCCGGGGAAGGTGGCTACACCTTC	CASSMLPGEGGYTF	TRBV10-1	TRBJ1-2
TGTGCCAGCAGTTTGTATGGACAGCCGGGGGAAAAACTGTTTTTT	CASSLYGQPGEKLFF	TRBV28	TRBJ1-4
TGTGCCTGGTCAGGACTAGCGGGGGGCAGGAACACCGGGGAGCTGTTTTTT	CAWSGLAGGRNTGELFF	TRBV7-4	TRBJ2-2
TGTGCCAGCAGCTTGCCATTGGGAGGGGAAAAACTGTTTTTT	CASSLPLGGEKLFF	TRBV11-2	TRBJ1-4
TGTGCCAGCAGCTTGAACAGGCCGGGGGAGACCCAGTACTTC	CASSLNRPGETQYF	TRBV5-6	TRBJ2-5
TGTGCCAGCAGTTACAGGGGGGAGCAGTACTTC	CASSYRGEQYF	TRBV6-6	TRBJ2-7
TGTGCCAGCAGCGCTATGCAAAAGGGGGAGACCGGTACTTTCAATCAGCCCCAGCATTTT	CASSAMQKGETGTFNQPQHF	TRBV13	TRBJ1-5
TGCGCCAGCAGCCAAAACGGAAGCTACAATGAGCAGTTCTTC	CASSQNGSYNEQFF	TRBV4-1	TRBJ2-1
TGTGCCAGCAGTGACTCCGTAGAACACGAGCAGTACTTC	CASSDSVEHEQYF	TRBV6-4	TRBJ2-7
TGCAGTGCTTTGCGGGAACAGCCCCAGCATTTT	CSALREQPQHF	TRBV20-1	TRBJ1-5
TGCGCCAGCAGCCTAACAGGGAGCTCCTACAATGAGCAGTTCTTC	CASSLTGSSYNEQFF	TRBV5-1	TRBJ2-1
TGTGCCAGCAGCTTTTCGACAGGGACCATGAACACTGAAGCTTTCTTT	CASSFSTGTMNTEAFF	TRBV7-3	TRBJ1-1
TGTGCCAGCAGTGATCGAGGGAGCTCTGGAAACACCATATATTTT	CASSDRGSSGNTIYF	TRBV6-5	TRBJ1-3
TGTGCCACCAGCGGGACCACTGAAGCTTTCTTT	CATSGTTEAFF	TRBV15	TRBJ1-1
TGTGCCAGCAGGTTTGGCCGTACTAGCGGAAGGAAAGAGACCCAGTACTTC	CASRFGRTSGRKETQYF	TRBV6-3	TRBJ2-5
TGTGCCAGCAGCTGCGACAGACGCAATCAGCCCCAGCATTTT	CASSCDRRNQPQHF	TRBV5-6	TRBJ1-5
TGCAGCGGTGGAGCCAGGAATTCACCCCTCCACTTT	CSGGARNSPLHF	TRBV29-1	TRBJ1-6
TGTGCCAGCAGCGTGCGGGACAGGTTAGAGGAGCTGTTTTTT	CASSVRDRLEELFF	TRBV2	TRBJ2-2
TGTGCCAGCAGGCCGGAGGGCAGTTCCTACAATGAGCAGTTCTTC	CASRPEGSSYNEQFF	TRBV2	TRBJ2-1
TGCGCCAGCAGTGGGGACAGGACGGTACAGAACTATGGCTACACCTTC	CASSGDRTVQNYGYTF	TRBV10-1	TRBJ1-2
TGTGCCAGCTCCCAGGAATGGAAGGGGGCTGAAGCTTTCTTT	CASSQEWKGAEAFF	TRBV18	TRBJ1-1
TGTGCCAGCAGTCAGGGGGCTTCGGCTGAAGCTTTCTTT	CASSQGASAEAFF	TRBV9	TRBJ1-1
TGTGCCAGCAGCAAACCGGGACTAGCATCACCGGGATTTCCCCAAGAGACCCAGTACTTC	CASSKPGLASPGFPQETQYF	TRBV5-6	TRBJ2-5
TGTGCCAGCAGCGTGGGTTGGACTAGCGGGGACACAGATACGCAGTATTTT	CASSVGWTSGDTDTQYF	TRBV2	TRBJ2-3
TGTGCCAGCAGCTCTGGACTAGCGGGGGTCTACGAGCAGTACTTC	CASSSGLAGVYEQYF	TRBV13	TRBJ2-7
TGTGCCAGCAGCGGTAACGGAATGCAGGACAGGGCAGCTAACTATGGCTACACCTTC	CASSGNGMQDRAANYGYTF	TRBV13	TRBJ1-2
TGTGCCAGCAGCTTCTTGACGATTCTCGAGACCCAGTACTTC	CASSFLTILETQYF	TRBV5-6	TRBJ2-5
TGTGCCAGCAGCGTCCACAGGGGAGATTCACCCCTCCACTTT	CASSVHRGDSPLHF	TRBV7-4	TRBJ1-6
TGTGCCAGCAGCCCAGTAGACGGGCATACTGCTTTCTTT	CASSPVDGHTAFF	TRBV6-5	TRBJ1-1
TGCGCCAGCAGCTACCATAGCGGGCCCGTATCCTACAATGAGCAGTTCTTC	CASSYHSGPVSYNEQFF	TRBV5-1	TRBJ2-1
TGCGCCAGCAGCTTACTAGCGGTGGGCGGGGAGCTGTTTTTT	CASSLLAVGGELFF	TRBV5-1	TRBJ2-2
TGCAGTGCTAGCAGGCCTCCAGGCGTTAGATCCTACGAGCAGTACTTC	CSASRPPGVRSYEQYF	TRBV20-1	TRBJ2-7
TGTGCCAGGGGACAGGGGAACATTCAGTACTTC	CARGQGNIQYF	TRBV10-3	TRBJ2-4
TGTGCCAGCAGTTCCGGGACAGGCTGGCCCTATGGCTACACCTTC	CASSSGTGWPYGYTF	TRBV9	TRBJ1-2
TGCAGTGCTAGCCCCCCACAAGGAAACACCATATATTTT	CSASPPQGNTIYF	TRBV20-1	TRBJ1-3
TGTGCCAGCAGCTTAGCCAGCGGGATGGGGGCCAACGTCCTGACTTTC	CASSLASGMGANVLTF	TRBV7-2	TRBJ2-6
TGCGCCAGCAGCTTGTTCCCAGGCTACACCTTC	CASSLFPGYTF	TRBV5-1	TRBJ1-2
TGTGCCAGCAGCTCAGCGGCTGAAGATCAGCCCCAGCATTTT	CASSSAAEDQPQHF	TRBV7-3	TRBJ1-5
TGTGCCTCGGGACTCTCCGACCAAGAGACCCAGTACTTC	CASGLSDQETQYF	TRBV19	TRBJ2-5
TGTGCCAGCAGCCGGACTAGCGGGGGCTACGAGCAGTACTTC	CASSRTSGGYEQYF	TRBV11-1	TRBJ2-7
TGTGCCAGCAGCCATCGGTGCTCTGGCGCTATCTACGAGCAGTACTTC	CASSHRCSGAIYEQYF	TRBV14	TRBJ2-7
TGTGCCACCAGGACGGACTTACAGGGGAGCTCTGGGGCCAACGTCCTGACTTTC	CATRTDLQGSSGANVLTF	TRBV24-1	TRBJ2-6
TGTGCCAGCAGCTGGGCCCATGTCCGACTAGCGTCCTACAATGAGCAGTTCTTC	CASSWAHVRLASYNEQFF	TRBV7-2	TRBJ2-1
TGTGCCAGCTCACCCGCGACAGGGGATAGATATGGCTACACCTTC	CASSPATGDRYGYTF	TRBV18	TRBJ1-2
TGTGCCAGCAGCCAAGATCTTGAGACTCCCACGTCCTACAATGAGCAGTTCTTC	CASSQDLETPTSYNEQFF	TRBV14	TRBJ2-1
TGTGCCAGCAGCTTAGCTAGGTATCCCAGGGGTTTGTATGGCTACACCTTC	CASSLARYPRGLYGYTF	TRBV7-9	TRBJ1-2
TGTGCCAGCAGTAGACAGCGGGTTCGGGGGGCGGGAATCGAGCAGTACTTC	CASSRQRVRGAGIEQYF	TRBV28	TRBJ2-7
TGTGCCAGCAGCTTAGATTCCCCTTCACTCCCGGGGGAGACCCAGTACTTC	CASSLDSPSLPGETQYF	TRBV11-2	TRBJ2-5
TGCACCTACCGGGACAGGTCCCAGAACACTGAAGCTTTCTTT	CTYRDRSQNTEAFF	TRBV20-1	TRBJ1-1
TGTGCCAGCCGAGAGGGGCCCGAGCAGTACTTC	CASREGPEQYF	TRBV6-1	TRBJ2-7
TGTGCCAGCAGTAATATCCAGGGATGGATTCCCACCGGGGAGCTGTTTTTT	CASSNIQGWIPTGELFF	TRBV28	TRBJ2-2
TGTGCCAGCAGCTTGCCTAGTTACGAGCAGTACTTC	CASSLPSYEQYF	TRBV5-6	TRBJ2-7
TGTGCCACCGGGACAGGGGCGGAGGTCTATGGCTACACCTTC	CATGTGAEVYGYTF	TRBV6-4	TRBJ1-2
TGTGCCAGCACCGGTGTGTGGGAGGGAGAAAAACTGTTTTTT	CASTGVWEGEKLFF	TRBV6-4	TRBJ1-4
TGCAGTGCTAGCCAAACAGGGGGGATGGACGAGCAGTACTTC	CSASQTGGMDEQYF	TRBV20-1	TRBJ2-7
TGTGCCACCAGCAGAGCTCCCGCCGAGGGGCTGGCCAGCACAGATACGCAGTATTTT	CATSRAPAEGLASTDTQYF	TRBV15	TRBJ2-3
TGTGCCAGCAGCTTGCTGGTAAGGGGCACAGGGGATGATATAGAGCAGTACTTC	CASSLLVRGTGDDIEQYF	TRBV5-4	TRBJ2-7
TGCGCCAGCAGCCAAGAGGGACAGCCCCCGATGGAGCAGTACTTC	CASSQEGQPPMEQYF	TRBV4-1	TRBJ2-7
TGTGCCAGCAGCTTAGACGGGACAGGGGGCTACGAGCAGTACTTC	CASSLDGTGGYEQYF	TRBV7-4	TRBJ2-7
TGCAGTGCTAGAGATCATCCTGGCTACGAGCAGTACTTC	CSARDHPGYEQYF	TRBV20-1	TRBJ2-7
TGTGCCAGCACACTTGGATACGAGCAGTACTTC	CASTLGYEQYF	TRBV11-3	TRBJ2-7
TGCAGTGCTAGTAGACAGGGGTTGAACACTGAAGCTTTCTTT	CSASRQGLNTEAFF	TRBV20-1	TRBJ1-1
TGTGCCAGCAGCCTGACAGGCCCTGGGGAGACCCAGTACTTC	CASSLTGPGETQYF	TRBV6-2	TRBJ2-5
TGCGCCAGCAGTCTGCAAGAGACCCAGTACTTC	CASSLQETQYF	TRBV10-2	TRBJ2-5
TGTGCCAGCAGTGACGGAGGAACACGAATAGAGCAGTACTTC	CASSDGGTRIEQYF	TRBV6-2	TRBJ2-7
TGTGCCAGCAGCCACAGGGCCGGGAGCTACAATGAGCAGTTCTTC	CASSHRAGSYNEQFF	TRBV11-2	TRBJ2-1
TGTGCCAGCTCACCAATCCGGGAGGGGGACAGGGAGACCCAGTACTTC	CASSPIREGDRETQYF	TRBV18	TRBJ2-5
TGTGCCAGCAGTCCACGTAGCGGGTACCATCCATTGTCTGCCTACGAGCAGTACTTC	CASSPRSGYHPLSAYEQYF	TRBV12-3	TRBJ2-7
TGTGCCAGCAGCTTAGCGGGGGTCCCCTATGGCTACACCTTC	CASSLAGVPYGYTF	TRBV7-3	TRBJ1-2
TGTGCTAGTGGTTTAGTAAACCGGGCCTCTTATGTGTATCAGCCCCAGCATTTT	CASGLVNRASYVYQPQHF	TRBV12-5	TRBJ1-5
TGTGCCAGCAGCTTCCCTACGTGTAGGCTACTTTATAGCAATCAGCCCCAGCATTTT	CASSFPTCRLLYSNQPQHF	TRBV7-8	TRBJ1-5
TGTGCCAGCAGCTTAGACAGCGAGGGGGGCTTTTTTACGCAGTATTTT	CASSLDSEGGFFTQYF	TRBV11-3	TRBJ2-3
TGTGCCAGCAGGGGGGCGCAGGCCTACGAGCAGTACTTC	CASRGAQAYEQYF	TRBV6-5	TRBJ2-7
TGTGCCAGCAACAGAATGGACAATGAGCAGTTCTTC	CASNRMDNEQFF	TRBV27	TRBJ2-1
TGTGCCAGCAGTTTGGACGACTACCCGGAGACCCAGTACTTC	CASSLDDYPETQYF	TRBV12-4	TRBJ2-5
TGTGCCAGCCCACTCCAGGGTAAGGGAGCTTTCTTT	CASPLQGKGAFF	TRBV7-9	TRBJ1-1
TGTGCCAGCAGTTTTCGGACAGGGTTTGTCGGACACTATGGCTACACCTTC	CASSFRTGFVGHYGYTF	TRBV28	TRBJ1-2
TGTGCCAGCAGCCCGCCGGGGGGTTGCAATCAGCCCCAGCATTTT	CASSPPGGCNQPQHF	TRBV13	TRBJ1-5
TGTGCCAGCAGCGCCGCCATGGACAGGGGCCTTAGCTCTGGAAACACCATATATTTT	CASSAAMDRGLSSGNTIYF	TRBV13	TRBJ1-3
TGTGCCAGCAGCCAAGAGTGGGGGCAAGAGACCCAGTACTTC	CASSQEWGQETQYF	TRBV14	TRBJ2-5
TGCGCCAGCGCCCCCCGGGACGAAGGCTATGGCTACACCTTC	CASAPRDEGYGYTF	TRBV5-1	TRBJ1-2
TGTGCCGGTCAGGGGGCTAGTTACACTGAAGCTTTCTTT	CAGQGASYTEAFF	TRBV7-2	TRBJ1-1
TGTGCCAGCAGCTTAGTCCGGGGGACATTCAATGAGCAGTTCTTC	CASSLVRGTFNEQFF	TRBV7-9	TRBJ2-1
TGCGCCAGCAGCCAAGCCAACGGGACCGGATCCTACAATGAGCAGTTCTTC	CASSQANGTGSYNEQFF	TRBV4-1	TRBJ2-1
TGTGCCAGCAGCTGGAGGGGGGGGATTAATGAGCAGTTCTTC	CASSWRGGINEQFF	TRBV11-3	TRBJ2-1
TGTGCCAGCAAGTTATCGACAGGGTTAGCCAAAAACATTCAGTACTTC	CASKLSTGLAKNIQYF	TRBV6-1	TRBJ2-4
TGCGCCAGCACCCGCCGGGACGGTGCTAACTATGGCTACACCTTC	CASTRRDGANYGYTF	TRBV10-1	TRBJ1-2
TGTGCCAGCAGCGTAGCCGACAGGGACGAGCAGTACTTC	CASSVADRDEQYF	TRBV9	TRBJ2-7
TGTGCCATCAGTGTTCTAGACTACGAGCAGTACTTC	CAISVLDYEQYF	TRBV10-3	TRBJ2-7
TGTGCCAGCAGTGGGGCTGAGAGAACTGAAGCTTTCTTT	CASSGAERTEAFF	TRBV6-5	TRBJ1-1
TGTGCCAGCTCACCTTTACGCGGAGAACACTATGGCTACACCTTC	CASSPLRGEHYGYTF	TRBV18	TRBJ1-2
TGTTCCCGGGGGGGGGGTGGCTACACCTTC	CSRGGGGYTF	TRBV30	TRBJ1-2
TGTGCCAGCAGCGCCCTCGGACAGGGCGTTACTATTTACTATGGCTACACCTTC	CASSALGQGVTIYYGYTF	TRBV6-6	TRBJ1-2
TGTGCCATCGTGCGGACAGGGGGCCGGGAGCGAAACACCATATATTTT	CAIVRTGGRERNTIYF	TRBV10-3	TRBJ1-3
TGTGCCAGCAGCCAAGGACGGGACAGGTACGAGCAGTACTTC	CASSQGRDRYEQYF	TRBV11-2	TRBJ2-7
TGTGCCATGATCTGCAATCAGCCCCAGCATTTT	CAMICNQPQHF	TRBV19	TRBJ1-5
TGTGCCAGCAGCGAGCCGTCGCGGCCAACCTATGGCTACACCTTC	CASSEPSRPTYGYTF	TRBV5-8	TRBJ1-2
TGTGCCAGCGAACGGGGCTCGGATCAGCCCCAGCATTTT	CASERGSDQPQHF	TRBV6-5	TRBJ1-5
TGTGCCAGCAGCCCCAGGGCCAAGGGCATGAACACTGAAGCTTTCTTT	CASSPRAKGMNTEAFF	TRBV7-9	TRBJ1-1
TGTGCCAGCAGTGGGGGGGGCCACGAGCAGTACTTC	CASSGGGHEQYF	TRBV6-6	TRBJ2-7
TGTGCCAGCAGTGAACACTCTAGCGGGGCCTTTAAGGCTGACAATGAGCAGTTCTTC	CASSEHSSGAFKADNEQFF	TRBV25-1	TRBJ2-1
TGTGCCAGCAGCTTAGATGCCCCCGGGACGACCCAGTACTTC	CASSLDAPGTTQYF	TRBV11-3	TRBJ2-5
TGCGCCAGACCCGACAGGTCCTACGAGCAGTACTTC	CARPDRSYEQYF	TRBV5-1	TRBJ2-7
TGTGCCAGCAGCCAAAGGGGGGGCTATGGCTACACCTTC	CASSQRGGYGYTF	TRBV7-7	TRBJ1-2
TGTGCCAGCAGCCGGACAGTATGCTACGAGCAGTACTTC	CASSRTVCYEQYF	TRBV13	TRBJ2-7
TGTGCTAGTGGTTGCCGGGACAGGGAATTAGCCAAAAACATTCAGTACTTC	CASGCRDRELAKNIQYF	TRBV12-5	TRBJ2-4
TGCGCCAGCAGTGATCGGGGGGGTCACTACGAGCAGTACTTC	CASSDRGGHYEQYF	TRBV10-1	TRBJ2-7
TGTGCCAGCAGCATCGTGGGACAGTCTGGAAACACCATATATTTT	CASSIVGQSGNTIYF	TRBV7-3	TRBJ1-3
TGTGCCAGCAGCACCGGGGACGTTTCCTACGAGCAGTACTTC	CASSTGDVSYEQYF	TRBV9	TRBJ2-7
TGTGCCACTAGCTTACAGCCCCAGCATTTT	CATSLQPQHF	TRBV28	TRBJ1-5
TGTGCCAGCAGCGGGGACAGTAAGGCCGAGCAGTACTTC	CASSGDSKAEQYF	TRBV7-3	TRBJ2-7
