TGTGCCAGCAGCTTATTTATGATCCTTAGCAATCAGCCCCAGCATTTT	CASSLFMILSNQPQHF	TRBV11-2	TRBJ1-5
TGTGCCAGCAGTGAACCAGGACTAGCGGGCCATGATCGGTACAATGAGCAGTTCTTC	CASSEPGLAGHDRYNEQFF	TRBV6-1	TRBJ2-1
TGTGCCAGCTCACAGTCACCGGGAGGGGGGGGAAACTATGGCTACACCTTC	CASSQSPGGGGNYGYTF	TRBV18	TRBJ1-2
TGTGCCAGCAGCGAGGGGGCTAGGTCCCTCCACTTT	CASSEGARSLHF	TRBV9	TRBJ1-6
TGTGCCAGCAGCCCCGGCCGACACAACACTGAAGCTTTCTTT	CASSPGRHNTEAFF	TRBV7-3	TRBJ1-1
TGTGCCAGCAGTGAATTGGGGACAAAGAAAGAGACCCAGTACTTC	CASSELGTKKETQYF	TRBV6-1	TRBJ2-5
TGTGCCAGCAGCTTAGTGGACAGGGGGCGGGCCTACGAGCAGTACTTC	CASSLVDRGRAYEQYF	TRBV7-4	TRBJ2-7
TGTGCCAGCATGGCGTTAATTAGGTTAGCGGGGGTCCGAGAGACCCAGTACTTC	CASMALIRLAGVRETQYF	TRBV9	TRBJ2-5
TGTGCCAGCAGTCTAGGGGGACATTACAATTGCTGGACCGGGGAGCTGTTTTTT	CASSLGGHYNCWTGELFF	TRBV27	TRBJ2-2
TGTGCCAGCTCACGGCTGCCCCACACAGGGCGATCAGTTAACTATGGCTACACCTTC	CASSRLPHTGRSVNYGYTF	TRBV18	TRBJ1-2
TGTGCCACCAGCAGAGAAACATTCCGGGGTTCGAGGTTGAACACTGAAGCTTTCTTT	CATSRETFRGSRLNTEAFF	TRBV15	TRBJ1-1
TGTGCCAGCAGCCGCCCGTCCTACGAGCAGTACTTC	CASSRPSYEQYF	TRBV5-6	TRBJ2-7
TGTGCCAGGGATAAGGGGGGCTGGAATGAGCAGTTCTTC	CARDKGGWNEQFF	TRBV6-2	TRBJ2-1
TGCGCCAGCAGCAGCAGGGTTGGCTACACCTTC	CASSSRVGYTF	TRBV5-1	TRBJ1-2
TGTGCCAGCAGTGGACTTGAGTCCAGAGTCCCTAGCACAGATACGCAGTATTTT	CASSGLESRVPSTDTQYF	TRBV28	TRBJ2-3
TGTGCCAGCTCAACGGGGTTAGGGGGGGCGGCCTACGAGCAGTACTTC	CASSTGLGGAAYEQYF	TRBV18	TRBJ2-7
TGTGCCAGCAGCTGTCCGGGAGCTCTGCGTGGGGCCAACGTCCTGACTTTC	CASSCPGALRGANVLTF	TRBV5-6	TRBJ2-6
TGTGCCAGCAGCCCCAGGAGAGCGACCTACGAGCAGTACTTC	CASSPRRATYEQYF	TRBV13	TRBJ2-7
TGTGCCAGCAGCTTGGCGGATCTAGCCTACGAGCAGTACTTC	CASSLADLAYEQYF	TRBV5-4	TRBJ2-7
TGTGCCAGCAGCGTAGGCCGGCCGGCTCGGGGTCCTGTACCGGGACAGTGGAGCTCCTACGAGCAGTACTTC	CASSVGRPARGPVPGQWSSYEQYF	TRBV9	TRBJ2-7
TGTGCCAGCAAGGGGCCAGGACGACAGCACCGGAACACTGAAGCTTTCTTT	CASKGPGRQHRNTEAFF	TRBV25-1	TRBJ1-1
TGTGCCAGCAGCCATAGGACGTCGAACACTGAAGCTTTCTTT	CASSHRTSNTEAFF	TRBV12-3	TRBJ1-1
TGTGCCAGCAGCTTGCCTCCCCGGGACGAGCAGTACTTC	CASSLPPRDEQYF	TRBV5-6	TRBJ2-7
TGTGCCAGCAGCTTCATCGGACAGGGGGGGGTTCACTACGAGCAGTACTTC	CASSFIGQGGVHYEQYF	TRBV5-4	TRBJ2-7
TGTGCCTGGCCGGGACGGGACAGGGCCAGAGAGACCCAGTACTTC	CAWPGRDRARETQYF	TRBV30	TRBJ2-5
TGTGCCAGCAGCGGTCCGGGCAGGAGGGAAACCCAGTACTTC	CASSGPGRRETQYF	TRBV7-3	TRBJ2-5
TGTGCCAGCAGTCGCGTAGGACAGGGATTGGTTCCTCGTGGCTACACCTTC	CASSRVGQGLVPRGYTF	TRBV6-6	TRBJ1-2
TGTGCCAGCAGCCAAGATCCAAGCGGCCTACTCTCAGATACGCAGTATTTT	CASSQDPSGLLSDTQYF	TRBV14	TRBJ2-3
TGTGCCATGTCAGGGGGCGGATACGAGCAGTACTTC	CAMSGGGYEQYF	TRBV10-3	TRBJ2-7
TGTGCCAGCAGTTACGTGAAGACAGGGACGCATTCACCCCTCCACTTT	CASSYVKTGTHSPLHF	TRBV6-2	TRBJ1-6
TGCGCCAGCAGCTTGCATCACAGGGAAGGCTACAATGAGCAGTTCTTC	CASSLHHREGYNEQFF	TRBV5-1	TRBJ2-1
TGTGCCAGCAGCCAAGACATACTAGCGGGAGCCGCTAACTATGGCTACACCTTC	CASSQDILAGAANYGYTF	TRBV3-1	TRBJ1-2
TGCGAGGGCGCCTACGAGCAGTACTTC	CEGAYEQYF	TRBV20-1	TRBJ2-7
TGTGCCAGCAGCTCCACCGGTCCGGGACTAGGGCGCGGGAACACCGGGGAGCTGTTTTTT	CASSSTGPGLGRGNTGELFF	TRBV13	TRBJ2-2
TGTGCCAGCAGCGTAGTTCTCCAGTCGGGCCGGGAACCGAGGGGCAAGATAGGGGTTGCTACACTTAATGAAAAACTGTTTTTT	CASSVVLQSGREPRGKIGVATLNEKLFF	TRBV9	TRBJ1-4
TGTGCCAGCAGGGAGACAGCCGAGCAGTACTTC	CASRETAEQYF	TRBV27	TRBJ2-7
TGTGCCAGCAGCTTGGTCCCGGGCTATGGCTACACCTTC	CASSLVPGYGYTF	TRBV5-4	TRBJ1-2
TGTGCCAGCAGCTTAAGGGAGGGGGACGTACTGCCCGCCAAAAACATTCAGTACTTC	CASSLREGDVLPAKNIQYF	TRBV7-2	TRBJ2-4
TGTGCCAGCAGCCAAGGAGAGGTCTATAGCAATCAGCCCCAGCATTTT	CASSQGEVYSNQPQHF	TRBV14	TRBJ1-5
TGTGCCAGCAGCTTGCGGCCGACTTCCATCTACGAGCAGTACTTC	CASSLRPTSIYEQYF	TRBV5-6	TRBJ2-7
TGCAGTGCTAGAGGACCAGGGACTACTTCCTACGAGCAGTACTTC	CSARGPGTTSYEQYF	TRBV20-1	TRBJ2-7
TGTGCCAGCAGTTTAGGACGGGAGGGGCACCGCGAGCAGTACTTC	CASSLGREGHREQYF	TRBV6-2	TRBJ2-7
TGTGCCAGCAAAGCAGGGCTAGGACAGGAGACCCAGTACTTC	CASKAGLGQETQYF	TRBV6-5	TRBJ2-5
TGTGCCAGTAGTATAGATGTCAGTTCAGATACGCAGTATTTT	CASSIDVSSDTQYF	TRBV19	TRBJ2-3
TGTGCCAGTAGTATAGACAGACTAAAAAAGAACACTGAAGCTTTCTTT	CASSIDRLKKNTEAFF	TRBV19	TRBJ1-1
TGTGCCAGCAGCTTGGAAGGGGTACTAGCTTTCTTT	CASSLEGVLAFF	TRBV5-6	TRBJ1-1
TGTGAAGTGAAAGGGCCCAATCAGCCCCAGCATTTT	CEVKGPNQPQHF	TRBV27	TRBJ1-5
TGTGCCAGCAGCGGCGGACCGTCCTACGTTAGCCTAGCCAAAAACATTCAGTACTTC	CASSGGPSYVSLAKNIQYF	TRBV13	TRBJ2-4
TGTGCCAGCGGAGCGGGACAAGACGAGCAGTACTTC	CASGAGQDEQYF	TRBV27	TRBJ2-7
TGCGCCAGCAGCAGCCCGGGTGCAGAACCAAGCACAGATACGCAGTATTTT	CASSSPGAEPSTDTQYF	TRBV5-1	TRBJ2-3
TGCAGCGTTCTAACTTGGACAGATCACTATCAGCCCCAGCATTTT	CSVLTWTDHYQPQHF	TRBV29-1	TRBJ1-5
TGTGCCAGCAGCGTAGGGGGCGGTCCCTTC	CASSVGGGPF	TRBV11-3	TRBJ2-7
TGTGCCAGCAGTTTGGTCCAAGGGGGGACAGGCTACTATGGCTACACCTTC	CASSLVQGGTGYYGYTF	TRBV12-4	TRBJ1-2
TGCAGTGCTATCCCGGGGTCAGATACGCAGTATTTT	CSAIPGSDTQYF	TRBV20-1	TRBJ2-3
TGTGCCAGCAGTTTATGCGAACAGAGAGGCTACACCTTC	CASSLCEQRGYTF	TRBV28	TRBJ1-2
TGTGCCAGCAGGTTTGGGGGAGACTATGGCTACACCTTC	CASRFGGDYGYTF	TRBV6-5	TRBJ1-2
TGTGCCAGCAGCGTACCCGACCCCCTGGATGAGCAGTACTTC	CASSVPDPLDEQYF	TRBV9	TRBJ2-7
TGTGCCAGCAGCTTCGGGAGGGGCGAGCAGTACTTC	CASSFGRGEQYF	TRBV6-4	TRBJ2-7
TGTGCCAGTAGTATAGATCAACTGACTAGGGACAATGAGCAGTTCTTC	CASSIDQLTRDNEQFF	TRBV19	TRBJ2-1
TGTGCCAGCAGTTCGAGGGGGGGTCTCTATGGCTACACCTTC	CASSSRGGLYGYTF	TRBV6-2	TRBJ1-2
TGTGCCAGTAAAACCGGGGGCAAGGCCTACGAGCAGTACTTC	CASKTGGKAYEQYF	TRBV19	TRBJ2-7
TGTGCCAGCCGGGCGGGACAGGCTGGCTACACCTTC	CASRAGQAGYTF	TRBV19	TRBJ1-2
TGTGCTAGTGGGGCCAGAGTACTTTCACCCCTCCACTTT	CASGARVLSPLHF	TRBV12-5	TRBJ1-6
TGTGCCAGCAGCCAAGAGGGCTCAAGGACACCGAACACTGAAGCTTTCTTT	CASSQEGSRTPNTEAFF	TRBV4-2	TRBJ1-1
TGCGCCAGGCACGGACAGGGTGTTGGTACTGAAGCTTTCTTT	CARHGQGVGTEAFF	TRBV10-2	TRBJ1-1
TGTGCCACCAGTGCTTGCCAGATTGTAGAGCAGTACTTC	CATSACQIVEQYF	TRBV24-1	TRBJ2-7
TGTGCCAGCAGCTTCAGTACGAATGGCTACACCTTC	CASSFSTNGYTF	TRBV5-6	TRBJ1-2
TGTGCCAGCAGCCAAGGGGCTGCCTCCTACGAGCAGTACTTC	CASSQGAASYEQYF	TRBV14	TRBJ2-7
TGCAGTCCCGGGTGGAACACTGAAGCTTTCTTT	CSPGWNTEAFF	TRBV20-1	TRBJ1-1
TGCGCCAGCCGGCTAGCGGACCGGAGGCTCGAGCAGTACTTC	CASRLADRRLEQYF	TRBV5-1	TRBJ2-7
TGCAGTGCTCCGACAGGGGGGGATGGCTACACCTTC	CSAPTGGDGYTF	TRBV20-1	TRBJ1-2
TGCAGTGCGGCAAACCGGGAAGGGGCCTACGAGCAGTACTTC	CSAANREGAYEQYF	TRBV20-1	TRBJ2-7
TGTGCCATCAGGAATGGAGGTAGAAGCTCCTACGAGCAGTACTTC	CAIRNGGRSSYEQYF	TRBV10-3	TRBJ2-7
TGTGCCAACTTACAGGGCACTGAAGCTTTCTTT	CANLQGTEAFF	TRBV6-4	TRBJ1-1
TGTGCCAGCAGCTTAGAAGGCGGAGCGGGACTAGCGGGGCTCTACGAGCAGTACTTC	CASSLEGGAGLAGLYEQYF	TRBV11-3	TRBJ2-7
TGTAATACCCTGGGGTCTGATAATTATACAAACACTGAAGCTTTCTTT	CNTLGSDNYTNTEAFF	TRBV7-9	TRBJ1-1
TGCGCCAGCAGCTTTGGCGGTATCGGGACACCGGAGACCCAGTACTTC	CASSFGGIGTPETQYF	TRBV5-1	TRBJ2-5
TGCGCCAGCAGCCAAGATCAGAGACAGGGGGCGGTGGACACTGAAGCTTTCTTT	CASSQDQRQGAVDTEAFF	TRBV4-1	TRBJ1-1
TGCGCCGGCGGGGCCGGGAACACCATATATTTT	CAGGAGNTIYF	TRBV5-1	TRBJ1-3
TGCAGTGCTAGAGGACCGGGACAGGGGAGCTCTGGGGCCAACGTCCTGACTTTC	CSARGPGQGSSGANVLTF	TRBV20-1	TRBJ2-6
TGTGCCAGCAGCCTGGGGGGCTCTAGCACAGATACGCAGTATTTT	CASSLGGSSTDTQYF	TRBV7-3	TRBJ2-3
TGCGCCAGCGCGGGACTAGCGGGGAACGGGGAGCTGTTTTTT	CASAGLAGNGELFF	TRBV10-1	TRBJ2-2
TGTGCCAGCAGCTTTATCAAGACAATAACTGAAGCTTTCTTT	CASSFIKTITEAFF	TRBV11-2	TRBJ1-1
TGTGCCAGCAGTGACCCCGCCAGGGGCTACGAGCAGTACTTC	CASSDPARGYEQYF	TRBV6-4	TRBJ2-7
TGTGCCAGCAGTAGAAGGGGATGCTCTGAAGCTTTCTTT	CASSRRGCSEAFF	TRBV28	TRBJ1-1
TGTGCCACCAGTGAGGGCGCGTACTACGAGCAGTACTTC	CATSEGAYYEQYF	TRBV24-1	TRBJ2-7
TGTGCCACCATGGACAGGGGTACGCAGTATTTT	CATMDRGTQYF	TRBV24-1	TRBJ2-3
TGTGCCAGCAGGACAGCCTGGTTCGACGAGCAGTACTTC	CASRTAWFDEQYF	TRBV6-5	TRBJ2-7
TGTGCCAGCAGTTACTCAGGTCGCCGACTAGTATGGTTCATTCAGTACTTC	CASSYSGRRLVWFIQYF	TRBV6-5	TRBJ2-4
TGTGCCAGCAGAACGGCCAACAGGGGGTCCGAGCAGTACTTC	CASRTANRGSEQYF	TRBV6-3	TRBJ2-7
TGTGCCTTGGGGACTGCTTTCTTT	CALGTAFF	TRBV7-9	TRBJ1-1
TGTGCCAGCAGTTCCGGGGTCGGCGGCTTAAACAATGAGCAGTTCTTC	CASSSGVGGLNNEQFF	TRBV11-3	TRBJ2-1
TGTGCCAGCAGCAAAGCCAGATATGGATACGGGGAGCTGTTTTTT	CASSKARYGYGELFF	TRBV7-9	TRBJ2-2
TGTGCCACGGGGGTCACAGATACGCAGTATTTT	CATGVTDTQYF	TRBV7-9	TRBJ2-3
TGTGCCACCAGCTCAGGGAAATCCTACGAGCAGTACTTC	CATSSGKSYEQYF	TRBV15	TRBJ2-7
TGTGCCAGCAGCTTGGCCACGGGACAGGGGGGGCCCCACGAGCAGTACTTC	CASSLATGQGGPHEQYF	TRBV5-6	TRBJ2-7
TGTGCCAGCAGCTTGAAGACAGGGTACGAGCAGTACTTC	CASSLKTGYEQYF	TRBV7-3	TRBJ2-7
TGTGCCAGCAGCCAAGGGGGGGGCACAGGGGGGATAGGCTACACCTTC	CASSQGGGTGGIGYTF	TRBV3-1	TRBJ1-2
TGTGCCAGCAGTGGGAGAGGTGGTCAGTACTTC	CASSGRGGQYF	TRBV6-1	TRBJ2-5
TGCGCCAGCAGCGGTGAACGTACGGGCAATCAGCCCCAGCATTTT	CASSGERTGNQPQHF	TRBV5-1	TRBJ1-5
TGTGCCAGCAGTTACCAAGTCATTAACTTCTCCGGAAACACCATATATTTT	CASSYQVINFSGNTIYF	TRBV6-2	TRBJ1-3
TGTGCCAGCAGTGATAAGGGGGGGGCAACTTACGAGCAGTACTTC	CASSDKGGATYEQYF	TRBV25-1	TRBJ2-7
TGTGCCAGCAGCTTAGCCCCTAGCGAGGAGCTGTTTTTT	CASSLAPSEELFF	TRBV7-2	TRBJ2-2
TGTGCCAGCAGTGCGAGGGGGCCCCCCCCTGAGACCCAGTACTTC	CASSARGPPPETQYF	TRBV6-1	TRBJ2-5
TGTGCCAGCAGCTTGGATCCAGCGACCTGTGGGTATGGCTACACCTTC	CASSLDPATCGYGYTF	TRBV5-5	TRBJ1-2
TGTGCCTGGAAAGAGGGGTACTTC	CAWKEGYF	TRBV30	TRBJ2-7
TGTGCCATCCATCCGCACGGGCCCCAGCATTTT	CAIHPHGPQHF	TRBV10-3	TRBJ1-5
TGTGCCAGTTGGGTGAACACCGGGGAGCTGTTTTTT	CASWVNTGELFF	TRBV13	TRBJ2-2
TGTGCCAGCAGGGACGAATTAGCCGAGCAGTACTTC	CASRDELAEQYF	TRBV27	TRBJ2-7
TGTGCCAGCAGTGAATTCGGGACCAGGACTAGAGATACGCAGTATTTT	CASSEFGTRTRDTQYF	TRBV2	TRBJ2-3
TGCAGTGCCAAGGGTAGGGGTTCGAACACTGAAGCTTTCTTT	CSAKGRGSNTEAFF	TRBV20-1	TRBJ1-1
TGTGCCAGCAGCCAAGCGAGACTATTGATTCTCCTGAACTATGGCTACACCTTC	CASSQARLLILLNYGYTF	TRBV14	TRBJ1-2
TGTGCCAGCAGCGTCCCTCAACCCAGTAGTCGCACAGATACGCAGTATTTT	CASSVPQPSSRTDTQYF	TRBV9	TRBJ2-3
TGTGCCAGCAGCTTGGCGAGCGGGAGCGCTAGCACAGATACGCAGTATTTT	CASSLASGSASTDTQYF	TRBV7-7	TRBJ2-3
TGTGCCAGCAGTTTCGCCCCACAGGGGCCCCCGAATCGACCTAAAAAAGAGACCCAGTACTTC	CASSFAPQGPPNRPKKETQYF	TRBV12-4	TRBJ2-5
TGCGCCAGCAGCCAAGGACGGACAGAGATCAGGGGCTACACCTTC	CASSQGRTEIRGYTF	TRBV4-1	TRBJ1-2
TGCAGTGCTAGACGAGGGGGCTCACCCCTCCACTTT	CSARRGGSPLHF	TRBV20-1	TRBJ1-6
TGTGCCAGCAGCCACGGCCAGGACTATGGCTACACCTTC	CASSHGQDYGYTF	TRBV7-3	TRBJ1-2
TGTGCTAGTGGTTTCCATGCCTTGGGGGGAGTAGGCGCGGTAAGCAATCAGCCCCAGCATTTT	CASGFHALGGVGAVSNQPQHF	TRBV12-5	TRBJ1-5
TGTGCCACCAGTGATTCCGGTACACTAGCGGGAGGGCGAAGCCGGACCCAGTACTTC	CATSDSGTLAGGRSRTQYF	TRBV24-1	TRBJ2-5
TGTGCCAGCAGCCCCAGGCGGAGCTCTGGGGCCAACGTCCTGACTTTC	CASSPRRSSGANVLTF	TRBV13	TRBJ2-6
TGCAGTGCTAGAGCCGGGAGGGCCCTGGAAGCCAAAAACATTCAGTACTTC	CSARAGRALEAKNIQYF	TRBV20-1	TRBJ2-4
TGTGCCAGCAGCCCCCAAAGAGGCTACACCTTC	CASSPQRGYTF	TRBV6-5	TRBJ1-2
TGTGCCTCGCGGGAGGAGCAGTACTTC	CASREEQYF	TRBV5-4	TRBJ2-7
TGTGCCAGCAGCTACTGTCTCCGACACGAGCAGTACTTC	CASSYCLRHEQYF	TRBV7-2	TRBJ2-7
TGCAGTGCGTGTCTGGGGGCTAAGAACACTGAAGCTTTCTTT	CSACLGAKNTEAFF	TRBV20-1	TRBJ1-1
TGTGCCAGCTCACCACAAGGGAGGTCCAGGGACCAAGAGACCCAGTACTTC	CASSPQGRSRDQETQYF	TRBV18	TRBJ2-5
TGTGCCAGCAGAAGAACAGGGTTCTTT	CASRRTGFF	TRBV27	TRBJ1-1
TGCGCCAGCAGCTTCGGGCAGAGGAAGTACTTC	CASSFGQRKYF	TRBV5-1	TRBJ2-5
TGTGCCAGCAGTGAACACGGATTGGAGGAAGGGGGGGGATCTGGAAACACCATATATTTT	CASSEHGLEEGGGSGNTIYF	TRBV2	TRBJ1-3
TGCGCCAGCAGCTTGGGGGTCGGCAGGATCAATGGCTACACCTTC	CASSLGVGRINGYTF	TRBV5-1	TRBJ1-2
TGTGCTAGTGGTTTGCCGGGACAGGGTCGAAAAGAGACCCAGTACTTC	CASGLPGQGRKETQYF	TRBV12-5	TRBJ2-5
TGCGCCAGCAGCTGGCGGGGCAATCAGCCCCAGCATTTT	CASSWRGNQPQHF	TRBV5-1	TRBJ1-5
TGTGCCACGGGGGTAGGGGAAGAGACCCAGTACTTC	CATGVGEETQYF	TRBV15	TRBJ2-5
TGTGCCAGCCGCTTCACTAGCGGGAGGAGGGGAGAGCAGTACTTC	CASRFTSGRRGEQYF	TRBV6-5	TRBJ2-7
TGCGCCAGCAGTGATGGGGCTATCCAAGAGACCCAGTACTTC	CASSDGAIQETQYF	TRBV10-1	TRBJ2-5
TGTGCCAGCAGCCATTCCACCAACGAGCAGTACTTC	CASSHSTNEQYF	TRBV12-3	TRBJ2-7
TGTGCCACCAGTGAGAAGACAGGGGATACGCAGTATTTT	CATSEKTGDTQYF	TRBV24-1	TRBJ2-3
TGCGCCAGCAGCTTCCTTAGACAGGGTATCTCTGGAAACACCATATATTTT	CASSFLRQGISGNTIYF	TRBV5-1	TRBJ1-3
TGTGCCAGCAAAGTGGACACCGTAGCAGGGCCACCCCTCCACTTT	CASKVDTVAGPPLHF	TRBV5-6	TRBJ1-6
TGTGCCAGCAGCTTATCCCCTAGCGGGTCAAAGACCCAGTACTTC	CASSLSPSGSKTQYF	TRBV7-6	TRBJ2-5
TGCGCCAGCAGTGAACTTAAGTGTCTAGCGAGGAACTCAGATACGCAGTATTTT	CASSELKCLARNSDTQYF	TRBV10-1	TRBJ2-3
TGTGCCAGCAGTGGATTCCCTAGCGGGTTTATCGGCTCCGAAGAGACCCAGTACTTC	CASSGFPSGFIGSEETQYF	TRBV2	TRBJ2-5
TGTGCTAGCAGCTTGACTAGGTACAATTCACCCCTCCACTTT	CASSLTRYNSPLHF	TRBV7-7	TRBJ1-6
TGTGCCAGCAGCGTACTCAGAGAGGGCTACACCTTC	CASSVLREGYTF	TRBV9	TRBJ1-2
TGTGCCAGCAGATCAGGCTATGGCTACACCTTC	CASRSGYGYTF	TRBV9	TRBJ1-2
TGTGCCAGCAACAACCGAGGCTATGGCTACACCTTC	CASNNRGYGYTF	TRBV6-2	TRBJ1-2
TGCGCCAGCAGCCCCCGGAGGGGGGCTGAAAAACTGTTTTTT	CASSPRRGAEKLFF	TRBV5-1	TRBJ1-4
TGTGCCAGCAGCCCGAAACGAGAACTCCCAGGGGACGAGCAGTACTTC	CASSPKRELPGDEQYF	TRBV3-1	TRBJ2-7
TGTGCCAGCAGTGTCACCCCGCCCCAATTACTAGCGGGAGGATGGAACACCGGGGAGCTGTTTTTT	CASSVTPPQLLAGGWNTGELFF	TRBV28	TRBJ2-2
TGTGCCATCAGCGGGGCAGGGGACAGGGCCTACGAGCAGTACTTC	CAISGAGDRAYEQYF	TRBV10-3	TRBJ2-7
TGTGCCACCACCCACAGGGAATCCGCCTTCTACGAGCAGTACTTC	CATTHRESAFYEQYF	TRBV24-1	TRBJ2-7
TGTGCCAGCAGCTTAGCGAGGGGCCGGATTGTCGAGACCCAGTACTTC	CASSLARGRIVETQYF	TRBV7-3	TRBJ2-5
TGCAGTGCTACGCCCCGTGGGGACTGGGAAAAACTGTTTTTT	CSATPRGDWEKLFF	TRBV20-1	TRBJ1-4
TGTGCCAGCAGCGGACAGGGTCTAGGTGGCTACACCTTC	CASSGQGLGGYTF	TRBV7-3	TRBJ1-2
TGTGCCAGCAACACGGACAGGGGCCGCCCCTATGGCTACACCTTC	CASNTDRGRPYGYTF	TRBV9	TRBJ1-2
TGTGCCAGCAGCTTGCCCCGCAGGGTAGTCTCTGGGGCCAACGTCCTGACTTTC	CASSLPRRVVSGANVLTF	TRBV5-4	TRBJ2-6
TGTGCCAGCAGTTTAACCCAGCAGGCTGACGTAGAGACCCAGTACTTC	CASSLTQQADVETQYF	TRBV28	TRBJ2-5
TGTGCCAGCAGCTCCGACAGGAGGGCAGGTCAGCCCCAGCATTTT	CASSSDRRAGQPQHF	TRBV7-3	TRBJ1-5
TGTGCCAGCAGTTTATGCGAGGGGCCGGGACAGGGGGGGCAGTATTTT	CASSLCEGPGQGGQYF	TRBV28	TRBJ2-3
TGTGCCAGTAGTATGGGGGACATCCCAACTAATGAAAAACTGTTTTTT	CASSMGDIPTNEKLFF	TRBV19	TRBJ1-4
TGCAGTGCTACGGGGGAAAAACTGTTTTTT	CSATGEKLFF	TRBV20-1	TRBJ1-4
TGTGCCAGTTTCGGCCGGGACGCTCTAGGCTATACTCAAGAGACCCAGTACTTC	CASFGRDALGYTQETQYF	TRBV27	TRBJ2-5
TGTGCCAGCAGCCAAGGCCGGACGACTATGACCTCACCCACAGATACGCAGTATTTT	CASSQGRTTMTSPTDTQYF	TRBV14	TRBJ2-3
TGCAGTGCTAGAGATCTAGGGGCCCCGTACACCGGGGAGCTGTTTTTT	CSARDLGAPYTGELFF	TRBV20-1	TRBJ2-2
TGTGCCAGCAGTCCCGAGGGCCTGCCTAACTATGGCTACACCTTC	CASSPEGLPNYGYTF	TRBV6-4	TRBJ1-2
TGTGCCAGCAGCCCCTGGGGGTATTCCTATAATTCACCCCTCCACTTT	CASSPWGYSYNSPLHF	TRBV11-3	TRBJ1-6
TGTGCCAGCGTCCACAGGACCTCCTACGAGCAGTACTTC	CASVHRTSYEQYF	TRBV9	TRBJ2-7
TGCAGTGCTAGGGGGAGGGACAGCGGTCCGCTCTACGAGCAGTACTTC	CSARGRDSGPLYEQYF	TRBV20-1	TRBJ2-7
TGTGCCAGCCCCTGTCCAGGGACCCAGTACTTC	CASPCPGTQYF	TRBV27	TRBJ2-5
TGTGCCAGTAGTATAAGCGGACTAGCGGGAGGCGGGGGCTCTGGAAACACCATATATTTT	CASSISGLAGGGGSGNTIYF	TRBV19	TRBJ1-3
TGTGCCAGGATAGAGGTGGGCACACCAGACAGGGGCAATGAGCAGTTCTTC	CARIEVGTPDRGNEQFF	TRBV25-1	TRBJ2-1
TGTGCCACCAGTGTTCGCGGGGACAGGGTAGGCATTCAGTACTTC	CATSVRGDRVGIQYF	TRBV24-1	TRBJ2-4
TGTGCCAGCAGTTACCCCCCAGGCATGAACACTGAAGCTTTCTTT	CASSYPPGMNTEAFF	TRBV6-5	TRBJ1-1
TGTGCCAGTAGTAGAGGACATGGCTACACCTTC	CASSRGHGYTF	TRBV19	TRBJ1-2
TGTGCCAGCAGCTTGTTTAAGGTGCGGGAGGAATACGAGCAGTACTTC	CASSLFKVREEYEQYF	TRBV5-4	TRBJ2-7
TGTGCCAGCAGCACAGGGGTGGTGAACACTGAAGCTTTCTTT	CASSTGVVNTEAFF	TRBV11-2	TRBJ1-1
TGCGCCAGCAGCTTGGTCAGGGGGCGACGGAACATTCAGTACTTC	CASSLVRGRRNIQYF	TRBV5-1	TRBJ2-4
TGTGCCAGCAGCGTAGGGGGCAGAACCCTGAGACAGGGGGGTAGAGTGATCACCTTC	CASSVGGRTLRQGGRVITF	TRBV9	TRBJ1-2
TGTGCCAGCAGCCCCGCAACAACGGGAGTCAGGCGCTACGAGCAGTACTTC	CASSPATTGVRRYEQYF	TRBV13	TRBJ2-7
TGTGCCAGCAGGGTCCATAGCGGGTTTGAACCAGGGTACCAAGAGACCCAGTACTTC	CASRVHSGFEPGYQETQYF	TRBV5-4	TRBJ2-5
TGTGCCAGCAGCCAACAGACTAGCGGGTTTCCCAAAAACATTCAGTACTTC	CASSQQTSGFPKNIQYF	TRBV3-1	TRBJ2-4
TGTGCCAGCAGTTTAGGTGGAGGGGGCGGGAACACTGAAGCTTTCTTT	CASSLGGGGGNTEAFF	TRBV12-3	TRBJ1-1
TGTGCCAGCAGCTTAGTGCTCGGGACCCGGGAGGCAGATACGCAGTATTTT	CASSLVLGTREADTQYF	TRBV7-9	TRBJ2-3
TGTGCCAGCAGCTTTAATCGGGGGTACCCCGGCTACGAGCAGTACTTC	CASSFNRGYPGYEQYF	TRBV5-4	TRBJ2-7
TGTGCCATCAGTGAGGGTAGTACGGTTACTAATCAGCCCCAGCATTTT	CAISEGSTVTNQPQHF	TRBV10-3	TRBJ1-5
TGTGCCAGCATAATACCGCGGGAGCGCCAAGAGACCCAGTACTTC	CASIIPRERQETQYF	TRBV6-1	TRBJ2-5
TGTGCCAGCAGGTTAACTGACAGGGGGTGCTATGGCTACACCTTC	CASRLTDRGCYGYTF	TRBV12-3	TRBJ1-2
TGTGCCAGCAGCTTAACGAGGCCTCAGCCCCAGCATTTT	CASSLTRPQPQHF	TRBV7-2	TRBJ1-5
TGTGCCAGCAGCATGGGGGGGACCCCAGATACGCAGTATTTT	CASSMGGTPDTQYF	TRBV7-2	TRBJ2-3
TGTGCCAGCAGCGTAGCTCTAGCGGGGAACCAAGAGACCCAGTACTTC	CASSVALAGNQETQYF	TRBV9	TRBJ2-5
TGCAGTGCTAGGTCGACAGGTAAAGGAACCGAAAAACTGTTTTTT	CSARSTGKGTEKLFF	TRBV20-1	TRBJ1-4
TGTGCCAGCAGCGCAGGGCGGGGTAGGCCCTACGAGCAGTACTTC	CASSAGRGRPYEQYF	TRBV7-4	TRBJ2-7
TGTGCCAGCAGAGAAAGACTAGTGGAGACCCAGTACTTC	CASRERLVETQYF	TRBV12-4	TRBJ2-5
TGTGCCAGCAGTTTCTGCGGGGTCAACGAGCAGTACTTC	CASSFCGVNEQYF	TRBV6-5	TRBJ2-7
TGTGCCAGCAGTTTCGACAGGGGCTCAAATTCACCCCTCCACTTT	CASSFDRGSNSPLHF	TRBV12-4	TRBJ1-6
TGTGCCAGCAGCTGGGGGATACAGGGTACGAACACCGGGGAGCTGTTTTTT	CASSWGIQGTNTGELFF	TRBV5-6	TRBJ2-2
TGTGCCAGCAGCTTAGGCGGCCGGGACAGGGGGGAGACCCAGTACTTC	CASSLGGRDRGETQYF	TRBV11-2	TRBJ2-5
TGTGCCATCAGTTTCTTGCGGGAGTACTTC	CAISFLREYF	TRBV10-3	TRBJ2-5
TGTGCCAGCAGCACCCCCGACATTCTGGGAAACACCATATATTTT	CASSTPDILGNTIYF	TRBV7-4	TRBJ1-3
TGTGCCAGCAGCTTATCCCCGGTAGCGGGCGATAATGAGCAGTTCTTC	CASSLSPVAGDNEQFF	TRBV7-6	TRBJ2-1
TGTGCCAGCAGCCCCGGACAGGCGAGCTCCTACAATGAGCAGTTCTTC	CASSPGQASSYNEQFF	TRBV13	TRBJ2-1
TGTGCCAGCAGCTTGGGTCGGGGGGGGGGCCAAGAGACCCAGTACTTC	CASSLGRGGGQETQYF	TRBV7-9	TRBJ2-5
TGTGCCAGCAGTGATAATGGGGGCCCAACCCCCTTTGGTCCCGTCGATACGCAGTATTTT	CASSDNGGPTPFGPVDTQYF	TRBV6-4	TRBJ2-3
TGTGCCAGCAGCTTGTATGGGGTACGGTATGGCTACACCTTC	CASSLYGVRYGYTF	TRBV5-5	TRBJ1-2
TGCGCCAGCAGCCTCGTTTACTTC	CASSLVYF	TRBV5-1	TRBJ1-2
TGTGCCAGCAGTACGGACAGCGGCCCCTACTACGTCTATGGCTACACCTTC	CASSTDSGPYYVYGYTF	TRBV6-1	TRBJ1-2
TGTGCCAGTAGTATAGAGCTTGGGAGTTCCCGACTAGATACGCAGTATTTT	CASSIELGSSRLDTQYF	TRBV19	TRBJ2-3
TGCGCCAGCAGCCAAGATAAGAGACAGGGGGTAGAGACCCAGTACTTC	CASSQDKRQGVETQYF	TRBV4-1	TRBJ2-5
TGTGCCAGCAGTGAACCCGCCGGGACAGGGGCTTCCTACAATGAGCAGTTCTTC	CASSEPAGTGASYNEQFF	TRBV25-1	TRBJ2-1
TGTGCCAGCAGCAGCTTCACACGCTACGAGCAGTACTTC	CASSSFTRYEQYF	TRBV9	TRBJ2-7
TGTGCCAGCAGTGAAATGCAACCGGGACAGAGGAGCTCTGGAAACACCATATATTTT	CASSEMQPGQRSSGNTIYF	TRBV2	TRBJ1-3
TGTGCCAGCAGCGGGGATGCGGCAGACTCCTACAATGAGCAGTTCTTC	CASSGDAADSYNEQFF	TRBV7-9	TRBJ2-1
TGTGCCACCGGAACAACGGTTCTTTCACCCCTCCACTTT	CATGTTVLSPLHF	TRBV24-1	TRBJ1-6
TGTGCCAGCAGCGGACAGGGGGGTGGGCGAGGCTACACCTTC	CASSGQGGGRGYTF	TRBV7-8	TRBJ1-2
TGTGCCAGGGGGCTTGTCAATCAGCCCCAGCATTTT	CARGLVNQPQHF	TRBV24-1	TRBJ1-5
TGTGCCAGCAGCCCCCGGGACAGGGCCGGGGAGCTGTTTTTT	CASSPRDRAGELFF	TRBV7-6	TRBJ2-2
TGTCAGGGGAAGCCCCAGAGCAGGACCGGGGAGCTGTTTTTT	CQGKPQSRTGELFF	TRBV19	TRBJ2-2
TGTGCCAGCAGGCAGAAAAGCAATCAGCCCCAGCATTTT	CASRQKSNQPQHF	TRBV12-3	TRBJ1-5
TGTGCCAGCAGCAGGACAGGGAGGGGGTACGAGCAGTACTTC	CASSRTGRGYEQYF	TRBV13	TRBJ2-7
TGTGCCAGCAGTGACTGCGTGACCGAGCAGTACTTC	CASSDCVTEQYF	TRBV2	TRBJ2-7
TGTGCCACCAAAGTGCGGGAGGGAGAGACCCAGTACTTC	CATKVREGETQYF	TRBV24-1	TRBJ2-5
TGCGCCAGCAGAACGCTAGCGGGGCAGGTCACAGATACGCAGTATTTT	CASRTLAGQVTDTQYF	TRBV5-1	TRBJ2-3
TGTGCCAGCAGCATGAATGGGGCGGTAATGCAAGCTTTCTTT	CASSMNGAVMQAFF	TRBV7-9	TRBJ1-1
TGTGCCAACCGGTCGCGGGAGCAGTACTTC	CANRSREQYF	TRBV24-1	TRBJ2-7
TGTGCCAGCAGGAAACCCGGGGGGGATCACCCTCAGCCCCAGCATTTT	CASRKPGGDHPQPQHF	TRBV5-6	TRBJ1-5
TGTGCCAGCAGCTGCCAAAGAGGGGGCTACAATGAGCAGTTCTTC	CASSCQRGGYNEQFF	TRBV13	TRBJ2-1
TGTGCCAGCAGCCCAAACACTGAAGCTTTCTTT	CASSPNTEAFF	TRBV28	TRBJ1-1
TGCAGTGCGGGCGCACCGGGACTAGCGGGGATCTACAATGAGCAGTTCTTC	CSAGAPGLAGIYNEQFF	TRBV20-1	TRBJ2-1
TGTGCCAGAAAACAGGGGGCCCGCAATGAGCAGTTCTTC	CARKQGARNEQFF	TRBV19	TRBJ2-1
TGTGCTAGTGGACCAACCGGGAAGAGATACGAGCAGTACTTC	CASGPTGKRYEQYF	TRBV12-5	TRBJ2-7
TGTGCCAGCAGTTTGCACAACAGGGGGCTACCTCGCACTGAAGCTTTCTTT	CASSLHNRGLPRTEAFF	TRBV28	TRBJ1-1
TGTGCCAGCAGCCAGGGGGACCACCTAAAAGTAAGACAAGAGACCCAGTACTTC	CASSQGDHLKVRQETQYF	TRBV13	TRBJ2-5
TGTGCCAGCAGCTGCGTAGTACCCCGGGACAGGGGGTTAGGCTACACCTTC	CASSCVVPRDRGLGYTF	TRBV7-2	TRBJ1-2
TGTGCCAGCAGCTTAAGGTCACAGGGCGGGCGGCAGCCCCAGCATTTT	CASSLRSQGGRQPQHF	TRBV5-5	TRBJ1-5
TGCAGTGCTAGAGATTTGGGGGGACAGAGGTACGGGGAGCTGTTTTTT	CSARDLGGQRYGELFF	TRBV20-1	TRBJ2-2
TGTGCCAGCTCACCCCCGGGACAGAAGGGTGAAAAGAACACCGGGGAGCTGTTTTTT	CASSPPGQKGEKNTGELFF	TRBV18	TRBJ2-2
TGTGCCAGCAGCTTAGCCACAGGACAGGACGAAGCCCCGGAAAAACTGTTTTTT	CASSLATGQDEAPEKLFF	TRBV7-6	TRBJ1-4
TGTGCCAGCAGCCGCGCGGACGAATCTGGTCAGCCCCAGCATTTT	CASSRADESGQPQHF	TRBV12-4	TRBJ1-5
TGTGCCAGCAGCCCGATTACGGGACGGGCCTCCTACGAGCAGTACTTC	CASSPITGRASYEQYF	TRBV7-9	TRBJ2-7
TGTGCCAGCAGCTGGGGGACAGGGAGGTACGAGCAGTACTTC	CASSWGTGRYEQYF	TRBV7-8	TRBJ2-7
TGCAGTATTGGACAGGGGATCGAGCAGTACTTC	CSIGQGIEQYF	TRBV20-1	TRBJ2-7
TGTGCCAGGAGGAACAGGGGGGCACGCGAGCAGTACTTC	CARRNRGAREQYF	TRBV2	TRBJ2-7
TGTGCCAGCAGTTATACGGGGCATTGTGAGCAGTTCTTC	CASSYTGHCEQFF	TRBV6-2	TRBJ2-1
TGCAGCGTTGGTCCCCGGGTTAGGGAGACCCAGTACTTC	CSVGPRVRETQYF	TRBV29-1	TRBJ2-5
TGTGCCAGCAGCTTAGAACCCGCGACCCAGTACTTC	CASSLEPATQYF	TRBV7-8	TRBJ2-5
TGTGCCAGCAGGGAGTTTAGAGGCGGGAAGCGAGATACGCAGTATTTT	CASREFRGGKRDTQYF	TRBV6-3	TRBJ2-3
TGTGCCAGCAGCCAAGATACAAGGGGTGGCTACACCTTC	CASSQDTRGGYTF	TRBV4-2	TRBJ1-2
TGTGCCAGCAGTGGAGGAGATGGCTACACCTTC	CASSGGDGYTF	TRBV12-3	TRBJ1-2
TGTGCCAGCAGCCTACGGGGTACGCAGCCCCAGCATTTT	CASSLRGTQPQHF	TRBV11-3	TRBJ1-5
TGCAGTGCGTACGACAAAGGAAACACCATATATTTT	CSAYDKGNTIYF	TRBV20-1	TRBJ1-3
TGTGCCAGCAGTTCGGCGGCAGGGCGCAATCAGCCCCAGCATTTT	CASSSAAGRNQPQHF	TRBV6-5	TRBJ1-5
TGTGCCAGCAGCGGTCGACAGGGGAACTACAATGAGCAGTTCTTC	CASSGRQGNYNEQFF	TRBV11-3	TRBJ2-1
TGCGCCAGCAGCCAAGCCGACCGGGACAGGGGGCGGGGCGTGGAACTCTACAATGAGCAGTTCTTC	CASSQADRDRGRGVELYNEQFF	TRBV4-3	TRBJ2-1
TGCGCCAGCAGTGAGTCGAAGAAAAGTCCCAGGGCCCTCCACTTT	CASSESKKSPRALHF	TRBV10-1	TRBJ1-6
TGTGCCAGCAATGAGGAGAGGGCCGCCTACGAGCAGTACTTC	CASNEERAAYEQYF	TRBV7-3	TRBJ2-7
TGTGCCAGCAGTTTGTCCCTAGATCAGCCCCAGCATTTT	CASSLSLDQPQHF	TRBV27	TRBJ1-5
TGTGCCAGCAGCCATGGGGCCCAGAACACCGGGGAGCTGTTTTTT	CASSHGAQNTGELFF	TRBV14	TRBJ2-2
TGTGCCAGCAGTGGGGGGAGGCTATTTCTGAACACCGGGGAGCTGTTTTTT	CASSGGRLFLNTGELFF	TRBV6-1	TRBJ2-2
TGTGCCAGCAGCTTTCCGGGACAGGGGGGCAATGAGCAGTTCTTC	CASSFPGQGGNEQFF	TRBV7-9	TRBJ2-1
TGTGCCAGCAGCTTACCCCCTCAGGGTTTCTCTAACTATGGCTACACCTTC	CASSLPPQGFSNYGYTF	TRBV7-9	TRBJ1-2
TGTGCCAGCAGTCATGGGAGGGTCGCCCTGCGCGCCGAGACCCAGTACTTC	CASSHGRVALRAETQYF	TRBV27	TRBJ2-5
TGTGCCAGCAGTTTAACGGGGACAGTAGAGAATGAGCAGTTCTTC	CASSLTGTVENEQFF	TRBV27	TRBJ2-1
TGTGCCAGCAACCCCAGGACCCTCCTGAACACTGAAGCTTTCTTT	CASNPRTLLNTEAFF	TRBV9	TRBJ1-1
TGTGCCAGCAGACTCCGGGACAGGGGAGAGCCCCAGCATTTT	CASRLRDRGEPQHF	TRBV12-4	TRBJ1-5
TGCAGTGCTTCTTATACGGGACGGGGGAACACCGGGGAGCTGTTTTTT	CSASYTGRGNTGELFF	TRBV20-1	TRBJ2-2
TGCAGTGCTAGCTTAAGCGCTTGGGCTGGGGCCAACGTCCTGACTTTC	CSASLSAWAGANVLTF	TRBV20-1	TRBJ2-6
TGTGCCAGCAGTTTAGGGGGGGGGACCTACGAGCAGTACTTC	CASSLGGGTYEQYF	TRBV27	TRBJ2-7
TGTGCCACCAGTGAGGGCGGGCACCGGCGAAAGTCGCATTTT	CATSEGGHRRKSHF	TRBV24-1	TRBJ1-5
TGTGTGGGGTTCCGACTGGACGAGCAGTACTTC	CVGFRLDEQYF	TRBV9	TRBJ2-7
TGCAGTGCTAGAGCACAACCGGGCCCGGGGGAAAAACTGTTTTTT	CSARAQPGPGEKLFF	TRBV20-1	TRBJ1-4
TGTGCCACCAGCTCGTTACGTTGTTCCGAGCAGTACTTC	CATSSLRCSEQYF	TRBV15	TRBJ2-7
TGTGCCACGGGTCGCGCCCCGGCCAAAAACATTCAGTACTTC	CATGRAPAKNIQYF	TRBV13	TRBJ2-4
TGTGCCAGCAGCCAAGATCTACTTAGCACGGGAGGAGGATACAATGAGCAGTTCTTC	CASSQDLLSTGGGYNEQFF	TRBV3-1	TRBJ2-1
TGTGCCAGCAGACGGACAGGGGTACCACAAGAGACCCAGTACTTC	CASRRTGVPQETQYF	TRBV6-5	TRBJ2-5
TGTGCCAGCAGCGCCACCTCCCAGACGGGGTTCAGGGGCGGATGGGGACTAGCCAAAAACATTCAGTACTTC	CASSATSQTGFRGGWGLAKNIQYF	TRBV5-6	TRBJ2-4
TGTGCCAGCAGTGAAGCCCAGGGCCCCACCACTGGGGCCAACGTCCTGACTTTC	CASSEAQGPTTGANVLTF	TRBV28	TRBJ2-6
TGTGCCAGCAGGTCTGGGAGACAGGGTGGCGAGACCCAGTACTTC	CASRSGRQGGETQYF	TRBV2	TRBJ2-5
TGTGCCAGCAGCGTAGGTAGGGGGGGCAGGAACACCGGGGAGCTGTTTTTT	CASSVGRGGRNTGELFF	TRBV9	TRBJ2-2
TGTGCCAGCGTTTGGGCCCGGATCAATGAGCAGTTCTTC	CASVWARINEQFF	TRBV6-4	TRBJ2-1
TGTGCCAGCAGCGAGGGACTAGCGGGGGGTCCCGAGCAGTACTTC	CASSEGLAGGPEQYF	TRBV7-9	TRBJ2-7
TGTGCCAGCAGCCCGGGGGTATCCGTCAAGACGGCCGGGGAGCTGTTTTTT	CASSPGVSVKTAGELFF	TRBV3-1	TRBJ2-2
TGCGCCAGCAGCTTGGTTCCTACGACAGGTCACTGCACTGAAGCTTTCTTT	CASSLVPTTGHCTEAFF	TRBV5-1	TRBJ1-1
TGTGCCAGCACAAGGACTAGCGGGAGGGTGTACAATGAGCAGTTCTTC	CASTRTSGRVYNEQFF	TRBV28	TRBJ2-1
TGTGCCAGCAGCTATCACCCGGGACAGGGGGCCCCGAGCAATCAGCCCCAGCATTTT	CASSYHPGQGAPSNQPQHF	TRBV5-4	TRBJ1-5
TGTGCCAGCAGCGGGAGGCTTGGCAAGAAGTACTTC	CASSGRLGKKYF	TRBV13	TRBJ2-7
TGCAGTGCTAGGGGGAAGCGGCCATACGAGCAGTACTTC	CSARGKRPYEQYF	TRBV20-1	TRBJ2-7
TGTGCCAGCAGCCCGATAGGGAATGAGCAGTTCTTC	CASSPIGNEQFF	TRBV7-3	TRBJ2-1
TGCGCCAGCAGCGGAGAGGGCGGCTACGAGCAGTACTTC	CASSGEGGYEQYF	TRBV5-1	TRBJ2-7
TGCGCCAGCAGGCCTGGACCGGTATACAATGAGCAGTTCTTC	CASRPGPVYNEQFF	TRBV5-1	TRBJ2-1
TGCAGTGGAACCGGGGGGGGAGGCTCCACCGGGGAGCTGTTTTTT	CSGTGGGGSTGELFF	TRBV20-1	TRBJ2-2
TGTGCCAGCAGTTACGGGACAGGGTGCTGCACTGAAGCTTTCTTT	CASSYGTGCCTEAFF	TRBV6-5	TRBJ1-1
TGTGCCAGCAGCTTAGTGACACGGACAGGGGGCGGTTGCTCTGGAAACACCATATATTTT	CASSLVTRTGGGCSGNTIYF	TRBV11-2	TRBJ1-3
TGTGCCAGCAGCGTCGAACTACTAGCGGGAGGCTCTGGAAACACCATATATTTT	CASSVELLAGGSGNTIYF	TRBV7-3	TRBJ1-3
TGTGCCAGCAGCGTACTAGCGGGACCCAGCTACAATGAGCAGTTCTTC	CASSVLAGPSYNEQFF	TRBV9	TRBJ2-1
TGTGCCAGCAGCTTAAGAGGGATATCACCCCTCCACTTT	CASSLRGISPLHF	TRBV7-9	TRBJ1-6
TGTGCCAGCAGTTCGACAGCGGGAACTAATCAGCCCCAGCATTTT	CASSSTAGTNQPQHF	TRBV6-3	TRBJ1-5
TGTGCCAGCAGCTTGGGGGCCTCAAATAATGAAAAACTGTTTTTT	CASSLGASNNEKLFF	TRBV5-4	TRBJ1-4
TGTGCCAGCCCCAAGCCTGGACAGGGGTGCACTGGGGCCAACGTCCTGACTTTC	CASPKPGQGCTGANVLTF	TRBV19	TRBJ2-6
TGTGCCTGGACAAAGTCCGAAGGGGAAAACACTGAAGCTTTCTTT	CAWTKSEGENTEAFF	TRBV30	TRBJ1-1
TGTGCCACCAGTGATCGCCTTAGTAAATGGCCCCAGCATTTT	CATSDRLSKWPQHF	TRBV24-1	TRBJ1-5
TGTGCCAGTGGACGCGAGCAGTACTTC	CASGREQYF	TRBV19	TRBJ2-7
TGTGCCAGCAGCGGCCTGTGTCACTCCTACAATGAGCAGTTCTTC	CASSGLCHSYNEQFF	TRBV7-9	TRBJ2-1
TGTGCCAGCAGCTTAGCCGTCCCCAAGAGGACAGCGTACGAGCAGTACTTC	CASSLAVPKRTAYEQYF	TRBV7-9	TRBJ2-7
TGTGCCAGCTTGGGGGGACAGCCTCCTTGGAATTCACCCCTCCACTTT	CASLGGQPPWNSPLHF	TRBV5-4	TRBJ1-6
TGTGCCAGCAGCCACCCCGAGGGAACCCAGACTGAAGCTTTCTTT	CASSHPEGTQTEAFF	TRBV14	TRBJ1-1
TGTGCCAGCAGTGTCGAGGGGGGGTCTGTGAGAGGGATCGCTGGAAACACCATATATTTT	CASSVEGGSVRGIAGNTIYF	TRBV12-4	TRBJ1-3
TGTGCCAGCAGCACCCCGGGACAAACAGGGAGAGGCAATGAGCAGTTCTTC	CASSTPGQTGRGNEQFF	TRBV5-4	TRBJ2-1
TGCGCCAGCAGTGAGTCCTCGCGATTCGTAGGGGGAGGCGACGACGAGCAGTACTTC	CASSESSRFVGGGDDEQYF	TRBV10-1	TRBJ2-7
TGCGCCAGCAGCCCCGGCCCAGGTTACGCCAGCTCCTACAATGAGCAGTTCTTC	CASSPGPGYASSYNEQFF	TRBV4-1	TRBJ2-1
TGTGCCAGCAGGGGATATACGGACACCGGGGAGCTGTTTTTT	CASRGYTDTGELFF	TRBV6-2	TRBJ2-2
TGCGCCAGCAGTGAGAGTCTGGCAGGGACAGGGTCCTACGAGCAGTACTTC	CASSESLAGTGSYEQYF	TRBV10-1	TRBJ2-7
TGTGCCAGCAGTTTAAGGCAGGTTTCTGAAGCTTTCTTT	CASSLRQVSEAFF	TRBV27	TRBJ1-1
TGTGCCTGGAGTAGGATTTCGGGGCACACTGAAGCTTTCTTT	CAWSRISGHTEAFF	TRBV30	TRBJ1-1
TGTGCCACCAGTGATGGGACAGAGCCCAATCAGCCCCAGCATTTT	CATSDGTEPNQPQHF	TRBV24-1	TRBJ1-5
TGTGCCCCCGGGACAGGGTTTCCCTGGAAGTACTTC	CAPGTGFPWKYF	TRBV5-6	TRBJ2-7
TGTGCCAGCAGCGTAGCGGCAGATACGCAGTATTTT	CASSVAADTQYF	TRBV7-3	TRBJ2-3
TGTGCCAGCAGCTCGAGCGATACGCAGTATTTT	CASSSSDTQYF	TRBV7-3	TRBJ2-3
TGTGCCAGCAGCTTAAGACAGCTAGCCAAAAACATTCAGTACTTC	CASSLRQLAKNIQYF	TRBV5-6	TRBJ2-4
TGTGCCAGCAGCCACCTTAGACTAGAGGGAGATGAGCAGTTCTTC	CASSHLRLEGDEQFF	TRBV3-1	TRBJ2-1
TGTGCCAGCAGCAGATCCCGGAAGCGGCAAAACGAGCAGTACTTC	CASSRSRKRQNEQYF	TRBV7-9	TRBJ2-7
TGTGCCAGCAGCCGCGGGACAGAGGAAGCTTTCTTT	CASSRGTEEAFF	TRBV9	TRBJ1-1
TGCAGTGCTCAGAGGGAGGACAGGGGAAACACCGGGGAGCTGTTTTTT	CSAQREDRGNTGELFF	TRBV20-1	TRBJ2-2
TGTGCCAGCAGTGACGAGCGGGAGGGGGCCTCCTACGAGCAGTACTTC	CASSDEREGASYEQYF	TRBV6-1	TRBJ2-7
TGTGCCAGCAGTTTATCACGATGGCATGGCTACACCTTC	CASSLSRWHGYTF	TRBV27	TRBJ1-2
TGTGCCACCAGTGAGAGGCGGTTATGGGCGAACACTGAAGCTTTCTTT	CATSERRLWANTEAFF	TRBV24-1	TRBJ1-1
TGTGCCACCAGCATGTCGGACAGGCGGCATTTTTATGAGCAGTTCTTC	CATSMSDRRHFYEQFF	TRBV15	TRBJ2-1
TGTGCCAGCAGCCGCCAAAGGAATAGCGGGACTTATGAGCAGTTCTTC	CASSRQRNSGTYEQFF	TRBV3-1	TRBJ2-1
TGTGCCAGCAGTGGACGGACTAGCGGGAGCTCTGGAAACACCATATATTTT	CASSGRTSGSSGNTIYF	TRBV6-4	TRBJ1-3
TGTGCCAGCAGCAACCCGGGGGAGGAAGCTTTCTTT	CASSNPGEEAFF	TRBV5-5	TRBJ1-1
TGCGCCAGCAGCCAAGGACAGAAGTATTTT	CASSQGQKYF	TRBV4-1	TRBJ2-3
TGTGCCAGCGGCCTATCGAGGACTACTAACTCCTACGAGCAGTACTTC	CASGLSRTTNSYEQYF	TRBV6-4	TRBJ2-7
TGCGCCAGCCTCCCCCAAACTAGAGATGACTACGAGCAGTACTTC	CASLPQTRDDYEQYF	TRBV10-1	TRBJ2-7
TGTGCCAGCAGCGAGCAGCCAGGGGCGGTTGCTGAGACCCAGTACTTC	CASSEQPGAVAETQYF	TRBV7-9	TRBJ2-5
TGCAGTGCTAGAGATACCCCCGACAGGGCGTCTAACTATGGCTACACCTTC	CSARDTPDRASNYGYTF	TRBV20-1	TRBJ1-2
TGTGCCAGCAGCCACCCGGGGCGCATCGGGCGAACTGAAGCTTTCTTT	CASSHPGRIGRTEAFF	TRBV3-1	TRBJ1-1
TGTGCCAGCAGGGTTATGGCACCCGGGATCACAATTGAAAAACTGTTTTTT	CASRVMAPGITIEKLFF	TRBV9	TRBJ1-4
TGCGCCAGCAGCGTCCTAACGGCTACAGGTTCCGAGCAGTACTTC	CASSVLTATGSEQYF	TRBV5-1	TRBJ2-7
TGCGCCAGCTGGGTTGTTAGTGTCTACAATGAGCAGTTCTTC	CASWVVSVYNEQFF	TRBV5-1	TRBJ2-1
TGTGCCAGCAGTTTAGTAGGGTCAGGCGCTAGCACAGATACGCAGTATTTT	CASSLVGSGASTDTQYF	TRBV12-4	TRBJ2-3
TGTGCCAGCAGCACCACCCCGACTAGCGGGTCCACAGATACGCAGTATTTT	CASSTTPTSGSTDTQYF	TRBV13	TRBJ2-3
TGTGCCAGCAGCTTAGGGGCGGGAGGAGAAGACTACGAGCAGTACTTC	CASSLGAGGEDYEQYF	TRBV7-3	TRBJ2-7
TGCAGTGCTAGAGAGCCTTGGAGAAGGGTTAACTATGGCTACACCTTC	CSAREPWRRVNYGYTF	TRBV20-1	TRBJ1-2
TGTGCCAGCAGCTTAGATCTCTTAGCGGGACAGCAAGGGGTGGACAATGAGCAGTTCTTC	CASSLDLLAGQQGVDNEQFF	TRBV11-3	TRBJ2-1
TGTGCCCAGGAGATAAGGGTAACGAGAGAGACCCAGTACTTC	CAQEIRVTRETQYF	TRBV30	TRBJ2-5
TGTGCCAGTAGTATTTTGAGATCTAACCCCAACGTCCTGACTTTC	CASSILRSNPNVLTF	TRBV19	TRBJ2-6
TGCAGTGCTGGAGATTTTAACTATGGCTACACCTTC	CSAGDFNYGYTF	TRBV20-1	TRBJ1-2
TGTGCCAGCAGCCAAGCTACTACTAGCGGGAGGGCCCCGGTGGATTACAAAGAGACCCAGTACTTC	CASSQATTSGRAPVDYKETQYF	TRBV3-1	TRBJ2-5
TGTGCCAGCAGTTACGGACGGACAGGGGGAAGAAACACCATATATTTT	CASSYGRTGGRNTIYF	TRBV6-2	TRBJ1-3
TGTGCCAGCAGCTTAAAAGCCTCGGACAGGGGCTCCTACAATGAGCAGTTCTTC	CASSLKASDRGSYNEQFF	TRBV7-8	TRBJ2-1
TGTGCCAGCAGTTTAGACGTCCTGTACTCTGGGGCCAACGTCCTGACTTTC	CASSLDVLYSGANVLTF	TRBV28	TRBJ2-6
TGTGCCACCACGAAGGGGAGCACTGAAGCTTTCTTT	CATTKGSTEAFF	TRBV24-1	TRBJ1-1
TGTGCCAGCATTGGACGGGTTCCTTATCAGCCCCAGCATTTT	CASIGRVPYQPQHF	TRBV5-6	TRBJ1-5
TGTGCCAGCAGTCGATCAACGACAGGACGATGTTCACCCCTCCACTTT	CASSRSTTGRCSPLHF	TRBV27	TRBJ1-6
TGTGCCAGCAGTACCTCCGGGAGGACTGAAGCTTTCTTT	CASSTSGRTEAFF	TRBV6-4	TRBJ1-1
TGCGCCAGCAGCCAAGAACAGGTCCTCTACGAGCAGTACTTC	CASSQEQVLYEQYF	TRBV4-3	TRBJ2-7
TGTGCCAGCAGGAAGTTGGGGGATAGCAATCAGCCCCAGCATTTT	CASRKLGDSNQPQHF	TRBV6-4	TRBJ1-5
TGTGCCAGAGGCTGGACAGCCTCCGGGGAGCTGTTTTTT	CARGWTASGELFF	TRBV6-4	TRBJ2-2
TGTGCTAGTGGTGGGTACCGGGACAGGGTTCTAATACCAGGCGAGCAGTACTTC	CASGGYRDRVLIPGEQYF	TRBV12-5	TRBJ2-7
TGTGCCATCCCAGCCCGCCTAGCGGGAGGGGTACCTCCCTACAATGAGCAGTTCTTC	CAIPARLAGGVPPYNEQFF	TRBV28	TRBJ2-1
TGTGCCAGCAGCACCCAGAAGCAGTACTTC	CASSTQKQYF	TRBV9	TRBJ2-7
TGTGCCAGCAGCGGACGGGGGGGAGAACCCTACGAGCAGTACTTC	CASSGRGGEPYEQYF	TRBV7-9	TRBJ2-7
TGTGCCAGCAGTGACCACACCTACTTACTTCCCAGGGGCTATGGCTACACCTTC	CASSDHTYLLPRGYGYTF	TRBV6-4	TRBJ1-2
TGTGCCAGCAGCCAAGATAGCACGATAAAAGGGACAATGGCCCAGCATTTT	CASSQDSTIKGTMAQHF	TRBV3-1	TRBJ1-5
TGTGCCAGCAGCTTACTAGAGTACGAGCAGTACTTC	CASSLLEYEQYF	TRBV7-9	TRBJ2-7
TGTGCCACCCCCTGGACAGGGGTCAACACTGAAGCTTTCTTT	CATPWTGVNTEAFF	TRBV24-1	TRBJ1-1
TGCGCCAGCATGCCGGGACAGGCCTGGAATCAGCCCCAGCATTTT	CASMPGQAWNQPQHF	TRBV10-1	TRBJ1-5
TGTGCCAGCAGCTTAGATCAGTCACCCCAGGAGGACTACGAGCAGTACTTC	CASSLDQSPQEDYEQYF	TRBV11-2	TRBJ2-7
TGCAGTGCTAGGGGACTAGCGGGGGGGACCGAGGAGACCCAGTACTTC	CSARGLAGGTEETQYF	TRBV20-1	TRBJ2-5
TGTGCCAGCAGCTTAAGTCCGGGGGCCGAGCATCCGAGAGAGACCCAGTACTTC	CASSLSPGAEHPRETQYF	TRBV11-2	TRBJ2-5
TGTGCCAGCAGCTTGCAAGTGCGGCTAACCAGTCATCGGGGCTACGAGCAGTACTTC	CASSLQVRLTSHRGYEQYF	TRBV5-5	TRBJ2-7
TGTGCCAGCAGTGACCCTGATAGGACCACAGATACGCAGTATTTT	CASSDPDRTTDTQYF	TRBV6-4	TRBJ2-3
TGCAGTGCTAGAAGAAGACCCAGGACAGGTCCGGTTTCACCCCTCCACTTT	CSARRRPRTGPVSPLHF	TRBV20-1	TRBJ1-6
TGTGCCAGGGGTTTTCGGGGAAGGACAGGGGGGGCCAACGTCCTGACTTTC	CARGFRGRTGGANVLTF	TRBV24-1	TRBJ2-6
TGTGCCAGCAGTTTCCCAAGACAGGGCAAGGACACGTACGAGCAGTACTTC	CASSFPRQGKDTYEQYF	TRBV27	TRBJ2-7
TGTGCCAGCAGTTCGGGACAGGAGACCAGCTCCTACGAGCAGTACTTC	CASSSGQETSSYEQYF	TRBV27	TRBJ2-7
TGTGCCAGCAGTTACTTTCCAGGAGGGATGGGCTACAATGAGCAGTTCTTC	CASSYFPGGMGYNEQFF	TRBV6-5	TRBJ2-1
TGTGCCAGCAGCCTCAAAAAGGCTAACACTGAAGCTTTCTTT	CASSLKKANTEAFF	TRBV13	TRBJ1-1
TGTGCCAGCAGCTCGGGCCCTGGTGAAAAACTGTTTTTT	CASSSGPGEKLFF	TRBV7-4	TRBJ1-4
TGTGCCAGCAGTCCTTGCGTGGCGACCCAGTACTTC	CASSPCVATQYF	TRBV2	TRBJ2-5
TGTGCCAGCAGCTGGCCGGGACCAGATACGCAGTATTTT	CASSWPGPDTQYF	TRBV5-4	TRBJ2-3
TGTGCCAGCAGCCCGTCCGGGACCCACACTGAAGCTTTCTTT	CASSPSGTHTEAFF	TRBV5-4	TRBJ1-1
TGCGCCAGCAGCGCTAGCGGCGAAGAGACCCAGTACTTC	CASSASGEETQYF	TRBV5-1	TRBJ2-5
TGTGCCAGCAGCTTGGAATGCGGGGGCACTGAAGCTTTCTTT	CASSLECGGTEAFF	TRBV5-6	TRBJ1-1
TGTGCCAGCAGCTCCCGGGGGGGCAATGAGCAGTTCTTC	CASSSRGGNEQFF	TRBV7-3	TRBJ2-1
TGCTTAGACAAGGCTTATGGCTACACCTTC	CLDKAYGYTF	TRBV29-1	TRBJ1-2
TGTGCCAGCAAGCGGGCCAGATACTTC	CASKRARYF	TRBV7-2	TRBJ2-4
TGCAGCGTTTATATTATTTATCCCGGACTAGCGGGTCCCAATGAGCAGTTCTTC	CSVYIIYPGLAGPNEQFF	TRBV29-1	TRBJ2-1
TGTGCCAGCAGTCACATGAACACTGAAGCTTTCTTT	CASSHMNTEAFF	TRBV6-5	TRBJ1-1
TGTGCCAGCGGCCAGGGGGTCGGTCCCTATGGCTACACCTTC	CASGQGVGPYGYTF	TRBV25-1	TRBJ1-2
TGTGCCAGCAGCGTGCGAATGCTTCGATATGGCTACACCTTC	CASSVRMLRYGYTF	TRBV9	TRBJ1-2
TGTGCCAGCAGCCAAACTAGCAGACGGGGCTACACCTTC	CASSQTSRRGYTF	TRBV3-1	TRBJ1-2
TGTGCCCAAAAGGGGAAGACTAGCACAGATACGCAGTATTTT	CAQKGKTSTDTQYF	TRBV10-3	TRBJ2-3
TGTGCCAGCAGCTTACGGGTTCGGCCCCTCTCTGGAAACACCATATATTTT	CASSLRVRPLSGNTIYF	TRBV11-2	TRBJ1-3
TGTGCCATCACGAAACGGTCAGGGCCCTTTTACGAGCAGTACTTC	CAITKRSGPFYEQYF	TRBV10-3	TRBJ2-7
TGTGCCAGACTGGGTCAGCCCCAGCATTTT	CARLGQPQHF	TRBV27	TRBJ1-5
TGTGCCAGCAGTTCCCGGGACAGGGTCTCGGGCTCTGGGGCCAACGTCCTGACTTTC	CASSSRDRVSGSGANVLTF	TRBV28	TRBJ2-6
TGTGCCAGCACCCTGGACAGTTTGAACACTGAAGCTTTCTTT	CASTLDSLNTEAFF	TRBV6-1	TRBJ1-1
TGTGCCAGCAGCCACAGAGCAAGGACCTCTGGGGCCAACGTCCTGACTTTC	CASSHRARTSGANVLTF	TRBV3-1	TRBJ2-6
TGTGCCAGCAGCCAAAGCTTGGGGACTAGCGGGAGTGGCGAGCAGTTCTTC	CASSQSLGTSGSGEQFF	TRBV3-1	TRBJ2-1
TGTGCCAGCAGCCTTCCCGGGACGGGTGGGCATGCAACTAATGAAAAACTGTTTTTT	CASSLPGTGGHATNEKLFF	TRBV6-4	TRBJ1-4
TGTGCTAGTGGTTGTGACATTAACGGACAGGGTAACAACACTGAAGCTTTCTTT	CASGCDINGQGNNTEAFF	TRBV12-5	TRBJ1-1
TGTGCCAGCAGTGACGGAAACCTACTCCTAGTTCCGTCTAATGAAAAACTGTTTTTT	CASSDGNLLLVPSNEKLFF	TRBV6-1	TRBJ1-4
TGTGCCATCAGTGATCATCGGGGTTTTGAAGTGGATCAGCCCCAGCATTTT	CAISDHRGFEVDQPQHF	TRBV10-3	TRBJ1-5
TGTGCCAGCAGCCAAGATTTAGGGGGGCGACCCTTCAATACATACCAAGAGACCCAGTACTTC	CASSQDLGGRPFNTYQETQYF	TRBV3-1	TRBJ2-5
TGCGCCAGCAGCCAAGACGAACCTCAAAGACAGGGAGGTTCCGATACTGAAGCTTTCTTT	CASSQDEPQRQGGSDTEAFF	TRBV4-1	TRBJ1-1
TGTGCCAGCAGCTATTCGGGTCCACAGCCCCAGCATTTT	CASSYSGPQPQHF	TRBV7-9	TRBJ1-5
TGTGCCAGCAGTTGCGGGAACACTGAAGCTTTCTTT	CASSCGNTEAFF	TRBV28	TRBJ1-1
TGTGCCTCCGCAGACTGGGGCGCAAGTGGGCAGCCCCAGCATTTT	CASADWGASGQPQHF	TRBV15	TRBJ1-5
TGCAGCGTGAGGACAGGGGAGGCAGAGCAGTACTTC	CSVRTGEAEQYF	TRBV29-1	TRBJ2-7
TGTGCCATCAGTAGTGGACAGCGCTCCTACGAGCAGTACTTC	CAISSGQRSYEQYF	TRBV10-3	TRBJ2-7
TGTGCCAGCAGTTACCGGCTTATGTATGGCTACACCTTC	CASSYRLMYGYTF	TRBV6-2	TRBJ1-2
TGTGCCAGCACTCAGGGGACTAGCAATCAGCCCCAGCATTTT	CASTQGTSNQPQHF	TRBV13	TRBJ1-5
TGTGCCAGGACGCCAGGTCCCCGGGACAGTGGGGCCAACGTCCTGACTTTC	CARTPGPRDSGANVLTF	TRBV28	TRBJ2-6
TGTGCCAGCAGTTTATGCGGGAGGAGCTCCTACGAGCAGTACTTC	CASSLCGRSSYEQYF	TRBV27	TRBJ2-7
TGTGCCACCAGTAGCCGACCCACTTCGCAGGGAGGGGAGACCCAGTACTTC	CATSSRPTSQGGETQYF	TRBV24-1	TRBJ2-5
TGTGCCATCAGTGCGGCCAGGGCCTACGAGCAGTACTTC	CAISAARAYEQYF	TRBV10-3	TRBJ2-7
TGTGCCAGCAGCAACCAGCTTAGCCTAGCGAAAAGTGAGCAGTTCTTC	CASSNQLSLAKSEQFF	TRBV7-6	TRBJ2-1
TGTGCCAGCAGCCAAGATCTCCCAATTCGGGGGGGCAGATCGGGCCGGGTGTACAATGAGCAGTTCTTC	CASSQDLPIRGGRSGRVYNEQFF	TRBV14	TRBJ2-1
TGTGCCAGTTGGACTAGGGGAGGCACAGATACGCAGTATTTT	CASWTRGGTDTQYF	TRBV7-9	TRBJ2-3
TGTGCCAGCAGTTACCCCCGCAAAGCTTTCTTT	CASSYPRKAFF	TRBV6-2	TRBJ1-1
TGTGCCGAGACAGACACTGAAGCTTTCTTT	CAETDTEAFF	TRBV6-4	TRBJ1-1
TGTGCCACCAGTGAGCGAAGCACAGATACGCAGTATTTT	CATSERSTDTQYF	TRBV24-1	TRBJ2-3
TGCAGTGCTATCGGGCGGACTGAAGCTTTCTTT	CSAIGRTEAFF	TRBV20-1	TRBJ1-1
TGCAGTGCTAGAGAGGGGGGCTGGGGGGGTCAGTACTTC	CSAREGGWGGQYF	TRBV20-1	TRBJ2-5
TGTGCCAGTAGTAAGACAGGGCAAGAGCAGTACTTC	CASSKTGQEQYF	TRBV19	TRBJ2-7
TGCGCCAGCAGCCGTGACCCCTACAATGAGCAGTTCTTC	CASSRDPYNEQFF	TRBV10-2	TRBJ2-1
TGTGCCAGCAGTTACCGGGACAGGGGGCGGCACTATGGCTACACCTTC	CASSYRDRGRHYGYTF	TRBV6-6	TRBJ1-2
TGTGCCAGCAGCTTGCCCCCCCCGATAAAAGAGACCCAGTACTTC	CASSLPPPIKETQYF	TRBV5-6	TRBJ2-5
TGTGCCAGCAGCATAGAGGGACGCGGCCTTTTCGATGCTGGAAACACCATATATTTT	CASSIEGRGLFDAGNTIYF	TRBV9	TRBJ1-3
TGCGCCAGCAAGGGACGATCTGGAAACACCATATATTTT	CASKGRSGNTIYF	TRBV5-1	TRBJ1-3
TGTGCCAGCAGCTTAGTGTTGTGGGACAGGGGGAATGCAACTAATGAAAAACTGTTTTTT	CASSLVLWDRGNATNEKLFF	TRBV7-9	TRBJ1-4
TGTGCCAGCAGCGTTTTGTGGGACACTGAAGCTTTCTTT	CASSVLWDTEAFF	TRBV9	TRBJ1-1
TGTGCCAGCAGCCCAGGGGATCAGCCCCAGCATTTT	CASSPGDQPQHF	TRBV6-4	TRBJ1-5
TGTGCCAGCAGTTCCGTGAGGGGGAGGGCCTACGAGCAGTACTTC	CASSSVRGRAYEQYF	TRBV27	TRBJ2-7
TGCAGCGTGAGGCGAAACCTCCACTTT	CSVRRNLHF	TRBV29-1	TRBJ1-6
TGCAGTGCTAGGGGTGGTAAGAGGAACACTGAAGCTTTCTTT	CSARGGKRNTEAFF	TRBV20-1	TRBJ1-1
TGTGCCAGCAGTCCCCCCAAGGGAAAAGACGAGCAGTACTTC	CASSPPKGKDEQYF	TRBV12-4	TRBJ2-7
TGCAGTGCTCTCAGTCAGCCCCAGCATTTT	CSALSQPQHF	TRBV20-1	TRBJ1-5
TGTGCCACCAGTGCGAGACAGGGACACGAGCAGTACTTC	CATSARQGHEQYF	TRBV24-1	TRBJ2-7
TGTGCAAGACAGGGGGCGGACGGTAGGGGGCAGTACTTC	CARQGADGRGQYF	TRBV5-4	TRBJ2-7
TGTGCCAGCAGCTTATCTTCCGGGACTTACGAGCAGTACTTC	CASSLSSGTYEQYF	TRBV7-3	TRBJ2-7
TGCAGTGCTCCCCGTCTCGGCGGGGGGGTCGAGACCCAGTACTTC	CSAPRLGGGVETQYF	TRBV20-1	TRBJ2-5
TGTGCCAGCAGCGGCGACAGGCCTGAAGCTTTCTTT	CASSGDRPEAFF	TRBV9	TRBJ1-1
TGTGCCAGCAGCATTGCAAGCGAGCAGTACTTC	CASSIASEQYF	TRBV7-3	TRBJ2-7
TGCAGTGCTTCCGGACGCGAGAGTGAAGATACGCAGTATTTT	CSASGRESEDTQYF	TRBV20-1	TRBJ2-3
TGTGCCAGCACAAACGGCAGGGATCTCTACGAGCAGTACTTC	CASTNGRDLYEQYF	TRBV5-6	TRBJ2-7
TGTGCCAGCAGTTACCCGGGATTAAGGAATGGGGGTGAACCCTACGAGCAGTACTTC	CASSYPGLRNGGEPYEQYF	TRBV6-5	TRBJ2-7
TGTGCCAGCAGTGGACCTCTACCTGAAGCTTTCTTT	CASSGPLPEAFF	TRBV2	TRBJ1-1
TGCGCCAGCAGCCCCGGGCGACCGACGAACACCGGGGAGCTGTTTTTT	CASSPGRPTNTGELFF	TRBV5-1	TRBJ2-2
TGTGCCAGCAGTTATCCGGGACGCTCGAACACCGGGGAGCTGTTTTTT	CASSYPGRSNTGELFF	TRBV6-9	TRBJ2-2
TGTGCCAGCAGCACTCAGCAGGGCGTTCGAACTAATGAAAAACTGTTTTTT	CASSTQQGVRTNEKLFF	TRBV7-7	TRBJ1-4
TGTGCTAGTGGTTTGGTAAGCGGAGTGACTAGCGGGGGGTTTGATGAGCAGTTCTTC	CASGLVSGVTSGGFDEQFF	TRBV12-5	TRBJ2-1
TGTGCCAGCAGTTACGCTTCTCAGGGGCCCATCACCGGGGAGCTGTTTTTT	CASSYASQGPITGELFF	TRBV12-4	TRBJ2-2
TGCAAAGGGGGTCCCTACGAGCAGTACTTC	CKGGPYEQYF	TRBV20-1	TRBJ2-7
TGCGCCAGCAGTGAGGTCCTGACGGGGCGCGGGGAGCTGTTTTTT	CASSEVLTGRGELFF	TRBV10-2	TRBJ2-2
TGCAGCACAGCGAACACTGAAGCTTTCTTT	CSTANTEAFF	TRBV29-1	TRBJ1-1
TGTGCCAGCAGCCACAGGAAAGGGTCTCCGGCCTATGGCTACACCTTC	CASSHRKGSPAYGYTF	TRBV3-1	TRBJ1-2
TGTGCCAGCTCACCAGGGAGGGGACAGGGGGGGGCCCAGCCCCAGCATTTT	CASSPGRGQGGAQPQHF	TRBV18	TRBJ1-5
TGTGCCTGGAGTCGAGGAGTAAAGCCGGGACGCCCCGGCAATCAGCCCCAGCATTTT	CAWSRGVKPGRPGNQPQHF	TRBV30	TRBJ1-5
TGTGCCAGCAGCCGACTAGCCACAGATACGCAGTATTTT	CASSRLATDTQYF	TRBV7-3	TRBJ2-3
TGTGCCAGCAGTTTACTCAGGATCCAGGGGGGGGAGACCCAGTACTTC	CASSLLRIQGGETQYF	TRBV27	TRBJ2-5
TGTGCCAGCAGCGGCGGGCTCCTGCAGTTTCCTAGCAATCAGCCCCAGCATTTT	CASSGGLLQFPSNQPQHF	TRBV13	TRBJ1-5
TGTGCCAGCTCACCTGGGGGGGGGGTCCATGAGCAGTTCTTC	CASSPGGGVHEQFF	TRBV18	TRBJ2-1
TGTGCCAGCAGCTCGGGTACCCCTGACCGAGCTTTCTTT	CASSSGTPDRAFF	TRBV16	TRBJ1-1
TGCGCCAGCAGCCAGTCTAGAGGGAACACTGAAGCTTTCTTT	CASSQSRGNTEAFF	TRBV4-3	TRBJ1-1
TGCGCCAGCAGCCCTAGCGGGAGGGGGGTGGAGCAGTTCTTC	CASSPSGRGVEQFF	TRBV4-3	TRBJ2-1
TGTGCCAGCAGTAATTTTTGGAGTGAGACCCAGTACTTC	CASSNFWSETQYF	TRBV2	TRBJ2-5
TGTGCCAGCAGCTTACAGGCGGGACGGAACACTGAAGCTTTCTTT	CASSLQAGRNTEAFF	TRBV7-2	TRBJ1-1
TGCAGTGCAAGACAGGGAAGAATTTTCAATGAGCAGTTCTTC	CSARQGRIFNEQFF	TRBV20-1	TRBJ2-1
TGTGACCCTAGCGGCGAGCTGGACGAGCAGTACTTC	CDPSGELDEQYF	TRBV11-3	TRBJ2-7
TGTGCCATCAGCCCAATTCCACAGGGGAGCACTGAAGCTTTCTTT	CAISPIPQGSTEAFF	TRBV10-3	TRBJ1-1
TGTGCCAGCAGTAGCAAGGAGGACAGGAATCAGCCCCAGCATTTT	CASSSKEDRNQPQHF	TRBV7-9	TRBJ1-5
TGTGCCAGACAGGGCCGGGACTCTGGAAACACCATATATTTT	CARQGRDSGNTIYF	TRBV6-2	TRBJ1-3
TGTGCCAGTAGTAAAAATACTTACGAGCAGTACTTC	CASSKNTYEQYF	TRBV19	TRBJ2-7
TGTGCCAGCAACCCCGTCATCTACGAGCAGTACTTC	CASNPVIYEQYF	TRBV25-1	TRBJ2-7
TGTGCCAGCAACCCGGGACCTAAGCGCGTTGCCTACGAGCAGTACTTC	CASNPGPKRVAYEQYF	TRBV2	TRBJ2-7
TGTGCCAGCAGTTACTCCAGCGATAACGGGAACACCGGGGAGCTGTTTTTT	CASSYSSDNGNTGELFF	TRBV6-6	TRBJ2-2
TGTGCCAGCAGCCCGCCTCCGCCGGGACTAGCGGGAGAGTATATAGCCAAAAACATTCAGTACTTC	CASSPPPPGLAGEYIAKNIQYF	TRBV5-4	TRBJ2-4
TGTGCCAGCAGGCTGAAACGGGGGTACGCCCAGCATTTT	CASRLKRGYAQHF	TRBV6-4	TRBJ1-5
TGTGCCAGCAGCCAAGGGACCTCATGCTGTTACACGGGATCAACCGAGCAGTACTTC	CASSQGTSCCYTGSTEQYF	TRBV3-1	TRBJ2-7
TGCGCCAGCAGCTTGTTTCGCGACCAGGTCTCTCAGCCCCAGCATTTT	CASSLFRDQVSQPQHF	TRBV5-1	TRBJ1-5
TGTGCCAGCATGACAGGGGGCCGGGCAGAAAAACTGTTTTTT	CASMTGGRAEKLFF	TRBV7-4	TRBJ1-4
TGTGCCAGCAGCTCCGGGGGGCAGACTGTAGTAAACCCTGCCGGGGAGCTGTTTTTT	CASSSGGQTVVNPAGELFF	TRBV5-4	TRBJ2-2
TGTGCCAGCAGCTTAGATGGGGAAATAAACACCATATATTTT	CASSLDGEINTIYF	TRBV11-2	TRBJ1-3
TGTGCCAGCAGCTTAGTACCCAGGGGGTACGGGGAGCTGTTTTTT	CASSLVPRGYGELFF	TRBV7-9	TRBJ2-2
TGTGCCAGCAGCTTGGAATCTCGTACGGGAAATGTAGAGCAGTACTTC	CASSLESRTGNVEQYF	TRBV5-6	TRBJ2-7
TGTGCCAGCAGCGTGAGAGAAGGACAATCGGAAATAGAGTGCTACGAGCAGTACTTC	CASSVREGQSEIECYEQYF	TRBV9	TRBJ2-7
TGTGCCAGCAGCTCAGTCCCCGACGGGACGACTGAAGCTTTCTTT	CASSSVPDGTTEAFF	TRBV11-2	TRBJ1-1
TGTGCCAGCAGCTTATTACAGGAAAGGGGGGCGGCTTTCTTT	CASSLLQERGAAFF	TRBV7-9	TRBJ1-1
TGCGCCAGCATCCGAAGGCGGGACAGCTTCAACACTGAAGCTTTCTTT	CASIRRRDSFNTEAFF	TRBV10-1	TRBJ1-1
TGTGCCATCAGTGGGTGTCCCCATACGCCTTCTAATGAAAAACTGTTTTTT	CAISGCPHTPSNEKLFF	TRBV10-3	TRBJ1-4
TGCAGTGCCAGTGGGGCCGGGCAGTACTTC	CSASGAGQYF	TRBV20-1	TRBJ2-7
TGTGCCACCACATTGGGCGGAGAAAAACTGTTTTTT	CATTLGGEKLFF	TRBV24-1	TRBJ1-4
TGTGCCACCAGTGACCCAACTACAGGGCAGGGGGGGAACTATGGCTACACCTTC	CATSDPTTGQGGNYGYTF	TRBV24-1	TRBJ1-2
TGTGCCACCAGTGATTGTCAGTTGGGGGGGGGCATTCAATACCAAGAGACCCAGTACTTC	CATSDCQLGGGIQYQETQYF	TRBV24-1	TRBJ2-5
TGCAGTGCTAGCCCCCGGGACAGGGGGACGGGATCATCCGGGGAGCTGTTTTTT	CSASPRDRGTGSSGELFF	TRBV20-1	TRBJ2-2
TGTGCCAGCAGAAAACAGGGGACCAAAAACATTCAGTACTTC	CASRKQGTKNIQYF	TRBV6-3	TRBJ2-4
TGTGCCAGCACCCCCCCGGGGCAACCGAAAGAGACCCAGTACTTC	CASTPPGQPKETQYF	TRBV7-3	TRBJ2-5
TGTGCCAGCAGCCCTGTTCAGCCTGAAGCTTTCTTT	CASSPVQPEAFF	TRBV7-3	TRBJ1-1
TGTGCCATCAGTGTCCATAGCGGGGGGTTGGGCGAGCAGTACTTC	CAISVHSGGLGEQYF	TRBV10-3	TRBJ2-7
TGCAGTGCTAGCAAATCACCACTACATTTTGATCAGCCCCAGCATTTT	CSASKSPLHFDQPQHF	TRBV20-1	TRBJ1-5
TGTGCCAGCAGCGTAAGGACTAGCGGGACGTTGCAGTATTTT	CASSVRTSGTLQYF	TRBV9	TRBJ2-3
TGTGCCAGCAGCTTGCAAGAGCACCTTAACCGGGACGGGGGAACCGACGAGCAGTACTTC	CASSLQEHLNRDGGTDEQYF	TRBV7-9	TRBJ2-7
TGCAGTGCTCCCCCGGGACCCTATAATTCACCCCTCCACTTT	CSAPPGPYNSPLHF	TRBV20-1	TRBJ1-6
TGCGCCAGCAGTGACGCCACCACAGGGACTAACTATGGCTACACCTTC	CASSDATTGTNYGYTF	TRBV10-1	TRBJ1-2
TGTGCCACCAGCAGAGACCGGGACAGGGGTTGGATTTATGGCTACACCTTC	CATSRDRDRGWIYGYTF	TRBV15	TRBJ1-2
TGTGCCAGCAGTGGGATAAGCAGAGCTTTCTTT	CASSGISRAFF	TRBV28	TRBJ1-1
TGTGCCAGCAGCTTAGGGGTGGACAGGGAAGAGACCCAGTACTTC	CASSLGVDREETQYF	TRBV7-6	TRBJ2-5
TGTGCCAGCAGCGTCCCTCGGGTGGCCGGGGGAGTTTTGTGTAACTATGGCTACACCTTC	CASSVPRVAGGVLCNYGYTF	TRBV7-6	TRBJ1-2
TGTGCCAGCAGCTTACCTCGACAGGGAGCGGCTCCAGAGACCCAGTACTTC	CASSLPRQGAAPETQYF	TRBV13	TRBJ2-5
TGCGCCAGCAGTGAGGCGCGGGGCCAGGAAGCTTTCTTT	CASSEARGQEAFF	TRBV10-1	TRBJ1-1
TGTGCCAGCAGTTACCCGTGTCGGGGGTCGTGGGATACGCAGTATTTT	CASSYPCRGSWDTQYF	TRBV6-6	TRBJ2-3
TGTGCCAGCAGTTACTCGAGGAGCCCGAATAAGCACAATAGCAATCAGCCCCAGCATTTT	CASSYSRSPNKHNSNQPQHF	TRBV6-5	TRBJ1-5
TGTGCCAGCAGCAGGGTGGGTAACTATGGCTACACCTTC	CASSRVGNYGYTF	TRBV13	TRBJ1-2
TGCAGCGTTGAGCGACTAGCGGGGTATACCTACAATGAGCAGTTCTTC	CSVERLAGYTYNEQFF	TRBV29-1	TRBJ2-1
TGTGCCAGCAGCGAGCAGTTCTTC	CASSEQFF	TRBV7-4	TRBJ2-1
TGTGCCAGCAGGCGGGCCCCCATTACGAACACCGGGGAGCTGTTTTTT	CASRRAPITNTGELFF	TRBV14	TRBJ2-2
TGTGCCAGCAGTCAGCGATCTAGCTCCTACGAGCAGTACTTC	CASSQRSSSYEQYF	TRBV12-4	TRBJ2-7
TGTGCCAGCAGCCTCCTCCTAGCAGGCGGAGTCGAGCAGTACTTC	CASSLLLAGGVEQYF	TRBV9	TRBJ2-7
TGCGCCAGCAGCAGCGGGAGGCCCCCCCAGCCTGAAGCTTTCTTT	CASSSGRPPQPEAFF	TRBV5-1	TRBJ1-1
TGTGCCAGCAAACAGGGAATTGGCTACACCTTC	CASKQGIGYTF	TRBV5-6	TRBJ1-2
TGCTCCAAAACTAGCGGGAGTATCAATCAGCCCCAGCATTTT	CSKTSGSINQPQHF	TRBV20-1	TRBJ1-5
TGTGCCAGCAGCGGATATTCAGGGCTTATGGGGAAGGGCAATCAGCCCCAGCATTTT	CASSGYSGLMGKGNQPQHF	TRBV13	TRBJ1-5
TGTGCCAGTAGTAGTACCCCCGGGGAGCTGTTTTTT	CASSSTPGELFF	TRBV19	TRBJ2-2
TGTGCCAGCAGCCAGGGGGGGGGAAGCTCCTACAATGAGCAGTTCTTC	CASSQGGGSSYNEQFF	TRBV13	TRBJ2-1
TGCAGTGCTAGGAGGTTAGCGGAGATCTCTGGGGCCAACGTCCTGACTTTC	CSARRLAEISGANVLTF	TRBV20-1	TRBJ2-6
TGTGCCAGCAGCCAGGACTCCCCCGAGACCCAGTACTTC	CASSQDSPETQYF	TRBV13	TRBJ2-5
TGTGCCAGCAGCTCTAGAAAAGGGAACACTGAAGCTTTCTTT	CASSSRKGNTEAFF	TRBV11-3	TRBJ1-1
TGTGCCAGCAGCAAGGCCGAGAGGGGCTACAATGAGCAGTTCTTC	CASSKAERGYNEQFF	TRBV13	TRBJ2-1
TGTGCCAGCAGTTACCGTGGCGGGAGCACTGAAGCTTTCTTT	CASSYRGGSTEAFF	TRBV6-9	TRBJ1-1
TGTGCCAGCAGAACAGGGGCCCAGCAGCCCCAGCATTTT	CASRTGAQQPQHF	TRBV6-5	TRBJ1-5
TGCGCCAGCAGCGATGGGTTGGACAGGGATGGCTACACCTTC	CASSDGLDRDGYTF	TRBV5-1	TRBJ1-2
TGTGCCAGCAGCTTAATTTGGACAGGGGAATTAAGGGGAAGGTATGAAGCTTTCTTT	CASSLIWTGELRGRYEAFF	TRBV5-6	TRBJ1-1
TGTGCCAGCAGCATACAGACAGGTGATAGCTCTGGGGCCAACGTCCTGACTTTC	CASSIQTGDSSGANVLTF	TRBV7-4	TRBJ2-6
TGTGCCAGCACAGTCAGGGGCTCCGGTGAAGCTTTCTTT	CASTVRGSGEAFF	TRBV2	TRBJ1-1
TGTGCCAGACGGGAGGGAACCACAGATACGCAGTATTTT	CARREGTTDTQYF	TRBV3-1	TRBJ2-3
TGCAGTGCTAGAGATGGCTTCGGGACAGGGGTAAGGGAGAATCAGCCCCAGCATTTT	CSARDGFGTGVRENQPQHF	TRBV20-1	TRBJ1-5
TGTGCCAGCAGTGAAGCGGTTCCATCCGAGCGGGAGATGTACGAGCAGTACTTC	CASSEAVPSEREMYEQYF	TRBV6-1	TRBJ2-7
TGTGCCAGCAGCACTAACAGGGGGGGGAAACATTATGAGCAGTTCTTC	CASSTNRGGKHYEQFF	TRBV7-8	TRBJ2-1
TGTGCCAGCAGTGTGCTCCGGGACACTAACTATGGCTACACCTTC	CASSVLRDTNYGYTF	TRBV6-5	TRBJ1-2
TGCAATGACCGAGGGACCACAGATACGCAGTATTTT	CNDRGTTDTQYF	TRBV20-1	TRBJ2-3
TGTGCCACCAGATTCCTGACAGCGGGACGGGACAATGAGCAGTTCTTC	CATRFLTAGRDNEQFF	TRBV24-1	TRBJ2-1
TGTGCCAGCCTACAAGAGACCCAGTACTTC	CASLQETQYF	TRBV18	TRBJ2-5
TGTGCCAGCTGTACGACAGGACATAGCAATCAGCCCCAGCATTTT	CASCTTGHSNQPQHF	TRBV2	TRBJ1-5
TGCGCCAGCAGCCAAGGGATGGGCCCAAGCACAGATACGCAGTATTTT	CASSQGMGPSTDTQYF	TRBV4-1	TRBJ2-3
TGTGCCAGCAGCCCGCGGTACGAGCAGTACTTC	CASSPRYEQYF	TRBV11-3	TRBJ2-7
TGTGCCAGCAGTTACCTTGGGGCGCCTGAAGCTTTCTTT	CASSYLGAPEAFF	TRBV6-5	TRBJ1-1
TGTGCCACCATCTCCTCTTACGAGCAGTACTTC	CATISSYEQYF	TRBV24-1	TRBJ2-7
TGTGCCAGTAGGCGACTAGCGGGTTGCACCGGGGAGCTGTTTTTT	CASRRLAGCTGELFF	TRBV5-6	TRBJ2-2
TGTGCCAGCAGAACGTTTTCCAGGGGGCAAGAGACCCAGTACTTC	CASRTFSRGQETQYF	TRBV6-5	TRBJ2-5
TGTGCCAGCAGCCGCCTGAAGAATGAGCAGTTCTTC	CASSRLKNEQFF	TRBV6-2	TRBJ2-1
TGTGCCAGCAGTTACTTTGATGATGGGTACAATGAGCAGTTCTTC	CASSYFDDGYNEQFF	TRBV6-5	TRBJ2-1
TGCGCCAGCAAAACCGGACGCGTGCAGTTCTTC	CASKTGRVQFF	TRBV10-1	TRBJ2-1
TGTGCCTGGAGTGTACGGGACAGGGGGCAGATTACCTACGAGCAGTACTTC	CAWSVRDRGQITYEQYF	TRBV30	TRBJ2-7
TGCAGCGTTGGGGGGGTGGGCAGACCCGAAGGCGGAAGGGAGAGACCTCCGGAGACCCAGTACTTC	CSVGGVGRPEGGRERPPETQYF	TRBV29-1	TRBJ2-5
TGTGCCAGCAGCATCTCCGGGACAGGGGCCAGGGTGCAGTATTTT	CASSISGTGARVQYF	TRBV14	TRBJ2-3
TGTGCCAGCAGCTACACGACTTGTGACAATGAGCAGTTCTTC	CASSYTTCDNEQFF	TRBV11-2	TRBJ2-1
TGTGCCAGCAGCCCTGGGGTTGGACACACTGAAGCTTTCTTT	CASSPGVGHTEAFF	TRBV11-3	TRBJ1-1
TGCGCCAGCAGCCAAGAGGCGACAAGCACCGGGGAGCTGTTTTTT	CASSQEATSTGELFF	TRBV4-1	TRBJ2-2
TGTGCCAGCAGAGAAGCAAGCGCAGTCCTTTTAGAAGGGGTGTACAATGAGCAGTTCTTC	CASREASAVLLEGVYNEQFF	TRBV6-2	TRBJ2-1
TGTGCCAGCCCACCGGGACAGGGGCCAGATGGCTACACCTTC	CASPPGQGPDGYTF	TRBV9	TRBJ1-2
TGTGCCAGCTGTAGCGTGACGTCAGATACGCAGTATTTT	CASCSVTSDTQYF	TRBV6-1	TRBJ2-3
TGTGCCAGCAGTAACAGGGGTTATCAGCCCCAGCATTTT	CASSNRGYQPQHF	TRBV6-5	TRBJ1-5
TGTGCCAGCAGTTTGAGGATAGCGGACGAGCAGTACTTC	CASSLRIADEQYF	TRBV27	TRBJ2-7
TGTGCCACCAGTGGGATCACAGGGCTGTCCGTCTCCTATAATTCACCCCTCCACTTT	CATSGITGLSVSYNSPLHF	TRBV24-1	TRBJ1-6
TGTGCCGGGGTGCACACTGAAGCTTTCTTT	CAGVHTEAFF	TRBV28	TRBJ1-1
TGCGCCAGCAGCGCCAGGGGGCTCCGCTACACCTTC	CASSARGLRYTF	TRBV5-1	TRBJ1-2
TGTGCCAGCAGTTTATCCGGACCCGGGACAGTTTATGGCTACGAGCAGTACTTC	CASSLSGPGTVYGYEQYF	TRBV27	TRBJ2-7
TGTGCCAGCAGTTTATGGGGGGGTATGATGAACACTGAAGCTTTCTTT	CASSLWGGMMNTEAFF	TRBV12-4	TRBJ1-1
TGCGCCAGTGCGAGTGGTCTAGCGGGGGGGCCGCCACACAATGAGCAGTTCTTC	CASASGLAGGPPHNEQFF	TRBV5-1	TRBJ2-1
TGTGCCAGCAGCCAAGGAGTTCCAGGGAGTTCCTACGAGCAGTACTTC	CASSQGVPGSSYEQYF	TRBV14	TRBJ2-7
TGTGCCAGCATCCGCACCGTTGAGGGGGGGAGAAATCAGCCCCAGCATTTT	CASIRTVEGGRNQPQHF	TRBV5-4	TRBJ1-5
TGTGCCAGCAGTCCACGGCGGGCGTCCCAGGTACACGAGCAGTACTTC	CASSPRRASQVHEQYF	TRBV11-2	TRBJ2-7
TGTGCCAGCGATCAGGGGGCGACCAGAAAGGGAAACACCATATATTTT	CASDQGATRKGNTIYF	TRBV11-2	TRBJ1-3
TGTGCCCTGACAAGAAGATTCCTCAAAGATACGCAGTATTTT	CALTRRFLKDTQYF	TRBV12-3	TRBJ2-3
TGTGCCAGCAGCCATGGCCAGGGGCCGTTATACCGCTCCTACGAGCAGTACTTC	CASSHGQGPLYRSYEQYF	TRBV14	TRBJ2-7
TGTGCCAGCAGTGAAGCGGGAGCCGGGTACGAGCAGTACTTC	CASSEAGAGYEQYF	TRBV28	TRBJ2-7
TGTGCCCTCCAAATATCAGGGGGGTACCAAGAGACCCAGTACTTC	CALQISGGYQETQYF	TRBV7-9	TRBJ2-5
TGTGCCAGCACTCCGGGACAGAAGGGATATGGCTACACCTTC	CASTPGQKGYGYTF	TRBV6-6	TRBJ1-2
TGTGCCAGCACAGGGAGAGCCCGAATCATCTCCTACGAGCAGTACTTC	CASTGRARIISYEQYF	TRBV11-1	TRBJ2-7
TGTGCCAGCAGCTTATCGGGTTCCGAGGGACAGGGGGATAGATTTAATGAAAAACTGTTTTTT	CASSLSGSEGQGDRFNEKLFF	TRBV11-2	TRBJ1-4
TGTGCCAGCAGCCAAGAATTGGACATCGGTAGCAATCAGCCCCAGCATTTT	CASSQELDIGSNQPQHF	TRBV14	TRBJ1-5
TGTGCCAGCAGCTACCAATGCAATCAGCCCCAGCATTTT	CASSYQCNQPQHF	TRBV11-2	TRBJ1-5
TGTGCCAGCAACCGGGGGGCTCACGAGCAGTACTTC	CASNRGAHEQYF	TRBV7-2	TRBJ2-7
TGTGCCAGCAGTTATTCTACTAGCGGGAGGGCGCATTGCAATCAGCCCCAGCATTTT	CASSYSTSGRAHCNQPQHF	TRBV6-5	TRBJ1-5
TGTGCCAGACCAAGCAATCAGCCCCAGCATTTT	CARPSNQPQHF	TRBV25-1	TRBJ1-5
TGTGCCAGCAAAAACAGGTTAAACAATCAGCCCCAGCATTTT	CASKNRLNNQPQHF	TRBV12-3	TRBJ1-5
TGCAGCGCCGGGACAGGGTCCTATCAGCCCCAGCATTTT	CSAGTGSYQPQHF	TRBV29-1	TRBJ1-5
TGCAGTGCCCCCAGAGACGAGCAGTACTTC	CSAPRDEQYF	TRBV20-1	TRBJ2-7
TGTGCCAGCAGTTACAAACGGGACAGAGGTTATGGCTACACCTTC	CASSYKRDRGYGYTF	TRBV6-3	TRBJ1-2
TGTGCCAGCAGTTACGGTCCCAGGGTAGTCTCTGGAAACACCATATATTTT	CASSYGPRVVSGNTIYF	TRBV6-5	TRBJ1-3
TGTGCCAGCAGTCCTACGTCAGGGCTAACTGAAGCTTTCTTT	CASSPTSGLTEAFF	TRBV12-4	TRBJ1-1
TGTGCCAGCAGGTTAAGTGTGAGGGGGCAAATCTACGAGCAGTACTTC	CASRLSVRGQIYEQYF	TRBV6-6	TRBJ2-7
TGTGCCAGCACCCCGGGGGGCCGCAGAGAAGAGACCCAGTACTTC	CASTPGGRREETQYF	TRBV6-2	TRBJ2-5
TGTGCCAGTAGGGGGACGGAATTTAGGCGGATAGCCAAAAACATTCAGTACTTC	CASRGTEFRRIAKNIQYF	TRBV19	TRBJ2-4
TGTGCCAGACCCCGGACAGCCACCACCGGGGAGCTGTTTTTT	CARPRTATTGELFF	TRBV6-4	TRBJ2-2
TGTGCCAGCAGCCCCCTGGGACAGGGGGGGGAAAACTCTGGGGCCAACGTCCTGACTTTC	CASSPLGQGGENSGANVLTF	TRBV11-2	TRBJ2-6
TGTGCCAGCAGCCGCGGGGGGGCCTACGAGCAGTACTTC	CASSRGGAYEQYF	TRBV7-3	TRBJ2-7
TGCGCCAGCAGTGAGCTGGGGGGGCCTAACTCCTTTGGGGACTCCTACGAGCAGTACTTC	CASSELGGPNSFGDSYEQYF	TRBV10-2	TRBJ2-7
TGTGCCAGCAGCTTCTTAAGTGAAAAACTGTTTTTT	CASSFLSEKLFF	TRBV5-6	TRBJ1-4
TGTGCCAGCAGTTCAGGGGAGGTAACTAATGAAAAACTGTTTTTT	CASSSGEVTNEKLFF	TRBV28	TRBJ1-4
TGTGCCAGCAGCTTCCAGTTGACAGTAGGCGGGGAGCTGTTTTTT	CASSFQLTVGGELFF	TRBV7-9	TRBJ2-2
TGTGCCAGCAGTATTCCTAGCGGGGGGAGGCAAGAGACCCAGTACTTC	CASSIPSGGRQETQYF	TRBV6-4	TRBJ2-5
TGTGCCAGCAGCGTAGATGCGGGTTACGAGCAGTACTTC	CASSVDAGYEQYF	TRBV9	TRBJ2-7
TGTGCCAGCAGCCAAGTGGGAACCGGGACAGTTGTTCCCTATACGCAGTATTTT	CASSQVGTGTVVPYTQYF	TRBV14	TRBJ2-3
TGTGCCAGACAGGGACCTTCACCCCTCCACTTT	CARQGPSPLHF	TRBV27	TRBJ1-6
TGTGCCAGCAGCACACCGGGACAGGGGAATAGCAATCAGCCCCAGCATTTT	CASSTPGQGNSNQPQHF	TRBV7-9	TRBJ1-5
TGTGCCAGCAGCTTACGGCGGACTGACTACGAGCAGTACTTC	CASSLRRTDYEQYF	TRBV7-4	TRBJ2-7
TGTGCCAGCAGCTTAGTAGTAGAAACCGGGGGGTCTGGGGCCAACGTCCTGACTTTC	CASSLVVETGGSGANVLTF	TRBV7-9	TRBJ2-6
TGCGCCAGCAGATTGTCCTCTGCCGGGAATGAAAAACTGTTTTTT	CASRLSSAGNEKLFF	TRBV10-1	TRBJ1-4
TGTGCCAGCAGCAGGCACCGGACGAGAGGGGAGCAGTACTTC	CASSRHRTRGEQYF	TRBV7-4	TRBJ2-7
TGTGCCAGCAGCAGGGGGCGACTTGAACTTTATGGCTACACCTTC	CASSRGRLELYGYTF	TRBV28	TRBJ1-2
TGTGCCAGCAGCTTATCACGACCTAGTAACAATGAGCAGTTCTTC	CASSLSRPSNNEQFF	TRBV13	TRBJ2-1
TGTGCCAGCTCACCTCTCGACAGGGGGGTTGAGGCTTTCTTT	CASSPLDRGVEAFF	TRBV18	TRBJ1-1
TGCGCCAGCAGCTCGCGGGAGACTATCCATTTCGGGGAGCTGTTTTTT	CASSSRETIHFGELFF	TRBV5-1	TRBJ2-2
TGCAGCGTCAGACAGAAACAGCCCCAGCATTTT	CSVRQKQPQHF	TRBV29-1	TRBJ1-5
TGTGCCAGCTCAGCGCAGGCTAATCCTTCTTCCACTGAAGCTTTCTTT	CASSAQANPSSTEAFF	TRBV18	TRBJ1-1
TGTGCCAGCAGTTTGAGGGGGCGACATAAAGGGAAGATAGCCAAAAACATTCAGTACTTC	CASSLRGRHKGKIAKNIQYF	TRBV12-3	TRBJ2-4
TGTGTCCCCCGGGACAGGGACACTGAAGCTTTCTTT	CVPRDRDTEAFF	TRBV9	TRBJ1-1
TGCGCCAGCAGCTTGCAGTCCCGGGGGAACGGAACTAATGAAAAACTGTTTTTT	CASSLQSRGNGTNEKLFF	TRBV5-1	TRBJ1-4
TGCGCCAGCAGCCCACAGGGGAATCAGGAAGAGACCCAGTACTTC	CASSPQGNQEETQYF	TRBV10-1	TRBJ2-5
TGTGCCAGCAGTGACTTGCAACTAGCGGGAGGGCCATACAATGAGCAGTTCTTC	CASSDLQLAGGPYNEQFF	TRBV6-4	TRBJ2-1
TGTGCCAGCAATCTCCTGGGGTTAAATCAGCCCCAGCATTTT	CASNLLGLNQPQHF	TRBV14	TRBJ1-5
TGTGCCATCCGGGAACAGAATGAAAAACTGTTTTTT	CAIREQNEKLFF	TRBV6-5	TRBJ1-4
TGTGCCAGCAGCCCCCCCGGGGCGGGACCCCTCCACTTT	CASSPPGAGPLHF	TRBV13	TRBJ1-6
TGTGCCAGCAGCTTACCGAGCGACTTCGATGGCACAGATACGCAGTATTTT	CASSLPSDFDGTDTQYF	TRBV7-3	TRBJ2-3
TGTGCCAGCAGTTTAAGTCGGGGGAGGGCACGTTACGAGCAGTACTTC	CASSLSRGRARYEQYF	TRBV27	TRBJ2-7
TGTGCCAGCAGCAATCTTCTAGCGCCCTTAAATGAGCAGTTCTTC	CASSNLLAPLNEQFF	TRBV7-3	TRBJ2-1
TGTGCCACCAAGACAGGGACCCGCAATCAGCCCCAGCATTTT	CATKTGTRNQPQHF	TRBV24-1	TRBJ1-5
TGTGCCAGCAGCTCCCACGGCAAAGATTACGAGCAGTACTTC	CASSSHGKDYEQYF	TRBV7-2	TRBJ2-7
TGTGCCAGCAGCTTGTTTCACAGGGGGCGAATTAACTATGGCTACACCTTC	CASSLFHRGRINYGYTF	TRBV7-3	TRBJ1-2
TGTGCCACCAAAACTAGGAGTCAAGAGACCCAGTACTTC	CATKTRSQETQYF	TRBV24-1	TRBJ2-5
TGTGCCAAAGTACTTGGGGTAGGAGCCTACGAGCAGTACTTC	CAKVLGVGAYEQYF	TRBV13	TRBJ2-7
TGTGCCAGCAGTCATCTACCGATTAGGGGAGCACTGTTTTTT	CASSHLPIRGALFF	TRBV27	TRBJ1-4
TGTGCCTGGAGTGGCCATCGAGACGGCGATCAGCCCCAGCATTTT	CAWSGHRDGDQPQHF	TRBV30	TRBJ1-5
TGTGCTAGTGGTTCGGTCGCGGGACAGGGGGGCTATGGCTACACCTTC	CASGSVAGQGGYGYTF	TRBV12-5	TRBJ1-2
TGTGCCAGCAGCCACCGGTCTGGGACCAGAAGCTCCTATAATTCACCCCTCCACTTT	CASSHRSGTRSSYNSPLHF	TRBV4-2	TRBJ1-6
TGTGCCAGCAGCTTAAAGTCCTACCAATGGGAAGAGACCCAGTACTTC	CASSLKSYQWEETQYF	TRBV7-2	TRBJ2-5
TGTGCCAGCGTCACATTTAACAATCAGCCCCAGCATTTT	CASVTFNNQPQHF	TRBV7-9	TRBJ1-5
TGTGCCAGCAGCTTGGCCATTCCGGAAATAAGGAACACTGAAGCTTTCTTT	CASSLAIPEIRNTEAFF	TRBV5-6	TRBJ1-1
TGCAGTGCTAGTCCCCCGCAGGGGCACTATGGCTACACCTTC	CSASPPQGHYGYTF	TRBV20-1	TRBJ1-2
TGTGCCAGGGGAGACAGGGGCTGCACAGATACGCAGTATTTT	CARGDRGCTDTQYF	TRBV14	TRBJ2-3
TGCGCCAGCAGCCGCCGGACAGGGCACAATGAGCAGTTCTTC	CASSRRTGHNEQFF	TRBV10-1	TRBJ2-1
TGTGCCAGCAGCTTGGGGGCGGTAAATCAGCCCCAGCATTTT	CASSLGAVNQPQHF	TRBV11-2	TRBJ1-5
TGCAGTGCTACAAGCACTGAAGCTTTCTTT	CSATSTEAFF	TRBV20-1	TRBJ1-1
TGCAAGGGGACGGACAGGGGGGTTAAACTTAAGTATGGCTACACCTTC	CKGTDRGVKLKYGYTF	TRBV20-1	TRBJ1-2
TGTGCTAGCAGCTTAGTTGGTCCGGCCGGGACAGGGAGACTCTTTTGCACTGAAGCTTTCTTT	CASSLVGPAGTGRLFCTEAFF	TRBV7-7	TRBJ1-1
TGCAGTGCTAGAGATGAAGCGGGGGATACGCTGGGCCCACCAAGCAATCAGCCCCAGCATTTT	CSARDEAGDTLGPPSNQPQHF	TRBV20-1	TRBJ1-5
TGTGCCAGCAGCAGCCGGGACGAGGAAACGGAGAACACTGAAGCTTTCTTT	CASSSRDEETENTEAFF	TRBV3-1	TRBJ1-1
TGCGCCAGCAGCCACTTGACAGGGGGCTTGTGGGGGGAGCAGTACTTC	CASSHLTGGLWGEQYF	TRBV4-1	TRBJ2-7
TGTGCCAGCAGCTGCCCACCTCATTGGACAAAGTACGAGCAGTACTTC	CASSCPPHWTKYEQYF	TRBV6-4	TRBJ2-7
TGTGCCAGCAGCTTATTGAAGGGGGGCAGGGACACTGAAGCTTTCTTT	CASSLLKGGRDTEAFF	TRBV5-6	TRBJ1-1
TGTGCCAGCAGCGTGTGGGACAACAAGTACTCCTACGAGCAGTACTTC	CASSVWDNKYSYEQYF	TRBV7-9	TRBJ2-7
TGTGCCAGCAGCCGGGGAGAGACCCAGTACTTC	CASSRGETQYF	TRBV11-2	TRBJ2-5
TGCGCCAGCAGCTTGTCTCTACTCACAGGGTTCGGAACTAATGAAAAACTGTTTTTT	CASSLSLLTGFGTNEKLFF	TRBV5-1	TRBJ1-4
TGCAGTGGGACTAGCGGGGGGATGGAGACCCAGTACTTC	CSGTSGGMETQYF	TRBV20-1	TRBJ2-5
TGTGCCAGCAGCGGACCCCCCTCAGGGAATCATGGCTACACCTTC	CASSGPPSGNHGYTF	TRBV9	TRBJ1-2
TGTGCCAGCAGCCTCTCTCTGACGGCGAACAATCAGCCCCAGCATTTT	CASSLSLTANNQPQHF	TRBV9	TRBJ1-5
TGCAGTGCTAGGGTCCGGGACGCTTCTGGGGCCAACGTCCTGACTTTC	CSARVRDASGANVLTF	TRBV20-1	TRBJ2-6
TGTGCCAGCAGCCAAGATCGTCACACATACTACGAGCAGTACTTC	CASSQDRHTYYEQYF	TRBV4-2	TRBJ2-7
TGCAGTGCTACCCGGGACAGGGGAATGGCAGATACGCAGTATTTT	CSATRDRGMADTQYF	TRBV20-1	TRBJ2-3
TGTGCCAGCTCACCACAGGGTGACCCTTGCTACGAGCAGTACTTC	CASSPQGDPCYEQYF	TRBV18	TRBJ2-7
TGTGCCAGCAGTGAATTGACAGGATACGAGCAGTACTTC	CASSELTGYEQYF	TRBV2	TRBJ2-7
TGCAGTGCTAGCCGTGTGGGGGCGGGCGGCAATCAGCCCCAGCATTTT	CSASRVGAGGNQPQHF	TRBV20-1	TRBJ1-5
TGCAGTGCTAGAGGGCCGACAGGGATCGACATTCAGTACTTC	CSARGPTGIDIQYF	TRBV20-1	TRBJ2-4
TGTGCCACCAGTGATACCGGGAAGCAAGAGACCCAGTACTTC	CATSDTGKQETQYF	TRBV24-1	TRBJ2-5
TGCGCCAGCAGTGAGTCGATTGACAGGATGTATCACACTGAAGCTTTCTTT	CASSESIDRMYHTEAFF	TRBV10-1	TRBJ1-1
TGTGCCTGGAGCTCCCCTCCCTGCGGCCCTAACGAGCAGTACTTC	CAWSSPPCGPNEQYF	TRBV30	TRBJ2-7
TGTGCCAGCTCACCATCCGGGGGGCCAGATGAGCAGTTCTTC	CASSPSGGPDEQFF	TRBV18	TRBJ2-1
TGTGCCAGCAGGCGGGGGGCCACAGGGAGAGTCCAGGGGGCCAACGTCCTGACTTTC	CASRRGATGRVQGANVLTF	TRBV6-1	TRBJ2-6
TGTGCCAGCAGCATGGAAGGGACAGTTTTACCGGATGAGCAGTTCTTC	CASSMEGTVLPDEQFF	TRBV7-9	TRBJ2-1
TGCGCCAGCAAGCAGGGGGCATTGAACTATGGCTACACCTTC	CASKQGALNYGYTF	TRBV5-1	TRBJ1-2
TGTGCCAGCAGGAGACAGGTGGGCGAGCAGTACTTC	CASRRQVGEQYF	TRBV9	TRBJ2-7
TGTGCCAAAGTGAGGGACAGCTCTTATGGCTACACCTTC	CAKVRDSSYGYTF	TRBV6-2	TRBJ1-2
TGTGCCAGCAGTGTGTCTACGGCCGGGGAGCTGTTTTTT	CASSVSTAGELFF	TRBV27	TRBJ2-2
TGTGCCACCATCACACGGGGCTATGGCTACACCTTC	CATITRGYGYTF	TRBV24-1	TRBJ1-2
TGTGCCAGCAGTGACAGGGGATACACTAGCGGGAGGGCCGATACGCAGTATTTT	CASSDRGYTSGRADTQYF	TRBV2	TRBJ2-3
TGTGCCAGCTCACCCCGGGACAGGGGCGTGGAACCTGATACGCAGTATTTT	CASSPRDRGVEPDTQYF	TRBV18	TRBJ2-3
TGTGCCAGCAGTTACTCGACACCGGGACAGGGAACTAATGAAAAACTGTTTTTT	CASSYSTPGQGTNEKLFF	TRBV6-5	TRBJ1-4
TGTGCCACCAGTGACAGGGCGACTGTGAGAAAACTGTTTTTT	CATSDRATVRKLFF	TRBV24-1	TRBJ1-4
TGTGCCAGCAGTAGAGGGGGGACCCAGTACTTC	CASSRGGTQYF	TRBV6-1	TRBJ2-5
TGTGCCAGCAGTTTAAGGGGTGGACAGAACACCGGGGAGCTGTTTTTT	CASSLRGGQNTGELFF	TRBV27	TRBJ2-2
TGCGCCAGCAGCTCGAGACAGGGAGCCTATTCGCAGTACTTC	CASSSRQGAYSQYF	TRBV5-1	TRBJ2-7
TGTGCCATAAGAAGTTATAGGAGCAAGGAAAACATTCAGTACTTC	CAIRSYRSKENIQYF	TRBV10-3	TRBJ2-4
TGTGCCAGCAGCCAGCCGGGACAGAACACTGAAGCTTTCTTT	CASSQPGQNTEAFF	TRBV11-2	TRBJ1-1
TGTGCCAGCAGCATTGGGCTCCGGGACACAGATACGCAGTATTTT	CASSIGLRDTDTQYF	TRBV5-6	TRBJ2-3
TGTGCCAGCGGGGCCAAGGGGAGAGGCAGGCTGTACGAGCAGTACTTC	CASGAKGRGRLYEQYF	TRBV12-4	TRBJ2-7
TGTGCCAGCAGCCCCGACGGCGACGAGCAGTACTTC	CASSPDGDEQYF	TRBV14	TRBJ2-7
TGTGCCCTAGGGACAGGCAATCAGCCCCAGCATTTT	CALGTGNQPQHF	TRBV5-6	TRBJ1-5
TGTGCCAGCAGTGACACAGGACAGGACGAGAGTCGCAATCAGCCCCAGCATTTT	CASSDTGQDESRNQPQHF	TRBV6-1	TRBJ1-5
TGTGCCACCAGTGGTTCAATGGAGGGGGCCAATGAAAAACTGTTTTTT	CATSGSMEGANEKLFF	TRBV24-1	TRBJ1-4
TGTGCCCCCCCAGAATTTGAGCAGTTCTTC	CAPPEFEQFF	TRBV6-5	TRBJ2-1
TGCAGTGCTAGAATCGCTCGGGGGGCCCAAGGAAATGAGCAGTTCTTC	CSARIARGAQGNEQFF	TRBV20-1	TRBJ2-1
TGTGCCAGCAGCCCTTCCCAGGGGGGGGCTTTTAACTATGGCTACACCTTC	CASSPSQGGAFNYGYTF	TRBV7-9	TRBJ1-2
TGTGCCAGCAGCTTGGGTCGTTTCTCGGGAAGGCTTGGCACAGATACGCAGTATTTT	CASSLGRFSGRLGTDTQYF	TRBV5-6	TRBJ2-3
TGTGCCAGCAGACTAGAAGGGGAGGTAAGCACTGAAGCTTTCTTT	CASRLEGEVSTEAFF	TRBV27	TRBJ1-1
TGTGCCAGCAGCTTAGGCATTAGCGGAGGCCCCTTTGAGCAGTTCTTC	CASSLGISGGPFEQFF	TRBV7-9	TRBJ2-1
TGTGCCAGCGTAGCCAATGTGGAGGGGAACACTGAAGCTTTCTTT	CASVANVEGNTEAFF	TRBV2	TRBJ1-1
TGTGCCATCAGTGAAAAATACGGGCGTTACGAGCAGTACTTC	CAISEKYGRYEQYF	TRBV10-3	TRBJ2-7
TGCGCCAGCAGCCAGGGATCCCGCGGGAGAACAGATACGCAGTATTTT	CASSQGSRGRTDTQYF	TRBV4-1	TRBJ2-3
TGTGCGTCAGGGGTGGCGACAAGCTCCTACAATGAGCAGTTCTTC	CASGVATSSYNEQFF	TRBV9	TRBJ2-1
TGCAGCGGACTAGCTCCTAGCTCCTACGAGCAGTACTTC	CSGLAPSSYEQYF	TRBV20-1	TRBJ2-7
TGTTACCCTTCCCAGGGGATAAGCTCCTACGAGCAGTACTTC	CYPSQGISSYEQYF	TRBV19	TRBJ2-7
TGCAGTGTTGACAGGGGAAGGTCGGACACCGGGGAGCTGTTTTTT	CSVDRGRSDTGELFF	TRBV20-1	TRBJ2-2
TGTGCCAGCAGCTTATTGGGGGAGAGGGTCTACGAGCAGTACTTC	CASSLLGERVYEQYF	TRBV7-6	TRBJ2-7
TGTGCCAGCAGCGACAGGAGGAGAGAAGAGACCCAGTACTTC	CASSDRRREETQYF	TRBV9	TRBJ2-5
TGTGCCACCAGTGACCCGCTACTAGCGGGAGGGCGGAGCATTGACCAAGAGACCCAGTACTTC	CATSDPLLAGGRSIDQETQYF	TRBV24-1	TRBJ2-5
TGTGCCAGCAAGAGCCTAGCGGGCCCTTACAATGAGCAGTTCTTC	CASKSLAGPYNEQFF	TRBV6-1	TRBJ2-1
TGTGCCAGCAGCGGGACAGGGGATCACCAAGAGACCCAGTACTTC	CASSGTGDHQETQYF	TRBV7-4	TRBJ2-5
TGTGCCAGCAGCCGTGTGGGACAGGGGAGGAGGCGTCAGCCCCAGCATTTT	CASSRVGQGRRRQPQHF	TRBV7-9	TRBJ1-5
TGTGCCAGCAGCTTTGCCGGGACAGGGTGGGAGACCCAGTACTTC	CASSFAGTGWETQYF	TRBV7-9	TRBJ2-5
TGCAGTGCTCCGGGACTCGTTCCTTCTGGACAGGGGGCCAAAGGACTCCACTCCTACGAGCAGTACTTC	CSAPGLVPSGQGAKGLHSYEQYF	TRBV20-1	TRBJ2-7
TGTGCCAGCAGTTACAGGGGGTATTCACCCCTCCACTTT	CASSYRGYSPLHF	TRBV2	TRBJ1-6
TGTGCCAGCAGCTTGATTAGGACAGGTTGGGGAAACACCATATATTTT	CASSLIRTGWGNTIYF	TRBV11-2	TRBJ1-3
TGTGCCAGCAGCATGACGCGTTCGGGACAGGGGTCCTCCTACGAGCAGTACTTC	CASSMTRSGQGSSYEQYF	TRBV14	TRBJ2-7
TGTGCCAGCAGCCAAGATCTGCTTCAGGGGGTGCTAGCCAAAAACATTCAGTACTTC	CASSQDLLQGVLAKNIQYF	TRBV14	TRBJ2-4
TGTGCCAGCAGCCAACAAGGGACAGGAACCCAAGAGACCCAGTACTTC	CASSQQGTGTQETQYF	TRBV3-1	TRBJ2-5
TGTGCCAAAGGAGGGCAAGAGACCCAGTACTTC	CAKGGQETQYF	TRBV6-5	TRBJ2-5
TGTGCCAGTAGTATCCCTGGGTCGGGAGATACGCAGTATTTT	CASSIPGSGDTQYF	TRBV19	TRBJ2-3
TGTGCCAGCAGCTTGAAAACAGGGGGTGAAGCTTTCTTT	CASSLKTGGEAFF	TRBV5-6	TRBJ1-1
TGTGCCAGCAGCATCGGTCGGCATCAGCCCCAGCATTTT	CASSIGRHQPQHF	TRBV7-3	TRBJ1-5
TGCGCCAGCCGGGGGGGGAAAAGCCAGAGGCCGTTCACAGATACGCAGTATTTT	CASRGGKSQRPFTDTQYF	TRBV10-1	TRBJ2-3
TGTGCCAGCAGCCCCCTTCAACTGGAGGGACTCTATGGCTACACCTTC	CASSPLQLEGLYGYTF	TRBV13	TRBJ1-2
TGTGCCACCAGCGGGGCGGTATTCACTGAAGCTTTCTTT	CATSGAVFTEAFF	TRBV15	TRBJ1-1
TGTGCCAGCAGGCCCAGGGGGGGGGCCGGGGAGCTGTTTTTT	CASRPRGGAGELFF	TRBV6-2	TRBJ2-2
TGTGCCAGCACCCACCTCATTACTGAAGCTTTCTTT	CASTHLITEAFF	TRBV27	TRBJ1-1
TGCAGTGCTAGAGCCTTGTGGGGAAGGAGCAATCAGCCCCAGCATTTT	CSARALWGRSNQPQHF	TRBV20-1	TRBJ1-5
TGCAGCGTTGAAGGACAGCAAATCGACTACGAGCAGTACTTC	CSVEGQQIDYEQYF	TRBV29-1	TRBJ2-7
TGTGCCAGCAGTACGAGGGCTCGGGGGGGGGTCTTAAACACTGAAGCTTTCTTT	CASSTRARGGVLNTEAFF	TRBV7-6	TRBJ1-1
TGCGCCAGCAGCCATTCTCAGGGCAGCTCCAATGAGCAGTTCTTC	CASSHSQGSSNEQFF	TRBV4-1	TRBJ2-1
TGTGCCAGCAGTGCGGGACCTAACGGTAGGTTGGAGCAGTACTTC	CASSAGPNGRLEQYF	TRBV2	TRBJ2-7
TGCAGTGCTAGACCTACACCGGGGTGGTATGGCTACACCTTC	CSARPTPGWYGYTF	TRBV20-1	TRBJ1-2
TGTGCCAGCAGCCCATGCATAGGACCGTGCTACGAGCAGTACTTC	CASSPCIGPCYEQYF	TRBV13	TRBJ2-7
TGTGCCAGCAGCCCCCCTACGGGATTCGAGCAGTACTTC	CASSPPTGFEQYF	TRBV5-4	TRBJ2-7
TGTGCCAGCAGTGGGGGGGGCCGGACCAATGAGCAGTTCTTC	CASSGGGRTNEQFF	TRBV12-4	TRBJ2-1
TGCAGTGCTAGAGCCGGACAGGGTTACTCCTACGAGCAGTACTTC	CSARAGQGYSYEQYF	TRBV20-1	TRBJ2-7
TGTGCCAGCAGCCAAGACCTAGCGGGCACTGAGCAGTTCTTC	CASSQDLAGTEQFF	TRBV3-1	TRBJ2-1
TGTGCCAGCAGCTTGAGGGGAGGCAATTGGCTGAGGGGGTGCACAGATACGCAGTATTTT	CASSLRGGNWLRGCTDTQYF	TRBV5-5	TRBJ2-3
TGTGCCAGCAGTTTACCCACTGGACAGGGCCCCAGCTCCTATAATTCACCCCTCCACTTT	CASSLPTGQGPSSYNSPLHF	TRBV27	TRBJ1-6
TGCGCCAGCAGATCAGGCTGCTCGGCAATGGAGGGTAGAACCCGTGCTTTCTTT	CASRSGCSAMEGRTRAFF	TRBV10-1	TRBJ1-1
TGCACGCCGGGACGTGTGACGCAGTATTTT	CTPGRVTQYF	TRBV20-1	TRBJ2-3
TGTGCCAGCATAAACAGGGTCAGTGTAAGGCGGTGGGTGGGAAACACCATATATTTT	CASINRVSVRRWVGNTIYF	TRBV27	TRBJ1-3
TGTGCTGGGGACAGGTTGGTGAACACTGAAGCTTTCTTT	CAGDRLVNTEAFF	TRBV30	TRBJ1-1
TGTGCCAGCAGTTCCCCGAAGGGGCGGGGCACTGAAGCTTTCTTT	CASSSPKGRGTEAFF	TRBV28	TRBJ1-1
TGTGCCAGCAGGGTACAGGGATGTGAGCAGTTCTTC	CASRVQGCEQFF	TRBV6-1	TRBJ2-1
TGTGCCAGCATCCATCACCCAGACTGGGACAGCAATCAGCCCCAGCATTTT	CASIHHPDWDSNQPQHF	TRBV6-5	TRBJ1-5
TGTGCCAGCAGCCCAGTGCGACATCCGAGGTCCTACGAGCAGTACTTC	CASSPVRHPRSYEQYF	TRBV7-3	TRBJ2-7
TGCGCCAGCAGTGAGGGACAGGGCACAGATACGCAGTATTTT	CASSEGQGTDTQYF	TRBV10-1	TRBJ2-3
TGTGCCATAGGACAGTACCCCTACGAGCAGTACTTC	CAIGQYPYEQYF	TRBV10-3	TRBJ2-7
TGTGCCAGCAGCTTAGCAAGACAGGGGCCAGAGGGTTACAATGAGCAGTTCTTC	CASSLARQGPEGYNEQFF	TRBV7-6	TRBJ2-1
TGCATTAACACTGAAGCTTTCTTT	CINTEAFF	TRBV20-1	TRBJ1-1
TGCGCCAGCAAGGAGAGAGGGTGCATAGAACCTGGAAACACCATATATTTT	CASKERGCIEPGNTIYF	TRBV4-1	TRBJ1-3
TGTGCCAGCAGTTGGCCAGGGCAGGGGAAACGGAATGAAAAACTGTTTTTT	CASSWPGQGKRNEKLFF	TRBV27	TRBJ1-4
TGTGCCAGCAGCTTAGAGGGGGGGGGAGACAATGAGCAGTTCTTC	CASSLEGGGDNEQFF	TRBV7-2	TRBJ2-1
TGCAGTGCTAGAGGTAGGGGAATGGGGGTGGAGCAGTACTTC	CSARGRGMGVEQYF	TRBV20-1	TRBJ2-7
TGTGCCAGCATCAGGGACGAAGAAGCTTTCTTT	CASIRDEEAFF	TRBV28	TRBJ1-1
TGTGCCACCAGTGAATCACTAGGACGGGGGACGTCACGGCAATACAATGAGCAGTTCTTC	CATSESLGRGTSRQYNEQFF	TRBV24-1	TRBJ2-1
TGTGCCAGCAGCTTAATCGTGTGGTCCAGGGGAGGTGGCTACACCTTC	CASSLIVWSRGGGYTF	TRBV7-3	TRBJ1-2
TGCGCCAGCAGCCAATTGGACAGTTCCCGGAATCATCTTGAAAAACTGTTTTTT	CASSQLDSSRNHLEKLFF	TRBV4-1	TRBJ1-4
TGTGCCAGCTCACCTCCCCGGGGGGAGGGTACCCCCTACGAGCAGTACTTC	CASSPPRGEGTPYEQYF	TRBV18	TRBJ2-7
TGCGCCAGCAGTGTTTATTACTTCAGAACTAATGAGCAGTTCTTC	CASSVYYFRTNEQFF	TRBV10-1	TRBJ2-1
TGTGCCAGCAGCTTACCGCCGGGCTTATCCACAAAGGATACGCAGTATTTT	CASSLPPGLSTKDTQYF	TRBV7-6	TRBJ2-3
TGCAGCTGGAAGTGCGTGGGACAGGGGAGGAGCTATGGCTACACCTTC	CSWKCVGQGRSYGYTF	TRBV29-1	TRBJ1-2
TGCGCCAGCAGCTTGGGGGGGGCTAGCACAGATACGCAGTATTTT	CASSLGGASTDTQYF	TRBV5-1	TRBJ2-3
TGTGCCATCAGTGAGTTGGCGGGAAACAATGAGCAGTTCTTC	CAISELAGNNEQFF	TRBV10-3	TRBJ2-1
TGCAGTGCTACTAGCGGGCAAGAGACCCAGTACTTC	CSATSGQETQYF	TRBV20-1	TRBJ2-5
TGTGCCAGCAGCGTAGGACTAGGGGGCAATGAGCAGTTCTTC	CASSVGLGGNEQFF	TRBV9	TRBJ2-1
TGTGCCAGCAGTTTAGGAGGACAGGGGGGGGATGGACCCTACGAGCAGTACTTC	CASSLGGQGGDGPYEQYF	TRBV27	TRBJ2-7
TGTGCCAGTATTCGGGGGGCGAACACCGGGGAGCTGTTTTTT	CASIRGANTGELFF	TRBV19	TRBJ2-2
TGTGCCAGCAGCCTCTTGAGGGAGGGGATGAATCAGCCCCAGCATTTT	CASSLLREGMNQPQHF	TRBV3-1	TRBJ1-5
TGTGCCAGTAACCAGATCGGGCAAGGGAACACCATATATTTT	CASNQIGQGNTIYF	TRBV19	TRBJ1-3
TGTGCCAGCAGCCCTTGTCCCGGACGGGCGCCCCAGCATTTT	CASSPCPGRAPQHF	TRBV7-3	TRBJ1-5
TGTGCCAGCAGCGTAGACGTAAGGGGCGAAATCACAGATACGCAGTATTTT	CASSVDVRGEITDTQYF	TRBV9	TRBJ2-3
TGCGCCAGCCGAGTATTAAGCTCTGGGGCCAACGTCCTGACTTTC	CASRVLSSGANVLTF	TRBV5-1	TRBJ2-6
TGTGCCAGCAGCCCGAGTCTGGGGACCTACGAGCAGTACTTC	CASSPSLGTYEQYF	TRBV14	TRBJ2-7
TGTGCCAGCAGCACACTTTTGACAAGGGCACCGTATGGCTACACCTTC	CASSTLLTRAPYGYTF	TRBV7-9	TRBJ1-2
TGCAGTGCGGGGGGACGCTCACCCCTCCACTTT	CSAGGRSPLHF	TRBV20-1	TRBJ1-6
TGCGCCAGCATCGGAGGGGGCACGGTCGAAGGGTATGGCTACACCTTC	CASIGGGTVEGYGYTF	TRBV10-2	TRBJ1-2
TGTGCCAGCAGTTTAATCCCCCCACGAGGACTAGCGGGTCAGCCCTACGAGCAGTACTTC	CASSLIPPRGLAGQPYEQYF	TRBV27	TRBJ2-7
TGTGCCAGTAGTATCAAGGAAACTTTGGCAGGCTACGAGCAGTACTTC	CASSIKETLAGYEQYF	TRBV19	TRBJ2-7
TGTGCCAGGGGGGACAGGGGAGAGAACACTGAAGCTTTCTTT	CARGDRGENTEAFF	TRBV19	TRBJ1-1
TGCGCCAGCAGCCAAGCCGGGCAAAGTGGAACAGATACGCAGTATTTT	CASSQAGQSGTDTQYF	TRBV4-3	TRBJ2-3
TGTGCCAGCAGCGGAGAGGGACAGTGGGGCTACACCTTC	CASSGEGQWGYTF	TRBV7-9	TRBJ1-2
TGCGCCAGCAGCCTCAGGGCCGGGCTCTACAATGAGCAGTTCTTC	CASSLRAGLYNEQFF	TRBV4-3	TRBJ2-1
TGTGCCAGCAGTGAATCACAACTAGCGGAACAAGAGACCCAGTACTTC	CASSESQLAEQETQYF	TRBV6-1	TRBJ2-5
TGCGCCAGCAGTGAGTTACGAATCACTCGCCGGGACAGGGGTAATGAAAAACTGTTTTTT	CASSELRITRRDRGNEKLFF	TRBV10-1	TRBJ1-4
TGTGCCAGCTCGGACAGGCTCTACGAGCAGTACTTC	CASSDRLYEQYF	TRBV2	TRBJ2-7
TGTGCTAGTGGTCGGACAGACAGGGAGACCCAGTACTTC	CASGRTDRETQYF	TRBV12-5	TRBJ2-5
TGTGCCACAGAATTGATGGGGGGGACATTCTTCTACGAGCAGTACTTC	CATELMGGTFFYEQYF	TRBV6-4	TRBJ2-7
TGTGCCAGCAGAGATACAGGTGAGTATGGCTACACCTTC	CASRDTGEYGYTF	TRBV6-3	TRBJ1-2
TGTGCCAGCAGTTACTACACAGAGACCCAGTACTTC	CASSYYTETQYF	TRBV6-5	TRBJ2-5
TGTGCCAGCAGCTCACGCGGGCTTTCTGGAAACACCATATATTTT	CASSSRGLSGNTIYF	TRBV7-9	TRBJ1-3
TGTGCTAGCAGCACCTCCGGGGAACCGGAGGCCAATGAGCAGTTCTTC	CASSTSGEPEANEQFF	TRBV7-7	TRBJ2-1
TGTGCCAGCAGCCAAGATGAGGGAACAGCGGGCAGAGGATTCACTGAAGCTTTCTTT	CASSQDEGTAGRGFTEAFF	TRBV14	TRBJ1-1
TGTGCCAGCAGTTACTCGCCGAGGGGGGGCTACGAGCAGTACTTC	CASSYSPRGGYEQYF	TRBV6-5	TRBJ2-7
TGTGCCAGCATAGGCGGACTAGCGTTCGGAAGCTACGAGCAGTACTTC	CASIGGLAFGSYEQYF	TRBV5-6	TRBJ2-7
TGTGCCAGCAGGAATATCTGCCGGAGCAGGGGCAATCAGCCCCAGCATTTT	CASRNICRSRGNQPQHF	TRBV7-4	TRBJ1-5
TGTGCCAGCAGTGGGGCCGACTGGGAGACCCAGTACTTC	CASSGADWETQYF	TRBV6-1	TRBJ2-5
TGTGCCAGCAGCTTAGCACCGGGACAGGAAGGGGTAGGCTATGGCTACACCTTC	CASSLAPGQEGVGYGYTF	TRBV7-6	TRBJ1-2
TGTGCCAGCAGCGTTCTGGTGGGACTAGCTTCCGATGAGCAGTTCTTC	CASSVLVGLASDEQFF	TRBV7-8	TRBJ2-1
TGTGCCAGCAGTTACCAAGGACTTGCTGGAAACACCATATATTTT	CASSYQGLAGNTIYF	TRBV6-3	TRBJ1-3
TGTGCCAGCATTCGGTATCGGCAGCTTAACTATGGCTACACCTTC	CASIRYRQLNYGYTF	TRBV6-1	TRBJ1-2
TGCGCCAGCAGTGAGCTCCCCGGGACTTTCTTCACTGGGGCCAACGTCCTGACTTTC	CASSELPGTFFTGANVLTF	TRBV10-1	TRBJ2-6
TGTGCCAGCAGTGGCGGGCAGGGGACAGGGACCCATGGCTACACCTTC	CASSGGQGTGTHGYTF	TRBV6-3	TRBJ1-2
TGTGCCAGCATTCAATTCTCTAATGAAAAACTGTTTTTT	CASIQFSNEKLFF	TRBV6-5	TRBJ1-4
TGTGCCAGCTCACAGGGGGTAGCCAGCTCCTATAATTCACCCCTCCACTTT	CASSQGVASSYNSPLHF	TRBV11-1	TRBJ1-6
TGTGCCAGCAGCTTAACCGTCGGGGGGGGAGAGACCCAGTACTTC	CASSLTVGGGETQYF	TRBV11-3	TRBJ2-5
TGTGCCAGCAGTGATCCGGGAACAAGGAACACCGGGGAGCTGTTTTTT	CASSDPGTRNTGELFF	TRBV6-1	TRBJ2-2
TGTGCCAGCAGCGGGGTCGTTCCAGGGGGCATAAGTATGAATCAGCCCCAGCATTTT	CASSGVVPGGISMNQPQHF	TRBV7-9	TRBJ1-5
TGTGCCATTCCTGATCAGCTGCCGCAGTACGAGCAGTACTTC	CAIPDQLPQYEQYF	TRBV6-1	TRBJ2-7
TGCGCCAGCAGTGGACGCGTGAGGGCCTTTGAACAGGGGTACAGGAACGAGCAGTACTTC	CASSGRVRAFEQGYRNEQYF	TRBV10-2	TRBJ2-7
TGCAGTGCTAGAGAGGACCTCCAGTACACCATATATTTT	CSAREDLQYTIYF	TRBV20-1	TRBJ1-3
TGCAGTGCTGCCAATAGCTACGAGCAGTACTTC	CSAANSYEQYF	TRBV20-1	TRBJ2-7
TGTGCCAGCAGTGACGCACAGGGCAGGGTGGCTAATGAGCAGTTCTTC	CASSDAQGRVANEQFF	TRBV6-4	TRBJ2-1
TGCGCCAGCAGCGGAACAAGAGGGGGGACGATGTGCTACGAGCAGTACTTC	CASSGTRGGTMCYEQYF	TRBV5-1	TRBJ2-7
TGTGCCAGCCCGGCAGTTAGGGGACGTGTCTACGAGCAGTACTTC	CASPAVRGRVYEQYF	TRBV6-3	TRBJ2-7
TGTGCTAGTGGTTTGGTTCGCTACGGGGAGGGAGACTTCACAGATACGCAGTATTTT	CASGLVRYGEGDFTDTQYF	TRBV12-5	TRBJ2-3
TGTGCCAGCAGGTCTGCAGGAACCTTC	CASRSAGTF	TRBV6-5	TRBJ1-2
TGTGCCAGCAAATACCCCTGGGGCGAATCTGGAAACACCATATATTTT	CASKYPWGESGNTIYF	TRBV25-1	TRBJ1-3
TGCGCCAGCAGCCAAGTGGTGACTAGGGGCACAGATACGCAGTATTTT	CASSQVVTRGTDTQYF	TRBV4-1	TRBJ2-3
TGTGCCTGGATCCCTAGGCTAAACCATGAGCAGTTCTTC	CAWIPRLNHEQFF	TRBV30	TRBJ2-1
TGTGCCAGCAGCGGTCCAAGACAGCGAAACGAGCAGTACTTC	CASSGPRQRNEQYF	TRBV12-3	TRBJ2-7
TGCGCCAGCAGCCAAGCTTTAACCCGGGAGGGCCCTAAGCGGTGCTCCTACGAGCAGTACTTC	CASSQALTREGPKRCSYEQYF	TRBV4-3	TRBJ2-7
TGTGCCAGCAGTTTGTCCATACAGTATGGCTATGGCTACACCTTC	CASSLSIQYGYGYTF	TRBV12-4	TRBJ1-2
TGTGCCAGCAGTAGATGGGGAGCCGAGCAGTACTTC	CASSRWGAEQYF	TRBV2	TRBJ2-7
TGTGCCAGCCCGTCTAGCGGGGCCAAAAACATTCAGTACTTC	CASPSSGAKNIQYF	TRBV6-5	TRBJ2-4
TGTGCCAGCAGCGTAGCTGGGGGGGTTACAGATACGCAGTATTTT	CASSVAGGVTDTQYF	TRBV9	TRBJ2-3
TGTGCCAGCAGTTACCTCAGGGAGAAGGGCACAGATACGCAGTATTTT	CASSYLREKGTDTQYF	TRBV6-2	TRBJ2-3
TGCGCCAGCAGCTTGGGAGCCCGGGACCCCCCAGCTTTCTTT	CASSLGARDPPAFF	TRBV5-1	TRBJ1-1
TGCGCCAGCAGCTTGCTGAGCGAGCAGTACTTC	CASSLLSEQYF	TRBV5-1	TRBJ2-7
TGTGCCAGCAGACCTCGGACGATTGGCTACACCTTC	CASRPRTIGYTF	TRBV28	TRBJ1-2
TGCGCCAGCAGAAGACAGGGGGCTGAGACCCAGTACTTC	CASRRQGAETQYF	TRBV5-1	TRBJ2-5
TGTGCCAGCAGTGTTGACAGGGGTCAGCCCCAGCATTTT	CASSVDRGQPQHF	TRBV6-4	TRBJ1-5
TGTGCCAGCAGTTATCGAGCGCAAGAGACCCAGTACTTC	CASSYRAQETQYF	TRBV27	TRBJ2-5
TGTGCCAGCAGCATTCTCTGGACAGGGTATCAGCCCCAGCATTTT	CASSILWTGYQPQHF	TRBV13	TRBJ1-5
TGTGCCAGCAGCTACTATGTAGCGGGTGACGAGACCCAGTACTTC	CASSYYVAGDETQYF	TRBV5-6	TRBJ2-5
TGCGCCAGCATAGACAGGGGAGGTCGCAATCAGCCCCAGCATTTT	CASIDRGGRNQPQHF	TRBV5-1	TRBJ1-5
TGTGCCACCCCTAAGCAAACCCCAGAGGACCACTATGGCTACACCTTC	CATPKQTPEDHYGYTF	TRBV15	TRBJ1-2
TGTGCCAGCAGACCCAGGGGCGAGCATACCGGGGAGCTGTTTTTT	CASRPRGEHTGELFF	TRBV6-2	TRBJ2-2
TGTGCCAGGAAATCACTAGCGGGCGTCGGGGCCCCCAATGAGCAGTTCTTC	CARKSLAGVGAPNEQFF	TRBV6-6	TRBJ2-1
TGCGCCAGCAGAGAGAAAGAGACCCAGTACTTC	CASREKETQYF	TRBV10-2	TRBJ2-5
TGTGCCAGCAGCCCAGATTTTTCTATAGCCTACGAGCAGTACTTC	CASSPDFSIAYEQYF	TRBV3-1	TRBJ2-7
TGTGCCAGCATAACGGGGGCGTATGGCTACACCTTC	CASITGAYGYTF	TRBV6-4	TRBJ1-2
TGTGCCAGCAGCCCTTCTGGGAGGTCCTACGAGCAGTACTTC	CASSPSGRSYEQYF	TRBV7-2	TRBJ2-7
TGTGCCAGTGAAAAGTCCCCAGCAATGGAGGGCCGGGCCTCTGAAGCTTTCTTT	CASEKSPAMEGRASEAFF	TRBV19	TRBJ1-1
TGTGCCAGCAGCTTAGCCCGTGAGGATACGCAGTATTTT	CASSLAREDTQYF	TRBV11-3	TRBJ2-3
TGTGCCAGCAGCTTAGCGGGACAGGATCAGCCCCAGCATTTT	CASSLAGQDQPQHF	TRBV7-9	TRBJ1-5
TGTGCCAGCTCACCAAGGGGGACAGGGGGCCCTGGCTACACCTTC	CASSPRGTGGPGYTF	TRBV18	TRBJ1-2
TGTGCCAGCTCACCCAAGGGGGAAGGGGCCGGTACGGGCAATCAGCCCCAGCATTTT	CASSPKGEGAGTGNQPQHF	TRBV18	TRBJ1-5
TGTGCCAGCAGCGGGAGCTCTGGAAACACCATATATTTT	CASSGSSGNTIYF	TRBV7-3	TRBJ1-3
TGTGCCATTGGCGGGCCTGGCTACACCTTC	CAIGGPGYTF	TRBV6-5	TRBJ1-2
TGCGCCAGCAGCTCCGGCACCCGGGACGGAAATGAGCAGTTCTTC	CASSSGTRDGNEQFF	TRBV5-1	TRBJ2-1
TGCGCCAGCGTATCTTCGGGGGGCACTACCACCGGGGAGCTGTTTTTT	CASVSSGGTTTGELFF	TRBV10-1	TRBJ2-2
TGCGCCAGCAGCCCCCACGGGGGGGGCGGACTCCAAGAGACCCAGTACTTC	CASSPHGGGGLQETQYF	TRBV5-1	TRBJ2-5
TGTGCCAGCAGCTGGACAGATCTAGAGACCCAGTACTTC	CASSWTDLETQYF	TRBV7-9	TRBJ2-5
TGCAGTGCTAGAGGGGTCTGGGGGGGCTACCCCTCTGGAAACACCATATATTTT	CSARGVWGGYPSGNTIYF	TRBV20-1	TRBJ1-3
TGTGCCAGCAGTGACCTGTTGACAGTGGACTTC	CASSDLLTVDF	TRBV6-1	TRBJ2-5
TGTGCCAGCAGCTTGGTTGTACGTGATAAAGGATACACTGAAGCTTTCTTT	CASSLVVRDKGYTEAFF	TRBV5-6	TRBJ1-1
TGTGCCAGCAGGCCCACAGGGGGCCTTTGGATTGAGCAGTTCTTC	CASRPTGGLWIEQFF	TRBV7-2	TRBJ2-1
TGTGCCAGCTGGGCTCCAAAGCACGAGCAGTACTTC	CASWAPKHEQYF	TRBV9	TRBJ2-7
TGTGCCAGCAAACCTATATCTTTGAACACTGAAGCTTTCTTT	CASKPISLNTEAFF	TRBV6-4	TRBJ1-1
TGTGCCAGCAGAGGACAGGGTTCCAACACTGAAGCTTTCTTT	CASRGQGSNTEAFF	TRBV6-3	TRBJ1-1
TGCAGTGCTAGATTCCTTTCGGGGGGGGGACACGAGCAGTACTTC	CSARFLSGGGHEQYF	TRBV20-1	TRBJ2-7
TGTGCCAGCAGAACGGACAGTTCACGGGGGAACACTGAAGCTTTCTTT	CASRTDSSRGNTEAFF	TRBV6-5	TRBJ1-1
TGTGCCAGCAGGCACTTTGGCACACCCGGCGAGCAGTACTTC	CASRHFGTPGEQYF	TRBV27	TRBJ2-7
TGTGCCAGCAGCTGGAACTCCCTCCACTTT	CASSWNSLHF	TRBV7-9	TRBJ1-6
TGTGCCAGCAGTGAACGCCCAACTAATGAAAAACTGTTTTTT	CASSERPTNEKLFF	TRBV25-1	TRBJ1-4
TGTGCCAGCAGTCCCGTAAAATTCTGGGACAGCACTAATGAAAAACTGTTTTTT	CASSPVKFWDSTNEKLFF	TRBV6-3	TRBJ1-4
TGTGCCAGCAAAGGGAGGAAGAACACTGAAGCTTTCTTT	CASKGRKNTEAFF	TRBV6-4	TRBJ1-1
TGCGCCAGCAGCGTGGGACAGGGAGGGGGAAGCTCTGGGGCCAACGTCCTGACTTTC	CASSVGQGGGSSGANVLTF	TRBV5-1	TRBJ2-6
TGTGCCAGCAGTGAGGCCAGATACCAAGAGACCCAGTACTTC	CASSEARYQETQYF	TRBV28	TRBJ2-5
TGTGCCAGCAGTCCAGTATACAATGAGCAGTTCTTC	CASSPVYNEQFF	TRBV3-1	TRBJ2-1
TGCGCCAGCAGCCACCTTGGACGGCCTACCTACGAGCAGTACTTC	CASSHLGRPTYEQYF	TRBV4-1	TRBJ2-7
TGTGCCAGCAGCTTCACCACGGCAGTTGCCGACAAAGGCTCCTACGAGCAGTACTTC	CASSFTTAVADKGSYEQYF	TRBV7-9	TRBJ2-7
TGTGCCAGCAGTGACCCAGGGAGGGGTCCCTACGAGCAGTACTTC	CASSDPGRGPYEQYF	TRBV6-1	TRBJ2-7
TGTGCCAGCCGATGGCAGGATCAGCCCCAGCATTTT	CASRWQDQPQHF	TRBV7-9	TRBJ1-5
TGTGCCACCAGTGATTTCCAAAACTCCTCGACTAACACTGAAGCTTTCTTT	CATSDFQNSSTNTEAFF	TRBV24-1	TRBJ1-1
TGTGCCACCAGTGAGCCCGGACAGGGAATGGCTTACACTGAAGCTTTCTTT	CATSEPGQGMAYTEAFF	TRBV24-1	TRBJ1-1
TGCGCCAGCAGCTACACTAGCGGGAGTTCGTCCAGCTCCTATAATTCACCCCTCCACTTT	CASSYTSGSSSSSYNSPLHF	TRBV5-1	TRBJ1-6
TGTGCCACCAGTGATTCGATCGAGGGGGATGAAAAACTGTTTTTT	CATSDSIEGDEKLFF	TRBV24-1	TRBJ1-4
TGTGCCAGCAGCTTAGCCAATTTCACCCAGGCTCCACCTGAAAAACTGTTTTTT	CASSLANFTQAPPEKLFF	TRBV11-3	TRBJ1-4
TGTGCCAGCAGCTTAGATTGGGTCGGGACAGGGGAGGGTGGAAACACCATATATTTT	CASSLDWVGTGEGGNTIYF	TRBV11-2	TRBJ1-3
TGTGCCAGCAAGAGCCTTCGACGCCTACGAGGGGACACTGAAGCTTTCTTT	CASKSLRRLRGDTEAFF	TRBV27	TRBJ1-1
TGTGCCACCAGCCCACGCCCGGGAAGAGGGCCCCATCAGCCCCAGCATTTT	CATSPRPGRGPHQPQHF	TRBV15	TRBJ1-5
TGTGCCAGCAGCCAAGATCTGCTAGCGGGTAAGGCCAAAAACATTCAGTACTTC	CASSQDLLAGKAKNIQYF	TRBV14	TRBJ2-4
TGTGCCAGCAGGCATCTAGCGGGGTTCCGCTACGAGCAGTACTTC	CASRHLAGFRYEQYF	TRBV7-9	TRBJ2-7
TGTGCCAGCAGCTGGCACCCTAAGGTACAGGGTACCTACGAGCAGTACTTC	CASSWHPKVQGTYEQYF	TRBV7-4	TRBJ2-7
TGTGCCAGCAGCATTCCGCACAGGGGGCAGGGATGCTATGGCTACACCTTC	CASSIPHRGQGCYGYTF	TRBV7-3	TRBJ1-2
TGTGCCAGCAGTTCTGGGGACAGGGGACACACCGGGGAGCTGTTTTTT	CASSSGDRGHTGELFF	TRBV6-3	TRBJ2-2
TGTGCCAGCAGTTTATCTCGGGGGCGAACCGTGTACGAGCAGTACTTC	CASSLSRGRTVYEQYF	TRBV12-3	TRBJ2-7
TGTGCCTACCAGGGGGAAAGTCGGAACACTGAAGCTTTCTTT	CAYQGESRNTEAFF	TRBV24-1	TRBJ1-1
TGCAGTGCTAGTCTGACTAGCGGGAAAAATGGGAGCTCCTACGAGCAGTACTTC	CSASLTSGKNGSSYEQYF	TRBV20-1	TRBJ2-7
TGTGCCAGCAGCTTAAACCCCCCGGGACTAGCGGAGGAACCAGATACGCAGTATTTT	CASSLNPPGLAEEPDTQYF	TRBV7-3	TRBJ2-3
TGCGCCAGCAGCGAAAGGGGTATGGTTTACGAGCAGTACTTC	CASSERGMVYEQYF	TRBV5-1	TRBJ2-7
TGCAGTGCGTATGGGGAGCACACTGAAGCTTTCTTT	CSAYGEHTEAFF	TRBV20-1	TRBJ1-1
TGTGCCATATCAGCAGGGGAGCACTTGACTAGAACAGATACGCAGTATTTT	CAISAGEHLTRTDTQYF	TRBV10-3	TRBJ2-3
TGTGCCAGCAGCTTCACCTACGAGCAGTACTTC	CASSFTYEQYF	TRBV11-3	TRBJ2-7
TGTGCCAGCAGCGCGCCAGGGGGCACAGATACGCAGTATTTT	CASSAPGGTDTQYF	TRBV6-5	TRBJ2-3
TGTGCCAGCAGCTGGCCGGGACAGGGAAGGGCCGGGGAGCTGTTTTTT	CASSWPGQGRAGELFF	TRBV7-9	TRBJ2-2
TGTGCCAGCACGCGCGGTTTTAGGAACACTGAAGCTTTCTTT	CASTRGFRNTEAFF	TRBV7-8	TRBJ1-1
TGCGCCAGCAGCCAAGATGGGCTCCGGACAGCCGGCTACACCTTC	CASSQDGLRTAGYTF	TRBV4-1	TRBJ1-2
TGTGCCAGCAGGAACCCCTCTAGCGGGGGCTACGAGCAGTACTTC	CASRNPSSGGYEQYF	TRBV2	TRBJ2-7
TGTGCCAGCAGTTACAACTTTCCGGGACTGAACACCGGGGAGCTGTTTTTT	CASSYNFPGLNTGELFF	TRBV6-5	TRBJ2-2
TGTGCCAGCAGGCTCCATCTAATAGAGACCCAGTACTTC	CASRLHLIETQYF	TRBV2	TRBJ2-5
TGTGCCAGCAAAACCGGGGGGGGGAGCTACGAGCAGTACTTC	CASKTGGGSYEQYF	TRBV7-9	TRBJ2-7
TGTGCCAGTAAAAATCTGGGGGGACCTCGACCCAATGAAAAACTGTTTTTT	CASKNLGGPRPNEKLFF	TRBV19	TRBJ1-4
TGTGCCAGCAGTGAATACATCACCAGGGGGCAGCCCCAGCATTTT	CASSEYITRGQPQHF	TRBV25-1	TRBJ1-5
TGTGCCAGCAGTGTGCGCGGGTTGCAAAAGTACGAGCAGTACTTC	CASSVRGLQKYEQYF	TRBV2	TRBJ2-7
TGTGCTAGTGGTCTTCAGGGGTTGCGGTCCAAAAACATTCAGTACTTC	CASGLQGLRSKNIQYF	TRBV12-5	TRBJ2-4
TGTGCCAGCAGCTTACCTTCGACGGACGAGCAGTACTTC	CASSLPSTDEQYF	TRBV11-2	TRBJ2-7
TGTGCTAGTGGTTTGGCAGGGGGCGGGACTAGGGGGAAGTTTCAGGGGTACGAGCAGTACTTC	CASGLAGGGTRGKFQGYEQYF	TRBV12-5	TRBJ2-7
TGCGCCAGCAGCCAAGCCGAGGACAGGGATGAAAAACTGTTTTTT	CASSQAEDRDEKLFF	TRBV5-1	TRBJ1-4
TGTGCCAGCCAAACTGTACAAGAGACCCAGTACTTC	CASQTVQETQYF	TRBV11-3	TRBJ2-5
TGTGCCAGCAGTTGGCCTGGTGAGTCACCCCTCCACTTT	CASSWPGESPLHF	TRBV7-3	TRBJ1-6
TGTGCCAGCAGCAATTGGTATAGCAATCAGCCCCAGCATTTT	CASSNWYSNQPQHF	TRBV7-3	TRBJ1-5
TGTGCCACCAGTGATTTGGGACTACATGAGCAGTTCTTC	CATSDLGLHEQFF	TRBV24-1	TRBJ2-1
TGTGCCAGCAGCGAGACCCAAGGGACAGGGGACGAGCAGTACTTC	CASSETQGTGDEQYF	TRBV9	TRBJ2-7
TGTGCCATCGAGGGCTGGGGCGCAGGGGGGGCTGTTGGGTGCCAAGAGACCCAGTACTTC	CAIEGWGAGGAVGCQETQYF	TRBV10-3	TRBJ2-5
TGTGCCAGACCCGACAGGTGCCCGGGCAATCAGCCCCAGCATTTT	CARPDRCPGNQPQHF	TRBV3-1	TRBJ1-5
TGTGCCAGCAGCTCCCCAGGGGTGTTCTACACTGAAGCTTTCTTT	CASSSPGVFYTEAFF	TRBV7-6	TRBJ1-1
TGTGCCAGCAGCTTACCCAGAGGGGCTTATAGGGGGGACGATCCGGCAACTAATGAAAAACTGTTTTTT	CASSLPRGAYRGDDPATNEKLFF	TRBV7-2	TRBJ1-4
TGTGCCAGCAACCCCAGGGGCAGGAAGCAAGAGACCCAGTACTTC	CASNPRGRKQETQYF	TRBV7-2	TRBJ2-5
TGTGCCAGCAGCGGTACGACAGGGGGCTCGAACGAGCAGTACTTC	CASSGTTGGSNEQYF	TRBV16	TRBJ2-7
TGTGCCAGCAGTGAATGTGGGGGGCCGGACTACGAGCAGTACTTC	CASSECGGPDYEQYF	TRBV25-1	TRBJ2-7
TGTGCCAGCAGTGATACTGACAGCCTCACAGATACGCAGTATTTT	CASSDTDSLTDTQYF	TRBV6-1	TRBJ2-3
TGTGCTAGTGGTTTGGTAGTCCTCCACAGGGGGAACTATGGCTACACCTTC	CASGLVVLHRGNYGYTF	TRBV12-5	TRBJ1-2
TGCAGTGCTAGAGTTAGGGGACCATCTTATGGCTACACCTTC	CSARVRGPSYGYTF	TRBV20-1	TRBJ1-2
TGTGCCCCGTTTCCGGGACTAGCGGGAAGCGGTTCACAAGAGACCCAGTACTTC	CAPFPGLAGSGSQETQYF	TRBV27	TRBJ2-5
TGTGCCAGCAGGAGGGAGTCCGAGGTCTTAGTAACTGAAGCTTTCTTT	CASRRESEVLVTEAFF	TRBV6-4	TRBJ1-1
TGTGCCTGGAGTGTACGACCCGGGACAGGGCGATGGTCAGACCAAGAGACCCAGTACTTC	CAWSVRPGTGRWSDQETQYF	TRBV30	TRBJ2-5
TGCAGTGCTAGAGAGCCAGATCCAGAGCAGTACTTC	CSAREPDPEQYF	TRBV20-1	TRBJ2-7
TGTGCCAGCAGCTTCGTCAGGGGGGGGACAACTAATGAAAAACTGTTTTTT	CASSFVRGGTTNEKLFF	TRBV7-4	TRBJ1-4
TGCAGTGCTAGTCTCCGACCTCATAGCAATCAGCCCCAGCATTTT	CSASLRPHSNQPQHF	TRBV20-1	TRBJ1-5
TGTGCCAGCAGCCGAATGGCCGGACTCGAGCAGTACTTC	CASSRMAGLEQYF	TRBV3-1	TRBJ2-7
TGTGCCAGCAGCCGAAGGGCACAAGGACAGTTTCAAAACTATGGCTACACCTTC	CASSRRAQGQFQNYGYTF	TRBV9	TRBJ1-2
TGTGCCATAGGGGGTAATGGGGACGAGCAGTACTTC	CAIGGNGDEQYF	TRBV11-2	TRBJ2-7
TGTGCCAGGGGGGGGGGCCATCTCTACGAGCAGTACTTC	CARGGGHLYEQYF	TRBV7-3	TRBJ2-7
TGTGCCAGCAGCCCGGGCCCAACCTACGAGCAGTACTTC	CASSPGPTYEQYF	TRBV6-1	TRBJ2-7
TGTGCCTGGAGTGTACTCCACCGACTAGCGGTCGGCCGCACAGATACGCAGTATTTT	CAWSVLHRLAVGRTDTQYF	TRBV30	TRBJ2-3
TGTGCCAGCAATGGAGGGGGCCTGCCTAACTATGGCTACACCTTC	CASNGGGLPNYGYTF	TRBV6-5	TRBJ1-2
TGCGCCAGCAGCCGCCCAGGACAGAGAACGAACACTGAAGCTTTCTTT	CASSRPGQRTNTEAFF	TRBV5-1	TRBJ1-1
TGCGCCAGCAGGTTTCTGGATAATGAAAAACTGTTTTTT	CASRFLDNEKLFF	TRBV10-2	TRBJ1-4
TGTGCCAGCAGCTTGGAAACAGTCCCGGAGCAGTACTTC	CASSLETVPEQYF	TRBV5-6	TRBJ2-7
TGTGCCAGCAGTTACGTGAAGCGGGATCAGAACATGAACACTGAAGCTTTCTTT	CASSYVKRDQNMNTEAFF	TRBV6-5	TRBJ1-1
TGTGCCAGCACCCCCACTACAACCTCCTCGGGAGGACAGGAACGCTACGAGCAGTACTTC	CASTPTTTSSGGQERYEQYF	TRBV6-8	TRBJ2-7
TGTGCCAGCACTAGCGCCGACTACGAGCAGTACTTC	CASTSADYEQYF	TRBV27	TRBJ2-7
TGTGCCAGCAGCACACCACAAGCGGAACGGACCGGGGAGCTGTTTTTT	CASSTPQAERTGELFF	TRBV7-4	TRBJ2-2
TGTGCCAGCAGGATCTATACACTAGCCAAAAACATTCAGTACTTC	CASRIYTLAKNIQYF	TRBV12-3	TRBJ2-4
TGTGCAGGGGGGGACAGGTTATACGAGCAGTACTTC	CAGGDRLYEQYF	TRBV11-3	TRBJ2-7
TGTGCCAGCCGACTGACAGGGGAGCTACCTCCTGGAAACACCATATATTTT	CASRLTGELPPGNTIYF	TRBV7-9	TRBJ1-3
TGTGCCAGCAGGATCGGATTGTACAATGAGCAGTTCTTC	CASRIGLYNEQFF	TRBV12-3	TRBJ2-1
TGTGCCAGCAGTTACTCGAACCGAGGGGTCAACATTCAGTACTTC	CASSYSNRGVNIQYF	TRBV6-5	TRBJ2-4
TGTGCCAGCAGTTTTGAAGGACAGTGGGACTACTATCAGCCCCAGCATTTT	CASSFEGQWDYYQPQHF	TRBV27	TRBJ1-5
TGTGCCTGGACTTCCCCAGGGCCTAAAAGCGAGCAGTACTTC	CAWTSPGPKSEQYF	TRBV30	TRBJ2-7
TGTGCCAGCAGCGCCTCGGGGGATCGGACGTCACCCCTCCACTTT	CASSASGDRTSPLHF	TRBV7-3	TRBJ1-6
TGTGCCAGCAGCGCTTTGGGGGGGGGGCGCAATGAGCAGTTCTTC	CASSALGGGRNEQFF	TRBV11-3	TRBJ2-1
TGTGCCAGCAGCGGCACAGGGGCTGGTAAGAACACTGAAGCTTTCTTT	CASSGTGAGKNTEAFF	TRBV7-9	TRBJ1-1
TGCAGTGCTAGAGCCCCCGGGACTAGCGGGAGCTACAATCAGCCCCAGCATTTT	CSARAPGTSGSYNQPQHF	TRBV20-1	TRBJ1-5
TGTGCCAGCTCACATGGGGAAGGTGAGCAGTTCTTC	CASSHGEGEQFF	TRBV18	TRBJ2-1
TGTGCCACCAGTGGGGGGGAAAAGGGGTACTGCTCCTACGAGCAGTACTTC	CATSGGEKGYCSYEQYF	TRBV24-1	TRBJ2-7
TGTGCCAGCAGCTTAGATACTGGTCAGCCCCAGCATTTT	CASSLDTGQPQHF	TRBV7-2	TRBJ1-5
TGTGCCAGCAGCTTAGGGGGCCTCGACAGGGAAGGCTACACCTTC	CASSLGGLDREGYTF	TRBV7-8	TRBJ1-2
TGCAGTGCTAGAGATCTCGCGGGGCACAATGGCTACACCTTC	CSARDLAGHNGYTF	TRBV20-1	TRBJ1-2
TGTGCCAGCAGCAAACGGGTCTTGGGGGCGCAGGTCCAAGAGACCCAGTACTTC	CASSKRVLGAQVQETQYF	TRBV13	TRBJ2-5
TGTGCCAGCAGCCCCGGGACCTGGCCCCAGCATTTT	CASSPGTWPQHF	TRBV7-3	TRBJ1-5
TGCGCCAGCAGTGAGTCGGCGGTCCCCAATGAGCAGTTCTTC	CASSESAVPNEQFF	TRBV10-1	TRBJ2-1
TGTGCCAGCAAGAGAAGACAGAGATTCAATCAGCCCCAGCATTTT	CASKRRQRFNQPQHF	TRBV28	TRBJ1-5
TGCGCCAGCAGCCTAGCGGCCCGGGAGACCCAGTACTTC	CASSLAARETQYF	TRBV5-1	TRBJ2-5
TGTGCCAGCAGCTTAGGGGATCAGCCCCAGCATTTT	CASSLGDQPQHF	TRBV7-9	TRBJ1-5
TGTGCCATACGGCCTCTAGCGGGACTGTGCGGCGAGACCCAGTACTTC	CAIRPLAGLCGETQYF	TRBV10-3	TRBJ2-5
TGTGCCAGCAGCTTAGATTGGAGAGGGTATGCAACTAATGAAAAACTGTTTTTT	CASSLDWRGYATNEKLFF	TRBV13	TRBJ1-4
TGTGCCAGCAGTTACGACAATTATGGCTACACCTTC	CASSYDNYGYTF	TRBV6-3	TRBJ1-2
TGCAGTGCACCCACCATTACCTTTCAAGAGTACTTC	CSAPTITFQEYF	TRBV20-1	TRBJ2-4
TGTGCCACCGGGACAAACAATCAGCCCCAGCATTTT	CATGTNNQPQHF	TRBV6-2	TRBJ1-5
TGTGCCAGCAGCAATTGTCGGTACCCAACAGATACGCAGTATTTT	CASSNCRYPTDTQYF	TRBV7-4	TRBJ2-3
TGTGCCAGCAGTTTAAAGTTCCTCGGACCGGGACATGAAGCTTTCTTT	CASSLKFLGPGHEAFF	TRBV28	TRBJ1-1
TGTGCCAGCAGCTTCCAAGGGGTACGGGAAAAACTGTTTTTT	CASSFQGVREKLFF	TRBV5-4	TRBJ1-4
TGTGCCAGCAGCGTAAGGGACCTTAATGAAAAACTGTTTTTT	CASSVRDLNEKLFF	TRBV7-2	TRBJ1-4
TGTGCCAGCAGAGGGCCTGGTCGTGACAGGAGGGATGAGCAGTTCTTC	CASRGPGRDRRDEQFF	TRBV9	TRBJ2-1
TGTGCCAGCAGCAAGGGACTAGCGGGGAGCCAAGAGACCCAGTACTTC	CASSKGLAGSQETQYF	TRBV9	TRBJ2-5
TGTGCCAGCGGGGGACAGATGTGGGAGCTGGCCTATAATTCACCCCTCCACTTT	CASGGQMWELAYNSPLHF	TRBV11-3	TRBJ1-6
TGTGCCAGCAGCCCAGGACAGGGGGGGGACGAGCAGTACTTC	CASSPGQGGDEQYF	TRBV7-3	TRBJ2-7
TGCGCCAGCAGCATTCTAGCGCGGCTCCAGCAGTTCTTC	CASSILARLQQFF	TRBV5-1	TRBJ2-1
TGTGCCAGCAGCTTTTGTACGGGGGACCGGCCCAACTCCTACGAGCAGTACTTC	CASSFCTGDRPNSYEQYF	TRBV7-8	TRBJ2-7
TGCGCCAGCAAGGCAAACCCGACTAGCACTAGCTCCTACAATGAGCAGTTCTTC	CASKANPTSTSSYNEQFF	TRBV10-1	TRBJ2-1
TGTGCCAGCAGCCAAGATGAGACTCGGGGAAAAGATACGCAGTATTTT	CASSQDETRGKDTQYF	TRBV3-1	TRBJ2-3
TGTGCCACCAGTGATAGCCAGGGACTAGCGGGTTCAGATACGCAGTATTTT	CATSDSQGLAGSDTQYF	TRBV24-1	TRBJ2-3
TGTGCCAGCAGCCTGGGGGCCCTATATAGCAATCAGCCCCAGCATTTT	CASSLGALYSNQPQHF	TRBV3-1	TRBJ1-5
TGTGCCAGCAGTTGGAGGACCCGCGGGCCCACCGAGTACTTC	CASSWRTRGPTEYF	TRBV6-2	TRBJ2-7
TGTGCCAGCAGCAGCTTGGCAGGGCCTGACACCATATATTTT	CASSSLAGPDTIYF	TRBV11-3	TRBJ1-3
TGTGCCTTGCTAGGGGAGGACTACGAGCAGTACTTC	CALLGEDYEQYF	TRBV15	TRBJ2-7
TGTGCCAAGGGACAGGGAACCCACAATGAGCAGTTCTTC	CAKGQGTHNEQFF	TRBV6-4	TRBJ2-1
TGCGCCAGCAGTGACCGCGCTTTTGTCACAGATACGCAGTATTTT	CASSDRAFVTDTQYF	TRBV10-1	TRBJ2-3
TGTGCCAGCAGCAACAGGGAGAAGTCCTACGAGCAGTACTTC	CASSNREKSYEQYF	TRBV3-1	TRBJ2-7
TGCAGTGCTAGTGCGGGTCTCCTGGGCAGGGCAAACTACGAGCAGTACTTC	CSASAGLLGRANYEQYF	TRBV20-1	TRBJ2-7
TGTGCCAGCAGCGTAGTGACAGGGAAACGCAGTCAGCCCCAGCATTTT	CASSVVTGKRSQPQHF	TRBV9	TRBJ1-5
TGTGCCAGCTCCTGGGACAGGGGGCGGGAGGGCTACAATGAGCAGTTCTTC	CASSWDRGREGYNEQFF	TRBV2	TRBJ2-1
TGCAGCGTCCGGGGCTTCAAAAACATTCAGTACTTC	CSVRGFKNIQYF	TRBV29-1	TRBJ2-4
TGTGCCAGCAGCTTAGGAACAGGGGGCGGGGTCTGGAGCGGCACAGATACGCAGTATTTT	CASSLGTGGGVWSGTDTQYF	TRBV7-2	TRBJ2-3
