TGTGCCATTAAGGACTATTGCAATCAGCCCCAGCATTTT	CAIKDYCNQPQHF	TRBV6-2	TRBJ1-5
TGCGCCAGCAGCCAAGACTCCCGGGACTCCTTCAAAAGGGGAAAGTTCAAAGATACGCAGTATTTT	CASSQDSRDSFKRGKFKDTQYF	TRBV4-1	TRBJ2-3
TGTGCCAGCAGCTTAGCCAACCGGGGGGGAAACAGGGAAAAACTGTTTTTT	CASSLANRGGNREKLFF	TRBV11-2	TRBJ1-4
TGTGCCAGCAGCTGTAGGACAGTTGTGGTATATTGTGCCGAGTATGGCTACACCTTC	CASSCRTVVVYCAEYGYTF	TRBV6-8	TRBJ1-2
TGTGCCAGCAGCTTAATAACTAGCGGGAGGGCTAAGGGCACAGATACGCAGTATTTT	CASSLITSGRAKGTDTQYF	TRBV7-9	TRBJ2-3
TGCGCCAGCAACGGAGGAGGGGGCAGTTGCACAGATACGCAGTATTTT	CASNGGGGSCTDTQYF	TRBV10-1	TRBJ2-3
TGTGCCAGCAGACGTGGTCTGACAGGGGGTCGCAATCAGCCCCAGCATTTT	CASRRGLTGGRNQPQHF	TRBV7-4	TRBJ1-5
TGTGCCAGCAGCGCCCCAAGAGGCAGGGGCGGTTATAGCAATCAGCCCCAGCATTTT	CASSAPRGRGGYSNQPQHF	TRBV7-3	TRBJ1-5
TGTGCCAGCAGCCAAGAAAGCCCGATGACCCAGTACTTC	CASSQESPMTQYF	TRBV3-1	TRBJ2-5
TGTGCCAGCAGTGTCAGACCCGGGACTAGCGCCAAAGCCTACGAGCAGTACTTC	CASSVRPGTSAKAYEQYF	TRBV27	TRBJ2-7
TGCGCCAGCGGTGACGACATCAACGGAGAGACCCAGTACTTC	CASGDDINGETQYF	TRBV10-1	TRBJ2-5
TGTGCTAGTGGTTTAAAACAGGGGCCAAGGAACGAGCAGTACTTC	CASGLKQGPRNEQYF	TRBV12-5	TRBJ2-7
TGTGCCAGCACATTTCTAGCGGGTGGGTACGAGCAGTACTTC	CASTFLAGGYEQYF	TRBV2	TRBJ2-7
TGTGCCAGCAGTAGGGGCCCGTACGAGCAGTACTTC	CASSRGPYEQYF	TRBV6-1	TRBJ2-7
TGTGCCAGCAGTGTTGCCGTCCTAGCGGGAGACTGCGAGCAGTACTTC	CASSVAVLAGDCEQYF	TRBV6-1	TRBJ2-7
TGCAGTGCTAGGGGCGACGGCTCCTACAATGAGCAGTTCTTC	CSARGDGSYNEQFF	TRBV20-1	TRBJ2-1
TGCAGTGCTAGAGAACCGGCCCTCGGGGGGGACGAGCAGTACTTC	CSAREPALGGDEQYF	TRBV20-1	TRBJ2-7
TGCGCCAGCAGTCGGGGCGGGAGCTCCTACGAGCAGTACTTC	CASSRGGSSYEQYF	TRBV10-1	TRBJ2-7
TGTGCCAGCACCATACAGGGGGTCGAGACCCAGTACTTC	CASTIQGVETQYF	TRBV12-3	TRBJ2-5
TGTGCTAGTGGTTTGGTACGGACGGGTTATGAGCAGTTCTTC	CASGLVRTGYEQFF	TRBV12-5	TRBJ2-1
TGTGCCAGCAGCGTCCTGCTCAAAGACAATGAGCAGTTCTTC	CASSVLLKDNEQFF	TRBV7-4	TRBJ2-1
TGTGCCAGCAGGGGACAGGGTATGAGCTATGGCTACACCTTC	CASRGQGMSYGYTF	TRBV6-1	TRBJ1-2
TGTGCCAGCAGTTACTCGATCCAGGGGACAGGCTATAATTCACCCCTCCACTTT	CASSYSIQGTGYNSPLHF	TRBV6-6	TRBJ1-6
TGTGCCAGCAGAGGCGGGACTAGCGTCCGGGGCGGGGAGCTGTTTTTT	CASRGGTSVRGGELFF	TRBV6-4	TRBJ2-2
TGCGCCAGCTCGGCCTCACTCGGAGAGGACACCGGGGAGCTGTTTTTT	CASSASLGEDTGELFF	TRBV4-1	TRBJ2-2
TGTGCCAGCAGTGGGCATTGGGACACTGAAGCTTTCTTT	CASSGHWDTEAFF	TRBV27	TRBJ1-1
TGTGCCAGCAGCTTCAGGAGGGGAGTGAACTACGAGCAGTACTTC	CASSFRRGVNYEQYF	TRBV7-8	TRBJ2-7
TGTGCCAGCAGTTACTCGCCCCTAAGCGGTCGCTACGAGCAGTACTTC	CASSYSPLSGRYEQYF	TRBV6-6	TRBJ2-7
TGCAGCGGGCCGGGAACATGCTACGAGCAGTACTTC	CSGPGTCYEQYF	TRBV29-1	TRBJ2-7
TGTGCCAGCAGTTATTGCCCCCGGGACTGGGGGGAAGCCTATGGCTACACCTTC	CASSYCPRDWGEAYGYTF	TRBV6-2	TRBJ1-2
TGCGCCAGCAGCTTCCTCCGCCCGGACAGCACTAAATACGAGCAGTACTTC	CASSFLRPDSTKYEQYF	TRBV5-1	TRBJ2-7
TGTGCCAGCGGGGCGTGGGCGAACGATACGCAGTATTTT	CASGAWANDTQYF	TRBV6-4	TRBJ2-3
TGTGCCATCAGTGCAGGGGGGCCTCAAGCCAAAAACATTCAGTACTTC	CAISAGGPQAKNIQYF	TRBV10-3	TRBJ2-4
TGTGCCAGCAGCCTAGCGGGAGGCCGGCGGGACACCGGGGAGCTGTTTTTT	CASSLAGGRRDTGELFF	TRBV5-5	TRBJ2-2
TGCGCCAGCAGCTTTAGCGGGGTCACAGATACGCAGTATTTT	CASSFSGVTDTQYF	TRBV5-1	TRBJ2-3
TGCGCCAGCAGCCCGGAAACCGCTGGGTTTTACGAGCAGTACTTC	CASSPETAGFYEQYF	TRBV4-1	TRBJ2-7
TGTGCTAGCAGCTTTGCCCCCCCAGGAGTTCTCTTTAGCAATCAGCCCCAGCATTTT	CASSFAPPGVLFSNQPQHF	TRBV7-7	TRBJ1-5
TGTGCTAGTGGTCACACAGGGGGAAGATTTCAGCCCCAGCATTTT	CASGHTGGRFQPQHF	TRBV12-5	TRBJ1-5
TGTGCCAGCAGCCCCGCGGGAGGGACGAACACCGGGGAGCTGTTTTTT	CASSPAGGTNTGELFF	TRBV6-1	TRBJ2-2
TGTGCCAGCAGTTACCGGGACAGGGGAACTGAAAAACTGTTTTTT	CASSYRDRGTEKLFF	TRBV27	TRBJ1-4
TGTGCCACCAGCAGAGATCCCAGGGGGGCCGCAACTAATGAAAAACTGTTTTTT	CATSRDPRGAATNEKLFF	TRBV15	TRBJ1-4
TGTGCCAGCAGCTACCCCTCCTTCCCGAGGTCCACCTATGGCTACACCTTC	CASSYPSFPRSTYGYTF	TRBV5-5	TRBJ1-2
TGTGCCAGTAGTATTCCCCCCCGCGGGAGGGGCTACGAGCAGTACTTC	CASSIPPRGRGYEQYF	TRBV19	TRBJ2-7
TGTGCCAGCAGTGTCCAGGGGGGTTCGTCCTACGAGCAGTACTTC	CASSVQGGSSYEQYF	TRBV6-1	TRBJ2-7
TGTGCCAGCAGTAACAGGGGGCGGCAGGTTGGCTCCTACGAGCAGTACTTC	CASSNRGRQVGSYEQYF	TRBV6-8	TRBJ2-7
TGTGCCAGCAGTTCCTATAGGACTAGCGGTTTTGGCTACGAGCAGTACTTC	CASSSYRTSGFGYEQYF	TRBV6-1	TRBJ2-7
TGTAACATAGGGGTTCAAGAGACCCAGTACTTC	CNIGVQETQYF	TRBV7-9	TRBJ2-5
TGTGCCAGCAGCCAAGACCTCAGGCGCAATCAGCCCCAGCATTTT	CASSQDLRRNQPQHF	TRBV14	TRBJ1-5
TGTGCCAGCTCACCTTTTCAGGGTTATAGCAATCAGCCCCAGCATTTT	CASSPFQGYSNQPQHF	TRBV18	TRBJ1-5
TGTGCCAGCAGCCTGAGCGTCACCGGGGAGCTGTTTTTT	CASSLSVTGELFF	TRBV7-3	TRBJ2-2
TGTGCCAGAAGAGGGACTAGCGGGGGGTCGGTGCGCACCTCCAGCTCCTACAATGAGCAGTTCTTC	CARRGTSGGSVRTSSSYNEQFF	TRBV10-3	TRBJ2-1
TGTGCCATAGTGCTTAGCTACGAGCAGTACTTC	CAIVLSYEQYF	TRBV12-4	TRBJ2-7
TGTGCCAGTAGTCCGAAGACAGCCTACAATGAGCAGTTCTTC	CASSPKTAYNEQFF	TRBV19	TRBJ2-1
TGTGCCAGCAGCTTGTCCGGGACGGTCTCCTACGAGCAGTACTTC	CASSLSGTVSYEQYF	TRBV11-3	TRBJ2-7
TGTGCCACCAGTGATCCACCAGGGGGTAATGAAAAACTGTTTTTT	CATSDPPGGNEKLFF	TRBV24-1	TRBJ1-4
TGTGCCAGCAGCCAAGACCCCAGGGCGCCTGAATCGATCCCTGAAGCTTTCTTT	CASSQDPRAPESIPEAFF	TRBV3-1	TRBJ1-1
TGTGCCAGCAGCTTAAGTCGGTTTTGGACTAACTTAACGAACACCGGGGAGCTGTTTTTT	CASSLSRFWTNLTNTGELFF	TRBV6-4	TRBJ2-2
TGTGCCAGCAGCCGAGTATTGGGTCCAGGGCTTCTCACAGATACGCAGTATTTT	CASSRVLGPGLLTDTQYF	TRBV7-2	TRBJ2-3
TGTGCCAGCAGTTTACTTGGTTTGGATACAATGAGCTCCTACGAGCAGTACTTC	CASSLLGLDTMSSYEQYF	TRBV27	TRBJ2-7
TGCAGACCGGGACAGGGCTATAGCAATCAGCCCCAGCATTTT	CRPGQGYSNQPQHF	TRBV20-1	TRBJ1-5
TGTGCCAGCAGCCAAGGTAGAGAGCGGGAGACTCTTCAGTACTTC	CASSQGRERETLQYF	TRBV3-1	TRBJ2-7
TGCGCCAGCAGCTTGGCGGCAGGGGCCCTCAACTATGGCTACACCTTC	CASSLAAGALNYGYTF	TRBV5-1	TRBJ1-2
TGTGCCAGCAGCTGGAACCAGGGGCTTGGCTACACCTTC	CASSWNQGLGYTF	TRBV9	TRBJ1-2
TGCGCCAGCAGCCAAGATGGGGTTGCAGATGGCTACACCTTC	CASSQDGVADGYTF	TRBV4-3	TRBJ1-2
TGTGCCAGCAGTGATAGGGAAGAGACCCAGTACTTC	CASSDREETQYF	TRBV6-1	TRBJ2-5
TGCGCCAGCAATAGTCTTCTTCAGCCCCAGCATTTT	CASNSLLQPQHF	TRBV10-1	TRBJ1-5
TGTGCCAGCAGCTCTTTGGCAGGCTCCTACGAGCAGTACTTC	CASSSLAGSYEQYF	TRBV5-4	TRBJ2-7
TGTGCCCGAGGGGGAAACACCATATATTTT	CARGGNTIYF	TRBV27	TRBJ1-3
TGTGCCAGCAGCCAAGGGAAGAGACGTAAAGACGAGCAGTACTTC	CASSQGKRRKDEQYF	TRBV3-1	TRBJ2-7
TGTGCCAGCAGCAAGATACGGGGGGGGTACTCCTACGAGCAGTACTTC	CASSKIRGGYSYEQYF	TRBV13	TRBJ2-7
TGCAAGTTTCAGGGGTCTGAAAAACTGTTTTTT	CKFQGSEKLFF	TRBV20-1	TRBJ1-4
TGTGCCAGCAGCCTGGGGACTGAAGCTTTCTTT	CASSLGTEAFF	TRBV5-5	TRBJ1-1
TGTGCCAGCAGAAAAGGGGGCTCTGGAAACACCATATATTTT	CASRKGGSGNTIYF	TRBV12-3	TRBJ1-3
TGTGCCAGCAGGCCTCTCGGGACTCGCTACGAGCAGTACTTC	CASRPLGTRYEQYF	TRBV27	TRBJ2-7
TGTGCCATCACTGGGACCAGGGTGAGCTCCTACAATGAGCAGTTCTTC	CAITGTRVSSYNEQFF	TRBV10-3	TRBJ2-1
TGTGCCAGCAGTTTAGTCGCCGGAGGGTCCTATAATTCACCCCTCCACTTT	CASSLVAGGSYNSPLHF	TRBV12-4	TRBJ1-6
TGTGCCAGCAGCGAGATTCATACAGCGAACACTGAAGCTTTCTTT	CASSEIHTANTEAFF	TRBV7-3	TRBJ1-1
TGTGCCAGCAGCGGGGCTAGCGGGCGCTACGAGCAGTACTTC	CASSGASGRYEQYF	TRBV7-9	TRBJ2-7
TGTGCCAGCAGTTTCTTCATTGACAGGGGCCCAGCACACGAGCAGTACTTC	CASSFFIDRGPAHEQYF	TRBV27	TRBJ2-7
TGTGCCAGCAGCTTAGTCGCCACAGGGTTAAGACACAATGAGCAGTTCTTC	CASSLVATGLRHNEQFF	TRBV13	TRBJ2-1
TGTGCCAGCAGCTTGCCCGGGACGGTAGGAGCCTACGAGCAGTACTTC	CASSLPGTVGAYEQYF	TRBV5-4	TRBJ2-7
TGTGCCAGGGGGGTGGACTATGGCTACACCTTC	CARGVDYGYTF	TRBV27	TRBJ1-2
TGTGCCAGCAGGCATCGACAGGGTCCAACTAATGAAAAACTGTTTTTT	CASRHRQGPTNEKLFF	TRBV6-3	TRBJ1-4
TGTGCCAGCAGCGGAGACAGGCAGGGCTACACCTTC	CASSGDRQGYTF	TRBV7-4	TRBJ1-2
TGTGCCAGCAGTTTCCCATGTGACCGGGACAGGGGAGAAATCCATAGCAATCAGCCCCAGCATTTT	CASSFPCDRDRGEIHSNQPQHF	TRBV12-4	TRBJ1-5
TGTGCCAGCAGAGTCCGGGACAGACCCGGCTACACCTTC	CASRVRDRPGYTF	TRBV6-4	TRBJ1-2
TGTGCCAGCAGTGGCTGTGAGGACAGGGGGCGGGCCAAGGGCGAGCAGTACTTC	CASSGCEDRGRAKGEQYF	TRBV25-1	TRBJ2-7
TGCGCCAGCTCCTCTAAGGAAGTAGCGGGGGCCTACGAGCAGTACTTC	CASSSKEVAGAYEQYF	TRBV10-1	TRBJ2-7
TGTGCCAGCACTAGAGGGGGTGAAAAACTGTTTTTT	CASTRGGEKLFF	TRBV27	TRBJ1-4
TGCGCCAGCAGATCTGGCCCCGGGCCCCGCTACGAGCAGTACTTC	CASRSGPGPRYEQYF	TRBV5-1	TRBJ2-7
TGCGCCAGCAGCCAAGTATATTTAGGGTCGAACCAAAAGACGATGAACACTGAAGCTTTCTTT	CASSQVYLGSNQKTMNTEAFF	TRBV4-1	TRBJ1-1
TGTGCCAGCCACAGGGGTCGTGATTTGGAGCCCCAGCATTTT	CASHRGRDLEPQHF	TRBV18	TRBJ1-5
TGTGCCAGCAGCTACTCAACCTACGAGCAGTACTTC	CASSYSTYEQYF	TRBV7-8	TRBJ2-7
TGTGCCAGCAGTTTGAACAGGTGTCGAGATAATTCACCCCTCCACTTT	CASSLNRCRDNSPLHF	TRBV27	TRBJ1-6
TGTGCCAGCAGCAGAAGGGGACAAGGCATCGAAAAACTGTTTTTT	CASSRRGQGIEKLFF	TRBV5-6	TRBJ1-4
TGTGCCAGGTGGCTTCGGACAGGGACCCCGTACACCTTC	CARWLRTGTPYTF	TRBV28	TRBJ1-2
TGTGCCACCAGTGCTGTAAAGATCCGACCAAGAGCTTTCTTT	CATSAVKIRPRAFF	TRBV24-1	TRBJ1-1
TGTGCCGTAAAAAAGAAAGGGGATCAGCCCCAGCATTTT	CAVKKKGDQPQHF	TRBV3-1	TRBJ1-5
TGTGCCAGCAGTTCGCAAGACCCTCTGGAAACTGAAGCTTTCTTT	CASSSQDPLETEAFF	TRBV6-2	TRBJ1-1
TGTGCCACCAAGTCTCCCGGGGGGCTAACCCGCTCCTACGAGCAGTACTTC	CATKSPGGLTRSYEQYF	TRBV24-1	TRBJ2-7
TGCGCCAGCAGATCAAAGCAGGGGAATAGCAATCAGCCCCAGCATTTT	CASRSKQGNSNQPQHF	TRBV5-1	TRBJ1-5
TGTGCCAGCAGTGACTATAGGAACTATGGCTACACCTTC	CASSDYRNYGYTF	TRBV6-4	TRBJ1-2
TGTGCCAGCAGCCAAGATTTCCAGCAGGGCGAGGACTATGGCTACACCTTC	CASSQDFQQGEDYGYTF	TRBV14	TRBJ1-2
TGTGCCAGCAGTGAGGGGGAAAATCCCTACGAGCAGTACTTC	CASSEGENPYEQYF	TRBV6-5	TRBJ2-7
TGTGCCAGCAGCTCCGGGCTTAGGTTCCAAGAGACCCAGTACTTC	CASSSGLRFQETQYF	TRBV5-4	TRBJ2-5
TGTGCCAGCAGAGGGACCGGGTTTAACTATGGCTACACCTTC	CASRGTGFNYGYTF	TRBV6-5	TRBJ1-2
TGTGCCAGTAGAAAGATGGGTAAAGTCTTCCGGGACGAGCAGTACTTC	CASRKMGKVFRDEQYF	TRBV19	TRBJ2-7
TGTGCCAGCAAGTCAGGCGACTATGGCTACACCTTC	CASKSGDYGYTF	TRBV6-5	TRBJ1-2
TGTGCCAGCAGCTTCGGGGGGTCCTACAATGAGCAGTTCTTC	CASSFGGSYNEQFF	TRBV11-2	TRBJ2-1
TGTGCCGGAGTCGCGGGCTCCTACGAGCAGTACTTC	CAGVAGSYEQYF	TRBV10-3	TRBJ2-7
TGTGCCAGACAGGGGGCTGACACCGGGGAGCTGTTTTTT	CARQGADTGELFF	TRBV6-6	TRBJ2-2
TGCGCCAGCAGCGACCACCCCCCAGGGGGCCGGGTCAGCTCCTACGAGCAGTACTTC	CASSDHPPGGRVSSYEQYF	TRBV5-1	TRBJ2-7
TGTGCCAGCATATGGTGGGGGGGCTACGAGCAGTACTTC	CASIWWGGYEQYF	TRBV9	TRBJ2-7
TGTGCCAGCTCACCCGAATACGAAGGGAGGGGGGGGCCCGCCTACGAGCAGTACTTC	CASSPEYEGRGGPAYEQYF	TRBV18	TRBJ2-7
TGTGCCACGCGGACCGGTGATGGCCCCCACACTGAAGCTTTCTTT	CATRTGDGPHTEAFF	TRBV24-1	TRBJ1-1
TGTGCCAGCAGCCGTACAGGAAAAGTCTACGAGCAGTACTTC	CASSRTGKVYEQYF	TRBV9	TRBJ2-7
TGCAGTGGCCCGGGACAGGGCAGGAACTCCTACGAGCAGTACTTC	CSGPGQGRNSYEQYF	TRBV20-1	TRBJ2-7
TGTGCCAGCAGCGATGGGACAGCGGGCTATGGCTACACCTTC	CASSDGTAGYGYTF	TRBV7-3	TRBJ1-2
TGCAGTGCTAGAGGAAACGGGATCAGCAATCAGCCCCAGCATTTT	CSARGNGISNQPQHF	TRBV20-1	TRBJ1-5
TGTGCCAGCAGCAGGAGCGGGAGGGTCTATGGCTACACCTTC	CASSRSGRVYGYTF	TRBV7-3	TRBJ1-2
TGTGCCAGCAGCAAGGGACAGGGAGGGGCTTTCTTT	CASSKGQGGAFF	TRBV7-2	TRBJ1-1
TGTGCCAGCAGCCGACAGAACACTGAAGCTTTCTTT	CASSRQNTEAFF	TRBV7-6	TRBJ1-1
TGTGCCAGCAGCGGGTGGGTGGACAGTTTCTCTCTGGCCCAGCATTTT	CASSGWVDSFSLAQHF	TRBV13	TRBJ1-5
TGTGCCAGCAGCGTTCGACTGACCAACCCGGATACGCAGTATTTT	CASSVRLTNPDTQYF	TRBV6-2	TRBJ2-3
TGTGCCAGCAGTTTGAACCCTTCGGGGAGCTCCTACAATGAGCAGTTCTTC	CASSLNPSGSSYNEQFF	TRBV27	TRBJ2-1
TGTGCCAGCAGGTCGACAGGGCCGGACACTGAAGCTTTCTTT	CASRSTGPDTEAFF	TRBV27	TRBJ1-1
TGTGCTAGTGGTTCGCCCCAGGGGGCGGACCTGACTTCAACTAGCAATCAGCCCCAGCATTTT	CASGSPQGADLTSTSNQPQHF	TRBV12-5	TRBJ1-5
TGTGCCACCAGTGCCGGAACGTACGAGCAGTACTTC	CATSAGTYEQYF	TRBV24-1	TRBJ2-7
TGTGCCAGCAGGTCAGCCAGGATATTAAGCACAGATACGCAGTATTTT	CASRSARILSTDTQYF	TRBV6-2	TRBJ2-3
TGTGCCACCAGTGAGCCACCCTATAATTCACCCCTCCACTTT	CATSEPPYNSPLHF	TRBV24-1	TRBJ1-6
TGTGCCAGCAGATACAGGGCGTATCCTGGCTACACCTTC	CASRYRAYPGYTF	TRBV6-1	TRBJ1-2
TGCAGTGCTAGAGGCTTGGACAAGGGCAATCAGCCCCAGCATTTT	CSARGLDKGNQPQHF	TRBV20-1	TRBJ1-5
TGTGCCAGCTCACCATCAGGTACATTCCCGAGAGGCTACACCTTC	CASSPSGTFPRGYTF	TRBV18	TRBJ1-2
TGTGCCAGCAGCTTAGCCCGCGGCGACAATGAGCAGTTCTTC	CASSLARGDNEQFF	TRBV11-2	TRBJ2-1
TGTGCCAGCAGTAGGTTAAGGAACACTGAAGCTTTCTTT	CASSRLRNTEAFF	TRBV27	TRBJ1-1
TGCAGACGGGGACGGTTACCCTCTGGAAACACCATATATTTT	CRRGRLPSGNTIYF	TRBV20-1	TRBJ1-3
TGTGCCACCAAATCAGGGAAACATCAGCCCCAGCATTTT	CATKSGKHQPQHF	TRBV24-1	TRBJ1-5
TGTGCCAGCAGCCCCCTTACGAGGGTTGAGGGGACTAGAGTAAAATACACCGGGGAGCTGTTTTTT	CASSPLTRVEGTRVKYTGELFF	TRBV7-2	TRBJ2-2
TGCAGTGCTAGAGCCGAAGGGGACCCATTCGGCAGACACACCGGGGAGCTGTTTTTT	CSARAEGDPFGRHTGELFF	TRBV20-1	TRBJ2-2
TGCGCCAGCAGCCGGCAGGGCATCACCGGGGAGCTGTTTTTT	CASSRQGITGELFF	TRBV5-1	TRBJ2-2
TGTGCCAGCAGCTTAGTACCCGGGACTAGATGCCCCCTCCTCGGGGAGGAATACAACACCGGGGAGCTGTTTTTT	CASSLVPGTRCPLLGEEYNTGELFF	TRBV7-2	TRBJ2-2
TGCAGTGCTAGTCGGGACAAAGTCGAGCAGTACTTC	CSASRDKVEQYF	TRBV20-1	TRBJ2-7
TGCGCCAGCAGTGACACACCCCAGGGTCAATACACCTTC	CASSDTPQGQYTF	TRBV10-1	TRBJ1-2
TGTGCCAGCAGAATTCCATCGGGGAGGTCACCCCTCCACTTT	CASRIPSGRSPLHF	TRBV12-3	TRBJ1-6
TGTGCCAGTATGGCGGCTTACGAGCAGTACTTC	CASMAAYEQYF	TRBV19	TRBJ2-7
TGTGCCAGCAGGTATCGGCGGACAGGGTATAGGTACTTC	CASRYRRTGYRYF	TRBV7-2	TRBJ2-7
TGTGCCAGCAGTTTATTGTGGTCCCAGGGCCTGGGAGGGCCTCAAGAGACCCAGTACTTC	CASSLLWSQGLGGPQETQYF	TRBV27	TRBJ2-5
TGTGCCAGCAGCATCATGACAGGGGCGAGCATTCAGTACTTC	CASSIMTGASIQYF	TRBV5-4	TRBJ2-4
TGTGGGGGAGAAGGGGACTATGGCTACACCTTC	CGGEGDYGYTF	TRBV12-3	TRBJ1-2
TGTGCCAGCAGCCCACTCCTCCTAGCGGGCCCATTCAATGAGCAGTTCTTC	CASSPLLLAGPFNEQFF	TRBV13	TRBJ2-1
TGTGCCAGCAGCGGGGGGGGGCTAAAAAGCACCGGGGAGCTGTTTTTT	CASSGGGLKSTGELFF	TRBV12-4	TRBJ2-2
TGTGCCAGCTCGTTCGGAAAGGGACGTGTAGGCTCCTACGAGCAGTACTTC	CASSFGKGRVGSYEQYF	TRBV11-3	TRBJ2-7
TGTGCCAGCAGTTCAATACCAGGAGAGCGTATGAACACTGAAGCTTTCTTT	CASSSIPGERMNTEAFF	TRBV27	TRBJ1-1
TGTGCCAGCAGCTTACTAAATCGGGGACAGGATAATGAGCAGTTCTTC	CASSLLNRGQDNEQFF	TRBV7-3	TRBJ2-1
TGTGCCAGCAGTCTTCGGACAGGGGTTGGCTACACCTTC	CASSLRTGVGYTF	TRBV6-1	TRBJ1-2
TGTGCCAGCAGTTTAGCGCGCCGACAGCCTGACAGTAACGATCAGCCCCAGCATTTT	CASSLARRQPDSNDQPQHF	TRBV12-3	TRBJ1-5
TGTGCCAGCAGCTGTGGGGCTAGCAATTCAAATGAGCAGTTCTTC	CASSCGASNSNEQFF	TRBV7-2	TRBJ2-1
TGCAGTGCTTTACTAGGGGATGACTATGGCTACACCTTC	CSALLGDDYGYTF	TRBV20-1	TRBJ1-2
TGTGCCAGCAGTGAAACTTCCCCGAGGGGCGGCCTTCCAGATACGCAGTATTTT	CASSETSPRGGLPDTQYF	TRBV6-1	TRBJ2-3
TGTGCCAGCAGCCAAGTCTCGGGACAGTGGAGCTACGAGCAGTACTTC	CASSQVSGQWSYEQYF	TRBV14	TRBJ2-7
TGTGCCAGCAGTGACGCAGTGGGGGGCATAAAATACGAGCAGTACTTC	CASSDAVGGIKYEQYF	TRBV6-4	TRBJ2-7
TGTGCCAGCACCGGGGAGCAGCCTGAAAAACTGTTTTTT	CASTGEQPEKLFF	TRBV28	TRBJ1-4
TGTGCCACCAGGCCCGGGACAGGGAACAGTAATGAAAAACTGTTTTTT	CATRPGTGNSNEKLFF	TRBV24-1	TRBJ1-4
TGTGCGAATAGTTTCTTC	CANSFF	TRBV27	TRBJ2-1
TGTGCCAGCAGCTTGGGGGGGTCGGGACAGGGCCCCTACGAGCAGTACTTC	CASSLGGSGQGPYEQYF	TRBV5-4	TRBJ2-7
TGTGCCAGCAGCCAAGATACCGGAGGGGGAGGGAGCAATCAGCCCCAGCATTTT	CASSQDTGGGGSNQPQHF	TRBV14	TRBJ1-5
TGTGCCAGCAGTTACTCTCCAAATACAGGGGGCCCAACTGAAGCTTTCTTT	CASSYSPNTGGPTEAFF	TRBV6-5	TRBJ1-1
TGTGCCACCAGTGAGTACGTAACTAGCGGGGGCAGTGAGCAGTTCTTC	CATSEYVTSGGSEQFF	TRBV24-1	TRBJ2-1
TGTGCCAGCAGCAGATTCAGGACTAGCGAGTACGAGCAGTACTTC	CASSRFRTSEYEQYF	TRBV7-3	TRBJ2-7
TGTGCCAGCAGCTCCGGGGAACGACCCAATGAGCAGTTCTTC	CASSSGERPNEQFF	TRBV5-8	TRBJ2-1
TGTGCCAGCAGCTTACTTCCGGGACAGGGCGTCGGAGCTTTCTTT	CASSLLPGQGVGAFF	TRBV7-9	TRBJ1-1
TGTGCCAGCAGCCGCTTGTCCCCAGGGTCAGCTGCCAATCAGCCCCAGCATTTT	CASSRLSPGSAANQPQHF	TRBV14	TRBJ1-5
TGTGCCAGCAGCCAAGAAGCCGTCGGTGAGGGGTATAACACTGAAGCTTTCTTT	CASSQEAVGEGYNTEAFF	TRBV14	TRBJ1-1
TGTGCCAGCAGTACTAGCGGGAGTGGTCTGAACACTGAAGCTTTCTTT	CASSTSGSGLNTEAFF	TRBV27	TRBJ1-1
TGTGCCAGCAGTTTATGTAGCGGTCAGACCGAATTCACAGCTTTCTTT	CASSLCSGQTEFTAFF	TRBV28	TRBJ1-1
TGTGCCAGCAGAAAAGGGCATTCACCCCTCCACTTT	CASRKGHSPLHF	TRBV28	TRBJ1-6
TGTGCCAGCAGCTGGGGGGGCCCCGTACATTCCTACGAGCAGTACTTC	CASSWGGPVHSYEQYF	TRBV13	TRBJ2-7
TGTGCCAGCAGCCAAGAAGGGAGGGTTGGGGGCGGAGAGACCCAGTACTTC	CASSQEGRVGGGETQYF	TRBV3-1	TRBJ2-5
TGTGCCAGCCAGGACTTTAGAGATACGCAGTATTTT	CASQDFRDTQYF	TRBV5-6	TRBJ2-3
TGTGCCAGCAGCGGGGCTAGGGAGCTGTTTTTT	CASSGARELFF	TRBV13	TRBJ2-2
TGTGCCAGCAGTGTACCGGGGGGCGCGGGCTCTGGAAACACCATATATTTT	CASSVPGGAGSGNTIYF	TRBV2	TRBJ1-3
TGTGCCAGCAAGAGGGGAATAGCTAGGGTCGACACTGAAGCTTTCTTT	CASKRGIARVDTEAFF	TRBV6-5	TRBJ1-1
TGCAGTGCTAGAGATTACCGACTAGCTAAAGGTCTCGATACGCAGTATTTT	CSARDYRLAKGLDTQYF	TRBV20-1	TRBJ2-3
TGTGCCACCAGTGGTACGGGCAGGCCCGAGGACACCGGGGAGCTGTTTTTT	CATSGTGRPEDTGELFF	TRBV24-1	TRBJ2-2
TGTGCCAGCAGCATCTGTACCACAGATACGCAGTATTTT	CASSICTTDTQYF	TRBV27	TRBJ2-3
TGTGCCACCAGTGATTCGACAGGGTATAGCAATCAGCCCCAGCATTTT	CATSDSTGYSNQPQHF	TRBV24-1	TRBJ1-5
TGTGCCAGCAGCCAGGAGAGATTAGGTACCGGGGAGCTGTTTTTT	CASSQERLGTGELFF	TRBV14	TRBJ2-2
TGTGCCAGCAGTGAGACAGGACGGGCCAACGTCCTGACTTTC	CASSETGRANVLTF	TRBV6-4	TRBJ2-6
TGTGCCAGCCCGGGGACGGGGCACACCGGGGAGCTGTTTTTT	CASPGTGHTGELFF	TRBV15	TRBJ2-2
TGCGCCAGCAGCTTGGTCAAAACAGGGGACGCTACCGGGGAGCTGTTTTTT	CASSLVKTGDATGELFF	TRBV5-1	TRBJ2-2
TGTGCCAGCAGCCCCAGGGGGAGCCCAAGCACTGAAGCTTTCTTT	CASSPRGSPSTEAFF	TRBV11-3	TRBJ1-1
TGTGCCAGCAGCTTTTTCGGAGTGTCCCCCGTTCAGCCCCAGCATTTT	CASSFFGVSPVQPQHF	TRBV7-8	TRBJ1-5
TGTGCCAGCAGTAAAACCCCCCAAGACCTAGGGTATCAGCCCCAGCATTTT	CASSKTPQDLGYQPQHF	TRBV27	TRBJ1-5
TGTGCCACCAGTGATTGGACCCCGGGCCCGCAAAGATATAGCAATCAGCCCCAGCATTTT	CATSDWTPGPQRYSNQPQHF	TRBV24-1	TRBJ1-5
TGTGCCACCAGTGATTTGCTTACAGCACGACCGCCGGGACTAGCCTGGTGGTCTGGCTACAATGAGCAGTTCTTC	CATSDLLTARPPGLAWWSGYNEQFF	TRBV24-1	TRBJ2-1
TGTGCCACCAGTGATTTTACTTTTCGGACAGGCAATCAGCCCCAGCATTTT	CATSDFTFRTGNQPQHF	TRBV24-1	TRBJ1-5
TGTGCCAGCAGCTTAGCAGGACAGGGGTTCGAGGAAGCTTTCTTT	CASSLAGQGFEEAFF	TRBV11-2	TRBJ1-1
TGTGCCAGCAGCTTGTTGTATGGGGGGGCCCACAATGAGCAGTTCTTC	CASSLLYGGAHNEQFF	TRBV5-6	TRBJ2-1
TGTGCCAGCAGCTTAAATCTCAGGACAGGGTTAGGCCTCCCCTCTGGAAACACCATATATTTT	CASSLNLRTGLGLPSGNTIYF	TRBV7-3	TRBJ1-3
TGTGCCAGCAGTGTTCAAGGGTGCGGAGGGGCGTATGGCTACACCTTC	CASSVQGCGGAYGYTF	TRBV6-5	TRBJ1-2
TGTGCCACCAGTGAACTCCGGACTGGAAACACCATATATTTT	CATSELRTGNTIYF	TRBV24-1	TRBJ1-3
TGTGCCACCCGGGGACCCCCGAAAAATCAGCCCCAGCATTTT	CATRGPPKNQPQHF	TRBV19	TRBJ1-5
TGTGCCAGCAGCCCGGGACTCACGCGGAACACTGAAGCTTTCTTT	CASSPGLTRNTEAFF	TRBV11-3	TRBJ1-1
TGTGCCAGCAGCCAGGAGGGCCCGGGACAGGGCAGAGGGCCCTCGAGGGCCAACGTCCTGACTTTC	CASSQEGPGQGRGPSRANVLTF	TRBV4-2	TRBJ2-6
TGTGCCAGCAGGTTAAGCGGGACAAACCGTGGCTACACCTTC	CASRLSGTNRGYTF	TRBV27	TRBJ1-2
TGTGCCAGCAGTGAATATCCAATGGGACTAGCGGGTAGAGAGCAGTACTTC	CASSEYPMGLAGREQYF	TRBV25-1	TRBJ2-7
TGTGCCAGCATCCGTGAACAGGCTGACACTGAAGCTTTCTTT	CASIREQADTEAFF	TRBV6-4	TRBJ1-1
TGTGCCAGCAGCCAGGTGACAGTAGGCGTCGAGCAGTACTTC	CASSQVTVGVEQYF	TRBV3-1	TRBJ2-7
TGCAGTGCTAGTAGGGTCGGACAGGGGGCGGAAAGCAATCAGCCCCAGCATTTT	CSASRVGQGAESNQPQHF	TRBV20-1	TRBJ1-5
TGTGCCATCACAGCTAGCGGGTTCCATACGCAGTATTTT	CAITASGFHTQYF	TRBV10-3	TRBJ2-3
TGTGCCAGCACACTATCCAATGGCTACACCTTC	CASTLSNGYTF	TRBV12-3	TRBJ1-2
TGTGCCCTATTCCTAGCGGGGTTCCTAGAGACCCAGTACTTC	CALFLAGFLETQYF	TRBV7-3	TRBJ2-5
TGTGCCTGGAGGTTATTGGGTCGGGAAGACTCATACCCGGACACCGGGGAGCTGTTTTTT	CAWRLLGREDSYPDTGELFF	TRBV30	TRBJ2-2
TGTGCCAGCAGTAACTATCGGGAAAGGGTTGTTAATGAAAAACTGTTTTTT	CASSNYRERVVNEKLFF	TRBV27	TRBJ1-4
TGTGCCAGCAGGGACAGGCTAATGAACACTGAAGCTTTCTTT	CASRDRLMNTEAFF	TRBV27	TRBJ1-1
TGTGCCACCAGTGATTCCTTAACAGGGGGCGAGCAGTACTTC	CATSDSLTGGEQYF	TRBV24-1	TRBJ2-7
TGTGCCACCAGCTTTATTTTAAATGAGCAGTTCTTC	CATSFILNEQFF	TRBV24-1	TRBJ2-1
TGTGCCAGCAGGTATCGTTTAGCCTACGAGCAGTACTTC	CASRYRLAYEQYF	TRBV7-2	TRBJ2-7
TGTGCCATCACCGGAAGCAGTCGGGGGCGGGGCTCTGGAAACACCATATATTTT	CAITGSSRGRGSGNTIYF	TRBV10-3	TRBJ1-3
TGTGCCAGCAGCTTAGATCCCGGAAAAGAAGGAATCTCCTACGAGCAGTACTTC	CASSLDPGKEGISYEQYF	TRBV11-3	TRBJ2-7
TGCAGTGCGGAGCACAGGGCCGTCTATGGCTACACCTTC	CSAEHRAVYGYTF	TRBV20-1	TRBJ1-2
TGTGCCAGCAGACGGGACAGAGACTATGGCTACACCTTC	CASRRDRDYGYTF	TRBV7-9	TRBJ1-2
TGTGCCACCAGCAGAGATTGCGACCTAGCGGGGGGTAGCACAGATACGCAGTATTTT	CATSRDCDLAGGSTDTQYF	TRBV15	TRBJ2-3
TGTGCCAGCAGTTTATTGGAGGGGGACCATGAGCAGTTCTTC	CASSLLEGDHEQFF	TRBV27	TRBJ2-1
TGTGCCAGCAGCCCGCGAGGGTACGAGCAGTACTTC	CASSPRGYEQYF	TRBV28	TRBJ2-7
TGTGCCACCAGTCTCGGGGATGGGTGCTACAATGAGCAGTTCTTC	CATSLGDGCYNEQFF	TRBV24-1	TRBJ2-1
TGCGCCAGCAGTGATCCCGTTTGTCCGGGACAGTTTCAGCCCCAGCATTTT	CASSDPVCPGQFQPQHF	TRBV10-1	TRBJ1-5
TGTGCCAGCAGCTGGGAGGCGGGAGGAAATGAGCAGTTCTTC	CASSWEAGGNEQFF	TRBV7-7	TRBJ2-1
TGTGCCAGCAGTAACAACCAGGGTATTCGATACCTCTACAATGAGCAGTTCTTC	CASSNNQGIRYLYNEQFF	TRBV6-6	TRBJ2-1
TGTGCCAGCAGCACAAACAGGGAGAGACCGCCCCAGCATTTT	CASSTNRERPPQHF	TRBV7-9	TRBJ1-5
TGCGCCAGCAGCTTGGTGTCCCCTAGGGGGCAAGATGGCTACACCTTC	CASSLVSPRGQDGYTF	TRBV5-1	TRBJ1-2
TGCGCCAGCAGCTGGGGCATAGGGGGGTGGAACACTGAAGCTTTCTTT	CASSWGIGGWNTEAFF	TRBV5-1	TRBJ1-1
TGTGCCAGCAGTGACTCGAAAGTCGGGGACGAGCAGTACTTC	CASSDSKVGDEQYF	TRBV6-4	TRBJ2-7
TGTGCCAGCAGCTGGGGGGCCAGCTACGAGCAGTACTTC	CASSWGASYEQYF	TRBV5-4	TRBJ2-7
TGCAGTGCTAGGGCGCCTCGGGACAGGGGACCCCAGCAAGAGACCCAGTACTTC	CSARAPRDRGPQQETQYF	TRBV20-1	TRBJ2-5
TGTGCCAGCAGCCCCCACAGGGGCACTGAAGCTTTCTTT	CASSPHRGTEAFF	TRBV13	TRBJ1-1
TGTGCCAGCAGCTCTCACAGGGAAGAGACCCAGTACTTC	CASSSHREETQYF	TRBV12-3	TRBJ2-5
TGTGCTAGTGGTTTGGTACCCGTCGACGAGTCGGGGGAAAAACTGTTTTTT	CASGLVPVDESGEKLFF	TRBV12-5	TRBJ1-4
TGCGCCAGCAGCTTTTCGGGTCGACAGCCCCAGCATTTT	CASSFSGRQPQHF	TRBV5-1	TRBJ1-5
TGTGCCAGCGCCTTGAGACCCCGGGGATTCTATGGCTACACCTTC	CASALRPRGFYGYTF	TRBV7-2	TRBJ1-2
TGTGCCTGGAGTGGGTCCCCCCTCAGGGGGCAAAGGTCCTACGAGCAGTACTTC	CAWSGSPLRGQRSYEQYF	TRBV30	TRBJ2-7
TGTGCCAGCAGCGTAGCTACCTGTACCAGGTGGGGGGTAATCGGGGCCAACGTCCTGACTTTC	CASSVATCTRWGVIGANVLTF	TRBV9	TRBJ2-6
TGTGCCACCAGTGCAAGGGACAGGGGGGGGGGCTACACCTTC	CATSARDRGGGYTF	TRBV24-1	TRBJ1-2
TGTGCCAGCAGCTTGGCCCGCCCGGCCCGGGAAGAGACCCAGTACTTC	CASSLARPAREETQYF	TRBV5-4	TRBJ2-5
TGTGCCAGCAGCAGTTTGATCGCAGGGGGCGATTATGATAGCAATCAGCCCCAGCATTTT	CASSSLIAGGDYDSNQPQHF	TRBV5-5	TRBJ1-5
TGTGCCGGGACAGGGCGTGCTGAAGCTTTCTTT	CAGTGRAEAFF	TRBV30	TRBJ1-1
TGTGCCAGCAGCCAAGCCCGGGGGCGGTTTGTCTATGGCTACACCTTC	CASSQARGRFVYGYTF	TRBV3-1	TRBJ1-2
TGTGCCAGCAGTATGTCAGGGGGGGTGTGCGCCTACAATGAGCAGTTCTTC	CASSMSGGVCAYNEQFF	TRBV27	TRBJ2-1
TGTGCCAGCAGCGTAGCAGCGCTCCAGGGAAACTACAATGAGCAGTTCTTC	CASSVAALQGNYNEQFF	TRBV9	TRBJ2-1
TGTGCCAGCAGCCCCACGAGGGCAGCAGGGGCTACAGATACGCAGTATTTT	CASSPTRAAGATDTQYF	TRBV3-1	TRBJ2-3
TGTGCCAGCAGTGCGGGACTAGCGGGAGATAACATTCAGTACTTC	CASSAGLAGDNIQYF	TRBV6-4	TRBJ2-4
TGTGCCAGCAGTGAAATCCCGTGGGGGGGGCGTATCTCCTACAATGAGCAGTTCTTC	CASSEIPWGGRISYNEQFF	TRBV6-1	TRBJ2-1
TGTGCCAGCAGTGGTCGGGACAGAAACTTGACCCAGTACTTC	CASSGRDRNLTQYF	TRBV25-1	TRBJ2-5
TGTGCCAGCAGCCACTCCGCAGGGCTGTCGCATCAAGAGACCCAGTACTTC	CASSHSAGLSHQETQYF	TRBV7-3	TRBJ2-5
TGCAGTGCACCTAGTGAATCCTACAATGAGCAGTTCTTC	CSAPSESYNEQFF	TRBV20-1	TRBJ2-1
TGCAGTGCTAGAGATTTACCCGGGACAGGTCTGCAGCCCCAGCATTTT	CSARDLPGTGLQPQHF	TRBV20-1	TRBJ1-5
TGTGCCAGTAGTATTCTGGACAGGGCTGGTAGCAATCAGCCCCAGCATTTT	CASSILDRAGSNQPQHF	TRBV19	TRBJ1-5
TGCGCCAGCAGCCAAGAGGATGCGAACACTGAAGCTTTCTTT	CASSQEDANTEAFF	TRBV4-1	TRBJ1-1
TGTGCCAGCGAAACTAGCGGGAGGACTGATACGCAGTATTTT	CASETSGRTDTQYF	TRBV7-3	TRBJ2-3
TGCGCCAGCACCCAGAATTCACCCCTCCACTTT	CASTQNSPLHF	TRBV4-3	TRBJ1-6
TGCGCCAGCAGCTTGCCTCACGTCTATGGCTACACCTTC	CASSLPHVYGYTF	TRBV5-1	TRBJ1-2
TGCGCCAGCAGCTGTGGCAGGGTCAGGACCGGGGAGCTGTTTTTT	CASSCGRVRTGELFF	TRBV4-1	TRBJ2-2
TGTGCCAGCAGTCCAGGGAGTTCCGAAGCTTTCTTT	CASSPGSSEAFF	TRBV12-3	TRBJ1-1
TGTGCCAGCAGCTCCGGGACAAGGTATGGCTACACCTTC	CASSSGTRYGYTF	TRBV7-6	TRBJ1-2
TGTGCCAGCATCTGGGGGGAGGAAGATTCATTAGTCTATGGCTACACCTTC	CASIWGEEDSLVYGYTF	TRBV7-9	TRBJ1-2
TGTGCCAGCAGCCCCCTGAGCTTCTGCAGGGGGCTTGAACTGGCCTACGAGCAGTACTTC	CASSPLSFCRGLELAYEQYF	TRBV2	TRBJ2-7
TGTGCCAGCAGTTACTCTCTCCCCACTAGCGGGAGGCACTCTGGAAACACCATATATTTT	CASSYSLPTSGRHSGNTIYF	TRBV6-5	TRBJ1-3
TGTGCCAGCAGCGAAACAGGGCTAGTCGCAGATACGCAGTATTTT	CASSETGLVADTQYF	TRBV7-3	TRBJ2-3
TGTGCCAGCAGCGTAGACCCAACCGGACAGGGGGCAACCTACGAGCAGTACTTC	CASSVDPTGQGATYEQYF	TRBV9	TRBJ2-7
TGCAGTGCTCTACTTGAGCGGGACTACGAGCAGTACTTC	CSALLERDYEQYF	TRBV20-1	TRBJ2-7
TGTGCCAGTTTGAGCTTTAACACCGGGGAGCTGTTTTTT	CASLSFNTGELFF	TRBV9	TRBJ2-2
TGTGCCAGCAGGTCCGGACAGGGGACTACCGACACTGAAGCTTTCTTT	CASRSGQGTTDTEAFF	TRBV6-1	TRBJ1-1
TGTGCCAGCACCGGGACAGATCTGGGCACTGAAGCTTTCTTT	CASTGTDLGTEAFF	TRBV5-6	TRBJ1-1
TGTGCCAGCAGCTCCCTAGCGACTCGTAACACAGATACGCAGTATTTT	CASSSLATRNTDTQYF	TRBV7-2	TRBJ2-3
TGTGCCAGCAGGATATGCACCGGGGAGCTGTTTTTT	CASRICTGELFF	TRBV6-5	TRBJ2-2
TGCGCCAGCAGCCCGATTGACAGCGGTAAAGACAATGAGCAGTTCTTC	CASSPIDSGKDNEQFF	TRBV5-1	TRBJ2-1
TGTGCCAGCAGGGTTTTCGGAGGACAAGAGACCCAGTACTTC	CASRVFGGQETQYF	TRBV6-5	TRBJ2-5
TGTGCCAGCAGCTTAGGGTACGAGCAGTACTTC	CASSLGYEQYF	TRBV11-3	TRBJ2-7
TGTGCCAGCACATGGGGGGGAACCGGGGTCGGGGAGCTGTTTTTT	CASTWGGTGVGELFF	TRBV6-4	TRBJ2-2
TGCAGCGTTGACAAATTCCCGCAGGGGGAGTCTGGGGCCAACGTCCTGACTTTC	CSVDKFPQGESGANVLTF	TRBV29-1	TRBJ2-6
TGTGCTACCAATCTAGCGGGAGGGTGGTCCTACAATGAGCAGTTCTTC	CATNLAGGWSYNEQFF	TRBV28	TRBJ2-1
TGCGCCAGCAGTGGACAGGGATGGGACTACGAGCAGTACTTC	CASSGQGWDYEQYF	TRBV10-1	TRBJ2-7
TGTGCCAGCAGCAAAGTCGAGCAGTACTTC	CASSKVEQYF	TRBV13	TRBJ2-7
TGCAGCGTTGTCCAGTTATGGACAGCCCCACAGCAGTACTTC	CSVVQLWTAPQQYF	TRBV29-1	TRBJ2-7
TGTGCCAGCAGCCATGGTCGCGGGGCGCTGCGGTACACCGGGGAGCTGTTTTTT	CASSHGRGALRYTGELFF	TRBV3-1	TRBJ2-2
TGTGCCAGCAGCTTCTTGGACCGCTCTGGAAACACCATATATTTT	CASSFLDRSGNTIYF	TRBV7-6	TRBJ1-3
TGTGCCAGCAGCGCCCGGGGGGGGCATGGGGCCAACGTCCTGACTTTC	CASSARGGHGANVLTF	TRBV7-3	TRBJ2-6
TGTGCCAGCAGCTGGAACGAGCAGTACTTC	CASSWNEQYF	TRBV7-2	TRBJ2-7
TGTGCCAGCAGACTGACGTCCAGCAATCAGCCCCAGCATTTT	CASRLTSSNQPQHF	TRBV13	TRBJ1-5
TGTGCCAGCACGATGTTGGACGATCCCTATAATTCACCCCTCCACTTT	CASTMLDDPYNSPLHF	TRBV5-4	TRBJ1-6
TGTGCCTGGAGTGATCCCGGTACAGATACGCAGTATTTT	CAWSDPGTDTQYF	TRBV30	TRBJ2-3
TGTGCCAGCAGTACTATGAAAAGTCGGCGAGGCTACACCTTC	CASSTMKSRRGYTF	TRBV6-4	TRBJ1-2
TGTGCCAGCAGCACGCCTGGGTGCTCCTACGAGCAGTACTTC	CASSTPGCSYEQYF	TRBV7-3	TRBJ2-7
TGTGCCAGCAGCTTGGGCGTGGGGGGCGGAGATGAAAAACTGTTTTTT	CASSLGVGGGDEKLFF	TRBV5-4	TRBJ1-4
TGTGCCAGCAGTTTAAACCGAACGTTGAACATTCAGTACTTC	CASSLNRTLNIQYF	TRBV27	TRBJ2-4
TGTGCCAGCAGCCGGGGACAGGGGAAAGCGCAGGGGAACACTGAAGCTTTCTTT	CASSRGQGKAQGNTEAFF	TRBV7-3	TRBJ1-1
TGTGCCAGCAGCGTAGGTAAAGAGGGGGCCGCAATCAGGTTTGGGAGGTATCCCTCTGGAAACACCATATATTTT	CASSVGKEGAAIRFGRYPSGNTIYF	TRBV9	TRBJ1-3
TGTGCCAGCACCACCAAGCGCACTGAAGCTTTCTTT	CASTTKRTEAFF	TRBV2	TRBJ1-1
TGTGCCAGCAGCCAAGATTCAACAACGACTAGCGGCTCCTACAATGAGCAGTTCTTC	CASSQDSTTTSGSYNEQFF	TRBV4-2	TRBJ2-1
TGTGCCAGCAGCCCCACAGGGGGTAAAGATACGCAGTATTTT	CASSPTGGKDTQYF	TRBV27	TRBJ2-3
TGTGCCAGCAGTGACTCGACTGGACTAGTGGGACACTCAGATACGCAGTATTTT	CASSDSTGLVGHSDTQYF	TRBV6-4	TRBJ2-3
TGTGCCAGCAGCTTAGGCCTGGGACGGTCGACTGAAGCTTTCTTT	CASSLGLGRSTEAFF	TRBV7-9	TRBJ1-1
TGTGCCAGCATAGCAAGGGACTGGGGGGGGACCCCTCCTAACTATGGCTACACCTTC	CASIARDWGGTPPNYGYTF	TRBV27	TRBJ1-2
TGTGCCAGCAACGGGGAACTCCGGGGGCGCGGCCAAGAGACCCAGTACTTC	CASNGELRGRGQETQYF	TRBV28	TRBJ2-5
TGTGCCAGCAGCCCGCCCGGGACTAGCGGGGGGGAGGTCGAGACCCAGTACTTC	CASSPPGTSGGEVETQYF	TRBV3-1	TRBJ2-5
TGTGCCAGCAGCGATTGGGGGGGGCCCGAGCAGTACTTC	CASSDWGGPEQYF	TRBV3-1	TRBJ2-7
TGTGCCAGCAGCTTAACGACAGGAGCTAACTATGGCTACACCTTC	CASSLTTGANYGYTF	TRBV7-3	TRBJ1-2
TGTGCCAGCAGTAGGCACAAGGGGGGCTCCGAGGAAAAACTGTTTTTT	CASSRHKGGSEEKLFF	TRBV13	TRBJ1-4
TGTGCCAGCAGTCCAGGTCCGCAGGGACGCGGACACCAGGGGCACACCTTC	CASSPGPQGRGHQGHTF	TRBV6-1	TRBJ1-2
TGCGCCAGCATTCCTAGAGCAGATACGCAGTATTTT	CASIPRADTQYF	TRBV10-1	TRBJ2-3
TGTGCCAGCAGACAGGGGGGGGTGGGCTACACCTTC	CASRQGGVGYTF	TRBV6-1	TRBJ1-2
TGTGCCAGCAGCCAAGTTGCTCGATTCTTAACTATTAGGTGCCTTAGGCCGTCGAACCCAAACAATGAGCAGTTCTTC	CASSQVARFLTIRCLRPSNPNNEQFF	TRBV3-1	TRBJ2-1
TGTGCCAGCAGCTTATATCAAAAGCTAGACGGAAAAAACATTCAGTACTTC	CASSLYQKLDGKNIQYF	TRBV7-8	TRBJ2-4
TGCAGTGCTGAAAAAGCAGACGCTTTTAGCTCTGGAAACACCATATATTTT	CSAEKADAFSSGNTIYF	TRBV20-1	TRBJ1-3
TGTGCCAGCAGTGATACCCTTGACAGGGGGCTTCATCAGCCCCAGCATTTT	CASSDTLDRGLHQPQHF	TRBV6-1	TRBJ1-5
TGTGCCAGCAGCCAGAGAGAAGAAGGGCAGTTCTTC	CASSQREEGQFF	TRBV14	TRBJ2-1
TGTGCCAGCAGTGAAGGGGCCCACCCCCCCCGACTAGCGGGGGGGCTTCCATGTGAGCAGTTCTTC	CASSEGAHPPRLAGGLPCEQFF	TRBV2	TRBJ2-1
TGTGCCAGCAGCATCCCGACTGGGGGGACAGGGATTAAGGAGAATGAAAAACTGTTTTTT	CASSIPTGGTGIKENEKLFF	TRBV7-3	TRBJ1-4
TGTGCCATCAGTGACCGGGACACAGGTGAGCAGTTCTTC	CAISDRDTGEQFF	TRBV10-3	TRBJ2-1
TGTGCCAGCAGCAATCAGGGTAGCTCCTACAATGAGCAGTTCTTC	CASSNQGSSYNEQFF	TRBV6-4	TRBJ2-1
TGTGCCAGCAGCGGGGGGCCATTGAGGCTATCCTACGAGCAGTACTTC	CASSGGPLRLSYEQYF	TRBV13	TRBJ2-7
TGTGCCTGGAGTGTAAGTTCTTGCGATGAGCAGTTCTTC	CAWSVSSCDEQFF	TRBV30	TRBJ2-1
TGCGGGAGATCAGGGGTGGAGAGGAACACTGAAGCTTTCTTT	CGRSGVERNTEAFF	TRBV10-2	TRBJ1-1
TGTGCCAGCAGTGAACGGGGGAGCACAGATACGCAGTATTTT	CASSERGSTDTQYF	TRBV25-1	TRBJ2-3
TGTGCCAGCCTTAGGGGGGCAGGCCTCCAAGAGACCCAGTACTTC	CASLRGAGLQETQYF	TRBV5-6	TRBJ2-5
TGCGCCAGCTCCTCGGGACTAGCTCTCCCGAACACCGGGGAGCTGTTTTTT	CASSSGLALPNTGELFF	TRBV10-2	TRBJ2-2
TGTGCCAGCAGCTTACCCCCAGTAGCCGACAATGAGCAGTTCTTC	CASSLPPVADNEQFF	TRBV7-9	TRBJ2-1
TGCAGCGTTATAACCACCGGGACGCTCTCTGGAAACACCATATATTTT	CSVITTGTLSGNTIYF	TRBV29-1	TRBJ1-3
TGTGCCAGCACTGGGCCCGAGACCCAGTACTTC	CASTGPETQYF	TRBV28	TRBJ2-5
TGTGCCAGCAACAATCGACAGGGGGAGTCTTCAGCTAACTATGGCTACACCTTC	CASNNRQGESSANYGYTF	TRBV6-3	TRBJ1-2
TGTGCCAGCAGCCTGGGGGTCCCCAACGAGCAGTACTTC	CASSLGVPNEQYF	TRBV13	TRBJ2-7
TGCAGTGCTAGAGATAACACTCAGACTAGCGGGCATAATGAGCAGTTCTTC	CSARDNTQTSGHNEQFF	TRBV20-1	TRBJ2-1
TGTGCCAGCAGCCAAAACAAGGCGGATTGGGTAGCAACTAATGAAAAACTGTTTTTT	CASSQNKADWVATNEKLFF	TRBV3-1	TRBJ1-4
TGTGCCACCAGCAGAGCACCCAATAAAAACTCCAGGGCGTATAGCAATCAGCCCCAGCATTTT	CATSRAPNKNSRAYSNQPQHF	TRBV15	TRBJ1-5
TGTGCCACCAGTGTATCGGCGTCCGAGCAGTACTTC	CATSVSASEQYF	TRBV24-1	TRBJ2-7
TGTGCCAGCAGCACAGAGGCGTACGAGCAGTACTTC	CASSTEAYEQYF	TRBV7-4	TRBJ2-7
TGTGCCAGCAGTTCAGGCACTGAAGCTTTCTTT	CASSSGTEAFF	TRBV27	TRBJ1-1
TGTGCCAGCAGACTAGATGAAAAACTGTTTTTT	CASRLDEKLFF	TRBV6-5	TRBJ1-4
TGTGCCAGATTGATCCTATTCCGGACTAGGGGGGCGGAGTACGAGCAGTACTTC	CARLILFRTRGAEYEQYF	TRBV19	TRBJ2-7
TGTGCCAGCAGTTTATGTGATGGACCACAGGGTCAGGATATCTACGAGCAGTACTTC	CASSLCDGPQGQDIYEQYF	TRBV28	TRBJ2-7
TGTGCCAGCAGCTCACAGGGGAGGAACACTGAAGCTTTCTTT	CASSSQGRNTEAFF	TRBV9	TRBJ1-1
TGTGCCAGCACTGTGCTCATGGGGCCGACGCGGGCCGGCTACGAGCAGTACTTC	CASTVLMGPTRAGYEQYF	TRBV7-9	TRBJ2-7
TGTGCCAGCAGCTTCCCCGGACCCAGAGCTCGTATAGAACTGGCTGGAAACACCATATATTTT	CASSFPGPRARIELAGNTIYF	TRBV5-5	TRBJ1-3
TGTGCCAGCAGTGTAGCCGGGTGGGGAGGGAGCGAGTACCGAAAGACCAGCACTGAAGCTTTCTTT	CASSVAGWGGSEYRKTSTEAFF	TRBV2	TRBJ1-1
TGCGCCAGAGGAAACGACAATGAGCAGTTCTTC	CARGNDNEQFF	TRBV5-1	TRBJ2-1
TGCAGTGCTAGATCTGAGCGGGAGTTCAATTCACCCCTCCACTTT	CSARSEREFNSPLHF	TRBV20-1	TRBJ1-6
TGTGCCAGCAGTGTGCAGTCGGACCGGGGAAAGGCCTACGAGCAGTACTTC	CASSVQSDRGKAYEQYF	TRBV6-4	TRBJ2-7
TGTGCCAGCAGTTACCCCGGCAGGGGGGACGAGCAGTACTTC	CASSYPGRGDEQYF	TRBV6-5	TRBJ2-7
TGTGCCAGCAGCCTAGGAAGAGCGTACGAGCAGTACTTC	CASSLGRAYEQYF	TRBV13	TRBJ2-7
TGTGCCAGCAGCTCCCGGGCCCGGACTAGCGGGAGGGCCTACGAGCAGTACTTC	CASSSRARTSGRAYEQYF	TRBV9	TRBJ2-7
TGTGCCAGCAGTGAAAACAGGGTCGTGTCCTACGAGCAGTACTTC	CASSENRVVSYEQYF	TRBV25-1	TRBJ2-7
TGTGCCAGCAGTTTCCGACGGGACTATAAGTCTAGTAGCACAGATACGCAGTATTTT	CASSFRRDYKSSSTDTQYF	TRBV27	TRBJ2-3
TGTGCCACCAGTGAGTCCACGACCCTGTTGAACACTGAAGCTTTCTTT	CATSESTTLLNTEAFF	TRBV24-1	TRBJ1-1
TGTGCCAGCAGAAGTGGACACACTGAAGCTTTCTTT	CASRSGHTEAFF	TRBV12-4	TRBJ1-1
TGTGCCTGGAGTGTAACGTGGACAGTTCTCGCGGGAGGGCGTTTCGAGGGGAACACTGAAGCTTTCTTT	CAWSVTWTVLAGGRFEGNTEAFF	TRBV30	TRBJ1-1
TGTGCCAGCAGGGACCCCGGGGAGCTGTTTTTT	CASRDPGELFF	TRBV27	TRBJ2-2
TGTGCCAGCAGTGAAAAATTAACGACCTGTAATTCACCCCTCCACTTT	CASSEKLTTCNSPLHF	TRBV6-1	TRBJ1-6
TGTGCCAGCAGTTTCCAGGGGTGGAGTAATGGCTACACCTTC	CASSFQGWSNGYTF	TRBV12-3	TRBJ1-2
TGTGCCAGCAGCCAAGGCATTAAGGTCGAAAAACTGTTTTTT	CASSQGIKVEKLFF	TRBV11-3	TRBJ1-4
TGTGCCAGCAGCGGAATGTTGACAGGGCTGAGAAGGGAGGGGACCGGGGAGCTGTTTTTT	CASSGMLTGLRREGTGELFF	TRBV11-3	TRBJ2-2
TGTGCCAGCAGTTATAGCCGGGGCTTTAACTTC	CASSYSRGFNF	TRBV27	TRBJ2-7
TGCGCCAGCAGTGAGTGGGGGGGACCAGGGAACACTGAAGCTTTCTTT	CASSEWGGPGNTEAFF	TRBV10-2	TRBJ1-1
TGTGCCAGCAGTTGTGACAGGCGAAGGGATACAAGGTGCGCAGCCAATCAGCCCCAGCATTTT	CASSCDRRRDTRCAANQPQHF	TRBV28	TRBJ1-5
TGTGCCACCAGTTTAAGCGGCGACAGGGGGGGGGCCTACGAGCAGTACTTC	CATSLSGDRGGAYEQYF	TRBV24-1	TRBJ2-7
TGTGCCAGCAGTGGGACAGGGGGGGGGAGCTCCTACGAGCAGTACTTC	CASSGTGGGSSYEQYF	TRBV6-1	TRBJ2-7
TGTGCCAGCAGCTTAGGAGGGGGACGGTCGAACACTGAAGCTTTCTTT	CASSLGGGRSNTEAFF	TRBV7-9	TRBJ1-1
TGCGCTAGGGAAGGCCGCGGGGAGCTGTTTTTT	CAREGRGELFF	TRBV5-1	TRBJ2-2
TGTGCCAGCAGCACGCCTCCTCCGACCTACAATGAGCAGTTCTTC	CASSTPPPTYNEQFF	TRBV7-3	TRBJ2-1
TGCAGCGTAAGAAGTGAAAAACTGTTTTTT	CSVRSEKLFF	TRBV29-1	TRBJ1-4
TGCGCCAGCAGGAGCTTGGGACTAGACGAGCAGTACTTC	CASRSLGLDEQYF	TRBV5-1	TRBJ2-7
TGTGCCAGCCCCGGAGGGGGGCTCGGCTATGGCTACACCTTC	CASPGGGLGYGYTF	TRBV6-5	TRBJ1-2
TGTGCCAGCAGCCAAGATCGATCCGGGACACCTACTGAAGCTTTCTTT	CASSQDRSGTPTEAFF	TRBV3-1	TRBJ1-1
TGTGCTAGCAGCTACAGGGCCATCAACGGCACAGATACGCAGTATTTT	CASSYRAINGTDTQYF	TRBV7-7	TRBJ2-3
TGTGCCACCAGTGATTTGCTAACTGGACAGGAGCATGAGCAGTTCTTC	CATSDLLTGQEHEQFF	TRBV24-1	TRBJ2-1
TGTGCCAGCAGCGTACGGAGCGCTGGGGGGGGGCGGGCAGATACGCAGTATTTT	CASSVRSAGGGRADTQYF	TRBV9	TRBJ2-3
TGTGCCAGCACAAGGACAGGGGCGGACTCTGGAAACACCATATATTTT	CASTRTGADSGNTIYF	TRBV27	TRBJ1-3
TGTGCCAGCAGTGACCCGCCCTGGGGTGAATCTGGGGCCAACGTCCTGACTTTC	CASSDPPWGESGANVLTF	TRBV6-4	TRBJ2-6
TGTGCCCCCAGGGGGCTATTTCGCACAGATACGCAGTATTTT	CAPRGLFRTDTQYF	TRBV7-9	TRBJ2-3
TGCAGTGCTCCCCGGAGGGGGGGTGTCAATCAGCCCCAGCATTTT	CSAPRRGGVNQPQHF	TRBV20-1	TRBJ1-5
TGTGCCAGCAGTTCCGTAGGGTGTAGCCATTACGAGCAGTACTTC	CASSSVGCSHYEQYF	TRBV27	TRBJ2-7
TGCAGTGCAAAGGGGAAGGAGACCCAGTACTTC	CSAKGKETQYF	TRBV20-1	TRBJ2-5
TGTGCCAGCAGTTACTCCACGGGAGTCAGGGGGACTTCTGGAAACACCATATATTTT	CASSYSTGVRGTSGNTIYF	TRBV6-3	TRBJ1-3
TGTGCCAGCAGTTACGAGGGGGATAGCAATCAGCCCCAGCATTTT	CASSYEGDSNQPQHF	TRBV6-5	TRBJ1-5
TGTGCCAGCAGCCTCGGGGGTATGACGGAAAAACTGTTTTTT	CASSLGGMTEKLFF	TRBV3-1	TRBJ1-4
TGCGCCAGCAGCCAAGAGGGGGCCGGGGGGTTCGGCTACGAGCAGTACTTC	CASSQEGAGGFGYEQYF	TRBV4-3	TRBJ2-7
TGTGCCAGCAGTTACCACAAGCGCCAAGAGACCCAGTACTTC	CASSYHKRQETQYF	TRBV6-2	TRBJ2-5
TGTGCCAAAGGAGGGCCTAGGTGTGACAATGAGCAGTTCTTC	CAKGGPRCDNEQFF	TRBV12-3	TRBJ2-1
TGCGCCAGCAGCTCCCGCAGGGGGCGCTTCGGGTTTTACAATGAGCAGTTCTTC	CASSSRRGRFGFYNEQFF	TRBV10-1	TRBJ2-1
TGTGCCAGCAGCACCGGGATTAGCGTTCAGCCCCAGCATTTT	CASSTGISVQPQHF	TRBV6-1	TRBJ1-5
TGTGCCAGCAGCCAACCCGGGCCCGCTTTCTTT	CASSQPGPAFF	TRBV5-6	TRBJ1-1
TGTGCCAGCCGGGACAGGGAGGAGCGCTACGAGCAGTACTTC	CASRDREERYEQYF	TRBV6-4	TRBJ2-7
TGTGCCAGCAGCATCTCACTCGGGAGTATAAGAAACACCATATATTTT	CASSISLGSIRNTIYF	TRBV7-3	TRBJ1-3
TGTGCCACCAGCAGAGATAGGGGCCGGGACAGGGGGGATGAGCAGTTCTTC	CATSRDRGRDRGDEQFF	TRBV15	TRBJ2-1
TGTGCCAGCAGTGAGTTATCAGGTGCAATTGACTATGGCTACACCTTC	CASSELSGAIDYGYTF	TRBV6-1	TRBJ1-2
TGTGCCACCAGTGTGAACCTGGCGGAAGCCCGCGGGAGAAATTACTACTCCTACAATGAGCAGTTCTTC	CATSVNLAEARGRNYYSYNEQFF	TRBV24-1	TRBJ2-1
TGTGCCAGCAGTGGAGGGGACAGGGCTTTCTTT	CASSGGDRAFF	TRBV6-4	TRBJ1-1
TGTGCCAGCAGCTTAGGTTCTCCCCTAGACAGAGACCTTAGCAATCAGCCCCAGCATTTT	CASSLGSPLDRDLSNQPQHF	TRBV7-4	TRBJ1-5
TGTGCCAGCAGTGGACAGCCTGATGGCTACACCTTC	CASSGQPDGYTF	TRBV6-5	TRBJ1-2
TGTGCCAGCAGTAGTGGGGGTGTTCGTAACTATGGCTACACCTTC	CASSSGGVRNYGYTF	TRBV28	TRBJ1-2
TGTGCCAGTTCGGGGGAGTACGAGCAGTACTTC	CASSGEYEQYF	TRBV19	TRBJ2-7
TGTGCCAGCAGCGTCCTTTGTGCTGGGGGGGTTTTTTCTTACGAGCAGTACTTC	CASSVLCAGGVFSYEQYF	TRBV9	TRBJ2-7
TGTGCCAGCAGTTTGGAAGCTAGCGGGAATTCCCAAGAGACCCAGTACTTC	CASSLEASGNSQETQYF	TRBV28	TRBJ2-5
TGTGCCAGCAGCCTCAAGGGACTAGCGGGCATCAGCACAGATACGCAGTATTTT	CASSLKGLAGISTDTQYF	TRBV11-2	TRBJ2-3
TGCAGTGCTAGAGTCACGGGAGATACCGAGCAGTACTTC	CSARVTGDTEQYF	TRBV20-1	TRBJ2-7
TGTGCTACATCCAGCTGGAAACACAGGGTGGGCCGAACTGAAGCTTTCTTT	CATSSWKHRVGRTEAFF	TRBV12-5	TRBJ1-1
TGTGCCAGCAGGCCCCACGGAGCGGGAACTCATACGCAGTATTTT	CASRPHGAGTHTQYF	TRBV28	TRBJ2-3
TGTGCTAGTGGTTTGGTAACTAACTCCAATCAGCCCCAGCATTTT	CASGLVTNSNQPQHF	TRBV12-5	TRBJ1-5
TGTGCCAGCAGGGACGCGAGCCTAAGCAATCAGCCCCAGCATTTT	CASRDASLSNQPQHF	TRBV2	TRBJ1-5
TGTGCTAGCAGCTTAACACACTGGACAGGGACGTTGACTGAAGCTTTCTTT	CASSLTHWTGTLTEAFF	TRBV7-7	TRBJ1-1
TGTGCCAGCAGCTTAGAACTAGAGGGACTAGCGGGGCAGCAAGAGACCCAGTACTTC	CASSLELEGLAGQQETQYF	TRBV7-9	TRBJ2-5
TGTGCCAGGGACAAAGATGAAAAACTGTTTTTT	CARDKDEKLFF	TRBV27	TRBJ1-4
TGTGCCAGCCCCCGGGGGCAAGAGACCCAGTACTTC	CASPRGQETQYF	TRBV9	TRBJ2-5
TGTGCCAGCAGCTTAGGCTCGGGGGATCGGCCACCCCTCCACTTT	CASSLGSGDRPPLHF	TRBV7-2	TRBJ1-6
TGTGCCAGAACACTAGCGGTCCTCATCTTC	CARTLAVLIF	TRBV6-4	TRBJ2-1
TGTGCCAGCAGTTACCAAGGGGGGGGCAATGGCTACACCTTC	CASSYQGGGNGYTF	TRBV6-1	TRBJ1-2
TGTGCCAGCAGCTTAGGCAACCTGGCCTCTGGGGCCAACGTCCTGACTTTC	CASSLGNLASGANVLTF	TRBV7-6	TRBJ2-6
TGTGCCAGCAGTTTCCAGACCCAGGGGAGCTGCGCGAACACCGGGGAGCTGTTTTTT	CASSFQTQGSCANTGELFF	TRBV12-4	TRBJ2-2
TGTGCCAGCAGAACAACTAGACGTTACGAGCAGTACTTC	CASRTTRRYEQYF	TRBV12-3	TRBJ2-7
TGCGCCAGCAGCTTGTTTGGAAGGACAGGGGCTAGCTACGAGCAGTACTTC	CASSLFGRTGASYEQYF	TRBV5-1	TRBJ2-7
TGTGCCACCAGGCTTTGCGAGGTGGCGTGGGGGTCCTATAATTCACCCCTCCACTTT	CATRLCEVAWGSYNSPLHF	TRBV15	TRBJ1-6
TGTGCCAGCAGCATCCTTAGAGACCATAGCACAGATACGCAGTATTTT	CASSILRDHSTDTQYF	TRBV7-9	TRBJ2-3
TGCAGTCAGGGGAGGTTCACTGAAGCTTTCTTT	CSQGRFTEAFF	TRBV20-1	TRBJ1-1
TGTGCCAGCAGGGAAGAGCGACAGGGCCAAGAGACCCAGTACTTC	CASREERQGQETQYF	TRBV7-6	TRBJ2-5
TGTGCCAGCTCACCACCTAACATGCGCGGACAGCCTACCTCCTACGAGCAGTACTTC	CASSPPNMRGQPTSYEQYF	TRBV18	TRBJ2-7
TGTGCCAGCAGTCCGGACAGATCTGGAAACACCATATATTTT	CASSPDRSGNTIYF	TRBV6-3	TRBJ1-3
TGTGCCACTAGGGATGGCTACACCTTC	CATRDGYTF	TRBV6-5	TRBJ1-2
TGTGCTAGTGGTTTCAAAACGGGGGGCAAGCGGCCCTACAATGAGCAGTTCTTC	CASGFKTGGKRPYNEQFF	TRBV12-5	TRBJ2-1
TGTGCCAGCAGCGGCCGAGGGGGCCACAATGAGCAGTTCTTC	CASSGRGGHNEQFF	TRBV5-5	TRBJ2-1
TGTGCCACCAGGACTAGGGGAGATACGCAGTATTTT	CATRTRGDTQYF	TRBV24-1	TRBJ2-3
TGTGCCAGCAGACAGGGGGGTGTAAACATTCAGTACTTC	CASRQGGVNIQYF	TRBV6-5	TRBJ2-4
TGTGCCAGCAGTTACACCGAGGTCGTGACACAAAACATTCAGTACTTC	CASSYTEVVTQNIQYF	TRBV6-2	TRBJ2-4
TGCAGTGCTAGAAAGGGAGGGAGGCTTCCCAATGAGCAGTTCTTC	CSARKGGRLPNEQFF	TRBV20-1	TRBJ2-1
TGTGCCACCAGGGGTTCACCCCTCCACTTT	CATRGSPLHF	TRBV15	TRBJ1-6
TGTGCCAGCAGAGGTTGGGGACAGGGCACCGGGGAGCTGTTTTTT	CASRGWGQGTGELFF	TRBV3-1	TRBJ2-2
TGTGCCACCAACGGGCTGACAAAGCGGGGTATGGAGGACTATGGCTACACCTTC	CATNGLTKRGMEDYGYTF	TRBV24-1	TRBJ1-2
TGTGCCAGCCTGCTGAAGGACAGGGGGGGATGTGATACGCAGTATTTT	CASLLKDRGGCDTQYF	TRBV27	TRBJ2-3
TGTGCCAGCAGGGGGACAGGGAGGTCTGAAAAACTGTTTTTT	CASRGTGRSEKLFF	TRBV6-4	TRBJ1-4
TGTGCCAGCAGTTTCCTAGCGGCGAACTGGGACAATGAGCAGTTCTTC	CASSFLAANWDNEQFF	TRBV6-5	TRBJ2-1
TGTGCCAGCTACTTGGGACAGGTGACGCAGTATTTT	CASYLGQVTQYF	TRBV6-1	TRBJ2-3
TGTGCCAGCAGGACAGGGATACACCAAGAGACCCAGTACTTC	CASRTGIHQETQYF	TRBV6-5	TRBJ2-5
TGCAGTGCTAGACCCATATGTCCCATCACAGATACGCAGTATTTT	CSARPICPITDTQYF	TRBV20-1	TRBJ2-3
TGTGCCAGCAGTGAATATCCACGCGGGTCTAACTATGGCTACACCTTC	CASSEYPRGSNYGYTF	TRBV25-1	TRBJ1-2
TGTGCCAGCAGTCACCAGGGGTGCGGGTCCTACAATGAGCAGTTCTTC	CASSHQGCGSYNEQFF	TRBV11-2	TRBJ2-1
TGCAGTGCGGGCCCAGACGCGAACACTGAAGCTTTCTTT	CSAGPDANTEAFF	TRBV20-1	TRBJ1-1
TGTGCCAGCAGCGTTCTCTGGGGCCGGGCTGAAGCTTTCTTT	CASSVLWGRAEAFF	TRBV9	TRBJ1-1
TGCGCCAGCAGCATTCGGGACAGTAGGTCCCCCCACTCTGGAAACACCATATATTTT	CASSIRDSRSPHSGNTIYF	TRBV5-1	TRBJ1-3
TGTGCCAGCAGTTACTCCACCTTGGACAGGGGTAACGAGCAGTACTTC	CASSYSTLDRGNEQYF	TRBV6-3	TRBJ2-7
TGCAGTGCGGAAGCGGACAGGGTAGACACCGGGGAGCTGTTTTTT	CSAEADRVDTGELFF	TRBV20-1	TRBJ2-2
TGTGCCAGCAGCGGCACAGGGTGGATGAACACTGAAGCTTTCTTT	CASSGTGWMNTEAFF	TRBV5-6	TRBJ1-1
TGTGCCAGCAGCAAAAAGGGGGGGAGGTATAATGAAAAACTGTTTTTT	CASSKKGGRYNEKLFF	TRBV7-3	TRBJ1-4
TGCAGCCAGGGCGGAAAGTACTTC	CSQGGKYF	TRBV20-1	TRBJ2-7
TGTGCCAGCAGTTTATCCCGTGTAGGACGACCTGGCGGAAACACCATATATTTT	CASSLSRVGRPGGNTIYF	TRBV28	TRBJ1-3
TGTGCCAGCAGATCGCGAGGGTACGGCTCCTACGAGCAGTACTTC	CASRSRGYGSYEQYF	TRBV2	TRBJ2-7
TGTGCTAGCAGCCGCGCCGGGACGAGCTCCTATAATTCACCCCTCCACTTT	CASSRAGTSSYNSPLHF	TRBV7-7	TRBJ1-6
TGTGCCAGCAGTCAGGCTTTTGGCTACACCTTC	CASSQAFGYTF	TRBV12-3	TRBJ1-2
TGTGCCAGCAGCTTGGGTCCGTCCGAGTCGGGCCGCTACGAGCAGTACTTC	CASSLGPSESGRYEQYF	TRBV7-4	TRBJ2-7
TGCGCCAGCAGCCAACCAACAGACGCCTACGAGCAGTACTTC	CASSQPTDAYEQYF	TRBV4-3	TRBJ2-7
TGTGCCAGCAGGACAGATGAAGCTTTCTTT	CASRTDEAFF	TRBV6-5	TRBJ1-1
TGTGCCAGCAGTAGAGGGGACAGAGAGCTTGGGTGCTTAGCCGTCTGGGAGAACACTGAAGCTTTCTTT	CASSRGDRELGCLAVWENTEAFF	TRBV11-3	TRBJ1-1
TGTGCCAGAGGTATAGCGGATGGTACCCGCTCCTACGAGCAGTACTTC	CARGIADGTRSYEQYF	TRBV6-5	TRBJ2-7
TGTGCCAGCAGCGTAGAGTTGGGACAGGGGGGACCGGTTGCTTTCTTT	CASSVELGQGGPVAFF	TRBV9	TRBJ1-1
TGTGCCAGCAGACCAAGGACTGGACACACTGAAGCTTTCTTT	CASRPRTGHTEAFF	TRBV6-5	TRBJ1-1
TGTGCCAGCAGCAGTCCCCCCCCCCGCGGCCCCTACGAGCAGTACTTC	CASSSPPPRGPYEQYF	TRBV7-9	TRBJ2-7
TGTGCCAGCAGCCCCCTAGAGGGGGCTCGAAACCCCGGGGAGCTGTTTTTT	CASSPLEGARNPGELFF	TRBV7-2	TRBJ2-2
TGCGCCAGCAGGCCAGGGCTGGGCTACACCTTC	CASRPGLGYTF	TRBV4-1	TRBJ1-2
TGTGCCAGCAGTTCTAAAGAAGGGAATTCCACCGGGGAGCTGTTTTTT	CASSSKEGNSTGELFF	TRBV6-5	TRBJ2-2
TGTGCCACCAGTTCCGCCCTGGACAGGGTATTCTACGAGCAGTACTTC	CATSSALDRVFYEQYF	TRBV24-1	TRBJ2-7
TGTGCTAGCAGCTTATTAACCGTGGGAAGGTATGAAAAACTGTTTTTT	CASSLLTVGRYEKLFF	TRBV7-7	TRBJ1-4
TGCGCCAGCAGCCAAGACGGGGACAGCCCGGTCGAGCAGTACTTC	CASSQDGDSPVEQYF	TRBV4-1	TRBJ2-7
TGTGCCAGCAGGGACTCTCCTCATGAGCAGTTCTTC	CASRDSPHEQFF	TRBV2	TRBJ2-1
TGTGCCAGCAGCAGACGACGGTTCGAGCAGTACTTC	CASSRRRFEQYF	TRBV7-4	TRBJ2-7
TGCGCCAGCAGCCCCCTTTGGGACAGGGGGGAGGTCTACGAGCAGTACTTC	CASSPLWDRGEVYEQYF	TRBV5-1	TRBJ2-7
TGTGCCATCAGTGAGTCGGATCTGCAGGGAGCCGTGAGAGCCTACGAGCAGTACTTC	CAISESDLQGAVRAYEQYF	TRBV10-3	TRBJ2-7
TGTGCCAGCAGCGAATCTGTCGGCACCGGGGAGCTGTTTTTT	CASSESVGTGELFF	TRBV7-6	TRBJ2-2
TGTGCCAGCCCCCACAGGGTCTCAAGCTCTGGGGCCAACGTCCTGACTTTC	CASPHRVSSSGANVLTF	TRBV12-3	TRBJ2-6
TGTGCCAGCAGTGAAGCAGCCGGGACTAGCGGGAGTGGAAACTATGGCTACACCTTC	CASSEAAGTSGSGNYGYTF	TRBV2	TRBJ1-2
TGTGCCACCAGCAAGGGGGTAGCTAACTATGGCTACACCTTC	CATSKGVANYGYTF	TRBV24-1	TRBJ1-2
TGTGCCAGCAGCTTGAGTCCGGATGAGCAGTTCTTC	CASSLSPDEQFF	TRBV5-5	TRBJ2-1
TGTGCCAGCAGTGAAAGCGGGAGGGGGGGGGTGGACAATCAGCCCCAGCATTTT	CASSESGRGGVDNQPQHF	TRBV6-4	TRBJ1-5
TGTGCCTTGTCCCTTTTTGTGGAGACCCAGTACTTC	CALSLFVETQYF	TRBV24-1	TRBJ2-5
TGTGCCAGCAGATCAGGTGACAGGGAAACTTTCAAGGAGACCCAGTACTTC	CASRSGDRETFKETQYF	TRBV7-9	TRBJ2-5
TGTGCCAGCAGCTTAAACTGGACAGATACGCAGTATTTT	CASSLNWTDTQYF	TRBV7-4	TRBJ2-3
TGTGCCACACCAGGGGGGCGCTACGAGCAGTACTTC	CATPGGRYEQYF	TRBV15	TRBJ2-7
TGTGCCTGGAGTTCTCCGTCCCACGCAAAGTTCGGACAGACGAACACTGAAGCTTTCTTT	CAWSSPSHAKFGQTNTEAFF	TRBV30	TRBJ1-1
TGTGCCAGCAGCACGACGGGACTAGCGGGTAAGACAGATACGCAGTATTTT	CASSTTGLAGKTDTQYF	TRBV7-3	TRBJ2-3
TGTGCCAGCAGCGTCGACATCCAGGAAGGCCTCTACGAGCAGTACTTC	CASSVDIQEGLYEQYF	TRBV7-3	TRBJ2-7
TGTGCCAGCAGTGTCAGGACAGGGGGTCAGCCCCAGCATTTT	CASSVRTGGQPQHF	TRBV6-4	TRBJ1-5
TGCAGTGCTAGAGGGACCCTCCCATCCCCGAACACTGAAGCTTTCTTT	CSARGTLPSPNTEAFF	TRBV20-1	TRBJ1-1
TGTGCCAGCAGCCAAGTCTTGGGAGGGAGGGTCGGGGAGCTGTTTTTT	CASSQVLGGRVGELFF	TRBV3-1	TRBJ2-2
TGTGCCAGCTCACCGGGACTAAAGGACCCCTACACCGGGGAGCTGTTTTTT	CASSPGLKDPYTGELFF	TRBV18	TRBJ2-2
TGTGCCTGGAGTCAAGGAAGGACTGGAATTCAGCCCCAGCATTTT	CAWSQGRTGIQPQHF	TRBV30	TRBJ1-5
TGTGCCAGCAGTTGTAAACGACTAGCGGGTAAATCAGAGACCCAGTACTTC	CASSCKRLAGKSETQYF	TRBV27	TRBJ2-5
TGTGCCAGCAGCTTTTTAGCGGGGGCAAATGAGCAGTTCTTC	CASSFLAGANEQFF	TRBV7-9	TRBJ2-1
TGTGCTAGTGGTTTGGTATGTACTAGCGGGAGGAGGGTCATTCAGTACTTC	CASGLVCTSGRRVIQYF	TRBV12-5	TRBJ2-4
TGCGCCAGCAGCTTGGTAACTACATTTTTTCAGCCCCAGCATTTT	CASSLVTTFFQPQHF	TRBV5-1	TRBJ1-5
TGTGCCAGCAACTACAGGGCGGGGAACACTGAAGCTTTCTTT	CASNYRAGNTEAFF	TRBV27	TRBJ1-1
TGCAGTGCTCGGGGGGGTAACCAGGAGACCCAGTACTTC	CSARGGNQETQYF	TRBV20-1	TRBJ2-5
TGCGCCACAGGCCGGGACAGGGTGGCCGGGGAGCTGTTTTTT	CATGRDRVAGELFF	TRBV5-1	TRBJ2-2
TGTGCCAGCAGCCCCCGACAGGGATATAGCAATCAGCCCCAGCATTTT	CASSPRQGYSNQPQHF	TRBV7-9	TRBJ1-5
TGTGCCAGCAGCTCCACCCGGGGTGGCACCGGGGAGCTGTTTTTT	CASSSTRGGTGELFF	TRBV7-9	TRBJ2-2
TGTGCCTGGAGGATGATCGACAGGGGACGAAACACCATATATTTT	CAWRMIDRGRNTIYF	TRBV30	TRBJ1-3
TGTGCCAGCAGTTACTTCCGTCACGACTTGGAGCAGCCCCAGCATTTT	CASSYFRHDLEQPQHF	TRBV6-6	TRBJ1-5
TGTGCCTGGAGTGTACTAGGCTCGGGACAGGGGAACCCCCAGCATTTT	CAWSVLGSGQGNPQHF	TRBV30	TRBJ1-5
TGTGCCAGCAGCCAAGATCGGGTAGGGAGGAACTATGGCTACACCTTC	CASSQDRVGRNYGYTF	TRBV3-1	TRBJ1-2
TGCAGTGCTAGTCAGCGGCCCCTACATGCTCTGCATTTT	CSASQRPLHALHF	TRBV20-1	TRBJ1-5
TGTGCCAGCAGTCGAGCGGGAGGGGGGGCCGGTACCTACAATGAGCAGTTCTTC	CASSRAGGGAGTYNEQFF	TRBV6-5	TRBJ2-1
TGTGCCAGCAGTTTCGTGGGGACAGGGCTGGGGATCAAAGAGACCCAGTACTTC	CASSFVGTGLGIKETQYF	TRBV28	TRBJ2-5
TGTGCCAGCAGTGGGGGACAGGGGCTGGAGGATTCCACCGGGGAGCTGTTTTTT	CASSGGQGLEDSTGELFF	TRBV6-4	TRBJ2-2
TGCGCCAGCAGCCTAGCGGGAGATGAGCAGTTCTTC	CASSLAGDEQFF	TRBV5-1	TRBJ2-1
TGTGCCAGCAGCCGGAGGGACTTCCCTAGCACAGATACGCAGTATTTT	CASSRRDFPSTDTQYF	TRBV13	TRBJ2-3
TGTGCCACTGGACAGGGAGTCATTAGTACAGATACGCAGTATTTT	CATGQGVISTDTQYF	TRBV28	TRBJ2-3
TGCAGTGCCACAGGGGGACTAGAAGAGACCCAGTACTTC	CSATGGLEETQYF	TRBV20-1	TRBJ2-5
TGTGCCAGCAGCTTCCGGGACATGTATGGCTACACCTTC	CASSFRDMYGYTF	TRBV3-1	TRBJ1-2
TGCGCCAGCAGCTTTAGCCAGGAGCGGGCCTACGAGCAGTACTTC	CASSFSQERAYEQYF	TRBV5-1	TRBJ2-7
TGTGCCAGCGCCTTCCAGGGGTGGGATCACCCTTCACCCCTCCACTTT	CASAFQGWDHPSPLHF	TRBV14	TRBJ1-6
TGTGCCACCAGCAGAGATGTAAGAGGAGGACAGGGGTGGACTTACAATGAGCAGTTCTTC	CATSRDVRGGQGWTYNEQFF	TRBV15	TRBJ2-1
TGTGCCAGCAGCTGGGCGGGACAGGGAGGTAATCAGCCCCAGCATTTT	CASSWAGQGGNQPQHF	TRBV9	TRBJ1-5
TGTGCCAATCATCTAGAACACACAGATACGCAGTATTTT	CANHLEHTDTQYF	TRBV11-3	TRBJ2-3
TGCAGTGCTAGAGACGATTGGGACACACCTGCGAAAGAGACCCAGTACTTC	CSARDDWDTPAKETQYF	TRBV20-1	TRBJ2-5
TGTGCCAGCAGCCGCGGGAGGGGATATTCCGAGCAGTACTTC	CASSRGRGYSEQYF	TRBV6-5	TRBJ2-7
TGTGCCAGCAGCAGGCCAGACAGGGGAGTGAACACTGAAGCTTTCTTT	CASSRPDRGVNTEAFF	TRBV11-2	TRBJ1-1
TGTGCCAGCTCACCCAGGACTGGGGCCAACGTCCTGACTTTC	CASSPRTGANVLTF	TRBV18	TRBJ2-6
TGTGCCAGCAGCACCAAGGCTTGGGGTTCCTACGAGCAGTACTTC	CASSTKAWGSYEQYF	TRBV11-2	TRBJ2-7
TGTGCCAGCAGCCAAGCTAGCCGAGCTTCTCGGGCTAAGGACTCCTACGAGCAGTACTTC	CASSQASRASRAKDSYEQYF	TRBV14	TRBJ2-7
TGTGCCAGCAGGAGACAGGAACTGGAGACCCAGTACTTC	CASRRQELETQYF	TRBV6-1	TRBJ2-5
TGTGCCACCAGAAACGTTAGGGATACACAAGAGACCCAGTACTTC	CATRNVRDTQETQYF	TRBV24-1	TRBJ2-5
TGTGCCAGCAGTTACTCCATCTTACGGCTTAGTTCTAAGGGTAACTCTGGAAACACCATATATTTT	CASSYSILRLSSKGNSGNTIYF	TRBV6-2	TRBJ1-3
TGTGCCAGCAGTTACCGGACTAGGTCACACATTCAGTACTTC	CASSYRTRSHIQYF	TRBV6-5	TRBJ2-4
TGTGCCACCACAGGGGAAAAACTGTTTTTT	CATTGEKLFF	TRBV11-3	TRBJ1-4
TGTGCCAGCAGCTTGGCCGCAGAGGGCTACACCTTC	CASSLAAEGYTF	TRBV5-6	TRBJ1-2
TGTGCCAGCAGTTCGTGGGGGGTCGAGCAGTACTTC	CASSSWGVEQYF	TRBV27	TRBJ2-7
TGTGCCAGCAGTGAGCTATCCACGGACAGGACTGGAAACACCATATATTTT	CASSELSTDRTGNTIYF	TRBV6-4	TRBJ1-3
TGTGCCAGCAGTAAGGTCCCAGACAGGCGCAGCCGCACAGATACGCAGTATTTT	CASSKVPDRRSRTDTQYF	TRBV6-8	TRBJ2-3
TGTGCCAGCAGTTACGGCCGCTCACAGGGGGACTATGGCTACACCTTC	CASSYGRSQGDYGYTF	TRBV6-5	TRBJ1-2
TGCGCCAGCAGTGAGGGCCGGCCCAAGGAGACCCAGTACTTC	CASSEGRPKETQYF	TRBV10-1	TRBJ2-5
TGTGCCAGCAGCGACTTGGACGATACGCAGTATTTT	CASSDLDDTQYF	TRBV5-6	TRBJ2-3
TGTGCCAGCAAAATCGACGACAGCTCTGGGGCCAACGTCCTGACTTTC	CASKIDDSSGANVLTF	TRBV6-4	TRBJ2-6
TGTGCCAGCAGTGAAGCCATAATCTTCAATAAGCCGTCATTAGACAATGAGCAGTTCTTC	CASSEAIIFNKPSLDNEQFF	TRBV6-1	TRBJ2-1
TGCGCCAGCATGGAGGGTTCGGAGCAGTACTTC	CASMEGSEQYF	TRBV5-1	TRBJ2-7
TGTGCCAGCAAATCCAGAAGCGGGACAAGGAAGTACGAGCAGTACTTC	CASKSRSGTRKYEQYF	TRBV7-2	TRBJ2-7
TGCAGTGCTAGGGACTGTCGGGGACGGGAGCATTCAACTAATGAAAAACTGTTTTTT	CSARDCRGREHSTNEKLFF	TRBV20-1	TRBJ1-4
TGTGCCAGCAGCTTAGAGACCCTACGCAATCAGCCCCAGCATTTT	CASSLETLRNQPQHF	TRBV7-6	TRBJ1-5
TGTGCCAGCAGCACCCCCGTTAGGACCTTGTATGGCTACACCTTC	CASSTPVRTLYGYTF	TRBV13	TRBJ1-2
TGCAGCGTGACGATGGGAGATAGCAATCAGCCCCAGCATTTT	CSVTMGDSNQPQHF	TRBV29-1	TRBJ1-5
TGTGCCAGCAGTTTATTCGTGGGACAAGCCTACGAGCAGTACTTC	CASSLFVGQAYEQYF	TRBV27	TRBJ2-7
TGCAGTGCTCGACCTAACGACAGAACGGTAAGAAACTATGGCTACACCTTC	CSARPNDRTVRNYGYTF	TRBV20-1	TRBJ1-2
TGTGCCAGCCCCCACCTGCGACAGGGGGCTTGCTACGAGCAGTACTTC	CASPHLRQGACYEQYF	TRBV2	TRBJ2-7
TGTGCCAGCAGTTACTCGGGACAGGGGGGACACACCGGGGAGCTGTTTTTT	CASSYSGQGGHTGELFF	TRBV6-2	TRBJ2-2
TGTGCCTGGAGTACCGATTCCTCTCGGAGCCGGTGCACAGATACGCAGTATTTT	CAWSTDSSRSRCTDTQYF	TRBV30	TRBJ2-3
TGTGCCAGCAGCGGGCCCAAATCCGCGGAAAATCTCAATGAGCAGTTCTTC	CASSGPKSAENLNEQFF	TRBV7-3	TRBJ2-1
TGCGCCAGCAGCTTGGGATGCGGGAGGTCAGATACGCAGTATTTT	CASSLGCGRSDTQYF	TRBV5-1	TRBJ2-3
TGTGCCAGCATATTACGGGACGCTTTCTTT	CASILRDAFF	TRBV6-3	TRBJ1-1
TGTGCCAGCCGACAGGGGAGGGCTAACTATGGCTACACCTTC	CASRQGRANYGYTF	TRBV27	TRBJ1-2
TGCAGTGCAGAGGGAGGGCGACTTGACGAGCAGTACTTC	CSAEGGRLDEQYF	TRBV20-1	TRBJ2-7
TGCAGCGTTGTTTTGTTTTCAGGTCTACAATCCTACGAGCAGTACTTC	CSVVLFSGLQSYEQYF	TRBV29-1	TRBJ2-7
TGTGCCAGCAGCTTCGGGACAGGAGTAGGGAGCTACGAGCAGTACTTC	CASSFGTGVGSYEQYF	TRBV14	TRBJ2-7
TGTGCCACCAGTGATTTACTCACAAACACCGGGGAGCTGTTTTTT	CATSDLLTNTGELFF	TRBV24-1	TRBJ2-2
TGTGCCAGCACACTCTGGAGAGATCGGGGGTTCTATAATTCACCCCTCCACTTT	CASTLWRDRGFYNSPLHF	TRBV6-4	TRBJ1-6
TGTGCCAGCAGCTACCGGTGTGGTGGACAAAGATACGAGCAGTACTTC	CASSYRCGGQRYEQYF	TRBV5-4	TRBJ2-7
TGTGCCAGCAGCCAGGGGTTGGACACTGAAGCTTTCTTT	CASSQGLDTEAFF	TRBV3-1	TRBJ1-1
TGTGCCACCAGCAGAGCTAGGGGCTCTGGGGCCAACGTCCTGACTTTC	CATSRARGSGANVLTF	TRBV15	TRBJ2-6
TGTGCCAGCAGAGGGGGAGGACCCAACCGCTGCGAGCAGTACTTC	CASRGGGPNRCEQYF	TRBV6-2	TRBJ2-7
TGTGCCCCAGGGGGCAAAGATAGCAATCAGCCCCAGCATTTT	CAPGGKDSNQPQHF	TRBV19	TRBJ1-5
TGCAGTGCTAGCGCACCCGACAGGGACACTGAAGCTTTCTTT	CSASAPDRDTEAFF	TRBV20-1	TRBJ1-1
TGTGCCAGCAGTTTCGGACCAAACACTGAAGCTTTCTTT	CASSFGPNTEAFF	TRBV6-1	TRBJ1-1
TGCGCCGCAGCAGGGCGAAGAGGAGATACGCAGTATTTT	CAAAGRRGDTQYF	TRBV10-1	TRBJ2-3
TGTGCCAGCAGAAGCGGGATAGACTTCGTGCAGTACTTC	CASRSGIDFVQYF	TRBV6-5	TRBJ2-7
TGTGCTAGTGGTCGCTCGCGAGACAGGGCCTGGGTACTGCAGTACTTC	CASGRSRDRAWVLQYF	TRBV12-5	TRBJ2-7
TGTGCCAGCAGTGGGGTGCGCGACACCGGGGAGCTGTTTTTT	CASSGVRDTGELFF	TRBV6-4	TRBJ2-2
TGTGCCACCATTGGGGGGGCCCAGGCATCTAGCACAGATACGCAGTATTTT	CATIGGAQASSTDTQYF	TRBV24-1	TRBJ2-3
TGCAGTGCTGGGCCTCTGCGTACCGGGACTAGCGGGTCCCAAGAGACCCAGTACTTC	CSAGPLRTGTSGSQETQYF	TRBV20-1	TRBJ2-5
TGTGCCAGCACGCCGGCTGGGGGGCCGAGCAATCAGCCCCAGCATTTT	CASTPAGGPSNQPQHF	TRBV7-8	TRBJ1-5
TGTGCCAGCAGAGCGGTAGCCCCCGGGGTCGAGGACAATGAGCAGTTCTTC	CASRAVAPGVEDNEQFF	TRBV6-2	TRBJ2-1
TGTGCCAGCAGTTCCTGGCAACCGTCCCGGACTAGCGGGGGAGGCTACGAGCAGTACTTC	CASSSWQPSRTSGGGYEQYF	TRBV12-3	TRBJ2-7
TGTGCCAGCAGTGCGGGGGCGCGGATGGACTCTGGAAACACCATATATTTT	CASSAGARMDSGNTIYF	TRBV6-1	TRBJ1-3
TGTGCCAGTAGTAGGGACAGGGGGTACAACGAGCAGTACTTC	CASSRDRGYNEQYF	TRBV19	TRBJ2-7
TGTGCCAGCAGTCCACAGGGGTTCTACGAGCAGTACTTC	CASSPQGFYEQYF	TRBV12-4	TRBJ2-7
TGTGCCAGCAGCGCGGGAGGGATGACTGAAGCTTTCTTT	CASSAGGMTEAFF	TRBV13	TRBJ1-1
TGTGCCAGCAGCTTACGAAACGGGGTAGGGCAAGAGACCCAGTACTTC	CASSLRNGVGQETQYF	TRBV7-4	TRBJ2-5
TGTGCCAGCGGGCATTCTCCATACCCGTACGAGCAGTACTTC	CASGHSPYPYEQYF	TRBV27	TRBJ2-7
TGTGCCAGCAGCCACAGGGATTCGAACACTGAAGCTTTCTTT	CASSHRDSNTEAFF	TRBV7-9	TRBJ1-1
TGTGCCAGCAGCTTAATGGAGGCGAGTCACTTCACTGAAGCTTTCTTT	CASSLMEASHFTEAFF	TRBV7-3	TRBJ1-1
TGCGCCAGCCCTGCGGTCCGACCTCACTCTGGGGCCAACGTCCTGACTTTC	CASPAVRPHSGANVLTF	TRBV10-2	TRBJ2-6
TGTGCCAGCAGGGGTTGGGAATGTCAGCGGGATTATGAGCAGTTCTTC	CASRGWECQRDYEQFF	TRBV7-6	TRBJ2-1
TGTGCCAGCAGTCGCTGTGAGCAGTACTTC	CASSRCEQYF	TRBV12-3	TRBJ2-7
TGCGCCAGCAGCTTGGGCGTCCTGAGGCCGATCAATGAGCAGTTCTTC	CASSLGVLRPINEQFF	TRBV5-1	TRBJ2-1
TGTGCCAGCAGCTTCTCCTTCGCCATGGCATGCTACGAGCAGTACTTC	CASSFSFAMACYEQYF	TRBV11-2	TRBJ2-7
TGTGCCAGCAGCCAAGAAGGACAGGGGACTCGGGCTGCGACGAACACTGAAGCTTTCTTT	CASSQEGQGTRAATNTEAFF	TRBV14	TRBJ1-1
TGTGCCAGTAGTCCTGGTCGGGCAGGAGGGGGATACGAGCAGTACTTC	CASSPGRAGGGYEQYF	TRBV19	TRBJ2-7
TGTGCCAGCAGCCCACCGGACAGGGGTCTCACTGAAGCTTTCTTT	CASSPPDRGLTEAFF	TRBV14	TRBJ1-1
TGTGCCAGCAGTGCCGAGGGGGAGGACGCCTACGAGCAGTACTTC	CASSAEGEDAYEQYF	TRBV2	TRBJ2-7
TGTGCCAGCAGCCTCCCCGGGACCTCTGGAAACACCATATATTTT	CASSLPGTSGNTIYF	TRBV14	TRBJ1-3
TGCGCCAGCAGCTTGCCTTGTTCGAGGCACGAGCAGTACTTC	CASSLPCSRHEQYF	TRBV5-1	TRBJ2-7
TGTGCCAGCAGCGGGACACTAATAGCGGGCTCCTACAATGAGCAGTTCTTC	CASSGTLIAGSYNEQFF	TRBV3-1	TRBJ2-1
TGTGCCAGCAGCCAAGGTTCAGACCCGGAAGCTTTCTTT	CASSQGSDPEAFF	TRBV3-1	TRBJ1-1
TGTGCCACCAGATTAAAGGACCCTACTAGCACAGATACGCAGTATTTT	CATRLKDPTSTDTQYF	TRBV24-1	TRBJ2-3
TGTGCCAGCAGCCCCCGACAGTATAGCAATCAGCCCCAGCATTTT	CASSPRQYSNQPQHF	TRBV7-4	TRBJ1-5
TGTGCCAGCAGCGGTACTAGCGAGCGGTCCTACGAGCAGTACTTC	CASSGTSERSYEQYF	TRBV7-4	TRBJ2-7
TGTGCCATCAGTTCAAGGAGTTCAGATACGCAGTATTTT	CAISSRSSDTQYF	TRBV10-3	TRBJ2-3
TGTGCCAGCTCACCAAGGGGTGACACTGAAGCTTTCTTT	CASSPRGDTEAFF	TRBV18	TRBJ1-1
TGTGCCAGCAGCTACCCCCGACAGGGGCTCTATGGCTACACCTTC	CASSYPRQGLYGYTF	TRBV5-4	TRBJ1-2
TGCGCCAGCAGCATTCTCCTAGGCCATAGGGTGAATGAAAAACTGTTTTTT	CASSILLGHRVNEKLFF	TRBV4-3	TRBJ1-4
TGTGCCAGCAGCAGGGACACCTATAGCAATCAGCCCCAGCATTTT	CASSRDTYSNQPQHF	TRBV13	TRBJ1-5
TGCGCCAGCACGTCGGTCGGACTAGCGGGGGGGCCTACCGGGGAGCTGTTTTTT	CASTSVGLAGGPTGELFF	TRBV5-1	TRBJ2-2
TGTGCCAGCAGCTTAGGCGAGCTTGATCAGCCCCAGCATTTT	CASSLGELDQPQHF	TRBV7-4	TRBJ1-5
TGTGCCAGCAGCTTAGGAGGCGCCCCCACAGATACGCAGTATTTT	CASSLGGAPTDTQYF	TRBV7-8	TRBJ2-3
TGTGCCAGCAGTGCCGCGGGCTATAGCAATCAGCCCCAGCATTTT	CASSAAGYSNQPQHF	TRBV6-4	TRBJ1-5
TGCAGTGCTAGAGCGGGACAGTGTCATATATACTACGAGCAGTACTTC	CSARAGQCHIYYEQYF	TRBV20-1	TRBJ2-7
TGTGCCAGCAGCCATTGTTCGGGGAACAATGAGCAGTTCTTC	CASSHCSGNNEQFF	TRBV14	TRBJ2-1
TGTGCCAGCTCACGCATCGTCAAGGGACAGGGAGGAATGAACACTGAAGCTTTCTTT	CASSRIVKGQGGMNTEAFF	TRBV18	TRBJ1-1
TGTGCCAGCAGCTGGCCCAGTCTAGCGGGACTAAGCTCTGGGGCCAACGTCCTGACTTTC	CASSWPSLAGLSSGANVLTF	TRBV9	TRBJ2-6
TGTGCCAGCAGCGATCCAATAGAGCCGGGACAGGGTCGAGACTACGAGCAGTACTTC	CASSDPIEPGQGRDYEQYF	TRBV7-8	TRBJ2-7
TGTGCCAGCAGCTTTCCAAGGACAGGGGGCGAGACCCAGTACTTC	CASSFPRTGGETQYF	TRBV7-9	TRBJ2-5
TGTGCCAGCAGCTTAGGCCGGGTTGGCACAGATACGCAGTATTTT	CASSLGRVGTDTQYF	TRBV7-9	TRBJ2-3
TGTGCCAGCAGAGTGGGACTTGCCCACGAGCAGTACTTC	CASRVGLAHEQYF	TRBV7-3	TRBJ2-7
TGTGCCAGCAGCTTAGCCAGGGTCTGTATTCCGTACCAAGAGACCCAGTACTTC	CASSLARVCIPYQETQYF	TRBV7-9	TRBJ2-5
TGTGCCAGCAGCCAAGATTGTCTGAAGGTATTGAACTTGGTTAATCAGCCCCAGCATTTT	CASSQDCLKVLNLVNQPQHF	TRBV14	TRBJ1-5
TGTGCCAGCAGCAGTCGGGGCGAGACCCAGTACTTC	CASSSRGETQYF	TRBV7-7	TRBJ2-5
TGCGCCAGCTCCCATGTAGACAGGGTCCCGAACACTGAAGCTTTCTTT	CASSHVDRVPNTEAFF	TRBV5-1	TRBJ1-1
TGTGCCAGCAGTCCGGCGAGCGCTGAAGCTTTCTTT	CASSPASAEAFF	TRBV6-1	TRBJ1-1
TGTGCCAGCAGCTTAGCCCCTGGGGGTACTAATCAGCCCCAGCATTTT	CASSLAPGGTNQPQHF	TRBV7-4	TRBJ1-5
TGTGCCAGCAGCCCGTGGGTAGGCTATGGCTACACCTTC	CASSPWVGYGYTF	TRBV9	TRBJ1-2
TGTGCCAGCAGCCGTCGTAATGGCTACACCTTC	CASSRRNGYTF	TRBV3-1	TRBJ1-2
TGTGCCAGCAGTTTATTTACAGGGGGGTATGGTGCTTTCTTT	CASSLFTGGYGAFF	TRBV27	TRBJ1-1
TGTGCCAGCAGCGGACCCCGGGGGTATGGCTACACCTTC	CASSGPRGYGYTF	TRBV7-9	TRBJ1-2
TGCAGTGCTCCCAGGCCGGGACTAGCGGGGGTAAGGTTCGGGGGCTACAATGAGCAGTTCTTC	CSAPRPGLAGVRFGGYNEQFF	TRBV20-1	TRBJ2-1
TGTGCCAGGAGAGAGGACAGGGGCGGGACGCGCAATCAGCCCCAGCATTTT	CARREDRGGTRNQPQHF	TRBV10-3	TRBJ1-5
TGTGCCAGACAGGGTAGCGAAACGAACACCGGGGAGCTGTTTTTT	CARQGSETNTGELFF	TRBV6-1	TRBJ2-2
TGTGCGTCATCTACCCGGGAGCAGGCCCCCGCTGAAGCTTTCTTT	CASSTREQAPAEAFF	TRBV9	TRBJ1-1
TGCAGCTTTCCCGCGGGAGCTGTGTCCGAGGCGTATAGCAATCAGCCCCAGCATTTT	CSFPAGAVSEAYSNQPQHF	TRBV29-1	TRBJ1-5
TGTGCCAGCAGTGAAGGTCTGACCAGCCTCTATGGCTACACCTTC	CASSEGLTSLYGYTF	TRBV6-1	TRBJ1-2
TGTGCCAGCAGTCGCCGGCGAGAAAAACTGTTTTTT	CASSRRREKLFF	TRBV6-2	TRBJ1-4
TGCGCCAGCAGCTGGAGATCGTGTAATGAAAAACTGTTTTTT	CASSWRSCNEKLFF	TRBV5-1	TRBJ1-4
TGTGCCAGCAGCAGTCGGGCGCGAGGAAACACCATATATTTT	CASSSRARGNTIYF	TRBV7-4	TRBJ1-3
TGTGCCACCAGCAGAGGAAGACTAGCGGGAGCCTACAATGAGCAGTTCTTC	CATSRGRLAGAYNEQFF	TRBV15	TRBJ2-1
TGTGCCTGGGCCGCAGTCCCGTACGAGCAGTACTTC	CAWAAVPYEQYF	TRBV30	TRBJ2-7
TGTGCCAGCAGTTTACTTGCCCCAAGGACTGAGACCCAGTACTTC	CASSLLAPRTETQYF	TRBV27	TRBJ2-5
TGCGCCAGCAGTGAGGTCATCCAGGGTAAGTACGAGCAGTACTTC	CASSEVIQGKYEQYF	TRBV10-1	TRBJ2-7
TGTGCCTGCCGCCCGAGGGGGGGCCAACACACCGGGGAGCTGTTTTTT	CACRPRGGQHTGELFF	TRBV30	TRBJ2-2
TGTGCCAGCAGTTACTCGCCGAGACAGGGGGCTGGAAACACCATATATTTT	CASSYSPRQGAGNTIYF	TRBV6-2	TRBJ1-3
TGTGCCAGCAGTTACTCGGGACCACGTTCCTACGAGCAGTACTTC	CASSYSGPRSYEQYF	TRBV6-5	TRBJ2-7
TGCAGTGTCTCCCCCAGGAGCGGGGAGCTGTTTTTT	CSVSPRSGELFF	TRBV20-1	TRBJ2-2
TGTGCCAGCAGCCAAGACTCCCTTCCCAGGGTTGATCCACGCACAGATACGCAGTATTTT	CASSQDSLPRVDPRTDTQYF	TRBV14	TRBJ2-3
TGCGCCAGCAGCCCAGAAAAAAAGGAGGAAGGATCTGAAGCTTTCTTT	CASSPEKKEEGSEAFF	TRBV5-1	TRBJ1-1
TGTGCCAGTGGGGGGGTGAAGGATTATAGCAATCAGCCCCAGCATTTT	CASGGVKDYSNQPQHF	TRBV2	TRBJ1-5
TGCAGTGCTAGATACGGAGGGTTCCGCTACGAGCAGTACTTC	CSARYGGFRYEQYF	TRBV20-1	TRBJ2-7
TGTGCCAGCAGCTCTTCTATGCGGGGGACCGTTATCGGAATCTGGTACAATGAGCAGTTCTTC	CASSSSMRGTVIGIWYNEQFF	TRBV7-3	TRBJ2-1
TGTGCCAGCAGCGGGAGACAGGAGACCCAGTACTTC	CASSGRQETQYF	TRBV4-2	TRBJ2-5
TGTGCCACCATGGGTCGGCGAGACACCGGGGAGCTGTTTTTT	CATMGRRDTGELFF	TRBV24-1	TRBJ2-2
TGTGCCACAGAGGGGCACTTGGGGCATAGCAATCAGCCCCAGCATTTT	CATEGHLGHSNQPQHF	TRBV27	TRBJ1-5
TGTGCCAGCAGCTTGGTGGAGGGCAGCTACGAGCAGTACTTC	CASSLVEGSYEQYF	TRBV5-6	TRBJ2-7
TGTGCCAGCAGCTTGACCCCGAAAGAACTAGCGGGAACGCCCCCTGAGCAGTTCTTC	CASSLTPKELAGTPPEQFF	TRBV5-5	TRBJ2-1
TGTGCCAGCAGTTCTTTGGGAGGGCCCACCGGGGAGCTGTTTTTT	CASSSLGGPTGELFF	TRBV28	TRBJ2-2
TGTGCCAGCAGACTCGGGAGGGTTCACGATCCCTACGAGCAGTACTTC	CASRLGRVHDPYEQYF	TRBV6-5	TRBJ2-7
TGCGCCAGAGGAGGGGGGGGTTTCTTT	CARGGGGFF	TRBV10-1	TRBJ1-1
TGTGCCAGCTCACCACAGGGGGCGGCAGCATACAATGAGCAGTTCTTC	CASSPQGAAAYNEQFF	TRBV18	TRBJ2-1
TGTGCCAGCAGTTGGGTAGCGCAATATCAAGAGACCCAGTACTTC	CASSWVAQYQETQYF	TRBV12-4	TRBJ2-5
TGTGCCACCAAGGGGTCTGACACGCGGGGCTACGAGCAGTACTTC	CATKGSDTRGYEQYF	TRBV24-1	TRBJ2-7
TGTGCCAGCAGCCCCGAAAGTCTCATTTATCAGGGTGAGACCCAGTACTTC	CASSPESLIYQGETQYF	TRBV13	TRBJ2-5
TGTGCCAGCAGCATTACAGGGCATAATGAAAAACTGTTTTTT	CASSITGHNEKLFF	TRBV5-4	TRBJ1-4
TGTGCCAGCAGTGTGTGGGACAGGGTCGAGCAGTTCTTC	CASSVWDRVEQFF	TRBV6-6	TRBJ2-1
TGTGCCAGCAGCCTGGGCGGGGGGCAATACGAGCAGTACTTC	CASSLGGGQYEQYF	TRBV14	TRBJ2-7
TGTGCCAGCAGCGTAGCCCGACAGGGGAACACTGAAGCTTTCTTT	CASSVARQGNTEAFF	TRBV9	TRBJ1-1
TGTGCCAGCAGCCAACCCTTAGCGGGAGCCTACGAGCAGTACTTC	CASSQPLAGAYEQYF	TRBV3-1	TRBJ2-7
TGCAGTGATTGCCGCAATCAGCCCCAGCATTTT	CSDCRNQPQHF	TRBV20-1	TRBJ1-5
TGTGCCAGCAGCTTAGAATACTCATCCACAGATACGCAGTATTTT	CASSLEYSSTDTQYF	TRBV7-4	TRBJ2-3
TGTGCCAGCAGCTCAAACACTCATCCTATGGGGGGGACTAGCGGGAGGGCTGACCCCCCCTACGAGCAGTACTTC	CASSSNTHPMGGTSGRADPPYEQYF	TRBV7-3	TRBJ2-7
TGTGCCTGGAGTGCAAGAACCTCGGGCGGGAACACTGAAGCTTTCTTT	CAWSARTSGGNTEAFF	TRBV30	TRBJ1-1
TGTGCCAGCAGCAGTGAAGCTAGCGGGGAGCAGTACTTC	CASSSEASGEQYF	TRBV7-2	TRBJ2-7
TGTGCCAGCAGCGTCCGGTGGACTCTGGGGGGGTTTACCTACAATGAGCAGTTCTTC	CASSVRWTLGGFTYNEQFF	TRBV9	TRBJ2-1
TGCAGCGTTGACGAAGGGGGGGGGCCCTATACGCAGTATTTT	CSVDEGGGPYTQYF	TRBV29-1	TRBJ2-3
TGCAGTGCTAGAGCCCGGGGCTCGAGCTCCTACAATGAGCAGTTCTTC	CSARARGSSSYNEQFF	TRBV20-1	TRBJ2-1
TGTGCCAGCAAGGGACGGGTTAACTATGGCTACACCTTC	CASKGRVNYGYTF	TRBV27	TRBJ1-2
TGCGCCAGCAGCTTGGCACTCTCCGGACTCCTTGGGGGTGTGGCTTTCTTT	CASSLALSGLLGGVAFF	TRBV5-1	TRBJ1-1
TGTGCCAGCAGTCCCGGGGGCGCCAATCAGCCCCAGCATTTT	CASSPGGANQPQHF	TRBV6-6	TRBJ1-5
TGTGCCAGCCGGCTAGTTCACATTCAGTACTTC	CASRLVHIQYF	TRBV6-5	TRBJ2-4
TGTGCCAGCAGTAGGACTAGCGGGTCTATTTCCAATGAGCAGTTCTTC	CASSRTSGSISNEQFF	TRBV6-2	TRBJ2-1
TGCAGTGCTACCCTCATACTGGGGGCATTTTTAGGCTACACCTTC	CSATLILGAFLGYTF	TRBV20-1	TRBJ1-2
TGTGCCAGTACCCCGGCAGGGGTCCACACTGAAGCTTTCTTT	CASTPAGVHTEAFF	TRBV19	TRBJ1-1
TGTGCCAGCAGCTCTAGGACCTCCGGCGGGGAGCTGTTTTTT	CASSSRTSGGELFF	TRBV11-2	TRBJ2-2
TGTGCCAGCAGCTTGGGGAACCTAGCGGGCGGGGTTGAGCAGTACTTC	CASSLGNLAGGVEQYF	TRBV5-4	TRBJ2-7
TGTGCCAGCACCCCCCTAACAGGGGGGTCCAAGTATAGCAATCAGCCCCAGCATTTT	CASTPLTGGSKYSNQPQHF	TRBV11-2	TRBJ1-5
TGTGCCAGCAGTTTTCCGGGACAGGGCCAAGAGACCCAGTACTTC	CASSFPGQGQETQYF	TRBV12-4	TRBJ2-5
TGCGCCAGCAGCTCAGGTTATCGCTCCTACGAGCAGTACTTC	CASSSGYRSYEQYF	TRBV5-1	TRBJ2-7
TGTGCCAGCAGCCAAGAAAGAGGGGACAGGGTCAATCAGCCCCAGCATTTT	CASSQERGDRVNQPQHF	TRBV14	TRBJ1-5
TGTGCCAGCAGCTTCTTTCCGGGGTCCACCTTC	CASSFFPGSTF	TRBV5-4	TRBJ1-2
TGTGCCAGCAGTTTTTATTCAATTCCCAGGAACTTC	CASSFYSIPRNF	TRBV28	TRBJ2-7
TGTGCCAGCAGTGAAGTGACCTGGAGTTGCTCCTACGAGCAGTACTTC	CASSEVTWSCSYEQYF	TRBV2	TRBJ2-7
TGTGCCAGCAGCGGACGGACAGGGGGCGACGGTGGCTATAATTCACCCCTCCACTTT	CASSGRTGGDGGYNSPLHF	TRBV6-4	TRBJ1-6
TGCGCCAGAGGGGCCGGGACAGGGGGGATGGATCTAGCCAAAAACATTCAGTACTTC	CARGAGTGGMDLAKNIQYF	TRBV4-1	TRBJ2-4
TGTGCCAGCAGCCATGTGGACAGGCTAGGCTACACCTTC	CASSHVDRLGYTF	TRBV3-1	TRBJ1-2
TGCGCCAGCAGCAACGGCTATTTTCAGGGTTCGATATATTTT	CASSNGYFQGSIYF	TRBV5-1	TRBJ1-3
TGTGCCTTGGACAGTCAGTCACCCCTCCACTTT	CALDSQSPLHF	TRBV27	TRBJ1-6
TGTGCCAGCAGCCCACGCCAAAGGGGGTCACAGCCCCAGCATTTT	CASSPRQRGSQPQHF	TRBV7-4	TRBJ1-5
TGCAGCGTTGAGGGGTGGGGGTATAGCAATCAGCCCCAGCATTTT	CSVEGWGYSNQPQHF	TRBV29-1	TRBJ1-5
TGTGCCAGCACTGACAGAGTAGTCTACCCAGAGACCCAGTACTTC	CASTDRVVYPETQYF	TRBV12-4	TRBJ2-5
TGCAGTGCTAGAGGGCCTAAGGGACTGGAGTTCCATGGCTACACCTTC	CSARGPKGLEFHGYTF	TRBV20-1	TRBJ1-2
TGTGCCAGCAGCAGGGCTTCACTAGCCAAAAACATTCAGTACTTC	CASSRASLAKNIQYF	TRBV12-4	TRBJ2-4
TGTGCCAGCAGCTTGATGACATTCAGCCGGGGACACAGACAGAGCTCCTACGAGCAGTACTTC	CASSLMTFSRGHRQSSYEQYF	TRBV5-8	TRBJ2-7
TGTGCCAGCAGTGTACGGGGGCAAGGGGCAAAACTGTTTTTT	CASSVRGQGAKLFF	TRBV7-2	TRBJ1-4
TGCAGTGATTTTCTCCCGGGACAGGGGTTACAGCCCCAGCATTTT	CSDFLPGQGLQPQHF	TRBV20-1	TRBJ1-5
TGTGCCAGCAGCGTCGCCTGGAGCTCCTACGAGCAGTACTTC	CASSVAWSSYEQYF	TRBV12-4	TRBJ2-7
TGTGCCAGCAGCTCTGCGCTGTTAAGCCGATCCTCCTACGAGCAGTACTTC	CASSSALLSRSSYEQYF	TRBV9	TRBJ2-7
TGCAGTGCTAGAGCCCAGCAGGGAACCGATCCCTACGAGCAGTACTTC	CSARAQQGTDPYEQYF	TRBV20-1	TRBJ2-7
TGTGCCAGCACTGGAAATCAGCCCCAGCATTTT	CASTGNQPQHF	TRBV11-3	TRBJ1-5
TGTGCCAGCAGTTTACCTAAGAGCCTTTACAATGAGCAGTTCTTC	CASSLPKSLYNEQFF	TRBV12-4	TRBJ2-1
TGTGCCAGCAGTGATCCGAGAGGAAGGGAGACCCAGTACTTC	CASSDPRGRETQYF	TRBV6-4	TRBJ2-5
TGTGCCAGCAGCGACGTGACTAGCGGGAGAAAAGAGACCCAGTACTTC	CASSDVTSGRKETQYF	TRBV5-8	TRBJ2-5
TGTGCCACCAGCTTCGGCCGGACGGGCTGTTTGAACACTGAAGCTTTCTTT	CATSFGRTGCLNTEAFF	TRBV24-1	TRBJ1-1
TGTGCCAGCAGCTTCACCCTAACCGGGGGGGGCTACGAGCAGTACTTC	CASSFTLTGGGYEQYF	TRBV2	TRBJ2-7
TGTGCCAGCAGCCGCGCGGCCTCCTACAATGAGCAGTTCTTC	CASSRAASYNEQFF	TRBV4-2	TRBJ2-1
TGTGCCAGCAGTAGGGCAGGAATCTATGGCTACACCTTC	CASSRAGIYGYTF	TRBV12-4	TRBJ1-2
TGTGCCAGCAGCCGAGAGCCCCAGCATTTT	CASSREPQHF	TRBV7-9	TRBJ1-5
TGTGCCAGCAGCCAAGATCTACTAGGACTTGGCTACACCTTC	CASSQDLLGLGYTF	TRBV4-2	TRBJ1-2
TGCGCCAGCAGTTACAGGGGGGCGCAGTACTTC	CASSYRGAQYF	TRBV10-1	TRBJ2-7
TGCAGTGCTTGGACGGGACTAGCGGGCACAGATACGCAGTATTTT	CSAWTGLAGTDTQYF	TRBV20-1	TRBJ2-3
TGTGCCAGCTCACCACTACTCTCGGGTTACGACAGGTGGGGGAACACTGAAGCTTTCTTT	CASSPLLSGYDRWGNTEAFF	TRBV18	TRBJ1-1
TGTGCCAGCAGTTTTATGAATGTTCCTGCGATGAGGGAGCAGTACTTC	CASSFMNVPAMREQYF	TRBV27	TRBJ2-7
TGTGCCAGCAGCGCCGTTTCAGGTACAGGTTGGGACTATGGCTACACCTTC	CASSAVSGTGWDYGYTF	TRBV5-6	TRBJ1-2
TGTGCCAGCAGCTTACGCTACCAGACAGGGTCCGGGAACACTGAAGCTTTCTTT	CASSLRYQTGSGNTEAFF	TRBV7-3	TRBJ1-1
TGTGCCACCAGTGCGTTCAGTTCACCCCTCCACTTT	CATSAFSSPLHF	TRBV24-1	TRBJ1-6
TGTGCCAGACGGTGGAAATGGGCCGAGCAGTACTTC	CARRWKWAEQYF	TRBV6-1	TRBJ2-7
TGTGCCAGCAGCGATACGGGACTAGAGAACACCGGGGAGCTGTTTTTT	CASSDTGLENTGELFF	TRBV13	TRBJ2-2
TGTGCCTGGTGGTACGAGGGTGGGGGGGTTTACTATGGCTACACCTTC	CAWWYEGGGVYYGYTF	TRBV30	TRBJ1-2
TGTGCCAGCATCAAGGGGACCACACGCTATAATTCACCCCTCCACTTT	CASIKGTTRYNSPLHF	TRBV6-8	TRBJ1-6
TGTGCCAGCAGTCGGACTAGCGGGACCTACAATGAGCAGTTCTTC	CASSRTSGTYNEQFF	TRBV27	TRBJ2-1
TGTGCCAGCAGTGCGAAGGAGCGACTAGCGCGCTACGAGCAGTACTTC	CASSAKERLARYEQYF	TRBV6-4	TRBJ2-7
TGTGCCTGGACCTCTTCGGACTTGGATACGCAGTATTTT	CAWTSSDLDTQYF	TRBV30	TRBJ2-3
TGTGCCAGCAGCTTAGACCAGGAGACCCAGTACTTC	CASSLDQETQYF	TRBV7-3	TRBJ2-5
TGCAGTGCAACCGGTAGGGCCCGAGTGGACTTC	CSATGRARVDF	TRBV20-1	TRBJ2-5
TGTGCCAGCAGCTTAGAAAACGCGGGAGGGGGCGAATCAGATACGCAGTATTTT	CASSLENAGGGESDTQYF	TRBV11-3	TRBJ2-3
TGTGCCAGCTCCGGGGGTATGCCGAATCAGCCCCAGCATTTT	CASSGGMPNQPQHF	TRBV27	TRBJ1-5
TGTGCCAGCACTAAAATAGGACAGGGGCCGCGGGCCAACGTCCTGACTTTC	CASTKIGQGPRANVLTF	TRBV9	TRBJ2-6
TGTGCCAGCAGAAAGGACTCTATCGGGTCTGGGTACAATGAGCAGTTCTTC	CASRKDSIGSGYNEQFF	TRBV7-3	TRBJ2-1
TGTGCCAGCAGCCGCATAATAGGGCCCGGGCAGCCCCAGCATTTT	CASSRIIGPGQPQHF	TRBV14	TRBJ1-5
TGCGCCAGCAGCGGGCAGGGGAAAGCTAACTATGGCTACACCTTC	CASSGQGKANYGYTF	TRBV5-1	TRBJ1-2
TGTGCCAGCAGCTGGACACCCTATGGCTACACCTTC	CASSWTPYGYTF	TRBV5-4	TRBJ1-2
TGTGCCAGCAGTGTTCCGGACAGGGTCTGCTCCCGCAATCAGCCCCAGCATTTT	CASSVPDRVCSRNQPQHF	TRBV6-5	TRBJ1-5
TGTGCCAGCAGTTTGTCTTACACCTTCTATGGCTACACCTTC	CASSLSYTFYGYTF	TRBV12-4	TRBJ1-2
TGTGCCAGCAGTTTATGCCTCCCGTCTCGACAGGGACAGTGCCAGGCACAGCCCCAGCATTTT	CASSLCLPSRQGQCQAQPQHF	TRBV28	TRBJ1-5
TGTGCCAGCAGCAGATTCGGAAGCTCCTACGAGCAGTACTTC	CASSRFGSSYEQYF	TRBV13	TRBJ2-7
TGTGCCTGGCATGGGGGGGCCAATGAGCAGTTCTTC	CAWHGGANEQFF	TRBV30	TRBJ2-1
TGCATCACCGGGGGCAATCCCAATCAGCCCCAGCATTTT	CITGGNPNQPQHF	TRBV29-1	TRBJ1-5
TGCGCCAGCAGCAACGGTACCTACGAGCAGTACTTC	CASSNGTYEQYF	TRBV5-1	TRBJ2-7
TGTGCCAGCAGCCAGAAGACGACAGATACGCAGTATTTT	CASSQKTTDTQYF	TRBV3-1	TRBJ2-3
TGTGCCAGCAGCCCGAGACAGCCTGCCTGGGGCTACGAGCAGTACTTC	CASSPRQPAWGYEQYF	TRBV4-2	TRBJ2-7
TGTGCCAGCAGCAAAATATGGGGAAGAACAGATACGCAGTATTTT	CASSKIWGRTDTQYF	TRBV7-2	TRBJ2-3
TGTGCCAGCAGCTTTAGGGGTGGACCACCCACTGAAGCTTTCTTT	CASSFRGGPPTEAFF	TRBV7-9	TRBJ1-1
TGTGCCAGCAGCGGGGACAGCAATCAGCCCCAGCATTTT	CASSGDSNQPQHF	TRBV7-3	TRBJ1-5
TGTGCCAGCAGCTTAAGGCCTCTAATCCAGTCAGCTTTCTTT	CASSLRPLIQSAFF	TRBV11-2	TRBJ1-1
TGTGCCAGCAGCCCGAGGACTAGCGGGCATAGTTGGAACGAGCAGTACTTC	CASSPRTSGHSWNEQYF	TRBV7-2	TRBJ2-7
TGTGCCAGGTGGACGAACTCCTCCTACAATGAGCAGTTCTTC	CARWTNSSYNEQFF	TRBV19	TRBJ2-1
TGTGCTAGCAGCTGGAGACAGCCTACTAACTATGGCTACACCTTC	CASSWRQPTNYGYTF	TRBV7-7	TRBJ1-2
TGTGCCAGCAGCGTAGCAGGACGCCCTTGCAATCAGCCCCAGCATTTT	CASSVAGRPCNQPQHF	TRBV9	TRBJ1-5
TGTGCCAGCACTGGGCGGGACAGGGGGGAAGCCTACGAGCAGTACTTC	CASTGRDRGEAYEQYF	TRBV6-5	TRBJ2-7
TGTGCCAGCAGGCAGGATAGAAACACCGGGGAGCTGTTTTTT	CASRQDRNTGELFF	TRBV9	TRBJ2-2
TGTGCCAGCAGCGTTCCCGGGAGTCTGAATGAAAAACTGTTTTTT	CASSVPGSLNEKLFF	TRBV13	TRBJ1-4
TGTGCCAGCTCATACGAGGGGGCCAATAACACGAATGAGCAGTTCTTC	CASSYEGANNTNEQFF	TRBV28	TRBJ2-1
TGTGCCAGCAGTTTACTTGAGTCCTACGAGCAGTACTTC	CASSLLESYEQYF	TRBV27	TRBJ2-7
TGCAGTGCTTCACTAGCGGGTAAACCCTACGAGCAGTACTTC	CSASLAGKPYEQYF	TRBV20-1	TRBJ2-7
TGTGCCAGCAGACGCACTGGAAACACCATATATTTT	CASRRTGNTIYF	TRBV7-3	TRBJ1-3
TGCCGGTGGCAGGGGGGGGGTAGCAATCAGCCCCAGCATTTT	CRWQGGGSNQPQHF	TRBV6-1	TRBJ1-5
TGTGCCAGCAGACCTCAGGGACAGGGATTACCGGGAACCTACGAGCAGTACTTC	CASRPQGQGLPGTYEQYF	TRBV3-1	TRBJ2-7
TGTGCCAGTAGTATAGGACTAGGTGCCGGGGAGCTGTTTTTT	CASSIGLGAGELFF	TRBV19	TRBJ2-2
TGTGCCAGCAGCCGCGCGATGACAGGCGAACCCACTGAAGCTTTCTTT	CASSRAMTGEPTEAFF	TRBV7-3	TRBJ1-1
TGTGCCAGCAGCTTAGGGGGCCCACCAGGCACCTTC	CASSLGGPPGTF	TRBV11-2	TRBJ1-2
TGTGCCAGCAGCGACCTCAGGTTCCGTGGGGGGGGAAGCTCTGGGGCCAACGTCCTGACTTTC	CASSDLRFRGGGSSGANVLTF	TRBV5-6	TRBJ2-6
TGTGCCAGCAGTCGGTTGGGACAGGGCTCTGATGGACGAAACACCGGGGAGCTGTTTTTT	CASSRLGQGSDGRNTGELFF	TRBV6-5	TRBJ2-2
TGTGCCAGCAGTGGATACCAGTCATCCTACAATGAGCAGTTCTTC	CASSGYQSSYNEQFF	TRBV6-4	TRBJ2-1
TGTGCCAGCAGTTACGGGGGAGCAGGACGCAATCAGCCCCAGCATTTT	CASSYGGAGRNQPQHF	TRBV6-5	TRBJ1-5
TGCAGTGCGACCACCATCTACAATGAGCAGTTCTTC	CSATTIYNEQFF	TRBV20-1	TRBJ2-1
TGTGCCAGCAGCGAGCACCCGGGACAGGGGAATCAGCCCCAGCATTTT	CASSEHPGQGNQPQHF	TRBV9	TRBJ1-5
TGCGCCAGCAGCCAAGACGACACTTGCACAGATACGCAGTATTTT	CASSQDDTCTDTQYF	TRBV4-1	TRBJ2-3
TGTGCCTGGGGCAGGGAGGGAGAAAAACTGTTTTTT	CAWGREGEKLFF	TRBV27	TRBJ1-4
TGTGCCAGCAGCTTACTCTTAGCGGCGACAGGTGAGCAGTTCTTC	CASSLLLAATGEQFF	TRBV11-2	TRBJ2-1
TGCAGCGTGGGGTCCTTCGGTGTAGCCCGGAACGAGCAGTACTTC	CSVGSFGVARNEQYF	TRBV29-1	TRBJ2-7
TGTGCCAGCAGCAGAAGTCTACCTCGTTCGAACACTGAAGCTTTCTTT	CASSRSLPRSNTEAFF	TRBV7-9	TRBJ1-1
TGTGCCAGCACAAAGGACAGGGGGTCGCCCCAGCATTTT	CASTKDRGSPQHF	TRBV27	TRBJ1-5
TGTGCCAGCAGCGGGGAAGGGGGGGTGGTTCAAGAGACCCAGTACTTC	CASSGEGGVVQETQYF	TRBV7-9	TRBJ2-5
TGCAGTCTTTCGTCGTGGGGACTAGCGGGTTTCGCCTACAATGAGCAGTTCTTC	CSLSSWGLAGFAYNEQFF	TRBV20-1	TRBJ2-1
TGTGCCAGCTCACCAGAGATAACTGAAGCTTTCTTT	CASSPEITEAFF	TRBV18	TRBJ1-1
TGTGCCAGCAGCCACAGGGATTATCAGCCCCAGCATTTT	CASSHRDYQPQHF	TRBV7-2	TRBJ1-5
TGTGCCAGCAGTTTCCCCGCCAGAAACAGGGCCTACGAGCAGTACTTC	CASSFPARNRAYEQYF	TRBV27	TRBJ2-7
TGTGCCAGCAGCTTAGTCCGCGGGAGCCTTCACGAGCAGTACTTC	CASSLVRGSLHEQYF	TRBV7-8	TRBJ2-7
TGTGCCAGGACGGGTAATCCGGGACAGGGGAGGACTGAAGCTTTCTTT	CARTGNPGQGRTEAFF	TRBV27	TRBJ1-1
TGTGCCAGCAGTGATCGGGGGTTTGAGGCAGAGACCCAGTACTTC	CASSDRGFEAETQYF	TRBV6-1	TRBJ2-5
TGTGCCAGCAGCGAATCCAGAACCGCCCAGGGGCAAGAGACCCAGTACTTC	CASSESRTAQGQETQYF	TRBV13	TRBJ2-5
TGTGCCAGCAGGCCCCGCAAGGGTGGCTACACCTTC	CASRPRKGGYTF	TRBV13	TRBJ1-2
TGTGCCAGCAGCCCTCAGGGTTTGCAGTACTTC	CASSPQGLQYF	TRBV14	TRBJ2-7
TGTGCCAGCAGTTACCGCATGCTTAGCTCTGGAAACACCATATATTTT	CASSYRMLSSGNTIYF	TRBV6-6	TRBJ1-3
TGTGCCACCAGTGATTTGCAACCAGTAAATTCTGGAAACACCATATATTTT	CATSDLQPVNSGNTIYF	TRBV24-1	TRBJ1-3
TGTGCCAGCAGCGGGACAGAAGGGCTGGACGATACGCAGTATTTT	CASSGTEGLDDTQYF	TRBV7-8	TRBJ2-3
TGTGCTAGTGGCCGGGACATAAGGCCTGAAGCTTTCTTT	CASGRDIRPEAFF	TRBV12-5	TRBJ1-1
TGCGCCAGCAGCTTGAAGAGCGTCAGGGGAGGGTCCAACTATGGCTACACCTTC	CASSLKSVRGGSNYGYTF	TRBV5-1	TRBJ1-2
TGTGCCAGCAGCCATGGGGTGGTCTATGGCTACACCTTC	CASSHGVVYGYTF	TRBV7-9	TRBJ1-2
TGTGCCAGCACTGGGGTTGGGGGCAATCAGCCCCAGCATTTT	CASTGVGGNQPQHF	TRBV27	TRBJ1-5
TGTGCCAGCAGCACAAGCCGCAGGGGGCACCACTATGGCTACACCTTC	CASSTSRRGHHYGYTF	TRBV7-9	TRBJ1-2
TGTGCCAGCAGCGGTCCGGGACTAGCGGGTAGGTACAATGAGCAGTTCTTC	CASSGPGLAGRYNEQFF	TRBV7-3	TRBJ2-1
TGTGCCAGCAGTGAGGGGGGGGCCTTTAGACTGACCCAGTACTTC	CASSEGGAFRLTQYF	TRBV27	TRBJ2-5
TGCAGTGCTAGCAAATCGAGTCTAACAGATGAGCAGTTCTTC	CSASKSSLTDEQFF	TRBV20-1	TRBJ2-1
TGTGCCAGCAGGAAGGGGGATACGAACACCGGGGAGCTGTTTTTT	CASRKGDTNTGELFF	TRBV7-3	TRBJ2-2
TGTGCCAGCAGTTATAAGCCGATGACCCAAGAGACCCAGTACTTC	CASSYKPMTQETQYF	TRBV6-5	TRBJ2-5
TGTGCCAGCACCGATTCTGAAGCTTTCTTT	CASTDSEAFF	TRBV2	TRBJ1-1
TGCGCCAGCAGCTCTTCCGGGACAGGGTATATTGAAAAACTGTTTTTT	CASSSSGTGYIEKLFF	TRBV5-1	TRBJ1-4
TGCGCCAGCAGTGACGCGAGCAACTATGGCTACACCTTC	CASSDASNYGYTF	TRBV10-1	TRBJ1-2
TGTGCCAGCAGTCCCCCCCAGATAAACACCGGGGAGCTGTTTTTT	CASSPPQINTGELFF	TRBV2	TRBJ2-2
TGCGCCAGCAAAGCGGGGAGGTTCTACAATGAGCAGTTCTTC	CASKAGRFYNEQFF	TRBV10-1	TRBJ2-1
TGTGCCAGCAGCCCAGGGGAAGAGACCCAGTACTTC	CASSPGEETQYF	TRBV7-4	TRBJ2-5
TGTGCCACCAGTGATTTACTTAAGACAGGGGGGGCCACTGAAGCTTTCTTT	CATSDLLKTGGATEAFF	TRBV24-1	TRBJ1-1
TGTGCCAGCAGCTTAACGGGGGGCACCGGGGAGCTGTTTTTT	CASSLTGGTGELFF	TRBV7-3	TRBJ2-2
TGCAGTGCTAGAGCTAACATCGTCTCCCCGCCAGGGCTTCGAAACACCATATATTTT	CSARANIVSPPGLRNTIYF	TRBV20-1	TRBJ1-3
TGTGCCACCAGTGACAGGGGGGGGGTCTCCTATAATTCACCCCTCCACTTT	CATSDRGGVSYNSPLHF	TRBV24-1	TRBJ1-6
TGTGCCTCGCATTTCCAAGAGACTATGACCCAGTACTTC	CASHFQETMTQYF	TRBV9	TRBJ2-5
TGCGCCAGCAGCCAAGTAGACAGGCAAACCTACGAGCAGTACTTC	CASSQVDRQTYEQYF	TRBV4-1	TRBJ2-7
TGTGCCAGCAGTTTACTGGGGGGGGCTTGCAATTCACCCCTCCACTTT	CASSLLGGACNSPLHF	TRBV28	TRBJ1-6
TGTGCCAGCAGTGTCCTGAGAGGGTGCCGGTGCAATCAGCCCCAGCATTTT	CASSVLRGCRCNQPQHF	TRBV6-4	TRBJ1-5
TGTGCCAGCAGCCAAGCAGTCAGAGCGGGTTGGGTAGATACGCAGTATTTT	CASSQAVRAGWVDTQYF	TRBV14	TRBJ2-3
TGTGCCAGCAGGGTCGGCCTAATGGAAGGCTACACCTTC	CASRVGLMEGYTF	TRBV14	TRBJ1-2
TGTGCCAGCAGCTTAGTCGGGGGCATGGCGAAGTATGGCTACACCTTC	CASSLVGGMAKYGYTF	TRBV7-9	TRBJ1-2
TGTGCCAGCAGCCCGGGACAGGAGGGCGAGCAGTACTTC	CASSPGQEGEQYF	TRBV9	TRBJ2-7
TGTGCCAGCAGAATAGGGTGGATTGGCAACACTGAAGCTTTCTTT	CASRIGWIGNTEAFF	TRBV14	TRBJ1-1
TGTGCCAGCAGTCGAGGAAGGGAGCGGAATGAAAAACTGTTTTTT	CASSRGRERNEKLFF	TRBV27	TRBJ1-4
TGTGCCTGGAGCGAAGACGAGCAGTACTTC	CAWSEDEQYF	TRBV30	TRBJ2-7
TGTGCCAGCAGCTTCTGGAAAAGGGACAGGGGGCACGCGATGAACACTGAAGCTTTCTTT	CASSFWKRDRGHAMNTEAFF	TRBV7-8	TRBJ1-1
TGTGCCAGCAGCTTAGATCCTATTGAGGGGGCAGGGGGCCATGGCTACACCTTC	CASSLDPIEGAGGHGYTF	TRBV11-3	TRBJ1-2
TGTGCCAGCAGCGGGAGGAGCAACTATGGCTACACCTTC	CASSGRSNYGYTF	TRBV5-6	TRBJ1-2
TGTGCCAGCAGGACCGAGAATCAGCCCCAGCATTTT	CASRTENQPQHF	TRBV5-6	TRBJ1-5
TGTGCCAGCAGTGACGTAATAGGCCTTCGGGGGGGCACAAGACTGCCGGCCAAAAACATTCAGTACTTC	CASSDVIGLRGGTRLPAKNIQYF	TRBV2	TRBJ2-4
TGTGCCAGCAGGAGGACAGATAGTTCACCCCTCCACTTT	CASRRTDSSPLHF	TRBV7-9	TRBJ1-6
TGCAGTGCTAAGGTATGGGGAAATGAAAAACTGTTTTTT	CSAKVWGNEKLFF	TRBV20-1	TRBJ1-4
TGTGCCAGCAGCCGGGGAGGGGGGCAAACTGAAGCTTTCTTT	CASSRGGGQTEAFF	TRBV28	TRBJ1-1
TGTGCCAGCAGTTATAGTGATCTCCGGGACAGCGTACCAGCTTTCTTT	CASSYSDLRDSVPAFF	TRBV6-5	TRBJ1-1
TGTGCCAGCAGCCTGTTGGGACAGGTCGCAGCTAACTATGGCTACACCTTC	CASSLLGQVAANYGYTF	TRBV7-9	TRBJ1-2
TGTGCCAGAAGGGGACAGGGTCATGGGAAAAGAAAATGCCCGTATGGCTACACCTTC	CARRGQGHGKRKCPYGYTF	TRBV27	TRBJ1-2
TGTGCCAGCAGCCGTCTTACTAGATCGAAAGAGACCCAGTACTTC	CASSRLTRSKETQYF	TRBV9	TRBJ2-5
TGCGCCAGCAGTTCCTCGGGACAGTACGGGTACTATGGCTACACCTTC	CASSSSGQYGYYGYTF	TRBV10-1	TRBJ1-2
TGTGCCAGCAGTGAAAGGTGCGCGGTACTAGCGGGAGGGCTCTCTGGAAACACCATATATTTT	CASSERCAVLAGGLSGNTIYF	TRBV6-1	TRBJ1-3
TGCGCCAGCAGTCCGATTCTGAGATCTCTTAGCAATCAGCCCCAGCATTTT	CASSPILRSLSNQPQHF	TRBV10-1	TRBJ1-5
TGTGCCAGCACAACGGTCACCAGGAACACTGAAGCTTTCTTT	CASTTVTRNTEAFF	TRBV28	TRBJ1-1
TGTGCCAGCAGCTTCGGGGGGTTGGATGGCTACACCTTC	CASSFGGLDGYTF	TRBV7-9	TRBJ1-2
TGTGCCACGGGACTAGCGGGGGGTCGCACAGATACGCAGTATTTT	CATGLAGGRTDTQYF	TRBV24-1	TRBJ2-3
TGTGCCAGCAGTATCCCACTAGCGGGAGCAAAGGACTATGGCTACACCTTC	CASSIPLAGAKDYGYTF	TRBV6-5	TRBJ1-2
TGTGCCAGCAGCTTAGGGGTCTCGGTGTATGGCTACACCTTC	CASSLGVSVYGYTF	TRBV11-2	TRBJ1-2
TGTGCCAGCAGCGTAGCTAGAACGAGGTCAGATACGCAGTATTTT	CASSVARTRSDTQYF	TRBV9	TRBJ2-3
TGTGCCAGCAGTTACTCGAAACCGGGACAGGAGTCCTACGAGCAGTACTTC	CASSYSKPGQESYEQYF	TRBV6-2	TRBJ2-7
TGTGCCAGCAGGACAGGCCCCTACGAGCAGTACTTC	CASRTGPYEQYF	TRBV7-9	TRBJ2-7
TGTGCCAGCAACCCGCTCCGTGCTAGCACAGATACGCAGTATTTT	CASNPLRASTDTQYF	TRBV27	TRBJ2-3
TGCAGTGCTAGGGGGACAGGGGATAATAATTCACCCCTCCACTTT	CSARGTGDNNSPLHF	TRBV20-1	TRBJ1-6
TGTGCCAGCGGGACAGAGACGCCTAAACGGGAGACCCAGTACTTC	CASGTETPKRETQYF	TRBV7-3	TRBJ2-5
TGTGCCAGCAGTGACCCCGGACCTTGGAGCTCCTACAATGAGCAGTTCTTC	CASSDPGPWSSYNEQFF	TRBV6-4	TRBJ2-1
TGTGCCAGCCGACAGGGAGAGACCCAGTACTTC	CASRQGETQYF	TRBV5-6	TRBJ2-5
TGTGCCAGCAGGGGGGGGGCGGCGAACTGGGAAGTCTTC	CASRGGAANWEVF	TRBV5-6	TRBJ2-1
TGCAGTGCTAGAGATGGTGGACAGGGGGGAGCCAAAAACATTCAGTACTTC	CSARDGGQGGAKNIQYF	TRBV20-1	TRBJ2-4
TGTGCCAGCAGTTTAGGGGTTTGGGGGGGGTATAGCAATCAGCCCCAGCATTTT	CASSLGVWGGYSNQPQHF	TRBV6-5	TRBJ1-5
TGTGCCAGCAGCTGTGTTCGGAGGGGACTAGCGGGGCGTTCCTACGAGCAGTACTTC	CASSCVRRGLAGRSYEQYF	TRBV11-2	TRBJ2-7
TGTGCCAGCAGTGATCGTTACTATGAGCAGTTCTTC	CASSDRYYEQFF	TRBV2	TRBJ2-1
TGTGCCAGCAGTTGGCATACAGATACGCAGTATTTT	CASSWHTDTQYF	TRBV27	TRBJ2-3
TGCGCCAGCAGCTGGACTAGCGGGGAGACCCAGTACTTC	CASSWTSGETQYF	TRBV5-1	TRBJ2-5
TGCAGTGCTAGAGCTGGGGTCCCCACTGAAGCTTTCTTT	CSARAGVPTEAFF	TRBV20-1	TRBJ1-1
TGTGCCAGCTCATATAGGGGGCCTAGCAATCAGCCCCAGCATTTT	CASSYRGPSNQPQHF	TRBV18	TRBJ1-5
TGTGCCAGCAGCCGCGGGAGAAACGAAACCCGGGGCTCCTACAATGAGCAGTTCTTC	CASSRGRNETRGSYNEQFF	TRBV6-5	TRBJ2-1
TGCAGTGCTAAGACGGACGCTTCTTCTAGCGGGATGGCCGGGGAGCTGTTTTTT	CSAKTDASSSGMAGELFF	TRBV20-1	TRBJ2-2
TGTGCCAGCAGTAGAACCGGGGCGAACACCGGGGAGCTGTTTTTT	CASSRTGANTGELFF	TRBV28	TRBJ2-2
TGTGCCAGCAGGAGGGGGGGCCGGGGTGGCTACACCTTC	CASRRGGRGGYTF	TRBV6-2	TRBJ1-2
TGTGCCAGCAGTTACCGGGACAGGGTAGCACACAACAATCAGCCCCAGCATTTT	CASSYRDRVAHNNQPQHF	TRBV27	TRBJ1-5
TGTGCCAGCAGCTTCTTGACTAGCGGGAGGGCTCTCGAGCAGTACTTC	CASSFLTSGRALEQYF	TRBV7-9	TRBJ2-7
TGTGCCAGCAGCCAATTAAGGTTATGGGGGGGTAACAATGAGCAGTTCTTC	CASSQLRLWGGNNEQFF	TRBV14	TRBJ2-1
TGCAGTGCTCTCGCCTACGAGCAGTACTTC	CSALAYEQYF	TRBV20-1	TRBJ2-7
TGTGCCAGCAGCGGGGACAGGGTATCAATTACCGGGGAGCTGTTTTTT	CASSGDRVSITGELFF	TRBV7-3	TRBJ2-2
TGTGCCAGCAGCTTACCCCGGGGGCAGTTCTTC	CASSLPRGQFF	TRBV7-9	TRBJ2-1
TGTGCCAGCAGCCCGACGAACTTCCCGCGAGAAGAATTCCAGCTACGTGCAACTAATGAAAAACTGTTTTTT	CASSPTNFPREEFQLRATNEKLFF	TRBV7-3	TRBJ1-4
TGTGCCTTTTTGTCGAGGGGACAGCTGACCCAGTACTTC	CAFLSRGQLTQYF	TRBV24-1	TRBJ2-5
TGCAGCGTTGAAGGGACAGGGGGGGAGCAGTACTTC	CSVEGTGGEQYF	TRBV29-1	TRBJ2-7
TGTGCCAGCAGGACAGGGGCGGAGAATGAGCAGTTCTTC	CASRTGAENEQFF	TRBV6-4	TRBJ2-1
TGTGCCAGCAGTTACTCGGGGACATGTAGGGCGAACACTGAAGCTTTCTTT	CASSYSGTCRANTEAFF	TRBV6-3	TRBJ1-1
TGTGCCAGCAGCCAAGCTTCGGCGGACGAGACAGGGTATACAGAGACCCAGTACTTC	CASSQASADETGYTETQYF	TRBV3-1	TRBJ2-5
TGTGCCAGCAGCCTCCGCGGACAGGGTGTTGGCTACACCTTC	CASSLRGQGVGYTF	TRBV14	TRBJ1-2
TGTGCCAGCAGTACGGGGGGGGGCGAGAGGGTGAACAATGAGCAGTTCTTC	CASSTGGGERVNNEQFF	TRBV6-4	TRBJ2-1
TGTGCCAGCAGGTATCTAGCGGGAAGGGCTGGAGATACGCAGTATTTT	CASRYLAGRAGDTQYF	TRBV7-3	TRBJ2-3
TGTGCCAGCAGCTTAGAGTGGAGGGCCTGCCGTGGACAAGAGACCCAGTACTTC	CASSLEWRACRGQETQYF	TRBV7-3	TRBJ2-5
TGTGCCAGCTCACCACAATCCGTGGACAGCACCTACGAGCAGTACTTC	CASSPQSVDSTYEQYF	TRBV18	TRBJ2-7
TGTGCCAGCAGTTTCGTTACGGGTCAGTTCACAGATACGCAGTATTTT	CASSFVTGQFTDTQYF	TRBV6-2	TRBJ2-3
TGTGCCAGCAGTTCCATACCGACAGGAAGCGCCTACGAGCAGTACTTC	CASSSIPTGSAYEQYF	TRBV27	TRBJ2-7
TGTGCCAGCAGCTTATTCTATCCAGAGGCGCCCCAGCATTTT	CASSLFYPEAPQHF	TRBV13	TRBJ1-5
TGTGCCAAGACGGGGCACCTAGGCTACACCTTC	CAKTGHLGYTF	TRBV5-5	TRBJ1-2
TGTGCCAGCAGAGGGGGGGCGGATACGCAGTATTTT	CASRGGADTQYF	TRBV6-1	TRBJ2-3
TGTGCCAGCAGCTTTCCGAGGGGGAGGGGGAGCAATCAGCCCCAGCATTTT	CASSFPRGRGSNQPQHF	TRBV7-8	TRBJ1-5
TGTGCCAGCAGTGACGGGAGTGGGACAGGGGCGCAGAGGGAGACCCAGTACTTC	CASSDGSGTGAQRETQYF	TRBV6-4	TRBJ2-5
TGTGCCAGCAGTCCGGGACTAGACAATGAGCAGTTCTTC	CASSPGLDNEQFF	TRBV6-5	TRBJ2-1
TGTGCCAGCATCACCCAGTTCTTATGGAACACTGAAGCTTTCTTT	CASITQFLWNTEAFF	TRBV19	TRBJ1-1
TGTGCCAGCAGTGACAGGAACAGGGCCAATGAGCAGTTCTTC	CASSDRNRANEQFF	TRBV25-1	TRBJ2-1
TGCGCCAGCAGCGGTAGGGGACAGGGCTACGAGCAGTACTTC	CASSGRGQGYEQYF	TRBV5-1	TRBJ2-7
TGTGCCAGCCGTGGGGGAAGACAGGGTCGCGCCTACGAGCAGTACTTC	CASRGGRQGRAYEQYF	TRBV5-4	TRBJ2-7
TGCGCCAGCAGTGTTGGGGGGGGTTTCTTCTACAATGAGCAGTTCTTC	CASSVGGGFFYNEQFF	TRBV10-1	TRBJ2-1
TGTGCCAGCAGCTTACCTGGGTTCGATACGCAGTATTTT	CASSLPGFDTQYF	TRBV7-2	TRBJ2-3
TGCAGTGCTATAAAAAGAATACATTCTGAAGCTTTCTTT	CSAIKRIHSEAFF	TRBV20-1	TRBJ1-1
TGTGCCAGCAGCGATCAGGGAGAGACCCAGTACTTC	CASSDQGETQYF	TRBV12-3	TRBJ2-5
TGTGCCAGCAGCTCGGACAGTTGGCGGAAAGTCTACAATGAGCAGTTCTTC	CASSSDSWRKVYNEQFF	TRBV7-3	TRBJ2-1
TGCAGTGCTCTGTGGGGGGGCAGCTATGGCTACACCTTC	CSALWGGSYGYTF	TRBV20-1	TRBJ1-2
TGTGCCAGCAGCTCTCAGCGGGACACTGAAGCTTTCTTT	CASSSQRDTEAFF	TRBV5-6	TRBJ1-1
TGTGCCAGACCCCAAGAGGACTCCTACGAGCAGTACTTC	CARPQEDSYEQYF	TRBV14	TRBJ2-7
TGTGCCAGCGTTAGCGGGTATCCGAGCACCGGGGAGCTGTTTTTT	CASVSGYPSTGELFF	TRBV6-4	TRBJ2-2
TGTGCCAGCAATAGGACTAGCGGGTTATTCTCCTACAATGAGCAGTTCTTC	CASNRTSGLFSYNEQFF	TRBV27	TRBJ2-1
TGCGCCAGCACAGTGGGAGGGATCTACGAGCAGTACTTC	CASTVGGIYEQYF	TRBV5-1	TRBJ2-7
TGTGCCACTCAGGGGTTCTACGAGCAGTACTTC	CATQGFYEQYF	TRBV24-1	TRBJ2-7
TGTGCCAGCAGCGTCTACCTAGCGGGATCCAGCGTCACAGATACGCAGTATTTT	CASSVYLAGSSVTDTQYF	TRBV9	TRBJ2-3
TGTGCCAGCAGCCAAGATCGGTGGGGGAACATTCAGTACTTC	CASSQDRWGNIQYF	TRBV14	TRBJ2-4
TGCGCCAGCAGTGAGCGGGAGGGCTATGGCTACACCTTC	CASSEREGYGYTF	TRBV10-1	TRBJ1-2
TGTGCCAGCAGTCAAGGGGAACTACAGGGGGGCTACACCTTC	CASSQGELQGGYTF	TRBV6-5	TRBJ1-2
TGTGCCAGCACCCGGGACGCCCAAGAGACCCAGTACTTC	CASTRDAQETQYF	TRBV6-1	TRBJ2-5
TGTGCCAGCATTGGACAGGGGGCGTGGGTAATACCTGAAGCTTTCTTT	CASIGQGAWVIPEAFF	TRBV7-9	TRBJ1-1
TGTGCCAGCAGTGGACGCCTAACCGGGGCATACGAGCAGTACTTC	CASSGRLTGAYEQYF	TRBV6-5	TRBJ2-7
TGTGCCAGCAGCTTGCTTGGGACGTTTGCCCCCTACGAGCAGTACTTC	CASSLLGTFAPYEQYF	TRBV5-6	TRBJ2-7
TGTGCCAGCAGAAGAAGGACAGGGGTTCCCTCCTATGGCTACACCTTC	CASRRRTGVPSYGYTF	TRBV5-5	TRBJ1-2
TGTGCCAGCAGCGCCACAAAGAGGGACAGGGCCCGGGATCGCAATCAGCCCCAGCATTTT	CASSATKRDRARDRNQPQHF	TRBV9	TRBJ1-5
TGTGCCAGCAGCGGGGTGGGGTTCGATGGAAGTATAGAAGCTTTCTTT	CASSGVGFDGSIEAFF	TRBV7-3	TRBJ1-1
TGTGCCAGCAGCTCGAGGACTAGGACAGATACGCAGTATTTT	CASSSRTRTDTQYF	TRBV5-4	TRBJ2-3
TGTGCCAGCAGTCACCTCGGTACATTATGTAAGGGGGAAATCGTTAACACTGAAGCTTTCTTT	CASSHLGTLCKGEIVNTEAFF	TRBV6-3	TRBJ1-1
TGTGCCAGCAGGACTAGCGGGCGTAAAGAGCAGTACTTC	CASRTSGRKEQYF	TRBV3-1	TRBJ2-7
TGCGCCAGCAGTTTGAGGCTAAGCTCTGGCAATCAGCCCCAGCATTTT	CASSLRLSSGNQPQHF	TRBV10-2	TRBJ1-5
TGTGCCAGCAGCCACGAACAACAGGGTCATAGCACAGATACGCAGTATTTT	CASSHEQQGHSTDTQYF	TRBV3-1	TRBJ2-3
TGTGCCAGCAGTGACTCGACCCAGGGCCGGGAACAAGGAAACACTGAAGCTTTCTTT	CASSDSTQGREQGNTEAFF	TRBV6-4	TRBJ1-1
TGTGCCAGCATCGCCCCCCGGGACAGGGCGGGTCAGCCCCAGCATTTT	CASIAPRDRAGQPQHF	TRBV6-5	TRBJ1-5
TGTGCCAGCCGGGGTCGAATTAGCTCTGGAAACACCATATATTTT	CASRGRISSGNTIYF	TRBV7-9	TRBJ1-3
TGTGCCAGCAGCCAAGATCGGAAAAACATACTAGACGTCGAGACCCAGTACTTC	CASSQDRKNILDVETQYF	TRBV3-1	TRBJ2-5
TGTGCCAGCAGTTTAATAGGCCGGACAGTGGGCACAGATACGCAGTATTTT	CASSLIGRTVGTDTQYF	TRBV28	TRBJ2-3
TGTGCCACCAGTGACCTAAGACTAGCGGGAGCTCTAGACGAGCAGTACTTC	CATSDLRLAGALDEQYF	TRBV24-1	TRBJ2-7
TGTGCCAGCAGCTTACCCGGTGGGACCTACGAGCAGTACTTC	CASSLPGGTYEQYF	TRBV11-2	TRBJ2-7
TGTGCCACCGGACCAAAAGGCCAGCGCTATGGCTACACCTTC	CATGPKGQRYGYTF	TRBV24-1	TRBJ1-2
TGCGCCAGCAGCTCTAGCGGGTCCCAAGAGACCCAGTACTTC	CASSSSGSQETQYF	TRBV5-1	TRBJ2-5
TGCGCCAGCAGCTCCCGCGGGAGCTGGAGGCGGGGAATGAACACTGAAGCTTTCTTT	CASSSRGSWRRGMNTEAFF	TRBV5-1	TRBJ1-1
TGTGCCAGCAGTTACCCGCCCCCGCCCACTGAAGCTTTCTTT	CASSYPPPPTEAFF	TRBV6-5	TRBJ1-1
TGTGCCAGTAGGGACAGAGAGTCCTACGAGCAGTACTTC	CASRDRESYEQYF	TRBV19	TRBJ2-7
TGTGCCAGCAGTTACTCTCAAAGCTACAACCGGGACAGGGGTTGCACTGAAGCTTTCTTT	CASSYSQSYNRDRGCTEAFF	TRBV6-5	TRBJ1-1
TGTGCCAGCAGTTACTCTGGACGGACGCTTTTAAACTATGGCTACACCTTC	CASSYSGRTLLNYGYTF	TRBV6-2	TRBJ1-2
TGTGCCAGCAGCGGGACAGGCCGAAGCGAGCAGTACTTC	CASSGTGRSEQYF	TRBV7-9	TRBJ2-7
TGTGCCAGCAGCGCACAGGATAGGCAGCCCCAGCATTTT	CASSAQDRQPQHF	TRBV9	TRBJ1-5
TGTGCCAGCAGACGCTCGGCGACAGGGGGCCATTCCGGCTACACCTTC	CASRRSATGGHSGYTF	TRBV27	TRBJ1-2
TGCGCCAGCAGTGCAGGGGGCGGCGATACCAATTCACCCCTCCACTTT	CASSAGGGDTNSPLHF	TRBV10-1	TRBJ1-6
TGTGCCAGCAGCTTAGGACAGAAAGTTCAGCCCCAGCATTTT	CASSLGQKVQPQHF	TRBV7-3	TRBJ1-5
TGCAGTGCTAGGGGGCAGGCGACCGGAAAGTACAATGAGCAGTTCTTC	CSARGQATGKYNEQFF	TRBV20-1	TRBJ2-1
TGTGCCAGCAGTGACACGGGATCAGGCTACACCTTC	CASSDTGSGYTF	TRBV6-4	TRBJ1-2
TGTGCCAGCAGCTGTAGGGGAAATCCTAATGAAAAACTGTTTTTT	CASSCRGNPNEKLFF	TRBV11-3	TRBJ1-4
TGTGCCAGCAGTTACCCCGCTCGGTCTACTGAAGCTTTCTTT	CASSYPARSTEAFF	TRBV6-5	TRBJ1-1
TGCAGTAACGGACCCCACTCTGGAAACACCATATATTTT	CSNGPHSGNTIYF	TRBV20-1	TRBJ1-3
TGTGCCGCCCGGGACAGGGCGGGATCGCTCTCTGGAAACACCATATATTTT	CAARDRAGSLSGNTIYF	TRBV24-1	TRBJ1-3
TGTGCCAGCAGCACTAGGAAGACAGTCACTGAAGCTTTCTTT	CASSTRKTVTEAFF	TRBV7-2	TRBJ1-1
TGCGCCAGCAGCCAAGTGACTTACACTGAAGCTTTCTTT	CASSQVTYTEAFF	TRBV4-1	TRBJ1-1
TGTGCCAGCAGCCAAGTAATAGGAACTCACAGCTCCTATAATTCACCCCTCCACTTT	CASSQVIGTHSSYNSPLHF	TRBV14	TRBJ1-6
TGCGCCAGCAGCCAAGGGGGAACCTACGAGCAGTACTTC	CASSQGGTYEQYF	TRBV4-1	TRBJ2-7
TGTGCCAGCAGCGGCTTTCGGGGACTGCGCACAGATACGCAGTATTTT	CASSGFRGLRTDTQYF	TRBV7-3	TRBJ2-3
TGTGCCAGCAGCTTGGCCAGCGGGAGAGGTGCCTACGAGCAGTACTTC	CASSLASGRGAYEQYF	TRBV5-6	TRBJ2-7
TGCAGTGCTAGAGAAACTAGCGGGAGAGGGGGGCAGTTCTTC	CSARETSGRGGQFF	TRBV20-1	TRBJ2-1
TGCAGTGCTAGAGCCTTTAGCTCTGGAAACACCATATATTTT	CSARAFSSGNTIYF	TRBV20-1	TRBJ1-3
TGCAGTGCTAGTACGGCCTACGAGCAGTACTTC	CSASTAYEQYF	TRBV20-1	TRBJ2-7
TGTGCCAGCAGCTTAGGGGGGGAGGAGACCCAGTACTTC	CASSLGGEETQYF	TRBV7-9	TRBJ2-5
TGTGCCAGCAGTTTAGTGTCGGGTTCTGAAGCTTTCTTT	CASSLVSGSEAFF	TRBV6-5	TRBJ1-1
TGTGCCACCAGCAGAGATGTTCTAAGGCGGGCCCAGCATTTT	CATSRDVLRRAQHF	TRBV15	TRBJ1-5
TGTGCCAGCACCGAGGGAACACCCACAGATACGCAGTATTTT	CASTEGTPTDTQYF	TRBV2	TRBJ2-3
TGCAGCGTTGAACCTGCCGAGGGCTCCTACGAGCAGTACTTC	CSVEPAEGSYEQYF	TRBV29-1	TRBJ2-7
TGTGCCAGCAGAACTGGGACCCTCAATCAGCCCCAGCATTTT	CASRTGTLNQPQHF	TRBV6-2	TRBJ1-5
TGCGCCAGCAGCTTCCGGGGCTGTATCGAAAAACTGTTTTTT	CASSFRGCIEKLFF	TRBV5-1	TRBJ1-4
TGTGCCAGCAGCTCTTCTGACAGGGAGGAACGCTCCTACGAGCAGTACTTC	CASSSSDREERSYEQYF	TRBV13	TRBJ2-7
TGCAGCGTTGAAGCACATGACGCTAATGAGCAGTTCTTC	CSVEAHDANEQFF	TRBV29-1	TRBJ2-1
TGCAGTGCTAGGGGGGGGACTAATGGCACAGATACGCAGTATTTT	CSARGGTNGTDTQYF	TRBV20-1	TRBJ2-3
TGTGCCTGGAGTGTATTCGTGAGGGGTAACTATGGCTACACCTTC	CAWSVFVRGNYGYTF	TRBV30	TRBJ1-2
TGTGCCAGCAGTTGCCGGGACAGGGCGGGCTCTGGGGCCAACGTCCTGACTTTC	CASSCRDRAGSGANVLTF	TRBV6-3	TRBJ2-6
TGCGCCAGCAGCTTAGTCAGACAGGGGAGGGAGCAGTTCTTC	CASSLVRQGREQFF	TRBV5-1	TRBJ2-1
TGTGCCAGCAGTTTCACCCAGCGGGATGCAGATACGCAGTATTTT	CASSFTQRDADTQYF	TRBV28	TRBJ2-3
TGTGCCAGCAGCGGGTCCCGTTGGGGGACAGGGGACTATGCAACTAATGAAAAACTGTTTTTT	CASSGSRWGTGDYATNEKLFF	TRBV11-1	TRBJ1-4
TGCGCCAGCAGCTTGTACAGGGTAAAAAAGGTAGCTGGAAACACCATATATTTT	CASSLYRVKKVAGNTIYF	TRBV5-1	TRBJ1-3
TGTGCCAGCAGCTTAGGCCACCGGACCCTGTACAATGAGCAGTTCTTC	CASSLGHRTLYNEQFF	TRBV11-3	TRBJ2-1
TGTGCCAGCAGCCAGGGACAGCAAACCTGGAACACTGAAGCTTTCTTT	CASSQGQQTWNTEAFF	TRBV14	TRBJ1-1
TGTGCCAGCAGCCCGGGACAGGGAGGCACAGATACGCAGTATTTT	CASSPGQGGTDTQYF	TRBV6-5	TRBJ2-3
TGTGCCAGCAGTGACCGCGGTGGGGGCTACACCTTC	CASSDRGGGYTF	TRBV6-4	TRBJ1-2
TGTGCCATCAGTGAGTGGGACGAGCCAAACTTC	CAISEWDEPNF	TRBV10-3	TRBJ2-7
TGTGCCAGCAGTGACTCCCCGGGGGGGAATTCAGATACGCAGTATTTT	CASSDSPGGNSDTQYF	TRBV6-4	TRBJ2-3
TGTGCCAGTACTGAGAACGGGTGGGGGGGGGAGAGGTGTACACCTGAGAATTACGAGCAGTACTTC	CASTENGWGGERCTPENYEQYF	TRBV19	TRBJ2-7
TGTGCCAGCAGCTTAACACGGAAGGACCGCTTCCCCTACAATGAGCAGTTCTTC	CASSLTRKDRFPYNEQFF	TRBV7-6	TRBJ2-1
TGTGCCAGCAGCGGACTAGCGCCCACCGGGGAGCTGTTTTTT	CASSGLAPTGELFF	TRBV7-8	TRBJ2-2
TGTGCCAGCAGCTTGGTCCGAGGCGGGAAGAGCGAGCAGTACTTC	CASSLVRGGKSEQYF	TRBV7-3	TRBJ2-7
TGTGCCAGCAGCTTAGCGGTAAGCCGGGGCGAGCAGTACTTC	CASSLAVSRGEQYF	TRBV11-2	TRBJ2-7
TGTACCGCCAGCAGGCGGGGGGATCGCACAGATACGCAGTATTTT	CTASRRGDRTDTQYF	TRBV6-1	TRBJ2-3
TGTGCCAGCAGCTTGGACAGGGGGACCTCCTATAATTCACCCCTCCACTTT	CASSLDRGTSYNSPLHF	TRBV5-4	TRBJ1-6
TGCGCCAGCAGCCAAGCCCAAGGACTAGCGGGGCGGAGCACAGATACGCAGTATTTT	CASSQAQGLAGRSTDTQYF	TRBV4-1	TRBJ2-3
TGTGCCAGCAATAGAGAGACCCAGTACTTC	CASNRETQYF	TRBV3-1	TRBJ2-5
TGTGCCACCTCCAGTGGCTCCTACGAGCAGTACTTC	CATSSGSYEQYF	TRBV24-1	TRBJ2-7
TGTGCCAGCAGCGGCACAGAGAACACTGAAGCTTTCTTT	CASSGTENTEAFF	TRBV27	TRBJ1-1
TGTGCCAGCAGCGCCTCACCGTCTTTAGCTACCGGGGAGCTGTTTTTT	CASSASPSLATGELFF	TRBV7-3	TRBJ2-2
TGTGCCAGCAGTCCCCCATATCATGGGGCAACTAATGAAAAACTGTTTTTT	CASSPPYHGATNEKLFF	TRBV6-1	TRBJ1-4
TGTGCCAGCAGCCGGGGGGGGAGGGGGGGGCAAGAGACCCAGTACTTC	CASSRGGRGGQETQYF	TRBV5-5	TRBJ2-5
TGTGCCAGGCGGGCGACTAATGAAAAACTGTTTTTT	CARRATNEKLFF	TRBV6-2	TRBJ1-4
TGTGCCAGCTACAGTAGAGGGCTGGGAAGCAATCAGCCCCAGCATTTT	CASYSRGLGSNQPQHF	TRBV7-3	TRBJ1-5
TGTGCCAGCAGTGACGCTCAAAAGTTGACAAGGGTCCAAGAGACCCAGTACTTC	CASSDAQKLTRVQETQYF	TRBV6-4	TRBJ2-5
TGTGCCAGTAGGAGTGGGACAGGGGGGCTCGAGCAGTACTTC	CASRSGTGGLEQYF	TRBV19	TRBJ2-7
TGCGCCAGCATAGCCACAGGGTTTTCACCCCTCCACTTT	CASIATGFSPLHF	TRBV10-1	TRBJ1-6
TGTGCCAGCAGCCAAGTCAGGAATGAAAAACTGTTTTTT	CASSQVRNEKLFF	TRBV14	TRBJ1-4
TGTGCCAGCAGTATGTGCGGACGGACTGAAGCTTTCTTT	CASSMCGRTEAFF	TRBV12-3	TRBJ1-1
TGTGCCAGCAGCTTACGCGCGACTAGCAATCAGCCCCAGCATTTT	CASSLRATSNQPQHF	TRBV11-3	TRBJ1-5
TGTGCCAGCAGCTTCAGGGACAGGTTCACAGATACGCAGTATTTT	CASSFRDRFTDTQYF	TRBV11-3	TRBJ2-3
