TGCGCCAGCAGCCGGGTAGGCCATAGCCCCCTCACAGATACGCAGTATTTT	CASSRVGHSPLTDTQYF	TRBV4-1	TRBJ2-3
TGTGCCAGCAGCGTACCTAGCCCTGACCAGCCCCAGCATTTT	CASSVPSPDQPQHF	TRBV13	TRBJ1-5
TGTGCCAGCAGCTCGAGGAGGACAGGGGGGTTCCTTAGCAATCAGCCCCAGCATTTT	CASSSRRTGGFLSNQPQHF	TRBV7-8	TRBJ1-5
TGTGCCAGCAGCTTGCGGGAGGGTACAGCTTTCTTT	CASSLREGTAFF	TRBV7-9	TRBJ1-1
TGTGCCAGCAGCTGGAGACGATACAATGAGCAGTTCTTC	CASSWRRYNEQFF	TRBV7-3	TRBJ2-1
TGTGCCACCACAGGGGGACGGTACAACTCCTACGAGCAGTACTTC	CATTGGRYNSYEQYF	TRBV24-1	TRBJ2-7
TGTGCCAGCAGCTTGAGAAGGAGAAGTAATGAAAAACTGTTTTTT	CASSLRRRSNEKLFF	TRBV5-4	TRBJ1-4
TGTGCCAGCAGCCAAGATCTGGACCCCGGACTAGAATACACCGGGGAGCTGTTTTTT	CASSQDLDPGLEYTGELFF	TRBV4-2	TRBJ2-2
TGTGCCAGCAGCCCGTCGGCACACTCTGGGGCCAACGTCCTGACTTTC	CASSPSAHSGANVLTF	TRBV6-6	TRBJ2-6
TGCGCCAGCAGTGAACTGGACTGGGGGTACGAGCAGTACTTC	CASSELDWGYEQYF	TRBV10-1	TRBJ2-7
TGCGCCAGCAGCTTTCGGGCCTACGAGCAGTACTTC	CASSFRAYEQYF	TRBV5-1	TRBJ2-7
TGTGCCAGCAGCTTAGAATCGGACGCTTTCTTT	CASSLESDAFF	TRBV7-2	TRBJ1-1
TGTGCCAGCAGTTTCGCCGGGACAGTCTCGCAAGAGACCCAGTACTTC	CASSFAGTVSQETQYF	TRBV27	TRBJ2-5
TGTGCCACCCGTACCCCCCGGGCCTACGAGCAGTACTTC	CATRTPRAYEQYF	TRBV6-2	TRBJ2-7
TGCGCCAGCAGCCAAGATTCTAGCGGAATAGGTGCCTACGAGCAGTACTTC	CASSQDSSGIGAYEQYF	TRBV4-1	TRBJ2-7
TGTGCCACGACCCCCCGGACAGTCAAGGTAGTGAACACTGAAGCTTTCTTT	CATTPRTVKVVNTEAFF	TRBV24-1	TRBJ1-1
TGCGCCAGCGTCAGAAACGTTCTTGAGCAGTTCTTC	CASVRNVLEQFF	TRBV10-2	TRBJ2-1
TGTGCCAGCATAGGTCCTAGGCTAGCGGTGAGCTACGAGCAGTACTTC	CASIGPRLAVSYEQYF	TRBV6-4	TRBJ2-7
TGTGCCAGCAGTTTAGCAAGCGGCGGGAGGGATCAGGGTCAGCCCCAGCATTTT	CASSLASGGRDQGQPQHF	TRBV12-3	TRBJ1-5
TGTGCCATCAGTAAAGTCCCGTGGGACTACGAGCAGTACTTC	CAISKVPWDYEQYF	TRBV10-3	TRBJ2-7
TGTGCCTTAAGTTTGCAGTACTTC	CALSLQYF	TRBV6-1	TRBJ2-7
TGTGCCAGCATGGCCCGCCCCTTGGGCCTGGAGGAGGAAATGAACACTGAAGCTTTCTTT	CASMARPLGLEEEMNTEAFF	TRBV27	TRBJ1-1
TGTGCCAGCAGCGGGGACTATTCACCCCTCCACTTT	CASSGDYSPLHF	TRBV9	TRBJ1-6
TGCGCCAGAGACCAGGGATTTCGGGCCACATCCAAATTCGGGGGAAACACCATATATTTT	CARDQGFRATSKFGGNTIYF	TRBV10-1	TRBJ1-3
TGCGCCAGCAGCTTACGCAAGGGACGGGACAGTAACTCAATCACCAACACTGAAGCTTTCTTT	CASSLRKGRDSNSITNTEAFF	TRBV5-1	TRBJ1-1
TGTGCCAGCAGCGTATATTTTCCCCAGGGGCCCTCCTATGGCTACACCTTC	CASSVYFPQGPSYGYTF	TRBV9	TRBJ1-2
TGTGCCAGGGGGGACAGGGATACCTACGAGCAGTACTTC	CARGDRDTYEQYF	TRBV19	TRBJ2-7
TGTGCCAGCAGCCCCGGTAAAAGGGCGGTTTACGAGCAGTACTTC	CASSPGKRAVYEQYF	TRBV5-6	TRBJ2-7
TGTGCCAGCAGCCAAGATGTCGCCCAGGTCCGAAACACCATATATTTT	CASSQDVAQVRNTIYF	TRBV14	TRBJ1-3
TGTGCCAGCAGTGAAATCCCGAGAGGGGGGGACACAGATACGCAGTATTTT	CASSEIPRGGDTDTQYF	TRBV25-1	TRBJ2-3
TGTGCCACCAGTGATACCGGGAGAATAGCTGGCGGCACAGATACGCAGTATTTT	CATSDTGRIAGGTDTQYF	TRBV24-1	TRBJ2-3
TGTGCCAGCAGTGACACTAGCGGGAACCAGTTAAGCACGGAGCAGTACTTC	CASSDTSGNQLSTEQYF	TRBV12-3	TRBJ2-7
TGTGCCAGCAGCCTGAGTCCCGGGACAAACTATGGCTACACCTTC	CASSLSPGTNYGYTF	TRBV7-9	TRBJ1-2
TGTGCCATCCAGGGGGGGGGCTCTCTAGCCAAAAACATTCAGTACTTC	CAIQGGGSLAKNIQYF	TRBV10-3	TRBJ2-4
TGTGCCAGCAGCTTGCCCCGGGGAAAGAGCTCCTATAATTCACCCCTCCACTTT	CASSLPRGKSSYNSPLHF	TRBV5-6	TRBJ1-6
TGTGCCAGCAGCCAAGGAGGGGAGGTAGCCAAAAACATTCAGTACTTC	CASSQGGEVAKNIQYF	TRBV3-1	TRBJ2-4
TGTGCCAGCAGCTTAGGGCACAATTCACCCCTCCACTTT	CASSLGHNSPLHF	TRBV11-2	TRBJ1-6
TGTGCCAGCAGCTCCAGGAACACTGAAGCTTTCTTT	CASSSRNTEAFF	TRBV13	TRBJ1-1
TGTGCTAGTGGTTTTCCTAGGAGGGGCTACACCTTC	CASGFPRRGYTF	TRBV12-5	TRBJ1-2
TGCAGTGCAATTACGGAACAGGGCCAGGAAAAACTGTTTTTT	CSAITEQGQEKLFF	TRBV20-1	TRBJ1-4
TGTGCCAGCTGGGGGGACGTCTATGGCTACACCTTC	CASWGDVYGYTF	TRBV12-3	TRBJ1-2
TGTGCCAGCAGTGACTCAAGGGGAGCAACTAATGAAAAACTGTTTTTT	CASSDSRGATNEKLFF	TRBV6-4	TRBJ1-4
TGTGCCAGCAGCCGATTCATCCGAGTCTTCACAGGGAAACTCACCGGGGAGCTGTTTTTT	CASSRFIRVFTGKLTGELFF	TRBV7-3	TRBJ2-2
TGTGCCACCAGTGATGGAACCAGGGCTAAGAATTCGGATAATGAAAAACTGTTTTTT	CATSDGTRAKNSDNEKLFF	TRBV24-1	TRBJ1-4
TGTGCCAGCAGTGACCCCGGGACAGGGGATCAGCCCCAGCATTTT	CASSDPGTGDQPQHF	TRBV6-4	TRBJ1-5
TGTGCCAGCACCGCGGGCCTGATTCTGGGTCCCGAGCAGTACTTC	CASTAGLILGPEQYF	TRBV6-1	TRBJ2-7
TGTGCCAGCAGCACCGTGGCAGGGGTTAATTCACCCCTCCACTTT	CASSTVAGVNSPLHF	TRBV6-8	TRBJ1-6
TGTGCCAGCAGTTATTTCCTAGCGGCCTACGAGCAGTACTTC	CASSYFLAAYEQYF	TRBV12-3	TRBJ2-7
TGCAGTGCTAGAGATCTACAGGGGCAAGGCGAGGGTAACTATGGCTACACCTTC	CSARDLQGQGEGNYGYTF	TRBV20-1	TRBJ1-2
TGCAGTGCTAGACATCTAGAGGATTCACCCCTCCACTTT	CSARHLEDSPLHF	TRBV20-1	TRBJ1-6
TGTGCCACCAGTGAAACCAGCGGGATTGGCTATGAGCAGTTCTTC	CATSETSGIGYEQFF	TRBV24-1	TRBJ2-1
TGTGCCAGCAGCGTCCTCCGGGGTGACAACACTGAAGCTTTCTTT	CASSVLRGDNTEAFF	TRBV9	TRBJ1-1
TGTGCCAGCAGCGCGGACAGGGGGGGGCAAACTGGAAACACCATATATTTT	CASSADRGGQTGNTIYF	TRBV9	TRBJ1-3
TGTGCCAGCAGCTTAGTACAGGGTAATGAAAAACTGTTTTTT	CASSLVQGNEKLFF	TRBV7-9	TRBJ1-4
TGTGCCAGCAGCCGTATAGGCTCCTACGAGCAGTACTTC	CASSRIGSYEQYF	TRBV7-2	TRBJ2-7
TGTGCCAGCAGCCTCCCGCTAGCGGGTTTTGACATTCAGTACTTC	CASSLPLAGFDIQYF	TRBV13	TRBJ2-4
TGCGCCAGCAGCTTGCCCAGAGATCAGCCCCAGCATTTT	CASSLPRDQPQHF	TRBV5-1	TRBJ1-5
TGCAGTGCTAGCCGAACGGGAATCCAGCCGGAGCAGTACTTC	CSASRTGIQPEQYF	TRBV20-1	TRBJ2-7
TGTGCCAGCAGCATTACCCTTCCTGCGGGAGGACGGTCGGTCCACTTAGTCTCCTACGAGCAGTACTTC	CASSITLPAGGRSVHLVSYEQYF	TRBV7-8	TRBJ2-7
TGTGCCAGCAGTAATCGACTAGCGACAGATACGCAGTATTTT	CASSNRLATDTQYF	TRBV27	TRBJ2-3
TGTGCCAGCGGGGATGAAGCTTTCTTT	CASGDEAFF	TRBV27	TRBJ1-1
TGTGCCACTCCGGGAAGAGGGGGGGGCACAGATACGCAGTATTTT	CATPGRGGGTDTQYF	TRBV24-1	TRBJ2-3
TGTGCCAGCAGCAGGGACAGGGACCGCCCGAACACTGAAGCTTTCTTT	CASSRDRDRPNTEAFF	TRBV13	TRBJ1-1
TGTGCGGACCGAACGCGCCAAGAGACCCAGTACTTC	CADRTRQETQYF	TRBV2	TRBJ2-5
TGTGCCAGTAGTATGAGGAGAGGCGCCAAAAACATTCAGTACTTC	CASSMRRGAKNIQYF	TRBV19	TRBJ2-4
TGTGCCAGCAGGGTTCTAGCGGGCTGTGGAGATACGCAGTATTTT	CASRVLAGCGDTQYF	TRBV12-3	TRBJ2-3
TGTGCCAGCAGCTTAGCCATCAGGTCCTACGAGCAGTACTTC	CASSLAIRSYEQYF	TRBV11-2	TRBJ2-7
TGTGCCAGCAGCTGGGGGGCCGCAGATGGGGCCAACGTCCTGACTTTC	CASSWGAADGANVLTF	TRBV13	TRBJ2-6
TGTGCCAGCAGCAAAAGCGGGAGGATCTCCAGCTCCTACAATGAGCAGTTCTTC	CASSKSGRISSSYNEQFF	TRBV6-4	TRBJ2-1
TGTGCCAGCAGCAGGTACACCTATTTTGGCACAGATACGCAGTATTTT	CASSRYTYFGTDTQYF	TRBV6-2	TRBJ2-3
TGCAGTGCTAGTGAACTAGCGACAGATACGCAGTATTTT	CSASELATDTQYF	TRBV20-1	TRBJ2-3
TGTGCCATGGGGTATGGGGAGCTGTTTTTT	CAMGYGELFF	TRBV19	TRBJ2-2
TGTGCCAGCAAAGTACTAGGTGTCAATGAGCAGTTCTTC	CASKVLGVNEQFF	TRBV6-6	TRBJ2-1
TGTGCCAGCAGCCCCCCAGATGGGGTAGGCATGAACACTGAAGCTTTCTTT	CASSPPDGVGMNTEAFF	TRBV6-5	TRBJ1-1
TGTTTCCGCGGGAGCCGTAACAATGAGCAGTTCTTC	CFRGSRNNEQFF	TRBV30	TRBJ2-1
TGTGCCAGCAGCCAAGAAGGTAGAAAAGATACGCAGTATTTT	CASSQEGRKDTQYF	TRBV14	TRBJ2-3
TGTGCCAGCAGCTTACTAGCGGGTAAAGAGACCCAGTACTTC	CASSLLAGKETQYF	TRBV11-1	TRBJ2-5
TGCGCCAGCAGCCACGGGGGGGCCAACACCGGGGAGCTGTTTTTT	CASSHGGANTGELFF	TRBV4-1	TRBJ2-2
TGCGCCAGCACCGGTTGGGGGGGCGTCAATGAGCAGTTCTTC	CASTGWGGVNEQFF	TRBV10-1	TRBJ2-1
TGCAGTGCGGGACTAGACGAGCAGTACTTC	CSAGLDEQYF	TRBV20-1	TRBJ2-7
TGTGCCAGCAGCTTGGCGGACAGGGGTCAGCCCCAGCATTTT	CASSLADRGQPQHF	TRBV5-6	TRBJ1-5
TGTGCCAGCAGGGAGCACGACAGAGGAGCTAACTATGGCTACACCTTC	CASREHDRGANYGYTF	TRBV6-1	TRBJ1-2
TGTGCCAGCACAGGGACAACCGGGGAGCTGTTTTTT	CASTGTTGELFF	TRBV7-9	TRBJ2-2
TGTGCCAGCAGCTTCTTCTGGCGTGACGATTGTAGGGAGCGGAATAGCAATCAGCCCCAGCATTTT	CASSFFWRDDCRERNSNQPQHF	TRBV11-2	TRBJ1-5
TGTGCCAGCAGTTCGGACCCAAATCTCTACAATGAGCAGTTCTTC	CASSSDPNLYNEQFF	TRBV27	TRBJ2-1
TGTGCCAGCAGTTTGGGGGTCCTCGAGCAGTACTTC	CASSLGVLEQYF	TRBV6-1	TRBJ2-7
TGTGCCAGCAGCAAATTCCAGGAGGGGTCCTATGGCTACACCTTC	CASSKFQEGSYGYTF	TRBV7-3	TRBJ1-2
TGTGCCAGTAGGTATAACCGGGCTCGTGGCTACACCTTC	CASRYNRARGYTF	TRBV19	TRBJ1-2
TGTGCCAGCCGAAATCAGCCCCAGCATTTT	CASRNQPQHF	TRBV6-5	TRBJ1-5
TGTGCCAGCTCACCCCCCCCCGGGACCACATATAGCAATCAGCCCCAGCATTTT	CASSPPPGTTYSNQPQHF	TRBV18	TRBJ1-5
TGTGCCAGCAGCTTAGGACAGGAGAGAACTAATGAAAAACTGTTTTTT	CASSLGQERTNEKLFF	TRBV11-2	TRBJ1-4
TGTGCCAGCAGCTTAATACCGCGGGAGACCCTCCGTTCCTACGAGCAGTACTTC	CASSLIPRETLRSYEQYF	TRBV11-2	TRBJ2-7
TGTGCCATCAAGTGGCTCCCGGGACTAGCGGGAGTGCGTGTGAACACTGAAGCTTTCTTT	CAIKWLPGLAGVRVNTEAFF	TRBV10-3	TRBJ1-1
TGCAGTGACAGTAATTATAATTCACCCCTCCACTTT	CSDSNYNSPLHF	TRBV20-1	TRBJ1-6
TGTGCCAGCAGCTTACGAGTATCAGCTAATGAAAAACTGTTTTTT	CASSLRVSANEKLFF	TRBV11-1	TRBJ1-4
TGTGCCAGCAGCCCCACATACAAGTCTACGCACGCCTACGAGCAGTACTTC	CASSPTYKSTHAYEQYF	TRBV7-2	TRBJ2-7
TGTGCCAGCAGCGGCCTCGGATCCACTTGGAGGGGGTGGGGTAATTCACCCCTCCACTTT	CASSGLGSTWRGWGNSPLHF	TRBV7-2	TRBJ1-6
TGCGCCAGCAGCTTAAACCTTTATTTTGGCTACACCTTC	CASSLNLYFGYTF	TRBV5-1	TRBJ1-2
TGTGCCAGCAGCCCCGGGCGCCCCGGTGAAAAACTGTTTTTT	CASSPGRPGEKLFF	TRBV5-6	TRBJ1-4
TGTGCGAGGAGGAATCAGCCCCAGCATTTT	CARRNQPQHF	TRBV6-4	TRBJ1-5
TGTGCCAGCAGTTACCTTCAGGCCTTTTATGAGACCCAGTACTTC	CASSYLQAFYETQYF	TRBV6-6	TRBJ2-5
TGTGCTAGCAGAAGTCGGGACAGGGGGTCCTACGAGCAGTACTTC	CASRSRDRGSYEQYF	TRBV7-7	TRBJ2-7
TGCGCCAGCAGCCCGGGACAGGGACGAAAGCATGAGCAGTTCTTC	CASSPGQGRKHEQFF	TRBV5-1	TRBJ2-1
TGTGCCAGCAGCCGGACACCTAACTATGGCTACACCTTC	CASSRTPNYGYTF	TRBV6-5	TRBJ1-2
TGTGCCACTAGCGGGAGACCCGTGGTTCCCTACGAGCAGTACTTC	CATSGRPVVPYEQYF	TRBV3-1	TRBJ2-7
TGCAGTGCTAGAATAGCCTATGGCTACACCTTC	CSARIAYGYTF	TRBV20-1	TRBJ1-2
TGTGCCAGCATACCTCGGCAGATTGGGTTGCTCACTGAAGCTTTCTTT	CASIPRQIGLLTEAFF	TRBV6-5	TRBJ1-1
TGCAGTGCTGGGGCAGGGCGGTTAAGCGGGGTTGGGAAGAGGTGTGAAAAACTGTTTTTT	CSAGAGRLSGVGKRCEKLFF	TRBV20-1	TRBJ1-4
TGTGCCAGCAGCTTACACGCCGAGGGACTAGCGGGCTCTTTTTCCTCCTACAATGAGCAGTTCTTC	CASSLHAEGLAGSFSSYNEQFF	TRBV7-9	TRBJ2-1
TGTGCCAGCAGTGGTACAGGGGGGAGCAATCAGCCCCAGCATTTT	CASSGTGGSNQPQHF	TRBV12-3	TRBJ1-5
TGTGCCACCAGTGCGAAGGGCCCTTATGGCTACACCTTC	CATSAKGPYGYTF	TRBV24-1	TRBJ1-2
TGTGCCAGCAGCGGGCCAGGAATAGAGACCCAGTACTTC	CASSGPGIETQYF	TRBV9	TRBJ2-5
TGTGCCAGCAGCCAAGATTCGAGCCGAAATTCGGGACCGGAAGAGACCCAGTACTTC	CASSQDSSRNSGPEETQYF	TRBV14	TRBJ2-5
TGTGCCAGCAGTTACCAAGAAATAGGGACTAGCGGGACCTGTCGGTATGTCTACGAGCAGTACTTC	CASSYQEIGTSGTCRYVYEQYF	TRBV6-6	TRBJ2-7
TGTGCCAGCAGTACCCGGGAGGTGTACCACGAGCAGTACTTC	CASSTREVYHEQYF	TRBV25-1	TRBJ2-7
TGTGCCAGCAGCCAGGGCTCCTACGAGCAGTACTTC	CASSQGSYEQYF	TRBV7-2	TRBJ2-7
TGCAGTGCTGAACGACCGGAAAACAATGAGCAGTTCTTC	CSAERPENNEQFF	TRBV20-1	TRBJ2-1
TGTGCCAGCCCCTGGGGCCAAGAGACCCAGTACTTC	CASPWGQETQYF	TRBV6-1	TRBJ2-5
TGTGCCTGGACCTGGGGAGGCTCCGATACGCAGTATTTT	CAWTWGGSDTQYF	TRBV30	TRBJ2-3
TGTGCCAGCAGCCCGTACGGACAGGGCCTCGGGAGCTATGGCTACACCTTC	CASSPYGQGLGSYGYTF	TRBV7-4	TRBJ1-2
TGTGCCAGCAGTTACACGCAGGGGATCACAGATACGCAGTATTTT	CASSYTQGITDTQYF	TRBV6-5	TRBJ2-3
TGTGCCATACAGGGGTGTCAGCCCCAGCATTTT	CAIQGCQPQHF	TRBV6-2	TRBJ1-5
TGCAGTGCTAGAGATCTCCCCACGGGTGGGACAAGGACTGAAGCTTTCTTT	CSARDLPTGGTRTEAFF	TRBV20-1	TRBJ1-1
TGTGCCAGCAGCTCGGGGAAGAGCACCGGGGAGCTGTTTTTT	CASSSGKSTGELFF	TRBV11-2	TRBJ2-2
TGTGCCAGCAGTGAGCGGGACAGAACCTCCTACAATGAGCAGTTCTTC	CASSERDRTSYNEQFF	TRBV2	TRBJ2-1
TGTGCCAGCAGTGAGGAGCGGGAGGGCTACGAGCAGTACTTC	CASSEEREGYEQYF	TRBV5-6	TRBJ2-7
TGTGCCAGCAGGGGGGACATCGGGGCCAACGTCCTGACTTTC	CASRGDIGANVLTF	TRBV7-6	TRBJ2-6
TGTGCCAGCAGTCTCCTAGCGGTTCCTAGCACAGATACGCAGTATTTT	CASSLLAVPSTDTQYF	TRBV3-1	TRBJ2-3
TGTGCCAGGACAGGAAACTATGGCTACACCTTC	CARTGNYGYTF	TRBV7-3	TRBJ1-2
TGTGCCAGCAGCTCGGAACTGGAGGGGGCCTTTAACTATGGCTACACCTTC	CASSSELEGAFNYGYTF	TRBV13	TRBJ1-2
TGTGCCAGCAGCCATCATCGATCTACCTTGATTTCTTCCGAGCAGTACTTC	CASSHHRSTLISSEQYF	TRBV13	TRBJ2-7
TGTGCCAGCAGCTTGGACCCGGAGGGACAGGGGATTGCCCCTATGAACACTGAAGCTTTCTTT	CASSLDPEGQGIAPMNTEAFF	TRBV5-4	TRBJ1-1
TGCGCCAGCAGTGAACCGGGAGGGGGAGCCGGCTATAATTCACCCCTCCACTTT	CASSEPGGGAGYNSPLHF	TRBV10-1	TRBJ1-6
TGTGCCAGCAGCTTAGAAAGTCGGAACGGGGATGAGCAGTTCTTC	CASSLESRNGDEQFF	TRBV11-3	TRBJ2-1
TGTGCCAGCAGCCGTTCGACGACCGGGGAGCTGTTTTTT	CASSRSTTGELFF	TRBV7-4	TRBJ2-2
TGTGCCAGCAGCTTTTCCGGCCCCCTGGCCCAAGAGACCCAGTACTTC	CASSFSGPLAQETQYF	TRBV7-4	TRBJ2-5
TGTGCCAGCAGGACCGGGACAGGGATGACGAGCACAGATACGCAGTATTTT	CASRTGTGMTSTDTQYF	TRBV12-3	TRBJ2-3
TGTGCCAGCAGCCTCCCGGGGACGCTGGCCCAGCATTTT	CASSLPGTLAQHF	TRBV14	TRBJ1-5
TGCAGTGCTAGTAGTAGGGGATTCGGGGAGCTGTTTTTT	CSASSRGFGELFF	TRBV20-1	TRBJ2-2
TGTGCCCTACACGAGACAAGGAACACTGAAGCTTTCTTT	CALHETRNTEAFF	TRBV6-3	TRBJ1-1
TGTGCCAGCAGTGACTCGATAGGGCCTGGACCCCCGGAGTCAGAGAACACCGGGGAGCTGTTTTTT	CASSDSIGPGPPESENTGELFF	TRBV6-4	TRBJ2-2
TGTGCCAGCAGTTTTTATCCGGAGCGCTCCTACGAGCAGTACTTC	CASSFYPERSYEQYF	TRBV6-2	TRBJ2-7
TGCAGTGCCGCCCCTCAAGCGGGAGCGTGGAATGAGCAGTTCTTC	CSAAPQAGAWNEQFF	TRBV20-1	TRBJ2-1
TGTGCCCCCCGGTCTGATTCCACCGGGACTAGCGGCTGGTGGAATGCATTACGCACAGATACGCAGTATTTT	CAPRSDSTGTSGWWNALRTDTQYF	TRBV6-5	TRBJ2-3
TGCAGCGTTGACGGGGTAGCTTTCTTT	CSVDGVAFF	TRBV29-1	TRBJ1-1
TGTGCCACCAGTGATTCCCTAGCGGGAAGGACTGAAGCTTTCTTT	CATSDSLAGRTEAFF	TRBV24-1	TRBJ1-1
TGTGCCACCACTCCGACAGGACAGAATATTTTTAATTCACCCCTCCACTTT	CATTPTGQNIFNSPLHF	TRBV24-1	TRBJ1-6
TGTGCCAGCAGCTCGGTACGTAAGAGCGGGGAGCTGTTTTTT	CASSSVRKSGELFF	TRBV5-4	TRBJ2-2
TGTGCCAGCTCCCAGCCCCATACTAGCGGGCAAGCAGATACGCAGTATTTT	CASSQPHTSGQADTQYF	TRBV27	TRBJ2-3
TGTGCCAGCAGCTGCCGGGCACAGGGATACGAGCAGTACTTC	CASSCRAQGYEQYF	TRBV7-9	TRBJ2-7
TGTGCCAGCAGCTCTTCACCTAATGAGCAGTTCTTC	CASSSSPNEQFF	TRBV5-5	TRBJ2-1
TGCAGTGCTAGAAGTTGTCCGACTAGCGGGTGCGGGGCCTACGAGCAGTACTTC	CSARSCPTSGCGAYEQYF	TRBV20-1	TRBJ2-7
TGTGCCAGCAGTCCCGGGAAAAAAAGCTCCTACAATGAGCAGTTCTTC	CASSPGKKSSYNEQFF	TRBV27	TRBJ2-1
TGCGCCAGCAGCCCAGGGGACAGGGCCCGCAACACCGGGGAGCTGTTTTTT	CASSPGDRARNTGELFF	TRBV5-1	TRBJ2-2
TGTGCCAGCAATTCGGGGTCACGAGAGACCCAGTACTTC	CASNSGSRETQYF	TRBV27	TRBJ2-5
TGTGCCAGCCAGAGAAACACCATATATTTT	CASQRNTIYF	TRBV9	TRBJ1-3
TGTGCCAGTACTAAGGGGAAGGAACCCTACGAGCAGTACTTC	CASTKGKEPYEQYF	TRBV19	TRBJ2-7
TGTGCCAGCAGTTTCCCGGAAAAATACGAGCAGTACTTC	CASSFPEKYEQYF	TRBV27	TRBJ2-7
TGTGCCACCAGTGATTTCCGGGGGCGGTTACGAGCCAAAAACATTCAGTACTTC	CATSDFRGRLRAKNIQYF	TRBV24-1	TRBJ2-4
TGCAGTGCTAGTAACCCTAAAGGGCCCGAGGAGCAGTACTTC	CSASNPKGPEEQYF	TRBV20-1	TRBJ2-7
TGTGCCAGCAGAACGAGATCCTCCTACGAGCAGTACTTC	CASRTRSSYEQYF	TRBV3-1	TRBJ2-7
TGTGCCAGTAGTATTCGGGGATACAATTCACCCCTCCACTTT	CASSIRGYNSPLHF	TRBV19	TRBJ1-6
TGTGCCAGCAGCCTCCCGAGAGCGGGATTGAAGACCGGGGAGCTGTTTTTT	CASSLPRAGLKTGELFF	TRBV6-2	TRBJ2-2
TGTGCCAGCAGACTATTCGGTAAGGGTATAGGGGGAAACACCATATATTTT	CASRLFGKGIGGNTIYF	TRBV12-4	TRBJ1-3
TGTGCCAGTGGAGAATCGGAACGCGAGCAGTACTTC	CASGESEREQYF	TRBV19	TRBJ2-7
TGTGCCAGCAGTTATTGGGACAGGGTGGTTGGCTACACCTTC	CASSYWDRVVGYTF	TRBV6-3	TRBJ1-2
TGCGCCAGCAGCTTGGGCTTCACGACAGCCTTCTACGAGCAGTACTTC	CASSLGFTTAFYEQYF	TRBV5-1	TRBJ2-7
TGTGCCAGCAGTTACTCGACAGGGGACAATGAGCAGTTCTTC	CASSYSTGDNEQFF	TRBV6-5	TRBJ2-1
TGTGCCAGCAGCTTAATGGGGTGTCCGGAGACCCAGTACTTC	CASSLMGCPETQYF	TRBV7-3	TRBJ2-5
TGTGCCAGCAGTTTCACGTTCCCCACAGCCTACGAGCAGTACTTC	CASSFTFPTAYEQYF	TRBV12-4	TRBJ2-7
TGCAGTGCCTATACAATAGGCTCCTACGAGCAGTACTTC	CSAYTIGSYEQYF	TRBV20-1	TRBJ2-7
TGTGCCAGCTCACCACCGAATAATCCGGGACGGGTGTTGGGGCATAGGAGCTCCTACAATGAGCAGTTCTTC	CASSPPNNPGRVLGHRSSYNEQFF	TRBV18	TRBJ2-1
TGCAGCGGGAGCGATGGCTACACCTTC	CSGSDGYTF	TRBV20-1	TRBJ1-2
TGTGCCACCAGTGTACCCGGGACTCAGTTAACGGGCTCCTACGAGCAGTACTTC	CATSVPGTQLTGSYEQYF	TRBV24-1	TRBJ2-7
TGTGCCAGCAGCACTGGGGGTGAGACCCAGTACTTC	CASSTGGETQYF	TRBV5-4	TRBJ2-5
TGCGCCAGCAGTGAGACAACCCCAGAAATCAAAAACATTCAGTACTTC	CASSETTPEIKNIQYF	TRBV10-1	TRBJ2-4
TGTGCCAGCAGTTTCCCAGACAGGACCTATGGCTACACCTTC	CASSFPDRTYGYTF	TRBV27	TRBJ1-2
TGTGCCAGCACCCCACCCTGGGGCTTCTACGAGCAGTACTTC	CASTPPWGFYEQYF	TRBV27	TRBJ2-7
TGTGCCAGCAGCCAAGGCAAACCGGACAGGGGGCCACCAGGCTACACCTTC	CASSQGKPDRGPPGYTF	TRBV4-2	TRBJ1-2
TGCGCCAGCGACACCCTCAGCTCCTACGAGCAGTACTTC	CASDTLSSYEQYF	TRBV10-1	TRBJ2-7
TGTGCCAGCAGCGTAGGTCGAAAAACAGGGGACAAACTGTTTTTT	CASSVGRKTGDKLFF	TRBV9	TRBJ1-4
TGTGCCAGCAGCTCCCCCCGGGACAGGGGCATACCGCGAGTCTTC	CASSSPRDRGIPRVF	TRBV7-2	TRBJ2-1
TGTGCCACCTCCCCTCTACTTAGGGCGGCCTCTGGGGCCAACGTCCTGACTTTC	CATSPLLRAASGANVLTF	TRBV24-1	TRBJ2-6
TGTGCCAGCAGCAGACTAGCCCCCTACGAGCAGTACTTC	CASSRLAPYEQYF	TRBV6-5	TRBJ2-7
TGTGCCAGCAGCTCCGGACAGAAAGCCACTGAAGCTTTCTTT	CASSSGQKATEAFF	TRBV11-3	TRBJ1-1
TGCGCCAGCAGCCAAGATACTAGCGGGAGAGGCGGCACGAACACCGGGGAGCTGTTTTTT	CASSQDTSGRGGTNTGELFF	TRBV4-3	TRBJ2-2
TGCAGTGCTCCCAAGGGCACGAACTATGGCTACACCTTC	CSAPKGTNYGYTF	TRBV20-1	TRBJ1-2
TGCAGTGCGAGGGGGAAGAATGAAAAACTGTTTTTT	CSARGKNEKLFF	TRBV20-1	TRBJ1-4
TGTGCCACCATGGGGCAGTGGGGGGCCCATTGGATGGGCAATCAGCCCCAGCATTTT	CATMGQWGAHWMGNQPQHF	TRBV24-1	TRBJ1-5
TGTGCCAGCAGACTACCTAGGGCTAGTGGCTATGGCTACACCTTC	CASRLPRASGYGYTF	TRBV12-4	TRBJ1-2
TGTGCCAGCAGCCCTCGCACGAGGACTAGCGGGTCCCGGAAAGAGACCCAGTACTTC	CASSPRTRTSGSRKETQYF	TRBV13	TRBJ2-5
TGCGCCAGCAGTGGACCCCCCGACAGGGACTGGCGTCGGAACTATGGCTACACCTTC	CASSGPPDRDWRRNYGYTF	TRBV10-1	TRBJ1-2
TGCGCCAGCAGGGGAGTTTCCTCCTACGAGCAGTACTTC	CASRGVSSYEQYF	TRBV10-1	TRBJ2-7
TGTGCCAGCAGCTTACTGACTAGTTATCCGGATACGCAGTATTTT	CASSLLTSYPDTQYF	TRBV11-1	TRBJ2-3
TGTGCCAGCTCACCGGACAGGGGGGCTAAATGGAAGGCAGATACGCAGTATTTT	CASSPDRGAKWKADTQYF	TRBV18	TRBJ2-3
TGCGCCAGCAGCTTGCAGCTATTGGAGGGGGTCTATGGCTACACCTTC	CASSLQLLEGVYGYTF	TRBV5-1	TRBJ1-2
TGTGCCACCAGTGATCTGCTCCGGGACGTAGTCCAAGAGACCCAGTACTTC	CATSDLLRDVVQETQYF	TRBV24-1	TRBJ2-5
TGTGCCAGTAGTATAACGTGGTTTCTAGCGGGGGCTCACGAGCAGTACTTC	CASSITWFLAGAHEQYF	TRBV19	TRBJ2-7
TGTGCCAGCAACCTTGGACTAGCGGGCTCCTACAATGAGCAGTTCTTC	CASNLGLAGSYNEQFF	TRBV2	TRBJ2-1
TGTGCCATTTGGAAAAGGGGACAGTGTGCCAATTCACCCCTCCACTTT	CAIWKRGQCANSPLHF	TRBV10-3	TRBJ1-6
TGTGCCAGCAGCTTATGCAACAGGGGGGGGGGGATTCGTAAGGCTTTCTTT	CASSLCNRGGGIRKAFF	TRBV11-2	TRBJ1-1
TGCGCCAGCAGCCCCGACAGGGGTTTCAGCGAAGAGACCCAGTACTTC	CASSPDRGFSEETQYF	TRBV4-1	TRBJ2-5
TGTGCCAGGAACAGGGCCATGCGTCCCTCCGAGAACACTGAAGCTTTCTTT	CARNRAMRPSENTEAFF	TRBV12-3	TRBJ1-1
TGTGCCAGTAGTATAGGGCTGGTCTCCTACAATGAGCAGTTCTTC	CASSIGLVSYNEQFF	TRBV19	TRBJ2-1
TGTGCCAGCAGCTCTAGCCGCCCCGGGGACCACAGGGGTTACTACGAGCAGTACTTC	CASSSSRPGDHRGYYEQYF	TRBV11-3	TRBJ2-7
TGTGCCATAGGGACCCTCCAACTAGATACGCAGTATTTT	CAIGTLQLDTQYF	TRBV10-3	TRBJ2-3
TGTGCCAGCACGGTACTGGGCGCCAAAAACATTCAGTACTTC	CASTVLGAKNIQYF	TRBV27	TRBJ2-4
TGTGCCAGCAGCCCCCTGAATGGGCAGTACTTC	CASSPLNGQYF	TRBV4-2	TRBJ2-7
TGTGCCAGCACAAGACGGGCGATGGGAAACACCATATATTTT	CASTRRAMGNTIYF	TRBV28	TRBJ1-3
TGTGCCAGCAGTTTGGATCGAGTGTGCTACGAGCAGTACTTC	CASSLDRVCYEQYF	TRBV27	TRBJ2-7
TGTGCCAGCCCAGAGATGGCAACTAATGAAAAACTGTTTTTT	CASPEMATNEKLFF	TRBV2	TRBJ1-4
TGTGCCAGCGAAGACCCCCGGGACAGAGTAATTACTGAAGCTTTCTTT	CASEDPRDRVITEAFF	TRBV12-3	TRBJ1-1
TGTGCCAGCAGGAACCCAGGGTTCTACGAGCAGTACTTC	CASRNPGFYEQYF	TRBV6-1	TRBJ2-7
TGTGCCAGTAGGGCCTCGGACACTGAAGCTTTCTTT	CASRASDTEAFF	TRBV19	TRBJ1-1
TGCGCCAGCAGCCAGCGGTCCCCTCGAATATCACCCCTCCACTTT	CASSQRSPRISPLHF	TRBV4-1	TRBJ1-6
TGTGCCAGCTCACCACTCCCGGGTATCGAGCAGTACTTC	CASSPLPGIEQYF	TRBV18	TRBJ2-7
TGTGCCAGCAGCCGCGTATGCTACGAGCAGTACTTC	CASSRVCYEQYF	TRBV3-1	TRBJ2-7
TGTGCCAGCAGGAAAGGGACAGGGGAAATTCTCTTC	CASRKGTGEILF	TRBV7-3	TRBJ2-1
TGTGCCAGCAGCCAAGATCGCCCCTTCCTCCCTTATGAGGGACAGGGTACGTTTATGGTACCCGACTATGGCTACACCTTC	CASSQDRPFLPYEGQGTFMVPDYGYTF	TRBV14	TRBJ1-2
TGTGCCAGCAGCGGGGGGCATACGCAGTATTTT	CASSGGHTQYF	TRBV9	TRBJ2-3
TGTGCCAAAGTTACGTGTCGGAACACCGGGGAGCTGTTTTTT	CAKVTCRNTGELFF	TRBV11-3	TRBJ2-2
TGTGCCAGCAGTATGTCTGTGACTAGATTCAATGAGCAGTTCTTC	CASSMSVTRFNEQFF	TRBV28	TRBJ2-1
TGTGCCAGCAGTAGTTGGCGCATCCGGGACAGATCCGCGTACCTACCTGAAGCTTTCTTT	CASSSWRIRDRSAYLPEAFF	TRBV27	TRBJ1-1
TGTGCCAGCAGCTCACAAGGGATTTATAATTCACCCCTCCACTTT	CASSSQGIYNSPLHF	TRBV7-9	TRBJ1-6
TGTGCCAGCAGTAGAGGGCGGGAGGACCGGTACAATGAGCAGTTCTTC	CASSRGREDRYNEQFF	TRBV6-2	TRBJ2-1
TGTGCCTGGAGTGTACGACAGGGCTATGAAAAACTGTTTTTT	CAWSVRQGYEKLFF	TRBV30	TRBJ1-4
TGCGCCAGCAGTGCCTCGGACAGGGTCGGTGGAAACACCATATATTTT	CASSASDRVGGNTIYF	TRBV10-1	TRBJ1-3
TGTGCCAGCAGTTTATTCCGGGGCGCGGAGTATAATTCACCCCTCCACTTT	CASSLFRGAEYNSPLHF	TRBV27	TRBJ1-6
TGTGCCAGCAGCAGCGGGAGGGAAGATGGAAACACCATATATTTT	CASSSGREDGNTIYF	TRBV7-9	TRBJ1-3
TGTGCCAGCAGCTTATCGACTCCAGAGTATACTGAAGCTTTCTTT	CASSLSTPEYTEAFF	TRBV11-3	TRBJ1-1
TGTGCCGACAAGATGAACTTGCTAGCGTCCCACGAGCAGTACTTC	CADKMNLLASHEQYF	TRBV6-1	TRBJ2-7
TGTGCCAGCAGTGGAAAGGGGGGAACCACCATATATTTT	CASSGKGGTTIYF	TRBV6-4	TRBJ1-3
TGTGCCCCCTTTACCGAGGGGGCGATTCCGGAGCAGTACTTC	CAPFTEGAIPEQYF	TRBV5-6	TRBJ2-7
TGTGCCAGTTCCCAGGTCAAGGGGGGGACTCCAGATACGCAGTATTTT	CASSQVKGGTPDTQYF	TRBV19	TRBJ2-3
TGTGCCAGCAGCGGTCCGACTAGTTTATACAATGAGCAGTTCTTC	CASSGPTSLYNEQFF	TRBV6-5	TRBJ2-1
TGTGCCAGCAGTAAGCGCCAGGGGTTCGGGGTCACTGAAGCTTTCTTT	CASSKRQGFGVTEAFF	TRBV12-3	TRBJ1-1
TGTGCCAGCTCGGGTGACAGGCGAGGAACAGATACGCAGTATTTT	CASSGDRRGTDTQYF	TRBV18	TRBJ2-3
TGTGCCAGCAGCCAAAAGCCGGGACAGGGCGATCCTCACGAGCAGTACTTC	CASSQKPGQGDPHEQYF	TRBV3-1	TRBJ2-7
TGCAGTGCTAGCGCAGGGGGCTTCGGCTACACCTTC	CSASAGGFGYTF	TRBV20-1	TRBJ1-2
TGTGCCAGCAGCCCTCGCTTTAATGAAAAACTGTTTTTT	CASSPRFNEKLFF	TRBV12-4	TRBJ1-4
TGTGCCAGCAGCTTCCCCCAACTGGGGGGGGATAATTCACCCCTCCACTTT	CASSFPQLGGDNSPLHF	TRBV7-2	TRBJ1-6
TGTGCCAGCAGCTTCTTCGGGGGGGGGCTCTCCTACGAGCAGTACTTC	CASSFFGGGLSYEQYF	TRBV5-6	TRBJ2-7
TGCGCCAGCAGCTGTCCCAGGACCCATACAAGCTCCTATAATTCACCCCTCCACTTT	CASSCPRTHTSSYNSPLHF	TRBV5-1	TRBJ1-6
TGTGCCTGGAGGCCTAGACAGGGTGGCTACACCTTC	CAWRPRQGGYTF	TRBV30	TRBJ1-2
TGTGCCAGCAGCTTTAAGAGCGCCTACGAGCAGTACTTC	CASSFKSAYEQYF	TRBV7-9	TRBJ2-7
TGTGCCAGCAGCTTGAGCCTCCCCCGGGAAGGGGGGGAGACCCAGTACTTC	CASSLSLPREGGETQYF	TRBV5-4	TRBJ2-5
TGTGCCAGCAGTTTAGGGCAACGGAATCAGCCCCAGCATTTT	CASSLGQRNQPQHF	TRBV12-3	TRBJ1-5
TGCGCCAGCATACCCCGACTCAGGAGTTACTTCCCCTACGAGCAGTACTTC	CASIPRLRSYFPYEQYF	TRBV10-1	TRBJ2-7
TGTGCCAGCAGTTACTCGTTAGGGGAGACCGGCTACACCTTC	CASSYSLGETGYTF	TRBV6-5	TRBJ1-2
TGTGCCAGCAGCCGGGGGGCGGGTCCGAATCAGCCCCAGCATTTT	CASSRGAGPNQPQHF	TRBV13	TRBJ1-5
TGCGCCAGCAGCCTAGGCCCCTTCGACAGGGGGCGCAGTTTCAGCAATCAGCCCCAGCATTTT	CASSLGPFDRGRSFSNQPQHF	TRBV4-3	TRBJ1-5
TGTGCCAGCAGCCAAGAGTCGGGACAGACGCCCGGCAATCAGCCCCAGCATTTT	CASSQESGQTPGNQPQHF	TRBV4-2	TRBJ1-5
TGTGCCAGCAGTGCTCAGGGGCGTCCCCATCAGCCCCAGCATTTT	CASSAQGRPHQPQHF	TRBV6-4	TRBJ1-5
TGTGCCAGCAGCGCACTTGGATTCGGGTATAATTCACCCCTCCACTTT	CASSALGFGYNSPLHF	TRBV13	TRBJ1-6
TGTGCTAGTGGTAGATTCGGGGACAGCAATGAGCAGTTCTTC	CASGRFGDSNEQFF	TRBV12-5	TRBJ2-1
TGTGCCAGCAAAGGGACACTGTTGCAGATCTACGAGCAGTACTTC	CASKGTLLQIYEQYF	TRBV6-3	TRBJ2-7
TGCGCCAGCAGCAAGGGCGGCACAGATACGCAGTATTTT	CASSKGGTDTQYF	TRBV5-1	TRBJ2-3
TGCAGTGCGCCACTGGGGAGGGAGACCCAGTACTTC	CSAPLGRETQYF	TRBV20-1	TRBJ2-5
TGCGCCAGCAGCTTGGGGGGGGGGAGGCCCAATGAGCAGTTCTTC	CASSLGGGRPNEQFF	TRBV5-1	TRBJ2-1
TGTGCCAGCAGCGTCGCAGATGGTTCCTACAATGAGCAGTTCTTC	CASSVADGSYNEQFF	TRBV9	TRBJ2-1
TGTGCCACCGAGACAGGGCCGTACAGCTACGAGCAGTACTTC	CATETGPYSYEQYF	TRBV24-1	TRBJ2-7
TGCAGTGCTAGAGCAAGCCAAGAGACCCAGTACTTC	CSARASQETQYF	TRBV20-1	TRBJ2-5
TGTGCCACAGTAGGGAACACTGAAGCTTTCTTT	CATVGNTEAFF	TRBV24-1	TRBJ1-1
TGTGCCAGCAGTGAACCGGGACTCAGCTCCTACAATGAGCAGTTCTTC	CASSEPGLSSYNEQFF	TRBV6-4	TRBJ2-1
TGCGCCAGCAGCTTGGACTTACACCGGGGCAAATGCTACGAGCAGTACTTC	CASSLDLHRGKCYEQYF	TRBV5-1	TRBJ2-7
TGTGCCAACAGGCGCTCTGGGGCCAACGTCCTGACTTTC	CANRRSGANVLTF	TRBV14	TRBJ2-6
TGTGCCAGGTCACACTACGAGCAGTACTTC	CARSHYEQYF	TRBV13	TRBJ2-7
TGTGCCTGGAGCCAGGCCTTATTCACCGCGAGCTCCTACGAGCAGTACTTC	CAWSQALFTASSYEQYF	TRBV30	TRBJ2-7
TGTGCCACCAGTGGGTACGGCGAGCAGTACTTC	CATSGYGEQYF	TRBV24-1	TRBJ2-7
TGTGCCAGTAGTATGTTCATCAGGGGGGTCGTCTACACCTTC	CASSMFIRGVVYTF	TRBV19	TRBJ1-2
TGTGCCAGCAGCCATAATGACAGCGGCTCCTACGAGCAGTACTTC	CASSHNDSGSYEQYF	TRBV3-1	TRBJ2-7
TGCAGTGCTAGCAAACCGGGACAGGGGTCGGAAAAACTGTTTTTT	CSASKPGQGSEKLFF	TRBV20-1	TRBJ1-4
TGCAGTGCACACACCGGGGAGCTGTTTTTT	CSAHTGELFF	TRBV20-1	TRBJ2-2
TGTGCCAGCAGTTTATGCCGCCGGGACAGGGAGGAGCAGTACTTC	CASSLCRRDREEQYF	TRBV28	TRBJ2-7
TGTGCCAGCAGCTGGGACAGGGGTATTTATGGCTACACCTTC	CASSWDRGIYGYTF	TRBV7-6	TRBJ1-2
TGTGCCAGCAGCTTAAACCTGCTGTACTTC	CASSLNLLYF	TRBV5-5	TRBJ2-7
TGTGCCAGCAGCTTACGCACTGGGAGTTACTACGAGCAGTACTTC	CASSLRTGSYYEQYF	TRBV13	TRBJ2-7
TGTGCCAGCAGTGACGACCGTAGATATGAGCAGTTCTTC	CASSDDRRYEQFF	TRBV6-4	TRBJ2-1
TGTGCCAGCAGTAGGGGACACTATGGCTACACCTTC	CASSRGHYGYTF	TRBV6-1	TRBJ1-2
TGTGCCAGCAGTTGTGGTTTGGGGGACGGGGACAATGAGCAGTTCTTC	CASSCGLGDGDNEQFF	TRBV27	TRBJ2-1
TGTGCCAGCAGTTACCCTACAACAGAGACCCAGTACTTC	CASSYPTTETQYF	TRBV6-5	TRBJ2-5
TGTGCCAGCAGTGAAATAGCGGGAGGCTCCTACAATGAGCAGTTCTTC	CASSEIAGGSYNEQFF	TRBV25-1	TRBJ2-1
TGTGCCAGCAGCTTAAAAAGTAAGCGGGATCCCGGGGAGCTGTTTTTT	CASSLKSKRDPGELFF	TRBV7-3	TRBJ2-2
TGTGCCAGCAGCGTGTCGGGGGAGCAAGAGACCCAGTACTTC	CASSVSGEQETQYF	TRBV9	TRBJ2-5
TGCGCCAGCAGATTTGTACTTCTTGAGCAGTTCTTC	CASRFVLLEQFF	TRBV5-1	TRBJ2-1
TGTGCCAGCAGCCAACACCGGACTAGCGGGGGGGCCATAGTGGCCTACGAGCAGTACTTC	CASSQHRTSGGAIVAYEQYF	TRBV7-9	TRBJ2-7
TGTGCCAGCCCGCGAATAAGGACAGGGCAACCGGACAGGGGGGAGCCCCAGCATTTT	CASPRIRTGQPDRGEPQHF	TRBV2	TRBJ1-5
TGTGCCAGCAGCCCCCAAGGGGACTATGGCTACACCTTC	CASSPQGDYGYTF	TRBV9	TRBJ1-2
TGTGCCAGCACGAGATGGGGGACAGGGGCCAAAAACATTCAGTACTTC	CASTRWGTGAKNIQYF	TRBV5-4	TRBJ2-4
TGTGCCAGCAGCCACCCAGGGAATGATACGCAGTATTTT	CASSHPGNDTQYF	TRBV14	TRBJ2-3
TGCGCCAGCGGGGCCGGGACAGGGCTTGTAGAGACCCAGTACTTC	CASGAGTGLVETQYF	TRBV10-1	TRBJ2-5
TGTGCCAGCAGTTGTTCAATCCAGCCCCAGCATTTT	CASSCSIQPQHF	TRBV6-6	TRBJ1-5
TGCGCCAGCAGCCGTTCCGGGACAGGGGCCACGAGCGAGCAGTACTTC	CASSRSGTGATSEQYF	TRBV5-1	TRBJ2-7
TGTGCCAGCAGCTTAACGGGACAGTTTGCCACCATATATTTT	CASSLTGQFATIYF	TRBV5-6	TRBJ1-3
TGTGCCAGCCTTACCGGGCTCTATGGCTACACCTTC	CASLTGLYGYTF	TRBV27	TRBJ1-2
TGTGCCAGCAGCGTCGTCAGGGGGGGCTACGAGCAGTACTTC	CASSVVRGGYEQYF	TRBV9	TRBJ2-7
TGTGCCAGCAGCGGCCAAGGACGGGACTCCTACGAGCAGTACTTC	CASSGQGRDSYEQYF	TRBV7-3	TRBJ2-7
TGTGCCAGCAGCCCGACAGGTTTGCCTAACTATGGCTACACCTTC	CASSPTGLPNYGYTF	TRBV13	TRBJ1-2
TGTGCCACTAAGCGCGGGCACCAGCCCCAGCATTTT	CATKRGHQPQHF	TRBV24-1	TRBJ1-5
TGTGCCACCAGTGATTGCGACTTAAAAGGCTACACCTTC	CATSDCDLKGYTF	TRBV24-1	TRBJ1-2
TGTGCCAGCAGTGACTGGGGACTGGGGAGGGACACCGGGGAGCTGTTTTTT	CASSDWGLGRDTGELFF	TRBV6-4	TRBJ2-2
TGTGCCAGCAGCTCAGGGACAGGGGATAGCCGCAATCAGCCCCAGCATTTT	CASSSGTGDSRNQPQHF	TRBV7-3	TRBJ1-5
TGTGCCAGCTCACCAGGGATCAGAGCTGAAGCTTTCTTT	CASSPGIRAEAFF	TRBV18	TRBJ1-1
TGTGCCAGCAGCAACGAGGGGGTCCCGGCATCCGAGCAGTACTTC	CASSNEGVPASEQYF	TRBV13	TRBJ2-7
TGCGCCAGCAGCCTAACCCGGGGGGGAAATCAGCCCCAGCATTTT	CASSLTRGGNQPQHF	TRBV5-1	TRBJ1-5
TGTGCCAGCAGTTCAAACAAGGGCGAGGCGAACACCGGGGAGCTGTTTTTT	CASSSNKGEANTGELFF	TRBV6-2	TRBJ2-2
TGCGCCAGCAGTGATACAGGGGGTGTAAACACTGAAGCTTTCTTT	CASSDTGGVNTEAFF	TRBV10-1	TRBJ1-1
TGCGCCAGCAGCCAAGAGACGGGCGTCTACGAGCAGTACTTC	CASSQETGVYEQYF	TRBV4-3	TRBJ2-7
TGCGCCAGCGTCAAGGGACAGGGCTCTGGAAACACCATATATTTT	CASVKGQGSGNTIYF	TRBV4-3	TRBJ1-3
TGTGCCAGCGACAGGGGGAAGAACACTGAAGCTTTCTTT	CASDRGKNTEAFF	TRBV6-1	TRBJ1-1
TGCAGTGCTAGAGGGACCAGGTTACCCAGGACCTACGAGCAGTACTTC	CSARGTRLPRTYEQYF	TRBV20-1	TRBJ2-7
TGTGCCAGCAGTTTGTCCGGGGGCCCTCATACCTACGAGCAGTACTTC	CASSLSGGPHTYEQYF	TRBV12-4	TRBJ2-7
TGTGCCAGCAGTGGCCTTCAAGAGTCTACAACTAATGAAAAACTGTTTTTT	CASSGLQESTTNEKLFF	TRBV6-5	TRBJ1-4
TGTGCCAGCAGTTTACTCCTGACTAGTAAGGAGCAGTTCTTC	CASSLLLTSKEQFF	TRBV12-4	TRBJ2-1
TGCGCCAGCCCAACAGGGGGAAAGAACACTGAAGCTTTCTTT	CASPTGGKNTEAFF	TRBV10-1	TRBJ1-1
TGTGCCAGCAGCTGCATGGGACAGGGCTATGGCTACACCTTC	CASSCMGQGYGYTF	TRBV7-3	TRBJ1-2
TGTGCCAAAGTGGACAGGGAGCGACCCGAAACCTACGAGCAGTACTTC	CAKVDRERPETYEQYF	TRBV24-1	TRBJ2-7
TGTGCCAGCAGCTGGGACGAGGCCCAGTACTTC	CASSWDEAQYF	TRBV11-2	TRBJ2-5
TGTGCCAGCAGTTACTCCCGAGGTGTCCTTTCCTACGAGCAGTACTTC	CASSYSRGVLSYEQYF	TRBV6-2	TRBJ2-7
TGTGCCAGCAGACAGTCCGGGACAGGGGGTTCAGATACGCAGTATTTT	CASRQSGTGGSDTQYF	TRBV12-3	TRBJ2-3
TGTGCCATTCGACAGGGAGACGAAGCTTTCTTT	CAIRQGDEAFF	TRBV10-3	TRBJ1-1
TGCAGTGCTAGAGATGGGCGGACAGGGTGGAAAGAGACCCAGTACTTC	CSARDGRTGWKETQYF	TRBV20-1	TRBJ2-5
TGTGCCTGGAGTGTACGGGTCCCCTCTAGGCAGGGGGGGCTCCTCAATGAGCAGTTCTTC	CAWSVRVPSRQGGLLNEQFF	TRBV30	TRBJ2-1
TGTGCCAGCAGCGTCCTCTACAGGGACCGAGGGGAAAAACTGTTTTTT	CASSVLYRDRGEKLFF	TRBV5-6	TRBJ1-4
TGTATAGGGACTAGCGGGAGCTCCTACGAGCAGTACTTC	CIGTSGSSYEQYF	TRBV6-1	TRBJ2-7
TGTGCCAGTAAATGTTACTGGGGCCACGGCTCACCCCTCCACTTT	CASKCYWGHGSPLHF	TRBV19	TRBJ1-6
TGTGCCAGCAGCTCAAGACTCGACGGGGAGCTGTTTTTT	CASSSRLDGELFF	TRBV7-9	TRBJ2-2
TGTGCCAGCAGCCCGCCGGGACAGGGCCTTACGCCCTACGAGCAGTACTTC	CASSPPGQGLTPYEQYF	TRBV6-5	TRBJ2-7
TGTGCCAGCAGAGACGGAGGCTACGAGCAGTACTTC	CASRDGGYEQYF	TRBV6-2	TRBJ2-7
TGCAGTGCAATGACAGTCTATGCTTCTAACTATGGCTACACCTTC	CSAMTVYASNYGYTF	TRBV20-1	TRBJ1-2
TGTGCCAGCAGTTCTCGACTAGCGGGAGGGTCTAGCACAGATACGCAGTATTTT	CASSSRLAGGSSTDTQYF	TRBV6-6	TRBJ2-3
TGTGCCAGCAGTTCTAAAAGTTCCACCGTTCTGTATAATTCACCCCTCCACTTT	CASSSKSSTVLYNSPLHF	TRBV27	TRBJ1-6
TGTGCCAGCAGCGGATCCACAGCCAAAAACATTCAGTACTTC	CASSGSTAKNIQYF	TRBV3-1	TRBJ2-4
TGCGCCAGCAGCTTCTCCTGGGCTGAAGCTTTCTTT	CASSFSWAEAFF	TRBV5-1	TRBJ1-1
TGTGCCACCAGTGATTTGAAGGACGAGCAGTACTTC	CATSDLKDEQYF	TRBV24-1	TRBJ2-7
TGCGCCATCAGGGACTATGGCTACACCTTC	CAIRDYGYTF	TRBV10-2	TRBJ1-2
TGTGCCCCACACAGGGGGGGGTTCACAGATACGCAGTATTTT	CAPHRGGFTDTQYF	TRBV18	TRBJ2-3
TGTGCCAGCAGAACAGGGCAGAATGGAAACACCATATATTTT	CASRTGQNGNTIYF	TRBV28	TRBJ1-3
TGCGCCAGCAGACCTCTGGACCGGCAATGGACCACAGATACGCAGTATTTT	CASRPLDRQWTTDTQYF	TRBV5-1	TRBJ2-3
TGCGCCAGCAGCCCGACAGGGGGCCGCAATCAGCCCCAGCATTTT	CASSPTGGRNQPQHF	TRBV10-1	TRBJ1-5
TGTGCCAGTAGAAGAACGAAACCAGCCAATCAGCCCCAGCATTTT	CASRRTKPANQPQHF	TRBV19	TRBJ1-5
TGCAGTGTTCGACATCTATCGGGGGCCTACGAGCAGTACTTC	CSVRHLSGAYEQYF	TRBV20-1	TRBJ2-7
TGTGCCAGCCGAAGACTTTCTCAGCCCCAGCATTTT	CASRRLSQPQHF	TRBV6-3	TRBJ1-5
TGTGCCAGCAGTTTATCGACCGCCGAAACACCTCAGCCCCAGCATTTT	CASSLSTAETPQPQHF	TRBV27	TRBJ1-5
TGTGCCAGCAGCAAGGGAAACAATGAGCAGTTCTTC	CASSKGNNEQFF	TRBV7-9	TRBJ2-1
TGCAGCGAAAGAAAACATAGGGAAGAGCAGTACTTC	CSERKHREEQYF	TRBV20-1	TRBJ2-7
TGCGCCAGCAGCTTGGGAATCCGAGGGACAGGCTCAGAGCCCCAGCATTTT	CASSLGIRGTGSEPQHF	TRBV5-1	TRBJ1-5
TGTGCCAGTAGTATGGCACAGGGTTATCAGCCCCAGCATTTT	CASSMAQGYQPQHF	TRBV19	TRBJ1-5
TGCGCCAGCAGCCCCACAGGGGGTTGGTGGGGAAACACCATATATTTT	CASSPTGGWWGNTIYF	TRBV4-3	TRBJ1-3
TGCGCCAGCAGCCACCCCGGGACTAGCAATGAGCAGTTCTTC	CASSHPGTSNEQFF	TRBV4-3	TRBJ2-1
TGTGCCAGCAGTTACTCCCCACAGGGCCGCTCCTACGAGCAGTACTTC	CASSYSPQGRSYEQYF	TRBV6-5	TRBJ2-7
TGTGCCAGCTCACCAAAGGGTAGACTGGATAGCAATCAGCCCCAGCATTTT	CASSPKGRLDSNQPQHF	TRBV18	TRBJ1-5
TGTGCCAGCAGCCCGTTCCGTCTTGTAGGGGCCAACGTCCTGACTTTC	CASSPFRLVGANVLTF	TRBV7-9	TRBJ2-6
TGCAGTGCTGAAACGGGACAGAAGAACTATGGCTACACCTTC	CSAETGQKNYGYTF	TRBV20-1	TRBJ1-2
TGTGCCACCAGTGATTTTGAAGGGACAGTGGGGCCCCAGCATTTT	CATSDFEGTVGPQHF	TRBV24-1	TRBJ1-5
TGTGCCAGCACCCCGGGAGGGTCTGGAAACACCATATATTTT	CASTPGGSGNTIYF	TRBV27	TRBJ1-3
TGTGCCACCAGTGATTTCTCTGGCGGGAGGGGGCCGAACACTGAAGCTTTCTTT	CATSDFSGGRGPNTEAFF	TRBV24-1	TRBJ1-1
TGTGCCAGCAGTTTCACTAGCGGGGGAGAACCCAGGTCTCTTGATACGCAGTATTTT	CASSFTSGGEPRSLDTQYF	TRBV28	TRBJ2-3
TGTGCCAGCAGTATGTTTCAAACCAATGAGCAGTTCTTC	CASSMFQTNEQFF	TRBV2	TRBJ2-1
TGTGCCAGCACCGGGACTCACTCCTACGAGCAGTACTTC	CASTGTHSYEQYF	TRBV6-4	TRBJ2-7
TGTGCCAGCATTCGTCGGGGAGACGAGCAGTACTTC	CASIRRGDEQYF	TRBV28	TRBJ2-7
TGTGCCACCGCTGAAATAGGGGGCAACTATGGCTACACCTTC	CATAEIGGNYGYTF	TRBV24-1	TRBJ1-2
TGTGCCAGCAGGAGGGACAGGGGGCTTCCCGTCCCAGATACGCAGTATTTT	CASRRDRGLPVPDTQYF	TRBV2	TRBJ2-3
TGTGGATACCGGTTCGGTCTAACCTGGCGGACTAGCCCTTTGCACTACGAGCAGTACTTC	CGYRFGLTWRTSPLHYEQYF	TRBV5-4	TRBJ2-7
TGCAGTGCTAGCCGGGACAGGACAACTAATGAAAAACTGTTTTTT	CSASRDRTTNEKLFF	TRBV20-1	TRBJ1-4
TGTGCCAGCAGCTTAGTAAACACAACCCAGCTAACTTGTGTGAGCACAGATACGCAGTATTTT	CASSLVNTTQLTCVSTDTQYF	TRBV7-9	TRBJ2-3
TGTGCCATAAGCAGGGATCTAGAGACCCAGTACTTC	CAISRDLETQYF	TRBV10-3	TRBJ2-5
TGTGCCAGCAGGGCCCTACAGAAAGCCAACGTCCTGACTTTC	CASRALQKANVLTF	TRBV28	TRBJ2-6
TGTGCTAGCAGCTTAGCGCGGGCCCGGGTAGCGGGCGGGAATGAGCAGTTCTTC	CASSLARARVAGGNEQFF	TRBV7-7	TRBJ2-1
TGTGCCAGGCGATTTGGGACTAACTATGGCTACACCTTC	CARRFGTNYGYTF	TRBV13	TRBJ1-2
TGTGCCAGCAGCTTGTTGGAGGGACATAACAGACCTCCGGTCCAAGAGACCCAGTACTTC	CASSLLEGHNRPPVQETQYF	TRBV5-6	TRBJ2-5
TGTGCCAGCAGTAATGGACGCTACTACGAGCAGTACTTC	CASSNGRYYEQYF	TRBV13	TRBJ2-7
TGTGCCACCAGCAGAGATCCTCCCTCCACATGTGGCTCTGGAAACACCATATATTTT	CATSRDPPSTCGSGNTIYF	TRBV15	TRBJ1-3
TGTGCCACCAGCAGAGATCTAAATCGACCTGGGGCCAACGTCCTGACTTTC	CATSRDLNRPGANVLTF	TRBV15	TRBJ2-6
TGTGCCAGCAGCCAAGGGAACACTGAAGCTTTCTTT	CASSQGNTEAFF	TRBV14	TRBJ1-1
TGTGCCAGCAGCTTGTCCCGCGGGAGAGACATTCAGTACTTC	CASSLSRGRDIQYF	TRBV5-5	TRBJ2-4
TGCAGTGCTAGCATCCAACAGGGGTCGGCTAACTATGGCTACACCTTC	CSASIQQGSANYGYTF	TRBV20-1	TRBJ1-2
TGTGCCATAGAAGTCAGTCGGGGAAACACCATATATTTT	CAIEVSRGNTIYF	TRBV10-3	TRBJ1-3
TGCAGTGCCAGAGTCAGGGGAGCTTCACCCCTCCACTTT	CSARVRGASPLHF	TRBV20-1	TRBJ1-6
TGTGCCAGCAGTTACCACGGACGAAATGAGCAGTTCTTC	CASSYHGRNEQFF	TRBV6-6	TRBJ2-1
TGCAGTGCTACAAATAAAATAAACACCATATATTTT	CSATNKINTIYF	TRBV20-1	TRBJ1-3
TGTGCCAGCAGTTTAGGAGACCAGCCCCAGCATTTT	CASSLGDQPQHF	TRBV6-5	TRBJ1-5
TGTGCCAGCCAGCGGGACCGTAACTATGGCTACACCTTC	CASQRDRNYGYTF	TRBV7-4	TRBJ1-2
TGTGCCAGCAGCTTAGGCGGGACAGGGGGGTTGGGATTAGAGACCCAGTACTTC	CASSLGGTGGLGLETQYF	TRBV7-8	TRBJ2-5
TGTGCCAGCGGGGCACTGGGCTACACCTTC	CASGALGYTF	TRBV19	TRBJ1-2
TGCGCCAGCAGCTCCTCGCCGCCCCGACAGGGGCCCTCCTACGAGCAGTACTTC	CASSSSPPRQGPSYEQYF	TRBV5-1	TRBJ2-7
TGTGCCAGCAGCTCCCCGTTAATTGGTGAGCATGGCTACACCTTC	CASSSPLIGEHGYTF	TRBV5-4	TRBJ1-2
TGTGCCAGCAGTTTGACCGGACAGGGTTGCAATCAGCCCCAGCATTTT	CASSLTGQGCNQPQHF	TRBV27	TRBJ1-5
TGTGCCAGCAGGTGGGGGGCGGGACAGGGGCCGTACTATGGCTACACCTTC	CASRWGAGQGPYYGYTF	TRBV3-1	TRBJ1-2
TGTGCCTGGAGCCTTCCAGCGGGGTTGTATGGCTACACCTTC	CAWSLPAGLYGYTF	TRBV30	TRBJ1-2
TGTGCCAGCAGCTCCCAGAGCGGGGAGCTGTTTTTT	CASSSQSGELFF	TRBV11-2	TRBJ2-2
TGTGCCAGCAGTGTTACTAGGAAAGGGCGTAGCGGGTGGTTTTCAGATACGCAGTATTTT	CASSVTRKGRSGWFSDTQYF	TRBV6-1	TRBJ2-3
TGTGCCAGCGAAAAACGACAGGGCCACACTGAAGCTTTCTTT	CASEKRQGHTEAFF	TRBV7-3	TRBJ1-1
TGTGCCAGCAGCCGAGGGGAGTACAATGAGCAGTTCTTC	CASSRGEYNEQFF	TRBV7-4	TRBJ2-1
TGCGCCAGCATGCCTATGGGACAGGGCAATGAGCAGTTCTTC	CASMPMGQGNEQFF	TRBV10-1	TRBJ2-1
TGTGCCAGCAGTTTAGACCGGGACAGGGAGGGGCCCCCCCTCCACTTT	CASSLDRDREGPPLHF	TRBV27	TRBJ1-6
TGTGCCAGCGCAAACAGGGACCCCTACGAGCAGTACTTC	CASANRDPYEQYF	TRBV25-1	TRBJ2-7
TGTGCCAGCACGAGACAGGGCCCATCTCCCTACGAGCAGTACTTC	CASTRQGPSPYEQYF	TRBV6-6	TRBJ2-7
TGTGCCAGCAGCATCCGGGACCAGGGCTACGAGCAGTACTTC	CASSIRDQGYEQYF	TRBV11-3	TRBJ2-7
TGTGCCAGCAGCTCCCAGAGGCCCCTAGCGGGCGTGGGCACAGATACGCAGTATTTT	CASSSQRPLAGVGTDTQYF	TRBV7-3	TRBJ2-3
TGTGCCAGCAGCTTACCAGGGCGGGGACAGCTGTTGAATCAGCCCCAGCATTTT	CASSLPGRGQLLNQPQHF	TRBV7-2	TRBJ1-5
TGCAGCGTTGCCAATCTGGACAGGGCGAAGGGGTATTTT	CSVANLDRAKGYF	TRBV29-1	TRBJ2-3
TGTGCCAGCAGCGTAGCCACTAATAGACAGGGGTTGTTCCTCTACGAGCAGTACTTC	CASSVATNRQGLFLYEQYF	TRBV9	TRBJ2-7
TGTGCCATCAGTGATACTAGAAGCTTCTACAATGAGCAGTTCTTC	CAISDTRSFYNEQFF	TRBV10-3	TRBJ2-1
TGCGCCAGCAGTGACATTACCGAGTTGGTCGTTCCTGAGCAGTTCTTC	CASSDITELVVPEQFF	TRBV10-1	TRBJ2-1
TGTGCCAGCAGTGCCAGGGGGGATGAAAACAATCAGCCCCAGCATTTT	CASSARGDENNQPQHF	TRBV2	TRBJ1-5
TGTGCCAGCAGCCCCCCCGGCCAGACCTACGAGCAGTACTTC	CASSPPGQTYEQYF	TRBV7-3	TRBJ2-7
TGTGCCAGCAGTTTACCCCAGTGGAACACTGAAGCTTTCTTT	CASSLPQWNTEAFF	TRBV12-3	TRBJ1-1
TGTGCCAGCAGCGGGGGGAAACCCTACGAGCAGTACTTC	CASSGGKPYEQYF	TRBV6-5	TRBJ2-7
TGCGCCAGCAGCTTGGGCCAGGGCGGTAACTATGGCTACACCTTC	CASSLGQGGNYGYTF	TRBV5-1	TRBJ1-2
TGTGCCAGCAGCTTAACTTCGTGGCAGATTGGCTACACCTTC	CASSLTSWQIGYTF	TRBV11-3	TRBJ1-2
TGTGCCAGCAGTGCAGGCACAGGAACTAATGAAAAACTGTTTTTT	CASSAGTGTNEKLFF	TRBV6-4	TRBJ1-4
TGTGCCAGCAGCTTAAGGGAGGCAGGCACAGATACGCAGTATTTT	CASSLREAGTDTQYF	TRBV7-8	TRBJ2-3
TGTGCCACCAGCTCCGTTTCCCCGGGACAGGGTAGGGACGGGGAGCTGTTTTTT	CATSSVSPGQGRDGELFF	TRBV15	TRBJ2-2
TGTGCCAGCAGTTCGGGGGCGCGCAATCAGCCCCAGCATTTT	CASSSGARNQPQHF	TRBV2	TRBJ1-5
TGTGCCAGCAGCTGGCTTTCTTTAGGGGGGGATTCTTTATGCAATGAGCAGTTCTTC	CASSWLSLGGDSLCNEQFF	TRBV5-4	TRBJ2-1
TGCGCCAGCAGCCCGACAGGGTGCTCCTACGAGCAGTACTTC	CASSPTGCSYEQYF	TRBV4-3	TRBJ2-7
TGCGCCAGCAGCTTGGATTCGGGACAGGGTCTCTACGAGCAGTACTTC	CASSLDSGQGLYEQYF	TRBV5-1	TRBJ2-7
TGTGCCAGCAGTTTTGCCCCGGGGAGCTCCTATAATTCACCCCTCCACTTT	CASSFAPGSSYNSPLHF	TRBV27	TRBJ1-6
TGCGCCAGCCCCCCGAAGGACAGGGGGCTCTACGAGCAGTACTTC	CASPPKDRGLYEQYF	TRBV4-1	TRBJ2-7
TGTGCCAGCAGCCACATCAGGGGGGGCCTCTCTGGGGCCAACGTCCTGACTTTC	CASSHIRGGLSGANVLTF	TRBV14	TRBJ2-6
TGCGCCAGCAGCTTGGGCCCGAAAGAGATCTATGAAAAACTGTTTTTT	CASSLGPKEIYEKLFF	TRBV5-1	TRBJ1-4
TGTGCCAGGGGTCGCTCTGGAAACACCATATATTTT	CARGRSGNTIYF	TRBV12-3	TRBJ1-3
TGTGCCAGCAGCACGACCCCCAAACAAGAGACCCAGTACTTC	CASSTTPKQETQYF	TRBV13	TRBJ2-5
TGTGCCAGCAGCACGGACGGTGAGCAGTTCTTC	CASSTDGEQFF	TRBV5-5	TRBJ2-1
TGTGCCAGCAGAGGGACCGTAGGGGACCGCCCCCCAACTAAACTGTTTTTT	CASRGTVGDRPPTKLFF	TRBV27	TRBJ1-4
TGCAGACTAGCGGGTGGAGGGACGAACACCGGGGAGCTGTTTTTT	CRLAGGGTNTGELFF	TRBV20-1	TRBJ2-2
TGTGCCAGCAGCATGTATCCGGGCCTTACTTTTATCACAGATACGCAGTATTTT	CASSMYPGLTFITDTQYF	TRBV7-6	TRBJ2-3
TGTGCCAGCAGAGCTGGACATGAAAAACTGTTTTTT	CASRAGHEKLFF	TRBV7-9	TRBJ1-4
TGTGCCAGCAGCAATGGGAGACTGTACGAGCAGTACTTC	CASSNGRLYEQYF	TRBV7-4	TRBJ2-7
TGTGCCACCAGTGCTTTTTATACTAGCGGGAGGCAAATCTTCGAGCAGTACTTC	CATSAFYTSGRQIFEQYF	TRBV24-1	TRBJ2-7
TGTGCTAGTGGTTTGTTGCTGGGGACGGTAAGGCCTAAAGAGACCCAGTACTTC	CASGLLLGTVRPKETQYF	TRBV12-5	TRBJ2-5
TGTGCCAGCAGTTTCATAGGTCGGAGATACTGGGTGGGGGACAGGGGGCCGACACTTAGCTCCTACGAGCAGTACTTC	CASSFIGRRYWVGDRGPTLSSYEQYF	TRBV12-4	TRBJ2-7
TGTGCCACCAAAATTCCCTTTGGCAATGAGCAGTTCTTC	CATKIPFGNEQFF	TRBV24-1	TRBJ2-1
TGTGCCAGCTCACCACGGTGCGACTGCGCTTTCTTT	CASSPRCDCAFF	TRBV18	TRBJ1-1
TGCAGTGCTAGAGGAATGGGGACAGGGGGCTCCTACAATGAGCAGTTCTTC	CSARGMGTGGSYNEQFF	TRBV20-1	TRBJ2-1
TGTGCCATCACGCACAGGGGTGCAACTAATGAAAAACTGTTTTTT	CAITHRGATNEKLFF	TRBV10-3	TRBJ1-4
TGTGCCAGCAGCTTGGGGAAAGCATCACTAACAGGGTACAAAGACGAGCAGTACTTC	CASSLGKASLTGYKDEQYF	TRBV5-5	TRBJ2-7
TGTGCCAGCAGTTTAAGGCAGGTTTGGTCCTACGAGCAGTACTTC	CASSLRQVWSYEQYF	TRBV27	TRBJ2-7
TGTGCCAGCAGCTTAGGGACGAGCTCCGGGGGACTAGCGCAGTGTAATGAGCAGTTCTTC	CASSLGTSSGGLAQCNEQFF	TRBV11-2	TRBJ2-1
TGTGCCAGCAGCCGGCGACAGATGACGAATTCACCCCTCCACTTT	CASSRRQMTNSPLHF	TRBV11-2	TRBJ1-6
TGTGCCAGCAGTGGGGGAGAGACCCAGTACTTC	CASSGGETQYF	TRBV25-1	TRBJ2-5
TGTGCCAGCAGCCAAGATCGGGACGACAATGAGCAGTTCTTC	CASSQDRDDNEQFF	TRBV11-3	TRBJ2-1
TGTGCCAGCAGCGCGTGGACTATTCCCAACCAAGAGACCCAGTACTTC	CASSAWTIPNQETQYF	TRBV9	TRBJ2-5
TGTGCCACCAGCAGATCGACACCAAGAGAGACCCAGTACTTC	CATSRSTPRETQYF	TRBV15	TRBJ2-5
TGTGCCAGCAGTGCCCTAGGGGGGGGCTACGAGCAGTACTTC	CASSALGGGYEQYF	TRBV6-4	TRBJ2-7
TGCAGTGCTAGAGATTTTGTCAACAGGGGCGAGCAGTACTTC	CSARDFVNRGEQYF	TRBV20-1	TRBJ2-7
TGTGCCAGCAGCCGGGGGGACAGTACCTGTTACAATGAGCAGTTCTTC	CASSRGDSTCYNEQFF	TRBV14	TRBJ2-1
TGCGCCAGCAGTGAGGCCGGGACCGGGGGGACCGGCTCCTACGAGCAGTACTTC	CASSEAGTGGTGSYEQYF	TRBV10-1	TRBJ2-7
TGCGCCAGCAGAAGGGAGCCCCCTTACGAGCAGTACTTC	CASRREPPYEQYF	TRBV5-1	TRBJ2-7
TGTGCCAGCAAAAATTATCCAGGGGATGATGGCTACACCTTC	CASKNYPGDDGYTF	TRBV7-9	TRBJ1-2
TGCGCCAGCAGCTTCCACGGACATAATTCACCCCTCCACTTT	CASSFHGHNSPLHF	TRBV5-1	TRBJ1-6
TGTGCCAGCAGAAAGACAGGGCACTTTAACTATGGCTACACCTTC	CASRKTGHFNYGYTF	TRBV7-3	TRBJ1-2
TGTGCCAGCAGCGCATTGACAGCTATGAACACTGAAGCTTTCTTT	CASSALTAMNTEAFF	TRBV13	TRBJ1-1
TGTGCCAGCAGTCGGACCATCCTAAACAATGAGCAGTTCTTC	CASSRTILNNEQFF	TRBV6-8	TRBJ2-1
TGCAGCGTATCTAGCCCTGGAGACATCACCTATGGCTACACCTTC	CSVSSPGDITYGYTF	TRBV29-1	TRBJ1-2
TGCGCCAGCAGCTTGCGGGGGGGGGAGGAGGCGTATGAGCAGTTCTTC	CASSLRGGEEAYEQFF	TRBV5-1	TRBJ2-1
TGTGAAGTGGGGCCGGAGGGGGGGCCCACAAGCTCCTACAATGAGCAGTTCTTC	CEVGPEGGPTSSYNEQFF	TRBV6-4	TRBJ2-1
TGCGCCAGCAGCACACCAACTAATGAAAAACTGTTTTTT	CASSTPTNEKLFF	TRBV10-2	TRBJ1-4
TGTGCCAGCAGCCAAGAAGTTGGGACGGAGGGCGGCTACACCTTC	CASSQEVGTEGGYTF	TRBV3-1	TRBJ1-2
TGTGCCAGCAGCTATTCCTATTGGGGTACTAATGAGCAGTTCTTC	CASSYSYWGTNEQFF	TRBV7-6	TRBJ2-1
TGTGCTAGCAGCAGTCGGGGGGGCACCCTTGACAATGAGCAGTTCTTC	CASSSRGGTLDNEQFF	TRBV7-7	TRBJ2-1
TGTGCCTGGAGTGTCCACAGGGGCACCGGGGAGCTGTTTTTT	CAWSVHRGTGELFF	TRBV30	TRBJ2-2
TGTGCTAGTGGTTTGGCTACAGGGTGGGACTATGGCTACACCTTC	CASGLATGWDYGYTF	TRBV12-5	TRBJ1-2
TGCGCCAGCAGCCTCCCGGGGGTCTTC	CASSLPGVF	TRBV5-1	TRBJ2-1
TGTGCCAGCAGATTCGAGACTAGTGCTATCTCTGGGGCCAACGTCCTGACTTTC	CASRFETSAISGANVLTF	TRBV6-1	TRBJ2-6
TGTGCCTGGAGGGACACGGAGACCCAGTACTTC	CAWRDTETQYF	TRBV30	TRBJ2-5
TGCGCCAGCAGCTTGGTACCTCGGGATTTCCAAGTAACGGAGACCCAGTACTTC	CASSLVPRDFQVTETQYF	TRBV5-1	TRBJ2-5
TGTGCCAGCCAGGAAGTAGAGACTAATGAAAAACTGTTTTTT	CASQEVETNEKLFF	TRBV25-1	TRBJ1-4
TGTGCCAGCAGCGTCACCCCAGCAGGGGGGGGGTTCTCGGACGAGCAGTACTTC	CASSVTPAGGGFSDEQYF	TRBV13	TRBJ2-7
TGTGCCAGCAGCTTCCCACAAGTCTATGGCTACACCTTC	CASSFPQVYGYTF	TRBV11-3	TRBJ1-2
TGTGCCAGCAGCTTGTGGACCGTCAACGAGACCCAGTACTTC	CASSLWTVNETQYF	TRBV7-4	TRBJ2-5
TGTGCCACCAACCCTCCAGAACAGGGGGAAGAGACCCAGTACTTC	CATNPPEQGEETQYF	TRBV24-1	TRBJ2-5
TGTGCTAGTGGTTTCTTGTCTCCGGGGAGTAGCAATCAGCCCCAGCATTTT	CASGFLSPGSSNQPQHF	TRBV12-5	TRBJ1-5
TGCGCCAGCAGTCATACCCCGGGACAGGGGGCAGATTACGAGCAGTACTTC	CASSHTPGQGADYEQYF	TRBV10-1	TRBJ2-7
TGTGCCAGCAGCCAAGATGACAGGGGACGAGAGCAGTTCTTC	CASSQDDRGREQFF	TRBV14	TRBJ2-1
TGTGCCAGCAGTGTAGGCGAATTGCCCCACACCATATATTTT	CASSVGELPHTIYF	TRBV6-2	TRBJ1-3
TGTGCCAGCAGCCGGACAGGGTGTCAGCCCCAGCATTTT	CASSRTGCQPQHF	TRBV7-9	TRBJ1-5
TGTGCCATCATTGACTTACCATCAGGGTCGACTGAAGCTTTCTTT	CAIIDLPSGSTEAFF	TRBV10-3	TRBJ1-1
TGTGCCAGCAGCCGAACGGTAGAGACCCAGTACTTC	CASSRTVETQYF	TRBV7-6	TRBJ2-5
TGCGCCAGCCCCCAGACAGGGGGAGGGAACACCGGGGAGCTGTTTTTT	CASPQTGGGNTGELFF	TRBV10-1	TRBJ2-2
TGTGCCAGCAGCCCCATTGGACAGGTTGCAACTAATGAAAAACTGTTTTTT	CASSPIGQVATNEKLFF	TRBV11-3	TRBJ1-4
TGTGCCTGGAGTGTACAGCCGACAGGGGGGAGGAGCAATCAGCCCCAGCATTTT	CAWSVQPTGGRSNQPQHF	TRBV30	TRBJ1-5
TGTGCCAGCACCCGGGAGTATGGCTACACCTTC	CASTREYGYTF	TRBV28	TRBJ1-2
TGTGCCCCTCCGCAAGTTCAGGGGGTAAGCTCTGGGGCCAACGTCCTGACTTTC	CAPPQVQGVSSGANVLTF	TRBV6-1	TRBJ2-6
TGCAGTGCTAGTAAGGACAGCCTGACCTCCCGCAATCAGCCCCAGCATTTT	CSASKDSLTSRNQPQHF	TRBV20-1	TRBJ1-5
TGTGCCAGCAGGCCCGAAAGGGGGAAATATGGCTACACCTTC	CASRPERGKYGYTF	TRBV6-6	TRBJ1-2
TGCAGTGCTAGAGATTCTTCGGTACCTAGCGGGGAGACCCAGTACTTC	CSARDSSVPSGETQYF	TRBV20-1	TRBJ2-5
TGTGCCAGCTCACCGCGCGACCTCCCAGGGGGCGGGAGAGAAGAAGGCTATGGCTACACCTTC	CASSPRDLPGGGREEGYGYTF	TRBV18	TRBJ1-2
TGTGCCAGCAGCAGAGTCCACCGGGACGGCTTGAACACTGAAGCTTTCTTT	CASSRVHRDGLNTEAFF	TRBV7-7	TRBJ1-1
TGTGCCAGCAGCCGGTGCGGTGAGAACCTGACGGGGCCTAGGGACGAGCAGTACTTC	CASSRCGENLTGPRDEQYF	TRBV14	TRBJ2-7
TGTGCCAGCGACTACAATGAGCAGTTCTTC	CASDYNEQFF	TRBV28	TRBJ2-1
TGCAGTGCATTGCTAGCGGGACCTTACGAGCAGTACTTC	CSALLAGPYEQYF	TRBV20-1	TRBJ2-7
TGTGCCAGCAGTTTCCGGGACACCTCCTTTAACACTGAAGCTTTCTTT	CASSFRDTSFNTEAFF	TRBV12-3	TRBJ1-1
TGTGCCAGCAGCTTAGGGCGACTAGCGGGAGGGCCCTACTATGGCTACACCTTC	CASSLGRLAGGPYYGYTF	TRBV7-8	TRBJ1-2
TGTGCCAGCGAAACTACACCGGCGGGTTCCTTCGACCGTCAAGAGACCCAGTACTTC	CASETTPAGSFDRQETQYF	TRBV6-1	TRBJ2-5
TGTGCCAGCAGCGAAACCGGGACCTACGGGGAGCTGTTTTTT	CASSETGTYGELFF	TRBV13	TRBJ2-2
TGTGCCAGGGGCCTCACAGATACGCAGTATTTT	CARGLTDTQYF	TRBV6-2	TRBJ2-3
TGCGCCAGCATCCCTAAATTGGGGAACTGCACCGGGGAGCTGTTTTTT	CASIPKLGNCTGELFF	TRBV10-1	TRBJ2-2
TGTGCCAGTAGTATCACACTCAAAGGACCATTGAACACTGAAGCTTTCTTT	CASSITLKGPLNTEAFF	TRBV19	TRBJ1-1
TGTGCCAGCAGAGCCGACAGGGGCGAAAAGGGTCAAGAGACCCAGTACTTC	CASRADRGEKGQETQYF	TRBV6-4	TRBJ2-5
TGTGCCAGCAGAGGATTACACAGGGGGCCCTCTGGAAACACCATATATTTT	CASRGLHRGPSGNTIYF	TRBV25-1	TRBJ1-3
TGTGCCAGTAGGGAAGCGGGGGGGCACGACATTGAGCAGTTCTTC	CASREAGGHDIEQFF	TRBV19	TRBJ2-1
TGTGCCAGCAGTTACGGCGGTCCCTCGAATGAAAAACTGTTTTTT	CASSYGGPSNEKLFF	TRBV6-5	TRBJ1-4
TGTGCCAGCAGTTACAAGGGGACGTGTAATCAGCCCCAGCATTTT	CASSYKGTCNQPQHF	TRBV6-3	TRBJ1-5
TGTGCCAGCATCTCAACCCAGAGCTCCTACGAGCAGTACTTC	CASISTQSSYEQYF	TRBV9	TRBJ2-7
TGTGCCACCAGTGATTTGACCCCCCGGCGGTCCACTGAAGCTTTCTTT	CATSDLTPRRSTEAFF	TRBV24-1	TRBJ1-1
TGTGCCAGCAGTTTAGGGGACCCTGGGGGGGGTGTTAAAAGCACAGATACGCAGTATTTT	CASSLGDPGGGVKSTDTQYF	TRBV28	TRBJ2-3
TGTGCCAGTAGTATCGACAGAATGCGCTATGGCTACACCTTC	CASSIDRMRYGYTF	TRBV19	TRBJ1-2
TGCGCCAGCAGTGCCCTCATAAAAACCTACGAGCAGTACTTC	CASSALIKTYEQYF	TRBV10-1	TRBJ2-7
TGCGCCAGCAGCTGTCCCCGTGGACAGGTACGCAATCAGCCCCAGCATTTT	CASSCPRGQVRNQPQHF	TRBV5-1	TRBJ1-5
TGTGCGCCGGGACAACACCGCCAAGAGACCCAGTACTTC	CAPGQHRQETQYF	TRBV9	TRBJ2-5
TGCAGTGCTAGACAGGTGGGAGGTGAGCAGTTCTTC	CSARQVGGEQFF	TRBV20-1	TRBJ2-1
TGTGCCAGCGGGGGCTCGACCCGCTACGAGCAGTACTTC	CASGGSTRYEQYF	TRBV5-6	TRBJ2-7
TGCGCCAGCAGCTTGGGAGACAGGATGGGGAACTATGGCTACACCTTC	CASSLGDRMGNYGYTF	TRBV5-1	TRBJ1-2
TGTGCCAGCCAGGACGGGGGCCATCAGCCCCAGCATTTT	CASQDGGHQPQHF	TRBV27	TRBJ1-5
TGTGCCAGCAGCTTAGGGAGTACTAGCGGGAGCGGCGATCGGGGAATAAGCGAGCAGTACTTC	CASSLGSTSGSGDRGISEQYF	TRBV7-6	TRBJ2-7
TGTGCCAGCAGCGCTCGGTGGAGACTTGGGAGAATAGCGAACACCGGGGAGCTGTTTTTT	CASSARWRLGRIANTGELFF	TRBV7-2	TRBJ2-2
TGTGCCACCACTCGTCCTAGCGGGACGGGCACAGATACGCAGTATTTT	CATTRPSGTGTDTQYF	TRBV24-1	TRBJ2-3
TGTGCCTGGTTGACCAGGGGTAACAATGAGCAGTTCTTC	CAWLTRGNNEQFF	TRBV30	TRBJ2-1
TGCAGCTACGGGACAGGGGGCGGGAGGGGTGAGCAGTACTTC	CSYGTGGGRGEQYF	TRBV29-1	TRBJ2-7
TGTGCCAGCAGTTATAGTGGGAGGGGGTCACCTGGGGCCAACGTCCTGACTTTC	CASSYSGRGSPGANVLTF	TRBV6-5	TRBJ2-6
TGTGCCACCAGTGATGATAGGGACAGGGGAATCGTATGTTGTCAGCCCCAGCATTTT	CATSDDRDRGIVCCQPQHF	TRBV24-1	TRBJ1-5
TGTGCCAGCTCACCACACAGTCTAGAGTTCTATAGCAATCAGCCCCAGCATTTT	CASSPHSLEFYSNQPQHF	TRBV18	TRBJ1-5
TGCAGTGCTCAGGTTCAGCATTTT	CSAQVQHF	TRBV20-1	TRBJ1-5
TGTGCCAGCAGAACCCGCAGGGGGATGGAAACGGGCAATCAGCCCCAGCATTTT	CASRTRRGMETGNQPQHF	TRBV6-4	TRBJ1-5
TGTGCCAGCAGCTCTCCTCCGGGACAGCCGGGGACTAGGCATTCACCCCTCCACTTT	CASSSPPGQPGTRHSPLHF	TRBV5-4	TRBJ1-6
TGTGCCAGCAGCCAATGCACAGGCTCTGGAAACACCATATATTTT	CASSQCTGSGNTIYF	TRBV3-1	TRBJ1-3
TGTGCCAGCAGCGGGAGGAACACCGGGGAGCTGTTTTTT	CASSGRNTGELFF	TRBV27	TRBJ2-2
TGTGCCAGCAGCCAGGGCCAAGAGACCCAGTACTTC	CASSQGQETQYF	TRBV11-2	TRBJ2-5
TGTGCCAGCTCACCCCGTCTGGACAGGGAACATCAGCCCCAGCATTTT	CASSPRLDREHQPQHF	TRBV18	TRBJ1-5
TGCGCCAGCAGTGCTCCGGGACACACTGAAGCTTTCTTT	CASSAPGHTEAFF	TRBV10-1	TRBJ1-1
TGTGCCAGCAGTCCTAGCGGGAGCAGAGTATCCTACAATGAGCAGTTCTTC	CASSPSGSRVSYNEQFF	TRBV12-3	TRBJ2-1
TGTGCCAGCAGCCGCAAGCAGTACTTC	CASSRKQYF	TRBV7-9	TRBJ2-7
TGTGCCAGCAGCTTAGTGGACGTAGCGGAGGTTACCGGGGAGCTGTTTTTT	CASSLVDVAEVTGELFF	TRBV11-2	TRBJ2-2
TGTGCCAGCAGCCCTTTAGCGGGGGGGAGGTTCAATGAGCAGTTCTTC	CASSPLAGGRFNEQFF	TRBV13	TRBJ2-1
TGCAGTAGTGAGGACAGGTTAGGTTGCACCTTC	CSSEDRLGCTF	TRBV20-1	TRBJ1-2
TGTGCCAGCAGTTCTCCGGGACACGGGATGGACAATGAGCAGTTCTTC	CASSSPGHGMDNEQFF	TRBV12-4	TRBJ2-1
TGTGCCACGCAGGGCCAACGTGGAAACACCATATATTTT	CATQGQRGNTIYF	TRBV24-1	TRBJ1-3
TGTGCCAGCAGCCGTCGGTCCCCGGGACAGGGCAGGAGTCAGCCCCAGCATTTT	CASSRRSPGQGRSQPQHF	TRBV14	TRBJ1-5
TGTGCCAGCAGCGGCGCGGGACGAATTCTAGAGACCCAGTACTTC	CASSGAGRILETQYF	TRBV9	TRBJ2-5
TGTGCCAAAGAGTCGTGGGAGCTGTTTTTT	CAKESWELFF	TRBV28	TRBJ2-2
TGCAGCGTTGCCCCCCAGGGGGTCTACTATGGCTACACCTTC	CSVAPQGVYYGYTF	TRBV29-1	TRBJ1-2
TGCAGTGCGGTAAGGTTACAGGGGGGGCGGGGCTACACCTTC	CSAVRLQGGRGYTF	TRBV20-1	TRBJ1-2
TGTGCCCCGGGGGCTACTAATGAAAAACTGTTTTTT	CAPGATNEKLFF	TRBV24-1	TRBJ1-4
TGTGCCAGCAGTTTATCGGGGGGGGATGAGCAGTTCTTC	CASSLSGGDEQFF	TRBV27	TRBJ2-1
TGTGCCTGGAATCCCCATCCCAACAGGGTTCCTGACAATCAGCCCCAGCATTTT	CAWNPHPNRVPDNQPQHF	TRBV30	TRBJ1-5
TGTGCCAGCAGCGTAGCTCCCGCGGAGCTAGGGGCCCGTGGCTACGAGCAGTACTTC	CASSVAPAELGARGYEQYF	TRBV9	TRBJ2-7
TGTGCCAGCAGCGGCACAGGGAGCACAGATACGCAGTATTTT	CASSGTGSTDTQYF	TRBV9	TRBJ2-3
TGTGCCAGCAGCGGTCTTTTCGTTTGCCAGGGTTATCAGCCCCAGCATTTT	CASSGLFVCQGYQPQHF	TRBV13	TRBJ1-5
TGTGCCAGCAGCGGCACACCGGGAGGGCCCTCCTACGAGCAGTACTTC	CASSGTPGGPSYEQYF	TRBV13	TRBJ2-7
TGTGCCAGCAGCTTTCTGGGGACAAATCAGCCCCAGCATTTT	CASSFLGTNQPQHF	TRBV11-3	TRBJ1-5
TGTGCCAGCAGCTTAGATAGGCCGACGGTTACCTACGAGCAGTACTTC	CASSLDRPTVTYEQYF	TRBV11-3	TRBJ2-7
TGTGCCAGCAGCAATATCGGGGGGGGCCGATACGAGCAGTACTTC	CASSNIGGGRYEQYF	TRBV9	TRBJ2-7
TGTGCCAGCAGCCAAGAGTCAGGAAGGGATTCTAGCACAGATACGCAGTATTTT	CASSQESGRDSSTDTQYF	TRBV14	TRBJ2-3
TGTGCCAGCAGTCCAGGTCGGGGGAGGTACCAAGAGACCCAGTACTTC	CASSPGRGRYQETQYF	TRBV27	TRBJ2-5
TGTGCCAGCAGCTTATTCCCGTATGCACCCGGGACAGGGGGGGGCACAGATACGCAGTATTTT	CASSLFPYAPGTGGGTDTQYF	TRBV5-5	TRBJ2-3
TGTGCCAGCAGCACATTTGCGGGACTAGCGGACTACGAGCAGTACTTC	CASSTFAGLADYEQYF	TRBV13	TRBJ2-7
TGTGCCAGCAGCCCGACAGGGGAAAATCAGCCCCAGCATTTT	CASSPTGENQPQHF	TRBV9	TRBJ1-5
TGTGCCAGCAGCTTGCTCCCTTCAGGTTTAAAAACCCACGTGGCCTATGGCTACACCTTC	CASSLLPSGLKTHVAYGYTF	TRBV7-3	TRBJ1-2
TGTGCCAGCAGCTCCGGCCACCTCAGCCGGACAGTCCCCTACGAGCAGTACTTC	CASSSGHLSRTVPYEQYF	TRBV9	TRBJ2-7
TGTGCCAGCAGTCTAACGTACCAAGAGACCCAGTACTTC	CASSLTYQETQYF	TRBV6-6	TRBJ2-5
TGTGCCAGCAGGACCATTCTTCGTCCCCGGGACTGTCTAGAGACCCAGTACTTC	CASRTILRPRDCLETQYF	TRBV12-3	TRBJ2-5
TGCGCCAGCAGCCAAGGTCAGGGGACTAGCAATCAGCCCCAGCATTTT	CASSQGQGTSNQPQHF	TRBV4-1	TRBJ1-5
TGTCTGGGACATAACTATGGCTACACCTTC	CLGHNYGYTF	TRBV6-1	TRBJ1-2
TGCGCCAGCAATAGGGGGAATGGCTCCTACGAGCAGTACTTC	CASNRGNGSYEQYF	TRBV4-3	TRBJ2-7
TGCGCCAGCAGCTTGTTCCATGACAGAGGGTCTAGCAATCAGCCCCAGCATTTT	CASSLFHDRGSSNQPQHF	TRBV5-1	TRBJ1-5
TGTGCCAGCAGCTTAAGACCTCGCTGCCCGGTGCCCCAGCATTTT	CASSLRPRCPVPQHF	TRBV7-2	TRBJ1-5
TGTGCCAGCAGATGTTTTGGGACAGGGGGCCTTCCGGCCATATATTTT	CASRCFGTGGLPAIYF	TRBV13	TRBJ1-3
TGTGCCACCAGTGACATAACTAGGCGATACGAGCAGTACTTC	CATSDITRRYEQYF	TRBV24-1	TRBJ2-7
TGTGCCAGTAGTATAGCCAGGGACAGGGGCTCCTACGAGCAGTACTTC	CASSIARDRGSYEQYF	TRBV19	TRBJ2-7
TGCAGTGCTAGAAGAGGGGGCGGGACAGAAAGAAGTGTCACAGATACGCAGTATTTT	CSARRGGGTERSVTDTQYF	TRBV20-1	TRBJ2-3
TGTGCCACCAGTGATTTGAACCTAGGGGTTCGGGGCTCCTACGAGCAGTACTTC	CATSDLNLGVRGSYEQYF	TRBV24-1	TRBJ2-7
TGTGCCAGCAGCTTACTGGAAGGGCTAGCTGATCCTAGCACAGATACGCAGTATTTT	CASSLLEGLADPSTDTQYF	TRBV7-4	TRBJ2-3
TGTGCCAGCAGTTACCGTAACATTCGGAATGAGCAGTACTTC	CASSYRNIRNEQYF	TRBV6-6	TRBJ2-7
TGTGCCAGCAGCCGGCGGGGGTACGGGGAGCTGTTTTTT	CASSRRGYGELFF	TRBV9	TRBJ2-2
TGTGCCAGCAGAAGGGCTCCTAGAATGAACACTGAAGCTTTCTTT	CASRRAPRMNTEAFF	TRBV7-9	TRBJ1-1
TGTGCCAGCAGCGACAGGGACCCGAACACCGGGGAGCTGTTTTTT	CASSDRDPNTGELFF	TRBV13	TRBJ2-2
TGTGCCAGCTGGCATTACAGGGATCTAGCCCCCTACGAGCAGTACTTC	CASWHYRDLAPYEQYF	TRBV6-2	TRBJ2-7
TGCAGTGCTGCGGCTGGCAGGGCTGATTCCTACACTGAAGCTTTCTTT	CSAAAGRADSYTEAFF	TRBV20-1	TRBJ1-1
TGTGCCAGTAGTATAGGTATCGCACTAGCGGGAGTTCCCTACGAGCAGTACTTC	CASSIGIALAGVPYEQYF	TRBV19	TRBJ2-7
TGTGCCAGCAGCCCCCGGACACCGGCAAGGCTGAACACTGAAGCTTTCTTT	CASSPRTPARLNTEAFF	TRBV3-1	TRBJ1-1
TGTGCCAGCTCACCCCGGACATGGGCCCTCCACTTT	CASSPRTWALHF	TRBV18	TRBJ1-6
TGCGCCAGCAGCTTTAAATCTTCTAGCTTTGCATACGAGCAGTACTTC	CASSFKSSSFAYEQYF	TRBV5-1	TRBJ2-7
TGTGCCAGCAGGTCCACTCCGCCCACAGGGCCCAGAGAGCAGTACTTC	CASRSTPPTGPREQYF	TRBV6-8	TRBJ2-7
TGCGCCAGCAGTGACCTAGCGCCCTGGGCCACCGGGGAGCTGTTTTTT	CASSDLAPWATGELFF	TRBV10-1	TRBJ2-2
TGTGCCAGCAGTTGGGGACCGAGAGCAACCAACTATGGCTACACCTTC	CASSWGPRATNYGYTF	TRBV6-5	TRBJ1-2
TGTGCCAGCAGTGACTCGACCCCGGTTTTGGGGCATAATTCACCCCTCCACTTT	CASSDSTPVLGHNSPLHF	TRBV6-4	TRBJ1-6
TGTGCCAGCTCACCACCAGGGAGGGGCTATGGCTACACCTTC	CASSPPGRGYGYTF	TRBV18	TRBJ1-2
TGTGCCAGCAGCCCGGTCCTCGGAGCAGGGCTCTCTGGGGCCAACGTCCTGACTTTC	CASSPVLGAGLSGANVLTF	TRBV7-4	TRBJ2-6
TGTGCCACCAGTGATACCGACAGGGGGGGGGCAACTAATGAAAAACTGTTTTTT	CATSDTDRGGATNEKLFF	TRBV24-1	TRBJ1-4
TGTGCCAGCAGCGACGTCCCTAGCTACAATGAGCAGTTCTTC	CASSDVPSYNEQFF	TRBV13	TRBJ2-1
TGTGCCAGCAGCTTGGTCTGTAGGGGGGCTGCCTACGAGCAGTACTTC	CASSLVCRGAAYEQYF	TRBV5-6	TRBJ2-7
TGTGCCAGCAGTGGTTGTACAGGGGACTGGGGGAACACTGAAGCTTTCTTT	CASSGCTGDWGNTEAFF	TRBV2	TRBJ1-1
TGTGCCAGCAGTTTGAGGCCCCGGTTACAGGGGGCGCTGATCGGCAATCAGCCCCAGCATTTT	CASSLRPRLQGALIGNQPQHF	TRBV12-4	TRBJ1-5
TGTGCCAGCAGTTACCCGACAGGTCGGGGTCATGGCTACACCTTC	CASSYPTGRGHGYTF	TRBV6-2	TRBJ1-2
TGTGCCAGCTCCGCTAGCGGGACGCAGTATTTT	CASSASGTQYF	TRBV18	TRBJ2-3
TGTGCCAGCAGTGACTCGAGTCCCACTCTAGTGACAGAGACCCAGTACTTC	CASSDSSPTLVTETQYF	TRBV6-4	TRBJ2-5
TGTGCCAGCAGCGATCCCATACAGTACCGATATAGCAATCAGCCCCAGCATTTT	CASSDPIQYRYSNQPQHF	TRBV14	TRBJ1-5
TGTGCCAGCAGCCAAGAATGGACAGGGGGGGTTTGCACAGATACGCAGTATTTT	CASSQEWTGGVCTDTQYF	TRBV14	TRBJ2-3
TGTCCGACAGGGGAAATGAACACTGAAGCTTTCTTT	CPTGEMNTEAFF	TRBV7-9	TRBJ1-1
TGTGCCAGCACGAGTATAACCAGGGAGGCTCACCTAGGCTACACCTTC	CASTSITREAHLGYTF	TRBV27	TRBJ1-2
TGTGCCAGCAGCTTGTGCGGAAGAATCCCACTAGCGGGAGGGCGGCGGTCAGAGCAGTTCTTC	CASSLCGRIPLAGGRRSEQFF	TRBV5-4	TRBJ2-1
TGCGCCAGCAGAACTGCAATGAGAACTAGGGAGGAGCACACCGGGGAGCTGTTTTTT	CASRTAMRTREEHTGELFF	TRBV5-1	TRBJ2-2
TGTGCCAGCTCACTCTGTGCAGGGGGCATTTCCTGGGAAAAACTGTTTTTT	CASSLCAGGISWEKLFF	TRBV18	TRBJ1-4
TGCGCCAGCGTGTCAGGCTCCTACGAGCAGTACTTC	CASVSGSYEQYF	TRBV5-1	TRBJ2-7
TGTGCCAGCAGTTTACCTCCGGTACAGAACACTGAAGCTTTCTTT	CASSLPPVQNTEAFF	TRBV28	TRBJ1-1
TGTGCCAGCAGCCCCGGGACAGGTGGATTGTCGAACACTGAAGCTTTCTTT	CASSPGTGGLSNTEAFF	TRBV13	TRBJ1-1
TGCAGTGCCGGGACGGAGCGGGAAGAGACCCAGTACTTC	CSAGTEREETQYF	TRBV20-1	TRBJ2-5
TGTGCCAGCAGCTTAAATGATAGATACTACGAGCAGTACTTC	CASSLNDRYYEQYF	TRBV7-8	TRBJ2-7
TGTGCCAGCAGCCAAGGAGCAGGGGGGGCCAAAAACATTCAGTACTTC	CASSQGAGGAKNIQYF	TRBV14	TRBJ2-4
TGTGCCAGCAGCTTGGCAGGGAACAATCAGCCCCAGCATTTT	CASSLAGNNQPQHF	TRBV5-4	TRBJ1-5
TGCAGCGTTGAAGGATCAGCACTATCAGATACGCAGTATTTT	CSVEGSALSDTQYF	TRBV29-1	TRBJ2-3
TGTGCCAGCAGGGCCGGTGGGACAGGGAGGTCCACCGGGGAGCTGTTTTTT	CASRAGGTGRSTGELFF	TRBV11-1	TRBJ2-2
TGTGCCAGCAGCTTCCGGAGGGTAAATGAGCAGTTCTTC	CASSFRRVNEQFF	TRBV7-9	TRBJ2-1
TGTGCCAGCAGCTTAGGGAACAGGGGTTTCGGCCAAGAGACCCAGTACTTC	CASSLGNRGFGQETQYF	TRBV7-9	TRBJ2-5
TGCGCCAGCAGCCAGGTCGGACAGGGGGGCGGGGGCTCCTATAATTCACCCCTCCACTTT	CASSQVGQGGGGSYNSPLHF	TRBV4-1	TRBJ1-6
TGTGCCAGCAGCGAAGGACAGGACTATAATTCACCCCTCCACTTT	CASSEGQDYNSPLHF	TRBV7-9	TRBJ1-6
TGTGCCAGCAGCTTGGAGGGCCCAGATACGCAGTATTTT	CASSLEGPDTQYF	TRBV5-4	TRBJ2-3
TGTGCCAGCAGCAAACCAGGTGGGTTGATCAAAAACATTCAGTACTTC	CASSKPGGLIKNIQYF	TRBV7-9	TRBJ2-4
TGTGCCAGCAGCGGCAGTCCGGGACGCGGCCACGAGCAGTACTTC	CASSGSPGRGHEQYF	TRBV7-9	TRBJ2-7
TGCAGTGCTAGATGCTCCGGGACTACCGGGGAGCTGTTTTTT	CSARCSGTTGELFF	TRBV20-1	TRBJ2-2
TGTGCCACCAGTAAAACCCGACAGCGGGAATCTGATAATTCACCCCTCCACTTT	CATSKTRQRESDNSPLHF	TRBV24-1	TRBJ1-6
TGTGCCAGCAGTTACTCGGGACAGGGGAACAATCAGCCCCAGCATTTT	CASSYSGQGNNQPQHF	TRBV6-5	TRBJ1-5
TGCGCCAGCAGCCAAGACGACAACCCGACAGGGGGCTTGGCTTTCTTT	CASSQDDNPTGGLAFF	TRBV4-1	TRBJ1-1
TGTGCCAGCAGCGGACAGGGCCTTAAAGAGACCCAGTACTTC	CASSGQGLKETQYF	TRBV7-2	TRBJ2-5
TGTGCCAGTAGCCTCGGGTATCAAGAGACCCAGTACTTC	CASSLGYQETQYF	TRBV19	TRBJ2-5
TGTGCCACCAGTGATTTTTTACATTCTCACTCTGGAAACACCATATATTTT	CATSDFLHSHSGNTIYF	TRBV24-1	TRBJ1-3
TGCGCCAGCAGGCCCTCTTTTCGGGGGCAAGAGACCCAGTACTTC	CASRPSFRGQETQYF	TRBV10-1	TRBJ2-5
TGTGCCAGCAGTTTACCCCCCGGGGGACAGGATTTCCACCTTCGGAACACTGAAGCTTTCTTT	CASSLPPGGQDFHLRNTEAFF	TRBV6-9	TRBJ1-1
TGTGCCAGCAGTGACTCGCGTGGACAGGGCCACGATAATTCACCCCTCCACTTT	CASSDSRGQGHDNSPLHF	TRBV6-1	TRBJ1-6
TGCAGTGCTAGAGATGCGGGACGATATTCACCCCTCCACTTT	CSARDAGRYSPLHF	TRBV20-1	TRBJ1-6
TGTGCCAGCAGCCTCCGGACAGGGGAGACCCAGTACTTC	CASSLRTGETQYF	TRBV6-5	TRBJ2-5
TGTGCCAGCAGTCGACAGGGGGAGTGGTATGGCTACACCTTC	CASSRQGEWYGYTF	TRBV6-4	TRBJ1-2
TGTGCCAGCAGCCGTGGGACCAACCCCTCAGAGACCCAGTACTTC	CASSRGTNPSETQYF	TRBV7-9	TRBJ2-5
TGCAGTGCTAACCCCTCAGGGACTAGCGGGGTTTACGAGCAGTACTTC	CSANPSGTSGVYEQYF	TRBV20-1	TRBJ2-7
TGTGCCAGCAGCGAAGTGGACAGGGAGGTTGGTTATGGCTACACCTTC	CASSEVDREVGYGYTF	TRBV7-9	TRBJ1-2
TGTGCCAGGGGCAAATCCCACCGGGACAGCGCCTACGAGCAGTACTTC	CARGKSHRDSAYEQYF	TRBV27	TRBJ2-7
TGTGCCAGCAGTGAACGGGAGACTGGGTCCAGCTCCTACGAGCAGTACTTC	CASSERETGSSSYEQYF	TRBV6-1	TRBJ2-7
TGTGCCAGCAGCGTAGACCCCGCCGGGACAGATTGCTTCGCCCTCCACTTT	CASSVDPAGTDCFALHF	TRBV9	TRBJ1-6
TGCAGTGCTAGAAAGACCTCCGGGCCAACGAACACCGGGGAGCTGTTTTTT	CSARKTSGPTNTGELFF	TRBV20-1	TRBJ2-2
TGTGCCAGCAGCTTAGACCGAATGACTAGCGGTGGGCTAGTAAACGAGCAGTACTTC	CASSLDRMTSGGLVNEQYF	TRBV11-2	TRBJ2-7
TGTGCCAGCAGCTTAGGGACAGACATGAACACCGGGGAGCTGTTTTTT	CASSLGTDMNTGELFF	TRBV7-3	TRBJ2-2
TGTGCCAGCAGCCAAGATCCGGGACAGGGCTCTGGGGCCAACGTCCTGACTTTC	CASSQDPGQGSGANVLTF	TRBV14	TRBJ2-6
TGTGCCAGCAGCTTAGGCCGGGACAGGGCCCAAAGTGAAAAACTGTTTTTT	CASSLGRDRAQSEKLFF	TRBV7-9	TRBJ1-4
TGTGCCAGCAGCTTGAAAGGGGCGGACTATGGCTACACCTTC	CASSLKGADYGYTF	TRBV11-3	TRBJ1-2
TGTGCCAGCAGTTACACCGTCCCGGGACAGGGTGAAGCTTTCTTT	CASSYTVPGQGEAFF	TRBV6-2	TRBJ1-1
TGCGCCAGCAGCCCCGGCGGAAACACCATATATTTT	CASSPGGNTIYF	TRBV4-1	TRBJ1-3
TGTGCCAGCACGGGGGACTACCCGGTCTCCTACGAGCAGTACTTC	CASTGDYPVSYEQYF	TRBV28	TRBJ2-7
TGCAGCGTTGTTGCGGGCCAAGTCGTAAACAATGAGCAGTTCTTC	CSVVAGQVVNNEQFF	TRBV29-1	TRBJ2-1
TGTGCCAGCAGCTTAGCCCGGGGGAATGGCTACACCTTC	CASSLARGNGYTF	TRBV7-2	TRBJ1-2
TGTGCCTGCGAACCACAGGGGGCTGAAGCTTTCTTT	CACEPQGAEAFF	TRBV24-1	TRBJ1-1
TGCGCCAGAGAGAGCAAAGGACAGGAGACCCAGTACTTC	CARESKGQETQYF	TRBV5-1	TRBJ2-5
TGTGCCAGCAGCTCGATGGGCAGGGGCGCAGATACGCAGTATTTT	CASSSMGRGADTQYF	TRBV7-3	TRBJ2-3
TGTGCCAGCAGTGTCCCCGGGACAGGGGAGACCCAGTACTTC	CASSVPGTGETQYF	TRBV27	TRBJ2-5
TGTGCCAGCAGTTACTCGAGGGGGCAGATTAAAGGGGACAGGAAGGCCGGGGAGCTGTTTTTT	CASSYSRGQIKGDRKAGELFF	TRBV6-5	TRBJ2-2
TGTGCCATTCACCGCAACGAGCAGTACTTC	CAIHRNEQYF	TRBV13	TRBJ2-7
TGTGCCAGCAGCTTAGCTCCCGGCCGGGACATCGAGGAAATCACTGAAGCTTTCTTT	CASSLAPGRDIEEITEAFF	TRBV11-2	TRBJ1-1
TGTGCCAGCAAGTCCCAAACTAGCGGGAGCTCATTAGCTTACAATGAGCAGTTCTTC	CASKSQTSGSSLAYNEQFF	TRBV5-6	TRBJ2-1
TGTGCCAGCAGTGGAAGAGAGACCCAGTACTTC	CASSGRETQYF	TRBV6-1	TRBJ2-5
TGTGCCAGCAGTTCCCTGGTACGCGAGCAGTACTTC	CASSSLVREQYF	TRBV28	TRBJ2-7
TGTGCCAGCAGCTTATTAGCGGGGAACGTCCCAACCTACGAGCAGTACTTC	CASSLLAGNVPTYEQYF	TRBV11-1	TRBJ2-7
TGTGCCAGCAGCTTGCGGGATCCGGGACTAGTGGATGAGCAGTTCTTC	CASSLRDPGLVDEQFF	TRBV5-6	TRBJ2-1
TGTGCCAGCAGCTTCTGGTACGGGGCGAGTATCTTC	CASSFWYGASIF	TRBV5-4	TRBJ2-1
TGTGCCAGCACCTCACAGGGATTCTTT	CASTSQGFF	TRBV27	TRBJ1-1
TGTGCCAGCAGCCTCCAGGGGAGGGAGACCCAGTACTTC	CASSLQGRETQYF	TRBV14	TRBJ2-5
TGTGCCACCACTGACAGGGAATCCTCGAGGGAGACCCAGTACTTC	CATTDRESSRETQYF	TRBV15	TRBJ2-5
TGTGCCATCAGTGAGTCGTTGGGGGAAGATGGGACAGATACGCAGTATTTT	CAISESLGEDGTDTQYF	TRBV10-3	TRBJ2-3
TGTGCCAGCAGTGACTCTACTTGGGGAGAGACCCAGTACTTC	CASSDSTWGETQYF	TRBV6-4	TRBJ2-5
TGTGCCAGTAGTAAACAGGGCGTGCAGCCGGTTTGGACCCCGGCGAACACCGGGGAGCTGTTTTTT	CASSKQGVQPVWTPANTGELFF	TRBV19	TRBJ2-2
TGTGCCATCAGTGAGTGCGGGGAGAAAACATCTGAGCAGTTCTTC	CAISECGEKTSEQFF	TRBV10-3	TRBJ2-1
TGTGCCAGCAGTTACTCGAACCTGCAAGAGACCCAGTACTTC	CASSYSNLQETQYF	TRBV6-5	TRBJ2-5
TGTGCCAGCAGATATACAGGGAAATGTCGTGAAGCTTTCTTT	CASRYTGKCREAFF	TRBV6-6	TRBJ1-1
TGTGCCACCGGGACAGGAAGCAATCAGCCCCAGCATTTT	CATGTGSNQPQHF	TRBV27	TRBJ1-5
TGTGCCAGCAGTTATTCGCGAGCGTCCACTGAAGCTTTCTTT	CASSYSRASTEAFF	TRBV6-5	TRBJ1-1
TGTGCCAGCAGTGGAGGAGGGGACTACGAGCAGTACTTC	CASSGGGDYEQYF	TRBV7-3	TRBJ2-7
TGTGCCAGCAGCTTGTGGCGAGGTCTATCTGAAGCTTTCTTT	CASSLWRGLSEAFF	TRBV5-6	TRBJ1-1
TGTGCCAGCAGTTTATATATGGGGACGCAGGGAAGGAAAAACACTGAAGCTTTCTTT	CASSLYMGTQGRKNTEAFF	TRBV27	TRBJ1-1
TGTGCCAGCAGCGCAGGGACAGTTGGCCTGTTCTCTGGGGCCAACGTCCTGACTTTC	CASSAGTVGLFSGANVLTF	TRBV9	TRBJ2-6
TGTGCCAGCAGCCCTGTAACACAGACAGGGGGGACCGGGAACACTGAAGCTTTCTTT	CASSPVTQTGGTGNTEAFF	TRBV4-2	TRBJ1-1
TGTGCCAGCAGCGTGACAGGGGAGAATGAAAAACTGTTTTTT	CASSVTGENEKLFF	TRBV5-4	TRBJ1-4
TGTGCCAGTACCGAAATAGCGGGACGCCAAGAGACCCAGTACTTC	CASTEIAGRQETQYF	TRBV19	TRBJ2-5
TGTGCCAGCAGTCTCCCGGGCGATAGCTCACCCACCGGGGAGCTGTTTTTT	CASSLPGDSSPTGELFF	TRBV6-6	TRBJ2-2
TGTGCCAGCAGCTTGCGAACATGTAGAAGATATTACGAGCAGTACTTC	CASSLRTCRRYYEQYF	TRBV5-4	TRBJ2-7
TGTGCCAGCAGCCAAAAGGGTGGGCGAGAACCTAACTATGGCTACACCTTC	CASSQKGGREPNYGYTF	TRBV3-1	TRBJ1-2
TGTGCCATCCCCGAACTCCAATCCATTCAGTACTTC	CAIPELQSIQYF	TRBV10-3	TRBJ2-4
TGTGCCAGCAGCTCATATTCGGGAGGGGATGGCCAAGAGACCCAGTACTTC	CASSSYSGGDGQETQYF	TRBV13	TRBJ2-5
TGCGCCAGCATTCTGGCAGGGGGGGGTAACAACAATGAGCAGTTCTTC	CASILAGGGNNNEQFF	TRBV10-2	TRBJ2-1
TGTGCCAGCAGCGTCGGACAGAACCCTGAAGCTTTCTTT	CASSVGQNPEAFF	TRBV9	TRBJ1-1
TGTGCCAGCAGCCTGGCGACATATGGCTACACCTTC	CASSLATYGYTF	TRBV7-3	TRBJ1-2
TGTGCCAGCAGGACCAGGAGTATTAGCAATCAGCCCCAGCATTTT	CASRTRSISNQPQHF	TRBV9	TRBJ1-5
TGTGCCAGCAGCACGTGGTCAGACAGGGACTATGGCTACACCTTC	CASSTWSDRDYGYTF	TRBV7-3	TRBJ1-2
TGTGCCACTGACGGACTGTTGGGCGACTATACTGAAGCTTTCTTT	CATDGLLGDYTEAFF	TRBV24-1	TRBJ1-1
TGCAGTGCTCCTGCAGGGGGCGCGGCGTGCAATCAGCCCCAGCATTTT	CSAPAGGAACNQPQHF	TRBV20-1	TRBJ1-5
TGTGCCAGCAGCCAAGACCTCGGGGCCGGGAACACCGGGGAGCTGTTTTTT	CASSQDLGAGNTGELFF	TRBV4-2	TRBJ2-2
TGTGCCAGCAGCTGTCGACTAAACAGCACAGATACGCAGTATTTT	CASSCRLNSTDTQYF	TRBV11-2	TRBJ2-3
TGTGCCAGCAGTTTTCCCGGGACAGATTCCTTACAGCCCCAGCATTTT	CASSFPGTDSLQPQHF	TRBV6-5	TRBJ1-5
TGTGCCAGCAGCAACTTCGGACTCAGATACTACGAGCAGTACTTC	CASSNFGLRYYEQYF	TRBV7-3	TRBJ2-7
TGTGCCAGCAGCGGGACAGGGGGGAATTCACCCCTCCACTTT	CASSGTGGNSPLHF	TRBV6-2	TRBJ1-6
TGTGCCAGCAGTTTATGCAATGTACCGGGGGGGGCCTACAATGAGCAGTTCTTC	CASSLCNVPGGAYNEQFF	TRBV28	TRBJ2-1
TGTGCCAGCAGCCAAGCCAATCCCTGGGACAACAGACAAGCTTTCTTT	CASSQANPWDNRQAFF	TRBV14	TRBJ1-1
TGTGCCAGCAGTGAAGTGGGGACTAGCTCCTACAATGAGCAGTTCTTC	CASSEVGTSSYNEQFF	TRBV2	TRBJ2-1
TGTGCCAGCAGTGCCCCGAAGTACGGGAACACTGAAGCTTTCTTT	CASSAPKYGNTEAFF	TRBV28	TRBJ1-1
TGTGCCAGCAGGGTTCTGGACCGAAATCAGCCCCAGCATTTT	CASRVLDRNQPQHF	TRBV27	TRBJ1-5
TGTGCCAGCAATAGGGGCCAAGAGACCCAGTACTTC	CASNRGQETQYF	TRBV28	TRBJ2-5
TGTGCCAGCACTGAGAGTCAACGTGAGCAGTTCTTC	CASTESQREQFF	TRBV6-3	TRBJ2-1
TGTGCCAGCAGCGTGTACGACCCAGGGGTTTTCCTGGGAAACACCATATATTTT	CASSVYDPGVFLGNTIYF	TRBV7-3	TRBJ1-3
TGTGCCAGCAGCGGTCTCCGGGAGCCCCCTAATGAGCAGTTCTTC	CASSGLREPPNEQFF	TRBV7-4	TRBJ2-1
TGCGCCAGCAGCCAAGGTGGGCGCAGCGGGAGGACTAATGAAAAACTGTTTTTT	CASSQGGRSGRTNEKLFF	TRBV4-3	TRBJ1-4
TGTGCCAGCAGCTTAGATTGCCTAGCGGGCGGGAGCTCCTACGAGCAGTACTTC	CASSLDCLAGGSSYEQYF	TRBV11-3	TRBJ2-7
TGTGCCAGCAGTCCTGACAGGGGACGTTCACCCCTCCACTTT	CASSPDRGRSPLHF	TRBV6-2	TRBJ1-6
TGTGCCAGCAGCTTCCGTGGCCTGTTTTTT	CASSFRGLFF	TRBV7-7	TRBJ1-4
TGTGCCAGTAGTATAGAGAGGGACCGGACTAGCGGGGAACCTAGCACAGATACGCAGTATTTT	CASSIERDRTSGEPSTDTQYF	TRBV19	TRBJ2-3
TGTGCCAGCAGTTTAGCGACCCGGGACAGATCGGGCGGGGAGCTGTTTTTT	CASSLATRDRSGGELFF	TRBV12-3	TRBJ2-2
TGCAGTCGGGAGTCCAACGAGCAGTACTTC	CSRESNEQYF	TRBV20-1	TRBJ2-7
TGTGCCACGGATCAAGGGGGCGTACACTGCAATCAGCCCCAGCATTTT	CATDQGGVHCNQPQHF	TRBV27	TRBJ1-5
TGTGCCAGTAGTATAGCTAGGTTCTCCTACGAGCAGTACTTC	CASSIARFSYEQYF	TRBV19	TRBJ2-7
TGTGCCAGCAGTTTAACTTGGGCCTTCTGGCGTCGCACAGATACGCAGTATTTT	CASSLTWAFWRRTDTQYF	TRBV12-3	TRBJ2-3
TGTGCCAGCAGGGGAGGGACCGGGGAGCTGTTTTTT	CASRGGTGELFF	TRBV27	TRBJ2-2
TGTGCCAGCTTTACCCCCGCAAGGGGGGGCGGGGCCACGGAAAAACTGTTTTTT	CASFTPARGGGATEKLFF	TRBV5-6	TRBJ1-4
TGTGCCACCGCGGGGACAGGGGAAGCTGAGTTGAACACTGAAGCTTTCTTT	CATAGTGEAELNTEAFF	TRBV24-1	TRBJ1-1
TGTGCCAGCACGTTCCTAACAGGGGAATGTGAGCAGTACTTC	CASTFLTGECEQYF	TRBV6-2	TRBJ2-7
TGTGCCAGCAGGGACTACGTCCAAAGTCTCGAGGTCTTCTTC	CASRDYVQSLEVFF	TRBV28	TRBJ2-1
TGTGCCAGCAGCGTTGGGACAGGGAGACGGCCTCAGCCCCAGCATTTT	CASSVGTGRRPQPQHF	TRBV9	TRBJ1-5
TGTGCCAGTTCCAGGCTGAAGTGGGGAATATCTTTACCAGAGACCCAGTACTTC	CASSRLKWGISLPETQYF	TRBV27	TRBJ2-5
TGTGCCAGCAGCCAAGATCCGGACGGAGTAGGGGGTGGAAACACCATATATTTT	CASSQDPDGVGGGNTIYF	TRBV14	TRBJ1-3
TGTGCCAGCAGTTACGCTCTAGGAGGGGTTGCCTACAATGAGCAGTTCTTC	CASSYALGGVAYNEQFF	TRBV6-5	TRBJ2-1
TGTGCCAGCAAAAGGCGGGAGTACTTC	CASKRREYF	TRBV12-3	TRBJ2-5
TGCAGTGCTGTAAGGGCGGGTCCGATCTCTGGAAACACCATATATTTT	CSAVRAGPISGNTIYF	TRBV20-1	TRBJ1-3
TGCGCCAGCAGCTTGGCCCTAGCGCAGAATAAGGAGACCCAGTACTTC	CASSLALAQNKETQYF	TRBV5-1	TRBJ2-5
TGTGCCACCAGACCTTGGTCGGGGGTACCCGGGGAGCTGTTTTTT	CATRPWSGVPGELFF	TRBV24-1	TRBJ2-2
TGTGCCTGGAGTGTACAGCCCCGAAATGGGGGCGGACGAAGGTCGGCCTCCTACGAGCAGTACTTC	CAWSVQPRNGGGRRSASYEQYF	TRBV30	TRBJ2-7
TGTGCCACCAGTGATTTGTGGCGACAGGGCTCCATCTGTCAGCCCCAGCATTTT	CATSDLWRQGSICQPQHF	TRBV24-1	TRBJ1-5
TGTGCCAGCAGCAACAAGGTTCCGAACACTGAAGCTTTCTTT	CASSNKVPNTEAFF	TRBV5-4	TRBJ1-1
TGTGCCAGCAGCTTAATCGTCCTAGGGGGTTTCGAGGTCGAGCAGTACTTC	CASSLIVLGGFEVEQYF	TRBV11-3	TRBJ2-7
TGTGCCAGCAGTACCAGGGAGTCAGAGCAGTACTTC	CASSTRESEQYF	TRBV7-3	TRBJ2-7
TGTGCCAGCAACGAGACAGGTGAGACCCAGTACTTC	CASNETGETQYF	TRBV2	TRBJ2-5
TGTGCCAGCAGCTCGCCCCCGGACAGCTATGGCTACACCTTC	CASSSPPDSYGYTF	TRBV11-3	TRBJ1-2
TGTGCCATCAGTGAGCCAGGGATAGAGACCCAGTACTTC	CAISEPGIETQYF	TRBV10-3	TRBJ2-5
TGTGCCACCCTCAGGGGCGAAAGCTCCTACGAGCAGTACTTC	CATLRGESSYEQYF	TRBV19	TRBJ2-7
TGTGCCAGCAGCCACCGGGACAGGGGGCTGGACTATGGCTACACCTTC	CASSHRDRGLDYGYTF	TRBV14	TRBJ1-2
TGTGCCAGCAGCAAGGGTGATCAGCCCCAGCATTTT	CASSKGDQPQHF	TRBV11-1	TRBJ1-5
TGTGCCACCAGTGGGGCCCTCTGGAACAGTGGGAGGAACTACGAGCAGTACTTC	CATSGALWNSGRNYEQYF	TRBV24-1	TRBJ2-7
TGCGCCAGCAGGACTCCTGAGCAGTTCTTC	CASRTPEQFF	TRBV5-1	TRBJ2-1
TGTGCCAGCGCTCCCCGGGGGGAGGAGAACACCGGGGAGCTGTTTTTT	CASAPRGEENTGELFF	TRBV9	TRBJ2-2
TGTGCCAGCAGAGACGAGTACGAGCAGTACTTC	CASRDEYEQYF	TRBV12-4	TRBJ2-7
TGTGCCAGCAGTAAGACCTACCCCGGGGAGCTGTTTTTT	CASSKTYPGELFF	TRBV6-4	TRBJ2-2
TGCGCCAGCAGCTGCGATCTTCCCGGGACTAGCGGGAGGCGGTCCTACAATGAGCAGTTCTTC	CASSCDLPGTSGRRSYNEQFF	TRBV5-1	TRBJ2-1
TGTGCCAGCAGTTTGAGGCCGGGACGCAATCAGCCCCAGCATTTT	CASSLRPGRNQPQHF	TRBV27	TRBJ1-5
TGCGCCAGCAGCTTGGCCGAGTTGTATAGCCAGGGAGTGGACGGCTACACCTTC	CASSLAELYSQGVDGYTF	TRBV5-1	TRBJ1-2
TGTGCCAGCAGCCAAGAACAATACCAGGGCTATGGCTACACCTTC	CASSQEQYQGYGYTF	TRBV4-2	TRBJ1-2
TGCGCCGTGGACAAGGGGGCAGAGGGAATAGAGACCCAGTACTTC	CAVDKGAEGIETQYF	TRBV10-1	TRBJ2-5
TGTGCCAGCAGTGACCTATTGCGACACATCGAGCGACGGGAAAACATTCAGTACTTC	CASSDLLRHIERRENIQYF	TRBV6-4	TRBJ2-4
TGTGCCAGCAGTTTATGGCGGGACGGCGTTCGCACAGATACGCAGTATTTT	CASSLWRDGVRTDTQYF	TRBV27	TRBJ2-3
TGTGCCAGCACCCTAATTGGCTACACCTTC	CASTLIGYTF	TRBV7-4	TRBJ1-2
TGTGCCAGCAGGGGGGGCTCGGGCATTAGCGCGAACACCGGGGAGCTGTTTTTT	CASRGGSGISANTGELFF	TRBV6-3	TRBJ2-2
TGTGCTAGCAGCTTCCCTTACGAACGGGGAAACACCATATATTTT	CASSFPYERGNTIYF	TRBV7-7	TRBJ1-3
TGTGCCAGCAGTTACACCCGGCCCACAGGCGAGCAGTACTTC	CASSYTRPTGEQYF	TRBV6-5	TRBJ2-7
TGTGCCAGGGGCCCTCGGAGAGACAATGAGCAGTTCTTC	CARGPRRDNEQFF	TRBV25-1	TRBJ2-1
TGTGCCACCAGTGCAGGGGGGACAGGGGTAGACTACGAGCAGTACTTC	CATSAGGTGVDYEQYF	TRBV24-1	TRBJ2-7
TGTGCCAGCAATGGGGCTGAGGCGAACACCGGGGAGCTGTTTTTT	CASNGAEANTGELFF	TRBV6-4	TRBJ2-2
TGCAGCGTTGCTAGCGGGAGAGGGGGCGAGCAGTACTTC	CSVASGRGGEQYF	TRBV29-1	TRBJ2-7
TGTGCCAGCAGTGAGAGCATTTCGGGACAGGTTCCTAATGAAAAACTGTTTTTT	CASSESISGQVPNEKLFF	TRBV25-1	TRBJ1-4
TGCGCCAGCCGAGGGGGGTGGATCTATGGCTACACCTTC	CASRGGWIYGYTF	TRBV10-1	TRBJ1-2
TGCAGTGCTAGAGCATCCCTACAGGGGAGTGGGGCCAACGTCCTGACTTTC	CSARASLQGSGANVLTF	TRBV20-1	TRBJ2-6
TGTGCCAGCAGCACGTTTACAGCACAGGTCCCTTCCTACAATGAGCAGTTCTTC	CASSTFTAQVPSYNEQFF	TRBV13	TRBJ2-1
TGCGCCAGCAGCTTGCTCCACAGGAGGGGCTACACCTTC	CASSLLHRRGYTF	TRBV5-1	TRBJ1-2
TGTGCCAGCAGTGAGGGGGCAGGGGGGCCGGCCTATGGCTACACCTTC	CASSEGAGGPAYGYTF	TRBV6-5	TRBJ1-2
TGCAGTGCTAGAGATAAGACAGGGGTTCACACCGGGGAGCTGTTTTTT	CSARDKTGVHTGELFF	TRBV20-1	TRBJ2-2
TGTGCCAGCAGCAAGGGGTGGGACGGGCAAGAGACCCAGTACTTC	CASSKGWDGQETQYF	TRBV11-3	TRBJ2-5
TGTGCCAGCATCATGTCTAAGGGACAGGGCCGCCCCTCCTACGAGCAGTACTTC	CASIMSKGQGRPSYEQYF	TRBV6-2	TRBJ2-7
TGTGCCAGCAGTGACGGAGGGACAGCACCACAAGCCCGCTATAATTCACCCCTCCACTTT	CASSDGGTAPQARYNSPLHF	TRBV6-4	TRBJ1-6
TGTGCCAGCAGCTTATGTAGCTTGCAGTACTTC	CASSLCSLQYF	TRBV7-9	TRBJ2-7
TGTGCCAGCAGTGAGGCCGGGACAGGGGAATACGAGCAGTACTTC	CASSEAGTGEYEQYF	TRBV6-4	TRBJ2-7
TGCGCCAGCAGTGCGGGGAGACAAGGATACGAGCAGTACTTC	CASSAGRQGYEQYF	TRBV10-1	TRBJ2-7
TGTGCCAGCAGCCCCATGGGGGGGGAGACACGCACAGATACGCAGTATTTT	CASSPMGGETRTDTQYF	TRBV11-3	TRBJ2-3
TGTGCCAGCAGTTACGGCCTGACCTGTGGGGGGGAGCTTGGCCAAGAGACCCAGTACTTC	CASSYGLTCGGELGQETQYF	TRBV6-2	TRBJ2-5
TGTGCCAGCAGACGTACTCGGAAAGCCTACGAGCAGTACTTC	CASRRTRKAYEQYF	TRBV6-4	TRBJ2-7
TGTGCCAGCCAGGGGGCAGGCTACACCTTC	CASQGAGYTF	TRBV6-5	TRBJ1-2
TGTGCCAGTAGTATCACCAGGGAGTTAAACATTCAGTACTTC	CASSITRELNIQYF	TRBV19	TRBJ2-4
TGTGCCAGCAGAATGGGGGCTGTAGAGACCCAGTACTTC	CASRMGAVETQYF	TRBV6-5	TRBJ2-5
TGTGCCAGCAGTCATAATAGGGGCAATCAGCCCCAGCATTTT	CASSHNRGNQPQHF	TRBV6-1	TRBJ1-5
TGTGCCACCAGTGATCGTACTAGAGAAGCCCCCGTATTCACTAATGAGCAGTTCTTC	CATSDRTREAPVFTNEQFF	TRBV24-1	TRBJ2-1
TGTGCCAGCAGCTTAGTAAGGGGGGCCGGGCGGGAGTCAGGGGCCTACGAGCAGTACTTC	CASSLVRGAGRESGAYEQYF	TRBV7-4	TRBJ2-7
TGTGCCAGCAGTCGATCCCACCGGGACAGGACCAATGAAAAACTGTTTTTT	CASSRSHRDRTNEKLFF	TRBV28	TRBJ1-4
TGCGCCAGCAGCCAAGATCTGGACCCGACAGGGTTTGAGACCCAGTACTTC	CASSQDLDPTGFETQYF	TRBV4-1	TRBJ2-5
TGTGCCACCAGCATCAGGGTGGGACAGGGGGGTAATGAAAAACTGTTTTTT	CATSIRVGQGGNEKLFF	TRBV24-1	TRBJ1-4
TGTGCCACCAGTGATTTGGTTTATCCGGGGGGTCTTGAGCCGCACGAGCAGTACTTC	CATSDLVYPGGLEPHEQYF	TRBV24-1	TRBJ2-7
TGTGCCAGCAGCGCTAGACAGGGTTGGATCCGGAGCTCCTACAATGAGCAGTTCTTC	CASSARQGWIRSSYNEQFF	TRBV5-6	TRBJ2-1
TGTGCCAGCAGTTGGCGGGGGGGGCCAGCCGAAGAGACCCAGTACTTC	CASSWRGGPAEETQYF	TRBV7-2	TRBJ2-5
TGTGCCAGCAGAGCGGGCGAGCAGTACTTC	CASRAGEQYF	TRBV6-5	TRBJ2-7
TGTGCCACCAGTGCATTGGGCGATGGCTACACCTTC	CATSALGDGYTF	TRBV24-1	TRBJ1-2
TGTGCCAGCTCACCACCCCCAAGAAGACCGTGGGGGGCGGTTGGCTACACCTTC	CASSPPPRRPWGAVGYTF	TRBV18	TRBJ1-2
TGTGCCACCCCGTCTGACAGAACCAGCTCCTACGAGCAGTACTTC	CATPSDRTSSYEQYF	TRBV15	TRBJ2-7
TGTGCCAGCAGCTTACTTGGGGGGCTCCCATTCCAGGAGACCCAGTACTTC	CASSLLGGLPFQETQYF	TRBV7-3	TRBJ2-5
TGTGCTAGCAGCTTATCTACCAGCGGGGGGCTGGGATCCTACAATGAGCAGTTCTTC	CASSLSTSGGLGSYNEQFF	TRBV7-7	TRBJ2-1
TGTGCCAGCAGTTTATCCTATAGGGGACAGGATGAGCAGTTCTTC	CASSLSYRGQDEQFF	TRBV27	TRBJ2-1
TGTGCCAGGACCTTGAACACTGAAGCTTTCTTT	CARTLNTEAFF	TRBV28	TRBJ1-1
TGCGCCAGCAGCTTGACGGAGCCGGGGCGCAATTACCCCTCCTACGAGCAGTACTTC	CASSLTEPGRNYPSYEQYF	TRBV5-1	TRBJ2-7
TGTGCCAGCAGCTTGTCAGGGGGAGGGGATAGCAATCAGCCCCAGCATTTT	CASSLSGGGDSNQPQHF	TRBV5-5	TRBJ1-5
TGTGCCAGCAGCCGCACGAGGACAGATACGCAGTATTTT	CASSRTRTDTQYF	TRBV7-3	TRBJ2-3
TGTGCCAGCAGCTACACCGACACTGAAGCTTTCTTT	CASSYTDTEAFF	TRBV9	TRBJ1-1
TGCAGCGGGCCCAAAGGGGGCACAGATACGCAGTATTTT	CSGPKGGTDTQYF	TRBV29-1	TRBJ2-3
TGTGCCAGCTCACGGAGCGGGGTTGGGGGGGCCTACGAGCAGTACTTC	CASSRSGVGGAYEQYF	TRBV18	TRBJ2-7
TGTGCCATCAGTGGGGGGCGTGGAGAAAAACTGTTTTTT	CAISGGRGEKLFF	TRBV10-3	TRBJ1-4
TGTGCCAGCAGCTTAAACAGTTCTAGCGGGTGCTACAATGAGCAGTTCTTC	CASSLNSSSGCYNEQFF	TRBV7-9	TRBJ2-1
TGTGCCAGTAGTATAGGGGCGGGCAATCAGCCCCAGCATTTT	CASSIGAGNQPQHF	TRBV19	TRBJ1-5
TGCAGTGCTAGCCCTTATGGGACAGATAACAATGAGCAGTTCTTC	CSASPYGTDNNEQFF	TRBV20-1	TRBJ2-1
TGTGCCAGCAGCCAAGACGTTGTAACTAGCGGGCGGGATCCCACAGATACGCAGTATTTT	CASSQDVVTSGRDPTDTQYF	TRBV14	TRBJ2-3
TGTGCCAGCAGCTTCCCGGGACAGGGTTTTGAGCAGTTCTTC	CASSFPGQGFEQFF	TRBV5-6	TRBJ2-1
TGTGCCAGACGGGGGGGATACAATGAGCAGTTCTTC	CARRGGYNEQFF	TRBV6-3	TRBJ2-1
TGCAGCGTTGAAGCAAGTAGAGGCGTTCAGCCCCAGCATTTT	CSVEASRGVQPQHF	TRBV29-1	TRBJ1-5
TGTGCCAGCAGCGGTACAGGGGCCCATCAGCCCCAGCATTTT	CASSGTGAHQPQHF	TRBV9	TRBJ1-5
TGTGCCCGGGGGGGGACTAGCGGGGGGCCGGGCTACGAGCAGTACTTC	CARGGTSGGPGYEQYF	TRBV30	TRBJ2-7
TGCGCCAGCAGACGATCGGTCTCCTACAATGAGCAGTTCTTC	CASRRSVSYNEQFF	TRBV10-1	TRBJ2-1
TGTGCCAGCACCAACTGTGACGGTTCCAATCAGCCCCAGCATTTT	CASTNCDGSNQPQHF	TRBV27	TRBJ1-5
TGTGCCAGCAGTTTGTTGGAGGGCTTCCTGTACGAGCAGTACTTC	CASSLLEGFLYEQYF	TRBV27	TRBJ2-7
TGTGCCAGCAGTCGCAGGGGCGGTCACTACGAGCAGTACTTC	CASSRRGGHYEQYF	TRBV27	TRBJ2-7
TGTGCCAGCAGTGAAAGCGGGATGGAAATTTTAATGAACACTGAAGCTTTCTTT	CASSESGMEILMNTEAFF	TRBV6-1	TRBJ1-1
TGTGCCAGCAGTGACGGAGGGGAGTATTCTGGAAACACCATATATTTT	CASSDGGEYSGNTIYF	TRBV6-4	TRBJ1-3
TGCAGCGTTGACCCCGGGAAACAGGGGGCTGACCCCTACGAGCAGTACTTC	CSVDPGKQGADPYEQYF	TRBV29-1	TRBJ2-7
TGTGCCACCGCAGCTTGGGAAAGCTCCTACGAGCAGTACTTC	CATAAWESSYEQYF	TRBV24-1	TRBJ2-7
TGCAGTGCTAGGGGTAGGCGGGGTATCAAGGACAGGGCTAATGAAAAACTGTTTTTT	CSARGRRGIKDRANEKLFF	TRBV20-1	TRBJ1-4
TGTGCCTGGGAACACAGGGGTGGGTCCGGTGATCAGCCCCAGCATTTT	CAWEHRGGSGDQPQHF	TRBV30	TRBJ1-5
TGCGCCAGCAGCTTAGAGAACGGGGCAGATAACACCGGGGAGCTGTTTTTT	CASSLENGADNTGELFF	TRBV5-1	TRBJ2-2
TGTGCCAGCAGTGGGGAAGAGGAGGAAAAACTGTTTTTT	CASSGEEEEKLFF	TRBV28	TRBJ1-4
TGTGCCAGCCCAGGGGCCCGCTACAATGAGCAGTTCTTC	CASPGARYNEQFF	TRBV6-1	TRBJ2-1
TGTGCCAGCAGCCAAGCGGGGACAGGGGGGTGTAGCAATCAGCCCCAGCATTTT	CASSQAGTGGCSNQPQHF	TRBV3-1	TRBJ1-5
TGTGCCAGCAGCCTGGGGGGGCCAGGAGGTTGTTATAGCAATCAGCCCCAGCATTTT	CASSLGGPGGCYSNQPQHF	TRBV7-8	TRBJ1-5
TGTGCCACCAGTGATTTGACCGAGTCACAGGGGGAACCAGAATATAGCAATCAGCCCCAGCATTTT	CATSDLTESQGEPEYSNQPQHF	TRBV24-1	TRBJ1-5
TGTGCCAGCAGCGCTTGCTTGGGGGGGGGCGACAATGAGCAGTTCTTC	CASSACLGGGDNEQFF	TRBV11-3	TRBJ2-1
TGTGCCAGGGGGGTTAGCACAGATACGCAGTATTTT	CARGVSTDTQYF	TRBV6-1	TRBJ2-3
TGTGCCAGCAGCTTCCAACAGGGATCCGGAGGGTCAGCCTATACCCCCGGCTCTGGAAACACCATATATTTT	CASSFQQGSGGSAYTPGSGNTIYF	TRBV7-6	TRBJ1-3
TGTGCCAGCAGCCAGGGGCGCAAAGGAACTAATGAAAAACTGTTTTTT	CASSQGRKGTNEKLFF	TRBV7-3	TRBJ1-4
TGTGCCAGCAGTTCAAACAGGGGGGGGGCCAACGTCCTGACTTTC	CASSSNRGGANVLTF	TRBV27	TRBJ2-6
TGTGCCAGCAGCTTACATGGCGACAGGGGGTCGCCTAGCAATCAGCCCCAGCATTTT	CASSLHGDRGSPSNQPQHF	TRBV7-3	TRBJ1-5
TGTGCCAGCAGCGTAGGAGGGGGGCCTGAAGCTGAGCAGTTCTTC	CASSVGGGPEAEQFF	TRBV9	TRBJ2-1
TGTGCCAGCAGCCACACTAGCGGGAGTACCCGCAATGAGCAGTTCTTC	CASSHTSGSTRNEQFF	TRBV13	TRBJ2-1
TGTGCCAGCTCTTCGGGGACGGGCGTGACCTACGAGCAGTACTTC	CASSSGTGVTYEQYF	TRBV6-4	TRBJ2-7
TGTGCCACCAGTGATGACCGGGACGGGGAAACTGAAGCTTTCTTT	CATSDDRDGETEAFF	TRBV24-1	TRBJ1-1
TGTGCCAGCAGCGGGGGGGACGACCCCTACGAGCAGTACTTC	CASSGGDDPYEQYF	TRBV9	TRBJ2-7
TGTGCCAGCGAAAAGGATAGCAATCAGCCCCAGCATTTT	CASEKDSNQPQHF	TRBV5-6	TRBJ1-5
TGTGCCAGCAGCCCTTATTCGGGGGGCAATCAGCCCCAGCATTTT	CASSPYSGGNQPQHF	TRBV7-9	TRBJ1-5
TGTGCCAGCAATGAAAAGTCTAGCGGGGGCTACAATGAGCAGTTCTTC	CASNEKSSGGYNEQFF	TRBV6-5	TRBJ2-1
TGTGCCAGCAGTGGGGTCGGGGGGCTAGACAATGAGCAGTTCTTC	CASSGVGGLDNEQFF	TRBV27	TRBJ2-1
TGCGCCAGCAGCTTGACTGAGGACAGGAAGTACCAAGAGACCCAGTACTTC	CASSLTEDRKYQETQYF	TRBV5-1	TRBJ2-5
TGTGCCAGTAGTTCCGAAAGAGGAGGTAATGAGCAGTTCTTC	CASSSERGGNEQFF	TRBV19	TRBJ2-1
TGCAGTGCTAGTCTGGGGACCGACACTGAAGCTTTCTTT	CSASLGTDTEAFF	TRBV20-1	TRBJ1-1
TGTGCCAGCAGTTACTCGCCTAGCGGGGGGGCCAATCACAATGAGCAGTTCTTC	CASSYSPSGGANHNEQFF	TRBV6-3	TRBJ2-1
TGTGCCAGCAGGTTGAGGGCCGGGTGCTCTGAAGCTTTCTTT	CASRLRAGCSEAFF	TRBV6-2	TRBJ1-1
TGTGCCAGCAGTTTATCTACCGCTGGCCGGGACAGGACTGAAGCTTTCTTT	CASSLSTAGRDRTEAFF	TRBV27	TRBJ1-1
TGCGCCAGCAGCTTAAAGCTTGACATGCAGTATTCACCCCTCCACTTT	CASSLKLDMQYSPLHF	TRBV5-1	TRBJ1-6
TGTGCCATCAGTCAGGGGTACGAGCAGTACTTC	CAISQGYEQYF	TRBV10-3	TRBJ2-7
TGCGCCAGCAGCTTGTCCCCAGGACAGGCTTTAAAAGGGAAAGTGGGGAACACTGAAGCTTTCTTT	CASSLSPGQALKGKVGNTEAFF	TRBV5-1	TRBJ1-1
TGTGCCAGCAGCGAGCCCGGGACCTCCTACGAGCAGTACTTC	CASSEPGTSYEQYF	TRBV9	TRBJ2-7
TGTGCCAGCAGCGTCCTCGGGGGACGGGGAGGATGGCCCCAGCATTTT	CASSVLGGRGGWPQHF	TRBV13	TRBJ1-5
TGTGCCACCGGCCCCCGATTACTAGCCGTGACAGATACGCAGTATTTT	CATGPRLLAVTDTQYF	TRBV24-1	TRBJ2-3
TGTGCCAGCAGAGCCTTCGCCCTCCCAGCTCGGCCTTGCGAGCAGTACTTC	CASRAFALPARPCEQYF	TRBV27	TRBJ2-7
TGCAGTGCTAGTCCTTTTTCCGCAGGGTTGGATTACGAGCAGTACTTC	CSASPFSAGLDYEQYF	TRBV20-1	TRBJ2-7
TGTGCCAGCAGCGTAGGGTTAGCGGGTGAGTACAATGAGCAGTTCTTC	CASSVGLAGEYNEQFF	TRBV9	TRBJ2-1
TGCGCCAGCAGCGTTTGGCTAACAGGGGGCGTCAATGAGCAGTTCTTC	CASSVWLTGGVNEQFF	TRBV5-1	TRBJ2-1
TGTGCTAGTGGTGTGGGGGGAGCAAGATCCTACAATGAGCAGTTCTTC	CASGVGGARSYNEQFF	TRBV12-5	TRBJ2-1
TGTGCCAGTCCCCCCCCACAGGCTTCACCCCTCCACTTT	CASPPPQASPLHF	TRBV5-8	TRBJ1-6
TGCAGTGCTAAGGACGCCAGGCGGGGAGACTCCTACGAGCAGTACTTC	CSAKDARRGDSYEQYF	TRBV20-1	TRBJ2-7
TGTGCCAGCACGTCCCCGGGACAGGGGGCTGGAAACACCATATATTTT	CASTSPGQGAGNTIYF	TRBV5-4	TRBJ1-3
TGTGCCAGCAGCATAAATCCGCCGGGACAGGGCCCGGTCTCCTACAATGAGCAGTTCTTC	CASSINPPGQGPVSYNEQFF	TRBV13	TRBJ2-1
TGTGCCAGCAGTGGCCCCTCTGCCAAAAACATTCAGTACTTC	CASSGPSAKNIQYF	TRBV12-4	TRBJ2-4
TGTGCCACCAGTGATTTGCCGCCCGGGGACTTC	CATSDLPPGDF	TRBV24-1	TRBJ2-7
TGCGCCAACGTAGGGGGGAGAAGTTGCTACGAGCAGTACTTC	CANVGGRSCYEQYF	TRBV10-2	TRBJ2-7
TGTGCCAGCAGCGTTCCGGGACGGGCTGGAAACACCATATATTTT	CASSVPGRAGNTIYF	TRBV11-2	TRBJ1-3
TGTGCCATCAGTGAGTCCGGTTCGTACAATGAGCAGTTCTTC	CAISESGSYNEQFF	TRBV10-3	TRBJ2-1
TGCAGTGACGACAGGGAAACTATTTCCAATTCACCCCTCCACTTT	CSDDRETISNSPLHF	TRBV20-1	TRBJ1-6
TGCAGCGTTCCGGGACATCATTCACCCCTCCACTTT	CSVPGHHSPLHF	TRBV29-1	TRBJ1-6
TGTGCCTCCCCACGGAAGGGCGATTACGAGCAGTACTTC	CASPRKGDYEQYF	TRBV30	TRBJ2-7
TGTGCCAGCAGCTTAATCCGGTATCAGGGGGGGGCCTACGAGCAGTACTTC	CASSLIRYQGGAYEQYF	TRBV7-2	TRBJ2-7
TGCAGTACTGACAGGCCCCAGCATTTT	CSTDRPQHF	TRBV20-1	TRBJ1-5
TGTGCCAGCAGCCTGGGGAAGGGGGCTGGGGCCAACGTCCTGACTTTC	CASSLGKGAGANVLTF	TRBV27	TRBJ2-6
TGTGCCATCAGTCGAACAGGGAGACCCCTCCACTTT	CAISRTGRPLHF	TRBV10-3	TRBJ1-6
TGTGCCAGCAGGAGAATGGATACCTCCCCGGGCGAGGCAACTAATGAAAAACTGTTTTTT	CASRRMDTSPGEATNEKLFF	TRBV11-2	TRBJ1-4
TGCGCCAGCGGCTCGGTGGAGAGCTCCTACGAGCAGTACTTC	CASGSVESSYEQYF	TRBV5-1	TRBJ2-7
TGTGCCAGCAGCTGTGGGACTAGCGGGAGGGCCCGTCATTATGAGCCTGAAAAACTGTTTTTT	CASSCGTSGRARHYEPEKLFF	TRBV5-8	TRBJ1-4
TGTGCCAGCAGCAGCGTGACTAGCTCGCCTAGCTCCTACAATGAGCAGTTCTTC	CASSSVTSSPSSYNEQFF	TRBV11-3	TRBJ2-1
TGCAGTGCTAGATCCGAGACCTACCGGAATCAGCCCCAGCATTTT	CSARSETYRNQPQHF	TRBV20-1	TRBJ1-5
TGTGCTGGGCGTACTGAAGCTTTCTTT	CAGRTEAFF	TRBV12-5	TRBJ1-1
TGTGCCAGCAGTGACTCTGGCCGGACTAGCGGGTCCCATGAGCAGTTCTTC	CASSDSGRTSGSHEQFF	TRBV6-4	TRBJ2-1
TGTGCCAGCAGCCCTAACCAGGCCCGCACAGATACGCAGTATTTT	CASSPNQARTDTQYF	TRBV9	TRBJ2-3
TGTGCCAGGGACAGGTGGGCGGGACAGGGTCTTACTATTAGCAATCAGCCCCAGCATTTT	CARDRWAGQGLTISNQPQHF	TRBV6-5	TRBJ1-5
TGTGCCAGCAGCAACCGCAAGAACACCGGGGAGCTGTTTTTT	CASSNRKNTGELFF	TRBV6-3	TRBJ2-2
TGTGCCAGCAAGAGCGGGAGGCAACCTGAGGGGTACTTC	CASKSGRQPEGYF	TRBV27	TRBJ2-5
TGTGCCAGCGGACTAGCGCCCTGGGTGTCTACGGTAGTCACAGATACGCAGTATTTT	CASGLAPWVSTVVTDTQYF	TRBV6-1	TRBJ2-3
TGTGCCAGCAGCGGAAGGGGGGGGGCCCAGTACTTC	CASSGRGGAQYF	TRBV7-8	TRBJ2-5
TGTGCCATCAGTGAGCCGGGGGGGACAGTTTATAGCAATCAGCCCCAGCATTTT	CAISEPGGTVYSNQPQHF	TRBV10-3	TRBJ1-5
TGCGCCAGCAGCTTGGGTGGGCCCGCGGCCGAGCAGTACTTC	CASSLGGPAAEQYF	TRBV5-1	TRBJ2-7
TGTGCCAGCAGTTTATCAGATCACTACGCTGAAGCTTTCTTT	CASSLSDHYAEAFF	TRBV27	TRBJ1-1
TGCAGTGCTAGCGAAGAAGCTCGGGACAGGGGCAATCAGCCCCAGCATTTT	CSASEEARDRGNQPQHF	TRBV20-1	TRBJ1-5
TGTGCCAGCAGCTCCCTGGGGCAGGACTACGAGCAGTACTTC	CASSSLGQDYEQYF	TRBV11-2	TRBJ2-7
TGTGCCAGCAGCTTATGGGCTCCGGGGTCGGACAGGGATCAGCCCCAGCATTTT	CASSLWAPGSDRDQPQHF	TRBV11-1	TRBJ1-5
TGTGCCAGGGGAGCAGAAGGACTGGCCTACAATGAGCAGTTCTTC	CARGAEGLAYNEQFF	TRBV18	TRBJ2-1
TGTGCCAGCAGTGCCTCTAGAGCGGGAGTGAAAGAGCCTTCACCCCTCCACTTT	CASSASRAGVKEPSPLHF	TRBV6-1	TRBJ1-6
TGTGCCAGCAAACGGGGGGGGGGTATAGGATACGCGAACACCGGGGAGCTGTTTTTT	CASKRGGGIGYANTGELFF	TRBV6-3	TRBJ2-2
TGTGCCAGCAGTGTAGCGTGTCCTAGCACAGATACGCAGTATTTT	CASSVACPSTDTQYF	TRBV6-1	TRBJ2-3
TGTGCCACCAGTGCCCCTAAAGGGAAACCTGAGCAGTTCTTC	CATSAPKGKPEQFF	TRBV24-1	TRBJ2-1
TGCGCCAGCAGTGATGGGGGAGGGGAACCAGAAAAACTGTTTTTT	CASSDGGGEPEKLFF	TRBV10-1	TRBJ1-4
TGTGCCAGCAGCCCAGCCAGATGTCTCTATGGCTACACCTTC	CASSPARCLYGYTF	TRBV5-6	TRBJ1-2
TGCGCCAGCAATCAGGGTGAAAAACTGTTTTTT	CASNQGEKLFF	TRBV5-1	TRBJ1-4
TGTGCCAGCAGCGTAGAAGAGGGACCAGAGACCCAGTACTTC	CASSVEEGPETQYF	TRBV9	TRBJ2-5
TGTGCCAGCTCACCACGAGCAGGGATTCAGCCCCAGCATTTT	CASSPRAGIQPQHF	TRBV18	TRBJ1-5
TGTGCCAGCAGTTACGGTCTCCAGAGAAGCTCTGGAAACACCATATATTTT	CASSYGLQRSSGNTIYF	TRBV6-5	TRBJ1-3
TGTGCCAGCAGCGGGCTTTTCAGGGTCGACGAGCAGTACTTC	CASSGLFRVDEQYF	TRBV9	TRBJ2-7
TGCGCCAGCAGCCAAGCGCCACGGGGAGTTTGCAATTGGAGACGAGACTTC	CASSQAPRGVCNWRRDF	TRBV4-1	TRBJ2-7
TGTGCCAGCAGCTTTGACAGGAGAAATGAAAAACTGTTTTTT	CASSFDRRNEKLFF	TRBV9	TRBJ1-4
TGTGCCAGCAGCGTAGAACACAGGGGAGACTTC	CASSVEHRGDF	TRBV9	TRBJ2-7
TGTGCCAGCAGTGACCTAAGCCTGGACTACAGGGTGAACACTGAAGCTTTCTTT	CASSDLSLDYRVNTEAFF	TRBV6-1	TRBJ1-1
TGTGCCAGCACGGCAAGGAGGGAGACCCAGTACTTC	CASTARRETQYF	TRBV6-4	TRBJ2-5
TGTGCCAGTAGTATTAGAAGGGAAACGCAGCGAGCTTTCTTT	CASSIRRETQRAFF	TRBV19	TRBJ1-1
TGTGGTATCCGGGACATAGGCACAGATACGCAGTATTTT	CGIRDIGTDTQYF	TRBV5-4	TRBJ2-3
TGTGCCAGCAGGGGGATACGCCAGGGGTTGAACGAGCAGTACTTC	CASRGIRQGLNEQYF	TRBV6-2	TRBJ2-7
TGTGCCATCACGGAGGGCGACGTGGACTCCTACGAGCAGTACTTC	CAITEGDVDSYEQYF	TRBV10-3	TRBJ2-7
TGTGCCAGCAGCAGCCCATTGGGGGCTAGCAATGAGCAGTTCTTC	CASSSPLGASNEQFF	TRBV5-4	TRBJ2-1
TGTGCCAGCAGTATCCCCCCCCGGGGGGTCAGCTACAATGAGCAGTTCTTC	CASSIPPRGVSYNEQFF	TRBV6-3	TRBJ2-1
TGTGCCAGCAGCGGGGGGGCTCCTTTCTACGAGCAGTACTTC	CASSGGAPFYEQYF	TRBV13	TRBJ2-7
TGTGCCAGCAGCTTGGGTCCGGGGGCGGGTGTTCGGTTGAGGTGTTGCTCCTACGAGCAGTACTTC	CASSLGPGAGVRLRCCSYEQYF	TRBV5-4	TRBJ2-7
TGTGCCTGGAGTGAACCAAATTTTAAGGGACTAGCGGCAGATACGCAGTATTTT	CAWSEPNFKGLAADTQYF	TRBV30	TRBJ2-3
TGTGCCAGCACAGGGGGACTAGACACCATATATTTT	CASTGGLDTIYF	TRBV6-4	TRBJ1-3
TGTGCCCCGCAGGGCGACCAAGAGACCCAGTACTTC	CAPQGDQETQYF	TRBV15	TRBJ2-5
TGCGCCAGCAGCCAAGAAGGCGGGAGGGAGGAAAGCTCCTACAATGAGCAGTTCTTC	CASSQEGGREESSYNEQFF	TRBV4-1	TRBJ2-1
TGTGCCAGCAGTGGTATCCTCTGTGTTAGCTCCTACGAGCAGTACTTC	CASSGILCVSSYEQYF	TRBV6-5	TRBJ2-7
TGTGCCAGCAGCCAAGATCCGGGACAGCACATTGAATCAAACACTGAAGCTTTCTTT	CASSQDPGQHIESNTEAFF	TRBV3-1	TRBJ1-1
TGCAGTGCTAGTATTGGGAGCTCTGGAAACACCATATATTTT	CSASIGSSGNTIYF	TRBV20-1	TRBJ1-3
TGTGCCAGCAGCTTGGCTCCTAGCGGGCGAGAGACCCAGTACTTC	CASSLAPSGRETQYF	TRBV5-6	TRBJ2-5
TGTGCCACCAGACTGACGGGCGGCGATAATTCACCCCTCCACTTT	CATRLTGGDNSPLHF	TRBV24-1	TRBJ1-6
TGTGCCAGCAATCCCGTACTGAAATGTTACTTC	CASNPVLKCYF	TRBV14	TRBJ2-5
TGTGCCAGCAGTGGAGTTGCACCAGGGGGGGCTGAGCAGTTCTTC	CASSGVAPGGAEQFF	TRBV6-5	TRBJ2-1
TGCGCCAGCAGCCTCTCGGGGGCTTGTGGAAACACCATATATTTT	CASSLSGACGNTIYF	TRBV5-1	TRBJ1-3
TGCGCCAGCAGCCTCCATCCAATGACAGACGAGCAGTACTTC	CASSLHPMTDEQYF	TRBV4-3	TRBJ2-7
TGTGCCAGCAGTCGTACGGGGGGGGGGTATCAGCCCCAGCATTTT	CASSRTGGGYQPQHF	TRBV6-1	TRBJ1-5
TGTGCCAGCAGTTTAGCGCGAGGGGGCCTGAAGACCCGCATTAGCAATCAGCCCCAGCATTTT	CASSLARGGLKTRISNQPQHF	TRBV28	TRBJ1-5
TGTGCCAGCTCACAGCACAGAAAGAGCTCCTATAATTCACCCCTCCACTTT	CASSQHRKSSYNSPLHF	TRBV18	TRBJ1-6
TGCGCCAGCAGCACAGGGGTTGCTAGAAGGACAGGCTACACCTTC	CASSTGVARRTGYTF	TRBV5-1	TRBJ1-2
TGCAGTGCTTTCACAGGACTTTCGGGGGAGCTGTTTTTT	CSAFTGLSGELFF	TRBV20-1	TRBJ2-2
TGTGCCAGCAGCTTAGGTATTCGGAGGACAGGCTACGAGCAGTACTTC	CASSLGIRRTGYEQYF	TRBV7-8	TRBJ2-7
TGTGCCAGCAGTTTATCAACTAATCGAGCACCCTATGGCTACACCTTC	CASSLSTNRAPYGYTF	TRBV12-4	TRBJ1-2
TGTGCCATTCTCGGCTCTGGGGCCAACGTCCTGACTTTC	CAILGSGANVLTF	TRBV10-3	TRBJ2-6
TGTGCCAGCAGCAAGGGTACCCCGGACAGGAGATATCAGCCCCAGCATTTT	CASSKGTPDRRYQPQHF	TRBV7-9	TRBJ1-5
TGTGCCAGCACCCAGAGTAGAATCACAGATACGCAGTATTTT	CASTQSRITDTQYF	TRBV5-4	TRBJ2-3
TGTGCCAGCAGCTTAGAAAGACGCGCGCGGCGGGACGAGCAGTACTTC	CASSLERRARRDEQYF	TRBV7-9	TRBJ2-7
TGCGCCAGCAGTGAGATTAAGCCCCTCGAACATAGCAATCAGCCCCAGCATTTT	CASSEIKPLEHSNQPQHF	TRBV10-2	TRBJ1-5
TGCGCCAGCATGGCCAACAGGGTAAACACCATATATTTT	CASMANRVNTIYF	TRBV10-2	TRBJ1-3
TGCGCCAGCAGCCAAGAAATCGGGAGGGTCGCTTCGCAGTACTTC	CASSQEIGRVASQYF	TRBV4-1	TRBJ2-5
TGCGCCAGCAGCTTGGAGACGACAGGGCATCAGCCCCAGCATTTT	CASSLETTGHQPQHF	TRBV5-1	TRBJ1-5
TGTGCCAGCAGCTTTCCTACAGGGGGCCCCTATGCACCCGGGGAGCTGTTTTTT	CASSFPTGGPYAPGELFF	TRBV7-2	TRBJ2-2
TGCAGTGCTAGAGATCCCCCGGAGGGCAAGCCCGATACGCAGTATTTT	CSARDPPEGKPDTQYF	TRBV20-1	TRBJ2-3
TGTGCCAGCAGTTCTGGGGATGATCAGCCCCAGCATTTT	CASSSGDDQPQHF	TRBV27	TRBJ1-5
TGTGCCAGCAGGACAGGGGGTGAAAAACTGTTTTTT	CASRTGGEKLFF	TRBV7-8	TRBJ1-4
TGCAGTGAGGGGGGGGGGGGACCGCAGTTCTTC	CSEGGGGPQFF	TRBV20-1	TRBJ2-1
TGTGCTAGTGGTGTTTTTCTAAGGGGGACAGGGGGACCTGCTGGGGCCAACGTCCTGACTTTC	CASGVFLRGTGGPAGANVLTF	TRBV12-5	TRBJ2-6
TGTGCCAGCAGTGACTCTAAGTCGACAGGGGAGAACACCGGGGAGCTGTTTTTT	CASSDSKSTGENTGELFF	TRBV6-4	TRBJ2-2
TGCAGTGCGCAAATAGATGAAAAACTGTTTTTT	CSAQIDEKLFF	TRBV20-1	TRBJ1-4
TGTGCCAGCACCCCGGCTAGCGGGGGGTACAATGAGCAGTTCTTC	CASTPASGGYNEQFF	TRBV12-3	TRBJ2-1
TGCGCCAGCAGCTTGGCCAGTACCGAATCGGTGCAAGAGACCCAGTACTTC	CASSLASTESVQETQYF	TRBV5-1	TRBJ2-5
TGCAGTGCTAGAGTCCCGTGGGAACTAGTTTTGAGCACAGATACGCAGTATTTT	CSARVPWELVLSTDTQYF	TRBV20-1	TRBJ2-3
TGTGCCAGCAGTTGTCCCGGTCAGGGGGGCTCCTATAATTCACCCCTCCACTTT	CASSCPGQGGSYNSPLHF	TRBV6-6	TRBJ1-6
TGTGCCAGCATTGATCAGACAGGGGTCACTGAAGCTTTCTTT	CASIDQTGVTEAFF	TRBV27	TRBJ1-1
TGTGCCAGCAGCTTGAGGGGACAGGGGGCGAATGAAAAACTGTTTTTT	CASSLRGQGANEKLFF	TRBV5-6	TRBJ1-4
TGCAGTGCCCCTAAGGTCCACCCGGCTTCGACGAGGTACGAGCAGTACTTC	CSAPKVHPASTRYEQYF	TRBV20-1	TRBJ2-7
TGTGCTAGTGGTTCCTTAGAAGGGGGCTCCAATGAAAAACTGTTTTTT	CASGSLEGGSNEKLFF	TRBV12-5	TRBJ1-4
TGTGCCACCTTCCGGACAGGGCGGAGCAATGAGCAGTTCTTC	CATFRTGRSNEQFF	TRBV24-1	TRBJ2-1
TGTGCCAGCAGCGAGGGGACAGATACGCAGTATTTT	CASSEGTDTQYF	TRBV9	TRBJ2-3
TGTGCCACCAGGGCCTTAGCGGGAGCGGTCAATGAGCAGTTCTTC	CATRALAGAVNEQFF	TRBV24-1	TRBJ2-1
TGCGCCAGCAGCCAAGATAGTACAGGGTTCAACACCATATATTTT	CASSQDSTGFNTIYF	TRBV4-1	TRBJ1-3
TGCGCCAGCAGCCAAGTCGGACAGGCTCGCGCCAAAAACATTCAGTACTTC	CASSQVGQARAKNIQYF	TRBV4-1	TRBJ2-4
TGTGCCAGCAGCTCGTCCGGGACAGTACATGAAAAACTGTTTTTT	CASSSSGTVHEKLFF	TRBV13	TRBJ1-4
TGTGCCAGCAGTTGCGGGCCAGGCAGCACAGATACGCAGTATTTT	CASSCGPGSTDTQYF	TRBV6-3	TRBJ2-3
TGTGCCAGCAGCTGGGGGCTATCTGAAGCTTTCTTT	CASSWGLSEAFF	TRBV7-3	TRBJ1-1
TGTGCCAGCAGCTCGCGGACAGGAGGGAGTAACTATGGCTACACCTTC	CASSSRTGGSNYGYTF	TRBV11-3	TRBJ1-2
TGTGCCAGCAGCGAGCAGGGGATTAATGAGCAGTTCTTC	CASSEQGINEQFF	TRBV27	TRBJ2-1
TGTGCCAGCAGCCCGGGAAACAATGAGCAGTTCTTC	CASSPGNNEQFF	TRBV7-2	TRBJ2-1
TGTGCTAGTGGTTGGGGCTTTGAGCAGTTCTTC	CASGWGFEQFF	TRBV12-5	TRBJ2-1
TGTGCCACCAGCAGCCTTCCCGGGGGGAGTAAGACCCAGTACTTC	CATSSLPGGSKTQYF	TRBV15	TRBJ2-5
TGTGCCAGCAGCGAGCTAGAAGTAAACACCATATATTTT	CASSELEVNTIYF	TRBV11-1	TRBJ1-3
TGTGCCAGCAGCGCCCAGGGGCATGGAAGGTTGGTTACCCAGCATTTT	CASSAQGHGRLVTQHF	TRBV9	TRBJ1-5
TGTGCCAGCAGCCCAGTATCCAGGGACAGTAGCCTAACCTACGAGCAGTACTTC	CASSPVSRDSSLTYEQYF	TRBV7-3	TRBJ2-7
TGTGCCAGCAGCCGGGACAGGCCAAAGACCCAGTACTTC	CASSRDRPKTQYF	TRBV7-9	TRBJ2-5
TGTGCCTGGAGTGTAGTAGCCGGGACAGGCACTGAAGCTTTCTTT	CAWSVVAGTGTEAFF	TRBV30	TRBJ1-1
TGTGCCAGCATGTCCCAGCTGTGCCTAATCTACGAGCAGTACTTC	CASMSQLCLIYEQYF	TRBV12-3	TRBJ2-7
TGTGCCAGCAGCTTAGCGCTTACAGACAGGGACGAGCAGTACTTC	CASSLALTDRDEQYF	TRBV7-9	TRBJ2-7
TGTGCCAGGCTCGCCGCCCCCGGGACTAGCGGAGACGAGCAGTACTTC	CARLAAPGTSGDEQYF	TRBV27	TRBJ2-7
TGTGCCAGCAGCTTAGACCGGACAGGGCCCACAGGGCTTAACAATGAGCAGTTCTTC	CASSLDRTGPTGLNNEQFF	TRBV7-4	TRBJ2-1
TGTGCCAGCCCCTTCGGGACAGCTGCCTATGGCTACACCTTC	CASPFGTAAYGYTF	TRBV6-5	TRBJ1-2
TGTGCCAGCAGTTGGAGGGGGGCTTATGGATACAATGAGCAGTTCTTC	CASSWRGAYGYNEQFF	TRBV6-3	TRBJ2-1
TGCGCCAGCAGCAAGTACGAACACACTGAAGCTTTCTTT	CASSKYEHTEAFF	TRBV5-1	TRBJ1-1
TGTGCTAGTGGTCAAACTTATAATGAGACAGGACCCGAGCAGTACTTC	CASGQTYNETGPEQYF	TRBV12-5	TRBJ2-7
TGCAGCGGAGTGGGACAGGGACTGTTTTTT	CSGVGQGLFF	TRBV29-1	TRBJ1-4
TGTGCCAGCGTTGCAATCGGGACAGACACTGAAGCTTTCTTT	CASVAIGTDTEAFF	TRBV25-1	TRBJ1-1
TGTGCCACATCACTAGCGGGAGATAATCAGCCCCAGCATTTT	CATSLAGDNQPQHF	TRBV15	TRBJ1-5
TGTGCCAGCAGCTTCCGGGGCCATAGGAGGTACAATGAGCAGTTCTTC	CASSFRGHRRYNEQFF	TRBV5-4	TRBJ2-1
TGTGCCACCAGCAGAGCATCTCCTCGTAGGTCACAGCGGGATTCCTACAATGAGCAGTTCTTC	CATSRASPRRSQRDSYNEQFF	TRBV15	TRBJ2-1
TGTGCCAGCAGGGGCACCCCCCTATGCAGGTATAGCAATCAGCCCCAGCATTTT	CASRGTPLCRYSNQPQHF	TRBV12-4	TRBJ1-5
TGTGCCGTGGAGTCCTACGAGCAGTACTTC	CAVESYEQYF	TRBV9	TRBJ2-7
TGTGCCAGCAGCTTGGGAGAACGGACAGCCCGTGGGGGCACAGATACGCAGTATTTT	CASSLGERTARGGTDTQYF	TRBV5-4	TRBJ2-3
