TGTGCCAGCAGCTTAGGGGCAATCTACGAGCAGTACTTC	CASSLGAIYEQYF	TRBV11-3	TRBJ2-7
TGTGCCAGCACCGCAAGGTGGGACAGGGTTTGTAATGGCTACACCTTC	CASTARWDRVCNGYTF	TRBV7-9	TRBJ1-2
TGTGCCAGCAGTGCATGGGGGCATAGTGCAACTAATGAAAAACTGTTTTTT	CASSAWGHSATNEKLFF	TRBV6-4	TRBJ1-4
TGTGCCACCTGTGTACTAGCGGGGGGCCGGAACACCGGGGAGCTGTTTTTT	CATCVLAGGRNTGELFF	TRBV24-1	TRBJ2-2
TGCGCCAGCAGCTTATCCTACGGGTGGGGAAACACCATATATTTT	CASSLSYGWGNTIYF	TRBV5-1	TRBJ1-3
TGTGCCAGTCCGGACAGGGTAGCCAAAAACATTCAGTACTTC	CASPDRVAKNIQYF	TRBV12-3	TRBJ2-4
TGTGCCAGCAGCTCCGAGGGAGTGACGGGGGGGGTAGGGGAGCAGTTCTTC	CASSSEGVTGGVGEQFF	TRBV7-4	TRBJ2-1
TGTGCCAGCAGCCAAGAGTCCGCTACTGAAAAACTGTTTTTT	CASSQESATEKLFF	TRBV14	TRBJ1-4
TGTGCCAGCAGCTTTGGGGGGCGCGATAGCAATCAGCCCCAGCATTTT	CASSFGGRDSNQPQHF	TRBV5-6	TRBJ1-5
TGTGCTAGCAGCTTAAGACCTGGACTTGGGGGAAACACCATATATTTT	CASSLRPGLGGNTIYF	TRBV7-7	TRBJ1-3
TGTGCCAGCAGCGATCCAAGGGGACTAGCGGGATCTATCCAAATGGCCTACGAGCAGTACTTC	CASSDPRGLAGSIQMAYEQYF	TRBV13	TRBJ2-7
TGTGCCAGCAGCGTAGGACAGGGAAGATGGGCTGGGGCCAACGTCCTGACTTTC	CASSVGQGRWAGANVLTF	TRBV5-4	TRBJ2-6
TGTGCCAGCAGCTCGGGGGCCGCAGGACTAGCGGGATTTGGGAACACAGATACGCAGTATTTT	CASSSGAAGLAGFGNTDTQYF	TRBV11-2	TRBJ2-3
TGTGCCAGCAGTTACACTGGAGGGGCGTTCTCTGGAAACACCATATATTTT	CASSYTGGAFSGNTIYF	TRBV6-2	TRBJ1-3
TGTGCCAGCAGCGAGGGACAGTTCGCGGGAACTGAAGCTTTCTTT	CASSEGQFAGTEAFF	TRBV5-6	TRBJ1-1
TGTGCCAGCAGCAGTCTCAGGGGATTGGGAAGCCTGGTTCGAAAGCACTATGGCTACACCTTC	CASSSLRGLGSLVRKHYGYTF	TRBV13	TRBJ1-2
TGCGCCACGGGGCCGGGACTAGGCGAACTCGAGCAGTACTTC	CATGPGLGELEQYF	TRBV5-1	TRBJ2-7
TGTGCCAGCAGCTTTGCCCTTAGGTACAGCGTATACGAGCAGTACTTC	CASSFALRYSVYEQYF	TRBV11-3	TRBJ2-7
TGTGCCAGCAGCCTTAGAGGTGGAACGGATGAAAAACTGTTTTTT	CASSLRGGTDEKLFF	TRBV7-3	TRBJ1-4
TGTGCCAGCAGTACTAGGGCACGTGAGCAGTTCTTC	CASSTRAREQFF	TRBV27	TRBJ2-1
TGTGCCAGCAGTGATCCCCCCACAGGGACGGACAATCAGCCCCAGCATTTT	CASSDPPTGTDNQPQHF	TRBV2	TRBJ1-5
TGTGCCAGCAGGACTAGCGGGGTCGAGCAGTACTTC	CASRTSGVEQYF	TRBV27	TRBJ2-7
TGTGCCATCACGGAGAGGACTAGCGGGCCTTCGGTCGGCACAGATACGCAGTATTTT	CAITERTSGPSVGTDTQYF	TRBV10-3	TRBJ2-3
TGTGCCAGCAGCCTCGGACAGGGGGGGAGTTCCAAAAACATTCAGTACTTC	CASSLGQGGSSKNIQYF	TRBV13	TRBJ2-4
TGTGCCAGCAGTGCGTGCCCGGGACAGGAATACGAGCAGTACTTC	CASSACPGQEYEQYF	TRBV12-4	TRBJ2-7
TGTGCCAAGGTGCAGGGAGCTGAAGCTTTCTTT	CAKVQGAEAFF	TRBV6-4	TRBJ1-1
TGTGCCAGCAGTTACTGGTCCCCCCTCAGGGGGAGGAACACTGAAGCTTTCTTT	CASSYWSPLRGRNTEAFF	TRBV6-2	TRBJ1-1
TGTGCCAGCAGTGACGTGGACGGAGGCACAGATACGCAGTATTTT	CASSDVDGGTDTQYF	TRBV6-4	TRBJ2-3
TGCAGTGTGGAGACTTGTTGGTCGTTAGGCTACACCTTC	CSVETCWSLGYTF	TRBV20-1	TRBJ1-2
TGCGCCAGCAGCGGGACCACAGGGGGCCCGGAGGATTGCTATGGCTACACCTTC	CASSGTTGGPEDCYGYTF	TRBV5-1	TRBJ1-2
TGCGCCAGCAGCTCGGGCGATGGGCCCAGTTACTCCTACAATGAGCAGTTCTTC	CASSSGDGPSYSYNEQFF	TRBV5-1	TRBJ2-1
TGTGCCAGCTCACCCTGGGGGGTCCGCCTCAGCGAGCAGTACTTC	CASSPWGVRLSEQYF	TRBV18	TRBJ2-7
TGTGCCGCTAGCTATGGCTACACCTTC	CAASYGYTF	TRBV6-5	TRBJ1-2
TGCGCCAGCCCGCGAAGCAATGAGCAGTTCTTC	CASPRSNEQFF	TRBV10-2	TRBJ2-1
TGCGCCAGCAGCCGGTCCGGGACAGCCCACATTCAGTACTTC	CASSRSGTAHIQYF	TRBV4-3	TRBJ2-4
TGTGCCAGCAGCGTTAGGACTCGAAACAATGAGCAGTTCTTC	CASSVRTRNNEQFF	TRBV13	TRBJ2-1
TGTGCCAGCAGCTACGCGGCAAGCGAGCAGTACTTC	CASSYAASEQYF	TRBV5-6	TRBJ2-7
TGTGCCATCAGTGTCCCCGGACAGGGGCTCCGGCCCCAGCATTTT	CAISVPGQGLRPQHF	TRBV10-3	TRBJ1-5
TGTGCCAGCACCTCAGGACGTTTGACCTACGAGCAGTACTTC	CASTSGRLTYEQYF	TRBV27	TRBJ2-7
TGTGCCAGCAGCTTTGGGGTCAGGACGGACGAGCAGTACTTC	CASSFGVRTDEQYF	TRBV7-9	TRBJ2-7
TGTGCCAGAGTGGGGGACTCGTACGAGCAGTACTTC	CARVGDSYEQYF	TRBV7-9	TRBJ2-7
TGCTCCCTCCCCACGGGACATGAAAAACTGTTTTTT	CSLPTGHEKLFF	TRBV20-1	TRBJ1-4
TGTGCCAGCAGCGACCGGGGGCGGACGTCTGAAGCTTTCTTT	CASSDRGRTSEAFF	TRBV9	TRBJ1-1
TGTGCCAGCAGTTTGCAGGGACGTCTAGCTGACTACGAGCAGTACTTC	CASSLQGRLADYEQYF	TRBV28	TRBJ2-7
TGTGCCATCGTCCTGGGCGGGCCTGGCTACACCTTC	CAIVLGGPGYTF	TRBV10-3	TRBJ1-2
TGTGCCAGCAGCATAGCGGGGGAAAAACTGTTTTTT	CASSIAGEKLFF	TRBV27	TRBJ1-4
TGTGCCAGCAGCTGCTCAGCATACACCTTC	CASSCSAYTF	TRBV7-2	TRBJ1-2
TGTGCCAGCAGCTTAGGCTGTTCCTCCGGACAGGGCGCCTACGAGCAGTACTTC	CASSLGCSSGQGAYEQYF	TRBV7-9	TRBJ2-7
TGTGCCACCAGTGATTTTGGGGATACAGGGGGCTACAATGAGCAGTTCTTC	CATSDFGDTGGYNEQFF	TRBV24-1	TRBJ2-1
TGTGCCAGCAGCATCCGGACACGGCCTGAAGCTTTCTTT	CASSIRTRPEAFF	TRBV7-3	TRBJ1-1
TGTGCCAGCCCCGGACTAGCGGGACGGGCGTGCGTTCCCTACGAGCAGTACTTC	CASPGLAGRACVPYEQYF	TRBV7-9	TRBJ2-7
TGCGCCAGCAGCTCCCGGCAGGGGCTGCCGGTCGAGCAGTACTTC	CASSSRQGLPVEQYF	TRBV5-1	TRBJ2-7
TGCAGTGCTGCTATATCAGGGTGTGTTTCGAGAATGAACACTGAAGCTTTCTTT	CSAAISGCVSRMNTEAFF	TRBV20-1	TRBJ1-1
TGTGCCAGCACCAACGTGACAGGGGGTAAAGAGACCCAGTACTTC	CASTNVTGGKETQYF	TRBV7-9	TRBJ2-5
TGTGCCAGCAGTGCAGTCATGGCGCCGGTCCAAGAGACCCAGTACTTC	CASSAVMAPVQETQYF	TRBV6-4	TRBJ2-5
TGTGCCACCAGTGATAGGGGGGAGGACTACAATGAGCAGTTCTTC	CATSDRGEDYNEQFF	TRBV24-1	TRBJ2-1
TGTGCTAGTGGTTTGGTTCGGGGGGTATACGAGCAGTACTTC	CASGLVRGVYEQYF	TRBV12-5	TRBJ2-7
TGTGCCAGCAGCTTGCCCGGTACCGGGGGCACTGCCTACGAGCAGTACTTC	CASSLPGTGGTAYEQYF	TRBV5-5	TRBJ2-7
TGTGCCAGCAGGCCATTAATGTACACAGATACGCAGTATTTT	CASRPLMYTDTQYF	TRBV5-6	TRBJ2-3
TGTGCCAGCAGCTTTCACGACGGAAAGGGAGGCTGCGAGCAGTACTTC	CASSFHDGKGGCEQYF	TRBV9	TRBJ2-7
TGTGCCAGCAGCGACCCGCAGGGTTCTGGGGCTACTGAAGCTTTCTTT	CASSDPQGSGATEAFF	TRBV7-7	TRBJ1-1
TGTGCCAGCAGCCCCCACAGGGGGCACTACTATCAGCCCCAGCATTTT	CASSPHRGHYYQPQHF	TRBV9	TRBJ1-5
TGTGCCAGCAGCTTTCATAGACAGGGGCGGACCCAGTACTTC	CASSFHRQGRTQYF	TRBV7-8	TRBJ2-5
TGTGCCAGCAGCTCCCCAACGGGAGGTGGCTCGTCCTACGAGCAGTACTTC	CASSSPTGGGSSYEQYF	TRBV13	TRBJ2-7
TGTGCCAGCAGCGTTTTACAGGGGTCTCACTCCTACGAGCAGTACTTC	CASSVLQGSHSYEQYF	TRBV9	TRBJ2-7
TGTGCCAGCAGGAGGACAAGGAGCTCCTACAATGAGCAGTTCTTC	CASRRTRSSYNEQFF	TRBV4-2	TRBJ2-1
TGCGCCAGCAGCCAAGACCGGGGGGGCCAGGAAGGCGCCCATCCAGATACGCAGTATTTT	CASSQDRGGQEGAHPDTQYF	TRBV4-3	TRBJ2-3
TGTGCCAGTAGTCCAGGGGAGGGGGAGGGGGGCTACCAAAGTAACTATGGCTACACCTTC	CASSPGEGEGGYQSNYGYTF	TRBV19	TRBJ1-2
TGCGCCAGCAGCCAAGCCCCCGGGGGCATGAAGGGGCGCGGCTACACCTTC	CASSQAPGGMKGRGYTF	TRBV4-1	TRBJ1-2
TGTGCCAGCAGCCACAGGGGGGACCCCCAGCATTTT	CASSHRGDPQHF	TRBV13	TRBJ1-5
TGTGCCAGCAGCTTATCACCCTGTGAGAAAGGAACCGGGGAGCTGTTTTTT	CASSLSPCEKGTGELFF	TRBV7-4	TRBJ2-2
TGTGCCAGCAGCGTGGACAGTAAGGAAAAACTGTTTTTT	CASSVDSKEKLFF	TRBV27	TRBJ1-4
TGTGCCAGCAGTTACAAGACCTACTATCGCCGGAACGGCTCCTACAATGAGCAGTTCTTC	CASSYKTYYRRNGSYNEQFF	TRBV6-5	TRBJ2-1
TGTGCCAGCAGCTCCATTCCATGCGGGAGACGAACAGATACGCAGTATTTT	CASSSIPCGRRTDTQYF	TRBV7-2	TRBJ2-3
TGTGCCAGCAGCATTGCACAGGGGGAAGACTATGGCTACACCTTC	CASSIAQGEDYGYTF	TRBV5-6	TRBJ1-2
TGCGCCAGCTGGATCGCGTCCGACCCAGATTATGGCGAGCAGTACTTC	CASWIASDPDYGEQYF	TRBV10-1	TRBJ2-7
TGTGCCAGCAGTTATTCCCGCCTCGGGACAGGGGCGTTGCTGTTTTTT	CASSYSRLGTGALLFF	TRBV27	TRBJ1-4
TGCGCCAGCAAACCCCCAGTTATGGAAGAGACCCAGTACTTC	CASKPPVMEETQYF	TRBV10-1	TRBJ2-5
TGTGCCAGTAGGACGAAGGAAGAGACCCAGTACTTC	CASRTKEETQYF	TRBV19	TRBJ2-5
TGTGCCACTGGGGACGCTTGGCCCAGCAATCAGCCCCAGCATTTT	CATGDAWPSNQPQHF	TRBV24-1	TRBJ1-5
TGTGCCAGCAGTTTCCCCGGGACAGGGCTAGAGAACACTGAAGCTTTCTTT	CASSFPGTGLENTEAFF	TRBV12-3	TRBJ1-1
TGTGCCAGACGGGACAGGCCGAACACTGAAGCTTTCTTT	CARRDRPNTEAFF	TRBV10-3	TRBJ1-1
TGTGCCAGCAGCCAAGTGCAGCGGGAGAACACTGAAGCTTTCTTT	CASSQVQRENTEAFF	TRBV14	TRBJ1-1
TGTGCCAGCAGGGGATCGAGACAGGGGAGGCAGTACTTC	CASRGSRQGRQYF	TRBV9	TRBJ2-7
TGTGCCAGCAGCACCGGGGGGGCCAACACCGGGGAGCTGTTTTTT	CASSTGGANTGELFF	TRBV12-3	TRBJ2-2
TGTGCCTGGAGTAATAATAACAAAAATAATTCACCCCTCCACTTT	CAWSNNNKNNSPLHF	TRBV30	TRBJ1-6
TGTGCCAGCAGTGTCCAGGGTATGTACAATGAGCAGTTCTTC	CASSVQGMYNEQFF	TRBV6-1	TRBJ2-1
TGTGCCAGCAGCTCGCTAGGTGGTGAGTACTTC	CASSSLGGEYF	TRBV5-6	TRBJ2-7
TGTGCCAGCAGTTTATTCCCGACAGGGGACAATCAGCCCCAGCATTTT	CASSLFPTGDNQPQHF	TRBV27	TRBJ1-5
TGTGCCAGCAGCGTAGTAACACAGGGCGGAGAGACCCAGTACTTC	CASSVVTQGGETQYF	TRBV9	TRBJ2-5
TGTGCCAGCAGCTTGGCTATAGTGCGACAGGTGAACACTGAAGCTTTCTTT	CASSLAIVRQVNTEAFF	TRBV5-5	TRBJ1-1
TGTGCCAGCAGCGTCCGGGTCAGTGCCGCCTACGAGCAGTACTTC	CASSVRVSAAYEQYF	TRBV9	TRBJ2-7
TGCGCCAGCAGGGGTGACAGAAATGAAAAACTGTTTTTT	CASRGDRNEKLFF	TRBV5-1	TRBJ1-4
TGCGCCAGCAGTGGGCGGCTGTCCAATCAGCCCCAGCATTTT	CASSGRLSNQPQHF	TRBV10-1	TRBJ1-5
TGCAGTGCTAGCCTGACAGGGGCGGCCGAGTGCTCCTACGAGCAGTACTTC	CSASLTGAAECSYEQYF	TRBV20-1	TRBJ2-7
TGTGCCAGCTTTATCACCAGGAGGACTGAAGCTTTCTTT	CASFITRRTEAFF	TRBV7-3	TRBJ1-1
TGTGCCAGCAGCCCCCTCACAGGGGGGTCGACCCAAGCCGAGCAGTACTTC	CASSPLTGGSTQAEQYF	TRBV7-9	TRBJ2-7
TGCAGTGCTATCCATGGACAGGTTACTGGGGCCAACGTCCTGACTTTC	CSAIHGQVTGANVLTF	TRBV20-1	TRBJ2-6
TGTGCGGAGCGAAATACGCAGTATTTT	CAERNTQYF	TRBV5-4	TRBJ2-3
TGTGCCAGCATAGGGGGAAGGTACGAGCAGTACTTC	CASIGGRYEQYF	TRBV7-3	TRBJ2-7
TGTGCCACAAGCGGGAGGGTGCAGTACTTC	CATSGRVQYF	TRBV24-1	TRBJ2-7
TGTGCCAGCAGTTCACCGCTAGGGGGGGGGGCAGCGAACACCGGGGAGCTGTTTTTT	CASSSPLGGGAANTGELFF	TRBV28	TRBJ2-2
TGTGCCAGCAGCCCCCTCGCTATTCGGATACCCTATACTAACTATGGCTACACCTTC	CASSPLAIRIPYTNYGYTF	TRBV14	TRBJ1-2
TGTGCCAGCTCCGGGACAGGAAATACTAATGAAAAACTGTTTTTT	CASSGTGNTNEKLFF	TRBV18	TRBJ1-4
TGTGCCAGCAACAGATGGCACCGGGACAGGAGGAACTATGGCTACACCTTC	CASNRWHRDRRNYGYTF	TRBV6-6	TRBJ1-2
TGCGCCAGCAGCAGGTCCAGGGAAGATACGCAGTATTTT	CASSRSREDTQYF	TRBV5-1	TRBJ2-3
TGTGCCAGCTCCCGGGATGTCCGAACTAATGAAAAACTGTTTTTT	CASSRDVRTNEKLFF	TRBV18	TRBJ1-4
TGTGCCAGCAGTGAATATATCCTGGGACAGTGGGCGGGAAATCAGCCCCAGCATTTT	CASSEYILGQWAGNQPQHF	TRBV25-1	TRBJ1-5
TGTGCCTGGAGTGTACAAACCGGGACAGCGTGGGTCCTGACTTTC	CAWSVQTGTAWVLTF	TRBV30	TRBJ2-6
TGTGCCAGTATTGGGGGGCGCTACGAGCAGTACTTC	CASIGGRYEQYF	TRBV19	TRBJ2-7
TGCAGCGTTGCGGGACAGGATTTCAATCAGCCCCAGCATTTT	CSVAGQDFNQPQHF	TRBV29-1	TRBJ1-5
TGTGCCAGCAGTTCGCCGGGACTAGCGGGGGCAAGGGGAGGCACAGATACGCAGTATTTT	CASSSPGLAGARGGTDTQYF	TRBV6-5	TRBJ2-3
TGTGCCAGCAGCCAAGATTTTGGAGAAAGCACAGATACGCAGTATTTT	CASSQDFGESTDTQYF	TRBV4-2	TRBJ2-3
TGTGCCAGCAGCGTAGCGGGACAGGGACAACAGCCCCAGCATTTT	CASSVAGQGQQPQHF	TRBV9	TRBJ1-5
TGTGCCAGCAGCCACTTCGGGGCGTTTCACTATGGCTACACCTTC	CASSHFGAFHYGYTF	TRBV3-1	TRBJ1-2
TGTGCCTGGAGTGTATCGGGGAGGGGTGATACGCAGTATTTT	CAWSVSGRGDTQYF	TRBV30	TRBJ2-3
TGCAGCCCTTTCAATAAAGACAACGGCGACTATGGCTACACCTTC	CSPFNKDNGDYGYTF	TRBV29-1	TRBJ1-2
TGTGCCAGCAGGTTTACTAGCGGGAGTTCGGATCACACCGGGGAGCTGTTTTTT	CASRFTSGSSDHTGELFF	TRBV7-3	TRBJ2-2
TGTGCCAGCAGCGGACAGGGTAGCAATCAGCCCCAGCATTTT	CASSGQGSNQPQHF	TRBV13	TRBJ1-5
TGTGCCAGCAGCTTTTCAGGATATGAGCCCCAGCATTTT	CASSFSGYEPQHF	TRBV7-3	TRBJ1-5
TGTGCCAGCAGCTTCCGAGAATTAGCGGGGAAGTTGTTCACAGATACGCAGTATTTT	CASSFRELAGKLFTDTQYF	TRBV5-6	TRBJ2-3
TGCGCCAGCAGCTTGGGGGGGGCCGGGGAGCTGTTTTTT	CASSLGGAGELFF	TRBV5-1	TRBJ2-2
TGTGCCAGTAGTGGGGTCGGGGACAGGGAAAGCTCCTACGAGCAGTACTTC	CASSGVGDRESSYEQYF	TRBV19	TRBJ2-7
TGTGCCACCAGTGATGGGGAAAAGCAGCCCCAGCATTTT	CATSDGEKQPQHF	TRBV24-1	TRBJ1-5
TGCGCCAGCAGCCCGGGCTCCGCCACCTTC	CASSPGSATF	TRBV5-1	TRBJ1-2
TGTGCCAGCAGCCACAGTCAGCAGGAGGGAAACACCATATATTTT	CASSHSQQEGNTIYF	TRBV4-2	TRBJ1-3
TGTGCCAGCAGCCAAGGGACAGACACTTCTGGGGCCAACGTCCTGACTTTC	CASSQGTDTSGANVLTF	TRBV3-1	TRBJ2-6
TGTGCCAGCAGTGACCAGAAGCGGGATTGGGGGCACTACGAGCAGTACTTC	CASSDQKRDWGHYEQYF	TRBV6-4	TRBJ2-7
TGTGCCAGCAGCAACAGGGAAACCGTTAATTCACCCCTCCACTTT	CASSNRETVNSPLHF	TRBV7-9	TRBJ1-6
TGTGCCAGCATTGCGGGGTACAATGAGCAGTTCTTC	CASIAGYNEQFF	TRBV6-4	TRBJ2-1
TGTGCCAGCAGCTTAGGCACGGGAGGGATAAGGACAGATACGCAGTATTTT	CASSLGTGGIRTDTQYF	TRBV7-8	TRBJ2-3
TGTGCCAGCAGTGAGTACCGGGACAGGTTTAGCTTTATTTACGAGCAGTACTTC	CASSEYRDRFSFIYEQYF	TRBV6-4	TRBJ2-7
TGTGCCAGCAGCTTACGGGACTTGTCGACCGGGGAGCTGTTTTTT	CASSLRDLSTGELFF	TRBV7-3	TRBJ2-2
TGTGCCAGCAGTGAAGGTACAGGGGGCTCTGAAGCTTTCTTT	CASSEGTGGSEAFF	TRBV12-4	TRBJ1-1
TGTGCCAGCAGTTACTCGACAGGGGTGGGAGTTAGTGAAGCTTTCTTT	CASSYSTGVGVSEAFF	TRBV6-5	TRBJ1-1
TGTGCCAGTAGTGCCCCCGGGACTAGCGAGCAAGAGACCCAGTACTTC	CASSAPGTSEQETQYF	TRBV19	TRBJ2-5
TGTGCCAGCAGCGGACCGACAGGAGATCAGGCGCCACCGGTGAGCAATCAGCCCCAGCATTTT	CASSGPTGDQAPPVSNQPQHF	TRBV6-5	TRBJ1-5
TGTGCCAGCAGCATAGAGACTGAGCAGTTCTTC	CASSIETEQFF	TRBV2	TRBJ2-1
TGTGCCAGCAGTCCGACTAGCGGGGGAACAGATACGCAGTATTTT	CASSPTSGGTDTQYF	TRBV7-3	TRBJ2-3
TGTGCCAGCAGCTTCGATCCAGGGGGTATGAACACTGAAGCTTTCTTT	CASSFDPGGMNTEAFF	TRBV11-1	TRBJ1-1
TGTGCCAGCAGCTGTACGGGGGGGTCGAACGAGCAGTACTTC	CASSCTGGSNEQYF	TRBV11-3	TRBJ2-7
TGCGCCAGCAGTGAGGTACGGACCTCCGCGTGTCTTATTGAGCAGTTCTTC	CASSEVRTSACLIEQFF	TRBV10-1	TRBJ2-1
TGTGCCAGCAGCACCGGGAGACAGGGGGCGAGCTCCTACGAGCAGTACTTC	CASSTGRQGASSYEQYF	TRBV11-3	TRBJ2-7
TGTGCCAGCAGCGGAAAAACTGGCTTAGGAAACACCATATATTTT	CASSGKTGLGNTIYF	TRBV13	TRBJ1-3
TGTGCCAGCAGTTACGGTGGGACTAGCACAGATACGCAGTATTTT	CASSYGGTSTDTQYF	TRBV6-5	TRBJ2-3
TGTGCCAGCAGCTTAATAAGCTGCGTCCACTACGAGCAGTACTTC	CASSLISCVHYEQYF	TRBV7-9	TRBJ2-7
TGTGCCAGCAGCCAAGGGACAGGTTCGCATCAGCCCCAGCATTTT	CASSQGTGSHQPQHF	TRBV4-2	TRBJ1-5
TGTGCCAGCAGACAATCGGGGCCAGTAAAAAACTATGGCTACACCTTC	CASRQSGPVKNYGYTF	TRBV6-3	TRBJ1-2
TGTGCCGCGATCCGACAGGCCTCGACCTCTTCCTATAATTCACCCCTCCACTTT	CAAIRQASTSSYNSPLHF	TRBV10-3	TRBJ1-6
TGTGCCACAGGGACAGGGGTACACGAGCAGTACTTC	CATGTGVHEQYF	TRBV19	TRBJ2-7
TGTGCCAGCAGCATTCAACGGGAGGGCTACGAGCAGTACTTC	CASSIQREGYEQYF	TRBV11-2	TRBJ2-7
TGTGCCAGCAGCCCCGTCCCCGCGGGACTAGTCGGCTACGAGCAGTACTTC	CASSPVPAGLVGYEQYF	TRBV11-3	TRBJ2-7
TGTGCCACCAGTGATTTGTGTAGGGGTTACACTGAAGCTTTCTTT	CATSDLCRGYTEAFF	TRBV24-1	TRBJ1-1
TGTGCCAGCAGCGGTAAACGTAAGAATTCACCCCTCCACTTT	CASSGKRKNSPLHF	TRBV11-2	TRBJ1-6
TGTGCCAGTAGTATTGTTCCTTCAGGTGGACAGGGCAGCTTTGAAGCTTTCTTT	CASSIVPSGGQGSFEAFF	TRBV19	TRBJ1-1
TGCAGTGCTAGGTCTGCACCGACAGGGGAACACTGGAACACTGAAGCTTTCTTT	CSARSAPTGEHWNTEAFF	TRBV20-1	TRBJ1-1
TGTGCCGGAGACTGGACAGGGGAAGAAAAACTGTTTTTT	CAGDWTGEEKLFF	TRBV5-6	TRBJ1-4
TGTGCCAAATTGAGGGACAGTGCGAGGCAGGACGAGCAGTACTTC	CAKLRDSARQDEQYF	TRBV6-3	TRBJ2-7
TGTGCCAGCAGTGACTCCTCAATAGGCTACGAAGCGGGAGCCTTCGATACGCAGTATTTT	CASSDSSIGYEAGAFDTQYF	TRBV6-4	TRBJ2-3
TGTGCCACCAGTGAGTACGGGGGCGGGCAGAACACCGGGGAGCTGTTTTTT	CATSEYGGGQNTGELFF	TRBV24-1	TRBJ2-2
TGTGCCAGCAGCTCCCGGAAGGGACTAGGGTCCGACAATGAGCAGTTCTTC	CASSSRKGLGSDNEQFF	TRBV7-3	TRBJ2-1
TGTGCCAGGGACGGCTATGGCTACACCTTC	CARDGYGYTF	TRBV11-3	TRBJ1-2
TGTGCCAGCTTCCCGGGACTGGTCCCTAGGGTGAAGTACTTC	CASFPGLVPRVKYF	TRBV6-1	TRBJ2-7
TGTGCCAGCAGCACCCGGGTCTCCGACAGGGCCCGGGACAATGAGCAGTTCTTC	CASSTRVSDRARDNEQFF	TRBV13	TRBJ2-1
TGTGCCAGCTCACCAATAAGGACAGACAATGGCTACACCTTC	CASSPIRTDNGYTF	TRBV18	TRBJ1-2
TGCAGTGGGGTGGTCGGCAGGGGGAGCTCTAGCACAGATACGCAGTATTTT	CSGVVGRGSSSTDTQYF	TRBV20-1	TRBJ2-3
TGCGCCAGCAGCTCGGGGCTAGGCACGGATCAGCCCCAGCATTTT	CASSSGLGTDQPQHF	TRBV5-1	TRBJ1-5
TGTGCCAGCAGCGGGACTAGCGGGATCTCCTACGAGCAGTACTTC	CASSGTSGISYEQYF	TRBV7-4	TRBJ2-7
TGTGCCAGCATTGGTGGACGCGGGGATGGCTACACCTTC	CASIGGRGDGYTF	TRBV27	TRBJ1-2
TGCGCCAGCCGGAGGACAGGACGCAATCAGCCCCAGCATTTT	CASRRTGRNQPQHF	TRBV5-1	TRBJ1-5
TGTGCCAGCAGTTCATGGTCAGGGGGGTTCAATCAGCCCCAGCATTTT	CASSSWSGGFNQPQHF	TRBV28	TRBJ1-5
TGTGCCAGCAGGGTCGGAGATGACGAGCAGTACTTC	CASRVGDDEQYF	TRBV6-4	TRBJ2-7
TGCAGTGCTAGAGCCCGGGAGGGCCCTAACAATGAGCAGTTCTTC	CSARAREGPNNEQFF	TRBV20-1	TRBJ2-1
TGTGCCTGCAACCTAGCGGCGAATGTCATCGAGCAGTACTTC	CACNLAANVIEQYF	TRBV12-3	TRBJ2-7
TGTGCCAGCAGCTTAACGGCGGGCCCACTCTCACCCCTCCACTTT	CASSLTAGPLSPLHF	TRBV7-3	TRBJ1-6
TGTGCCACCAGTGATGACCTGGGCCATGATGGTGAAAAACTGTTTTTT	CATSDDLGHDGEKLFF	TRBV24-1	TRBJ1-4
TGTGCCAGCAGTGAAGCGTACAGGCCTACTAACACTGAAGCTTTCTTT	CASSEAYRPTNTEAFF	TRBV6-1	TRBJ1-1
TGTGCCTGGAGCCCGACAGAAAATCAGCCCCAGCATTTT	CAWSPTENQPQHF	TRBV30	TRBJ1-5
TGTGCCAGCAGCTTCTTGGACAGAAGTATTGGATTCTTT	CASSFLDRSIGFF	TRBV7-2	TRBJ1-1
TGTGCCAGCAGTGAAGCGGCACCGGGACGGAGCTCCTACAATGAGCAGTTCTTC	CASSEAAPGRSSYNEQFF	TRBV6-1	TRBJ2-1
TGTGCCAGCAGTTATACTGCGGGAGGATTCTACGAGCAGTACTTC	CASSYTAGGFYEQYF	TRBV6-3	TRBJ2-7
TGTGCCAGCAGAGACTATGATAGACAAGAGACCCAGTACTTC	CASRDYDRQETQYF	TRBV6-5	TRBJ2-5
TGCGCCAGCAGCTGTTGCGGGAGGGGGAGCTACAATGAGCAGTTCTTC	CASSCCGRGSYNEQFF	TRBV5-1	TRBJ2-1
TGTGCCAGCAGCGGAGGACAGGCCCCTAACTATGGCTACACCTTC	CASSGGQAPNYGYTF	TRBV9	TRBJ1-2
TGTGCCAGCAGCTTCGTTGTAGGCCGCTGGAGCTTTCTCGAGCAGTACTTC	CASSFVVGRWSFLEQYF	TRBV7-8	TRBJ2-7
TGTGCCACCAGCAGTGGACAGAGGGACTATGGCTACACCTTC	CATSSGQRDYGYTF	TRBV15	TRBJ1-2
TGTGCCAGCAGCAGGATGACAGGGAGGTGGAGAGGCTATGGCTACACCTTC	CASSRMTGRWRGYGYTF	TRBV13	TRBJ1-2
TGTGCCAGCAGTGAATGGGGGAGACAGGCCGAGCAGTACTTC	CASSEWGRQAEQYF	TRBV25-1	TRBJ2-7
TGTGCCAGAACGGGCCGGGATATAGCCAAAAACATTCAGTACTTC	CARTGRDIAKNIQYF	TRBV6-5	TRBJ2-4
TGTGCGAGTGGACTAGCGGAGAGCTACAATGAGCAGTTCTTC	CASGLAESYNEQFF	TRBV27	TRBJ2-1
TGCAGTGCTAGAGAAGCAAATCCCCGGCGGGAAGACTACACCTTC	CSAREANPRREDYTF	TRBV20-1	TRBJ1-2
TGTGCCAGCAGTGGGTACAAAGGGGGCGCTTTCTTT	CASSGYKGGAFF	TRBV6-5	TRBJ1-1
TGTGCCAGTAGACGGGCATTTAGGGCGCCCCAGCATTTT	CASRRAFRAPQHF	TRBV19	TRBJ1-5
TGTGCCAGCAGCTTACTAAGTCAGGTGGGGGAGTACAATGAGCAGTTCTTC	CASSLLSQVGEYNEQFF	TRBV11-3	TRBJ2-1
TGTGCCAGCACAGGGACGGTCAACCGGTACTTC	CASTGTVNRYF	TRBV12-3	TRBJ2-7
TGCGCCAGCAGCCAAGACCTAAGCGGGAGGGTCCCCTATAATTCACCCCTCCACTTT	CASSQDLSGRVPYNSPLHF	TRBV4-1	TRBJ1-6
TGTGCCAGCAGCTTCTTCCCTTCAGACGAGGGGGAATACGAGCAGTACTTC	CASSFFPSDEGEYEQYF	TRBV7-9	TRBJ2-7
TGTGCCAGCAGTTTCCTTGACAGGGTTTGTAGCTCCTACAATGAGCAGTTCTTC	CASSFLDRVCSSYNEQFF	TRBV12-3	TRBJ2-1
TGTGCCAGCAGGGGGGTAAGGGGCCGATACGAGCAGTACTTC	CASRGVRGRYEQYF	TRBV6-8	TRBJ2-7
TGTGCCAGCAGTAATAGCTATGGCTACACCTTC	CASSNSYGYTF	TRBV28	TRBJ1-2
TGTGCCTGGACTTATTATACCGGGGTCAATGAGCAGTTCTTC	CAWTYYTGVNEQFF	TRBV30	TRBJ2-1
TGTGCCAGCAGTGACAGTGGGGCACAAAACAGCACCGGGGAGCTGTTTTTT	CASSDSGAQNSTGELFF	TRBV6-4	TRBJ2-2
TGTGCCAGCAGTGATCTCGGCAGGGCAAGGGTCTCCGGGTACAGCAATCAGCCCCAGCATTTT	CASSDLGRARVSGYSNQPQHF	TRBV6-4	TRBJ1-5
TGTGCCAGCAGTGACAGGTCCCGGGACAGGCAGAACACTGAAGCTTTCTTT	CASSDRSRDRQNTEAFF	TRBV6-4	TRBJ1-1
TGTGCCACCGATGATGGGACTTGCACAGATACGCAGTATTTT	CATDDGTCTDTQYF	TRBV24-1	TRBJ2-3
TGTGCCAGCAGCCGTCGCGTTCCTGTCGGGTGCACAGATACGCAGTATTTT	CASSRRVPVGCTDTQYF	TRBV5-4	TRBJ2-3
TGTGCCAGCAGCTTAGATGACAGGGGGTCAGCCAAAAACATTCAGTACTTC	CASSLDDRGSAKNIQYF	TRBV11-2	TRBJ2-4
TGTGCCAGCAGCTTACTCCCGCGCGGGGCCCTTGGCTACACCTTC	CASSLLPRGALGYTF	TRBV11-3	TRBJ1-2
TGCGCCAGCAGCCAAGGGAGGGACAGGGGCTCTGGGGCCAACGTCCTGACTTTC	CASSQGRDRGSGANVLTF	TRBV4-1	TRBJ2-6
TGTGCCAGCTCACGAGCCCCTAACAGGGTGGTTGGAAACACCATATATTTT	CASSRAPNRVVGNTIYF	TRBV18	TRBJ1-3
TGTGCCACCAGTGAAAGCAGACAGGGGAGCTCCTACAATGAGCAGTTCTTC	CATSESRQGSSYNEQFF	TRBV24-1	TRBJ2-1
TGTGCCAGCAGTTGGCAAAAGGGGCCCTCCTACGAGCAGTACTTC	CASSWQKGPSYEQYF	TRBV27	TRBJ2-7
TGTGCCAGCAGCCACGGGACAGGGATTCTGAACACTGAAGCTTTCTTT	CASSHGTGILNTEAFF	TRBV9	TRBJ1-1
TGCAGTGCTAGAGATCAAAGGGGGGTCGGGGTAAATGAGCAGTTCTTC	CSARDQRGVGVNEQFF	TRBV20-1	TRBJ2-1
TGTGCCAGCACCCGAGGACAGAACACCGGGGAGCTGTTTTTT	CASTRGQNTGELFF	TRBV28	TRBJ2-2
TGTGCAGGACTAGCGGGAACTTACGAGCAGTACTTC	CAGLAGTYEQYF	TRBV6-5	TRBJ2-7
TGTGCCAGCAGCTGTACTGGACAGGGGGGAAACACCATATATTTT	CASSCTGQGGNTIYF	TRBV13	TRBJ1-3
TGTGCCAGCCGGGGATCAGCATGGACGGACTATAATTCACCCCTCCACTTT	CASRGSAWTDYNSPLHF	TRBV9	TRBJ1-6
TGTGCCAGCTCACCACGGAACGACACGGCTAACACTGAAGCTTTCTTT	CASSPRNDTANTEAFF	TRBV18	TRBJ1-1
TGCAGTGCTAGCAGCTTAACTAGCGGGAGACTGGGGATAGCCTACGAGCAGTACTTC	CSASSLTSGRLGIAYEQYF	TRBV20-1	TRBJ2-7
TGTGCCAGCAGCTTAGAACCGGTTGGCTACGAGCAGTACTTC	CASSLEPVGYEQYF	TRBV7-2	TRBJ2-7
TGTGCCAGCAGCGGGCTAGCGGTCTTCCTGTACAATGAGCAGTTCTTC	CASSGLAVFLYNEQFF	TRBV13	TRBJ2-1
TGTGCCAGCAGCCCAGGCAGGGGCTACGAGCAGTACTTC	CASSPGRGYEQYF	TRBV7-6	TRBJ2-7
TGTGCCAGCAGTTACTCGACAGATCAGCCCCAGCATTTT	CASSYSTDQPQHF	TRBV6-5	TRBJ1-5
TGTGCCACCAGCAGACCGTCAGGGGGCCAAGGGAACACTGAAGCTTTCTTT	CATSRPSGGQGNTEAFF	TRBV15	TRBJ1-1
TGTGCCAGCAGAGAGGGAAGGGCCGAGCAGTACTTC	CASREGRAEQYF	TRBV11-3	TRBJ2-7
TGTGCCAGCAGTGGATACCGGGACAGGGCGGGCTACGAGCAGTACTTC	CASSGYRDRAGYEQYF	TRBV27	TRBJ2-7
TGTGCCACCAGTGATTTGGACACTAGCGGGAGAACCTTGTCCTACAATGAGCAGTTCTTC	CATSDLDTSGRTLSYNEQFF	TRBV24-1	TRBJ2-1
TGTGCCAGCAGCCTTCGGGACAGAAACAATCAGCCCCAGCATTTT	CASSLRDRNNQPQHF	TRBV11-2	TRBJ1-5
TGTGCCAGCAGCTTGGCCGGGCCGCCTGGACAGCCCCAGCATTTT	CASSLAGPPGQPQHF	TRBV5-6	TRBJ1-5
TGCATTGGGAGCTACGAGCAGTACTTC	CIGSYEQYF	TRBV20-1	TRBJ2-7
TGTGCCAGCACTCGACAGGGCGTTAGCACTAATGAAAAACTGTTTTTT	CASTRQGVSTNEKLFF	TRBV27	TRBJ1-4
TGTGCCAGCAGTGAGCGGACGGGGGAGTACTATGGCTACACCTTC	CASSERTGEYYGYTF	TRBV2	TRBJ1-2
TGTGCCAGCGTGGCCCCTTGCCACAGAACGACAGATACGCAGTATTTT	CASVAPCHRTTDTQYF	TRBV25-1	TRBJ2-3
TGCGCCAGCAGCCGCAGGAGGAACACTGAAGCTTTCTTT	CASSRRRNTEAFF	TRBV5-1	TRBJ1-1
TGTGCCAGCAGCTTCCGGACAGAAAGCGGCTATGGCTACACCTTC	CASSFRTESGYGYTF	TRBV7-8	TRBJ1-2
TGTGCCAGCAGACCCCAACAGGGTATAGCCAAAAACATTCAGTACTTC	CASRPQQGIAKNIQYF	TRBV11-2	TRBJ2-4
TGTGCCAGCAGTTTACCGGGGAGGACCAATCTAGTGAACACTGAAGCTTTCTTT	CASSLPGRTNLVNTEAFF	TRBV27	TRBJ1-1
TGTGCCAGCAGCGGAGTCCGGGGCCGAGTTCTTTGCTTTTGGCGTAGCACAGATACGCAGTATTTT	CASSGVRGRVLCFWRSTDTQYF	TRBV13	TRBJ2-3
TGTGCCAGCAGCTTACCCGGGAGATTGAACACTGAAGCTTTCTTT	CASSLPGRLNTEAFF	TRBV7-4	TRBJ1-1
TGTGCCAGCAGTTATGGAGAAGTCCCCTCCCGGGGGACCGGGACAGGGGAGAACGAGCAGTACTTC	CASSYGEVPSRGTGTGENEQYF	TRBV6-9	TRBJ2-7
TGCGCCAGCAGTGAACCAGGGACGGTGAACACTGAAGCTTTCTTT	CASSEPGTVNTEAFF	TRBV10-1	TRBJ1-1
TGTGCCAGCAGAAATGGGGGCGGTCTCGGCTACACCTTC	CASRNGGGLGYTF	TRBV6-6	TRBJ1-2
TGTGCCAGCAGCTTAGATGCGGCTAAGGGAGGGGCTAATTCACCCCTCCACTTT	CASSLDAAKGGANSPLHF	TRBV11-3	TRBJ1-6
TGCGCCAGCAGCGGCTTGGTGCAGGGAGGCTACACCTTC	CASSGLVQGGYTF	TRBV5-1	TRBJ1-2
TGTGCCAGCAGCGTTTGTGGTCAAAGGGGAGTCACAGACACAGATACGCAGTATTTT	CASSVCGQRGVTDTDTQYF	TRBV9	TRBJ2-3
TGCGCCAGCAACAACAGGGCGGACTTCTATGGCTACACCTTC	CASNNRADFYGYTF	TRBV10-2	TRBJ1-2
TGTGCCAGCAGTGAACCCCAGGGTCTCGGTCTCAATCAGCCCCAGCATTTT	CASSEPQGLGLNQPQHF	TRBV6-1	TRBJ1-5
TGTGCCAGCAGTGAACCGGTATACCTCTATACTCTCATCCACATTCAGTACTTC	CASSEPVYLYTLIHIQYF	TRBV2	TRBJ2-4
TGTGCCAGCAGTGACCGAGAGGGCTACGAGCAGTACTTC	CASSDREGYEQYF	TRBV2	TRBJ2-7
TGTGCCAGCAGCCAGAGAATTAGAGGAAGGAACAATGAGCAGTTCTTC	CASSQRIRGRNNEQFF	TRBV3-1	TRBJ2-1
TGTGCCAGCAGCCGCATAACAGAGACCCAGTACTTC	CASSRITETQYF	TRBV6-5	TRBJ2-5
TGCGCCAGCAGCTTGATCACCGCGCGTTTTCAGGGGGGTCCCTACGAGCAGTACTTC	CASSLITARFQGGPYEQYF	TRBV5-1	TRBJ2-7
TGTGCCAGCAGCTTAAGGTTACAAGTAGCCAAAAACATTCAGTACTTC	CASSLRLQVAKNIQYF	TRBV7-6	TRBJ2-4
TGTGCCAGCAGCAACAAAGGAGCACCTATTGGACTAGCGGTGGGGTACGAGCAGTACTTC	CASSNKGAPIGLAVGYEQYF	TRBV7-3	TRBJ2-7
TGTGCGACTAGGGACTTAAGCTCCTACAATGAGCAGTTCTTC	CATRDLSSYNEQFF	TRBV6-4	TRBJ2-1
TGCAGTGCTTTGCTCGGGCGGGTCAACAATGAGCAGTTCTTC	CSALLGRVNNEQFF	TRBV20-1	TRBJ2-1
TGTGCCAGCAGTTTCGGGAGGGGGGGGCAGTTCTTC	CASSFGRGGQFF	TRBV27	TRBJ2-1
TGCGCCAGCAGCTGCCCTGCCGGGACTTATCATCAGCCCCAGCATTTT	CASSCPAGTYHQPQHF	TRBV5-1	TRBJ1-5
TGTGCCAGCCCATCTTCCCGACGCTGGGTTCTCTTGGGGGACCAGCCCCAGCATTTT	CASPSSRRWVLLGDQPQHF	TRBV6-4	TRBJ1-5
TGTGCCTGGAGTGTACCTGAAGGCACTCTAGCGGGCTACGAGCAGTACTTC	CAWSVPEGTLAGYEQYF	TRBV30	TRBJ2-7
TGTGCCAGCAGCCCTACTAACAGGGAGGGTACCGGGGTCGGGGAGCTGTTTTTT	CASSPTNREGTGVGELFF	TRBV14	TRBJ2-2
TGTGCCAGCATAGCCTCAGGTATGTCTCAGCCCCAGCATTTT	CASIASGMSQPQHF	TRBV6-3	TRBJ1-5
TGTGCCAGCATGGGACCGGCGACAGGGGACTGGGGCTACGAGCAGTACTTC	CASMGPATGDWGYEQYF	TRBV12-3	TRBJ2-7
TGTGCCAGCAGCGGGGGGGGCCCGAATAAGACCCAGTACTTC	CASSGGGPNKTQYF	TRBV5-4	TRBJ2-5
TGTGCCAGCGCCGACAGGGGTAGCAGGTGTCCACCCCTCCACTTT	CASADRGSRCPPLHF	TRBV6-5	TRBJ1-6
TGTGCCACCAGCAGACTAACGGTTGAAAGTCGGCCCCCAGGTTGGAACACTGAAGCTTTCTTT	CATSRLTVESRPPGWNTEAFF	TRBV15	TRBJ1-1
TGTGCCAGCAGCAGGGACATGCCCGGAAACACCATATATTTT	CASSRDMPGNTIYF	TRBV7-6	TRBJ1-3
TGCGCCAGCAGCTTGGCCCCCCCCATGGACAGGGCGGTCGAGCAGTACTTC	CASSLAPPMDRAVEQYF	TRBV5-1	TRBJ2-7
TGCGCCAGCAGCCAGGGACCGGGGACGGAACGGGGCGAGCAGTACTTC	CASSQGPGTERGEQYF	TRBV4-1	TRBJ2-7
TGTGCCACCAGGGGAGATAGCGAGCAGTACTTC	CATRGDSEQYF	TRBV24-1	TRBJ2-7
TGTGCCAGCAGCGGTTCTCCAGGACAGGGGGGGGCTAACTATGGCTACACCTTC	CASSGSPGQGGANYGYTF	TRBV11-3	TRBJ1-2
TGTGCCAGCAGCTTATGGGGGGGTGAGACCCAGTACTTC	CASSLWGGETQYF	TRBV7-8	TRBJ2-5
TGCGCCAGCAGCTGGGAACTGATTGACGAGCAGTACTTC	CASSWELIDEQYF	TRBV5-1	TRBJ2-7
TGTGCCATCAGCGGCGGAAGTACAGGGGGCAACACTGTTGGCTACACCTTC	CAISGGSTGGNTVGYTF	TRBV10-3	TRBJ1-2
TGTGCCAGCAGTGAACAGGTGGATTCCGATGAGCAGTTCTTC	CASSEQVDSDEQFF	TRBV6-4	TRBJ2-1
TGTGCCAGCAGTTACACCACGGCCAGCGGGACTAGCGGGAGCTCCTACGAGCAGTACTTC	CASSYTTASGTSGSSYEQYF	TRBV6-6	TRBJ2-7
TGTGCCTGGAGTGTACAGGACTATGAAAAACTGTTTTTT	CAWSVQDYEKLFF	TRBV30	TRBJ1-4
TGTGCCAGCAGCGAGATAGCAGTATCTGCCTACGAGCAGTACTTC	CASSEIAVSAYEQYF	TRBV9	TRBJ2-7
TGTGCCAGCTCACCGGAAGGGGGCTATGAGCAGTACTTC	CASSPEGGYEQYF	TRBV18	TRBJ2-7
TGTGCCAGCACCGGGGGCCCCCGATGGAACATTCAGTACTTC	CASTGGPRWNIQYF	TRBV6-4	TRBJ2-4
TGTGCCACCAGTGATTCCACCTTACTAGCGGGAGACGCCTACGAGCAGTACTTC	CATSDSTLLAGDAYEQYF	TRBV24-1	TRBJ2-7
TGTGCCAGCAGCTTGACTTTTTTGGGGCATTACGAGCAGTACTTC	CASSLTFLGHYEQYF	TRBV5-6	TRBJ2-7
TGTGCCAGCAGCATGACAGTACAGAGCTTTCCAATATCCGGTCAGCCCCAGCATTTT	CASSMTVQSFPISGQPQHF	TRBV7-2	TRBJ1-5
TGTGCCAGCAGGAGAAGGCACCTTCAGCCCCAGCATTTT	CASRRRHLQPQHF	TRBV28	TRBJ1-5
TGTGCCAGCAGCGAAGGACCGGGACAGGACGAGCAGTACTTC	CASSEGPGQDEQYF	TRBV11-3	TRBJ2-7
TGTGCCAGCAGCCACCCCGGGGATAGCAATCAGCCCCAGCATTTT	CASSHPGDSNQPQHF	TRBV4-2	TRBJ1-5
TGTGCCACCAGCACGGGCCCCGCGGAGACCCAGTACTTC	CATSTGPAETQYF	TRBV15	TRBJ2-5
TGTGCTAGTGGTGTAAGAGTTGGCCTCACAGATACGCAGTATTTT	CASGVRVGLTDTQYF	TRBV12-5	TRBJ2-3
TGTGCCAGCTCACCACCGCCCGTGGGGAGCGGGAGGGAGTTGGTAAACATTCAGTACTTC	CASSPPPVGSGRELVNIQYF	TRBV18	TRBJ2-4
TGTGCCAGCAGCGTAGGTCAGGGAGTGTATCAGCCCCAGCATTTT	CASSVGQGVYQPQHF	TRBV9	TRBJ1-5
TGTGCCAGCAGGGGACGCGATGAAGCTTTCTTT	CASRGRDEAFF	TRBV5-5	TRBJ1-1
TGTGCCAGTAGTATAGCGGCGGGGTCTGGAAACACCATATATTTT	CASSIAAGSGNTIYF	TRBV19	TRBJ1-3
TGTGCCAGCAGCTGCTCATTCTCTCGTGTCAGCAATCAGCCCCAGCATTTT	CASSCSFSRVSNQPQHF	TRBV11-2	TRBJ1-5
TGCGCCAGCAGTCGTTTCCCCTGGTCGGGGGCGATATACGAGCAGTACTTC	CASSRFPWSGAIYEQYF	TRBV5-1	TRBJ2-7
TGTGCCAGCAGTGGACAAGGAATGCCCCAGCATTTT	CASSGQGMPQHF	TRBV6-1	TRBJ1-5
TGCGCCAGCAGCCAGCAGGCGTGTGAGACCCAGTACTTC	CASSQQACETQYF	TRBV4-3	TRBJ2-5
TGTGCCAGCAGTGTGCGTGGCGATGGCTACACCTTC	CASSVRGDGYTF	TRBV25-1	TRBJ1-2
TGTGCCAGCAGGAAGGAGAGCCCTAGGATGAACTATGGCTACACCTTC	CASRKESPRMNYGYTF	TRBV7-9	TRBJ1-2
TGCGCCAGCAGCCAAAGGGGGGGGCAAGAGACCCAGTACTTC	CASSQRGGQETQYF	TRBV4-3	TRBJ2-5
TGCAGTGCTAGAAAGGCTATAAAAGACACCGGGGAGCTGTTTTTT	CSARKAIKDTGELFF	TRBV20-1	TRBJ2-2
TGTGCCAGCATTCTAGCGGGCTCCTACGAGCAGTACTTC	CASILAGSYEQYF	TRBV25-1	TRBJ2-7
TGTGCCAGCAGTCGCGGCCACGAGCAGTTCTTC	CASSRGHEQFF	TRBV6-4	TRBJ2-1
TGTGCCAGCAGGAAAACCCCGGGACTAGCGGGGATTTACGAGCAGTACTTC	CASRKTPGLAGIYEQYF	TRBV6-1	TRBJ2-7
TGTGCCAGGCAGCGGGAGGAAGAAGATACGCAGTATTTT	CARQREEEDTQYF	TRBV2	TRBJ2-3
TGTGCCACCAGTGATTTGTCGGGAGGGGTTGAGCAGTTCTTC	CATSDLSGGVEQFF	TRBV24-1	TRBJ2-1
TGTGCCAGCAGCATGGTTGACTGTGGAGATACGCAGTATTTT	CASSMVDCGDTQYF	TRBV5-4	TRBJ2-3
TGCAGTGCTAGGGGACAGGTGGGCTACACCTTC	CSARGQVGYTF	TRBV20-1	TRBJ1-2
TGTGCCAGCAGCGCGACCGGGGACTGTTGGGACTATGGCTACACCTTC	CASSATGDCWDYGYTF	TRBV5-4	TRBJ1-2
TGTGCCAGCAGCTTAAAGGAGCCACCTGACTCTGGAAACACCATATATTTT	CASSLKEPPDSGNTIYF	TRBV7-2	TRBJ1-3
TGCAGTGCTAAGGGTAAAGGGGGCTGCCAAGAGACCCAGTACTTC	CSAKGKGGCQETQYF	TRBV20-1	TRBJ2-5
TGTGCCAGCATGAGAGGAATAACCTACGCGTGGACAGGGTCGGCCTACAATGAGCAGTTCTTC	CASMRGITYAWTGSAYNEQFF	TRBV7-3	TRBJ2-1
TGTGCCAGCAGGGGGGCCGCTTTCTTT	CASRGAAFF	TRBV3-1	TRBJ1-1
TGTGCCAGCAGCTTACCGGGCATCAATCACAGGGGCCTGCGCTACGAGCAGTACTTC	CASSLPGINHRGLRYEQYF	TRBV7-6	TRBJ2-7
TGTGCCAGCAGCTTACTGGGCGGGTACCAAGGCGATAGATCTGAAGCTTTCTTT	CASSLLGGYQGDRSEAFF	TRBV5-6	TRBJ1-1
TGCAGTGCTCGGGAATGGAAGAGAGCCTACGAGCAGTACTTC	CSAREWKRAYEQYF	TRBV20-1	TRBJ2-7
TGCGCCAGCAGCCAAGCCAGGGGCGACAGGGGGTTTCCATATAATTCACCCCTCCACTTT	CASSQARGDRGFPYNSPLHF	TRBV4-1	TRBJ1-6
TGTGCCAGCCGACAGGGTCTGTTGATCACCGGGGAGCTGTTTTTT	CASRQGLLITGELFF	TRBV6-5	TRBJ2-2
TGTGCCAGCAGTGACTCCGGGTCAGGGAGCTACGAGCAGTACTTC	CASSDSGSGSYEQYF	TRBV6-4	TRBJ2-7
TGTGCCAGCAGCTTAGGGTCCCGGGACAGGGCCCGTAGGCCTGGCTACACCTTC	CASSLGSRDRARRPGYTF	TRBV7-9	TRBJ1-2
TGTGCCAGCAGTCGTCCGGGGGGGTTGGATAGGTACCATGAGCAGTTCTTC	CASSRPGGLDRYHEQFF	TRBV12-3	TRBJ2-1
TGTGCCTGGAAACTCAGGGAATTCTCCTACAATGAGCAGTTCTTC	CAWKLREFSYNEQFF	TRBV30	TRBJ2-1
TGTGCCATCAGGGGACAGGATAGGGACGTTGCCTACGAGCAGTACTTC	CAIRGQDRDVAYEQYF	TRBV10-3	TRBJ2-7
TGTGCCAGCAGTGACTCGCTCTCAGGGCGCAACAATGAGCAGTTCTTC	CASSDSLSGRNNEQFF	TRBV6-4	TRBJ2-1
TGTGCCAGCAGTGACTCGAAAACGCTTCGAAAACTGTTTTTT	CASSDSKTLRKLFF	TRBV6-4	TRBJ1-4
TGTGCTCCTGCTTCTCCCGACACTGAAGCTTTCTTT	CAPASPDTEAFF	TRBV12-3	TRBJ1-1
TGTGCCGGGTACGGCTGGGGAGGGACAGGGGGCTGTTTAGTCTCCTATAATTCACCCCTCCACTTT	CAGYGWGGTGGCLVSYNSPLHF	TRBV5-5	TRBJ1-6
TGTGCCAGCAGCAACGCCTACGAGCAGTACTTC	CASSNAYEQYF	TRBV13	TRBJ2-7
TGTGCCAGCAGAGGACCGGGGAATCACCAAGAGACCCAGTACTTC	CASRGPGNHQETQYF	TRBV3-1	TRBJ2-5
TGTGCCAGGACGCTTCCCCTGGATAGCAATCAGCCCCAGCATTTT	CARTLPLDSNQPQHF	TRBV27	TRBJ1-5
TGCAGTGCTAGAGATTATCCAGGGACTAGCGGTTGGAATGAGCAGTTCTTC	CSARDYPGTSGWNEQFF	TRBV20-1	TRBJ2-1
TGTGCCAGTAGGCCGGGACAGCTGGGAATGAACACTGAAGCTTTCTTT	CASRPGQLGMNTEAFF	TRBV19	TRBJ1-1
TGTGCCAGCAGTGGACGCTCCCCGCCGCCCGTCGGGAGGGGAGAGACCCAGTACTTC	CASSGRSPPPVGRGETQYF	TRBV6-5	TRBJ2-5
TGTGCCAGCAGCGGGAAGCCCCAGCATTTT	CASSGKPQHF	TRBV9	TRBJ1-5
TGCAGTGCTAGAGCTCCAAAGACTAGCGGGTACAATGAGCAGTTCTTC	CSARAPKTSGYNEQFF	TRBV20-1	TRBJ2-1
TGTGCCACCAGTGAGCCGCAGGCTAATGAAAAACTGTTTTTT	CATSEPQANEKLFF	TRBV24-1	TRBJ1-4
TGTGCCTCCAGGGATACGCAGTATTTT	CASRDTQYF	TRBV30	TRBJ2-3
TGTGCCAGCAGTTTATCCGGACAGGGAGGAGAGACCCAGTACTTC	CASSLSGQGGETQYF	TRBV28	TRBJ2-5
TGTGCCAGCAGCATATCCGGGGAGGACTATGGCTACACCTTC	CASSISGEDYGYTF	TRBV7-3	TRBJ1-2
TGTGCCAGCAGTGAATTACCTAGACTAGCGGGGGGGCTTAATGAGCAGTTCTTC	CASSELPRLAGGLNEQFF	TRBV6-1	TRBJ2-1
TGTGCCAGTACCCAGACAGGGGGCGGGGGTACTGAAGCTTTCTTT	CASTQTGGGGTEAFF	TRBV19	TRBJ1-1
TGTGCCAGCATGACAGGGGGTTCTGGAAACACCATATATTTT	CASMTGGSGNTIYF	TRBV7-3	TRBJ1-3
TGCGCCAGAAAAGTCGCGGGAGATACGCAGTATTTT	CARKVAGDTQYF	TRBV5-1	TRBJ2-3
TGTGCCACTCAGCGGAGGCCTGAAGCTTTCTTT	CATQRRPEAFF	TRBV24-1	TRBJ1-1
TGTGCCTTAACTAGCGGCAATGAGCAGTTCTTC	CALTSGNEQFF	TRBV30	TRBJ2-1
TGCGCCAGCAGCCTCACGAGTAGGAGCTCCTACAATGAGCAGTTCTTC	CASSLTSRSSYNEQFF	TRBV4-1	TRBJ2-1
TGTGCCAGCAGCGAAGGGGCTTCATGCTTCGAGCAGTACTTC	CASSEGASCFEQYF	TRBV9	TRBJ2-7
TGCAGTGCTGAGGGACAGGGGGCTACCCCGGCCCAGTGGCCCGGTGCTATAGAGAACACTGAAGCTTTCTTT	CSAEGQGATPAQWPGAIENTEAFF	TRBV20-1	TRBJ1-1
TGTGCCAGCAGCCAGGGGGCCCTCTCCTACGAGCAGTACTTC	CASSQGALSYEQYF	TRBV5-8	TRBJ2-7
TGTGCCAGCAGCCGCCGCAGGAACACTGAAGCTTTCTTT	CASSRRRNTEAFF	TRBV3-1	TRBJ1-1
TGTGCCAGCAGCGATAGGGCGAACATTCAGTACTTC	CASSDRANIQYF	TRBV5-6	TRBJ2-4
TGTGCCAGCAGAGCCGGGACAGCCACCGAGACCCAGTACTTC	CASRAGTATETQYF	TRBV25-1	TRBJ2-5
TGTGCCAGCACAACCCCCCATGGGGGTAATTGGATTTACGAGCAGTACTTC	CASTTPHGGNWIYEQYF	TRBV7-7	TRBJ2-7
TGTGCCAGCAGCCCTACCTTGCATGAAACCCAGTACTTC	CASSPTLHETQYF	TRBV7-3	TRBJ2-5
TGTGCCAGCAGCGTCGGACGGGTGCAAGAGACCCAGTACTTC	CASSVGRVQETQYF	TRBV13	TRBJ2-5
TGTGCCAGCAGCTTTCGAAAGGTACGAAACACCATATATTTT	CASSFRKVRNTIYF	TRBV5-4	TRBJ1-3
TGTGCCAGCAGCTTCTACAGGGCTTCTGGGGCCAACGTCCTGACTTTC	CASSFYRASGANVLTF	TRBV7-3	TRBJ2-6
TGTGCCAGTAGGACACAGAGGAAGTCCGGGGAGCTGTTTTTT	CASRTQRKSGELFF	TRBV19	TRBJ2-2
TGCAGTGCTAGTTTAAACGCCCAGGGTAAGGGGGGTGAGTACACCTTC	CSASLNAQGKGGEYTF	TRBV20-1	TRBJ1-2
TGTGCCAGCAGCCGCCCCGCAGCGGGATATGACTACGAGCAGTACTTC	CASSRPAAGYDYEQYF	TRBV6-5	TRBJ2-7
TGTGCCAGCCCGTCACGGCCTTTGGACACCGGGGAGCTGTTTTTT	CASPSRPLDTGELFF	TRBV6-1	TRBJ2-2
TGTGCCAGCAGCTTAGACGGGAGAAATGAGCAGTTCTTC	CASSLDGRNEQFF	TRBV7-2	TRBJ2-1
TGCAGTGCTAGAGATCTGGCCCTACTAGGGGGAGGTGGAGGCGAGCAGTACTTC	CSARDLALLGGGGGEQYF	TRBV20-1	TRBJ2-7
TGTGTTCTAGCGGGGGATGATGAGCAGTTCTTC	CVLAGDDEQFF	TRBV24-1	TRBJ2-1
TGCGCCAGCCTGGCCGACAGGGCCTACAATGAGCAGTTCTTC	CASLADRAYNEQFF	TRBV10-1	TRBJ2-1
TGTGCCAGCAGTTACTCGACAGGGCGATCTGAAGCTTTCTTT	CASSYSTGRSEAFF	TRBV6-8	TRBJ1-1
TGCAGTGCTAGCCTCCTGCGGGACAGGGGATTTACCGACCAAGAGACCCAGTACTTC	CSASLLRDRGFTDQETQYF	TRBV20-1	TRBJ2-5
TGTGCCAGCAGTGACAGGTGGGACGCTGAAGCTTTCTTT	CASSDRWDAEAFF	TRBV12-3	TRBJ1-1
TGCGCCAGCAGCTTTTGGAGGCCGGGGGTTCCAGATACGCAGTATTTT	CASSFWRPGVPDTQYF	TRBV4-3	TRBJ2-3
TGTGCCAGCAGACCGTCCAGGGGGGTACAGGGGTGTAAGAACACTGAAGCTTTCTTT	CASRPSRGVQGCKNTEAFF	TRBV14	TRBJ1-1
TGTGCCACCAGTGACCCACAGGGCCGGGTTGAAGCTTTCTTT	CATSDPQGRVEAFF	TRBV24-1	TRBJ1-1
TGTGCCAGCAGTTACTCGGGGGGGCAGCCCCAGCATTTT	CASSYSGGQPQHF	TRBV6-2	TRBJ1-5
TGTGCCAGCAGTTACCCCCAGGGGGCTTTTCGTATGTACAATGAGCAGTTCTTC	CASSYPQGAFRMYNEQFF	TRBV6-6	TRBJ2-1
TGTGCCAGTAGTAAAAACCCTCACCGAACCCAGCATTTT	CASSKNPHRTQHF	TRBV19	TRBJ1-5
TGTGCCAGCAGCCCGACAGGCTACAATGAGCAGTTCTTC	CASSPTGYNEQFF	TRBV6-4	TRBJ2-1
TGTGCCAGCAGTCACAGGCTCGATCAGCCCCAGCATTTT	CASSHRLDQPQHF	TRBV28	TRBJ1-5
TGTGCCAGCAGTGTGTACCCCCAGGGGGGTGCGACCGGGGAGCTGTTTTTT	CASSVYPQGGATGELFF	TRBV27	TRBJ2-2
TGTGCCAGCAGCGCGGCAGGGGGTGGCCCCTACGAGCAGTACTTC	CASSAAGGGPYEQYF	TRBV5-4	TRBJ2-7
TGCGCCAGCAGCCAAGAGCAGGACCCCGAGCAGTACTTC	CASSQEQDPEQYF	TRBV4-1	TRBJ2-7
TGTGCCAGCAGTTTCCATGGAGTGCAGCATTTT	CASSFHGVQHF	TRBV12-3	TRBJ1-5
TGTGCCAGCAGGGCCGAACTAGGGGGAGCGAACACCGGGGAGCTGTTTTTT	CASRAELGGANTGELFF	TRBV6-3	TRBJ2-2
TGTGATCAGTTAACCGCAACTAATGAAAAACTGTTTTTT	CDQLTATNEKLFF	TRBV4-2	TRBJ1-4
TGTGCCAGCAGCCCCCCGGGGGCCAACACCGGGGAGCTGTTTTTT	CASSPPGANTGELFF	TRBV7-3	TRBJ2-2
TGTGCCAGCAGCCCTCTAACCACTGAAGCTTTCTTT	CASSPLTTEAFF	TRBV7-3	TRBJ1-1
TGTGCCAGCAGCCAAGTCCAGGGGGAAGTCTATAACTATGGCTACACCTTC	CASSQVQGEVYNYGYTF	TRBV14	TRBJ1-2
TGTGCCAGCAGTTGGCCCCAGGGGAGGAAAGCTTTCTTT	CASSWPQGRKAFF	TRBV6-1	TRBJ1-1
TGCGCCAGCAGTGAGCCGTCCTTAGAACCGGGCCCGGAAATCTACAATGAGCAGTTCTTC	CASSEPSLEPGPEIYNEQFF	TRBV10-2	TRBJ2-1
TGTGCCACCAGCAGGTTATTCTGGTTGGCGAACACCGGGGAGCTGTTTTTT	CATSRLFWLANTGELFF	TRBV15	TRBJ2-2
TGTGCCAGCAGTCCAAAAGGGGGTTACGAGCAGTACTTC	CASSPKGGYEQYF	TRBV27	TRBJ2-7
TGTGCCAGCATGCAGGGGAGGCAGGGGACCTACGAGCAGTACTTC	CASMQGRQGTYEQYF	TRBV6-6	TRBJ2-7
TGTGCCAGCAGCTTAATGCAGGGGGGCATATACAATGAGCAGTTCTTC	CASSLMQGGIYNEQFF	TRBV7-6	TRBJ2-1
TGTGCCAGCAGCTTAGTGACAAGGGGGCGCGGTTTAGGAGACAATGAGCAGTTCTTC	CASSLVTRGRGLGDNEQFF	TRBV7-9	TRBJ2-1
TGCAGTGCGAACCTACTAGCGGGAGTTACAAGCAATCAGCCCCAGCATTTT	CSANLLAGVTSNQPQHF	TRBV20-1	TRBJ1-5
TGTGCCAGTCCATCTGGGCCACAGAGCACTGAAGCTTTCTTT	CASPSGPQSTEAFF	TRBV19	TRBJ1-1
TGTGCCATCCGACAGTACACCTTC	CAIRQYTF	TRBV10-3	TRBJ1-2
TGTGCCATCAGTGAGTCCAGAACCTACACCTTC	CAISESRTYTF	TRBV10-3	TRBJ1-2
TGTGCCAGCAGCTTGCCCAGGGGAAGCCAAGAGACCCAGTACTTC	CASSLPRGSQETQYF	TRBV5-4	TRBJ2-5
TGTGCCAGCAGCCAAGATATACGAGGGAATTCACCCCTCCACTTT	CASSQDIRGNSPLHF	TRBV3-1	TRBJ1-6
TGTGCCAGCTGGGCCGGGGGACTGGCTTTCTTT	CASWAGGLAFF	TRBV5-4	TRBJ1-1
TGTGCCAGCAGCAGCCCCCTAGGGGCTCAGCCCCAGCATTTT	CASSSPLGAQPQHF	TRBV9	TRBJ1-5
TGTGCCAGCAGCTTTACTAGCGGGAGTCCAAACACTGAAGCTTTCTTT	CASSFTSGSPNTEAFF	TRBV7-9	TRBJ1-1
TGCGCCAGCAGCAAGTGGAAGCGTAGGCCTAGCGGCCGGGATGAGCAGTTCTTC	CASSKWKRRPSGRDEQFF	TRBV5-1	TRBJ2-1
TGCGCCAGGACAAGGATTCCTTGGGGTTGGAGCACTGAAGCTTTCTTT	CARTRIPWGWSTEAFF	TRBV4-1	TRBJ1-1
TGTGCCAGCAGTGAGCCACGTGGGGGAGTTAATGAAAAACTGTTTTTT	CASSEPRGGVNEKLFF	TRBV2	TRBJ1-4
TGTGCCAGCAGGGCCCCAGGCAGGGGAGAAAAACTGTTTTTT	CASRAPGRGEKLFF	TRBV6-2	TRBJ1-4
TGTGCCAGCAGTGACTCGATGAGGGTTCTTCGACGAGGAGATACGCAGTATTTT	CASSDSMRVLRRGDTQYF	TRBV6-4	TRBJ2-3
TGTGCCAGCAGCCAAGACAGACAGGGTTACGTTGAAAGCTCTGGGGCCAACGTCCTGACTTTC	CASSQDRQGYVESSGANVLTF	TRBV14	TRBJ2-6
TGTGCCAGCAGCCCTGGGACAGGGGCTACCTACGAGCAGTACTTC	CASSPGTGATYEQYF	TRBV7-9	TRBJ2-7
TGCAGTGCTAGAGGGCGGGGGACAGATCAGCCCCAGCATTTT	CSARGRGTDQPQHF	TRBV20-1	TRBJ1-5
TGCAGTGCTAGGGGGGGACCGAACACCGGGGAGCTGTTTTTT	CSARGGPNTGELFF	TRBV20-1	TRBJ2-2
TGTGCCAGCAGCTTAGCGGAGAGAAAAGAGACCCAGTACTTC	CASSLAERKETQYF	TRBV7-2	TRBJ2-5
TGTGCCAGCAGGCGAAGAAACCCGGGCTTAGGGGGCAATCAGCCCCAGCATTTT	CASRRRNPGLGGNQPQHF	TRBV27	TRBJ1-5
TGTGCCACCAGTGAGGCTAGCGGGCCGTTCACCTACGAGCAGTACTTC	CATSEASGPFTYEQYF	TRBV24-1	TRBJ2-7
TGTGCCAGCAGCTTGACAGGGGGCGGCCCTGACCGGTCTGGAAACACCATATATTTT	CASSLTGGGPDRSGNTIYF	TRBV5-8	TRBJ1-3
TGCGCCAGCAGCTTCGTTAACTGGGAAGGGGGACCTGGTCCGCGTTTCACTGAAGCTTTCTTT	CASSFVNWEGGPGPRFTEAFF	TRBV5-1	TRBJ1-1
TGCGCCAGCAGTGAGGCTAGTGAAGAGACCCAGTACTTC	CASSEASEETQYF	TRBV10-1	TRBJ2-5
TGTGCTAGTGCCCGTAACGGGACTGTTTTTCCCTACGAGCAGTACTTC	CASARNGTVFPYEQYF	TRBV12-5	TRBJ2-7
TGTGCCAGCTCACCACTACCCGGGACTAGCGGCATAGTGAGTCGCGCTAACACCGGGGAGCTGTTTTTT	CASSPLPGTSGIVSRANTGELFF	TRBV18	TRBJ2-2
TGCAGTGCTGATACCGAGGGGGAAGACTACGAGCAGTACTTC	CSADTEGEDYEQYF	TRBV20-1	TRBJ2-7
TGCGCCAGCAGCCAAGGATTGAGGACAGGCACTGAAGCTTTCTTT	CASSQGLRTGTEAFF	TRBV4-1	TRBJ1-1
TGTGCCGGGGAGGGGGGCTACGAGCAGTACTTC	CAGEGGYEQYF	TRBV19	TRBJ2-7
TGTGCCAGCAGGCACAGTTGTAGGGGGGCAACTAATGAAAAACTGTTTTTT	CASRHSCRGATNEKLFF	TRBV9	TRBJ1-4
TGTGCCAGCAGCTCACCTTGGGCAAGTGGGTACAATGAGCAGTTCTTC	CASSSPWASGYNEQFF	TRBV7-6	TRBJ2-1
TGTGCCAGCAGTCCGTCTCTGGACATTCAGTACTTC	CASSPSLDIQYF	TRBV5-6	TRBJ2-4
TGCAGTGCTACTTCTCACCGGGTCGTCAAGGTGCCCCTCCACTTT	CSATSHRVVKVPLHF	TRBV20-1	TRBJ1-6
TGTGCCAGCAGCCAAATCAGCCGGGACAGGGGGTGTAACTATGGCTACACCTTC	CASSQISRDRGCNYGYTF	TRBV7-9	TRBJ1-2
TGCAGTTCGGGAGGAGATACGCAGTATTTT	CSSGGDTQYF	TRBV20-1	TRBJ2-3
TGTGCCAGCCAGGGGCCTAGGGAGACCCAGTACTTC	CASQGPRETQYF	TRBV19	TRBJ2-5
TGTGCCAGCAGCTTACCGACCGGGAGGCCTAGCACAGATACGCAGTATTTT	CASSLPTGRPSTDTQYF	TRBV7-9	TRBJ2-3
TGCAGTGCTAGAGATGAAGTACGGCAAAATCAAAAGGACTCCTACGAGCAGTACTTC	CSARDEVRQNQKDSYEQYF	TRBV20-1	TRBJ2-7
TGTGCCATCAGTGATGTCCCACAGGGGAGCTACAATGAGCAGTTCTTC	CAISDVPQGSYNEQFF	TRBV10-3	TRBJ2-1
TGTGCCAGCAGCAAGGGGCTGACTAGCGGGGGGTGCTCCTACAATGAGCAGTTCTTC	CASSKGLTSGGCSYNEQFF	TRBV7-2	TRBJ2-1
TGCGCCAGCAGCCAAGCGGTAAAGACCTATTCGGGATGTGAAGCTTTCTTT	CASSQAVKTYSGCEAFF	TRBV4-1	TRBJ1-1
TGCGCCAGCAGTACAGGGCAGGGGGCCCGAGTGGGACCCTATGGCTACACCTTC	CASSTGQGARVGPYGYTF	TRBV10-1	TRBJ1-2
TGTGCCAGCAGCGCCGGGTCCAACACTGAAGCTTTCTTT	CASSAGSNTEAFF	TRBV13	TRBJ1-1
TGTGCCAGATCCCGGACAGGAATTCACAATCAGCCCCAGCATTTT	CARSRTGIHNQPQHF	TRBV10-3	TRBJ1-5
TGCGCCAGCAGCCTTTGGGACAGGCAAGCTTTCTTT	CASSLWDRQAFF	TRBV4-1	TRBJ1-1
TGTGCCAGCAGCTTGGAGAATGATTGGTGCTCCTATAATTCACCCCTCCACTTT	CASSLENDWCSYNSPLHF	TRBV5-5	TRBJ1-6
TGCGCCAATTTAAAGGGACACGGGCCCCAGCATTTT	CANLKGHGPQHF	TRBV10-1	TRBJ1-5
TGTGCCTGGAGTGTACTTGGACAGGGTTGCTACGAGCAGTACTTC	CAWSVLGQGCYEQYF	TRBV30	TRBJ2-7
TGTGCCAGCAGCCTCCCAGTATCTGAAGCTTTCTTT	CASSLPVSEAFF	TRBV4-2	TRBJ1-1
TGCAGCGTTGAAGATCCAGGGGGGCGACTGCCTTCCTATAATTCACCCCTCCACTTT	CSVEDPGGRLPSYNSPLHF	TRBV29-1	TRBJ1-6
TGTGCCAGCAGTATCATAGGGGACAGGAGGAACGAGCAGTACTTC	CASSIIGDRRNEQYF	TRBV6-1	TRBJ2-7
TGTGCCAGCACCCCAGGGAGTGGCACTGAAGCTTTCTTT	CASTPGSGTEAFF	TRBV28	TRBJ1-1
TGTGCCAATCTCCGCTTCCACTCTGCCCTAGATACGCAGTATTTT	CANLRFHSALDTQYF	TRBV11-2	TRBJ2-3
TGCAGCGTGGGGACAGGGGCGGTCTATGGCTACACCTTC	CSVGTGAVYGYTF	TRBV29-1	TRBJ1-2
TGTGCCAGCAGCCAAGGCCGGGCGAAGGCCAAAAACATTCAGTACTTC	CASSQGRAKAKNIQYF	TRBV3-1	TRBJ2-4
TGTGCCAGCCCATCACTTCAGGGGCTTCCCAGTCAGCCCCAGCATTTT	CASPSLQGLPSQPQHF	TRBV12-3	TRBJ1-5
TGTGCCAGCAGCTTAGACCCATGTTCGCTAGCGGCCACAGATACGCAGTATTTT	CASSLDPCSLAATDTQYF	TRBV7-2	TRBJ2-3
TGCGCCAGCAGTTTGGGGGCGGGGAATCCCTGGGCCAATCAGCCCCAGCATTTT	CASSLGAGNPWANQPQHF	TRBV10-2	TRBJ1-5
TGCGCCAGCAGCTCCCGGACGCAGAACACTGAAGCTTTCTTT	CASSSRTQNTEAFF	TRBV5-1	TRBJ1-1
TGCGCCAGCAGCCAAGACCCCAGGGGCAATCAGCCCCAGCATTTT	CASSQDPRGNQPQHF	TRBV4-1	TRBJ1-5
TGTGCCAGCAGTGAACCCCGGGGGTTTTGCAATTCACCCCTCCACTTT	CASSEPRGFCNSPLHF	TRBV6-1	TRBJ1-6
TGCAGTGCACGAGTACTGAACATGGAGGCCTATGGCTACACCTTC	CSARVLNMEAYGYTF	TRBV20-1	TRBJ1-2
TGTGCCAGCAGCCGGACTAGGATAGCCAAAAACATTCAGTACTTC	CASSRTRIAKNIQYF	TRBV4-2	TRBJ2-4
TGTGCCAGCAGCCACCGGGACAACGCTAGCACAGATACGCAGTATTTT	CASSHRDNASTDTQYF	TRBV3-1	TRBJ2-3
TGTGCCAGCAGTACAGGGGGCGATCCACACTATGGCTACACCTTC	CASSTGGDPHYGYTF	TRBV27	TRBJ1-2
TGTGCCAGTGTACCCAAAGGGCTCTACGAGCAGTACTTC	CASVPKGLYEQYF	TRBV13	TRBJ2-7
TGTGCCAGCTCTGGGCAGGGGGCCGGTTACGATGGCTACACCTTC	CASSGQGAGYDGYTF	TRBV27	TRBJ1-2
TGCGCCAGCAGAGGGACAGGGCATTTGGAGTCGTATGGCTACACCTTC	CASRGTGHLESYGYTF	TRBV5-1	TRBJ1-2
TGTGCCAGCAGTGACCGGGGGAACTCTAATGAAAAACTGTTTTTT	CASSDRGNSNEKLFF	TRBV6-4	TRBJ1-4
TGTGCCAGCAGCTCGACGACTAGACAGGGGGGAAAACTGTTTTTT	CASSSTTRQGGKLFF	TRBV7-3	TRBJ1-4
TGTGCCAGCAGTTACAAGTTACACAGACCCAACTACGAGCAGTACTTC	CASSYKLHRPNYEQYF	TRBV6-2	TRBJ2-7
TGTGCCAGCAGCTTACACACAATGGAAAGGGGTACAGGCCATAGCAATCAGCCCCAGCATTTT	CASSLHTMERGTGHSNQPQHF	TRBV7-2	TRBJ1-5
TGTGCCAGCAGGAGGGACGCCCCACCCCTCCACTTT	CASRRDAPPLHF	TRBV7-3	TRBJ1-6
TGTGCCACGAAATACTCAACGACAGTTCAGACGAGCAATCAGCCCCAGCATTTT	CATKYSTTVQTSNQPQHF	TRBV24-1	TRBJ1-5
TGTGCCAGCAGGTCAGCAGGGACAGGCTCTGGAAACACCATATATTTT	CASRSAGTGSGNTIYF	TRBV6-5	TRBJ1-3
TGCAGTGCTAGCTCGGGGAGGGGGCGACCGCATTTT	CSASSGRGRPHF	TRBV20-1	TRBJ1-5
TGCGCCAGCAGTGTGCGTTCGGCCTACACTGAAGCTTTCTTT	CASSVRSAYTEAFF	TRBV5-1	TRBJ1-1
TGTGCCAGCAGCCAAGCATGTGTGGGGTTGGAGACCCAGTACTTC	CASSQACVGLETQYF	TRBV3-1	TRBJ2-5
TGTGCCAGCAGTGAACCGTCGGGCCCCCGCGAGGGCAATGAGCAGTTCTTC	CASSEPSGPREGNEQFF	TRBV6-4	TRBJ2-1
TGTGCCAGCAGCCAAGAAGTAGGCTACGAGCAGTACTTC	CASSQEVGYEQYF	TRBV14	TRBJ2-7
TGTGCCAGCAGTTACTCGAACCAGCCTGGGACAGGAGCTCCCACAGATACGCAGTATTTT	CASSYSNQPGTGAPTDTQYF	TRBV6-5	TRBJ2-3
TGTGCCAGGGCACAAGGGTACGAGCAGTACTTC	CARAQGYEQYF	TRBV5-6	TRBJ2-7
TGTGCCAGCAGCCAACGGTACGTAGCGGGGGTGCACGAGCAGTACTTC	CASSQRYVAGVHEQYF	TRBV14	TRBJ2-7
TGTGCCAGCAGTTCGCTTCGGGGGCCATACGAGCAGTACTTC	CASSSLRGPYEQYF	TRBV12-3	TRBJ2-7
TGTGCCAGCAGTATGGTATCAGGGTCGTCAGGACCCGAGCAGTACTTC	CASSMVSGSSGPEQYF	TRBV27	TRBJ2-7
TGTGCCAGCAGCGGGGGCCCCGGGGTCGCAGATACGCAGTATTTT	CASSGGPGVADTQYF	TRBV5-6	TRBJ2-3
TGTGCCAGCAGTGGTTATCGGAAGCAAGAGACCCAGTACTTC	CASSGYRKQETQYF	TRBV12-4	TRBJ2-5
TGTGCCAGCAGTTCGGGATGCAGGCCCTCTGAAGCTTTCTTT	CASSSGCRPSEAFF	TRBV6-9	TRBJ1-1
TGCGCCAGCCCCCATTCCGGGACCTACGAGCAGTACTTC	CASPHSGTYEQYF	TRBV10-1	TRBJ2-7
TGTGCCAGCAGTTGGACAGAATTGAGCTCCTACGAGCAGTACTTC	CASSWTELSSYEQYF	TRBV27	TRBJ2-7
TGTGCCAGCAGTTTTCCGGGACTAGTAGGGGGTCTCTACGAGCAGTACTTC	CASSFPGLVGGLYEQYF	TRBV27	TRBJ2-7
TGTGCCAGCAGCCCCCTCCTTTCTGACCTACGTTCCTACGAGCAGTACTTC	CASSPLLSDLRSYEQYF	TRBV14	TRBJ2-7
TGTGCCAGCAGACTCGGGGACGCTGGAGACACTGAAGCTTTCTTT	CASRLGDAGDTEAFF	TRBV28	TRBJ1-1
TGTGCCAGCAGTTCAGGGGGGGGGATTGAAGCTTTCTTT	CASSSGGGIEAFF	TRBV27	TRBJ1-1
TGTGCCTTTGAGGACTACGAGCAGTACTTC	CAFEDYEQYF	TRBV6-4	TRBJ2-7
TGCGCCAGCAGCCAGGGTCCGGGGCCGCCTCAGCCCCAGCATTTT	CASSQGPGPPQPQHF	TRBV4-1	TRBJ1-5
TGTGCCAGCAGCCAACACTCGGACTGCGGGTTTAACACTGAAGCTTTCTTT	CASSQHSDCGFNTEAFF	TRBV3-1	TRBJ1-1
TGCGCCAGCAAAGGGGATGCAGTAGATACGCAGTATTTT	CASKGDAVDTQYF	TRBV10-1	TRBJ2-3
TGCGCCAGCAGCCAAGACAGGGGGGGGAGAGATACGCAGTATTTT	CASSQDRGGRDTQYF	TRBV4-1	TRBJ2-3
TGTGCCAGCAGTTACTTTATTAAACTGTACGCGGGAGCCTACGAGCAGTACTTC	CASSYFIKLYAGAYEQYF	TRBV6-3	TRBJ2-7
TGTGCCAGCAGAGGCAATCGGCATGTCTACGAGCAGTACTTC	CASRGNRHVYEQYF	TRBV12-4	TRBJ2-7
TGTGCCAGCAGCTGGGCCGTCTCTGGAAACACCATATATTTT	CASSWAVSGNTIYF	TRBV7-2	TRBJ1-3
TGTGCCAGCTCACCGACCCCGGCAGACTATGGCTACACCTTC	CASSPTPADYGYTF	TRBV18	TRBJ1-2
TGTGCCAGCAGCGTACAGCCTGCTCCCTACGAGCAGTACTTC	CASSVQPAPYEQYF	TRBV9	TRBJ2-7
TGCGCCAGCAGCCAACCGCAGACTCGGCCCCAGCATTTT	CASSQPQTRPQHF	TRBV4-3	TRBJ1-5
TGTGCCAGTCGAAAAACTAGCGGGAGAAAACTGTCCTCCTACGAGCAGTACTTC	CASRKTSGRKLSSYEQYF	TRBV27	TRBJ2-7
TGTGCCAGCTTCAAGAAATCCGGGGGAGGTACTAGTCCGGGATACGAGCAGTACTTC	CASFKKSGGGTSPGYEQYF	TRBV18	TRBJ2-7
TGCAGTGCTAGAGATCTGGGGAACCCCGTACCCTCTGCTAAAGATACGCAGTATTTT	CSARDLGNPVPSAKDTQYF	TRBV20-1	TRBJ2-3
TGTGCCAGCAGCCAAGATGGCTGTGGGGTCGCCTCCTACGAGCAGTACTTC	CASSQDGCGVASYEQYF	TRBV14	TRBJ2-7
TGTGCCAGCAGCCACAGGGGGGGCGAAGGCCCCGTCTCCTACGAGCAGTACTTC	CASSHRGGEGPVSYEQYF	TRBV7-9	TRBJ2-7
TGTGCCATCAGTGAGGGGACTTCTTCAGGGGGCCTCGAGCAGTACTTC	CAISEGTSSGGLEQYF	TRBV10-3	TRBJ2-7
TGCGCCAGCAGTCGGACTAGCGGGACTAGCACAGATACGCAGTATTTT	CASSRTSGTSTDTQYF	TRBV10-1	TRBJ2-3
TGTGCCAGCAGCTCCCCACCAACGGGGGATAATGAAAAACTGTTTTTT	CASSSPPTGDNEKLFF	TRBV7-6	TRBJ1-4
TGTGCCAGCAGCTTTGTAAGGCGAGATACGCAGTATTTT	CASSFVRRDTQYF	TRBV5-4	TRBJ2-3
TGTGCCAGCAGCATCTACGGGTTGGACTACGAGCAGTACTTC	CASSIYGLDYEQYF	TRBV7-2	TRBJ2-7
TGTGCCAGCCCTGGACTAGCGGGTGTGGATAATACAGATACGCAGTATTTT	CASPGLAGVDNTDTQYF	TRBV6-4	TRBJ2-3
TGTGCCAGCAGGGGGTCCAGCACGGGGGGGGGGGCCAACGTCCTGACTTTC	CASRGSSTGGGANVLTF	TRBV6-2	TRBJ2-6
TGTGCCATCACCCTTACTGGGGCCAACGTCCTGACTTTC	CAITLTGANVLTF	TRBV10-3	TRBJ2-6
TGTGCCATCAGTCCGGGACCCAAAAACATTCAGTACTTC	CAISPGPKNIQYF	TRBV10-3	TRBJ2-4
TGTGCCAGCAATGACAGGGAGGGAGATGAGCAGTTCTTC	CASNDREGDEQFF	TRBV12-3	TRBJ2-1
TGCGCCAGCAGCTTGTGGGGCGTGAAGGGGTTTATAGCCAAAAACATTCAGTACTTC	CASSLWGVKGFIAKNIQYF	TRBV5-1	TRBJ2-4
TGTGCCAGCAGACTCAACTGCAAAGGGGGGGGGAGGACCACAGATACGCAGTATTTT	CASRLNCKGGGRTTDTQYF	TRBV7-3	TRBJ2-3
TGTGCCAGTAGTTGCGGGCAGTGGAGGTATGGCTACACCTTC	CASSCGQWRYGYTF	TRBV19	TRBJ1-2
TGTGCCAGCAGGCTTGGGAGGTCCGGGATTGAGCAGTTCTTC	CASRLGRSGIEQFF	TRBV7-8	TRBJ2-1
TGTGCCAGCAGTTTATCGCTGGCGGGGACGGATCAGCCCCAGCATTTT	CASSLSLAGTDQPQHF	TRBV27	TRBJ1-5
TGTGCCAGCATAGGGGGGAATCTAGGTGGTGGCTACACCTTC	CASIGGNLGGGYTF	TRBV25-1	TRBJ1-2
TGTGCCAGCAGCAGAAGGGTCGGGACAGTGTATGACCCTCTGGTCCTCAGTATATATGAGCAGTTCTTC	CASSRRVGTVYDPLVLSIYEQFF	TRBV7-3	TRBJ2-1
TGCGCCAGCAGTGACCCTTCTCAGCGGGGCAATGAGCAGTTCTTC	CASSDPSQRGNEQFF	TRBV10-1	TRBJ2-1
TGTGCCAGCAGCCACTCACAGGGGGGTGGAAACACCATATATTTT	CASSHSQGGGNTIYF	TRBV13	TRBJ1-3
TGTGCCAGCAGTGGGACAGGGAACACCGGGGAGCTGTTTTTT	CASSGTGNTGELFF	TRBV25-1	TRBJ2-2
TGCAGTGCTCCTGGACAGACAAGATATAAAAAGTACTATGGCTACACCTTC	CSAPGQTRYKKYYGYTF	TRBV20-1	TRBJ1-2
TGTGCCAGCAGCCGGAGGGGGGCCAAAAACATTCAGTACTTC	CASSRRGAKNIQYF	TRBV13	TRBJ2-4
TGTGCCACGCGGGAGGGACTGAATGAGCAGTTCTTC	CATREGLNEQFF	TRBV24-1	TRBJ2-1
TGTGCCAGCCCTCTACCCTATGGCTACACCTTC	CASPLPYGYTF	TRBV14	TRBJ1-2
TGTGCCATCAGCGAGGTTACGCCCTCAAGTATTCCCTACGAGCAGTACTTC	CAISEVTPSSIPYEQYF	TRBV10-3	TRBJ2-7
TGCAGTGCCCGGGAGGGGTATGCCTACGAGCAGTACTTC	CSAREGYAYEQYF	TRBV20-1	TRBJ2-7
TGTGCCAGCAGCGGACTACACGAGCAGTACTTC	CASSGLHEQYF	TRBV5-6	TRBJ2-7
TGCAGTGCTAGAGATCGTACCGAAGGGAGTACTCCCGGGGACGAGCAGTACTTC	CSARDRTEGSTPGDEQYF	TRBV20-1	TRBJ2-7
TGTGCCAGCAGGTCATGGGACAGGGAGTCAGTAAATTCACCCCTCCACTTT	CASRSWDRESVNSPLHF	TRBV6-2	TRBJ1-6
TGTGCCAGGTCCCCAGACAGGGAGGGAGGTAACACTGAAGCTTTCTTT	CARSPDREGGNTEAFF	TRBV7-8	TRBJ1-1
TGTGCCAGCAGTTACTCGAAGGGACGTTACGAGCAGTACTTC	CASSYSKGRYEQYF	TRBV6-2	TRBJ2-7
TGTGCCAGCAGTTACGGAGACCTGGGGGCCCCGAGGTGGCACGAGCAGTACTTC	CASSYGDLGAPRWHEQYF	TRBV6-5	TRBJ2-7
TGTGCCACCTGTTGCGGGGCGATGGGGACCGGGGAGCTGTTTTTT	CATCCGAMGTGELFF	TRBV12-4	TRBJ2-2
TGCAGTGCGACGACTGCCTACGAGCAGTACTTC	CSATTAYEQYF	TRBV20-1	TRBJ2-7
TGCGCCAGCAGCCGACTAAGAGACTCCTACGAGCAGTACTTC	CASSRLRDSYEQYF	TRBV4-1	TRBJ2-7
TGTGCCAGCAGTGACTCAAGGGACAGGGGGAGGACTGAAGCTTTCTTT	CASSDSRDRGRTEAFF	TRBV6-4	TRBJ1-1
TGTGCCAGCCGGGGGCCCCGTCCAGGGAGGGATACGCAGTATTTT	CASRGPRPGRDTQYF	TRBV28	TRBJ2-3
TGTGCCAACGCCCCACCGTGGCAGTATTTT	CANAPPWQYF	TRBV18	TRBJ2-3
TGTGCCAGCAGCGGCTCGAAGTCGTACGTC	CASSGSKSYV	TRBV13	TRBJ2-7
TGTGCCAGCAGTTTAGGGCGTCAGGGTAATGAAAAACTGTTTTTT	CASSLGRQGNEKLFF	TRBV12-3	TRBJ1-4
TGTGCCAGCAGCGTAGGGCGTACCCTGATTTACGAGCAGTACTTC	CASSVGRTLIYEQYF	TRBV9	TRBJ2-7
TGTGCCAGCAGCGCTGAAAACTATGGCTACACCTTC	CASSAENYGYTF	TRBV13	TRBJ1-2
TGTGCCAGCAGCCCCTCGCTCTCCTACGAGCAGTACTTC	CASSPSLSYEQYF	TRBV11-2	TRBJ2-7
TGTGCCAGCCCACGGGAGGACGAGGGGATTCGTGGCTACACCTTC	CASPREDEGIRGYTF	TRBV6-5	TRBJ1-2
TGCAGCTCTGCGTACAATGAGCAGTTCTTC	CSSAYNEQFF	TRBV29-1	TRBJ2-1
TGTGCCAGCAGCCCCCGGCCGGGACAGGGTCGCTATGGCTACACCTTC	CASSPRPGQGRYGYTF	TRBV14	TRBJ1-2
TGTGCCAGCAGCTACAAGTCGCAGGGACGTGAAGCTTTCTTT	CASSYKSQGREAFF	TRBV7-3	TRBJ1-1
TGTGCCAGCAGTTACTCCAGGGGGCGCCAACGGGGAGCAGATACGCAGTATTTT	CASSYSRGRQRGADTQYF	TRBV6-2	TRBJ2-3
TGTGCCAGCAGCAACCACGGGGGGGGGCCTTCCGGGGAGCTGTTTTTT	CASSNHGGGPSGELFF	TRBV13	TRBJ2-2
TGTGCCAGCAGGGTAGGGGAGGGAGAGACCCAGTACTTC	CASRVGEGETQYF	TRBV13	TRBJ2-5
TGTGCCAAGACATTCGATGAAAAACTGTTTTTT	CAKTFDEKLFF	TRBV6-5	TRBJ1-4
TGTGCCAGCAGCTTAGCATTAGAAGGGGACGGGCAAGAGACCCAGTACTTC	CASSLALEGDGQETQYF	TRBV7-7	TRBJ2-5
TGTGCCAGTAGTATTTTTAATGGATCAGCGGGACATTTAGGCTACACCTTC	CASSIFNGSAGHLGYTF	TRBV19	TRBJ1-2
TGTGCCACCAGTGATTTGCACCAGTATCCCCCCGAGATGGGGGCCAACGTCCTGACTTTC	CATSDLHQYPPEMGANVLTF	TRBV24-1	TRBJ2-6
TGTGCCAGCAGTGACTCCCCCCGCTGGGGGGGCCGGACCTACAATGAGCAGTTCTTC	CASSDSPRWGGRTYNEQFF	TRBV6-4	TRBJ2-1
TGTGCCAGCAGCGCCCGGACTAGCGGGGGGTCCTACGAGCAGTACTTC	CASSARTSGGSYEQYF	TRBV7-6	TRBJ2-7
TGTGCCAGCAGTTACACATGCAGGGTACACTACAATGAGCAGTTCTTC	CASSYTCRVHYNEQFF	TRBV6-6	TRBJ2-1
TGTGCCAGCAGCCAAGAGTCCCAACTAGGGTCGAGCTCCTACAATGAGCAGTTCTTC	CASSQESQLGSSSYNEQFF	TRBV4-2	TRBJ2-1
TGTGCCCAGTTACAGGGTGGTCAGCCCCAGCATTTT	CAQLQGGQPQHF	TRBV28	TRBJ1-5
TGTGCCAGCATAGACAGCGGGAACACTGAAGCTTTCTTT	CASIDSGNTEAFF	TRBV27	TRBJ1-1
TGTGCCAGCAGCCACAACGGGGAAACGGAAAATGAGCAGTTCTTC	CASSHNGETENEQFF	TRBV14	TRBJ2-1
TGTGCCATCAGTGACGGTAAAGACAGGGCTCAGAATGTCGATAACTATGGCTACACCTTC	CAISDGKDRAQNVDNYGYTF	TRBV10-3	TRBJ1-2
TGTGCCAGCAGCGCCCGGGTTGGGGGGAGACACTCCTCCTACGAGCAGTACTTC	CASSARVGGRHSSYEQYF	TRBV7-3	TRBJ2-7
TGTGCCAGCAGTGAAGGCTCCCTAGCGTCAGGGCAGACCACAGATACGCAGTATTTT	CASSEGSLASGQTTDTQYF	TRBV6-1	TRBJ2-3
TGTGCCAGCAGCTGGAGACATCAGACCCAGTACTTC	CASSWRHQTQYF	TRBV5-4	TRBJ2-5
TGTGCCACCACTCGGACAGATTTCAAGGATACGCAGTATTTT	CATTRTDFKDTQYF	TRBV24-1	TRBJ2-3
TGCGCCAGCAGCTTTCGGCGGCTGATGATCATCTATACTGAAGCTTTCTTT	CASSFRRLMIIYTEAFF	TRBV5-1	TRBJ1-1
TGTGCCAGGAGGGGGTGGGCCTCTGTAGTTCCCTACGAGCAGTACTTC	CARRGWASVVPYEQYF	TRBV5-6	TRBJ2-7
TGTGCCAGCAGCAGGCGGGAAAGGTGCAATCAGCCCCAGCATTTT	CASSRRERCNQPQHF	TRBV7-9	TRBJ1-5
TGTGCCAGTACGCTTAGCGGGATCGCTCAAGAGACCCAGTACTTC	CASTLSGIAQETQYF	TRBV19	TRBJ2-5
TGTGCCAGCAGCTTACATAGCTTCCCCAGGGGGGACAGGGAGAAGTTGAACACTGAAGCTTTCTTT	CASSLHSFPRGDREKLNTEAFF	TRBV7-9	TRBJ1-1
TGTGCTAGCAGCCAACGACCTGCGACTGGAAACACCATATATTTT	CASSQRPATGNTIYF	TRBV7-7	TRBJ1-3
TGTGCCAGCAGTGAAGCGGTCCCCATGAACACTGAAGCTTTCTTT	CASSEAVPMNTEAFF	TRBV6-1	TRBJ1-1
TGTGCCTGGAGGAACTCCGCTCCAGGTCTGAACACTGAAGCTTTCTTT	CAWRNSAPGLNTEAFF	TRBV30	TRBJ1-1
TGTGCGTTGGGACAGCATATTAGCAATCAGCCCCAGCATTTT	CALGQHISNQPQHF	TRBV6-4	TRBJ1-5
TGTGCCAGCAGTTACTCGAGGAATACCCGGGACAAAGAGACCCAGTACTTC	CASSYSRNTRDKETQYF	TRBV6-5	TRBJ2-5
TGTGCCAGCAGTTGGCTAAGGGTGGGACAGAGAATGGACTATGGCTACACCTTC	CASSWLRVGQRMDYGYTF	TRBV27	TRBJ1-2
TGTGCCAGCAGCTTAGATCTACGGGAGAACACTGAAGCTTTCTTT	CASSLDLRENTEAFF	TRBV7-2	TRBJ1-1
TGTGCCAGCAGCCAACAGACTAGCGGGAGGGGAACCGGGGAGCTGTTTTTT	CASSQQTSGRGTGELFF	TRBV7-3	TRBJ2-2
TGCGCCAGCAGCCAAGATATCTCAATGAGGGAAGGCGGCTGCTACGAGCAGTACTTC	CASSQDISMREGGCYEQYF	TRBV4-1	TRBJ2-7
TGTGCCAGCAGTCCCCCAACACAGGGATATGCAACTAATGAAAAACTGTTTTTT	CASSPPTQGYATNEKLFF	TRBV27	TRBJ1-4
TGTGGACCGGACAGGGGGCGGTTTGGCTACACCTTC	CGPDRGRFGYTF	TRBV30	TRBJ1-2
TGTGCCTGGGGGGCAGAGGGCTCGAACACCGGGGAGCTGTTTTTT	CAWGAEGSNTGELFF	TRBV10-3	TRBJ2-2
TGTGCCAGCAGCTTCGGGGACAGGGGCACCGGGGAGCTGTTTTTT	CASSFGDRGTGELFF	TRBV5-4	TRBJ2-2
TGTGCCAGTAGTGCGTGGGACCTGTTTCAGCCCCAGCATTTT	CASSAWDLFQPQHF	TRBV19	TRBJ1-5
TGTGCCAGCAGTGAATACTCTAACTCGGGGGGCTTATTTGAAAAACTGTTTTTT	CASSEYSNSGGLFEKLFF	TRBV25-1	TRBJ1-4
TGTGCCAGCAGCTGGGGTAAAGAATACACTGAAGCTTTCTTT	CASSWGKEYTEAFF	TRBV7-8	TRBJ1-1
TGCGCCAGCAGCTTGGGTTCACTCGGGACAGGGGGTCGAGGCAATCAGCCCCAGCATTTT	CASSLGSLGTGGRGNQPQHF	TRBV5-1	TRBJ1-5
TGTGCCAGTGACAGGAGCGGCTACGAGCAGTACTTC	CASDRSGYEQYF	TRBV6-2	TRBJ2-7
TGTGCCACCGGACGACGAATTCGGACCTCTGGAAACACCATATATTTT	CATGRRIRTSGNTIYF	TRBV15	TRBJ1-3
TGTGCCAGCATCGGAGGCTACGAGCAGTACTTC	CASIGGYEQYF	TRBV6-1	TRBJ2-7
TGTGCCAGCAGCCCAGACGGGAAACGGGGGGCCGCCAACAATGAGCAGTTCTTC	CASSPDGKRGAANNEQFF	TRBV14	TRBJ2-1
TGTGCCAGCAGTGAAACTAGGGAATTGAACACTGAAGCTTTCTTT	CASSETRELNTEAFF	TRBV28	TRBJ1-1
TGCAGCGTTGCCGACCCGGGGGTCATTTGGGGAAACGAGCAGTACTTC	CSVADPGVIWGNEQYF	TRBV29-1	TRBJ2-7
TGCGCCAGCAGTGAGTCGTCCCGGGACAGGGGGAGGACTGAAGCTTTCTTT	CASSESSRDRGRTEAFF	TRBV10-1	TRBJ1-1
TGTGCCAGCAGCCTAGCGGGAGAGACCCAGTACTTC	CASSLAGETQYF	TRBV7-4	TRBJ2-5
TGTGCCAGCGACGCCCCCTGGGACAGTTCCTACGAGCAGTACTTC	CASDAPWDSSYEQYF	TRBV7-3	TRBJ2-7
TGTGCCAGCAGCAGTGTCCCGCGACGGGGAGGCTACACCTTC	CASSSVPRRGGYTF	TRBV13	TRBJ1-2
TGTGCCAGCAGCCAACTTAAGAGGGTCCCCAGGGGAGGGGACGAGGAGCAGTACTTC	CASSQLKRVPRGGDEEQYF	TRBV4-2	TRBJ2-7
TGCAGTGCGGCGACAGGGAGGACTGAAGCTTTCTTT	CSAATGRTEAFF	TRBV20-1	TRBJ1-1
TGCGCCAGCAGTGAGTTTCGGCCTGCCTCTAGATTTAGGAACACAGATACGCAGTATTTT	CASSEFRPASRFRNTDTQYF	TRBV10-1	TRBJ2-3
TGTGCCGCAGGAGGACTAGCGCAAAATCTATATTTGTACAATGAGCAGTTCTTC	CAAGGLAQNLYLYNEQFF	TRBV15	TRBJ2-1
TGCGCCAGCAGCCAAGACTTGGACCCCGAAAAACTGTTTTTT	CASSQDLDPEKLFF	TRBV4-1	TRBJ1-4
TGTGCCAGCAGCCCCAGGGACCTTACTAATGAAAAACTGTTTTTT	CASSPRDLTNEKLFF	TRBV13	TRBJ1-4
TGTGCCACCCCCCCAACGGGGGTGGTCCAGCCCCAGCATTTT	CATPPTGVVQPQHF	TRBV24-1	TRBJ1-5
TGTGCCAGCAGCGGTATGGCCCCCAGGGAAACCCCAACTTCGGAGACAAATGAGCAGTTCTTC	CASSGMAPRETPTSETNEQFF	TRBV5-4	TRBJ2-1
TGCAGTGCTAGACAAACCAGGGTAAAGTCCTACGAGCAGTACTTC	CSARQTRVKSYEQYF	TRBV20-1	TRBJ2-7
TGTGCCAGCAGCCAAGACCCCATAAGGGACAGGGCTGCCCAAGAGACCCAGTACTTC	CASSQDPIRDRAAQETQYF	TRBV3-1	TRBJ2-5
TGTGCCAGCAGTTTAATCGGGACAGGGGTAGCCTACGAGCAGTACTTC	CASSLIGTGVAYEQYF	TRBV28	TRBJ2-7
TGTGCCAGAAAACTTACGGAGGATGAAAAACTGTTTTTT	CARKLTEDEKLFF	TRBV6-2	TRBJ1-4
TGTTTGCTACCGACTAGGGGACCGACCGGGGAGCTGTTTTTT	CLLPTRGPTGELFF	TRBV30	TRBJ2-2
TGTGCCAGCAGTAAGCCTGGAGTCGGGTACCAGCCCCAGCATTTT	CASSKPGVGYQPQHF	TRBV5-6	TRBJ1-5
TGTGCCAGTAGTATCCTCCTTGACAGGGCCCCGAAAGGCTACACCTTC	CASSILLDRAPKGYTF	TRBV19	TRBJ1-2
TGTGCCTGGAGCAGGGCTGACTTC	CAWSRADF	TRBV30	TRBJ2-7
TGTGCCAGCCCCTTGACGGTCGTGAACTATGGCTACACCTTC	CASPLTVVNYGYTF	TRBV6-1	TRBJ1-2
TGTGCCAGCGTCCTCGCGAATGAGCAGTTCTTC	CASVLANEQFF	TRBV7-3	TRBJ2-1
TGTGCCAGCAGCCGAAGCCCGGGACTGAGTGCCGGCACCGGGGAGCTGTTTTTT	CASSRSPGLSAGTGELFF	TRBV6-3	TRBJ2-2
TGTGCTAGTGGTTTGGTCGGAGGGGGCGGTAAAACATATGGCTACACCTTC	CASGLVGGGGKTYGYTF	TRBV12-5	TRBJ1-2
TGTGCTAGTGGTTTGATCATGAATAATCCACCGAGACAGTTTAACGAGCAGTACTTC	CASGLIMNNPPRQFNEQYF	TRBV12-5	TRBJ2-7
TGTGCCAGCAGCTCACACAGGGACCACTATGGCTACACCTTC	CASSSHRDHYGYTF	TRBV7-9	TRBJ1-2
TGTGCGGCGGAGGTAACAACCGTGGAGGCGGGGCGGGAGACCCAGTACTTC	CAAEVTTVEAGRETQYF	TRBV7-6	TRBJ2-5
TGCAGTGCACACCCTAGCGGGAGATTTATCGCGAACACCGGGGAGCTGTTTTTT	CSAHPSGRFIANTGELFF	TRBV20-1	TRBJ2-2
TGCAGCGGTAGCCAAGTCGGGGCGACAGAGGACGAGCAGTACTTC	CSGSQVGATEDEQYF	TRBV29-1	TRBJ2-7
TGTGCCAGCAGCTCGTATATCGCACAGGTTAACTATGGCTACACCTTC	CASSSYIAQVNYGYTF	TRBV5-6	TRBJ1-2
TGTGCCAGCAGCTTGTCCCCTGGACTTAGCTCCTACAATGAGCAGTTCTTC	CASSLSPGLSSYNEQFF	TRBV5-5	TRBJ2-1
TGTGCCAGCAGCGCCAGGGGGGTGCTCTGCTGCCATCAGCCCCAGCATTTT	CASSARGVLCCHQPQHF	TRBV9	TRBJ1-5
TGTGCCAGTAGTCCACGCTCCACATCTGAAAAACTGTTTTTT	CASSPRSTSEKLFF	TRBV19	TRBJ1-4
TGTGCCAGCAGCCCTATACAGGGGACTGAATTTAACACTGAAGCTTTCTTT	CASSPIQGTEFNTEAFF	TRBV6-1	TRBJ1-1
TGTGCCAGCTCACCGTCCAAACCCACGGACAGGGGCTGGGAAAAACTGTTTTTT	CASSPSKPTDRGWEKLFF	TRBV18	TRBJ1-4
TGTGCCAGCAGTTTAGTATTGACTAGCAAACCCCAAGAGACCCAGTACTTC	CASSLVLTSKPQETQYF	TRBV12-4	TRBJ2-5
TGTGCCAGCAGCTTAGCCACTGACCGTCAGCCCCAGCATTTT	CASSLATDRQPQHF	TRBV7-9	TRBJ1-5
TGTGCTAGTGGTTTGCCCCCCCTCTTCCTCGTTGGTGAAGCTTTCTTT	CASGLPPLFLVGEAFF	TRBV12-5	TRBJ1-1
TGTGCCAGCAGCCCAGACAGGGGTTCCCAGCATTTT	CASSPDRGSQHF	TRBV3-1	TRBJ1-5
TGTGCCAGCACGTTGCCCAAAGTGGGACAGGGACAAGCCCCTAATGAAAAACTGTTTTTT	CASTLPKVGQGQAPNEKLFF	TRBV7-9	TRBJ1-4
TGTGCCAGCAGCCCCAGGGGGGGCCGACACGAGCAGTACTTC	CASSPRGGRHEQYF	TRBV7-9	TRBJ2-7
TGTGCCAGCAGCAGGGCACGCAGCAATCAGCCCCAGCATTTT	CASSRARSNQPQHF	TRBV9	TRBJ1-5
TGTGCCAGCAGTCTAACAAAACACAGGGTCAGATGCTCCTACGAGCAGTACTTC	CASSLTKHRVRCSYEQYF	TRBV28	TRBJ2-7
TGCGCCAGCAGTGAGGGGCATACAAATCAGCCCCAGCATTTT	CASSEGHTNQPQHF	TRBV10-1	TRBJ1-5
TGTGCCAGCAGACCGGGGTCCCAGGGGAGCGAGACCCAGTACTTC	CASRPGSQGSETQYF	TRBV2	TRBJ2-5
TGTGCCGACAGGCATTTCACTGAAGCTTTCTTT	CADRHFTEAFF	TRBV10-3	TRBJ1-1
TGTGCCACCAGTGATTTTGGAATCACTAGCGGGAGGAACACTGAAGCTTTCTTT	CATSDFGITSGRNTEAFF	TRBV24-1	TRBJ1-1
TGCAGTGCTAGCCCCGCAGGGCCTCCGCATCAGCCCCAGCATTTT	CSASPAGPPHQPQHF	TRBV20-1	TRBJ1-5
TGTGCCAGCAGCCCTCGAAATGAAGAGACCCAGTACTTC	CASSPRNEETQYF	TRBV3-1	TRBJ2-5
TGCGCCAGGGTGACAGGGGGCTCCGTGGAGGTGGACGGCTACACCTTC	CARVTGGSVEVDGYTF	TRBV10-1	TRBJ1-2
TGCAGCGTTGGGGGGGGTCTTGGGTACAATGAGCAGTTCTTC	CSVGGGLGYNEQFF	TRBV29-1	TRBJ2-1
TGCGCCAGCAGCCAACCCGAGAGGAGCTATGGCTACACCTTC	CASSQPERSYGYTF	TRBV4-1	TRBJ1-2
TGCGCCAGCAACCGTACTAGCGGGAGCAGCAATCAGCCCCAGCATTTT	CASNRTSGSSNQPQHF	TRBV10-1	TRBJ1-5
TGCAGTGCTAGGTACGAGGGGGCAGATACGCAGTATTTT	CSARYEGADTQYF	TRBV20-1	TRBJ2-3
TGCAGTGCTAGAGATACCCGCACACGGTTCGAGACCCAGTACTTC	CSARDTRTRFETQYF	TRBV20-1	TRBJ2-5
TGTGCCAGCAGTGAAGCTCCGCCAGGGACAGGGGTAGCCCAGTACTTC	CASSEAPPGTGVAQYF	TRBV2	TRBJ2-5
TGTGCCACCAGCAGAGATTCGTTTACATCGGCCTCTGGAAACACCATATATTTT	CATSRDSFTSASGNTIYF	TRBV15	TRBJ1-3
TGCGCCAGCACGAGTTTCCCCGGGAGGGGGGATCGAGCAAAACTGTTTTTT	CASTSFPGRGDRAKLFF	TRBV10-2	TRBJ1-4
TGTGCCAGCAGCTTAGGAAATGAGCAGTTCTTC	CASSLGNEQFF	TRBV5-4	TRBJ2-1
TGCGCCAGCAGCCAAGAGACAGGGGCTAACTATGGCTACACCTTC	CASSQETGANYGYTF	TRBV4-1	TRBJ1-2
TGTGCCAGCAGGCCCTTACCTGGCTACACCTTC	CASRPLPGYTF	TRBV2	TRBJ1-2
TGTGCCAGCAGTTCGTTGTCACTAGCGGGAGGTCTATACACCGGGGAGCTGTTTTTT	CASSSLSLAGGLYTGELFF	TRBV28	TRBJ2-2
TGTGCCAGCATCCAGAACTCCTGGAAGTACGAGCAGTACTTC	CASIQNSWKYEQYF	TRBV28	TRBJ2-7
TGTGCCAGCAGCGAAAAGCGGGACAGCGAGCAGTACTTC	CASSEKRDSEQYF	TRBV13	TRBJ2-7
TGTGCCAGCAGCGACGGGACTCTCTCCTACAATGAGCAGTTCTTC	CASSDGTLSYNEQFF	TRBV9	TRBJ2-1
TGTGCCAGCAGCTCTAGATCCGGGACTCAGAATGAGCAGTTCTTC	CASSSRSGTQNEQFF	TRBV7-6	TRBJ2-1
TGTGCCAGCAGTTTAATGGCCAGCACTTCGAACACTGAAGCTTTCTTT	CASSLMASTSNTEAFF	TRBV28	TRBJ1-1
TGTGCCAGGGGCACAGGGGGCTCTGGAAACACCATATATTTT	CARGTGGSGNTIYF	TRBV19	TRBJ1-3
TGTGCCAGGCGGGGGGGCGCGTCCACCGGGGAGCTGTTTTTT	CARRGGASTGELFF	TRBV25-1	TRBJ2-2
TGCGCCAGCAGCCCTATTTGCCCGAAACAGGACCCGGCCTCTGGGGCCAACGTCCTGACTTTC	CASSPICPKQDPASGANVLTF	TRBV5-1	TRBJ2-6
TGTGCCAGCAGTGAAGCGCTTCCTACACGGGACAGCTTTCAGCCCCAGCATTTT	CASSEALPTRDSFQPQHF	TRBV2	TRBJ1-5
TGTGCCAGCCGGGTCGATGGTTTCTATGGCTACACCTTC	CASRVDGFYGYTF	TRBV6-3	TRBJ1-2
TGTGCCAGCAGTTCTGAAACTAATGAAAAACTGTTTTTT	CASSSETNEKLFF	TRBV6-5	TRBJ1-4
TGTGCCAGCAGCCACTCCGTTACACTTCTTACAGGGCGGTCAGACGAGCAGTACTTC	CASSHSVTLLTGRSDEQYF	TRBV9	TRBJ2-7
TGTGCCAGCAGTGACTCGAGGCCTTGGGGGAAGCAGGGCTTAAAGTCCTACGAGCAGTACTTC	CASSDSRPWGKQGLKSYEQYF	TRBV6-4	TRBJ2-7
TGTGCCAGCAGCGTCCGGCGACTAGCGGGAGTGGGTACCCAGTACTTC	CASSVRRLAGVGTQYF	TRBV9	TRBJ2-5
TGCAGTGCGTCCTTTTCCGGGACAGGACCCAATTCACCCCTCCACTTT	CSASFSGTGPNSPLHF	TRBV20-1	TRBJ1-6
TGTGCCATCAGTCAGTGGACTGACTATGGCTACACCTTC	CAISQWTDYGYTF	TRBV10-3	TRBJ1-2
TGTGCCAGCAGCCCCGACAGGAGAGGGAACACCGGGGAGCTGTTTTTT	CASSPDRRGNTGELFF	TRBV5-6	TRBJ2-2
TGCGCCAGCAGGCGACGGAACCGCAACCCAGGGAACACCGGGGAGCTGTTTTTT	CASRRRNRNPGNTGELFF	TRBV4-1	TRBJ2-2
TGCGCCAGCAGTGAGGTCGGGGGGAGTCTCTACGAGCAGTACTTC	CASSEVGGSLYEQYF	TRBV10-2	TRBJ2-7
TGCGCCAGCCGGGGACGGACTGAAGCTTTCTTT	CASRGRTEAFF	TRBV5-1	TRBJ1-1
TGTGCCAGCACTCTACAGGGGGGCTCCTATAATTCACCCCTCCACTTT	CASTLQGGSYNSPLHF	TRBV7-8	TRBJ1-6
TGTGCCAGCAGTTACTCCCGGTTTGATGGGACAGCTTTCCAAGAGACCCAGTACTTC	CASSYSRFDGTAFQETQYF	TRBV6-5	TRBJ2-5
TGTGCCGGCCGGGGGCCCCTCGAGCAGTACTTC	CAGRGPLEQYF	TRBV6-2	TRBJ2-7
TGTGCCAGCAGCCCCTCGGGACAGTGTGGCTACACCTTC	CASSPSGQCGYTF	TRBV13	TRBJ1-2
TGCGCCAGCACAAAACCTATGTGCGGCTACACCTTC	CASTKPMCGYTF	TRBV5-1	TRBJ1-2
TGTGCCAGCAGCTTGAGCCCGGACCTGGGCACAGATACGCAGTATTTT	CASSLSPDLGTDTQYF	TRBV5-8	TRBJ2-3
TGTGCCAGCAGTAACAGGTCGGCCACCTATGGCTACACCTTC	CASSNRSATYGYTF	TRBV7-6	TRBJ1-2
TGTGCCAGCAGCTCGACCAACTATGGCTACACCTTC	CASSSTNYGYTF	TRBV7-4	TRBJ1-2
TGTGCCACCAGCAGAGATGTACTCTTCAATCAGCCCCAGCATTTT	CATSRDVLFNQPQHF	TRBV15	TRBJ1-5
TGTGCCAGCACTGGGGACGGCAATCAGCCCCAGCATTTT	CASTGDGNQPQHF	TRBV6-5	TRBJ1-5
TGTGCCAGCAGCTTAGTTCTAGCGGGCCCGGAGGGTCATGAGCAGTTCTTC	CASSLVLAGPEGHEQFF	TRBV7-9	TRBJ2-1
TGCGCCAGCAGCTATTCCACCAGGACCTATGGCTACACCTTC	CASSYSTRTYGYTF	TRBV5-1	TRBJ1-2
TGTGCCAGCAGTTACCGCCCACAGGGCGGTAGCAATCAGCCCCAGCATTTT	CASSYRPQGGSNQPQHF	TRBV6-5	TRBJ1-5
TGTGCCAGCTCACCTACTTCAGACACAGATACGCAGTATTTT	CASSPTSDTDTQYF	TRBV18	TRBJ2-3
TGTGCCAGCAGCGGGGGGGTGAATAGATACAATGAGCAGTTCTTC	CASSGGVNRYNEQFF	TRBV6-5	TRBJ2-1
TGTGCCAGCAGGTGCTGTCGGTCTAATGAAAAACTGTTTTTT	CASRCCRSNEKLFF	TRBV5-6	TRBJ1-4
TGTGCCAGCAGCTTAGCAACAGGACATAACACCGGGGAGCTGTTTTTT	CASSLATGHNTGELFF	TRBV7-4	TRBJ2-2
TGTGCCAGCAGCCCAGCGGTGGACAAGAAGAATGAAAAACTGTTTTTT	CASSPAVDKKNEKLFF	TRBV7-9	TRBJ1-4
TGTGCCAGCAGCTTAGGTTGGGGGGGGGATCGCAGCACAGATACGCAGTATTTT	CASSLGWGGDRSTDTQYF	TRBV11-2	TRBJ2-3
TGCAGTGCTAGAAGTGGGGGGACCAATGAGCAGTTCTTC	CSARSGGTNEQFF	TRBV20-1	TRBJ2-1
TGCGCCAGCAGCTTGGCCTGTACCTACTATGGCTACACCTTC	CASSLACTYYGYTF	TRBV5-1	TRBJ1-2
TGTGCCTGGACCCCGGACAGTGAGCAGTACTTC	CAWTPDSEQYF	TRBV30	TRBJ2-7
TGTGCCAGCAGCAAAGGGAGGGATTATGAGCAGTTCTTC	CASSKGRDYEQFF	TRBV5-8	TRBJ2-1
TGTGCCAGCAGCTCAGAATGCTTGAGCAATCAGCCCCAGCATTTT	CASSSECLSNQPQHF	TRBV7-2	TRBJ1-5
TGTGCCAGCAGCTTTCGCAATAGACATGGCTACACCTTC	CASSFRNRHGYTF	TRBV11-3	TRBJ1-2
TGTGCCAGGGCGCAGTGGGCCCCGAACACTGAAGCTTTCTTT	CARAQWAPNTEAFF	TRBV28	TRBJ1-1
TGTGCCAGCAGCTGTCCGGACAGAGTTGGTAACAGCAATCAGCCCCAGCATTTT	CASSCPDRVGNSNQPQHF	TRBV11-2	TRBJ1-5
TGTGCCAGCAGCCAAGGATTTGGCCCAGGGTGCACAGATACGCAGTATTTT	CASSQGFGPGCTDTQYF	TRBV3-1	TRBJ2-3
TGTGCCAGCGGTGTTCTCCCCGAACCGGGACTAGGGGGAGCCAAAAACATTCAGTACTTC	CASGVLPEPGLGGAKNIQYF	TRBV28	TRBJ2-4
TGTGCCAGGACTCGGGTACGCTCTGGAAACACCATATATTTT	CARTRVRSGNTIYF	TRBV11-2	TRBJ1-3
TGTGCCAGCAGCTTAGTAGAAGGACGCACCGGGGAGCTGTTTTTT	CASSLVEGRTGELFF	TRBV11-3	TRBJ2-2
TGTGCCAGCAGTTACGAACAACCCTACGAGCAGTACTTC	CASSYEQPYEQYF	TRBV6-6	TRBJ2-7
TGTGCCATCATTACGTCAGGAAACACTGAAGCTTTCTTT	CAIITSGNTEAFF	TRBV10-3	TRBJ1-1
TGTGCCAGCAGTGACTCAGGTTTGGCCGGGGAGCTGTTTTTT	CASSDSGLAGELFF	TRBV6-4	TRBJ2-2
TGTGCCAGCAGTGACTCATGGGGAGGGTTTCCTGAAGCTTTCTTT	CASSDSWGGFPEAFF	TRBV6-4	TRBJ1-1
TGCGGTCCTGAGGCGCTGTTTCTGACAGGAGTGAACATTCAGTACTTC	CGPEALFLTGVNIQYF	TRBV10-1	TRBJ2-4
TGTGCCAGCAGAGGAGCAACTAATGAAAAACTGTTTTTT	CASRGATNEKLFF	TRBV27	TRBJ1-4
TGTGCCAGCAGGAAAGGGGGGGCCTCCTGCACAGATACGCAGTATTTT	CASRKGGASCTDTQYF	TRBV2	TRBJ2-3
TGTGCCACCAGTGTTGGATCGGAGACCCAGTACTTC	CATSVGSETQYF	TRBV24-1	TRBJ2-5
TGTGCCAGCAGCACCAAACGGATTGGAGGTAAGTATGGCTACACCTTC	CASSTKRIGGKYGYTF	TRBV13	TRBJ1-2
TGTGCCAGCAGCGCCTTCGTGGTAGCGGGTCCAACCTACGAGCAGTACTTC	CASSAFVVAGPTYEQYF	TRBV7-8	TRBJ2-7
TGTGCCAGCAGACTTCGGGAGCGGGATAAGAACACTGAAGCTTTCTTT	CASRLRERDKNTEAFF	TRBV6-5	TRBJ1-1
TGCGCCAGCAGCTTCCGAGAGAGGAACACTGAAGCTTTCTTT	CASSFRERNTEAFF	TRBV5-1	TRBJ1-1
TGTGCCAGCAGATCCCGAATTATGAACACTGAAGCTTTCTTT	CASRSRIMNTEAFF	TRBV5-8	TRBJ1-1
TGCAGTGCTAGGAAACGTGCCGACAATGAGCAGTTCTTC	CSARKRADNEQFF	TRBV20-1	TRBJ2-1
TGTGCCAGCAGCCCCGCCGGGGACGGACAGGGTACATCTGAAGCTTTCTTT	CASSPAGDGQGTSEAFF	TRBV5-6	TRBJ1-1
TGTGCTAGTGGGAAACCTACGGATAGACTAGCGGGCTACGAGCAGTACTTC	CASGKPTDRLAGYEQYF	TRBV12-5	TRBJ2-7
TGTGCCAGCAGTTACTCGACGTACTACGAGCAGTACTTC	CASSYSTYYEQYF	TRBV6-5	TRBJ2-7
TGTGCTAGGCAGGGGAACCGGTATCAGCCCCAGCATTTT	CARQGNRYQPQHF	TRBV6-4	TRBJ1-5
TGTGCCAGCCAGGGGGCCTACGAGCAGTACTTC	CASQGAYEQYF	TRBV13	TRBJ2-7
TGCGCCAGCAGGGGGGGGGCCACTAGCACAGATACGCAGTATTTT	CASRGGATSTDTQYF	TRBV5-1	TRBJ2-3
TGTGCCAGCAGCCAAGCCCATGGGGGGCTATGGGATCAGCCCCAGCATTTT	CASSQAHGGLWDQPQHF	TRBV3-1	TRBJ1-5
TGTGCCAGCTCTAAGCAGCGTGGCTACACCTTC	CASSKQRGYTF	TRBV18	TRBJ1-2
TGTGCCTTTCCCTCCCCCGTTTCCGGGGGGAGCAACAATGAGCAGTTCTTC	CAFPSPVSGGSNNEQFF	TRBV15	TRBJ2-1
TGTGCCAGCAGCCAAGTCGTGGGAGGCGGGAGTGGCAACACCGGGGAGCTGTTTTTT	CASSQVVGGGSGNTGELFF	TRBV3-1	TRBJ2-2
TGTGCCAGCAGCGTATCCGGGTGGGGGGGCGGCACCGGGGAGCTGTTTTTT	CASSVSGWGGGTGELFF	TRBV9	TRBJ2-2
TGTGCCAGCAGCTCGGGCAAGAACACTGAAGCTTTCTTT	CASSSGKNTEAFF	TRBV7-3	TRBJ1-1
TGCAGCGTTGGCCAAAGTGGTAGGGGGCCGGCGGAGTATGGCTACACCTTC	CSVGQSGRGPAEYGYTF	TRBV29-1	TRBJ1-2
TGTGCCAGCAGTGTCCCGGGACAGAGGGATGAGCAGTTCTTC	CASSVPGQRDEQFF	TRBV25-1	TRBJ2-1
TGTGCCACCAGTGAGGGATACCTCCTCGAGGTATGGGGAACTAACTATGGCTACACCTTC	CATSEGYLLEVWGTNYGYTF	TRBV24-1	TRBJ1-2
TGTGCCAGTACCCCGGGACAGGAGCCGCGAGAGACCCAGTACTTC	CASTPGQEPRETQYF	TRBV19	TRBJ2-5
TGTGCCAGCAGCGCGAGACAGGGGGCCCAGCATTTT	CASSARQGAQHF	TRBV9	TRBJ1-5
TGTGCCAGCAGCTTATCACATTGGCCGGCTGGAGAGACCCAGTACTTC	CASSLSHWPAGETQYF	TRBV7-9	TRBJ2-5
TGTGCCAGCAGTGACAGAAAACTAGCTGGCTACGAGCAGTACTTC	CASSDRKLAGYEQYF	TRBV6-4	TRBJ2-7
TGCAGCGTTGAGAAAACCAGGCGGGAGGGAAGCTATGGCTACACCTTC	CSVEKTRREGSYGYTF	TRBV29-1	TRBJ1-2
TGTGCCACCCTGACGCGGGAGCCTGACTATGGCTACACCTTC	CATLTREPDYGYTF	TRBV24-1	TRBJ1-2
TGTGCCAGCAGAGAAACAGGGGGGAATCTCACCGGGGAGCTGTTTTTT	CASRETGGNLTGELFF	TRBV11-3	TRBJ2-2
TGTGCCAGCAGGGAGCGGGAGACTAATGAAAAACTGTTTTTT	CASRERETNEKLFF	TRBV6-5	TRBJ1-4
TGTGCCCCTTGGACAGGTAGGCTTAACACCGGGGAGCTGTTTTTT	CAPWTGRLNTGELFF	TRBV19	TRBJ2-2
TGTGCCAGCGCTGACAGTGAGCAGTTCTTC	CASADSEQFF	TRBV25-1	TRBJ2-1
TGTGCCAGCAGTTATATAGAAAACCCGAGGGCACCAGATACGCAGTATTTT	CASSYIENPRAPDTQYF	TRBV27	TRBJ2-3
TGTGCCAGCTTCGGAGCGGGAGCCCCGCTAAGTTACGAGCAGTACTTC	CASFGAGAPLSYEQYF	TRBV7-9	TRBJ2-7
TGTGCCATCACCCCCCCTGCGGGAAACATTCAGTACTTC	CAITPPAGNIQYF	TRBV10-3	TRBJ2-4
TGTGCTAGCAGCTTACGCGATACTAGTGCTAACTCCTACAATGAGCAGTTCTTC	CASSLRDTSANSYNEQFF	TRBV7-7	TRBJ2-1
TGTGCCAGCAGTACAGGGCCGTATGGCTACACCTTC	CASSTGPYGYTF	TRBV28	TRBJ1-2
TGCACCGGGACAGGACAGGAGCAGTACTTC	CTGTGQEQYF	TRBV5-1	TRBJ2-7
TGTGCCAGCAGCAAAATATCAGGGCTAAGGCCCTTTGCTGAAGCTTTCTTT	CASSKISGLRPFAEAFF	TRBV7-3	TRBJ1-1
TGCAGTGCTAGAGCCATCCAGCCCATGAACACTGAAGCTTTCTTT	CSARAIQPMNTEAFF	TRBV20-1	TRBJ1-1
TGTGCCAGCAGCGTAGATAAAAACGACCCTGGAAAGGCCTACGAGCAGTACTTC	CASSVDKNDPGKAYEQYF	TRBV9	TRBJ2-7
TGTGCCACCAGCAGAGGGTTAGGGGGGCGGGATTTGCACGAGCAGTACTTC	CATSRGLGGRDLHEQYF	TRBV15	TRBJ2-7
TGTGCCAGCACCACGGGTTCACAGGGGCCCAATCAGCCCCAGCATTTT	CASTTGSQGPNQPQHF	TRBV27	TRBJ1-5
TGTGCCAGCAGTTTAGTAAACCCCAGGGACCCTGCAAAGCTTAATCAGCCCCAGCATTTT	CASSLVNPRDPAKLNQPQHF	TRBV27	TRBJ1-5
TGTGCCACCTCCGGGAGGGCCCTACACACTGAAGCTTTCTTT	CATSGRALHTEAFF	TRBV24-1	TRBJ1-1
TGTGCCTGGAGTGCCGGGGAGCTTTGGCACTATGGCTACACCTTC	CAWSAGELWHYGYTF	TRBV30	TRBJ1-2
TGTGCCAGCAGTACGGCGGGAGGTGGCTACACCTTC	CASSTAGGGYTF	TRBV6-2	TRBJ1-2
TGTGCCAGCAGTTCCTCACTAGCGGGGGGGCCGTTTTTCGCTAGCACAGATACGCAGTATTTT	CASSSSLAGGPFFASTDTQYF	TRBV27	TRBJ2-3
TGTGCCACCAGTGATCCACTCGACTACGAGCAGTACTTC	CATSDPLDYEQYF	TRBV24-1	TRBJ2-7
TGTGCCAGCAGCAGGAAGTCGACAACCATGTGGTGCTTAACTAATGAAAAACTGTTTTTT	CASSRKSTTMWCLTNEKLFF	TRBV13	TRBJ1-4
TGTGCCAGCAGTGGGACTCTCCCGAGGAATTCACCCCTCCACTTT	CASSGTLPRNSPLHF	TRBV6-1	TRBJ1-6
TGCAGTGCTAGAGCCAACGATGGACTAAAGAGAAACACCATATATTTT	CSARANDGLKRNTIYF	TRBV20-1	TRBJ1-3
TGTGCCAGCAGCCTAGAGGCTAGCGGGAACCCAAATGAGCAGTTCTTC	CASSLEASGNPNEQFF	TRBV7-9	TRBJ2-1
TGTGCCAGCAGTTTATCGCCTAGAGGGCTTCTGCCCGAAAAACTGTTTTTT	CASSLSPRGLLPEKLFF	TRBV27	TRBJ1-4
TGTGCCAGCAGAGATGGGACTGTGGACTCAGGGGATACAGATACGCAGTATTTT	CASRDGTVDSGDTDTQYF	TRBV6-1	TRBJ2-3
TGTGCCAGCAGTAAACAACCTCCGGGACTAGCGGGACCTTACAATGAGCAGTTCTTC	CASSKQPPGLAGPYNEQFF	TRBV6-2	TRBJ2-1
TGTGCCTGGAGGGCAGGGGGAAGCAATCAGCCCCAGCATTTT	CAWRAGGSNQPQHF	TRBV30	TRBJ1-5
TGTGCCCCGGGGAGCAATCAGCCCCAGCATTTT	CAPGSNQPQHF	TRBV9	TRBJ1-5
TGTGCCACCAGCGGTGTCGGGGGAGCGAGGCTAGCCAAAAACATTCAGTACTTC	CATSGVGGARLAKNIQYF	TRBV24-1	TRBJ2-4
TGTGCCAGCAGTGAAAGACCGACGGGGGGGCCAAAGGGAAACTCCTACAATGAGCAGTTCTTC	CASSERPTGGPKGNSYNEQFF	TRBV6-4	TRBJ2-1
TGCAGCGTTGAGCCCCAGCACCGTAACTATGGCTACACCTTC	CSVEPQHRNYGYTF	TRBV29-1	TRBJ1-2
TGTGCCAGCAGCTCTTCCACGGAGACCGCCTACGAGCAGTACTTC	CASSSSTETAYEQYF	TRBV11-2	TRBJ2-7
TGTGCCAGCAGCGGAAGACCCCCGCAGGGCCGGATCAGGACAGTTAGAGGCACAGATACGCAGTATTTT	CASSGRPPQGRIRTVRGTDTQYF	TRBV7-3	TRBJ2-3
TGCAGTGCTCTACGTAACGTGGATGGACCAAAGCAGGTGTTCTTC	CSALRNVDGPKQVFF	TRBV20-1	TRBJ1-2
TGTGCCAGCAGCGGGTCACGCACAGATACGCAGTATTTT	CASSGSRTDTQYF	TRBV9	TRBJ2-3
TGTGCCAGCAGTTTAGGGACACTCGTAGAGCAGTTCTTC	CASSLGTLVEQFF	TRBV12-4	TRBJ2-1
TGTGCCAGCAGCTTAGACATTTGGTCTAGGGCGAACACTGAAGCTTTCTTT	CASSLDIWSRANTEAFF	TRBV7-6	TRBJ1-1
TGTGCCAGCACGGTTAGAAGGGGGGGCCGGGCAGAGACCCAGTACTTC	CASTVRRGGRAETQYF	TRBV14	TRBJ2-5
TGTGCCAGCACGGGGGATCTACCTGGAAACACCATATATTTT	CASTGDLPGNTIYF	TRBV6-4	TRBJ1-3
TGCAGTGCTAGAGATCCCTTGGGAACCGCCACTGAAGCTTTCTTT	CSARDPLGTATEAFF	TRBV20-1	TRBJ1-1
TGTGCCAGCAATGACAGAATGGAAGCCTACAATGAGCAGTTCTTC	CASNDRMEAYNEQFF	TRBV6-4	TRBJ2-1
TGTGCCATCAGGGGACCCGGGACTAGACAGATCGAGCAGTACTTC	CAIRGPGTRQIEQYF	TRBV10-3	TRBJ2-7
TGTGCCAGCCCTACCTCTGCAGGCTCCTACGAGCAGTACTTC	CASPTSAGSYEQYF	TRBV11-3	TRBJ2-7
TGCGCCAGCAGCCAAGATACGGGCCGGGACTTCAATCAGCCCCAGCATTTT	CASSQDTGRDFNQPQHF	TRBV4-1	TRBJ1-5
TGTGCCAGCAGTTTGGATAGGGCCAGCGAGCAGTACTTC	CASSLDRASEQYF	TRBV12-3	TRBJ2-7
TGTGCCAGCAGTTATGTAGGCTGTGGCTACACCTTC	CASSYVGCGYTF	TRBV6-6	TRBJ1-2
TGCGCCAGAGCACAGACCTACGAGCAGTACTTC	CARAQTYEQYF	TRBV10-1	TRBJ2-7
TGTGCCAGCAGTGCCGGGGTGCAGTTCTTC	CASSAGVQFF	TRBV6-4	TRBJ2-1
TGTGCCAGCAGATCCAGCTCCGCCTCAGATACGCAGTATTTT	CASRSSSASDTQYF	TRBV7-3	TRBJ2-3
TGCGCCAGCAGTGCCCCCATCGAACAAGAGACCCAGTACTTC	CASSAPIEQETQYF	TRBV10-1	TRBJ2-5
TGTGCCAGCAGCAAAATTCAGGGAAACACCATATATTTT	CASSKIQGNTIYF	TRBV9	TRBJ1-3
TGCGCCAGCAGCCAGGGACAGGGGCACGGGAATTCACCCCTCCACTTT	CASSQGQGHGNSPLHF	TRBV4-3	TRBJ1-6
TGTGCCAGCAGCTTGTACAAGGACAGGGTCAGAGAGACCCAGTACTTC	CASSLYKDRVRETQYF	TRBV5-6	TRBJ2-5
TGTGCCAGCAGCTTGACCGGGACAGGGGGTGGGACCTACGAGCAGTACTTC	CASSLTGTGGGTYEQYF	TRBV5-6	TRBJ2-7
TGTGCCAGCAGCCAAGAGGGACAGGGAGAGACCCAGTACTTC	CASSQEGQGETQYF	TRBV14	TRBJ2-5
TGCGCCAGCAGCTGGTCCCGGGCAAAACCCAATGAGCAGTTCTTC	CASSWSRAKPNEQFF	TRBV5-1	TRBJ2-1
TGTGCCAGTCAAAAACCCCCAGGGTGTTGCTCCTACGAGCAGTACTTC	CASQKPPGCCSYEQYF	TRBV3-1	TRBJ2-7
TGTGCCAGGATAACAGGGAGTTATGGCGAGCAGTACTTC	CARITGSYGEQYF	TRBV11-2	TRBJ2-7
TGTGCCAGCAATGGGGGGGCTCGGGTCGAGCAGTACTTC	CASNGGARVEQYF	TRBV7-6	TRBJ2-7
TGCAGCGGGAGAACGGGGATCTCTGGAAACACCATATATTTT	CSGRTGISGNTIYF	TRBV29-1	TRBJ1-3
TGTGCCAGCACGGGCCCCTCTGGGGCCAACGTCCTGACTTTC	CASTGPSGANVLTF	TRBV6-1	TRBJ2-6
TGTGCCAGCATACCAGCGGGAAGCTACGAGCAGTACTTC	CASIPAGSYEQYF	TRBV12-3	TRBJ2-7
TGCAGTGCTAGCAAACCTAGCGGCTACGAGCAGTACTTC	CSASKPSGYEQYF	TRBV20-1	TRBJ2-7
TGTGCCAGCAGTGACAGGCGAGAGACCCAGTACTTC	CASSDRRETQYF	TRBV27	TRBJ2-5
TGCAGTCTTTTTACAGAAAAACTGTTTTTT	CSLFTEKLFF	TRBV20-1	TRBJ1-4
TGTGCCAGCAGTTACCTTTCCGAGGGGGCCTTAGAGAGCAATCAGCCCCAGCATTTT	CASSYLSEGALESNQPQHF	TRBV6-5	TRBJ1-5
TGCAGCGTTGGGTCTGGGACTAGTCATGAGCAGTTCTTC	CSVGSGTSHEQFF	TRBV29-1	TRBJ2-1
TGTGCCAGCAGTTACAACTATGGGACTAGCGGTACTGAGCAGTTCTTC	CASSYNYGTSGTEQFF	TRBV6-3	TRBJ2-1
TGTGCCAGCAGACAGGGCGAGCAGTACTTC	CASRQGEQYF	TRBV7-3	TRBJ2-7
TGTGCCAGCAGTGGAAACTTGACTAGCGGCTGCTGCGATGAGCAGTTCTTC	CASSGNLTSGCCDEQFF	TRBV6-2	TRBJ2-1
TGCGCCAGCAGCCAAGACAGGGGGCCTCCTGGCTATGGCTACACCTTC	CASSQDRGPPGYGYTF	TRBV4-3	TRBJ1-2
TGTGCCAGCAGCGGCAGGGGAAAAGCTGGGGCCAACGTCCTGACTTTC	CASSGRGKAGANVLTF	TRBV11-3	TRBJ2-6
TGTGCCAGCAGCCAAGGATGCACGCAGGACGACTATGGCTACACCTTC	CASSQGCTQDDYGYTF	TRBV4-2	TRBJ1-2
TGTGCCAGCAGCGGGTTCCGGTTAACCTACGAGCAGTACTTC	CASSGFRLTYEQYF	TRBV7-3	TRBJ2-7
TGTGCCAGCAGCCAGTCCGAGGGGGGGGGGCGGCGGAACAATGAGCAGTTCTTC	CASSQSEGGGRRNNEQFF	TRBV14	TRBJ2-1
TGTGCCGAACGGACTAGCGTTCCCACAGATACGCAGTATTTT	CAERTSVPTDTQYF	TRBV10-3	TRBJ2-3
TGTGGACAGGAGTGTCAGCCCCAGCATTTT	CGQECQPQHF	TRBV30	TRBJ1-5
TGTGCCAGTAGTATAGGTCTACGGACTGAAGCTTTCTTT	CASSIGLRTEAFF	TRBV19	TRBJ1-1
TGCGCCAGCAGCTTGGGGCCGGGGGGGCGCGGCCAGCCCCAGCATTTT	CASSLGPGGRGQPQHF	TRBV5-1	TRBJ1-5
TGCAGCGTTGAAGCCCCCCCCGACAGGGTTAGTCTGAACACTGAAGCTTTCTTT	CSVEAPPDRVSLNTEAFF	TRBV29-1	TRBJ1-1
TGTGGGGGCGGAGAAAGGGCCTACGAGCAGTACTTC	CGGGERAYEQYF	TRBV19	TRBJ2-7
TGCGCCAGCAGTGCCCCCCCGGGACAGTTTCGCCAGCCCCAGCATTTT	CASSAPPGQFRQPQHF	TRBV10-1	TRBJ1-5
TGTGCCAGCAGAGTCAGTACTGAAGCTTTCTTT	CASRVSTEAFF	TRBV12-3	TRBJ1-1
TGTGCCAGCAGTGAACGGGAGACAGATACGCAGTATTTT	CASSERETDTQYF	TRBV25-1	TRBJ2-3
TGTGCCAGCCGGACTAGCGGGAGGGGATGTCTAACGCAGTATTTT	CASRTSGRGCLTQYF	TRBV7-3	TRBJ2-3
TGTGCCAGCAGTTTAGGGAAAGCCGGGACAGGGGGGTACGAAGAGACCCAGTACTTC	CASSLGKAGTGGYEETQYF	TRBV27	TRBJ2-5
TGTGCCAGCAGTTACAAGCTTCAGGGGGCTGGGGCCAACGTCCTGACTTTC	CASSYKLQGAGANVLTF	TRBV6-5	TRBJ2-6
TGTGCCTGGCGGGACTTCGGGGAGCTGTTTTTT	CAWRDFGELFF	TRBV30	TRBJ2-2
TGTGCCAGCAGCCAGGGGGGGTACCAAGAGACCCAGTACTTC	CASSQGGYQETQYF	TRBV7-4	TRBJ2-5
TGTGCCAGCGTCATCCCAGGGGGGGCCTACGAGCAGTACTTC	CASVIPGGAYEQYF	TRBV9	TRBJ2-7
TGTGCCAGCTCCTTATATGTACCGAAGGTCTTGTACAATGAGCAGTTCTTC	CASSLYVPKVLYNEQFF	TRBV18	TRBJ2-1
TGCAGTCGCTTAGACAGGGTCTATGGCTACACCTTC	CSRLDRVYGYTF	TRBV20-1	TRBJ1-2
TGTGCCAGTACGCCTAGCGGGGAATTGGATCCCCATCAGCCCCAGCATTTT	CASTPSGELDPHQPQHF	TRBV19	TRBJ1-5
TGTGCCAGCAGTCCCCCCCCACGGAACACTGAAGCTTTCTTT	CASSPPPRNTEAFF	TRBV6-5	TRBJ1-1
TGTGCCAGCAGCCAAGATCGCCCGGAAGAGACCCAGTACTTC	CASSQDRPEETQYF	TRBV3-1	TRBJ2-5
TGTGCCAGCAGCCGCCGGGACGATACCCAGTACTTC	CASSRRDDTQYF	TRBV7-9	TRBJ2-5
TGCAGTGCTGCCGGGACTAGCGGGCCCGGGAACACCGGGGAGCTGTTTTTT	CSAAGTSGPGNTGELFF	TRBV20-1	TRBJ2-2
TGTGCCAGCAGCTTACCGGAAGGGGGGGCCCCCACAGATACGCAGTATTTT	CASSLPEGGAPTDTQYF	TRBV7-9	TRBJ2-3
TGTGCCAGACAGGGGGAAAAACTGTTTTTT	CARQGEKLFF	TRBV2	TRBJ1-4
TGTGCCAGCAGCGCGGCCCAGGGGAATACTAATAATTCACCCCTCCACTTT	CASSAAQGNTNNSPLHF	TRBV5-4	TRBJ1-6
TGTGCCAGTGCGGGGACTTTTTCTGAAGCTTTCTTT	CASAGTFSEAFF	TRBV11-2	TRBJ1-1
TGCGCCAGCAGCTTGTCCAACGGACAGGACACTGAAGCTTTCTTT	CASSLSNGQDTEAFF	TRBV5-1	TRBJ1-1
TGTGCCAGCAGCGAGACAGGGGTCGAGCAGTACTTC	CASSETGVEQYF	TRBV11-2	TRBJ2-7
TGTGCCAGCAGTTACGTTCTTTTAATCTGGCTGGGAACCGGGGAGCTGTTTTTT	CASSYVLLIWLGTGELFF	TRBV6-3	TRBJ2-2
TGCAGTGCTAGTATTGACAGCTACGAGCAGTACTTC	CSASIDSYEQYF	TRBV20-1	TRBJ2-7
TGTGCCAGCAGCAACGGTCCCTATGGAAACACCATATATTTT	CASSNGPYGNTIYF	TRBV5-6	TRBJ1-3
TGTGCCAGCACCTCGGGGTCTATTCTAACCAATCAGCCCCAGCATTTT	CASTSGSILTNQPQHF	TRBV6-5	TRBJ1-5
TGTGCCAGCAGTTGGAGCCCAGGCGAGCAGTACTTC	CASSWSPGEQYF	TRBV6-3	TRBJ2-7
TGTGCCAGCAGAAGGGCCGGGACCTTCTCCTACGAGCAGTACTTC	CASRRAGTFSYEQYF	TRBV2	TRBJ2-7
TGCAGTGCAAATCCCCCCACTAGCGGGGAGAGATTCAACATTCAGTACTTC	CSANPPTSGERFNIQYF	TRBV20-1	TRBJ2-4
TGTGCCAGCAGTTACTCGTTAGGGCCCAATCAGCCCCAGCATTTT	CASSYSLGPNQPQHF	TRBV6-8	TRBJ1-5
TGTGCCAGCAGCTTAGTACTCTTAGCTAACTATGGCTACACCTTC	CASSLVLLANYGYTF	TRBV7-3	TRBJ1-2
TGTGCCACCGCCTCGGACAGGGGGAACAGGAACACCGGGGAGCTGTTTTTT	CATASDRGNRNTGELFF	TRBV27	TRBJ2-2
TGTGCCAGCAGTAACTGGGCTAGCGTCTTTAGGAGCACAGATACGCAGTATTTT	CASSNWASVFRSTDTQYF	TRBV6-5	TRBJ2-3
TGTGCCAGCAACTCAGGACAGGCCTACGAGCAGTACTTC	CASNSGQAYEQYF	TRBV12-4	TRBJ2-7
TGTGCCAGCAGTGAACCAGGGTCAAATGGCTACACCTTC	CASSEPGSNGYTF	TRBV6-4	TRBJ1-2
TGTGCCAGCAGTTACTCGAGCCCCGGGACTAGCGGGAGTGGCTACACCTTC	CASSYSSPGTSGSGYTF	TRBV6-5	TRBJ1-2
TGCAGTGCTCCAGTTACGGGACAGGGTCTGCGACTCCCTAACTATGGCTACACCTTC	CSAPVTGQGLRLPNYGYTF	TRBV20-1	TRBJ1-2
TGTGCCAGCTCACCACGAACGGTAACTTGCTACAATGAGCAGTTCTTC	CASSPRTVTCYNEQFF	TRBV18	TRBJ2-1
TGTGCCAGCAGTCAACACAGAGAGACTGAAGCTTTCTTT	CASSQHRETEAFF	TRBV6-1	TRBJ1-1
TGCGCCAGCAGCTGGACAGGGGGCGAGACTGAAGCTTTCTTT	CASSWTGGETEAFF	TRBV5-1	TRBJ1-1
TGCGCCAGCAGTGAGTTAAAACTTGGAGGGACCGCAACTAATGAAAAACTGTTTTTT	CASSELKLGGTATNEKLFF	TRBV10-1	TRBJ1-4
TGTGCCAGCAGTGTCGACAGGCCAAATGGCTACACCTTC	CASSVDRPNGYTF	TRBV6-2	TRBJ1-2
TGTGCCAGCAGCTGGGGGCCTGCATTTGTCAATCAGCCCCAGCATTTT	CASSWGPAFVNQPQHF	TRBV11-3	TRBJ1-5
TGTGCCAGCAGTTCATACAGGGGGGGGGCGAAAGCAGATACGCAGTATTTT	CASSSYRGGAKADTQYF	TRBV12-3	TRBJ2-3
TGTGCCAGCAGTTTATGCGGGGCCACGAACACTGAAGCTTTCTTT	CASSLCGATNTEAFF	TRBV27	TRBJ1-1
TGTGCCAGCAGATTCCTTCAGGTCTCCTATGGCTACACCTTC	CASRFLQVSYGYTF	TRBV6-3	TRBJ1-2
TGTGCCAGCAGTTATGCCGCCGAGCCGAGAAACTATGGCTACACCTTC	CASSYAAEPRNYGYTF	TRBV6-8	TRBJ1-2
TGTGCCAGCAGCATCGTAAAGGGCAGGTGGGATAGCAATCAGCCCCAGCATTTT	CASSIVKGRWDSNQPQHF	TRBV13	TRBJ1-5
TGTCTGGGACAGACTGAAGCTTTCTTT	CLGQTEAFF	TRBV6-5	TRBJ1-1
TGTGCCAGCAGCCAGTGGACAGGGGTCCGGGAGCTGTTTTTT	CASSQWTGVRELFF	TRBV14	TRBJ2-2
TGTGCCAGCAGTTTCGTAAGCTACGAGCAGTACTTC	CASSFVSYEQYF	TRBV28	TRBJ2-7
TGTGCCACCAGTTCGAGGACTAGCGGGTGTATTACTTGCGAGGGAAATGAGCAGTTCTTC	CATSSRTSGCITCEGNEQFF	TRBV24-1	TRBJ2-1
TGCAAGATGCGGGGCGGGCACAATGAGCAGTTCTTC	CKMRGGHNEQFF	TRBV20-1	TRBJ2-1
TGTGCCAGCAGTGATAGCGGATATGTGGTAGAGCAGTACTTC	CASSDSGYVVEQYF	TRBV25-1	TRBJ2-7
TGCAGTGCGGGGGGGACCTACGAGCAGTACTTC	CSAGGTYEQYF	TRBV20-1	TRBJ2-7
TGTGCCAGCTCTGTGGCCGGGACAGGGGTAGGGTGGCTGCTGAGCTCCTACAATGAGCAGTTCTTC	CASSVAGTGVGWLLSSYNEQFF	TRBV18	TRBJ2-1
TGTGCCTCTACTCATATAGTACCGAACACTGAAGCTTTCTTT	CASTHIVPNTEAFF	TRBV6-1	TRBJ1-1
TGTGCCAGCAGCTTAGCTAGGGCGCAGTTCTTC	CASSLARAQFF	TRBV11-3	TRBJ2-1
TGTGCCAGCAAGACCGACATGTCCTCTGGGGCCAACGTCCTGACTTTC	CASKTDMSSGANVLTF	TRBV28	TRBJ2-6
TGCAGTGCTAGAGCTCGACACCACTACAATGAGCAGTTCTTC	CSARARHHYNEQFF	TRBV20-1	TRBJ2-1
TGTGCCAGCAGTGGGTCCAACAGGGTACAGGGGGCACAGTACAATGAGCAGTTCTTC	CASSGSNRVQGAQYNEQFF	TRBV12-4	TRBJ2-1
TGCAGTGCTAGATGCAGGGAGACCGAGACCCAGTACTTC	CSARCRETETQYF	TRBV20-1	TRBJ2-5
TGTGCCAGCAGCTCTCAGGGACAGTTTTACACCGGGGAGCTGTTTTTT	CASSSQGQFYTGELFF	TRBV11-2	TRBJ2-2
TGTGCCAGCAGCTTAATGAGAGACAGGATATCCTACGAGCAGTACTTC	CASSLMRDRISYEQYF	TRBV7-9	TRBJ2-7
TGTGCCAGCAGCACGGGGGCACGGTACCTACCTGGGGCCAACGTCCTGACTTTC	CASSTGARYLPGANVLTF	TRBV11-3	TRBJ2-6
TGTGCCAGTAGAACCGGGGGGATACGGGACTCTGGAAACACCATATATTTT	CASRTGGIRDSGNTIYF	TRBV19	TRBJ1-3
TGTGCCAGCAGCGTAGGACAGACCGGGAGCAATCAGCCCCAGCATTTT	CASSVGQTGSNQPQHF	TRBV9	TRBJ1-5
TGTGCCAGCAGCATTGGGGGGGGGCAAGAGACCCAGTACTTC	CASSIGGGQETQYF	TRBV7-9	TRBJ2-5
TGTGCCACCACGGGGGGGGTGAATGAGCAGTTCTTC	CATTGGVNEQFF	TRBV24-1	TRBJ2-1
TGTGCCAGCAGGTGCACAGGCTCACAGCCCCAGCATTTT	CASRCTGSQPQHF	TRBV28	TRBJ1-5
TGTGCCAGCCGTAGGGACCTGTTTTTT	CASRRDLFF	TRBV19	TRBJ1-4
TGTGCCAGCAGCCGTGGCGGGAGGACGGTCTTC	CASSRGGRTVF	TRBV27	TRBJ2-1
TGTGCCAGCAGCGATCGACATAGGATGGTAACCGGGGAGCTGTTTTTT	CASSDRHRMVTGELFF	TRBV7-9	TRBJ2-2
TGTGCCAGCAGTTTCAGGCGTCCTGATTATAGCAATCAGCCCCAGCATTTT	CASSFRRPDYSNQPQHF	TRBV27	TRBJ1-5
TGCGCCAGCAGCTTGGCGACCCAGGGGGGAACTGAAGCTTTCTTT	CASSLATQGGTEAFF	TRBV5-1	TRBJ1-1
TGTGCCAGCAGCTTAGCCCGTACCCGGGACAGCCAGCATTTT	CASSLARTRDSQHF	TRBV7-2	TRBJ1-5
TGTGCCAGCAGTGACGACGTTCCGACGAACAATGAGCAGTTCTTC	CASSDDVPTNNEQFF	TRBV6-1	TRBJ2-1
TGTGCCAGCAGCTCGGGACAGTACGAGCAGTACTTC	CASSSGQYEQYF	TRBV13	TRBJ2-7
TGCGCCAGCAGCCAAGATAGACACTTAGGGGGGTTGAACGGGGAGCTGTTTTTT	CASSQDRHLGGLNGELFF	TRBV4-3	TRBJ2-2
TGTGCCACCAGCAGAGATAAAATTGTGAAAGGGAGCAGGGGGATCTACGAGCAGTACTTC	CATSRDKIVKGSRGIYEQYF	TRBV15	TRBJ2-7
TGTGCCAGCAGTGACTCCAAATCGACAGCATTCGCCTACGAGCAGTACTTC	CASSDSKSTAFAYEQYF	TRBV25-1	TRBJ2-7
TGTGCCAGCAGCGACCGGGGGCCCGGGTCACCCCTCCACTTT	CASSDRGPGSPLHF	TRBV3-1	TRBJ1-6
TGTGCCAGCAGCTTAGTCTTACTAGGCACGAATGAAAAACTGTTTTTT	CASSLVLLGTNEKLFF	TRBV7-9	TRBJ1-4
TGCAGTGCAGGGGAGGGGGGGAACACTGAAGCTTTCTTT	CSAGEGGNTEAFF	TRBV20-1	TRBJ1-1
TGCAGCGTGGAATTTGGGGCGGTCAATGAGCAGTTCTTC	CSVEFGAVNEQFF	TRBV29-1	TRBJ2-1
TGTGCCAGCAGTTTATCGCAGGGGATAAATAACTATGGCTACACCTTC	CASSLSQGINNYGYTF	TRBV27	TRBJ1-2
TGTGCCAGTAGTCGAGACCGGGGGCATTATGGCTACACCTTC	CASSRDRGHYGYTF	TRBV19	TRBJ1-2
TGTGCCAGCACGGTTAGGAACGGGACAGGGTCTGGAACCCCCGGCTCTGGGGCCAACGTCCTGACTTTC	CASTVRNGTGSGTPGSGANVLTF	TRBV11-2	TRBJ2-6
TGTGCCAGCAGTGTTCCCGAAGCGGGAGGGCGCAATCAGCCCCAGCATTTT	CASSVPEAGGRNQPQHF	TRBV28	TRBJ1-5
TGTGCCAGCAGCATGACAGGGCCAACATATGGCTACACCTTC	CASSMTGPTYGYTF	TRBV5-8	TRBJ1-2
TGTGCCATCAGGCGGGCCCCGGACTACGAGCAGTACTTC	CAIRRAPDYEQYF	TRBV10-3	TRBJ2-7
TGCAGTGCTAGAGATACCCCAGCTTCTAGCGGCCCCTTC	CSARDTPASSGPF	TRBV20-1	TRBJ2-5
TGCGCCAGCATCCCGGGGACGAACACCGGGGAGCTGTTTTTT	CASIPGTNTGELFF	TRBV4-1	TRBJ2-2
TGTGCCAGCAGCCAAGAATCGGAATGCCGGTGGTGGGAAAGCTACGAGCAGTACTTC	CASSQESECRWWESYEQYF	TRBV4-2	TRBJ2-7
TGTGCCAGCAGTTTAGGTCTCAGGGTTCCTGGAAACACCATATATTTT	CASSLGLRVPGNTIYF	TRBV27	TRBJ1-3
TGTGCCACCTCCGAGGGGACAGATTCACCCCTCCACTTT	CATSEGTDSPLHF	TRBV24-1	TRBJ1-6
TGCAGTGCTAGTCCGCGGACGGGAGGGCAAGAGACCCAGTACTTC	CSASPRTGGQETQYF	TRBV20-1	TRBJ2-5
TGTGCCAGCAGCTCGGCTTCGTCCGTGGACTCCTACGAGCAGTACTTC	CASSSASSVDSYEQYF	TRBV5-4	TRBJ2-7
TGTGCCAGCAGCATAGACTGGTTCTCCGGGGAGCTGTTTTTT	CASSIDWFSGELFF	TRBV9	TRBJ2-2
TGTGAGGGACAGGGAAGGAACACCGGGGAGCTGTTTTTT	CEGQGRNTGELFF	TRBV28	TRBJ2-2
TGTGCCAGCAGCCAAGATCGTACCGGGGAGCTGTTTTTT	CASSQDRTGELFF	TRBV4-2	TRBJ2-2
TGTCGGACTTCCTACGAGCAGTACTTC	CRTSYEQYF	TRBV6-1	TRBJ2-7
TGTGCCAGCAGTTACTCCCCCCAGGGGGCGGTTGAAGCCAAAAACATTCAGTACTTC	CASSYSPQGAVEAKNIQYF	TRBV6-5	TRBJ2-4
TGTGCCAGCAGTCCCCCCGAGGCTCGGGGGCGATTCTACGAGCAGTACTTC	CASSPPEARGRFYEQYF	TRBV27	TRBJ2-7
TGTGCCAGCAGCGAACCGGGACTAGCGGGGGGCCGGGGTGAGCAGTTCTTC	CASSEPGLAGGRGEQFF	TRBV13	TRBJ2-1
TGCGCCAGCAGCGGGTACCCCGGGACTAGCAAAGGGACCTACGAGCAGTACTTC	CASSGYPGTSKGTYEQYF	TRBV4-1	TRBJ2-7
TGCAGTGCTCCCGGACAGGGGGCGGCCCTGAGCTATGGCTACACCTTC	CSAPGQGAALSYGYTF	TRBV20-1	TRBJ1-2
TGTGCCAGCTCACCAGGGACCTCCTCCTACAATGAGCAGTTCTTC	CASSPGTSSYNEQFF	TRBV18	TRBJ2-1
TGTGCCAAGTATCCATACAATGAGCAGTTCTTC	CAKYPYNEQFF	TRBV6-4	TRBJ2-1
TGTGCCAGCAGCTTTTTCGCCAGGGGACTAGCGGGGGGGCCCGAGGGCGAGCAGTACTTC	CASSFFARGLAGGPEGEQYF	TRBV11-2	TRBJ2-7
TGCAGTGCTGTTGAAACAGGGTGTTCCAGAGCGCCGCCCCAGCATTTT	CSAVETGCSRAPPQHF	TRBV20-1	TRBJ1-5
TGTGCCTGGAGTCGGGCAGGGGGAGGGCGGGTATATTTT	CAWSRAGGGRVYF	TRBV30	TRBJ1-3
TGTGCCAGCAGCTTGGAGGTTGCTGGGAGGGCTGGGGCCAACGTCCTGACTTTC	CASSLEVAGRAGANVLTF	TRBV5-4	TRBJ2-6
TGTGCCAGCAGCCGGGACAATGCTTTCTTT	CASSRDNAFF	TRBV2	TRBJ1-1
TGTGCCAGCAGCCCTACTAGGGAGTTAGGGTATGGCTACACCTTC	CASSPTRELGYGYTF	TRBV5-6	TRBJ1-2
TGTGCCAGCAGGGGTCCGGGAGAAGCTTTCTTT	CASRGPGEAFF	TRBV6-1	TRBJ1-1
TGTGCCAGCAGTGACTGGGGACTAGCGTCCTGCACAGATACGCAGTATTTT	CASSDWGLASCTDTQYF	TRBV6-4	TRBJ2-3
TGTGCCAGCAGCCTTTGGGGGGCCTATGGCTACACCTTC	CASSLWGAYGYTF	TRBV11-3	TRBJ1-2
TGTGCCAACGGGAACCATTCACTGACGTGCTCCTACGAGCAGTACTTC	CANGNHSLTCSYEQYF	TRBV2	TRBJ2-7
TGTGCCAGCAGCCAAGGAACTAGCGGGGGGAGAACAGATACGCAGTATTTT	CASSQGTSGGRTDTQYF	TRBV4-2	TRBJ2-3
TGTGCCAGCAGCGTCTTTACGGACACAGATACGCAGTATTTT	CASSVFTDTDTQYF	TRBV9	TRBJ2-3
TGTGCCAGCAGCTTGCGTAATGGAGGCTCCTACGAGCAGTACTTC	CASSLRNGGSYEQYF	TRBV5-4	TRBJ2-7
TGCGCCAGCAGTGAGTCGCCACTAGGGAGGCCCCACACAGATACGCAGTATTTT	CASSESPLGRPHTDTQYF	TRBV10-2	TRBJ2-3
TGCAGTGCTAGCTCAGGGCCTGGGCGAACTGAAGCTTTCTTT	CSASSGPGRTEAFF	TRBV20-1	TRBJ1-1
TGTGCCTCCAGCCCAGGGCGGGACGCCCAGCATTTT	CASSPGRDAQHF	TRBV6-5	TRBJ1-5
TGCGCCAGCAGACTCAAGAGGGGGCTCTATAGCAATCAGCCCCAGCATTTT	CASRLKRGLYSNQPQHF	TRBV10-2	TRBJ1-5
TGTGCCAGCATGGGGACAGGGGGTTATGAAGCTTTCTTT	CASMGTGGYEAFF	TRBV5-6	TRBJ1-1
TGTGCCAGCAGTTTAGGGACGAAGGATCACAAGGGAAACACCATATATTTT	CASSLGTKDHKGNTIYF	TRBV12-3	TRBJ1-3
TGCAGTGCTATCTCCCCGGACAGGGCAAGGGACGAGCAGTACTTC	CSAISPDRARDEQYF	TRBV20-1	TRBJ2-7
TGTGCCAGCTGCGGGGACAGGGGTAACGCCTACAATGAGCAGTTCTTC	CASCGDRGNAYNEQFF	TRBV6-4	TRBJ2-1
TGTGCCAGCAGTCCCGGACAGGGGGGGAGCTCTGGAAACACCATATATTTT	CASSPGQGGSSGNTIYF	TRBV6-6	TRBJ1-3
TGTGCCAGTAGTGGGTGGCACCGGGAACCTGGCTACACCTTC	CASSGWHREPGYTF	TRBV19	TRBJ1-2
TGTGCCAGCAGCCAAGCTGGGACTAGCGGGCAACAATTATCAGAGACCCAGTACTTC	CASSQAGTSGQQLSETQYF	TRBV3-1	TRBJ2-5
TGTGCCAGCAGTGAACGCGTCCACACTCGAGGCTCTGGAAACACCATATATTTT	CASSERVHTRGSGNTIYF	TRBV6-1	TRBJ1-3
TGTGCCACACGCTATCAGGGTACGCAGTATTTT	CATRYQGTQYF	TRBV15	TRBJ2-3
TGTGCCAGCAGCTTACCCGCTGGAGGGGTTAAATACGAGCAGTACTTC	CASSLPAGGVKYEQYF	TRBV11-2	TRBJ2-7
TGTAAAGCAACGCTCAGGGGGGGGAATTATGGCTACACCTTC	CKATLRGGNYGYTF	TRBV30	TRBJ1-2
TGCGCCAGCAAGAATAGTAAGGGGACCGGGGAGCTGTTTTTT	CASKNSKGTGELFF	TRBV10-1	TRBJ2-2
TGTGCCAGCAGCTGGGACAGCGAGCAGTACTTC	CASSWDSEQYF	TRBV7-9	TRBJ2-7
TGCAGTGCTAGCCCTTCAAAGACACGGACCCACACCGGGGAGCTGTTTTTT	CSASPSKTRTHTGELFF	TRBV20-1	TRBJ2-2
TGTGCCAGCAGCCACGAGGGGGGCTCCTACGAGCAGTACTTC	CASSHEGGSYEQYF	TRBV3-1	TRBJ2-7
TGTGCCAGCAGCTCCGACTATGGCTACACCTTC	CASSSDYGYTF	TRBV11-2	TRBJ1-2
TGTGCCAGCAGCTTGCCGGGGGACAGGGCCCGGGCTTTCTTT	CASSLPGDRARAFF	TRBV5-5	TRBJ1-1
TGTGCCAGCACAGAGGGGGCCCGGTATGAGCAGTTCTTC	CASTEGARYEQFF	TRBV28	TRBJ2-1
TGTGCCAGCAGGGTTGGGTGTAGCGGGGACACCGGGGAGCTGTTTTTT	CASRVGCSGDTGELFF	TRBV7-2	TRBJ2-2
TGTGCCAGCAGCCTCTACTATGGCTACACCTTC	CASSLYYGYTF	TRBV6-1	TRBJ1-2
TGTGCCAGCAGCTCGGGACAGAGTATAAAATACGAGCAGTACTTC	CASSSGQSIKYEQYF	TRBV5-4	TRBJ2-7
TGTGCCAGCTCACCTCTCCGCCTCGGGGGCGGAGAGACCCAGTACTTC	CASSPLRLGGGETQYF	TRBV18	TRBJ2-5
TGTGCCAGGTATAGGAACACAGGGGAAGATACGCAGTATTTT	CARYRNTGEDTQYF	TRBV19	TRBJ2-3
TGTGCCAGCAGTGATACAGGTAGCAATCAGCCCCAGCATTTT	CASSDTGSNQPQHF	TRBV6-1	TRBJ1-5
TGCAGTGACCTGTACTGGACAAACTATGGCTACACCTTC	CSDLYWTNYGYTF	TRBV20-1	TRBJ1-2
TGCGCCAGCAGTGAGAATAGCAATCCGTACGAGCAGTACTTC	CASSENSNPYEQYF	TRBV10-1	TRBJ2-7
TGTGCCACCAGCAGAGATCAGAGGGAAACGGAAGCTTTCTTT	CATSRDQRETEAFF	TRBV15	TRBJ1-1
TGTGCCAGCATAATGAACGATAATGAAAAACTGTTTTTT	CASIMNDNEKLFF	TRBV12-3	TRBJ1-4
TGTGCCAGCAGTTACTCGAGGGGGGGCTTCTACGAGCAGTACTTC	CASSYSRGGFYEQYF	TRBV6-5	TRBJ2-7
TGTGCCAACCGGGAAAAACTGTTTTTT	CANREKLFF	TRBV6-5	TRBJ1-4
TGCAGTGCTGAGGTGACAGATACGCAGTATTTT	CSAEVTDTQYF	TRBV20-1	TRBJ2-3
TGCAGTGCTGAGGAACCTAGCAAAGGGGTTACAGGTCATGGCTACACCTTC	CSAEEPSKGVTGHGYTF	TRBV20-1	TRBJ1-2
TGTGCCAGTAGTACCCCGGGGTACGCCGCCTACGAGCAGTACTTC	CASSTPGYAAYEQYF	TRBV19	TRBJ2-7
TGTGCCAGCAGCTCGACGGGGTACACTGAAGCTTTCTTT	CASSSTGYTEAFF	TRBV5-5	TRBJ1-1
TGTGCCAGCAGAGAGCGGGATCGGGAGCTGTTTTTT	CASRERDRELFF	TRBV7-9	TRBJ2-2
TGCGCCAGCAGGCGTGCTAGCGGGCATTGGAATGAGCAGTTCTTC	CASRRASGHWNEQFF	TRBV10-1	TRBJ2-1
TGTGCCAGCAGCTTAAGGGGGTCGGATGAAAAACTGTTTTTT	CASSLRGSDEKLFF	TRBV11-3	TRBJ1-4
TGTGCCAGCAGCGTACTGGAGTCCGTAGAGACCCAGTACTTC	CASSVLESVETQYF	TRBV9	TRBJ2-5
TGCAGTGCTAGAGATCCCCGAGGGAGGCGGGACTCTGGGGCCAACGTCCTGACTTTC	CSARDPRGRRDSGANVLTF	TRBV20-1	TRBJ2-6
TGTGCCAGCAGTTTTTCTCAGGGCACTGAAGCTTTCTTT	CASSFSQGTEAFF	TRBV28	TRBJ1-1
TGTGCCAGCAGCACCCCCGATGGGGCACAGTACTTC	CASSTPDGAQYF	TRBV7-9	TRBJ2-5
TGTGCCAGCAGGTACACAGGGGGACACCATACGCAGTATTTT	CASRYTGGHHTQYF	TRBV6-4	TRBJ2-3
TGTGCGCAGTCTTGCAGCTCCTACAATGAGCAGTTCTTC	CAQSCSSYNEQFF	TRBV30	TRBJ2-1
TGTGCCAGCAGCCAAGTCAGAGGGTCATCGGAAAACTCCTACAATGAGCAGTTCTTC	CASSQVRGSSENSYNEQFF	TRBV14	TRBJ2-1
TGTGCCAGCAGTTTCGAGCTGGGGTGGGCCCTCCACTTT	CASSFELGWALHF	TRBV28	TRBJ1-6
TGTGCCAGCAGCGCGAGGACGGGAGGAGTCATCCAAGAGACCCAGTACTTC	CASSARTGGVIQETQYF	TRBV7-9	TRBJ2-5
TGTGCCAGCAGCTTATGTAAGCCGGGCACCGGGGAGCTGTTTTTT	CASSLCKPGTGELFF	TRBV5-4	TRBJ2-2
