TGTGCCAGCAGCTTACGTGGCCGGACCTCCTATGGCTACACCTTC	CASSLRGRTSYGYTF	TRBV7-3	TRBJ1-2
TGTGCCAGCAGCTCCGACAGGTCTAATGAAAAACTGTTTTTT	CASSSDRSNEKLFF	TRBV13	TRBJ1-4
TGTGCCAGCAGGGGGGACTTAGAGTTCAGGTCAGGCACAGATACGCAGTATTTT	CASRGDLEFRSGTDTQYF	TRBV7-3	TRBJ2-3
TGTGCCAGCAGCGGAACCGCGGGAGAAAACATTCAGTACTTC	CASSGTAGENIQYF	TRBV2	TRBJ2-4
TGTGCCAGCAGTTACCATCCCAGCTCTGGAAACACCATATATTTT	CASSYHPSSGNTIYF	TRBV6-3	TRBJ1-3
TGTGCCAGCAGCCTACCCGACAGAGGAGTCAAGGGCTACACCTTC	CASSLPDRGVKGYTF	TRBV5-6	TRBJ1-2
TGTGCCAGCAGCTTTCGGGGGGCAAGCTCCTACGAGCAGTACTTC	CASSFRGASSYEQYF	TRBV7-3	TRBJ2-7
TGCATATCGAATGTGGGGATTGAATATAACTATGGCTACACCTTC	CISNVGIEYNYGYTF	TRBV29-1	TRBJ1-2
TGTGCCAGCAGTTATTCGGGAGGGGGGAAAAACATTCAGTACTTC	CASSYSGGGKNIQYF	TRBV6-9	TRBJ2-4
TGTGCCAGCAGCTTCGGTAGGGGGCCTTTCAGTCAGCCCCAGCATTTT	CASSFGRGPFSQPQHF	TRBV5-4	TRBJ1-5
TGCGCCAGCATAGGACAGGGGGCGCTTGGGGCCAACGTCCTGACTTTC	CASIGQGALGANVLTF	TRBV10-1	TRBJ2-6
TGTGCCAGCAGCCACCCGATTGGGGGGGTGTATAGATCGCGGAATGGCCTGAGGCAGTTCTTC	CASSHPIGGVYRSRNGLRQFF	TRBV4-2	TRBJ2-1
TGTGCCAGCAGTTTATCGTGGCACAAGGGACAGGATAATCAGCCCCAGCATTTT	CASSLSWHKGQDNQPQHF	TRBV27	TRBJ1-5
TGTGCCAGCATCCTAGTCCGTTACACAGATACGCAGTATTTT	CASILVRYTDTQYF	TRBV27	TRBJ2-3
TGTGCCAGCAGCTGGGGACAGGGCCTGAGCGAGCAGTACTTC	CASSWGQGLSEQYF	TRBV7-3	TRBJ2-7
TGTGCCACCAGTGCATTCCGGGACAGAAAAGGAGCTTTCTTT	CATSAFRDRKGAFF	TRBV24-1	TRBJ1-1
TGCAGTGCTAGCATCCGATCGCGGCGGAAGGAATTCAATGAGCAGTTCTTC	CSASIRSRRKEFNEQFF	TRBV20-1	TRBJ2-1
TGTGCCAGCAGCTTATCCCTCTACGGGGGGGGTTTAGCGGTGGTACTCGGGGAGCTGTTTTTT	CASSLSLYGGGLAVVLGELFF	TRBV11-1	TRBJ2-2
TGTGCCAGCCTCTTTGCGGGAGTAAGCTACGAGCAGTACTTC	CASLFAGVSYEQYF	TRBV7-3	TRBJ2-7
TGTGCCAGCACGAAGGGAGGTTCCGTAGACGAGCAGTACTTC	CASTKGGSVDEQYF	TRBV28	TRBJ2-7
TGTGCCAGCAGCTTATTGACTAGCGGACCTAGCTCCTACAATGAGCAGTTCTTC	CASSLLTSGPSSYNEQFF	TRBV11-3	TRBJ2-1
TGTGCCAGCCAGCCGGGACAGGGTTGCGAGCACTATGGCTACACCTTC	CASQPGQGCEHYGYTF	TRBV7-3	TRBJ1-2
TGTGCCAGCCAGTCTAGCGCCGGGCTACTGGAGCAGTTCTTC	CASQSSAGLLEQFF	TRBV27	TRBJ2-1
TGCAGCGCTCAACGGGGAGCACGGCAAAACTTCTCTGGAAACACCATATATTTT	CSAQRGARQNFSGNTIYF	TRBV29-1	TRBJ1-3
TGTGCCAGCAGCTCCTGGGGGACAGGGGGCTACACCTTC	CASSSWGTGGYTF	TRBV7-6	TRBJ1-2
TGTGCCAGCAGTTACTACGGGACAGGGCCGTACTTC	CASSYYGTGPYF	TRBV6-2	TRBJ2-5
TGTGCCAGCAGTGAGGGAACGCTGGAAGAGACCCAGTACTTC	CASSEGTLEETQYF	TRBV6-4	TRBJ2-5
TGTGCCAGTCTCCCCTACGGGTTTTACACCTACGAGCAGTACTTC	CASLPYGFYTYEQYF	TRBV27	TRBJ2-7
TGTGCCAGCTCACCCCGTCGACAGGGTCACGAGACCCAGTACTTC	CASSPRRQGHETQYF	TRBV18	TRBJ2-5
TGCGCCAGCAGCTTGCGATCGGGGGGGGGCTACACCTTC	CASSLRSGGGYTF	TRBV5-1	TRBJ1-2
TGTGCCAGCCCAGTGTTTATGAACACTGAAGCTTTCTTT	CASPVFMNTEAFF	TRBV5-6	TRBJ1-1
TGTGCCAGCCGGAGGATCGATACGCAGTATTTT	CASRRIDTQYF	TRBV28	TRBJ2-3
TGTGCCAGCAGTGACTCCCTTAGGGGCAATGAGCAGTTCTTC	CASSDSLRGNEQFF	TRBV6-4	TRBJ2-1
TGTGCCAGCAGTATAAGGCCAACAGCTTTCTTT	CASSIRPTAFF	TRBV7-3	TRBJ1-1
TGCAGCGTTGGGAGACAGAATTTCTTGGACACTGAAGCTTTCTTT	CSVGRQNFLDTEAFF	TRBV29-1	TRBJ1-1
TGTGCCAGCAGCTCCACCACCGGGACGAGATATAATTCACCCCTCCACTTT	CASSSTTGTRYNSPLHF	TRBV7-9	TRBJ1-6
TGTGCCACCAGTGATTTGCTAGGGACAGGCAGGATTCAGTACTTC	CATSDLLGTGRIQYF	TRBV24-1	TRBJ2-4
TGTGCCAGCAGTGACTCTCTGGGACAGGGGAACGCCTACGAGCAGTACTTC	CASSDSLGQGNAYEQYF	TRBV6-4	TRBJ2-7
TGTGCCAGCAGCGGACCGCGGTACAATGAGCAGTTCTTC	CASSGPRYNEQFF	TRBV28	TRBJ2-1
TGCGCCAGCAGTGAGAGCGACAGGCCAGTGAATGAGCAGTTCTTC	CASSESDRPVNEQFF	TRBV10-1	TRBJ2-1
TGTGCCAGCAGCCGTCTGACTGAGACCCAGTACTTC	CASSRLTETQYF	TRBV11-2	TRBJ2-5
TGCAGTGCTAGAGATACTGGGGGGGGGGCACGGGAACTTCGACACAATGAGCAGTTCTTC	CSARDTGGGARELRHNEQFF	TRBV20-1	TRBJ2-1
TGTGCCAGCAGACGGCTTAACACACGCATTCAGTACTTC	CASRRLNTRIQYF	TRBV6-5	TRBJ2-4
TGCGCCAGCAGTACCCAGCAGGAGAGGAGTAGGGGGTTCCACACTGAAGCTTTCTTT	CASSTQQERSRGFHTEAFF	TRBV10-1	TRBJ1-1
TGTGCCAGCAGTTACCGGGGGGGCTTAAACACCGGGGAGCTGTTTTTT	CASSYRGGLNTGELFF	TRBV6-2	TRBJ2-2
TGCAGTGCTAGAGATGACAGTTCACCCCTCCACTTT	CSARDDSSPLHF	TRBV20-1	TRBJ1-6
TGTGCCAGCAGCCAAGGGATTTGTGTCTGGCGGGTACCCTACGAGCAGTACTTC	CASSQGICVWRVPYEQYF	TRBV4-2	TRBJ2-7
TGTGCCAGTAGTATAGATTTTAGATTTGATGATACGCAGTATTTT	CASSIDFRFDDTQYF	TRBV19	TRBJ2-3
TGTGCCACCAGTGTCGCAGGGCAGGGCGTTAAGTACTTC	CATSVAGQGVKYF	TRBV24-1	TRBJ2-7
TGTGCCAGCAGAAGCCAGGAATGGGACGGGGATGAGCAGTTCTTC	CASRSQEWDGDEQFF	TRBV6-5	TRBJ2-1
TGTGCCAGCAGCTTAGTCCCTGGGGCTCTTTACGAGCAGTACTTC	CASSLVPGALYEQYF	TRBV7-2	TRBJ2-7
TGTGCCAGCAGTTACCTCCCGACTAGCTTAAGAGTCGAAACGGACACGCAGTATTTT	CASSYLPTSLRVETDTQYF	TRBV6-5	TRBJ2-3
TGCAGTGCCCCGGGGGCCCAGAATGGCTACACCTTC	CSAPGAQNGYTF	TRBV20-1	TRBJ1-2
TGTGCCACTGGGCCGAGCAGTGGGGGAGGTTCCTACGAGCAGTACTTC	CATGPSSGGGSYEQYF	TRBV24-1	TRBJ2-7
TGTGCCAGCAGTTTACCTAGCGGGCCTCGCGGGGAGCTGTTTTTT	CASSLPSGPRGELFF	TRBV12-4	TRBJ2-2
TGTGCCACCAGTGACCGTGGGACGTATGGCTACACCTTC	CATSDRGTYGYTF	TRBV24-1	TRBJ1-2
TGTGCCAGCCTCCCTAACACTGAAGCTTTCTTT	CASLPNTEAFF	TRBV9	TRBJ1-1
TGTGCCAGCAGGACCGACCACGAAAATTCACCCCTCCACTTT	CASRTDHENSPLHF	TRBV6-1	TRBJ1-6
TGTGCCAGCAGCGTGGGACTAGCGGGAGAGGGAGATACGCAGTATTTT	CASSVGLAGEGDTQYF	TRBV7-8	TRBJ2-3
TGTGCCAGCGTAAACTTTCAGGGGCGGGGCTACACCTTC	CASVNFQGRGYTF	TRBV14	TRBJ1-2
TGTGCCAGCAGCGTGGAGGGGGCGCAGGACACCGGGGAGCTGTTTTTT	CASSVEGAQDTGELFF	TRBV7-9	TRBJ2-2
TGCAGTGCTATCCGGGGGCGCAGTGCTTTCTTT	CSAIRGRSAFF	TRBV20-1	TRBJ1-1
TGTGCCAGCAGGCGTCCAGCACTCGGGTCCTACGAGCAGTACTTC	CASRRPALGSYEQYF	TRBV6-5	TRBJ2-7
TGTGCCAGCAGGCGCTATTATAGCGAGCAGTACTTC	CASRRYYSEQYF	TRBV12-4	TRBJ2-7
TGTGCCAGCAGTGCAGGGGGGGGAGACAATCAGCCCCAGCATTTT	CASSAGGGDNQPQHF	TRBV2	TRBJ1-5
TGTGCCAGCAGTTACTCGGCAGATACTAGCGGGAGCCTTTTGAACACTGAAGCTTTCTTT	CASSYSADTSGSLLNTEAFF	TRBV6-2	TRBJ1-1
TGCGGGCGGGAGGGGGAGACCCAGTACTTC	CGREGETQYF	TRBV5-1	TRBJ2-5
TGTGCCAGCAGCCTGACAGCCACTGAAGCTTTCTTT	CASSLTATEAFF	TRBV7-8	TRBJ1-1
TGTGCCAGTACTCGACAGGGCGTGCATCAGCCCCAGCATTTT	CASTRQGVHQPQHF	TRBV19	TRBJ1-5
TGTGCCAGCAGTTTACATACAGGGAAGAACGAGCAGTACTTC	CASSLHTGKNEQYF	TRBV12-3	TRBJ2-7
TGTGCCAGCAGTTCCGGCCAGAAAACAGTACCGCCTGACGAGCAGTACTTC	CASSSGQKTVPPDEQYF	TRBV6-2	TRBJ2-7
TGTGCCACCAGTGATTCCCCCGGCGAAGGGGTTGCCTACGAGCAGTACTTC	CATSDSPGEGVAYEQYF	TRBV24-1	TRBJ2-7
TGCGCCAGCAGCGTGCCGGCCCTAGCGGGCGGAAACACCGGGGAGCTGTTTTTT	CASSVPALAGGNTGELFF	TRBV5-1	TRBJ2-2
TGTGCCTGGAGCCCCCCGGGACAGGGTTATCGTCATCCCACCGGGGAGCTGTTTTTT	CAWSPPGQGYRHPTGELFF	TRBV30	TRBJ2-2
TGCAGCGTTGGGGGGGCGGCCCACACTGAAGCTTTCTTT	CSVGGAAHTEAFF	TRBV29-1	TRBJ1-1
TGCGCCAGCAGAAAACTAGGTCGGACAGGGGGCGTAGAAGCTTTCTTT	CASRKLGRTGGVEAFF	TRBV10-1	TRBJ1-1
TGTGCCAGCAGTAGGAATCAGCCCCAGCATTTT	CASSRNQPQHF	TRBV27	TRBJ1-5
TGTGCCAGCAGCACTAGGGCTAACTATGGCTACACCTTC	CASSTRANYGYTF	TRBV13	TRBJ1-2
TGTGCCAGCAGCGTAGAGAGACAATCGTATGGCTACACCTTC	CASSVERQSYGYTF	TRBV9	TRBJ1-2
TGTGCCACCAGAGGGGGGCGACGCCACCTGAACACTGAAGCTTTCTTT	CATRGGRRHLNTEAFF	TRBV24-1	TRBJ1-1
TGTGCCAGCCCCGATACAGGGCCAGGCCCCTACAATGAGCAGTTCTTC	CASPDTGPGPYNEQFF	TRBV5-4	TRBJ2-1
TGCAGTGCTTTTACGGAACCGCCCCAGCATTTT	CSAFTEPPQHF	TRBV20-1	TRBJ1-5
TGTGCCAGCAGTGGGACAGGGAATTTGGGACTGTTTTTT	CASSGTGNLGLFF	TRBV6-2	TRBJ1-4
TGCAGCGTTGAATGGGAGGACGGCTACGAGCAGTACTTC	CSVEWEDGYEQYF	TRBV29-1	TRBJ2-7
TGTGCCAGTAGCAGACTAGAGAGGAACCCGCTTGGGGCCAACGTCCTGACTTTC	CASSRLERNPLGANVLTF	TRBV19	TRBJ2-6
TGTGCCAGCAGCTCCGTTGTTTCCGGGACTAGCGGACTTCAAGCCTCCTACGAGCAGTACTTC	CASSSVVSGTSGLQASYEQYF	TRBV11-2	TRBJ2-7
TGTGCCAGCAGCCTCCAGCCGAACACCGGGGAGCTGTTTTTT	CASSLQPNTGELFF	TRBV5-4	TRBJ2-2
TGCAGCGTTGAAGATCCTGTATACAAGAACACTGAAGCTTTCTTT	CSVEDPVYKNTEAFF	TRBV29-1	TRBJ1-1
TGTGCCAGCAGCTTACTTTATACTAGCGGGGGAGGCTACAATGAGCAGTTCTTC	CASSLLYTSGGGYNEQFF	TRBV7-3	TRBJ2-1
TGTGCCAGCGTTGGGGGGTGGGCTGGAAACACCATATATTTT	CASVGGWAGNTIYF	TRBV2	TRBJ1-3
TGCGCCAGCAGCCATAGAAGACTAACTGGGGGTGAAGCTTTCTTT	CASSHRRLTGGEAFF	TRBV4-1	TRBJ1-1
TGTGCCAGCAGCAGGGGAGTCTTGGGGCGCTATGGCTACACCTTC	CASSRGVLGRYGYTF	TRBV7-8	TRBJ1-2
TGTGCCAGCAGTTTAGTACCCCCCGGGACAAGAAGGTATGAGCAGTTCTTC	CASSLVPPGTRRYEQFF	TRBV12-3	TRBJ2-1
TGTGCCAGCAGGAGGGGCGGGAGGGTGGCGGATGAGCAGTTCTTC	CASRRGGRVADEQFF	TRBV6-5	TRBJ2-1
TGTGCCACCCAGAAAAAGAACACCGGGGAGCTGTTTTTT	CATQKKNTGELFF	TRBV24-1	TRBJ2-2
TGTGCCAGCAGTATGAAAGGGACCAGCAATCAGCCCCAGCATTTT	CASSMKGTSNQPQHF	TRBV25-1	TRBJ1-5
TGTGCCAGCAGTTACATCCCCAAGGGAGCTGAAGCTTTCTTT	CASSYIPKGAEAFF	TRBV6-3	TRBJ1-1
TGTGCCAGCGGGGACGAAAGGAACGAGCAGTACTTC	CASGDERNEQYF	TRBV5-5	TRBJ2-7
TGTGCCAGCAGCGGAGCGCTGGCAGAAGAGACCCAGTACTTC	CASSGALAEETQYF	TRBV9	TRBJ2-5
TGCAGTGCTAGAGTTCAGAAGCAGTTCTTC	CSARVQKQFF	TRBV20-1	TRBJ2-1
TGTGCCATACAGGGACAGGGTTCTCAAGAGACCCAGTACTTC	CAIQGQGSQETQYF	TRBV10-3	TRBJ2-5
TGTGCCAGCAGCGTGAGGGCCCTCACAGATACGCAGTATTTT	CASSVRALTDTQYF	TRBV7-3	TRBJ2-3
TGTGCCACCAGTGTAACAAAACCGGGACAGAGCTCCTATAATTCACCCCTCCACTTT	CATSVTKPGQSSYNSPLHF	TRBV24-1	TRBJ1-6
TGTGCCAGCAGCGCAGGGTTCTATAGCACAGATACGCAGTATTTT	CASSAGFYSTDTQYF	TRBV5-4	TRBJ2-3
TGTGCCAGCAGCCAAGATTTGGACTTTTTCCACGAGCAGTACTTC	CASSQDLDFFHEQYF	TRBV4-2	TRBJ2-7
TGTGCTAGTGCCCCCTGTGAACGACTAGCCAAAAACATTCAGTACTTC	CASAPCERLAKNIQYF	TRBV12-5	TRBJ2-4
TGTGCCAGCAGCTTGGAGGTTGGACCAGATGGCTACACCTTC	CASSLEVGPDGYTF	TRBV5-4	TRBJ1-2
TGTGCCAGCAGTTTAAGGGACAGGGGAGGAGTGCCCCAGCATTTT	CASSLRDRGGVPQHF	TRBV27	TRBJ1-5
TGTGCTAGTGGTTTGGTCGTGACATGGAAGGGCTACACCTTC	CASGLVVTWKGYTF	TRBV12-5	TRBJ1-2
TGTGCCAGCAGTGAAGTCAGTTCTTCAGCGTTACCCATTGGGGGGGAACACACAGATACGCAGTATTTT	CASSEVSSSALPIGGEHTDTQYF	TRBV6-1	TRBJ2-3
TGTGCCACCAGTGACGAAGAGGGAACCAAAGGGGACATAGGGACTAATGAAAAACTGTTTTTT	CATSDEEGTKGDIGTNEKLFF	TRBV24-1	TRBJ1-4
TGTGCCAGCAGTGGTAGCGGATACGAGCAGTACTTC	CASSGSGYEQYF	TRBV3-1	TRBJ2-7
TGTGCCAGCAGTTTATTTGGGGAGGGGAGGTCCCCCTACGAGCAGTACTTC	CASSLFGEGRSPYEQYF	TRBV27	TRBJ2-7
TGTGCCAGCAGCGCCGGGGGGGACTTAAACTTCGCCTACGAGCAGTACTTC	CASSAGGDLNFAYEQYF	TRBV28	TRBJ2-7
TGTGCCACCCGGGGTACGAGCTCCTACGAGCAGTACTTC	CATRGTSSYEQYF	TRBV24-1	TRBJ2-7
TGTGCCAGCAGCTACCGACAGGGCCCCTTGGAGACCCAGTACTTC	CASSYRQGPLETQYF	TRBV7-3	TRBJ2-5
TGTGCCTTAGTGTACCTAGCGGGGGTTGAGCAGTACTTC	CALVYLAGVEQYF	TRBV30	TRBJ2-7
TGTGCCAGCAGCCTGAACACTGAAGCTTTCTTT	CASSLNTEAFF	TRBV7-3	TRBJ1-1
TGTGCCAGCAGGTCTCGGGTAAATCAGCCCCAGCATTTT	CASRSRVNQPQHF	TRBV12-3	TRBJ1-5
TGTGCCAGCAGATTGGTCAGGGGATACGAGCAGTACTTC	CASRLVRGYEQYF	TRBV6-1	TRBJ2-7
TGTGCCAGCAGTTTGGTAAATCAGGGGCCCGGCACTAACTATGGCTACACCTTC	CASSLVNQGPGTNYGYTF	TRBV28	TRBJ1-2
TGTGCCAGCAGCTATGGGGAGAGAAGCCATGGCTACACCTTC	CASSYGERSHGYTF	TRBV11-3	TRBJ1-2
TGTGCCACCAGCGTAGACAGCAATCAGCCCCAGCATTTT	CATSVDSNQPQHF	TRBV15	TRBJ1-5
TGTGCCAGCAGCGTGATCAGGGGGACTCCCCTCCAAGAGACCCAGTACTTC	CASSVIRGTPLQETQYF	TRBV9	TRBJ2-5
TGTGCCAGCAGCTGGGGAGGACAGCAAGAGACCCAGTACTTC	CASSWGGQQETQYF	TRBV13	TRBJ2-5
TGCGCCAGCAGCTTGTCCGCCCCATGGGTACTTGGCTACACCTTC	CASSLSAPWVLGYTF	TRBV5-1	TRBJ1-2
TGTGCCAGCAGCCAAGATCGGAGCGGGTGCGCGAACCAGCTAGCCAAAAACATTCAGTACTTC	CASSQDRSGCANQLAKNIQYF	TRBV14	TRBJ2-4
TGCGCCAGCAGCTGGTTGGGGTGGGGGGACGAGCAGTACTTC	CASSWLGWGDEQYF	TRBV5-1	TRBJ2-7
TGTGCCAGCAGTCTCCCTTTCCCCGGGACAGGTTTTGATGAGCAGTTCTTC	CASSLPFPGTGFDEQFF	TRBV27	TRBJ2-1
TGTGCCAGCAGGACGACTACAGGGTTGAGCAACGAGCAGTACTTC	CASRTTTGLSNEQYF	TRBV6-5	TRBJ2-7
TGCGCCAGCAGTGAGTCACTGGAGAATAGCGAGTACTTC	CASSESLENSEYF	TRBV10-1	TRBJ2-4
TGTGCCAAGGGGACTAACACCGGGGAGCTGTTTTTT	CAKGTNTGELFF	TRBV25-1	TRBJ2-2
TGCAGTGCCCCCATGTCGACAAATTCACCCCTCCACTTT	CSAPMSTNSPLHF	TRBV20-1	TRBJ1-6
TGTGCCAGCAGCTTAGTCGGGGGGGGGAACACCGGGGAGCTGTTTTTT	CASSLVGGGNTGELFF	TRBV7-9	TRBJ2-2
TGTGCCAGCAGCTTGAAGGGGACTAGCGGGGGTAGGTACGAGCAGTACTTC	CASSLKGTSGGRYEQYF	TRBV5-6	TRBJ2-7
TGTGCCAGCAGCTTATGGAGTCCCGGCACTGAAGCTTTCTTT	CASSLWSPGTEAFF	TRBV11-2	TRBJ1-1
TGTGCCAGGGGTGGAGGGGGCGAACACGGAAACACTGAAGCTTTCTTT	CARGGGGEHGNTEAFF	TRBV6-6	TRBJ1-1
TGTGCCAGCGCCCGTGGAGAACAGGGGAACGACGAGCAGTACTTC	CASARGEQGNDEQYF	TRBV6-2	TRBJ2-7
TGTGCCAGCAGCAAGGGGGCCGGGACGGAGGCGTTCAGGAGCTCCTATAATTCACCCCTCCACTTT	CASSKGAGTEAFRSSYNSPLHF	TRBV13	TRBJ1-6
TGTGCCAGCAGCCCAACTAGCGGGAGGGGTTCCCGCAATCAGCCCCAGCATTTT	CASSPTSGRGSRNQPQHF	TRBV11-3	TRBJ1-5
TGCGCCAGCAGTGAAATATTCCGAGCCGGGACAGGGACGACCCAGTACTTC	CASSEIFRAGTGTTQYF	TRBV10-1	TRBJ2-5
TGTGCCAGCAGCTGGGGGGGTAACTATGGCTACACCTTC	CASSWGGNYGYTF	TRBV5-4	TRBJ1-2
TGCAGTGCGGGACAGGGCTACGAGCAGTACTTC	CSAGQGYEQYF	TRBV20-1	TRBJ2-7
TGTGCCAGCAGCCCGGAAGCTATGACTAGCGGAGAAGGGACGCGCAATGAGCAGTTCTTC	CASSPEAMTSGEGTRNEQFF	TRBV11-2	TRBJ2-1
TGTGCCAGGGTCTTGGGTTCACCCCTCCACTTT	CARVLGSPLHF	TRBV5-4	TRBJ1-6
TGTGCCAGCAGCACTCGGAGGAATCAGCCCCAGCATTTT	CASSTRRNQPQHF	TRBV7-9	TRBJ1-5
TGTGCCAGTAGTATAATAGGGATCGGGCCAGCATCTGGGGCCAACGTCCTGACTTTC	CASSIIGIGPASGANVLTF	TRBV19	TRBJ2-6
TGTGCCAGCAGCAAAGGACGTGAGTACACCATATATTTT	CASSKGREYTIYF	TRBV7-4	TRBJ1-3
TGTGCCAGCAGTTACACGGGGGTTGGGAGGAATTCACCCCTCCACTTT	CASSYTGVGRNSPLHF	TRBV6-2	TRBJ1-6
TGTGCCAGCAGTTTACCTCTTCCTCAGGACAGGGGGAACTATGGCTACACCTTC	CASSLPLPQDRGNYGYTF	TRBV27	TRBJ1-2
TGTGCCACCAGTGCAACGGTCCGTGGGAGCTCCTATAATTCACCCCTCCACTTT	CATSATVRGSSYNSPLHF	TRBV24-1	TRBJ1-6
TGTGCCAGCATTCCACTAGCGGGAGTATTCTATGAGCAGTTCTTC	CASIPLAGVFYEQFF	TRBV2	TRBJ2-1
TGTGCCAGCTCACGGGACAGGGGTCTGAACACTGAAGCTTTCTTT	CASSRDRGLNTEAFF	TRBV18	TRBJ1-1
TGTGCCAGCAGCTTAGCCCATTCAACGACAGAGGGGTGCACTGAAGCTTTCTTT	CASSLAHSTTEGCTEAFF	TRBV11-3	TRBJ1-1
TGTGCCAGCATTCTACTAGCGGCAGGGTATTTT	CASILLAAGYF	TRBV28	TRBJ2-3
TGTGCCAGCATCAGAGGGGAGACCAGCAATCAGCCCCAGCATTTT	CASIRGETSNQPQHF	TRBV7-3	TRBJ1-5
TGTGCCATCAGGGGGCCAACTAATGAAAAACTGTTTTTT	CAIRGPTNEKLFF	TRBV10-3	TRBJ1-4
TGTGCCAGCAGTTACCCTCTACGTAGCAATCAGCCCCAGCATTTT	CASSYPLRSNQPQHF	TRBV27	TRBJ1-5
TGTGCCAGCAGCTTATCCCCTGGACAGTTTGCTGAAGCTTTCTTT	CASSLSPGQFAEAFF	TRBV7-3	TRBJ1-1
TGTGCCATCAGTGTTCGCCGGGACGGCTCCTACGAGCAGTACTTC	CAISVRRDGSYEQYF	TRBV10-3	TRBJ2-7
TGTGCCAGCATGGGTTTCCACTCCGACTATGGCTACACCTTC	CASMGFHSDYGYTF	TRBV6-2	TRBJ1-2
TGTGCCAGCAGCTTAGAAGTCCGGGACAGATCTTCCCCTGGCTACACCTTC	CASSLEVRDRSSPGYTF	TRBV11-2	TRBJ1-2
TGTGCCATCAGACCTCCTACTGCAAGGATTGGGGCCTCTGGGGCCAACGTCCTGACTTTC	CAIRPPTARIGASGANVLTF	TRBV10-3	TRBJ2-6
TGTGCCAGCAGCGGGGCCATCAGGGTCTATGGCTACACCTTC	CASSGAIRVYGYTF	TRBV7-4	TRBJ1-2
TGTGCCATCAGTGAGGGTGGACTAGCGGAAGAGACCCAGTACTTC	CAISEGGLAEETQYF	TRBV10-3	TRBJ2-5
TGTGCCAGCAGCTGGGGGGCAGGTAATGAAAAACTGTTTTTT	CASSWGAGNEKLFF	TRBV5-4	TRBJ1-4
TGTGCCAGCCTGGCGGGGGACAGCGGGAAACGGAATGAAAAACTGTTTTTT	CASLAGDSGKRNEKLFF	TRBV7-4	TRBJ1-4
TGCGCCAGCAGTGAGTCTCCCCAGGGACTAGCGGGGGGGCCGGGACCCTACGAGCAGTACTTC	CASSESPQGLAGGPGPYEQYF	TRBV10-1	TRBJ2-7
TGCGCCAGCAGCTTTACCTCGACAGGGGCTAATGAAAAACTGTTTTTT	CASSFTSTGANEKLFF	TRBV5-1	TRBJ1-4
TGTGCCAGCAGTTCAGAGTCTGGGAGGCGCCCGAATGAAAAACTGTTTTTT	CASSSESGRRPNEKLFF	TRBV27	TRBJ1-4
TGTGCCAGCAGTGACCAGACAACAGCTTTCTTT	CASSDQTTAFF	TRBV2	TRBJ1-1
TGTGCCAGCAGTTCGGACAGGGGGGAGTACACTGAAGCTTTCTTT	CASSSDRGEYTEAFF	TRBV6-2	TRBJ1-1
TGTGCCAGCAGTGACACTAGGGACAGATTTTGGGCGCATCAGCCCCAGCATTTT	CASSDTRDRFWAHQPQHF	TRBV6-4	TRBJ1-5
TGTGCCATCACCCCCGAATGGGTGCTTCCTAGCGGGGGGGCCAGGGACAATGAGCAGTTCTTC	CAITPEWVLPSGGARDNEQFF	TRBV10-3	TRBJ2-1
TGTGCCAGCAGTGTCGGACAGGGCACTGGAAACACCATATATTTT	CASSVGQGTGNTIYF	TRBV6-2	TRBJ1-3
TGCAACCGCTATAGGGGGCACTGTGGGGCCAACGTCCTGACTTTC	CNRYRGHCGANVLTF	TRBV20-1	TRBJ2-6
TGCACCGACGGGACAGGCTACGAGCAGTACTTC	CTDGTGYEQYF	TRBV20-1	TRBJ2-7
TGTGCCAGCAAGACCAGGGGAGGCTACACCTTC	CASKTRGGYTF	TRBV14	TRBJ1-2
TGTGCCAGCAGTTCAGAAAAAGAGACCCAGTACTTC	CASSSEKETQYF	TRBV27	TRBJ2-5
TGTGCCAGCAGCTTAGGCCAGGGTCTTATCCACACCGGGGAGCTGTTTTTT	CASSLGQGLIHTGELFF	TRBV5-6	TRBJ2-2
TGTGCCAGCAGTTACGACATTCGAGTAAGCAATGAAAAACTGTTTTTT	CASSYDIRVSNEKLFF	TRBV6-6	TRBJ1-4
TGTGCCAGTTTCAAGGAAGAGACCCAGTACTTC	CASFKEETQYF	TRBV19	TRBJ2-5
TGTGCCAGTAGTATAACGACTCCGGGACAGGGGAATCAGCCCCAGCATTTT	CASSITTPGQGNQPQHF	TRBV19	TRBJ1-5
TGTGCCAGCAGCTCGGATCCCTACAATGAGCAGTTCTTC	CASSSDPYNEQFF	TRBV7-3	TRBJ2-1
TGCAGCCCCATCCGGGACAGTTCGCGTGACAATGAGCAGTTCTTC	CSPIRDSSRDNEQFF	TRBV29-1	TRBJ2-1
TGTGCCCCTCCTAGCGGGAGGGGGAACACCGGGGAGCTGTTTTTT	CAPPSGRGNTGELFF	TRBV28	TRBJ2-2
TGTGCCAGCAGCTCGGGGGGGCCGCGCGAGCAGTACTTC	CASSSGGPREQYF	TRBV13	TRBJ2-7
TGTGCCAGCAGCGAATCAGGGGACTTTAACTATGGCTACACCTTC	CASSESGDFNYGYTF	TRBV13	TRBJ1-2
TGTGCCAGCATTCGAGGGAAGGGCTACGAGCAGTACTTC	CASIRGKGYEQYF	TRBV27	TRBJ2-7
TGTGCCCAAGCCCGGGGGACATGTACCGGGGAGCTGTTTTTT	CAQARGTCTGELFF	TRBV7-6	TRBJ2-2
TGTGCCAGCAGCTCTGGGAGGGGGTTGAACACTGAAGCTTTCTTT	CASSSGRGLNTEAFF	TRBV7-4	TRBJ1-1
TGCAGCGTTTTCCGACAGGGGCGATATCAGCCCCAGCATTTT	CSVFRQGRYQPQHF	TRBV29-1	TRBJ1-5
TGCAGTGCTAGGCTAGCGGGAGGGCTCTCCTACGAGCAGTACTTC	CSARLAGGLSYEQYF	TRBV20-1	TRBJ2-7
TGTGCCGGCAGTTTTCCGAACACCGGGGAGCTGTTTTTT	CAGSFPNTGELFF	TRBV27	TRBJ2-2
TGTGCCAGCAGCGTAGACTCGGGCCCAGAAGGCTACACCTTC	CASSVDSGPEGYTF	TRBV9	TRBJ1-2
TGTGCCAGCAGCGCATGGGCGGTATCCTTCAGAGAAATGGGTAGTAATGGCTACACCTTC	CASSAWAVSFREMGSNGYTF	TRBV7-9	TRBJ1-2
TGTGCCAGCAGAAGGCCGCGACGTCCGGGCTACGAGCAGTACTTC	CASRRPRRPGYEQYF	TRBV6-6	TRBJ2-7
TGTGCCAGCAGCCAAGACCCCGACAGGGAGGAGTACGAGCAGTACTTC	CASSQDPDREEYEQYF	TRBV4-2	TRBJ2-7
TGTGCCAGCCCATTAGGAGGGTTCTACAATGAGCAGTTCTTC	CASPLGGFYNEQFF	TRBV11-3	TRBJ2-1
TGTGCCAGCAGCAGCAGGGGGGGGAGCTCCTACGAGCAGTACTTC	CASSSRGGSSYEQYF	TRBV5-6	TRBJ2-7
TGCAGTGCTAGGCGAGTAACGGGGGGCGGGGACGAGCAGTACTTC	CSARRVTGGGDEQYF	TRBV20-1	TRBJ2-7
TGTGCCAGCAGCCATAAACGGGACAGGGATAGCAATCAGCCCCAGCATTTT	CASSHKRDRDSNQPQHF	TRBV7-6	TRBJ1-5
TGTGCCAGCAGTACACGGGGGCTCAAACTAGAGACCCAGTACTTC	CASSTRGLKLETQYF	TRBV27	TRBJ2-5
TGTGCCAGCAGCTTTCCGGGGAGATCAAAAGAGACCCAGTACTTC	CASSFPGRSKETQYF	TRBV7-2	TRBJ2-5
TGTGCCAGCAGTTTGCGGAGCAGTGTCAGCTCCTACGAGCAGTACTTC	CASSLRSSVSSYEQYF	TRBV12-3	TRBJ2-7
TGTGCCAGCAGTGACTCGAGCAGGGAAATGCCGCCGGGAAGTAGGGACTCTGGGGCCAACGTCCTGACTTTC	CASSDSSREMPPGSRDSGANVLTF	TRBV6-4	TRBJ2-6
TGCGCCAGCAGATCAGGAAGGGGGAACACTGAAGCTTTCTTT	CASRSGRGNTEAFF	TRBV10-1	TRBJ1-1
TGTGCCAGCAGAGTTGGGACTAGCGGCGGTCCGGGGGATACGCAGTATTTT	CASRVGTSGGPGDTQYF	TRBV6-2	TRBJ2-3
TGTGCCAGCAGTGGGACTAGGACCCAAGAGACCCAGTACTTC	CASSGTRTQETQYF	TRBV6-1	TRBJ2-5
TGTGCCAGCAGCAAGACAGGGAAAACCTACGAGCAGTACTTC	CASSKTGKTYEQYF	TRBV7-9	TRBJ2-7
TGTGCCATCAGTATTGAGGGGGGCGGGGGAAATGAGCAGTTCTTC	CAISIEGGGGNEQFF	TRBV10-3	TRBJ2-1
TGTGCCAGCAGCCTTCCGCCGGGACTGGATACGCAGTATTTT	CASSLPPGLDTQYF	TRBV7-3	TRBJ2-3
TGCAGTGCTAGAGGGTCCGACCTCTACAGGGGTAGGTATGGCTACACCTTC	CSARGSDLYRGRYGYTF	TRBV20-1	TRBJ1-2
TGTGCCAGCAGTTTGGCGGGCAATCAGCCCCAGCATTTT	CASSLAGNQPQHF	TRBV27	TRBJ1-5
TGTGCCAGCAGCGGCCGCGGCTCGGTTTTAGTTTACGAGCAGTACTTC	CASSGRGSVLVYEQYF	TRBV13	TRBJ2-7
TGTGCCAGCAGCTTGCGTTCTAGGGGGGCGTATGAGCAGTTCTTC	CASSLRSRGAYEQFF	TRBV9	TRBJ2-1
TGTGCCAGCAGCTTGATCGTCTTGGGGCCAAAGTACGAGCAGTACTTC	CASSLIVLGPKYEQYF	TRBV5-6	TRBJ2-7
TGTGCCAGCAGCGCCCCCCTGGGGGACAGCGCGGGCACTGAAGCTTTCTTT	CASSAPLGDSAGTEAFF	TRBV5-4	TRBJ1-1
TGTGCCAGCAGCTTAGGGATCCTAGTGCTTGAGACCCAGTACTTC	CASSLGILVLETQYF	TRBV7-4	TRBJ2-5
TGTGCCAGCAGCCCCGCGATTTCTTCAAGGGCAGATACGCAGTATTTT	CASSPAISSRADTQYF	TRBV6-5	TRBJ2-3
TGCGCCAGCAGCGAGCCGGTGAACACTGAAGCTTTCTTT	CASSEPVNTEAFF	TRBV5-1	TRBJ1-1
TGTGCCAGCGGGCTCGGCGGGACAGGGGATTGCCGAAATTCACCCCTCCACTTT	CASGLGGTGDCRNSPLHF	TRBV7-2	TRBJ1-6
TGTGCCAGTAGTATAGAACGCGGGGGAGGAACCGGGGAGCTGTTTTTT	CASSIERGGGTGELFF	TRBV19	TRBJ2-2
TGTGCCAGCAGCCAAGACGTCGGGCCCGAAGAGACCCAGTACTTC	CASSQDVGPEETQYF	TRBV14	TRBJ2-5
TGCAGTGCTAGAGATTTTTGCTATTCCCCGGGGACGGGCAATCAGCCCCAGCATTTT	CSARDFCYSPGTGNQPQHF	TRBV20-1	TRBJ1-5
TGTGCCAGCAGCTCGCGTAGCCCTGAAGCTTTCTTT	CASSSRSPEAFF	TRBV7-8	TRBJ1-1
TGTGCCAGCAGCATCAGGGGGACTAGCGGGAGGGTCAAGGCAACTAATGAAAAACTGTTTTTT	CASSIRGTSGRVKATNEKLFF	TRBV11-3	TRBJ1-4
TGCGCCAGCAGCCACGGGACAGGGGGGAAAGATACGCAGTATTTT	CASSHGTGGKDTQYF	TRBV4-3	TRBJ2-3
TGTGCCACCAGCCGTCAGTTCCTACTAGCGGGGGGGCCCGGGGGTGACACCGGGGAGCTGTTTTTT	CATSRQFLLAGGPGGDTGELFF	TRBV24-1	TRBJ2-2
TGTGCCACCAGTGATGAAGCAATCAGGCCAGCACCCCTCCACTTT	CATSDEAIRPAPLHF	TRBV24-1	TRBJ1-6
TGTGCCAGCAGTCCACGGCTCCCCGGACAGGGGTTATATCAGCCCCAGCATTTT	CASSPRLPGQGLYQPQHF	TRBV6-3	TRBJ1-5
TGCGCCAGCAAACCACAGGGCTACACTGAAGCTTTCTTT	CASKPQGYTEAFF	TRBV5-1	TRBJ1-1
TGCGCCAGCAGCCAGCAGGGCTCCAATGAAAAACTGTTTTTT	CASSQQGSNEKLFF	TRBV4-3	TRBJ1-4
TGTGCCAGCAGCTGGTGGGGCGGTAGCAATCAGCCCCAGCATTTT	CASSWWGGSNQPQHF	TRBV7-9	TRBJ1-5
TGTGCCAGCAGTTACGCCGAGAGGTCTCATCCCCGGGGCATGAACACTGAAGCTTTCTTT	CASSYAERSHPRGMNTEAFF	TRBV6-5	TRBJ1-1
TGTGCCAGCAGCCAACTCGACACCGGGGAGCTGTTTTTT	CASSQLDTGELFF	TRBV4-2	TRBJ2-2
TGTGCCACCAGTGATTCCAACAGGGGACTTAAGGGAAACACCATATATTTT	CATSDSNRGLKGNTIYF	TRBV24-1	TRBJ1-3
TGCGCCAGCAGTGAGACTGACAGGGTCTACGAGCAGTACTTC	CASSETDRVYEQYF	TRBV10-1	TRBJ2-7
TGTGCCAGCAGTCGACAGGGCCCGATGAACACTGAAGCTTTCTTT	CASSRQGPMNTEAFF	TRBV27	TRBJ1-1
TGTGCCACCGGGGGGGCTAGGACCCAGTACTTC	CATGGARTQYF	TRBV24-1	TRBJ2-5
TGTGCCAGCAGCTCACGAGGGACAGGGGCAGCTTTCTTT	CASSSRGTGAAFF	TRBV7-7	TRBJ1-1
TGTGCCAGCAGCTTGTTCAACGGGACAGGGCTTCAGCCCCAGCATTTT	CASSLFNGTGLQPQHF	TRBV5-5	TRBJ1-5
TGCAGTGCTAGAGAGGGGAAATTTCAGCCCCAGCATTTT	CSAREGKFQPQHF	TRBV20-1	TRBJ1-5
TGTGCCTGGAGTGTTAAGACTAGCGGGTCGAATGAGCAGTTCTTC	CAWSVKTSGSNEQFF	TRBV30	TRBJ2-1
TGCAGTGCTTCCCTCCGGGACAGGGAGCATAATCCCCCGTACTTC	CSASLRDREHNPPYF	TRBV20-1	TRBJ2-4
TGTGCCAGCAGAGGACGAGCGGGACCAAACTATGGCTACACCTTC	CASRGRAGPNYGYTF	TRBV6-1	TRBJ1-2
TGCGCCAGCAGCTCCCTTGAGATGGGACTAGCGGGGGACTACGAGCAGTACTTC	CASSSLEMGLAGDYEQYF	TRBV5-1	TRBJ2-7
TGTGCCAGTAGTATCAGGGGGTTCCTTAGGCCAGGCCGCAATCAGCCCCAGCATTTT	CASSIRGFLRPGRNQPQHF	TRBV19	TRBJ1-5
TGTGCCAGCAGCAAAGATGAGGGACTATCCTACGAGCAGTACTTC	CASSKDEGLSYEQYF	TRBV7-3	TRBJ2-7
TGCGCCTACGAAAAACAGTTAGGCAATCAGCCCCAGCATTTT	CAYEKQLGNQPQHF	TRBV10-1	TRBJ1-5
TGTGCCAGCGAGGGGAGGGTTCCGTTGGGGGATTGCACAGATACGCAGTATTTT	CASEGRVPLGDCTDTQYF	TRBV9	TRBJ2-3
TGTGCCAGCAGCACAGAACGGACAGGGAACTACGAGCAGTACTTC	CASSTERTGNYEQYF	TRBV6-5	TRBJ2-7
TGTGCCAGCAGCTTGGCTAGTAGGGCCGGGATGGTCACTGAAGCTTTCTTT	CASSLASRAGMVTEAFF	TRBV5-5	TRBJ1-1
TGCGCCAGCAGCCCTTCGACTAGTAGGCAGGATGGACACTTC	CASSPSTSRQDGHF	TRBV4-1	TRBJ2-7
TGCAGTGCACTAGGGGACCCCGGATACGAGCAGTACTTC	CSALGDPGYEQYF	TRBV20-1	TRBJ2-7
TGTGCCAGCAGCTCCGCGGGGACAGGCGAGGAGACCCAGTACTTC	CASSSAGTGEETQYF	TRBV7-6	TRBJ2-5
TGTGCCAGCAGCTCTCCCGGGACAGGGGCCGGGTATAGCAATCAGCCCCAGCATTTT	CASSSPGTGAGYSNQPQHF	TRBV7-4	TRBJ1-5
TGTGCCAGAGACGGGACAGGGCCATGCCAAGAGACCCAGTACTTC	CARDGTGPCQETQYF	TRBV13	TRBJ2-5
TGTGCCAGCAGTTTGTGGGGGACAGCTTCTTTTCAGCCCCAGCATTTT	CASSLWGTASFQPQHF	TRBV12-4	TRBJ1-5
TGTGCCAGCAGCTTAGGATGCGGTGGGGGGGCCAACGTCCTGACTTTC	CASSLGCGGGANVLTF	TRBV7-7	TRBJ2-6
TGTGCCTGGAGTGTAATTACCCGCAGGGAGTTTGGCTACACCTTC	CAWSVITRREFGYTF	TRBV30	TRBJ1-2
TGTGCCATCAGGGGTGGGGACGAGCAGTACTTC	CAIRGGDEQYF	TRBV10-3	TRBJ2-7
TGTGCCAGCAGCTTGGGGGGTGACAATGAGCAGTTCTTC	CASSLGGDNEQFF	TRBV5-4	TRBJ2-1
TGTGCCAGCAGTTACACCCGGGGCCGTTCCCCAACAGCCTCTGGGGCCAACGTCCTGACTTTC	CASSYTRGRSPTASGANVLTF	TRBV6-3	TRBJ2-6
TGTGCCAGCAGCCAAGTAACCCTCAGGGAAAGCTGCTACGAGCAGTACTTC	CASSQVTLRESCYEQYF	TRBV14	TRBJ2-7
TGTGCCACCCTATGGGGGGGGGGATATGAGCAGTTCTTC	CATLWGGGYEQFF	TRBV28	TRBJ2-1
TGTGCCATCATGTACTCTGGCCTTGAAAAACTGTTTTTT	CAIMYSGLEKLFF	TRBV10-3	TRBJ1-4
TGTGCCAGCAGCTTGGCGCGGGAGTGCTTCTACGAGCAGTACTTC	CASSLARECFYEQYF	TRBV7-3	TRBJ2-7
TGCGCCAGCGAACAGGGGAGGGCTTCCTACGAGCAGTACTTC	CASEQGRASYEQYF	TRBV4-1	TRBJ2-7
TGTGCCAGCTGGGGACTGGCACCCCTCCACTTT	CASWGLAPLHF	TRBV24-1	TRBJ1-6
TGTGCCAGCAGCCAAGAATTCAACAGGGTCTGGATAGCTTTCTTT	CASSQEFNRVWIAFF	TRBV3-1	TRBJ1-1
TGTGCCAGCAGTTCCCGGGGGTTGAACACCGGGGAGCTGTTTTTT	CASSSRGLNTGELFF	TRBV6-1	TRBJ2-2
TGTGCCAGCAGTCGCTGCGACCCCGGGGAGCTGTTTTTT	CASSRCDPGELFF	TRBV28	TRBJ2-2
TGTGCCAGCAGTTACCCCGTTCCCTCTAGGTTAAAGGCCAAAAACATTCAGTACTTC	CASSYPVPSRLKAKNIQYF	TRBV6-2	TRBJ2-4
TGTGCCAGCAGTTACCCGACAGGATTCAATCAGCCCCAGCATTTT	CASSYPTGFNQPQHF	TRBV6-2	TRBJ1-5
TGTGCCTGGAGTATTCACCACGGGACACGCCGGGGTCCCAAAAACATTCAGTACTTC	CAWSIHHGTRRGPKNIQYF	TRBV30	TRBJ2-4
TGTGCCAGCAGCCTGGGAGGGAGAGGAATTCAGGGAAACACCATATATTTT	CASSLGGRGIQGNTIYF	TRBV28	TRBJ1-3
TGTGCCAGCAGTTACTCGAATTGCAGGGTCCCCGGAAACACCATATATTTT	CASSYSNCRVPGNTIYF	TRBV6-6	TRBJ1-3
TGTGCCAGCACCGAAAAGGGGAAGAACACTGAAGCTTTCTTT	CASTEKGKNTEAFF	TRBV6-5	TRBJ1-1
TGTGCCACCGGGGGGGGGGGTGAAAAACTGTTTTTT	CATGGGGEKLFF	TRBV2	TRBJ1-4
TGTGCCAGCAGGTGCTGGACAGGGAGCACAGATACGCAGTATTTT	CASRCWTGSTDTQYF	TRBV6-5	TRBJ2-3
TGTGCCAGAGCGGGACTAGCGGGGCATCAAGAGACCCAGTACTTC	CARAGLAGHQETQYF	TRBV19	TRBJ2-5
TGTGCCAGCAGCGTAGAGCAGGGGCATGGGCGGGCTGGAAACACCATATATTTT	CASSVEQGHGRAGNTIYF	TRBV9	TRBJ1-3
TGTGCCATTCTTTCCGGGACAAGCGGAAACACCATATATTTT	CAILSGTSGNTIYF	TRBV10-3	TRBJ1-3
TGCAGTGCTCCCCGGGACAGCACTGGCTACACCTTC	CSAPRDSTGYTF	TRBV20-1	TRBJ1-2
TGTGCCAGCAGCTGGGGCGACAATGAGCAGTTCTTC	CASSWGDNEQFF	TRBV7-9	TRBJ2-1
TGTGCCAGCTCACCGACCTGCACCATCGTTAGCACAGATACGCAGTATTTT	CASSPTCTIVSTDTQYF	TRBV18	TRBJ2-3
TGTGCCAGCAGTTACTCGGTGGAGCTTACGCAGTATTTT	CASSYSVELTQYF	TRBV6-6	TRBJ2-3
TGCGCCAGCAGCCATGTCCCGGGACAGGGCGTCACCGGGGAGCTGTTTTTT	CASSHVPGQGVTGELFF	TRBV4-1	TRBJ2-2
TGTGCCACCCCATGGGGCCCGGGGACGACAGATACGCAGTATTTT	CATPWGPGTTDTQYF	TRBV15	TRBJ2-3
TGTGCCAGCAGCGGCGAACGGGGAGGGCTGGCCGAGGTTGGCTACACCTTC	CASSGERGGLAEVGYTF	TRBV9	TRBJ1-2
TGCAGTGCTAGGTTCCCCACCAATCAGCCCCAGCATTTT	CSARFPTNQPQHF	TRBV20-1	TRBJ1-5
TGTGCCAGCAGTTTCCCGACAGGCCCGGTTTATGGCTACACCTTC	CASSFPTGPVYGYTF	TRBV27	TRBJ1-2
TGTGCCAGCAGCCCCCCTACACTAGCGGGAGCTGGAGGGGCGCCAGACACCGGGGAGCTGTTTTTT	CASSPPTLAGAGGAPDTGELFF	TRBV13	TRBJ2-2
TGTGCCAGCAGCGGGGGACTAGTCTACGAGCAGTACTTC	CASSGGLVYEQYF	TRBV11-3	TRBJ2-7
TGTGCCAGCAGTTCTCCTCCTACTAGCGGGAGAGGCTATGGCTACACCTTC	CASSSPPTSGRGYGYTF	TRBV12-3	TRBJ1-2
TGCGCCAGCAGCCACAGGGGGGACCCTGAGACCCAGTACTTC	CASSHRGDPETQYF	TRBV4-1	TRBJ2-5
TGTGCCACCAGTGATTCCCCTAGCGGTAATGAGCAGTTCTTC	CATSDSPSGNEQFF	TRBV24-1	TRBJ2-1
TGTGCCAGCAGTGTTATACTAGCGGGGGGTCACGAGCAGTACTTC	CASSVILAGGHEQYF	TRBV27	TRBJ2-7
TGCGCCAGCAGCCAAGAAGGGACTCATCTCTACAATGAGCAGTTCTTC	CASSQEGTHLYNEQFF	TRBV4-1	TRBJ2-1
TGCAGTGCTAAGTCCCCAAGGTACTACAATGAGCAGTTCTTC	CSAKSPRYYNEQFF	TRBV20-1	TRBJ2-1
TGTGCCAGCAGCTTAGCGACTTACACCATATATTTT	CASSLATYTIYF	TRBV7-9	TRBJ1-3
TGTGCCAGTCGCGGGGGGTCCTTAGAGCAGTTCTTC	CASRGGSLEQFF	TRBV13	TRBJ2-1
TGTGCCAGCAGTTACCGGACAGGGGGCGAGGAAAATCAGCCCCAGCATTTT	CASSYRTGGEENQPQHF	TRBV6-6	TRBJ1-5
TGTGCCAGTTGTCGGGGCAATCAGCCCCAGCATTTT	CASCRGNQPQHF	TRBV6-4	TRBJ1-5
TGTGCCAGCAGTTTCGGCGGCTACACCTTC	CASSFGGYTF	TRBV6-1	TRBJ1-2
TGTGCCAGCAGCTCTCCCAGGGCCGAAGTCTACGAGCAGTACTTC	CASSSPRAEVYEQYF	TRBV5-6	TRBJ2-7
TGTGCCATTGCCGGGACGCCCTACAATGAGCAGTTCTTC	CAIAGTPYNEQFF	TRBV12-4	TRBJ2-1
TGTGCCAGCAGCCGGGGGTACGTCCTGACTTTC	CASSRGYVLTF	TRBV7-3	TRBJ2-6
TGTGCCTGGATCGGGGGGGCCCTTTCGTACAATGAGCAGTTCTTC	CAWIGGALSYNEQFF	TRBV30	TRBJ2-1
TGTGCCAGCAGCAATAGACTTGCCGAGCAGTACTTC	CASSNRLAEQYF	TRBV14	TRBJ2-7
TGTGCCAGCAGCGAACTCAGGGGCAATCAGCCCCAGCATTTT	CASSELRGNQPQHF	TRBV12-3	TRBJ1-5
TGCAGCGCCCGAAGCGGGAGATTCGACGAGCAGTACTTC	CSARSGRFDEQYF	TRBV29-1	TRBJ2-7
TGTGCCAGCAGTGAAGGAACCGGGTTGCAGTACTTC	CASSEGTGLQYF	TRBV2	TRBJ2-7
TGCGCCAGCTACAGGGGGCGGGGTCAAGAGACCCAGTACTTC	CASYRGRGQETQYF	TRBV10-1	TRBJ2-5
TGTGCCAGCACTGTTGCATCTAGCGGGAGATCTTACGAGCAGTACTTC	CASTVASSGRSYEQYF	TRBV2	TRBJ2-7
TGTGCCAGCAGTGGGGGGGGACTAGCGTGTGCGCAGTACTTC	CASSGGGLACAQYF	TRBV2	TRBJ2-7
TGCGCCAGCAGCCGGCTGTTCAATCAGCCCCAGCATTTT	CASSRLFNQPQHF	TRBV5-1	TRBJ1-5
TGTGCCAGCCAACCGGGACTAGCGACAGATACGCAGTATTTT	CASQPGLATDTQYF	TRBV6-4	TRBJ2-3
TGTGCCAGCAGAAACCTGGCGGGGGAGGGCGCCTACGAGCAGTACTTC	CASRNLAGEGAYEQYF	TRBV12-3	TRBJ2-7
TGTGCCAGCAGTATCTGGACAGGGGAGGTTAAGCCAAATCAGCCCCAGCATTTT	CASSIWTGEVKPNQPQHF	TRBV28	TRBJ1-5
TGCAGTGCACTGTCAGAGAACACTGAAGCTTTCTTT	CSALSENTEAFF	TRBV20-1	TRBJ1-1
TGTGCCAGTAGTATGATGAACAGGGAGGAAGCCGACAATGAGCAGTTCTTC	CASSMMNREEADNEQFF	TRBV19	TRBJ2-1
TGTGCCACCAGTGATTTCTTGGGGGTAGTGACTTACGAGCAGTACTTC	CATSDFLGVVTYEQYF	TRBV24-1	TRBJ2-7
TGTGCCAGTAGTGAGACAGGGTCTGATGAAAAACTGTTTTTT	CASSETGSDEKLFF	TRBV19	TRBJ1-4
TGTGCCAGCCCCCTGGGGGGAAGCACAGATACGCAGTATTTT	CASPLGGSTDTQYF	TRBV6-2	TRBJ2-3
TGTGCCACCAGTGACCCGGTGACCCAGGGTGTCACGAACACCGGGGAGCTGTTTTTT	CATSDPVTQGVTNTGELFF	TRBV24-1	TRBJ2-2
TGCGCCAGCAGCTCCATTACCTCAGGAGTATGTTTCCTGTCTGCAACTAATGAAAAACTGTTTTTT	CASSSITSGVCFLSATNEKLFF	TRBV5-1	TRBJ1-4
TGTGCCAGCAGTCGACTCCCCCGCCGGGACATGGCAGATACGCAGTATTTT	CASSRLPRRDMADTQYF	TRBV6-1	TRBJ2-3
TGTGCCAGCCTTAGACAGGTTTGCGGGTCCCAGGAGACCCAGTACTTC	CASLRQVCGSQETQYF	TRBV28	TRBJ2-5
TGTGCCAGCAGCTCAATAGGTCGCGGGAGGCTCCCTGGAAACACCATATATTTT	CASSSIGRGRLPGNTIYF	TRBV7-8	TRBJ1-3
TGTGCCAGCAGTGAAGCGGGGGGGCTCAATGAGCAGTTCTTC	CASSEAGGLNEQFF	TRBV6-1	TRBJ2-1
TGTGCCAGCAGTGTCCTCACCGGGGAGCTGTTTTTT	CASSVLTGELFF	TRBV28	TRBJ2-2
TGCAGTGCTAGAGATGGCCCAGGGTCAACCAAAGAGACCCAGTACTTC	CSARDGPGSTKETQYF	TRBV20-1	TRBJ2-5
TGCCGGAGACTAGAGTTATCCGAGCAGTACTTC	CRRLELSEQYF	TRBV20-1	TRBJ2-7
TGTGTCGCACAAACCGGGACAGGGGAACGTCAAGAGACCCAGTACTTC	CVAQTGTGERQETQYF	TRBV6-4	TRBJ2-5
TGTGCCAGCCCCCAGGGGATCACAGATACGCAGTATTTT	CASPQGITDTQYF	TRBV2	TRBJ2-3
TGTGCCAGCAGCTACCGGCTTAACACTGAAGCTTTCTTT	CASSYRLNTEAFF	TRBV7-9	TRBJ1-1
TGTGCCAGCAGCAATCCCAAGGGGGAGAGCTACAATGAGCAGTTCTTC	CASSNPKGESYNEQFF	TRBV7-9	TRBJ2-1
TGTGCCAGCAGCTTAGCCAAGACAGGGCAGCCCCAGCATTTT	CASSLAKTGQPQHF	TRBV7-9	TRBJ1-5
TGTGCCAGCAGCATACCGGGCCCTTATGAGCAGTTCTTC	CASSIPGPYEQFF	TRBV7-9	TRBJ2-1
TGTGCCAGCAGCACATGGAGGAAGAAAGAGACCCAGTACTTC	CASSTWRKKETQYF	TRBV7-4	TRBJ2-5
TGCAGTGCGGAATCCTTCCATGTTTTCAAACAAGAGACCCAGTACTTC	CSAESFHVFKQETQYF	TRBV20-1	TRBJ2-5
TGTGCCAGCAGCCAAGATCGCCGTTCGGAGGGGATCACAGATACGCAGTATTTT	CASSQDRRSEGITDTQYF	TRBV4-2	TRBJ2-3
TGTGCCAGCAGCCGTTCTGACAGGGGAAACAGAGGGTCCTATAATTCACCCCTCCACTTT	CASSRSDRGNRGSYNSPLHF	TRBV14	TRBJ1-6
TGTGCCAGCAGTGAAAGGGGGGCCGGACCTGGAAACACCATATATTTT	CASSERGAGPGNTIYF	TRBV6-4	TRBJ1-3
TGTGCCAGCAGCCAAGCCAGCAGCCCGCAGCCCCAGCATTTT	CASSQASSPQPQHF	TRBV14	TRBJ1-5
TGTGCCAGCAGCCAAGGCCCCAGCCCCCCCAGGGCCTACGAGCAGTACTTC	CASSQGPSPPRAYEQYF	TRBV14	TRBJ2-7
TGTGCCAGCAGCGGGGTCGAGGAGGGCACTGAAGCTTTCTTT	CASSGVEEGTEAFF	TRBV7-3	TRBJ1-1
TGTGCCAGCAGTTACTTCGCGGGTGATCTAACAGATACGCAGTATTTT	CASSYFAGDLTDTQYF	TRBV6-6	TRBJ2-3
TGTGCCACCAGTGATTTGGTAACGTCCCGCGCGATTCAGACAGATACGCAGTATTTT	CATSDLVTSRAIQTDTQYF	TRBV24-1	TRBJ2-3
TGTGCCAGTAGTATTGGGGCGGGACAGGGGGCGGGTCCTGGCTCCTATAATTCACCCCTCCACTTT	CASSIGAGQGAGPGSYNSPLHF	TRBV19	TRBJ1-6
TGTGCCTGGAGCCCGGCTGACACCGGGGAGCTGTTTTTT	CAWSPADTGELFF	TRBV30	TRBJ2-2
TGTGCCAGCAAGGACAGGCGGCAGCCCCAGCATTTT	CASKDRRQPQHF	TRBV7-9	TRBJ1-5
TGTGCCAGCAGCTACCCGGGGAGTGGCTACACCTTC	CASSYPGSGYTF	TRBV7-3	TRBJ1-2
TGTGCCACCAGTGTGGGACTAGCGCATATACTTAATGAGCAGTTCTTC	CATSVGLAHILNEQFF	TRBV24-1	TRBJ2-1
TGTGCCAGCAGTGAACTCCCAGGGCTCTCTGGAAACACCATATATTTT	CASSELPGLSGNTIYF	TRBV25-1	TRBJ1-3
TGTGCCACCACAAGGATGAAGGGCTCTGGAAACACCATATATTTT	CATTRMKGSGNTIYF	TRBV24-1	TRBJ1-3
TGTGCCAGCAGTTTATTGATTCGACTAGGCGAGCAGTACTTC	CASSLLIRLGEQYF	TRBV28	TRBJ2-7
TGTGCCAGCAGTGTCCCAGGGAACGGAAACACCATATATTTT	CASSVPGNGNTIYF	TRBV6-1	TRBJ1-3
TGCAGCGTTCGAGAGGGGGAACGGGCTAACTATGGCTACACCTTC	CSVREGERANYGYTF	TRBV29-1	TRBJ1-2
TGCAGTGCTAAGCAGGGGTCCTACGAGCAGTACTTC	CSAKQGSYEQYF	TRBV20-1	TRBJ2-7
TGTGCCAGCAGCAAGAAACGAGACGGGTGCTACGAGCAGTACTTC	CASSKKRDGCYEQYF	TRBV7-8	TRBJ2-7
TGTGCCAGCAGTGGCCGGGGAAATCAGCCCCAGCATTTT	CASSGRGNQPQHF	TRBV6-1	TRBJ1-5
TGTGCCAGCAGTTCTGGCTCCTACGAGCAGTACTTC	CASSSGSYEQYF	TRBV27	TRBJ2-7
TGCGCCACCCCCTCGGACAGGGGAGGCGGGGAGCTGTTTTTT	CATPSDRGGGELFF	TRBV10-1	TRBJ2-2
TGCGCCAGCAGTGAGTCACCAACATGTCAGCCCCAGCATTTT	CASSESPTCQPQHF	TRBV10-1	TRBJ1-5
TGTGCCACCAGTGATCGGGAGAGGGGGGGGGAGCTGTTTTTT	CATSDRERGGELFF	TRBV24-1	TRBJ2-2
TGTGCCAGCATTGAGGCGGCAGATACGCAGTATTTT	CASIEAADTQYF	TRBV12-4	TRBJ2-3
TGTGCCAGCAGCTGCCCGAGGCCAGAGGGGGTTAATGAAAAACTGTTTTTT	CASSCPRPEGVNEKLFF	TRBV7-8	TRBJ1-4
TGCAGTGCTAGTAAAGGCGGGGGTAACGAGCAGTACTTC	CSASKGGGNEQYF	TRBV20-1	TRBJ2-7
TGTGCCAGCAGCACCATTCCCAAAGCGTTTTATAGCAATCAGCCCCAGCATTTT	CASSTIPKAFYSNQPQHF	TRBV7-4	TRBJ1-5
TGTGCCATCAGTGTAGCCCCGAGAGCCAAAAACATTCAGTACTTC	CAISVAPRAKNIQYF	TRBV10-3	TRBJ2-4
TGTGCCAGCAGTGGCCCGGCTAACTCTGGAAACACCATATATTTT	CASSGPANSGNTIYF	TRBV2	TRBJ1-3
TGTGCCAGCAGTTGGTATGGGGGGTGGAGATACAATGAGCAGTTCTTC	CASSWYGGWRYNEQFF	TRBV6-5	TRBJ2-1
TGTGCCAGCAGCGACAGTCCGACAGTCTGCAATGAGCAGTTCTTC	CASSDSPTVCNEQFF	TRBV9	TRBJ2-1
TGTGCCAGCAGTCCACTAGCGGGAGGGCGTTACACTGAAGCTTTCTTT	CASSPLAGGRYTEAFF	TRBV12-3	TRBJ1-1
TGCGCCAGCAGCGCCAGACAGGACGTCCTAGCTCGCACTGAAGCTTTCTTT	CASSARQDVLARTEAFF	TRBV5-1	TRBJ1-1
TGTGCCAGCAGCTTTCTAACGTGTGTGTTGAGAAGGGGACAGCTCAATGAGCAGTTCTTC	CASSFLTCVLRRGQLNEQFF	TRBV7-9	TRBJ2-1
TGCGCCCTCGGGGGGCGGGGTACGCAGTATTTT	CALGGRGTQYF	TRBV10-1	TRBJ2-3
TGTGCCAGCAGCCCGTCAGGGACAGGGGACATTCAGTACTTC	CASSPSGTGDIQYF	TRBV4-2	TRBJ2-4
TGTGCCACCAGCAGAGATGGGTCTTCAGACCTTGATTGCGGGGAGCTGTTTTTT	CATSRDGSSDLDCGELFF	TRBV15	TRBJ2-2
TGTGCCAGCAGCCGGACAGGGGTATATGGCTACACCTTC	CASSRTGVYGYTF	TRBV13	TRBJ1-2
TGTGCCACCAGTGAGTACCCAATAGGGGGCCACGCTGGCTACACCTTC	CATSEYPIGGHAGYTF	TRBV24-1	TRBJ1-2
TGTGCCAGCAGTTTGCGGGAAGCGGGGGGTACGAGCAATCAGCCCCAGCATTTT	CASSLREAGGTSNQPQHF	TRBV12-4	TRBJ1-5
TGTGCCAGCAGTTACCTACCCCCGGGGGGGCCCAGCTCCTACAATGAGCAGTTCTTC	CASSYLPPGGPSSYNEQFF	TRBV6-5	TRBJ2-1
TGTGCCAGCAGTAGGACAGACAGTCGGCGGTGCACTGAAGCTTTCTTT	CASSRTDSRRCTEAFF	TRBV28	TRBJ1-1
TGTGCCAGTATCGCGTCTTGCTACGAGCAGTACTTC	CASIASCYEQYF	TRBV6-6	TRBJ2-7
TGTGCCAGCAGCAGCGAGAGGGCCGAGTCTGGCTATGGCTACACCTTC	CASSSERAESGYGYTF	TRBV7-3	TRBJ1-2
TGTGCCAGCAGTTACCCGGGGGGGCGGGTTAAACGCTTC	CASSYPGGRVKRF	TRBV6-3	TRBJ2-7
TGTCAGGGTCGGGGCAATGCCGGGGAGCTGTTTTTT	CQGRGNAGELFF	TRBV20-1	TRBJ2-2
TGTGCCAGCAGCGTGTGTAAGGAAAGGGCCGAGGGGGGAATAGGTGAGACCCAGTACTTC	CASSVCKERAEGGIGETQYF	TRBV7-3	TRBJ2-5
TGCGCCAGCAGCTTGATCAGCTATGGCTACACCTTC	CASSLISYGYTF	TRBV5-1	TRBJ1-2
TGTGCCAGCAGTTTGAACGCGGGAGTAGCGTCCAAAAACATTCAGTACTTC	CASSLNAGVASKNIQYF	TRBV28	TRBJ2-4
TGTGCCATGGCGGGACTGTGGCAAGATACGCAGTATTTT	CAMAGLWQDTQYF	TRBV10-3	TRBJ2-3
TGTGCCAGCAGTTTCAATTGGGACAGGGACGAGCAGTACTTC	CASSFNWDRDEQYF	TRBV12-3	TRBJ2-7
TGTGCCAAGGTGAGGCGAGGGGACATGGCCTACGAGCAGTACTTC	CAKVRRGDMAYEQYF	TRBV27	TRBJ2-7
TGTGCCAGCAGCCAAGATGGGGAAGGGTGGGGCTACGAGCAGTACTTC	CASSQDGEGWGYEQYF	TRBV3-1	TRBJ2-7
TGTGCCTGGAGAAACAGGACAGTTGTCTACGAGCAGTACTTC	CAWRNRTVVYEQYF	TRBV30	TRBJ2-7
TGTGCCTTGTACAGGGGGACCCAGTACTTC	CALYRGTQYF	TRBV30	TRBJ2-5
TGCAGTGCTAGGAGGACTAGCGGGCGTTTTTACAGACCCAACACCGGGGAGCTGTTTTTT	CSARRTSGRFYRPNTGELFF	TRBV20-1	TRBJ2-2
TGTGCCAGCAGTTACCGGACAGTGTACACCGGGGAGCTGTTTTTT	CASSYRTVYTGELFF	TRBV6-5	TRBJ2-2
TGTGCCAGTACTGACACAGGGCAGCCCCAGCATTTT	CASTDTGQPQHF	TRBV19	TRBJ1-5
TGTGCCAGCAGCACTCCCGGGGGCGGACGAACTGAAGCTTTCTTT	CASSTPGGGRTEAFF	TRBV7-2	TRBJ1-1
TGTGCCAGCAGCTTAGCTTTAGCGGGAGGGAGCTCCTACAATGAGCAGTTCTTC	CASSLALAGGSSYNEQFF	TRBV7-2	TRBJ2-1
TGTGCCCCCGGGGGGCCAGCAGATACGCAGTATTTT	CAPGGPADTQYF	TRBV19	TRBJ2-3
TGCAGTGCTAGAACAGACCGACGGTCGCCGAACACCGGGGAGCTGTTTTTT	CSARTDRRSPNTGELFF	TRBV20-1	TRBJ2-2
TGTGCCAGCCTTGAGGACAATGAGCAGTTCTTC	CASLEDNEQFF	TRBV27	TRBJ2-1
TGTGCCACCAGTGAATCTAAAAGGGACAGGAAGTTCGACGAGCAGTACTTC	CATSESKRDRKFDEQYF	TRBV24-1	TRBJ2-7
TGTGCCAGCAGTTATCCAGGGCCAGCAACTAATGAAAAACTGTTTTTT	CASSYPGPATNEKLFF	TRBV27	TRBJ1-4
TGTGCCAGCAGCAAATGCCGGACAGCTAGGGAAACGGGAAACACCATATATTTT	CASSKCRTARETGNTIYF	TRBV27	TRBJ1-3
TGTGCCAGCAGCTTAGATCCCGGGACAGGGGGCGGGACCGGGGAGCTGTTTTTT	CASSLDPGTGGGTGELFF	TRBV11-3	TRBJ2-2
TGTGCCAGGGAACAACCGGGACAGGACAATCAGCCCCAGCATTTT	CAREQPGQDNQPQHF	TRBV19	TRBJ1-5
TGCGCCAGCAGTGAGTGGCGACATGGCTACACCTTC	CASSEWRHGYTF	TRBV10-1	TRBJ1-2
TGTGCCTGGCCAGAAAATACTGAAGCTTTCTTT	CAWPENTEAFF	TRBV30	TRBJ1-1
TGCGCCAGCAGCGCGAGCTGGACGAACACCGGGGAGCTGTTTTTT	CASSASWTNTGELFF	TRBV5-1	TRBJ2-2
TGTGCCAGCAGCTCCTACATAGGGACAGGGGTTACTGGGGCCAACGTCCTGACTTTC	CASSSYIGTGVTGANVLTF	TRBV7-9	TRBJ2-6
TGTTTTAGAAGCCAGACCCAGTACTTC	CFRSQTQYF	TRBV10-3	TRBJ2-5
TGTGCCAGCAGCACCGAGCCGGGACTCCGTTCCTACGAGCAGTACTTC	CASSTEPGLRSYEQYF	TRBV9	TRBJ2-7
TGTGCCAGCAGACAACACAGGACTGACTATGGCTACACCTTC	CASRQHRTDYGYTF	TRBV6-6	TRBJ1-2
TGCACCCCAAGCGGGACCTATGAAAAACTGTTTTTT	CTPSGTYEKLFF	TRBV20-1	TRBJ1-4
TGTGCCAGCAGCCGGACAGTGAACCTACCTAATGAAAAACTGTTTTTT	CASSRTVNLPNEKLFF	TRBV7-3	TRBJ1-4
TGTGCCAGCAGAACAGGGATCCACTATGGCTACACCTTC	CASRTGIHYGYTF	TRBV12-3	TRBJ1-2
TGTGCCAGCAGCCCAATGCCCCCAAAATCCGAGACAGGGGGGGACACTGAAGCTTTCTTT	CASSPMPPKSETGGDTEAFF	TRBV5-4	TRBJ1-1
TGTGCCAGCAGCTGCCGGGACATCCACTACAATGAGCAGTTCTTC	CASSCRDIHYNEQFF	TRBV7-6	TRBJ2-1
TGTGCCACCAAGGCCCCGTATAAAGATAATGAAAAACTGTTTTTT	CATKAPYKDNEKLFF	TRBV24-1	TRBJ1-4
TGTGCCAGCTCACCGGTGCGACAGGCCTGCACAGATACGCAGTATTTT	CASSPVRQACTDTQYF	TRBV18	TRBJ2-3
TGCAGTGCTAGAGATCTTCCCCTGGTTTACCCTACAGATACGCAGTATTTT	CSARDLPLVYPTDTQYF	TRBV20-1	TRBJ2-3
TGTGCCTCTTCCGACAGGGGAGTGGTGTCTAGCACAGATACGCAGTATTTT	CASSDRGVVSSTDTQYF	TRBV30	TRBJ2-3
TGCAGTGCTAGAGTGGGCGGGAGTATTGGCTACACCTTC	CSARVGGSIGYTF	TRBV20-1	TRBJ1-2
TGCGCCAGCAGCCAAGCTTTCAGACTCGAGCAGTACTTC	CASSQAFRLEQYF	TRBV4-1	TRBJ2-7
TGTGCCAGCAGCCCCCGGACAGCCTACGAGCAGTACTTC	CASSPRTAYEQYF	TRBV7-9	TRBJ2-7
TGTGCCAGCAGCTTAGATTCTTCGGCCGGGACAGGGGATAATGAAAAACTGTTTTTT	CASSLDSSAGTGDNEKLFF	TRBV11-3	TRBJ1-4
TGTGCCACCAGTGACCTTCAGTCCGAGGATTTGCAGTACTTC	CATSDLQSEDLQYF	TRBV24-1	TRBJ2-7
TGTGCCAGCAGTTACACGTTGGGGGCGGAGACCCAGTACTTC	CASSYTLGAETQYF	TRBV6-5	TRBJ2-5
TGTGCCAGCAGCTTTACACCCGGGACAGTAGACCGCGGGGCGAACACCGGGGAGCTGTTTTTT	CASSFTPGTVDRGANTGELFF	TRBV5-8	TRBJ2-2
TGTGCCAGCAGTTACGCCCATATACGACGGGACTACAATGAGCAGTTCTTC	CASSYAHIRRDYNEQFF	TRBV6-5	TRBJ2-1
TGTGCCAGCAGCTTGGGGATTCGATTGGGGGTCGCTAACTATGGCTACACCTTC	CASSLGIRLGVANYGYTF	TRBV5-4	TRBJ1-2
TGTGCCAGCAGCCCCCCGCCCTGGGGGGGCTACAATGAGCAGTTCTTC	CASSPPPWGGYNEQFF	TRBV3-1	TRBJ2-1
TGTGCCAGCAGCGACAGGCAGGTCTATGGCTACACCTTC	CASSDRQVYGYTF	TRBV12-3	TRBJ1-2
TGTGCTAGTGGTTGGGTCGGGCTCACAGATACGCAGTATTTT	CASGWVGLTDTQYF	TRBV12-5	TRBJ2-3
TGTGCCAGCAGTTTAACCTATTTTCGGTTCTTC	CASSLTYFRFF	TRBV28	TRBJ2-1
TGTGCCAGCAGGAACAGGGGGGGGGTTCTGTGCACTGAAGCTTTCTTT	CASRNRGGVLCTEAFF	TRBV14	TRBJ1-1
TGTGCCAGCAGTGAAGCGCAGAGGCGGACAGGCTATGGCTACACCTTC	CASSEAQRRTGYGYTF	TRBV6-1	TRBJ1-2
TGTGCCAGCAGTTTAAGTCCTCGGGCCCCCTACAATGAGCAGTTCTTC	CASSLSPRAPYNEQFF	TRBV27	TRBJ2-1
TGCAGTGCCTACACTGAAGCTTTCTTT	CSAYTEAFF	TRBV20-1	TRBJ1-1
TGTGCCAGCAGCTCGGGGACAGGGGGTGAAAAACTGTTTTTT	CASSSGTGGEKLFF	TRBV7-9	TRBJ1-4
TGTGCCAGCAGTGAACCGGGACACCTCGCCAAAAACATTCAGTACTTC	CASSEPGHLAKNIQYF	TRBV6-4	TRBJ2-4
TGTGCCAGCAGCGGGAATTACAGGGGTTCGGACTCACCCCTCCACTTT	CASSGNYRGSDSPLHF	TRBV6-5	TRBJ1-6
TGTGCCACCAGTGATGGGGAAAAGGATGCCAAAAACATTCAGTACTTC	CATSDGEKDAKNIQYF	TRBV24-1	TRBJ2-4
TGTGCCAGCAGCTATGGACAGGGCGTATCTAACTATGGCTACACCTTC	CASSYGQGVSNYGYTF	TRBV7-9	TRBJ1-2
TGTGCCAGCATCCGACTAGCGGGTAATGAGCAGTTCTTC	CASIRLAGNEQFF	TRBV7-9	TRBJ2-1
TGTGCCAGCGCAGGAGGAGAGCAGTACTTC	CASAGGEQYF	TRBV7-6	TRBJ2-7
TGTGCCAGCTCACCACGGGGGGGAGGGATGCCCTACGAGCAGTACTTC	CASSPRGGGMPYEQYF	TRBV18	TRBJ2-7
TGTGCTAGTGGTCCCTCCCTAAGACACTCCTACGAGCAGTACTTC	CASGPSLRHSYEQYF	TRBV12-5	TRBJ2-7
TGTGCCAGCAGTATTAGAGGGGGGGACAATGAGCAGTTCTTC	CASSIRGGDNEQFF	TRBV2	TRBJ2-1
TGTGCCAGCAGTTACTGCCGGCCGAGGGTTCAGGGCGATTCACCCCTCCACTTT	CASSYCRPRVQGDSPLHF	TRBV6-6	TRBJ1-6
TGCAGTCTGGGGCTACTGCTGGTGGCTAATGAAAAACTGTTTTTT	CSLGLLLVANEKLFF	TRBV29-1	TRBJ1-4
TGTGCCACGGGACAGGGGATGGAGCAGTACTTC	CATGQGMEQYF	TRBV24-1	TRBJ2-7
TGTGCCAGCAGCCAAGGCGGTAAGGATACGCAGTATTTT	CASSQGGKDTQYF	TRBV7-4	TRBJ2-3
TGTGCCACCAGCAGAGATCAATCGCGTTACAGGGACTCTTTGCATTTT	CATSRDQSRYRDSLHF	TRBV15	TRBJ1-5
TGTGCCAGCGAGGTAGGTGACAGGGCGGCCCGGGCCTACGAGCAGTACTTC	CASEVGDRAARAYEQYF	TRBV25-1	TRBJ2-7
TGTGCCAGCAGCCTACTAGATCTGCAGAACATTCAGTACTTC	CASSLLDLQNIQYF	TRBV13	TRBJ2-4
TGTGCCAGCAGCCAAGATGCTCTGGGAGTGGAGCAGTTCTTC	CASSQDALGVEQFF	TRBV14	TRBJ2-1
TGTGCCAGCAGCCAAGCAGTGTCGGGGACTGGGTGTTATGGCTACACCTTC	CASSQAVSGTGCYGYTF	TRBV14	TRBJ1-2
TGCGCCAGCAGCGTCTTTGGGCGCGTCCACGAGCAGTACTTC	CASSVFGRVHEQYF	TRBV10-1	TRBJ2-7
TGTGCCAGCAGCACCCTCAGCGTACATCAGCCCCAGCATTTT	CASSTLSVHQPQHF	TRBV2	TRBJ1-5
TGTGCCAGCAGTCCGGGACCGCACAGGAGCTACGAGCAGTACTTC	CASSPGPHRSYEQYF	TRBV6-3	TRBJ2-7
TGTGCCAGCAGTACCGAAGGGAAACCCAACGAGCAGTACTTC	CASSTEGKPNEQYF	TRBV6-1	TRBJ2-7
TGTGCCAGCACAACAGGGGTAGCCCTCCACTTT	CASTTGVALHF	TRBV25-1	TRBJ1-6
TGCAGTGCTAGAGATACGAAGACAGGGAGCGTAAATGAAAAACTGTTTTTT	CSARDTKTGSVNEKLFF	TRBV20-1	TRBJ1-4
TGTGCCAGCAATTTAAGTCCGGTGTCCAGGATCAATCAGCCCCAGCATTTT	CASNLSPVSRINQPQHF	TRBV25-1	TRBJ1-5
TGTGCCAGCAGTGAAGCGGCTTGGACGGCTCCAGGAGAGACCCAGTACTTC	CASSEAAWTAPGETQYF	TRBV2	TRBJ2-5
TGCGCCAGCAGCTTGGAGGGGACGTTGGTCGAGTTAGATACGCAGTATTTT	CASSLEGTLVELDTQYF	TRBV5-1	TRBJ2-3
TGCAGTGCTAGAGATCCCCGCGGGAACACTGAAGCTTTCTTT	CSARDPRGNTEAFF	TRBV20-1	TRBJ1-1
TGTGCCAGCAGGGGACGACAGGAAAGCACTCAGCCCCAGCATTTT	CASRGRQESTQPQHF	TRBV2	TRBJ1-5
TGTGCCAGCGATCCCCGGCCGGGACAGTCTCAGCCCCAGCATTTT	CASDPRPGQSQPQHF	TRBV25-1	TRBJ1-5
TGCGCCAGCAACCGGACTTTCGGGCGAGAGCAGTACTTC	CASNRTFGREQYF	TRBV10-1	TRBJ2-7
TGTGCCAGCAGCACTAGCGGGGATTTTCTCTACGAGCAGTACTTC	CASSTSGDFLYEQYF	TRBV13	TRBJ2-7
TGCGCCAGCAGCTTGGATCCCCTCCGGACAGCGGGCACCGGGGAGCTGTTTTTT	CASSLDPLRTAGTGELFF	TRBV5-1	TRBJ2-2
TGCGCCAGCAGCCCACAGGGAGCTTTCTTT	CASSPQGAFF	TRBV5-1	TRBJ1-1
TGCAGTGCTAGAAAGCGGGAGGTCCGAAATAATTCACCCCTCCACTTT	CSARKREVRNNSPLHF	TRBV20-1	TRBJ1-6
TGTGCCAGCGCTGGCGCCTGTCCTTATCAGCCCCAGCATTTT	CASAGACPYQPQHF	TRBV27	TRBJ1-5
TGCGCCAGCAGCACCGGGGGCTTGGAAAAACTGTTTTTT	CASSTGGLEKLFF	TRBV5-1	TRBJ1-4
TGTGCCTGGAGTGTACCCCGACAGGAGCAGTACTTC	CAWSVPRQEQYF	TRBV30	TRBJ2-7
TGTGCCAGCAGCCAAGTAAGACCCTGGGACCATTACAATGAGCAGTTCTTC	CASSQVRPWDHYNEQFF	TRBV14	TRBJ2-1
TGTGCCAGCAGCCAAGACAACAGGGATCAGGGTCAGGGGTCTAGCACAGATACGCAGTATTTT	CASSQDNRDQGQGSSTDTQYF	TRBV4-2	TRBJ2-3
TGTGCCAGCTCAGAGTCTAGAGTTCTTTCTGGGGCCAACGTCCTGACTTTC	CASSESRVLSGANVLTF	TRBV11-3	TRBJ2-6
TGTGCCTGGAGTCTTAGGGACAGGGCCTGCCCCTACGAGCAGTACTTC	CAWSLRDRACPYEQYF	TRBV30	TRBJ2-7
TGTGCCAGCAGTCCGTTAGCGGGATACTCCTACGAGCAGTACTTC	CASSPLAGYSYEQYF	TRBV6-2	TRBJ2-7
TGTGCCAGCAGAACAGGGGGCCGTGAAAAACTGTTTTTT	CASRTGGREKLFF	TRBV6-5	TRBJ1-4
TGTGCCAGCAGTTCCGCCGACAGGGCGGAGCTCGGCAAAAACATTCAGTACTTC	CASSSADRAELGKNIQYF	TRBV27	TRBJ2-4
TGTGCCAGCATTGGGGGGGTAGGCTACAATGAGCAGTTCTTC	CASIGGVGYNEQFF	TRBV6-4	TRBJ2-1
TGTGCCATCAGACGGACAGGCCAAGAGCAGTACTTC	CAIRRTGQEQYF	TRBV10-3	TRBJ2-7
TGTGCCAGCAGTTTAAAAGGACCGGGACAGGGTAGGGAGGATGAGACCCAGTACTTC	CASSLKGPGQGREDETQYF	TRBV12-3	TRBJ2-5
TGTGCCAGCAGCCGAGTTTCGGGCCTCGGCTACACCTTC	CASSRVSGLGYTF	TRBV7-9	TRBJ1-2
TGTGCCAGCAGCTGTATTGGGCCTAGGAGCTCCTACAATGAGCAGTTCTTC	CASSCIGPRSSYNEQFF	TRBV9	TRBJ2-1
TGTGCCAGCAGTATCCGTGACAGGAACATTCAGTACTTC	CASSIRDRNIQYF	TRBV27	TRBJ2-4
TGTGCCAGCAGCCCTAGACTAGCGGGGGGGCACAGCTCCTACAATGAGCAGTTCTTC	CASSPRLAGGHSSYNEQFF	TRBV7-2	TRBJ2-1
TGTGCCAGCAGCCGGGGACGGAGTAATTCACCCCTCCACTTT	CASSRGRSNSPLHF	TRBV5-6	TRBJ1-6
TGTGCCAGCAGTGAAGCTGGGACTCTCTATGGCTACACCTTC	CASSEAGTLYGYTF	TRBV6-1	TRBJ1-2
TGCAGTGAGGTCCTTTTTTTCTTT	CSEVLFFF	TRBV20-1	TRBJ1-1
TGTGCCAGCAGTTACTCTAGCGGTCAGTGGGGCTACGAGCAGTACTTC	CASSYSSGQWGYEQYF	TRBV6-5	TRBJ2-7
TGTGCCAGCAGCCGACGTGATAAATTCTATGAGCAGTTCTTC	CASSRRDKFYEQFF	TRBV11-2	TRBJ2-1
TGTGCCAGCAGTTCAGGGGAGACCCAGTACTTC	CASSSGETQYF	TRBV27	TRBJ2-5
TGTGCCAGCAGTTTCAGGCAGCGTACCGAGCAGTACTTC	CASSFRQRTEQYF	TRBV28	TRBJ2-7
TGTGCCAGCAGCTTTCGTCGAAAGCACCTCCCGCAGTACTTC	CASSFRRKHLPQYF	TRBV7-9	TRBJ2-7
TGTGCCTCAAGGGTAACGGGAGTCACCGGGGAGCTGTTTTTT	CASRVTGVTGELFF	TRBV27	TRBJ2-2
TGTGCCTGGAGTGTTCAGGGCGGGGCCGTCAATCAGCCCCAGCATTTT	CAWSVQGGAVNQPQHF	TRBV30	TRBJ1-5
TGCGCCAGCAGTGAGCTCAAGACAGGGACTGAAGCTTTCTTT	CASSELKTGTEAFF	TRBV10-1	TRBJ1-1
TGTGATCTTCCCTTGGGGTTATCCTACGAGCAGTACTTC	CDLPLGLSYEQYF	TRBV28	TRBJ2-7
TGTGCCAGCAGCGGGGTCTCAGCCAAAAACATTCAGTACTTC	CASSGVSAKNIQYF	TRBV11-1	TRBJ2-4
TGTGCCAGCAGCCAGGTGCACCGGATGAACACCGGGGAGCTGTTTTTT	CASSQVHRMNTGELFF	TRBV5-4	TRBJ2-2
TGTGCCAGCAGTGAAGCGACGGATACGCAGTATTTT	CASSEATDTQYF	TRBV6-1	TRBJ2-3
TGTGCCAGCAGTGTAAACCGCTACTTTGAGGAAAAGGGTCGGTACGAGCAGTACTTC	CASSVNRYFEEKGRYEQYF	TRBV6-4	TRBJ2-7
TGTGCCAGCAGCCAAGGACTAGGGTCTGGGGCCAACGTCCTGACTTTC	CASSQGLGSGANVLTF	TRBV4-2	TRBJ2-6
TGTGCCAGCAGCAATGCCGAGCGGGACGTAGGCGCTGAAGCTTTCTTT	CASSNAERDVGAEAFF	TRBV13	TRBJ1-1
TGTGCCAGCAGCCCCCAACTAGAGGAGACCCAGTACTTC	CASSPQLEETQYF	TRBV7-2	TRBJ2-5
TGTGCTAGTGGTGGCGGCAACAGGGGGCTTGCTGGGGCCAACGTCCTGACTTTC	CASGGGNRGLAGANVLTF	TRBV12-5	TRBJ2-6
TGTGCCAGCCAACGGTTCCTCATAGGGGCCCCAACCCCGGTCAATAATTCACCCCTCCACTTT	CASQRFLIGAPTPVNNSPLHF	TRBV6-1	TRBJ1-6
TGTGCCACCAGCAGACTCCCGTACCGGTTTAGCGGGTTTGGGGGCTACGAGCAGTACTTC	CATSRLPYRFSGFGGYEQYF	TRBV15	TRBJ2-7
TGTGCCAGCAGCTTACCGGGACTAGCGGGCTACGAGCAGTACTTC	CASSLPGLAGYEQYF	TRBV11-3	TRBJ2-7
TGTGCCAGCAGTACCAATTTTCGACGTACGTACAATGAGCAGTTCTTC	CASSTNFRRTYNEQFF	TRBV6-6	TRBJ2-1
TGTGCCAGCAGCCTCGCAGGGACGTATGTGAACACTGAAGCTTTCTTT	CASSLAGTYVNTEAFF	TRBV7-4	TRBJ1-1
TGCGCCAGCAGCTTTAGAGCCCGAGTTTGGGTCTCCTACGAGCAGTACTTC	CASSFRARVWVSYEQYF	TRBV5-1	TRBJ2-7
TGTGCCAGCAGCTTAAGAGGGGGCAATCAGCCCCAGCATTTT	CASSLRGGNQPQHF	TRBV7-9	TRBJ1-5
TGTGCCAGCAGCCGTAGGGGGGAAGAGACCCAGTACTTC	CASSRRGEETQYF	TRBV3-1	TRBJ2-5
TGTGCCAGCAGCGGATCCCTGGACTATGGCTACACCTTC	CASSGSLDYGYTF	TRBV13	TRBJ1-2
TGTGCCAGCTTCATTCAGGGGACCCAGTACTTC	CASFIQGTQYF	TRBV28	TRBJ2-5
TGTGCCAGCAGCTACAGGCGCGAAAAACTGTTTTTT	CASSYRREKLFF	TRBV7-9	TRBJ1-4
TGCGCCAGCAGTCAGGCGGTTGGTGGAGATACGCAGTATTTT	CASSQAVGGDTQYF	TRBV5-1	TRBJ2-3
TGCGCCAGCAGCTTGACAAACGTGGGAGTCCTGAGTCGGCCGTACCAAGAGACCCAGTACTTC	CASSLTNVGVLSRPYQETQYF	TRBV5-1	TRBJ2-5
TGCGCCAGCAGCGTGACAGGTCGGGGAGCTGGAAACACCATATATTTT	CASSVTGRGAGNTIYF	TRBV5-1	TRBJ1-3
TGTGCCAGCAGCTCTAGACAGGGATCAAGCTCCTACGAGCAGTACTTC	CASSSRQGSSSYEQYF	TRBV11-3	TRBJ2-7
TGTGCCAGCAGCGGACCGGACAGGGGGAACACTGAAGCTTTCTTT	CASSGPDRGNTEAFF	TRBV11-1	TRBJ1-1
TGTGCCAGCAGTCAGGGCCGGTCCTACGAGCAGTACTTC	CASSQGRSYEQYF	TRBV28	TRBJ2-7
TGTGCCAGCAGGGAGGAGGGCTACGAGCAGTACTTC	CASREEGYEQYF	TRBV12-4	TRBJ2-7
TGTGCCAGCAGTTTATGTGCACCCGGGGACATTCGGTATCAGCCCCAGCATTTT	CASSLCAPGDIRYQPQHF	TRBV28	TRBJ1-5
TGTGCCAGCTCACCAAGGGACAGGGTCTCAGATTGGTATGGCTACACCTTC	CASSPRDRVSDWYGYTF	TRBV18	TRBJ1-2
TGTGCCAGCAGTTTCGCCTACGGGTATCAGCCCCAGCATTTT	CASSFAYGYQPQHF	TRBV12-4	TRBJ1-5
TGTGCCAGCAGTTTCCCTCGGAGTTTGGATCAGCCCCAGCATTTT	CASSFPRSLDQPQHF	TRBV27	TRBJ1-5
TGCGCCAGCAGCCAAAAAGCCCTAGCGGGCACTTACGAGCAGTACTTC	CASSQKALAGTYEQYF	TRBV4-3	TRBJ2-7
TGTGCCAGCAGCGAGAAGAAGGAGGGGTATGGCTACACCTTC	CASSEKKEGYGYTF	TRBV5-6	TRBJ1-2
TGTGCCTGGAGACTCCCCGGCGATAATCAGCCCCAGCATTTT	CAWRLPGDNQPQHF	TRBV30	TRBJ1-5
TGTGCCAGCAGCGGTGGGGCCGGGGCGTCGAACACCATATATTTT	CASSGGAGASNTIYF	TRBV13	TRBJ1-3
TGTGCCGGGAGGGACTATGGCTACACCTTC	CAGRDYGYTF	TRBV30	TRBJ1-2
TGTGCCAGCAGCCAATGTTTCCCAGGGTTCAATGAGCAGTTCTTC	CASSQCFPGFNEQFF	TRBV9	TRBJ2-1
TGTGCCTGGAGTGTACAGGGGGCAACTAATGAAAAACTGTTTTTT	CAWSVQGATNEKLFF	TRBV30	TRBJ1-4
TGTGCCAGCAGTGAACGCAGGGTCGGGTATGGCTACACCTTC	CASSERRVGYGYTF	TRBV6-1	TRBJ1-2
TGTGCCAGCAGCGTAGAGGGACAGGGATTGGGGCCCCAGCATTTT	CASSVEGQGLGPQHF	TRBV9	TRBJ1-5
TGTGCCAGCAGCCTTCCCCACAGGGGGCGTGACTACGAGCAGTACTTC	CASSLPHRGRDYEQYF	TRBV9	TRBJ2-7
TGTGCCAGCAGAGGTGACAGGGGTTGGAGCTCCTACAATGAGCAGTTCTTC	CASRGDRGWSSYNEQFF	TRBV6-4	TRBJ2-1
TGCAGTGCTAGAGAGTGGGCGAACACCGGGGAGCTGTTTTTT	CSAREWANTGELFF	TRBV20-1	TRBJ2-2
TGCAAAGAAGTAAATGAAAAACTGTTTTTT	CKEVNEKLFF	TRBV5-1	TRBJ1-4
TGCGCCAGCGACGCGGGAGCCCGCACAGATACGCAGTATTTT	CASDAGARTDTQYF	TRBV10-2	TRBJ2-3
TGTGCCAGCAGTTACTCTGGATGTCAGGGCTACACCTTC	CASSYSGCQGYTF	TRBV6-5	TRBJ1-2
TGCAGTGCTAGGGGAGACAGGGGAAATTCACCCCTCCACTTT	CSARGDRGNSPLHF	TRBV20-1	TRBJ1-6
TGCGCCAGCAGCTTCTACCGGGACAGGGGCGATGAGCAGTTCTTC	CASSFYRDRGDEQFF	TRBV5-1	TRBJ2-1
TGTGCCAGCAGCCCAACACTACAGGGTGAGCCCCAGCATTTT	CASSPTLQGEPQHF	TRBV7-9	TRBJ1-5
TGCAGTGCTAGACAGGTTAATATTAGACAGGAGACCCAGTACTTC	CSARQVNIRQETQYF	TRBV20-1	TRBJ2-5
TGTGCTAGTGGTGGCGCGGGAGGGAAGTTTGGTAACTATGGCTACACCTTC	CASGGAGGKFGNYGYTF	TRBV12-5	TRBJ1-2
TGTGCCAGCAGGTTCCGGCCCGAGCCGCAAGAGACCCAGTACTTC	CASRFRPEPQETQYF	TRBV27	TRBJ2-5
TGTGCCAGCAGCGCTACCCCGGGGCGCACTGAAGCTTTCTTT	CASSATPGRTEAFF	TRBV6-6	TRBJ1-1
TGTGCCAGCAGTTGGTGTGGGACTAGCGGGGGATTAGTATTTGAGCAGTTCTTC	CASSWCGTSGGLVFEQFF	TRBV12-3	TRBJ2-1
TGTGCCAGCAGCTTAGACCACCGAATCGGGAGGGCCTATGGCTACACCTTC	CASSLDHRIGRAYGYTF	TRBV11-2	TRBJ1-2
TGTGCCATCAGTGAGTCGACAACGGGACCCAATGAGCAGTTCTTC	CAISESTTGPNEQFF	TRBV10-3	TRBJ2-1
TGCAGTGCCACCCGGGGACGGGACTCTGGAAACACCATATATTTT	CSATRGRDSGNTIYF	TRBV20-1	TRBJ1-3
TGTGCCAGCAGCGTAGGGGACCACACTGAAGCTTTCTTT	CASSVGDHTEAFF	TRBV9	TRBJ1-1
TGTGCCACCAGTTGTTTGTCGGGAGCCCAGCATTTT	CATSCLSGAQHF	TRBV24-1	TRBJ1-5
TGTGCCAGCAGCTCTTCTTGGGGGGGAAGGAAGGAGACCCAGTACTTC	CASSSSWGGRKETQYF	TRBV7-9	TRBJ2-5
TGCGCCAGCAGCTTGGGACGTAGGTTTACCCTCGGGGGCAATGAGCAGTTCTTC	CASSLGRRFTLGGNEQFF	TRBV5-1	TRBJ2-1
TGCGCCATCGGGGCAGGGGATTCCGGGGAGCTGTTTTTT	CAIGAGDSGELFF	TRBV5-1	TRBJ2-2
TGTGCCAGCATCAATAAGTTTAGCGAGCAGTACTTC	CASINKFSEQYF	TRBV27	TRBJ2-7
TGTGCCAGCAAGGGACCGGCTGCACCCCTCCACTTT	CASKGPAAPLHF	TRBV5-6	TRBJ1-6
TGTGCCAGCAGTGAAGCGGAGGGAGGGAACGTACTCTTC	CASSEAEGGNVLF	TRBV25-1	TRBJ2-7
TGTGCCAGCAGTCAAGTCGGACAGGGGGCGAATCGTTATAATTCACCCCTCCACTTT	CASSQVGQGANRYNSPLHF	TRBV27	TRBJ1-6
TGTGCCAGCAGTTGTGGGGACTATGGCTACACCTTC	CASSCGDYGYTF	TRBV6-9	TRBJ1-2
TGCGCCAGCACCCGAAGTCCCGGTCTCTATGGCTACACCTTC	CASTRSPGLYGYTF	TRBV5-1	TRBJ1-2
TGTGCCAGCACGCCGGGGGACGCGAGCTACAATGAGCAGTTCTTC	CASTPGDASYNEQFF	TRBV6-4	TRBJ2-1
TGTGCCATCAGTGGCGGGACTCTGGGGGCTAGCACAGATACGCAGTATTTT	CAISGGTLGASTDTQYF	TRBV10-3	TRBJ2-3
TGTGCCAGCAATAAGGGGTCTGCCGGGGAGCTGTTTTTT	CASNKGSAGELFF	TRBV27	TRBJ2-2
TGCGCCACACTATCCGAGTGCGAGCAGTACTTC	CATLSECEQYF	TRBV10-1	TRBJ2-7
TGTGCCAGCAGCGGAGGTTGGGACCGCAATCAGCCCCAGCATTTT	CASSGGWDRNQPQHF	TRBV7-2	TRBJ1-5
TGTGCCAGCAGCGGACGGGCGGGAGTCCCCGAGACCCAGTACTTC	CASSGRAGVPETQYF	TRBV7-7	TRBJ2-5
TGTGCCACCAGTGATTTATGGAGGGGGCCAGAGACCCAGTACTTC	CATSDLWRGPETQYF	TRBV24-1	TRBJ2-5
TGTGCCAGCAGCTTATTCCCGGGACAGTGCACAGACGAGCAGTACTTC	CASSLFPGQCTDEQYF	TRBV7-3	TRBJ2-7
TGTGCCAGCAGTCCACATTTGGAGACCTATGGCTACACCTTC	CASSPHLETYGYTF	TRBV27	TRBJ1-2
TGTGCCAGCAGTGGGGACAGGGATTCAAAAGATAGCAATCAGCCCCAGCATTTT	CASSGDRDSKDSNQPQHF	TRBV27	TRBJ1-5
TGTGCCAGCAGCCCGGGACAGGCCAACGAGCAGTACTTC	CASSPGQANEQYF	TRBV7-3	TRBJ2-7
TGTGCCAGCAGCCGGGAAGGGCTAAGCTCCTACGAGCAGTACTTC	CASSREGLSSYEQYF	TRBV11-3	TRBJ2-7
TGTGCCAGCAGCCAAGATGTCCCACCGGGGACAGGGGGCCGGAACACTGAAGCTTTCTTT	CASSQDVPPGTGGRNTEAFF	TRBV3-1	TRBJ1-1
TGCGCCAGCAGCCGCGCTGGGGGGGGCTCCCAAGAGACCCAGTACTTC	CASSRAGGGSQETQYF	TRBV4-1	TRBJ2-5
TGCAGTGCTAGAGATCGACTGCGGACAGGGCCAGCTCAGACCCAGTACTTC	CSARDRLRTGPAQTQYF	TRBV20-1	TRBJ2-5
TGTGCCAGCAGTTTCCTTTCAGGCGAGCAGTACTTC	CASSFLSGEQYF	TRBV28	TRBJ2-7
TGTGCCAGCAGTGAAGCGAAAATCGGGAACGGAAACACCATATATTTT	CASSEAKIGNGNTIYF	TRBV6-1	TRBJ1-3
TGTGCCAGCAGCGCCCGGACAAGAGAGACCCAGTACTTC	CASSARTRETQYF	TRBV13	TRBJ2-5
TGCGCCAGCAGCTTGAGGGTGGGACATTCGCCCCAGCATTTT	CASSLRVGHSPQHF	TRBV5-1	TRBJ1-5
TGTGCCAGCAGCACCGGAAAGCGGGAAAACACTGAAGCTTTCTTT	CASSTGKRENTEAFF	TRBV7-2	TRBJ1-1
TGTGCCAGCAGTGACTGCGGGAGGGGTGCTTTCTTT	CASSDCGRGAFF	TRBV6-4	TRBJ1-1
TGTGCCAAAACCCGGGACAGAACCTATGGCTACACCTTC	CAKTRDRTYGYTF	TRBV12-3	TRBJ1-2
TGTGCCTGGAGCAACCTAGCGGGCGCCTACGAGCAGTACTTC	CAWSNLAGAYEQYF	TRBV30	TRBJ2-7
TGTGCCAGCCCCCAAGGATGGGACGGAAGTCAGCCCCAGCATTTT	CASPQGWDGSQPQHF	TRBV6-4	TRBJ1-5
TGTGCCGGGTATGGCGCGGGAGCGAATCAGCCCCAGCATTTT	CAGYGAGANQPQHF	TRBV6-5	TRBJ1-5
TGTGCCAGTATATGGGGGGCTAGCGGGGGCACCACCGGGGAGCTGTTTTTT	CASIWGASGGTTGELFF	TRBV19	TRBJ2-2
TGTGCCAGCAGCCCCCCAGGGGCCGGGGAGCTGTTTTTT	CASSPPGAGELFF	TRBV7-9	TRBJ2-2
TGTGCCAGCAGCCTCCAAACCGGGGGGGGAGGGGGGGCCAACGTCCTGACTTTC	CASSLQTGGGGGANVLTF	TRBV7-9	TRBJ2-6
TGTGCCAGCAGTGATGAGACTAGGATCAAGGATGAGCAGTTCTTC	CASSDETRIKDEQFF	TRBV2	TRBJ2-1
TGTGCCAGCAGCTTGGGCCCCCTCCTAGCGGGGCCTGTTATAAAAGAGACCCAGTACTTC	CASSLGPLLAGPVIKETQYF	TRBV5-6	TRBJ2-5
TGTGCCAGCCCCGGTCCCGGGACCAGGGGGGGATCCTACGAGCAGTACTTC	CASPGPGTRGGSYEQYF	TRBV27	TRBJ2-7
TGCAGCGTTGAATATGTTGACAGGGAGAGATTCCCGGAGACCCAGTACTTC	CSVEYVDRERFPETQYF	TRBV29-1	TRBJ2-5
TGCAGTGCCCGTCTTTGGACGGGTAATGAAAAACTGTTTTTT	CSARLWTGNEKLFF	TRBV20-1	TRBJ1-4
TGTGCCAGCAGCTTAGTGGGACAGGGGGGTCCTCCTAACTATGGCTACACCTTC	CASSLVGQGGPPNYGYTF	TRBV7-9	TRBJ1-2
TGTGCCACCAGTGTTGACAGGGGGCGCTATGGCTACACCTTC	CATSVDRGRYGYTF	TRBV24-1	TRBJ1-2
TGTGCCATCAGCGACCGTTCGGCGACTGAAAAACTGTTTTTT	CAISDRSATEKLFF	TRBV10-3	TRBJ1-4
TGCGCCAGCAGCTTATCAGGGGGCCATGCAACTAATGAAAAACTGTTTTTT	CASSLSGGHATNEKLFF	TRBV5-1	TRBJ1-4
TGTGCCACTGGGACGCAACAGGGTCGAAATCAGCCCCAGCATTTT	CATGTQQGRNQPQHF	TRBV2	TRBJ1-5
TGCAGTGCTGAGGGCCGGGTCGCGGACTACGAGCAGTACTTC	CSAEGRVADYEQYF	TRBV20-1	TRBJ2-7
TGTGCCAGCAAGGGGGGACCCTACGAGCAGTACTTC	CASKGGPYEQYF	TRBV2	TRBJ2-7
TGTGCCACCGCCCGGGACAGGCCGGGGGATCAGCCCCAGCATTTT	CATARDRPGDQPQHF	TRBV15	TRBJ1-5
TGCAGTGCTAGAGATGTTAAGAGCGGAGGGAGCGCTGGGGCCAACGTCCTGACTTTC	CSARDVKSGGSAGANVLTF	TRBV20-1	TRBJ2-6
TGTGCCAGCAGCTTACTCAGGACTAGCGCACCCTCCTACAATGAGCAGTTCTTC	CASSLLRTSAPSYNEQFF	TRBV7-9	TRBJ2-1
TGTGCCAGCAGCCCTGTCCGGGGGAGCACAGATACGCAGTATTTT	CASSPVRGSTDTQYF	TRBV5-5	TRBJ2-3
TGTGCCAGCAGCATAATTTTCCTTGAAAAACTGTTTTTT	CASSIIFLEKLFF	TRBV7-3	TRBJ1-4
TGTGCCAGCAGACCCGGGACAGGGGTAGGCGGCACAGATACGCAGTATTTT	CASRPGTGVGGTDTQYF	TRBV2	TRBJ2-3
TGTGCCAGCACCGGGACTAGCTCCACAGATACGCAGTATTTT	CASTGTSSTDTQYF	TRBV6-6	TRBJ2-3
TGTGCCAGCAGCCTGAATAAGGACAGGGGGCGCAATCGGCCCTATGGCTACACCTTC	CASSLNKDRGRNRPYGYTF	TRBV7-9	TRBJ1-2
TGCAGCGTTCCGCGGGAGGGGGGTACGGAAGAGACCCAGTACTTC	CSVPREGGTEETQYF	TRBV29-1	TRBJ2-5
TGTGCCACCAGCAGAACGGTCGGACAGTATGGCTACACCTTC	CATSRTVGQYGYTF	TRBV15	TRBJ1-2
TGCGCCAGCAGGGCAGGGGGGGGCTATGGCTACACCTTC	CASRAGGGYGYTF	TRBV10-1	TRBJ1-2
TGTGCCAGGTGCTGCGGGAGGAACAATGAGCAGTTCTTC	CARCCGRNNEQFF	TRBV6-6	TRBJ2-1
TGTGCCAGCATAAATTGTGATAGTCAAGAGACCCAGTACTTC	CASINCDSQETQYF	TRBV27	TRBJ2-5
TGCGCCAGCAGCCCGGGATCGACACGCCAGCCCCAGCATTTT	CASSPGSTRQPQHF	TRBV5-1	TRBJ1-5
TGTGCCAGCAGCAGTCTAGGCGGGCTAGCGGGGGGGGATGAGCAGTTCTTC	CASSSLGGLAGGDEQFF	TRBV7-3	TRBJ2-1
TGCAGCGTTGAAGTCCTCCGGAATGCAGGGAATATGAAGTCCTCCTACGAGCAGTACTTC	CSVEVLRNAGNMKSSYEQYF	TRBV29-1	TRBJ2-7
TGTGCCACCGAGGCGGTGAGTGTCTTC	CATEAVSVF	TRBV24-1	TRBJ1-2
TGCGCCAGCAGCCAAGACTTTAAGGGGGGGACCGGGGAGAGGTATGGCTACACCTTC	CASSQDFKGGTGERYGYTF	TRBV4-3	TRBJ1-2
TGCAGTGCTACCTCCAGTGACAGGGGTCGGCCTGAAGCTTTCTTT	CSATSSDRGRPEAFF	TRBV20-1	TRBJ1-1
TGTGCCAGCAGCTTACCCGGGAGTCGCGGGCACTACGAGCAGTACTTC	CASSLPGSRGHYEQYF	TRBV11-2	TRBJ2-7
TGTGCCAGCGAGAGGTTGACCGGGGAGCTGTTTTTT	CASERLTGELFF	TRBV9	TRBJ2-2
TGTGCCAGCAGCACTGTGGAAGGTCCTAGCGGGGGGGACGAGCAGTACTTC	CASSTVEGPSGGDEQYF	TRBV11-3	TRBJ2-7
TGTGCCAGCAGTTACTCCGGAGCGGGAAGGGTCGATACGCAGTATTTT	CASSYSGAGRVDTQYF	TRBV6-9	TRBJ2-3
TGTGCCAGCAGCGGCGGGGGGGCCGAGTACTTC	CASSGGGAEYF	TRBV9	TRBJ2-7
TGTGCCAGCATTGACAGGACTAGGAACGAGCAGTACTTC	CASIDRTRNEQYF	TRBV9	TRBJ2-7
TGTGCCACCAGTGATTGCATGGCTGAGACGAAAGAGACCCAGTACTTC	CATSDCMAETKETQYF	TRBV24-1	TRBJ2-5
TGTGCCAGCAGTTTTAAAGGCCGGGGCGAGACCCAGTACTTC	CASSFKGRGETQYF	TRBV27	TRBJ2-5
TGCGCCAGCAGACAGGGGAAACCCAAAAACATTCAGTACTTC	CASRQGKPKNIQYF	TRBV10-2	TRBJ2-4
TGTGCCAGCAGCTTTACACCGGAGGAAGAAGAGACCCAGTACTTC	CASSFTPEEEETQYF	TRBV7-9	TRBJ2-5
TGTGCCATAGCGGGCAACAATGAGCAGTTCTTC	CAIAGNNEQFF	TRBV10-3	TRBJ2-1
TGCGCCAGCAGACTACGACTAGCGGGAGGGCAGAACACTGAAGCTTTCTTT	CASRLRLAGGQNTEAFF	TRBV5-1	TRBJ1-1
TGCAGTGCTAGAGATTGGAAACATAAACGCTTAGCGGGAGAGGGGCAGTTCTTC	CSARDWKHKRLAGEGQFF	TRBV20-1	TRBJ2-1
TGTGCCAGCAGCCTTGGCCTATTTGACAGTTGGGATCAAGCTTTCTTT	CASSLGLFDSWDQAFF	TRBV14	TRBJ1-1
TGTGCCAGAGGGGGCGAGTCCTCTGGGGCCAACGTCCTGACTTTC	CARGGESSGANVLTF	TRBV19	TRBJ2-6
TGTGCCAGCAGGGGGATGCATTTT	CASRGMHF	TRBV2	TRBJ1-5
TGTGCCAGCAGCTTAATCAGCGGGTTTACGGGGACCGAGCAGTACTTC	CASSLISGFTGTEQYF	TRBV7-7	TRBJ2-7
TGTGCCAGCAGCTTAAGGGCCGGGACGTGCCCCAATGAGCAGTTCTTC	CASSLRAGTCPNEQFF	TRBV13	TRBJ2-1
TGTGCCAGCTGGGAGGGACAGAGTGGGGGAGAAGCTTTCTTT	CASWEGQSGGEAFF	TRBV11-3	TRBJ1-1
TGCGCCAGCATTCAGTCTCGCAGGGGGAATAGCCTAGCCAAAAACATTCAGTACTTC	CASIQSRRGNSLAKNIQYF	TRBV5-1	TRBJ2-4
TGTGCCAGTGACCCACTTAGGGACACCGGGGAGCTGTTTTTT	CASDPLRDTGELFF	TRBV19	TRBJ2-2
TGCAGCGGCCAGGAAGGGTACGAGCAGTACTTC	CSGQEGYEQYF	TRBV29-1	TRBJ2-7
TGTGCCAGCAGCCAAGTTTCGACAGGGGACTACGAGCAGTACTTC	CASSQVSTGDYEQYF	TRBV14	TRBJ2-7
TGTGCCAGCAGTCCGGGCCCATGTCCGGGGTCCTACGAGCAGTACTTC	CASSPGPCPGSYEQYF	TRBV5-6	TRBJ2-7
TGTGCCAGCAGTTACGGACTAGCGGTTGGAGAGACCCAGTACTTC	CASSYGLAVGETQYF	TRBV11-3	TRBJ2-5
TGTGCCAGCAGCCAAGGTGACGCGAGCTACGAGCAGTACTTC	CASSQGDASYEQYF	TRBV14	TRBJ2-7
TGTGCCAGCAGTGACGATCGCTTTCGGACTGGTAACCAAGAGACCCAGTACTTC	CASSDDRFRTGNQETQYF	TRBV6-4	TRBJ2-5
TGTGCCACCAGTGATTGCTCAACGGCCTACGAGCAGTACTTC	CATSDCSTAYEQYF	TRBV24-1	TRBJ2-7
TGCAGTGCTAGATCGGACATGGGATGCAATCAGCCCCAGCATTTT	CSARSDMGCNQPQHF	TRBV20-1	TRBJ1-5
TGTGCCAGCAGCTCACTAGCCAAAAATGAGCAGTTCTTC	CASSSLAKNEQFF	TRBV9	TRBJ2-1
TGCAGCGTTGACGGCCCGGGGCCGGGGGGGCTTATCGGGGCAGATACGCAGTATTTT	CSVDGPGPGGLIGADTQYF	TRBV29-1	TRBJ2-3
TGTGCCTGGCAACGTCCCGAAGAGACCCAGTACTTC	CAWQRPEETQYF	TRBV30	TRBJ2-5
TGTGCCAGCAGCCATAACTCGGACGACGGGAGATTCAAGAATCAGCCCCAGCATTTT	CASSHNSDDGRFKNQPQHF	TRBV3-1	TRBJ1-5
TGTGCCGCCGCTCAGGGCGATTGGGATAGCAATCAGCCCCAGCATTTT	CAAAQGDWDSNQPQHF	TRBV5-5	TRBJ1-5
TGTGCCAGCAGTTACTCGAGTGACCGGGCGCCATCGAACACTGAAGCTTTCTTT	CASSYSSDRAPSNTEAFF	TRBV6-5	TRBJ1-1
TGTGCCAGCACTGGGCAAAAGCTAGGTTCGGGGTCTGGGGCCAACGTCCTGACTTTC	CASTGQKLGSGSGANVLTF	TRBV12-3	TRBJ2-6
TGTGCCAGCACAAAAGTTAGGGGAACCTACGAGCAGTACTTC	CASTKVRGTYEQYF	TRBV7-3	TRBJ2-7
TGCAGCGTTGGCAGAGCTAGCGGGGGTGAAGACAATGAGCAGTTCTTC	CSVGRASGGEDNEQFF	TRBV29-1	TRBJ2-1
TGTGCCAGCAGTCCGACGGGAACTGAAGCTTTCTTT	CASSPTGTEAFF	TRBV6-5	TRBJ1-1
TGTGCCAGCAGCCCGGTAGGGACAGGGGGATCTCACGAGCAGTACTTC	CASSPVGTGGSHEQYF	TRBV11-3	TRBJ2-7
TGTGCCAACGAGGGGTGGGTGCAGTACTTC	CANEGWVQYF	TRBV19	TRBJ2-7
TGTGCCAGCAGTGAGTGGGACAGTGAGCAGTACTTC	CASSEWDSEQYF	TRBV28	TRBJ2-7
TGTGCCAGCAGCTGTTTAACAGGGGGCCCCCTAGGAGTTCAGCCCCAGCATTTT	CASSCLTGGPLGVQPQHF	TRBV5-5	TRBJ1-5
TGTGCCAGCAGTTTCCCAGGGGGGAAGCCCTACGAGCAGTACTTC	CASSFPGGKPYEQYF	TRBV27	TRBJ2-7
TGTGCCAGCAGCGTAGCTTGTCCCGGGCCGGTGGATGAGCAGTTCTTC	CASSVACPGPVDEQFF	TRBV9	TRBJ2-1
TGTGCCAGCAGCCAAGACTCGTTCTCCGGGACAAATCAGCCCCAGCATTTT	CASSQDSFSGTNQPQHF	TRBV14	TRBJ1-5
TGCAGCGTTTGGACTAGGCTGGGAGAGACCCAGTACTTC	CSVWTRLGETQYF	TRBV29-1	TRBJ2-5
TGTGCCAGCAGCGTTCCCGGGTGGGGGTACCTGTCCTACGAGCAGTACTTC	CASSVPGWGYLSYEQYF	TRBV11-3	TRBJ2-7
TGTGCCAGCAGCTTACCAACAAGACTAGCGGGAGGGCCCGGGGGTTTGCCATTAAAAAGCTCAAGGATGGGCTACACCTTC	CASSLPTRLAGGPGGLPLKSSRMGYTF	TRBV7-3	TRBJ1-2
TGTGCCAGGGTACGGGTTTACGAGCAGTACTTC	CARVRVYEQYF	TRBV5-6	TRBJ2-7
TGTGCCAATAAGATCCGACAGGGGGTGGGAACTGAAGCTTTCTTT	CANKIRQGVGTEAFF	TRBV19	TRBJ1-1
TGTGCCAGCAGCGGAGGGACAGGGGGATACGAGCAGTACTTC	CASSGGTGGYEQYF	TRBV7-2	TRBJ2-7
TGTGCCAGCAAGGGACAGGGACGGGGCAATCAGCCCCAGCATTTT	CASKGQGRGNQPQHF	TRBV7-9	TRBJ1-5
TGTGCCAGGGTCAGGGGGCCTGGGTATAATTCACCCCTCCACTTT	CARVRGPGYNSPLHF	TRBV11-2	TRBJ1-6
TGTGCCAGCAGGAGAGAGCAGTTCTTC	CASRREQFF	TRBV6-1	TRBJ2-1
TGTGCCTGGAGTGTAAGAGGGCCCCCGGCTAGCACAGATACGCAGTATTTT	CAWSVRGPPASTDTQYF	TRBV30	TRBJ2-3
TGTGCCAGCAGGAACGGAAGCTACACCTTC	CASRNGSYTF	TRBV6-8	TRBJ1-2
TGTGCCACCAGTCTCCCAGTCCGAGCCGAGCGTTGCAATCAGCCCCAGCATTTT	CATSLPVRAERCNQPQHF	TRBV24-1	TRBJ1-5
TGTGCCAGCAGCTTAGAAAGACGGGACGAGCAGTACTTC	CASSLERRDEQYF	TRBV11-2	TRBJ2-7
TGCAGTGCTAGCGGGGTTCAGCTCCACACTGAAGCTTTCTTT	CSASGVQLHTEAFF	TRBV20-1	TRBJ1-1
TGTGCCAGCAGCTTAGCGTCTTCGTCGAGGGGGACTAGCGGGGACTCCTACGAGCAGTACTTC	CASSLASSSRGTSGDSYEQYF	TRBV7-9	TRBJ2-7
TGTGCCAGCAGCTTTCGCAGGGTCACCGACTCAGATACGCAGTATTTT	CASSFRRVTDSDTQYF	TRBV7-6	TRBJ2-3
TGTGCCAGCAGTTGTATAACTAGCGGGACCGTACAGTCCTACGAGCAGTACTTC	CASSCITSGTVQSYEQYF	TRBV6-9	TRBJ2-7
TGTGCCAGCAGCTTGGCGGGAAGGGCGCGACGTTATGGCTACACCTTC	CASSLAGRARRYGYTF	TRBV5-6	TRBJ1-2
TGTGCCACCACTAGCGGGAGCGTCGGCACAGATACGCAGTATTTT	CATTSGSVGTDTQYF	TRBV24-1	TRBJ2-3
TGTGCCAGCAGCTCCAGGGCCTATGGCTACACCTTC	CASSSRAYGYTF	TRBV11-2	TRBJ1-2
TGTGCCAGTAGTATAGGAGGTGGCACCGGGGAGCTGTTTTTT	CASSIGGGTGELFF	TRBV19	TRBJ2-2
TGTGCCAGCAGCGAACGGGACGGATTCGGGGAGCTGTTTTTT	CASSERDGFGELFF	TRBV11-2	TRBJ2-2
TGTGCCAGCACGGCAGGGGATAATGAAAAACTGTTTTTT	CASTAGDNEKLFF	TRBV6-1	TRBJ1-4
TGCAAGACCACCGAGGAGTCAGGATATGGCTACACCTTC	CKTTEESGYGYTF	TRBV20-1	TRBJ1-2
TGTGCCAGCAGCCCAGGGCGGACTAGCGGGTTTGATACCACAGATACGCAGTATTTT	CASSPGRTSGFDTTDTQYF	TRBV6-8	TRBJ2-3
TGTGCCAGCAGTTACATTAAAGGGGATACTGAAGCTTTCTTT	CASSYIKGDTEAFF	TRBV6-2	TRBJ1-1
TGTGCCACCAGGAGGCCCGTCTACAGGGCCGCTACCTATGGCTACACCTTC	CATRRPVYRAATYGYTF	TRBV24-1	TRBJ1-2
TGCAGTGCTAGAGGAATAGGGGAGCCCCAGCATTTT	CSARGIGEPQHF	TRBV20-1	TRBJ1-5
TGTGCCAGCAGCAACCCGGGACTTCGGGGAGAGTATAGCAATCAGCCCCAGCATTTT	CASSNPGLRGEYSNQPQHF	TRBV7-3	TRBJ1-5
TGTTTTAGGGGGGAACACTATGGCTACACCTTC	CFRGEHYGYTF	TRBV29-1	TRBJ1-2
TGTGCCAGCAGATCCCAGGGGGGGAACACTGAAGCTTTCTTT	CASRSQGGNTEAFF	TRBV7-4	TRBJ1-1
TGTGCCAGCAGGGTACAGGGTCCGTCCACCTCTGGAAACACCATATATTTT	CASRVQGPSTSGNTIYF	TRBV6-8	TRBJ1-3
TGTGCCAGCAGTTTAACTGAAACAGGGGTCTACTATGGCTACACCTTC	CASSLTETGVYYGYTF	TRBV12-4	TRBJ1-2
TGTGCCAGCAGTGCGGGGACGGTAGGCAATCAGCCCCAGCATTTT	CASSAGTVGNQPQHF	TRBV6-4	TRBJ1-5
TGTGCCAGCAGCTCCTGGGGTGCGGCTAGCACAGATACGCAGTATTTT	CASSSWGAASTDTQYF	TRBV6-5	TRBJ2-3
TGTGCCAGCAGTTTCCGATTCGACCAACCGGGACAGGGAAAGGGGGCCAACGTCCTGACTTTC	CASSFRFDQPGQGKGANVLTF	TRBV28	TRBJ2-6
TGCAGTGCTGGCCGACTAGTCCCGGGTGAGACCCAGTACTTC	CSAGRLVPGETQYF	TRBV20-1	TRBJ2-5
TGTGCCAGCAGTTTGGAGGTGCCCGTCGGGACAAAACAGCCCCAGCATTTT	CASSLEVPVGTKQPQHF	TRBV28	TRBJ1-5
TGTGCCAGCCTAGCGGGGGGGCCACTATCGGAATCCTACAATGAGCAGTTCTTC	CASLAGGPLSESYNEQFF	TRBV11-3	TRBJ2-1
TGCAGTGCTTCCCCAGGGGGGGGCCAAGAGACCCAGTACTTC	CSASPGGGQETQYF	TRBV20-1	TRBJ2-5
TGTGCCAGCAGCTTACCTCGGGGGTCCAAGGCAAAGGGCTGTGAAAAACTGTTTTTT	CASSLPRGSKAKGCEKLFF	TRBV7-4	TRBJ1-4
TGTGCCAGCAGGTCCCAGACAGGAGGCTACAATGAGCAGTTCTTC	CASRSQTGGYNEQFF	TRBV28	TRBJ2-1
TGCAGTGCTTCAGGGGAGACGAACACCGGGGAGCTGTTTTTT	CSASGETNTGELFF	TRBV20-1	TRBJ2-2
TGCAGTGCTAGGCGAGGGACAGGTCGTTGGGAACCTGGCTACACCTTC	CSARRGTGRWEPGYTF	TRBV20-1	TRBJ1-2
TGTGCCAGCAGCTGGACCGGGACCCCCACAGATACGCAGTATTTT	CASSWTGTPTDTQYF	TRBV5-5	TRBJ2-3
TGTGCCAGCGGGACTAGCGGGGGGGGGAATGAGCAGTTCTTC	CASGTSGGGNEQFF	TRBV6-3	TRBJ2-1
TGTGCCAGCAGCGGACCGTTTCTCGGGACTAGCGGGTACAACATTCAGTACTTC	CASSGPFLGTSGYNIQYF	TRBV14	TRBJ2-4
TGCAGTGCTAGAGTCAGGTTAAACACTGAAGCTTTCTTT	CSARVRLNTEAFF	TRBV20-1	TRBJ1-1
TGTGCCAGCAGTGACCGAGGAGGGGAGCAGTTCTTC	CASSDRGGEQFF	TRBV6-4	TRBJ2-1
TGTGCCAGCAGTTACTTCTATCGCGGGGAGCTGTTTTTT	CASSYFYRGELFF	TRBV27	TRBJ2-2
TGTGCCAGCAGCGTAGAGGGGGGGCCCTATATCTACGAGCAGTACTTC	CASSVEGGPYIYEQYF	TRBV9	TRBJ2-7
TGTGCCAGCTTCCCTAGCGAGCAGTACTTC	CASFPSEQYF	TRBV6-2	TRBJ2-7
TGTGCCAGCAGCTGGGTAAGAATTGGACGGGCGCGGTTCTATGGCTACACCTTC	CASSWVRIGRARFYGYTF	TRBV11-3	TRBJ1-2
TGCAGTGCCACGGGAGTAGATCACGAGCAGTACTTC	CSATGVDHEQYF	TRBV20-1	TRBJ2-7
TGTGCCAGCAGTGCTTTGCAGGGGGCATCTAGAGCTTTCTTT	CASSALQGASRAFF	TRBV6-1	TRBJ1-1
TGTGCCTGGAGACAGACCAATCAGCCCCAGCATTTT	CAWRQTNQPQHF	TRBV30	TRBJ1-5
TGTGCCCCTTTGATGGGCAGGGGGATCCTCGAGCAGTACTTC	CAPLMGRGILEQYF	TRBV28	TRBJ2-7
TGTGCCAGCAGCCAAGACCTTAAGGCCGGGACTAGTTGCTACAATGAGCAGTTCTTC	CASSQDLKAGTSCYNEQFF	TRBV3-1	TRBJ2-1
TGTGCCAGCAGCTTTTCCGGGACTGCCAACACCGGGGAGCTGTTTTTT	CASSFSGTANTGELFF	TRBV9	TRBJ2-2
TGTGCCAGCAGTGACCAGGGACAGACCCTCGGGACTGAAGCTTTCTTT	CASSDQGQTLGTEAFF	TRBV6-1	TRBJ1-1
TGCGCCACGCTGCCCAGGACTAAATGGGAACGCATCCGATTAGCCAAAAACATTCAGTACTTC	CATLPRTKWERIRLAKNIQYF	TRBV5-1	TRBJ2-4
TGTGCCAGCATTGGACGGGAGCAGTACTTC	CASIGREQYF	TRBV6-3	TRBJ2-7
TGCAGTGCTAGGGTAAACGTGAACGAGCAGTACTTC	CSARVNVNEQYF	TRBV20-1	TRBJ2-7
TGTGCCAGCAGCAACGGGGGGCCGACAGGGGCCTCGGGGAATCAGCCCCAGCATTTT	CASSNGGPTGASGNQPQHF	TRBV7-6	TRBJ1-5
TGTGCCAGCAGTCTGGGGGGGGTTGAGCAGTTCTTC	CASSLGGVEQFF	TRBV27	TRBJ2-1
TGCAGTGCTCGACAGGGGTACTATGGCTACACCTTC	CSARQGYYGYTF	TRBV20-1	TRBJ1-2
TGCAGTGCTAGCACAGACGGCCGGGACAGCGGTTTATGGAAGATCTATGGCTACACCTTC	CSASTDGRDSGLWKIYGYTF	TRBV20-1	TRBJ1-2
TGCAGTGCTCCTAGCGATGACAATGAGCAGTTCTTC	CSAPSDDNEQFF	TRBV20-1	TRBJ2-1
TGTGCCAGCAGCCTAGACAGGGAATGGGGCGAGCAGTTCTTC	CASSLDREWGEQFF	TRBV13	TRBJ2-1
TGTGCCAGCAGTCTCCGGGACATAGCCTACAATGAGCAGTTCTTC	CASSLRDIAYNEQFF	TRBV6-4	TRBJ2-1
TGTGCCTGGAGTGTACGTTCGGGGGGCTACGAGCAGTACTTC	CAWSVRSGGYEQYF	TRBV30	TRBJ2-7
TGCGCCAGCAGCCGCTCAGATCCTCCCTACGAGCAGTACTTC	CASSRSDPPYEQYF	TRBV5-1	TRBJ2-7
TGCAGTGCAACTACAGGGAACCTAGAGACCCAGTACTTC	CSATTGNLETQYF	TRBV20-1	TRBJ2-5
TGTGCCACCAGTCACAGGGAAAGGTACGAGCAGTACTTC	CATSHRERYEQYF	TRBV24-1	TRBJ2-7
TGCGCCAGCAGCCAAGCCCGGGGGCTCCGGGACGAGCAGTACTTC	CASSQARGLRDEQYF	TRBV4-3	TRBJ2-7
TGCGCCAGCAGTGGTATTTCCGAGGGGGCCATCGATACGCAGTATTTT	CASSGISEGAIDTQYF	TRBV10-1	TRBJ2-3
TGTGCCAGCAGCCCCGGGTCATACGGACGAAAAGCTTTCTTT	CASSPGSYGRKAFF	TRBV9	TRBJ1-1
TGTGCCAGCAGCGTCGGGAAGATGGACAGGGGGCTTACGGGCATGAACACTGAAGCTTTCTTT	CASSVGKMDRGLTGMNTEAFF	TRBV9	TRBJ1-1
TGTGCCAGCAGCTTCCGGCGAACCTGGGGGAGCGAGCAGTACTTC	CASSFRRTWGSEQYF	TRBV5-4	TRBJ2-7
TGTGCCAGCAGCTTGGCCCACTACGAGCAGTACTTC	CASSLAHYEQYF	TRBV5-6	TRBJ2-7
TGTGCCAGCAGCGGGCAGGGTAACACCGGGGAGCTGTTTTTT	CASSGQGNTGELFF	TRBV9	TRBJ2-2
TGTGGGGTATCTTTCTACGGCTACACCTTC	CGVSFYGYTF	TRBV4-2	TRBJ1-2
TGTGCCAGCAGCGCCGGGAGGTATTGGAACACTGAAGCTTTCTTT	CASSAGRYWNTEAFF	TRBV7-3	TRBJ1-1
TGTGCCAGCAGCAAGCTGGGAACTAGCGGGCAAAGCGATACGCAGTATTTT	CASSKLGTSGQSDTQYF	TRBV7-3	TRBJ2-3
TGTGCCAGCAGCTACCACAGGGAGGAGAGATTGAACACTGAAGCTTTCTTT	CASSYHREERLNTEAFF	TRBV5-5	TRBJ1-1
TGCGCCAGCGGTACGTTCGACAGTGCTGAAGCTTTCTTT	CASGTFDSAEAFF	TRBV10-1	TRBJ1-1
TGTGCCACCAGTCGCGGATGGGGGGGCTTTGTCGAGCAGTACTTC	CATSRGWGGFVEQYF	TRBV24-1	TRBJ2-7
TGTGCCAGCAGTTCCACGGCCTCGACTGAAGAGACCCAGTACTTC	CASSSTASTEETQYF	TRBV7-6	TRBJ2-5
TGTGCCAGCAGCAACCAGACTTCAGGACGGGTGGTCCGCAATCAGCCCCAGCATTTT	CASSNQTSGRVVRNQPQHF	TRBV7-2	TRBJ1-5
TGTGCCTGCGCGAGGCTCAGCACAGATACGCAGTATTTT	CACARLSTDTQYF	TRBV30	TRBJ2-3
TGTGCCAGCAGCGCGGGGGGACAGGGCCGGGATGGCTACACCTTC	CASSAGGQGRDGYTF	TRBV7-7	TRBJ1-2
TGCAGCGTTGAATCGAGAGCGGCGAACACTGAAGCTTTCTTT	CSVESRAANTEAFF	TRBV29-1	TRBJ1-1
TGTGCCAGCAGCTTAGGACCAGCTGGCTACACCTTC	CASSLGPAGYTF	TRBV7-9	TRBJ1-2
TGCAGTGCTCCCACAGGGCGGGACCAAGAGACCCAGTACTTC	CSAPTGRDQETQYF	TRBV20-1	TRBJ2-5
TGTGCCAGCAGCGGGGGGGCCGGGCTTTATGAGCAGTTCTTC	CASSGGAGLYEQFF	TRBV14	TRBJ2-1
TGCAGCGTTGGCCAGCGGACAGAGACCCAGTACTTC	CSVGQRTETQYF	TRBV29-1	TRBJ2-5
TGCGCCAGCAGTGAGGAGGGGCAGGGCGGGGGAGATACGCAGTATTTT	CASSEEGQGGGDTQYF	TRBV10-1	TRBJ2-3
TGTACGAGCCCCCCAGGTTTTCACTACGAGCAGTACTTC	CTSPPGFHYEQYF	TRBV27	TRBJ2-7
TGCAGTGCAATGAATCAGCCCCAGCATTTT	CSAMNQPQHF	TRBV20-1	TRBJ1-5
TGCGCCAGCAGCTACGGGGGGGGGATCGAATGGTGGGAAGAGACCCAGTACTTC	CASSYGGGIEWWEETQYF	TRBV5-1	TRBJ2-5
TGTGCCAGCAGTGGACTAGCGGGTACGGACAATGAGCAGTTCTTC	CASSGLAGTDNEQFF	TRBV27	TRBJ2-1
TGTGCCAGCAGAGGCCCGGATGAGCAGTTCTTC	CASRGPDEQFF	TRBV7-9	TRBJ2-1
TGTGCCTGGAGTGTAGGGAGACTAGCGGGGAAAACCTACGAGCAGTACTTC	CAWSVGRLAGKTYEQYF	TRBV30	TRBJ2-7
TGTGCCAGCAGCAACCAGGGGGGGAATGAGCAGTTCTTC	CASSNQGGNEQFF	TRBV9	TRBJ2-1
TGTGCCAGCAGCGGACAGTTCAATGAGCAGTTCTTC	CASSGQFNEQFF	TRBV6-2	TRBJ2-1
TGCAGTGCTAGAGGCCGGGAGGGCCCTTCGGAGACCCAGTACTTC	CSARGREGPSETQYF	TRBV20-1	TRBJ2-5
TGCGCCAGCAGCTTCCCCTTGGGGGCAGGCACTGAAGCTTTCTTT	CASSFPLGAGTEAFF	TRBV5-1	TRBJ1-1
TGTGCCAGCAGTGAAGGGGGGCGTTGTAATCCAAGTGCAACGTTCTCCTACAATGAGCAGTTCTTC	CASSEGGRCNPSATFSYNEQFF	TRBV2	TRBJ2-1
TGTGCCAGCAGTTACCCAGTAGCGGGGGACGGGGAGCAGTTCTTC	CASSYPVAGDGEQFF	TRBV27	TRBJ2-1
TGTGCCAGCAGTGACCGAGACAGGCGTAGCACAGATACGCAGTATTTT	CASSDRDRRSTDTQYF	TRBV25-1	TRBJ2-3
TGTGCCAGCAGCTTGGAGGGCTGGGAGCCCCAGCATTTT	CASSLEGWEPQHF	TRBV5-5	TRBJ1-5
TGTGCCTGGAGTAGGAGAGGGGGAGGGAATTTGAATGAAAAACTGTTTTTT	CAWSRRGGGNLNEKLFF	TRBV30	TRBJ1-4
TGCGCCAGCAGTGGCCGGACCCCGGAAGCAGGGAGCCACACTGAAGCTTTCTTT	CASSGRTPEAGSHTEAFF	TRBV10-1	TRBJ1-1
TGTGCCAGCAGCGTCGACCTGGGGGAGAATGAGCAGTTCTTC	CASSVDLGENEQFF	TRBV14	TRBJ2-1
TGTGCCAGCAGTGCCCCCGGGACTAGCCACTACAATGAGCAGTTCTTC	CASSAPGTSHYNEQFF	TRBV6-1	TRBJ2-1
TGTGCCAGCAGGGGGGGACCTGGGGCCAACGTCCTGACTTTC	CASRGGPGANVLTF	TRBV6-4	TRBJ2-6
TGTGCCAGCAGTACCGGGACAGGGTATAGCAATCAGCCCCAGCATTTT	CASSTGTGYSNQPQHF	TRBV6-1	TRBJ1-5
TGTGCCAGCAGCGGGACAGACAGAATGAACACTGAAGCTTTCTTT	CASSGTDRMNTEAFF	TRBV25-1	TRBJ1-1
TGTGCCACCAGTGATTTACCTTACTCCTACGAGCAGTACTTC	CATSDLPYSYEQYF	TRBV24-1	TRBJ2-7
TGTGCCAGCCCCGGGCTAAGGTCTGTTCAAGAGACCCAGTACTTC	CASPGLRSVQETQYF	TRBV7-6	TRBJ2-5
TGTGCCAGCAGGGCCTTGGGGGTTAATTCACCCCTCCACTTT	CASRALGVNSPLHF	TRBV12-3	TRBJ1-6
TGTGCCAGCAGCTTAGAAAATAACCGGGACAGGGATTCTAATGAAAAACTGTTTTTT	CASSLENNRDRDSNEKLFF	TRBV7-6	TRBJ1-4
TGTGCCAGCACGGCCTACGAGCAGTACTTC	CASTAYEQYF	TRBV27	TRBJ2-7
TGTGCCTGGAGTGTACCCCTCGTTGAGAACACTGAAGCTTTCTTT	CAWSVPLVENTEAFF	TRBV30	TRBJ1-1
TGTGCCAGCAGCTATGTACGACAGGCCTACGAGCAGTACTTC	CASSYVRQAYEQYF	TRBV13	TRBJ2-7
TGTGCCAGGCTAGCGGGGAGTTGTGACAATGAGCAGTTCTTC	CARLAGSCDNEQFF	TRBV5-4	TRBJ2-1
TGTGCCTGGAGTAGTCCCGAGCCAACCTACGAGCAGTACTTC	CAWSSPEPTYEQYF	TRBV30	TRBJ2-7
TGCAGCGTCGTGACAGGTGGCTACACCTTC	CSVVTGGYTF	TRBV29-1	TRBJ1-2
TGTGCCAGCAGTCCGGGACATACGCCTGAGCAGTTCTTC	CASSPGHTPEQFF	TRBV28	TRBJ2-1
TGTGCCACCAGCAGAGAAGCTGGGTATGAGCAGTTCTTC	CATSREAGYEQFF	TRBV15	TRBJ2-1
TGTGCCAGCATTCGGGGGGCAAGGGGACGGAGCTCCTATAATTCACCCCTCCACTTT	CASIRGARGRSSYNSPLHF	TRBV27	TRBJ1-6
TGTGCCAGCAGCCGCAGGGAAAAGCTTTCCGGGGAGCTGTTTTTT	CASSRREKLSGELFF	TRBV13	TRBJ2-2
TGCAGCCGAGGACCCGGGCCTGAGAATGGCTACACCTTC	CSRGPGPENGYTF	TRBV29-1	TRBJ1-2
TGTGCCAGCAGTTCCTTACATCCGGGACCTTACTATGGCTACACCTTC	CASSSLHPGPYYGYTF	TRBV27	TRBJ1-2
TGCAACGGACGGGGGGGCTTAATTACGTGCACAGATACGCAGTATTTT	CNGRGGLITCTDTQYF	TRBV20-1	TRBJ2-3
TGCAGTGCTCAGCGGGAGCTAATCCACGAGCAGTACTTC	CSAQRELIHEQYF	TRBV20-1	TRBJ2-7
TGTGCCAGCAGTTTTCTGGGCCTGTGGAGCACAGATACGCAGTATTTT	CASSFLGLWSTDTQYF	TRBV12-3	TRBJ2-3
TGTGCCAGCAGATCCTGTGTGCCGAGTCCAGGAAACACCATATATTTT	CASRSCVPSPGNTIYF	TRBV28	TRBJ1-3
TGCGCCAGGTTCCAGGGAAAAACGAACTACGGCGAGCAGTACTTC	CARFQGKTNYGEQYF	TRBV5-1	TRBJ2-7
TGTGCCAGCAGCTTGGAACCAGGGGGTAATGGCTACACCTTC	CASSLEPGGNGYTF	TRBV5-6	TRBJ1-2
TGTGCCAGCAGTTACAGAATGACAGGGGGCTACACCTTC	CASSYRMTGGYTF	TRBV6-6	TRBJ1-2
TGTGCCAGCAGCTTCCCGGGGGGACTAGGAGGGATCTACAATGAGCAGTTCTTC	CASSFPGGLGGIYNEQFF	TRBV7-9	TRBJ2-1
TGTGCCAGCAGGGGGCCGTATGAGCAGTTCTTC	CASRGPYEQFF	TRBV6-2	TRBJ2-1
TGCGCCAGCAGCTTGGCTCGGGGCTTATGGGTATGCCGGGTCTTCTATGGCTACACCTTC	CASSLARGLWVCRVFYGYTF	TRBV5-1	TRBJ1-2
TGTGCCAGCAGCCAGGACAGGGGGGGGGAGGATGGCTACACCTTC	CASSQDRGGEDGYTF	TRBV7-3	TRBJ1-2
TGCGCCAGCAGTGGATGGACAGACGAGCAGTACTTC	CASSGWTDEQYF	TRBV10-1	TRBJ2-7
TGCAGTGCTAGATCGATGGGACAGCCGAAGGAAACAGATACGCAGTATTTT	CSARSMGQPKETDTQYF	TRBV20-1	TRBJ2-3
TGCACACCCCCCCCCCTAGCGGGCAAGAGCTCCTACAATGAGCAGTTCTTC	CTPPPLAGKSSYNEQFF	TRBV20-1	TRBJ2-1
TGTGCCAGCAGTCGTGACAGGGGGGAAGCTTTCTTT	CASSRDRGEAFF	TRBV6-6	TRBJ1-1
TGCGCCAGCAGCAGGGCGGGAGGCGGATACGAGCAGTACTTC	CASSRAGGGYEQYF	TRBV5-1	TRBJ2-7
TGTGCCAGCAGCTTTTTCCGGGACAGGGAACCAGAAGCTTTCTTT	CASSFFRDREPEAFF	TRBV7-3	TRBJ1-1
TGTGCCAGCAGTGAACGGGGGGGGTATGGCTACACCTTC	CASSERGGYGYTF	TRBV27	TRBJ1-2
TGCAGTGCTAGAGGAAGGACAGGAGCAACTAATGAAAAACTGTTTTTT	CSARGRTGATNEKLFF	TRBV20-1	TRBJ1-4
TGCAGTGCTAGTAGCGGACTAGCGACCCAGTACTTC	CSASSGLATQYF	TRBV20-1	TRBJ2-5
TGTGCCAGCAGTTTTATCCGGACAGGTTGTCACACTGAAGCTTTCTTT	CASSFIRTGCHTEAFF	TRBV27	TRBJ1-1
TGTGCCAGCAGCCAAGAAGAGACAGGGCCCTCTGAAGCTTTCTTT	CASSQEETGPSEAFF	TRBV3-1	TRBJ1-1
TGTGCGAAAGGGGACAGCTCTGGAAACACCATATATTTT	CAKGDSSGNTIYF	TRBV2	TRBJ1-3
TGTGCCAGCAGAGCTGGCCGGGACTCCGGTAATCAGCCCCAGCATTTT	CASRAGRDSGNQPQHF	TRBV6-4	TRBJ1-5
TGTGCCAGCAGTCGACAGGGGGCTACTAGCAATCAGCCCCAGCATTTT	CASSRQGATSNQPQHF	TRBV6-5	TRBJ1-5
TGTGCCAGCAAATTAGGACAGGGGAGAGAGATGAGGTTTTTGAGGAGGTGCAATCAGCCCCAGCATTTT	CASKLGQGREMRFLRRCNQPQHF	TRBV6-2	TRBJ1-5
TGTGCCAGCAGCCAGGCCAGGGCGAACACCGGGGAGCTGTTTTTT	CASSQARANTGELFF	TRBV4-2	TRBJ2-2
TGTGCCAGCAGTGAACTTCGGAAGCGCCTCGAGCAGTACTTC	CASSELRKRLEQYF	TRBV2	TRBJ2-7
TGTGCCAGCTTTGATGCTCGGCTGTCAGGGGTTGTAACCTCCTACGAGCAGTACTTC	CASFDARLSGVVTSYEQYF	TRBV27	TRBJ2-7
TGTGCCAGCAGCCGAACGGGACCGGCCACAGATACGCAGTATTTT	CASSRTGPATDTQYF	TRBV7-3	TRBJ2-3
TGTGCCTGGAGTGGATATAGGGACTGGAACACTGAAGCTTTCTTT	CAWSGYRDWNTEAFF	TRBV30	TRBJ1-1
TGTGCCAGCAGCCCCCGGCCTAACTATGGCTACACCTTC	CASSPRPNYGYTF	TRBV9	TRBJ1-2
TGCGCCAGCGGACAGGGAACTACGCAGTATTTT	CASGQGTTQYF	TRBV5-1	TRBJ2-3
TGTGCCAGCTCACCACGCACCTCCAAGGAGGGGGGCTACACCTTC	CASSPRTSKEGGYTF	TRBV18	TRBJ1-2
TGTGCCAGCTCACCAGACCGGGACAGGGGGACCGGGGAGCTGTTTTTT	CASSPDRDRGTGELFF	TRBV18	TRBJ2-2
TGTGCCAGCAGCTTAAGCGACCCAGGACGGAGGAACACCGGGGAGCTGTTTTTT	CASSLSDPGRRNTGELFF	TRBV7-9	TRBJ2-2
TGTGCCAGCAGCCCCGAACTAGCGGGAGTCTCAGGTGGCTACACCTTC	CASSPELAGVSGGYTF	TRBV7-3	TRBJ1-2
TGTGCCAGCAGCTTAGCCTACCAGGGGGAGACCCAGTACTTC	CASSLAYQGETQYF	TRBV7-6	TRBJ2-5
TGTGCCAGCAGTTGTTCCTCTTACAGGCCGGACAATGAGCAGTTCTTC	CASSCSSYRPDNEQFF	TRBV12-4	TRBJ2-1
TGTGCCAGCAGCCAAGACCAAACGTCCCGGGACGGCGACACAGATACGCAGTATTTT	CASSQDQTSRDGDTDTQYF	TRBV14	TRBJ2-3
TGCGCCAGCGGGTTCACCCAGAGAGGTGCCTACGAGCAGTACTTC	CASGFTQRGAYEQYF	TRBV5-1	TRBJ2-7
TGTGCCAGCAGCTTAGTTATCCTCACAGATACGCAGTATTTT	CASSLVILTDTQYF	TRBV7-6	TRBJ2-3
TGCAGTGCTGTCCTAGACAGGGTGGTAAGCAATCAGCCCCAGCATTTT	CSAVLDRVVSNQPQHF	TRBV20-1	TRBJ1-5
TGTGCCAGCAGCTTATTAAACCAGAACTACTACTCCTACAATGAGCAGTTCTTC	CASSLLNQNYYSYNEQFF	TRBV7-9	TRBJ2-1
TGTGCCTGGCAGCCCCCCCACAGGCCCGCCTACGAGCAGTACTTC	CAWQPPHRPAYEQYF	TRBV30	TRBJ2-7
TGCAGTGCTAGAGAAATCGGGAATCAGCCCCAGCATTTT	CSAREIGNQPQHF	TRBV20-1	TRBJ1-5
TGTGCCAGCAGTGATAAGGCGGGACAGGGCTACGAGCAGTACTTC	CASSDKAGQGYEQYF	TRBV25-1	TRBJ2-7
TGTGCCAGCAGTCCACAGGGCCGGCAGCCCCAGCATTTT	CASSPQGRQPQHF	TRBV6-3	TRBJ1-5
TGTGCCAGGGGGCTTGCCTACGAGCAGTACTTC	CARGLAYEQYF	TRBV28	TRBJ2-7
TGTGAATTACTAGCGGGAGAAGAATGTCAGCCCCAGCATTTT	CELLAGEECQPQHF	TRBV24-1	TRBJ1-5
TGTGCCATCATAGAAGGGTCAGAGGTACACTGCTACGAGCAGTACTTC	CAIIEGSEVHCYEQYF	TRBV10-3	TRBJ2-7
TGTGCCAGCAGTCGATCTCCTAGGTGGATGAACACTGAAGCTTTCTTT	CASSRSPRWMNTEAFF	TRBV12-3	TRBJ1-1
TGTGCCAGCAGCTTAGCTCGCTGGGGGGGGGGCAGTGCCAATGAGCAGTTCTTC	CASSLARWGGGSANEQFF	TRBV7-6	TRBJ2-1
TGTGCCAGCAAGATCGGGACAGGGGTACCCAATCAGCCCCAGCATTTT	CASKIGTGVPNQPQHF	TRBV27	TRBJ1-5
TGTGCGACCAGACTAGTTAAACCGTACAATGAGCAGTTCTTC	CATRLVKPYNEQFF	TRBV6-2	TRBJ2-1
TGTGCTAGTGGGGCCTCAGAATGGGGGGGGGGCACCGCAGATACGCAGTATTTT	CASGASEWGGGTADTQYF	TRBV12-5	TRBJ2-3
TGCAGTGCTAGCCGGGGAGGGGGGAGCTCCTACGAGCAGTACTTC	CSASRGGGSSYEQYF	TRBV20-1	TRBJ2-7
TGTGCCAGCAGTACAGGGGGCCTGGACAACGAGCAGTACTTC	CASSTGGLDNEQYF	TRBV12-3	TRBJ2-7
TGTGCCAGCAAGACAACTGAAGCTTTCTTT	CASKTTEAFF	TRBV6-2	TRBJ1-1
TGTGCCACCAGCAGACAATTGAAGGGGGGAAGGAGCTACGAGCAGTACTTC	CATSRQLKGGRSYEQYF	TRBV15	TRBJ2-7
TGTGCCAGTAGTATTGAACAGGGTCGTGGCACAGATACGCAGTATTTT	CASSIEQGRGTDTQYF	TRBV19	TRBJ2-3
TGTGCCAGCAGCCAAGAGGAGCTCTACGAGCAGTACTTC	CASSQEELYEQYF	TRBV14	TRBJ2-7
TGTGCCACCAGGGCTATCCGGAAGGCGGAGGACGGGGCGACACATAGAAATTCACCCCTCCACTTT	CATRAIRKAEDGATHRNSPLHF	TRBV24-1	TRBJ1-6
TGCAGCGTTGCGAGCCCAAGGCAGGCCAATCAGCCCCAGCATTTT	CSVASPRQANQPQHF	TRBV29-1	TRBJ1-5
TGTGCCAGCACAGGGGCCGCATCTGGAAACACCATATATTTT	CASTGAASGNTIYF	TRBV2	TRBJ1-3
TGTGCCAGTCGGGGGCCCCGTCGCACCGGGGAGCTGTTTTTT	CASRGPRRTGELFF	TRBV7-2	TRBJ2-2
TGTAGTTTAGCAGCTGAAGCTTTCTTT	CSLAAEAFF	TRBV14	TRBJ1-1
TGTGCCAGCAGCGGGGACAGGGAGGCAGAGACCCAGTACTTC	CASSGDREAETQYF	TRBV6-4	TRBJ2-5
TGCAGTGGTGACAGGGGTACTATGGCCAAAAACATTCAGTACTTC	CSGDRGTMAKNIQYF	TRBV20-1	TRBJ2-4
TGTGCCAGCAGCCCGAAAAGCCGGACTAGCGGGGACGAGCAGTACTTC	CASSPKSRTSGDEQYF	TRBV13	TRBJ2-7
TGTGCCAGCAGTCCCCCCTCCAGAAAGAACACTGAAGCTTTCTTT	CASSPPSRKNTEAFF	TRBV6-5	TRBJ1-1
TGTGCCAGCAGCGGAAGGGGGCGACGACCAGGCTACACCTTC	CASSGRGRRPGYTF	TRBV13	TRBJ1-2
TGTGCCAGCAGCTTTACCCCCGGGACTAGACTAGAGACCCAGTACTTC	CASSFTPGTRLETQYF	TRBV11-3	TRBJ2-5
TGCGCCAGCAGGGACACTTCCTACGAGCAGTACTTC	CASRDTSYEQYF	TRBV5-1	TRBJ2-7
TGTGCCGTAAGGGACAGGGCTATAGATACGCAGTATTTT	CAVRDRAIDTQYF	TRBV10-3	TRBJ2-3
TGTGCCAGCAGCGTTCCCGGGGCAAATGGCTACACCTTC	CASSVPGANGYTF	TRBV9	TRBJ1-2
TGTGCCAGCAGCCCCGGGATAGATACGCAGTATTTT	CASSPGIDTQYF	TRBV11-2	TRBJ2-3
TGTGCCAGCGGATCGGGACTAGCGACTTCTAGCTACGAGCAGTACTTC	CASGSGLATSSYEQYF	TRBV7-3	TRBJ2-7
TGTGCCAGCAGCCCGCCACCGGAGCTCTCGGAGCAGTACTTC	CASSPPPELSEQYF	TRBV6-2	TRBJ2-7
TGCGCCAGGAATCTCCGGGGGCTCGAAGATACGCAGTATTTT	CARNLRGLEDTQYF	TRBV10-1	TRBJ2-3
TGTGCCACCAGTGGAGCCGTAGGGAAAGGGGCAACTAATGAAAAACTGTTTTTT	CATSGAVGKGATNEKLFF	TRBV24-1	TRBJ1-4
TGTGCCAGGCCGATATCACGGCGCTACGAGCAGTACTTC	CARPISRRYEQYF	TRBV19	TRBJ2-7
TGTGCCAGCAGCGGACTTAGGGACAGGGGGCCTGGAAACACCATATATTTT	CASSGLRDRGPGNTIYF	TRBV13	TRBJ1-3
TGTGCCAGCAGCAACAAGACAGGGTGTGGGGTTAGGGGGGAAAAACTGTTTTTT	CASSNKTGCGVRGEKLFF	TRBV7-3	TRBJ1-4
TGTGCCAGCAGCGTCCCGGGGGTGGTTTCTGCAAAGTGCCCCGGGGGGCCGGATCCTCCCGAGCAGTACTTC	CASSVPGVVSAKCPGGPDPPEQYF	TRBV11-2	TRBJ2-7
TGTGCCACCTTTTCAGCGGGAGAAAAACTGTTTTTT	CATFSAGEKLFF	TRBV11-3	TRBJ1-4
TGTGCCAGCAGCATGGGGGGGAGATACTACGAGCAGTACTTC	CASSMGGRYYEQYF	TRBV12-4	TRBJ2-7
TGTGCCACCAGTGGGGACAGGGGCTACGAGCAGTACTTC	CATSGDRGYEQYF	TRBV24-1	TRBJ2-7
TGTGCCAGCAGGGGGCCTAGGGACACTGAAGCTTTCTTT	CASRGPRDTEAFF	TRBV7-2	TRBJ1-1
TGTGCCACCAGTGATCTAGGGCCGAACTATGGCTACACCTTC	CATSDLGPNYGYTF	TRBV24-1	TRBJ1-2
TGTGCCAGCAGCGGGGAAACAATTAGGGCGGAAATCAGAAGCAATCAGCCCCAGCATTTT	CASSGETIRAEIRSNQPQHF	TRBV7-7	TRBJ1-5
TGTGCCAGCAGCTTAGAAAGCGTTTGTTCCTACAATGAGCAGTTCTTC	CASSLESVCSYNEQFF	TRBV11-3	TRBJ2-1
TGCAGCGGGTTAGACAGGGGGCCTAACGAGGACCTACCCTACGAGCAGTACTTC	CSGLDRGPNEDLPYEQYF	TRBV29-1	TRBJ2-7
TGCAGTGCTAGAGATCACTTTGTCCCCAGGTTGGCCTACGAGCAGTACTTC	CSARDHFVPRLAYEQYF	TRBV20-1	TRBJ2-7
TGTGCCAGCAGGACTAGACTCTACGAGCAGTACTTC	CASRTRLYEQYF	TRBV6-5	TRBJ2-7
TGTGCCACCAGTTCGGGACAGGATTGTCAGCCCCAGCATTTT	CATSSGQDCQPQHF	TRBV24-1	TRBJ1-5
TGCGCCAGCAGCTTGGCGGGTACGCACAAATACGAGCAGTACTTC	CASSLAGTHKYEQYF	TRBV5-1	TRBJ2-7
TGTGCCAGCAGTGAACTAACGACGCTAGCGGGGAGATGCTACAATGAGCAGTTCTTC	CASSELTTLAGRCYNEQFF	TRBV25-1	TRBJ2-1
TGTGCCAGCAGGTCCGGGACCAGAGGGGGCTACACCTTC	CASRSGTRGGYTF	TRBV14	TRBJ1-2
TGCGCCAGCAGCCAAATCCCGTTTCCTTGGGGGAACACTGAAGCTTTCTTT	CASSQIPFPWGNTEAFF	TRBV4-1	TRBJ1-1
TGCGCCAGAGGGACTAGGTCTTTTTACGAGCAGTACTTC	CARGTRSFYEQYF	TRBV4-1	TRBJ2-7
TGTGCCAGCAGCCAACTCTTAGGGCAGGTTACTGAAGCTTTCTTT	CASSQLLGQVTEAFF	TRBV14	TRBJ1-1
TGTGCCAGCCTTGCAACGGGACATAGGGAGCAGTACTTC	CASLATGHREQYF	TRBV28	TRBJ2-7
TGTGCCAGCAGTGCTGGCCCTCTCAATGAGCAGTTCTTC	CASSAGPLNEQFF	TRBV6-4	TRBJ2-1
TGTGCCAGCAGTGAGGTTATAAACTGGGGAGACTATGGCTACACCTTC	CASSEVINWGDYGYTF	TRBV25-1	TRBJ1-2
TGTGCCAGCAGTTTCCTGACAGGGGGGGACTACAATGAGCAGTTCTTC	CASSFLTGGDYNEQFF	TRBV28	TRBJ2-1
TGCAGTGCTAGAGCCCTCACCTCTGGGGCCAACGTCCTGACTTTC	CSARALTSGANVLTF	TRBV20-1	TRBJ2-6
TGCAGTGCCGCAATCCGGGACGGAGCCTACGAGCAGTACTTC	CSAAIRDGAYEQYF	TRBV20-1	TRBJ2-7
TGTGCCAGAGCAGGGGGCAACGTATTTTATAGCAATCAGCCCCAGCATTTT	CARAGGNVFYSNQPQHF	TRBV2	TRBJ1-5
TGTGCCAGCAGCTTCCTAACACAGGGACAGAATGAAAAACTGTTTTTT	CASSFLTQGQNEKLFF	TRBV5-6	TRBJ1-4
TGTGCCAGCAGCGTCGAGGCTAGCACCGGGGAGCTGTTTTTT	CASSVEASTGELFF	TRBV7-3	TRBJ2-2
TGCGCCAGCAGCCAAGGACATCGGGACAGGGGGCGGTATGGCTACACCTTC	CASSQGHRDRGRYGYTF	TRBV4-3	TRBJ1-2
TGTGCCAGCAGTTCCCCGGGACAGGGGAGAATGGAAGGGACCGGGGAGCTGTTTTTT	CASSSPGQGRMEGTGELFF	TRBV6-5	TRBJ2-2
TGTGCCAGCAGTTACCCAGGACTAGCGGGCGATGAGCAGTTCTTC	CASSYPGLAGDEQFF	TRBV6-5	TRBJ2-1
TGTGCCAGCAGCGAGATCCTTAGCTGCGGGATGAACACTGAAGCTTTCTTT	CASSEILSCGMNTEAFF	TRBV13	TRBJ1-1
TGTGCCAGCAGCATAGGGACAGATAGCAATCAGCCCCAGCATTTT	CASSIGTDSNQPQHF	TRBV11-2	TRBJ1-5
TGCAGTGCTAGAGAGTTGGTTTATGGGGGAGAAAGGCAGTTCTTC	CSARELVYGGERQFF	TRBV20-1	TRBJ2-1
TGTGCCAGCAGCTTAACCCCCTCGCCGGGACTTTACCGGAGCTCTGGAAACACCATATATTTT	CASSLTPSPGLYRSSGNTIYF	TRBV7-4	TRBJ1-3
TGTGCCAGCAGCGGGAGAACCACTGAAGCTTTCTTT	CASSGRTTEAFF	TRBV13	TRBJ1-1
TGTGCCAGCACAATAAGGGGGCGAGCGCAGCCCCAGCATTTT	CASTIRGRAQPQHF	TRBV7-4	TRBJ1-5
TGCGCCAGCAGCTGGTGGGACAAGAACTATGGCTACACCTTC	CASSWWDKNYGYTF	TRBV5-1	TRBJ1-2
TGTGCCAGCAGCTCGACGGGGCCCGGCAACTATGGCTACACCTTC	CASSSTGPGNYGYTF	TRBV5-4	TRBJ1-2
TGTGCCACCAGTGATTGGGTTGGGATATCCAGGGTGTATTACGAGCAGTACTTC	CATSDWVGISRVYYEQYF	TRBV24-1	TRBJ2-7
TGCAGTGCTAGAGATACGCCGGGAACGGAGGACAATCAGCCCCAGCATTTT	CSARDTPGTEDNQPQHF	TRBV20-1	TRBJ1-5
TGTGCCAGCAGTGAAGGGGGTGAGGGCTACACCTTC	CASSEGGEGYTF	TRBV6-5	TRBJ1-2
TGTGCCAGCAGTATGCTCCTTCCGGGACTAGCGGGAGAGACAGATACGCAGTATTTT	CASSMLLPGLAGETDTQYF	TRBV6-5	TRBJ2-3
TGTGCCAGCAGCGGGCCCGTTCACAGGGCTGAGGAGGAAAATGAGCAGTTCTTC	CASSGPVHRAEEENEQFF	TRBV13	TRBJ2-1
TGTGCCAGCAGTTTAAGAGTAAGGAGGACTGAAGCTTTCTTT	CASSLRVRRTEAFF	TRBV27	TRBJ1-1
TGTGCCAGCAGCCCCGGATGCGGTGGGGGGCGGCTTAACGAGCAGTACTTC	CASSPGCGGGRLNEQYF	TRBV7-9	TRBJ2-7
TGTGCCAGCAGCTGGGTCGGGGGATATAGCAATCAGCCCCAGCATTTT	CASSWVGGYSNQPQHF	TRBV5-5	TRBJ1-5
TGCGCCCCCCGCCCCGGGACAGGGGAAGGAGCCTACGAGCAGTACTTC	CAPRPGTGEGAYEQYF	TRBV5-1	TRBJ2-7
TGTGCCAGCAGTGTTAAGCAGTCGGGCTATGGCTACACCTTC	CASSVKQSGYGYTF	TRBV2	TRBJ1-2
TGTGCCAGCAGCTACCTCGGGCGGGTTGATGAGCAGTTCTTC	CASSYLGRVDEQFF	TRBV11-3	TRBJ2-1
TGCAGTGCTATTGTCCCGGGGAGGGTGGGTGAGCAGTTCTTC	CSAIVPGRVGEQFF	TRBV20-1	TRBJ2-1
TGTGCCAGCAGCTTAGATTACGGGGGGTCCCTCCACTTT	CASSLDYGGSLHF	TRBV7-6	TRBJ1-6
TGCAGTGCTAGCCGGAAAGCCTACGAGCAGTACTTC	CSASRKAYEQYF	TRBV20-1	TRBJ2-7
TGCGCCAGCAGCCGCCTCACAGGGGCAGATACGCAGTATTTT	CASSRLTGADTQYF	TRBV4-1	TRBJ2-3
TGTGCCAGCAGTGACGGTGATGACTACGAGCAGTACTTC	CASSDGDDYEQYF	TRBV6-4	TRBJ2-7
TGTGCCAGCAGTTTACCAAAACGGAACATTCAGTACTTC	CASSLPKRNIQYF	TRBV12-3	TRBJ2-4
TGTGCCAGCCTCCGGGGGGGGGGATGGGGTGACGAGCAGTACTTC	CASLRGGGWGDEQYF	TRBV7-3	TRBJ2-7
TGTGCCAGCAGCCCAATTCATTGGGACAGGGGGCCAATGAACACTGAAGCTTTCTTT	CASSPIHWDRGPMNTEAFF	TRBV9	TRBJ1-1
TGTGCCAGCAGTTTCAGGGGCATTCAGTACTTC	CASSFRGIQYF	TRBV12-3	TRBJ2-4
TGCAGTGCTGGGGACAGGGGGGGACGCTCTGGAAACACCATATATTTT	CSAGDRGGRSGNTIYF	TRBV20-1	TRBJ1-3
TGTGCCAGCAGCCAAAGGTACAATCAGCCCCAGCATTTT	CASSQRYNQPQHF	TRBV7-8	TRBJ1-5
TGTGCCAAGCTAGAGAGCAATGAGCAGTTCTTC	CAKLESNEQFF	TRBV2	TRBJ2-1
TGTGCCAGCAGCTTGGCGACAGGGACGGATGAAAAACTGTTTTTT	CASSLATGTDEKLFF	TRBV7-4	TRBJ1-4
TGTGCCAGCAGCCAAGCCCCGGGATTAGGAGGGAACAATGAGCAGTTCTTC	CASSQAPGLGGNNEQFF	TRBV3-1	TRBJ2-1
TGCAGTGCTAGGAAACTAGGGGATAGCAATCAGCCCCAGCATTTT	CSARKLGDSNQPQHF	TRBV20-1	TRBJ1-5
TGCGCCAGCAGTGAGCAGGCGAGCTCCTACGAGCAGTACTTC	CASSEQASSYEQYF	TRBV10-2	TRBJ2-7
TGTGCCAGCAGTTTAAATAGGGCGGAAAATAGGGAGCTGTTTTTT	CASSLNRAENRELFF	TRBV28	TRBJ2-2
TGCGCCAGCAGTGGGCGAGAGGATACGCAGTATTTT	CASSGREDTQYF	TRBV10-1	TRBJ2-3
TGTGCCAGCAGTGGTAACGGACTAGCGGGCCCGCCCTACGAGCAGTACTTC	CASSGNGLAGPPYEQYF	TRBV25-1	TRBJ2-7
TGTGCCAGCAGTGAACTAGTGGGCACAGATACGCAGTATTTT	CASSELVGTDTQYF	TRBV6-4	TRBJ2-3
TGCGCCAGCAGCTTGCCCACTGGAGGCTACGAGCAGTACTTC	CASSLPTGGYEQYF	TRBV5-1	TRBJ2-7
TGTGCCAGCAGCTTAGGACCTGAACTCAACAGTAGGGATACGCAGTATTTT	CASSLGPELNSRDTQYF	TRBV7-7	TRBJ2-3
TGTGCCAGCAGCCCCAGTCCCAGTGAGCAGTTCTTC	CASSPSPSEQFF	TRBV13	TRBJ2-1
TGTGCCAGCAGCCAAGAATTAAGGGCGGAAACCTACGAGCAGTACTTC	CASSQELRAETYEQYF	TRBV14	TRBJ2-7
TGTGCCAGCCCTCCGAATGGTTCGGGACAGGCGAGGTTCTCTGGAAACACCATATATTTT	CASPPNGSGQARFSGNTIYF	TRBV13	TRBJ1-3
TGTGCCCTTGATTTTAGGACTAGCGGGGCCGGGCGCACAGATACGCAGTATTTT	CALDFRTSGAGRTDTQYF	TRBV6-6	TRBJ2-3
TGTGCCAGCACCCTTTCCGGGACGAGGTTCGAGCAGTACTTC	CASTLSGTRFEQYF	TRBV6-3	TRBJ2-7
TGTGCCAGCAGCAGAGATGATGGGACTAGCGGGCGTGAGACCCAGTACTTC	CASSRDDGTSGRETQYF	TRBV11-1	TRBJ2-5
TGCGCCAGCAGCTTGTCGAGACAGGGCTACTATGGCTACACCTTC	CASSLSRQGYYGYTF	TRBV5-1	TRBJ1-2
TGTGCCAGAGGCATTAATATAGAGACCCAGTACTTC	CARGINIETQYF	TRBV6-8	TRBJ2-5
TGTGCCAGACACTCTAAGGGGGCATTCGACGATTCTTATTATGGCTACACCTTC	CARHSKGAFDDSYYGYTF	TRBV24-1	TRBJ1-2
TGTGCCAGCAGCGGGGGCTTCGGCCCGCCCCAGCATTTT	CASSGGFGPPQHF	TRBV28	TRBJ1-5
TGCGCCAGCGCAGGGGGCAAGTCCAGTCTTTGGATGTGTGGGGCCAACGTCCTGACTTTC	CASAGGKSSLWMCGANVLTF	TRBV10-1	TRBJ2-6
TGTGCCAGCAGTTTAGTACTCACCAACGAGCAGTACTTC	CASSLVLTNEQYF	TRBV12-4	TRBJ2-7
TGTGCCAGCAGCGGGAAGGCCCCGGATGAGCAGTTCTTC	CASSGKAPDEQFF	TRBV6-5	TRBJ2-1
TGTGCCAGCAGTGTCGGAAGGACTAGCGGGGGGGGACACTCGTACAATGAGCAGTTCTTC	CASSVGRTSGGGHSYNEQFF	TRBV2	TRBJ2-1
TGTGCCAGCAGCCCTCCAGAGGGGATTAGGACCCAGTACTTC	CASSPPEGIRTQYF	TRBV13	TRBJ2-5
TGTGCCAGCAGTTACCGATTGACAGGGACCTACGAGCAGTACTTC	CASSYRLTGTYEQYF	TRBV6-5	TRBJ2-7
TGTGCCAGCAGCCGAGGGGGGGCTACCTCCTACAATGAGCAGTTCTTC	CASSRGGATSYNEQFF	TRBV2	TRBJ2-1
TGTGCCAGCAGCTTAACCGGCCCCCGGTACGAGCAGTACTTC	CASSLTGPRYEQYF	TRBV13	TRBJ2-7
TGTGCCAGCACCGAAGCGAAGGACAATGAGCAGTTCTTC	CASTEAKDNEQFF	TRBV28	TRBJ2-1
TGTGCCAGCAGTTCCGGTGACGTAGGAGAGGCTGGAAACACCATATATTTT	CASSSGDVGEAGNTIYF	TRBV28	TRBJ1-3
TGTGCCAGCAGCAAGGAAAGCTTAGGGTATAACTACGAGCAGTACTTC	CASSKESLGYNYEQYF	TRBV5-6	TRBJ2-7
TGTGCCAGCAGCGTCAGGCCCCACAGGGGGTATTGGGAGGTACCCCTCCACTTT	CASSVRPHRGYWEVPLHF	TRBV5-6	TRBJ1-6
TGTGCCAGCAGTTGGATGGGGACTAACTATGGCTACACCTTC	CASSWMGTNYGYTF	TRBV28	TRBJ1-2
TGTGCCAGCAAAGGGGGCGACGTAAACACTGAAGCTTTCTTT	CASKGGDVNTEAFF	TRBV2	TRBJ1-1
TGTGCCAGCAGAAACACAGGGGGTGGCTACACCTTC	CASRNTGGGYTF	TRBV7-9	TRBJ1-2
TGTGCCAGCAGTTTATGCTATGAGCAGTTCTTC	CASSLCYEQFF	TRBV28	TRBJ2-1
TGTGCCAGCAGCTATGCGGATGATCAGCCCCAGCATTTT	CASSYADDQPQHF	TRBV7-3	TRBJ1-5
TGTGCCAGCAAGCCACCCCGGGACAGTTTGTTCATGAACACTGAAGCTTTCTTT	CASKPPRDSLFMNTEAFF	TRBV6-5	TRBJ1-1
