TGTGCCAGCAGTGTTAAACGAACCTACGAGCAGTACTTC	CASSVKRTYEQYF	TRBV6-1	TRBJ2-7
TGTGCCAGCTCACCAGTATTTGCTTCCAATGGCTACACCTTC	CASSPVFASNGYTF	TRBV18	TRBJ1-2
TGTGCCAGCAGTCGTTCTAAGGAAGACAGGGGGCCGAGCTACGAGCAGTACTTC	CASSRSKEDRGPSYEQYF	TRBV6-3	TRBJ2-7
TGTGCCAGCAGCCAAAGCCGCAATGAGCAGTTCTTC	CASSQSRNEQFF	TRBV3-1	TRBJ2-1
TGTGCCAGCAGCCAGAAAAACACCCGGGGTTTACTGAGAGGTGAGCAGTACTTC	CASSQKNTRGLLRGEQYF	TRBV14	TRBJ2-7
TGTGCCAGTAGTACCCTTAATCTCCCACTAGTTGGCAAGGGCGCTGAGACCCAGTACTTC	CASSTLNLPLVGKGAETQYF	TRBV19	TRBJ2-5
TGTGCCAGCAGTTACGGTGGCAGGAACACTGAAGCTTTCTTT	CASSYGGRNTEAFF	TRBV6-3	TRBJ1-1
TGCAGTGCTAGAGCGCAAGGGGAACGAAGGGGGGGGGGAGGAAACACCATATATTTT	CSARAQGERRGGGGNTIYF	TRBV20-1	TRBJ1-3
TGTGCCAGCAGTTTCGGGGAAGGGGGGCTGCCCTATGGCTACACCTTC	CASSFGEGGLPYGYTF	TRBV27	TRBJ1-2
TGTGCCAGCAGTGTTAGTAGTTCCCATAGAGGGGAAAAACTGTTTTTT	CASSVSSSHRGEKLFF	TRBV6-1	TRBJ1-4
TGTGCCATTTTCATGGGACGGGTAGATACGCAGTATTTT	CAIFMGRVDTQYF	TRBV13	TRBJ2-3
TGTGCCAGCAGGAGGCGCTTCAGCTACGAGCAGTACTTC	CASRRRFSYEQYF	TRBV28	TRBJ2-7
TGTGCCAGTAGTCCCCAGACTAGCGGGCATGAGCAGTTCTTC	CASSPQTSGHEQFF	TRBV19	TRBJ2-1
TGTGCCAGCAGCGTAGGGGGGACAGGGGGCGCCCAGCCCCAGCATTTT	CASSVGGTGGAQPQHF	TRBV9	TRBJ1-5
TGCAGTGCTACCGAGCGGTACCCTCCCTACGAGCAGTACTTC	CSATERYPPYEQYF	TRBV20-1	TRBJ2-7
TGTGCCAGCAGTGACCGGGAGGGCTTAAACTATGGCTACACCTTC	CASSDREGLNYGYTF	TRBV2	TRBJ1-2
TGCGCCAGCAGCTTGCGTAAAAAATCACCAAATAACACTGAAGCTTTCTTT	CASSLRKKSPNNTEAFF	TRBV5-1	TRBJ1-1
TGTGCCAGCAGTTTCAAGGGGGACGGACAGTCATACGAGCAGTACTTC	CASSFKGDGQSYEQYF	TRBV27	TRBJ2-7
TGCGCCAGCAGCCCCGGGGACGCTCGGACGGACTTAATTAGCAATCAGCCCCAGCATTTT	CASSPGDARTDLISNQPQHF	TRBV5-1	TRBJ1-5
TGTGCCAGCAGCTCCAACGGACAGACCTATGGCTACACCTTC	CASSSNGQTYGYTF	TRBV9	TRBJ1-2
TGTGCCAGCAGCTGCAAGAGGGGAAAATACGAGCAGTACTTC	CASSCKRGKYEQYF	TRBV7-2	TRBJ2-7
TGTGCCAGCAGCGCACCGGGCGACGGCCGAAACACCATATATTTT	CASSAPGDGRNTIYF	TRBV14	TRBJ1-3
TGTGCCAGCAGCCAAGACACATCATACGAGCAGTACTTC	CASSQDTSYEQYF	TRBV14	TRBJ2-7
TGTGCCAGCAGCAAAACCAGGGGCGAGGGGTCTGGAAACACCATATATTTT	CASSKTRGEGSGNTIYF	TRBV13	TRBJ1-3
TGTGCCACCTTACTCGGGACAGCTAGTCAGCCCCAGCATTTT	CATLLGTASQPQHF	TRBV24-1	TRBJ1-5
TGTGCCAGCAGGTTGAGCGGGGAGCAGTTCTTC	CASRLSGEQFF	TRBV6-1	TRBJ2-1
TGTGCCAGCAGTGAAGACAGGGGTTACTACGAGCAGTACTTC	CASSEDRGYYEQYF	TRBV6-4	TRBJ2-7
TGTGCCACCAGTGAGCTAGGTCGCCAGCCCCAGCATTTT	CATSELGRQPQHF	TRBV24-1	TRBJ1-5
TGTGCCAGCAGCCGGTCTAGGGGTGAAGGTAATAGCAATCAGCCCCAGCATTTT	CASSRSRGEGNSNQPQHF	TRBV27	TRBJ1-5
TGTGCCAGCAGCCCGGGTGGGGAAAATGAGCAGTTCTTC	CASSPGGENEQFF	TRBV13	TRBJ2-1
TGTGCCAGCAGCGCGGGCCCAGATACGCAGTATTTT	CASSAGPDTQYF	TRBV7-2	TRBJ2-3
TGTGCCAGCAGTAAAGTTCCCCAGGGACAGGGGAACACCATATATTTT	CASSKVPQGQGNTIYF	TRBV28	TRBJ1-3
TGTGCCAGCAGCATTTTAAAGGACAGGAACTCTGGAAACACCATATATTTT	CASSILKDRNSGNTIYF	TRBV7-3	TRBJ1-3
TGTGCCAGCTCACAGGGGGTCTTT	CASSQGVF	TRBV18	TRBJ1-1
TGCCGAACGACAGGGGGCGAAGATACGCAGTATTTT	CRTTGGEDTQYF	TRBV20-1	TRBJ2-3
TGTGCCAGCACAATCAGGGTTGAAAAACTGTTTTTT	CASTIRVEKLFF	TRBV27	TRBJ1-4
TGTGCCAGCAGCCGGTTTTCAGACCGGGAGCAGTACTTC	CASSRFSDREQYF	TRBV27	TRBJ2-7
TGTGCCAGCAGTTATGTACGACGGGACGAAGGGTACACTGAAGCTTTCTTT	CASSYVRRDEGYTEAFF	TRBV6-3	TRBJ1-1
TGTGCCAGCACGCGACAGAAACAGGGGCTCGTAGGCACAGATACGCAGTATTTT	CASTRQKQGLVGTDTQYF	TRBV28	TRBJ2-3
TGTGCCAGCAGCAACTTACGGGGAGGAACCGGGCCCGCTAACTATGGCTACACCTTC	CASSNLRGGTGPANYGYTF	TRBV7-3	TRBJ1-2
TGTGCCAGCAGTGTCGTTACCGGGACAGGGGAGACCCAGTACTTC	CASSVVTGTGETQYF	TRBV6-5	TRBJ2-5
TGTGCCACCAGCAGCAGCCAGCGTCAGCCCCAGCATTTT	CATSSSQRQPQHF	TRBV15	TRBJ1-5
TGTGCCAGCAGCCAAGATCGGCTAGAGCGCAGCGACAATCAGCCCCAGCATTTT	CASSQDRLERSDNQPQHF	TRBV14	TRBJ1-5
TGTGCCCATGTGGGGACTAGCGGAACATACGAGCAGTACTTC	CAHVGTSGTYEQYF	TRBV28	TRBJ2-7
TGTGCCAGCAGTGGGGATCCCATCGGGGGAGACGAGCAGTACTTC	CASSGDPIGGDEQYF	TRBV6-4	TRBJ2-7
TGTGCCAGCAGTGACTCGACAGGACAGGGGGCTAGGCGGCCCCAGCATTTT	CASSDSTGQGARRPQHF	TRBV6-4	TRBJ1-5
TGTGCCAGCAGCCCAAATCCAGGGAATTCACCCCTCCACTTT	CASSPNPGNSPLHF	TRBV7-3	TRBJ1-6
TGTGCCAGCAGTTTATCTTGGGCCGGGTGGGACACTGAAGCTTTCTTT	CASSLSWAGWDTEAFF	TRBV12-3	TRBJ1-1
TGTGCCAGCAGCACCGACTACGAGCAGTACTTC	CASSTDYEQYF	TRBV9	TRBJ2-7
TGTGCCACCAGTGATTTGACCCTCATCCCAGCTGGCTACACCTTC	CATSDLTLIPAGYTF	TRBV24-1	TRBJ1-2
TGTGCCACCAGAAAACAGGGGTATGGAATTAGTTACAGCATCACCGGGGAGCTGTTTTTT	CATRKQGYGISYSITGELFF	TRBV24-1	TRBJ2-2
TGCGCCAGCACGGGGGGACAGTCCACCGGGGAGCTGTTTTTT	CASTGGQSTGELFF	TRBV5-1	TRBJ2-2
TGTGCCAGGGAACCCCGGACAGGGGGCTCCTACGAGCAGTACTTC	CAREPRTGGSYEQYF	TRBV25-1	TRBJ2-7
TGCGCCAGCAAGGGTCTGCCGGGACACCTGAACAATCAGCCCCAGCATTTT	CASKGLPGHLNNQPQHF	TRBV4-1	TRBJ1-5
TGTGCCAGCAGCTTAGCCGAGGGGGTCTCCTACGAGCAGTACTTC	CASSLAEGVSYEQYF	TRBV7-2	TRBJ2-7
TGCGCCAGCAGTCCTACAGAAGGGCATGAAAAACTGTTTTTT	CASSPTEGHEKLFF	TRBV10-1	TRBJ1-4
TGTGCCAGCAGTTACAGTAAAAACATTCAGTACTTC	CASSYSKNIQYF	TRBV6-2	TRBJ2-4
TGTGCCAGCACTAGACCTATGGAGACCCAGTACTTC	CASTRPMETQYF	TRBV27	TRBJ2-5
TGTGCCAGCAGCTTAGCCGGGACCCCAAAGGGCCCGGACAATGAGCAGTTCTTC	CASSLAGTPKGPDNEQFF	TRBV11-3	TRBJ2-1
TGCACCCTAAACAGGGGGCAGCCGAACGAGCAGTACTTC	CTLNRGQPNEQYF	TRBV29-1	TRBJ2-7
TGTGCCAGCAGTTACACAAGGGGGATAGCTTTCTTT	CASSYTRGIAFF	TRBV6-5	TRBJ1-1
TGTGCCAGCAGCTTAGATGTCGGGCGGGACAGGAGGGAGCAGTACTTC	CASSLDVGRDRREQYF	TRBV7-2	TRBJ2-7
TGTGCCAGCACCCGCGGGACACAATACGAGCAGTACTTC	CASTRGTQYEQYF	TRBV6-4	TRBJ2-7
TGTGCCAGCAGCCCGGTGGTGTGGACATACCGACATAGCAATCAGCCCCAGCATTTT	CASSPVVWTYRHSNQPQHF	TRBV3-1	TRBJ1-5
TGTGCCAGTACGAGACAGGGCAGCACTGAAGCTTTCTTT	CASTRQGSTEAFF	TRBV25-1	TRBJ1-1
TGCGCCAGCAGCCAAGATCCTTTACCCGCGGGACAAGTCCCAGAGACCCAGTACTTC	CASSQDPLPAGQVPETQYF	TRBV4-1	TRBJ2-5
TGCAGTGTACAGGTCAGCAATCAGCCCCAGCATTTT	CSVQVSNQPQHF	TRBV20-1	TRBJ1-5
TGCAGCCCAAATATCGCCTTCAGCAGAAGGGAGCAGTACTTC	CSPNIAFSRREQYF	TRBV29-1	TRBJ2-7
TGTGCCAGCAGCGACATCACCGGTCTAACCTACGAGCAGTACTTC	CASSDITGLTYEQYF	TRBV7-3	TRBJ2-7
TGCAGCGTTGCGTGGACTAGCGGGAGGGCGGGGTACTACGAGCAGTACTTC	CSVAWTSGRAGYYEQYF	TRBV29-1	TRBJ2-7
TGTGCCAGCAGTGACTCGTTCGACGCAGGGAATTACCGCACAGATACGCAGTATTTT	CASSDSFDAGNYRTDTQYF	TRBV6-4	TRBJ2-3
TGTGCCAGCAGCACCCCCAGTAGGACCGAGGAGACCCAGTACTTC	CASSTPSRTEETQYF	TRBV7-3	TRBJ2-5
TGTGCCACCTTCCCGTGGACAGGGGCCCAGGCTCGTATTCCGAACACCGGGGAGCTGTTTTTT	CATFPWTGAQARIPNTGELFF	TRBV27	TRBJ2-2
TGTGCCAGCAGGGATCTTAGGGCAGGGGGCGGGGCCAACGTCCTGACTTTC	CASRDLRAGGGANVLTF	TRBV6-5	TRBJ2-6
TGTGCCAGCAGCTTGGCACCAGTGTCCTACGAGCAGTACTTC	CASSLAPVSYEQYF	TRBV5-4	TRBJ2-7
TGTGCCAGCAGTTGCCTTGGCAGCCGAGGACAGGGTCCGCACGAGCAGTACTTC	CASSCLGSRGQGPHEQYF	TRBV6-2	TRBJ2-7
TGTGCTAGTGGTTTGCTGAGGGGACGGGCAGATACGCAGTATTTT	CASGLLRGRADTQYF	TRBV12-5	TRBJ2-3
TGTGCCAGCAGCGCAGGGTTTGACAGGGTACGGAGCAATCAGCCCCAGCATTTT	CASSAGFDRVRSNQPQHF	TRBV7-8	TRBJ1-5
TGCGCCAGCAGCTTGGTTCGACTGCGACAGAAAATGAACACTGAAGCTTTCTTT	CASSLVRLRQKMNTEAFF	TRBV5-1	TRBJ1-1
TGTGCCAGCAGTTACACCCACCCGGACAGGGTAACGAAGAGCTCCTATAATTCACCCCTCCACTTT	CASSYTHPDRVTKSSYNSPLHF	TRBV6-5	TRBJ1-6
TGTGCCTGGAGCCAGTTCCCCCAGGGAGCGGTATTCACCGGGGAGCTGTTTTTT	CAWSQFPQGAVFTGELFF	TRBV30	TRBJ2-2
TGTGCCAGCAGTTTATTGTGGACAGGGGGTGGCTACACCTTC	CASSLLWTGGGYTF	TRBV28	TRBJ1-2
TGTGCCAGCAGACCTCTGGGTAATTGCTACGAGCAGTACTTC	CASRPLGNCYEQYF	TRBV11-3	TRBJ2-7
TGTGCCAGCGGAGCGCCCGGACTGGCAGGTGATACTGAAGCTTTCTTT	CASGAPGLAGDTEAFF	TRBV7-9	TRBJ1-1
TGTGCCAGCAGCAGGGCGGGACAGGAACGAACTAACTATGGCTACACCTTC	CASSRAGQERTNYGYTF	TRBV7-3	TRBJ1-2
TGTGCCAGCAGCCCATCCCTTAGCAGACGAAGCTCCTACAATGAGCAGTTCTTC	CASSPSLSRRSSYNEQFF	TRBV28	TRBJ2-1
TGTGCCAGCAGCCAAGGGGGGCCCCCCACAGATACGCAGTATTTT	CASSQGGPPTDTQYF	TRBV7-6	TRBJ2-3
TGTGCCAGCAGTTACCAGGGGCCCAGGGGGAACCGCCAAGAGACCCAGTACTTC	CASSYQGPRGNRQETQYF	TRBV6-3	TRBJ2-5
TGTGCCAGCAGCGGGTCCCGACTAGCTTTGCTCCAGGTGGAAGATACGCAGTATTTT	CASSGSRLALLQVEDTQYF	TRBV13	TRBJ2-3
TGTGCCAGCAGCGGTAGGGCCTCTGGGGCCAACGTCCTGACTTTC	CASSGRASGANVLTF	TRBV7-9	TRBJ2-6
TGTGCCAGCAGCTTAGATGCGGGACAAGCTTTCTTT	CASSLDAGQAFF	TRBV11-2	TRBJ1-1
TGTGCCAGCAGCCCAATTGGGGGGGTTGAAGCTTTCTTT	CASSPIGGVEAFF	TRBV14	TRBJ1-1
TGTGCCAGTAGTACCTCTAAGAGCGTCTCCTACGAGCAGTACTTC	CASSTSKSVSYEQYF	TRBV19	TRBJ2-7
TGTGCCAGCAGTATGAGACTGTTAACAGATACGCAGTATTTT	CASSMRLLTDTQYF	TRBV6-1	TRBJ2-3
TGCAGTGCTAGAGATACAGGGGCAAATCAGCCCCAGCATTTT	CSARDTGANQPQHF	TRBV20-1	TRBJ1-5
TGTGCCAGCAGTTTGACGGGACTTGGGATTATTAATGGCTACACCTTC	CASSLTGLGIINGYTF	TRBV12-3	TRBJ1-2
TGTGCCAGCAGCTGGACAGGGGGCTACACCTTC	CASSWTGGYTF	TRBV7-3	TRBJ1-2
TGTGCCAGTAGTTTTGACCTGGTGAACACTGAAGCTTTCTTT	CASSFDLVNTEAFF	TRBV19	TRBJ1-1
TGTGCCAGCAGCTTAGAAAATCCCGGGACGGAGAGGATGATCGGTGGCTACACCTTC	CASSLENPGTERMIGGYTF	TRBV7-3	TRBJ1-2
TGTGCCAGCAGTTGGGGTAGAATCTACGAGCAGTACTTC	CASSWGRIYEQYF	TRBV12-3	TRBJ2-7
TGTGCCAGCAAGTTCGACAGGGGGGAGCAGTACTTC	CASKFDRGEQYF	TRBV28	TRBJ2-7
TGTGCCAGCATCGTAGGGACTAGCGTAACGAACACCGGGGAGCTGTTTTTT	CASIVGTSVTNTGELFF	TRBV6-2	TRBJ2-2
TGCGCCAGCAGCTATAGCAGAGGACACATGAACACTGAAGCTTTCTTT	CASSYSRGHMNTEAFF	TRBV5-1	TRBJ1-1
TGTGCCAGCAGTGATCTAGAATACGAGCAGTACTTC	CASSDLEYEQYF	TRBV6-4	TRBJ2-7
TGTGCCAGCAGCGACAGATACGAGCAGTACTTC	CASSDRYEQYF	TRBV13	TRBJ2-7
TGTGCCAGCAGGGACGGATACCCGTACGAGCAGTACTTC	CASRDGYPYEQYF	TRBV12-4	TRBJ2-7
TGTGCCAGTAGTAGTTCCGCGGGTCGCTTGAATGAAAAACTGTTTTTT	CASSSSAGRLNEKLFF	TRBV19	TRBJ1-4
TGTGCCAGCAGCCAAGATCCGGGACGATTAGTCGAAACGGACGAGCAGTACTTC	CASSQDPGRLVETDEQYF	TRBV3-1	TRBJ2-7
TGTGCCAGCAGCCTGTCGGTTGAACTCCCCAGCTCCTATAATTCACCCCTCCACTTT	CASSLSVELPSSYNSPLHF	TRBV7-8	TRBJ1-6
TGTGCCACCAGTGTTGGGGACAGCACTGAAGCTTTCTTT	CATSVGDSTEAFF	TRBV24-1	TRBJ1-1
TGTGCCTGGGGAGGGCCAAGGAGCTCCTATAATTCACCCCTCCACTTT	CAWGGPRSSYNSPLHF	TRBV30	TRBJ1-6
TGTGCCAGCAGCTTTGGACAGGATCCCACCGGGGAGCTGTTTTTT	CASSFGQDPTGELFF	TRBV7-9	TRBJ2-2
TGCGCCAGTGATGGACAGGGGTGTGCTGAAGCTTTCTTT	CASDGQGCAEAFF	TRBV5-1	TRBJ1-1
TGTGCCAGCAGTTACTTTAGGAAATCCTACAATGAGCAGTTCTTC	CASSYFRKSYNEQFF	TRBV6-5	TRBJ2-1
TGTGCCAGCAGCAGACTCGAGGGGGATAACACCATATATTTT	CASSRLEGDNTIYF	TRBV13	TRBJ1-3
TGCAGTGCTAGAGATCAGACCATACACAACAATCAGCCCCAGCATTTT	CSARDQTIHNNQPQHF	TRBV20-1	TRBJ1-5
TGTGCCAGCAGCCCCCGGATAACTCGCCTTAGCACAGATACGCAGTATTTT	CASSPRITRLSTDTQYF	TRBV7-9	TRBJ2-3
TGTGCCAGCAGCTTAGCCGGGGATGGCTACACCTTC	CASSLAGDGYTF	TRBV11-3	TRBJ1-2
TGTGCCAGCAGCGGGACAGGGGCAACTAATGAAAAACTGTTTTTT	CASSGTGATNEKLFF	TRBV6-5	TRBJ1-4
TGTGCCAGCAGCACCGGGACTAGCGGGACGGAGGATGAGCAGTTCTTC	CASSTGTSGTEDEQFF	TRBV5-8	TRBJ2-1
TGTGCCAGCAGCCTCTACGGGTCGGGACAGGGCTCCGTTAGCAATCAGCCCCAGCATTTT	CASSLYGSGQGSVSNQPQHF	TRBV2	TRBJ1-5
TGTGCTAGTGGTTCTCCAGGCGAGCAGTACTTC	CASGSPGEQYF	TRBV12-5	TRBJ2-7
TGCGCCAGCAGCTTGGAGCCGGGACTAGCTACCGGGTTCATTCAGTACTTC	CASSLEPGLATGFIQYF	TRBV5-1	TRBJ2-4
TGTGCCAGTAGCCTGCGGTTTCCCTACAATGAGCAGTTCTTC	CASSLRFPYNEQFF	TRBV19	TRBJ2-1
TGCGCCAGCAGCCAAGATCTCAAGCCGACTAGATATGAGCAGTTCTTC	CASSQDLKPTRYEQFF	TRBV4-1	TRBJ2-1
TGTGCCAGCAGCTTTGTCTGCGCCCGAGCCCAGTACTTC	CASSFVCARAQYF	TRBV7-9	TRBJ2-4
TGTGCCCCCCAAGGGGGCCGGGGGGGACAAGAGACCCAGTACTTC	CAPQGGRGGQETQYF	TRBV11-2	TRBJ2-5
TGTGCCAGCAGTTTGGCGGGGACTAGCGGGGGGACGTCCCTTTGGGGCACAGATACGCAGTATTTT	CASSLAGTSGGTSLWGTDTQYF	TRBV27	TRBJ2-3
TGTGCCAGCAGCCGGGTGTCTGGGGCCAACGTCCTGACTTTC	CASSRVSGANVLTF	TRBV7-3	TRBJ2-6
TGTGCCAGCCCCGGGACGGGGCTGCAGTATTTT	CASPGTGLQYF	TRBV7-3	TRBJ2-3
TGTGCCAGCAGTTTTGAGACTAGCGGGGGTGGGGAGACCCAGTACTTC	CASSFETSGGGETQYF	TRBV27	TRBJ2-5
TGTGCCAGCAGCCAAGGTGAGAAAAAGGAGCCCCTAGAGACCCAGTACTTC	CASSQGEKKEPLETQYF	TRBV14	TRBJ2-5
TGTCTACATGCATTTCGGGGCAATCAGCCCCAGCATTTT	CLHAFRGNQPQHF	TRBV30	TRBJ1-5
TGCGCCAGCAGCTGGCCCTCCGGGACAGGGGGCTTAAGGTACTTC	CASSWPSGTGGLRYF	TRBV10-1	TRBJ2-7
TGTGCCAGCAATCCCGGGACCTCTGAAGCTTTCTTT	CASNPGTSEAFF	TRBV6-5	TRBJ1-1
TGCGCCAGCAGCCAAGGCAGGACAGGGGTTTTGAACACTGAAGCTTTCTTT	CASSQGRTGVLNTEAFF	TRBV4-1	TRBJ1-1
TGCGCCACCCGGCCTGAAGCTTTCTTT	CATRPEAFF	TRBV5-1	TRBJ1-1
TGTGCCACCAGCAGAGATCTGACGTTATCCAATAGCAATCAGCCCCAGCATTTT	CATSRDLTLSNSNQPQHF	TRBV15	TRBJ1-5
TGCGCCAGCAGTGAGTCGGGGGACGGTACGCAGTATTTT	CASSESGDGTQYF	TRBV10-1	TRBJ2-3
TGTGCCCGGGAATCGAGCGCCTACAATGAGCAGTTCTTC	CARESSAYNEQFF	TRBV10-3	TRBJ2-1
TGTGCCAGCAGTTATTTAGAGTTAGAAGCTTTCTTT	CASSYLELEAFF	TRBV6-3	TRBJ1-1
TGTGCCAGCAGTGACAAATTTCCCCCAGCTAATAGTAGAGGGAAAATCACCGGGGAGCTGTTTTTT	CASSDKFPPANSRGKITGELFF	TRBV6-4	TRBJ2-2
TGTGCCAGCAGCTTAGAGCTAGGGAGGGGGGCACTTCTGTATAGCAATCAGCCCCAGCATTTT	CASSLELGRGALLYSNQPQHF	TRBV11-2	TRBJ1-5
TGTGCCAGCTCGAACGAGAGGGGACATTTTAATGAGCAGTTCTTC	CASSNERGHFNEQFF	TRBV6-3	TRBJ2-1
TGTGCCACCAGTGTTGCAGTATATCGAGGGACAGGGGGGAATGGCTACACCTTC	CATSVAVYRGTGGNGYTF	TRBV24-1	TRBJ1-2
TGTGCCAGCAGCTTAGTAGCGGGACTCTACGAGCAGTACTTC	CASSLVAGLYEQYF	TRBV7-7	TRBJ2-7
TGTGCCAGCAGTTACCTCAGGGGGCCTGGCACAGATACGCAGTATTTT	CASSYLRGPGTDTQYF	TRBV6-5	TRBJ2-3
TGTGCCAGCAGCCCGTGGATCCGATCTCGGGGTACGAACACCGGGGAGCTGTTTTTT	CASSPWIRSRGTNTGELFF	TRBV7-3	TRBJ2-2
TGCAGTGCTAGATATAACCGGGCCCGGGGAATGCTCCCATCCTACGAGCAGTACTTC	CSARYNRARGMLPSYEQYF	TRBV20-1	TRBJ2-7
TGTGCCAGCAGCCAAGATAGGGCCTTGCGGGAAGAGACCCAGTACTTC	CASSQDRALREETQYF	TRBV3-1	TRBJ2-5
TGTGCCAGCAAACTCATAGGGGAGATCAATCAGCCCCAGCATTTT	CASKLIGEINQPQHF	TRBV9	TRBJ1-5
TGTGCCAGCTCACCCCCAGCGGACCCCGGGGAGCTGTTTTTT	CASSPPADPGELFF	TRBV18	TRBJ2-2
TGTGCCAGACTGTGGACCACTGAAGCTTTCTTT	CARLWTTEAFF	TRBV2	TRBJ1-1
TGTGCCAGCAGTGCCTTAGCGGGATCTGACTACGAGCAGTACTTC	CASSALAGSDYEQYF	TRBV6-5	TRBJ2-7
TGTGCCAGCATCCCCATGTCAGTGGTTTATGGCTACACCTTC	CASIPMSVVYGYTF	TRBV14	TRBJ1-2
TGTGCCAGCAGTTCTCGGGACAGTAACTATGGCTACACCTTC	CASSSRDSNYGYTF	TRBV27	TRBJ1-2
TGTGCCAGCAGCTTAGTCCTAGGGGGCCGTCGGGCCCAACACGACTACGAGCAGTACTTC	CASSLVLGGRRAQHDYEQYF	TRBV7-2	TRBJ2-7
TGCGCCAGCAGACCACACCGGGACGGTTACAATGAGCAGTTCTTC	CASRPHRDGYNEQFF	TRBV10-1	TRBJ2-1
TGTGCCAGCAGCTTAGGGGACAGAAATTTAGATGGCTACACCTTC	CASSLGDRNLDGYTF	TRBV7-2	TRBJ1-2
TGTGCCAGCAGCGGAGCCCTTAGACAGGGGCTATATCAGCCCCAGCATTTT	CASSGALRQGLYQPQHF	TRBV13	TRBJ1-5
TGTGAAGATGGGACAGGGCGGACTGAAGCTTTCTTT	CEDGTGRTEAFF	TRBV7-9	TRBJ1-1
TGTGCCAGCAGCCGGCCGCGGCCCTACGAGCAGTACTTC	CASSRPRPYEQYF	TRBV5-5	TRBJ2-7
TGTGCCAGCAGCTTGCGGGCGCCAAGGTCCTACGAGCAGTACTTC	CASSLRAPRSYEQYF	TRBV7-4	TRBJ2-7
TGTGCCAGCAGCTTAGGAGGAAGCGGGTGTCCCACAGATACGCAGTATTTT	CASSLGGSGCPTDTQYF	TRBV7-8	TRBJ2-3
TGTGCCAGCAGCAAACCGGGACATGGCTACGAGCAGTACTTC	CASSKPGHGYEQYF	TRBV7-3	TRBJ2-7
TGTGCCAGCAGCCGTATCCAACCGGCCCACAATGAGCAGTTCTTC	CASSRIQPAHNEQFF	TRBV5-5	TRBJ2-1
TGTGCCAGCAGCCAAATTATGGAGACCCAGTACTTC	CASSQIMETQYF	TRBV3-1	TRBJ2-5
TGTGCCAGCAGCCCGGGACAGGGAAATCAGCCCCAGCATTTT	CASSPGQGNQPQHF	TRBV3-1	TRBJ1-5
TGCGCCAGCAGCCATATAGCGGGGAGGTACAATGAGCAGTTCTTC	CASSHIAGRYNEQFF	TRBV4-1	TRBJ2-1
TGTGCCAGCAGCTTAGACCATCGCAGGGGAGATTGCACAGATACGCAGTATTTT	CASSLDHRRGDCTDTQYF	TRBV7-8	TRBJ2-3
TGTGCCAGCAGTTACAACCTAACCCCGGACATGAACACTGAAGCTTTCTTT	CASSYNLTPDMNTEAFF	TRBV6-6	TRBJ1-1
TGTGCCTGGAGTGTACTTGGACAGGGCCGACAAGAGACCCAGTACTTC	CAWSVLGQGRQETQYF	TRBV30	TRBJ2-5
TGTGCCAGCAGCTTTGGGGTGATAAGGGACTCCTACGAGCAGTACTTC	CASSFGVIRDSYEQYF	TRBV7-2	TRBJ2-7
TGCGCCAGCAATAAAGGGGGATATACTGAAGCTTTCTTT	CASNKGGYTEAFF	TRBV5-1	TRBJ1-1
TGTGCCAGCTTAGGCCGGGACAGGGGGCCCACGGCTGAAGCTTTCTTT	CASLGRDRGPTAEAFF	TRBV27	TRBJ1-1
TGCGCCAGCAGCAATATAGGAGGGCAATTCTACGAGCAGTACTTC	CASSNIGGQFYEQYF	TRBV5-1	TRBJ2-7
TGTGCCAGCAGCGATGGTTCTCAGGGTTTAGCGGCCACCGGGGAGCTGTTTTTT	CASSDGSQGLAATGELFF	TRBV13	TRBJ2-2
TGTGCCAGCAGTTTCCGCGCGGGAGCCTCCTCCTTGAACACTGAAGCTTTCTTT	CASSFRAGASSLNTEAFF	TRBV28	TRBJ1-1
TGTGCCAGCAGGACAGGGGGGGTGCAAGAGACCCAGTACTTC	CASRTGGVQETQYF	TRBV12-3	TRBJ2-5
TGTGCCAGCAAAAGACTCCTATCCTCCTACAATGAGCAGTTCTTC	CASKRLLSSYNEQFF	TRBV6-5	TRBJ2-1
TGTGCACCCCCTTCTCAGGGGGAAGAGCAGTACTTC	CAPPSQGEEQYF	TRBV3-1	TRBJ2-7
TGTGCCAGCCTCGATGACAGGGGGGAGAGCAATCAGCCCCAGCATTTT	CASLDDRGESNQPQHF	TRBV6-4	TRBJ1-5
TGTGCCAGCCAGCGGGACCCATTCACTGAAGCTTTCTTT	CASQRDPFTEAFF	TRBV6-6	TRBJ1-1
TGTGCCACCATGGTGACCCGACAGGGACGCTATGGCTACACCTTC	CATMVTRQGRYGYTF	TRBV24-1	TRBJ1-2
TGTGCCAGCAGTGAAGGAACTAGCGGCAGGATATACGAGCAGTACTTC	CASSEGTSGRIYEQYF	TRBV6-1	TRBJ2-7
TGTGCCAGCAGCGATCGGCGGAGGAATCAGCCCCAGCATTTT	CASSDRRRNQPQHF	TRBV7-3	TRBJ1-5
TGTGCCAGCAGCAAGTTTCCCGGACTCGGCTACACCTTC	CASSKFPGLGYTF	TRBV13	TRBJ1-2
TGCGCCAGCAGCCAAGACTGGGGGGGGGCCAACAATGAGCAGTTCTTC	CASSQDWGGANNEQFF	TRBV4-3	TRBJ2-1
TGTGCCAGCAGTTTCCTCGGGATAGAGCAGTTCTTC	CASSFLGIEQFF	TRBV28	TRBJ2-1
TGTGCCACCATTGGGGGGGGGGGGGATCATTCAAGCAAGTGGACTGAAGCTTTCTTT	CATIGGGGDHSSKWTEAFF	TRBV24-1	TRBJ1-1
TGTGCCAGCATCAACTCTGGAAACACCATATATTTT	CASINSGNTIYF	TRBV27	TRBJ1-3
TGTGCCAGTCCTGGAGGTAGTGCGGGATACGAGCAGTACTTC	CASPGGSAGYEQYF	TRBV19	TRBJ2-7
TGTGCCAGCAGCCAAGGGGCGGAGTGGTCCTACGAGCAGTACTTC	CASSQGAEWSYEQYF	TRBV3-1	TRBJ2-7
TGTGCCAGCATTGGGGGGGATGAGCAGTTCTTC	CASIGGDEQFF	TRBV5-6	TRBJ2-1
TGCGCCAGCAGTGAGTCTGAGTGCAGGACCACTGAAGCTTTCTTT	CASSESECRTTEAFF	TRBV10-1	TRBJ1-1
TGTGCCAGCAGTCGGGACCGGACTAGCGGGGGGGCCTCCTACAATGAGCAGTTCTTC	CASSRDRTSGGASYNEQFF	TRBV12-3	TRBJ2-1
TGTGCCAGCAGCTACTCCAGGGCTAGGTATGAGCAGTTCTTC	CASSYSRARYEQFF	TRBV11-2	TRBJ2-1
TGCAGCGACGGACAGGGGATGAACACTGAAGCTTTCTTT	CSDGQGMNTEAFF	TRBV29-1	TRBJ1-1
TGTGCCAGCAGACAGGGGGGGCCGGGGGGTTTGGGCTCCTACAATGAGCAGTTCTTC	CASRQGGPGGLGSYNEQFF	TRBV7-3	TRBJ2-1
TGTGCCAGCAGCTTAGTCAGGGGGCGGCATGAGCAGTTCTTC	CASSLVRGRHEQFF	TRBV7-4	TRBJ2-1
TGTGCCAGCAGCTTGAGGGGGGGCGCGGATACGCAGTATTTT	CASSLRGGADTQYF	TRBV11-3	TRBJ2-3
TGTGCCAGCAGCAAGAGCAATGAGCAGTTCTTC	CASSKSNEQFF	TRBV6-1	TRBJ2-1
TGTGCTAGGGTTGGGGCCAGCATTATTGGGACATCCTACAATGAGCAGTTCTTC	CARVGASIIGTSYNEQFF	TRBV12-5	TRBJ2-1
TGTGCCAGTTTCTGGCGGGAGGTAATTCGAGCCAAAAACATTCAGTACTTC	CASFWREVIRAKNIQYF	TRBV11-3	TRBJ2-4
TGCAGTAGGGAAGGGACACCGGGGCCCACAGATACGCAGTATTTT	CSREGTPGPTDTQYF	TRBV20-1	TRBJ2-3
TGTGCCAGCAGTAGAACGAGGGGGACGCACGCAGATACGCAGTATTTT	CASSRTRGTHADTQYF	TRBV2	TRBJ2-3
TGTGCCAGCAGCCCAGACATTAGACAGGGGAATACCACCGGGGAGCTGTTTTTT	CASSPDIRQGNTTGELFF	TRBV13	TRBJ2-2
TGTGCCAGCAGTTTGACTTCGGGGGGGCAAGAAGCTTTCTTT	CASSLTSGGQEAFF	TRBV28	TRBJ1-1
TGCGCCAGCAGCCAGGGTAACACTGAAGCTTTCTTT	CASSQGNTEAFF	TRBV5-1	TRBJ1-1
TGCAGTGCTAGAGGGGGACGTAGGCATTTT	CSARGGRRHF	TRBV20-1	TRBJ1-5
TGTGCCAGCAGGGGGGAGGGGAATTCCGCTTTCTTT	CASRGEGNSAFF	TRBV7-9	TRBJ1-1
TGTGCCAGCAGGCTAGGGCGACACTATGGCTACACCTTC	CASRLGRHYGYTF	TRBV12-4	TRBJ1-2
TGTGCCAGCAGCTCAATAGGCGGGCGCTCTGGAAACACCATATATTTT	CASSSIGGRSGNTIYF	TRBV7-2	TRBJ1-3
TGCAGTGCTTATGCGGCGACCACAGATACGCAGTATTTT	CSAYAATTDTQYF	TRBV20-1	TRBJ2-3
TGTGCCAGCAGCCCAGACAGCGGGGAGCTGTTTTTT	CASSPDSGELFF	TRBV5-4	TRBJ2-2
TGTGCCTGGAGGTGGACAGAGGGTTCACCCCTCCACTTT	CAWRWTEGSPLHF	TRBV30	TRBJ1-6
TGTGCCAGCAGCAACACGGGACGAGAGAGCTCCTACAATGAGCAGTTCTTC	CASSNTGRESSYNEQFF	TRBV7-9	TRBJ2-1
TGTGCCAGCAGCTTAGTATCCTGCGGGTACGAGCAGTACTTC	CASSLVSCGYEQYF	TRBV7-9	TRBJ2-7
TGCAGTGCTAGCCCTGGGACAGGCGGGGAGCTGTTTTTT	CSASPGTGGELFF	TRBV20-1	TRBJ2-2
TGTGCCACCAGTGATTCGGGGGCTGAAGCTTTCTTT	CATSDSGAEAFF	TRBV24-1	TRBJ1-1
TGCAGCCAAGCGAGGGAGGGGGGGCAGTACTTC	CSQAREGGQYF	TRBV29-1	TRBJ2-7
TGTGCCAGCAGCTCAGGGGCACCGAGAGGAACAAATCAGCCCCAGCATTTT	CASSSGAPRGTNQPQHF	TRBV7-2	TRBJ1-5
TGTGCCAGCAGCAAAAGAGGAGCGGGAGATACGCAGTATTTT	CASSKRGAGDTQYF	TRBV9	TRBJ2-3
TGTGCCAGCCAGGGGTGGAGCGAGCAGTACTTC	CASQGWSEQYF	TRBV6-1	TRBJ2-7
TGTGCCAGCAGCTTGGTGGGGGGACACAATCCCGGGGAGCTGTTTTTT	CASSLVGGHNPGELFF	TRBV11-3	TRBJ2-2
TGTGCCAGCAGCCAAGGGGGCGAGCAGTACTTC	CASSQGGEQYF	TRBV14	TRBJ2-7
TGCAGTGCCGGACTAGGCTACGAGCAGTACTTC	CSAGLGYEQYF	TRBV20-1	TRBJ2-7
TGCAGCGTCGAGGCGCGGAATACCGGGGAGCTGTTTTTT	CSVEARNTGELFF	TRBV29-1	TRBJ2-2
TGCAGTGCTAGGCTTACGGAGGGCAAGGCTATGGGGGCCAACGTCCTGACTTTC	CSARLTEGKAMGANVLTF	TRBV20-1	TRBJ2-6
TGTGCCAGCATACTGCGGGAGGGAACTGAAGCTTTCTTT	CASILREGTEAFF	TRBV13	TRBJ1-1
TGTGCCAGTAGTATCGGACAGGGAGTGAACACTGAAGCTTTCTTT	CASSIGQGVNTEAFF	TRBV19	TRBJ1-1
TGTGCCAGCAGTGAAATGCGTAACACTAACACTGAAGCTTTCTTT	CASSEMRNTNTEAFF	TRBV6-1	TRBJ1-1
TGTGCCAGCAGCTGGGGAGGTTGGCTCTCCTACAATGAGCAGTTCTTC	CASSWGGWLSYNEQFF	TRBV5-6	TRBJ2-1
TGCAGTGCTAGAGATCTCCGTCCGGGACAGGGAGGGGGGGTGAACACTGAAGCTTTCTTT	CSARDLRPGQGGGVNTEAFF	TRBV20-1	TRBJ1-1
TGCAGCGTTGCCAAGGGGGACATTACCGGGTCCTACGAGCAGTACTTC	CSVAKGDITGSYEQYF	TRBV29-1	TRBJ2-7
TGTGCCAGCAGTTTATCCGAGGGAGGTCATTGCTACGAGCAGTACTTC	CASSLSEGGHCYEQYF	TRBV12-4	TRBJ2-7
TGTGCCAGCAGTTTAGGAGACAGGGGTGTAGCCAAAAACATTCAGTACTTC	CASSLGDRGVAKNIQYF	TRBV28	TRBJ2-4
TGTGCCAGCAGCATGGGGAATTCACCCCTCCACTTT	CASSMGNSPLHF	TRBV5-8	TRBJ1-6
TGTGCCAGCTGGGGGGGCGAGACCCAGTACTTC	CASWGGETQYF	TRBV6-4	TRBJ2-5
TGCGCCAGCAGCCGGACAGTAGTCCCTAGCTCCTACGAGCAGTACTTC	CASSRTVVPSSYEQYF	TRBV4-1	TRBJ2-7
TGTGCCAGCAGTTTTACGACTGGAGGGAAAGAGACCCAGTACTTC	CASSFTTGGKETQYF	TRBV27	TRBJ2-5
TGTGCCAGCAGCCCAGGCAGGGGCCCCACAGATACGCAGTATTTT	CASSPGRGPTDTQYF	TRBV7-9	TRBJ2-3
TGTGCCAGCAGTACTACCAACAGGGATCAAAAAGAGACCCAGTACTTC	CASSTTNRDQKETQYF	TRBV6-1	TRBJ2-5
TGTGCCAGCAGTTTATGGGACTCATTGAATGAGCAGTTCTTC	CASSLWDSLNEQFF	TRBV27	TRBJ2-1
TGCAGTGCTTGGCAGCGGGATTTGCACTTC	CSAWQRDLHF	TRBV20-1	TRBJ2-7
TGTGCCACCAGTGATTCTTCACTGCAGACTGGCTACACCTTC	CATSDSSLQTGYTF	TRBV24-1	TRBJ1-2
TGTGCCAGCAGGGGAAAGAGGAACCGGGTTGAGCAGTTCTTC	CASRGKRNRVEQFF	TRBV6-2	TRBJ2-1
TGTGCCTGGAGACCAGGAAACTATGGCTACACCTTC	CAWRPGNYGYTF	TRBV30	TRBJ1-2
TGTGCCAGCAGTTTGTGTAGGGGACTAGCGGTTCGCCCGGAAGAGACCCAGTACTTC	CASSLCRGLAVRPEETQYF	TRBV12-3	TRBJ2-5
TGTGCCAGCAGCTCCCTGACCTACGAGCAGTACTTC	CASSSLTYEQYF	TRBV7-9	TRBJ2-7
TGCAGTGCTAGTATGGAGGGGAAGGAGCAGTTCTTC	CSASMEGKEQFF	TRBV20-1	TRBJ2-1
TGTGCCAGCAGGTGGGGGGGGAAGGAAGGGGGGAGGGATGGCTACACCTTC	CASRWGGKEGGRDGYTF	TRBV6-5	TRBJ1-2
TGTGCCAGCAGCGCAGAGCAGTACTTC	CASSAEQYF	TRBV2	TRBJ2-7
TGTGCCAGCAGTCCACTAGCGGGAGGGCCGCGACAGTACTTC	CASSPLAGGPRQYF	TRBV12-3	TRBJ2-5
TGTGCCAGCAGCTTAGCTCCAAAACTACCCGGCTACACCTTC	CASSLAPKLPGYTF	TRBV7-2	TRBJ1-2
TGTGCCAGCAGCATCACGGGAGTAACTGAGACCCAGTACTTC	CASSITGVTETQYF	TRBV2	TRBJ2-5
TGCGCCAGCAGTCCCAGGGGCCAAGGCGGGGAGCTGTTTTTT	CASSPRGQGGELFF	TRBV10-1	TRBJ2-2
TGTGCCAGCAGCTCAAAGAGGGGGCAACGTGAAGCTTTCTTT	CASSSKRGQREAFF	TRBV7-9	TRBJ1-1
TGTGCCAGCAGATGGACAGCGGAGAACACTGAAGCTTTCTTT	CASRWTAENTEAFF	TRBV6-6	TRBJ1-1
TGCAGCGTTCTCGGGGCAGCTTTTTACACTGAAGCTTTCTTT	CSVLGAAFYTEAFF	TRBV29-1	TRBJ1-1
TGTGCCAGCAGCTTCGGCATTAGCGGGAGGAGGGACGAGCAGTACTTC	CASSFGISGRRDEQYF	TRBV14	TRBJ2-7
TGTGCCAGTAGTATGGATCCCCCGGGACATAGGACCGGGGAGCTGTTTTTT	CASSMDPPGHRTGELFF	TRBV19	TRBJ2-2
TGTGCCAGCAGCGAGGGCGTGGACACCGGGGAGCTGTTTTTT	CASSEGVDTGELFF	TRBV7-3	TRBJ2-2
TGTGCCACTGAGAGCTATAATTCACCCCTCCACTTT	CATESYNSPLHF	TRBV19	TRBJ1-6
TGTGCCAGCAGTCATGCCTCACACAGGGACGCGAAGGATCAGCCCCAGCATTTT	CASSHASHRDAKDQPQHF	TRBV2	TRBJ1-5
TGTGCCAGCATAAGAAAGTCCGGACAGGCTCGGGGAGAGACCCAGTACTTC	CASIRKSGQARGETQYF	TRBV9	TRBJ2-5
TGTGCCAGCAGCAAAGTCGTGGGGGGCAGTATTAGTAAACCTGAAGCTTTCTTT	CASSKVVGGSISKPEAFF	TRBV13	TRBJ1-1
TGTGCCAGCAGCCGAGGGGGGACCGGCTGCACAGACGAGCAGTACTTC	CASSRGGTGCTDEQYF	TRBV7-3	TRBJ2-7
TGTGCCAGCAGCGGTGGACCTGGGAATGAAAAACTGTTTTTT	CASSGGPGNEKLFF	TRBV6-1	TRBJ1-4
TGTGCCAGCACCCGGGGAAGTAATTCACCCCTCCACTTT	CASTRGSNSPLHF	TRBV2	TRBJ1-6
TGCGCCAGCAGCTGGGGCACAGACTATGGCTACACCTTC	CASSWGTDYGYTF	TRBV5-1	TRBJ1-2
TGTGCCAGCAGTGACCCAGGACGGGGCGCTTACTATGGCTACACCTTC	CASSDPGRGAYYGYTF	TRBV6-4	TRBJ1-2
TGTGCTAGCAGCTTGTACCCTGAGGATGGACTAGCGGGCGGTAGCTCCTACGAGCAGTACTTC	CASSLYPEDGLAGGSSYEQYF	TRBV7-7	TRBJ2-7
TGTGCCAGCAGCCCGCGGATAACTGGGACAGGGTGGGGGTCTAATCAGCCCCAGCATTTT	CASSPRITGTGWGSNQPQHF	TRBV7-2	TRBJ1-5
TGTGCCAGCAGCTCCCATGTCCGTCCCAGGTTCAACGAGACCCAGTACTTC	CASSSHVRPRFNETQYF	TRBV5-4	TRBJ2-5
TGTGCCAGCAGTTACACTCACGGGGGGAGCGGGAGCTCTGAAGCTTTCTTT	CASSYTHGGSGSSEAFF	TRBV6-3	TRBJ1-1
TGTGCCAGCAGCAGTGGACAGGGGGCAATAGGCTATGGCTACACCTTC	CASSSGQGAIGYGYTF	TRBV5-6	TRBJ1-2
TGTGCCAGCAGCTTATCACGGGACAGGGAGGGCAGCAATCAGCCCCAGCATTTT	CASSLSRDREGSNQPQHF	TRBV11-3	TRBJ1-5
TGTGCCAGCCATTTCAAGGGCGAGCAGTACTTC	CASHFKGEQYF	TRBV5-4	TRBJ2-7
TGTGCCAGCAGCCAGGAGACGACCGACACCGGGGAGCTGTTTTTT	CASSQETTDTGELFF	TRBV3-1	TRBJ2-2
TGTGCCAGCAGCGGAACTAGCGGGAGATGGGGGGCCTACGAGCAGTACTTC	CASSGTSGRWGAYEQYF	TRBV7-9	TRBJ2-7
TGCAGTGCTATTTCCCCAGGGGGATTTAACTATGGCTACACCTTC	CSAISPGGFNYGYTF	TRBV20-1	TRBJ1-2
TGTGCCAGCAGCTTAGAGGAACCGGTGGGGGGGGCCCTAGTTAGCGGGTCCGGGGAGCTGTTTTTT	CASSLEEPVGGALVSGSGELFF	TRBV7-9	TRBJ2-2
TGTGCCAGTAAGCAGAGGAAAGCTGGAAACACCATATATTTT	CASKQRKAGNTIYF	TRBV6-4	TRBJ1-3
TGTGCCAGCAGCTTGGTCCTCCCCAGGGGATACAACACCATATATTTT	CASSLVLPRGYNTIYF	TRBV5-4	TRBJ1-3
TGTGCCAGCAGACCCCCCTCTAGCGGGGGATACGAGCAGTACTTC	CASRPPSSGGYEQYF	TRBV6-5	TRBJ2-7
TGTGCCAGAGGGGGGTTTCTGTCAGATACGCAGTATTTT	CARGGFLSDTQYF	TRBV27	TRBJ2-3
TGTGCCAGCGAACAGGGGGCAGGTAGCTCCTACAATGAGCAGTTCTTC	CASEQGAGSSYNEQFF	TRBV6-2	TRBJ2-1
TGTGCCATCAAAGTTGGGACAGGGCTATATGGCTACACCTTC	CAIKVGTGLYGYTF	TRBV10-3	TRBJ1-2
TGTGCCAGCAGTTTATCGCTGGGGGGGCGAACAGATACGCAGTATTTT	CASSLSLGGRTDTQYF	TRBV27	TRBJ2-3
TGTGCCAGCAGCCGGCTTGGGGTTTATGGGAACACTGAAGCTTTCTTT	CASSRLGVYGNTEAFF	TRBV13	TRBJ1-1
TGTGCCAGCAGCGGCCACACATCCGGCTACACCTTC	CASSGHTSGYTF	TRBV27	TRBJ1-2
TGTGCCAGCAGCCCCTATTCTCCGCTCGTATCAGTTTCACCCCTCCACTTT	CASSPYSPLVSVSPLHF	TRBV13	TRBJ1-6
TGTGCCAGCTTGAGTCGGGGAAGGGTTGGTTTTGAAGCTTTCTTT	CASLSRGRVGFEAFF	TRBV27	TRBJ1-1
TGCAGTGCTGCGAGGACTATGGGGTTGACAGATACGCAGTATTTT	CSAARTMGLTDTQYF	TRBV20-1	TRBJ2-3
TGCGCCAGCAGCCAAGATTGGGGAAGGAAAGGCTTTGGCTACACCTTC	CASSQDWGRKGFGYTF	TRBV4-1	TRBJ1-2
TGCGCCAGCTATGTAAGGGACAGGGGGCGGACCACCGAGGAGACCCAGTACTTC	CASYVRDRGRTTEETQYF	TRBV5-1	TRBJ2-5
TGTGCCAGCACGAACATCATGGGTTACAGCGCGGGAGAAGGAAACACCATATATTTT	CASTNIMGYSAGEGNTIYF	TRBV11-3	TRBJ1-3
TGTGCCAGCAGTGGCAGCTTTATAGGCTACACCTTC	CASSGSFIGYTF	TRBV27	TRBJ1-2
TGTGCCAGCAGTTACAGGGGGTTCGTGGACTATGGCTACACCTTC	CASSYRGFVDYGYTF	TRBV6-5	TRBJ1-2
TGTGCCAGCAGCTCCACAAGACCAGCCTGGTTCTATAATTCACCCCTCCACTTT	CASSSTRPAWFYNSPLHF	TRBV5-4	TRBJ1-6
TGTGCCAGCAGCTGGAACCCTAGCGAGCAGTACTTC	CASSWNPSEQYF	TRBV7-9	TRBJ2-7
TGTGCCAGCAGCGGCTATAGCAATCAGCCCCAGCATTTT	CASSGYSNQPQHF	TRBV5-6	TRBJ1-5
TGTGCCAGCAGCGTAGGCGGGCGACTAGCGGGTACAGATACGCAGTATTTT	CASSVGGRLAGTDTQYF	TRBV9	TRBJ2-3
TGTGCCAGCATACCCCGGGACATCATAGACACCGGGGAGCTGTTTTTT	CASIPRDIIDTGELFF	TRBV12-3	TRBJ2-2
TGTGCCATCAGTGAGTCGCACCCAGCGGGACAAACGGCCAGAAGGAAGAAAGTTCAGCCCCAGCATTTT	CAISESHPAGQTARRKKVQPQHF	TRBV10-3	TRBJ1-5
TGTGCCAGCAGCTATACAGCTTTAGAGACCCAGTACTTC	CASSYTALETQYF	TRBV7-2	TRBJ2-5
TGCGCCAGCAGTGTGGGGGCCTACGAGCAGTACTTC	CASSVGAYEQYF	TRBV10-1	TRBJ2-7
TGTGCCAGCAGCTTAGATGGTAGAGGTCTACTCTCCTACGAGCAGTACTTC	CASSLDGRGLLSYEQYF	TRBV11-2	TRBJ2-7
TGTGCCAGCAGCCCAAAGGGGGGCTACACCTTC	CASSPKGGYTF	TRBV7-8	TRBJ1-2
TGTGCCAGCAGTTCGACCCGGGGAGTCTTAGGATATCAGCCCCAGCATTTT	CASSSTRGVLGYQPQHF	TRBV6-3	TRBJ1-5
TGTGCCAGCAGTGACCCCAAAGGGGGACAGGCCGAGCAGTACTTC	CASSDPKGGQAEQYF	TRBV2	TRBJ2-7
TGTGCCAGCAGTTACCTCGGGGGACAGGGAAGGGGACGGTATAATTCACCCCTCCACTTT	CASSYLGGQGRGRYNSPLHF	TRBV6-5	TRBJ1-6
TGTGCCAGCAAGGGAGTAGGCACAGATACGCAGTATTTT	CASKGVGTDTQYF	TRBV27	TRBJ2-3
TGTGCCAGCAGGGCTCAGCGGGATCAGCCCCAGCATTTT	CASRAQRDQPQHF	TRBV7-9	TRBJ1-5
TGTGCCAGCAGTGAAGAAGCCCAGGGGCGGCAGAACACTGAAGCTTTCTTT	CASSEEAQGRQNTEAFF	TRBV25-1	TRBJ1-1
TGTGCCAGCTGGGACCGTCAGCCCCAGCATTTT	CASWDRQPQHF	TRBV7-9	TRBJ1-5
TGTGCCAGTAGCATTATATTAGCCTACGAGCAGTACTTC	CASSIILAYEQYF	TRBV19	TRBJ2-7
TGTGCCAGCAGTGACCTCCTTCAGCCTGGAGAAGCTTTCTTT	CASSDLLQPGEAFF	TRBV25-1	TRBJ1-1
TGTGCCACCACCCGACACACCGGGGAGCTGTTTTTT	CATTRHTGELFF	TRBV24-1	TRBJ2-2
TGTGCCACGTACCGACAGGGATGGGGGAATTATGGCTACACCTTC	CATYRQGWGNYGYTF	TRBV12-4	TRBJ1-2
TGTGCCAGCAACGGACTAGCGGGCTTAGGGCAAGAGACCCAGTACTTC	CASNGLAGLGQETQYF	TRBV25-1	TRBJ2-5
TGTGCCAGTACTGTCCTAGGGAACACTGAAGCTTTCTTT	CASTVLGNTEAFF	TRBV9	TRBJ1-1
TGTGCCAGCTCACCACAGGCCGGGCCAGACCTAAAAAACATTCAGTACTTC	CASSPQAGPDLKNIQYF	TRBV18	TRBJ2-4
TGTGCTAAGAGATATCAGCCCCAGCATTTT	CAKRYQPQHF	TRBV7-7	TRBJ1-5
TGTGTGTTAGCCGACACTGAAGCTTTCTTT	CVLADTEAFF	TRBV3-1	TRBJ1-1
TGTGCCAGCATGGTACCGGGCGGGAGGGGAGATGAATACTACGAGCAGTACTTC	CASMVPGGRGDEYYEQYF	TRBV9	TRBJ2-7
TGCAGTGCGAACCCGAATGGAAACACCGGGGAGCTGTTTTTT	CSANPNGNTGELFF	TRBV20-1	TRBJ2-2
TGTGCCAGCAGCCTCAAAGGGCAGGGGGGACAAGATGAAGCTTTCTTT	CASSLKGQGGQDEAFF	TRBV6-6	TRBJ1-1
TGTGCCAGCAGCTGTGGACAGGTGGGCAATGAGCAGTTCTTC	CASSCGQVGNEQFF	TRBV7-8	TRBJ2-1
TGTGCCAGCACAGGGGGTTCACTGTTTTGGGTGAACACCGGGGAGCTGTTTTTT	CASTGGSLFWVNTGELFF	TRBV24-1	TRBJ2-2
TGTGCCAGCCATAGGGCTAATGAAAAACTGTTTTTT	CASHRANEKLFF	TRBV7-9	TRBJ1-4
TGCGCCAGCAGCCAAGTCACCATAACTGTAGATTCACCCCTCCACTTT	CASSQVTITVDSPLHF	TRBV4-3	TRBJ1-6
TGTGCCAGCAGCTTAGGCCACGGGGAGGGGCTATTTCCCGAGACCCAGTACTTC	CASSLGHGEGLFPETQYF	TRBV7-2	TRBJ2-5
TGCGCCAGCGGACAGATCAGACGGGAGCTGTTTTTT	CASGQIRRELFF	TRBV4-3	TRBJ2-2
TGTGCCAGCAGCAGGGACGCTTTCTTT	CASSRDAFF	TRBV11-3	TRBJ1-1
TGTGCCAGCAGCGACCCAAGTATTTGTTTCGGCGGACACGAGACCCAGTACTTC	CASSDPSICFGGHETQYF	TRBV13	TRBJ2-5
TGCGCCAGCACAGGGATAGATTCACCCCTCCACTTT	CASTGIDSPLHF	TRBV10-1	TRBJ1-6
TGTGCCAGTAAGCCCCAGGGTAGCAATCAGCCCCAGCATTTT	CASKPQGSNQPQHF	TRBV19	TRBJ1-5
TGTGCCAGCAGTGAAGACCGATTCAGTACTAGCAATCAGCCCCAGCATTTT	CASSEDRFSTSNQPQHF	TRBV2	TRBJ1-5
TGCGCCAGCAGCCCATGTTATTTGCTAGCGGGTAAGAGACCTAGCACAGATACGCAGTATTTT	CASSPCYLLAGKRPSTDTQYF	TRBV4-3	TRBJ2-3
TGTGCCAGCAGCTTAGGGCAGGGGACGGGTATGGAGGGCTACACCTTC	CASSLGQGTGMEGYTF	TRBV11-2	TRBJ1-2
TGTGCCAGCAGCTTCCATGGACAGGGGTGGGGAAACACCATATATTTT	CASSFHGQGWGNTIYF	TRBV7-7	TRBJ1-3
TGTGCCACCAGTGATAACTCGATCGGACAGGTGTCCTCCTACGAGCAGTACTTC	CATSDNSIGQVSSYEQYF	TRBV24-1	TRBJ2-7
TGTGCCATCAGAACAGGTCTCTTAGAGACCCAGTACTTC	CAIRTGLLETQYF	TRBV10-3	TRBJ2-5
TGTGCCACCAGTGAGGCCACAGGACTTAGGGCTGGGGGCTACACCTTC	CATSEATGLRAGGYTF	TRBV24-1	TRBJ1-2
TGTGCCAGCAGTGGAGGAGGGAACGAGCAGTACTTC	CASSGGGNEQYF	TRBV12-4	TRBJ2-7
TGCAGCGCCTTGAACGGGACACAAAACATTCAGTACTTC	CSALNGTQNIQYF	TRBV29-1	TRBJ2-4
TGTGCCAGCAGCTTTACTAGGACAGGGCCGAGCTACGAGCAGTACTTC	CASSFTRTGPSYEQYF	TRBV5-5	TRBJ2-7
TGCAGTGCTAGTCCACCGGGACTAGCGGGAAACAGTCCCTACGAGCAGTACTTC	CSASPPGLAGNSPYEQYF	TRBV20-1	TRBJ2-7
TGTGCCAGCAGCTTGGGGACCAACGAGCAGTACTTC	CASSLGTNEQYF	TRBV11-2	TRBJ2-7
TGTGCCAGCAGTCCCGGGACTAGCGGGTCCTACAATGAGCAGTTCTTC	CASSPGTSGSYNEQFF	TRBV12-3	TRBJ2-1
TGTGCCAGCAGCTTAGGACCGTCCAGCCGGAGGTCGGGCTTCGACTATGGCTACACCTTC	CASSLGPSSRRSGFDYGYTF	TRBV7-7	TRBJ1-2
TGTGCCAGCAGTTGGGAACCCCCCGGGACTAGCGGGAGTCGCTTAGCCAAAAACATTCAGTACTTC	CASSWEPPGTSGSRLAKNIQYF	TRBV6-5	TRBJ2-4
TGTGCCAGCAGCCCGGACAGGGGACCCACTGAAGCTTTCTTT	CASSPDRGPTEAFF	TRBV5-4	TRBJ1-1
TGCGCCAGCAGCTTGGCGCACTACGAGCAGTACTTC	CASSLAHYEQYF	TRBV5-1	TRBJ2-7
TGTGCCTGGCGAAGGACTAGGGGGGATACGCAGTATTTT	CAWRRTRGDTQYF	TRBV30	TRBJ2-3
TGTGCCAGCAGCAGACCCCGGGACATCCCCCAGCATTTT	CASSRPRDIPQHF	TRBV5-6	TRBJ1-5
TGTGCCAGCAGTCGTCCGAGGCCGGGACAGGGTGAAAAACTGTTTTTT	CASSRPRPGQGEKLFF	TRBV6-4	TRBJ1-4
TGTGCCGGGGGCACTGAAGCTTTCTTT	CAGGTEAFF	TRBV19	TRBJ1-1
TGTGCCAGCAGCCAGGGACAGGACTCGGGAACTAATGAAAAACTGTTTTTT	CASSQGQDSGTNEKLFF	TRBV7-9	TRBJ1-4
TGTGCCAGCCCTCGGCTATACGAGCAGTACTTC	CASPRLYEQYF	TRBV6-2	TRBJ2-7
TGTGCCAGCAGTTATCGAGGGGGCCAGGGCAGAGGGGAAGAGACCCAGTACTTC	CASSYRGGQGRGEETQYF	TRBV6-3	TRBJ2-5
TGTGCCAGCAGCTTCGGTGAAGAGACCCAGTACTTC	CASSFGEETQYF	TRBV7-2	TRBJ2-5
TGTGCCAGCAGCTTAAGGGGGGAGATGAACACTGAAGCTTTCTTT	CASSLRGEMNTEAFF	TRBV7-9	TRBJ1-1
TGCGCCAGCAGCTCGGGGGGGTCCCAAAATCAGCCCCAGCATTTT	CASSSGGSQNQPQHF	TRBV5-1	TRBJ1-5
TGTGCCAGCAGTGAAGTAGAAAGGGCGTACGAGCAGTACTTC	CASSEVERAYEQYF	TRBV6-4	TRBJ2-7
TGTGCCACCAGCGAGCTAGCGGGGCTTTTCCCCTACGAGCAGTACTTC	CATSELAGLFPYEQYF	TRBV15	TRBJ2-7
TGCGCCAGCAGCCAAGGGGGGCAAGAAAAACTGTTTTTT	CASSQGGQEKLFF	TRBV4-1	TRBJ1-4
TGTGCCAATCCCCCACTTTGGGCCAGGACCGGGGAGCTGTTTTTT	CANPPLWARTGELFF	TRBV11-3	TRBJ2-2
TGCGCCAGCAGCCAAGCGTCCGGGAGGACAGGGGGATCTCATAGGACTGAAGCTTTCTTT	CASSQASGRTGGSHRTEAFF	TRBV4-1	TRBJ1-1
TGCGCCAGCATGGGAGCCATTCACAGGGAGACGAACACTGAAGCTTTCTTT	CASMGAIHRETNTEAFF	TRBV5-1	TRBJ1-1
TGTGCCAGCAGGCCCCTCCCCTCCGGGACAGGGGGCAATCAGCCCCAGCATTTT	CASRPLPSGTGGNQPQHF	TRBV11-2	TRBJ1-5
TGTGCCAGCTCTAGCACAGGGATGAACACTGAAGCTTTCTTT	CASSSTGMNTEAFF	TRBV18	TRBJ1-1
TGTGCCAGCAGCGTAGGGACCGTTTGCTACGAGCAGTACTTC	CASSVGTVCYEQYF	TRBV9	TRBJ2-7
TGTGCCAGCAGCGTAGCCCACACCGGACAGGGTCTATTCCTCTGCGATGAGCAGTTCTTC	CASSVAHTGQGLFLCDEQFF	TRBV9	TRBJ2-1
TGTGCCAGCAGCATGTCACAGCTGGTACTTCCTGGAAACACCATATATTTT	CASSMSQLVLPGNTIYF	TRBV11-2	TRBJ1-3
TGTGCCAAGAGGGGGCGGGGGGACAATGAAAAACTGTTTTTT	CAKRGRGDNEKLFF	TRBV12-4	TRBJ1-4
TGTGCCAGCAGTTTGAGATCAACGGAGCAGTACTTC	CASSLRSTEQYF	TRBV12-4	TRBJ2-7
TGTGCCAGCAGTAGAAGGACAGGACCGTCAACTAATGAAAAACTGTTTTTT	CASSRRTGPSTNEKLFF	TRBV6-1	TRBJ1-4
TGTGCATGGGACAGGGCCGAACTGTTTTTT	CAWDRAELFF	TRBV2	TRBJ1-4
TGTGCCTGGAGCGCCAAAGGGGGGTATTATCAGCCCCAGCATTTT	CAWSAKGGYYQPQHF	TRBV30	TRBJ1-5
TGTGCCAGCAGCTTCCCCCGTCAGGGTTACTATGGCTACACCTTC	CASSFPRQGYYGYTF	TRBV11-2	TRBJ1-2
TGTGCCAGCAGCAACTCCGTCGGGAACACTGAAGCTTTCTTT	CASSNSVGNTEAFF	TRBV13	TRBJ1-1
TGTGCCAGCAGCCAAGCCTTCGGGGGTTTACAAGAGACCCAGTACTTC	CASSQAFGGLQETQYF	TRBV3-1	TRBJ2-5
TGTGCCAGCAGTGACATTGACTGGAGGCAGTACTTC	CASSDIDWRQYF	TRBV6-3	TRBJ2-4
TGTGCCAGCGGTCTAGCGGGGATATCTCATGAGCAGTTCTTC	CASGLAGISHEQFF	TRBV2	TRBJ2-1
TGTGCCAGCAGTGAAGCGCTTGACCCCGGGTCGCAGGACACAGATACGCAGTATTTT	CASSEALDPGSQDTDTQYF	TRBV2	TRBJ2-3
TGTGCCAGCAGCAAAATTTCCGGGACAGAGTGTGCCCATGGCTACACCTTC	CASSKISGTECAHGYTF	TRBV14	TRBJ1-2
TGTGCCAGCAGCCAAGGTTGGACAGAAGGTAATGGCTACACCTTC	CASSQGWTEGNGYTF	TRBV4-2	TRBJ1-2
TGCAGTGCTAGTCACCCCCCACAGGGTGGGAACACTGAAGCTTTCTTT	CSASHPPQGGNTEAFF	TRBV20-1	TRBJ1-1
TGTGCCAGCAGCCAGGGGAGCGGTACCGGGGAGCTGTTTTTT	CASSQGSGTGELFF	TRBV14	TRBJ2-2
TGTGCCGGAAGACAGGGGGCTGGGGGCCAAGACACTGAAGCTTTCTTT	CAGRQGAGGQDTEAFF	TRBV24-1	TRBJ1-1
TGTGCCAGCAGGGGTACTAGCGGGCCCACAGATACGCAGTATTTT	CASRGTSGPTDTQYF	TRBV6-2	TRBJ2-3
TGTGCCAGCAGCCAAGATGACATTTCCCCCTACGAGCAGTACTTC	CASSQDDISPYEQYF	TRBV14	TRBJ2-7
TGCGCCCGTATTACCGGACAGGGCCGTCTAGCCAAAAACATTCAGTACTTC	CARITGQGRLAKNIQYF	TRBV10-1	TRBJ2-4
TGTGCCAGCAGCGGACGGACCTTCGCCTATAGCAATCAGCCCCAGCATTTT	CASSGRTFAYSNQPQHF	TRBV28	TRBJ1-5
TGCGCCAGCAGCGGGGCTTTGGCTACTAATGAAAAACTGTTTTTT	CASSGALATNEKLFF	TRBV5-1	TRBJ1-4
TGCGCCAGCAGAAAGGGCCGGAGGTATAGCAATCAGCCCCAGCATTTT	CASRKGRRYSNQPQHF	TRBV10-1	TRBJ1-5
TGTGCCAGCAGCTTAGATAGGCAATCGGACTCCTACGAGCAGTACTTC	CASSLDRQSDSYEQYF	TRBV11-2	TRBJ2-7
TGTGCCAGTAGTTCCCGCTCCTACGAGCAGTACTTC	CASSSRSYEQYF	TRBV19	TRBJ2-7
TGTGCCACCAGCAGGAGGGGCAGCTATTCACCCCTCCACTTT	CATSRRGSYSPLHF	TRBV15	TRBJ1-6
TGTGCCAGCAGTTGCAGTCTTCCAGGTGAAAAACTGTTTTTT	CASSCSLPGEKLFF	TRBV12-3	TRBJ1-4
TGTGCCAGCAGTTTAAGCATCAGGACAGTTAGCCTTCCGGCCTATAATTCACCCCTCCACTTT	CASSLSIRTVSLPAYNSPLHF	TRBV12-4	TRBJ1-6
TGTGCCACCAGCAGCCGTAAAGGACAGGGAAACACCATATATTTT	CATSSRKGQGNTIYF	TRBV15	TRBJ1-3
TGCGCCAGCAGTGTAGGACGTTGCTCGGAGACCCAGTACTTC	CASSVGRCSETQYF	TRBV10-1	TRBJ2-5
TGTGCCAGCAGTATGACAGAATACACCTTC	CASSMTEYTF	TRBV6-5	TRBJ1-2
TGCAGTGCCAATCCGGGACGCGAATACTATGGCTACACCTTC	CSANPGREYYGYTF	TRBV20-1	TRBJ1-2
TGTGCCAGCATCCCTGGGGGCTACGAGCAGTACTTC	CASIPGGYEQYF	TRBV12-3	TRBJ2-7
TGTGCCAGCAGCCAAGATCGACAGGGGAACACTGAAGCTTTCTTT	CASSQDRQGNTEAFF	TRBV4-2	TRBJ1-1
TGCGCCAGCAGTACAGGGGGCGCACCCACTTCCTCCTACGAGCAGTACTTC	CASSTGGAPTSSYEQYF	TRBV10-2	TRBJ2-7
TGTGCCTGGAGTGCCAGGGACAGGGGCGCCTTGGGCTACACCTTC	CAWSARDRGALGYTF	TRBV30	TRBJ1-2
TGTGCCAGCTCACCACCGGGTCCTGGGGACAGTCCCCAGCATTTT	CASSPPGPGDSPQHF	TRBV18	TRBJ1-5
TGTGCCAGCAGCCGAGGGCATGAGCAGTTCTTC	CASSRGHEQFF	TRBV7-8	TRBJ2-1
TGTGCCACCAGCAGGGGGCGCCGCTATGGCTACACCTTC	CATSRGRRYGYTF	TRBV24-1	TRBJ1-2
TGTGCCACCACTAGACAGGGGAATGGGGCCAACGTCCTGACTTTC	CATTRQGNGANVLTF	TRBV24-1	TRBJ2-6
TGCAGTGCCCACGGGGACAGGGGGCGGAGCAATCAGCCCCAGCATTTT	CSAHGDRGRSNQPQHF	TRBV20-1	TRBJ1-5
TGTGCCAGCAGTAGGGGGGGGAATACGCAGTATTTT	CASSRGGNTQYF	TRBV27	TRBJ2-3
TGTGCCAGCAGCTTGAAGGACAGAGGCGCAGAGACCCAGTACTTC	CASSLKDRGAETQYF	TRBV5-5	TRBJ2-5
TGTGCCAGCAGCTCGCAAGATTACCGGGACAGGGATCAGCCCCAGCATTTT	CASSSQDYRDRDQPQHF	TRBV13	TRBJ1-5
TGTGCCAGCAGGGAGGGACTAGCGGGACTTGACTGCTCCTACAATGAGCAGTTCTTC	CASREGLAGLDCSYNEQFF	TRBV28	TRBJ2-1
TGTGCCAGCAGCACTAGCGGGAGGGCCCCTAGCACAGATACGCAGTATTTT	CASSTSGRAPSTDTQYF	TRBV11-3	TRBJ2-3
TGTGCCAGCAGCAGCCGGACAGGGGGACACGGCAATCAGCCCCAGCATTTT	CASSSRTGGHGNQPQHF	TRBV7-2	TRBJ1-5
TGTGCCAGCAGTCGCTGTCGGAGAGGTAATGAGCAGTTCTTC	CASSRCRRGNEQFF	TRBV6-8	TRBJ2-1
TGCAGTGCTTCCCCAACTAGCACAGAGACCCAGTACTTC	CSASPTSTETQYF	TRBV20-1	TRBJ2-5
TGTGCCACCAGTGACACGAAGGGGCAGTACTTC	CATSDTKGQYF	TRBV24-1	TRBJ2-7
TGTGCCAGCAGTTGTGGCGGGGTGGATGAGCAGTTCTTC	CASSCGGVDEQFF	TRBV6-5	TRBJ2-1
TGTGCCAGCAGCTCCTGGCAAGTTGGGCCTAATGAAAAACTGTTTTTT	CASSSWQVGPNEKLFF	TRBV11-3	TRBJ1-4
TGTGCCAGGGGGGAAAGGGTTAGCAATCAGCCCCAGCATTTT	CARGERVSNQPQHF	TRBV2	TRBJ1-5
TGCAGTGCGGACACCATTGACAGGAGGCAAGAGACCCAGTACTTC	CSADTIDRRQETQYF	TRBV20-1	TRBJ2-5
TGCGCCAGGAGAGGGACAGGCTCCTACGAGCAGTACTTC	CARRGTGSYEQYF	TRBV5-1	TRBJ2-7
TGTGCCAGCAGTTTATCAAGGGGAGCCTACGAGCAGTACTTC	CASSLSRGAYEQYF	TRBV27	TRBJ2-7
TGCAGTGCCACCTCATACCAAGAGACCCAGTACTTC	CSATSYQETQYF	TRBV20-1	TRBJ2-5
TGTGCCAGCAGCTTGGGACGCGGACAGGGAAACACCGGGGAGCTGTTTTTT	CASSLGRGQGNTGELFF	TRBV7-4	TRBJ2-2
TGCAGCGTTGAAGTTGCAAGGACTAGCGGGGGGTATGAGCAGTTCTTC	CSVEVARTSGGYEQFF	TRBV29-1	TRBJ2-1
TGTGCCAGCAGCACTGCCGGGGCTTATGGCTACACCTTC	CASSTAGAYGYTF	TRBV11-2	TRBJ1-2
TGTGCCAGCAGCCAAGTGACAGAGGAAGTCTGGGGCGAGCAGTACTTC	CASSQVTEEVWGEQYF	TRBV14	TRBJ2-7
TGCGCCAGCCCGGTAGAGAATCAGCCCCAGCATTTT	CASPVENQPQHF	TRBV10-1	TRBJ1-5
TGCGCCAGCAGTGAGTCGGGGTATACGGACCATGAGCAGTTCTTC	CASSESGYTDHEQFF	TRBV10-2	TRBJ2-1
TGTGCCAGCAGCTTAGGCCACGGGACAGGGGGCCTAGATGGCTACACCTTC	CASSLGHGTGGLDGYTF	TRBV7-4	TRBJ1-2
TGTGCCAGCAGTGAGGGGGAGCAGTTCTTC	CASSEGEQFF	TRBV6-5	TRBJ2-1
TGTGCCAGCAGTCAGGTATGGAGCCGGGACAGGGCGGGAAATCGGGATGAGCAGTTCTTC	CASSQVWSRDRAGNRDEQFF	TRBV27	TRBJ2-1
TGTGCCAGCAGGCCGGGACAGACCCACACTGAAGCTTTCTTT	CASRPGQTHTEAFF	TRBV6-4	TRBJ1-1
TGCAGTGCTAGAGATTGTTTAGTTGACTTC	CSARDCLVDF	TRBV20-1	TRBJ2-7
TGTGCCAGCAGCGAGGTATCTCTTAGAACACCCCTCCACTTT	CASSEVSLRTPLHF	TRBV9	TRBJ1-6
TGTGCCAGCAGCACAGGGGGCCCCGGGATGTGTGGCTACACCTTC	CASSTGGPGMCGYTF	TRBV13	TRBJ1-2
TGTGCCAGCCGGACACCACTAGCGAGATACGAGCAGTACTTC	CASRTPLARYEQYF	TRBV27	TRBJ2-7
TGTGCCAGCAGTTATTCACTGGTGGGACAGACCGGGGAGCTGTTTTTT	CASSYSLVGQTGELFF	TRBV6-9	TRBJ2-2
TGTGCCAGCAGCTTAGGAGACAGGGGGCCTTACGGCAATCAGCCCCAGCATTTT	CASSLGDRGPYGNQPQHF	TRBV11-3	TRBJ1-5
TGCGCCTTTACGGTCTCTCGCAGGGGGGTGGACTCTGGGGCCAACGTCCTGACTTTC	CAFTVSRRGVDSGANVLTF	TRBV10-2	TRBJ2-6
TGTGCCAGCGGAGGTTTCGACCCTGAGCAGTTCTTC	CASGGFDPEQFF	TRBV27	TRBJ2-1
TGCAGTGCTCCGCATCGGGGGTGGCAAGAGACCCAGTACTTC	CSAPHRGWQETQYF	TRBV20-1	TRBJ2-5
TGTGCCAGCAGCCGTCAGAGGGGGTGGACCCAGTACTTC	CASSRQRGWTQYF	TRBV7-3	TRBJ2-5
TGTGCCACCAGTGATCTACCCAGACAGGGGGGCAACACTGAAGCTTTCTTT	CATSDLPRQGGNTEAFF	TRBV24-1	TRBJ1-1
TGCGCCAGCAGTGACGGGGGTAGGACAGTTACTGGGGCCAACGTCCTGACTTTC	CASSDGGRTVTGANVLTF	TRBV10-1	TRBJ2-6
TGCAGTGCTAGAGTTGGGACTAGCGGTTTTATAGAGACCCAGTACTTC	CSARVGTSGFIETQYF	TRBV20-1	TRBJ2-5
TGTGCCAGCAGTTTTGCAGGGGACCGGGACGAGCAGTACTTC	CASSFAGDRDEQYF	TRBV28	TRBJ2-7
TGCGCCAGCAGCTTGGGCTTATCCCTCGGGACCGAAAAACTGTTTTTT	CASSLGLSLGTEKLFF	TRBV5-1	TRBJ1-4
TGTGCCAGCATCCCTAGCGGGGTTGGAAGCTCCTACAATGAGCAGTTCTTC	CASIPSGVGSSYNEQFF	TRBV6-5	TRBJ2-1
TGTGCCAGCATCCTCCGGTCTTTGGGCCGACGCTATGGCTACACCTTC	CASILRSLGRRYGYTF	TRBV7-9	TRBJ1-2
TGCGCCAGCAGCGCGACAGGGTCGCCGGGTGGGGCCAACGTCCTGACTTTC	CASSATGSPGGANVLTF	TRBV5-1	TRBJ2-6
TGTGCCAGCCCTATGGGGCCCACCTACGAGCAGTACTTC	CASPMGPTYEQYF	TRBV27	TRBJ2-7
TGCGCCAGCAGCCAAGATTACCCAGTCGCCTACGAGCAGTACTTC	CASSQDYPVAYEQYF	TRBV4-1	TRBJ2-7
TGCGCCAGCAGCTTGCTTCCTCCGGGACAGGGTGGCTCCTCGTCCTACAATGAGCAGTTCTTC	CASSLLPPGQGGSSSYNEQFF	TRBV5-1	TRBJ2-1
TGCGCCAGCAGCCAAGAAGCCGCAGGTCAGCCCCAGCATTTT	CASSQEAAGQPQHF	TRBV4-1	TRBJ1-5
TGTGCCAGCAGTGAAGCCGGGGGGGACGGGGAGCTGTTTTTT	CASSEAGGDGELFF	TRBV6-1	TRBJ2-2
TGTGCCATCATAATCTCCGGGGCTTGTGCCGCGCATTTT	CAIIISGACAAHF	TRBV10-3	TRBJ1-5
TGTGCCAGCAGCTCCCCCGACCAGGGAGGGGGAAACACCATATATTTT	CASSSPDQGGGNTIYF	TRBV7-3	TRBJ1-3
TGTGCCACCGGGGGCTCTAGCACAGATACGCAGTATTTT	CATGGSSTDTQYF	TRBV19	TRBJ2-3
TGTGCCAGCAGACTCCTCCGGCGGGGGGCTGAAGATACGCAGTATTTT	CASRLLRRGAEDTQYF	TRBV7-2	TRBJ2-3
TGCGCCAGCAGTGGACAGAGGCTATGCTCCTACGAGCAGTACTTC	CASSGQRLCSYEQYF	TRBV10-1	TRBJ2-7
TGTGCCAGCAGCAGTCGTCCGCTTGGGGGCTCCTATAATTCACCCCTCCACTTT	CASSSRPLGGSYNSPLHF	TRBV9	TRBJ1-6
TGTGCCAGCAGTGACCGAGGGACAGTGGGTAGCGGGTGCTATGGCTACACCTTC	CASSDRGTVGSGCYGYTF	TRBV6-4	TRBJ1-2
TGCAGTGCGGGCCCATGGGACAGGTGTAGCAATCAGCCCCAGCATTTT	CSAGPWDRCSNQPQHF	TRBV20-1	TRBJ1-5
TGTGCCAGCAGCGCTAGGCCCGGGACAAAACATTATGGCTACACCTTC	CASSARPGTKHYGYTF	TRBV5-6	TRBJ1-2
TGTGCCAGTAGTATTGGGGGGGGCTGGAATGAGCAGTTCTTC	CASSIGGGWNEQFF	TRBV19	TRBJ2-1
TGTGCCAGCAATGACCTACAGTCCAGGTGGGGGGAAAAACTGTTTTTT	CASNDLQSRWGEKLFF	TRBV28	TRBJ1-4
TGTGCCAGCAGCCACCTCCTCAAGTTTTCAAAAGGGTGTTGTACTGGAAACACCATATATTTT	CASSHLLKFSKGCCTGNTIYF	TRBV14	TRBJ1-3
TGCGCCAGCAGTGAAACTGAGTTCTTT	CASSETEFF	TRBV10-1	TRBJ1-1
TGCGCCACTCTGACAGGGGGCTTGGACACCATATATTTT	CATLTGGLDTIYF	TRBV10-1	TRBJ1-3
TGTGCCGGTTCAGGGGTCGCATCTGAAGCTTTCTTT	CAGSGVASEAFF	TRBV27	TRBJ1-1
TGTGCCACTGAGGAAGGTCTCCTTCTTATGACAGATACGCAGTATTTT	CATEEGLLLMTDTQYF	TRBV24-1	TRBJ2-3
TGTGCTAGTGGTTGGGGGGGGCTTCCCCCCCAGTACAATGAGCAGTTCTTC	CASGWGGLPPQYNEQFF	TRBV12-5	TRBJ2-1
TGCAGTGCTGTGCCCCGGGGCAGCTACGAGCAGTACTTC	CSAVPRGSYEQYF	TRBV20-1	TRBJ2-7
TGTGCCAGCAGCACCTGGGAGCTGGACAGGCAAGAGACCCAGTACTTC	CASSTWELDRQETQYF	TRBV5-4	TRBJ2-5
TGTGCTAGTGGTGACAGGGTCTATGAAAAACTGTTTTTT	CASGDRVYEKLFF	TRBV12-5	TRBJ1-4
TGTGCCAGCAGCTTAAGGGGAGGGGCTTTAAAACTGTTTTTT	CASSLRGGALKLFF	TRBV7-3	TRBJ1-4
TGCGCCAGCAGCCAAGATGGCTGGTGTGGGAACCGAGCCTACAATGAGCAGTTCTTC	CASSQDGWCGNRAYNEQFF	TRBV4-1	TRBJ2-1
TGTGCCAGCAGTTCCGGGCGGGAGTGTTCCTACAATGAGCAGTTCTTC	CASSSGRECSYNEQFF	TRBV27	TRBJ2-1
TGTGCCAGCAGCTACGCACAGGGGGAGAATGGCTACACCTTC	CASSYAQGENGYTF	TRBV7-3	TRBJ1-2
TGCGCCAGCAGTCCCGGGGGGCGTGAAAAACTGTTTTTT	CASSPGGREKLFF	TRBV10-1	TRBJ1-4
TGTGCCAGCAGTGACCTCCAGTGGGGTGATAACTATGGCTACACCTTC	CASSDLQWGDNYGYTF	TRBV6-4	TRBJ1-2
TGTGCCACCAGTGATTTAGTCCGTTACCGTAGCTCTGGAAACACCATATATTTT	CATSDLVRYRSSGNTIYF	TRBV24-1	TRBJ1-3
TGTGCCAGCAGTTCCAGGACAGGGGAGGGGTCTGGAAACACCATATATTTT	CASSSRTGEGSGNTIYF	TRBV27	TRBJ1-3
TGTGCCAGCAGCTTAGCGCCACAGGCCTATGGCTACACCTTC	CASSLAPQAYGYTF	TRBV7-2	TRBJ1-2
TGTGCCAGCAGCGGAGGGAGGGGCGCGAGCGGGGAGCTGTTTTTT	CASSGGRGASGELFF	TRBV13	TRBJ2-2
TGTGCCAGCAGTGAGAAAAACCATATCGGTAGCAATCAGCCCCAGCATTTT	CASSEKNHIGSNQPQHF	TRBV6-4	TRBJ1-5
TGTGCCACCAGTGATGGCCCCTTCGATAGGAACACCGGGGAGCTGTTTTTT	CATSDGPFDRNTGELFF	TRBV24-1	TRBJ2-2
TGTGCCAGCAGCCAAGTAGTCGAATATTTT	CASSQVVEYF	TRBV4-2	TRBJ2-3
TGCAGTGCTAGAGATCCCCGGGGGGCCCGCCGCACAGATACGCAGTATTTT	CSARDPRGARRTDTQYF	TRBV20-1	TRBJ2-3
TGTGCCAGCAGGGCAGCGAACTACGAGCAGTACTTC	CASRAANYEQYF	TRBV6-4	TRBJ2-7
TGTGCCATCATTTGGGGAGGGGTACACGAGCAGTACTTC	CAIIWGGVHEQYF	TRBV10-3	TRBJ2-7
TGTGCCACCAGTGATAAGGCCGGGACAGGGAGTAGCGATCAGCCCCAGCATTTT	CATSDKAGTGSSDQPQHF	TRBV24-1	TRBJ1-5
TGTGCCAGCAGTGAACGGCCCAGGGACCAGAGCTCCTACGAGCAGTACTTC	CASSERPRDQSSYEQYF	TRBV6-1	TRBJ2-7
TGTGCCAGCAGCTTCCCTCGACTAGCGGGAGATGAGGACGGTGCTGAAGCTTTCTTT	CASSFPRLAGDEDGAEAFF	TRBV7-4	TRBJ1-1
TGTGCCAGCAGCTTTTATCTGGCTGAAGCTTTCTTT	CASSFYLAEAFF	TRBV7-3	TRBJ1-1
TGTGCCAGCAGCGTAGCGGCCAGGACTGAAGCTTTCTTT	CASSVAARTEAFF	TRBV9	TRBJ1-1
TGTGCCAGAAAAGGGGGGGCAGAGACCCAGTACTTC	CARKGGAETQYF	TRBV9	TRBJ2-5
TGTGCCAGCAGCCAAGGGCCTGGCTGGGATCAGCCCCAGCATTTT	CASSQGPGWDQPQHF	TRBV5-8	TRBJ1-5
TGCGCCAGCAGCTTTGAGGGGGGGAGCAATCAGCCCCAGCATTTT	CASSFEGGSNQPQHF	TRBV5-1	TRBJ1-5
TGTGCCAGCAGTTTGAGGGGGGGGGGAACTAACTATGGCTACACCTTC	CASSLRGGGTNYGYTF	TRBV28	TRBJ1-2
TGCGCCAGCGAACCCCAGGTCCCTAGCGGGGGCGCGGTAACCCAAGAGACCCAGTACTTC	CASEPQVPSGGAVTQETQYF	TRBV10-1	TRBJ2-5
TGTGCCAGCAGCGGGGTATCTGGGGCCAACGTCCTGACTTTC	CASSGVSGANVLTF	TRBV7-9	TRBJ2-6
TGCAGCGTGCGGCGAGGGGAGAATTTTGAGCAGTACTTC	CSVRRGENFEQYF	TRBV29-1	TRBJ2-7
TGTGCCAGCAGCGGGGTTGACACCATATATTTT	CASSGVDTIYF	TRBV9	TRBJ1-3
TGTGCCAGCAGCTGGGACAGGGAAACCTACGAGCAGTACTTC	CASSWDRETYEQYF	TRBV5-6	TRBJ2-7
TGTGCCAGCAGTCGCACTCCAGAGAATAGCAAAAACATTCAGTACTTC	CASSRTPENSKNIQYF	TRBV6-5	TRBJ2-4
TGTGCCAGCAGCGTCAGTCTGGGCTCTGGAAACACCATATATTTT	CASSVSLGSGNTIYF	TRBV9	TRBJ1-3
TGCGCCAGCAGCGCCCAGGGTGGTGAAGCTTTCTTT	CASSAQGGEAFF	TRBV5-1	TRBJ1-1
TGTGCCAGCAGTTACGGTCCAAGACGACTAGCGGGCTACGAGCAGTACTTC	CASSYGPRRLAGYEQYF	TRBV6-3	TRBJ2-7
TGTGCCAGCAGCGTAGCTCCCCCGTCCGGACTAGCGGCTAAGAAGGGCTACGAGCAGTACTTC	CASSVAPPSGLAAKKGYEQYF	TRBV9	TRBJ2-7
TGTGCCACCACCCGACAGGATCCCAGGAGTAATTCACCCCTCCACTTT	CATTRQDPRSNSPLHF	TRBV24-1	TRBJ1-6
TGCGCCAGCAGCCCTGGTCGGACAGGGTTTAAACTAGGTGAAGCTTTCTTT	CASSPGRTGFKLGEAFF	TRBV4-1	TRBJ1-1
TGTGCCAGTAGTATAGATTACGTCGGGGCCTCCCAAGAGACCCAGTACTTC	CASSIDYVGASQETQYF	TRBV19	TRBJ2-5
TGTGCCAGCAGCAACCCTCCCGGGGCGGGGTCACCCCTCCACTTT	CASSNPPGAGSPLHF	TRBV14	TRBJ1-6
TGTGCCAGCAGTCTTACCCAGGTGGACAGGGGGGACTCTGGAAACACCATATATTTT	CASSLTQVDRGDSGNTIYF	TRBV12-4	TRBJ1-3
TGTGCCAGCTCAAAGACTCCCGGGGGGGGGTTGGACTACGAGCAGTACTTC	CASSKTPGGGLDYEQYF	TRBV18	TRBJ2-7
TGCGCCACCGGACATTTGGCCTACGAGCAGTACTTC	CATGHLAYEQYF	TRBV10-2	TRBJ2-7
TGTGCCAGCAGCTTAGGAGTCCTACCCCTCCGGGGGCGAATCTACGAGCAGTACTTC	CASSLGVLPLRGRIYEQYF	TRBV13	TRBJ2-7
TGTGCCACCAGTGATAAGGCGGACGGGACAGGGACCTACGAGCAGTACTTC	CATSDKADGTGTYEQYF	TRBV24-1	TRBJ2-7
TGTGCCAGCTTCGAGACCGGCAGGGGACCATACAATCAGCCCCAGCATTTT	CASFETGRGPYNQPQHF	TRBV2	TRBJ1-5
TGTGCACTGGGACATTCCTGGTGCGACTCCGATTCACCCCTCCACTTT	CALGHSWCDSDSPLHF	TRBV5-5	TRBJ1-6
TGTGCCAGCAGCGGAACCCGGGGGGATAGGGTAAGCTACGAGCAGTACTTC	CASSGTRGDRVSYEQYF	TRBV3-1	TRBJ2-7
TGCAGCGATGGGGTGAGGGCCCCAGACCCATGCCCTAACGGTGGCTACACCTTC	CSDGVRAPDPCPNGGYTF	TRBV29-1	TRBJ1-2
TGTGCTAGTGGTTTGGTAAGGGGGGACAGGGCCGTCTGCTCCTACGAGCAGTACTTC	CASGLVRGDRAVCSYEQYF	TRBV12-5	TRBJ2-7
TGTGCCACCAGCAGAGTACGGGTGACTCCCCAGGGACCCTACAATGAGCAGTTCTTC	CATSRVRVTPQGPYNEQFF	TRBV15	TRBJ2-1
TGTGCCAGCAGCCTGAGGTCTCTTTTAGGACAGTCCTACGAGCAGTACTTC	CASSLRSLLGQSYEQYF	TRBV12-3	TRBJ2-7
TGTGCCAGCAGCCGTCGGACAGGAGGGGGCACTGAAGCTTTCTTT	CASSRRTGGGTEAFF	TRBV3-1	TRBJ1-1
TGTGCCACCAGTGATTTGGAGACTAGCGGGGAGGGTCATGAGCAGTTCTTC	CATSDLETSGEGHEQFF	TRBV24-1	TRBJ2-1
TGTGCCAGCAGACCGGGGGGACGATGGCAGCCCCAGCATTTT	CASRPGGRWQPQHF	TRBV28	TRBJ1-5
TGTGCCAGCAGCGCTGGGACTAGCGGGAGGACGCAGTATTTT	CASSAGTSGRTQYF	TRBV9	TRBJ2-3
TGTGCCAGCAGTGAAGCCCCCGGTGTCCCCGGGACTAGCGGAGACACAGATACGCAGTATTTT	CASSEAPGVPGTSGDTDTQYF	TRBV25-1	TRBJ2-3
TGTGCCACCAACGGACCTCGGAACACTGAAGCTTTCTTT	CATNGPRNTEAFF	TRBV24-1	TRBJ1-1
TGTGCCAGCAGATCGAGGGGGTTGAGCTCCTACGAGCAGTACTTC	CASRSRGLSSYEQYF	TRBV6-8	TRBJ2-7
TGTGCCAGCAGTTACAGGGGCGGGAGCTTGAACACTGAAGCTTTCTTT	CASSYRGGSLNTEAFF	TRBV6-2	TRBJ1-1
TGCGCCAGCAGCCTAACAGGGGGGTCCGACACCATATATTTT	CASSLTGGSDTIYF	TRBV4-1	TRBJ1-3
TGTGCCACCAGCAGATGGGACAGGGTCGAGTCACCCCTCCACTTT	CATSRWDRVESPLHF	TRBV15	TRBJ1-6
TGTGCTAGCAGCTTACCCGGGATGGACAGGGACCAAGAGACCCAGTACTTC	CASSLPGMDRDQETQYF	TRBV7-7	TRBJ2-5
TGTGCCAGCAGCCCTGAGACTAGCGGGTACTCCTACAATGAGCAGTTCTTC	CASSPETSGYSYNEQFF	TRBV3-1	TRBJ2-1
TGTGCCAGCAGGGGGGGGATTGGCTCCTACGAGCAGTACTTC	CASRGGIGSYEQYF	TRBV3-1	TRBJ2-7
TGTGCCAGCAGCTTGCCAGCGGGAAAAGTCTACGAGCAGTACTTC	CASSLPAGKVYEQYF	TRBV5-4	TRBJ2-7
TGTGCCAGGACTGCGGACAGGGCCTCTGGGGCCAACGTCCTGACTTTC	CARTADRASGANVLTF	TRBV19	TRBJ2-6
TGTGCCAGCAGCTCTCCGGGACAGACATTGACCCCTAATGAAAAACTGTTTTTT	CASSSPGQTLTPNEKLFF	TRBV13	TRBJ1-4
TGTGCCAGCAGCTTGGGTGAGGACAGGGGTTCCGGGGAGCTGTTTTTT	CASSLGEDRGSGELFF	TRBV5-5	TRBJ2-2
TGTGCCAGCACAGGTCGGGGGGCCGAGAGAAGCACAGATACGCAGTATTTT	CASTGRGAERSTDTQYF	TRBV28	TRBJ2-3
TGTGCCAGCAGTTACAACAGCATTCAGTACTTC	CASSYNSIQYF	TRBV6-5	TRBJ2-4
TGTGCCAGCAGCAAACATGAAGCTTTCTTT	CASSKHEAFF	TRBV13	TRBJ1-1
TGTGCCAGCAGTGGCAGGGCTACTGAAGCTTTCTTT	CASSGRATEAFF	TRBV6-5	TRBJ1-1
TGTGCCAGCAGCCGTTGGGGGCAGCCCCAGCATTTT	CASSRWGQPQHF	TRBV7-9	TRBJ1-5
TGTGCCAGCAGCGAGTGTCCCCCAGGGGGGTTTCTCTATTACAATGAGCAGTTCTTC	CASSECPPGGFLYYNEQFF	TRBV14	TRBJ2-1
TGTGCCATTGACAAATTGGGGCGGCAGCCCCAGCATTTT	CAIDKLGRQPQHF	TRBV19	TRBJ1-5
TGTGCCAGCAACACCGGCGGTTACGAGACCCAGTACTTC	CASNTGGYETQYF	TRBV2	TRBJ2-5
TGCGCCAGCAGCCAAGGGTCCGTGGGACAGGGGTCGATTGTAAAGACCCACTATGGCTACACCTTC	CASSQGSVGQGSIVKTHYGYTF	TRBV4-1	TRBJ1-2
TGTGCCAGCAGCCGTGCCGACAGGGACAGCAATCAGCCCCAGCATTTT	CASSRADRDSNQPQHF	TRBV3-1	TRBJ1-5
TGCGCCAGCAGCCAAGGGGTTACGCGGAACACTGAAGCTTTCTTT	CASSQGVTRNTEAFF	TRBV4-1	TRBJ1-1
TGTGCCAGCAGTTTGCGGAACTCTGGGGCCAACGTCCTGACTTTC	CASSLRNSGANVLTF	TRBV28	TRBJ2-6
TGTGCCAGCAGTGGCCAGGGAAGGGAGGTCTATGGCTACACCTTC	CASSGQGREVYGYTF	TRBV6-1	TRBJ1-2
TGTGCCAGCAGTTACTCAGGGACTACCCTAGAGACCCAGTACTTC	CASSYSGTTLETQYF	TRBV6-3	TRBJ2-5
TGCAGTGCAAGACAGGAAAAGTTGCGGAACTATGGCTACACCTTC	CSARQEKLRNYGYTF	TRBV20-1	TRBJ1-2
TGCGCCAGCAGCTTGGATAGGGCTTCAGATACGCAGTATTTT	CASSLDRASDTQYF	TRBV5-1	TRBJ2-3
TGTGCCAGCATGGGCAGTTCAGCAGGGGCGGGGTTCTACGAGCAGTACTTC	CASMGSSAGAGFYEQYF	TRBV6-3	TRBJ2-7
TGTGCCAGCCCAGAACGGAATTGCAAAGGGTACGAGCAGTACTTC	CASPERNCKGYEQYF	TRBV2	TRBJ2-7
TGTGCCATCAGTGTCGAGGGGACAGGAGAGGACGGGGAGCTGTTTTTT	CAISVEGTGEDGELFF	TRBV10-3	TRBJ2-2
TGCAGTGCACAGGGTGAAGCTTTCTTT	CSAQGEAFF	TRBV20-1	TRBJ1-1
TGTGCCAGCAGTGATTTCCCCGGGCCGGGACAGCTTGGGAGTGCAACTAATGAAAAACTGTTTTTT	CASSDFPGPGQLGSATNEKLFF	TRBV25-1	TRBJ1-4
TGTGCCAGCAGCCAGTCCGGGACTAGAGTAGTGGATGAGCAGTTCTTC	CASSQSGTRVVDEQFF	TRBV3-1	TRBJ2-1
TGCGCCAGCAAGGGGGTACGAATCAGCAGGGAGCTGAGATACTATGGCTACACCTTC	CASKGVRISRELRYYGYTF	TRBV4-1	TRBJ1-2
TGTGCCAGCAGCCAATATCGCAGTGGTCAGCCCCAGCATTTT	CASSQYRSGQPQHF	TRBV13	TRBJ1-5
TGTGCTAGTGGTTTTCCCCCGAGGACTTTTTGTGATCAGCCCCAGCATTTT	CASGFPPRTFCDQPQHF	TRBV12-5	TRBJ1-5
TGTGCCAGCACCAAAGAGGACTGCACAGATACGCAGTATTTT	CASTKEDCTDTQYF	TRBV27	TRBJ2-3
TGTGCCAGCAGCTGGGTGGGACAGGGTGATGAAAAACTGTTTTTT	CASSWVGQGDEKLFF	TRBV5-4	TRBJ1-4
TGTGCCAGCAGTCCGCCTACTAGCGGGCTTCACAATGAGCAGTTCTTC	CASSPPTSGLHNEQFF	TRBV27	TRBJ2-1
TGCGCCAGCAGCCGGGGGGGACCGAGGGAGACCCAGTACTTC	CASSRGGPRETQYF	TRBV5-1	TRBJ2-5
TGCGCCAGCAGCTTGATGGGGCGTACGACGTGTATGGAAACCGGGGAGCTGTTTTTT	CASSLMGRTTCMETGELFF	TRBV5-1	TRBJ2-2
TGCAGCGTTCCGAGGGTCACCGGGGAGCTGTTTTTT	CSVPRVTGELFF	TRBV29-1	TRBJ2-2
TGTGCCAGCATAACGGGACTTCCCGGGACTCGAAAGACCTACAATGAGCAGTTCTTC	CASITGLPGTRKTYNEQFF	TRBV5-5	TRBJ2-1
TGTGCCAGCAGCTTAACGCCGACGACAGGGAGAGAAAAACTGTTTTTT	CASSLTPTTGREKLFF	TRBV7-3	TRBJ1-4
TGTGCCAGCAGCGCAGATAGGACAGGGAGCTTTGGCTACACCTTC	CASSADRTGSFGYTF	TRBV6-4	TRBJ1-2
TGCGCCAGCAGCGCCACAAGTAACTCTGGAAACACCATATATTTT	CASSATSNSGNTIYF	TRBV5-1	TRBJ1-3
TGTGCCAGCAGTTTAGCCCCGGGACTAGCGGGCAGGCGTTGTCGGTCCTACGAGCAGTACTTC	CASSLAPGLAGRRCRSYEQYF	TRBV12-4	TRBJ2-7
TGTGCCAGCAGCTGTCTCGTGATTAATGAAAAACTGTTTTTT	CASSCLVINEKLFF	TRBV7-2	TRBJ1-4
TGTGCCAGCAGTTACGGGAAGCCGGGACGAGAGACCCAGTACTTC	CASSYGKPGRETQYF	TRBV6-5	TRBJ2-5
TGTGCCAGCAGCCAGTCTGCTGTAACTGACACTGAAGCTTTCTTT	CASSQSAVTDTEAFF	TRBV27	TRBJ1-1
TGTGCCAGCAGCTTAATTGGACAGACCTCTGGGGCCAACGTCCTGACTTTC	CASSLIGQTSGANVLTF	TRBV7-3	TRBJ2-6
TGTGCCAGCAGTTTAACTCTATCCTATAATTCACCCCTCCACTTT	CASSLTLSYNSPLHF	TRBV12-4	TRBJ1-6
TGTGCACTAGCGGGTTCAGGATACACAGATACGCAGTATTTT	CALAGSGYTDTQYF	TRBV7-7	TRBJ2-3
TGTGCCAGCAGTCCTACAGGGGGCTCCTATAATTCACCCCTCCACTTT	CASSPTGGSYNSPLHF	TRBV25-1	TRBJ1-6
TGTGCCAGCAGTGTCCCGGACAGCCCTGAAGCTTTCTTT	CASSVPDSPEAFF	TRBV7-9	TRBJ1-1
TGTGCCATCAGTGAGTCGGAAAGACAGGGTTGTACACCCCTCCACTTT	CAISESERQGCTPLHF	TRBV10-3	TRBJ1-6
TGTGCCATACGCGGGAGGAACACTGAAGCTTTCTTT	CAIRGRNTEAFF	TRBV10-3	TRBJ1-1
TGTGCCAGCAGCACGACTAGCGGGGGGGAGTATAGCACAGATACGCAGTATTTT	CASSTTSGGEYSTDTQYF	TRBV13	TRBJ2-3
TGTGCCAGCAGCCCGAACGACGGGCAGAATTCACCCCTCCACTTT	CASSPNDGQNSPLHF	TRBV13	TRBJ1-6
TGTGCCTGGAGTTCACCGGGGCGATTCTTAGGGCCCGGGGAGCTGTTTTTT	CAWSSPGRFLGPGELFF	TRBV30	TRBJ2-2
TGTGCCACCAGTGACAGGGGGCCCTATGGCTACACCTTC	CATSDRGPYGYTF	TRBV24-1	TRBJ1-2
TGCGCCAGCAGCTTCCCCCGCGACAGGGGAGCTGAAGCTTTCTTT	CASSFPRDRGAEAFF	TRBV5-1	TRBJ1-1
TGTGCCAGCAGTTTCGGGAGATTGGAGATCCCTTGCTCCTACAATGAGCAGTTCTTC	CASSFGRLEIPCSYNEQFF	TRBV6-2	TRBJ2-1
TGTGCCAGCTCACCACCGACTAGCGGGGGCGAACGCGAGCAGTACTTC	CASSPPTSGGEREQYF	TRBV18	TRBJ2-7
TGTGCCAGCAGCCGACTCGAGGGGGATACGAGGAACCACGAGCAGTACTTC	CASSRLEGDTRNHEQYF	TRBV7-3	TRBJ2-7
TGTGCCAGCAGTTTGCCTAGTCCCTACAATGAGCAGTTCTTC	CASSLPSPYNEQFF	TRBV12-3	TRBJ2-1
TGTGCCAGCAGATCCCCCAGGAACACTGAAGCTTTCTTT	CASRSPRNTEAFF	TRBV7-9	TRBJ1-1
TGTGCCAGCAGCAGTGGAGACACTGAAGCTTTCTTT	CASSSGDTEAFF	TRBV5-4	TRBJ1-1
TGTGCCAGCAGCTCCCTTCTGCCCAAAAACATTCAGTACTTC	CASSSLLPKNIQYF	TRBV11-2	TRBJ2-4
TGCGCCAGCAGCCAAGAAAGACAGGCCGGGATAGGCAATCAGCCCCAGCATTTT	CASSQERQAGIGNQPQHF	TRBV4-1	TRBJ1-5
TGCGCCAGCAGCCACCAGATTTATAGGCAGTACTTC	CASSHQIYRQYF	TRBV5-1	TRBJ2-7
TGCGCCAGCAGCAAATACCCGCAGTATTTT	CASSKYPQYF	TRBV10-1	TRBJ2-3
TGTGCCAGCAGCAAAACAACCCAAGTGAAACAGGGGTTCAGGGCCGCCAACACCGGGGAGCTGTTTTTT	CASSKTTQVKQGFRAANTGELFF	TRBV5-4	TRBJ2-2
TGTGCCACCAATAAGGACAGAGTGAAAGAGACAGAGACCCAGTACTTC	CATNKDRVKETETQYF	TRBV15	TRBJ2-5
TGTGCCAGCAGTGTTGCAGGTGACACAGGGGGGGCAAGTTCTCTAGAATCTGGAAACACCATATATTTT	CASSVAGDTGGASSLESGNTIYF	TRBV6-3	TRBJ1-3
TGTGCCAGCAGCCTTAAAGGGGGCTACGAGCAGTACTTC	CASSLKGGYEQYF	TRBV11-2	TRBJ2-7
TGCGCCAGCAGCTTGGTAGTTGTCCCGAATCGGGGGGGCGGGGAGACCCAGTACTTC	CASSLVVVPNRGGGETQYF	TRBV5-1	TRBJ2-5
TGTGCCAGCAGTTTATCGGGGACTAGCGGGCAGTCCGCCTACGAGCAGTACTTC	CASSLSGTSGQSAYEQYF	TRBV27	TRBJ2-7
TGTGCCAGCAGCTTAGACGGGACAGGGGAGGTCGGTAATGAAAAACTGTTTTTT	CASSLDGTGEVGNEKLFF	TRBV13	TRBJ1-4
TGTGCCAGCAGCGGGACAAATAATTACTATGGCTACACCTTC	CASSGTNNYYGYTF	TRBV7-6	TRBJ1-2
TGCGCCAGCAGTGTCCTTCGAGGGTACTCTGGAAACACCATATATTTT	CASSVLRGYSGNTIYF	TRBV10-1	TRBJ1-3
TGCGCCAGCAGTGAAATTTTGAGGCTCAGTCCCTACGAGCAGTACTTC	CASSEILRLSPYEQYF	TRBV10-1	TRBJ2-7
TGTGCCAGCTCACTTGGGACCTACACCTTC	CASSLGTYTF	TRBV18	TRBJ1-2
TGTGCCAGCAGGGGGCCGTTCGGGCAGTACTTC	CASRGPFGQYF	TRBV11-3	TRBJ2-7
TGCGCCAGCAGCCTTGGGACTAGCGGGGTCTACGAGCAGTACTTC	CASSLGTSGVYEQYF	TRBV4-1	TRBJ2-7
TGTGCCAGCAGCGGTCCGGCCATTGGCTACACCTTC	CASSGPAIGYTF	TRBV9	TRBJ1-2
TGTGCCAGCAGCAGCTTAGAGAACAGCCCCCTGAGCAATCAGCCCCAGCATTTT	CASSSLENSPLSNQPQHF	TRBV6-4	TRBJ1-5
TGCGCCAGCAGCTTGACCTGGGGGGGCCTGTTCACAGATACGCAGTATTTT	CASSLTWGGLFTDTQYF	TRBV5-1	TRBJ2-3
TGTGCCACCAGTGATTTCGATTTCGCTAGCGGGAGGCACAGCTACAATGAGCAGTTCTTC	CATSDFDFASGRHSYNEQFF	TRBV24-1	TRBJ2-1
TGTGCCAGCCAGGGCCTCAGCAATCAGCCCCAGCATTTT	CASQGLSNQPQHF	TRBV6-5	TRBJ1-5
TGTGCCAGCAGCAGGGGGCCACAGCAGTACCAAGAGACCCAGTACTTC	CASSRGPQQYQETQYF	TRBV7-3	TRBJ2-5
TGTCCGAGACCCTACGAGCAGTACTTC	CPRPYEQYF	TRBV19	TRBJ2-7
TGCAGTGCTCCGGACTGCTGGTGCGATACGCAGTATTTT	CSAPDCWCDTQYF	TRBV20-1	TRBJ2-3
TGTGCCAGGGGAAAAAGGCAGTACTTC	CARGKRQYF	TRBV28	TRBJ2-5
TGTGCCAGCAACCTTCCTATCTGCTTTGAATTTGAGCAGTTCTTC	CASNLPICFEFEQFF	TRBV6-4	TRBJ2-1
TGCGCCAGCAGCCAAAATAACGGGACAGCCCAGTATGGCTACACCTTC	CASSQNNGTAQYGYTF	TRBV4-1	TRBJ1-2
TGTGCCAGCAACCCTACCGATAATTCACCCCTCCACTTT	CASNPTDNSPLHF	TRBV6-5	TRBJ1-6
TGTGCCAGTAGTCTGACTAGCGGGGGGGCAGATACGCAGTATTTT	CASSLTSGGADTQYF	TRBV19	TRBJ2-3
TGTGCCAGCCCACAGGGGGTGATCTATGGCTACACCTTC	CASPQGVIYGYTF	TRBV6-5	TRBJ1-2
TGTGCCAGCAGCTTATGGGCTCCGGGGGGCGAGCAGTACTTC	CASSLWAPGGEQYF	TRBV7-9	TRBJ2-7
TGTGCCAGCAGCTCCTGGGGGCAGGAGCCCGGGGAGCTGTTTTTT	CASSSWGQEPGELFF	TRBV7-4	TRBJ2-2
TGTGCCAGTATGTTAGCTGTAATACATGGCTACACCTTC	CASMLAVIHGYTF	TRBV12-3	TRBJ1-2
TGTGCCAGCAGTTGCCGGGCCTACGAGCAGTACTTC	CASSCRAYEQYF	TRBV6-2	TRBJ2-7
TGCGCCAGCAGGCTGTGGACTACAACTAATGAAAAACTGTTTTTT	CASRLWTTTNEKLFF	TRBV10-1	TRBJ1-4
TGTGCCTGGAGAAAAGCGACCGACAGCACTGAAGCTTTCTTT	CAWRKATDSTEAFF	TRBV30	TRBJ1-1
TGTGCCAGCAGCCGGGCCAGGTATCAGTGGAGGGCGAGCTCCTACAATGAGCAGTTCTTC	CASSRARYQWRASSYNEQFF	TRBV5-4	TRBJ2-1
TGTGCCAGCAGTAGTGACTGGATTAATGAAAAACTGTTTTTT	CASSSDWINEKLFF	TRBV6-3	TRBJ1-4
TGTGCCAGCAGCCAACTTCCGCCGGGACAGGTTAGCAATCAGCCCCAGCATTTT	CASSQLPPGQVSNQPQHF	TRBV3-1	TRBJ1-5
TGTGCCAGCAGCTTAGTCAAGTCGGGGGCTAAGGGTACCGAGCAGTACTTC	CASSLVKSGAKGTEQYF	TRBV11-3	TRBJ2-7
TGTGCCAGCAGTAATGGAGTGGGACTAGCGGGCTACGAGCAGTACTTC	CASSNGVGLAGYEQYF	TRBV6-4	TRBJ2-7
TGTGCCAGCAAAGACCCCGACAGGGCCATGGACCGAAAACTGTTTTTT	CASKDPDRAMDRKLFF	TRBV27	TRBJ1-4
TGCGCCAGCCACGGTCCGACCGAGGATGAAAAACTGTTTTTT	CASHGPTEDEKLFF	TRBV4-3	TRBJ1-4
TGCAGTGCTAGTATGGGACAGCCAGACTATGGCTACACCTTC	CSASMGQPDYGYTF	TRBV20-1	TRBJ1-2
TGCGCCAGCAGCCTAAAATCGGGTCACCGGGGGCCAGAGAGCAATCAGCCCCAGCATTTT	CASSLKSGHRGPESNQPQHF	TRBV4-1	TRBJ1-5
TGTGCCAGCAGCGTTAGGGCCGGCACAGATACGCAGTATTTT	CASSVRAGTDTQYF	TRBV6-1	TRBJ2-3
TGCGCCAGCAGCCAAGGTGACAGGCCCCAGCATTTT	CASSQGDRPQHF	TRBV4-1	TRBJ1-5
TGTGCCAGCCCGAGAGAGGAGGATGAGCAGTTCTTC	CASPREEDEQFF	TRBV6-5	TRBJ2-1
TGCAGCGTTGTGTGGGACAGCTTTGGCTACACCTTC	CSVVWDSFGYTF	TRBV29-1	TRBJ1-2
TGTGCCACCAGTGATTTTTCGTGCGGAACCGGGGAGCTGTTTTTT	CATSDFSCGTGELFF	TRBV24-1	TRBJ2-2
TGCGCCAGCAGCCAAGAACGACAGGGGCTCACCTATGGCTACACCTTC	CASSQERQGLTYGYTF	TRBV4-3	TRBJ1-2
TGCAGTGCTAGAGATGCGACAGTGGGAGGAAACACCATATATTTT	CSARDATVGGNTIYF	TRBV20-1	TRBJ1-3
TGCAGTGCTAGAGGGGGGCCCCTAGCGGCGAGCACAGATACGCAGTATTTT	CSARGGPLAASTDTQYF	TRBV20-1	TRBJ2-3
TGTGCCATCCAGAGGAGGGACTTCGACACAGATACGCAGTATTTT	CAIQRRDFDTDTQYF	TRBV10-3	TRBJ2-3
TGTGCCAGCAGCCCTTCCGACTCCAGGGCCGGAAACACCATATATTTT	CASSPSDSRAGNTIYF	TRBV13	TRBJ1-3
TGTGCCAGCAGCTTACCCGGGGGAGCTTATGGCTACACCTTC	CASSLPGGAYGYTF	TRBV11-3	TRBJ1-2
TGCGCCAGGGCCCGGGGGTGTCCGAATCAGCCCCAGCATTTT	CARARGCPNQPQHF	TRBV10-1	TRBJ1-5
TGTGCCAGCAGCATAACAGGGTACAGAAACACTGAAGCTTTCTTT	CASSITGYRNTEAFF	TRBV5-4	TRBJ1-1
TGTGCCAGTAGTATAAGTGCATACGAGCAGTACTTC	CASSISAYEQYF	TRBV19	TRBJ2-7
TGCAGTGCTGGAAAGCGGCACTCTGGAAACACCATATATTTT	CSAGKRHSGNTIYF	TRBV20-1	TRBJ1-3
TGTGCCAGCAGCAGGACAGGGCCAAGGGATGGCTACACCTTC	CASSRTGPRDGYTF	TRBV5-4	TRBJ1-2
TGTGCCAGCATTCCTGGCGACTACGAGCAGTACTTC	CASIPGDYEQYF	TRBV9	TRBJ2-7
TGTGCCAGCAGCCAGGGCGTCCCCCTAACCGATGGGGGGGTCTACGAGCAGTACTTC	CASSQGVPLTDGGVYEQYF	TRBV13	TRBJ2-7
TGTGCCAGCAGCCAACCCCTGGCGGGAGGGGGGACCGGGGAGCTGTTTTTT	CASSQPLAGGGTGELFF	TRBV13	TRBJ2-2
TGTGCCAGTGAGGACAGGGGATCCTACGAGCAGTACTTC	CASEDRGSYEQYF	TRBV2	TRBJ2-7
TGCGCCAGCAGTGGACCTCAGGGCGACGGGTATAGCAATCAGCCCCAGCATTTT	CASSGPQGDGYSNQPQHF	TRBV10-2	TRBJ1-5
TGTGCCAGCAGCCCTAGCGGTGCGGAAGGACAGGATACGCAGTATTTT	CASSPSGAEGQDTQYF	TRBV7-3	TRBJ2-3
TGCGCCAGCAGCAAAGACCCCTATGGCTACACCTTC	CASSKDPYGYTF	TRBV5-1	TRBJ1-2
TGTGCCAGCAGCTTACCTACTAGCGGGAGTATTCAGCCCCAGCATTTT	CASSLPTSGSIQPQHF	TRBV7-3	TRBJ1-5
TGTGCCAGCAGCGAACGAAAGACAGGGGTGCGGAACACTGAAGCTTTCTTT	CASSERKTGVRNTEAFF	TRBV5-4	TRBJ1-1
TGTGCCAGCAGCTGGAACCACAGTCCCTCCTACGAGCAGTACTTC	CASSWNHSPSYEQYF	TRBV11-2	TRBJ2-7
TGTGCCAGCAGCCAACACAACTGGGGGGGGCCCGATACGCAGTATTTT	CASSQHNWGGPDTQYF	TRBV3-1	TRBJ2-3
TGTGCCAGCTCACAAAAGCCAGTCCACAGGGGTGGGGGGGGCTACACCTTC	CASSQKPVHRGGGGYTF	TRBV18	TRBJ1-2
TGCGCCAGCAGCTTGGGGACAGGGGGCGTCTCTGGAAACACCATATATTTT	CASSLGTGGVSGNTIYF	TRBV5-1	TRBJ1-3
TGTGCCAGCAGTTCAGGACAGAGTGCAACTAATGAAAAACTGTTTTTT	CASSSGQSATNEKLFF	TRBV6-5	TRBJ1-4
TGTGCCAGCAGCTTGGCCCTAAAACTAGCGGTGGGTATCTCCTACAATGAGCAGTTCTTC	CASSLALKLAVGISYNEQFF	TRBV5-6	TRBJ2-1
TGCAGCGGTCCCCTAGAGGACACCATATATTTT	CSGPLEDTIYF	TRBV29-1	TRBJ1-3
TGCGCCAGCAGCCCCACTGAAGGGTATACGCAGTATTTT	CASSPTEGYTQYF	TRBV4-1	TRBJ2-3
TGTGCCAGCAGTGACTCTGACAGGGCCGAGGGCCCCGCTGAAGCTTTCTTT	CASSDSDRAEGPAEAFF	TRBV6-4	TRBJ1-1
TGTGCCAGCAGCGTAGTGGACCGCTACAATGAGCAGTTCTTC	CASSVVDRYNEQFF	TRBV7-9	TRBJ2-1
TGTGCCAGCAGCTTGCGAGAGGAAGGACAAGAGACCCAGTACTTC	CASSLREEGQETQYF	TRBV5-6	TRBJ2-5
TGTGCCAGCAGCGGGCCTTCCGGGACAGACTCGGCCTACGAGCAGTACTTC	CASSGPSGTDSAYEQYF	TRBV7-2	TRBJ2-7
TGTGCCAGCGGGGGGACATGCCTCTACGAGCAGTACTTC	CASGGTCLYEQYF	TRBV6-5	TRBJ2-7
TGTGCCAGCAGTTCATCACGCCAGGGTGCCTACGAGCAGTACTTC	CASSSSRQGAYEQYF	TRBV12-3	TRBJ2-7
TGTGCCAGCCCGGAATGGAGCTCCTACGAGCAGTACTTC	CASPEWSSYEQYF	TRBV6-1	TRBJ2-7
TGTGCCACCGAGGGAGGCACCGGGGAGCTGTTTTTT	CATEGGTGELFF	TRBV15	TRBJ2-2
TGTGCCAGCAGCTTAGATCACAAGGGTAGCAATCAGCCCCAGCATTTT	CASSLDHKGSNQPQHF	TRBV11-2	TRBJ1-5
TGTGCCAGCAGCCCAGGGGCCTGCTACAATGAGCAGTTCTTC	CASSPGACYNEQFF	TRBV5-6	TRBJ2-1
TGTGCCAGCAGCGGGGGGGGTTGTAGCAATCAGCCCCAGCATTTT	CASSGGGCSNQPQHF	TRBV7-2	TRBJ1-5
TGTGCCAGCAGTTTCCGGGGTGATTCCGGCATGAACACTGAAGCTTTCTTT	CASSFRGDSGMNTEAFF	TRBV28	TRBJ1-1
TGCAGTGCTTCCCAGAGGAGGGAGGACAATGAGCAGTTCTTC	CSASQRREDNEQFF	TRBV20-1	TRBJ2-1
TGTGCCAGCAGTTTGGACAGGGGGAGGGCGAATAGCAATCAGCCCCAGCATTTT	CASSLDRGRANSNQPQHF	TRBV28	TRBJ1-5
TGTGCCAGCAGCTTACTCGAACTAGCGCGCACAGATACGCAGTATTTT	CASSLLELARTDTQYF	TRBV7-2	TRBJ2-3
TGTGCCAGCAGCCCCCGCGCCCACAGGGAAACTCACTATGGCTACACCTTC	CASSPRAHRETHYGYTF	TRBV6-6	TRBJ1-2
TGTGCCATCAGAGGTCCCATGGAGTACAACCTAGAGACCCAGTACTTC	CAIRGPMEYNLETQYF	TRBV10-3	TRBJ2-5
TGTGCCAGCAGCCAACCGGCGGAAAGCGGGGCTTCACCCCTCCACTTT	CASSQPAESGASPLHF	TRBV14	TRBJ1-6
TGTGCCAGCAGGGGCCAAGAGACTAGCGATGCTTGCCGGCACGACAATGAGCAGTTCTTC	CASRGQETSDACRHDNEQFF	TRBV27	TRBJ2-1
TGCGCCAGCAGCCAAGCCTTTCGGGGGGGGGACGTATCGGGCAATCAGCCCCAGCATTTT	CASSQAFRGGDVSGNQPQHF	TRBV4-1	TRBJ1-5
TGTGCCAGCGGGGGGTCCCCGGATTGTGAAGCTTTCTTT	CASGGSPDCEAFF	TRBV6-3	TRBJ1-1
TGTGCCAGCAGCTTATGGCCGGGCCGGAACACTGAAGCTTTCTTT	CASSLWPGRNTEAFF	TRBV5-8	TRBJ1-1
TGTGCCAGCAGCGAGCGGGAGAGTAGCGAGCAGTACTTC	CASSERESSEQYF	TRBV7-4	TRBJ2-7
TGCAGTGCTATCCGGAGGCTGGGGGTAGGATACGAGCAGTACTTC	CSAIRRLGVGYEQYF	TRBV20-1	TRBJ2-7
TGTGCCAGCAGCTTGTTGCGAGCCGTACCGTGGGGGGGGATCTATGGCTACACCTTC	CASSLLRAVPWGGIYGYTF	TRBV5-6	TRBJ1-2
TGTGCCAGCAGCTTAAGGTCAGGGGGGCTAGAGCAGTACTTC	CASSLRSGGLEQYF	TRBV7-6	TRBJ2-7
TGTGCCAGCAGTTCAACGGGGAGGGCTCTTTCCGGCTCTGGAAACACCATATATTTT	CASSSTGRALSGSGNTIYF	TRBV6-2	TRBJ1-3
TGCAGCTCCGGGACAGGGCCTCAGCCCCAGCATTTT	CSSGTGPQPQHF	TRBV29-1	TRBJ1-5
TGTGCCAGCATCGGGACAGACCGTTCACCCCTCCACTTT	CASIGTDRSPLHF	TRBV12-4	TRBJ1-6
TGTGCCATCAGCCCCGGGGCAGTATTTCGTCTTGAGCAGTTCTTC	CAISPGAVFRLEQFF	TRBV10-3	TRBJ2-1
TGTGCCAGTAGTGGGGGAGGGGTAAGGAGCAATCAGCCCCAGCATTTT	CASSGGGVRSNQPQHF	TRBV19	TRBJ1-5
TGTGCCAGCTCGACAGGGGACACAGATACGCAGTATTTT	CASSTGDTDTQYF	TRBV3-1	TRBJ2-3
TGCGCCAGCTGTCTGGGGTTGGCGAAAGCTTTCTTT	CASCLGLAKAFF	TRBV5-1	TRBJ1-1
TGTGCCAGCAGCTTAGGTGGAGGCCGAGACAGGGGGGCAACTAATGAAAAACTGTTTTTT	CASSLGGGRDRGATNEKLFF	TRBV7-7	TRBJ1-4
TGTGCCAGCAGCCTAGTGAGGTCAGCAACTAATGAAAAACTGTTTTTT	CASSLVRSATNEKLFF	TRBV4-2	TRBJ1-4
TGTGCCAGCAGTTTTACCAGGACTAGCGGGGACACAGATACGCAGTATTTT	CASSFTRTSGDTDTQYF	TRBV27	TRBJ2-3
TGTGCCAGCTCTGGGAGGGGACCGAGCACAGATACGCAGTATTTT	CASSGRGPSTDTQYF	TRBV6-3	TRBJ2-3
TGTGCCAGACGACTAGCGGGGGGGCTGGGCATAAATGAGCAGTTCTTC	CARRLAGGLGINEQFF	TRBV27	TRBJ2-1
TGTGCCAGCAGGAGGGGGACGGCTACCATTCAGTACTTC	CASRRGTATIQYF	TRBV6-2	TRBJ2-4
TGTGCCAGCAGTGAAGCGCCCCCCCCGAGACAGGCCAGAAGAAATGGCTACACCTTC	CASSEAPPPRQARRNGYTF	TRBV2	TRBJ1-2
TGTGCCATCACCCTATCAGGATTTCAGCCCCAGCATTTT	CAITLSGFQPQHF	TRBV10-3	TRBJ1-5
TGTGCTAGTGTTCGGGGGGAAGACTCTACAATTGAAGCTTTCTTT	CASVRGEDSTIEAFF	TRBV12-5	TRBJ1-1
TGTGCCAGCAGCCAAGAGAGGGACCAAGAAAAACTGTTTTTT	CASSQERDQEKLFF	TRBV3-1	TRBJ1-4
TGTGCCAGCAGCCTGACCTACGAGCAGTACTTC	CASSLTYEQYF	TRBV7-2	TRBJ2-7
TGCGCCAGCAGCCAGTCCCCAATTGGGGAGAACACTGAAGCTTTCTTT	CASSQSPIGENTEAFF	TRBV4-1	TRBJ1-1
TGCAGTGCTATCGGGGGGGTAGAAACTGGCACAGATACGCAGTATTTT	CSAIGGVETGTDTQYF	TRBV20-1	TRBJ2-3
TGTGCACTGAAACAGGGTACGTACTATGGCTACACCTTC	CALKQGTYYGYTF	TRBV2	TRBJ1-2
TGTGCCATCCCCCCCGAAACTCTAGCGGGAGGGTCAGATACGCAGTATTTT	CAIPPETLAGGSDTQYF	TRBV28	TRBJ2-3
TGTGCCATCAGTGAAAGGGGTAGGGGGACTGAAGCTTTCTTT	CAISERGRGTEAFF	TRBV10-3	TRBJ1-1
TGTGCCAGCAGCCAAGAGTTGGCGGCATCTCACAATCAGCCCCAGCATTTT	CASSQELAASHNQPQHF	TRBV3-1	TRBJ1-5
TGTGCCAGCAGCTCCAAGGGACTAGGCTTCTCCTACAATGAGCAGTTCTTC	CASSSKGLGFSYNEQFF	TRBV5-6	TRBJ2-1
TGTGCCAGCAGTGAAGGCAGGGACGGCCTGGATTCACCCCTCCACTTT	CASSEGRDGLDSPLHF	TRBV25-1	TRBJ1-6
TGTGCCAGCACGTCTAACAGGGAGGGGTTGGGTACCCTGAACACTGAAGCTTTCTTT	CASTSNREGLGTLNTEAFF	TRBV6-4	TRBJ1-1
TGTGCCAGCAGCTTAGGGGACAGGTATAGCTACGAGCAGTACTTC	CASSLGDRYSYEQYF	TRBV11-2	TRBJ2-7
TGTGCCAGCAAAAGACCTAGCGGGCAGTACTTC	CASKRPSGQYF	TRBV7-4	TRBJ2-7
TGTGCCACCAAGAGGTCACCTAGACAGGCCAGTCAGCCCCAGCATTTT	CATKRSPRQASQPQHF	TRBV24-1	TRBJ1-5
TGTGCCAGCAGTTTATGGAGCGGCACAGATACGCAGTATTTT	CASSLWSGTDTQYF	TRBV27	TRBJ2-3
TGTGCCACGCTGGGTTCCGTAGCCGAGACCCAGTACTTC	CATLGSVAETQYF	TRBV24-1	TRBJ2-5
TGTGCCAGCAGCGTGACAGGGGTAGAGTTTCGCAATCAGCCCCAGCATTTT	CASSVTGVEFRNQPQHF	TRBV9	TRBJ1-5
TGCGCCAAAAAGGTAAGCTATGGCTACACCTTC	CAKKVSYGYTF	TRBV10-1	TRBJ1-2
TGTGCCAGCACGCATATTCCAGTCTCTGGCTACACCTTC	CASTHIPVSGYTF	TRBV6-5	TRBJ1-2
TGTGCCAGCAGCCAAGAGGGCGGCGGAAACACCATATATTTT	CASSQEGGGNTIYF	TRBV11-3	TRBJ1-3
TGTGCCAGCAGTTCTAGGCCACAGTATCAGCCCCAGCATTTT	CASSSRPQYQPQHF	TRBV6-5	TRBJ1-5
TGCGCCAGCAGCTTGGCCCGAGGGCGGCTGGCTAGCACAGATACGCAGTATTTT	CASSLARGRLASTDTQYF	TRBV5-1	TRBJ2-3
TGTGCCAGCAGCTTCGGAGACACCATATATTTT	CASSFGDTIYF	TRBV11-2	TRBJ1-3
TGTGCCAGCAGCTTAGTACACGACAGGAATGAAAAACTGTTTTTT	CASSLVHDRNEKLFF	TRBV7-9	TRBJ1-4
TGTGCCAGCAGCCGGGGGCGCAAAAACATTCAGTACTTC	CASSRGRKNIQYF	TRBV7-2	TRBJ2-4
TGCGCCAGCAGCCGGGCCACGAATGAGCAGTTCTTC	CASSRATNEQFF	TRBV5-1	TRBJ2-1
TGTGCCAGCAGCTGTGGACAGGTTATGAACACTGAAGCTTTCTTT	CASSCGQVMNTEAFF	TRBV5-6	TRBJ1-1
TGCAGCGTTGGTTGCGGGAGGAGTCTCCGCAATCAGCCCCAGCATTTT	CSVGCGRSLRNQPQHF	TRBV29-1	TRBJ1-5
TGTGCCAGCGTGGGACACGAGCAGTACTTC	CASVGHEQYF	TRBV6-5	TRBJ2-7
TGTGCCAGCCCTAGGGGTGGATCGCCCCAGCATTTT	CASPRGGSPQHF	TRBV13	TRBJ1-5
TGTGCCAGCAGTCCCAAGGACAGTCGTGGCTACACCTTC	CASSPKDSRGYTF	TRBV12-3	TRBJ1-2
TGTGCCAGCAGTTTCTGGATCACTGAAGCTTTCTTT	CASSFWITEAFF	TRBV27	TRBJ1-1
TGTGCCAGCAGCCCTAAAACACAGGGGAAATTGTTTTATAGCAATCAGCCCCAGCATTTT	CASSPKTQGKLFYSNQPQHF	TRBV5-4	TRBJ1-5
TGTGCCAGCAGCCTGTCAGGGATTGACACCCATTCACCCCTCCACTTT	CASSLSGIDTHSPLHF	TRBV7-8	TRBJ1-6
TGTGCCAGCAGCCGGGACAGGGGATGTAATGGCTACACCTTC	CASSRDRGCNGYTF	TRBV7-2	TRBJ1-2
TGCGCCAGCAGCTTTTCGACAGCGCGCCTTCCCGGGGAGCTGTTTTTT	CASSFSTARLPGELFF	TRBV5-1	TRBJ2-2
TGTGCCAGGACTTGGGGCGAGCAGTACTTC	CARTWGEQYF	TRBV27	TRBJ2-7
TGTGCCAGCAGCGTAGGGACCAGAGGACTAGCGATGGCCTACGAGCAGTACTTC	CASSVGTRGLAMAYEQYF	TRBV9	TRBJ2-7
TGTGCCAGCAGCGTATGCGGGAGTTACATTCAGTACTTC	CASSVCGSYIQYF	TRBV9	TRBJ2-4
TGCGCCAGCAGCGGGGGACAGGGGAACACCGGGGAGCTGTTTTTT	CASSGGQGNTGELFF	TRBV5-1	TRBJ2-2
TGTGCTAGTGGTTTGGTCGTCCCGGGACTAGCGGGGGGGATCCCCTGTACGGGCTACGAGCAGTACTTC	CASGLVVPGLAGGIPCTGYEQYF	TRBV12-5	TRBJ2-7
TGCGCCAGCAGCTACCCACGCCCCGAGGGACAGAGAGGATACAATGAGCAGTTCTTC	CASSYPRPEGQRGYNEQFF	TRBV5-1	TRBJ2-1
TGTGCCAGTAGGGAGAGCGGGCTAATACCCTCCTACGAGCAGTACTTC	CASRESGLIPSYEQYF	TRBV19	TRBJ2-7
TGCGCCAGCAAATCGGAGCGGCTGGTAGGTACGCAGTATTTT	CASKSERLVGTQYF	TRBV5-1	TRBJ2-3
TGTGCCAGCAGCTTAGGTAGGCTTACAGGGGAGATACTTCTAACTGAAGCTTTCTTT	CASSLGRLTGEILLTEAFF	TRBV7-9	TRBJ1-1
TGCAGTGCTAGAGGGTCCAAAGAGGGGGGGACAGTGGATGAGCAGTTCTTC	CSARGSKEGGTVDEQFF	TRBV20-1	TRBJ2-1
TGTGCCAGCAGCAACATCCGCCCTCTTTCTAATGAGCAGTTCTTC	CASSNIRPLSNEQFF	TRBV27	TRBJ2-1
TGCGCCAGCAGCTGGGGGGGGACCGGGGAGCTGTTTTTT	CASSWGGTGELFF	TRBV10-1	TRBJ2-2
TGTGCCAGCGGCCAACCTCTAGCGGGGGCCTACAATGAGCAGTTCTTC	CASGQPLAGAYNEQFF	TRBV2	TRBJ2-1
TGTGCCAGCAGCCAAGCCGGCGAAGAGACCCAGTACTTC	CASSQAGEETQYF	TRBV3-1	TRBJ2-5
TGTGCCACCAGTGTCGACGAAATCAGACAGGGGAACACTGAAGCTTTCTTT	CATSVDEIRQGNTEAFF	TRBV24-1	TRBJ1-1
TGTGCCAGCAGTTACTCGCCTGTAGTGGGTAACAATGAGCAGTTCTTC	CASSYSPVVGNNEQFF	TRBV6-5	TRBJ2-1
TGTGCCAGCAGCGTATTGGGACAAGGGTTGGACAAAAACATTCAGTACTTC	CASSVLGQGLDKNIQYF	TRBV7-3	TRBJ2-4
TGCATTAGGACTAGCGCAGAGGTGAGAAACGGATGGTACGAGCAGTACTTC	CIRTSAEVRNGWYEQYF	TRBV20-1	TRBJ2-7
TGTGCCATTGACAGGGACCGGGACATTCAGTACTTC	CAIDRDRDIQYF	TRBV27	TRBJ2-4
TGTGCCAGCAGCTTGTCGAACCTAGGATACGAGCAGTACTTC	CASSLSNLGYEQYF	TRBV5-4	TRBJ2-7
TGCAGCGTTGAGGCACTGCGCGGGAGGGCCGGGGAGCTGTTTTTT	CSVEALRGRAGELFF	TRBV29-1	TRBJ2-2
TGTGCCAGCATTAGGGCAGGATCCTACGAGCAGTACTTC	CASIRAGSYEQYF	TRBV27	TRBJ2-7
TGCAGTGCTAGAGATGTTCTTGCCGACAGGGACTCCTCCTACGAGCAGTACTTC	CSARDVLADRDSSYEQYF	TRBV20-1	TRBJ2-7
TGTGCCACCAGTGGCAGATTCTGGGTCTTC	CATSGRFWVF	TRBV24-1	TRBJ2-1
TGCAGTGCTAGGTGGAGGGGGCGGATCGAGCAGTACTTC	CSARWRGRIEQYF	TRBV20-1	TRBJ2-7
TGCAGTGCTAGAGATGAAACTGGCACCGGGGAGCTGTTTTTT	CSARDETGTGELFF	TRBV20-1	TRBJ2-2
TGTGCCAGCAGCACGGCCCGGGGGACTGACGAGCAGTACTTC	CASSTARGTDEQYF	TRBV7-3	TRBJ2-7
TGCAGTGCTCGAGGGGGGGCCGGGATGGGGACCTACAATGAGCAGTTCTTC	CSARGGAGMGTYNEQFF	TRBV20-1	TRBJ2-1
TGTGCCAGCAGCAGGTCATTCCGGACGGTTGAGACCCAGTACTTC	CASSRSFRTVETQYF	TRBV7-3	TRBJ2-5
TGTGCCATCAGTGAAGACTTAGGCAGGGCAGATACGCAGTATTTT	CAISEDLGRADTQYF	TRBV10-3	TRBJ2-3
TGCAGTGCTAGAAAGACAGGGGGAGACAACTATGGCTACACCTTC	CSARKTGGDNYGYTF	TRBV20-1	TRBJ1-2
TGTGCCAGCAGCATCTACGTGGGGGAGACCCAGTACTTC	CASSIYVGETQYF	TRBV13	TRBJ2-5
TGTGCTAGTGGTTTGCATTGGACAGGGCCGAATGGCTACACCTTC	CASGLHWTGPNGYTF	TRBV12-5	TRBJ1-2
TGCAGTGCTAGAGACGTCCTCCGGGACCTCTGGTTCCATACGCAGTATTTT	CSARDVLRDLWFHTQYF	TRBV20-1	TRBJ2-3
TGTGCCATCAGTGAGGGACAGGGTAGCAATCAGCCCCAGCATTTT	CAISEGQGSNQPQHF	TRBV10-3	TRBJ1-5
TGTGCCAGCACCTATGGGACTCGACGTTACCGTCCCCATTTACACTCTGGAAACACCATATATTTT	CASTYGTRRYRPHLHSGNTIYF	TRBV6-8	TRBJ1-3
TGTGCCAGCAGCACCCACGGTTGGACAGGCCGTTCACCCCTCCACTTT	CASSTHGWTGRSPLHF	TRBV7-2	TRBJ1-6
TGTGCCAGCAGTGACGGACTAGCGGACAACAATGAGCAGTTCTTC	CASSDGLADNNEQFF	TRBV6-4	TRBJ2-1
TGTGCCAGCACCTTCATAGGGCGATGTTCCCCCAGCTCTGGAAACACCATATATTTT	CASTFIGRCSPSSGNTIYF	TRBV28	TRBJ1-3
TGTGCCAGCAGCCCATGGCGGACAGATACGCAGTATTTT	CASSPWRTDTQYF	TRBV7-4	TRBJ2-3
TGTGCCAGCAGCTCCCGTAACCCACAAGAGACCCAGTACTTC	CASSSRNPQETQYF	TRBV7-3	TRBJ2-5
TGTGCCAGCAGCCCTGACAGGGGGCGTTCCCGCTGTTCACCCCTCCACTTT	CASSPDRGRSRCSPLHF	TRBV7-9	TRBJ1-6
TGCGCCAGCAGCACCGGGACAGGGACGGACTATGGCTACACCTTC	CASSTGTGTDYGYTF	TRBV5-1	TRBJ1-2
TGTGCCAGCAGCTATCAACTAGCGGGAGTCGGCTACGAGCAGTACTTC	CASSYQLAGVGYEQYF	TRBV11-2	TRBJ2-7
TGCAGTGCTAGGGGCTCCACAGATACGCAGTATTTT	CSARGSTDTQYF	TRBV20-1	TRBJ2-3
TGTGCCAGTAGTATGCTTGGGTGGACTAGCGGGGGGGCTACCAATGAGCAGTTCTTC	CASSMLGWTSGGATNEQFF	TRBV19	TRBJ2-1
TGTGCCAGCTCACCTCTTGTGCAAGAGACCCAGTACTTC	CASSPLVQETQYF	TRBV18	TRBJ2-5
TGTGCCAGCACATTATACGATAAACGATTGGACTCTCATGGCTACACCTTC	CASTLYDKRLDSHGYTF	TRBV4-2	TRBJ1-2
TGTGCCAGCAGTTTGGAACACCCAGGGGGGAACACCGGGGAGCTGTTTTTT	CASSLEHPGGNTGELFF	TRBV12-4	TRBJ2-2
TGTGCCAGCAGTGTGAGGGGGGGACGCGAGCAGTACTTC	CASSVRGGREQYF	TRBV6-1	TRBJ2-7
TGCGCCAGCAGCCAATGGGACAGAGGGACCGGGGAGCTGTTTTTT	CASSQWDRGTGELFF	TRBV4-1	TRBJ2-2
TGCGCCAGCAGCCAAGATTATTTTTTAGTCGATCAGGGGGCGAGGCAGCCCCAGCATTTT	CASSQDYFLVDQGARQPQHF	TRBV4-1	TRBJ1-5
TGCGCCAGCAGCTCGGAAGGACAGGGGAGGTACGAGCAGTACTTC	CASSSEGQGRYEQYF	TRBV10-1	TRBJ2-7
TGTGCCAGCAGTTTCCACCAGACGGGGGCGTCCTATTCACCCCTCCACTTT	CASSFHQTGASYSPLHF	TRBV6-2	TRBJ1-6
TGTGCCAGTAGTAGCATCTTAAACACTAGCGGGAGAAACACCGGGGAGCTGTTTTTT	CASSSILNTSGRNTGELFF	TRBV19	TRBJ2-2
TGTGCCAGCAGTTTTAGGGGACTAGCGGTGAAAAGTGAGCAGTTCTTC	CASSFRGLAVKSEQFF	TRBV12-3	TRBJ2-1
TGCGCCAGCAGCCAAGATAGGGGACAGTTGTCTGAAGCTTTCTTT	CASSQDRGQLSEAFF	TRBV4-3	TRBJ1-1
TGTGCCAGCAGGGCTAGCGGGTCAAATGAGCAGTTCTTC	CASRASGSNEQFF	TRBV27	TRBJ2-1
TGTGCCAGCAGGAACTGGGGGGCAAACACCATATATTTT	CASRNWGANTIYF	TRBV9	TRBJ1-3
TGTGCCAGCAGTGAAGCGTGTTGCCGAGGGGAGGATGAAGCTTTCTTT	CASSEACCRGEDEAFF	TRBV2	TRBJ1-1
TGTGCCACCAGTGACCGAAGCTTTAATGAGCAGTTCTTC	CATSDRSFNEQFF	TRBV24-1	TRBJ2-1
TGTGCCAGCCATACAGTAGCGGGGAACACAGATACGCAGTATTTT	CASHTVAGNTDTQYF	TRBV7-7	TRBJ2-3
TGTGCCAGCAGCGGCTTCACAATTGGAAACACCATATATTTT	CASSGFTIGNTIYF	TRBV9	TRBJ1-3
TGTGCCAGCAGTTACAGGACTAGCGGGACTAGGGCTACCAATGAGCAGTTCTTC	CASSYRTSGTRATNEQFF	TRBV6-6	TRBJ2-1
TGCGCCAGCAGTGGGACGCCTTCCTATAGCAATCAGCCCCAGCATTTT	CASSGTPSYSNQPQHF	TRBV10-1	TRBJ1-5
TGTGCCAGCAGCAGACAGGGGGGCCTGAGCTCCTACGAGCAGTACTTC	CASSRQGGLSSYEQYF	TRBV7-9	TRBJ2-7
TGCAGTGCTAGAGATGTTGGGTATAATTGGGGGGGGGATGAAAAACTGTTTTTT	CSARDVGYNWGGDEKLFF	TRBV20-1	TRBJ1-4
TGTGCCAGCAGCAATGACCGGGGGGCCTCCTACGAGCAGTACTTC	CASSNDRGASYEQYF	TRBV7-3	TRBJ2-7
TGTGCCAGTCAAGGAGAGACCCAGTACTTC	CASQGETQYF	TRBV6-5	TRBJ2-5
TGTGCCATCCCCACAGGGATCGTCGATCAGCCCCAGCATTTT	CAIPTGIVDQPQHF	TRBV28	TRBJ1-5
TGCAGTGCTAGACCGTTGGACAGGGGTTTCAATCAGCCCCAGCATTTT	CSARPLDRGFNQPQHF	TRBV20-1	TRBJ1-5
TGTGCCAGCAGTTCCCGGAGGGGGCGCCCTATTCGTTTCTACGAGCAGTACTTC	CASSSRRGRPIRFYEQYF	TRBV12-4	TRBJ2-7
TGTGCCTGGACAGGGGGGGACTATGGCTACACCTTC	CAWTGGDYGYTF	TRBV30	TRBJ1-2
TGTGCCAGCAGTGATTGTACAGTTGACAGGCTCCACTTT	CASSDCTVDRLHF	TRBV25-1	TRBJ1-6
TGTGCCAGCTCACCAAACTTCGAGGGATACGAGCAGTACTTC	CASSPNFEGYEQYF	TRBV18	TRBJ2-7
TGCGCCAGCATGTGGGCCGATAACTCCTACAATGAGCAGTTCTTC	CASMWADNSYNEQFF	TRBV10-1	TRBJ2-1
TGCGCCAGCATCCTTGTGGGGGTAGGAAACCAAGAGACCCAGTACTTC	CASILVGVGNQETQYF	TRBV10-2	TRBJ2-5
TGTGCCAGCAGCGTAGGGGTAGCAGGGCCGGTTAACTATGGCTACACCTTC	CASSVGVAGPVNYGYTF	TRBV9	TRBJ1-2
TGCGCCAGCAGCTTGCCGAGCTCTCGACAGGGCTATGGCTACACCTTC	CASSLPSSRQGYGYTF	TRBV5-1	TRBJ1-2
TGCGCCAGCAGCAAGGGGGACAGAGTTGGATACAATGAGCAGTTCTTC	CASSKGDRVGYNEQFF	TRBV5-1	TRBJ2-1
TGTGCCAGCAGTTACCGGGGACGATCACGGGCCTCCTATAATTCACCCCTCCACTTT	CASSYRGRSRASYNSPLHF	TRBV6-5	TRBJ1-6
TGTGCCAGCAGCTTCCAAACCGACAGGAGGGATAATTCACCCCTCCACTTT	CASSFQTDRRDNSPLHF	TRBV13	TRBJ1-6
TGTGCCATCAGTAAGGGGTCTTTAACAGATACGCAGTATTTT	CAISKGSLTDTQYF	TRBV10-3	TRBJ2-3
TGTGCCAGCAGCACCGTAGGGGGGCCGGTGAACACCGGGGAGCTGTTTTTT	CASSTVGGPVNTGELFF	TRBV6-5	TRBJ2-2
TGTGCCAGCAGCCTCGGAACAGGGCAACGCGAGCAGTACTTC	CASSLGTGQREQYF	TRBV13	TRBJ2-7
TGTGCCACCAGCAGAGAAAATATCTACGAAAGAAGGGCGCGGAGTCTCAGCTCTGGGGCCAACGTCCTGACTTTC	CATSRENIYERRARSLSSGANVLTF	TRBV15	TRBJ2-6
TGTGCCAGCAGCTTAGCCGCTGGGTATACGCAGTATTTT	CASSLAAGYTQYF	TRBV11-3	TRBJ2-3
TGTGCCAGCAGTGACTCCTTTGCTAGCGGGGAGGAAGATACGCAGTATTTT	CASSDSFASGEEDTQYF	TRBV6-4	TRBJ2-3
TGTGCCAGCAGCTTGGAGAGGTTCTTCGACGGCGAGGGAGATACGCAGTATTTT	CASSLERFFDGEGDTQYF	TRBV5-6	TRBJ2-3
TGTGCCAGCAGCTTAGCGGGGTACGACAGGGGCGACTATGGCTACACCTTC	CASSLAGYDRGDYGYTF	TRBV7-9	TRBJ1-2
TGTGCCAGCCCAGTCCACGGGGGGGCCATTGTAGCCAAAAACATTCAGTACTTC	CASPVHGGAIVAKNIQYF	TRBV9	TRBJ2-4
TGTGCCAGCAACCAGGCTCCCAGGGGCGATTCCTACGAGCAGTACTTC	CASNQAPRGDSYEQYF	TRBV7-4	TRBJ2-7
TGTGCCAGCAGGGGCACATGTTACAGCGAGACCCAGTACTTC	CASRGTCYSETQYF	TRBV6-5	TRBJ2-5
TGTGCCAGTAGTATGACGGTTTCTACGCTAGGGCCCCAGCATTTT	CASSMTVSTLGPQHF	TRBV19	TRBJ1-5
TGCGCCAGCAGTGTTGGTCGGGGGGGGGAAAGACCCTACGAGCAGTACTTC	CASSVGRGGERPYEQYF	TRBV10-1	TRBJ2-7
TGCGCCAGCAGGAAGGGGCGAGGGACCGGGGAGCTGTTTTTT	CASRKGRGTGELFF	TRBV4-1	TRBJ2-2
TGTGCCAGCAGCCAAGATCCGGGGCTAGAGACCCAGTACTTC	CASSQDPGLETQYF	TRBV4-2	TRBJ2-5
TGTGCCAGCACCAAACAACAGGGGGCCCAGATGAACACTGAAGCTTTCTTT	CASTKQQGAQMNTEAFF	TRBV7-4	TRBJ1-1
TGTGCCAGCACACCCGGGACAGATTTAGGAGACACTGAAGCTTTCTTT	CASTPGTDLGDTEAFF	TRBV27	TRBJ1-1
TGTGCCAGCAGCATTCCAATATGTGGGAATTCACCCCTCCACTTT	CASSIPICGNSPLHF	TRBV7-3	TRBJ1-6
TGTGCCAGCAGCCCCCATCCCAACCCGGGACGGAAAGGCGGGGGTGCCTATAATTCACCCCTCCACTTT	CASSPHPNPGRKGGGAYNSPLHF	TRBV13	TRBJ1-6
TGTGCCAGCAGTGAAGGCACTAGCGGGATTCAAGAGACCCAGTACTTC	CASSEGTSGIQETQYF	TRBV2	TRBJ2-5
TGTGCCACCAGCAAAGGGGGCTTCGCTAACTATGGCTACACCTTC	CATSKGGFANYGYTF	TRBV15	TRBJ1-2
TGTGCCAGCTCGACAGGGGGCTCACCCCTCCACTTT	CASSTGGSPLHF	TRBV27	TRBJ1-6
TGTGCCAGCAGGGTCTTTAGTGGCCAATATTCCTATAATTCACCCCTCCACTTT	CASRVFSGQYSYNSPLHF	TRBV27	TRBJ1-6
TGTGCCCATACGCGGGACAGGACCGTGAACACTGAAGCTTTCTTT	CAHTRDRTVNTEAFF	TRBV5-5	TRBJ1-1
TGCGCCAGCATCATAACTCAGCCCCAGCATTTT	CASIITQPQHF	TRBV10-1	TRBJ1-5
TGCGCCAGCAGCGCAAACCCAAGAAGCGAGGGAAATGAGCAGTTCTTC	CASSANPRSEGNEQFF	TRBV5-1	TRBJ2-1
TGTGCCAGCAGCCCTACGACCGGGACAGGGCGCGAGCAGTACTTC	CASSPTTGTGREQYF	TRBV13	TRBJ2-7
TGCAGCGTTGACTCGCGAGGACAGATTTCTGGAAACACCATATATTTT	CSVDSRGQISGNTIYF	TRBV29-1	TRBJ1-3
TGTGCCACCAGTGACGCAGGGGGCAGGTACTATGGCTACACCTTC	CATSDAGGRYYGYTF	TRBV24-1	TRBJ1-2
TGTGCCTGGAATACAGGGAGTAACTATGGCTACACCTTC	CAWNTGSNYGYTF	TRBV30	TRBJ1-2
TGTAACCGGGACAGATTAGAGCAGTACTTC	CNRDRLEQYF	TRBV20-1	TRBJ2-7
TGCGCCAGCAGCAAATCACGGACAGGTACCCAAGAGACCCAGTACTTC	CASSKSRTGTQETQYF	TRBV10-1	TRBJ2-5
TGTGCCATCATCCGGGGAACCGATAGCAATCAGCCCCAGCATTTT	CAIIRGTDSNQPQHF	TRBV10-3	TRBJ1-5
TGTGCCAGCACACGGAGTAGTGGGGGAGACCCAGCTTTCTTT	CASTRSSGGDPAFF	TRBV2	TRBJ1-1
TGTGCCAGCAGTGAGTTCAGGGGGCTCTCCTGCTCCTACGAGCAGTACTTC	CASSEFRGLSCSYEQYF	TRBV25-1	TRBJ2-7
TGTGCCAGCAGCACGACCTTCCAGCCCCAGCATTTT	CASSTTFQPQHF	TRBV13	TRBJ1-5
TGTGCCAGCAGTTTACAGGGTGGCACAGATACGCAGTATTTT	CASSLQGGTDTQYF	TRBV27	TRBJ2-3
TGCGCCAGCAGCCGTCGCAGAGGGGAGGAAGATACGCAGTATTTT	CASSRRRGEEDTQYF	TRBV5-1	TRBJ2-3
TGCGCCAGCAGAGCGGACGGTCGGAACACTGAAGCTTTCTTT	CASRADGRNTEAFF	TRBV10-1	TRBJ1-1
TGTGCCAGTAGTGTAGGGTATCGCACAGATACGCAGTATTTT	CASSVGYRTDTQYF	TRBV19	TRBJ2-3
TGCGCCAGCAGAAGGTGGGGTAACACTGAAGCTTTCTTT	CASRRWGNTEAFF	TRBV10-2	TRBJ1-1
TGTGCCAGTATCGGCGGGAGCAAAAACATTCAGTACTTC	CASIGGSKNIQYF	TRBV19	TRBJ2-4
TGTGCCAGCAGTGACGGGGGCTACGAGCAGTACTTC	CASSDGGYEQYF	TRBV6-1	TRBJ2-7
TGTGCCAGCACAACCGACTTTAGCAATCAGCCCCAGCATTTT	CASTTDFSNQPQHF	TRBV9	TRBJ1-5
TGCGCCAGCAGCAAAGGGGAGACTAAATATTTT	CASSKGETKYF	TRBV5-1	TRBJ2-3
TGCAGTGCTAGACCGGGACAGGTGGCCTACGAGCAGTACTTC	CSARPGQVAYEQYF	TRBV20-1	TRBJ2-7
TGCAGCGTTGCTCCCCCCCAGGCGGGGAACACTGAAGCTTTCTTT	CSVAPPQAGNTEAFF	TRBV29-1	TRBJ1-1
TGTGCCAGCAAAAGTTCAGTAACCACCTACGAGCAGTACTTC	CASKSSVTTYEQYF	TRBV28	TRBJ2-7
TGTGCCAGCAGCTTGTTTGGGATTACCTACGAGCAGTACTTC	CASSLFGITYEQYF	TRBV7-6	TRBJ2-7
TGTGCCAGCAGATTTTTGGCTCTCGAGCAGTACTTC	CASRFLALEQYF	TRBV6-2	TRBJ2-7
TGCGCCAGCAGAGGGGACAGGGTTGCTCAGCCCCAGCATTTT	CASRGDRVAQPQHF	TRBV10-1	TRBJ1-5
TGTGCCAACAGGGACAGGGGGTGGCAGCCCCAGCATTTT	CANRDRGWQPQHF	TRBV25-1	TRBJ1-5
TGTGCCAGTAGTCCGGGAGTTACCAGGGCTAGTCATCAGCCCCAGCATTTT	CASSPGVTRASHQPQHF	TRBV19	TRBJ1-5
TGTGCCAGCAGCTTGGACCTAAGGAACGGCTACGAGCAGTACTTC	CASSLDLRNGYEQYF	TRBV6-6	TRBJ2-7
TGTGCCAGCAGTTACTCGGCGACATGCACAGATACGCAGTATTTT	CASSYSATCTDTQYF	TRBV6-2	TRBJ2-3
TGCAACAAACAGGGAGGCAATTCACCCCTCCACTTT	CNKQGGNSPLHF	TRBV20-1	TRBJ1-6
TGCAGTGCTAGGTGTTCAGGGGCGTGTCAGCCCCAGCATTTT	CSARCSGACQPQHF	TRBV20-1	TRBJ1-5
TGCAGTGCTACGCGAATATACTTGGATGGGCAGCCCCAGCATTTT	CSATRIYLDGQPQHF	TRBV20-1	TRBJ1-5
TGTGCCTGGATACTTAAAGGGGAAAATCTCCAAAGAGGGAACACTGAAGCTTTCTTT	CAWILKGENLQRGNTEAFF	TRBV30	TRBJ1-1
TGTGCCAGCAGTTACTCGTCCAGGCGGAACCTAGTAAGACTAGGAGACGAGCAGTACTTC	CASSYSSRRNLVRLGDEQYF	TRBV6-3	TRBJ2-7
TGTGCCAGCACGCCAGGTAGGGATGGAAACACCATATATTTT	CASTPGRDGNTIYF	TRBV6-4	TRBJ1-3
TGTGCCAGCAAGCCTAGCGGGAGCTCCTACAATGAGCAGTTCTTC	CASKPSGSSYNEQFF	TRBV7-6	TRBJ2-1
TGTGCCAGCAGCCCGGAGGGTGGGGGCTATGGCTACACCTTC	CASSPEGGGYGYTF	TRBV12-4	TRBJ1-2
TGTGCCAGCAGCGCAGGAGAACTAGCAGATACGCAGTATTTT	CASSAGELADTQYF	TRBV11-3	TRBJ2-3
TGTGCCAGCAATTCAGCGGGAGCGATAGGGCTGAACGAGCAGTACTTC	CASNSAGAIGLNEQYF	TRBV27	TRBJ2-7
TGCCACTGGCCAGGGGGACTTGATAGCAATCAGCCCCAGCATTTT	CHWPGGLDSNQPQHF	TRBV20-1	TRBJ1-5
TGTGCCAGCAGCCCGTTACAGGGGTCGCAGTACTTC	CASSPLQGSQYF	TRBV2	TRBJ2-7
TGTGCCAGCAGGGGAACACCGGGACAGCACTTGGGAAATGAGCAGTTCTTC	CASRGTPGQHLGNEQFF	TRBV6-2	TRBJ2-1
TGTGCCAGCTGCGGACAGGCTGGGGCCAACGTCCTGACTTTC	CASCGQAGANVLTF	TRBV28	TRBJ2-6
TGCGCGGGGGCCTCAGGCTCTGAAGCTTTCTTT	CAGASGSEAFF	TRBV10-2	TRBJ1-1
TGTGCCAGCAGTGGCAACTGGGCCCAGGGTGTAGATCAGCCCCAGCATTTT	CASSGNWAQGVDQPQHF	TRBV6-4	TRBJ1-5
TGTGCCAGCAGTGGTACTAGCGGGAGTTTAGGAGGTGGGAATAGGCTGGGCCAAGAGACCCAGTACTTC	CASSGTSGSLGGGNRLGQETQYF	TRBV6-1	TRBJ2-5
TGTGCCACCCGGTCCGATAGGATAGGGAATCAGCCCCAGCATTTT	CATRSDRIGNQPQHF	TRBV24-1	TRBJ1-5
TGTGCCAGCAGCCCGGATAATGAAAAACTGTTTTTT	CASSPDNEKLFF	TRBV7-8	TRBJ1-4
TGTGCTAGTGGTTATCATACGGGACAGGGCGAGGTAAACACTGAAGCTTTCTTT	CASGYHTGQGEVNTEAFF	TRBV12-5	TRBJ1-1
TGCAGTGCTAGTGGGGGCTCCTACAATGAGCAGTTCTTC	CSASGGSYNEQFF	TRBV20-1	TRBJ2-1
TGTGCCAGCATCGTCGGGAAGACCCCGGGACTAAATTCACCCCTCCACTTT	CASIVGKTPGLNSPLHF	TRBV5-6	TRBJ1-6
TGCAGTGGATCGGGGGCGGCCAAAAACATTCAGTACTTC	CSGSGAAKNIQYF	TRBV20-1	TRBJ2-4
TGTGCCAGCAGTTCCGGGGGGCGAGGTGGCTCCTACGAGCAGTACTTC	CASSSGGRGGSYEQYF	TRBV6-6	TRBJ2-7
TGTGCCAGCAGCTTGGAACAGAGGGGCATAGTCTTC	CASSLEQRGIVF	TRBV7-8	TRBJ2-1
TGCAGTGCTAGACCTACGGGGACTCTAGAATCAGAGACCCAGTACTTC	CSARPTGTLESETQYF	TRBV20-1	TRBJ2-5
TGTGCCAGCAGCTTAGCCGGTAGCGGCTCCTACAATGAGCAGTTCTTC	CASSLAGSGSYNEQFF	TRBV11-2	TRBJ2-1
TGCGCCAAGGGACAGGGTTCCTACGAGCAGTACTTC	CAKGQGSYEQYF	TRBV10-2	TRBJ2-7
TGTGCCAGCAGCCCGGGGGGGCCCTACGAGCAGTACTTC	CASSPGGPYEQYF	TRBV9	TRBJ2-7
TGTGCCAGCAGCCGGGACAGGGCCTGGTTTGACTATGGCTACACCTTC	CASSRDRAWFDYGYTF	TRBV11-3	TRBJ1-2
TGCAGCGTCCACACGAGGGGAGATGAGCAGTTCTTC	CSVHTRGDEQFF	TRBV29-1	TRBJ2-1
TGTGCCACAAGGGGCGGCAATCAGCCCCAGCATTTT	CATRGGNQPQHF	TRBV24-1	TRBJ1-5
TGTGCCAGCAGCCAACGTGAGCCCGGGACAGCGAACACTGAAGCTTTCTTT	CASSQREPGTANTEAFF	TRBV3-1	TRBJ1-1
TGTGCCAGCAGCACCTCGGGGGGAGAGGTCGCGAACACCGGGGAGCTGTTTTTT	CASSTSGGEVANTGELFF	TRBV7-3	TRBJ2-2
TGTGCCAGCAGCTTGACGCAGACCGGGACAGCAGGCTACGAGCAGTACTTC	CASSLTQTGTAGYEQYF	TRBV5-4	TRBJ2-7
TGCAGGTACGACTCGGAGAGCAATCAGCCCCAGCATTTT	CRYDSESNQPQHF	TRBV20-1	TRBJ1-5
TGTGCCAGCAGCGCCAGGGGCACTGAAGCTTTCTTT	CASSARGTEAFF	TRBV7-2	TRBJ1-1
TGTGCCAGCAGCCACCCGGGGCCATACAATGAGCAGTTCTTC	CASSHPGPYNEQFF	TRBV7-3	TRBJ2-1
TGTGCCAGCAGCCAAGCTCGGACAGGGCGGGTGTTCTCTGGGGCCAACGTCCTGACTTTC	CASSQARTGRVFSGANVLTF	TRBV4-2	TRBJ2-6
TGTGCCAGCTCCCCCCGGGACGATACGCAGTATTTT	CASSPRDDTQYF	TRBV18	TRBJ2-3
TGCGCCAGCAGCCACCCGGTAACTGAAGCTTTCTTT	CASSHPVTEAFF	TRBV4-1	TRBJ1-1
TGCGCCAGCAGCGGGAGCAGGCCACAGGGGGCGAGTTACGAGCAGTACTTC	CASSGSRPQGASYEQYF	TRBV5-1	TRBJ2-7
TGTGCCAGCAGCCCTACAGGGAGTGGCACAGATACGCAGTATTTT	CASSPTGSGTDTQYF	TRBV7-4	TRBJ2-3
TGCGCCAGCAGCGGATTGGGGGGCCAGGCCCAGTACTTC	CASSGLGGQAQYF	TRBV10-1	TRBJ2-5
TGTGCCAGCAGCCCGAGGGCTCTGCGCGAAAACATTCAGTACTTC	CASSPRALRENIQYF	TRBV7-3	TRBJ2-4
TGTGCCAGCAGCTGCAGTATTACTGAAGCTTTCTTT	CASSCSITEAFF	TRBV7-3	TRBJ1-1
TGTGCCAGCAGTAATGTGGAAGAGACCCAGTACTTC	CASSNVEETQYF	TRBV6-1	TRBJ2-5
TGTGCCAGTAGTATAGTCAGAAATTCGGCGGACGAGCAGTACTTC	CASSIVRNSADEQYF	TRBV19	TRBJ2-7
TGCAGCGTCCCGGTCAAGGAGGGAGAGACCCAGTACTTC	CSVPVKEGETQYF	TRBV29-1	TRBJ2-5
TGTGCTAGTGGTTTGGTACCCCGGTCCGGCAATGAGCAGTTCTTC	CASGLVPRSGNEQFF	TRBV12-5	TRBJ2-1
TGTGCCAGCAGCCCTGGGGGGAGTGGCTACACCTTC	CASSPGGSGYTF	TRBV9	TRBJ1-2
TGTGCCAGCGCCGATTTTACGGGACTAGCGGATGAGCAGTTCTTC	CASADFTGLADEQFF	TRBV12-3	TRBJ2-1
TGTGCCAGCAGCGACGTCCGACGGGGGGGGGCCGGGGAGCTGTTTTTT	CASSDVRRGGAGELFF	TRBV5-4	TRBJ2-2
TGTGCCAGCAGTTACCCCTGGGGACAGATAAGACAAGAGACCCAGTACTTC	CASSYPWGQIRQETQYF	TRBV6-5	TRBJ2-5
TGTGCCAGCAGTGTGCCCGGGACTAACTATGGCTACACCTTC	CASSVPGTNYGYTF	TRBV6-1	TRBJ1-2
TGTGCCAGCAGGTCGATACTCGACACAGATACGCAGTATTTT	CASRSILDTDTQYF	TRBV6-4	TRBJ2-3
TGTGCCAGTAGTATACGAGACCATTGCTACCGGGACAGCCAAGAGCAGTACTTC	CASSIRDHCYRDSQEQYF	TRBV19	TRBJ2-7
TGTGCTAGTGGAACCCCCCTAGGTCACAATGAGCAGTTCTTC	CASGTPLGHNEQFF	TRBV12-5	TRBJ2-1
TGCGCCAGCAGCCATCTGGGGACAGGGGAATGGGGAGAAAAACTGTTTTTT	CASSHLGTGEWGEKLFF	TRBV4-1	TRBJ1-4
TGTGCTAGCAGCTTAGCTAGGGGCACTGAAGCTTTCTTT	CASSLARGTEAFF	TRBV7-7	TRBJ1-1
TGTGCCAGGTTTTCTAGTGGCAGGAGCTCTGGAAACACCATATATTTT	CARFSSGRSSGNTIYF	TRBV6-4	TRBJ1-3
TGTGCCAGCAGCTTAAGAGGGGCGAGGGAAGGCTACGAGCAGTACTTC	CASSLRGAREGYEQYF	TRBV7-2	TRBJ2-7
TGCGCCAGCAGTTGGAGGGGTCCTAATGAAAAACTGTTTTTT	CASSWRGPNEKLFF	TRBV10-1	TRBJ1-4
TGTGCCAGCAGCCCAAGCGGGAACGAGCAGTACTTC	CASSPSGNEQYF	TRBV2	TRBJ2-7
TGCAGTGCAGGGGGCTTTCTTTTAGAGCAGTTCTTC	CSAGGFLLEQFF	TRBV20-1	TRBJ2-1
TGTGCCAGCAGCTTAGACGCCCGGGGGTCGCAGTACTTC	CASSLDARGSQYF	TRBV7-2	TRBJ2-7
TGTGCCAGCGGGACAGGGACCGGGGAGCTGTTTTTT	CASGTGTGELFF	TRBV9	TRBJ2-2
TGTGCCAGCATCCCCCGGCCCAGGGAAGCGACTGAAGCTTTCTTT	CASIPRPREATEAFF	TRBV6-5	TRBJ1-1
TGTGCCAGTGGGGGGGAGTACACCTTC	CASGGEYTF	TRBV6-4	TRBJ1-2
TGTGCCAGCAGCTTCTACCAAGAGACCCAGTACTTC	CASSFYQETQYF	TRBV3-1	TRBJ2-5
TGTGCCAGCACGACGGGGGGGCGTTTTCCCTATGGCTACACCTTC	CASTTGGRFPYGYTF	TRBV6-2	TRBJ1-2
TGTGCCAGCAGGGGGGAGAGCGAGCAGTACTTC	CASRGESEQYF	TRBV27	TRBJ2-7
TGCGCCAGCAGCTCCGGGGGGGGGAACACTGAAGCTTTCTTT	CASSSGGGNTEAFF	TRBV5-1	TRBJ1-1
TGTGCCAGCAGCCAGTTGAGGAGTGAAGCTTTCTTT	CASSQLRSEAFF	TRBV7-3	TRBJ1-1
TGTGCCAGCAGCCATAGGGAGACCCAGTACTTC	CASSHRETQYF	TRBV5-6	TRBJ2-5
TGTGCCAGCAGCACTCGCCTACGCAATGAGCAGTTCTTC	CASSTRLRNEQFF	TRBV9	TRBJ2-1
TGTGCCAAAGGGGGCGTTAGCACAGATACGCAGTATTTT	CAKGGVSTDTQYF	TRBV24-1	TRBJ2-3
TGTGCCACCAGTGGATCTAATCCAGGGGAGACTCGCTACACCTTC	CATSGSNPGETRYTF	TRBV24-1	TRBJ1-2
TGTCAGACTATTAGCAATCAGCCCCAGCATTTT	CQTISNQPQHF	TRBV11-2	TRBJ1-5
TGCGCCAGCAGTGAGCCCAAGCAGGGGGGTGGTGAGCAGTTCTTC	CASSEPKQGGGEQFF	TRBV10-1	TRBJ2-1
TGTGCCGGAACCCTGGGCAACATAAACGAGCAGTACTTC	CAGTLGNINEQYF	TRBV14	TRBJ2-7
TGTGCATCAGCTAATCAGCCCCAGCATTTT	CASANQPQHF	TRBV11-3	TRBJ1-5
TGTGCCAGCAGCCAAGATGGGTCGGGGTGTAGGGGCTACACCTTC	CASSQDGSGCRGYTF	TRBV4-2	TRBJ1-2
TGTGCCAGCAGTTTCTGTATACAGGGCATCATCTGCAATCAGCCCCAGCATTTT	CASSFCIQGIICNQPQHF	TRBV12-4	TRBJ1-5
TGTGCCAGCAGCTCCGAACCTCAAGAGACCCAGTACTTC	CASSSEPQETQYF	TRBV9	TRBJ2-5
TGTGCCAGCAGTCCCGGACCGGACAGCGATGGCTACACCTTC	CASSPGPDSDGYTF	TRBV6-5	TRBJ1-2
TGTGCTAGTGGTTTGGGCCTCCGGACAGGGCCCACAGATACGCAGTATTTT	CASGLGLRTGPTDTQYF	TRBV12-5	TRBJ2-3
TGTGCCAGCAGCTTACCGATCTGGCGGGTGTACGAGCAGTACTTC	CASSLPIWRVYEQYF	TRBV11-3	TRBJ2-7
TGTGCCACCCTTCCCGAAGGGACGGGTGTCAGTGGCTACACCTTC	CATLPEGTGVSGYTF	TRBV24-1	TRBJ1-2
TGTGCCACCAGCAGAGATTCCACTCGAATTGAGCAGTTCTTC	CATSRDSTRIEQFF	TRBV15	TRBJ2-1
TGTGCCACGGAGGAGAACCAGCCCCAGCATTTT	CATEENQPQHF	TRBV6-5	TRBJ1-5
TGTGCCAGCACAAGGCCCGGTGCCAATGGCTACACCTTC	CASTRPGANGYTF	TRBV12-4	TRBJ1-2
TGTGCCTGGAGTGGGTACCCATTGGGTGGGGGGGGATCCTACGAGCAGTACTTC	CAWSGYPLGGGGSYEQYF	TRBV30	TRBJ2-7
TGTGCCAGCAGCTTTCAGGGGGCGCCGGGTTGGAACTACGAGCAGTACTTC	CASSFQGAPGWNYEQYF	TRBV5-4	TRBJ2-7
TGTGCCAGCAGCGTAGGGGGGCGTTCGCTGAGGAACAATGAGCAGTTCTTC	CASSVGGRSLRNNEQFF	TRBV9	TRBJ2-1
