TGCAGTGCTCCCGGAGGCCGAGGAGGAAAACTGTTTTTT	CSAPGGRGGKLFF	TRBV20-1	TRBJ1-4
TGTGCCAGCAAACCGACAGGCGACACCGGGGAGCTGTTTTTT	CASKPTGDTGELFF	TRBV11-3	TRBJ2-2
TGCAGTACAGCGACGGTCTACACCATATATTTT	CSTATVYTIYF	TRBV20-1	TRBJ1-3
TGTGCCACCAGTGATCCATCGACAGGGGGCAACCAGTGGGGCTACACCTTC	CATSDPSTGGNQWGYTF	TRBV24-1	TRBJ1-2
TGTGCCAGCAGCGCGGACAGGGGGCTGAACACTGAAGCTTTCTTT	CASSADRGLNTEAFF	TRBV7-3	TRBJ1-1
TGTGCCATCAGTCTGCGGCCATTCACTGAAGCTTTCTTT	CAISLRPFTEAFF	TRBV10-3	TRBJ1-1
TGTGCCAGCAGTTTCAGGGCGGGCACAGATACGCAGTATTTT	CASSFRAGTDTQYF	TRBV28	TRBJ2-3
TGTGCCAGCAGCCAACCGACCCTAGGCCTGGATACGCAGTATTTT	CASSQPTLGLDTQYF	TRBV5-6	TRBJ2-3
TGCAGTGCGAACAGGGACGGTAACTATGGCTACACCTTC	CSANRDGNYGYTF	TRBV20-1	TRBJ1-2
TGTGCCAGCAGCTTGGCACAGCAGCTATTTCCAGCTTTCTTT	CASSLAQQLFPAFF	TRBV7-9	TRBJ1-1
TGTGCCAGCAGCGTAGCGGGGACAGGGCCAAACAAAAACATTCAGTACTTC	CASSVAGTGPNKNIQYF	TRBV9	TRBJ2-4
TGTGCCAGCAGCCTGCAGGCAGGGCGTTTTCTCTCGGGGATAGAGACCCAGTACTTC	CASSLQAGRFLSGIETQYF	TRBV7-3	TRBJ2-5
TGTGCTAGTGGTTCTTCGGGAGCTCAGCCCCAGCATTTT	CASGSSGAQPQHF	TRBV12-5	TRBJ1-5
TGTGCCAGCAGTAATAACATCCGGGGGGGGAGCTCCTACGAGCAGTACTTC	CASSNNIRGGSSYEQYF	TRBV7-9	TRBJ2-7
TGCGCCAGCAGCTGGGGGGGCTCCTACAATGAGCAGTTCTTC	CASSWGGSYNEQFF	TRBV5-1	TRBJ2-1
TGTGCCAGCAGCGCCCGACTAGTATCCCAAGAGACCCAGTACTTC	CASSARLVSQETQYF	TRBV9	TRBJ2-5
TGTGCCAGCATGACAGGGAGGACTAACTATGGCTACACCTTC	CASMTGRTNYGYTF	TRBV6-4	TRBJ1-2
TGTGCCACCAGTCGTAGCGGGAGCTCGTACTTC	CATSRSGSSYF	TRBV24-1	TRBJ2-4
TGTGCCTGGAGTGTGCCCCACGGGAACAACACCGGGGAGCTGTTTTTT	CAWSVPHGNNTGELFF	TRBV30	TRBJ2-2
TGTGCCACCAGTGATTTGGGGACAACAGGGGGCAAGGGGGCCAATCAGCCCCAGCATTTT	CATSDLGTTGGKGANQPQHF	TRBV24-1	TRBJ1-5
TGTGCCAGCAGCCCATTAGGACAGGGGGGTGCTTACACGTACGAGCAGTACTTC	CASSPLGQGGAYTYEQYF	TRBV11-3	TRBJ2-7
TGTGCCAGCAGCTCCAGGATAGACAGGGGGCAGAGTCAGCCCCAGCATTTT	CASSSRIDRGQSQPQHF	TRBV7-9	TRBJ1-5
TGTGCCAGCAGCTGTCCGGGACTCCCAGGGGAGCAGTACTTC	CASSCPGLPGEQYF	TRBV9	TRBJ2-7
TGTGCCAGTAGTAAGCGGACCTCAGATACGCAGTATTTT	CASSKRTSDTQYF	TRBV19	TRBJ2-3
TGTGCCGGGACTAGCGGGAGATCCTACGAGCAGTACTTC	CAGTSGRSYEQYF	TRBV3-1	TRBJ2-7
TGTGCCAGCAGGGGGGGGAAAGGAGTGGATGAGCAGTTCTTC	CASRGGKGVDEQFF	TRBV14	TRBJ2-1
TGTGCCAGCAGCTTGGGTTGTTACCCATTAGGCTACACCTTC	CASSLGCYPLGYTF	TRBV7-2	TRBJ1-2
TGCGCCAGCAGTGAGAAAGACAGCCGCTTCAGCTCTGGAAACACCATATATTTT	CASSEKDSRFSSGNTIYF	TRBV10-1	TRBJ1-3
TGTGCCAGCAGTTTAGGAGTGAATCTAGCGGGCGGAACTCTCTTC	CASSLGVNLAGGTLF	TRBV28	TRBJ2-1
TGCAGCGTTGAAGAGACAGGGGATGGCTACACCTTC	CSVEETGDGYTF	TRBV29-1	TRBJ1-2
TGTGCCAGCAGCTTAGAGATAAGGGAGCAGTACTTC	CASSLEIREQYF	TRBV11-2	TRBJ2-7
TGTGCCAGCAGCGGAGACGGGGAGCTGTTTTTT	CASSGDGELFF	TRBV7-3	TRBJ2-2
TGTGCCAGCAGTTACCCGACAGGGAGGAATGAAAAACTGTTTTTT	CASSYPTGRNEKLFF	TRBV6-5	TRBJ1-4
TGTGCCAGCAGCTTAGACAAGTTGGGGACAGGGCCAATGCCTAGCACAGATACGCAGTATTTT	CASSLDKLGTGPMPSTDTQYF	TRBV7-9	TRBJ2-3
TGCGCCAGCAGCCAAGGAGACATGGAATGGCTGGGTCAGCCCCAGCATTTT	CASSQGDMEWLGQPQHF	TRBV4-1	TRBJ1-5
TGTGCCAGCGGAGATCACCGCAACACTGAAGCTTTCTTT	CASGDHRNTEAFF	TRBV28	TRBJ1-1
TGTGCCAGCAGTTACCCCCGGGACCACATCTTC	CASSYPRDHIF	TRBV6-2	TRBJ2-1
TGTGCTAGTGCACTGATCTCGACCGGGATCGAGCAGTTCTTC	CASALISTGIEQFF	TRBV12-5	TRBJ2-1
TGTGCCAGCACAGGAGTAAATCAGCCCCAGCATTTT	CASTGVNQPQHF	TRBV27	TRBJ1-5
TGTGCCAGCAGCCAAGATCCGGGGACTAGCCGAGATACGCAGTATTTT	CASSQDPGTSRDTQYF	TRBV14	TRBJ2-3
TGCAGTGCTACCACGACAGGGTACGACTATGGCTACACCTTC	CSATTTGYDYGYTF	TRBV20-1	TRBJ1-2
TGTGCCAGCAGCGGCAAACAGGGGGGGGGGGATGGCTACACCTTC	CASSGKQGGGDGYTF	TRBV13	TRBJ1-2
TGCAGCGCGATTACCGGACTCAACAGGGGTCAAAATGAAAAACTGTTTTTT	CSAITGLNRGQNEKLFF	TRBV29-1	TRBJ1-4
TGTGCCAGCAGTACCAGCGGGGGAACTGCGAACTATGGCTACACCTTC	CASSTSGGTANYGYTF	TRBV28	TRBJ1-2
TGCGCCAGCAGTTCAGGGAGGAGCTCCTATAATTCACCCCTCCACTTT	CASSSGRSSYNSPLHF	TRBV5-1	TRBJ1-6
TGCGCCAGCAGCTTGCCACGACAGGGATATGAAAAACTGTTTTTT	CASSLPRQGYEKLFF	TRBV5-1	TRBJ1-4
TGTGCCAGCAGGGGGACAATAGACTCCTACAATGAGCAGTTCTTC	CASRGTIDSYNEQFF	TRBV11-2	TRBJ2-1
TGTGCCCCCCAGGGCCATGGCTACACCTTC	CAPQGHGYTF	TRBV12-3	TRBJ1-2
TGCAGTGTCGCGTCCCGACTAGCGGGCCAAGAGACCCAGTACTTC	CSVASRLAGQETQYF	TRBV20-1	TRBJ2-5
TGTGCCACCAGTGATTTGACCACCGGGACAGGGATCATCTCCTACGAGCAGTACTTC	CATSDLTTGTGIISYEQYF	TRBV24-1	TRBJ2-7
TGTGCCAGCAGTTTGCCAACGGGGGGACAGGGAAGGTATTCACCCCTCCACTTT	CASSLPTGGQGRYSPLHF	TRBV28	TRBJ1-6
TGTGCCAGCTCCGGGGCGAACACTGAAGCTTTCTTT	CASSGANTEAFF	TRBV27	TRBJ1-1
TGTGCCAGCAGCTTGGGGGCACCCGGGGTCATTATAGATACGCAGTATTTT	CASSLGAPGVIIDTQYF	TRBV7-3	TRBJ2-3
TGTGCCAGCAGTCAAAGACCACAGGGTTACGAGCAGTACTTC	CASSQRPQGYEQYF	TRBV28	TRBJ2-7
TGTGCCAGTAATCCCGGGACAGGGGGCTGTCCGAATGCAACTAATGAAAAACTGTTTTTT	CASNPGTGGCPNATNEKLFF	TRBV19	TRBJ1-4
TGTGCCAGCAGCGGCCCACGGGATGGGGTCACTGGGGCCAACGTCCTGACTTTC	CASSGPRDGVTGANVLTF	TRBV9	TRBJ2-6
TGTGCCAGTCAGAAGGCACAGGGCGGTTGTCAGCCCCAGCATTTT	CASQKAQGGCQPQHF	TRBV6-5	TRBJ1-5
TGTGCCATCAGTGAGTGTCTAGCGGGTGACCCTAGAGGCTCCTACAATGAGCAGTTCTTC	CAISECLAGDPRGSYNEQFF	TRBV10-3	TRBJ2-1
TGTGCCTGGAAGGGCGAGCAGTACTTC	CAWKGEQYF	TRBV30	TRBJ2-7
TGTGCCAGCATTGGAGGCACTGGAAACACCATATATTTT	CASIGGTGNTIYF	TRBV28	TRBJ1-3
TGCAGTGCTAGAGATCTTCACAGGGGCACCGAGCAGTACTTC	CSARDLHRGTEQYF	TRBV20-1	TRBJ2-7
TGTGCCAGCAGCGGTGCAGGGGGCTGTCCCTACGAGCAGTACTTC	CASSGAGGCPYEQYF	TRBV9	TRBJ2-7
TGTGCCAGCAGCCAAGATACGTCCACTAGCCTCAACACTGAAGCTTTCTTT	CASSQDTSTSLNTEAFF	TRBV4-2	TRBJ1-1
TGTGCCAGCAGCTTACCAGGACAGTTGAACACCGGGGAGCTGTTTTTT	CASSLPGQLNTGELFF	TRBV11-3	TRBJ2-2
TGTGCCAGCAGTTTGTCACAGGTTTACAATTCACCCCTCCACTTT	CASSLSQVYNSPLHF	TRBV12-3	TRBJ1-6
TGTGCCACCAGTGATTTGAATCAACAGCCCGAGACCCAGTACTTC	CATSDLNQQPETQYF	TRBV24-1	TRBJ2-5
TGTGCCACCAGCTACATAGCGGCGAGCCCAGAATCGAACACCGGGGAGCTGTTTTTT	CATSYIAASPESNTGELFF	TRBV15	TRBJ2-2
TGTGCCAGCAGCTTGGCGGGGGAGGATGGCTACACCTTC	CASSLAGEDGYTF	TRBV5-4	TRBJ1-2
TGTGCCACCAGTGATCTCCGACTGGCGGGACAGGCAAAACTGTTTTTT	CATSDLRLAGQAKLFF	TRBV24-1	TRBJ1-4
TGCGCCAGCCGATGGATAGGGGGAATATTTGGGCCCTCCTACGAGCAGTACTTC	CASRWIGGIFGPSYEQYF	TRBV10-1	TRBJ2-7
TGCGCCAGCAGCCCCACATGCACAGATACGCAGTATTTT	CASSPTCTDTQYF	TRBV5-1	TRBJ2-3
TGTGCCAGCAGCCCCACAGGCCCAGTGAAGCAGCCCCAGCATTTT	CASSPTGPVKQPQHF	TRBV11-2	TRBJ1-5
TGTGCCAGCAGCTTAGCGGCTCGGGCAGGGCCCTTCAATGAGCAGTTCTTC	CASSLAARAGPFNEQFF	TRBV7-2	TRBJ2-1
TGTGCCAGCAGCTTGAACCGGGGGGCGATCCCCGAAGCCTACGAGCAGTACTTC	CASSLNRGAIPEAYEQYF	TRBV7-6	TRBJ2-7
TGTGCCAGCAGCTTATTCGGACCGGGACAGGGCCAAGCCTATAATTCACCCCTCCACTTT	CASSLFGPGQGQAYNSPLHF	TRBV7-3	TRBJ1-6
TGTGCCAGCAGCTTTCCTTCCGGGGCCTGGGGGGAGACCCAGTACTTC	CASSFPSGAWGETQYF	TRBV7-9	TRBJ2-5
TGTGCCAGCAGCGTTCGGGGGAGTAGCGATCAGCCCCAGCATTTT	CASSVRGSSDQPQHF	TRBV13	TRBJ1-5
TGTGCCAGCAGCCCGGCGACTGTTTCACCCCTCCACTTT	CASSPATVSPLHF	TRBV3-1	TRBJ1-6
TGTGCCAGCAGCCAAGATGGGGGGGGGTCCGACCCCTATGGCTACACCTTC	CASSQDGGGSDPYGYTF	TRBV14	TRBJ1-2
TGTGCCAGCAGGGGCGAACAGGGGGGAATACTGTTTTTT	CASRGEQGGILFF	TRBV9	TRBJ1-4
TGTGCCAGCAGCTTAGTGTACCGTGGCACCGGGGAGCTGTTTTTT	CASSLVYRGTGELFF	TRBV11-2	TRBJ2-2
TGCGCCAACGCGGGGTGGATCCTACCCTACGAGCAGTACTTC	CANAGWILPYEQYF	TRBV5-1	TRBJ2-7
TGTGCCCGGACAGAGGTGGTAGAGACCCAGTACTTC	CARTEVVETQYF	TRBV19	TRBJ2-5
TGCGCCAGCTTTCACCGACCCTCAGCCACCTACGAGCAGTACTTC	CASFHRPSATYEQYF	TRBV5-1	TRBJ2-7
TGTGCCAGCAGCCAGGGGCCCTATGGCTACACCTTC	CASSQGPYGYTF	TRBV7-2	TRBJ1-2
TGTGCCAGCAGATTCCGGGCACATCAGCCCCAGCATTTT	CASRFRAHQPQHF	TRBV6-2	TRBJ1-5
TGTGCCCCGGGACAGATCGTCGAGCAGTACTTC	CAPGQIVEQYF	TRBV19	TRBJ2-7
TGTGCCAGTAGCAACGACACTATAGACTCTGGGGCCAACGTCCTGACTTTC	CASSNDTIDSGANVLTF	TRBV19	TRBJ2-6
TGCAGTGCTAGAGGGCGCCCCACAGGTGACTATGGCTACACCTTC	CSARGRPTGDYGYTF	TRBV20-1	TRBJ1-2
TGTGCCAGCAGTAATAGAGGGGGTGTCTCCTACGAGCAGTACTTC	CASSNRGGVSYEQYF	TRBV6-2	TRBJ2-7
TGTGCCTGGAAGGGGGTACACTATGGCTACACCTTC	CAWKGVHYGYTF	TRBV30	TRBJ1-2
TGTGCCAGCTCACCAATAGCGGGGGACCCCCGGGACTTC	CASSPIAGDPRDF	TRBV18	TRBJ2-7
TGTGCCAGCAGCTTCGCCCGTTGGGGGGGCGTCGCGGAGCAGTTCTTC	CASSFARWGGVAEQFF	TRBV11-2	TRBJ2-1
TGTGCCAGCAGCAACACAGGGGAGGGCGAGACCCAGTACTTC	CASSNTGEGETQYF	TRBV5-5	TRBJ2-5
TGTGCCAGATCATCGCCGGGACAGAAATCCTACGAGCAGTACTTC	CARSSPGQKSYEQYF	TRBV6-1	TRBJ2-7
TGCGCCAGCAGCCTTCCCGGCTACGAGCAGTACTTC	CASSLPGYEQYF	TRBV4-1	TRBJ2-7
TGTGCCAGCAGCCCTAGGGTGGATCGCTACGAGCAGTACTTC	CASSPRVDRYEQYF	TRBV13	TRBJ2-7
TGCGCCAGCAGTGGGAAGGGACAGTTTGAAGCTTTCTTT	CASSGKGQFEAFF	TRBV10-1	TRBJ1-1
TGTGCCAGCAGGGGACAGGGGCAGGCAGATACGCAGTATTTT	CASRGQGQADTQYF	TRBV27	TRBJ2-3
TGTGCCAGCAGCGTAGCTCAACTCGGAGACGCTGCTCCCATCGGCACAGATACGCAGTATTTT	CASSVAQLGDAAPIGTDTQYF	TRBV9	TRBJ2-3
TGTGCCAGCAGTGAAGAAAGTTTAGAGGGGGAAGCAAATTCACCCCTCCACTTT	CASSEESLEGEANSPLHF	TRBV25-1	TRBJ1-6
TGTGCCAGCAGCCAGACCCGTAGCGGTTACAATGAGCAGTTCTTC	CASSQTRSGYNEQFF	TRBV3-1	TRBJ2-1
TGTGCCAGGAGTGCCCTTCCGGGGGGATTCGATAGCACAGATACGCAGTATTTT	CARSALPGGFDSTDTQYF	TRBV27	TRBJ2-3
TGTGCCAGCAGCCCAGAGGGACAGGGCCACACTGAAGCTTTCTTT	CASSPEGQGHTEAFF	TRBV13	TRBJ1-1
TGCGCCAGCAGGATACAGGGAGCGATTGATACTAATGAAAAACTGTTTTTT	CASRIQGAIDTNEKLFF	TRBV5-1	TRBJ1-4
TGTGCCAGCAGCGCGACAGGGGGCGGGCTCGGTAGAAATGAAAAACTGTTTTTT	CASSATGGGLGRNEKLFF	TRBV7-9	TRBJ1-4
TGCGCCAGCAGCCCCCGTTGCTGCGGGAGCGGGACTGAAGCTTTCTTT	CASSPRCCGSGTEAFF	TRBV4-3	TRBJ1-1
TGTGCCAGCAGCTTTTTCACTGGACGAAGGTACGAGCAGTACTTC	CASSFFTGRRYEQYF	TRBV5-4	TRBJ2-7
TGCGCCAGCAGTGAGGTGGGGGGGGGCGTTTACAATGAGCAGTTCTTC	CASSEVGGGVYNEQFF	TRBV10-1	TRBJ2-1
TGTGCCAGCAGTTTATGGAAGTGGGACAGTTCAGAGACCCAGTACTTC	CASSLWKWDSSETQYF	TRBV27	TRBJ2-5
TGTGCCAGCAGCCAAGTGGTGAGAACCGGACGCAATGAGCAGTTCTTC	CASSQVVRTGRNEQFF	TRBV3-1	TRBJ2-1
TGTGCCAGCAGCGCAGGCAGGTCGGTGGAAAAACTGTTTTTT	CASSAGRSVEKLFF	TRBV9	TRBJ1-4
TGTGCCAGCAGCTTGTGGGCCGGGGAGCTGTTTTTT	CASSLWAGELFF	TRBV7-4	TRBJ2-2
TGTGCCAGCAGTACGAGAGAGGGGGCGTACGAGCAGTACTTC	CASSTREGAYEQYF	TRBV6-4	TRBJ2-7
TGTGCCAGCAGCCTGGACCGGGACAGGGTTAGTAATTCACCCCTCCACTTT	CASSLDRDRVSNSPLHF	TRBV3-1	TRBJ1-6
TGTGCCAGCAGTTACTCAGGGACAGGGGGACGAAACGCTTTCTTT	CASSYSGTGGRNAFF	TRBV6-5	TRBJ1-1
TGTGCCAGCAGCTTTACAGGACAGGGTCGCTACGAGCAGTACTTC	CASSFTGQGRYEQYF	TRBV7-9	TRBJ2-7
TGCAGTGCTAGAAAAGGGGACACTGAAGCTTTCTTT	CSARKGDTEAFF	TRBV20-1	TRBJ1-1
TGTGCCAGCAGCTTACTGACGGCTCAGGGGGCAGTTAACTATGGCTACACCTTC	CASSLLTAQGAVNYGYTF	TRBV11-1	TRBJ1-2
TGTGCCAGCATACATAGGACAGGGAGCTATGGCTACACCTTC	CASIHRTGSYGYTF	TRBV6-3	TRBJ1-2
TGTCAAAGCCCTCCTGGGCCACGGATCCAAAAACTGTTTTTT	CQSPPGPRIQKLFF	TRBV10-3	TRBJ1-4
TGTGCCAGCAGCAAGGAGGATGAAAAACTGTTTTTT	CASSKEDEKLFF	TRBV7-3	TRBJ1-4
TGCAGTGCCGGGGGACCCCCCGGTAGAGAGACCCAGTACTTC	CSAGGPPGRETQYF	TRBV20-1	TRBJ2-5
TGTGCCATCAGGCCTATTATAAAAAAGTCGGGGCCCGACGAGCAGTACTTC	CAIRPIIKKSGPDEQYF	TRBV10-3	TRBJ2-7
TGTGCCAGCAGCTTTACCAACCCGCCCAACGTCCTGACTTTC	CASSFTNPPNVLTF	TRBV2	TRBJ2-6
TGCAGTGCTAGAGATGATCCCGAGGGAACCCACCAAGGCAGCAATCAGCCCCAGCATTTT	CSARDDPEGTHQGSNQPQHF	TRBV20-1	TRBJ1-5
TGTGCCAGCAGTTTATCCATGACAGGGTGGGAGAACACTGAAGCTTTCTTT	CASSLSMTGWENTEAFF	TRBV27	TRBJ1-1
TGTGCCACCAGTGATTCCCATTGGACGGGAATTGAGACCTACGAGCAGTACTTC	CATSDSHWTGIETYEQYF	TRBV24-1	TRBJ2-7
TGTGCCAGCAGCTGGGGGGCACAAGACAATGAGCAGTTCTTC	CASSWGAQDNEQFF	TRBV7-9	TRBJ2-1
TGTGCCAGCAGTTACCTTTCCGGGACAGTTATGAACACTGAAGCTTTCTTT	CASSYLSGTVMNTEAFF	TRBV6-3	TRBJ1-1
TGTGCCAGCAGCCAAGGGTCCCCAGACAGGGGAATCTCGGCGCAGTACTTC	CASSQGSPDRGISAQYF	TRBV14	TRBJ2-7
TGTGCCAGCAGTTCCCCTCAGGGCCCAAGCACTGAAGCTTTCTTT	CASSSPQGPSTEAFF	TRBV28	TRBJ1-1
TGTGCCAGCAGTTACTCGAGGACAGGGGGTTGGTCTGGGGCCAACGTCCTGACTTTC	CASSYSRTGGWSGANVLTF	TRBV6-5	TRBJ2-6
TGTGCCAGGAGTTCGGGGGTCGAAAAACTGTTTTTT	CARSSGVEKLFF	TRBV6-6	TRBJ1-4
TGTGCCAGCAGCAGAGGACGCTACAATGAGCAGTTCTTC	CASSRGRYNEQFF	TRBV5-6	TRBJ2-1
TGTGCCTGGGGTCGACAGGAGATTACTGAAGCTTTCTTT	CAWGRQEITEAFF	TRBV30	TRBJ1-1
TGTGCCAGCAGCTGGATACGAAACAAAGGGAGCTCTGGGGCCAACGTCCTGACTTTC	CASSWIRNKGSSGANVLTF	TRBV7-8	TRBJ2-6
TGCAGTCTGAAACTAGCGGGAGCACGTTCCTGCACAGATACGCAGTATTTT	CSLKLAGARSCTDTQYF	TRBV20-1	TRBJ2-3
TGTGCCAGCAGAGAAGGGGGGAAAGATGCCGGGGAGCTGTTTTTT	CASREGGKDAGELFF	TRBV28	TRBJ2-2
TGTGCCAGCCAGCCGACACAGTACCAAGAGACCCAGTACTTC	CASQPTQYQETQYF	TRBV6-5	TRBJ2-5
TGTGCCAGCAGCGAGTCAAACGGACAGCTCCTTCACACTGAAGCTTTCTTT	CASSESNGQLLHTEAFF	TRBV5-4	TRBJ1-1
TGTGCCACCAGCCTCGGGACTGGGATCTCTGGAAACACCATATATTTT	CATSLGTGISGNTIYF	TRBV24-1	TRBJ1-3
TGCGCCAGCACGTTCCCCGGGAGGGTGTCCTATAATTCACCCCTCCACTTT	CASTFPGRVSYNSPLHF	TRBV10-1	TRBJ1-6
TGTGCCAGCAGTTACGGGACAGCTTTCTTT	CASSYGTAFF	TRBV6-6	TRBJ1-1
TGTGCCAGCAGCGGACAGGGTCAGCCCCAGCATTTT	CASSGQGQPQHF	TRBV7-4	TRBJ1-5
TGTGCCAGCAGTGAAGGCAGATACGGGACCGAGCAGTACTTC	CASSEGRYGTEQYF	TRBV2	TRBJ2-7
TGTGCCAGCAGCTTACGAGGCCGGGTTCAGGGGCAAGAGACCCAGTACTTC	CASSLRGRVQGQETQYF	TRBV7-2	TRBJ2-5
TGCAGCTGGCCCACTAGCGCCACGCAGTATTTT	CSWPTSATQYF	TRBV29-1	TRBJ2-3
TGCAGCGTGGGTGATTTGTGGAGGAACACTGAAGCTTTCTTT	CSVGDLWRNTEAFF	TRBV29-1	TRBJ1-1
TGTGCCAGCAGGCCTCTTGGAGGACAGAAGGTCCCAAACACCATATATTTT	CASRPLGGQKVPNTIYF	TRBV6-6	TRBJ1-3
TGCGCCAGCAGTATCAATGATCATCGCGGGACTGAAGAGACCCAGTACTTC	CASSINDHRGTEETQYF	TRBV10-2	TRBJ2-5
TGCAGCGTTGGGACAGGGGTTGAGAAGCCCGCGAACACCGGGGAGCTGTTTTTT	CSVGTGVEKPANTGELFF	TRBV29-1	TRBJ2-2
TGTGCCAGCAGAAGTCCCCGGGAGACTTCACCCCTCCACTTT	CASRSPRETSPLHF	TRBV12-3	TRBJ1-6
TGCAGTGCTAGCCGTCTAGCGGAGACAGAGACCCAGTACTTC	CSASRLAETETQYF	TRBV20-1	TRBJ2-5
TGCAGTGCGATCCGTAACTATGGCTACACCTTC	CSAIRNYGYTF	TRBV20-1	TRBJ1-2
TGTGCCAGCAGCTTGGAAGGGGGCTATAATTCACCCCTCCACTTT	CASSLEGGYNSPLHF	TRBV5-6	TRBJ1-6
TGTGCCAGCAGCTCGATACGGGGCCAGGAGACCCAGTACTTC	CASSSIRGQETQYF	TRBV5-8	TRBJ2-5
TGTGCCAGCAGCGTAGGGGGGACAGAGGTCGGGATTTACAATGAGCAGTTCTTC	CASSVGGTEVGIYNEQFF	TRBV9	TRBJ2-1
TGTGCCAGCAGCGATCCGACATCCGATACGCAGTATTTT	CASSDPTSDTQYF	TRBV7-9	TRBJ2-3
TGTGCCAGCAGTGAATCCGGGACAGGTAACAGTGAAAAACTGTTTTTT	CASSESGTGNSEKLFF	TRBV25-1	TRBJ1-4
TGTGCCAGCAGCTTACTAAATCAGCCCCAGCATTTT	CASSLLNQPQHF	TRBV7-3	TRBJ1-5
TGTGAATGTTTCGCCGACAGCGAGAGCGGCATCTATGGCTACACCTTC	CECFADSESGIYGYTF	TRBV28	TRBJ1-2
TGCAGTGCTCGGTGGACACACAGGGTGAATCAGCCCCAGCATTTT	CSARWTHRVNQPQHF	TRBV20-1	TRBJ1-5
TGTGCCAGCAGGCCTGGCGGGCGGTCTTCTTCACCCCTCCACTTT	CASRPGGRSSSPLHF	TRBV6-6	TRBJ1-6
TGTGCCAGCAGTGACGCTCGGACAGGGGACTATGGCTACACCTTC	CASSDARTGDYGYTF	TRBV6-4	TRBJ1-2
TGCAGCGTCGGACAGGGAGGCTACACCTTC	CSVGQGGYTF	TRBV29-1	TRBJ1-2
TGTGCCAGCAGGGAGTTGTTCGGGGACAGGGGTAACTACGAGCAGTACTTC	CASRELFGDRGNYEQYF	TRBV2	TRBJ2-7
TGTGCCAGCCCAGAGAATCAGCCCCAGCATTTT	CASPENQPQHF	TRBV5-6	TRBJ1-5
TGTGCCAGCTCCGGGACAGTTTTTAACCCTAATGAAAAACTGTTTTTT	CASSGTVFNPNEKLFF	TRBV28	TRBJ1-4
TGTGCCAGCAGCGGCAGGACTCCAGGGGGCGACCCATCGATGACTGAAGCTTTCTTT	CASSGRTPGGDPSMTEAFF	TRBV7-3	TRBJ1-1
TGTGCCAGCAGCCAGCACCCCTGGACAGGATTAGACGAGCAGTACTTC	CASSQHPWTGLDEQYF	TRBV3-1	TRBJ2-7
TGCGCCTTGGCAGGACAGGGAAGACCCTATGGCTACACCTTC	CALAGQGRPYGYTF	TRBV10-1	TRBJ1-2
TGTGCCAGCAGCTTCACGACTAGGGGGCACGAGCAGTACTTC	CASSFTTRGHEQYF	TRBV9	TRBJ2-7
TGCGCCAGCAGCCAAGATGACTCAGGGGGTCGGGTAGAGCAGCAGTACTTC	CASSQDDSGGRVEQQYF	TRBV4-1	TRBJ2-7
TGTGCCAGCAGCTTGAGCGGGAGGGCGAGCACAGATACGCAGTATTTT	CASSLSGRASTDTQYF	TRBV5-4	TRBJ2-3
TGTGCCACCAGTGATTTGCGAGGACAGCTTCGGACAGATACGCAGTATTTT	CATSDLRGQLRTDTQYF	TRBV24-1	TRBJ2-3
TGTGCCAGCAGCTTAACAACTAGGACTAGCGGGATTCGCTCCACAGATACGCAGTATTTT	CASSLTTRTSGIRSTDTQYF	TRBV7-3	TRBJ2-3
TGTGCCAGCAGTGACCATAGAGCGGGATTGCGGAGTTCATACAATGAGCAGTTCTTC	CASSDHRAGLRSSYNEQFF	TRBV6-4	TRBJ2-1
TGCAGTGCTAGCCATCGAAAAATTGTGGACAGGGTCGGGGAGCTGTTTTTT	CSASHRKIVDRVGELFF	TRBV20-1	TRBJ2-2
TGTGCCAGCAGCCGGGGGGCCGTTCACGAGCAGTACTTC	CASSRGAVHEQYF	TRBV7-9	TRBJ2-7
TGTGCCCGAATCGCGGTTTCGACAGATACGCAGTATTTT	CARIAVSTDTQYF	TRBV6-4	TRBJ2-3
TGTGCCAGCACCCACAGGGGTGGAGCGAGCTCCTACGAGCAGTACTTC	CASTHRGGASSYEQYF	TRBV7-9	TRBJ2-7
TGTGCCAGCAGCCCCCTGGGGGTAGGAATGCTAGATGAGCAGTTCTTC	CASSPLGVGMLDEQFF	TRBV7-6	TRBJ2-1
TGTGCCACCCCCGTGAAGGACACCGGGGAGCTGTTTTTT	CATPVKDTGELFF	TRBV7-6	TRBJ2-2
TGTGCCAGCAGTTCTGTCCTTGGCTTCGAAACAACCGTCTCTGGAAACACCATATATTTT	CASSSVLGFETTVSGNTIYF	TRBV7-3	TRBJ1-3
TGCAGCGTTGGGGTGATAAGGCGCACTGAAGCTTTCTTT	CSVGVIRRTEAFF	TRBV29-1	TRBJ1-1
TGCGCCAGCAGAATGGGACAGGTCAGGGGCGAGCAGTACTTC	CASRMGQVRGEQYF	TRBV10-1	TRBJ2-7
TGTGCCAGCAGCTATAAGCCTCCTCAGGGTCAAACCGTCAATCAGCCCCAGCATTTT	CASSYKPPQGQTVNQPQHF	TRBV5-6	TRBJ1-5
TGTGCCAGCACGCGAACTCGGGGTGCAGCTTTCTTT	CASTRTRGAAFF	TRBV6-5	TRBJ1-1
TGTGCCAGCAGCCCCGGTCGCCATAGCAATCAGCCCCAGCATTTT	CASSPGRHSNQPQHF	TRBV7-8	TRBJ1-5
TGCAGTGCTAGAGATCCCGAGGAAGGCGAGCAGTACTTC	CSARDPEEGEQYF	TRBV20-1	TRBJ2-7
TGTGCGAACCTTAGGGGCTACGAGCAGTACTTC	CANLRGYEQYF	TRBV6-2	TRBJ2-7
TGTGCCAGCAGCTTAGAACGTCTATCAGATGGCTACACCTTC	CASSLERLSDGYTF	TRBV13	TRBJ1-2
TGCGCCAGCAGCCAACCGATATTCTATGTAAGCTATATCGGGGAGCAGTACTTC	CASSQPIFYVSYIGEQYF	TRBV5-1	TRBJ2-7
TGTGCCACCAGTAAAGACCCCCCCGGCTACGAGCAGTACTTC	CATSKDPPGYEQYF	TRBV24-1	TRBJ2-7
TGTGCCAGCAGTGACTCGGCTGGACTAGAATGCACAGATACGCAGTATTTT	CASSDSAGLECTDTQYF	TRBV6-4	TRBJ2-3
TGCGCCAGCAGCTTAAGAGGGCCTGGGCGGAACGAGCAGTACTTC	CASSLRGPGRNEQYF	TRBV5-1	TRBJ2-7
TGTGCCAGCAGCTTAGGCCGGGACAGGCATAACACCGGGGAGCTGTTTTTT	CASSLGRDRHNTGELFF	TRBV7-6	TRBJ2-2
TGTGCCAGCAGCTTAGTTTGTGCTCGCCACTACGAGCAGTACTTC	CASSLVCARHYEQYF	TRBV11-2	TRBJ2-7
TGTGCCAGCAGCTTAGAAGTGCGGACTAGCGGGAGTGGGGGTCGGGGCCTGGAGGGATGCACAGATACGCAGTATTTT	CASSLEVRTSGSGGRGLEGCTDTQYF	TRBV7-8	TRBJ2-3
TGTGCCAGTAGTTTCGTGTTTTTGGGAGGGCATAATGAGCAGTTCTTC	CASSFVFLGGHNEQFF	TRBV19	TRBJ2-1
TGTGCCAGCAGCTTGTACAGGGAATCCTATGGCTACACCTTC	CASSLYRESYGYTF	TRBV13	TRBJ1-2
TGCAGTGCTAGATTGAAAACCCGCGGAACATGCCCCTTCTCGGAGACCCAGTACTTC	CSARLKTRGTCPFSETQYF	TRBV20-1	TRBJ2-5
TGTGCCACCAGTGATGGACTGGGCTACACCTTC	CATSDGLGYTF	TRBV24-1	TRBJ1-2
TGTGCCAGCGTTGAGGCATCGGGAGACGGGACAGGGAGAACGGATGGCTACACCTTC	CASVEASGDGTGRTDGYTF	TRBV27	TRBJ1-2
TGTGCCAGCACAGGAACCGGCAATCTTGAAAATCAGCCCCAGCATTTT	CASTGTGNLENQPQHF	TRBV12-3	TRBJ1-5
TGTGCCAGCAGCACCTTATTACTAGGATCCTACGAGCAGTACTTC	CASSTLLLGSYEQYF	TRBV9	TRBJ2-7
TGTGCCAGCAGCCCGGGACAGGAACCTCCTTACATAACGACTGAAGCTTTCTTT	CASSPGQEPPYITTEAFF	TRBV13	TRBJ1-1
TGTGCCAGCAGCTTAGCAGTCCTAGTCCCGGACAGGGAGCTGGATGGAGACACTGAAGCTTTCTTT	CASSLAVLVPDRELDGDTEAFF	TRBV7-8	TRBJ1-1
TGTGCCAGCAGCATGCCCCCCCTAGCAGTTGCCCACTATGGCTACACCTTC	CASSMPPLAVAHYGYTF	TRBV5-8	TRBJ1-2
TGTGCCTGGAGTGTACTGACAGGGTACTCCTACGAGCAGTACTTC	CAWSVLTGYSYEQYF	TRBV30	TRBJ2-7
TGTGCCTCACAGTCACGGGAATCACCCCTCCACTTT	CASQSRESPLHF	TRBV10-3	TRBJ1-6
TGTGCCAGCAGTGAAACAGGGACAGGTTTATCGACCGGGGAGCTGTTTTTT	CASSETGTGLSTGELFF	TRBV6-4	TRBJ2-2
TGTGCCAGTAGTAGATTAGGCCGGGACCACACTGAAGCTTTCTTT	CASSRLGRDHTEAFF	TRBV19	TRBJ1-1
TGTGCCAGCAGTTTAAGTAAAAGGGCCTACGAGCAGTACTTC	CASSLSKRAYEQYF	TRBV12-3	TRBJ2-7
TGTGCCAGCAGCTTACCGGGACAGCATAGCAATCAGCCCCAGCATTTT	CASSLPGQHSNQPQHF	TRBV7-9	TRBJ1-5
TGTGCCAGCAGTAGTAAGTGGAGGATGATTAGCTACGAGCAGTACTTC	CASSSKWRMISYEQYF	TRBV28	TRBJ2-7
TGTGCCAGCAGTTGTGGGGAAAAGGGGTATGAGCAGTTCTTC	CASSCGEKGYEQFF	TRBV6-5	TRBJ2-1
TGTGCCAGCAGCCAAGGACAGGGGGGTGGCTACACCTTC	CASSQGQGGGYTF	TRBV3-1	TRBJ1-2
TGTGCCAGCAGCCCAACTGGGACAGGAAACAATCAGCCCCAGCATTTT	CASSPTGTGNNQPQHF	TRBV13	TRBJ1-5
TGTGCCAGCAGTTTTCCCCGACAGGTAGAATACGAGCAGTACTTC	CASSFPRQVEYEQYF	TRBV12-4	TRBJ2-7
TGTGCCAGCAGTAGACAGCCCGGAGGTCGGAGCACAGATACGCAGTATTTT	CASSRQPGGRSTDTQYF	TRBV7-9	TRBJ2-3
TGTGCCAGCAGACCCAACCGGAAGCTTGGGAGCGGGGAGCTGTTTTTT	CASRPNRKLGSGELFF	TRBV5-5	TRBJ2-2
TGTGCCATCAGCAGCTGGGACAGGGACTACTGGGGGGGGAATCAGCCCCAGCATTTT	CAISSWDRDYWGGNQPQHF	TRBV10-3	TRBJ1-5
TGTGTTTGGGGACAGGGCATCCTCAATCAGCCCCAGCATTTT	CVWGQGILNQPQHF	TRBV6-2	TRBJ1-5
TGTGCCAGCAGCGCCTCTGGGATAGCGGGAGGAAACGAGCAGTACTTC	CASSASGIAGGNEQYF	TRBV9	TRBJ2-7
TGCAGCGTTGCAAAGGCTCGGGACGCGCATTTT	CSVAKARDAHF	TRBV29-1	TRBJ1-5
TGTGCCAGCAGCTGGGGGGGTGTCCTAAACGAGCAGTACTTC	CASSWGGVLNEQYF	TRBV11-2	TRBJ2-7
TGTGCCAGCAGTGGTTACGAAAGCACTAGGAGAGATGAGCAGTTCTTC	CASSGYESTRRDEQFF	TRBV6-1	TRBJ2-1
TGTGCCAGCAGTGACGTGAGGGACGAGCAGTACTTC	CASSDVRDEQYF	TRBV2	TRBJ2-7
TGCGCCAGCAGTCAGCTGTCGTACGACAGGGGCCCTAGCTCCTATAATTCACCCCTCCACTTT	CASSQLSYDRGPSSYNSPLHF	TRBV10-1	TRBJ1-6
TGTGCCAGCAGCAGTAGACAGGGAGGGAACACTGAAGCTTTCTTT	CASSSRQGGNTEAFF	TRBV7-2	TRBJ1-1
TGTGCCACGGAGGATGGGGGGGGTCGCTCCTACAATGAGCAGTTCTTC	CATEDGGGRSYNEQFF	TRBV7-2	TRBJ2-1
TGTGCCAGCAGGCGTGAGTTCCCCTGCAGAGATGGCTACACCTTC	CASRREFPCRDGYTF	TRBV7-3	TRBJ1-2
TGTGCCACCAGTGATGGTGTTTACAAGCCCGCTAGCGGGGGGCATGAGCAGTTCTTC	CATSDGVYKPASGGHEQFF	TRBV24-1	TRBJ2-1
TGTGCCAGTGAAGGCAGTGATCCCTACGAGCAGTACTTC	CASEGSDPYEQYF	TRBV19	TRBJ2-7
TGTGCCAGCAGTTTAGCCGGGGGGGCAAGGAAGTACGAGCAGTACTTC	CASSLAGGARKYEQYF	TRBV12-4	TRBJ2-7
TGCAGTGCTAGAGTCACTAGCGGGAGGAGAGCTTTCTTT	CSARVTSGRRAFF	TRBV20-1	TRBJ1-1
TGTGCCACCAGTGATATGAGGGGGGGGCTCAGCCAAGAGACCCAGTACTTC	CATSDMRGGLSQETQYF	TRBV24-1	TRBJ2-5
TGTGCCAGCAGCGTAGAATATACCAGGACTAATCAGCCCCAGCATTTT	CASSVEYTRTNQPQHF	TRBV9	TRBJ1-5
TGTGCCAGCACCCCCTTCCGTCCCCTCGGGGACAGGGCTATGACCCAGTACTTC	CASTPFRPLGDRAMTQYF	TRBV7-4	TRBJ2-5
TGTGCCAGCAGCGGACGACGACGTCATGAGCAGTTCTTC	CASSGRRRHEQFF	TRBV11-3	TRBJ2-1
TGCGCCAGCAGCTCCGCCGGCCTAGATGACGAGCAGTACTTC	CASSSAGLDDEQYF	TRBV5-1	TRBJ2-7
TGCAGACAGGGGGCCCAAGAGACCCAGTACTTC	CRQGAQETQYF	TRBV20-1	TRBJ2-5
TGCTGGGCTAGGCCCAGGCCCCAATACGAGCAGTACTTC	CWARPRPQYEQYF	TRBV29-1	TRBJ2-7
TGTGCCAGCCTCGGACAGGGTTCTGTTAGCAATCAGCCCCAGCATTTT	CASLGQGSVSNQPQHF	TRBV6-5	TRBJ1-5
TGTGCCAGCAGCTCAGATACGCAGTATTTT	CASSSDTQYF	TRBV25-1	TRBJ2-3
TGTGCCAGCAGCGGCCACAGGGGTCTCCCCTACGAGCAGTACTTC	CASSGHRGLPYEQYF	TRBV7-3	TRBJ2-7
TGTGCCAGCAGTCCGATAGCCGACGAGCAGTACTTC	CASSPIADEQYF	TRBV6-5	TRBJ2-7
TGTGCCAGCAGTTTAGGCCCCCGGGACAGATCTAGCTCCTACGAGCAGTACTTC	CASSLGPRDRSSSYEQYF	TRBV27	TRBJ2-7
TGTGCCAGTAGTCCTTCTAGCTCCTACAATGAGCAGTTCTTC	CASSPSSSYNEQFF	TRBV19	TRBJ2-1
TGTGCCAGCAGCTTAGAGGGGCGCAAAGATTCCTGTCTGAGCAACTATGGCTACACCTTC	CASSLEGRKDSCLSNYGYTF	TRBV7-3	TRBJ1-2
TGTGCCAGCAGTTTCAGGGAAGGTGAGCAGTTCTTC	CASSFREGEQFF	TRBV27	TRBJ2-1
TGCAGTGCTAGCGAAACCTATGGCTACACCTTC	CSASETYGYTF	TRBV20-1	TRBJ1-2
TGTGCCAGCAGCATTGTCGGGACGAGTCCCAACGGCTACACCTTC	CASSIVGTSPNGYTF	TRBV7-3	TRBJ1-2
TGCAGTGCTAGAGCGAGGGACCACTATGGCTACACCTTC	CSARARDHYGYTF	TRBV20-1	TRBJ1-2
TGTGCCAGCCCCAGCCCGGGCCAAGAGACCCAGTACTTC	CASPSPGQETQYF	TRBV7-9	TRBJ2-5
TGTGCCAGCAGCCGAAGGGTCACGTTCGACAGGATTCGGTATGGAACCGGGGAGCTGTTTTTT	CASSRRVTFDRIRYGTGELFF	TRBV13	TRBJ2-2
TGTGCCAGCAGTAGAACAAGTCCGCTAAGGGGCTATAGCAATCAGCCCCAGCATTTT	CASSRTSPLRGYSNQPQHF	TRBV6-1	TRBJ1-5
TGTGCCAGCACCTCGGGAGGGTTGTACAATGAGCAGTTCTTC	CASTSGGLYNEQFF	TRBV25-1	TRBJ2-1
TGTGCCAGCAGCGACCACCAAAACCAGGTCTTTACTTCCTACGAGCAGTACTTC	CASSDHQNQVFTSYEQYF	TRBV7-9	TRBJ2-7
TGCGCCAGCAGCACTGAAGAGACTAGCGGGGGTCGCTACGAGCAGTACTTC	CASSTEETSGGRYEQYF	TRBV5-1	TRBJ2-7
TGTGCCAGCAGTTTGTGGCGATCCCCCGGGACAGGGGCGTTCCTTTTCACTGAAGCTTTCTTT	CASSLWRSPGTGAFLFTEAFF	TRBV12-3	TRBJ1-1
TGTGCCAGCAGCACCAGAACGCCTGACAGTAGGGGCTACACCTTC	CASSTRTPDSRGYTF	TRBV11-2	TRBJ1-2
TGTGCCAGCCCGGGGGGGAAGGATCAGCCCCAGCATTTT	CASPGGKDQPQHF	TRBV7-9	TRBJ1-5
TGTGCCAGCAACCGGGACCAGGACGTAGCGGGCCAGTATTTT	CASNRDQDVAGQYF	TRBV6-1	TRBJ2-3
TGCGCCAGCAGCTTAGGTCAGCCCCAGCATTTT	CASSLGQPQHF	TRBV4-1	TRBJ1-5
TGTGCTAGCAGCCTCCCAGCCTGGGAAAAACTGTTTTTT	CASSLPAWEKLFF	TRBV7-7	TRBJ1-4
TGTGCCACCAGGAAGACCTGGGAGCCGGGACAGGATGAAGCTTTCTTT	CATRKTWEPGQDEAFF	TRBV24-1	TRBJ1-1
TGTGCCAGCAGCTTGGACCCCCTGAGGCCCGAACGTCAGCCCCAGCATTTT	CASSLDPLRPERQPQHF	TRBV5-5	TRBJ1-5
TGTGCCAGCAGTGACTCGAGTGGAGGAGGAGACAGGGGGACTGAAGCTTTCTTT	CASSDSSGGGDRGTEAFF	TRBV6-4	TRBJ1-1
TGCGCCAGCAGCTTGGGAGGGGTCCTTTCCTGGACGATCTACGAGCAGTACTTC	CASSLGGVLSWTIYEQYF	TRBV5-1	TRBJ2-7
TGTGCCATCAGTGGACAGGGGGCGGTAGCACCCTGGTCCTACAATGAGCAGTTCTTC	CAISGQGAVAPWSYNEQFF	TRBV10-3	TRBJ2-1
TGCAGTGCTAGAGATTACAAGTGGGTCTCTGGGGCCAACGTCCTGACTTTC	CSARDYKWVSGANVLTF	TRBV20-1	TRBJ2-6
TGTGCCTGGAGTGTTTTCGGGACCGATTACAATGAGCAGTTCTTC	CAWSVFGTDYNEQFF	TRBV30	TRBJ2-1
TGTGCCCGGGTAGGTAGTTCGGGGGGGGATGAGCAGTTCTTC	CARVGSSGGDEQFF	TRBV12-5	TRBJ2-1
TGTGCCAGCAGCGATACCAGGGCCCGAAGCTCCTATAATTCACCCCTCCACTTT	CASSDTRARSSYNSPLHF	TRBV13	TRBJ1-6
TGTGCCACCAGGACCAGCAGAGAAAAACTGTTTTTT	CATRTSREKLFF	TRBV24-1	TRBJ1-4
TGTGCCAATCCTTTAATTGGACTAGCGGGCCCTCAAGAGACCCAGTACTTC	CANPLIGLAGPQETQYF	TRBV19	TRBJ2-5
TGTGCCAGCAGCGTCTCTCTAAACAATGAGCAGTTCTTC	CASSVSLNNEQFF	TRBV9	TRBJ2-1
TGTGCCAGCAGCTTAGCGGGACAGGGGTTCAGAACCTACGAGCAGTACTTC	CASSLAGQGFRTYEQYF	TRBV7-8	TRBJ2-7
TGTGCCAGCACGTCTTATATAAGGGCGGCCTACGAGCAGTACTTC	CASTSYIRAAYEQYF	TRBV6-2	TRBJ2-7
TGTGCCACCAACTTACACACTACAGACTGGGATGAGCAGTTCTTC	CATNLHTTDWDEQFF	TRBV24-1	TRBJ2-1
TGCGCCAGCAGCTTGTACGTACACGTCAGTCATGCAGGGGGATTAAAGGGCCCTCAGCCCCAGCATTTT	CASSLYVHVSHAGGLKGPQPQHF	TRBV5-1	TRBJ1-5
TGCGCCAGCAGCTATCCGGGACAGCCTCTGTTTTTT	CASSYPGQPLFF	TRBV5-1	TRBJ1-4
TGCGCCAGCAGTGAGCAGGGACGGGGGGGCCATACAGATACGCAGTATTTT	CASSEQGRGGHTDTQYF	TRBV10-1	TRBJ2-3
TGCGCCAGCAGTGAGGGTTGGACACATGCAAGAGATACGCAGTATTTT	CASSEGWTHARDTQYF	TRBV10-1	TRBJ2-3
TGCGCCAGCAGCTATACAGACTCCTACGAGCAGTACTTC	CASSYTDSYEQYF	TRBV5-1	TRBJ2-7
TGTGCCAGTAGTCCCGGGGTTCATGGCTACACCTTC	CASSPGVHGYTF	TRBV19	TRBJ1-2
TGTGCCAGCAGCTCGCTACCCTCCTACGAGCAGTACTTC	CASSSLPSYEQYF	TRBV9	TRBJ2-7
TGCAGCGTTGCGGAATGCACTGAAGCTTTCTTT	CSVAECTEAFF	TRBV29-1	TRBJ1-1
TGTGCCAGCAGCTTACCCCGGAACACTGAAGCTTTCTTT	CASSLPRNTEAFF	TRBV7-9	TRBJ1-1
TGTGCCAACTTCAATGAGCAGTTCTTC	CANFNEQFF	TRBV11-3	TRBJ2-1
TGTGCCAGCAGTGAAGCGACGGACCCTAGCGGGGCCCGAAGCTCCTACGAGCAGTACTTC	CASSEATDPSGARSSYEQYF	TRBV6-1	TRBJ2-7
TGTGCCAGCAGTTACCGGGACAGGGGGGGTTCACCCCTCCACTTT	CASSYRDRGGSPLHF	TRBV12-3	TRBJ1-6
TGTGCCAGCAGCGATGCAGCCTCGGCGGGGGGGCTATTCGGCTTCTCCTACGAGCAGTACTTC	CASSDAASAGGLFGFSYEQYF	TRBV7-3	TRBJ2-7
TGTGCCAGCAGCCAGCTCCGGGACAGGGCGGGGGAGCTGTTTTTT	CASSQLRDRAGELFF	TRBV4-2	TRBJ2-2
TGTGCCAGCAGCCCAAGGGACGCAAACTATGGCTACACCTTC	CASSPRDANYGYTF	TRBV5-4	TRBJ1-2
TGCGCCAGCAGCCAAGATAGAGGGTCTGAGCAGTTCTTC	CASSQDRGSEQFF	TRBV4-1	TRBJ2-1
TGTGCCAGCAGGCAAGCGGGCTACACCTTC	CASRQAGYTF	TRBV27	TRBJ1-2
TGTGCCAGCAGCTCGCCCGACAGGACTAGCGGGTCTGTGTTCCAAGAGACCCAGTACTTC	CASSSPDRTSGSVFQETQYF	TRBV7-8	TRBJ2-5
TGTGCCAGCAGTGACTTACCCTGGTCCCCCGGGGGGGCCCAAGAGACCCAGTACTTC	CASSDLPWSPGGAQETQYF	TRBV6-4	TRBJ2-5
TGCGCCAGCACCGGGACAGGGGTGGTCTCCTACGAGCAGTACTTC	CASTGTGVVSYEQYF	TRBV10-2	TRBJ2-7
TGTGCCAGCAGTGAGTTCCTACTCCTTCCCAATGAGCAGTTCTTC	CASSEFLLLPNEQFF	TRBV6-1	TRBJ2-1
TGTGCCAGCAGTTACACAGAGTTCATCTACGAGCAGTACTTC	CASSYTEFIYEQYF	TRBV6-5	TRBJ2-7
TGCGCCAGCAGGGACAGGGTAGGAAGGGATGAGACCGGGGAGCTGTTTTTT	CASRDRVGRDETGELFF	TRBV10-2	TRBJ2-2
TGTGCCAGCCTGTACCGCCCGGATCAGCCCCAGCATTTT	CASLYRPDQPQHF	TRBV27	TRBJ1-5
TGTGCCACCAGCAGCCCCAGAGAGACGGGAATTTTGTCTCTAAGCACAGATACGCAGTATTTT	CATSSPRETGILSLSTDTQYF	TRBV15	TRBJ2-3
TGTGCCAGCAGACTCCGGGACAGGGCCTACGAGCAGTACTTC	CASRLRDRAYEQYF	TRBV6-2	TRBJ2-7
TGTGCCAGCAGCTTACCCACGCATGGGAATGAGCAGTTCTTC	CASSLPTHGNEQFF	TRBV7-6	TRBJ2-1
TGTGCCAAAAACCGAAGCCAGCGTAATGAAAAACTGTTTTTT	CAKNRSQRNEKLFF	TRBV6-6	TRBJ1-4
TGCGCCAGCAGCCAGGACTGTCTAGCCGCCACTGAAGCTTTCTTT	CASSQDCLAATEAFF	TRBV5-1	TRBJ1-1
TGTGCCAGCAGCCACAGGGAGGACGGGGAGCTGTTTTTT	CASSHREDGELFF	TRBV11-3	TRBJ2-2
TGTGCCAGCATCAAGCTCATCACCTATGGCTACACCTTC	CASIKLITYGYTF	TRBV2	TRBJ1-2
TGTGCCAGCAGCCTAGCGGGTTCCTACGAGCAGTACTTC	CASSLAGSYEQYF	TRBV5-5	TRBJ2-7
TGTGCCAGCAGCATAGGGCCAACAGGATCCCCCGGCTTTGAAGCTTTCTTT	CASSIGPTGSPGFEAFF	TRBV7-6	TRBJ1-1
TGTGCCAGCAGCTTATGGACAAGGACGCCCCAGCATTTT	CASSLWTRTPQHF	TRBV7-9	TRBJ1-5
TGTGCCACCACTGGGGGGGCCTCTAACTATGGCTACACCTTC	CATTGGASNYGYTF	TRBV24-1	TRBJ1-2
TGTGCCAGTAGAGATTGGAGGGGGGGCTGCACTGAAGCTTTCTTT	CASRDWRGGCTEAFF	TRBV19	TRBJ1-1
TGCGCCAGCGACGGGGATGCTAATGAGCAGTTCTTC	CASDGDANEQFF	TRBV4-3	TRBJ2-1
TGTGCCAGCAGCGCAGCCAGGGAGGGCACCGGGGAGCTGTTTTTT	CASSAAREGTGELFF	TRBV5-4	TRBJ2-2
TGTGCCAGCAGTCGTAGCCATGGGACAGGGGGCACGGTCCGTACCTACGAGCAGTACTTC	CASSRSHGTGGTVRTYEQYF	TRBV2	TRBJ2-7
TGCAGCGTTGTCCGGGACAGGAGTGGGGGGGGAGAGACCCAGTACTTC	CSVVRDRSGGGETQYF	TRBV29-1	TRBJ2-5
TGCGCCAGCAGCCCCCCGAGGACAGGACCAGCCTACGAGCAGTACTTC	CASSPPRTGPAYEQYF	TRBV5-1	TRBJ2-7
TGTGCCAGCAGTTTAGGGGGACAGGGGGGAGCTAACTATGGCTACACCTTC	CASSLGGQGGANYGYTF	TRBV28	TRBJ1-2
TGTGCCAGCAGCGGGGACCAAGAGACCCAGTACTTC	CASSGDQETQYF	TRBV5-4	TRBJ2-5
TGTGCCAAAGGGCGGACAGCGACAGATACGCAGTATTTT	CAKGRTATDTQYF	TRBV11-2	TRBJ2-3
TGTGCCAGCAGCCAAGCGCACAGGGGAGGCTACACCTTC	CASSQAHRGGYTF	TRBV14	TRBJ1-2
TGCAGCCGCGGGGGTAGGCTGGAGCCCCAGCATTTT	CSRGGRLEPQHF	TRBV29-1	TRBJ1-5
TGTGGCCTACTCAGGGTGGGGAATTCACCCCTCCACTTT	CGLLRVGNSPLHF	TRBV7-9	TRBJ1-6
TGCGCCAGCAGCCCCAAGATAGGGGGGACAGAGCAGTACTTC	CASSPKIGGTEQYF	TRBV4-3	TRBJ2-7
TGTGCCAGCAGCCCCTTTGGGGATCAGGGGGGTTGGAACACTGAAGCTTTCTTT	CASSPFGDQGGWNTEAFF	TRBV7-9	TRBJ1-1
TGTGCCAGTAGTATAGTACATCACACTGAAGCTTTCTTT	CASSIVHHTEAFF	TRBV19	TRBJ1-1
TGTGCCAGCAGCGCACAGGTATGGACCCTGTACGAGCAGTACTTC	CASSAQVWTLYEQYF	TRBV5-4	TRBJ2-7
TGTGCCAGCAGCCAAGATGCCCCGGGGGGGGCGCAGCCCCAGCATTTT	CASSQDAPGGAQPQHF	TRBV4-2	TRBJ1-5
TGTGCCAGCAGCTTAGATTGGGGTAACACTGAAGCTTTCTTT	CASSLDWGNTEAFF	TRBV11-3	TRBJ1-1
TGCAGTGCTAGAAGCCAGGGAGGAGACTATGGCTACACCTTC	CSARSQGGDYGYTF	TRBV20-1	TRBJ1-2
TGTGCCAGCAGTTATTCACGGGTGCCCCAGCATTTT	CASSYSRVPQHF	TRBV6-9	TRBJ1-5
TGCAGCGTTATCTTTAATAGCGGGCGGTCGCAGTTCTTC	CSVIFNSGRSQFF	TRBV29-1	TRBJ2-1
TGCAGTGCATATCCCCATCCGGGACAGGGGGGAGACTACGAGCAGTACTTC	CSAYPHPGQGGDYEQYF	TRBV20-1	TRBJ2-7
TGTGCCAGCAGCACAGGGGACAATGAGCAGTTCTTC	CASSTGDNEQFF	TRBV7-3	TRBJ2-1
TGTGCCACCAGCAGTGAATACGAGCAGTACTTC	CATSSEYEQYF	TRBV15	TRBJ2-7
TGTGCCTCTCGGGGAGGGGGGGGGCGAAACATTCAGTACTTC	CASRGGGGRNIQYF	TRBV10-3	TRBJ2-4
TGCGCCAGCAGCACCCCGTGGGCCTTTCACACAGAGGCTACTGAAGCTTTCTTT	CASSTPWAFHTEATEAFF	TRBV5-1	TRBJ1-1
TGCGCCAGCAGCGGACTAGCGATAGAAGAGACCCAGTACTTC	CASSGLAIEETQYF	TRBV10-1	TRBJ2-5
TGCAGTGCTAGCAATACAGGGGTCAAAAAACTGTTTTTT	CSASNTGVKKLFF	TRBV20-1	TRBJ1-4
TGCGCCAGCAGCTTGCTGCCTTCGCGGGAGGGGCCCGGCACCGGGGAGCTGTTTTTT	CASSLLPSREGPGTGELFF	TRBV5-1	TRBJ2-2
TGCAGTGCTGTGGGGACAGGGGGATTTAATGAAAAACTGTTTTTT	CSAVGTGGFNEKLFF	TRBV20-1	TRBJ1-4
TGTGCCACCAGTGATCGTCCGGGACAGGGACACGAGCAGTACTTC	CATSDRPGQGHEQYF	TRBV24-1	TRBJ2-7
TGTGCCAGCAGGGCCTCCTCCAGGGCGGAATCTGAAGCTTTCTTT	CASRASSRAESEAFF	TRBV7-9	TRBJ1-1
TGTGCCAGCAGCGGAGAGGGCACCGGGGAGCTGTTTTTT	CASSGEGTGELFF	TRBV13	TRBJ2-2
TGTGCCAGCAGTTTATGGGTGGGACTAGGGTCCTCCACAGATACGCAGTATTTT	CASSLWVGLGSSTDTQYF	TRBV12-4	TRBJ2-3
TGTGCCAGCAGACCAGGGGTCTATTCAGATACGCAGTATTTT	CASRPGVYSDTQYF	TRBV7-8	TRBJ2-3
TGTGCCAGTAGTATAACACCCTACGAGCAGTACTTC	CASSITPYEQYF	TRBV19	TRBJ2-7
TGCGCCAGCAGCTTGGTTGGGGCCGGGACAGGGGGGACCTACGAGCAGTACTTC	CASSLVGAGTGGTYEQYF	TRBV5-1	TRBJ2-7
TGTGCCAGCAGCTTGAAGACGCTTCAGGGGGCCCCTCTACGGACCTACGAGCAGTACTTC	CASSLKTLQGAPLRTYEQYF	TRBV7-9	TRBJ2-7
TGTGCTAGTGGTTGGTCCGGGGGGGCTAAAAAACGGGGCTACGAGCAGTACTTC	CASGWSGGAKKRGYEQYF	TRBV12-5	TRBJ2-7
TGCGCCAGCAGAGGACAGGGGGCAGGCGAAGAGACCCAGTACTTC	CASRGQGAGEETQYF	TRBV10-1	TRBJ2-5
TGTGCCAGCAGCTTGTCCTCGTTCAATGAGCAGTTCTTC	CASSLSSFNEQFF	TRBV11-3	TRBJ2-1
TGTGCCAGCAGCTTAGCTTCGGGAGAAGCTTTCTTT	CASSLASGEAFF	TRBV11-2	TRBJ1-1
TGTGCCAGCAGCCAAGTCCCGGCTGTGGGCTCCTACGAGCAGTACTTC	CASSQVPAVGSYEQYF	TRBV14	TRBJ2-7
TGTGCCAGCAGCCAGGCCGCACTAGGGAGGACTAATGAAAAACTGTTTTTT	CASSQAALGRTNEKLFF	TRBV14	TRBJ1-4
TGCAGTGCTAGAGATGACTGGAAACTGTTTTTT	CSARDDWKLFF	TRBV20-1	TRBJ1-4
TGTGCCAGCAGTACGGGTGCCTACAATGAGCAGTTCTTC	CASSTGAYNEQFF	TRBV27	TRBJ2-1
TGTGCCAGCAGCTTAAAAGGGGGGGGGGGCCCCAACACCGGGGAGCTGTTTTTT	CASSLKGGGGPNTGELFF	TRBV11-1	TRBJ2-2
TGTGCCAGCAGCTGCAGGGCGAGGAACACTGAAGCTTTCTTT	CASSCRARNTEAFF	TRBV7-9	TRBJ1-1
TGTGCCAGTAGTTCTGGTCAGCCCCAGCATTTT	CASSSGQPQHF	TRBV19	TRBJ1-5
TGTGCCAGCAGCGGGCCACTAGCGGGAGCCCGACTGCAAGAGACCCAGTACTTC	CASSGPLAGARLQETQYF	TRBV7-3	TRBJ2-5
TGTGCCAGCAGCCAACTTACCGTTTACCCATACGAGCAGTACTTC	CASSQLTVYPYEQYF	TRBV3-1	TRBJ2-7
TGTGCCAGCAGCTGTTCAAGACAGCTTAGCAATCAGCCCCAGCATTTT	CASSCSRQLSNQPQHF	TRBV11-3	TRBJ1-5
TGCGCCAGCAGTAATGGACTAGCGGGGGTTTACATTCAGTACTTC	CASSNGLAGVYIQYF	TRBV10-1	TRBJ2-4
TGTGCCAGCAGACGGCGGGTGGCGATCACAGATACGCAGTATTTT	CASRRRVAITDTQYF	TRBV6-3	TRBJ2-3
TGTGCCAGCAGCGATGCGGTAACTGAAGCTTTCTTT	CASSDAVTEAFF	TRBV11-3	TRBJ1-1
TGCGCCAGCAGGAATGGAATGCGGAGGAGCAATCAGCCCCAGCATTTT	CASRNGMRRSNQPQHF	TRBV10-1	TRBJ1-5
TGTGCCAGCAGTTACCCTATACCCGCTGAAGCTTTCTTT	CASSYPIPAEAFF	TRBV6-5	TRBJ1-1
TGTGCCAGCGGCAGGAGACGGGGAGGCTCAGACGAGCAGTACTTC	CASGRRRGGSDEQYF	TRBV6-4	TRBJ2-7
TGCAGTGCTAGCTTCAGGTCAAGAAACACCATATATTTT	CSASFRSRNTIYF	TRBV20-1	TRBJ1-3
TGTGCCAGCAGCGGGCAGGAAAGCGCAGATACGCAGTATTTT	CASSGQESADTQYF	TRBV9	TRBJ2-3
TGTGCCAGCAGTGACAAGGGGACTAGCGGACGGGGGAAGACCTACAATGAGCAGTTCTTC	CASSDKGTSGRGKTYNEQFF	TRBV6-4	TRBJ2-1
TGTGCCAGCAGAACCCCAGGCGTGGCCGAGCAGTACTTC	CASRTPGVAEQYF	TRBV6-4	TRBJ2-7
TGTGCCTGGAGTGCCTTCAGAAATAGCAATCAGCCCCAGCATTTT	CAWSAFRNSNQPQHF	TRBV30	TRBJ1-5
TGTGCCAGCAGCTGTAGGAGTCAAAACACAGATACGCAGTATTTT	CASSCRSQNTDTQYF	TRBV7-2	TRBJ2-3
TGTGCCCCATCGGGACTAAGCAATGAAAAACTGTTTTTT	CAPSGLSNEKLFF	TRBV24-1	TRBJ1-4
TGTGCCACCAAATCAAACGAGACGACCTGGGATCAGCCCCAGCATTTT	CATKSNETTWDQPQHF	TRBV6-5	TRBJ1-5
TGTGCCAGCAGCTTAGTTGCCGGACAGGGCGAGCAGTACTTC	CASSLVAGQGEQYF	TRBV7-2	TRBJ2-7
TGTGCCAGCAGCGTTCAGCGATTTGGAGGGGAATGGCCTGCCTACGAGCAGTACTTC	CASSVQRFGGEWPAYEQYF	TRBV7-9	TRBJ2-7
TGTGCCAGCATTCCTAACGGGACTAGCGGGAGGTATAGCTCCTACGAGCAGTACTTC	CASIPNGTSGRYSSYEQYF	TRBV27	TRBJ2-7
TGTGCCAGCAGTGAAGAACTCCACGAGCAGTACTTC	CASSEELHEQYF	TRBV6-1	TRBJ2-7
TGTGCCAGCAGCTTAAGTAAAGATAGCGGGATCCATCAGCCCCAGCATTTT	CASSLSKDSGIHQPQHF	TRBV7-9	TRBJ1-5
TGTGCCAGCAGTGAATCACCGGGACTAGATTACAATGAGCAGTTCTTC	CASSESPGLDYNEQFF	TRBV28	TRBJ2-1
TGTGCCAGCGGGGGGGAGCAGTACTTC	CASGGEQYF	TRBV25-1	TRBJ2-7
TGTGCCAGCAGCCACCCAGCCCCCGGGACAGTCTACAATGAGCAGTTCTTC	CASSHPAPGTVYNEQFF	TRBV14	TRBJ2-1
TGTGCCAGTACTCTGAACCGACAGGGGAACACTGAAGCTTTCTTT	CASTLNRQGNTEAFF	TRBV19	TRBJ1-1
TGTGCCAGCAGTGAAGCGCATCTAATCATACAGGGTCGCACAGATACGCAGTATTTT	CASSEAHLIIQGRTDTQYF	TRBV2	TRBJ2-3
TGCGCCAGCAGCTGGGACTCCACAGATACGCAGTATTTT	CASSWDSTDTQYF	TRBV5-1	TRBJ2-3
TGTGCCAGCAGCTTTTGGACCCCAAATTCACCCCTCCACTTT	CASSFWTPNSPLHF	TRBV5-6	TRBJ1-6
TGCGCCAGCAGCCAAGAGGAGACGGACACAGATACGCAGTATTTT	CASSQEETDTDTQYF	TRBV4-1	TRBJ2-3
TGTGCCAGCAGTCCACGTCCAGGAGGTAGCAATCAGCCCCAGCATTTT	CASSPRPGGSNQPQHF	TRBV6-3	TRBJ1-5
TGTGCCAGTAGTATAGTAGGGACAGGAAGAGAGACCCAGTACTTC	CASSIVGTGRETQYF	TRBV19	TRBJ2-5
TGTGCCAGCGCGGGGGGATTAAGGCCCTACGAGCAGTACTTC	CASAGGLRPYEQYF	TRBV27	TRBJ2-7
TGTGCCAGCAGTCTCCCGGATGGACAGAAGTTGAACACTGAAGCTTTCTTT	CASSLPDGQKLNTEAFF	TRBV11-3	TRBJ1-1
TGCGCCAGCAGCAGGTGGACGGTTGGGAATGAAAAACTGTTTTTT	CASSRWTVGNEKLFF	TRBV5-1	TRBJ1-4
TGTGCCCCTATCGGGGGCCGGACCACCGGGGAGCTGTTTTTT	CAPIGGRTTGELFF	TRBV10-3	TRBJ2-2
TGTGCCAGACTAGCGGGTCTCTACGAGCAGTACTTC	CARLAGLYEQYF	TRBV6-2	TRBJ2-7
TGTCACGCTCTTAATGAAAAACTGTTTTTT	CHALNEKLFF	TRBV11-2	TRBJ1-4
TGTGCCAGCAGTAATCCTACTAGCGGGAGCTCCTACGAGCAGTACTTC	CASSNPTSGSSYEQYF	TRBV6-1	TRBJ2-7
TGTGCCAGCAGTTTATCGGGGGGGGCCAGGGTATCCGGGGAGCTGTTTTTT	CASSLSGGARVSGELFF	TRBV27	TRBJ2-2
TGTGCCAGCAGCGGGGGGGGGGCTAGCTCCTACAATGAGCAGTTCTTC	CASSGGGASSYNEQFF	TRBV5-4	TRBJ2-1
TGCGCCAGCAGCCCAGAGTGTACCGCCTACAATGAGCAGTTCTTC	CASSPECTAYNEQFF	TRBV4-1	TRBJ2-1
TGTGCCAGTAGTATCATTTCTGGGGCCAACGTCCTGACTTTC	CASSIISGANVLTF	TRBV19	TRBJ2-6
TGTGCCAGTAGTACAGGGGGCCGCTATGAGTACAATGAGCAGTTCTTC	CASSTGGRYEYNEQFF	TRBV19	TRBJ2-1
TGTGCCAGCAGTTTAAGGGCAGCGTACTATGGCTACACCTTC	CASSLRAAYYGYTF	TRBV28	TRBJ1-2
TGTGCCAGCAGGGTCCGAGGAGGTTGGTCACCCCTCCACTTT	CASRVRGGWSPLHF	TRBV12-4	TRBJ1-6
TGCGCCAGCAGCTTAGGAGAGCCCCCTCCAGTGCCTAGCGGTAAGACCTACAATGAGCAGTTCTTC	CASSLGEPPPVPSGKTYNEQFF	TRBV5-1	TRBJ2-1
TGTGCCAGTTCATCGACTTCTGAAGCTTTCTTT	CASSSTSEAFF	TRBV19	TRBJ1-1
TGTGCCAGCAGAAAACTTCGACTAGCGGCCGACACAGATACGCAGTATTTT	CASRKLRLAADTDTQYF	TRBV6-5	TRBJ2-3
TGCGCCAGCAGCCAAGAAAACAGGGCGGAGGATACCAATCAGCCCCAGCATTTT	CASSQENRAEDTNQPQHF	TRBV4-1	TRBJ1-5
TGTGCCAGCAGCCCTCAGGGTTGGGCTTTCTTT	CASSPQGWAFF	TRBV13	TRBJ1-1
TGTGCCAGCAGTTTACTAAAGAGGAGCACAGATACGCAGTATTTT	CASSLLKRSTDTQYF	TRBV27	TRBJ2-3
TGTGCCAGGCTGGAGGGAGAGACCCAGTACTTC	CARLEGETQYF	TRBV6-3	TRBJ2-5
TGTGCTAGTGGGGACAGGGCTCCTTTCGGGTACGAGCAGTACTTC	CASGDRAPFGYEQYF	TRBV12-5	TRBJ2-7
TGTGCCAGCAGTCCCCGTCGTGACGAGCAGTACTTC	CASSPRRDEQYF	TRBV6-4	TRBJ2-7
TGTGCCAGCAGCGCGGCGACACCAATGGTAGCCAAAAACATTCAGTACTTC	CASSAATPMVAKNIQYF	TRBV7-3	TRBJ2-4
TGCAGTGCCCCCGGGGCCGGAGGGCCTGAAAAACTGTTTTTT	CSAPGAGGPEKLFF	TRBV20-1	TRBJ1-4
TGTGCCAGAAGTTTAGGGGGCGACTCTGGAAACACCATATATTTT	CARSLGGDSGNTIYF	TRBV28	TRBJ1-3
TGTGCCAGCAGCCTCCTGCCCACCTGGGCCCGGCGTTACGAGCAGTACTTC	CASSLLPTWARRYEQYF	TRBV3-1	TRBJ2-7
TGTGCCAGCAGCCATTGTAAGGGCCACAAAGCCTACAATGAGCAGTTCTTC	CASSHCKGHKAYNEQFF	TRBV7-7	TRBJ2-1
TGTACAGGGGGCCTAAACGAGCAGTACTTC	CTGGLNEQYF	TRBV11-2	TRBJ2-7
TGTGCCAGCAGATGCGGGGGCGGTGAAGCTTTCTTT	CASRCGGGEAFF	TRBV13	TRBJ1-1
TGTGCCAGCCCAGGACTAGCGGGAGGAAGGCTAAGCCAAGAGACCCAGTACTTC	CASPGLAGGRLSQETQYF	TRBV28	TRBJ2-5
TGCGCCAGCAGCTGCAAACGTACCCGGGTTACAGATACGCAGTATTTT	CASSCKRTRVTDTQYF	TRBV5-1	TRBJ2-3
TGTGCCACCAGGCAGGGATACACTGAAGCTTTCTTT	CATRQGYTEAFF	TRBV24-1	TRBJ1-1
TGTGCCAGCCCCCGGGCTTATAGCAATCAGCCCCAGCATTTT	CASPRAYSNQPQHF	TRBV6-4	TRBJ1-5
TGCAGTGCTAGAGATGCGCGTAGGGCCTACGAGCAGTACTTC	CSARDARRAYEQYF	TRBV20-1	TRBJ2-7
TGCATTTTGACAGCCTACGAGCAGTACTTC	CILTAYEQYF	TRBV29-1	TRBJ2-7
TGTGCCAGCAGCTTAGGGGGGACAGGGGCCTATAATTCACCCCTCCACTTT	CASSLGGTGAYNSPLHF	TRBV7-7	TRBJ1-6
TGTGCCAGCAGTTTCGGGGCAACTAATGAAAAACTGTTTTTT	CASSFGATNEKLFF	TRBV28	TRBJ1-4
TGTGCCAGCAGTGCAGTATACACAGGTCCCGAGCAGTACTTC	CASSAVYTGPEQYF	TRBV6-1	TRBJ2-7
TGTGCCAGCTCTAAAGGACCCACTGAAGCTTTCTTT	CASSKGPTEAFF	TRBV18	TRBJ1-1
TGCGCCAGCAGAGCCGGGACAGGGGGCGGTTATGGCTACACCTTC	CASRAGTGGGYGYTF	TRBV10-1	TRBJ1-2
TGTGCCAGCAGCTTGCGGGAACGGGAGCATACCGGGGAGCTGTTTTTT	CASSLREREHTGELFF	TRBV5-6	TRBJ2-2
TGTGCCACCAGTGAAACGGACAGGGCTTTCTTT	CATSETDRAFF	TRBV24-1	TRBJ1-1
TGTGCCAGCAGTGGGGGACAGGGTTCGTCATGCCACAATCAGCCCCAGCATTTT	CASSGGQGSSCHNQPQHF	TRBV5-6	TRBJ1-5
TGTGCCACCAGGGACAGGGTCCATGAGCAGTTCTTC	CATRDRVHEQFF	TRBV24-1	TRBJ2-1
TGTGCCAGCAGCTTCCTCCCGGGACTAGCGGGAGGGACCCCGTCCTACGAGCAGTACTTC	CASSFLPGLAGGTPSYEQYF	TRBV9	TRBJ2-7
TGTGCCAGCAGCGTGGACAGGGACTACGAGCAGTACTTC	CASSVDRDYEQYF	TRBV9	TRBJ2-7
TGTGCCAGCAGTCCAAGTAGACTAGCGGAGGCCTACAATGAGCAGTTCTTC	CASSPSRLAEAYNEQFF	TRBV6-8	TRBJ2-1
TGTGCCAGTTCCTTGGTCGACAGGTGGACAGGGGCTCTAGGCAATCAGCCCCAGCATTTT	CASSLVDRWTGALGNQPQHF	TRBV6-5	TRBJ1-5
TGTGCCAGCAGCGGACAGGCCGGGAGCTATGGCTACACCTTC	CASSGQAGSYGYTF	TRBV14	TRBJ1-2
TGTGCCAGCAGCGTAGCCCTGCGCGACTATGGCTACACCTTC	CASSVALRDYGYTF	TRBV9	TRBJ1-2
TGTGCTGGGGGGAGGCCCGCGAACACCGGGGAGCTGTTTTTT	CAGGRPANTGELFF	TRBV7-7	TRBJ2-2
TGTGCCTGGAAAGCGACAGGGAAGCAGCCCCAGCATTTT	CAWKATGKQPQHF	TRBV30	TRBJ1-5
TGCGCCACCCCCACAGGGACTAGCGGGTCAGAAAGCTCCTACAATGAGCAGTTCTTC	CATPTGTSGSESSYNEQFF	TRBV5-1	TRBJ2-1
TGCGCCAGCAATGAACTAACCCCAGGGTGCTCCTACGAGCAGTACTTC	CASNELTPGCSYEQYF	TRBV10-1	TRBJ2-7
TGTGCCACCAGTGATTCGGGGGGGGGTGTAGAAAACACCGGGGAGCTGTTTTTT	CATSDSGGGVENTGELFF	TRBV24-1	TRBJ2-2
TGTGCCAGCAGTGTTTCTGACACCGGGGAGCTGTTTTTT	CASSVSDTGELFF	TRBV6-5	TRBJ2-2
TGTGCCAGCAGCTTAGTGGGCAGGTGTTTACAAGAGACCCAGTACTTC	CASSLVGRCLQETQYF	TRBV7-9	TRBJ2-5
TGTGCCAGCAGTTACACCCCGCCTAGACAGGGCCGGAGAAGCAATCAGCCCCAGCATTTT	CASSYTPPRQGRRSNQPQHF	TRBV6-6	TRBJ1-5
TGTGCCAGTATTGTTAGACCGTGGGTAGGGGAGGAACAAAATTCACCCCTCCACTTT	CASIVRPWVGEEQNSPLHF	TRBV19	TRBJ1-6
TGCGCCAGCAGCCAAGAGCTTCCCAGGGGGAGAGGCAATCAGCCCCAGCATTTT	CASSQELPRGRGNQPQHF	TRBV4-1	TRBJ1-5
TGCGCCAGCAGCTTAAAACAAGGACAGGGGTTGCGTCAGCCCCAGCATTTT	CASSLKQGQGLRQPQHF	TRBV5-1	TRBJ1-5
TGTGCCAGTAGTCGCTGTTACGAGCAGTACTTC	CASSRCYEQYF	TRBV19	TRBJ2-7
TGCGCCAGCAAACCCCTACCGGGACAGGGGGACCTTCAGCCCCAGCATTTT	CASKPLPGQGDLQPQHF	TRBV5-1	TRBJ1-5
TGTGCCAGCAACCAGGGCACCGGGGAGCTGTTTTTT	CASNQGTGELFF	TRBV9	TRBJ2-2
TGTGCCACCAGTGATTTGGCTCGGGAGCTGAACCTCTACGAGCAGTACTTC	CATSDLARELNLYEQYF	TRBV24-1	TRBJ2-7
TGCAGTCCCCCGGGGGGTAATGAGCAGTTCTTC	CSPPGGNEQFF	TRBV20-1	TRBJ2-1
TGCAGTGCTATTAACCCCCCGACAGGGCGCACAGATACGCAGTATTTT	CSAINPPTGRTDTQYF	TRBV20-1	TRBJ2-3
TGCGCCAGCAGCTTGGCCGCGGGGACAGGGCGGGGGGAACTTCACTATGGCTACACCTTC	CASSLAAGTGRGELHYGYTF	TRBV5-1	TRBJ1-2
TGTGCCAGCAGCTTCCCTAACAGGACAGGGTGCACAGATACGCAGTATTTT	CASSFPNRTGCTDTQYF	TRBV7-3	TRBJ2-3
TGCGCCAGCAGTGAGAGCCTTACGCCATCCCGAACGCAGTATTTT	CASSESLTPSRTQYF	TRBV10-1	TRBJ2-3
TGTGCCAGCAGTTACAGGTGGGGGGGGGGGGCCGCCTACAATGAGCAGTTCTTC	CASSYRWGGGAAYNEQFF	TRBV6-2	TRBJ2-1
TGTGCCAGCAGCTTAACCGCCGGGACTAGCGGGGATTACAATGAGCAGTTCTTC	CASSLTAGTSGDYNEQFF	TRBV7-9	TRBJ2-1
TGTGCCAGCAGTTACTCGAAGGGGGCGATGGACGAGCAGTACTTC	CASSYSKGAMDEQYF	TRBV6-2	TRBJ2-7
TGTGCCAGCAGTGAGACAGGACAGGGGGCGGGTGATGGCTACACCTTC	CASSETGQGAGDGYTF	TRBV6-1	TRBJ1-2
TGTGCCAGCTCACGCTTGGCCACTGAAGCTTTCTTT	CASSRLATEAFF	TRBV18	TRBJ1-1
TGTGCCAGCCGCTTCTTGACTACGGGGGGGCCCTACGAGCAGTACTTC	CASRFLTTGGPYEQYF	TRBV27	TRBJ2-7
TGCGCCAGCAGTGCCCGTCGAGGAACCAGAGGGGACGAGCAGTACTTC	CASSARRGTRGDEQYF	TRBV10-1	TRBJ2-7
TGCAGTGCTAGAGCGTGCGTGAAGGGCCAGCCCCAGCATTTT	CSARACVKGQPQHF	TRBV20-1	TRBJ1-5
TGTGCCAGCAGCGGGGACCGCAGGGAGAATGAGCAGTTCTTC	CASSGDRRENEQFF	TRBV11-1	TRBJ2-1
TGTGCCAGCAGGTGGGGGGGCAGGGGATACACTGAAGCTTTCTTT	CASRWGGRGYTEAFF	TRBV9	TRBJ1-1
TGTGCCAGCTCACCCCCTCCCCAGGGCCCAGGGCCCTACGAGCAGTACTTC	CASSPPPQGPGPYEQYF	TRBV18	TRBJ2-7
TGTGCCACCAGTACAGCACTTACCGGGGAGCTGTTTTTT	CATSTALTGELFF	TRBV28	TRBJ2-2
TGTGCCAGCAGACCAATAGCGGGTATCAAGGGGACAGATACGCAGTATTTT	CASRPIAGIKGTDTQYF	TRBV6-2	TRBJ2-3
TGTGCCAGCAGCCCTTCAGGTTATTCCGGGGAAATCTACGAGCAGTACTTC	CASSPSGYSGEIYEQYF	TRBV13	TRBJ2-7
TGTGCCTGGAGTGACAGGGAGAGGGGTGAAGCTTTCTTT	CAWSDRERGEAFF	TRBV30	TRBJ1-1
TGTGCCAGCAGTAGTTGGGGGAGGCGGAAAAATGAGCAGTTCTTC	CASSSWGRRKNEQFF	TRBV6-1	TRBJ2-1
TGTGCCACCAGTGATTTGCCTGGAGATAAGGGCGACAAAAACATTCAGTACTTC	CATSDLPGDKGDKNIQYF	TRBV24-1	TRBJ2-4
TGTGCCAGCAGCTTAGGGGCAGGGCGATACGAGCAGTACTTC	CASSLGAGRYEQYF	TRBV7-2	TRBJ2-7
TGCAGCGTTGAAGGACCCCCGTTGGGACAGGGGAGCTCCTACGAGCAGTACTTC	CSVEGPPLGQGSSYEQYF	TRBV29-1	TRBJ2-7
TGTGCCTGGAGGGACCCCGGGACTAGGAGGGGGACCGGGGAGCTGTTTTTT	CAWRDPGTRRGTGELFF	TRBV30	TRBJ2-2
TGCGCCAGCAGCCAAGTCGGGCCCGGCTCTGGGGCCAACGTCCTGACTTTC	CASSQVGPGSGANVLTF	TRBV4-1	TRBJ2-6
TGTGCCAGCAGCGTAGCAAGGCACCGGGCTGTGGGGCGGGCTAACACCGGGGAGCTGTTTTTT	CASSVARHRAVGRANTGELFF	TRBV9	TRBJ2-2
TGCGCCAGCAGCCAAGATGAAGGACAGGGGGCGAAGGAAAGAAATCAGCCCCAGCATTTT	CASSQDEGQGAKERNQPQHF	TRBV4-3	TRBJ1-5
TGTGCCAGCAGCTGGGAACTTGGGGACAGGGACCGCTCCTACGAGCAGTACTTC	CASSWELGDRDRSYEQYF	TRBV11-3	TRBJ2-7
TGCGCCTCAGGGAAGTCCCAGCCCCAGCATTTT	CASGKSQPQHF	TRBV10-2	TRBJ1-5
TGTGCCAGCAGTTTCAAGGGGATCTACGAGCAGTACTTC	CASSFKGIYEQYF	TRBV6-6	TRBJ2-7
TGCAGTGCGGCCGGAAACTATGGCTACACCTTC	CSAAGNYGYTF	TRBV20-1	TRBJ1-2
TGTGCCAGCAGCTTATGGCGGCGACAGGCAGCGTCTGGGGCCAACGTCCTGACTTTC	CASSLWRRQAASGANVLTF	TRBV7-9	TRBJ2-6
TGTGCCAGCAGCTCGACAGCCCTACTTTACAATGAGCAGTTCTTC	CASSSTALLYNEQFF	TRBV5-4	TRBJ2-1
TGTGCCAGCAGCCGGCTAGGGACTAGCGGGCGGGACACCGGGGAGCTGTTTTTT	CASSRLGTSGRDTGELFF	TRBV4-2	TRBJ2-2
TGTGCCAGCAGTTCCCCGGGGGGCGGTCAGCCCCAGCATTTT	CASSSPGGGQPQHF	TRBV28	TRBJ1-5
TGCGCCAGCAGCGTAACTCCAACAGGGGGCTCTGGAAACACCATATATTTT	CASSVTPTGGSGNTIYF	TRBV5-1	TRBJ1-3
TGTGCCAGAAAATTGACAGGGCCATACGAGCAGTACTTC	CARKLTGPYEQYF	TRBV19	TRBJ2-7
TGTGCCAGCAGCTTACCCTTGAGGACAGAGACCAACACTGAAGCTTTCTTT	CASSLPLRTETNTEAFF	TRBV7-3	TRBJ1-1
TGTGCCTGGAGTTCTGGGACTATGAGTGAGACCCAGTACTTC	CAWSSGTMSETQYF	TRBV30	TRBJ2-5
TGTGCCAGCATATGCCTTAACGGGCGGAATAGCAATCAGCCCCAGCATTTT	CASICLNGRNSNQPQHF	TRBV27	TRBJ1-5
TGTGCCAGCAGTTACGCCCGCCAAGGGCAAGAGACCCAGTACTTC	CASSYARQGQETQYF	TRBV6-6	TRBJ2-5
TGTGCCAGCAGCTTAGCATCAGGGGATGAGCAGTTCTTC	CASSLASGDEQFF	TRBV7-8	TRBJ2-1
TGTGCCAGCAGCTTAGGACTAGCGGGCTGTGAGCAGTTCTTC	CASSLGLAGCEQFF	TRBV7-9	TRBJ2-1
TGTGCCAGCTCACCACCAAGTCCGGGAGGCAGTAACACTGAAGCTTTCTTT	CASSPPSPGGSNTEAFF	TRBV18	TRBJ1-1
TGTAGGGACGTTCAGGTTAGTAGCAATCAGCCCCAGCATTTT	CRDVQVSSNQPQHF	TRBV11-2	TRBJ1-5
TGTGTACCCGATACTACAGGGGGCCACTATGGCTACACCTTC	CVPDTTGGHYGYTF	TRBV12-3	TRBJ1-2
TGTGCCAGTAGTATAAGGACTGGGGAGACCCAGTACTTC	CASSIRTGETQYF	TRBV19	TRBJ2-5
TGTGCCAGCAGCAGCCCATCAGAGACCCAGTACTTC	CASSSPSETQYF	TRBV7-9	TRBJ2-5
TGTGCCAGCAGTGACGGCTCACCCCTCCACTTT	CASSDGSPLHF	TRBV25-1	TRBJ1-6
TGTGCCAGCAGTTACAAACAGGCCTTTTCTGAGACCCAGTACTTC	CASSYKQAFSETQYF	TRBV6-5	TRBJ2-5
TGTGCCAGTAGTTGGGACAGACCGGGAGGGGAGACCCAGTACTTC	CASSWDRPGGETQYF	TRBV19	TRBJ2-5
TGTGCCAGCAGCTGGGAGGTGGAGTATACCTACGAGCAGTACTTC	CASSWEVEYTYEQYF	TRBV11-2	TRBJ2-7
TGCAGTGCTCGGAGTTTTTCCTACAATGAGCAGTTCTTC	CSARSFSYNEQFF	TRBV20-1	TRBJ2-1
TGTGCCAGCAGCCAAAGGGGTCTGTTAAATTCACCCCTCCACTTT	CASSQRGLLNSPLHF	TRBV3-1	TRBJ1-6
TGTGCCAGCAGTTGGGGGAGTTTGCAGCCCCAGCATTTT	CASSWGSLQPQHF	TRBV12-4	TRBJ1-5
TGTGCCAGCAGCTTCAAGGGCGCTAGCACAGATACGCAGTATTTT	CASSFKGASTDTQYF	TRBV7-9	TRBJ2-3
TGTGCCCAGGCAAGGGGGGGACCCCTTAGTTGCCAAGAGACCCAGTACTTC	CAQARGGPLSCQETQYF	TRBV6-2	TRBJ2-5
TGCAGTGCCTACGGACCCTACAATCAGCCCCAGCATTTT	CSAYGPYNQPQHF	TRBV20-1	TRBJ1-5
TGCGCCAGCAACGGGGGACAGTTCCGGTATAGCAATCAGCCCCAGCATTTT	CASNGGQFRYSNQPQHF	TRBV10-1	TRBJ1-5
TGTGCCAGCAGTCTTTACGAGCAGTACTTC	CASSLYEQYF	TRBV6-2	TRBJ2-7
TGTGCCAGCAGTGAGGATATGAGAACAGTTTATAGCAATCAGCCCCAGCATTTT	CASSEDMRTVYSNQPQHF	TRBV6-4	TRBJ1-5
TGTGCCAGCAGTGAGGTTGCGGGACGGGGGGCTTATGGCTACACCTTC	CASSEVAGRGAYGYTF	TRBV25-1	TRBJ1-2
TGTGCTGAAAGACAGGCGGGGAACACTGAAGCTTTCTTT	CAERQAGNTEAFF	TRBV9	TRBJ1-1
TGCGCCAGCAGCAAATCGACTAGCGGGGACAATGAGCAGTTCTTC	CASSKSTSGDNEQFF	TRBV5-1	TRBJ2-1
TGTGCCAGCAGTTCACTCTCCGGGCCGGAGGCTGGAAACACCATATATTTT	CASSSLSGPEAGNTIYF	TRBV27	TRBJ1-3
TGTGCCAGCAGCTTAAATGGGAAAAATTCACCCCTCCACTTT	CASSLNGKNSPLHF	TRBV7-2	TRBJ1-6
TGTGCCAGCAGCCGGACAGAACCGGGATCTACCTACGAGCAGTACTTC	CASSRTEPGSTYEQYF	TRBV11-2	TRBJ2-7
TGTGCCACCAGTGATTTGGCTTGCGGTCCCTACGAGCAGTACTTC	CATSDLACGPYEQYF	TRBV24-1	TRBJ2-7
TGTGCCAGCAACAGGGGGCGGAATGGGGGGGATGGCTACACCTTC	CASNRGRNGGDGYTF	TRBV2	TRBJ1-2
TGTGCCTGGGGCAGTGAAAAACTGTTTTTT	CAWGSEKLFF	TRBV30	TRBJ1-4
TGTGCCAGCAGCCCAGGACACCTCAACTATGGCTACACCTTC	CASSPGHLNYGYTF	TRBV9	TRBJ1-2
TGTGCCAACGGGGGGTTTGCCTACGAGCAGTACTTC	CANGGFAYEQYF	TRBV2	TRBJ2-7
TGTGCCAGCTCACCAGGTCCAAGATCGGTTAGTATAGAGACCCAGTACTTC	CASSPGPRSVSIETQYF	TRBV18	TRBJ2-5
TGTGCCACCAGTGACCGGCAGGGCTGGGGTAATGGGGCCAACGTCCTGACTTTC	CATSDRQGWGNGANVLTF	TRBV24-1	TRBJ2-6
TGTGCCAGCAGCTTGGCGGGCCTGGACTACGAGCAGTACTTC	CASSLAGLDYEQYF	TRBV5-5	TRBJ2-7
TGCAGTGCTAGAGAGCTCCCCAAGCGGGGGGGGGCTATCCCAGATACGCAGTATTTT	CSARELPKRGGAIPDTQYF	TRBV20-1	TRBJ2-3
TGTGCCAGCAGACCCCCGCAGGTCTACGAGCAGTACTTC	CASRPPQVYEQYF	TRBV27	TRBJ2-7
TGTGCCAGCAGTTTGTTAGAGGGGCGATGTAATGAAAAACTGTTTTTT	CASSLLEGRCNEKLFF	TRBV27	TRBJ1-4
TGTGCCACCAAAACGACTAGTTCCTACGAGCAGTACTTC	CATKTTSSYEQYF	TRBV24-1	TRBJ2-7
TGTGCCAGCAGCACGGGGACAGGGGTCCAGGGCTACGAGCAGTACTTC	CASSTGTGVQGYEQYF	TRBV5-4	TRBJ2-7
TGTGCCACCAGTCACCGGACGGAAGGGGAGAACAAAAACATTCAGTACTTC	CATSHRTEGENKNIQYF	TRBV24-1	TRBJ2-4
TGTGCCAGCAGCACCGGGACATTCAACTATGGCTACACCTTC	CASSTGTFNYGYTF	TRBV6-5	TRBJ1-2
TGTGCCCGTACTGGGGACAGGGGCGAAGATGAAAAACTGTTTTTT	CARTGDRGEDEKLFF	TRBV6-4	TRBJ1-4
TGTGCCAGCAGTTTATCGTCGTCGACACCCACACCTGAGACCCAGTACTTC	CASSLSSSTPTPETQYF	TRBV27	TRBJ2-5
TGTGCCACAAAGCCTGCCTCCTACGAGCAGTACTTC	CATKPASYEQYF	TRBV25-1	TRBJ2-7
TGTGCCAGCAGGGGAGGGCTCTACGAGCAGTACTTC	CASRGGLYEQYF	TRBV25-1	TRBJ2-7
TGTGCCAGCATGCCCCCGTTCCACAAAAACATTCAGTACTTC	CASMPPFHKNIQYF	TRBV3-1	TRBJ2-4
TGTGCCAGCAGTTTAGACAGGGGGCGGAAGAACACTGAAGCTTTCTTT	CASSLDRGRKNTEAFF	TRBV27	TRBJ1-1
TGTGCCAGCAGCTTAACCCCTAGCCCCGGGATTTTGAGGACAGTGCCATGGGGCAGGTACGAGCAGTACTTC	CASSLTPSPGILRTVPWGRYEQYF	TRBV7-3	TRBJ2-7
TGTGCCAGCGAACTGGTAGGGGGGGGGGATACGCAGTATTTT	CASELVGGGDTQYF	TRBV18	TRBJ2-3
TGCAGTGCTAGTACGAGCGAGGGCTTAGTGGAGCAGTTCTTC	CSASTSEGLVEQFF	TRBV20-1	TRBJ2-1
TGTGCCGCGGGACAGGGGTCCATGAACACTGAAGCTTTCTTT	CAAGQGSMNTEAFF	TRBV6-2	TRBJ1-1
TGTGCCAGCAGTAAAGGGACAGGGGGCGCGGAAATGGTTGAGAGGGCTTTCTTT	CASSKGTGGAEMVERAFF	TRBV6-3	TRBJ1-1
TGTGCCAGCAGCGAGTCTACCTACGAGCAGTACTTC	CASSESTYEQYF	TRBV13	TRBJ2-7
TGTGCCAGCAGTGAACCCAGGGCGGGTGAAAAACTGTTTTTT	CASSEPRAGEKLFF	TRBV2	TRBJ1-4
TGTGCCAGCAGCAGGCTCAGGGGAGACAGGGCTCAGGATAGCAATCAGCCCCAGCATTTT	CASSRLRGDRAQDSNQPQHF	TRBV6-1	TRBJ1-5
TGCGCCAGACCCCCTAGACGCAAAATGCTAGCCAAAAACATTCAGTACTTC	CARPPRRKMLAKNIQYF	TRBV10-1	TRBJ2-4
TGTGCCAGCAGCTGTGACCACAGGGAAAGGAATGAAGCTTTCTTT	CASSCDHRERNEAFF	TRBV7-3	TRBJ1-1
TGTGCCAGCAGTTTACTGGGAGGCCTCCGTGCAACTAATGAAAAACTGTTTTTT	CASSLLGGLRATNEKLFF	TRBV28	TRBJ1-4
TGTGCCAGCAGTGACTCTCTAGCGGGACGGCTGGACCACACGGAATTGTCCTACAATGAGCAGTTCTTC	CASSDSLAGRLDHTELSYNEQFF	TRBV6-4	TRBJ2-1
TGTGCCAGTAGTAACGTTCCCTTTACCGGCCAAGAGACCCAGTACTTC	CASSNVPFTGQETQYF	TRBV19	TRBJ2-5
TGTGCCAGCAGCCAAGATCTGTGGACTAGCGGGCTCAGGCCCAGCACAGATACGCAGTATTTT	CASSQDLWTSGLRPSTDTQYF	TRBV3-1	TRBJ2-3
TGCAGTGCTACCGGCGGGTCGGACTACAATGAGCAGTTCTTC	CSATGGSDYNEQFF	TRBV20-1	TRBJ2-1
TGTGCCACCAGTGCTCCGGGACAGGGGGGGACGAACACCGGGGAGCTGTTTTTT	CATSAPGQGGTNTGELFF	TRBV24-1	TRBJ2-2
TGTGCCAGCAGCTCTGGGGGAGTCCCGGGTAGGGACTGTGGAACCGGGGAGCTGTTTTTT	CASSSGGVPGRDCGTGELFF	TRBV13	TRBJ2-2
TGTGCCACAACCGACAGGGCACCGCAGTTCTTC	CATTDRAPQFF	TRBV24-1	TRBJ2-1
TGTGCCAGCAGTGAAAGTGAAGCACTGCGACGTGAGCAGTTCTTC	CASSESEALRREQFF	TRBV2	TRBJ2-1
TGCAGTGCTAGAGGCACTAGCGGGAGTTTCTACGAGCAGTACTTC	CSARGTSGSFYEQYF	TRBV20-1	TRBJ2-7
TGCAGTGGTTTATACAGGGGACTCTCCTACGAGCAGTACTTC	CSGLYRGLSYEQYF	TRBV20-1	TRBJ2-7
TGCAGCGCGAGGGGGCCTGCAAGACAAATTGAGAACACCGGGGAGCTGTTTTTT	CSARGPARQIENTGELFF	TRBV29-1	TRBJ2-2
TGTGCCAGCAGTTACTCAGGATCGGGTCAGGGGAACGGACAGGGAAGGGGCTACGAGCAGTACTTC	CASSYSGSGQGNGQGRGYEQYF	TRBV6-5	TRBJ2-7
TGTGCCACCGTTTGGTGCAGGAAGAATCAGCCCCAGCATTTT	CATVWCRKNQPQHF	TRBV24-1	TRBJ1-5
TGTGCCACCAGCAGAGAGGTGCCGCCGGGACAGGTCAACTCCTACGAGCAGTACTTC	CATSREVPPGQVNSYEQYF	TRBV15	TRBJ2-7
TGTGCCAGCAGTTCGCGCCAAAATACGGGCTCCAGGAACACTGAAGCTTTCTTT	CASSSRQNTGSRNTEAFF	TRBV6-5	TRBJ1-1
TGTGCCAGCAGTGGTGGCGGGAGGGTCTATGGCTACACCTTC	CASSGGGRVYGYTF	TRBV2	TRBJ1-2
TGCAGTGCTGAGACAGTCGGACAGGGGGTTTCACCCCTCCACTTT	CSAETVGQGVSPLHF	TRBV20-1	TRBJ1-6
TGTGCCAGCGAATGTGCTCGATTGTTGGGCTCTGAAGCTTTCTTT	CASECARLLGSEAFF	TRBV7-9	TRBJ1-1
TGTGCCAGCAGCATCAGAGAAATAGAATACAATGAGCAGTTCTTC	CASSIREIEYNEQFF	TRBV7-3	TRBJ2-1
TGTGCCTTCCCCTACGGGGATGAAAAACTGTTTTTT	CAFPYGDEKLFF	TRBV30	TRBJ1-4
TGTGCCAGCAGTAGACCCATAAATCAGCCCCAGCATTTT	CASSRPINQPQHF	TRBV5-6	TRBJ1-5
TGCAGTGCTACTGGACTCTTAAACACTGAAGCTTTCTTT	CSATGLLNTEAFF	TRBV20-1	TRBJ1-1
TGTGCCAGCACCCGCGGGCGGCAGTGGGGGAGACGAGAGACCCAGTACTTC	CASTRGRQWGRRETQYF	TRBV6-4	TRBJ2-5
TGTGCCAGTGACAGAACTGATCAGCCCCAGCATTTT	CASDRTDQPQHF	TRBV19	TRBJ1-5
TGTGCCAGTAGTTTGGAGGACATGAACATTCAGTACTTC	CASSLEDMNIQYF	TRBV19	TRBJ2-4
TGTGCCAGCAGTCACCACCCCGGGACCCCGTGGGTACCCTACGAGCAGTACTTC	CASSHHPGTPWVPYEQYF	TRBV28	TRBJ2-7
TGTTACGGGCTTGGAAACACCATATATTTT	CYGLGNTIYF	TRBV30	TRBJ1-3
TGCGCCAGCAGGGGCACGAACTATGGCTACACCTTC	CASRGTNYGYTF	TRBV10-1	TRBJ1-2
TGTGCCAGCAAAAACGGGCGACAGGGAGAGAGGCCGGAGGGGGATACCAATCAGCCCCAGCATTTT	CASKNGRQGERPEGDTNQPQHF	TRBV6-5	TRBJ1-5
TGCGCCAGCAGCTTGGGGAACTGGAAGCTATCATACGAGCAGTACTTC	CASSLGNWKLSYEQYF	TRBV5-1	TRBJ2-7
TGTGCCAGCAGCTTAGAAGGAGCGGTAAGCGGGAGGCCGGCCTACGAGCAGTACTTC	CASSLEGAVSGRPAYEQYF	TRBV11-3	TRBJ2-7
TGTGCCAGCAGCAGGGGGCTTACCCTAGGTGGAAACACCATATATTTT	CASSRGLTLGGNTIYF	TRBV13	TRBJ1-3
TGTGCCAGCAGCGTAGAGCCAGCCCTCGTGGGGGGGGGCACAGATACGCAGTATTTT	CASSVEPALVGGGTDTQYF	TRBV9	TRBJ2-3
TGTGCCGGAGCGGGAATAAGGCCTAACTATGGCTACACCTTC	CAGAGIRPNYGYTF	TRBV27	TRBJ1-2
TGTGCCAGCAGACAGCTGGATGAGCAGTTCTTC	CASRQLDEQFF	TRBV7-9	TRBJ2-1
TGCGCCAGCAGCCCCGCTAGCGGTGACCCGGGAGGGACAGATACGCAGTATTTT	CASSPASGDPGGTDTQYF	TRBV4-1	TRBJ2-3
TGTGCCTGGAGAACTCACCGCATGGCTGGGGCCAACGTCCTGACTTTC	CAWRTHRMAGANVLTF	TRBV30	TRBJ2-6
TGTGCCAGCAGCCGGGACAGGGGTCTCAAGGCTTTCTTT	CASSRDRGLKAFF	TRBV7-3	TRBJ1-1
TGTGCCAGCAGGGACAGCTGGGAGGATACGCAGTATTTT	CASRDSWEDTQYF	TRBV6-5	TRBJ2-3
TGTGCCAGCAGCTTGTCTCCCACAAAACTGTTTTTT	CASSLSPTKLFF	TRBV7-9	TRBJ1-4
TGTGCCAGCTCACCAGTCTTTGCACTCTACGAGCAGTACTTC	CASSPVFALYEQYF	TRBV18	TRBJ2-7
TGTGCCAGCAGACTCCGACAGAGAGGCTACACCTTC	CASRLRQRGYTF	TRBV5-6	TRBJ1-2
TGTGCCAGCAGCCCCGGGACTAGCGGGCGAATCCCCGGAAATGAGCAGTTCTTC	CASSPGTSGRIPGNEQFF	TRBV7-8	TRBJ2-1
TGTGCCAGCAGTGGCGGCCGGACTAGCGGGTCCACAGATACGCAGTATTTT	CASSGGRTSGSTDTQYF	TRBV6-4	TRBJ2-3
TGCGCCAGCAGCCAAGATGGGGAATGGAAGGGGGGTGGGAACACTGAAGCTTTCTTT	CASSQDGEWKGGGNTEAFF	TRBV4-1	TRBJ1-1
TGTGCCACCAGGATCGGCCGTGAGTGCCCGCAGTATTTT	CATRIGRECPQYF	TRBV15	TRBJ2-3
TGTGCCAGCAGTAACGGCTCCGGGGAGCTGTTTTTT	CASSNGSGELFF	TRBV5-4	TRBJ2-2
TGTGCCAGCAGCCTCGAATTACAAGGGACAGAGTCGAACACTGAAGCTTTCTTT	CASSLELQGTESNTEAFF	TRBV13	TRBJ1-1
TGTGCCAGCAGTTACTCGACCGCGGGAGTCTTGGAGTACGAGCAGTACTTC	CASSYSTAGVLEYEQYF	TRBV6-5	TRBJ2-7
TGTGCCAGCAGCCTGGTCCGTAACGGACGGCGGGACCGGAGACGGTCCCAGTACTTC	CASSLVRNGRRDRRRSQYF	TRBV11-2	TRBJ2-5
TGCGCCAGCAGCCCGGGACACCGCAATCAGCCCCAGCATTTT	CASSPGHRNQPQHF	TRBV5-1	TRBJ1-5
TGTGCCAGCAGTGACCCCGAGGGCAGGGCTGAAGCTTTCTTT	CASSDPEGRAEAFF	TRBV6-4	TRBJ1-1
TGTGCCAGCCAGGCCGACAGGGACCGGGGAAACACCATATATTTT	CASQADRDRGNTIYF	TRBV6-2	TRBJ1-3
TGTGCCAGAGTGGGACAGGTGGACTGCGGGGAGCTGTTTTTT	CARVGQVDCGELFF	TRBV10-3	TRBJ2-2
TGTGCCAGCAGCAAATTCGGCGAGCAGTACTTC	CASSKFGEQYF	TRBV6-4	TRBJ2-7
TGTGCCAGCAGTTCATGGAGTTCACCCCTCCACTTT	CASSSWSSPLHF	TRBV12-3	TRBJ1-6
TGTGCCAGCAGCCAAGATGGGCGGGGCCGAGGAGGTAGGGAGCAGTTCTTC	CASSQDGRGRGGREQFF	TRBV14	TRBJ2-1
TGTGCCAGCAGCCTAGCATGGAAACCCACAGATACGCAGTATTTT	CASSLAWKPTDTQYF	TRBV7-3	TRBJ2-3
TGTGCCAGCAGTCTCCGGCTCCAGGGGGCGCTCCCCAATCAGCCCCAGCATTTT	CASSLRLQGALPNQPQHF	TRBV12-3	TRBJ1-5
TGTGCCAGCAGCCGGCGGCCTAGCAATCAGCCCCAGCATTTT	CASSRRPSNQPQHF	TRBV11-3	TRBJ1-5
TGTGCCAGCAGCCGAGACTCGAGGCACTCCGACACCGGGGAGCTGTTTTTT	CASSRDSRHSDTGELFF	TRBV3-1	TRBJ2-2
TGTGCCAGTAGTATAGATGGATACCTCAGGACAGGGCATAGGGTCACAGATACGCAGTATTTT	CASSIDGYLRTGHRVTDTQYF	TRBV19	TRBJ2-3
TGCGCCAGCAGCCAAGCTAGGGGGCGAGGGAACACTGAAGCTTTCTTT	CASSQARGRGNTEAFF	TRBV4-3	TRBJ1-1
TGTGCCAGCAGTCCCTCTTGCGGGCGACCAAATGCCAATGAGCAGTTCTTC	CASSPSCGRPNANEQFF	TRBV12-4	TRBJ2-1
TGTGCCAGCATCAGGGGGACTAGCGGGAGCTCCTACAATGAGCAGTTCTTC	CASIRGTSGSSYNEQFF	TRBV7-9	TRBJ2-1
TGTGCCAGCAGCCAAGCGGGGAGGGTTAGGGCAGATACGCAGTATTTT	CASSQAGRVRADTQYF	TRBV14	TRBJ2-3
TGTGCCACCGATAGGGGGCAGGCTTCATACGAGCAGTACTTC	CATDRGQASYEQYF	TRBV24-1	TRBJ2-7
TGTGCCAGCAGCTTAGAGCAGCCATGCAAAAACATTCAGTACTTC	CASSLEQPCKNIQYF	TRBV7-6	TRBJ2-4
TGTGCCAGCAGCGGCCCCCGCGTCGACGTAGCCAAAAACATTCAGTACTTC	CASSGPRVDVAKNIQYF	TRBV7-8	TRBJ2-4
TGTGCCAGCAGAGGAGCCCCAGGGCTTTGCTATGGCTACACCTTC	CASRGAPGLCYGYTF	TRBV5-6	TRBJ1-2
TGTGCCAGCAGCTTAGGGTACAGGGACTGGAACACCGGGGAGCTGTTTTTT	CASSLGYRDWNTGELFF	TRBV7-8	TRBJ2-2
TGTGCCAGCAGTTACTCGACTAGTGAGCGGGATCGCTCTGGAAACACCATATATTTT	CASSYSTSERDRSGNTIYF	TRBV6-5	TRBJ1-3
TGTGCCAGCAGCTTGGAGCTCTACGAGCAGTACTTC	CASSLELYEQYF	TRBV5-4	TRBJ2-7
TGTGCCAGCAGCAGGGTCTACGGCTCACCCCTCCACTTT	CASSRVYGSPLHF	TRBV5-4	TRBJ1-6
TGTGCCAGCAGCTCGAGTTTTCAGGGGGGGGACCCAACTGAAGCTTTCTTT	CASSSSFQGGDPTEAFF	TRBV13	TRBJ1-1
TGTGCCAGCGGGACAGGGGCTGCTTTCTTT	CASGTGAAFF	TRBV19	TRBJ1-1
TGTGCCAGCAGGACGGGGGGGGGGTGCACAGATACGCAGTATTTT	CASRTGGGCTDTQYF	TRBV6-3	TRBJ2-3
TGTGCCACCGGACGAGACGGGGATACGCAGTATTTT	CATGRDGDTQYF	TRBV2	TRBJ2-3
TGTGCCAGCAGCCAAGGTCGCCCCGAGGGGTTGGAGTTCGAAGGCTACACCTTC	CASSQGRPEGLEFEGYTF	TRBV4-2	TRBJ1-2
TGTGCCTGGAGTGTAAAAACAATTTGGCAAGAGACCCAGTACTTC	CAWSVKTIWQETQYF	TRBV30	TRBJ2-5
TGCGCCATCCGAGGACAAAAACGAGGGGCGGTCTACGAGCAGTACTTC	CAIRGQKRGAVYEQYF	TRBV5-1	TRBJ2-7
TGTGCCAGCAGCTTGCGGCGGGCAGATACGCAGTATTTT	CASSLRRADTQYF	TRBV5-6	TRBJ2-3
TGTGCCAGCTCGAAGAGGGTGTACACCGGGGAGCTGTTTTTT	CASSKRVYTGELFF	TRBV6-4	TRBJ2-2
TGTGCCAGCAGCAGACGAGGGAGCCAAGAGACCCAGTACTTC	CASSRRGSQETQYF	TRBV13	TRBJ2-5
TGTGCCACCAGCTTAACGCCCGGGACAGGGGGTACTGAGTCACCCCTCCACTTT	CATSLTPGTGGTESPLHF	TRBV15	TRBJ1-6
TGTGCCAGCAGCAACTGCTGGTATGAGCAGTTCTTC	CASSNCWYEQFF	TRBV11-2	TRBJ2-1
TGTGCCAGCAGTTACACCCCCGCCCTAGCCAAAAACATTCAGTACTTC	CASSYTPALAKNIQYF	TRBV6-5	TRBJ2-4
TGTGCCAGCAGTTTTGACTACGAGCAGTACTTC	CASSFDYEQYF	TRBV12-4	TRBJ2-7
TGTGCCAGCAGGCCAGGGCAGACTAATGAAAAACTGTTTTTT	CASRPGQTNEKLFF	TRBV5-6	TRBJ1-4
TGTGCCAGCAGCCAAGATGACAGGGAGTCGCGACTCACAGATACGCAGTATTTT	CASSQDDRESRLTDTQYF	TRBV3-1	TRBJ2-3
TGTGCCATCAGGTCGGGCCTCCATTCACCCCTCCACTTT	CAIRSGLHSPLHF	TRBV10-3	TRBJ1-6
TGTGCCAGCAGCAGTTACCGGACAGTCAATCAGCCCCAGCATTTT	CASSSYRTVNQPQHF	TRBV9	TRBJ1-5
TGCGCCAGCAGGGTCTTCAGGGACTCAACTAATGAAAAACTGTTTTTT	CASRVFRDSTNEKLFF	TRBV10-1	TRBJ1-4
TGTGCCTGGAGTGGTCCCCGGGGCCCGAAGACCGGGGAGCTGTTTTTT	CAWSGPRGPKTGELFF	TRBV30	TRBJ2-2
TGTGCTAGTGGTTTGGTACAACTAGGCACAGATACGCAGTATTTT	CASGLVQLGTDTQYF	TRBV12-5	TRBJ2-3
TGTGCCAGCAGTACTAGCGGTGACTCCAGGAATGAGCAGTTCTTC	CASSTSGDSRNEQFF	TRBV6-1	TRBJ2-1
TGTGCCAGCAGCTTGGGGCTCCCGGTGCCCAGGGAGCCGGGAAACACCATATATTTT	CASSLGLPVPREPGNTIYF	TRBV5-4	TRBJ1-3
TGTGCCAGCAGTGAGCGGGCGACTAGGTGCCTTAGCTACGAGCAGTACTTC	CASSERATRCLSYEQYF	TRBV25-1	TRBJ2-7
TGCGCCGCGTCAGGGGGTGGCTACACCTTC	CAASGGGYTF	TRBV10-2	TRBJ1-2
TGTGCCAGCAGCCAAGATAGGACAGCTGGCTACACCTTC	CASSQDRTAGYTF	TRBV14	TRBJ1-2
TGTGCCAGTAGTATGCAGAAGGGCTACACCTTC	CASSMQKGYTF	TRBV19	TRBJ1-2
TGTGCCAGCAGCTTAGGGGCGGACAATCAGCCCCAGCATTTT	CASSLGADNQPQHF	TRBV11-2	TRBJ1-5
TGTGCCAGCAGCGGGGGGGGGGAGGACTATGGCTACACCTTC	CASSGGGEDYGYTF	TRBV11-3	TRBJ1-2
TGCGCCAGCAGCCAAGATACACGATTACAGGGGGCGACCCAGCATTTT	CASSQDTRLQGATQHF	TRBV4-1	TRBJ1-5
TGTGCCAGCAGCCGGACTAGATACGGCCGGGAGAGTCCCTACGAGCAGTACTTC	CASSRTRYGRESPYEQYF	TRBV5-6	TRBJ2-7
TGTGCCAGCAGTTCCTCCGGACAGGGTGTCACTGAAGCTTTCTTT	CASSSSGQGVTEAFF	TRBV6-2	TRBJ1-1
TGTGCCAGCAGCTTAACAGGGGGCTACGTGGGAGAGACCCAGTACTTC	CASSLTGGYVGETQYF	TRBV9	TRBJ2-5
TGCAGTGCGGTCAGGGAAGAGACCCAGTACTTC	CSAVREETQYF	TRBV20-1	TRBJ2-5
TGCGCCAGCAACGCAGCTACTGGAAACACCATATATTTT	CASNAATGNTIYF	TRBV10-1	TRBJ1-3
TGCGCCAGCAGTGAGGGGGCCCCGGGCGGGGACGAGACCCAGTACTTC	CASSEGAPGGDETQYF	TRBV10-1	TRBJ2-5
TGTGCCAGAGCACAAGACAGGACAGCAGATACGCAGTATTTT	CARAQDRTADTQYF	TRBV19	TRBJ2-3
TGTGCCAGCAGCTTCAGGGTAACTGAAGCTTTCTTT	CASSFRVTEAFF	TRBV7-3	TRBJ1-1
TGTGCCATCAGTGAGCCCCAATACCAGGGCAAGCGCACAGATACGCAGTATTTT	CAISEPQYQGKRTDTQYF	TRBV10-3	TRBJ2-3
TGTGCCAGCAGCTGCCACCAGGGTCAATACGTGTATAGCAATCAGCCCCAGCATTTT	CASSCHQGQYVYSNQPQHF	TRBV13	TRBJ1-5
TGTGCCAGCAGCACTACAGGGAGCAATCAGCCCCAGCATTTT	CASSTTGSNQPQHF	TRBV7-4	TRBJ1-5
TGCAGTGCTAGAAGGACTATGGTTTCAGGTTACAATGAGCAGTTCTTC	CSARRTMVSGYNEQFF	TRBV20-1	TRBJ2-1
TGTGCCAGCAGTTTAAAGCCGGGACAGGGTAGGACCGGGGAGCTGTTTTTT	CASSLKPGQGRTGELFF	TRBV27	TRBJ2-2
TGCAGCGTTGTTAGGGGAGGGAAGCGGAACACCGGGGAGCTGTTTTTT	CSVVRGGKRNTGELFF	TRBV29-1	TRBJ2-2
TGTGCCAGTAGCAAACGGGGGGACAGGGCCGAGCAGTACTTC	CASSKRGDRAEQYF	TRBV19	TRBJ2-7
TGCGCCAGCAGTGAGCCTCCCGGTCCTAGTCCTGAGTCCTACGAGCAGTACTTC	CASSEPPGPSPESYEQYF	TRBV10-1	TRBJ2-7
TGTGCCAGCAGTGAGTGGGACAGGGGCGAAGAGACCCAGTACTTC	CASSEWDRGEETQYF	TRBV25-1	TRBJ2-5
TGTGCCAGCAGCGCTAGCGGACCAGATACGCAGTATTTT	CASSASGPDTQYF	TRBV7-2	TRBJ2-3
TGTGCCAGCAGCTTAAGGTTAGCGGGCCAGCAGTACTTC	CASSLRLAGQQYF	TRBV7-3	TRBJ2-7
TGTGCCAGCAGCGGTCTGGAGAAGAGCACAGATACGCAGTATTTT	CASSGLEKSTDTQYF	TRBV9	TRBJ2-3
TGTGCCAGCTCGGAGGGAAAAAATGAAGCTTTCTTT	CASSEGKNEAFF	TRBV27	TRBJ1-1
TGTGCCAGCAGTCCTCCAGGGGGCCGGTCCAATGAGCAGTTCTTC	CASSPPGGRSNEQFF	TRBV6-5	TRBJ2-1
TGTGCCAGGGGGGGGAACACCGGGGAGCTGTTTTTT	CARGGNTGELFF	TRBV6-1	TRBJ2-2
TGTGCCAGCAGTGACCAGGGGTTCGAGACCCAGTACTTC	CASSDQGFETQYF	TRBV2	TRBJ2-5
TGTGCCAGCAGCGGCGGACGGCAAGAGACCCAGTACTTC	CASSGGRQETQYF	TRBV13	TRBJ2-5
TGTGCCAGCTACAGGGAAGCGAACACTGAAGCTTTCTTT	CASYREANTEAFF	TRBV5-4	TRBJ1-1
TGTGCCAGCCCTATAGCGGGGAGATGGGGGAGGTACAATGAGCAGTTCTTC	CASPIAGRWGRYNEQFF	TRBV7-9	TRBJ2-1
TGTGCCAGAAGGCGGGACAGCAGAAATGAGCAGTTCTTC	CARRRDSRNEQFF	TRBV6-1	TRBJ2-1
TGCGCCAGCGTCGATCAGGGCGACACTACGAACACCGGGGAGCTGTTTTTT	CASVDQGDTTNTGELFF	TRBV5-1	TRBJ2-2
TGCGCCAGCAGCTGTGAGGGGCGACTTGGCAGGCATCCCTACGAGCAGTACTTC	CASSCEGRLGRHPYEQYF	TRBV5-1	TRBJ2-7
TGTGCCAGCAGCCAAGATGGGCCGGGACATTACGGCAATGAGCAGTTCTTC	CASSQDGPGHYGNEQFF	TRBV14	TRBJ2-1
TGTGCCAGCAGCCAGGGGGCAAATGAGCAGTTCTTC	CASSQGANEQFF	TRBV7-4	TRBJ2-1
TGCAGTGCTATCCCCGGGTCTTTGTTCTACGAGCAGTACTTC	CSAIPGSLFYEQYF	TRBV20-1	TRBJ2-7
TGTGCCAGCAGCCGGGACAGGTTGCAAGCTTTCTTT	CASSRDRLQAFF	TRBV5-4	TRBJ1-1
TGCGCCAGCAGCGGGACAGGGAATCAGCCCCAGCATTTT	CASSGTGNQPQHF	TRBV5-1	TRBJ1-5
TGTGCCAGCAGCTTAGCTGGGGGGCGTACAGCCTACAATGAGCAGTTCTTC	CASSLAGGRTAYNEQFF	TRBV7-9	TRBJ2-1
TGTGCCAGCAGCTACCTAGGGACTAGCAACACCGGGGAGCTGTTTTTT	CASSYLGTSNTGELFF	TRBV7-3	TRBJ2-2
TGTGCCAGCAGCTTAGGGCATCTGAAATCCTACAATGAGCAGTTCTTC	CASSLGHLKSYNEQFF	TRBV11-2	TRBJ2-1
TGTGCCAGCAGAGGAACCTCTAAGGCGATCTTC	CASRGTSKAIF	TRBV6-4	TRBJ2-1
TGTGCCAGGGACAGGGTGGACTACACCTTC	CARDRVDYTF	TRBV12-4	TRBJ1-2
TGCGCCAGCAGCTTGGTAAAGACAGAGTTAAACACTGAAGCTTTCTTT	CASSLVKTELNTEAFF	TRBV5-1	TRBJ1-1
TGTGCCAAGTTCCCAGGACAGGAGTTAGACGAGCAGTACTTC	CAKFPGQELDEQYF	TRBV27	TRBJ2-7
TGTGCCAGCAGCTTATCGGACAGTATTGAAAAACTGTTTTTT	CASSLSDSIEKLFF	TRBV13	TRBJ1-4
TGTGCCAGCAGCCCGAACCAGGGGGGGGGGACCAGGGAGCAGTACTTC	CASSPNQGGGTREQYF	TRBV4-2	TRBJ2-7
TGTGCCATCAGTGCTGGGCTGCCTCAGCCCCAGCATTTT	CAISAGLPQPQHF	TRBV10-3	TRBJ1-5
TGTGCCAGCAGTTACTCCCCGGGCAATCAGCCCCAGCATTTT	CASSYSPGNQPQHF	TRBV6-6	TRBJ1-5
TGTGCCACGCACGGCTTTTACTACGAGCAGTACTTC	CATHGFYYEQYF	TRBV11-2	TRBJ2-7
TGCGCCAGCAGCCAAGGGACCAAAAACATTCAGTACTTC	CASSQGTKNIQYF	TRBV4-1	TRBJ2-4
TGTGCCAGCAGCGGGGGGCTTAGCTCCTACAATGAGCAGTTCTTC	CASSGGLSSYNEQFF	TRBV9	TRBJ2-1
TGTGCCAGCAGCCAAGTAAGGGACAGGGGCACTGAAGCTTTCTTT	CASSQVRDRGTEAFF	TRBV3-1	TRBJ1-1
TGTGCCAGCCGAGGGGGGGAAGAGACCCAGTACTTC	CASRGGEETQYF	TRBV18	TRBJ2-5
TGCGCCAGCAGCCTCAAAAGGAATCAGCCCCAGCATTTT	CASSLKRNQPQHF	TRBV4-1	TRBJ1-5
TGTGCCAGCAGTGACAGCGGGAATGGCTACACCTTC	CASSDSGNGYTF	TRBV25-1	TRBJ1-2
TGTGCCAGCAGCTTAAGCCGGGGGCATGAAGCTTTCTTT	CASSLSRGHEAFF	TRBV7-3	TRBJ1-1
TGCGCCAGCAGCACGAGCCGTAAACTAAAAGAGACCCAGTACTTC	CASSTSRKLKETQYF	TRBV5-1	TRBJ2-5
TGTGCCAGTAGTATAGGACAGGGGGGGCGAAACACTGAAGCTTTCTTT	CASSIGQGGRNTEAFF	TRBV19	TRBJ1-1
TGTGCTAGCAGCAATAGACGGGCGAACTCTTATAATGAAAAACTGTTTTTT	CASSNRRANSYNEKLFF	TRBV7-7	TRBJ1-4
TGTGCCAGCAGCCGAGGGGTAGGCTTACTCGTGCTGCGGACAGGGTATGGCTACACCTTC	CASSRGVGLLVLRTGYGYTF	TRBV13	TRBJ1-2
TGTGCCAGTAACTCCGGTGAGGAGACCAATGAGCAGTTCTTC	CASNSGEETNEQFF	TRBV19	TRBJ2-1
TGTGCCAGCAGCTACCACGCGCCAATCTCACCTTCTGGCGAATTCTCTAATGAAAAACTGTTTTTT	CASSYHAPISPSGEFSNEKLFF	TRBV7-9	TRBJ1-4
TGTGCCAGCAGCGGGGGCGAACCAAACTATGGCTACACCTTC	CASSGGEPNYGYTF	TRBV13	TRBJ1-2
TGCAGTGCCCATGAGGGACACGATGAAAAACTGTTTTTT	CSAHEGHDEKLFF	TRBV20-1	TRBJ1-4
TGTGCCAGTAATGCCTGTTACGAGCAGTACTTC	CASNACYEQYF	TRBV19	TRBJ2-7
TGTGCCAGCAGCCGGGGGGATAAACAGCCCCAGCATTTT	CASSRGDKQPQHF	TRBV13	TRBJ1-5
TGTGCCAGCAGTTACTCGACCGGGGGCTGGTGGGCACATGGCTACACCTTC	CASSYSTGGWWAHGYTF	TRBV6-5	TRBJ1-2
TGTGCCAGCAGCCGTGGGACAGGGGAGCAGTACTTC	CASSRGTGEQYF	TRBV7-3	TRBJ2-7
TGTGCCAGCAGCGTGGGGGGGAACTCCTACGAGCAGTACTTC	CASSVGGNSYEQYF	TRBV5-4	TRBJ2-7
TGTGCCAGCAGCTTATACCCGGGACAGGACACCAGCTCTGGGGCCAACGTCCTGACTTTC	CASSLYPGQDTSSGANVLTF	TRBV7-6	TRBJ2-6
TGTGCCAGCAGCACCGACAGGGCGATCGATGAAAAACTGTTTTTT	CASSTDRAIDEKLFF	TRBV5-5	TRBJ1-4
TGCAGTGCTAGATTTTGGGACATAATGCCCAGGACTAATGAAAAACTGTTTTTT	CSARFWDIMPRTNEKLFF	TRBV20-1	TRBJ1-4
TGTGCCCCAGGGAATGAGCAGTTCTTC	CAPGNEQFF	TRBV6-1	TRBJ2-1
TGCGCCAGCAGCCAAAGTCCGGGGGCGGAGGGCTATGGCTACACCTTC	CASSQSPGAEGYGYTF	TRBV4-3	TRBJ1-2
TGTGCCAGTGCAAATTCATTTCTTGAAGCTTTCTTT	CASANSFLEAFF	TRBV19	TRBJ1-1
TGTGCCAGCAGAGTGGGCACTGAAGCTTTCTTT	CASRVGTEAFF	TRBV27	TRBJ1-1
TGTGCCAGCAGTAGATCCGGGAGGCTCAACACTGAAGCTTTCTTT	CASSRSGRLNTEAFF	TRBV27	TRBJ1-1
TGTGCCAGCACACTAACTAGGGGGGCACCCCCTTCCTACGAGCAGTACTTC	CASTLTRGAPPSYEQYF	TRBV25-1	TRBJ2-7
TGTGCCATCAGTGTCTCGACAGGGCTAGGACAAGAGACCCAGTACTTC	CAISVSTGLGQETQYF	TRBV10-3	TRBJ2-5
TGTGCCAGCACAAGTAATCATAACTCCTACGAGCAGTACTTC	CASTSNHNSYEQYF	TRBV6-8	TRBJ2-7
TGTGCCAGCCCGGCGGGGGGCTACGAGCAGTACTTC	CASPAGGYEQYF	TRBV7-9	TRBJ2-7
TGTGCCAGCAGTCCCCCCGACCGACCGGAAGAAATAGCGATTCGCGAAGATACGCAGTATTTT	CASSPPDRPEEIAIREDTQYF	TRBV6-4	TRBJ2-3
TGTGCCAGCAGCGGAGGCGGCCAGGGTGGGCCCAGGGGCTATGGCTACACCTTC	CASSGGGQGGPRGYGYTF	TRBV7-3	TRBJ1-2
TGTGCCTTGTCTGAGGGACGTATGAACACTGAAGCTTTCTTT	CALSEGRMNTEAFF	TRBV30	TRBJ1-1
TGTGCCAGCAGCAAAGGCAAGGAGGGTCTCCTCAATGAGCAGTTCTTC	CASSKGKEGLLNEQFF	TRBV5-6	TRBJ2-1
TGTGCCATCGGGACAGGGCATTCTAACTATGGCTACACCTTC	CAIGTGHSNYGYTF	TRBV19	TRBJ1-2
TGTGCCAGCAGCCTCCAGGGATTGGGTACTAATGAAAAACTGTTTTTT	CASSLQGLGTNEKLFF	TRBV7-2	TRBJ1-4
TGTGCCAGCAGTGAATCCCGTCCGGGACAGCCGTACGCTTTCTTT	CASSESRPGQPYAFF	TRBV25-1	TRBJ1-1
TGTGCCAGCAGTGATTTAACCTATGGCCAGCCCCAGCATTTT	CASSDLTYGQPQHF	TRBV6-4	TRBJ1-5
TGTGCCAGCAGAACTAGCGTTCCTACGTACGAGCAGTACTTC	CASRTSVPTYEQYF	TRBV6-5	TRBJ2-7
TGTGCCACTCAGGGGTCCGACAATCAGCCCCAGCATTTT	CATQGSDNQPQHF	TRBV19	TRBJ1-5
TGTGCCAGCAGCTTGACAGCCAGCAAAAACATTCAGTACTTC	CASSLTASKNIQYF	TRBV12-4	TRBJ2-4
TGTGCCAGCTCACCGCAACTAGGTAGGGCTGCATTGGGCTACACCTTC	CASSPQLGRAALGYTF	TRBV18	TRBJ1-2
TGTGCCAGCAGCTTAGTCCGGGACAGTACTTGCAACGAGCAGTACTTC	CASSLVRDSTCNEQYF	TRBV11-2	TRBJ2-7
TGTGCCAGCAGTTTACCCCAGGGGGGACGAGGAGGCGGCTACACCTTC	CASSLPQGGRGGGYTF	TRBV28	TRBJ1-2
TGCGCCAGCAGTCCCCGGTCGGGTAATTCACCCCTCCACTTT	CASSPRSGNSPLHF	TRBV10-1	TRBJ1-6
TGTGCCAGCAGCTCCGAAGGACAGGGGGCAGAAGGAGGCTACACCTTC	CASSSEGQGAEGGYTF	TRBV11-2	TRBJ1-2
TGCGCCAGCAGCACGCCCGGGACGGTGGAGTTGGGCATGAACACTGAAGCTTTCTTT	CASSTPGTVELGMNTEAFF	TRBV4-1	TRBJ1-1
TGTGCCAGCAAGGGGTTAAGCACTGAAGCTTTCTTT	CASKGLSTEAFF	TRBV12-3	TRBJ1-1
TGTGCCAGCAGTGAAGCGGTTGGGGCCTCCAATCAGCCCCAGCATTTT	CASSEAVGASNQPQHF	TRBV6-1	TRBJ1-5
TGCAGTGCTAGCGGGAGCGACTCCTACAATGAGCAGTTCTTC	CSASGSDSYNEQFF	TRBV20-1	TRBJ2-1
TGCGCCAGCAGCCAAGCAATCCTAGCGGGAGTCAATGAGCAGTTCTTC	CASSQAILAGVNEQFF	TRBV4-3	TRBJ2-1
TGTGCCAGCAGCCCCCGACATGACAAAGGGAAAGAGACCCAGTACTTC	CASSPRHDKGKETQYF	TRBV7-9	TRBJ2-5
TGCGCCAGCAGGCCCGAGGGATATCAGCCCCAGCATTTT	CASRPEGYQPQHF	TRBV4-1	TRBJ1-5
TGTGCTAGCAGCTTCATTGACTTCGCGGAGCAGTTCTTC	CASSFIDFAEQFF	TRBV7-7	TRBJ2-1
TGTGCCAGCAGCCGGACGGACAGCTACCAAGAGACCCAGTACTTC	CASSRTDSYQETQYF	TRBV3-1	TRBJ2-5
TGTGCCAGCAGCGAACTGACAGTCCGAAACACTGAAGCTTTCTTT	CASSELTVRNTEAFF	TRBV7-3	TRBJ1-1
TGCGCCAGCAGCAGGGGTTTAGATCAGCCCCAGCATTTT	CASSRGLDQPQHF	TRBV10-1	TRBJ1-5
TGTGCCAGCAGTTGTCCAAAGGGGGTTTTAGAAGGGGCCAACGTCCTGACTTTC	CASSCPKGVLEGANVLTF	TRBV27	TRBJ2-6
TGTGCCAGCAGCTTGCCTTCCCTTGTAGGGGGCATGAATATTCAGCCCCAGCATTTT	CASSLPSLVGGMNIQPQHF	TRBV5-5	TRBJ1-5
TGCGCCAGCAGTGAGTCTACAGATTTGAACACTGAAGCTTTCTTT	CASSESTDLNTEAFF	TRBV10-2	TRBJ1-1
TGCAGTGCTAGAGCCCCCTACATTCCCGGGGGGATGAATAGCAATCAGCCCCAGCATTTT	CSARAPYIPGGMNSNQPQHF	TRBV20-1	TRBJ1-5
TGCAGCGATAGGGTCCGTGAGCAGTTCTTC	CSDRVREQFF	TRBV29-1	TRBJ2-1
TGTGCCAGCAGTTTAGTAGGTCACTACGAGCAGTACTTC	CASSLVGHYEQYF	TRBV28	TRBJ2-7
TGCAGTGCTTGGACAAAAAACATTCAGTACTTC	CSAWTKNIQYF	TRBV20-1	TRBJ2-4
TGTGCCAGCAAGACACGGGGGCGCTGGAACAATTCACCCCTCCACTTT	CASKTRGRWNNSPLHF	TRBV6-3	TRBJ1-6
TGTGCCAGCAGTTTAGCGGTCCAGCGTTTTCTCTACGAGCAGTACTTC	CASSLAVQRFLYEQYF	TRBV12-3	TRBJ2-7
TGTGCCAGCAGCTTCTCGTCGGGAGGTAGTAATGAAAAACTGTTTTTT	CASSFSSGGSNEKLFF	TRBV7-3	TRBJ1-4
TGTGCCAGCAGCCAAGAAGGCGAGCGGACTAGCGGGAATTTGAGTCACACCGGGGAGCTGTTTTTT	CASSQEGERTSGNLSHTGELFF	TRBV3-1	TRBJ2-2
TGTGCCACCCCGGACAGACTCGAGCAGTACTTC	CATPDRLEQYF	TRBV24-1	TRBJ2-7
TGTGCCAGCAGTTTGACTAGTGGGACCCAGCGCTCTGGGGCCAACGTCCTGACTTTC	CASSLTSGTQRSGANVLTF	TRBV12-3	TRBJ2-6
TGTGCCAGCAGACAGGACCTCTCATACGAGCAGTACTTC	CASRQDLSYEQYF	TRBV7-3	TRBJ2-7
TGTGCCAGCTCTAGCGGGAATGAGCAGTTCTTC	CASSSGNEQFF	TRBV6-2	TRBJ2-1
TGTGCCACCAGTGAAAAGGGACTAGAGACGCAAAGAGGGGAGCTGTTTTTT	CATSEKGLETQRGELFF	TRBV24-1	TRBJ2-2
TGTGCCAGCAGGTGGGACTACACCGGGGAGCTGTTTTTT	CASRWDYTGELFF	TRBV5-6	TRBJ2-2
TGTGCCAGCAAGGACAGGGGGCCACGTTTCTCCTATGGCTACACCTTC	CASKDRGPRFSYGYTF	TRBV7-9	TRBJ1-2
TGTGCCAGCAGTCCTGGGGAGCTGTTTTTT	CASSPGELFF	TRBV6-3	TRBJ2-2
TGTGCCACCAGTGATGGGGAACCCGGACGAATCAATCAGCCCCAGCATTTT	CATSDGEPGRINQPQHF	TRBV24-1	TRBJ1-5
TGTGCCAGCAGCCACAGGGGCTACACCTTC	CASSHRGYTF	TRBV7-3	TRBJ1-2
TGCGCCAGCAGTCACAGGGCGGCCACAGATACGCAGTATTTT	CASSHRAATDTQYF	TRBV5-1	TRBJ2-3
TGTGCCAGCGTCAGGGGAGATGAGACCCAGTACTTC	CASVRGDETQYF	TRBV27	TRBJ2-5
TGTGCCAGCAGCCAAGTAGGGGTGGCCGGTTCTAGCACAGATACGCAGTATTTT	CASSQVGVAGSSTDTQYF	TRBV3-1	TRBJ2-3
TGTGCCAGCAGCTCCCTGGGACAGGGGGCCGATTGGACAACTAATGAAAAACTGTTTTTT	CASSSLGQGADWTTNEKLFF	TRBV13	TRBJ1-4
TGCGCCAGCAGCCAAGATGGGGACGGGCTCTCTGGAAACACCATATATTTT	CASSQDGDGLSGNTIYF	TRBV4-1	TRBJ1-3
TGTGCCAGCAGCGAAAGGGACACCTCCTACAATGAGCAGTTCTTC	CASSERDTSYNEQFF	TRBV9	TRBJ2-1
TGCAGTGCTAGGTCACAAGGACAGGGAACGGGGGTGAAGTACGAGCAGTACTTC	CSARSQGQGTGVKYEQYF	TRBV20-1	TRBJ2-7
TGTGCCAGCAGCCCTACTCCGACTAGCGGGGACCCCGCCTACAATGAGCAGTTCTTC	CASSPTPTSGDPAYNEQFF	TRBV27	TRBJ2-1
TGTCCTACAGGGTACAACAATCAGCCCCAGCATTTT	CPTGYNNQPQHF	TRBV19	TRBJ1-5
TGCAGTGCTAGCCGGCGCATATCTGGGGCCAACGTCCTGACTTTC	CSASRRISGANVLTF	TRBV20-1	TRBJ2-6
TGTGCCAGCAGCTTAACCTGTGCTAACAATCAGCCCCAGCATTTT	CASSLTCANNQPQHF	TRBV5-8	TRBJ1-5
TGTGCCAGTAGGGGGCCTAGCTCCCTGGGGGAGCTGTTTTTT	CASRGPSSLGELFF	TRBV19	TRBJ2-2
TGTGCCAGCAGCTTACTAGCGGGAGATACGCAGTATTTT	CASSLLAGDTQYF	TRBV7-3	TRBJ2-3
TGTGCCAGCGGATGGCTTAGGTCCTACAATGAGCAGTTCTTC	CASGWLRSYNEQFF	TRBV6-4	TRBJ2-1
TGTGCCAGCAGCCTGTCACGACTTCTAGGGCCCTACGAGCAGTACTTC	CASSLSRLLGPYEQYF	TRBV11-3	TRBJ2-7
TGTGCCAGCAGCCCGGGGGGGGACGAGCAGTACTTC	CASSPGGDEQYF	TRBV14	TRBJ2-7
TGCGCCAGCAGCCAAGGGTATCCGGTAAGGTCGTCACCCCTCCACTTT	CASSQGYPVRSSPLHF	TRBV4-3	TRBJ1-6
TGTGCCAGTAGTATAGATACCGGGACCTACGAGCAGTACTTC	CASSIDTGTYEQYF	TRBV19	TRBJ2-7
TGTGCCAGCAGTTACCCCCTAGCGGGGGTGTACGAGCAGTACTTC	CASSYPLAGVYEQYF	TRBV6-2	TRBJ2-7
TGCAGCCAGGGGGGAAGGAGGGCTAATGAAAAACTGTTTTTT	CSQGGRRANEKLFF	TRBV29-1	TRBJ1-4
TGTGCCAGCATGATACGAACGAGACAGGGGGTGCCCCAGCATTTT	CASMIRTRQGVPQHF	TRBV6-5	TRBJ1-5
TGTGCCAGCAGTGCGGAAGGTGGAGACGCGAATTCACCCCTCCACTTT	CASSAEGGDANSPLHF	TRBV6-4	TRBJ1-6
TGTGCCAGCAGTCACAGGGAGCGGCAGCCCCAGCATTTT	CASSHRERQPQHF	TRBV12-3	TRBJ1-5
TGTGCCAGCAGCAAGATAGGGGCCCGTCAGCCCCAGCATTTT	CASSKIGARQPQHF	TRBV7-9	TRBJ1-5
TGTGCCAGCAGTTACTCTCTTAGCGGTCCCTCCTACGAGCAGTACTTC	CASSYSLSGPSYEQYF	TRBV6-5	TRBJ2-7
TGTGCCAGCTCGGGGGGGGAAAGCTACGAGCAGTACTTC	CASSGGESYEQYF	TRBV18	TRBJ2-7
TGTGCCAGCAGCCCTTCGGGACCGGATCATGGCTACACCTTC	CASSPSGPDHGYTF	TRBV3-1	TRBJ1-2
TGTGCCAGCAGCTTAGCGAGACAGGGGACTTCTGGGGCCAACGTCCTGACTTTC	CASSLARQGTSGANVLTF	TRBV7-6	TRBJ2-6
TGTGCCGCCCCCCCGGGACAGGGGGCGCCGAGCTCCTACGAGCAGTACTTC	CAAPPGQGAPSSYEQYF	TRBV27	TRBJ2-7
TGCAGTGCTGAGCCTAGCGGGTCCTTCCAGAGCACAGATACGCAGTATTTT	CSAEPSGSFQSTDTQYF	TRBV20-1	TRBJ2-3
TGTGCCAGCAGTGACCCCAGAAAGTGGGACAGGTCCTATGGCTACACCTTC	CASSDPRKWDRSYGYTF	TRBV2	TRBJ1-2
TGTGCCAGCAGTTTACCGTTCTACTCCTACAATGAGCAGTTCTTC	CASSLPFYSYNEQFF	TRBV27	TRBJ2-1
TGCGCCAGCAGCCAGAGTTCGCCCGGGACAGGGGAAAACACTGAAGCTTTCTTT	CASSQSSPGTGENTEAFF	TRBV4-3	TRBJ1-1
TGTGCCACCAGTGGACTAGCCTCAGATACGCAGTATTTT	CATSGLASDTQYF	TRBV24-1	TRBJ2-3
TGTGCCTCTAGGTACGAGCAGTACTTC	CASRYEQYF	TRBV27	TRBJ2-7
TGTGCCAGCAGAACCCCCCTGGGGAGGAACGGCTACACCTTC	CASRTPLGRNGYTF	TRBV28	TRBJ1-2
TGCGCCAGCAGTGCATGGGGCAACAATGAAAAACTGTTTTTT	CASSAWGNNEKLFF	TRBV10-1	TRBJ1-4
TGCGCCAGCAGCCGTCAGACCCTACCCCTACGCACAGATACGCAGTATTTT	CASSRQTLPLRTDTQYF	TRBV4-3	TRBJ2-3
TGTGCCAGCAGCACAGAGTGTTCCTACGAGCAGTACTTC	CASSTECSYEQYF	TRBV9	TRBJ2-7
TGTGCCAGCAGATGGACTAGCGAAAGAAACATTCAGTACTTC	CASRWTSERNIQYF	TRBV6-8	TRBJ2-4
TGTGCCAGCGAGCGGCGGAACAATGAGCAGTTCTTC	CASERRNNEQFF	TRBV14	TRBJ2-1
TGTGCCAGCAGTGACTCTAAGCACAGGGGGAGTTCGCCGCATCAGCCCCAGCATTTT	CASSDSKHRGSSPHQPQHF	TRBV6-4	TRBJ1-5
TGCGCCAGCAGCGTCCCGGGAAAAGTTAAGCGGGACCCCTATGGCTACACCTTC	CASSVPGKVKRDPYGYTF	TRBV4-3	TRBJ1-2
TGCAGTGCTAGAGATGACCCCCAGTCGGGTGGCTACACCTTC	CSARDDPQSGGYTF	TRBV20-1	TRBJ1-2
TGTGCCTGGAGTGTCCAGGTAGGGGGGGCGCCTGGGACTGAAGCTTTCTTT	CAWSVQVGGAPGTEAFF	TRBV30	TRBJ1-1
TGCGCCAGCAGCTCAAAGGGGGGAAATGAGCAGTTCTTC	CASSSKGGNEQFF	TRBV5-1	TRBJ2-1
TGTGCCAGCAGCCCCTGGGACCCAAGGGATGAAGCTTTCTTT	CASSPWDPRDEAFF	TRBV7-3	TRBJ1-1
TGCGCCAGCAGTGATAGAGCCGGGACAGGGTCTCCCAAGACAGAGACCCAGTACTTC	CASSDRAGTGSPKTETQYF	TRBV10-1	TRBJ2-5
TGTGCCAGCAGCTTGTCCGAAAGCGCGGGAGAAACCTCGCAGTTCTTC	CASSLSESAGETSQFF	TRBV5-4	TRBJ2-1
TGCGCCAGCCTTAGAGGGACGCATTGCTATGGCTACACCTTC	CASLRGTHCYGYTF	TRBV5-1	TRBJ1-2
TGTGCCAGCGTCCTAAGGCCGGGACAGGTAAGGAACACTGAAGCTTTCTTT	CASVLRPGQVRNTEAFF	TRBV28	TRBJ1-1
TGTGCCAGCAGCTGCCCCCAGGGGGAAGAAAAACTGTTTTTT	CASSCPQGEEKLFF	TRBV5-4	TRBJ1-4
TGTGCCAGCAGCCAATACCTTGGGGACTACATTAAGACCTACGAGCAGTACTTC	CASSQYLGDYIKTYEQYF	TRBV3-1	TRBJ2-7
TGTGCCACCAGTGAGGATGCTCCCTCGTTTACAGGGGGGCGCAACACAGATACGCAGTATTTT	CATSEDAPSFTGGRNTDTQYF	TRBV24-1	TRBJ2-3
TGTGCCAGCAGCTTCGATCCTAGGGGGGGACGGAGCTCCTATAATTCACCCCTCCACTTT	CASSFDPRGGRSSYNSPLHF	TRBV11-2	TRBJ1-6
TGTGCCAGCAGTTACTCGACAGACAGGGACAGAGAAGAGACCCAGTACTTC	CASSYSTDRDREETQYF	TRBV6-5	TRBJ2-5
TGTGCCAGCAGCCCGGGAGGGGGCTCCTACGAGCAGTACTTC	CASSPGGGSYEQYF	TRBV4-2	TRBJ2-7
TGTGCCAGCAGCAAAGCTCGACGGGTCTGTAGCTCCTACGAGCAGTACTTC	CASSKARRVCSSYEQYF	TRBV7-4	TRBJ2-7
TGCAGTGCTAGGCCCGGACAGTATAATTCACCCCTCCACTTT	CSARPGQYNSPLHF	TRBV20-1	TRBJ1-6
TGCAGCGTAGGCCTAGCGGGGGGGGAGACCCAGTACTTC	CSVGLAGGETQYF	TRBV29-1	TRBJ2-5
TGTGCCAGCAGTTGGGCGGGACTCCCTGCCAACGTCCTGACTTTC	CASSWAGLPANVLTF	TRBV6-5	TRBJ2-6
TGTGCCAGCATCTGTATATCTGAGCAGTTCTTC	CASICISEQFF	TRBV6-4	TRBJ2-1
TGTGCTAGTGCACGACTAGCCGGGGGGGGGAATGAGCAGTTCTTC	CASARLAGGGNEQFF	TRBV12-5	TRBJ2-1
TGTGCCAGCAGCCAACAACCTACGGCAATCCAAGAGACCCAGTACTTC	CASSQQPTAIQETQYF	TRBV14	TRBJ2-5
TGTGCCACCAGTGAACGGGACAGGGCCAAAAACATTCAGTACTTC	CATSERDRAKNIQYF	TRBV24-1	TRBJ2-4
TGTGCCAGCAGCGCGGAGAGAATATACACCGGGGAGCTGTTTTTT	CASSAERIYTGELFF	TRBV6-5	TRBJ2-2
TGTGCCACCAAGAGGGGTCTGGGGAACACCGGGGAGCTGTTTTTT	CATKRGLGNTGELFF	TRBV24-1	TRBJ2-2
TGTGCCAGCAGCACTTGGCGTAGGGCTAGCACAGATACGCAGTATTTT	CASSTWRRASTDTQYF	TRBV7-9	TRBJ2-3
TGTGCCAGCAGAGGGCGACAGAAGCACACCGGGGAGCTGTTTTTT	CASRGRQKHTGELFF	TRBV11-2	TRBJ2-2
TGCAGTGCTAGCCCGATTGGCTACACCTTC	CSASPIGYTF	TRBV20-1	TRBJ1-2
TGTGCCTGGAGTAGGGGGATCTATGGCTACACCTTC	CAWSRGIYGYTF	TRBV30	TRBJ1-2
TGTGCCCGCGTAGGGGCGCAAGGGCGCTACGAGCAGTACTTC	CARVGAQGRYEQYF	TRBV6-6	TRBJ2-7
TGTGCCAGCAGTTACGCCGACAGGTGGACCGGGGAGCTGTTTTTT	CASSYADRWTGELFF	TRBV6-3	TRBJ2-2
TGTGCTAGTGGTTCTTTAAAAGACACGATCTCCTACAATGAGCAGTTCTTC	CASGSLKDTISYNEQFF	TRBV12-5	TRBJ2-1
TGTGCCAGCAGCTCAGCAGAAACTATCGGGGGAGGGTTAGAGACCCAGTACTTC	CASSSAETIGGGLETQYF	TRBV5-6	TRBJ2-5
TGCGCCAGCAGCTGTGATCAGCCACCTGGCACCGGGGAGCTGTTTTTT	CASSCDQPPGTGELFF	TRBV5-1	TRBJ2-2
TGCAGTGCTAGAGATGATTTCCCCCGGGTAAGTAATCAGCCCCAGCATTTT	CSARDDFPRVSNQPQHF	TRBV20-1	TRBJ1-5
TGTGCCAGGAGGCTAGCGGGTTTTGAGCAGTTCTTC	CARRLAGFEQFF	TRBV2	TRBJ2-1
TGTGCCAGCAGCCCCCCCGGGACAGGGGGCGCTGCCGGGGAGCTGTTTTTT	CASSPPGTGGAAGELFF	TRBV11-2	TRBJ2-2
TGTGCCAGCAGCGACGGGGACTATGGCTACACCTTC	CASSDGDYGYTF	TRBV13	TRBJ1-2
TGTGCCTGGACACGCTACAATGAGCAGTTCTTC	CAWTRYNEQFF	TRBV30	TRBJ2-1
TGTGCCAGCAGTTTACGGACAGTCGAGACCCAGTACTTC	CASSLRTVETQYF	TRBV28	TRBJ2-5
TGTGCCAGCAGCCCGCGATGGACAGGGGGCCGCTACGAGCAGTACTTC	CASSPRWTGGRYEQYF	TRBV11-3	TRBJ2-7
TGCGCCAGCAGCTTGGCGTATGGGGCCGCTTTGCGAGAGGATAGCAATCAGCCCCAGCATTTT	CASSLAYGAALREDSNQPQHF	TRBV5-1	TRBJ1-5
TGTGCCAGCAGCCATTCAGTGGGCCGGGGAACTAATGAAAAACTGTTTTTT	CASSHSVGRGTNEKLFF	TRBV5-8	TRBJ1-4
TGTGCTAGTGGTTTCGCCAGACCTCGTAATGGCTACACCTTC	CASGFARPRNGYTF	TRBV12-5	TRBJ1-2
TGTGCCAGCAGCCATGACAGGGCGGGGGACCACGAGCAGTACTTC	CASSHDRAGDHEQYF	TRBV14	TRBJ2-7
TGTGCCAGCAGCTTAGTGCCACTGTACCGTATCTCTGGAAACACCATATATTTT	CASSLVPLYRISGNTIYF	TRBV13	TRBJ1-3
TGTGCCAGCAGCCAAGACCCCGGTGGCTACACCTTC	CASSQDPGGYTF	TRBV14	TRBJ1-2
TGTGCCAGCAGCTTAGAGGGGGACGGAGCAGAGACCCAGTACTTC	CASSLEGDGAETQYF	TRBV7-2	TRBJ2-5
TGTGCCAGCAGCCCGGACACAGCTAACTATGGCTACACCTTC	CASSPDTANYGYTF	TRBV14	TRBJ1-2
TGCGCCAGCAGCTTGCATACCCTACAGGGGGCCTCTGGGGCCAACGTCCTGACTTTC	CASSLHTLQGASGANVLTF	TRBV5-1	TRBJ2-6
TGTGCCAGCAGCTTGCAGGAAGCAGGGGGCGAGAGAAACACCGGGGAGCTGTTTTTT	CASSLQEAGGERNTGELFF	TRBV5-4	TRBJ2-2
TGTGCCTGGAGTGTAACAAAAGATCCCCCCCCCGCGGGTCCAAAGCTTACCGGCCCTAAGCAGTACTTC	CAWSVTKDPPPAGPKLTGPKQYF	TRBV30	TRBJ2-7
TGTGCCAGCAGTTTTTCCGCGGGAGGGGACTCCTACGAGCAGTACTTC	CASSFSAGGDSYEQYF	TRBV12-4	TRBJ2-7
TGTGCCAGCACGCTGGGGGTAGGGTACTCCAGTCACTATGGCTACACCTTC	CASTLGVGYSSHYGYTF	TRBV7-8	TRBJ1-2
TGTGCCATCTCCGTTAGACTGGAGACCCAGTACTTC	CAISVRLETQYF	TRBV10-3	TRBJ2-5
TGTGCCAGCAGTACCCCTCAGAGAAGGTGGCGCGGGGATGGCTACACCTTC	CASSTPQRRWRGDGYTF	TRBV6-2	TRBJ1-2
TGTGCCAGCAGCGCGAGACAGAGATGGAATGAAAAACTGTTTTTT	CASSARQRWNEKLFF	TRBV11-2	TRBJ1-4
TGTGCCAGAGATGGGACAGCGGCTTTCTTT	CARDGTAAFF	TRBV28	TRBJ1-1
TGTGCCAAATCTAGGGGGCGCCGCTCCTACAATGAGCAGTTCTTC	CAKSRGRRSYNEQFF	TRBV27	TRBJ2-1
TGTGCCTGGAGTGTACGGGGGGTACCTCCCGCGAATAATTCACCCCTCCACTTT	CAWSVRGVPPANNSPLHF	TRBV30	TRBJ1-6
TGTGCCAGCAGCGATGGGCACGAAGAGGCTGAAGCTTTCTTT	CASSDGHEEAEAFF	TRBV6-5	TRBJ1-1
TGTGCCAGTAGTATCCAGACGGGACGGGCTGCCCAGCATTTT	CASSIQTGRAAQHF	TRBV19	TRBJ1-5
TGCAGCGTTGAGCAGGGGGGGTCGGAGACCCAGTACTTC	CSVEQGGSETQYF	TRBV29-1	TRBJ2-5
TGTGCCAGCAGAGGCCTCGGGGGCGCGTACGAGCAGTACTTC	CASRGLGGAYEQYF	TRBV6-1	TRBJ2-7
TGCGCCAGCGCCCCTGGGGAAGCAGGATTATTGCGGTTGAACACTGAAGCTTTCTTT	CASAPGEAGLLRLNTEAFF	TRBV10-1	TRBJ1-1
TGTGCCAGCAGCTTATCCCCCGGGACTAGCGGGGGTGAAGAGACCCAGTACTTC	CASSLSPGTSGGEETQYF	TRBV7-3	TRBJ2-5
TGTGCCAGCAGCCTCCGGACAGGGGGGAACAACCTAGCGAACACTGAAGCTTTCTTT	CASSLRTGGNNLANTEAFF	TRBV13	TRBJ1-1
TGTGCCAGCAGTTTAGGCACTAGCGGGAGGGGCAACTTC	CASSLGTSGRGNF	TRBV12-4	TRBJ2-7
TGCGCCAGCGGACAGAATGAAAAACTGTTTTTT	CASGQNEKLFF	TRBV5-1	TRBJ1-4
TGTGCCAGCAGTGATTTGGAAGGAGGAGCCAAAAACATTCAGTACTTC	CASSDLEGGAKNIQYF	TRBV2	TRBJ2-4
TGTGCCAGCAGCGGGGGGGTTTCCTACGAGCAGTACTTC	CASSGGVSYEQYF	TRBV5-4	TRBJ2-7
TGTGCCAGCTTGGGGGGCCACTTGACCGGGGAGCTGTTTTTT	CASLGGHLTGELFF	TRBV7-3	TRBJ2-2
TGTGCCAGCTCACCAACTCGCCAACCGGCGAAGTCTGAAGCTTTCTTT	CASSPTRQPAKSEAFF	TRBV18	TRBJ1-1
TGTGCCAGCGTGGGACTAGCGGCCAGTTATGAGCAGTTCTTC	CASVGLAASYEQFF	TRBV7-3	TRBJ2-1
TGTGCCAGCAGCGTAACATTCCTAGGGACAGAAACCTACAATGAGCAGTTCTTC	CASSVTFLGTETYNEQFF	TRBV9	TRBJ2-1
TGTGCCAGCTCCGGACAGGTTGGTCCCTACGAGCAGTACTTC	CASSGQVGPYEQYF	TRBV18	TRBJ2-7
TGTGCCAGCAGTGAAGCGTGTGGGGCTACTCCAAGGTGGTCCCCTGAAGCTTTCTTT	CASSEACGATPRWSPEAFF	TRBV2	TRBJ1-1
TGTGCCAGCAGCGGGAAGCCCACTGAAGCTTTCTTT	CASSGKPTEAFF	TRBV5-6	TRBJ1-1
TGTGCCAGCAGCTTAATGGAGGAGCAGGGCTACGAGCAGTACTTC	CASSLMEEQGYEQYF	TRBV7-3	TRBJ2-7
TGTGCCAGCACCCGGCATCCGGGACAGTACGAGCAGTACTTC	CASTRHPGQYEQYF	TRBV11-2	TRBJ2-7
TGCGCCAGCAGCTCCCATTACAGGGCTCTTACCTACGAGCAGTACTTC	CASSSHYRALTYEQYF	TRBV5-1	TRBJ2-7
TGTGCCAGCTTACTCAGTAATGAAAAACTGTTTTTT	CASLLSNEKLFF	TRBV19	TRBJ1-4
TGCGCCAGCAGGGGACACGCCTACGAGCAGTACTTC	CASRGHAYEQYF	TRBV10-1	TRBJ2-7
TGTGCCAGCAGCTTAGCCGGGACAGGGGAGAGGCCTGGCTACACCTTC	CASSLAGTGERPGYTF	TRBV11-2	TRBJ1-2
TGTGCCAGCTCACCGACGGAATACAGGGGGAGAGGTCCAAACTGGGAGGGCTCCTACGAGCAGTACTTC	CASSPTEYRGRGPNWEGSYEQYF	TRBV18	TRBJ2-7
TGCAGTGCTAGAGAAACAGATACGCAGTATTTT	CSARETDTQYF	TRBV20-1	TRBJ2-3
TGTGCCAGCAGCGAGCTAGGCAGCGAGCAGTACTTC	CASSELGSEQYF	TRBV9	TRBJ2-7
TGTGCCAGCAGCCCAACAGGGGACACTGAAGCTTTCTTT	CASSPTGDTEAFF	TRBV5-4	TRBJ1-1
TGTGCCAGCAGCTTGTACCCCCCGGACAGTTATGTATTATACTATGGCTACACCTTC	CASSLYPPDSYVLYYGYTF	TRBV5-4	TRBJ1-2
TGTGCCAGCAGCGGCGTTGAAGGGGGAGGGGGGGGATCTAGCACAGATACGCAGTATTTT	CASSGVEGGGGGSSTDTQYF	TRBV13	TRBJ2-3
TGCAGTGCTAGAAAAACAGGGTTCCGCAATCAGCCCCAGCATTTT	CSARKTGFRNQPQHF	TRBV20-1	TRBJ1-5
TGCGCCAGCAGCCGCGACAGGGGACTCGGGCAAAACCCCAACACTGAAGCTTTCTTT	CASSRDRGLGQNPNTEAFF	TRBV4-1	TRBJ1-1
TGTGCCAGCAGCTTACTCAGAGGGCGCGCCTACGAGCAGTACTTC	CASSLLRGRAYEQYF	TRBV7-9	TRBJ2-7
TGTGCCAGCAGTTACTCCCTGGCTCATTCAGGGGAAGAGACCCAGTACTTC	CASSYSLAHSGEETQYF	TRBV6-5	TRBJ2-5
TGTGCCACCAGTGATGCGGGGCAGGGGGCGAACACTGAAGCTTTCTTT	CATSDAGQGANTEAFF	TRBV24-1	TRBJ1-1
TGTGCCAGCAGTTTAGACCACAGGGGCGGCTCTGAAGCTTTCTTT	CASSLDHRGGSEAFF	TRBV28	TRBJ1-1
TGTGCCAGCAGCTGCAAAGGCCGCCTTGAAAACATTCAGTACTTC	CASSCKGRLENIQYF	TRBV9	TRBJ2-4
TGTGCCACCAGTGATTTTGGGACAGGGGGCGAGGGGAGCTCCTATAATTCACCCCTCCACTTT	CATSDFGTGGEGSSYNSPLHF	TRBV24-1	TRBJ1-6
TGTGCCAGCAGCTTAGATCTTGCCCCGGACAGGGCCCTTACCTACGAGCAGTACTTC	CASSLDLAPDRALTYEQYF	TRBV11-3	TRBJ2-7
TGTGCCAGCAGCAGAACGTACGAGCAGTACTTC	CASSRTYEQYF	TRBV3-1	TRBJ2-7
TGTGCCAGCAGACTAGACTCCTACGAGCAGTACTTC	CASRLDSYEQYF	TRBV11-2	TRBJ2-7
TGTGCCAGCAGCCGCCTAGCGGGCACAGATACGCAGTATTTT	CASSRLAGTDTQYF	TRBV13	TRBJ2-3
TGCAGCGAACCTCGAGACAGGGGGCGGCAGCCCCAGCATTTT	CSEPRDRGRQPQHF	TRBV29-1	TRBJ1-5
TGTGCCAGCAGTTTACCAGGCCCGAGCAATCAGCCCCAGCATTTT	CASSLPGPSNQPQHF	TRBV27	TRBJ1-5
TGTGCCACCAGTGATCGGGGACAGCAGGTCTATGGCTACACCTTC	CATSDRGQQVYGYTF	TRBV24-1	TRBJ1-2
TGTGCCCACCCGGGAGCTTGGAAAAATCAGCCCCAGCATTTT	CAHPGAWKNQPQHF	TRBV27	TRBJ1-5
TGTGCCAGCAGCCAAGATTTACCTAGGGGGGGCCCTTTGGATACGCAGTATTTT	CASSQDLPRGGPLDTQYF	TRBV14	TRBJ2-3
TGTGCCAGCAGTTACCCCTCCAAGAGGGGCTACCAAGTTGAAAAACTGTTTTTT	CASSYPSKRGYQVEKLFF	TRBV6-2	TRBJ1-4
TGTGCCAGCGCTCTGAACACTGAAGCTTTCTTT	CASALNTEAFF	TRBV11-3	TRBJ1-1
TGCGCCAGCAGCTCTGGGCACCGAAGCTACGAGCAGTACTTC	CASSSGHRSYEQYF	TRBV5-1	TRBJ2-7
TGTGCCATCACACCCGTAGGGACTAGCTACGAGCAGTACTTC	CAITPVGTSYEQYF	TRBV10-3	TRBJ2-7
TGCGCCAGCAGCCATCGCGCGGACAGGGAACGGGATAGGCGCAATCAGCCCCAGCATTTT	CASSHRADRERDRRNQPQHF	TRBV4-3	TRBJ1-5
TGCAGTGCTAGAGATGGGGTAGGGGGGCAGTACTTC	CSARDGVGGQYF	TRBV20-1	TRBJ2-7
TGCAGTGCTAGAAGGGACGGCTACGAGCAGTACTTC	CSARRDGYEQYF	TRBV20-1	TRBJ2-7
TGCGCCAGCAGCTTGGCGGGACTAGCGGGGAGATCCTACGAGCAGTACTTC	CASSLAGLAGRSYEQYF	TRBV5-1	TRBJ2-7
TGTGCTAGCAGCTTAGCGAGGAGTCGCAGGGCTACAGATACGCAGTATTTT	CASSLARSRRATDTQYF	TRBV7-7	TRBJ2-3
TGTATCCCGAGACCCCAGAGCACAGATACGCAGTATTTT	CIPRPQSTDTQYF	TRBV7-9	TRBJ2-3
TGTGCCAGCAGCAGGGAGGGGCCGAATCAGCCCCAGCATTTT	CASSREGPNQPQHF	TRBV7-9	TRBJ1-5
TGTGCCATCAGTGAGTCCTCGACTAGCGGGGGGGCCTACGAGCAGTACTTC	CAISESSTSGGAYEQYF	TRBV10-3	TRBJ2-7
TGTGCCAGCAGCTCCGGGACAGGGGGAGGAGGTAACTATGGCTACACCTTC	CASSSGTGGGGNYGYTF	TRBV11-2	TRBJ1-2
TGTGCCAGCAGGGGGGCCTTGGCCCAGTACTTC	CASRGALAQYF	TRBV7-6	TRBJ2-5
TGTGCCAGCAGTGCCGTCACTGGGACAGGGGCACCTGAAGCTTTCTTT	CASSAVTGTGAPEAFF	TRBV27	TRBJ1-1
TGTGCCACCAGTGATTTGGGACTAGCGGGATTGAACAATGAGCAGTTCTTC	CATSDLGLAGLNNEQFF	TRBV24-1	TRBJ2-1
TGTGCCAGCAGTTCGCGGGCCCCCTCGGATACGCAGTATTTT	CASSSRAPSDTQYF	TRBV6-5	TRBJ2-3
TGTGCCAGCAGCACCGGCGGGGCAGATACGCAGTATTTT	CASSTGGADTQYF	TRBV6-4	TRBJ2-3
TGTGCCAGCAGTGTAGAGGATCTAGCGGGCGCCGAGACCCAGTACTTC	CASSVEDLAGAETQYF	TRBV27	TRBJ2-5
TGTGCCAGCTTACCAGGGCCTAACACTGAAGCTTTCTTT	CASLPGPNTEAFF	TRBV7-9	TRBJ1-1
TGTGCCAGCAGCAAAGGGACAGGGACCGTAGAGATACACGAGCAGTACTTC	CASSKGTGTVEIHEQYF	TRBV13	TRBJ2-7
TGCGCCAGCAGTGAGGCGGTAAGGTGTACCTGCAACCTCTACGAGCAGTACTTC	CASSEAVRCTCNLYEQYF	TRBV10-1	TRBJ2-7
TGCGCCAGCAGCTTGGAGCCGGGACGGAGCTACGAGCAGTACTTC	CASSLEPGRSYEQYF	TRBV5-1	TRBJ2-7
TGTGCCATCACCGAGAAAAACACCATATATTTT	CAITEKNTIYF	TRBV10-3	TRBJ1-3
TGTGCCAGCAGCTTGGGCCAGGCTAACTATGGCTACACCTTC	CASSLGQANYGYTF	TRBV7-4	TRBJ1-2
TGTGCCAGCAGCCCTACGGGACAGGGAAGATCCTACGAGCAGTACTTC	CASSPTGQGRSYEQYF	TRBV7-9	TRBJ2-7
TGCGCCAGCAGAAGAGGGAGGACGACGACCGGGGAGCTGTTTTTT	CASRRGRTTTGELFF	TRBV4-1	TRBJ2-2
TGTGCCACCAGTGATAGACGGGGGATTAGCACAGATACGCAGTATTTT	CATSDRRGISTDTQYF	TRBV24-1	TRBJ2-3
TGTGCCAGCAGCTCGGGACTAGAACTTGGGACAAGCACAGATACGCAGTATTTT	CASSSGLELGTSTDTQYF	TRBV7-3	TRBJ2-3
TGTGCCAGCAGCGTAGGGGGACAGGGCCCAGACTATGGCTACACCTTC	CASSVGGQGPDYGYTF	TRBV9	TRBJ1-2
TGTGCCAGCAGGACGCTGTTAATGCGGGAGGGAGACGAGCAGTACTTC	CASRTLLMREGDEQYF	TRBV2	TRBJ2-7
TGTGCCAGCAGCCAGGACGTGGGGAGGGGTTGCACAGATACGCAGTATTTT	CASSQDVGRGCTDTQYF	TRBV13	TRBJ2-3
TGTGCCAGCATAAGACAGGGGGTTACACTTCGGGTAACTGGAAACACCATATATTTT	CASIRQGVTLRVTGNTIYF	TRBV6-6	TRBJ1-3
TGTGCCAGCAGCCTATCGGATGGGAACACCGGGGAGCTGTTTTTT	CASSLSDGNTGELFF	TRBV14	TRBJ2-2
TGCAGTGCTAGAGATAATACGGCTCGTCCTCGTGAGCAGTTCTTC	CSARDNTARPREQFF	TRBV20-1	TRBJ2-1
TGCAGCGTTGAAGCGGTGCCGGGACAGGGGGCCTACGAGCAGTACTTC	CSVEAVPGQGAYEQYF	TRBV29-1	TRBJ2-7
TGTGCCAGCAGCGGGTTCCCGGGACAGGGGGGAAGCTCCTACGAGCAGTACTTC	CASSGFPGQGGSSYEQYF	TRBV9	TRBJ2-7
TGTGCCTGGAACCCCCTTTTGGGGCAGCCCCAGCATTTT	CAWNPLLGQPQHF	TRBV30	TRBJ1-5
TGCAGTGCTAGACCCGGGCTCGGCTATGGCTACACCTTC	CSARPGLGYGYTF	TRBV20-1	TRBJ1-2
TGCGCCAGCAGCTTCGAGCCCACGGGGAGAAATGAGCAGTTCTTC	CASSFEPTGRNEQFF	TRBV5-1	TRBJ2-1
TGTGCCACCGTTTTCTTTAGCGGGTTTCATACGCAGTATTTT	CATVFFSGFHTQYF	TRBV24-1	TRBJ2-3
TGTGCCAGCAGCGTTTCTAGACAGGGTATAGTTGGGCAAGAGACCCAGTACTTC	CASSVSRQGIVGQETQYF	TRBV13	TRBJ2-5
TGTGCCATCAGTGCCTTAATGTTGGGGGGCGAGCAGTACTTC	CAISALMLGGEQYF	TRBV10-3	TRBJ2-7
TGTGCTAGTGGCCGGTCTACAGGGCGACACTATGGCTACACCTTC	CASGRSTGRHYGYTF	TRBV12-5	TRBJ1-2
TGTGCCAGCAGCTTAGGGCATTTTTCGGGGGCTGCAACTAATGAAAAACTGTTTTTT	CASSLGHFSGAATNEKLFF	TRBV11-2	TRBJ1-4
TGTGCCTACGGGGGGGCAGTAGACGGGGAGCTGTTTTTT	CAYGGAVDGELFF	TRBV30	TRBJ2-2
TGTGCCAGCAGCCCGCAGAGGAAGGATGTCACCCGGACTAGAGAAGAGACCCAGTACTTC	CASSPQRKDVTRTREETQYF	TRBV5-4	TRBJ2-5
TGTGCCAGCAGTCCCAGACAGATGGTTTGGAATCAGCCCCAGCATTTT	CASSPRQMVWNQPQHF	TRBV25-1	TRBJ1-5
TGCGCCAGCAGTGTTGACAGCGGTAACACTGAAGCTTTCTTT	CASSVDSGNTEAFF	TRBV10-2	TRBJ1-1
TGCAGTGCCCACACCCAGACTTTCAATCAGCCCCAGCATTTT	CSAHTQTFNQPQHF	TRBV20-1	TRBJ1-5
TGTGCCAGCAGAAATCAGGGGGCGCCGTGGTACACTGAAGCTTTCTTT	CASRNQGAPWYTEAFF	TRBV12-3	TRBJ1-1
TGTGCCAGCAGCTTACTTGCCGACAGGGGTGGCTACACCTTC	CASSLLADRGGYTF	TRBV7-2	TRBJ1-2
TGTGCCAGTCCGGGACAACGGGTAAAGCACACCATATATTTT	CASPGQRVKHTIYF	TRBV7-9	TRBJ1-3
TGTGCCAGCAGTCCCAGGGGGGTTAACGATGAGCAGTTCTTC	CASSPRGVNDEQFF	TRBV12-3	TRBJ2-1
TGTGCCAGCAGTGTATTTAATTGGTCTGAAGCTTTCTTT	CASSVFNWSEAFF	TRBV6-4	TRBJ1-1
