TGCGCCAGCAGCCAAGAGGGGACTAGTAGCAGCCTAGAGTACAATGAGCAGTTCTTC	CASSQEGTSSSLEYNEQFF	TRBV4-3	TRBJ2-1
TGCGCCAGCAGCCAAACCAGACAGGGGGCGGGGGAGAACACTGAAGCTTTCTTT	CASSQTRQGAGENTEAFF	TRBV4-1	TRBJ1-1
TGCGCCAGCAGTGGTCGGGGGCGAGCGCGGCCCCAGCATTTT	CASSGRGRARPQHF	TRBV10-1	TRBJ1-5
TGTGCCAGCAGCTTAGACCGGACGGCCATGAACACTGAAGCTTTCTTT	CASSLDRTAMNTEAFF	TRBV11-2	TRBJ1-1
TGTGCCAGCAGTCTCGAAAGACTAGCGGGAGGCAATGAGCAGTTCTTC	CASSLERLAGGNEQFF	TRBV27	TRBJ2-1
TGCGCCAGCAGCCCCCGGGGCCTGTACGTC	CASSPRGLYV	TRBV5-1	TRBJ2-7
TGCGCCAGCAGCTTAACAGGGCAGGGGTGGAATAGCAATCAGCCCCAGCATTTT	CASSLTGQGWNSNQPQHF	TRBV5-1	TRBJ1-5
TGTGCCAGCATAGCTAACTGGGGGGGCACAGATACGCAGTATTTT	CASIANWGGTDTQYF	TRBV7-2	TRBJ2-3
TGTGCCAGCGTTGCAGGCCAGGAACGGAACACTGAAGCTTTCTTT	CASVAGQERNTEAFF	TRBV7-9	TRBJ1-1
TGTGCCAGTAGTATGAAGGGGACAGGGGAAGAGACCCAGTACTTC	CASSMKGTGEETQYF	TRBV19	TRBJ2-5
TGTGCCAGCAGCTTGGGGACTAAGGAGACCCAGTACTTC	CASSLGTKETQYF	TRBV7-3	TRBJ2-5
TGTGCCAGCAGCGGTAGGGGGAGGAAAGAGACCCAGTACTTC	CASSGRGRKETQYF	TRBV7-6	TRBJ2-5
TGTGCCAGCAGCTTGGCCCTTTCGTTTACAGGGCGGTATGAGCAGTACTTC	CASSLALSFTGRYEQYF	TRBV5-6	TRBJ2-7
TGTGCCAGCCGATACAGGGAACTACAAGAGACCCAGTACTTC	CASRYRELQETQYF	TRBV7-3	TRBJ2-5
TGTGCTAGTGGTTTGGTTAGGTACCCCTTCGAGACCCTAAAGCCCACGGACACTGAAGCTTTCTTT	CASGLVRYPFETLKPTDTEAFF	TRBV12-5	TRBJ1-1
TGTGCCAGCAGAAACGATCATAATGAAAAACTGTTTTTT	CASRNDHNEKLFF	TRBV6-5	TRBJ1-4
TGTGCCAGCAGCCAAGCGGAGCAGGGCCAGAACACTGAAGCTTTCTTT	CASSQAEQGQNTEAFF	TRBV3-1	TRBJ1-1
TGCAGCGTGGAGACTAGAAATGAGCAGTTCTTC	CSVETRNEQFF	TRBV29-1	TRBJ2-1
TGCGCCAGCCTCCGGGCGGGGGGAAGGGATACGCAGTATTTT	CASLRAGGRDTQYF	TRBV5-1	TRBJ2-3
TGTGCCAGCACGCGGGAGCTTGACAATCAGCCCCAGCATTTT	CASTRELDNQPQHF	TRBV7-9	TRBJ1-5
TGTGCCAGCAGCACTTTGGTTTTCCGGACACGGGGGACAGAGGAGACCCAGTACTTC	CASSTLVFRTRGTEETQYF	TRBV7-7	TRBJ2-5
TGTGCCAGCAGCCCGGGACAGGGGAACACTGAAGCTTTCTTT	CASSPGQGNTEAFF	TRBV7-2	TRBJ1-1
TGTGCCAGCAGCTTGGAGACTATCAGGGAGAACTATGGCTACACCTTC	CASSLETIRENYGYTF	TRBV5-8	TRBJ1-2
TGTGCCAGCAGCCTAAAGGGACTGGGCGAGCAGTACTTC	CASSLKGLGEQYF	TRBV3-1	TRBJ2-7
TGTGCCAGCAGCGGCCGTTGTGGACTAGCGGTCCTAACCGGGGAGCTGTTTTTT	CASSGRCGLAVLTGELFF	TRBV13	TRBJ2-2
TGTGCCAGCAGCACGGCGGGAGGGGAGACCCAGTACTTC	CASSTAGGETQYF	TRBV13	TRBJ2-5
TGTGCCACCAGTGATTTAGTCCTCCGAGGGACAGACACTGAAGCTTTCTTT	CATSDLVLRGTDTEAFF	TRBV24-1	TRBJ1-1
TGTGCCAGCAGTAGAGCCAAGTCTGGGAAGCATTACGAGCAGTACTTC	CASSRAKSGKHYEQYF	TRBV6-1	TRBJ2-7
TGTGCCAGCGGAGGACAGTGTAGGGTAAAGTCCTACAATGAGCAGTTCTTC	CASGGQCRVKSYNEQFF	TRBV6-5	TRBJ2-1
TGTGCCAGTAGAATCAGGGTGACCCAGCCCCAGCATTTT	CASRIRVTQPQHF	TRBV19	TRBJ1-5
TGTGCTAGTGGTTGGGGCGGGGGAGCTGAAGCTTTCTTT	CASGWGGGAEAFF	TRBV12-5	TRBJ1-1
TGTGCCAGCAGCCTGGGACAGGGACTAAACACTGAAGCTTTCTTT	CASSLGQGLNTEAFF	TRBV14	TRBJ1-1
TGTGCCAGCACCCCCGGGACAGTCTCTGGGGCCAACGTCCTGACTTTC	CASTPGTVSGANVLTF	TRBV28	TRBJ2-6
TGCAGTGCTACGACAGGGGGGGAGCCCCAGCATTTT	CSATTGGEPQHF	TRBV20-1	TRBJ1-5
TGCAGTGCGCACCTAGCGGGTGTTACTGAGCAGTTCTTC	CSAHLAGVTEQFF	TRBV20-1	TRBJ2-1
TGCGCCAGCACCGAGGGACCAGGGAATGGAAACACCATATATTTT	CASTEGPGNGNTIYF	TRBV5-1	TRBJ1-3
TGTGCCAGCAGCCAAATAGGGACAGGCCGTATCTCCTACGAGCAGTACTTC	CASSQIGTGRISYEQYF	TRBV3-1	TRBJ2-7
TGTGCCATCATCCAGGGACCAAATGAAGCTTTCTTT	CAIIQGPNEAFF	TRBV10-3	TRBJ1-1
TGTGCCAGCAGCAGAATTGTTCCTGGGCCCTTGGAGCAGTACTTC	CASSRIVPGPLEQYF	TRBV7-3	TRBJ2-7
TGTGCCAGCAGCTTAGCCACAATTCAGGGCAGGGGCGAGCAGTACTTC	CASSLATIQGRGEQYF	TRBV7-4	TRBJ2-7
TGTGCCAGCAGCGGGGGGAGGGCGAGGGAGACCCAGTACTTC	CASSGGRARETQYF	TRBV7-6	TRBJ2-5
TGTGCCAGCAGAGCAGACAGGAGCTCTGGAAACACCATATATTTT	CASRADRSSGNTIYF	TRBV5-5	TRBJ1-3
TGTGCCAGCAGCTTGGTCGGCCCTTTGGGGGAATTGGTCTATGGCTACACCTTC	CASSLVGPLGELVYGYTF	TRBV5-6	TRBJ1-2
TGTGCCAGCAGCCCCCCGGTGTCGGGCCGGGGAGGGGGAAATGAAAAACTGTTTTTT	CASSPPVSGRGGGNEKLFF	TRBV12-4	TRBJ1-4
TGTGCCAGCAGCTTAGCCCCGACGGGCGTCACCTTC	CASSLAPTGVTF	TRBV7-9	TRBJ1-2
TGCAGTGCTAGAGATGTAGGGGGCCCCCGTGAGCAGTACTTC	CSARDVGGPREQYF	TRBV20-1	TRBJ2-7
TGTGCCAGCTCACCCCACGGACAGTGTCTACCTTTTAATCAGCCCCAGCATTTT	CASSPHGQCLPFNQPQHF	TRBV18	TRBJ1-5
TGTGCCAGCATTCTGGTTACGGACAGGGTGGGCGGCTATGGCTACACCTTC	CASILVTDRVGGYGYTF	TRBV27	TRBJ1-2
TGCGCCAGCATCGGGGTCCAAGAGACCCAGTACTTC	CASIGVQETQYF	TRBV5-1	TRBJ2-5
TGCGCCAGCAGCTACGGAGGCGCCTGTGGGGGCTATAATTCACCCCTCCACTTT	CASSYGGACGGYNSPLHF	TRBV5-1	TRBJ1-6
TGTGCCAGCAGCATTGGGGGGGGGAATTTAACCGGGGAGCTGTTTTTT	CASSIGGGNLTGELFF	TRBV7-9	TRBJ2-2
TGTGCCAGCTCCGACCCATCCAATGAGCAGTTCTTC	CASSDPSNEQFF	TRBV18	TRBJ2-1
TGCGCCAGCAGCCAGGGGTTTTTTAACGAGCAGTACTTC	CASSQGFFNEQYF	TRBV5-1	TRBJ2-7
TGTGCCACCACAAAGGTGAGACCAGATACGCAGTATTTT	CATTKVRPDTQYF	TRBV24-1	TRBJ2-3
TGTGCCAGGATGGGGGGGAACGAGCAGTACTTC	CARMGGNEQYF	TRBV12-4	TRBJ2-7
TGTGCCAGCAGCGTGGGGACAGACTGCCGGTTTGATGGCTACACCTTC	CASSVGTDCRFDGYTF	TRBV13	TRBJ1-2
TGTGCCAGCAGCACCCCGGAGCGACAGGGGGAGCAGTACTTC	CASSTPERQGEQYF	TRBV7-9	TRBJ2-7
TGTGCCAGCAGCGTCCGGAAGAGCACGGGGTATGAGCAGTTCTTC	CASSVRKSTGYEQFF	TRBV7-2	TRBJ2-1
TGTGCCAGCGTACAAGCGGGAGATCTGGTCGATACGCAGTATTTT	CASVQAGDLVDTQYF	TRBV5-4	TRBJ2-3
TGTGCCAGCAGTTTCAACCGGGACAGGGGCGAAATCAATCAGCCCCAGCATTTT	CASSFNRDRGEINQPQHF	TRBV27	TRBJ1-5
TGTGCCAGCACCCCGTCCTTGCAGGCCGATGAGCAGTTCTTC	CASTPSLQADEQFF	TRBV6-3	TRBJ2-1
TGTGCCAGCCGACGGATTTACACCGGGGAGCTGTTTTTT	CASRRIYTGELFF	TRBV5-5	TRBJ2-2
TGTGCCAGCAGTCCACCTCTATGGGGGAAGGGACAGGGGTCGTGGTCTGGGGTGCCCGAAAAACTGTTTTTT	CASSPPLWGKGQGSWSGVPEKLFF	TRBV7-3	TRBJ1-4
TGTGCTGATAGAGGAGAGACCCAGTACTTC	CADRGETQYF	TRBV30	TRBJ2-5
TGTGCCAGCACCGGGACAGCCAGCTCTGGAAACACCATATATTTT	CASTGTASSGNTIYF	TRBV12-4	TRBJ1-3
TGCGCCAGCAGCGGCCCATCCGGGCCTGAAGCTTTCTTT	CASSGPSGPEAFF	TRBV5-1	TRBJ1-1
TGTGCCCGGGGGAGGAAGTTTTTCTATGGCTACACCTTC	CARGRKFFYGYTF	TRBV3-1	TRBJ1-2
TGTGCCAGCAGCTTAGTCCCAGGGCGACATGAGCAGTTCTTC	CASSLVPGRHEQFF	TRBV11-3	TRBJ2-1
TGTGCCAGCAGTAAACCGGGAGAAAGGGTATACAATGAGCAGTTCTTC	CASSKPGERVYNEQFF	TRBV28	TRBJ2-1
TGTGCCCCTTTTACAGGGATCTATGGCTACACCTTC	CAPFTGIYGYTF	TRBV14	TRBJ1-2
TGTGCCAGCAAAGGACCGGGTCATGCCTACGAGCAGTACTTC	CASKGPGHAYEQYF	TRBV6-4	TRBJ2-7
TGTGCCAGCAGCCGGGGGCTGGGCACCGGGGAGCTGTTTTTT	CASSRGLGTGELFF	TRBV4-2	TRBJ2-2
TGTGCCACCAGTGATTTGCGTCTGATGGGAGGCAAGAATGAAAAACTGTTTTTT	CATSDLRLMGGKNEKLFF	TRBV24-1	TRBJ1-4
TGTGCCAGCGCTCTGGGGGATCAGCCCCAGCATTTT	CASALGDQPQHF	TRBV27	TRBJ1-5
TGTGCCAGCAGCGGTCGACAGGGTAATAATCAGCCCCAGCATTTT	CASSGRQGNNQPQHF	TRBV7-4	TRBJ1-5
TGTGCCAGCAGTGGCCGGGACATGTGGCAGCCCCAGCATTTT	CASSGRDMWQPQHF	TRBV27	TRBJ1-5
TGTGCCAGCAGCTTTCCCGTAGTTAGCAACGAAGAGACCCAGTACTTC	CASSFPVVSNEETQYF	TRBV5-4	TRBJ2-5
TGTGCCAGCAGTTACTCGAAGCCCGTGGAAGTGTATGTCACAGGGAAAAATGAAAAACTGTTTTTT	CASSYSKPVEVYVTGKNEKLFF	TRBV6-5	TRBJ1-4
TGTGCCAGCAGTGAACCCAGGGGACAGATAGGGAACATGAACACTGAAGCTTTCTTT	CASSEPRGQIGNMNTEAFF	TRBV6-4	TRBJ1-1
TGTGCCAGCAGTTCAAGCGGGGACAGGGGTGAGAGCAATCAGCCCCAGCATTTT	CASSSSGDRGESNQPQHF	TRBV6-5	TRBJ1-5
TGTGCCGAATCCAGGGTAGCGGGGCTAATTGGAAGCTATGGCTACACCTTC	CAESRVAGLIGSYGYTF	TRBV6-5	TRBJ1-2
TGTGCCTGGAACGGCAGGTTAGGGGGTAACTATGGCTACACCTTC	CAWNGRLGGNYGYTF	TRBV30	TRBJ1-2
TGTGCCAGTAGTATTGACAGGGAATCTGAGCAGTTCTTC	CASSIDRESEQFF	TRBV19	TRBJ2-1
TGTGCCAGCAGCGCCCGCCTCAGAGTTCCCGAGCAGTACTTC	CASSARLRVPEQYF	TRBV7-6	TRBJ2-7
TGTGCCAGCAGCGGAATAGCGGACAATGAGCAGTTCTTC	CASSGIADNEQFF	TRBV13	TRBJ2-1
TGTGCCAGCAGTCCGCGGCTACCACGAAGCTCCTATAATTCACCCCTCCACTTT	CASSPRLPRSSYNSPLHF	TRBV6-2	TRBJ1-6
TGTGCCAGCAGCGGCGCCCAGGGTCTGCTGTACGAGCAGTACTTC	CASSGAQGLLYEQYF	TRBV9	TRBJ2-7
TGTGCCAGCAGAAACCTAGCGGGGGCGAGCGGGGAGCTGTTTTTT	CASRNLAGASGELFF	TRBV11-3	TRBJ2-2
TGTGCCAGCAGTAAAATAACAGGGGAGTGTCACGGTGGCTACACCTTC	CASSKITGECHGGYTF	TRBV27	TRBJ1-2
TGCAGCGTTGAAGATCCGGGGTGCTCTGGAAACACCATATATTTT	CSVEDPGCSGNTIYF	TRBV29-1	TRBJ1-3
TGTGCCAGCAGCATCAGGGGAGACCTGGAGACCCAGTACTTC	CASSIRGDLETQYF	TRBV28	TRBJ2-5
TGTGCCAGCAGCCTAGTGCGTCCGGGGGCCGGGAATGCAACTAATGAAAAACTGTTTTTT	CASSLVRPGAGNATNEKLFF	TRBV9	TRBJ1-4
TGTGCCAGCAGCTGCCGGGACAGGGGCGCCGGCCCTGGGGCCAACGTCCTGACTTTC	CASSCRDRGAGPGANVLTF	TRBV7-7	TRBJ2-6
TGTGCCATCAGTGCCGGCTCCCGGGACAGGCTTAACGAGCAGTACTTC	CAISAGSRDRLNEQYF	TRBV10-3	TRBJ2-7
TGTGCCAGCAAATTCGGGTGGGGCTACGAGCAGTACTTC	CASKFGWGYEQYF	TRBV12-3	TRBJ2-7
TGTGCCACCAGCAGAGTCAGGGTAGGCTACGAGCAGTACTTC	CATSRVRVGYEQYF	TRBV15	TRBJ2-7
TGTGCCAGCAGTTTACCTGGGAACAGGGGGCGCATCAATCAGCCCCAGCATTTT	CASSLPGNRGRINQPQHF	TRBV12-3	TRBJ1-5
TGTGCCAGTAGTAAATCCTTCCCGAGGTTTGACGAGCAGTACTTC	CASSKSFPRFDEQYF	TRBV19	TRBJ2-7
TGTGCCAGTAGTATAGATTGGAAAGCAGGGCCCAGCTCCTACGAGCAGTACTTC	CASSIDWKAGPSSYEQYF	TRBV19	TRBJ2-7
TGTGCCAGCAGCACGGGCATCCAAGAGACCCAGTACTTC	CASSTGIQETQYF	TRBV9	TRBJ2-5
TGTGCCAGCAGCTTAGCGGGGGGGGCCGGGTGTAGGGAGTATCAAGAGACCCAGTACTTC	CASSLAGGAGCREYQETQYF	TRBV11-3	TRBJ2-5
TGCGCCAGCAGCGGCGGTCGGGTAATTGACGAGCAGTACTTC	CASSGGRVIDEQYF	TRBV5-1	TRBJ2-7
TGCAGTGCTAGAGATGCGGGAGACCACGTCGAGCAGTACTTC	CSARDAGDHVEQYF	TRBV20-1	TRBJ2-7
TGTGCCAGGGAGGGGTGCGAGCAGTACTTC	CAREGCEQYF	TRBV7-9	TRBJ2-7
TGCGCCAGCAGCTTAGTACAGTCTCAGCCCCAGCATTTT	CASSLVQSQPQHF	TRBV5-1	TRBJ1-5
TGCAGCGTTGACATTACTAGCTCCCTGGGGGAGCAGTACTTC	CSVDITSSLGEQYF	TRBV29-1	TRBJ2-7
TGTGCCAGCAGCTTCCACGACAGAAGTCTGAACACTGAAGCTTTCTTT	CASSFHDRSLNTEAFF	TRBV7-7	TRBJ1-1
TGTGCCAGCAGCCCCTCGCGGGAGCCGGAAGCCGAATTCACAGATACGCAGTATTTT	CASSPSREPEAEFTDTQYF	TRBV13	TRBJ2-3
TGTGCCAGCAGCCTAAGGGGGCACGGGGCCTACAATGAGCAGTTCTTC	CASSLRGHGAYNEQFF	TRBV5-6	TRBJ2-1
TGTGCCAGCAGCATTGACGCAGGTGAGACCCAGTACTTC	CASSIDAGETQYF	TRBV7-3	TRBJ2-5
TGCGCCAGCAGCTTAAAACAGGGGCAGCCCCAGCATTTT	CASSLKQGQPQHF	TRBV5-1	TRBJ1-5
TGTGCCAGCAGCCACCCCTCGAAACAGGGAAAGTTCGTTCAAGAGACCCAGTACTTC	CASSHPSKQGKFVQETQYF	TRBV14	TRBJ2-5
TGCAGTGCTCGCCCATTTTTCGCTAGTAATGGCTACACCTTC	CSARPFFASNGYTF	TRBV20-1	TRBJ1-2
TGTGCCAGCAACTCGTTGCTTGACAGCAATCAGCCCCAGCATTTT	CASNSLLDSNQPQHF	TRBV25-1	TRBJ1-5
TGTGCCAGCAGCGTAGGGAACGTCAAGCAGTTCTTC	CASSVGNVKQFF	TRBV9	TRBJ2-1
TGTGCCAGCGGTAAAGGGGCTACTGGAAACACCATATATTTT	CASGKGATGNTIYF	TRBV27	TRBJ1-3
TGCGCCAGCAGCCAAGGGGGACTAGGGACGAAGGATGAGCAGTTCTTC	CASSQGGLGTKDEQFF	TRBV4-1	TRBJ2-1
TGCAGTGCTAGAGTTCCGCCCCTAGGTTGTTACTTCGTGGGAACTAGAAGCTCCTATAATTCACCCCTCCACTTT	CSARVPPLGCYFVGTRSSYNSPLHF	TRBV20-1	TRBJ1-6
TGTGCCAGCAGTTACTCAAACCTCGGGGTCTGGGGCTACACCTTC	CASSYSNLGVWGYTF	TRBV6-5	TRBJ1-2
TGTGCCAGCAGCCATCGGACAGGGACGTCCAATGTCTGCGAGCAGTACTTC	CASSHRTGTSNVCEQYF	TRBV14	TRBJ2-7
TGTGCCAGCAGCCAACCTCGGGGGGGCGGAGATACGCAGTATTTT	CASSQPRGGGDTQYF	TRBV4-2	TRBJ2-3
TGTGCCAGCAGCTTGGCAAAGGGACCAAACACTGAAGCTTTCTTT	CASSLAKGPNTEAFF	TRBV5-6	TRBJ1-1
TGTGCCAGCATGGCCTCTAGGGACGACGAGCAGTACTTC	CASMASRDDEQYF	TRBV6-4	TRBJ2-7
TGTGCCCCCAGTATGGAAATTCAGCCCCAGCATTTT	CAPSMEIQPQHF	TRBV7-2	TRBJ1-5
TGTGCCAGCAGCGAGGACAGGGCAGCTAACTATGGCTACACCTTC	CASSEDRAANYGYTF	TRBV7-9	TRBJ1-2
TGTGCCATCAGAAATATGGGACGGGCCTCCAGCACAGATACGCAGTATTTT	CAIRNMGRASSTDTQYF	TRBV10-3	TRBJ2-3
TGTGCCAGCAGTGACAGAAACGTCCCCCGGCCGACGGCCAATGAGCAGTTCTTC	CASSDRNVPRPTANEQFF	TRBV6-4	TRBJ2-1
TGTGCCAGCAGCAGCAGGGGGGGGGAGTATGGCTACACCTTC	CASSSRGGEYGYTF	TRBV7-3	TRBJ1-2
TGTGCCAGATCGGGACATTACGAGCAGTACTTC	CARSGHYEQYF	TRBV5-5	TRBJ2-7
TGTGCCAGCAGCGTAGCCGAGCCATCGACAGGGGCTTGCACAGATACGCAGTATTTT	CASSVAEPSTGACTDTQYF	TRBV9	TRBJ2-3
TGTGCCAGCAGTTTAGGGCCTGTAAGTGGGGCCAACGTCCTGACTTTC	CASSLGPVSGANVLTF	TRBV27	TRBJ2-6
TGCGCCAGCAGCGCGCGGGACAGGGAGGTGTTTGGGCAAGAGACCCAGTACTTC	CASSARDREVFGQETQYF	TRBV5-1	TRBJ2-5
TGTGCCAGCAGCAGAGAAAACAGGGGGTTGGGGAGCTACGAGCAGTACTTC	CASSRENRGLGSYEQYF	TRBV7-6	TRBJ2-7
TGTGCCATCAGTGCTACGAGCGGAAGGGGTATAGAAACTGAAGCTTTCTTT	CAISATSGRGIETEAFF	TRBV10-3	TRBJ1-1
TGTGCCAGCAGTCGGGACAGGGTGAGGAATCAGCCCCAGCATTTT	CASSRDRVRNQPQHF	TRBV6-6	TRBJ1-5
TGCGCCAGCCCGTCTAGCGGGAGTTACAATGAGCAGTTCTTC	CASPSSGSYNEQFF	TRBV10-1	TRBJ2-1
TGTGCCTTGGGGTCACTAGAGACCCAGTACTTC	CALGSLETQYF	TRBV5-6	TRBJ2-5
TGTGCCAGCAGCCTTTCAGGACCGCTCAGGGGGCGGAGCTCCTACGAGCAGTACTTC	CASSLSGPLRGRSSYEQYF	TRBV14	TRBJ2-7
TGTGCCACCAGTGATCCCAGGGGGTATTGGGACAATCAGCCCCAGCATTTT	CATSDPRGYWDNQPQHF	TRBV24-1	TRBJ1-5
TGTGCCACCTTGGGCGGGTACGAGCAGTACTTC	CATLGGYEQYF	TRBV28	TRBJ2-7
TGTGCCAGCAGCTTAAGGGATTGGAGGACAGGGGAACCGAGCAATGAGCAGTTCTTC	CASSLRDWRTGEPSNEQFF	TRBV11-1	TRBJ2-1
TGTGCCAGCAAGAAAACCCCGCCGTCTGGACAGGGCGAGGACTACAATGAGCAGTTCTTC	CASKKTPPSGQGEDYNEQFF	TRBV11-3	TRBJ2-1
TGTGCCAGCGAAGGGAATCTAGCCAAAAACATTCAGTACTTC	CASEGNLAKNIQYF	TRBV13	TRBJ2-4
TGTGCCAGCAGCGGCCGCGGGAGATCCCCGGGTAGGCAGTACTTC	CASSGRGRSPGRQYF	TRBV13	TRBJ2-7
TGTGCCAGCAGTTACGGGGGGGGGACCGAGCAGTACTTC	CASSYGGGTEQYF	TRBV6-5	TRBJ2-7
TGTGCCAGCAGCCATGGGGGGCCCTCAGATACGCAGTATTTT	CASSHGGPSDTQYF	TRBV3-1	TRBJ2-3
TGCAGCGTTGAGGTGGGGGGGCGGGGACCCCCTAGCACAGATACGCAGTATTTT	CSVEVGGRGPPSTDTQYF	TRBV29-1	TRBJ2-3
TGCAGTGCTCCGGCCAAGGGGACGACTGAGCAGTTCTTC	CSAPAKGTTEQFF	TRBV20-1	TRBJ2-1
TGTGCCAGCAGCAAGCGGGATCTTGAAAAACTGTTTTTT	CASSKRDLEKLFF	TRBV5-6	TRBJ1-4
TGCAGTCGGGGGGGTGGGGGCCGACACTATGCCTACGAGCAGTACTTC	CSRGGGGRHYAYEQYF	TRBV20-1	TRBJ2-7
TGCAGTGCGCTAGGGGATTCACCCCTCCACTTT	CSALGDSPLHF	TRBV20-1	TRBJ1-6
TGTGCCAGCAGCGGACAGGGGGATAACTATGGCTACACCTTC	CASSGQGDNYGYTF	TRBV9	TRBJ1-2
TGTGCCAGCAGGTTCCCAAGGACAGGGTCGAACACTGAAGCTTTCTTT	CASRFPRTGSNTEAFF	TRBV6-2	TRBJ1-1
TGTGCCAGCAGTGATCCGGGCAATCAGCCCCAGCATTTT	CASSDPGNQPQHF	TRBV27	TRBJ1-5
TGTGCCAGCAGCGGTCAACTAGGCTACGAGCAGTACTTC	CASSGQLGYEQYF	TRBV7-3	TRBJ2-7
TGTGCCAGCAGTGATTCACGTAAATCGGGGGGGCCCAATGAGCAGTTCTTC	CASSDSRKSGGPNEQFF	TRBV25-1	TRBJ2-1
TGCGCCAGCCGGTGTGATCAGGGGGGACCTTCCTATAGCAATCAGCCCCAGCATTTT	CASRCDQGGPSYSNQPQHF	TRBV5-1	TRBJ1-5
TGTGCCAGCAGGGGAGCACTGGACGTAACGGCCCTGGGGATACTAGCCAAAAACATTCAGTACTTC	CASRGALDVTALGILAKNIQYF	TRBV6-8	TRBJ2-4
TGCGCCAGCAAGCGGCGGGAGGTACACCAAGAGACCCAGTACTTC	CASKRREVHQETQYF	TRBV5-1	TRBJ2-5
TGTGCCATCAGTGAGTCGACGGCCCCTGAGGACAGGCCAAGAGTGAACACTGAAGCTTTCTTT	CAISESTAPEDRPRVNTEAFF	TRBV10-3	TRBJ1-1
TGTGCCAGCAGCCAAGATAAATTAAGTAGGGGGGACACTGAAGCTTTCTTT	CASSQDKLSRGDTEAFF	TRBV3-1	TRBJ1-1
TGTGCCAGCAGTGATAAACCTTTCGTGCAAGGCACAGATACGCAGTATTTT	CASSDKPFVQGTDTQYF	TRBV2	TRBJ2-3
TGTGCCATCTTGGGCCGGGCCGGGGAGCTGTTTTTT	CAILGRAGELFF	TRBV10-3	TRBJ2-2
TGTGCCACCAGTGACTTCCGGGTTGAGCAGTTCTTC	CATSDFRVEQFF	TRBV24-1	TRBJ2-1
TGTGCTAGTGGTTTGGACCCGGGACCGAACAATGAGCAGTTCTTC	CASGLDPGPNNEQFF	TRBV12-5	TRBJ2-1
TGTGCCAGCATCGGGGAGCAACAGCCCCAGCATTTT	CASIGEQQPQHF	TRBV7-4	TRBJ1-5
TGCGCCAGCAGCTTTTACGCCAGACAGTTTGTGGGAAAGCCCCAGCATTTT	CASSFYARQFVGKPQHF	TRBV5-1	TRBJ1-5
TGTGCCTGGAGTGTACCCGAGGAGAACAATGAGCAGTTCTTC	CAWSVPEENNEQFF	TRBV30	TRBJ2-1
TGTGCCAGCTCACCACCAAATTTCAGGGAATATTACAATGAGCAGTTCTTC	CASSPPNFREYYNEQFF	TRBV18	TRBJ2-1
TGTGCCTCTGGTGCGGGACTAGCGGGGGGGTACCAAGAGACCCAGTACTTC	CASGAGLAGGYQETQYF	TRBV27	TRBJ2-5
TGTGCCCTCCCACGAGGGGAGCAGTACTTC	CALPRGEQYF	TRBV19	TRBJ2-7
TGTGCCAGCAGCTTGACAGGGGGAACTGGCTCGGAGACCCAGTACTTC	CASSLTGGTGSETQYF	TRBV5-6	TRBJ2-5
TGCAGTGCAACAGGGGTGTCGAGAGATTATGGCTACACCTTC	CSATGVSRDYGYTF	TRBV20-1	TRBJ1-2
TGTGCCAGCAGTGACCTCCGGGACGGGAGGAAGCACTATGGCTACACCTTC	CASSDLRDGRKHYGYTF	TRBV27	TRBJ1-2
TGTGCCAGCAGTTTAGCGTTAGGGGGCCCATCCTACGAGCAGTACTTC	CASSLALGGPSYEQYF	TRBV12-4	TRBJ2-7
TGCGCCACTACGTCGCGACAGTGCAATCAGCCCCAGCATTTT	CATTSRQCNQPQHF	TRBV5-1	TRBJ1-5
TGTGCCAGCAGTGCGGGCGGGAAGACTAGCACAGATACGCAGTATTTT	CASSAGGKTSTDTQYF	TRBV6-4	TRBJ2-3
TGTGCCAGCAGCCGGCCGGTCGGACTAGCGGACATTCAGTACTTC	CASSRPVGLADIQYF	TRBV14	TRBJ2-4
TGCGCCAGCAGCTTGAGGGCCGCCTGGACCTCTGGAAACACCATATATTTT	CASSLRAAWTSGNTIYF	TRBV5-1	TRBJ1-3
TGTGCCAGCACTGCAGGGACGCCTACCTCTGGAAACACCATATATTTT	CASTAGTPTSGNTIYF	TRBV6-1	TRBJ1-3
TGTGCCAGTAATTGTGGGATTAATCAGCCCCAGCATTTT	CASNCGINQPQHF	TRBV19	TRBJ1-5
TGTGCCAGCAGACAGATTCCGAGACAAGAGACCCAGTACTTC	CASRQIPRQETQYF	TRBV7-6	TRBJ2-5
TGTGCCAGCAGCTTACCGGGGCGCAATCAGCCCCAGCATTTT	CASSLPGRNQPQHF	TRBV7-3	TRBJ1-5
TGCAGTGCTAGAGATGGGGGGGTGGTTTGGGGCTATGGCTACACCTTC	CSARDGGVVWGYGYTF	TRBV20-1	TRBJ1-2
TGTGCCAGCAGTGACGAACCCTCGGGAAGGGAATGGGGTTCCGGCAATGAGCAGTTCTTC	CASSDEPSGREWGSGNEQFF	TRBV6-4	TRBJ2-1
TGTGCCAGCAGCTCTTTCACCCTGACAGGTAGGTCGGACTATGGCTACACCTTC	CASSSFTLTGRSDYGYTF	TRBV5-5	TRBJ1-2
TGTGCCAGCAGCGCATCCCGGGGACAGGGAGGGAACATTCAGTACTTC	CASSASRGQGGNIQYF	TRBV7-9	TRBJ2-4
TGTGCCAGCAGCGCCCGTTCTAGCGGAGGAAATGAGCAGTTCTTC	CASSARSSGGNEQFF	TRBV9	TRBJ2-1
TGTGCCAGCAGCCCAGACAGGGGGCAGGGTGAAGCTTTCTTT	CASSPDRGQGEAFF	TRBV12-3	TRBJ1-1
TGTGCCAGCAGCTTGGAGATTTGCAGCACCGTCCAAGAGACCCAGTACTTC	CASSLEICSTVQETQYF	TRBV7-4	TRBJ2-5
TGTGCCTGGAGTGTCGGATCCACTAGCGGGAAAGCCTCCAGCTCCTACAATGAGCAGTTCTTC	CAWSVGSTSGKASSSYNEQFF	TRBV30	TRBJ2-1
TGTGCCATCAGTGAGAATGGGATTCCCCTAGGGGGGGGGATAAATGAGCAGTTCTTC	CAISENGIPLGGGINEQFF	TRBV10-3	TRBJ2-1
TGCGCCAGCAGCCAACCGGGTGGGGGCCGCTTACCCCATGCATACGAGCAGTACTTC	CASSQPGGGRLPHAYEQYF	TRBV4-1	TRBJ2-7
TGCAGCGTTCCTAGGGGGCCGGTTACTGAAGCTTTCTTT	CSVPRGPVTEAFF	TRBV29-1	TRBJ1-1
TGTGCCAGCAGCTTACACATGGGTACCCCAGCTTTCTTT	CASSLHMGTPAFF	TRBV5-4	TRBJ1-1
TGCAGTGCTACGACCCTCGGCTACACCTTC	CSATTLGYTF	TRBV20-1	TRBJ1-2
TGTGCCAGCAGCCAAGAGTCGGGACAGGCAGGTACCGGTAACTATGGCTACACCTTC	CASSQESGQAGTGNYGYTF	TRBV3-1	TRBJ1-2
TGTGCCAGCAGCTTAGTTGAGGAGACCCAGTACTTC	CASSLVEETQYF	TRBV7-3	TRBJ2-5
TGCAGTGCCGGTGAGCGGAACCGGGGGGTCTACGAGCAGTACTTC	CSAGERNRGVYEQYF	TRBV20-1	TRBJ2-7
TGTGCCAGCAGCTTATCGAAGGGGGCAACGTCTCTGGTACGCAATCAGCCCCAGCATTTT	CASSLSKGATSLVRNQPQHF	TRBV7-8	TRBJ1-5
TGTGCCAGCAGCCAGGGGGCCTCCTACGAGCAGTACTTC	CASSQGASYEQYF	TRBV7-3	TRBJ2-7
TGTGCCAGCAGTTTGACCCAAGATCGGGGACAGGGGGGAAACTATGGCTACACCTTC	CASSLTQDRGQGGNYGYTF	TRBV28	TRBJ1-2
TGTGCCAGCAGCCCCCCTCCGGGATACAACACCGGGGAGCTGTTTTTT	CASSPPPGYNTGELFF	TRBV9	TRBJ2-2
TGTGCCAGCAGTCAGGGAGTCGGCACAGATACGCAGTATTTT	CASSQGVGTDTQYF	TRBV6-5	TRBJ2-3
TGTGCCAGCAGCTTCCGGGGGGGGACAAGCTCTGGAAACACCATATATTTT	CASSFRGGTSSGNTIYF	TRBV5-4	TRBJ1-3
TGTGCCAGCAGCTCGGTACAGGGGTTTACGCAGTATTTT	CASSSVQGFTQYF	TRBV7-3	TRBJ2-3
TGCGCCAGCAGCCAAGCTCCGTGGGGAGTATACGAGACCCAGTACTTC	CASSQAPWGVYETQYF	TRBV4-1	TRBJ2-5
TGTGCCAGCAGTTCGATGAAGGGACACTGCACTGAAGCTTTCTTT	CASSSMKGHCTEAFF	TRBV6-2	TRBJ1-1
TGTGCCAGCAGCTTACCCAATGCGGTATGCACCGGGGAGCTGTTTTTT	CASSLPNAVCTGELFF	TRBV11-2	TRBJ2-2
TGCAAGCCCGGGACAGACAATGAGCAGTTCTTC	CKPGTDNEQFF	TRBV20-1	TRBJ2-1
TGTGCCAGCTCCCCACACAGGTTTGCTTCCCGAGAGACCCAGTACTTC	CASSPHRFASRETQYF	TRBV18	TRBJ2-5
TGTGCCAGCAGTTTCCGCCCGGGGGCGAGGTCAGATACGCAGTATTTT	CASSFRPGARSDTQYF	TRBV28	TRBJ2-3
TGTGCCAGCAAGCGGACAGGGACCTACGAGCAGTACTTC	CASKRTGTYEQYF	TRBV25-1	TRBJ2-7
TGTGCCAGCAGACTGTTCTACGAGCAGTACTTC	CASRLFYEQYF	TRBV6-4	TRBJ2-7
TGTGCCAGTAGTATTCCCCCCGAAACCGGGGAGCTGTTTTTT	CASSIPPETGELFF	TRBV19	TRBJ2-2
TGTGCCACCAGTGATTTGGCGAGGGGTACCTACGAGCAGTACTTC	CATSDLARGTYEQYF	TRBV24-1	TRBJ2-7
TGTGCCAGCAGCAAAAGGGGCAGGTACACTGAAGCTTTCTTT	CASSKRGRYTEAFF	TRBV2	TRBJ1-1
TGTGCCAGCAGCAGCGGGACAGCTCATCAGCCCCAGCATTTT	CASSSGTAHQPQHF	TRBV9	TRBJ1-5
TGCGCCAGCAGTACTGTCCGGGGGGGCCCCGCACCGACCCCCGAGCAGTACTTC	CASSTVRGGPAPTPEQYF	TRBV10-1	TRBJ2-7
TGTGCCAGCAGCCTACGACCGCGCTCGGCGTACAGTAAATCTAATCAGCCCCAGCATTTT	CASSLRPRSAYSKSNQPQHF	TRBV14	TRBJ1-5
TGTGCCACTGTACAGGGTTATGGCTACACCTTC	CATVQGYGYTF	TRBV12-3	TRBJ1-2
TGTGCCAGCAGCCAAGATCCCGATAACCATTTTCCCAATGAGCAGTTCTTC	CASSQDPDNHFPNEQFF	TRBV14	TRBJ2-1
TGTGCCATCTCTATTAGGGACCGCCCCTTC	CAISIRDRPF	TRBV10-3	TRBJ2-7
TGTGCCACCAGTGATTTGCCCTGCTTAATGGAGCAGTACTTC	CATSDLPCLMEQYF	TRBV24-1	TRBJ2-7
TGTGCCAGCAGTGGGTACGCTAGGGTAGAGCAGTACTTC	CASSGYARVEQYF	TRBV2	TRBJ2-7
TGCTTCCAGGGGGAGAATAACTATGGCTACACCTTC	CFQGENNYGYTF	TRBV29-1	TRBJ1-2
TGTGCCAGCAGTTTTAACGAAGACAGGGCCGGGAATAACATGAACACTGAAGCTTTCTTT	CASSFNEDRAGNNMNTEAFF	TRBV12-3	TRBJ1-1
TGTGCCAGCAGCGGTAGGGGACTAGGGGGCCATTGCACAGATACGCAGTATTTT	CASSGRGLGGHCTDTQYF	TRBV7-3	TRBJ2-3
TGTGCCAGCAGCTGTGGGCGAGACAGGTCGGGCTACGAGCAGTACTTC	CASSCGRDRSGYEQYF	TRBV7-9	TRBJ2-7
TGCGCCAGCCCTGGGGTCCAAGATACGCAGTATTTT	CASPGVQDTQYF	TRBV10-1	TRBJ2-3
TGTGCCAGCAGCCGGGACCGGGACAGGACGCCTGAAGCTTTCTTT	CASSRDRDRTPEAFF	TRBV3-1	TRBJ1-1
TGTGCCAGCAGCCAAGATAGGGGGACAGATGATTCACCCCTCCACTTT	CASSQDRGTDDSPLHF	TRBV3-1	TRBJ1-6
TGCAGTGCGGACCTTCACCCCCGGACTGACTCAGATACGCAGTATTTT	CSADLHPRTDSDTQYF	TRBV20-1	TRBJ2-3
TGTGCCAGCAGCGTATTTCCATCGGGGGGGCATGAAAAACTGTTTTTT	CASSVFPSGGHEKLFF	TRBV9	TRBJ1-4
TGTGCCAGCAGCCCTTCGTACGAGCAGTACTTC	CASSPSYEQYF	TRBV27	TRBJ2-7
TGTGCCAGCGATGGGACAGGATGTGGCTACACCTTC	CASDGTGCGYTF	TRBV9	TRBJ1-2
TGTGCCAGCAGAAGTGGGACAGGGGGGTACACCTTC	CASRSGTGGYTF	TRBV6-5	TRBJ1-2
TGCGCCAGATTCCCCAAGGGACAGGGGGGTTGTCAGCCCCAGCATTTT	CARFPKGQGGCQPQHF	TRBV10-1	TRBJ1-5
TGTGCCAGTAGTATCCCCTTCATAAATGAGCAGTTCTTC	CASSIPFINEQFF	TRBV19	TRBJ2-1
TGCGCCAGCAGCGGGACAGGGATTACCTACGAGCAGTACTTC	CASSGTGITYEQYF	TRBV5-1	TRBJ2-7
TGTGCCAGCAGTTTATCGTGGGGGAGCTATGGCTACACCTTC	CASSLSWGSYGYTF	TRBV27	TRBJ1-2
TGCGCCAGCAGTGAGTTTACCGTTGCGGACATGTCGGGCGGCTACACCTTC	CASSEFTVADMSGGYTF	TRBV10-1	TRBJ1-2
TGCAGCGTTGAACTGTCCGAGACCCAGTACTTC	CSVELSETQYF	TRBV29-1	TRBJ2-5
TGTGCCAGCAGCAACCCCCATCAAAGACAGGGTGACGATACGCAGTATTTT	CASSNPHQRQGDDTQYF	TRBV7-3	TRBJ2-3
TGTGCCAGCAGCTTAGTTCCCGAAGGGGTGGGGAACTATGGCTACACCTTC	CASSLVPEGVGNYGYTF	TRBV7-2	TRBJ1-2
TGTGCCAGCAAATCGGACGGTCCCCCGCTCGTAAACATTCAGTACTTC	CASKSDGPPLVNIQYF	TRBV12-4	TRBJ2-4
TGCGCCAGCAGTGAGGCGCAGGGACCTATAAGGGCCTATGGCTACACCTTC	CASSEAQGPIRAYGYTF	TRBV10-1	TRBJ1-2
TGCGCCAGCAGCTTCGGACGATTTGGCTATGGCTACACCTTC	CASSFGRFGYGYTF	TRBV5-1	TRBJ1-2
TGTGCCAGCAGCTTAGACTCCGCGGGGGATGAGCAGTTCTTC	CASSLDSAGDEQFF	TRBV7-8	TRBJ2-1
TGTGCCAGCAGCCGGGTTATGGGGGGCTCCTACGAGCAGTACTTC	CASSRVMGGSYEQYF	TRBV6-5	TRBJ2-7
TGTGCCATCAGGGCAGCCTCCCCGGTGGACACAGATACGCAGTATTTT	CAIRAASPVDTDTQYF	TRBV10-3	TRBJ2-3
TGCACCGCCCCGCGGGGGGGTTCCTACGAGCAGTACTTC	CTAPRGGSYEQYF	TRBV20-1	TRBJ2-7
TGTGCCACGGTTGAAACCGGGACTAGCAGGGCCTCCTACGAGCAGTACTTC	CATVETGTSRASYEQYF	TRBV24-1	TRBJ2-7
TGTGCCATCAGCGTGATTACTAGCGGGAGCAATCAGCCCCAGCATTTT	CAISVITSGSNQPQHF	TRBV10-3	TRBJ1-5
TGTGCCAGCAGCTGCCCCACCTCGGGACGACTCAATCAGCCCCAGCATTTT	CASSCPTSGRLNQPQHF	TRBV5-4	TRBJ1-5
TGCAGCGTTGGGGATGAACTTAACACTGAAGCTTTCTTT	CSVGDELNTEAFF	TRBV29-1	TRBJ1-1
TGCAGTGCGGTAAGGGGTTATATTCAGCCCCAGCATTTT	CSAVRGYIQPQHF	TRBV20-1	TRBJ1-5
TGTGCCAGCCCCCTCAGCTCTGGGGCCAACGTCCTGACTTTC	CASPLSSGANVLTF	TRBV6-4	TRBJ2-6
TGTGCCAGCAGCTCACCTCCCGACTATGGCTACACCTTC	CASSSPPDYGYTF	TRBV13	TRBJ1-2
TGTGCCAGCAGCCAAGAACGGGGGGGCCCGGGGCTCTTC	CASSQERGGPGLF	TRBV4-2	TRBJ2-1
TGTGCCAGCAGGGTGGCCGGCCGGCGGGGTTACGTAGTTTGGGACAGGTACTTC	CASRVAGRRGYVVWDRYF	TRBV6-4	TRBJ2-4
TGTGCCAGCAGAATTCGCTGGGCTGAGCAGTTCTTC	CASRIRWAEQFF	TRBV27	TRBJ2-1
TGTGCCAGCAGCCAAGCACCCGTTGGACGTAGGGTGGACGAGCAGTACTTC	CASSQAPVGRRVDEQYF	TRBV14	TRBJ2-7
TGTGCCAGCTCACCCTTTTGCGACAGTTGCAACACCGGGGAGCTGTTTTTT	CASSPFCDSCNTGELFF	TRBV18	TRBJ2-2
TGTGCCAGCAGTCCCCAGACCAAGAACACTGAAGCTTTCTTT	CASSPQTKNTEAFF	TRBV6-1	TRBJ1-1
TGTGCCAGTAGTATGTTTAAAAGAGTCTTGGAGGAATGGACGGAAGGAGATACGCAGTATTTT	CASSMFKRVLEEWTEGDTQYF	TRBV19	TRBJ2-3
TGTGCCAGCAGCCCGCCCCCCCGTGACCGCCCAGGACAGGAGGGCGAGCAGTACTTC	CASSPPPRDRPGQEGEQYF	TRBV3-1	TRBJ2-7
TGCGCCAGCAGCCAAGTATCTACCCAGCCTAGCGGGGAGCTGTTTTTT	CASSQVSTQPSGELFF	TRBV4-1	TRBJ2-2
TGTGCCAGCGTTTCAGGACTAGCGGGGGGGGAAAACAATGAGCAGTTCTTC	CASVSGLAGGENNEQFF	TRBV25-1	TRBJ2-1
TGTGCCAGCAGTGTTCCAACTAACGATCAGGGCCACAACGAGCAGTACTTC	CASSVPTNDQGHNEQYF	TRBV6-4	TRBJ2-7
TGTGCCAGCAGCTCCCCCCGCGGACAGGGCTCCGGGTCTCTCGGCGGGGAGCTGTTTTTT	CASSSPRGQGSGSLGGELFF	TRBV12-3	TRBJ2-2
TGTGCCAGCAGCCCGGACAGGGGACCCTACGAGCAGTACTTC	CASSPDRGPYEQYF	TRBV6-2	TRBJ2-7
TGTGCCAGCAGCGGGGGGGGGGAGGCATATGAGCAGTTCTTC	CASSGGGEAYEQFF	TRBV6-6	TRBJ2-1
TGTGCCAGCATGGGGGGCCCTAATTCACCCCTCCACTTT	CASMGGPNSPLHF	TRBV6-3	TRBJ1-6
TGTGCCAGCAGCTTACTTACAAGGGTAGCGGGTTTTGGGTGTGGGGGGGAGACCCAGTACTTC	CASSLLTRVAGFGCGGETQYF	TRBV7-3	TRBJ2-5
TGCAGCGCACTGGGGGCCAATGAGCAGTTCTTC	CSALGANEQFF	TRBV29-1	TRBJ2-1
TGCGCCAGCAGTGAGCCCAGGGCACCACCCTACGAGCAGTACTTC	CASSEPRAPPYEQYF	TRBV10-1	TRBJ2-7
TGCGCCAGCAGCTTGCGATTGCGAGGATTTGAGACCCAGTACTTC	CASSLRLRGFETQYF	TRBV5-1	TRBJ2-5
TGTGCCAGCAGCTGCGGGGGGCCGGACTACGAGCAGTACTTC	CASSCGGPDYEQYF	TRBV7-8	TRBJ2-7
TGTGCCAGCAGCTTGGCTAGGGGACCCTACGAGCAGTACTTC	CASSLARGPYEQYF	TRBV5-5	TRBJ2-7
TGTGCCAGCAGCTTAACAGGACAGGGGGATAATTCACCCCTCCACTTT	CASSLTGQGDNSPLHF	TRBV7-3	TRBJ1-6
TGTGCCAGCAGCTTGTCGGGGTCCTACGAGCAGTACTTC	CASSLSGSYEQYF	TRBV7-9	TRBJ2-7
TGTGCCACCAGTGATTTGGCTGGCTCAAGAGACAATGAGCAGTTCTTC	CATSDLAGSRDNEQFF	TRBV24-1	TRBJ2-1
TGTGCCATCAGTGAGTCGACGGGAGTCAGGGGGCACTACGAGCAGTACTTC	CAISESTGVRGHYEQYF	TRBV10-3	TRBJ2-7
TGTGCCAGCTCCCCTAGGACTAGCGGGGCCGAGCAGTACTTC	CASSPRTSGAEQYF	TRBV18	TRBJ2-7
TGCAGTGCTAAGGACAGGCCTGCCTACGAGCAGTACTTC	CSAKDRPAYEQYF	TRBV20-1	TRBJ2-7
TGTGCCAGCCCCACAGGCGGCGGGACAGCGAACTATGGCTACACCTTC	CASPTGGGTANYGYTF	TRBV27	TRBJ1-2
TGTGCCAGCAGTCGGACCTTCAGGGTGGTCGAGCAGTACTTC	CASSRTFRVVEQYF	TRBV2	TRBJ2-7
TGTGCCAGCAGCCGCCGCCCCCCAGGGGGGGGGACTAATGAAAAACTGTTTTTT	CASSRRPPGGGTNEKLFF	TRBV9	TRBJ1-4
TGTGCCAGCATTCCACTTGACTCGAAAAGGGGAGGGTGGTATGAGAAAGATACGCAGTATTTT	CASIPLDSKRGGWYEKDTQYF	TRBV2	TRBJ2-3
TGTGCCAGCAGCTTTCTGAGCAGGGGCCCTGGCTATGGCTACACCTTC	CASSFLSRGPGYGYTF	TRBV7-7	TRBJ1-2
TGTGCCATCAGTGATCCCGCGGACAGGGGGGTCCAAGAGACCCAGTACTTC	CAISDPADRGVQETQYF	TRBV10-3	TRBJ2-5
TGTGCCAGCAGTGAAGAAAGGGAGTGCTACGAGCAGTACTTC	CASSEERECYEQYF	TRBV2	TRBJ2-7
TGTGCCAGCAGCGCCGGGAGGGAAAAGGGTTACGAGCAGTACTTC	CASSAGREKGYEQYF	TRBV9	TRBJ2-7
TGTGCCAGCACACTAGCGGGAGGAATGAGGTCACCCCTCCACTTT	CASTLAGGMRSPLHF	TRBV12-3	TRBJ1-6
TGCGCCAGCAGCCGGGGGCTAGCGGGTGGCATTCAGTACTTC	CASSRGLAGGIQYF	TRBV4-1	TRBJ2-4
TGTGCCAGCAGTTCGCCGGGGGACAGGCCAGACTATGGCTACACCTTC	CASSSPGDRPDYGYTF	TRBV12-3	TRBJ1-2
TGTGCCAGCAGCGGAACAGGACTCGGGCAGCCCCAGCATTTT	CASSGTGLGQPQHF	TRBV9	TRBJ1-5
TGTGCCACCAGTGATTCGGCGGGGGAAAAAGATACGCAGTATTTT	CATSDSAGEKDTQYF	TRBV24-1	TRBJ2-3
TGTGCCAGCAGCTTAGACAGGGTCATAGGCACAGATACGCAGTATTTT	CASSLDRVIGTDTQYF	TRBV7-9	TRBJ2-3
TGTGCCAGCAGTGACCAGTCCCAGGAAGACATCTCTGGGGCCAACGTCCTGACTTTC	CASSDQSQEDISGANVLTF	TRBV6-4	TRBJ2-6
TGTGCCAGCATGTACCATTATCCGACAGGACTATATAGCAATCAGCCCCAGCATTTT	CASMYHYPTGLYSNQPQHF	TRBV11-3	TRBJ1-5
TGTGCCAGCAGTCCGAAACTAGCGGGTGCCACAGATACGCAGTATTTT	CASSPKLAGATDTQYF	TRBV12-3	TRBJ2-3
TGTGCCACCAGTGTGGATAGGGCCCACAATCAGCCCCAGCATTTT	CATSVDRAHNQPQHF	TRBV24-1	TRBJ1-5
TGCAGTGCTCACCTGGGGGGAGGGCGCACAGATACGCAGTATTTT	CSAHLGGGRTDTQYF	TRBV20-1	TRBJ2-3
TGTGCCAGCAGCCAAGATCCAGGGGGCGCAGCCAAAAACATTCAGTACTTC	CASSQDPGGAAKNIQYF	TRBV14	TRBJ2-4
TGCGCCAGCAGCCGCCCCGTCCGGGACCCCTCTGATACTCAGCCCCAGCATTTT	CASSRPVRDPSDTQPQHF	TRBV4-3	TRBJ1-5
TGTGCCAGTAGTATGCGGGACAGGGAGACTTATAGCAATCAGCCCCAGCATTTT	CASSMRDRETYSNQPQHF	TRBV19	TRBJ1-5
TGCAGTGCGGGCCTCTCGGACGGGGGTGCAACTAATGAAAAACTGTTTTTT	CSAGLSDGGATNEKLFF	TRBV20-1	TRBJ1-4
TGTGCCAGCAGCAACTCTTCGAGGGATATGGGGGGGCCTTCACCCCTCCACTTT	CASSNSSRDMGGPSPLHF	TRBV13	TRBJ1-6
TGCAGCGTTGATTGTGTAGGGGGCAGTTCCACTGAAGCTTTCTTT	CSVDCVGGSSTEAFF	TRBV29-1	TRBJ1-1
TGCAGTGCTGAGCGGGCGGCGATCGAGCAGTACTTC	CSAERAAIEQYF	TRBV20-1	TRBJ2-7
TGTGCCAGCAGCTTAGATCAACCCGGCGTAAACTATGGCTACACCTTC	CASSLDQPGVNYGYTF	TRBV11-2	TRBJ1-2
TGTGCCAGCAGCCAGGAGTGCCGGGACAGGAATAATAGCAATCAGCCCCAGCATTTT	CASSQECRDRNNSNQPQHF	TRBV13	TRBJ1-5
TGTGCCAGCAGTGAGTCAGCCGGGCCAGGGTTGGAAGCTTTCTTT	CASSESAGPGLEAFF	TRBV6-2	TRBJ1-1
TGTGCCAGTAGTATAGAGCACTGTAATACCCCCCCATCGCTAGCGGGCAGCCCGTCCAAGCAGTTCTTC	CASSIEHCNTPPSLAGSPSKQFF	TRBV19	TRBJ2-1
TGCAGTGCTAAGGGAACTAATGAAAAACTGTTTTTT	CSAKGTNEKLFF	TRBV20-1	TRBJ1-4
TGCGCCAGCAGCTTGTGGGGCTCAGAAAAACTGTTTTTT	CASSLWGSEKLFF	TRBV5-1	TRBJ1-4
TGCGCCAGCAGCGTTACAGGGAATTATTTCCCTAACTATGGCTACACCTTC	CASSVTGNYFPNYGYTF	TRBV5-1	TRBJ1-2
TGTGCCAGCAGCCGCTGCGGCCCTGGGGCCGGGGAGCTGTTTTTT	CASSRCGPGAGELFF	TRBV7-9	TRBJ2-2
TGTGCCAGCACCACCCGTAGGGATGAGCAGTTCTTC	CASTTRRDEQFF	TRBV6-2	TRBJ2-1
TGTGCCAGAGGGGGGGAACCCTATAATTCACCCCTCCACTTT	CARGGEPYNSPLHF	TRBV6-1	TRBJ1-6
TGTGCCTGGAGTACGCCGGGACTAGCGGGACTTTACAATGAGCAGTTCTTC	CAWSTPGLAGLYNEQFF	TRBV30	TRBJ2-1
TGTGCCTGGGAGTGTATTGGAAGGCGTGGGCCCTACAATGAGCAGTTCTTC	CAWECIGRRGPYNEQFF	TRBV30	TRBJ2-1
TGCGCCAGCAGCCGGGCCACAGGGACTGAAGCTTTCTTT	CASSRATGTEAFF	TRBV4-1	TRBJ1-1
TGTGCCAGCACTGACCTGGGACAATACGAGCAGTACTTC	CASTDLGQYEQYF	TRBV7-3	TRBJ2-7
TGCGCCAGCAGCTTGCAGGGCTTTAGCACAGATACGCAGTATTTT	CASSLQGFSTDTQYF	TRBV5-1	TRBJ2-3
TGTGCCAGCAGTTTAAAGGACCCTTCCACCAAACGCTATCAGCCCCAGCATTTT	CASSLKDPSTKRYQPQHF	TRBV27	TRBJ1-5
TGTGCCAGCGCCGGGACATATTCCTACGAGCAGTACTTC	CASAGTYSYEQYF	TRBV7-9	TRBJ2-7
TGTGCCAGCAGAGCCAACGGCCGGGACAATGGCTACACCTTC	CASRANGRDNGYTF	TRBV6-1	TRBJ1-2
TGTGCCAGCAGCTCCTATTCGGGACTAGCGGGGGTAGAGACCCAGTACTTC	CASSSYSGLAGVETQYF	TRBV7-3	TRBJ2-5
TGTGCCAGCAGCGCCAGGGGGCCCCAGCATTTT	CASSARGPQHF	TRBV9	TRBJ1-5
TGTGCCAGCAGTGAACAGGCTGACTACGAGCAGTACTTC	CASSEQADYEQYF	TRBV6-4	TRBJ2-7
TGTGCCAGCAGCCGGGGGGCCCAGGAAGAGCAGTACTTC	CASSRGAQEEQYF	TRBV7-3	TRBJ2-7
TGCGCCAGCAGCAGCTTAGCGGGAGGGGTCTACGAGCAGTACTTC	CASSSLAGGVYEQYF	TRBV5-1	TRBJ2-7
TGTGCCAGCTCACCGGGGGATTACGAGCAGTACTTC	CASSPGDYEQYF	TRBV18	TRBJ2-7
TGCAGCGTTGAAGAGACGGACCGCTTCACTGAAGCTTTCTTT	CSVEETDRFTEAFF	TRBV29-1	TRBJ1-1
TGTGCCAGTAGCCGGGACAGGGACTCGAACACCGGGGAGCTGTTTTTT	CASSRDRDSNTGELFF	TRBV28	TRBJ2-2
TGTGCCAGCAGCTGGTTAATGGATGAGACTAGGGTCTTCACTGAAGCTTTCTTT	CASSWLMDETRVFTEAFF	TRBV5-6	TRBJ1-1
TGCAGTGCCTCGGCAGGATGGTACGAGCAGTACTTC	CSASAGWYEQYF	TRBV20-1	TRBJ2-7
TGTGCCAGCAGCCCTGCCACAGATACGCAGTATTTT	CASSPATDTQYF	TRBV7-3	TRBJ2-3
TGCAGTGCGACACTCAGGGGGCAAGCCAAAAACATTCAGTACTTC	CSATLRGQAKNIQYF	TRBV20-1	TRBJ2-4
TGTGCCAGCAGCTTACGACCCAGGGGAAGGGAGAACACTGAAGCTTTCTTT	CASSLRPRGRENTEAFF	TRBV7-9	TRBJ1-1
TGTGCCACCAGTGATTGCCTATTATTCCGCACCGGGGAGCTGTTTTTT	CATSDCLLFRTGELFF	TRBV24-1	TRBJ2-2
TGTGCCAGCAGCTTGGGAGGGGGGACAAACATTCAGTACTTC	CASSLGGGTNIQYF	TRBV5-4	TRBJ2-4
TGCGCCAGCAGCTTGGGTTACGGCCAAGGGGGTGGCGGTGACTATGGCTACACCTTC	CASSLGYGQGGGGDYGYTF	TRBV10-1	TRBJ1-2
TGTGCCAGCTCCCTACCAGGGACAGGGCGGTACTCTGGAAACACCATATATTTT	CASSLPGTGRYSGNTIYF	TRBV7-3	TRBJ1-3
TGTGCCAGCACCCGCCCCCCGCAGGGGCAGTCTGGGGCCAACGTCCTGACTTTC	CASTRPPQGQSGANVLTF	TRBV25-1	TRBJ2-6
TGTGCCAGCAGTGAAAGCAGGGGTTACTATGGCTACACCTTC	CASSESRGYYGYTF	TRBV25-1	TRBJ1-2
TGTGCCAGCAGCTTTCACTCGGTCTGGGCCCCCCCCTGCAATCAGCCCCAGCATTTT	CASSFHSVWAPPCNQPQHF	TRBV7-9	TRBJ1-5
TGTGCCTGGACCGGGATCGTGGGACAGCTGCAAGAGACCCAGTACTTC	CAWTGIVGQLQETQYF	TRBV30	TRBJ2-5
TGTGCCAGATCTGAAAGGGGACGCGAGCAGTACTTC	CARSERGREQYF	TRBV7-8	TRBJ2-7
TGTGCCAGCAGCGGCGGGAGTAGCAATCAGCCCCAGCATTTT	CASSGGSSNQPQHF	TRBV7-4	TRBJ1-5
TGTGCCAGCAGCTCCAATTGCAAGGGACAGGGGAGGGTTTACAATGAGCAGTTCTTC	CASSSNCKGQGRVYNEQFF	TRBV7-8	TRBJ2-1
TGTGCCAGCAGCTTGGGCAAAACATGGACAGGGGGCGTTCGAGAGACCCAGTACTTC	CASSLGKTWTGGVRETQYF	TRBV7-9	TRBJ2-5
TGTGCCAGCAGCGTAGCGTTCCCCGGGGGGGCCTCCTACAATGAGCAGTTCTTC	CASSVAFPGGASYNEQFF	TRBV9	TRBJ2-1
TGTGCCACCGATGACCAAAGCTCCTACGAGCAGTACTTC	CATDDQSSYEQYF	TRBV24-1	TRBJ2-7
TGTGCCAGCAGTTACCTTCACGGGAGGGTAAGTAAGTTTTTTCTTGAGACCCAGTACTTC	CASSYLHGRVSKFFLETQYF	TRBV6-5	TRBJ2-5
TGTGCCAGCAGCCAAGTAGCGTACAATGAGCAGTTCTTC	CASSQVAYNEQFF	TRBV3-1	TRBJ2-1
TGCGCCCCGGGACTAGCGGGAAGAGATGAGCAGTTCTTC	CAPGLAGRDEQFF	TRBV5-1	TRBJ2-1
TGTGCCAGCAGTGAATGGGTTAGCGGGTGGAGGACAGATACGCAGTATTTT	CASSEWVSGWRTDTQYF	TRBV25-1	TRBJ2-3
TGTGCCAGCAGTGACCCGACAGAGGGAAGAAAGATCGGCTATGGCTACACCTTC	CASSDPTEGRKIGYGYTF	TRBV6-1	TRBJ1-2
TGTGCCAGCAGCCCAGGGTTTAACTATGGCTACACCTTC	CASSPGFNYGYTF	TRBV11-2	TRBJ1-2
TGTGCCAGCATTACAGGGGGCACCAATCAGCCCCAGCATTTT	CASITGGTNQPQHF	TRBV27	TRBJ1-5
TGCGCCCAAAACGAGAGACAGGGACGGCTAGAGACCCAGTACTTC	CAQNERQGRLETQYF	TRBV4-1	TRBJ2-5
TGTGCCAGCAGTTTACGAGGGACAGGGGGCTTGGATGGCTACACCTTC	CASSLRGTGGLDGYTF	TRBV27	TRBJ1-2
TGTGCCAAGACACCGGGGTTTAATGAGCAGTTCTTC	CAKTPGFNEQFF	TRBV27	TRBJ2-1
TGTGCTAGTTACCCCCCAGCGGACAGGTATACGCAGTATTTT	CASYPPADRYTQYF	TRBV12-5	TRBJ2-3
TGTGCCAGCAGCTTAGCTGGGAGTTGCACGATCGATTATGAGACCCAGTACTTC	CASSLAGSCTIDYETQYF	TRBV7-9	TRBJ2-5
TGTGCCAGCAGTGAGACTCAGGACAGTATAACCGCCAAAAACATTCAGTACTTC	CASSETQDSITAKNIQYF	TRBV6-4	TRBJ2-4
TGCAGTGCCCAGGGGACAGCAGGGGCAACTAATGAAAAACTGTTTTTT	CSAQGTAGATNEKLFF	TRBV20-1	TRBJ1-4
TGTGCCAGCAGTTCCTTCCACCGGACAGCTAGTTCTAGCACAGATACGCAGTATTTT	CASSSFHRTASSSTDTQYF	TRBV6-5	TRBJ2-3
TGTGCCAGCAGCTTACACGGGAATCGGAACACTGAAGCTTTCTTT	CASSLHGNRNTEAFF	TRBV11-3	TRBJ1-1
TGTGCCAGCTCGAAGGGGAGGGGGCATTATAGCAATCAGCCCCAGCATTTT	CASSKGRGHYSNQPQHF	TRBV18	TRBJ1-5
TGTGCCAGCAGTGAGGACAGGGCGGCTGAGTACTTC	CASSEDRAAEYF	TRBV28	TRBJ2-7
TGTGCCAGCAGCTTCCGGGGGGGGCCAATGCCTGCCAAAAACATTCAGTACTTC	CASSFRGGPMPAKNIQYF	TRBV5-4	TRBJ2-4
TGTGCCAGGTCGGATAACGGGAACACTGAAGCTTTCTTT	CARSDNGNTEAFF	TRBV6-4	TRBJ1-1
TGCGCCAGCAGGCGGACGGGGACGCCAGATACGCAGTATTTT	CASRRTGTPDTQYF	TRBV10-1	TRBJ2-3
TGTGCCAGTAGTATAGGCATGACAGGTTGCGTTGGCTACACCTTC	CASSIGMTGCVGYTF	TRBV19	TRBJ1-2
TGTGCCAGCCGAAAGGATAACTATGGCTACACCTTC	CASRKDNYGYTF	TRBV9	TRBJ1-2
TGCAGTGCTACAGCGGCCGGACAGGTAGGGGCCGAGCAGTACTTC	CSATAAGQVGAEQYF	TRBV20-1	TRBJ2-7
TGCGCCAGGTTACTAGCGGGGGCCAAAAACATTCAGTACTTC	CARLLAGAKNIQYF	TRBV10-1	TRBJ2-4
TGTGCCAGCAGCTTAGTCCCCAACAGGGTTAGCCCCACAGATACGCAGTATTTT	CASSLVPNRVSPTDTQYF	TRBV7-6	TRBJ2-3
TGTGCCAGCAGTGATCACAGGACAGATACGCAGTATTTT	CASSDHRTDTQYF	TRBV25-1	TRBJ2-3
TGTGCCAGCAGTCGAGGCCCCCAAGAGACCCAGTACTTC	CASSRGPQETQYF	TRBV12-3	TRBJ2-5
TGTGCCAGCCCCCCCCGGGACAAGCCCTACGAGCAGTACTTC	CASPPRDKPYEQYF	TRBV4-2	TRBJ2-7
TGTGCCAGCACACGAGGGGGTCAAACAACCTACGAGCAGTACTTC	CASTRGGQTTYEQYF	TRBV6-5	TRBJ2-7
TGTGCCAGCTCAGGGCCTCAGGGCACTGGAAACACCATATATTTT	CASSGPQGTGNTIYF	TRBV6-4	TRBJ1-3
TGTGCCAGCAGCGCCCATCCGGAGGAAACTAATGAAAAACTGTTTTTT	CASSAHPEETNEKLFF	TRBV13	TRBJ1-4
TGTGCCAGCAGTGCCCGAGGAGGCTACACCTTC	CASSARGGYTF	TRBV2	TRBJ1-2
TGTGCCAGCAGGATTCGGGCCCTGCATGAGCAGTTCTTC	CASRIRALHEQFF	TRBV6-8	TRBJ2-1
TGTGCCAGCAGCTTGGTATCTGGACTAGGTAAAAGCTCCTACAATGAGCAGTTCTTC	CASSLVSGLGKSSYNEQFF	TRBV5-8	TRBJ2-1
TGTGCCAGCAGCCAAGACTCACGGCGGGGTAGTTTGAACTATGGCTACACCTTC	CASSQDSRRGSLNYGYTF	TRBV14	TRBJ1-2
TGTGCCAGCAGCACAGGACAGAACGAACAAGAGACCCAGTACTTC	CASSTGQNEQETQYF	TRBV9	TRBJ2-5
TGTGCCAGTACGGGGGGATCGCTTAGCAATCAGCCCCAGCATTTT	CASTGGSLSNQPQHF	TRBV19	TRBJ1-5
TGTGCCAGCAGCCTCAGACGCTCTAACTATGGCTACACCTTC	CASSLRRSNYGYTF	TRBV7-3	TRBJ1-2
TGCAGTGCTAGACAAAGGGGGGACGAGCAGTACTTC	CSARQRGDEQYF	TRBV20-1	TRBJ2-7
TGTGCCAGCAGGTATCGGTTTACGGGAAGCACGCAGTATTTT	CASRYRFTGSTQYF	TRBV6-3	TRBJ2-3
TGTGCCAGCAGCAAAGCCCCCGGGGGGACTCAGCCCCAGCATTTT	CASSKAPGGTQPQHF	TRBV28	TRBJ1-5
TGTGCCAGCAGCTCAAACGACAAGGATGGCTACACCTTC	CASSSNDKDGYTF	TRBV7-4	TRBJ1-2
TGCGCCAGCACCGCGACAGGGAATGAAAAACTGTTTTTT	CASTATGNEKLFF	TRBV10-1	TRBJ1-4
TGTGCCAGCAGCTATGGGGGTCCACGCTATGGCTACACCTTC	CASSYGGPRYGYTF	TRBV5-5	TRBJ1-2
TGCAGTGCAAATAAATACTCCCGGACGGAAGAGACCCAGTACTTC	CSANKYSRTEETQYF	TRBV20-1	TRBJ2-5
TGCGCCAGCAGTTGGGGGAACAGGGGAATCAATCAGCCCCAGCATTTT	CASSWGNRGINQPQHF	TRBV5-1	TRBJ1-5
TGTGCCAGCAGCCGGGGCCCTCGCACTGAAGCTTTCTTT	CASSRGPRTEAFF	TRBV14	TRBJ1-1
TGTGCCAGCCATAAGATAGGGCCGGAAAGCTCCTACAATGAGCAGTTCTTC	CASHKIGPESSYNEQFF	TRBV28	TRBJ2-1
TGTGCCACCAGCAGCTCGGGACAGGGGTTGAACACCGGGGAGCTGTTTTTT	CATSSSGQGLNTGELFF	TRBV15	TRBJ2-2
TGCAGTGCTTGGCTCCAGCTGTTGGCCAAAAACATTCAGTACTTC	CSAWLQLLAKNIQYF	TRBV20-1	TRBJ2-4
TGCAGTGCTACAGGTAGTGGGGGGGGGTATGAGCAGTTCTTC	CSATGSGGGYEQFF	TRBV20-1	TRBJ2-1
TGTGCCAGCAGCCTCCCCCTAACAGGGTTCGAGACCCAGTACTTC	CASSLPLTGFETQYF	TRBV5-4	TRBJ2-5
TGTGCCTGGAGTGGATTAATTTTCCTGACAGGGAACGAGGATGGCTACACCTTC	CAWSGLIFLTGNEDGYTF	TRBV30	TRBJ1-2
TGTGCCAGCTCTCTCCCTAGTGGGCAAGAGACCCAGTACTTC	CASSLPSGQETQYF	TRBV7-2	TRBJ2-5
TGTGCCAGCAGCTTGGCTCGAGACAGGAGGTTTGGAGAGACCCAGTACTTC	CASSLARDRRFGETQYF	TRBV5-5	TRBJ2-5
TGTGCCAGCAGTTTACTCGACAGGGGTCTTGAGCAGTTCTTC	CASSLLDRGLEQFF	TRBV28	TRBJ2-1
TGCAGTGCTAGCCGACCCGGGGTGACCTACGAGCAGTACTTC	CSASRPGVTYEQYF	TRBV20-1	TRBJ2-7
TGCAGTGCTAGAGATGGGTGCTCGACAGTTGTCGGAACGAACTATGGCTACACCTTC	CSARDGCSTVVGTNYGYTF	TRBV20-1	TRBJ1-2
TGTGCCAGCAGCTCCAGGGGAGAGGATGGCTACACCTTC	CASSSRGEDGYTF	TRBV6-4	TRBJ1-2
TGTGCCAGCAGCCGGACAGGGCCTGAGCAGTACTTC	CASSRTGPEQYF	TRBV14	TRBJ2-7
TGTGCCAGCAGTTTTCAAGTGGAGACTAGCGGCCGCTACGAGCAGTACTTC	CASSFQVETSGRYEQYF	TRBV12-4	TRBJ2-7
TGTGCCTGGAGTGTACGTCTCCCGAATCTGGAAGAAACAGGATCAGATACGCAGTATTTT	CAWSVRLPNLEETGSDTQYF	TRBV30	TRBJ2-3
TGTGCCTGGAAGAGGGGCTCCTACGAGCAGTACTTC	CAWKRGSYEQYF	TRBV30	TRBJ2-7
TGTGCCAGCAGCCAGGACAGGGGGTCCTACAATGAGCAGTTCTTC	CASSQDRGSYNEQFF	TRBV14	TRBJ2-1
TGTGCCAGCAGCCAAGATCGGAGAGTCGCATGGCATCAGCCCCAGCATTTT	CASSQDRRVAWHQPQHF	TRBV14	TRBJ1-5
TGCAGCGTTGGAAGCAGACGTTTCACAGATACGCAGTATTTT	CSVGSRRFTDTQYF	TRBV29-1	TRBJ2-3
TGCGCCAGCAGCCAAGACCGGGTTGGGAACGAGCAGTACTTC	CASSQDRVGNEQYF	TRBV4-1	TRBJ2-7
TGTGCCAGCAGCTTAGGTGGGACAGGGGGAGGCTCCTATAATTCACCCCTCCACTTT	CASSLGGTGGGSYNSPLHF	TRBV11-3	TRBJ1-6
TGCAGTGCTAGAGATTTCCCGACAGGGGGGAGCAATCAGCCCCAGCATTTT	CSARDFPTGGSNQPQHF	TRBV20-1	TRBJ1-5
TGTGCCAGCAGCCCAAATGGGAGGTACGCCTACGAGCAGTACTTC	CASSPNGRYAYEQYF	TRBV7-3	TRBJ2-7
TGTGCCAGCAGCAGACAGGGTAGGAACACTGAAGCTTTCTTT	CASSRQGRNTEAFF	TRBV14	TRBJ1-1
TGTGCCATGTGGCAGGGACAGGGACATCAGCCCCAGCATTTT	CAMWQGQGHQPQHF	TRBV6-3	TRBJ1-5
TGCGCCAGCAGCCCTGACCAGATCTATGGCTACACCTTC	CASSPDQIYGYTF	TRBV4-1	TRBJ1-2
TGTGCCAGCAAGGAGGAGGGGCAGCCCCAGCATTTT	CASKEEGQPQHF	TRBV25-1	TRBJ1-5
TGTGCCACCAGCGGAACTAGCGGGGGGTACAATGAGCAGTTCTTC	CATSGTSGGYNEQFF	TRBV15	TRBJ2-1
TGTGCCAGCAGTTTATCGACCGTGGCCTCCTACGAGCAGTACTTC	CASSLSTVASYEQYF	TRBV27	TRBJ2-7
TGTGCTAAGACGGGGCCTGTCGGCTCCTACAATGAGCAGTTCTTC	CAKTGPVGSYNEQFF	TRBV27	TRBJ2-1
TGTGCCAAAACCACAGCCGGACTGTTTTTT	CAKTTAGLFF	TRBV6-6	TRBJ1-4
TGTGCCAGCAAAGGCCCCCTGACAGGGGATGGCTACACCTTC	CASKGPLTGDGYTF	TRBV27	TRBJ1-2
TGTGCCACCAGGGGGCGGTTGGTCTATGGCTACACCTTC	CATRGRLVYGYTF	TRBV15	TRBJ1-2
TGTGCCAGCAGCAAGCCAGGGAGGGGGGGAAACATTCAGTACTTC	CASSKPGRGGNIQYF	TRBV9	TRBJ2-4
TGTGCCAGCAGCACACCATCCTTAGGACTCGTCTCCTACAATGAGCAGTTCTTC	CASSTPSLGLVSYNEQFF	TRBV7-4	TRBJ2-1
TGTGCCCCTATTTTGCAGCCCCCCGGGGAGCTGTTTTTT	CAPILQPPGELFF	TRBV18	TRBJ2-2
TGCGCCAGCAGCCTCCGGACAGTGGTCAACACTGAAGCTTTCTTT	CASSLRTVVNTEAFF	TRBV5-1	TRBJ1-1
TGCGCCAGCGGGAACCTTCGGGGCTATGGCTACACCTTC	CASGNLRGYGYTF	TRBV5-1	TRBJ1-2
TGTGCCAGCAGCTTGGGGTGGACAGGGCGCCTCCAAGAGACCCAGTACTTC	CASSLGWTGRLQETQYF	TRBV5-8	TRBJ2-5
TGTGCCAGCAGTTACGTGAGGACAACGAGGAACACTGAAGCTTTCTTT	CASSYVRTTRNTEAFF	TRBV6-5	TRBJ1-1
TGTGCCAGCAGCTTAGTCGGAGGGAGCCCTGAGACCCAGTACTTC	CASSLVGGSPETQYF	TRBV11-3	TRBJ2-5
TGCAGTGCTAGGGAATTTTCTGGAAGCTCCTACGAGCAGTACTTC	CSAREFSGSSYEQYF	TRBV20-1	TRBJ2-7
TGTGCCATCCACGGTGGACTGACTCGTGGAAACACCATATATTTT	CAIHGGLTRGNTIYF	TRBV10-3	TRBJ1-3
TGTGCTAGTGGTTTGCTCGAGGGGACTCGGGATGCCTACAATGAGCAGTTCTTC	CASGLLEGTRDAYNEQFF	TRBV12-5	TRBJ2-1
TGTGCCAGCAGTGAAGCGGGACAGGGTACCTACGAGCAGTACTTC	CASSEAGQGTYEQYF	TRBV6-1	TRBJ2-7
TGCGCCAGCAGCCGAGGGCGGGAGAACACTGAAGCTTTCTTT	CASSRGRENTEAFF	TRBV5-1	TRBJ1-1
TGTGCCAGCAGTGAGGGCCCTGAAGCTTTCTTT	CASSEGPEAFF	TRBV13	TRBJ1-1
TGTGCCAGCAGTGAACCTACAGGGGGGACTTTGAATGGCTACACCTTC	CASSEPTGGTLNGYTF	TRBV25-1	TRBJ1-2
TGTGCCAGCAGCTTCAGATACTTAGGGAATGAGCAGTTCTTC	CASSFRYLGNEQFF	TRBV5-8	TRBJ2-1
TGTGCCAGCAGGGTGATTATGCGGGAGGAGGGAGATACGCAGTATTTT	CASRVIMREEGDTQYF	TRBV6-1	TRBJ2-3
TGTGCCAGTCGTAGACGGGCACCGATTCACGAGCAGTACTTC	CASRRRAPIHEQYF	TRBV19	TRBJ2-7
TGCAGAAGGGGCCCAAACACTGAAGCTTTCTTT	CRRGPNTEAFF	TRBV20-1	TRBJ1-1
TGTGCCAGCAGTGCGGGACACACCGGGGAGCTGTTTTTT	CASSAGHTGELFF	TRBV6-1	TRBJ2-2
TGTGCCAGCAGCCCGTTCCCCGGGACTAGCGGGAGGGGAAACACCATATATTTT	CASSPFPGTSGRGNTIYF	TRBV7-9	TRBJ1-3
TGTGCCAGCAGCAGGCGACACTCCTGTTGGCCCATCTACGAGCAGTACTTC	CASSRRHSCWPIYEQYF	TRBV13	TRBJ2-7
TGCAGCGTTGAGCTCCCGGGACAGACCTCTGGAAACACCATATATTTT	CSVELPGQTSGNTIYF	TRBV29-1	TRBJ1-3
TGCGCCAGCAGCACTAATGGGGACGAGCAGTACTTC	CASSTNGDEQYF	TRBV5-1	TRBJ2-7
TGTGCCAGCAGCCATAGCGGACGAGTCAACATTCAGTACTTC	CASSHSGRVNIQYF	TRBV3-1	TRBJ2-4
TGTGCCAGCAGCTACAGGGACGGTCAAGAGACCCAGTACTTC	CASSYRDGQETQYF	TRBV5-6	TRBJ2-5
TGTGCCACCAGCAGTATCTACAGGGGGCGCTGCCGACAGCCCCAGCATTTT	CATSSIYRGRCRQPQHF	TRBV15	TRBJ1-5
TGCGCCAGCAGCGAGCAGCCCTTGAACACCGGGGAGCTGTTTTTT	CASSEQPLNTGELFF	TRBV5-1	TRBJ2-2
TGTGCCAGCAGTCCCGGTCAGCGCGCCCGGCCGACGGCAGATACGCAGTATTTT	CASSPGQRARPTADTQYF	TRBV6-3	TRBJ2-3
TGTGCCACCAGTGACCTAGCCGTGGGGGACACTGAAGCTTTCTTT	CATSDLAVGDTEAFF	TRBV24-1	TRBJ1-1
TGCGCCAGCAGCCACGGAGCTAAGGTCACCGGACGGTGCGGGAGGGAAACCTGGGACGAGCAGTACTTC	CASSHGAKVTGRCGRETWDEQYF	TRBV4-1	TRBJ2-7
TGTGCCAGCCTTCCCGTTAAGTCAGATACGCAGTATTTT	CASLPVKSDTQYF	TRBV27	TRBJ2-3
TGTGCCACCAGTGATCAACCTCCAACCGTTCCCTCCTACAATGAGCAGTTCTTC	CATSDQPPTVPSYNEQFF	TRBV24-1	TRBJ2-1
TGTGCCAGCGCAGGGGGAGGCTACGAGCAGTACTTC	CASAGGGYEQYF	TRBV11-2	TRBJ2-7
TGTGCCAGCAGTGAATACGAAAGACCTAGGACAGGGGTACGACAAGAGACCCAGTACTTC	CASSEYERPRTGVRQETQYF	TRBV25-1	TRBJ2-5
TGTGCCACCATCCGGTCCACTGAAGCTTTCTTT	CATIRSTEAFF	TRBV30	TRBJ1-1
TGTGCCAGCAGCTCGGGAGCGGGAGGGTACGAGCAGTACTTC	CASSSGAGGYEQYF	TRBV13	TRBJ2-7
TGTGCCAGCACTTGCGGGGGGCGTCTCATATATTTT	CASTCGGRLIYF	TRBV27	TRBJ1-3
TGTGCCAGCAGCTTAGGCTTCCGGGACAGGGGGAGCTCCTACAATGAGCAGTTCTTC	CASSLGFRDRGSSYNEQFF	TRBV7-2	TRBJ2-1
TGTGCCAGCAGCCTCCGCGGGTGCCAAGAGACCCAGTACTTC	CASSLRGCQETQYF	TRBV7-2	TRBJ2-5
TGTGCCAGCAGCGTAGATTCGGGACAGGGGATAAGTGAAGCTTTCTTT	CASSVDSGQGISEAFF	TRBV9	TRBJ1-1
TGCGCCAGCAGTGTCTGCAGCGGGACAGAAGAGACCCAGTACTTC	CASSVCSGTEETQYF	TRBV10-1	TRBJ2-5
TGCGCCAGCATGCATTCGCCCCAGCATTTT	CASMHSPQHF	TRBV10-1	TRBJ1-5
TGTGCCAGCAGCACCCCCGGGACTAGTTTTGCGTACAATGAGCAGTTCTTC	CASSTPGTSFAYNEQFF	TRBV11-1	TRBJ2-1
TGCGCCAGCAGCCCCCAGGGTGTCGCGCGGTCTAAAACATCCAATCAGCCCCAGCATTTT	CASSPQGVARSKTSNQPQHF	TRBV5-1	TRBJ1-5
TGCAGCGCACCTAGGGTCCCTAACTATGGCTACACCTTC	CSAPRVPNYGYTF	TRBV29-1	TRBJ1-2
TGTGCCAGCAGTGAAGCGGAGTCGAGATTAAACGGTAATTCACCCCTCCACTTT	CASSEAESRLNGNSPLHF	TRBV6-1	TRBJ1-6
TGTGCCACACGGACAGGGAAGACCTACGAGCAGTACTTC	CATRTGKTYEQYF	TRBV10-3	TRBJ2-7
TGTGCCAGCAGCCAGAACGAGGGCGTAGATACGCAGTATTTT	CASSQNEGVDTQYF	TRBV14	TRBJ2-3
TGTGCCATCAGCCTCAGCCGCCTACTAGCGGGGGCCCCTGACAGATCAGATACGCAGTATTTT	CAISLSRLLAGAPDRSDTQYF	TRBV10-3	TRBJ2-3
TGTGCCCCTAGGCTCCCCTCCTACAATGAGCAGTTCTTC	CAPRLPSYNEQFF	TRBV28	TRBJ2-1
TGTGCCAGCAGCCAAGATAGCTCTTCACCCCTCCACTTT	CASSQDSSSPLHF	TRBV3-1	TRBJ1-6
TGTGCCAGTAGAAGAGCGGGATTGATCTCTGGGGCCAACGTCCTGACTTTC	CASRRAGLISGANVLTF	TRBV19	TRBJ2-6
TGTGCCAGTAGTATAGAGACCCAGTGGAACACCGGGGAGCTGTTTTTT	CASSIETQWNTGELFF	TRBV19	TRBJ2-2
TGTGCCAGCAGCTCTTTCCCGACAGCCTACGAGCAGTACTTC	CASSSFPTAYEQYF	TRBV5-6	TRBJ2-7
TGTGCCAGCAGTTTAACAGGGCCTAGATCCATGAACACTGAAGCTTTCTTT	CASSLTGPRSMNTEAFF	TRBV2	TRBJ1-1
TGCAGTGCCCTTCCGGCGGGACTAGGCCGTGCCTACGAGCAGTACTTC	CSALPAGLGRAYEQYF	TRBV20-1	TRBJ2-7
TGTGCCAGCAGTAGTGGGTACATCCAAGAGACCCAGTACTTC	CASSSGYIQETQYF	TRBV27	TRBJ2-5
TGTGCCAGCAGAATGACAGCTGAAGCTTTCTTT	CASRMTAEAFF	TRBV3-1	TRBJ1-1
TGTGCCACCAGTGACGCGGGAGCAACCGGGGAGCTGTTTTTT	CATSDAGATGELFF	TRBV24-1	TRBJ2-2
TGTGCCAGCACGTTTGACGAAAACATTCAGTACTTC	CASTFDENIQYF	TRBV25-1	TRBJ2-4
TGCGCCAGCCATAAGCCGGGACTAGTGGGATATCAAGAGACCCAGTACTTC	CASHKPGLVGYQETQYF	TRBV10-1	TRBJ2-5
TGCGCCAGCAGCTGCGAGCGCGGGAGTTCGAACACCGGGGAGCTGTTTTTT	CASSCERGSSNTGELFF	TRBV5-1	TRBJ2-2
TGTGCCTGGAGTAACATTAACGAGCAGTACTTC	CAWSNINEQYF	TRBV30	TRBJ2-7
TGTGCCACCAGTGAAAAACGGGACACAGATACGCAGTATTTT	CATSEKRDTDTQYF	TRBV24-1	TRBJ2-3
TGCGCCAGCAGCTTCCACAGGGTGGGGGACGAGCAGTACTTC	CASSFHRVGDEQYF	TRBV5-1	TRBJ2-7
TGTGCCATAAGAGGTAGGGCTGGCTACACCTTC	CAIRGRAGYTF	TRBV6-6	TRBJ1-2
TGTGCCAGTAGTTCCGTTCACTACAATGAGCAGTTCTTC	CASSSVHYNEQFF	TRBV19	TRBJ2-1
TGTGCCAGCAGCCCTCGGGACAGGGGGGATACGCAGTATTTT	CASSPRDRGDTQYF	TRBV7-3	TRBJ2-3
TGTGCCAGCAGTTACTCGAGGCTATCGCGCACAGATACGCAGTATTTT	CASSYSRLSRTDTQYF	TRBV6-8	TRBJ2-3
TGTGCCAGCAGTGAGCGGGTTAGGGGGCACAGTTACACCGGGGAGCTGTTTTTT	CASSERVRGHSYTGELFF	TRBV2	TRBJ2-2
TGTGCCAGCAGGATGGGGGGCAGGGACTGCTACAATGAGCAGTTCTTC	CASRMGGRDCYNEQFF	TRBV7-9	TRBJ2-1
TGTGCCAGCAGTTTCGTGTCGACAGGGAATAATGAAAAACTGTTTTTT	CASSFVSTGNNEKLFF	TRBV27	TRBJ1-4
TGTGCCAGCAGCGTAGCCGGGACAGGGGCGGAGCTGTTATTAGGGCATCAGCCCCAGCATTTT	CASSVAGTGAELLLGHQPQHF	TRBV9	TRBJ1-5
TGTGCCAGCAGCCCCTCGGGAGGGAGCGATGAGCAGTTCTTC	CASSPSGGSDEQFF	TRBV13	TRBJ2-1
TGTGCCAGCAGCCAATGGGGGGGATCCACCGGGGAGCTGTTTTTT	CASSQWGGSTGELFF	TRBV7-3	TRBJ2-2
TGTGCCACCAGTGATTTGATAACCTCTGGGACAGGGTCAGTTGCCTACGAGCAGTACTTC	CATSDLITSGTGSVAYEQYF	TRBV24-1	TRBJ2-7
TGTGCCAGCAGCTTAGAGGTAAATCTCCCCTACGAGCAGTACTTC	CASSLEVNLPYEQYF	TRBV7-2	TRBJ2-7
TGTGCCAGTAGTATAGTGTTAATTCGGACTAACAAAGAGACCCAGTACTTC	CASSIVLIRTNKETQYF	TRBV19	TRBJ2-5
TGTGCCACCGATTTACTCCGGGACGGTGGCTACAATGAGCAGTTCTTC	CATDLLRDGGYNEQFF	TRBV24-1	TRBJ2-1
TGTGCCAGCAGCCAAGATCAAGGGGTAATGACCTACGAGCAGTACTTC	CASSQDQGVMTYEQYF	TRBV3-1	TRBJ2-7
TGTGCCAGCAGTTTTAAGCGCTACGAGCAGTACTTC	CASSFKRYEQYF	TRBV28	TRBJ2-7
TGTGCCAGCAGTATCCTAAAAGACAGTCGAGCGTATACGCAGTATTTT	CASSILKDSRAYTQYF	TRBV27	TRBJ2-3
TGTGCCAGCCGCCGCAGGGGGCACGCCCAGTACTTC	CASRRRGHAQYF	TRBV27	TRBJ2-5
TGTGCCAGCAGCCCCCGGAGGGGCTACGAGCAGTACTTC	CASSPRRGYEQYF	TRBV5-5	TRBJ2-7
TGCAGTGCATCCCATCCCCTAGTCAGGCAGGGCATGAACACTGAAGCTTTCTTT	CSASHPLVRQGMNTEAFF	TRBV20-1	TRBJ1-1
TGTGCCAGCAGCCGGGAACGGCGGACAGAAGACGAGCAGTACTTC	CASSRERRTEDEQYF	TRBV7-3	TRBJ2-7
TGTGCCAGCAGCGACCGTATACAGGGGTCCAGGAACACTGAAGCTTTCTTT	CASSDRIQGSRNTEAFF	TRBV9	TRBJ1-1
TGTGCCAGCAGCCAAGCGACGGGAGAGGAAGGCACTAATGAAAAACTGTTTTTT	CASSQATGEEGTNEKLFF	TRBV3-1	TRBJ1-4
TGTACGCGGAATCAGCCCCAGCATTTT	CTRNQPQHF	TRBV19	TRBJ1-5
TGCAGTGCTATCCAACAGGGGTTAAATCTAGCCAAAAACATTCAGTACTTC	CSAIQQGLNLAKNIQYF	TRBV20-1	TRBJ2-4
TGCGCACCGACAGGGCAGCCCCAGCATTTT	CAPTGQPQHF	TRBV10-1	TRBJ1-5
TGCGCCAGCAACATTAGCCCACAGGAACCCGGGGAGCTGTTTTTT	CASNISPQEPGELFF	TRBV10-1	TRBJ2-2
TGCAGTGCTACGTTTATCAATGCTGAAGCTTTCTTT	CSATFINAEAFF	TRBV20-1	TRBJ1-1
TGTGCCAGCCCTCGGACAGGCCACTCTGGGGCCAACGTCCTGACTTTC	CASPRTGHSGANVLTF	TRBV6-5	TRBJ2-6
TGTGCCAGCAGTGAGGGCAAGTCGGACAGGGGGTTGTACTTC	CASSEGKSDRGLYF	TRBV6-1	TRBJ2-5
TGTGCCAGCAGCCAACCCTTAAGGGACAGTCAGCCCCAGCATTTT	CASSQPLRDSQPQHF	TRBV4-2	TRBJ1-5
TGTGCCAGCAGTGATCTGACTAGCGGGGGGGCCGAGCAGTACTTC	CASSDLTSGGAEQYF	TRBV6-4	TRBJ2-7
TGTGCCAGCAGTTTCCTAGCGGTCTCCTACGAGCAGTACTTC	CASSFLAVSYEQYF	TRBV25-1	TRBJ2-7
TGTGCTAGTGGTGGCTGGATTGAGGGGGGGGCGTGGTTGTATAGCAATCAGCCCCAGCATTTT	CASGGWIEGGAWLYSNQPQHF	TRBV12-5	TRBJ1-5
TGTGCCACGAACATTCAGTACTTC	CATNIQYF	TRBV11-2	TRBJ2-4
TGCGCCAGCAGGAGTTCGGGGACCGGGTCCTACGAGCAGTACTTC	CASRSSGTGSYEQYF	TRBV10-1	TRBJ2-7
TGTGCCAGCAGGATAATAGATATCCCGAGGGGTTTAGGAGGGGCCAACGTCCTGACTTTC	CASRIIDIPRGLGGANVLTF	TRBV2	TRBJ2-6
TGTGCCAGCAGTTTCCAGGGCTATGGCTACACCTTC	CASSFQGYGYTF	TRBV27	TRBJ1-2
TGCGCCAGCAGCCAAGAATCAGTGATTAACTATGGCTACACCTTC	CASSQESVINYGYTF	TRBV4-1	TRBJ1-2
TGTGCCAGCAGTTTAGTAGAGGGGGCGGAAGGAATCTCCTACGAGCAGTACTTC	CASSLVEGAEGISYEQYF	TRBV27	TRBJ2-7
TGTGCCAGCAGCTTATTAAGCTACAATGAGCAGTTCTTC	CASSLLSYNEQFF	TRBV5-4	TRBJ2-1
TGTGCCAGCAGCAGGACAGGATACACTGAAGCTTTCTTT	CASSRTGYTEAFF	TRBV11-3	TRBJ1-1
TGTGCCAGTACGCCCCCGGGACGAGGGTATTTT	CASTPPGRGYF	TRBV7-3	TRBJ1-3
TGTGCCAGCAGCCACGGGGTAGCGGGGGTAGGAAGGAGCTCCTACAATGAGCAGTTCTTC	CASSHGVAGVGRSSYNEQFF	TRBV12-4	TRBJ2-1
TGTGCCAGCAGCCCAACGGGGGCCCCCGATCCCGAGAATGAGCAGTTCTTC	CASSPTGAPDPENEQFF	TRBV5-6	TRBJ2-1
TGTGCCAGCAGGCGGGAGTGTCTGAGTGAGCAGTTCTTC	CASRRECLSEQFF	TRBV2	TRBJ2-1
TGTGCCAGCAGTTACGTTAGGCACAGGGTGTGGATTAACTATGGCTACACCTTC	CASSYVRHRVWINYGYTF	TRBV6-6	TRBJ1-2
TGTGCCACCAGCACAGGACAGGGGGCGGTCAAGGCCTCTTTCTTT	CATSTGQGAVKASFF	TRBV15	TRBJ1-1
TGCGAAACCTTCACAACAACTGAAGCTTTCTTT	CETFTTTEAFF	TRBV5-1	TRBJ1-1
TGTGCCAGCAGTTTCCGGGGGAGCTCTGGGGCCAACGTCCTGACTTTC	CASSFRGSSGANVLTF	TRBV12-4	TRBJ2-6
TGCAGTGCTTCGAGCGGGACCCGCAATCAGCCCCAGCATTTT	CSASSGTRNQPQHF	TRBV20-1	TRBJ1-5
TGTGCCAGCAGCTGGGCGATCGGACTAGCGTTCGCCCACAATGAGCAGTTCTTC	CASSWAIGLAFAHNEQFF	TRBV11-3	TRBJ2-1
TGTGCCAGCAGCTTGGACCGGGACCGGCGAACTGAAGCTTTCTTT	CASSLDRDRRTEAFF	TRBV7-8	TRBJ1-1
TGTGCCAGCAGTTACTCGCGGACAGCGGGAAGCTCCTATAATTCACCCCTCCACTTT	CASSYSRTAGSSYNSPLHF	TRBV6-6	TRBJ1-6
TGCGCCACTCCGGACATGTCCAACTATGGCTACACCTTC	CATPDMSNYGYTF	TRBV5-1	TRBJ1-2
TGTGCCAGCAGTTACTCCCCCTGGGGACACTATGGCTACACCTTC	CASSYSPWGHYGYTF	TRBV6-6	TRBJ1-2
TGTGCCAGCAGTTTCCAACTAGCGGGGGGGCCGGATGCGAACACCGGGGAGCTGTTTTTT	CASSFQLAGGPDANTGELFF	TRBV25-1	TRBJ2-2
TGTGCCAGTAGTATCCTTGGAACCCATTGGGTCCGGTACACCTTC	CASSILGTHWVRYTF	TRBV19	TRBJ1-2
TGTGCCAGCAGCTCGAGACAGGGGAAGATCTCTGGGGCCAACGTCCTGACTTTC	CASSSRQGKISGANVLTF	TRBV5-6	TRBJ2-6
TGCAGTGCTAAGACCAGGGGGGAGCTGTTTTTT	CSAKTRGELFF	TRBV20-1	TRBJ2-2
TGCGCCAGCAGGCCTCCGAACGGAGGGGGACATGACTATGGCTACACCTTC	CASRPPNGGGHDYGYTF	TRBV10-1	TRBJ1-2
TGCGCCAGCAGCTTAAGGGCTTATGGCTACACCTTC	CASSLRAYGYTF	TRBV4-1	TRBJ1-2
TGTGCCAGCAGTCTCATTGCAGGGGACCACCCACAGCCCCAGCATTTT	CASSLIAGDHPQPQHF	TRBV6-2	TRBJ1-5
TGTGCCAGCAGCTCCTGGAGGTCGAACACTGAAGCTTTCTTT	CASSSWRSNTEAFF	TRBV5-6	TRBJ1-1
TGTGCCAGCAGTTACAACGACAGTGCAGATACGCAGTATTTT	CASSYNDSADTQYF	TRBV6-5	TRBJ2-3
TGTGCCAGCAGTGAATCGCAAACTGGGGGGGGCTCTGGAAACACCATATATTTT	CASSESQTGGGSGNTIYF	TRBV6-4	TRBJ1-3
TGTGCCAGTAGGACAACCTTAGATCACGAGCAGTACTTC	CASRTTLDHEQYF	TRBV19	TRBJ2-7
TGTGCCAGCAGCCCCTGGGGGGCAGCACTCTTGCAGTTCTTC	CASSPWGAALLQFF	TRBV7-2	TRBJ2-1
TGTGCCAGCAGCTTAGGACAGGCGAACACTGAAGCTTTCTTT	CASSLGQANTEAFF	TRBV7-6	TRBJ1-1
TGCGCCAGCAGCTTGGCCCGAAAAAAGGACAGGGAAATGGGCTACACCTTC	CASSLARKKDREMGYTF	TRBV5-1	TRBJ1-2
TGTGCCAGCAGCCCCCACCGCAGTGTCGGCTACGAGCAGTACTTC	CASSPHRSVGYEQYF	TRBV7-3	TRBJ2-7
TGCGCCAGCAGTGAGCGGACCGGGACTAGGTACAATGAGCAGTTCTTC	CASSERTGTRYNEQFF	TRBV10-1	TRBJ2-1
TGTGCCAGCAGCTTGGATCGGACAGGGTTAACCCAAGAGACCCAGTACTTC	CASSLDRTGLTQETQYF	TRBV5-6	TRBJ2-5
TGTGCCAGCAGCCCCAAGGCCCACAGGGGGCCTGGGGCCAACGTCCTGACTTTC	CASSPKAHRGPGANVLTF	TRBV28	TRBJ2-6
TGTGCCAGCAGCGGTCGGGGAGGCTACGAGCAGTACTTC	CASSGRGGYEQYF	TRBV7-9	TRBJ2-7
TGTGCCAGCAGCTTAAATTGGATTTCAGCCTACAATGAGCAGTTCTTC	CASSLNWISAYNEQFF	TRBV7-3	TRBJ2-1
TGTGCCAGCAGCCTGAGGCCAGCCAAAAACATTCAGTACTTC	CASSLRPAKNIQYF	TRBV7-6	TRBJ2-4
TGCGCCAGCAGCTTGACCTTCAGGGTTTTTGCCTACGAGCAGTACTTC	CASSLTFRVFAYEQYF	TRBV5-1	TRBJ2-7
TGCGCCAGCAGGGTGTCTCTGGCGGGCTACAATGAGCAGTTCTTC	CASRVSLAGYNEQFF	TRBV10-1	TRBJ2-1
TGTGCCAGCAGCAGGACAGGGGCGAACTATGGCTACACCTTC	CASSRTGANYGYTF	TRBV11-2	TRBJ1-2
TGTGCCAGCAGTGAAGGGCGAGATGAGCAGTTCTTC	CASSEGRDEQFF	TRBV2	TRBJ2-1
TGTGCCAGCAAAGGAAGGACAGCTAGATCTGGGGCCAACGTCCTGACTTTC	CASKGRTARSGANVLTF	TRBV6-4	TRBJ2-6
TGTGCCAGGCAGGGGTCGTGCCCCGGGTCACCCCTCCACTTT	CARQGSCPGSPLHF	TRBV12-3	TRBJ1-6
TGCGCCAGCAGCTGGGGGGCCCCTAGTGGAAACACCATATATTTT	CASSWGAPSGNTIYF	TRBV5-1	TRBJ1-3
TGTGCCAGCAGCCAAGCAGTGGTCAGAGGGCTACTAACTGAAGCTTTCTTT	CASSQAVVRGLLTEAFF	TRBV14	TRBJ1-1
TGTGCCAGCAGTGTGAGGGTACCTGAAGCTTTCTTT	CASSVRVPEAFF	TRBV6-2	TRBJ1-1
TGTGCCAGCAGCCGTCCACACGGACAGAGTGATAGCAATCAGCCCCAGCATTTT	CASSRPHGQSDSNQPQHF	TRBV7-9	TRBJ1-5
TGCGCCAGCAGCCAAGTATGGGGCTACACCTTC	CASSQVWGYTF	TRBV4-1	TRBJ1-2
TGTGCCAGCAGCCAACTAGCCGCAGGGGGAACTGAAAAACTGTTTTTT	CASSQLAAGGTEKLFF	TRBV4-2	TRBJ1-4
TGCGCCAGCAGCCAAGGGGCAGGGGATTTTGGAAACACCATATATTTT	CASSQGAGDFGNTIYF	TRBV4-1	TRBJ1-3
TGTGCCAGCAGCTGGTACGGCTATGGCTACACCTTC	CASSWYGYGYTF	TRBV11-3	TRBJ1-2
TGTGCCAGCAGCAAGCCCTTTAATCAGCCCCAGCATTTT	CASSKPFNQPQHF	TRBV9	TRBJ1-5
TGCGCCAGCAGTGACAAAAAATACTTC	CASSDKKYF	TRBV10-1	TRBJ2-5
TGTGCCTGGAGTGTAACGGGGCGCCGCAGCTCTTACACCATATATTTT	CAWSVTGRRSSYTIYF	TRBV30	TRBJ1-3
TGTGCCAGCAGGCGGGAACGAAGGTTTTCTAGCGGGACCGACAATGAGCAGTTCTTC	CASRRERRFSSGTDNEQFF	TRBV6-5	TRBJ2-1
TGTGCCAGCAGACAGGGAGGTGCCTACGAGCAGTACTTC	CASRQGGAYEQYF	TRBV27	TRBJ2-7
TGTGCCAGCAGTTCTCTCGACAGGGAAGGGGGAGTATTCAGCAATCAGCCCCAGCATTTT	CASSSLDREGGVFSNQPQHF	TRBV6-5	TRBJ1-5
TGTGCCAGCAGCCGGGACAGGGGGCCCCAGCATTTT	CASSRDRGPQHF	TRBV11-3	TRBJ1-5
TGCAATCCCGTGACAGGGGGGATGAACACTGAAGCTTTCTTT	CNPVTGGMNTEAFF	TRBV29-1	TRBJ1-1
TGTGCCTGGAGTGGACAGGCCGTCCACTATGGCTACACCTTC	CAWSGQAVHYGYTF	TRBV30	TRBJ1-2
TGTGCCAGCAGTGGGGGGAGGTATCTTACTGACGCTGAAGCTTTCTTT	CASSGGRYLTDAEAFF	TRBV28	TRBJ1-1
TGCAGTGCTAGAGATAGTTTGCGGGGGCTCTACGAGCAGTACTTC	CSARDSLRGLYEQYF	TRBV20-1	TRBJ2-7
TGCGCCAGCAGCTTGGGCCTTGGACTTAATTCACCCCTCCACTTT	CASSLGLGLNSPLHF	TRBV5-1	TRBJ1-6
TGTGCCAGCAGTTCGGGCCTCAGAGCTATTTTTTATGGCTACACCTTC	CASSSGLRAIFYGYTF	TRBV6-2	TRBJ1-2
TGTGCCAGCAGTTTAAAGGGGACTAGGGAGCAGTTCTTC	CASSLKGTREQFF	TRBV27	TRBJ2-1
TGTGCCAGCAGAGCCGGGACTAGAGGGACCGGGGAGCTGTTTTTT	CASRAGTRGTGELFF	TRBV6-3	TRBJ2-2
TGCGCCAGCAGCCAAGCAGGGGGGGAAATCATAGGGTCAGGGGAGCTGTTTTTT	CASSQAGGEIIGSGELFF	TRBV4-1	TRBJ2-2
TGTGCCAGCACGGCTGGGGACATGGCCAAAAACATTCAGTACTTC	CASTAGDMAKNIQYF	TRBV11-3	TRBJ2-4
TGTGCCAGCAGCTGGACTATCACTGAAGCTTTCTTT	CASSWTITEAFF	TRBV7-2	TRBJ1-1
TGTGCCAGCAGCCGAAGGGGGCTCCGGGGGATTTCCTACGAGCAGTACTTC	CASSRRGLRGISYEQYF	TRBV9	TRBJ2-7
TGTGCCAGCAAATCCAGCACCTCCGGAGAGGACAGGCCTGAAGCTTTCTTT	CASKSSTSGEDRPEAFF	TRBV6-1	TRBJ1-1
TGTGCCACTAAGACAGGGCGAGACTATGGCTACACCTTC	CATKTGRDYGYTF	TRBV24-1	TRBJ1-2
TGCGCCAGCAGTGGTGCGGACAGGGGCGGGGAAGCTTTCTTT	CASSGADRGGEAFF	TRBV10-1	TRBJ1-1
TGCAGTGCCCGGGACAGGGGGGACTACGAGCAGTACTTC	CSARDRGDYEQYF	TRBV20-1	TRBJ2-7
TGCAGTGCTAGAGATCGGGGGCCCACCGGGGAGCTGTTTTTT	CSARDRGPTGELFF	TRBV20-1	TRBJ2-2
TGTGCCAGCAGCCTTCACAGGTGCGAGCAGTACTTC	CASSLHRCEQYF	TRBV7-9	TRBJ2-7
TGTGCCACCAGTGACAAGCCCGGGGTTTCTTTGCATTCACCCCTCCACTTT	CATSDKPGVSLHSPLHF	TRBV24-1	TRBJ1-6
TGTGCCAGCTCACCACCGAACGGGGGGGCACAAGAGACCCAGTACTTC	CASSPPNGGAQETQYF	TRBV18	TRBJ2-5
TGTGCCAGCAGCTGTAGGGGGCTAGGCAATGAGCAGTTCTTC	CASSCRGLGNEQFF	TRBV7-3	TRBJ2-1
TGTGCCACCAGTGATTTGCATCCTCAGACAGGGCGAAGCAGAGCTTTCTTT	CATSDLHPQTGRSRAFF	TRBV24-1	TRBJ1-1
TGTGCCAGCAGCCCCGGCGGGAGAGGGTTTGCCCCGAACACCGGGGAGCTGTTTTTT	CASSPGGRGFAPNTGELFF	TRBV13	TRBJ2-2
TGTGCCAGCAGTGAATTAAAAACTATAATAGGGGAAGATTATTCTGGAAACACCATATATTTT	CASSELKTIIGEDYSGNTIYF	TRBV25-1	TRBJ1-3
TGTGCCAGCAGCTCCAGGGTCACTGAAGCTTTCTTT	CASSSRVTEAFF	TRBV7-9	TRBJ1-1
TGTGCCAGCAGGTCCAGGAAGACCCAGTACTTC	CASRSRKTQYF	TRBV6-4	TRBJ2-5
TGTGCCAGTAGTAGCCACAGAGAGGGGGCCAACGTCCTGACTTTC	CASSSHREGANVLTF	TRBV19	TRBJ2-6
TGCGCCAGCAGCTTGTGTTATCCGGGAAGGGGGGCAGATACGCAGTATTTT	CASSLCYPGRGADTQYF	TRBV5-1	TRBJ2-3
TGTGCCACCAGTGATTTTAGGGGGGAAAAGTGGTTTTCCTACAATGAGCAGTTCTTC	CATSDFRGEKWFSYNEQFF	TRBV24-1	TRBJ2-1
TGTGCCAGCAGTAGGGGCCCTGGAAACACCATATATTTT	CASSRGPGNTIYF	TRBV6-5	TRBJ1-3
TGTGCCAGGACCCACGTTTACTTTTACAATGAGCAGTTCTTC	CARTHVYFYNEQFF	TRBV10-3	TRBJ2-1
TGTGCCAGCAGCTTAGCGGTTGGACAGGGTCCGGGAAGGTACGAGCAGTACTTC	CASSLAVGQGPGRYEQYF	TRBV7-6	TRBJ2-7
TGTGCCTGGAGGGCCTTTGAGGGATCCTACAATGAGCAGTTCTTC	CAWRAFEGSYNEQFF	TRBV30	TRBJ2-1
TGCAGTGCTCGGGGGACTGGGACCGATTCACCCCTCCACTTT	CSARGTGTDSPLHF	TRBV20-1	TRBJ1-6
TGTGCCTGGAGACAAGCTCAGCCCCAGCATTTT	CAWRQAQPQHF	TRBV30	TRBJ1-5
TGTGCCAGCATGATGCCGGGGGGGGGAGTTATAGATACGCAGTATTTT	CASMMPGGGVIDTQYF	TRBV6-1	TRBJ2-3
TGTGCCAGCAGCCTCAGTCGCGCTCCGGACAGGAGCCGAAAGGACTATGGCTACACCTTC	CASSLSRAPDRSRKDYGYTF	TRBV4-2	TRBJ1-2
TGCGCCAGCAGCTTGACCGCAAGGGGGGGCTACACCTTC	CASSLTARGGYTF	TRBV5-1	TRBJ1-2
TGTGCCAACCGAACGACTAGCGGGAAATCCTACGAGCAGTACTTC	CANRTTSGKSYEQYF	TRBV12-4	TRBJ2-7
TGTGCCACCAGTGAGGAGTATGAGCAGTTCTTC	CATSEEYEQFF	TRBV24-1	TRBJ2-1
TGCGCCAGCAGCCCGCCGGACAGGGGTCCCAGCTACGAGCAGTACTTC	CASSPPDRGPSYEQYF	TRBV4-3	TRBJ2-7
TGTGCCAGCAGCGTAGGAGGCCCCTCCGTTGGCGGACAGAGTACCGAGCAGTACTTC	CASSVGGPSVGGQSTEQYF	TRBV9	TRBJ2-7
TGTGCCAGCAGTTTAGACAGTGGAAACACCATATATTTT	CASSLDSGNTIYF	TRBV12-3	TRBJ1-3
TGTGCCAGCAGCTTACAGGGCTCTGGGGCCAACGTCCTGACTTTC	CASSLQGSGANVLTF	TRBV7-9	TRBJ2-6
TGTGCCAGCTGTCAAGCCGGGACAGGGAGCTCCTACAATGAGCAGTTCTTC	CASCQAGTGSSYNEQFF	TRBV6-1	TRBJ2-1
TGCGCCAGCAGCTTGCATACAGAACATAGCAATCAGCCCCAGCATTTT	CASSLHTEHSNQPQHF	TRBV5-1	TRBJ1-5
TGCGCCAGCAGCCAGGCACCTACTATTCCGGAACGATCTGTCCAACGCAGCTCCTATAATTCACCCCTCCACTTT	CASSQAPTIPERSVQRSSYNSPLHF	TRBV10-1	TRBJ1-6
TGTGCCAGCAGCTTAGTTCCCGAGGCAACCACAGATACGCAGTATTTT	CASSLVPEATTDTQYF	TRBV7-9	TRBJ2-3
TGTGCCAGCAGCTTAGTCTGGAACGGGGGGGCCGGGCAGAATGAGCAGTTCTTC	CASSLVWNGGAGQNEQFF	TRBV11-2	TRBJ2-1
TGTGCCAGCAGCTTAGCGGGACACCGCTATGGCTACACCTTC	CASSLAGHRYGYTF	TRBV7-2	TRBJ1-2
TGTGCCAGCAGGTTAAGATGGTTCCAGCGAGCCTACGAGCAGTACTTC	CASRLRWFQRAYEQYF	TRBV7-9	TRBJ2-7
TGCAGCTTTGAGAGGGGGCCTTCCAAAAACATTCAGTACTTC	CSFERGPSKNIQYF	TRBV29-1	TRBJ2-4
TGTGCCAGTAGTATCCTACACAGGGGGGGAAACATTCAGTACTTC	CASSILHRGGNIQYF	TRBV19	TRBJ2-4
TGTGCCAGCGCCAGCTCTAATGAGCAGTTCTTC	CASASSNEQFF	TRBV6-2	TRBJ2-1
TGTGCCAGCAGCTTACCGGATACTTTAGGTGAAAAACTGTTTTTT	CASSLPDTLGEKLFF	TRBV7-3	TRBJ1-4
TGCGCCAGCAGTGACCCTCAGCGGGGCTCCTACGAGCAGTACTTC	CASSDPQRGSYEQYF	TRBV10-1	TRBJ2-7
TGTGCCAGCAGCCAAGATACCAGGGGGCCGAACACCGGGGAGCTGTTTTTT	CASSQDTRGPNTGELFF	TRBV3-1	TRBJ2-2
TGTGCCAGCAGCAACCGACTAGTCTCGGATGAGCAGTTCTTC	CASSNRLVSDEQFF	TRBV5-6	TRBJ2-1
TGCGCCAGCCCCAGGACTGAGCGCAAAAACATTCAGTACTTC	CASPRTERKNIQYF	TRBV10-1	TRBJ2-4
TGTGCCAGCATCGGTTTCTATGGCTACACCTTC	CASIGFYGYTF	TRBV28	TRBJ1-2
TGTGCCACCAGTGACTGGGGACGAGGATCCTACGAGCAGTACTTC	CATSDWGRGSYEQYF	TRBV24-1	TRBJ2-7
TGCGCCAGCAATGCTAGCGGGTTTGAGACCCAGTACTTC	CASNASGFETQYF	TRBV10-1	TRBJ2-5
TGTGCCAGCAGCCCTCCTCGCGGGAGGGATCAGCCCCAGCATTTT	CASSPPRGRDQPQHF	TRBV7-6	TRBJ1-5
TGTGCCAGTACGGGACCGGAGCAGTACTTC	CASTGPEQYF	TRBV12-3	TRBJ2-7
TGTGCCAGCATGGAGGAGGGAGGGTCCAGCTCCTACGAGCAGTACTTC	CASMEEGGSSSYEQYF	TRBV28	TRBJ2-7
TGTGCCAGCAGTGGACCGACAGGAACCATCCATGATCAGCCCCAGCATTTT	CASSGPTGTIHDQPQHF	TRBV6-1	TRBJ1-5
TGTGCCAGCAGCAGGGGGCGCCGGAACACCGGGGAGCTGTTTTTT	CASSRGRRNTGELFF	TRBV2	TRBJ2-2
TGTGCCTGCTTCTACGTACCCTACAATGAGCAGTTCTTC	CACFYVPYNEQFF	TRBV30	TRBJ2-1
TGCAGTGCTAGAGATCTCTGCATAGGTATAGCCTCCTACGAGCAGTACTTC	CSARDLCIGIASYEQYF	TRBV20-1	TRBJ2-7
TGTGCCAGTAGTAATAAGGGACAGGGGTCCATGAACACTGAAGCTTTCTTT	CASSNKGQGSMNTEAFF	TRBV19	TRBJ1-1
TGTGCCAGCAGTTTACTAGGGTTAGGCGGGATACCCAATGAGCAGTTCTTC	CASSLLGLGGIPNEQFF	TRBV27	TRBJ2-1
TGTGCCAGCAGTTCGTCATGTGGACAGATCGAGCAGTACTTC	CASSSSCGQIEQYF	TRBV27	TRBJ2-7
TGTGCCAGCAGCTTACCGGGGACAGATGGCTACACCTTC	CASSLPGTDGYTF	TRBV7-3	TRBJ1-2
TGTGCCAGTAGCCATGCCGGACAGCCCCTAGACTATGGCTACACCTTC	CASSHAGQPLDYGYTF	TRBV19	TRBJ1-2
TGCAGTGCTAGCCCTAGCGGGAATGAGCAGTTCTTC	CSASPSGNEQFF	TRBV20-1	TRBJ2-1
TGCAGTGCCCTGGACAGGACAGGATCAGATACGCAGTATTTT	CSALDRTGSDTQYF	TRBV20-1	TRBJ2-3
TGTGCACTAGCTTACCAGTACTTC	CALAYQYF	TRBV12-5	TRBJ2-5
TGTGCCAGCTCGGGACAGGGCCCGACAAACACCATATATTTT	CASSGQGPTNTIYF	TRBV18	TRBJ1-3
TGCGCCAGCAGCTTGTCGGAGGGCACAGGGGCGTATAAAGGGGATCAAGAGACCCAGTACTTC	CASSLSEGTGAYKGDQETQYF	TRBV5-1	TRBJ2-5
TGTGCCAGCTGGGGACGGGGACAGGTCTACGAGCAGTACTTC	CASWGRGQVYEQYF	TRBV27	TRBJ2-7
TGTGCCAGTAGTTCGGCCGGGACAGTGAACACTGAAGCTTTCTTT	CASSSAGTVNTEAFF	TRBV19	TRBJ1-1
TGTGCCAATTGCGGGGGCGGAACAACTAATGAAAAACTGTTTTTT	CANCGGGTTNEKLFF	TRBV6-1	TRBJ1-4
TGTGCCAGCTCACCCGTATGGGACAGGGGAAACTACGAGCAGTACTTC	CASSPVWDRGNYEQYF	TRBV18	TRBJ2-7
TGTGCCAGCAGTTTCCCAGGGGACTCCTACGAGCAGTACTTC	CASSFPGDSYEQYF	TRBV27	TRBJ2-7
TGTGCCAGCAGGGTTCACAACAGGGCGACTGAAGCTTTCTTT	CASRVHNRATEAFF	TRBV6-3	TRBJ1-1
TGTGCCAGCAGGGTTTCGGGGGGTAATTTAGATCAGCCCCAGCATTTT	CASRVSGGNLDQPQHF	TRBV6-2	TRBJ1-5
TGTGCCAGCAGCCCAGGATCCTTCAATGAGCAGTTCTTC	CASSPGSFNEQFF	TRBV13	TRBJ2-1
TGCAGTGCAAACCATACTAAGGCCTCAGCTTTCTTT	CSANHTKASAFF	TRBV20-1	TRBJ1-1
TGTGCCAGCAGCTTATGGGGGTTGCAGCACGAGCAGTACTTC	CASSLWGLQHEQYF	TRBV7-3	TRBJ2-7
TGTGCCAGCAGCTTGCCCGGACAGAAGCAGCCCCAGCATTTT	CASSLPGQKQPQHF	TRBV5-5	TRBJ1-5
TGTGCCAGCAGCTTGAAAGCGACCCTCCGGGGGGTACCTAATGAAAAACTGTTTTTT	CASSLKATLRGVPNEKLFF	TRBV9	TRBJ1-4
TGTGCCAGCAGCCACACCGGGCCACGTGGAAACACCATATATTTT	CASSHTGPRGNTIYF	TRBV14	TRBJ1-3
TGTGCCAGCAGTCCCACAGGAGAGGTAGAGACCCAGTACTTC	CASSPTGEVETQYF	TRBV27	TRBJ2-5
TGTGCTAGCAGCCCTCAGGGGGCCTACGAGCAGTACTTC	CASSPQGAYEQYF	TRBV7-7	TRBJ2-7
TGTGCCTGGAGTACCGGGGGGTCCTACGAGCAGTACTTC	CAWSTGGSYEQYF	TRBV30	TRBJ2-7
TGTGCCAGCAGCCCATGGGGGACTAGCGGGAGAATAAACGAGCAGTACTTC	CASSPWGTSGRINEQYF	TRBV7-2	TRBJ2-7
TGTGCCACCAGTGATTTACGGCCGGGGGGGCGGGGGACCCAGTACTTC	CATSDLRPGGRGTQYF	TRBV24-1	TRBJ2-5
TGTGCCCCTCGGGGGGTCTTGCAGAACACCGGGGAGCTGTTTTTT	CAPRGVLQNTGELFF	TRBV6-4	TRBJ2-2
TGTGCCAGCAGCGGAGGTGGCCACCCAAAGGGGGCTCTAAACACCATATATTTT	CASSGGGHPKGALNTIYF	TRBV13	TRBJ1-3
TGTGCCACCGTGACTAGCGGGAGGGCTATTGATGAAAAACTGTTTTTT	CATVTSGRAIDEKLFF	TRBV24-1	TRBJ1-4
TGTGCCTGGAGTGTACCATTGACGGATCCGAAGAACACCGGGGAGCTGTTTTTT	CAWSVPLTDPKNTGELFF	TRBV30	TRBJ2-2
TGCGCCAGCCCAGTTGCGGGTGAGCAGTTCTTC	CASPVAGEQFF	TRBV10-1	TRBJ2-1
TGTGCCAGCCTCAGTTATCGTAATGAAAAACTGTTTTTT	CASLSYRNEKLFF	TRBV6-4	TRBJ1-4
TGTGCCACCAGGGGGAGGAATAGCCTGTACGGCTACGAGCAGTACTTC	CATRGRNSLYGYEQYF	TRBV24-1	TRBJ2-7
TGTGCCAGCAGCCGGAAGTTCCGGGACAGTCCCCCGCAAGAGACCCAGTACTTC	CASSRKFRDSPPQETQYF	TRBV13	TRBJ2-5
TGCGCCAGCCAACGGGTTCACTTCTATGGCTACACCTTC	CASQRVHFYGYTF	TRBV5-1	TRBJ1-2
TGCAGAACTTGGCGGGTACAGTACTATGGCTACACCTTC	CRTWRVQYYGYTF	TRBV20-1	TRBJ1-2
TGTGCCTGGAGTGCGACCCCTAGGAGCCGACCGAACACTGAAGCTTTCTTT	CAWSATPRSRPNTEAFF	TRBV30	TRBJ1-1
TGTGCCAGCAGCTTAGCATTGGACGGCCAGCCCCAGCATTTT	CASSLALDGQPQHF	TRBV11-3	TRBJ1-5
TGTGCCATCAGTGACCCCTGGGGATCTTTCTACGAGCAGTACTTC	CAISDPWGSFYEQYF	TRBV10-3	TRBJ2-7
TGTGCCAGCAGCCCGGGGGGGCCCTCCTACGAGCAGTACTTC	CASSPGGPSYEQYF	TRBV11-2	TRBJ2-7
TGCGCCAGCAGCTTGGACCCGCCGGGACAGGGGGCCAGCAATCAGCCCCAGCATTTT	CASSLDPPGQGASNQPQHF	TRBV5-1	TRBJ1-5
TGTGCTAGTGGGGGGGACAGAGCCTACGAGCAGTACTTC	CASGGDRAYEQYF	TRBV12-5	TRBJ2-7
TGCGCCAGCAGCGGGTTACAACAGGGGGCAGGGAGGACGGGCACAGATACGCAGTATTTT	CASSGLQQGAGRTGTDTQYF	TRBV5-1	TRBJ2-3
TGCGCCAGCAGTGTCGAGAGTAGCGGGCCCACAGATACGCAGTATTTT	CASSVESSGPTDTQYF	TRBV10-1	TRBJ2-3
TGTGCCAGCAGCTTAGGTAATCCCTTCAAAACAGGGCAAGATGGCTACACCTTC	CASSLGNPFKTGQDGYTF	TRBV7-7	TRBJ1-2
TGTGCCAGCAGCATCAGGATCCATTACGAGCAGTACTTC	CASSIRIHYEQYF	TRBV5-6	TRBJ2-7
TGTGCCAGTAGTATCGGGACAGGGAGGGAAAAGTCCCCGAACACTGAAGCTTTCTTT	CASSIGTGREKSPNTEAFF	TRBV19	TRBJ1-1
TGCGCCAGCGGGGGAACCTACGAGCAGTACTTC	CASGGTYEQYF	TRBV10-1	TRBJ2-7
TGCAGTGCTGTAATTAGGGGTCGCCAAGAGACCCAGTACTTC	CSAVIRGRQETQYF	TRBV20-1	TRBJ2-5
TGTGCCAGCAGTTACTCGGACCCTGTGACTCGGAACACCGGGGAGCTGTTTTTT	CASSYSDPVTRNTGELFF	TRBV6-5	TRBJ2-2
TGTGCCAGCAGCGCGGGTGGGGGACCCCGCAATCAGCCCCAGCATTTT	CASSAGGGPRNQPQHF	TRBV5-6	TRBJ1-5
TGCAGTGCGCCCCCCAGGGTTCAAGAGACCCAGTACTTC	CSAPPRVQETQYF	TRBV20-1	TRBJ2-5
TGTGCCAGCGTGGGGTTGATTAGTGCCTACAATGAGCAGTTCTTC	CASVGLISAYNEQFF	TRBV14	TRBJ2-1
TGTGCCAGCAAACAGGGTCGTAATTCACCCCTCCACTTT	CASKQGRNSPLHF	TRBV27	TRBJ1-6
TGTGCCAGCAGCGTTGGGGACTATGAAGCTTTCTTT	CASSVGDYEAFF	TRBV7-9	TRBJ1-1
TGTGCCACCAGCAGAGCGCCGTCACATGAGCAGTTCTTC	CATSRAPSHEQFF	TRBV15	TRBJ2-1
TGTGCCAGCTCACCTCATGAGGGGGGGTTTAATGAAAAACTGTTTTTT	CASSPHEGGFNEKLFF	TRBV18	TRBJ1-4
TGTGCCACCAGCAGAGTTGTATCATTGAGGGACGGATACGAGCAGTACTTC	CATSRVVSLRDGYEQYF	TRBV15	TRBJ2-7
TGTGCCAGCAGCTTAAAAAAAAGACAGGACACCATATATTTT	CASSLKKRQDTIYF	TRBV5-6	TRBJ1-3
TGTGCCAGCAGCTTTCGACTAGCGGGCACAGATACGCAGTATTTT	CASSFRLAGTDTQYF	TRBV7-2	TRBJ2-3
TGCAGCGTTGACCTGGACAGCCGGGTCTACGAGCAGTACTTC	CSVDLDSRVYEQYF	TRBV29-1	TRBJ2-7
TGTGCCAGCAGTCCCAGGGGACTAGCGGATCCCAAAAACATTCAGTACTTC	CASSPRGLADPKNIQYF	TRBV27	TRBJ2-4
TGTGCCAGCAGCCAAGATATGACTAGCAGTGCCTACGAGCAGTACTTC	CASSQDMTSSAYEQYF	TRBV3-1	TRBJ2-7
TGCAGTGCTGAACAGGGGAGATATGGCTACACCTTC	CSAEQGRYGYTF	TRBV20-1	TRBJ1-2
TGTGCCAGCAGCCTACGAAGACAAGAGACCCAGTACTTC	CASSLRRQETQYF	TRBV7-9	TRBJ2-5
TGCAGTGCTAGAGATCGGGGGACAGGTAATGCCTATGGCTACACCTTC	CSARDRGTGNAYGYTF	TRBV20-1	TRBJ1-2
TGTGCCAGCAGTTTACGGACAGGGGAAGGCTACGAGCAGTACTTC	CASSLRTGEGYEQYF	TRBV27	TRBJ2-7
TGCGCCAGCAGCTTGGCTCGGCCCCTAGCGGGTAGGGCGGAGACCCAGTACTTC	CASSLARPLAGRAETQYF	TRBV5-1	TRBJ2-5
TGCGCCAGCAACCGGGAGGAGACCCAGTACTTC	CASNREETQYF	TRBV10-1	TRBJ2-5
TGTGCCAGCAGCCCTGCCAGGGTAACAGATACGCAGTATTTT	CASSPARVTDTQYF	TRBV6-1	TRBJ2-3
TGCAGCGTTGACTTCGTGGGGTATACGCAGTATTTT	CSVDFVGYTQYF	TRBV29-1	TRBJ2-3
TGTGCCAGCAGAGTACGGGGGGGCGAGACCCAGTACTTC	CASRVRGGETQYF	TRBV12-3	TRBJ2-5
TGTGCCAGCAGCCTCAACAATTACACCTTC	CASSLNNYTF	TRBV9	TRBJ1-2
TGTGCCAGCAGCCAAGAGTCCTCCCGCGGGAGATCCTACGAGCAGTACTTC	CASSQESSRGRSYEQYF	TRBV14	TRBJ2-7
TGTGCCAGCAGAACAGGGAGTGGGGTCTCCTACAATGAGCAGTTCTTC	CASRTGSGVSYNEQFF	TRBV6-4	TRBJ2-1
TGTGCCACCAGTGATTTGAACGGACTAGGGGAAGACAATGAGCAGTTCTTC	CATSDLNGLGEDNEQFF	TRBV24-1	TRBJ2-1
TGCAGTGCTTTTCCGCTAGCGGGTAGTATAATAGAGACCCAGTACTTC	CSAFPLAGSIIETQYF	TRBV20-1	TRBJ2-5
TGTGCCAGCAGTTTAGTGATTCCGAGGACTTATAACACCATATATTTT	CASSLVIPRTYNTIYF	TRBV28	TRBJ1-3
TGTGCCAGCATCCCGGACAGGGAACGAAGGGGCTCGAACTATGGCTACACCTTC	CASIPDRERRGSNYGYTF	TRBV2	TRBJ1-2
TGTGCCAGCAGCTTGGAAGGCTGGGATACGCAGTATTTT	CASSLEGWDTQYF	TRBV5-8	TRBJ2-3
TGCAGCGGCCAGGGGAACACCGGGGAGCTGTTTTTT	CSGQGNTGELFF	TRBV29-1	TRBJ2-2
TGTGCCAGCAGTTTAGGGGGCTGGAGAGATACGCAGTATTTT	CASSLGGWRDTQYF	TRBV12-4	TRBJ2-3
TGTGCCAGCAGCCTAGGGGACGAGCAGTACTTC	CASSLGDEQYF	TRBV6-5	TRBJ2-7
TGCGCCAGCAGTGACCCCGACAGGACGGGCTACGAGCAGTACTTC	CASSDPDRTGYEQYF	TRBV10-1	TRBJ2-7
TGTGCGCAACTACGGGGGGGCCGGCCCGATACGCAGTATTTT	CAQLRGGRPDTQYF	TRBV11-3	TRBJ2-3
TGTGCCACCGAGGCCCAGGGGGCGATGGGGGAGGATGAAGCTTTCTTT	CATEAQGAMGEDEAFF	TRBV24-1	TRBJ1-1
TGTGCCACCAGTGGAGGTCGGAGACGAAGCACCGGGGAGCTGTTTTTT	CATSGGRRRSTGELFF	TRBV24-1	TRBJ2-2
TGTGCCAGCAGACTAGCGGGGGGGTTAGCCTACAATGAGCAGTTCTTC	CASRLAGGLAYNEQFF	TRBV28	TRBJ2-1
TGTGCCAGTAGTACTGGGACAGGAGGTGAAGCTTTCTTT	CASSTGTGGEAFF	TRBV19	TRBJ1-1
TGCGCCAGCAGCCAAGGAGGCTGGGGCTATGGCTACACCTTC	CASSQGGWGYGYTF	TRBV4-1	TRBJ1-2
TGTGCCAGCAGAGCAATGGGACAGGGGGGAAAGGGGGAGCCCCAGCATTTT	CASRAMGQGGKGEPQHF	TRBV6-5	TRBJ1-5
TGCGCCAGCAGTGAACTTTGGGTGGAAGAGACCCAGTACTTC	CASSELWVEETQYF	TRBV10-1	TRBJ2-5
TGTGCCAGCAGCCCCTATGGGGGGGTTTGTAGCACAGATACGCAGTATTTT	CASSPYGGVCSTDTQYF	TRBV7-3	TRBJ2-3
TGCGCCAGCAGCTTGGACCAGGGCGATGAAAAACTGTTTTTT	CASSLDQGDEKLFF	TRBV5-1	TRBJ1-4
TGTGCCTGGAGTGTACCGGGACAGGGGGATTGTCAGACCCAGTACTTC	CAWSVPGQGDCQTQYF	TRBV30	TRBJ2-5
TGTGCCAGCAGTCGAGATGAGCAGTTCTTC	CASSRDEQFF	TRBV27	TRBJ2-1
TGCACGAAACCCGTCTGGGGCGGACGAGACACTGAAGCTTTCTTT	CTKPVWGGRDTEAFF	TRBV20-1	TRBJ1-1
TGTGCCACCAGTGATTTTGGGGACAGGATATTAGCCAAAAACATTCAGTACTTC	CATSDFGDRILAKNIQYF	TRBV24-1	TRBJ2-4
TGTGCCAGCAGCCGCTTATCCCGGGAAGGGGTGAACACTGAAGCTTTCTTT	CASSRLSREGVNTEAFF	TRBV11-3	TRBJ1-1
TGTGCCAGCAGCTTAGATTCCTCCGAAGGCCCGACAGGGGGGGCAAGACCAGATACGCAGTATTTT	CASSLDSSEGPTGGARPDTQYF	TRBV11-3	TRBJ2-3
TGTGCCAGCAGCGTCGGGAACGGGACAGGCCTAAACACTGAAGCTTTCTTT	CASSVGNGTGLNTEAFF	TRBV7-3	TRBJ1-1
TGTGCCAGCAGCGTATTCGCGGGAGGGAACTATAGCAATCAGCCCCAGCATTTT	CASSVFAGGNYSNQPQHF	TRBV7-9	TRBJ1-5
TGTGCCATCCGCCGAGGGACTAGCGGGGGGGCTAGAGGCTACGAGCAGTACTTC	CAIRRGTSGGARGYEQYF	TRBV11-2	TRBJ2-7
TGTGCCAGCACTTCCGGGACAGGGGGTTACATGGAGGCTGAAGCTTTCTTT	CASTSGTGGYMEAEAFF	TRBV27	TRBJ1-1
TGTGCCAGCAGCTTACGGTGGGGGGGACATCCGATATATGAGCAGTTCTTC	CASSLRWGGHPIYEQFF	TRBV11-2	TRBJ2-1
TGTGCCTGGACCGGGACAGGGGATGGCTACACCTTC	CAWTGTGDGYTF	TRBV30	TRBJ1-2
TGTGCCACCAGTGATTTGGGGGCGGACTGGCAAGAGACCCAGTACTTC	CATSDLGADWQETQYF	TRBV24-1	TRBJ2-5
TGTGCCAGCAGTGCCTCTGACAGATACCACACTGAAGCTTTCTTT	CASSASDRYHTEAFF	TRBV6-4	TRBJ1-1
TGTGCCAGCAACCCGGACGGTCGGGCCTACAATGAGCAGTTCTTC	CASNPDGRAYNEQFF	TRBV12-3	TRBJ2-1
TGTGCCAGCAGTAATGGGGCTGGCCTTGCTAACTATGGCTACACCTTC	CASSNGAGLANYGYTF	TRBV2	TRBJ1-2
TGCAGCGTTCCCCGAGGTTCTATTAGCACAGATACGCAGTATTTT	CSVPRGSISTDTQYF	TRBV29-1	TRBJ2-3
TGTGCCAGCAGCCCAACAGGGGGGGGGATAAACCTCGTACTAGCGGACTATGGCTACACCTTC	CASSPTGGGINLVLADYGYTF	TRBV13	TRBJ1-2
TGTGCCAGCAGCCCTGGGGTCGGCGAAACTAATGAAAAACTGTTTTTT	CASSPGVGETNEKLFF	TRBV14	TRBJ1-4
TGCAGTGCTAGAATCCTAGGGGGGGGGGTCGGCTACAATGAGCAGTTCTTC	CSARILGGGVGYNEQFF	TRBV20-1	TRBJ2-1
TGCGCCAGCAGTCCGGGGGACAGGATGGGTTCCTACGAGCAGTACTTC	CASSPGDRMGSYEQYF	TRBV10-1	TRBJ2-7
TGTGCCAGCAGCTCGCCGGGACAGGGACTTTCACCCCTCCACTTT	CASSSPGQGLSPLHF	TRBV13	TRBJ1-6
TGTGCCAGCAGCACCCCTGACAGCTCTCCCTATTCTTACGAGCAGTACTTC	CASSTPDSSPYSYEQYF	TRBV13	TRBJ2-7
TGTGCCAGCAAAAATATACGAGGGACAAATATTAGGAATCAGCCCCAGCATTTT	CASKNIRGTNIRNQPQHF	TRBV7-9	TRBJ1-5
TGTGCCAGCAAGGAGGGACGGGACCGACAAGAGACCCAGTACTTC	CASKEGRDRQETQYF	TRBV7-9	TRBJ2-5
TGTGCCAGCAGTTTTGAGCACAGGGGGCATAAGACAGATACGCAGTATTTT	CASSFEHRGHKTDTQYF	TRBV12-4	TRBJ2-3
TGTGCCAGCAGTGAATACAGGACTGGCAATCAGCCCCAGCATTTT	CASSEYRTGNQPQHF	TRBV25-1	TRBJ1-5
TGCGCCAGCATTGGGACAGGTAGCTCCTACGAGCAGTACTTC	CASIGTGSSYEQYF	TRBV10-1	TRBJ2-7
TGTGCCAGCAGTTCCCGGCCAAGCACAGATACGCAGTATTTT	CASSSRPSTDTQYF	TRBV12-3	TRBJ2-3
TGCGCCAGCAGCAGCGGCAGTTCTACCGGGGAGCTGTTTTTT	CASSSGSSTGELFF	TRBV5-1	TRBJ2-2
TGTGCCAGCAGCGGCAGCTACGAGCAGTACTTC	CASSGSYEQYF	TRBV7-3	TRBJ2-7
TGTGCCTGGAGACGGCACAGGCTTGAAACGAGAGGCGGGGAGCTGTTTTTT	CAWRRHRLETRGGELFF	TRBV30	TRBJ2-2
TGTGCCAGCAGTGCGTACAGGGGGGGCCGTTCCTGCAATCAGCCCCAGCATTTT	CASSAYRGGRSCNQPQHF	TRBV28	TRBJ1-5
TGTGCCAGCAGTCATTGGAGACCCACCCCCCAGGGGAACTATGGCTACACCTTC	CASSHWRPTPQGNYGYTF	TRBV6-2	TRBJ1-2
TGTGCCAGTAGTATAGGGACTAGACAGTCCTACGAGCAGTACTTC	CASSIGTRQSYEQYF	TRBV19	TRBJ2-7
TGCAGTGCTCCGTACAGTGATGGAGTCACTAATGAAAAACTGTTTTTT	CSAPYSDGVTNEKLFF	TRBV20-1	TRBJ1-4
TGTGCCTCGTCGAGGCCCCAGCATTTT	CASSRPQHF	TRBV24-1	TRBJ1-5
TGTGCCAGCAGTGAAGCTCTCCCAATCCCAATTTCTCGGATGGGGGGGAAAGACTCTGGAAACACCATATATTTT	CASSEALPIPISRMGGKDSGNTIYF	TRBV6-1	TRBJ1-3
TGTGCCAGCAGCTTGCCGACGACAGGATCCGGTGATAGTGGCTACACCTTC	CASSLPTTGSGDSGYTF	TRBV11-2	TRBJ1-2
TGTGCCAGCAGCCAAGATCTACCGGAGGGGCTGACCCAGTACTTC	CASSQDLPEGLTQYF	TRBV3-1	TRBJ2-5
TGTGCCAGCAGTGGGGATGACGGAGCCAAAAACATTCAGTACTTC	CASSGDDGAKNIQYF	TRBV6-1	TRBJ2-4
TGTGCCACCAGTGATTTGCCTCCCTGGCCCAGGAACAATCAGCCCCAGCATTTT	CATSDLPPWPRNNQPQHF	TRBV24-1	TRBJ1-5
TGTGCCAGCAGAGGGACTAGCGGGCATACGCAGTATTTT	CASRGTSGHTQYF	TRBV5-4	TRBJ2-3
TGTGCCAGTAGTGGTGTGGACAGGGCAGCGAACACTGAAGCTTTCTTT	CASSGVDRAANTEAFF	TRBV19	TRBJ1-1
TGCGCCACTACTGGGCCAGGAACGAACACCGGGGAGCTGTTTTTT	CATTGPGTNTGELFF	TRBV5-1	TRBJ2-2
TGTGCCAGCACAGGGGGCATCGGTGAGCAGTTCTTC	CASTGGIGEQFF	TRBV6-4	TRBJ2-1
TGTGCCAGCAGCTTGGGTTACGTTCAGGCCTTTAGAAGGGACGAGCAGTACTTC	CASSLGYVQAFRRDEQYF	TRBV5-4	TRBJ2-7
TGTGCCACTAGCGGTACAGATACGCAGTATTTT	CATSGTDTQYF	TRBV7-9	TRBJ2-3
TGTGCCAGCAGTTTAGGAACTGGGACAGGGGATGGGTACGAGCAGTACTTC	CASSLGTGTGDGYEQYF	TRBV28	TRBJ2-7
TGCGCCAGCAGCTTGGGGAGGACTAGACCCCGGAATCCGGTCGGGTCGAACACCGGGGAGCTGTTTTTT	CASSLGRTRPRNPVGSNTGELFF	TRBV5-1	TRBJ2-2
TGCAGTCTTTCGACAGGGGGTTCGACTGAAGCTTTCTTT	CSLSTGGSTEAFF	TRBV20-1	TRBJ1-1
TGTGCCAGCAGCTTTTCTCCTGACCGACAGGGGTGGTGCTATGGCTACACCTTC	CASSFSPDRQGWCYGYTF	TRBV7-2	TRBJ1-2
TGTGCCAGCAGTTACCTAACTGCAACCCCGACCCAGTACTTC	CASSYLTATPTQYF	TRBV6-3	TRBJ2-5
TGCAGTGCTAGCAGGGGGGAAGTAAGGTACCAAGAGACCCAGTACTTC	CSASRGEVRYQETQYF	TRBV20-1	TRBJ2-5
TGTGCCAGCAGCTTAGAAGGGACAGCAATTTGTCGCGATGAGCAGTTCTTC	CASSLEGTAICRDEQFF	TRBV11-2	TRBJ2-1
TGCAGTGCTAGAGAGGAAGGACTAGAGGGATCCTACAATGAGCAGTTCTTC	CSAREEGLEGSYNEQFF	TRBV20-1	TRBJ2-1
TGTGCCACCAGTGCCTTGGTAAACCATAGCAATGAGCAGTTCTTC	CATSALVNHSNEQFF	TRBV24-1	TRBJ2-1
TGCGCCAGCAGCAGATACGCCAAAAACATTCAGTACTTC	CASSRYAKNIQYF	TRBV5-1	TRBJ2-4
TGCGCCAGCAGCCAACCGGGACAGGTCCGCACTGAAGCTTTCTTT	CASSQPGQVRTEAFF	TRBV4-1	TRBJ1-1
TGCAGTGTCCTTGAACAGTGTCGACGTGACGACGCCAAAAACATTCAGTACTTC	CSVLEQCRRDDAKNIQYF	TRBV20-1	TRBJ2-4
TGTGCCAGCAGTTCCAGTCCTAACTACGAGCAGTACTTC	CASSSSPNYEQYF	TRBV12-3	TRBJ2-7
TGCGCCAGCAGCTTGCGAGGGGGGGGGAACACTGAAGCTTTCTTT	CASSLRGGGNTEAFF	TRBV5-1	TRBJ1-1
TGCGCCAGCAGTGAGGAAAGCAAGAGCACTGAAGCTTTCTTT	CASSEESKSTEAFF	TRBV10-2	TRBJ1-1
TGCGCCAGCAGCAGGGGGGGAAATGTGACTAACTATGGCTACACCTTC	CASSRGGNVTNYGYTF	TRBV5-1	TRBJ1-2
TGTGCCAGCAGCTTAGGGCAGGGGGCGGTGTACTATGGCTACACCTTC	CASSLGQGAVYYGYTF	TRBV7-4	TRBJ1-2
TGCAGTGCTAGGCCCCCGGGACGAGCGGCAGAGAATTCACCCCTCCACTTT	CSARPPGRAAENSPLHF	TRBV20-1	TRBJ1-6
TGCAGTGCTCCCAGAGGTTATCCTAGCGGGTCTCCCGGGGAGCTGTTTTTT	CSAPRGYPSGSPGELFF	TRBV20-1	TRBJ2-2
TGTGCCAGCAGTTTGTTCGAGGGGGAATTGGTTTGGGACGAGCAGTACTTC	CASSLFEGELVWDEQYF	TRBV28	TRBJ2-7
TGTGCCAGCAGTGAAAAGGACCGGCCCCCCTACGAGCAGTACTTC	CASSEKDRPPYEQYF	TRBV27	TRBJ2-7
TGCAGTGCTTGGAACGGACTAGCGGGGGTCTCAAAGAAAAGTAATGAGCAGTTCTTC	CSAWNGLAGVSKKSNEQFF	TRBV20-1	TRBJ2-1
TGCGCCAGCAGCTTAACAGCGAAGTCATATAGCAATCAGCCCCAGCATTTT	CASSLTAKSYSNQPQHF	TRBV5-1	TRBJ1-5
TGCGCCAGCAGCCAAGGCCGGACTAGCGGGCTAGGGTACAATGAGCAGTTCTTC	CASSQGRTSGLGYNEQFF	TRBV4-3	TRBJ2-1
TGTGCCAGCAGGGGGCGGAGTCAGACCCAGTACTTC	CASRGRSQTQYF	TRBV12-3	TRBJ2-5
TGTGCCAGCAGCCAAGTGCTAGCGGGCACAGATACGCAGTATTTT	CASSQVLAGTDTQYF	TRBV3-1	TRBJ2-3
TGCGCCAGCAGCTTGCACTTTGGGGCGGGAGAGACCCAGTACTTC	CASSLHFGAGETQYF	TRBV5-1	TRBJ2-5
TGTGCCAGCAGTTTATGGACCCGGGTCCCGGACATCCCAAGAAACACCATATATTTT	CASSLWTRVPDIPRNTIYF	TRBV27	TRBJ1-3
TGTGCCAGCAGTTTGGTCCCTCTCAGGGGGCGGAATACAAATCAGCCCCAGCATTTT	CASSLVPLRGRNTNQPQHF	TRBV28	TRBJ1-5
TGTGCCAGCAGTTACGCCGACAGGGCCCCCGACGCGGAAAAACTGTTTTTT	CASSYADRAPDAEKLFF	TRBV6-5	TRBJ1-4
TGTGCCAGCAGCGTAATCTTAGTTCACAATGAGCAGTTCTTC	CASSVILVHNEQFF	TRBV9	TRBJ2-1
TGCAGTGCCGGGGGGGGGGGAAGTTGTGAGCAGTTCTTC	CSAGGGGSCEQFF	TRBV20-1	TRBJ2-1
TGCAGTGCTAGAGATCGCGGGCCGGCTAATGAAAAACTGTTTTTT	CSARDRGPANEKLFF	TRBV20-1	TRBJ1-4
TGCGCCAGCAGCCGGGGAATCTACCCACTCATCCGGGACAGGGGGGCCACCTCTGGAAACACCATATATTTT	CASSRGIYPLIRDRGATSGNTIYF	TRBV5-1	TRBJ1-3
TGTGCCAGCAGCCTAGCTACCCCGGGACAGGGCCAAAAGGAGCAGTTCTTC	CASSLATPGQGQKEQFF	TRBV14	TRBJ2-1
TGTGCCAGCAGCTTCTGGCTAGCGGGGCCTACGCAGTATTTT	CASSFWLAGPTQYF	TRBV11-2	TRBJ2-3
TGTGCCAGCAGTTCGGTCGGGGGCCCCGGGGAATATGGCTACACCTTC	CASSSVGGPGEYGYTF	TRBV6-5	TRBJ1-2
TGTGCCAGCAGTAGTAGAAACTCCCACATTATGGAGACCCAGTACTTC	CASSSRNSHIMETQYF	TRBV28	TRBJ2-5
TGTGCCAGCAACGGGAGGTGCGGGGAGCTGTTTTTT	CASNGRCGELFF	TRBV7-4	TRBJ2-2
TGTGCCATCAGGTGCTTGGACAGGCGATACGAGCAGTACTTC	CAIRCLDRRYEQYF	TRBV10-3	TRBJ2-7
TGTGCCAGCACAGGGCGGCGGACTGAAGCTTTCTTT	CASTGRRTEAFF	TRBV12-4	TRBJ1-1
TGTGCCAGCACCACAGGGCAGGGGAACACTGAAGCTTTCTTT	CASTTGQGNTEAFF	TRBV27	TRBJ1-1
TGCGCCAGCAGTGAGGCGACAGGCCGGCCAACGTACCAAGAGACCCAGTACTTC	CASSEATGRPTYQETQYF	TRBV10-1	TRBJ2-5
TGTGCTAGTGCGAAGGACAGGGGTCCGGAACAGTGTCTCCAAGCTTTCTTT	CASAKDRGPEQCLQAFF	TRBV12-5	TRBJ1-1
TGTGCCAGGACAGGGGACTCCTACGAGCAGTACTTC	CARTGDSYEQYF	TRBV12-3	TRBJ2-7
TGTGCCAGCGCAGGGCAAAGGACCTACAATGAGCAGTTCTTC	CASAGQRTYNEQFF	TRBV5-6	TRBJ2-1
TGCGCCAGCAATCACAGGGGGGGAGATTATGAGCAGTACTTC	CASNHRGGDYEQYF	TRBV5-1	TRBJ2-7
TGTGCCAGCAGAGGGAAAGGTTTCAATCAGCCCCAGCATTTT	CASRGKGFNQPQHF	TRBV7-2	TRBJ1-5
TGCAGTGCTAGAGCCGTGACTAGTTCGGCACAAAGAGAGACCCAGTACTTC	CSARAVTSSAQRETQYF	TRBV20-1	TRBJ2-5
TGTGCCACGCCATCTCCCGGGGATCCGAATCAGCCCCAGCATTTT	CATPSPGDPNQPQHF	TRBV24-1	TRBJ1-5
TGTGCCAGCTCCTATCGACAGGGGGCAACTGAAGCTTTCTTT	CASSYRQGATEAFF	TRBV18	TRBJ1-1
TGTGCCAGCAGCGTAGGGTCAGGCTCCTACGAGCAGTACTTC	CASSVGSGSYEQYF	TRBV9	TRBJ2-7
TGCAGTGCTAGCAGGGCGGGCTATGGCTACACCTTC	CSASRAGYGYTF	TRBV20-1	TRBJ1-2
TGCAGCGTTCTAGGGAATCCTCTCTACGAGCAGTACTTC	CSVLGNPLYEQYF	TRBV29-1	TRBJ2-7
TGTGCCAGCAGCTTTCTCACGGGCTATGACAATCAGCCCCAGCATTTT	CASSFLTGYDNQPQHF	TRBV7-4	TRBJ1-5
TGTGCCAGCAGCTTTACGGGCACAGATACGCAGTATTTT	CASSFTGTDTQYF	TRBV7-6	TRBJ2-3
TGTGCCAGCAGCTTGGAACCTGACAAATGCTCCTATAATTCACCCCTCCACTTT	CASSLEPDKCSYNSPLHF	TRBV7-2	TRBJ1-6
TGTGCCACGGATAGAGCTGAAGCTTTCTTT	CATDRAEAFF	TRBV6-2	TRBJ1-1
TGTGCCATCAGTGAGTTAGGCAGGGTCTATCCGCAGTATTTT	CAISELGRVYPQYF	TRBV10-3	TRBJ2-3
TGTGCCAGCAGTCACTTCCCCATCAGGGATATGAAGAAGCATAGAGGCAATCAGCCCCAGCATTTT	CASSHFPIRDMKKHRGNQPQHF	TRBV12-4	TRBJ1-5
TGTGCCAGCAGTTTCTATGACAGCCTCAATCAGCCCCAGCATTTT	CASSFYDSLNQPQHF	TRBV28	TRBJ1-5
TGTGCCAGCAACGGCGCAGGGACCCAGTACTTC	CASNGAGTQYF	TRBV6-1	TRBJ2-5
TGTGCCAGCAGCACACTAAAAGAGATTAAAGGCTACGAGCAGTACTTC	CASSTLKEIKGYEQYF	TRBV14	TRBJ2-7
TGTGCCAGTGACTCTCCCTTACGGCCACGCGTGTCCTACGAGCAGTACTTC	CASDSPLRPRVSYEQYF	TRBV19	TRBJ2-7
TGTGCCAGCAGCCAAGATAAAGCAGGGGGGGAAAACGAGCAGTACTTC	CASSQDKAGGENEQYF	TRBV3-1	TRBJ2-7
TGTGCCAGCAGCTGCCTAATGGGAGATCTTGAAGCTTTCTTT	CASSCLMGDLEAFF	TRBV11-2	TRBJ1-1
TGTGCCAGCAGTTTATTTAGTCCCAGGGGGACTGAAGCTTTCTTT	CASSLFSPRGTEAFF	TRBV12-3	TRBJ1-1
TGTGCCAGCAGTTTTCGTAAGTTGCAGATAAACATTCAGTACTTC	CASSFRKLQINIQYF	TRBV12-3	TRBJ2-4
TGTGCCAGCAGTCCGGGGAGAAACACCATATATTTT	CASSPGRNTIYF	TRBV27	TRBJ1-3
TGTGCCAGCAGTTTTTTCAGAGGCAGGGGGGAACGGGAGGGGCAGTTCTTC	CASSFFRGRGEREGQFF	TRBV28	TRBJ2-1
TGCGCCAGCAGAAGGGGAGAGAATGAGCAGTTCTTC	CASRRGENEQFF	TRBV10-1	TRBJ2-1
TGTGCCAGCAGCAATCTAACAAGGGAGACAGATACGCAGTATTTT	CASSNLTRETDTQYF	TRBV12-4	TRBJ2-3
TGTGCCAGCAGCAGCGAACGGACTAGCACAGATACGCAGTATTTT	CASSSERTSTDTQYF	TRBV7-9	TRBJ2-3
TGTGCCAGCAGCCAACCGACAGGGCCCCGGTGGCATTTT	CASSQPTGPRWHF	TRBV14	TRBJ1-5
TGTGCCACACTTAGCGTAAGAGCGTACGAGCAGTACTTC	CATLSVRAYEQYF	TRBV19	TRBJ2-7
TGCGCCACGTGCCCCAAGCTTCTAATGACCGGGGAGCTGTTTTTT	CATCPKLLMTGELFF	TRBV4-1	TRBJ2-2
TGCGCCAGCAGCCAAGAGGGAGGGGAAGTTATTTGTTCACCCCTCCACTTT	CASSQEGGEVICSPLHF	TRBV4-1	TRBJ1-6
TGTGCCAGCAGCGTACAGGGGGGCTACGAGCAGTACTTC	CASSVQGGYEQYF	TRBV13	TRBJ2-7
TGTGCCAGCAGCTTGGGGTGGCACTCCTACGAGCAGTACTTC	CASSLGWHSYEQYF	TRBV5-6	TRBJ2-7
TGTGCCAGCAGCCGCCGGGACAGCCACGAGCAGTACTTC	CASSRRDSHEQYF	TRBV13	TRBJ2-7
TGTGCCAGCAGTCCTCTGGGGAGAGGCTACAATCAGCCCCAGCATTTT	CASSPLGRGYNQPQHF	TRBV6-5	TRBJ1-5
TGTGCCAGCAGCCAACCTAGGGAGACAAGGCAGTTCTTC	CASSQPRETRQFF	TRBV3-1	TRBJ2-1
TGCGCCAGCAGGGGTATCCAGGGGGCGTGCTCCTACGAGCAGTACTTC	CASRGIQGACSYEQYF	TRBV4-1	TRBJ2-7
TGTGCCAGCAGTCAAGGTGGCGGGAGAGGATACAATGAGCAGTTCTTC	CASSQGGGRGYNEQFF	TRBV27	TRBJ2-1
TGTGCCTGGGGGACTCTCTACGAGCAGTACTTC	CAWGTLYEQYF	TRBV30	TRBJ2-7
TGTGCCAGCAGCTTCCCGAGGGTTGATAATGAGCAGTTCTTC	CASSFPRVDNEQFF	TRBV7-7	TRBJ2-1
TGTGCCAGCAGTTTACGACAGGGGGAGAATGAAAAACTGTTTTTT	CASSLRQGENEKLFF	TRBV27	TRBJ1-4
TGTGCCAGCAGCCTAGAAGGACAGGGGAGAAAGCTGTTTTTT	CASSLEGQGRKLFF	TRBV5-6	TRBJ1-4
TGTGCTAGCAGCTTGTCCTTTTGGGGGGATCATCAAGAGACCCAGTACTTC	CASSLSFWGDHQETQYF	TRBV7-7	TRBJ2-5
TGTGCCAGCAGTGGCCGGGACAGGGGGGGCCGCCCTGAAGCTTTCTTT	CASSGRDRGGRPEAFF	TRBV2	TRBJ1-1
TGTGCCATCCTCATCGACAGGGTGGGTAATGGCTACACCTTC	CAILIDRVGNGYTF	TRBV19	TRBJ1-2
TGTGCCAGCAGGAGGGACGGGGCTAGCAATCAGCCCCAGCATTTT	CASRRDGASNQPQHF	TRBV4-2	TRBJ1-5
TGTGCCATCATCTTCAAACTAGGGACAACGGCCGATGAGCAGTTCTTC	CAIIFKLGTTADEQFF	TRBV10-3	TRBJ2-1
TGTGCCAGTAGTAGACATCGCACAGATACGCAGTATTTT	CASSRHRTDTQYF	TRBV19	TRBJ2-3
TGCGCCAGCAGCCAAGAAAGGACAGGGAGCTCCCAGTGCAATCAGCCCCAGCATTTT	CASSQERTGSSQCNQPQHF	TRBV4-1	TRBJ1-5
TGTGCCAGCAGTTACTCAACGCTAGGCTTCGGGGATGGCTACACCTTC	CASSYSTLGFGDGYTF	TRBV6-2	TRBJ1-2
TGCAGTGCTAGTCGATGGGGGCGGACAGGGAGGGGTTTGAACACTGAAGCTTTCTTT	CSASRWGRTGRGLNTEAFF	TRBV20-1	TRBJ1-1
TGTGCCAGCAGCTTACCCAGGACTAGCGGGGGCTATGAGCAGTTCTTC	CASSLPRTSGGYEQFF	TRBV11-3	TRBJ2-1
TGTGCCAGTACCCTAAGGACCTACGAGCAGTACTTC	CASTLRTYEQYF	TRBV19	TRBJ2-7
TGCGTTACAGGGAAAGCAGTTAGCTTCTCCTACGAGCAGTACTTC	CVTGKAVSFSYEQYF	TRBV10-1	TRBJ2-7
TGCGCCAGCAGCCAAGACTACCAAGCGGGCCCCCTCAATTCACCCCTCCACTTT	CASSQDYQAGPLNSPLHF	TRBV4-1	TRBJ1-6
TGTGCCAGCAGTGAAGAACCTGGACGGGAGCAGTACTTC	CASSEEPGREQYF	TRBV6-1	TRBJ2-7
TGTGCCAGCAGCGTAGGTCGGACAGTTATGTTCTATGGCTACACCTTC	CASSVGRTVMFYGYTF	TRBV9	TRBJ1-2
TGCAGTGCCATAGGAGTGCCACCCTATAATTCACCCCTCCACTTT	CSAIGVPPYNSPLHF	TRBV20-1	TRBJ1-6
TGCAGTGCTAGAGGGGCCCACTATGGCTACACCTTC	CSARGAHYGYTF	TRBV20-1	TRBJ1-2
TGTGCCAGCAGCCAAGTCCGGGAGGGGGGGCCAGGGGTCTCCTACGAGCAGTACTTC	CASSQVREGGPGVSYEQYF	TRBV3-1	TRBJ2-7
TGTGCCAGCAGCCAAGACCCTCGGGGGGCGGTTCACACTGAAGCTTTCTTT	CASSQDPRGAVHTEAFF	TRBV3-1	TRBJ1-1
TGTGCCAGCAGCTTGATGGGGCCCTACGAGCAGTACTTC	CASSLMGPYEQYF	TRBV5-6	TRBJ2-7
TGTGCCAGAAAGTTTCGGGGGGGTAACGAGCAGTACTTC	CARKFRGGNEQYF	TRBV12-3	TRBJ2-7
TGTGCCAGCAGCGCGAGAGCAGAGACCCAGTACTTC	CASSARAETQYF	TRBV9	TRBJ2-5
TGTGCCAGCTCACCAAGTAGCAATCAGCCCCAGCATTTT	CASSPSSNQPQHF	TRBV18	TRBJ1-5
TGTGCCAGTAGCAACAGCCGTTGCGAGCAGTACTTC	CASSNSRCEQYF	TRBV19	TRBJ2-7
TGTGCCAGTCCCTTCAGATGCGGGCAGCCCCAGCATTTT	CASPFRCGQPQHF	TRBV6-5	TRBJ1-5
TGCAGTGCTAGAGAAGGACGGACTAGCGTTACAAAAGGGGAACAAGAGACCCAGTACTTC	CSAREGRTSVTKGEQETQYF	TRBV20-1	TRBJ2-5
TGTGCCAGCATAGGGGGGACAGGGTGCACTGAAGCTTTCTTT	CASIGGTGCTEAFF	TRBV12-4	TRBJ1-1
TGTGCCAGCAGGCTGGGGAGATACAATGAGCAGTTCTTC	CASRLGRYNEQFF	TRBV7-6	TRBJ2-1
TGTGCCAGCAAGGGCACTGAAGCTTTCTTT	CASKGTEAFF	TRBV28	TRBJ1-1
TGTGCCAGCAGTGACCCGGAGACAGGGTTGTATGGCTACACCTTC	CASSDPETGLYGYTF	TRBV6-4	TRBJ1-2
TGTGCCAGCAGCCAAGCTCCGGGACTAGGGTACAATGAGCAGTTCTTC	CASSQAPGLGYNEQFF	TRBV3-1	TRBJ2-1
TGTGCCAGCAGTTATGGGGTGGGGAATTCACCCCTCCACTTT	CASSYGVGNSPLHF	TRBV6-5	TRBJ1-6
TGTGCCACCAGTAGTCGGAGACAGTACCCGAACACTGAAGCTTTCTTT	CATSSRRQYPNTEAFF	TRBV24-1	TRBJ1-1
TGTGCCAGCAGCGTAGCCCGGGCCCGGCCCCCGGGCTACGAGCAGTACTTC	CASSVARARPPGYEQYF	TRBV9	TRBJ2-7
TGCAGCGTTGCTTGCGGGCTGTTTTTT	CSVACGLFF	TRBV29-1	TRBJ1-4
TGCGCCAGCAGCTTGTTACCCCAGGGGAAAGGCAATCAGCCCCAGCATTTT	CASSLLPQGKGNQPQHF	TRBV5-1	TRBJ1-5
TGCAGTGCGCAACTCGGGGGGCTTTATGGCTACACCTTC	CSAQLGGLYGYTF	TRBV20-1	TRBJ1-2
TGCGCCAGCAGAAGGTCCGATCCCATTAGCAATCAGCCCCAGCATTTT	CASRRSDPISNQPQHF	TRBV5-1	TRBJ1-5
TGTGCCAGCAGCGCCGAAATCAACGGCTACGAGCAGTACTTC	CASSAEINGYEQYF	TRBV9	TRBJ2-7
TGTGCCAGCAGCTGGGACAGGGGTAGGAATGAAAAACTGTTTTTT	CASSWDRGRNEKLFF	TRBV11-2	TRBJ1-4
TGTGCCAGCAGTTACGTCAGGCAGCCCCAGCATTTT	CASSYVRQPQHF	TRBV6-6	TRBJ1-5
TGTGCCACCAGCAGAGATGCCCACCAGCGTTTGAACACTGAAGCTTTCTTT	CATSRDAHQRLNTEAFF	TRBV15	TRBJ1-1
TGTGCCAGCAGTTTCCGTGGGGTTCGAGCCGGTGCTAATGAAAAACTGTTTTTT	CASSFRGVRAGANEKLFF	TRBV12-3	TRBJ1-4
TGTGCCAGCAGCGGGGAGGGATTCTTC	CASSGEGFF	TRBV13	TRBJ2-1
TGTGCCAGCAGCCGGCGGGACCAGAGCAATCAGCCCCAGCATTTT	CASSRRDQSNQPQHF	TRBV5-6	TRBJ1-5
TGTGCCAGCAGTTTACCCCCGAGGACGGCAGATACGCAGTATTTT	CASSLPPRTADTQYF	TRBV27	TRBJ2-3
TGTGCCAGCAGGGGACAGGTCCAAGAGACCCAGTACTTC	CASRGQVQETQYF	TRBV28	TRBJ2-5
TGTGCCAGCAGCGAGGGGGCAAAGTTAATTCAAGAGACCCAGTACTTC	CASSEGAKLIQETQYF	TRBV9	TRBJ2-5
TGCGCCAGCGGGAGGACTAGCGGGGAGTGCGAGACCCAGTACTTC	CASGRTSGECETQYF	TRBV5-1	TRBJ2-5
TGTGCCAGCAGCTCAGGGTCGGACACCGGGGAGCTGTTTTTT	CASSSGSDTGELFF	TRBV11-3	TRBJ2-2
TGTGCCAGCACAACCAAGGTGGTTGGGGGGACAGGGGAAGATGAAGCTTTCTTT	CASTTKVVGGTGEDEAFF	TRBV27	TRBJ1-1
TGTGCCAGCAGCTCCCGGACGGTGGGGGGCCCCAAAAGCTCCTACAATGAGCAGTTCTTC	CASSSRTVGGPKSSYNEQFF	TRBV5-6	TRBJ2-1
TGTGCCAGAGGGGGGCCTCCGGGACAGGCCCTGTACGAGCAGTACTTC	CARGGPPGQALYEQYF	TRBV6-4	TRBJ2-7
TGTGCCAGTTATCTAGCGGGCCAAGAGACCCAGTACTTC	CASYLAGQETQYF	TRBV7-9	TRBJ2-5
TGTGCCAGCAGAGTGACTAGCGGGGGGAAGGCGAACACCGGGGAGCTGTTTTTT	CASRVTSGGKANTGELFF	TRBV6-1	TRBJ2-2
TGTGCCAGCAGCCGGGGGATAGAAAAACTGTTTTTT	CASSRGIEKLFF	TRBV5-6	TRBJ1-4
TGTGCCCCCCCTGATGACACCGGGGAGCTGTTTTTT	CAPPDDTGELFF	TRBV27	TRBJ2-2
TGTGCCACCCAATCGGACAGCAGGAATGGAGGTTCTTACTACGAGCAGTACTTC	CATQSDSRNGGSYYEQYF	TRBV13	TRBJ2-7
TGTGCCAGCAGCTTCAACAGGGAACCAGATACGCAGTATTTT	CASSFNREPDTQYF	TRBV11-2	TRBJ2-3
TGTGCCATGTCCTATGGACAGGGGAAGGGGAATCAGCCCCAGCATTTT	CAMSYGQGKGNQPQHF	TRBV6-1	TRBJ1-5
TGTGCCAGCAGTTACCCGTGGGACAGAGGAATGAGAGGGACCCAGCATTTT	CASSYPWDRGMRGTQHF	TRBV6-3	TRBJ1-5
TGTGCCAGCACGGGGGATCAGCCCCAGCATTTT	CASTGDQPQHF	TRBV6-1	TRBJ1-5
TGTGCCAGCAGCAGGGGGACAGGGGTATCTAATTCACCCCTCCACTTT	CASSRGTGVSNSPLHF	TRBV6-6	TRBJ1-6
TGTGCCAGCCCCTCTGGACTAGCGGGAAATTTAGATACGCAGTATTTT	CASPSGLAGNLDTQYF	TRBV5-6	TRBJ2-3
TGCGCCAGCAGCGTGACAGGGGAGTTTCAGCCCCAGCATTTT	CASSVTGEFQPQHF	TRBV4-1	TRBJ1-5
TGTGCCAGCAGTTTGAGGACTAGCCTCTTTAGGAACACCGGGGAGCTGTTTTTT	CASSLRTSLFRNTGELFF	TRBV12-3	TRBJ2-2
TGTGCCAGCAGCCCCCTCCCGGCAGGGGGGGCCAATGAGCAGTTCTTC	CASSPLPAGGANEQFF	TRBV7-3	TRBJ2-1
TGTGCCAGCAGCTGCCAGGGGGTTTCCTACGAGCAGTACTTC	CASSCQGVSYEQYF	TRBV11-1	TRBJ2-7
TGTGCCAGCATTGACAATCTAATTTTTTCCACTGAAGCTTTCTTT	CASIDNLIFSTEAFF	TRBV6-1	TRBJ1-1
TGTGCCAGCAGAGGGCGATATGAGACCCAGTACTTC	CASRGRYETQYF	TRBV6-5	TRBJ2-5
TGTGCCAGCTCACCGCTGGACAGGGGATTACAAGAGACCCAGTACTTC	CASSPLDRGLQETQYF	TRBV18	TRBJ2-5
TGTGCGACCCTCTGGGGGATGGTTAAAAGCTACGAGCAGTACTTC	CATLWGMVKSYEQYF	TRBV9	TRBJ2-7
TGTGCCAGCAGCGTAGGGGGGGTTTATAGCAATCAGCCCCAGCATTTT	CASSVGGVYSNQPQHF	TRBV9	TRBJ1-5
TGTGCCAGGAGCGAGACAGGGTGCATGAACACTGAAGCTTTCTTT	CARSETGCMNTEAFF	TRBV27	TRBJ1-1
TGCAGTGCTAGAGATCGAAGTACTAGCGGGAGGGTGTATGGCTACACCTTC	CSARDRSTSGRVYGYTF	TRBV20-1	TRBJ1-2
TGTGCCAGCAGCTTAGATCTGTGGAATCGGGGGGGCAGATGCTACGAGCAGTACTTC	CASSLDLWNRGGRCYEQYF	TRBV11-3	TRBJ2-7
TGTGCCAGCAGCTCCCCGAGGACAGGGGTTTCCTACGAGCAGTACTTC	CASSSPRTGVSYEQYF	TRBV4-2	TRBJ2-7
TGTGCCTGGAGTGCTCAGGGGGAGGAGTTCCCCACTGAAGCTTTCTTT	CAWSAQGEEFPTEAFF	TRBV30	TRBJ1-1
TGTGCCAGCAGAACAGGGGGCCAGCCCCAGCATTTT	CASRTGGQPQHF	TRBV6-1	TRBJ1-5
TGTGCCAGCAGTGACGACAGCCATAATCAGCCCCAGCATTTT	CASSDDSHNQPQHF	TRBV6-4	TRBJ1-5
TGTGCCAGCAGTTTTAGGGACGCCCCCGCTGAAGCTTTCTTT	CASSFRDAPAEAFF	TRBV27	TRBJ1-1
TGTGCCACCCGCCCACAGGAGGCCTGGAACACTGAAGCTTTCTTT	CATRPQEAWNTEAFF	TRBV24-1	TRBJ1-1
TGTGCCAGCAGCGTTAGGAAGCGCTACAATGAGCAGTTCTTC	CASSVRKRYNEQFF	TRBV5-4	TRBJ2-1
TGCAGCGTTGTCACCCTTCTCTTAGGGCCCGCCTACGAGCAGTACTTC	CSVVTLLLGPAYEQYF	TRBV29-1	TRBJ2-7
TGCGCCAGCAGCAGGACAGGTTGCTACGAGCAGTACTTC	CASSRTGCYEQYF	TRBV5-1	TRBJ2-7
TGTGCCACCAGTGATTCGAGACTAGCGGGCGATGAGCAGTTCTTC	CATSDSRLAGDEQFF	TRBV24-1	TRBJ2-1
TGTGCCAGCAGCCCCGGGGGGCTAGCAGATACGCAGTATTTT	CASSPGGLADTQYF	TRBV13	TRBJ2-3
TGTGCCTGGAGCGTCCGACTAGGACCCTACGAGCAGTACTTC	CAWSVRLGPYEQYF	TRBV30	TRBJ2-7
TGCGCCGAGGGATTTGGTCGAGCTTTGCCCTCGAACACCGGGGAGCTGTTTTTT	CAEGFGRALPSNTGELFF	TRBV10-1	TRBJ2-2
TGTGCCAGCAGTGTGACCAGGGGCCGAAATGAAAAACTGTTTTTT	CASSVTRGRNEKLFF	TRBV25-1	TRBJ1-4
TGTGCCAGCAGCTTAGCTGGCAGGGCTCTCTCCTACAATGAGCAGTTCTTC	CASSLAGRALSYNEQFF	TRBV7-9	TRBJ2-1
TGTGCCAGCTCACCAGGGACTAGCGGAGGAGCACACTACGAGCAGTACTTC	CASSPGTSGGAHYEQYF	TRBV18	TRBJ2-7
TGCGCCAGCAGCGCAATTAAACTCGTCAGGGACGAGCAGTACTTC	CASSAIKLVRDEQYF	TRBV5-1	TRBJ2-7
TGTGCCAGTAGCGAAGGCTACACCTTC	CASSEGYTF	TRBV19	TRBJ1-2
TGTGCCAGCAGACAAACCCGGGACAGGGAAGGGGGCCCTAGACCCACTGAAGCTTTCTTT	CASRQTRDREGGPRPTEAFF	TRBV12-3	TRBJ1-1
TGCGCCAAGAATGCGAGGAATGAGCAGTTCTTC	CAKNARNEQFF	TRBV5-1	TRBJ2-1
TGTGCCACCAGTGAGGGAGGGGGGGGTAGCACAGATACGCAGTATTTT	CATSEGGGGSTDTQYF	TRBV24-1	TRBJ2-3
