TGTGCCAGCAGCTTATCAAGGGAAGAGCAGTACTTC	CASSLSREEQYF	TRBV7-9	TRBJ2-7
TGTGCCAGCAGCATCCCTCCCCAGGGAGGTCACACTGAAGCTTTCTTT	CASSIPPQGGHTEAFF	TRBV7-9	TRBJ1-1
TGTGCCAGCAGGTCGCCCCCCAGGGGCTTC	CASRSPPRGF	TRBV7-8	TRBJ2-5
TGTAAGGGGCCGGGCGATGAAAAACTGTTTTTT	CKGPGDEKLFF	TRBV6-6	TRBJ1-4
TGCGCCAGCAGCTTGTTCGAACCTCAGAACACTGAAGCTTTCTTT	CASSLFEPQNTEAFF	TRBV5-1	TRBJ1-1
TGTGCCACCAGTGGTTACCTTCCTAAGTATGAGCAGTTCTTC	CATSGYLPKYEQFF	TRBV24-1	TRBJ2-1
TGTGCCAGCACGGGGGAACAGGGGGAGGAAAAACTGTTTTTT	CASTGEQGEEKLFF	TRBV27	TRBJ1-4
TGCAGTGCTAGAGCCTCCCGGGACAGTTGTTCCTATGGCTACACCTTC	CSARASRDSCSYGYTF	TRBV20-1	TRBJ1-2
TGTGCCAGCAGCCACGACAGGGAGTTGTACGAGCAGTACTTC	CASSHDRELYEQYF	TRBV6-2	TRBJ2-7
TGCATCGCAACGCGTCTCAGGGAAACAGATACGCAGTATTTT	CIATRLRETDTQYF	TRBV20-1	TRBJ2-3
TGTGCCAGCAGCGCTGGACTAGCGAGGAACCTTGAGACCCAGTACTTC	CASSAGLARNLETQYF	TRBV14	TRBJ2-5
TGTGCCAGCAGTTACCGAGTAGGACAGGGCTACGAGCAGTACTTC	CASSYRVGQGYEQYF	TRBV6-6	TRBJ2-7
TGTGCCAGCAGCAAGTCTGAGGTTTCCAATGAAAAACTGTTTTTT	CASSKSEVSNEKLFF	TRBV13	TRBJ1-4
TGTGCCAGCAGCCCTTTAGGGCACTTTACTGGGGCCAACGTCCTGACTTTC	CASSPLGHFTGANVLTF	TRBV3-1	TRBJ2-6
TGCGCCAGCAGCCCAGGGAGCCGAAGCTACACCTTC	CASSPGSRSYTF	TRBV5-1	TRBJ1-2
TGTGCCAGCAGTGATCCGGGGGGGGGACCCTACGAGCAGTACTTC	CASSDPGGGPYEQYF	TRBV6-4	TRBJ2-7
TGTGCCAGCAGTATAGGGGGTGATCGGAGATACGAGCAGTACTTC	CASSIGGDRRYEQYF	TRBV6-1	TRBJ2-7
TGCGCCAGCAGCTTGGTTCCCAAGGGGCTGGGTGGTAATCAGCCCCAGCATTTT	CASSLVPKGLGGNQPQHF	TRBV5-1	TRBJ1-5
TGCGCCAGCAGCTTGCAGGGGGCCATTGAGCCCTACGAGCAGTACTTC	CASSLQGAIEPYEQYF	TRBV5-1	TRBJ2-7
TGCGCCAGCAGCCGCCAAATACAGGGGGCCCGTCGTACTGAAGCTTTCTTT	CASSRQIQGARRTEAFF	TRBV4-3	TRBJ1-1
TGTGCCAGCACTTCGACTAGCGGGGACAATGAGCAGTTCTTC	CASTSTSGDNEQFF	TRBV7-2	TRBJ2-1
TGTGCCAGCAGTGGCTGGGGTCCCCAGCCCCAGCATTTT	CASSGWGPQPQHF	TRBV12-4	TRBJ1-5
TGTGCCATCAGTGATGCCTGCCCCGGGGAGGGCACAGATACGCAGTATTTT	CAISDACPGEGTDTQYF	TRBV10-3	TRBJ2-3
TGTGCCACAATAGGGTCTGGGTTCTACGAGCAGTACTTC	CATIGSGFYEQYF	TRBV24-1	TRBJ2-7
TGTGCCAGCAGCCAACCCCCCACCGGGACAGGGTATCAGCCCCAGCATTTT	CASSQPPTGTGYQPQHF	TRBV14	TRBJ1-5
TGTGCCACCAGCAGAGAAGGGGGAGACAGGGACTTC	CATSREGGDRDF	TRBV15	TRBJ2-7
TGCGCCAGCAGCTTGGGGGGAAACTCGGCAACTAATGAAAAACTGTTTTTT	CASSLGGNSATNEKLFF	TRBV5-1	TRBJ1-4
TGCAGCCGCCAAAGGTACGGGACAGGTTGGGCAGCTTTCTTT	CSRQRYGTGWAAFF	TRBV29-1	TRBJ1-1
TGTGCCAGCAGCAGAGGACTTGCCCCCGGGACAGGGAAGGGGTATGGCTACACCTTC	CASSRGLAPGTGKGYGYTF	TRBV28	TRBJ1-2
TGTGCCAGCCGGACGGAGGTGAACAGGGGGGAAATGAACACTGAAGCTTTCTTT	CASRTEVNRGEMNTEAFF	TRBV11-1	TRBJ1-1
TGTGCCAGCAGCGTAAAAACAACGGGGGCCTACGAGCAGTACTTC	CASSVKTTGAYEQYF	TRBV7-3	TRBJ2-7
TGTGCCAGCAGCGTAGTTGCCGCTCCCCCCGGGACAGGACGCTATAGCAATCAGCCCCAGCATTTT	CASSVVAAPPGTGRYSNQPQHF	TRBV9	TRBJ1-5
TGTGCCATCAGTGACGGGGGGACATACGAGCAGTACTTC	CAISDGGTYEQYF	TRBV10-3	TRBJ2-7
TGTGCCACATCATGGGACAGGGCCGGCTTTAACTATGGCTACACCTTC	CATSWDRAGFNYGYTF	TRBV24-1	TRBJ1-2
TGCGCCAGCAGCCAAGACCATTCGATGAGGGAGATAGCCAAAAACATTCAGTACTTC	CASSQDHSMREIAKNIQYF	TRBV4-1	TRBJ2-4
TGTGCCAGCAGCTTAGGACACAATTACAATGAGCAGTTCTTC	CASSLGHNYNEQFF	TRBV7-2	TRBJ2-1
TGCAGTGCGATGGGCGCCGGGGAGAGAGGGGAGCTGTTTTTT	CSAMGAGERGELFF	TRBV20-1	TRBJ2-2
TGCGCCAGCAGTGAGTCGGGGACCCCCTATTTCGGCTACAATGAGCAGTTCTTC	CASSESGTPYFGYNEQFF	TRBV10-1	TRBJ2-1
TGCGCCAGCAGCTATCGACAGGGGTCCGCTAACTATGGCTACACCTTC	CASSYRQGSANYGYTF	TRBV5-1	TRBJ1-2
TGCAGTTCTACCGGAGAGACCCAGTACTTC	CSSTGETQYF	TRBV20-1	TRBJ2-5
TGTGCCGGCGGGGATAGCTCCTACAATGAGCAGTTCTTC	CAGGDSSYNEQFF	TRBV10-3	TRBJ2-1
TGTGCCAGCAGCACAACTAGCGGGAGTATGAGAGAGACCCAGTACTTC	CASSTTSGSMRETQYF	TRBV13	TRBJ2-5
TGTGCCAGCAGCTTTTTGAAGTCGCTCAGGGTCTGGTGGACCGGGGAGCTGTTTTTT	CASSFLKSLRVWWTGELFF	TRBV13	TRBJ2-2
TGTGCCAGCAGCGTTGGAACTAGCGGGAGCCGTACCCCGATCTACGAGCAGTACTTC	CASSVGTSGSRTPIYEQYF	TRBV7-9	TRBJ2-7
TGTGCCAGCAGCCCGGATCCCAGAGAGGGAGTAGCCAAAAACATTCAGTACTTC	CASSPDPREGVAKNIQYF	TRBV13	TRBJ2-4
TGTGCCCGCCACTGTTTCAATGAGCAGTTCTTC	CARHCFNEQFF	TRBV6-4	TRBJ2-1
TGTGCCAGCAGCGTAGAAGGCGGAGCCCCTTTCCCTTATAGCAATCAGCCCCAGCATTTT	CASSVEGGAPFPYSNQPQHF	TRBV9	TRBJ1-5
TGCGCCTCTCAAAGATTCTTACCGCCGATCCCCTCTGGAAACACCATATATTTT	CASQRFLPPIPSGNTIYF	TRBV5-1	TRBJ1-3
TGTGCCAGCAGCTTGGGCCAGGGGGACAGCTCTGGGGCCAACGTCCTGACTTTC	CASSLGQGDSSGANVLTF	TRBV5-6	TRBJ2-6
TGTGCCAGCAGTGATTCCGGAGGGCCCGACTATGGCTACACCTTC	CASSDSGGPDYGYTF	TRBV2	TRBJ1-2
TGTGCCACCAGTGAAACTTGGGGAGCGGATACTATGTACCAAGAGACCCAGTACTTC	CATSETWGADTMYQETQYF	TRBV24-1	TRBJ2-5
TGTGCCAGCAGCCAAGTCTTTAAGGGGTCCCCCTACAATGAGCAGTTCTTC	CASSQVFKGSPYNEQFF	TRBV4-2	TRBJ2-1
TGCAGTGCTAGAGATTGGCGCTCCGAGACTAGAGGAGCCAAAAACATTCAGTACTTC	CSARDWRSETRGAKNIQYF	TRBV20-1	TRBJ2-4
TGTGCCAGCAGTGATGTCGGCCGACTAGCGGGGCAGTTCTTC	CASSDVGRLAGQFF	TRBV6-4	TRBJ2-1
TGTGCCAGCAGCTCCGGGACAGGGCTCTCCTGCACAGATACGCAGTATTTT	CASSSGTGLSCTDTQYF	TRBV11-2	TRBJ2-3
TGTGCCAGCTTGGAGGGTGCCTACGAGCAGTACTTC	CASLEGAYEQYF	TRBV28	TRBJ2-7
TGTGCCAGCAGCTTGGAACAGGGAGGGGGCCGATACGAGCAGTACTTC	CASSLEQGGGRYEQYF	TRBV5-6	TRBJ2-7
TGTGCCAGCAGCCACGTAACAGGGGCCCCATTGCTCAATCAGCCCCAGCATTTT	CASSHVTGAPLLNQPQHF	TRBV14	TRBJ1-5
TGCAGTGCTCCCGGACAGGGCTTTCAGCCCCAGCATTTT	CSAPGQGFQPQHF	TRBV20-1	TRBJ1-5
TGCAGCGTTGGAATGGGACAAGAAGCTTTCTTT	CSVGMGQEAFF	TRBV29-1	TRBJ1-1
TGTGCCAGCAGCCACCCCGGGACAGCGGCTGCGCCCCAGCATTTT	CASSHPGTAAAPQHF	TRBV14	TRBJ1-5
TGTGCCAGCAGCTTAAATCCGGAGCCATCGTATTTT	CASSLNPEPSYF	TRBV7-2	TRBJ2-3
TGTGCCAGCAGCTTCCGGCCCGGGACTAGCGGGAAGGGGCCGGGCGATTGGAACACTGAAGCTTTCTTT	CASSFRPGTSGKGPGDWNTEAFF	TRBV13	TRBJ1-1
TGTGCCAGCAGCTTATCGCAGGGTAAACCCACTGAAGCTTTCTTT	CASSLSQGKPTEAFF	TRBV7-8	TRBJ1-1
TGTGCCACCAATGGGTTCCGAGGGGGTGTGAACACTGAAGCTTTCTTT	CATNGFRGGVNTEAFF	TRBV24-1	TRBJ1-1
TGTGCCAGCAGAGGGAGGGGCACTGAAGCTTTCTTT	CASRGRGTEAFF	TRBV6-5	TRBJ1-1
TGTGCCAGCAGTGGCCGGGACAGAACAGAGTACTTC	CASSGRDRTEYF	TRBV5-4	TRBJ2-7
TGTGCCAGCAGCGCGACAGGAGACGTTTGCACAGATACGCAGTATTTT	CASSATGDVCTDTQYF	TRBV13	TRBJ2-3
TGTGCCAGCAGTGTTCGTCATCCTGGGGAGCAGTACTTC	CASSVRHPGEQYF	TRBV6-1	TRBJ2-7
TGTGCCACCAGTGACCTCCACAGGGGGGAGACCCAGTACTTC	CATSDLHRGETQYF	TRBV24-1	TRBJ2-5
TGTGCCACCAATATGTATGGAAAGCGCCAGTACTTC	CATNMYGKRQYF	TRBV24-1	TRBJ2-5
TGTGCCAGCATTGGACTAGTTGGGTTCACAGATACGCAGTATTTT	CASIGLVGFTDTQYF	TRBV27	TRBJ2-3
TGTGGTCAACTAGCGGGAGGGCTTAATGGCTACACCTTC	CGQLAGGLNGYTF	TRBV6-4	TRBJ1-2
TGTGCCAGCAGCAGGGCTAGCAATCAGCCCCAGCATTTT	CASSRASNQPQHF	TRBV6-5	TRBJ1-5
TGTGCCAGCTCAACCCGAGTTGAGTATGAGCAGTTCTTC	CASSTRVEYEQFF	TRBV18	TRBJ2-1
TGTGCCAGCAGCTTACCCCTTTTAGGGGGCTTAAGTGCCCAGCATTTT	CASSLPLLGGLSAQHF	TRBV7-7	TRBJ1-5
TGTGCCAGCTCACCAGTGAGGGGCGGAGGGGGCGATCAGAATCAGCCCCAGCATTTT	CASSPVRGGGGDQNQPQHF	TRBV18	TRBJ1-5
TGCAGTGAAACGCAGGCATTGATGAACACTGAAGCTTTCTTT	CSETQALMNTEAFF	TRBV20-1	TRBJ1-1
TGTGCCAGCAGCTTTAGGACCCGATTCCACCATGGCTACACCTTC	CASSFRTRFHHGYTF	TRBV7-3	TRBJ1-2
TGTGCCAGCAGAGTAACAGAACGAGCTGAAGCTTTCTTT	CASRVTERAEAFF	TRBV7-8	TRBJ1-1
TGTGCCAGCAGCTTGGCGTCCGATGGCTACACCTTC	CASSLASDGYTF	TRBV5-6	TRBJ1-2
TGTGCCAGCGGGGGGCGCTCCTACAATGAGCAGTTCTTC	CASGGRSYNEQFF	TRBV7-9	TRBJ2-1
TGTGCCAGCTCGACGGAGTTACGTTCCCACACCATATATTTT	CASSTELRSHTIYF	TRBV7-2	TRBJ1-3
TGTGCCAGCAGTGACTCCCGTCGGCGACAGGAGGCTTGCACAGATACGCAGTATTTT	CASSDSRRRQEACTDTQYF	TRBV6-4	TRBJ2-3
TGTGCCAGCAGTTACTCGAAGGGGCGTCAGCCCCAGCATTTT	CASSYSKGRQPQHF	TRBV6-2	TRBJ1-5
TGCAGTGCTGCCAGACAGGCTATCAATCAGCCCCAGCATTTT	CSAARQAINQPQHF	TRBV20-1	TRBJ1-5
TGTGCGGACGGGACAGGGGTAGTGAACACTGAAGCTTTCTTT	CADGTGVVNTEAFF	TRBV28	TRBJ1-1
TGTGCCAGCAGCAGAGCCCGGGACGTGATTTTCATTGAAAAACTGTTTTTT	CASSRARDVIFIEKLFF	TRBV14	TRBJ1-4
TGCGCCAGCAGTGAGTCGCCCAGAGGACCGGGGGGATTAAACATGGGGCAGTTCTTC	CASSESPRGPGGLNMGQFF	TRBV10-1	TRBJ2-1
TGTGCCAGCAGTTACCCTCGGAGGTTATTTAACCAGTACTTC	CASSYPRRLFNQYF	TRBV6-5	TRBJ2-4
TGTGCCAGCAGTGCCGGGACGCCCAACATTCAGTACTTC	CASSAGTPNIQYF	TRBV6-3	TRBJ2-4
TGTGCCAGCAGCCAAGGTGGACGCCAAGAGACCCAGTACTTC	CASSQGGRQETQYF	TRBV14	TRBJ2-5
TGTGCCAGCTGGGGGGCCAATGAGGACAGGCGGTCACCCCTCCACTTT	CASWGANEDRRSPLHF	TRBV5-5	TRBJ1-6
TGTGCCAGGCCCGGACGCCATGGGAACACTGAAGCTTTCTTT	CARPGRHGNTEAFF	TRBV12-3	TRBJ1-1
TGTGCCACCAGTGAAAACGGAACCTGGGCCAGGGAGCTAGCCAAAAACATTCAGTACTTC	CATSENGTWARELAKNIQYF	TRBV24-1	TRBJ2-4
TGTGCCATCAGTTGGCCCGAGGGCCCAACTAATGAAAAACTGTTTTTT	CAISWPEGPTNEKLFF	TRBV10-3	TRBJ1-4
TGCGCCAGCAGCCAAGATTCCCCCCTCACAGGGAAAACAGATACGCAGTATTTT	CASSQDSPLTGKTDTQYF	TRBV4-1	TRBJ2-3
TGTGCCAGCAGCGAGGATCCTAGGCCCGCTGGCTACACCTTC	CASSEDPRPAGYTF	TRBV5-6	TRBJ1-2
TGTGCCAGCAGCCTAGGGGCAGGGGGCAACACCATATATTTT	CASSLGAGGNTIYF	TRBV7-3	TRBJ1-3
TGTGCCAGCAGCTGGGCGCCCCTTGGCTACACCTTC	CASSWAPLGYTF	TRBV7-3	TRBJ1-2
TGTGCCAGCAGCCAAGCCCAGGGGAGACAAGAGACCCAGTACTTC	CASSQAQGRQETQYF	TRBV14	TRBJ2-5
TGCGCCAGCAGCCGGGGGTGGGGCTCGAACTATGGCTACACCTTC	CASSRGWGSNYGYTF	TRBV10-1	TRBJ1-2
TGTGCCAGCAGCCGGGACGGGCGGTTCTCTAATTCACCCCTCCACTTT	CASSRDGRFSNSPLHF	TRBV7-4	TRBJ1-6
TGCAGTGCTAGTAATGGACAGGGGCGGGAGACCCAGTACTTC	CSASNGQGRETQYF	TRBV20-1	TRBJ2-5
TGTGCCATTGGGACAGCCTCTAGCAATCAGCCCCAGCATTTT	CAIGTASSNQPQHF	TRBV27	TRBJ1-5
TGTGCCAGCAGCTTGCGGGAGAACTACAATGAGCAGTTCTTC	CASSLRENYNEQFF	TRBV7-6	TRBJ2-1
TGTGCCAGCAGCCAAGATGGTGAAGACAGGACGCCCATGAACACTGAAGCTTTCTTT	CASSQDGEDRTPMNTEAFF	TRBV14	TRBJ1-1
TGTGCCACCAGTGATTTGACTAGCGGGGGGGCCCTGTCCCCGGAAAGGATGGACGAGCAGTACTTC	CATSDLTSGGALSPERMDEQYF	TRBV24-1	TRBJ2-7
TGTGCCAGCAGTTGGGTCGTAGGCAATGAGCAGTTCTTC	CASSWVVGNEQFF	TRBV27	TRBJ2-1
TGTGCCAGCAGCTTAGCGCGGCCACAATGGGGGCGGGACAATCAGCCCCAGCATTTT	CASSLARPQWGRDNQPQHF	TRBV7-6	TRBJ1-5
TGCAGTGCTAGAAGGAACCTCCCAGAAAAACTGTTTTTT	CSARRNLPEKLFF	TRBV20-1	TRBJ1-4
TGCAGCGTGTTAGCGGGGGACAATGAGCAGTTCTTC	CSVLAGDNEQFF	TRBV29-1	TRBJ2-1
TGTGCCAGGAGGGGGGGGCAAGCTTTCTTT	CARRGGQAFF	TRBV11-3	TRBJ1-1
TGTGCCAGCAGCGAAGACAGGGTATCAAATTATAACTATGGCTACACCTTC	CASSEDRVSNYNYGYTF	TRBV28	TRBJ1-2
TGCAGTGCTCACGACAGGGGGGGAAATGAAGCTTTCTTT	CSAHDRGGNEAFF	TRBV20-1	TRBJ1-1
TGTGCCAGCAGCAGCCAACGTGACTTATACGCGAACACCGGGGAGCTGTTTTTT	CASSSQRDLYANTGELFF	TRBV11-2	TRBJ2-2
TGTGCCAGCTCACCACAGGGGGGGCAAGAGACCCAGTACTTC	CASSPQGGQETQYF	TRBV18	TRBJ2-5
TGTGCCAGCAGCTTGAAGTATGACAGGGTCGTTGAACAGCCCCAGCATTTT	CASSLKYDRVVEQPQHF	TRBV5-6	TRBJ1-5
TGTGCCAGCAGCAGGGCAAACACTGAAGCTTTCTTT	CASSRANTEAFF	TRBV6-1	TRBJ1-1
TGTGCCAAAAGAGACAGAAACGGCAATCAGCCCCAGCATTTT	CAKRDRNGNQPQHF	TRBV30	TRBJ1-5
TGCGCCAGCAGCTCCTTACACACGGTCACTGAAGCTTTCTTT	CASSSLHTVTEAFF	TRBV4-3	TRBJ1-1
TGTGCCAGCAGTGCCCCAGCGGGAACTGAAGCTTTCTTT	CASSAPAGTEAFF	TRBV27	TRBJ1-1
TGTGCCAGCAGCCAGACGAATGAAAAACTGTTTTTT	CASSQTNEKLFF	TRBV11-2	TRBJ1-4
TGCGCCAGCCCCACGGGGCCCATAGAGAACACTGAAGCTTTCTTT	CASPTGPIENTEAFF	TRBV10-1	TRBJ1-1
TGTGCCAGCAGGAAGAGGACCAGGACAGGGCGGAGGATCGTTATAGAGACCCAGTACTTC	CASRKRTRTGRRIVIETQYF	TRBV6-5	TRBJ2-5
TGTGCCAGCAGTGGTAGGGGGCAGAATGAGCAGTTCTTC	CASSGRGQNEQFF	TRBV6-1	TRBJ2-1
TGTGCTAGTGGTGAAGGGACTAGCGGGGGGGCCCCCGGGGAGCTGTTTTTT	CASGEGTSGGAPGELFF	TRBV12-5	TRBJ2-2
TGTGCCAGCAGTGTGACGGGCCCAGGAAACACCATATATTTT	CASSVTGPGNTIYF	TRBV27	TRBJ1-3
TGCGCCAGCCCCAGATTCCGGGACAGGCAAGAGACCCAGTACTTC	CASPRFRDRQETQYF	TRBV5-1	TRBJ2-5
TGTGCCAGCAGCGTAAGGGGGCCTGGGGGGGGACGAAACAATGAGCAGTTCTTC	CASSVRGPGGGRNNEQFF	TRBV9	TRBJ2-1
TGCAGTGCTAGGTTTCTAGCCACATGCTACAATGAGCAGTTCTTC	CSARFLATCYNEQFF	TRBV20-1	TRBJ2-1
TGTGCCAGCAAAATGAGGACCGTCCGTTTGCCCTATAGCAATCAGCCCCAGCATTTT	CASKMRTVRLPYSNQPQHF	TRBV6-1	TRBJ1-5
TGTGCCAGCAATAGAGCAGAGGTGTACTACGAGCAGTACTTC	CASNRAEVYYEQYF	TRBV12-4	TRBJ2-7
TGTGCCAGCAGTTCGGCAGGGGGCGAATGCTACACCTTC	CASSSAGGECYTF	TRBV6-5	TRBJ1-2
TGTGCCAGCAGCTTTGTCTGGACTCAGAGCAATCAGCCCCAGCATTTT	CASSFVWTQSNQPQHF	TRBV7-9	TRBJ1-5
TGTGCCAGCAGCCAAGATAACCGACTTAATTCACCCCTCCACTTT	CASSQDNRLNSPLHF	TRBV14	TRBJ1-6
TGTGCCAGCAGCGGGGGCGGCTACACCTTC	CASSGGGYTF	TRBV9	TRBJ1-2
TGTGCCGGGGCGACAGCCGATACGCAGTATTTT	CAGATADTQYF	TRBV30	TRBJ2-3
TGCGCCAGCAGCTTGCAGTTCAACTGTACCACAGGGGTCCCCCGATATTACGAGCAGTACTTC	CASSLQFNCTTGVPRYYEQYF	TRBV5-1	TRBJ2-7
TGTGCCAGCAGCTTGGGTGTTAGGGGCGGAGAGGCTGAAGCTTTCTTT	CASSLGVRGGEAEAFF	TRBV5-8	TRBJ1-1
TGTGCCAGCAGGGGGGGGTTGAATGAGCAGTTCTTC	CASRGGLNEQFF	TRBV2	TRBJ2-1
TGTGCCAGCAGGGTCCGGGACAGGGGGCATCAGCCCCAGCATTTT	CASRVRDRGHQPQHF	TRBV14	TRBJ1-5
TGTGCACTCCCTAGCGGGGGGGCTGAGCAGTTCTTC	CALPSGGAEQFF	TRBV24-1	TRBJ2-1
TGTGCCAGCAGTCGCCAGAATCACATCACAGGGCCCTGGAACACTGAAGCTTTCTTT	CASSRQNHITGPWNTEAFF	TRBV27	TRBJ1-1
TGTGCTAGCAGCTTAGAAAGGGCAAGGGCCGTGAGCAATCAGCCCCAGCATTTT	CASSLERARAVSNQPQHF	TRBV7-7	TRBJ1-5
TGTGCCAGCAGTTTAAGGGGGGGGGGCCAAGATACGCAGTATTTT	CASSLRGGGQDTQYF	TRBV27	TRBJ2-3
TGCAGTGCTAGCAGAGAGGCAGGGCGCGAAGCTTTCTTT	CSASREAGREAFF	TRBV20-1	TRBJ1-1
TGTGCCAGCAGCGTAGACCTATCTAGCTACGAGCAGTACTTC	CASSVDLSSYEQYF	TRBV9	TRBJ2-7
TGTGCCAGCAGCCCCGGACATATCACGCATTTT	CASSPGHITHF	TRBV7-9	TRBJ1-5
TGCGCCCATGTCTACAGCGGGGGTGAGCAGTTCTTC	CAHVYSGGEQFF	TRBV4-1	TRBJ2-1
TGTGCCAGCAGCGTATCCGTTAAGACAGGGCCTACCCGTAACACCGGGGAGCTGTTTTTT	CASSVSVKTGPTRNTGELFF	TRBV9	TRBJ2-2
TGTGCCAGCAGCTTACCGGAATACAATGAGCAGTTCTTC	CASSLPEYNEQFF	TRBV11-2	TRBJ2-1
TGTGCCAGCGCAATCTGGTCCAGGGCGGTTGAAGCTTTCTTT	CASAIWSRAVEAFF	TRBV11-2	TRBJ1-1
TGTGCCTGGAGTTTCCTTTGGGCAGGAAGCAATGAGCAGTTCTTC	CAWSFLWAGSNEQFF	TRBV30	TRBJ2-1
TGTGCCAGAGAAAAGGTTCGCTACGAGCAGTACTTC	CAREKVRYEQYF	TRBV14	TRBJ2-7
TGTGCCAGCAGCTCAGGAGCCGGTAGCTCCTACAATGAGCAGTTCTTC	CASSSGAGSSYNEQFF	TRBV7-9	TRBJ2-1
TGTGCCAGCAGCGTAGGGTACAGGGTTACGAGCCAAGAGACCCAGTACTTC	CASSVGYRVTSQETQYF	TRBV9	TRBJ2-5
TGTGCCAGCAGGATGCAGGGACTTCAAGATCATAGGTTTAGGAGAGCTGTCTGCTACGAGCAGTACTTC	CASRMQGLQDHRFRRAVCYEQYF	TRBV6-5	TRBJ2-7
TGTGCCAGCAGTGGTGGGGACAGGGGGAACGAGCAGTACTTC	CASSGGDRGNEQYF	TRBV6-4	TRBJ2-7
TGTGCCAGCAGCTTGGCCATCGGACAGGGGAATCAGCCCCAGCATTTT	CASSLAIGQGNQPQHF	TRBV5-5	TRBJ1-5
TGCGCCAGCAGCTTGGTCATTTGTCCGGGGCCGGGCTACACCTTC	CASSLVICPGPGYTF	TRBV5-1	TRBJ1-2
TGTGCCAGCAGGTTTGGGGGGCTGACCCCTACCGGGGAGCTGTTTTTT	CASRFGGLTPTGELFF	TRBV5-5	TRBJ2-2
TGTGCCAGCAAAGGGGGCGTCAACTATGGCTACACCTTC	CASKGGVNYGYTF	TRBV6-1	TRBJ1-2
TGTGCCAGCAGTACCAGCCGCGACGAGCAGTACTTC	CASSTSRDEQYF	TRBV6-2	TRBJ2-7
TGTGCCAGCAGCAGTACTAGCGGGGGCACCTACAATGAGCAGTTCTTC	CASSSTSGGTYNEQFF	TRBV7-2	TRBJ2-1
TGTGCCAGCAGTTTAAGGGCTACCAGGAAGTCTGAAGCTTTCTTT	CASSLRATRKSEAFF	TRBV27	TRBJ1-1
TGCAGTGCTAGAGGAGGCCTTAGCACCTACGAGCAGTACTTC	CSARGGLSTYEQYF	TRBV20-1	TRBJ2-7
TGTGCCAGCACGGCGCGACAAGCCAAAAACATTCAGTACTTC	CASTARQAKNIQYF	TRBV6-6	TRBJ2-4
TGTGCCAGCAGCCAAGATCCAAGGGGCCGTTCGGAGAACACCGGGGAGCTGTTTTTT	CASSQDPRGRSENTGELFF	TRBV4-2	TRBJ2-2
TGTGCCAGCAGTTACACCCCCCCCACTGGGCGGGAGCACGAGCAGTACTTC	CASSYTPPTGREHEQYF	TRBV6-6	TRBJ2-7
TGTGCCAGCAGTTTCAATGGGGGGACCTACGAGCAGTACTTC	CASSFNGGTYEQYF	TRBV28	TRBJ2-7
TGTGCCAGCAGACCCCCCGGGGACAGGGGGTCCAGAGGCTACACCTTC	CASRPPGDRGSRGYTF	TRBV6-4	TRBJ1-2
TGTGCCAGCATCGAGGGGGGGCTGGGGCATACGCAGTATTTT	CASIEGGLGHTQYF	TRBV5-6	TRBJ2-3
TGTGCCAGCAGCTTAGACGTAATAGCGGGTAGGAAGAATGAGCAGTTCTTC	CASSLDVIAGRKNEQFF	TRBV7-9	TRBJ2-1
TGTGCCAGCAGGGGCAAGGGACAGGGAAGCTCCTACGAGCAGTACTTC	CASRGKGQGSSYEQYF	TRBV6-4	TRBJ2-7
TGTGCCAGCAGTCCAACCGGGGGCGGGAGTCAGTACTTC	CASSPTGGGSQYF	TRBV6-2	TRBJ2-5
TGTGCCATCAGTGAGGCCCCCGGGACAGGCCCCTACGAGCAGTACTTC	CAISEAPGTGPYEQYF	TRBV10-3	TRBJ2-7
TGTGCCATCAGTGTATGTGTTACTAGCGGGAGCCGAAAACTGTTTTTT	CAISVCVTSGSRKLFF	TRBV10-3	TRBJ1-4
TGTGCCAGCAGTCTTAGGGGGTGGAACACCGGGGAGCTGTTTTTT	CASSLRGWNTGELFF	TRBV2	TRBJ2-2
TGCGCTGGGTGCAGGGGGTTATACGATTGCACTGAAGCTTTCTTT	CAGCRGLYDCTEAFF	TRBV10-1	TRBJ1-1
TGCGCCAGCAGCCCGTCACAGGGGGGGCTGGAAAAACTGTTTTTT	CASSPSQGGLEKLFF	TRBV5-1	TRBJ1-4
TGCGCCAGCAGCTGTTCAAGTCCTAGCTCCTACGAGCAGTACTTC	CASSCSSPSSYEQYF	TRBV5-1	TRBJ2-7
TGTGCCAGCAGTAGCCCAACCCGCGGGATGGCAGAGACCCAGTACTTC	CASSSPTRGMAETQYF	TRBV28	TRBJ2-5
TGTGCCAGCCGGGACAGGTACCACACTGAAGCTTTCTTT	CASRDRYHTEAFF	TRBV6-1	TRBJ1-1
TGTGCCAGCTACGTCACCTCAGGGAGGCCTGGGAGCTCCTACAATGAGCAGTTCTTC	CASYVTSGRPGSSYNEQFF	TRBV25-1	TRBJ2-1
TGTGCCAGCCCCGGAGGGGTGCGTAACTATGGCTACACCTTC	CASPGGVRNYGYTF	TRBV18	TRBJ1-2
TGTGCCAGCAGTGCGGACAGTAACTATGGCTACACCTTC	CASSADSNYGYTF	TRBV6-4	TRBJ1-2
TGCGCCAAACAGGGGTCTAACTATGGCTACACCTTC	CAKQGSNYGYTF	TRBV5-1	TRBJ1-2
TGTGCCAGCAGCCTGAACAGCGAGGTAGCCAAAAACATTCAGTACTTC	CASSLNSEVAKNIQYF	TRBV14	TRBJ2-4
TGTGCCAGCAGCTCCAACGGAAAACACGAGCAGTACTTC	CASSSNGKHEQYF	TRBV5-6	TRBJ2-7
TGTGCCAGCAGCTTAGCAACAGGGCAGCCCCAGCATTTT	CASSLATGQPQHF	TRBV7-3	TRBJ1-5
TGTGCCAGTCAGAAAACGACAGGAGGTGACGAGCAGTACTTC	CASQKTTGGDEQYF	TRBV19	TRBJ2-7
TGTGCCAGCAGCCAAGATCGGACAGGGTACGAGCAGTACTTC	CASSQDRTGYEQYF	TRBV4-2	TRBJ2-7
TGTTCTCGCCGCGCTTCTGGGGCCAACGTCCTGACTTTC	CSRRASGANVLTF	TRBV7-9	TRBJ2-6
TGTGCCAGCAGTAACCGGCGGCCGGAAGCCAATGAGCAGTTCTTC	CASSNRRPEANEQFF	TRBV6-5	TRBJ2-1
TGTGCCATCAGCCATCTGATTCAAGGGGTTCGTTACGAGCAGTACTTC	CAISHLIQGVRYEQYF	TRBV10-3	TRBJ2-7
TGTGCCAGCAGTTTAACTAAGGTTCCTGAAGCTTTCTTT	CASSLTKVPEAFF	TRBV28	TRBJ1-1
TGTGCCAGTAGGGGTGGACCGTCCAACACTGAAGCTTTCTTT	CASRGGPSNTEAFF	TRBV19	TRBJ1-1
TGTGCCAGCGAGGACCACCTGACCTACGAGCAGTACTTC	CASEDHLTYEQYF	TRBV18	TRBJ2-7
TGTGCCACCAGTGCGACACAGGGGGTCTATGGCTACACCTTC	CATSATQGVYGYTF	TRBV24-1	TRBJ1-2
TGTGCCAGCACCCAGGGAAATAGCAATCAGCCCCAGCATTTT	CASTQGNSNQPQHF	TRBV2	TRBJ1-5
TGTGCCACCAGTGAGGAACCTAGATCCAAGGTCTTC	CATSEEPRSKVF	TRBV24-1	TRBJ2-1
TGTGCCAGCAGCCATTTTGGACAGGGAGGTTTCACGGGGGGACCAAATGAGCAGTTCTTC	CASSHFGQGGFTGGPNEQFF	TRBV4-2	TRBJ2-1
TGTGCCAGCAGTTACTTGCCTTCGCGCAGCACAGATACGCAGTATTTT	CASSYLPSRSTDTQYF	TRBV6-5	TRBJ2-3
TGCATTGTTCAGGGGGTCTCCTACGAGCAGTACTTC	CIVQGVSYEQYF	TRBV20-1	TRBJ2-7
TGTGCCAGCAGAGATCTGAACTACGAGCAGTACTTC	CASRDLNYEQYF	TRBV27	TRBJ2-7
TGCAGTGCTAGACCGGAATGCGGGGGGGCTTGGGGAAGCTCCTACGAGCAGTACTTC	CSARPECGGAWGSSYEQYF	TRBV20-1	TRBJ2-7
TGCGCCAGCAGCTTTATCGGACAGGGGCCGGACGGGGAGCTGTTTTTT	CASSFIGQGPDGELFF	TRBV5-1	TRBJ2-2
TGTGCGGGAAACCCCAAATGCACGGTTAATTCACCCCTCCACTTT	CAGNPKCTVNSPLHF	TRBV9	TRBJ1-6
TGTGCCAGCAGCTCACCCCGGGACAGAAACACCGGGGAGCTGTTTTTT	CASSSPRDRNTGELFF	TRBV13	TRBJ2-2
TGCAGTGCTAGAGATGAGTCGAATATGACAGGGAATTTTTCTGGGGCCAACGTCCTGACTTTC	CSARDESNMTGNFSGANVLTF	TRBV20-1	TRBJ2-6
TGTGCCAGCAGCTTCTCGGCGATAATCAACACCGGGGAGCTGTTTTTT	CASSFSAIINTGELFF	TRBV5-4	TRBJ2-2
TGTGCCAGCAGCGCTGGGGGGCCGACAGATACGCAGTATTTT	CASSAGGPTDTQYF	TRBV5-6	TRBJ2-3
TGTGCCAGCAGTCTAACCAGTGGCTACACCTTC	CASSLTSGYTF	TRBV27	TRBJ1-2
TGTGCCAGCAGCTTAGATGCACACTTCTCCTACGAGCAGTACTTC	CASSLDAHFSYEQYF	TRBV11-2	TRBJ2-7
TGCGCCAGCAGTGAGTACAAGACAGGGGAACAGTACTTC	CASSEYKTGEQYF	TRBV10-1	TRBJ2-5
TGTGCCAGCAGCCCAGTAGGGAGCAATCAGCCCCAGCATTTT	CASSPVGSNQPQHF	TRBV5-6	TRBJ1-5
TGTGCCCTGTACGCAACTAATGAAAAACTGTTTTTT	CALYATNEKLFF	TRBV19	TRBJ1-4
TGTGCCAGCAGCGTACGTTTAGCGACAGGGGTGAGCTCCTACGAGCAGTACTTC	CASSVRLATGVSSYEQYF	TRBV9	TRBJ2-7
TGTGCCAGCAGCTTAGCGAGGTCAGGGGGCTACGAGCAGTACTTC	CASSLARSGGYEQYF	TRBV7-9	TRBJ2-7
TGTGCCAGCAGCCCATGGAGACGGGGGGCGGTTGCGTACGAGCAGTACTTC	CASSPWRRGAVAYEQYF	TRBV11-3	TRBJ2-7
TGTGCCAGCAGCCCTGACTGGGGGAGGACAGTTGATAATTCACCCCTCCACTTT	CASSPDWGRTVDNSPLHF	TRBV11-2	TRBJ1-6
TGTGCCAGCTCACATGGGACAGGGTACGACACTGAAGCTTTCTTT	CASSHGTGYDTEAFF	TRBV18	TRBJ1-1
TGTGCCAGCAGTTGGTCTCAATGGGGGCAGGGTCATGAGCAGTTCTTC	CASSWSQWGQGHEQFF	TRBV27	TRBJ2-1
TGTGCCAGCAGTTGGGAGACCCCAGGATTGAACACTGAAGCTTTCTTT	CASSWETPGLNTEAFF	TRBV27	TRBJ1-1
TGTGCCAGCACTGGCTCGGTAGAGCATGAGTCCAATGAGCAGTTCTTC	CASTGSVEHESNEQFF	TRBV28	TRBJ2-1
TGTGCCAGCAGCTTCTGGGGCCCAGGTCAGCCCCAGCATTTT	CASSFWGPGQPQHF	TRBV11-2	TRBJ1-5
TGTGCCAGCAGTTTTCCCCCGGGACGTAATAACGAGCAGTACTTC	CASSFPPGRNNEQYF	TRBV28	TRBJ2-7
TGTGCCTGGAAAGGCAGGAACGGAGGGGGCAGTTATGGCTACACCTTC	CAWKGRNGGGSYGYTF	TRBV30	TRBJ1-2
TGTGCCACCAGCAGAGCAGCCGGGACAAAGATTTACGAGCAGTACTTC	CATSRAAGTKIYEQYF	TRBV15	TRBJ2-7
TGTGCCAGCAGTGACGGGCCGGGGTACTTC	CASSDGPGYF	TRBV7-9	TRBJ2-4
TGTGCCAGCAGCCAAGATGGGACCCAGGGCTATAGCAATCAGCCCCAGCATTTT	CASSQDGTQGYSNQPQHF	TRBV14	TRBJ1-5
TGCAGCGTTGCGGCAAGGGGGGGCTCACTGTTTTTT	CSVAARGGSLFF	TRBV29-1	TRBJ1-4
TGTGCCAGCCCCGGGCCCCAGGGGGGGGTGTACGAGCAGTACTTC	CASPGPQGGVYEQYF	TRBV27	TRBJ2-7
TGTGCCAGCAGCCAGAGCGGGAGCAACTATGGCTACACCTTC	CASSQSGSNYGYTF	TRBV3-1	TRBJ1-2
TGTGCCAGTAGTATTGATAGAAACAGGGGGTCGTACAATGAGCAGTTCTTC	CASSIDRNRGSYNEQFF	TRBV19	TRBJ2-1
TGTGCCAGCAGTTTCCAGGATATGAAAGAGACCCAGTACTTC	CASSFQDMKETQYF	TRBV27	TRBJ2-5
TGTGCCAGCAGTTACATGGGACAGGGTAACTATGGCTACACCTTC	CASSYMGQGNYGYTF	TRBV6-6	TRBJ1-2
TGTGCCAGCAGCCAAGATCCGCAGGGCAATCAGCCCCAGCATTTT	CASSQDPQGNQPQHF	TRBV4-2	TRBJ1-5
TGTGCCAGCAGCCGAGACGGACTGTCCTACGAGCAGTACTTC	CASSRDGLSYEQYF	TRBV7-3	TRBJ2-7
TGTGCCAGTAGTTTCCGCGGGGGTCCGCGCTTTAGCTCCTACGAGCAGTACTTC	CASSFRGGPRFSSYEQYF	TRBV19	TRBJ2-7
TGTGCCAGCAGCGGCGGAGGGGGCTATAACTATGGCTACACCTTC	CASSGGGGYNYGYTF	TRBV13	TRBJ1-2
TGTGCCAGCAGCCTTATGTTTAGTAGAATTTTTGGAATTAACTATGGCTACACCTTC	CASSLMFSRIFGINYGYTF	TRBV14	TRBJ1-2
TGTGCCAGCAGACTAAAAACCCGGGACCCATACGAGCAGTACTTC	CASRLKTRDPYEQYF	TRBV7-8	TRBJ2-7
TGTGCCAGCACTGGGGTCTATCAGCCCCAGCATTTT	CASTGVYQPQHF	TRBV6-5	TRBJ1-5
TGTGCCAAATCATACCCAGGGGTTGGCACCCAGTACTTC	CAKSYPGVGTQYF	TRBV30	TRBJ2-5
TGTGCCAGCAGTTTAGGAAAATGTCTTAAGAATAATGAAAAACTGTTTTTT	CASSLGKCLKNNEKLFF	TRBV12-4	TRBJ1-4
TGTGCCAGAACCTCGGGGGACATCTCGGAGCCCCAGCATTTT	CARTSGDISEPQHF	TRBV19	TRBJ1-5
TGTGCCAGCAGCTGGGCTTGGGACAGGAAGGCTGAAGCTTTCTTT	CASSWAWDRKAEAFF	TRBV7-2	TRBJ1-1
TGTGCCAGCAGCCCCTTGGGGTTTAACTATGGCTACACCTTC	CASSPLGFNYGYTF	TRBV3-1	TRBJ1-2
TGTGCCAGCAGCCGGGGGGGGCTGTTTTTT	CASSRGGLFF	TRBV3-1	TRBJ2-2
TGCAGCGTTGGGGACACCAGCTTGACCACTGAAGCTTTCTTT	CSVGDTSLTTEAFF	TRBV29-1	TRBJ1-1
TGTGCCAGTAGTATCCTTAGCAGGGGTTACAATGAGCAGTTCTTC	CASSILSRGYNEQFF	TRBV19	TRBJ2-1
TGTGCCAGCAGCACAGATCGGACATTAACTGAAGCTTTCTTT	CASSTDRTLTEAFF	TRBV7-9	TRBJ1-1
TGTGCCAGCAGCCAAGATGTGCACGGGGGACGGAACACCGGGGAGCTGTTTTTT	CASSQDVHGGRNTGELFF	TRBV4-2	TRBJ2-2
TGTGCCAGCAGCTTGGCGGGACAGCGGGGCTACGAGCAGTACTTC	CASSLAGQRGYEQYF	TRBV5-8	TRBJ2-7
TGTGCCAGCAGCTACGGAGCCGGGACAGTGAGCAATCAGCCCCAGCATTTT	CASSYGAGTVSNQPQHF	TRBV7-8	TRBJ1-5
TGCAGTGCTAGAGTGACTAGCAAAGGGGGAGATACGCAGTATTTT	CSARVTSKGGDTQYF	TRBV20-1	TRBJ2-3
TGCGCCAGCAGGTGGGGGACAGGGAACACTGAAGCTTTCTTT	CASRWGTGNTEAFF	TRBV5-1	TRBJ1-1
TGTGCCAGCAGTTTCCCGGCCAGATACTATGGCTACACCTTC	CASSFPARYYGYTF	TRBV12-3	TRBJ1-2
TGTGCCAGCAGCCGCTGGTTCAGCCTTAGCAAAAACATTCAGTACTTC	CASSRWFSLSKNIQYF	TRBV9	TRBJ2-4
TGTGCCAGTAGTCGATCCGAGAGGAGGGGGCATCAGCCCCAGCATTTT	CASSRSERRGHQPQHF	TRBV19	TRBJ1-5
TGTGCCAGCAGCGGGACGCGGTTAGCGTACCAAGAGACCCAGTACTTC	CASSGTRLAYQETQYF	TRBV13	TRBJ2-5
TGTGCCTGGAAGAGGGTCATGGACAGGGCCCAGAATGCCTATAATTCACCCCTCCACTTT	CAWKRVMDRAQNAYNSPLHF	TRBV30	TRBJ1-6
TGTGCCAGTCTATGGGGGAACACCGGGGAGCTGTTTTTT	CASLWGNTGELFF	TRBV19	TRBJ2-2
TGCGCCAGCAGTGACCGGGGACAGGGGCCGGCTCGCTACAATGAGCAGTTCTTC	CASSDRGQGPARYNEQFF	TRBV10-1	TRBJ2-1
TGCAGTGCTAAACCCCCCGGGGAGGAAGCTAGCACAGATACGCAGTATTTT	CSAKPPGEEASTDTQYF	TRBV20-1	TRBJ2-3
TGTGCCAGCAGTTACACCCAGAGCTGGAATAGCAATCAGCCCCAGCATTTT	CASSYTQSWNSNQPQHF	TRBV6-5	TRBJ1-5
TGTGCCAGCAGCAGCAGGGCTGAAGCTTTCTTT	CASSSRAEAFF	TRBV13	TRBJ1-1
TGTGCCAGCACACAGGGGTCCCGCTTGAACACTGAAGCTTTCTTT	CASTQGSRLNTEAFF	TRBV7-9	TRBJ1-1
TGTGCCAGCAAACGGGTCCCGACCAATGAGCAGTTCTTC	CASKRVPTNEQFF	TRBV12-3	TRBJ2-1
TGTGCCAGCAGCTTAGCAGGCGGCGGGAGACAGCCCCAGCATTTT	CASSLAGGGRQPQHF	TRBV7-9	TRBJ1-5
TGTGCCAGCAATGGACTAGCGGGGGGGCCCTCCTTTCGAGACAATGAGCAGTTCTTC	CASNGLAGGPSFRDNEQFF	TRBV27	TRBJ2-1
TGTGCCAGTAGTATCCTAAGCGCAGGATACACCGGGGAGCTGTTTTTT	CASSILSAGYTGELFF	TRBV19	TRBJ2-2
TGCAGTGCTAGAGTCCCAGGGCCTAGATATAGCAATCAGCCCCAGCATTTT	CSARVPGPRYSNQPQHF	TRBV20-1	TRBJ1-5
TGTGCCAGCACCTTTACCGTCAGGGCTAATGAAAAACTGTTTTTT	CASTFTVRANEKLFF	TRBV6-4	TRBJ1-4
TGCAGTGCTCCTGACAGCTCTGGAAACACCATATATTTT	CSAPDSSGNTIYF	TRBV20-1	TRBJ1-3
TGTGCCAGCAGCCGTGTAGTCAGGGCCGAACATGAGCAGTTCTTC	CASSRVVRAEHEQFF	TRBV13	TRBJ2-1
TGTGCCAGCAGTCAGATGAACACTGAAGCTTTCTTT	CASSQMNTEAFF	TRBV6-1	TRBJ1-1
TGTGCCAGCAGCCAAGGGACAGTCGGACCGTGCACAGATACGCAGTATTTT	CASSQGTVGPCTDTQYF	TRBV14	TRBJ2-3
TGTGCTAGTGGTTTTAGTCACAAACCGCGGTATTTT	CASGFSHKPRYF	TRBV12-5	TRBJ2-3
TGTGCCAGCAGAGAGGGAGGGGGCAATGAGCAGTTCTTC	CASREGGGNEQFF	TRBV14	TRBJ2-1
TGTGCCAGCAGCCGCCGGGACAAACCCTACAATGAGCAGTTCTTC	CASSRRDKPYNEQFF	TRBV4-2	TRBJ2-1
TGTGCCAGCAGCCGTTCAAAGTTAACTGAAGCTTTCTTT	CASSRSKLTEAFF	TRBV5-8	TRBJ1-1
TGTGCCAGCAGCCCGGGGGACAGCACGGCCTACGAGCAGTACTTC	CASSPGDSTAYEQYF	TRBV13	TRBJ2-7
TGTGCCAGCAGCCAAAACCGTATAGACACAGATACGCAGTATTTT	CASSQNRIDTDTQYF	TRBV7-3	TRBJ2-3
TGTGCCAGCAGTGGGGGGGAGGGGGGCTACACCTTC	CASSGGEGGYTF	TRBV6-5	TRBJ1-2
TGTGCCAGCATCGCCCTGGTGAATGAGCAGTTCTTC	CASIALVNEQFF	TRBV6-2	TRBJ2-1
TGTGCCAGCAGTGAGGACGACCAGGCCTACGAGCAGTACTTC	CASSEDDQAYEQYF	TRBV25-1	TRBJ2-7
TGTGCCAGCAGTGTATCGGGACAGGGGACAGATACGCAGTATTTT	CASSVSGQGTDTQYF	TRBV25-1	TRBJ2-3
TGTGCCAGCAGGTGGGTATATGGGGCAGATACGCAGTATTTT	CASRWVYGADTQYF	TRBV6-1	TRBJ2-3
TGTGCCAGCAGCTCGTCGTGGGACGACAATGAGCAGTTCTTC	CASSSSWDDNEQFF	TRBV7-2	TRBJ2-1
TGTGCCAGCAGCAGCACAGGGGTGGGGAAGCACTATAATTCACCCCTCCACTTT	CASSSTGVGKHYNSPLHF	TRBV5-4	TRBJ1-6
TGCAGTGCTAGAGTTATCTACAATGAGCAGTTCTTC	CSARVIYNEQFF	TRBV20-1	TRBJ2-1
TGCAGTGCTAGAAAGTGGGGGGCCTACGAGCAGTACTTC	CSARKWGAYEQYF	TRBV20-1	TRBJ2-7
TGTGCCAGCAGCTTGACGAGGGGACAGAAAGATTCAGGCATGAACACTGAAGCTTTCTTT	CASSLTRGQKDSGMNTEAFF	TRBV5-5	TRBJ1-1
TGCAGTGCTCCATCGAGGGACAGCATAAACACTGAAGCTTTCTTT	CSAPSRDSINTEAFF	TRBV20-1	TRBJ1-1
TGCGCCAGCAGCCGAGTCGGGAGCTCCTACAATGAGCAGTTCTTC	CASSRVGSSYNEQFF	TRBV4-1	TRBJ2-1
TGCGCCAGCAGCTTCTTAGCGGGCGCTAGCACAGATACGCAGTATTTT	CASSFLAGASTDTQYF	TRBV5-1	TRBJ2-3
TGTGCCAGCAGCAGACCGATGGAGGGGTTCTATGGCTACACCTTC	CASSRPMEGFYGYTF	TRBV13	TRBJ1-2
TGTGCCAGCAGTGCATCCTCTACGCAGGGCAATTCTGGAAACACCATATATTTT	CASSASSTQGNSGNTIYF	TRBV6-4	TRBJ1-3
TGTGCCAGCAGCGATATCCGAGGGACGGGAAACACAGATACGCAGTATTTT	CASSDIRGTGNTDTQYF	TRBV7-3	TRBJ2-3
TGCGCCAGCAGCTTGCCCGGGACAGCGCCCTACGAGCAGTACTTC	CASSLPGTAPYEQYF	TRBV5-1	TRBJ2-7
TGTGCCACGACAGGGCACGGCTACACCTTC	CATTGHGYTF	TRBV6-2	TRBJ1-2
TGTGCCAGCATGCTTTTGGGACTAGCGGGCTACGAGCAGTACTTC	CASMLLGLAGYEQYF	TRBV2	TRBJ2-7
TGTGCCAGCAGCATGGGCCCCGTTAACACAGATACGCAGTATTTT	CASSMGPVNTDTQYF	TRBV13	TRBJ2-3
TGTGCCAGCAGCAAGGACGGGACAGGGTGGAAGGGGGGGGAATTTTATGGCTACACCTTC	CASSKDGTGWKGGEFYGYTF	TRBV13	TRBJ1-2
TGTGCCAGCAGCCCAGCCCGCCAAGGACAGGGTCCCCTACCCTACGAGCAGTACTTC	CASSPARQGQGPLPYEQYF	TRBV13	TRBJ2-7
TGCAGTGGGGCTCGGGCACATGAGCAGTTCTTC	CSGARAHEQFF	TRBV20-1	TRBJ2-1
TGTGCCAGCAGCAACCGAGTGACCGAGAACTCTGGAAACACCATATATTTT	CASSNRVTENSGNTIYF	TRBV14	TRBJ1-3
TGTGCCAGCAGGAGAGTTTCGCGGGGCTCCTACGAGCAGTACTTC	CASRRVSRGSYEQYF	TRBV12-4	TRBJ2-7
TGTGCCAGCGGTCCACTCGCCAAAGAGACCCAGTACTTC	CASGPLAKETQYF	TRBV6-4	TRBJ2-5
TGTGCCACCAGTGACTTTCCGCGCCCCGGGACTGGCCACAGGATCTTC	CATSDFPRPGTGHRIF	TRBV24-1	TRBJ2-1
TGCAGTGCCAGGGACTCTTCCCATAATGAAAAACTGTTTTTT	CSARDSSHNEKLFF	TRBV20-1	TRBJ1-4
TGCAGTGCTGACAGGGGGGCCTACACAGATACGCAGTATTTT	CSADRGAYTDTQYF	TRBV20-1	TRBJ2-3
TGTGCCAGCAGCATCTGGAGAGGGGGCAATCAGCCCCAGCATTTT	CASSIWRGGNQPQHF	TRBV13	TRBJ1-5
TGTGCCAGCAGTGACTTGGGGGGACTTAACGCCCAAGAGACCCAGTACTTC	CASSDLGGLNAQETQYF	TRBV6-4	TRBJ2-5
TGTGCCAGCAGCCAAGGCGGGTCGGGGTATGGCTACACCTTC	CASSQGGSGYGYTF	TRBV3-1	TRBJ1-2
TGTGCCAGCTATGCGGGGCCGACAGCTGAAGCTTTCTTT	CASYAGPTAEAFF	TRBV28	TRBJ1-1
TGTGCCAGCAGCTTGGGACCAGGCTACACCTTC	CASSLGPGYTF	TRBV6-1	TRBJ1-2
TGCAGTGCAACACTCGGGGAGCTGTTTTTT	CSATLGELFF	TRBV20-1	TRBJ2-2
TGTGCCAGCGGGGGCCTCTACGAGCAGTACTTC	CASGGLYEQYF	TRBV5-4	TRBJ2-7
TGCGCCAGCAGCTTGGACACAGATACGCAGTATTTT	CASSLDTDTQYF	TRBV5-1	TRBJ2-3
TGTGCCACTATAAACGTCCCGGGGACAGGGGGCGGTAGCTCCTACAATGAGCAGTTCTTC	CATINVPGTGGGSSYNEQFF	TRBV24-1	TRBJ2-1
TGTGCCAGCAATACTCTACTAGCCACCGGGGAGCTGTTTTTT	CASNTLLATGELFF	TRBV2	TRBJ2-2
TGTGCCAGCTCACCACCCCTTCTGACCCAGTACTTC	CASSPPLLTQYF	TRBV18	TRBJ2-5
TGCAGTGCTAGAGGACCCCGCCGGGACAGGGGCTTCCCTTGCCGTGAAGCTTTCTTT	CSARGPRRDRGFPCREAFF	TRBV20-1	TRBJ1-1
TGTGCCAGCAGCGTAAAAGGCGGGAGGGGCTACAATGAGCAGTTCTTC	CASSVKGGRGYNEQFF	TRBV9	TRBJ2-1
TGCGCCAGCAGCCGGCAGGGCAATAGCAATCAGCCCCAGCATTTT	CASSRQGNSNQPQHF	TRBV5-1	TRBJ1-5
TGTGCCAGCATACTGACAGGGGTGAAATATGGCTACACCTTC	CASILTGVKYGYTF	TRBV12-4	TRBJ1-2
TGTGCCAGCAGCTTAACGCTGTACGACCGGGACGAGCAGTACTTC	CASSLTLYDRDEQYF	TRBV7-3	TRBJ2-7
TGTGCCAGCACTTTGCGTGGACCAGGACGAGGGGATCCCGCTTTCTTT	CASTLRGPGRGDPAFF	TRBV27	TRBJ1-1
TGTGCCAGCAGTTACACCGGGGGGGGCACCACATACGAGCAGTACTTC	CASSYTGGGTTYEQYF	TRBV6-3	TRBJ2-7
TGTGCCAGCAGTTATTCTCGGGGTGATGAGCAGTTCTTC	CASSYSRGDEQFF	TRBV6-9	TRBJ2-1
TGTGCCAGCAAGCGGGAAACCTACGAGCAGTACTTC	CASKRETYEQYF	TRBV6-4	TRBJ2-7
TGTGCCAGCAGCTCGACTAGTGGGCTTGGGGGGCCCTACGAGCAGTACTTC	CASSSTSGLGGPYEQYF	TRBV11-3	TRBJ2-7
TGTGCCAGCAGCTTCCACCGGGACAGGGGAACTGGGGCCAACGTCCTGACTTTC	CASSFHRDRGTGANVLTF	TRBV9	TRBJ2-6
TGTGCCATTAGACAGAACACCGGGGAGCTGTTTTTT	CAIRQNTGELFF	TRBV28	TRBJ2-2
TGTGCCAGCAGCAATCCCGGGACAGGGGGCGGGGAGGGGTCTGGGGCCAACGTCCTGACTTTC	CASSNPGTGGGEGSGANVLTF	TRBV13	TRBJ2-6
TGTGCCAGCAGCTTAGCGCTGAGGAGCGTGTGGTGCCTAGCCAAAAACATTCAGTACTTC	CASSLALRSVWCLAKNIQYF	TRBV7-9	TRBJ2-4
TGTGCCAGCCTAGGGCGCTTTGGCCCGTTGAACACTGAAGCTTTCTTT	CASLGRFGPLNTEAFF	TRBV6-5	TRBJ1-1
TGCAGTGCTAGCGCGGGACCCGGGTCGGGGGTCTATGGCTACACCTTC	CSASAGPGSGVYGYTF	TRBV20-1	TRBJ1-2
TGTGCCACCAGTGAAAGCAGAAGACTCATGAACACTGAAGCTTTCTTT	CATSESRRLMNTEAFF	TRBV24-1	TRBJ1-1
TGTGCTACTTGCCGGCGACAGGGACCTAATTCACCCCTCCACTTT	CATCRRQGPNSPLHF	TRBV12-5	TRBJ1-6
TGTGCCAGCAGTTTATGTGGGGAGGGTCCCTCCTCGATGAACACTGAAGCTTTCTTT	CASSLCGEGPSSMNTEAFF	TRBV28	TRBJ1-1
TGTGCCAGCAGCAGAGGGAGTAATACAGGGGAGTACCAAGAGACCCAGTACTTC	CASSRGSNTGEYQETQYF	TRBV5-6	TRBJ2-5
TGTGCCAGCAGCTTAGGGGCCCATGCCTACGAGCAGTACTTC	CASSLGAHAYEQYF	TRBV7-9	TRBJ2-7
TGTGCCAGCGTGGGAGGGGCCTCTGGAAACACCATATATTTT	CASVGGASGNTIYF	TRBV7-9	TRBJ1-3
TGCGCCATCCACAGGAACGTGGCGACCGGGGAGCTGTTTTTT	CAIHRNVATGELFF	TRBV10-1	TRBJ2-2
TGTGCCAGTAGTATAGATCCTGGGATAGCGGGAGGTACCTACGAGCAGTACTTC	CASSIDPGIAGGTYEQYF	TRBV19	TRBJ2-7
TGTGCCAGCAGGCATGGCCGGGACAGTGGGAATACTGAAGCTTTCTTT	CASRHGRDSGNTEAFF	TRBV6-4	TRBJ1-1
TGTGCTAGTGGTCCGGACAGGGGGCATGAGCAGTTCTTC	CASGPDRGHEQFF	TRBV12-5	TRBJ2-1
TGCGCCAGCAGCCAAGATAAGGGGGGTGGTTACGAGCAGTACTTC	CASSQDKGGGYEQYF	TRBV4-1	TRBJ2-7
TGTGCCAGCAGCTTGGGATGTACAAACAATGAGCAGTTCTTC	CASSLGCTNNEQFF	TRBV5-6	TRBJ2-1
TGTGCCAGTAGTAACCCTAAGGCCGCCAAAAACATTCAGTACTTC	CASSNPKAAKNIQYF	TRBV19	TRBJ2-4
TGCGCCAGCAGCCAGCTAAGGCAAAACTCCTACGAGCAGTACTTC	CASSQLRQNSYEQYF	TRBV4-1	TRBJ2-7
TGTGCCAGCAGTCCCCCAAGGGGGTGCAACACCGGGGAGCTGTTTTTT	CASSPPRGCNTGELFF	TRBV6-2	TRBJ2-2
TGCGCCAGCCCCCTCCCGGCCTATTCTGAAAAACTGTTTTTT	CASPLPAYSEKLFF	TRBV5-1	TRBJ1-4
TGTGCCAGTAGTATAGCAGAGGTCCTGCGGGTGGGGGGTGGCTACACCTTC	CASSIAEVLRVGGGYTF	TRBV19	TRBJ1-2
TGTGCCAGCAGTTTCCTTTTCGGGACAGGAGAAAACATTCAGTACTTC	CASSFLFGTGENIQYF	TRBV12-4	TRBJ2-4
TGTGCCAGCAGCTCGTCTACGGGCCCAGGGGAGACCCAGTACTTC	CASSSSTGPGETQYF	TRBV11-2	TRBJ2-5
TGTGCCAGCAGCCGGAGTCATGGGGCCAATGAAAAACTGTTTTTT	CASSRSHGANEKLFF	TRBV3-1	TRBJ1-4
TGTGCCAGCAGCTTGGCATCCCTTGTCAGGGGGGTTATCTACAATGAGCAGTTCTTC	CASSLASLVRGVIYNEQFF	TRBV11-2	TRBJ2-1
TGTGCCAGCAGCGTAGACCGGGACAGGGAGCGCACTGAAGCTTTCTTT	CASSVDRDRERTEAFF	TRBV9	TRBJ1-1
TGTGCCAGGTGGGGGGAGGGGAGGTCCTACGAGCAGTACTTC	CARWGEGRSYEQYF	TRBV24-1	TRBJ2-7
TGTGCCAGCAGTGACCTCCGAAGGGGGGGGGGGGGTGAGCAGTTCTTC	CASSDLRRGGGGEQFF	TRBV25-1	TRBJ2-1
TGTGCCAGCAGTGTGGACAGGGCATCTAAGAAAAAAGAGACCCAGTACTTC	CASSVDRASKKKETQYF	TRBV7-3	TRBJ2-5
TGTGCCACCAGTAATTGGGACAGGGCGTCTAGCACAGATACGCAGTATTTT	CATSNWDRASSTDTQYF	TRBV24-1	TRBJ2-3
TGTGCCAGCAGCAAAAGGGGGGCCGGGGAGCTGTTTTTT	CASSKRGAGELFF	TRBV5-5	TRBJ2-2
TGTGCCAGCAGTTACTCGGGCGGCAACAATGAGCAGTTCTTC	CASSYSGGNNEQFF	TRBV6-5	TRBJ2-1
TGTGCCAGCAGTGACTACCACAGGGACAGAAGTTCACCCCTCCACTTT	CASSDYHRDRSSPLHF	TRBV6-4	TRBJ1-6
TGTGCCAGCAGCTGCCCCCGACTAGCGGTGAGCTCCTACGAGCAGTACTTC	CASSCPRLAVSSYEQYF	TRBV11-2	TRBJ2-7
TGTGCCAGCAGCTTAGGACTAGCGGTTTCTCTAGCCAAAAACATTCAGTACTTC	CASSLGLAVSLAKNIQYF	TRBV7-9	TRBJ2-4
TGCGCCAGCAGCTTGGCCGGTGGGGGGCCGCGGAACACCGGGGAGCTGTTTTTT	CASSLAGGGPRNTGELFF	TRBV5-1	TRBJ2-2
TGTGCCAGCTCACCGGTAAACGGTAACGCAAATCAGCCCCAGCATTTT	CASSPVNGNANQPQHF	TRBV18	TRBJ1-5
TGTGCCAGCAGCGGGGACACTTATGATACGCAGTATTTT	CASSGDTYDTQYF	TRBV11-3	TRBJ2-3
TGTGCCAGCAGTTTATCGGTTAGGGGGACAGGCAATCAGCCCCAGCATTTT	CASSLSVRGTGNQPQHF	TRBV27	TRBJ1-5
TGTGCCAGCAGCAAACGGGCATTAGCTGGCTCCTACAATGAGCAGTTCTTC	CASSKRALAGSYNEQFF	TRBV13	TRBJ2-1
TGCAGCGCCAGGGTCCACGAGCAGTACTTC	CSARVHEQYF	TRBV29-1	TRBJ2-7
TGCGCCAGCAGCCAAGACCAGCGGGAACACACTGAAGCTTTCTTT	CASSQDQREHTEAFF	TRBV4-1	TRBJ1-1
TGTGCCAGCAGTGGCGACAGGGGAAGCTCCTACGAGCAGTACTTC	CASSGDRGSSYEQYF	TRBV27	TRBJ2-7
TGTGCCACCAGTCTTCTCCTAGCGGGGGGGCCGGAAGAGACCCAGTACTTC	CATSLLLAGGPEETQYF	TRBV24-1	TRBJ2-5
TGCGCCACTGGGGGGGCCACAATCCCTAGCTCCTACGAGCAGTACTTC	CATGGATIPSSYEQYF	TRBV10-1	TRBJ2-7
TGTGCCAGCTCACGTAATTGCACAGGGTCATGTGTCTCACAGAACACTGAAGCTTTCTTT	CASSRNCTGSCVSQNTEAFF	TRBV18	TRBJ1-1
TGTGCCAGCAGCCTCCCCCGGGACAGGGCCTACGAGCAGTACTTC	CASSLPRDRAYEQYF	TRBV13	TRBJ2-7
TGCAGTGCTAGAGATAGCCGAGTCTTTCTCATTCAGTACTTC	CSARDSRVFLIQYF	TRBV20-1	TRBJ2-4
TGTGCTAGCAGCTTAGCCCCGGGGCGCTACCTCTACGAGCAGTACTTC	CASSLAPGRYLYEQYF	TRBV7-7	TRBJ2-7
TGTGCCTGGTTGACGGAGTTACTCCTCTACGAGCAGTACTTC	CAWLTELLLYEQYF	TRBV30	TRBJ2-7
TGTGCCAGCAGCAAGGACAGTGAATTGAACACTGAAGCTTTCTTT	CASSKDSELNTEAFF	TRBV28	TRBJ1-1
TGTGCCAGCAGCTTAGTCGATGAGACCCAGTACTTC	CASSLVDETQYF	TRBV7-8	TRBJ2-5
TGCGCCAGCAGCTTGTTTTTGGACAGGGAGGGGGGAAACACCATATATTTT	CASSLFLDREGGNTIYF	TRBV5-1	TRBJ1-3
TGCAGCGTTGACGTCCCAAAAGCTATGTGGCAAGAGACCCAGTACTTC	CSVDVPKAMWQETQYF	TRBV29-1	TRBJ2-5
TGCGCCAGCAGCCAAGATGGGACAGGGACCCAGTACTTC	CASSQDGTGTQYF	TRBV4-1	TRBJ2-5
TGTGCCAGCAGGATAGGACAGGGGGTCATTAGCTCCTACAATGAGCAGTTCTTC	CASRIGQGVISSYNEQFF	TRBV6-1	TRBJ2-1
TGCGCCAGCAGCCAAGACATCCTCAGATTGGGGGGGACAGATACGCAGTATTTT	CASSQDILRLGGTDTQYF	TRBV4-1	TRBJ2-3
TGTGCCAGCCGTCCCTTGGGGGGGCGCAATGAGCAGTTCTTC	CASRPLGGRNEQFF	TRBV27	TRBJ2-1
TGTGCCAGCAGAATACGACCGAACACTGAAGCTTTCTTT	CASRIRPNTEAFF	TRBV27	TRBJ1-1
TGCAGTGCTAGAAGTGGCCCTACGGGCAGCTACAATGAGCAGTTCTTC	CSARSGPTGSYNEQFF	TRBV20-1	TRBJ2-1
TGTGCCACCAGTGAGCATAGAACGAACACCGGGGAGCTGTTTTTT	CATSEHRTNTGELFF	TRBV24-1	TRBJ2-2
TGCAGTGCTAGAGAAGGACGGGAGGGCCCTCCGTACACCGGGGAGCTGTTTTTT	CSAREGREGPPYTGELFF	TRBV20-1	TRBJ2-2
TGCAGCGGCCACGTTCACATCACCCAGTACTTC	CSGHVHITQYF	TRBV29-1	TRBJ2-5
TGCAGTCGGTTACGGTCGGGGGGAAGAAGGTATGAGCAGTTCTTC	CSRLRSGGRRYEQFF	TRBV20-1	TRBJ2-1
TGTGCCACCAGTGATCGGGACCGCCACCAGGGATACAATGAGCAGTTCTTC	CATSDRDRHQGYNEQFF	TRBV24-1	TRBJ2-1
TGCGCCAGCAGCTTAACGCGACGGATCAGAACTTCCTACGAGCAGTACTTC	CASSLTRRIRTSYEQYF	TRBV5-1	TRBJ2-7
TGTGCCAGCAGGGGGACTAGCGACGAGCAGTACTTC	CASRGTSDEQYF	TRBV6-2	TRBJ2-7
TGTGCCAGCGGTTTCAGGCACTATGGCTACACCTTC	CASGFRHYGYTF	TRBV7-9	TRBJ1-2
TGCAGTGCTAGAGAACCCCGGGGGGACTACTCCTACAATGAGCAGTTCTTC	CSAREPRGDYSYNEQFF	TRBV20-1	TRBJ2-1
TGTGCCACCAGTGATTTGCCGGGCGTAGGCGTTCTCATGAACACTGAAGCTTTCTTT	CATSDLPGVGVLMNTEAFF	TRBV24-1	TRBJ1-1
TGTGCCAGCAGGGGACTAGCGGGAGGGCGGGGCACTGAAGCTTTCTTT	CASRGLAGGRGTEAFF	TRBV7-9	TRBJ1-1
TGTGCCAGCAGCCAAGTGTCCCCGGACAGGAGCTCTGGAAACACCATATATTTT	CASSQVSPDRSSGNTIYF	TRBV14	TRBJ1-3
TGCGCCAGCAGCTCGGAATTTCCGGGACAGGGCGCTTCGACCCAGTACTTC	CASSSEFPGQGASTQYF	TRBV5-1	TRBJ2-5
TGTGCCAGCAGTTTCTGGGAGGGGGCGGACAATCAGCCCCAGCATTTT	CASSFWEGADNQPQHF	TRBV5-6	TRBJ1-5
TGTGCCAGCAGTGAATCCCGAGAGGGTGGGGGCTATGGCTACACCTTC	CASSESREGGGYGYTF	TRBV6-1	TRBJ1-2
TGTGCCAGCAGTTTACCTGGGGGCCGGGCTAACTATGGCTACACCTTC	CASSLPGGRANYGYTF	TRBV12-4	TRBJ1-2
TGTGCCAGCGGTGTCCCTGGGGATGAAAAACTGTTTTTT	CASGVPGDEKLFF	TRBV27	TRBJ1-4
TGTGCCAGCAGCTATAGTACGGACAGCCCGTACTCCTACGAGCAGTACTTC	CASSYSTDSPYSYEQYF	TRBV7-3	TRBJ2-7
TGTGCCAGCAGTTACTCGACCTGGACTATGGTCGGCATTAACTATGGCTACACCTTC	CASSYSTWTMVGINYGYTF	TRBV6-5	TRBJ1-2
TGTGCCAGCAGTTTGAAGGGGGGCCCACGAACGAGGTACTTC	CASSLKGGPRTRYF	TRBV28	TRBJ2-5
TGTGCCAGCAGCTTAGTAATGAGTAGCTGCAAGCGAAACACCATATATTTT	CASSLVMSSCKRNTIYF	TRBV7-2	TRBJ1-3
TGCAGTGCGCGGACAGGGAACAATCAGCCCCAGCATTTT	CSARTGNNQPQHF	TRBV20-1	TRBJ1-5
TGTGCCAGCAGTTTAATCCAACTAGCGGGAGGGCGGATAGACAATGAGCAGTTCTTC	CASSLIQLAGGRIDNEQFF	TRBV27	TRBJ2-1
TGTGCCAGCAGTTTCTACGCTCGAGGGGGGGTCGCCGCTTTTTATAATTCACCCCTCCACTTT	CASSFYARGGVAAFYNSPLHF	TRBV27	TRBJ1-6
TGTGCCAGCAGCCTTCACCGACTAGGGTACGAGCAGTACTTC	CASSLHRLGYEQYF	TRBV7-4	TRBJ2-7
TGTGCCAGCAGCCCCGGCGGTACGGGTACGTACAATGAGCAGTTCTTC	CASSPGGTGTYNEQFF	TRBV11-2	TRBJ2-1
TGTGCCAGCAGTCACGATGGGGTCCGAAGCAATCAGCCCCAGCATTTT	CASSHDGVRSNQPQHF	TRBV27	TRBJ1-5
TGTGCCAGCAGCCAAGGACAGGGCGGCTCCTACGAGCAGTACTTC	CASSQGQGGSYEQYF	TRBV4-2	TRBJ2-7
TGTGCCAAGCGGGGCAACTATGGCTACACCTTC	CAKRGNYGYTF	TRBV27	TRBJ1-2
TGTGCCAGCAGACGGACAGGGAGCCATGAAAAACTGTTTTTT	CASRRTGSHEKLFF	TRBV7-9	TRBJ1-4
TGTGCCAGCAGTTCCGGGGGGGGCCTGAATCGGGAGACCCAGTACTTC	CASSSGGGLNRETQYF	TRBV27	TRBJ2-5
TGTGCCAGCAGCTTAGCTAGCGGGGGGGATGAGCAGTTCTTC	CASSLASGGDEQFF	TRBV7-8	TRBJ2-1
TGCAGTGCTGGGAAGAAAGGGCGGGCCTGCTACGAGCAGTACTTC	CSAGKKGRACYEQYF	TRBV20-1	TRBJ2-7
TGTGCCAGCAGTTTAACTTCCCCCGGACAGGAGGCCTACGAGCAGTACTTC	CASSLTSPGQEAYEQYF	TRBV12-3	TRBJ2-7
TGTGCCAGCAGCCACCCGGGGGGGCCCTCCTACGAGCAGTACTTC	CASSHPGGPSYEQYF	TRBV4-2	TRBJ2-7
TGTGCCAGTAGTGGGAACGAGAACACTGAAGCTTTCTTT	CASSGNENTEAFF	TRBV19	TRBJ1-1
TGTGCCAGCAGCTTAGAAAGGACAGCGCCTGATAGCAATCAGCCCCAGCATTTT	CASSLERTAPDSNQPQHF	TRBV7-9	TRBJ1-5
TGTGCCAGCAGCACAACACTGGCAACTAATGAAAAACTGTTTTTT	CASSTTLATNEKLFF	TRBV11-2	TRBJ1-4
TGTGCCAGCAGCTTAGAGAAATACAATGGGACAGAAAGGGGGCGCAATCAGCCCCAGCATTTT	CASSLEKYNGTERGRNQPQHF	TRBV7-9	TRBJ1-5
TGTGCCAGCAGCCTCAGGGGGGCTGGAAACACCATATATTTT	CASSLRGAGNTIYF	TRBV7-9	TRBJ1-3
TGCGCCAGCATGGAAAGGACTAGGTACAAAAACATTCAGTACTTC	CASMERTRYKNIQYF	TRBV10-1	TRBJ2-4
TGTGCCAGCAGTGCGAACGGGACACGCCGCTATGGCTACACCTTC	CASSANGTRRYGYTF	TRBV6-4	TRBJ1-2
TGTGCCAGCTTTAAAGAGAAGGGGGCGAAAGAAAAACTGTTTTTT	CASFKEKGAKEKLFF	TRBV7-3	TRBJ1-4
TGTGCCAGCAGCGGCCCGGGACAGGGGATTGAGCAGTTCTTC	CASSGPGQGIEQFF	TRBV7-3	TRBJ2-1
TGTGCCAGCAGCCTGGGCCGAGCCGGCTACACCTTC	CASSLGRAGYTF	TRBV12-4	TRBJ1-2
TGTGCCAGCAGTTTACCGAGACAGGGCCCATCCTTC	CASSLPRQGPSF	TRBV12-3	TRBJ1-2
TGTGCCAGCGTCGGTCCCGCCCCTAACGGAGAGCCTAACTATGGCTACACCTTC	CASVGPAPNGEPNYGYTF	TRBV2	TRBJ1-2
TGTGCCAGCCTGCGGGACAGGGGGGGTCCAAGCGCCTATGGCTACACCTTC	CASLRDRGGPSAYGYTF	TRBV6-4	TRBJ1-2
TGTGCCAGCAGAAAACGGTCGTCCTACGAGCAGTACTTC	CASRKRSSYEQYF	TRBV28	TRBJ2-7
TGTGCCAGCAGTTTTTACCGGGCTCCTTACGAGCAGTACTTC	CASSFYRAPYEQYF	TRBV27	TRBJ2-7
TGTGCCAGCAGCCAACCGGGACACAATGAGCAGTTCTTC	CASSQPGHNEQFF	TRBV3-1	TRBJ2-1
TGCGCCAGCAGCTTGCTACAGGGGCTCTACGAGCAGTACTTC	CASSLLQGLYEQYF	TRBV5-1	TRBJ2-7
TGTGCCTGGAAAGGGGCCGACTACGAGCAGTACTTC	CAWKGADYEQYF	TRBV30	TRBJ2-7
TGTGCCAGCCACGTCACGTCCAGGGAGTCCTACGAGCAGTACTTC	CASHVTSRESYEQYF	TRBV27	TRBJ2-7
TGTGCCATCAGGTCTTCGGACAGGGAGGGAGATGAGCAGTTCTTC	CAIRSSDREGDEQFF	TRBV10-3	TRBJ2-1
TGCGCCAGCGGTAGGCCGGGACAGCGACAAAACTATGGCTACACCTTC	CASGRPGQRQNYGYTF	TRBV5-1	TRBJ1-2
TGTGCCAGCAGACCGCTGGGAAAGGAATGCGCCTACGAGCAGTACTTC	CASRPLGKECAYEQYF	TRBV27	TRBJ2-7
TGTGCCAGTAGTATAAATCAGGGGGGGCCTTACGAGCAGTACTTC	CASSINQGGPYEQYF	TRBV19	TRBJ2-7
TGCGCCAGCAGCTACCGGGGCTATAATTCACCCCTCCACTTT	CASSYRGYNSPLHF	TRBV5-1	TRBJ1-6
TGTGCCACCGAAATGTCCGACGGGTTGACCTTC	CATEMSDGLTF	TRBV24-1	TRBJ1-2
TGTGCCAGCGACATGCGGAGTGCTTTCTTT	CASDMRSAFF	TRBV6-5	TRBJ1-1
TGCGCCAGCAGCTTGGTAAACAGAGTAGCGGTCTATAATTCACCCCTCCACTTT	CASSLVNRVAVYNSPLHF	TRBV5-1	TRBJ1-6
TGTGCCAGCAGCCAACCTTACCCATTCCGTAATGAGCAGTTCTTC	CASSQPYPFRNEQFF	TRBV9	TRBJ2-1
TGTGCCAGCAGTAATAGGTACTACGAGCAGTACTTC	CASSNRYYEQYF	TRBV27	TRBJ2-7
TGTGCCAGCAATACCAGGACAGGGGGCAGAGTTCCCTCCTACGAGCAGTACTTC	CASNTRTGGRVPSYEQYF	TRBV7-6	TRBJ2-7
TGTGCCCGGCCAGCAAAGGGGACCAAACTGTTTTTT	CARPAKGTKLFF	TRBV10-3	TRBJ1-4
TGCGCCAGCAGGACATGCCGGACAGACGAGCAGTACTTC	CASRTCRTDEQYF	TRBV10-1	TRBJ2-7
TGCGCCAGCACATGCCGGGACAGGGGGCGAGGATGCTACGAGCAGTACTTC	CASTCRDRGRGCYEQYF	TRBV10-1	TRBJ2-7
TGCGCCAGCAGCTTGTTCGCCACCACCGGGACAGTGGAGACCCAGTACTTC	CASSLFATTGTVETQYF	TRBV5-1	TRBJ2-5
TGTGCTAGTGGTTCGTTTGGCAGGGTGATGACGCAGTATTTT	CASGSFGRVMTQYF	TRBV12-5	TRBJ2-3
TGTGCCAGCAGGCCTTCTCGCGGGAGGACCCGCAATCAGCCCCAGCATTTT	CASRPSRGRTRNQPQHF	TRBV7-6	TRBJ1-5
TGTGCCAGCAGGGACCGACACAATGAGCAGTTCTTC	CASRDRHNEQFF	TRBV6-5	TRBJ2-1
TGTGCCAGCAGCTTGGCTGGCCAGGTCGGCTCCTACGAGCAGTACTTC	CASSLAGQVGSYEQYF	TRBV5-5	TRBJ2-7
TGTGCCAGCAGCGACTATCTAGCGGCCTACGAGCAGTACTTC	CASSDYLAAYEQYF	TRBV7-4	TRBJ2-7
TGCGCCAGCAGTGGACAGGAGCCCCAGCATTTT	CASSGQEPQHF	TRBV10-1	TRBJ1-5
TGTGCCACCAGTGATTTGCCTGGGGAGAGCTGCTACAAAAAAGGCTACACCTTC	CATSDLPGESCYKKGYTF	TRBV24-1	TRBJ1-2
TGTGCCACCAGTGCCCGGCAGGGGCCTTCCTTCGCCAAGACCTACGAGCAGTACTTC	CATSARQGPSFAKTYEQYF	TRBV24-1	TRBJ2-7
TGTGCTAGTGGTTATGCCCTAGGGACCCAGTACTTC	CASGYALGTQYF	TRBV12-5	TRBJ2-5
TGTGCCAGCAGGGAGCGGGAGGAGCAAGAGACCCAGTACTTC	CASREREEQETQYF	TRBV7-2	TRBJ2-5
TGTGCCAGCAAGTCTCCGGACAGAGGGTACGAGCAGTACTTC	CASKSPDRGYEQYF	TRBV9	TRBJ2-7
TGCGCCAGCTACGGCCCTGGTCAGCCCCAGCATTTT	CASYGPGQPQHF	TRBV10-1	TRBJ1-5
TGCGCCAGCAGCCAAGATGGGGCAATACAGGGCTGTTATAGCAATCAGCCCCAGCATTTT	CASSQDGAIQGCYSNQPQHF	TRBV4-3	TRBJ1-5
TGCGCCAGCAGCTTGATCCCAGGACGGTGCTCCTATGGCTACACCTTC	CASSLIPGRCSYGYTF	TRBV5-1	TRBJ1-2
TGTGCTCTCTGGGGGGGAATCTCCTACGAGCAGTACTTC	CALWGGISYEQYF	TRBV11-3	TRBJ2-7
TGCAGTGCTAGAGCTTCCTGGGGGGGGTATGAGCAGTTCTTC	CSARASWGGYEQFF	TRBV20-1	TRBJ2-1
TGTGCCAGCAGCTCCTTCCGGGAGAATCCGGAGACCCAGTACTTC	CASSSFRENPETQYF	TRBV13	TRBJ2-5
TGTGCCTACTGGACAGCCCCAGGCTACGAGCAGTACTTC	CAYWTAPGYEQYF	TRBV24-1	TRBJ2-7
TGCGCCAGCAGCCAAGATCCCCAGGAGCCCGACACTGAAGCTTTCTTT	CASSQDPQEPDTEAFF	TRBV4-1	TRBJ1-1
TGTGCCTGGAGTGGCAAACGGGTCCCAGCTAGCGGGGTTCCTGAGCAGTTCTTC	CAWSGKRVPASGVPEQFF	TRBV30	TRBJ2-1
TGTGCCAGCGGGCCCGGGGTCAGACAGGAACCCTACGAGCAGTACTTC	CASGPGVRQEPYEQYF	TRBV6-4	TRBJ2-7
TGTGACAACAGGACAGGGCACAACACCATATATTTT	CDNRTGHNTIYF	TRBV4-2	TRBJ1-3
TGTGCCAGCAAATGGACACAGATGAACACTGAAGCTTTCTTT	CASKWTQMNTEAFF	TRBV27	TRBJ1-1
TGTGCCTGGAGTCCAGTGTACGAGCAGTACTTC	CAWSPVYEQYF	TRBV30	TRBJ2-7
TGTGCCAGCAGCTTAGCGACCAACAGGGGGCGCGGCGAGTGGGCAACTAATGAAAAACTGTTTTTT	CASSLATNRGRGEWATNEKLFF	TRBV7-8	TRBJ1-4
TGTGCCACTGGGGCAGTTGGGGACGAGCAGTACTTC	CATGAVGDEQYF	TRBV12-4	TRBJ2-7
TGTGCCAGCAGTCGGACAGACACTGGAAACACCATATATTTT	CASSRTDTGNTIYF	TRBV6-2	TRBJ1-3
TGTGCCAGCAGCTCGTCGGGGACAGGGGCGCACAGCACAGATACGCAGTATTTT	CASSSSGTGAHSTDTQYF	TRBV7-9	TRBJ2-3
TGCGCCAGCAGCTTGGCCCGAGACTACGAGCAGTACTTC	CASSLARDYEQYF	TRBV5-1	TRBJ2-7
TGCGCCAGCAGCTTAGTTCATCCAGGGGGCGCCTCCTACGAGCAGTACTTC	CASSLVHPGGASYEQYF	TRBV5-1	TRBJ2-7
TGTGCCAGCAGCCCCATCGGTAGTTTGCCAACTAATGAAAAACTGTTTTTT	CASSPIGSLPTNEKLFF	TRBV9	TRBJ1-4
TGTGCCACGGTCGGGGCCTACGAGCAGTACTTC	CATVGAYEQYF	TRBV3-1	TRBJ2-7
TGTGCCAGCAGAGAAAGATCCACTGGTGAAAAACTGTTTTTT	CASRERSTGEKLFF	TRBV7-9	TRBJ1-4
TGTGCCAGCAGCTTCCAGGGGGTTACCTACACCGGGACAGGGAAGAATCAGCCCCAGCATTTT	CASSFQGVTYTGTGKNQPQHF	TRBV11-3	TRBJ1-5
TGTGCCAGCAGCTTCGTCGGACAGGGGCGGATCATGAACACTGAAGCTTTCTTT	CASSFVGQGRIMNTEAFF	TRBV5-5	TRBJ1-1
TGTGCCGCCCGGGGGACAGGGTATCGGGGATTATACGAGCAGTACTTC	CAARGTGYRGLYEQYF	TRBV6-5	TRBJ2-7
TGTGCCACCAGTGATCCGGTCGGACGCCAGTCAGATACGCAGTATTTT	CATSDPVGRQSDTQYF	TRBV24-1	TRBJ2-3
TGCAGTGCTAGCCTTGCGGGGCGTGATACGCAGTATTTT	CSASLAGRDTQYF	TRBV20-1	TRBJ2-3
TGTGCCATACAGAAGATAGTGAACACTGAAGCTTTCTTT	CAIQKIVNTEAFF	TRBV5-4	TRBJ1-1
TGTGCCAGCAGTTGGATCCCGGGACAGGTGCCCTGCGATGGCTACACCTTC	CASSWIPGQVPCDGYTF	TRBV6-3	TRBJ1-2
TGTGCCTGGAGTGTACCCGGGACTAGGAGCTTTAGCTCCTACGAGCAGTACTTC	CAWSVPGTRSFSSYEQYF	TRBV30	TRBJ2-7
TGTGCCAGCAGGGGACCCTCGAACACCGGGGAGCTGTTTTTT	CASRGPSNTGELFF	TRBV6-3	TRBJ2-2
TGCGCCAGCAGCTCATTGGCAGGGGAGGGGAGCTCCTACAATGAGCAGTTCTTC	CASSSLAGEGSSYNEQFF	TRBV5-1	TRBJ2-1
TGTGCCAGCAGACTAGCGGGAGTCGCATTAGAGGCTGAAGCTTTCTTT	CASRLAGVALEAEAFF	TRBV16	TRBJ1-1
TGTGCCAGCAGCGACCTGGGGTACCAAGAGACCCAGTACTTC	CASSDLGYQETQYF	TRBV7-9	TRBJ2-5
TGTGCCAGCAGTGAAGGTAAAGGTTCTTACAATGAGCAGTTCTTC	CASSEGKGSYNEQFF	TRBV6-4	TRBJ2-1
TGTGCCAGCAGGATCCGGGGACTAGCGACCGGCTACAATGAGCAGTTCTTC	CASRIRGLATGYNEQFF	TRBV9	TRBJ2-1
TGTGCCAGCAGTTTACGGGGGGATGGAAGGTGCTACGAGCAGTACTTC	CASSLRGDGRCYEQYF	TRBV28	TRBJ2-7
TGTGCCAGCAGCTACCCGACAGGGTTTTCGGGTGGAAACACCATATATTTT	CASSYPTGFSGGNTIYF	TRBV7-6	TRBJ1-3
TGTGCCAGCAGCACAGATTCACCCCTCCACTTT	CASSTDSPLHF	TRBV7-4	TRBJ1-6
TGTGCCAGCAGCCAAGATAAGCGTGGAGTGGGGGAAGAGACCGGAGATGAGCAGTTCTTC	CASSQDKRGVGEETGDEQFF	TRBV3-1	TRBJ2-1
TGTGCCAGCGATCGAAGAGGCTTCCCGGCGCAGTATTTT	CASDRRGFPAQYF	TRBV6-5	TRBJ2-3
TGTGCCAGCAGCCTCCGGCACTGGTGGTCCGGGGAGCTGTTTTTT	CASSLRHWWSGELFF	TRBV14	TRBJ2-2
TGCGCCAGCAGCTCTTTGGCCGGGATGAACACTGAAGCTTTCTTT	CASSSLAGMNTEAFF	TRBV5-1	TRBJ1-1
TGTGCCAGCAGGGTAGGACAGGGCTACGAGCAGTACTTC	CASRVGQGYEQYF	TRBV7-9	TRBJ2-7
TGTGCCATCAGGGGGGGGGGCAATCAGCCCCAGCATTTT	CAIRGGGNQPQHF	TRBV10-3	TRBJ1-5
TGTGCCAGCAGTTTAGCCGGGGACAGGAAGTATAGCAATCAGCCCCAGCATTTT	CASSLAGDRKYSNQPQHF	TRBV28	TRBJ1-5
TGTGCCACCAGTGATTTGGTCAGGGGGCCAGGCTCCTACGAGCAGTACTTC	CATSDLVRGPGSYEQYF	TRBV24-1	TRBJ2-7
TGTGCCAGCAGCTCGCCAGCCGAGCAGTACTTC	CASSSPAEQYF	TRBV7-2	TRBJ2-7
TGTGCCAGCAGCCACCCCCCCGCCCCGGGACAGGGACGAGAAAAACTGTTTTTT	CASSHPPAPGQGREKLFF	TRBV14	TRBJ1-4
TGTGCCAGCAGCTTTTACAGGGAATCTAGCAATCAGCCCCAGCATTTT	CASSFYRESSNQPQHF	TRBV7-3	TRBJ1-5
TGTGCCAGCAGTGAGAGGCCGACCTCGTACGAGCAGTACTTC	CASSERPTSYEQYF	TRBV25-1	TRBJ2-7
TGTGCCAGCAAAGGACAGGATTATAATTCACCCCTCCACTTT	CASKGQDYNSPLHF	TRBV6-5	TRBJ1-6
TGTGCCAGCAGCATCAAATGGGACGGTATCTATGGCTACACCTTC	CASSIKWDGIYGYTF	TRBV11-2	TRBJ1-2
TGTGCCAGCAGCACTAAGTTTGGGGAAAGGAGCAATCAGCCCCAGCATTTT	CASSTKFGERSNQPQHF	TRBV5-4	TRBJ1-5
TGTGCCACCAGCAGAGAAGGGGGGGAAGCTTTCTTT	CATSREGGEAFF	TRBV15	TRBJ1-1
TGTGCCACCAGTGGCCACAGGGCGGGCACCTATGGCTACACCTTC	CATSGHRAGTYGYTF	TRBV24-1	TRBJ1-2
TGTGCCAGCAGACCAGGACAGGGCGATAGCAATCAGCCCCAGCATTTT	CASRPGQGDSNQPQHF	TRBV6-1	TRBJ1-5
TGTGCCAGCAGCAGGAGCAATCCTAGCGGGAAAGAGACCCAGTACTTC	CASSRSNPSGKETQYF	TRBV7-9	TRBJ2-5
TGTGCCACTCCTATACCGAGCGGGACAGGGGGTGGAAACTCTGGGGCCAACGTCCTGACTTTC	CATPIPSGTGGGNSGANVLTF	TRBV24-1	TRBJ2-6
TGTGCCAGCAGAAAAGAGGGGGAGGTCTCTGGGGCCAACGTCCTGACTTTC	CASRKEGEVSGANVLTF	TRBV11-1	TRBJ2-6
TGTGCCTGGTCGGGGGACATCATGAACACTGAAGCTTTCTTT	CAWSGDIMNTEAFF	TRBV30	TRBJ1-1
TGCGCCAGCAGTGCACCCGGGGACAGGAGGGACTATGGCTACACCTTC	CASSAPGDRRDYGYTF	TRBV10-1	TRBJ1-2
TGTGCCAGCAGCCGCCGGGACAGGGGTAACTATGGCTACACCTTC	CASSRRDRGNYGYTF	TRBV5-5	TRBJ1-2
TGCAGTGCACCCCCGAAATTCCGGGACAACCTCCCCAGAGCTTTCTTT	CSAPPKFRDNLPRAFF	TRBV20-1	TRBJ1-1
TGTGCCAGCAGAGGCGGTAGACACTATGGCTACACCTTC	CASRGGRHYGYTF	TRBV27	TRBJ1-2
TGCGCCAGCAGCTCAGGTCCCAGACAGGTTAACACTGAAGCTTTCTTT	CASSSGPRQVNTEAFF	TRBV5-1	TRBJ1-1
TGCAGTGCTAGAGGGCCTAATCTCCCGGCCTGGCTAGCGGGACGGGACGAGCAGTACTTC	CSARGPNLPAWLAGRDEQYF	TRBV20-1	TRBJ2-7
TGTGCCAGCAGCTTTTTGGGACAGGGGTTTACGAACACCGGGGAGCTGTTTTTT	CASSFLGQGFTNTGELFF	TRBV7-4	TRBJ2-2
TGTGCCAGCAGTTCTTGGACAGGGGTCTGCACAGATACGCAGTATTTT	CASSSWTGVCTDTQYF	TRBV6-5	TRBJ2-3
TGTGCCACCAGTAAGGGACCGGGACAAGCCAGGTCGCTTGAGCAGTTCTTC	CATSKGPGQARSLEQFF	TRBV24-1	TRBJ2-1
TGCAGTGCTGGCGGGATAGCGTACAATGAGCAGTTCTTC	CSAGGIAYNEQFF	TRBV20-1	TRBJ2-1
TGCGCCAGCAGCGCCAGAAGCTCCTACGAGCAGTACTTC	CASSARSSYEQYF	TRBV10-2	TRBJ2-7
TGTGCCAGCAGCCTAGCGGGGGCTCACATGAACACTGAAGCTTTCTTT	CASSLAGAHMNTEAFF	TRBV14	TRBJ1-1
TGTGCGCCCGGCAAACGCTCCTACGAGCAGTACTTC	CAPGKRSYEQYF	TRBV2	TRBJ2-7
TGTGCCAGCAGCTTAACCCAGGGTTGTCAGCCCCAGCATTTT	CASSLTQGCQPQHF	TRBV7-3	TRBJ1-5
TGTGCCAGCAGCAAAACTCGTAGCATCACCCGGGACAGGGGGGGGGGACAGCCCCAGCATTTT	CASSKTRSITRDRGGGQPQHF	TRBV9	TRBJ1-5
TGTGCCAGCGGAGGATTATTAGGGCTCACTGAAGCTTTCTTT	CASGGLLGLTEAFF	TRBV27	TRBJ1-1
TGCAGTGCGTCTGGAATGGCGGGACAGGGACACGATCTCCAGCCCCAGCATTTT	CSASGMAGQGHDLQPQHF	TRBV20-1	TRBJ1-5
TGTGCCAGCAGCGTAGCTGGGGTAGAAGATAATGAAAAACTGTTTTTT	CASSVAGVEDNEKLFF	TRBV9	TRBJ1-4
TGTGCCAGCAGCACTGACGATAAAGACTCCTACGAGCAGTACTTC	CASSTDDKDSYEQYF	TRBV5-4	TRBJ2-7
TGTGCCAGCAGCCCTTGGGACAGGGGGCCCCTCGCCGAGGGCAGCAATCAGCCCCAGCATTTT	CASSPWDRGPLAEGSNQPQHF	TRBV7-3	TRBJ1-5
TGTGCCAGCAGCCTGGAGACCGCAACTAGGGACGGGGAGCTGTTTTTT	CASSLETATRDGELFF	TRBV13	TRBJ2-2
TGCGCCGTGCAGGGACAAGGGCCGAATCAGCCCCAGCATTTT	CAVQGQGPNQPQHF	TRBV5-1	TRBJ1-5
TGCAGCGTTGGGACAGGGGGAGCCTATAATTCACCCCTCCACTTT	CSVGTGGAYNSPLHF	TRBV29-1	TRBJ1-6
TGCAGTGCTCCGGACAAGGCTCAGCCCCAGCATTTT	CSAPDKAQPQHF	TRBV20-1	TRBJ1-5
TGTGCCAGCAGTTTTCCGGGACTCTTC	CASSFPGLF	TRBV27	TRBJ2-1
TGTGCCAGCAGCTTACACGGGACCACGTACAATGAGCAGTTCTTC	CASSLHGTTYNEQFF	TRBV7-2	TRBJ2-1
TGTGCCAGCAGCTTAGTGCATTGGAGGACACAAGAGACCCAGTACTTC	CASSLVHWRTQETQYF	TRBV7-9	TRBJ2-5
TGCGCCAGCAGCTCCACGACCCACGGGTCCAACACCGGGGAGCTGTTTTTT	CASSSTTHGSNTGELFF	TRBV5-1	TRBJ2-2
TGTGCTAGTGGTTTGGTATATTTGGACTCTCGGCACGAAAAACTGTTTTTT	CASGLVYLDSRHEKLFF	TRBV12-5	TRBJ1-4
TGTGCCAGCACAAACGGTGTTACAGGGGGATACGAGCAGTACTTC	CASTNGVTGGYEQYF	TRBV11-3	TRBJ2-7
TGCGCCAAGTTACAAGAGACCCAGTACTTC	CAKLQETQYF	TRBV5-1	TRBJ2-5
TGTGCCAGCCCTAGCACAGATACGCAGTATTTT	CASPSTDTQYF	TRBV6-6	TRBJ2-3
TGTGCCAGCAGTCCCCCGATCCTACGGGCAGTGTCGGACAATAGCAATCAGCCCCAGCATTTT	CASSPPILRAVSDNSNQPQHF	TRBV28	TRBJ1-5
TGTGCCAGCAGCATTGGGCAGGGACAATGCCACTATGGCTACACCTTC	CASSIGQGQCHYGYTF	TRBV5-4	TRBJ1-2
TGTGCCAGCAGTTCTCGCCGGTGGGACAGCCCGAACACCGGGGAGCTGTTTTTT	CASSSRRWDSPNTGELFF	TRBV6-3	TRBJ2-2
TGTGCCAGCAGCCCCCGTTACAGTATGGAGCAGTACTTC	CASSPRYSMEQYF	TRBV13	TRBJ2-7
TGTGCCAGCAGCCCTCGACAGGGGGAGACCCAGTACTTC	CASSPRQGETQYF	TRBV7-3	TRBJ2-5
TGCGCCAGCAGCAGCCGAAACACTGAAGCTTTCTTT	CASSSRNTEAFF	TRBV5-1	TRBJ1-1
TGTGCCAGCAGTTACCCAACTTTCGGGACAGGGGGGTGCTACGAGCAGTACTTC	CASSYPTFGTGGCYEQYF	TRBV6-5	TRBJ2-7
TGCAGTGCTAGTTGGAACCAGGTACTAGCGGGGTTTTGCACAGATACGCAGTATTTT	CSASWNQVLAGFCTDTQYF	TRBV20-1	TRBJ2-3
TGTGCCATCAGTGCGTCGTACTACGAGCAGTACTTC	CAISASYYEQYF	TRBV10-3	TRBJ2-7
TGTGCCTGGAAAGGGGCCATTATGAGGGGGGCCAACGTCCTGACTTTC	CAWKGAIMRGANVLTF	TRBV30	TRBJ2-6
TGTGCCAGCAGCGTATGGGTAGCGGGAGGGAATACGCAGTATTTT	CASSVWVAGGNTQYF	TRBV9	TRBJ2-3
TGTGCCAGCAGTTTAATTAACCACCAACGGGACAGTGTGAACACTGAAGCTTTCTTT	CASSLINHQRDSVNTEAFF	TRBV12-3	TRBJ1-1
TGTGCCACCACGCAGGGGGCGCGCCTTGCGATCCAAGAGACCCAGTACTTC	CATTQGARLAIQETQYF	TRBV24-1	TRBJ2-5
TGTGCCAGTAGTATATCGAGGAACAATGAGCAGTTCTTC	CASSISRNNEQFF	TRBV19	TRBJ2-1
TGCGCCAGCAGATTCTCCGGCGGCTACACCTTC	CASRFSGGYTF	TRBV10-1	TRBJ1-2
TGCGCCAGCCGTATAGGGAGGGGTTGCGAGTCCGGGGAGCTGTTTTTT	CASRIGRGCESGELFF	TRBV4-1	TRBJ2-2
TGTGCCAGCAGTGTACGCTGCAGGGCGGGGAACACTGAAGCTTTCTTT	CASSVRCRAGNTEAFF	TRBV25-1	TRBJ1-1
TGTGCCAGCAGCCCGAACGGGGGGGGGGGAGAGACCCAGTACTTC	CASSPNGGGGETQYF	TRBV5-5	TRBJ2-5
TGCGCCAGCAGCCAAAACACAAGGGGGGGAGAGACCCAGTACTTC	CASSQNTRGGETQYF	TRBV4-3	TRBJ2-5
TGTGCCAGCAATGGACTAGGGGACGAGCAGTACTTC	CASNGLGDEQYF	TRBV12-4	TRBJ2-7
TGCGCCAGCAGCCAAGAGGGAACGGGGGTATTAAGCTCCTATAATTCACCCCTCCACTTT	CASSQEGTGVLSSYNSPLHF	TRBV4-3	TRBJ1-6
TGTGCCAGCAGTTACTCGTGGGACAGGGGGCGGTCAGAGGACACCGGGGAGCTGTTTTTT	CASSYSWDRGRSEDTGELFF	TRBV6-5	TRBJ2-2
TGTGCCAGCAGAGAACCGGGACAGGGAGGGAGCAACTATGGCTACACCTTC	CASREPGQGGSNYGYTF	TRBV6-5	TRBJ1-2
TGTGCCAGTAGTATAGTTACGATGGGGAGGTCGCGGGGATATCACACTGAAGCTTTCTTT	CASSIVTMGRSRGYHTEAFF	TRBV19	TRBJ1-1
TGTGCCAGCAGTGACGCCGGGGGTCAGGGGCGCCTGGAGACCCAGTACTTC	CASSDAGGQGRLETQYF	TRBV6-1	TRBJ2-5
TGTGCCAACCCCCCACAGGGCGGCTACGAGCAGTACTTC	CANPPQGGYEQYF	TRBV14	TRBJ2-7
TGTGCCAGCAGCTTAAGGGCGAGGGATGGCTACACCTTC	CASSLRARDGYTF	TRBV7-3	TRBJ1-2
TGTGCCAGCAGCTTCGCAGGAGGCACAGATACGCAGTATTTT	CASSFAGGTDTQYF	TRBV11-2	TRBJ2-3
TGTGCCAGCAGCGGGGCTGGTTTAGGCAATCAGCCCCAGCATTTT	CASSGAGLGNQPQHF	TRBV13	TRBJ1-5
TGTGCCAGCACCCGACAGGGGGCAATAAGAAGCAATCAGCCCCAGCATTTT	CASTRQGAIRSNQPQHF	TRBV13	TRBJ1-5
TGTGCCAGCAGGGGTGGGGGGCCGGGCTCTGGGGCCAACGTCCTGACTTTC	CASRGGGPGSGANVLTF	TRBV12-4	TRBJ2-6
TGCGCCAGCAGTGAGCAGCAGGGTGTTCGCAATCAGCCCCAGCATTTT	CASSEQQGVRNQPQHF	TRBV10-1	TRBJ1-5
TGTGCCAGTGTATGGGGATGGAACACTGAAGCTTTCTTT	CASVWGWNTEAFF	TRBV2	TRBJ1-1
TGTGCCAGCAGCCTTCCAATCCCGGGACAGACACCCTACAATGAGCAGTTCTTC	CASSLPIPGQTPYNEQFF	TRBV3-1	TRBJ2-1
TGTGCCACCAGCCGCAGGGTTGCCAAAAACATTCAGTACTTC	CATSRRVAKNIQYF	TRBV24-1	TRBJ2-4
TGTGCCAGCAGCGGGCGTACCTGGGACAGGGAGTCTGAAGCTTTCTTT	CASSGRTWDRESEAFF	TRBV9	TRBJ1-1
TGTGCCAGCACAGGGGGCATCCCCGGCTACACCTTC	CASTGGIPGYTF	TRBV7-4	TRBJ1-2
TGTGCCAGCAGCTTTAAGACGACGCACAGGGGGAACACCGGGGAGCTGTTTTTT	CASSFKTTHRGNTGELFF	TRBV11-3	TRBJ2-2
TGTGCCACCAGTGATTTTGGGGGGCGGGCCCCTCAAGAGACCCAGTACTTC	CATSDFGGRAPQETQYF	TRBV24-1	TRBJ2-5
TGTGCCAGCAGTTACATCAATTTATCCTCAGGGACTAGCGGGCAACAAGGAGGCGAGCAGTACTTC	CASSYINLSSGTSGQQGGEQYF	TRBV6-3	TRBJ2-7
TGTGCCAGCAGCCGGGGCGCTTTCTTT	CASSRGAFF	TRBV13	TRBJ1-1
TGTGCCAGCAGCTTAACACTAGCGGGAGGTCGAGGGCGATCCTACGAGCAGTACTTC	CASSLTLAGGRGRSYEQYF	TRBV7-3	TRBJ2-7
TGTGCCAGCAGTTTCGGGACGGTTAACACCGGGGAGCTGTTTTTT	CASSFGTVNTGELFF	TRBV27	TRBJ2-2
TGCGCCAGCAGTGAGTCCGAGGGGGGGCGGACCTACGAGCAGTACTTC	CASSESEGGRTYEQYF	TRBV10-1	TRBJ2-7
TGTGCCACCGTCCAACGGCAGGGCGAAAATTCACCCCTCCACTTT	CATVQRQGENSPLHF	TRBV24-1	TRBJ1-6
TGTGCCAGCAGCCAAGATGAACCGGCGCCTTTCGGGACAAGAGCCTCTGGAAACACCATATATTTT	CASSQDEPAPFGTRASGNTIYF	TRBV4-2	TRBJ1-3
TGTGCCAGTAGTCCAGAAGACCTTAGGGTGAATCAGCCCCAGCATTTT	CASSPEDLRVNQPQHF	TRBV19	TRBJ1-5
TGTGCCAGCAGCCCAGAGAACTATAATTCACCCCTCCACTTT	CASSPENYNSPLHF	TRBV6-2	TRBJ1-6
TGTGCAACGACAGGGGTTAGCTACGAGCAGTACTTC	CATTGVSYEQYF	TRBV3-1	TRBJ2-7
TGTGCCAGCAGTCATGGCTATCAGTACGAGCAGTACTTC	CASSHGYQYEQYF	TRBV2	TRBJ2-7
TGTGCCAGCAGTGACCGGGACAGAAAAACTGAAGCTTTCTTT	CASSDRDRKTEAFF	TRBV6-4	TRBJ1-1
TGTGCCAGCAGAGCCCGCCCGGGACAGACAAAGGGCTACACCTTC	CASRARPGQTKGYTF	TRBV14	TRBJ1-2
TGTGCCAGCAGTTATCCTAGCTGGCGGACAGCGCGACACTACGAGCAGTACTTC	CASSYPSWRTARHYEQYF	TRBV6-5	TRBJ2-7
TGTGCCAGCGCTCTCTTGGGGGCCTATGGCTACACCTTC	CASALLGAYGYTF	TRBV28	TRBJ1-2
TGTGCCAGCAGTTTCAGACGCAACTCTGGCTACACCTTC	CASSFRRNSGYTF	TRBV28	TRBJ1-2
TGTGCCAGCAGCTTAGAGGGGGACCAGTCCGGGGAGCTGTTTTTT	CASSLEGDQSGELFF	TRBV7-8	TRBJ2-2
TGTGCCAGCAGCCTCTCAGGGATCCTCGGGGGAAACACCATATATTTT	CASSLSGILGGNTIYF	TRBV7-3	TRBJ1-3
TGTGCCAGCAGTGATAGAGGGGGGGCGGAGGGCAATCAGCCCCAGCATTTT	CASSDRGGAEGNQPQHF	TRBV6-1	TRBJ1-5
TGCAGTGCGCCCGCAGGGAGCAATCAGCCCCAGCATTTT	CSAPAGSNQPQHF	TRBV20-1	TRBJ1-5
TGTGCCAGCAGCTTGGGGGACAGGTCTCACAAAGAAGTAGCCAAAAACATTCAGTACTTC	CASSLGDRSHKEVAKNIQYF	TRBV5-4	TRBJ2-4
TGTGCCAGCAGCTGCGGGACTAGCCAGGACCTTTCCTACAATGAGCAGTTCTTC	CASSCGTSQDLSYNEQFF	TRBV11-3	TRBJ2-1
TGTGCCAGCCGGAGCGGCGGGACATATGGCTACACCTTC	CASRSGGTYGYTF	TRBV9	TRBJ1-2
TGTGCCAGCAGGCGCTGGTATCCCTACGAGCAGTACTTC	CASRRWYPYEQYF	TRBV6-5	TRBJ2-7
TGCGCCAGCACAGTCGGGAGGGGAACCCTGCACATGAACACTGAAGCTTTCTTT	CASTVGRGTLHMNTEAFF	TRBV10-1	TRBJ1-1
TGTGCCAGCAGTGAAAGGACAGGGAAAAGGTCCTACGAGCAGTACTTC	CASSERTGKRSYEQYF	TRBV28	TRBJ2-7
TGTGCCAGCGCCCAGTCCCGCAATGAGCAGTTCTTC	CASAQSRNEQFF	TRBV27	TRBJ2-1
TGTGCCAGCAGCTCCCAAGCCAGGGGGCGAGGACCCCTCCACTTT	CASSSQARGRGPLHF	TRBV2	TRBJ1-6
TGTGCCAGCAGTGAAGGATCCAGGTTGTCTTACAATGAGCAGTTCTTC	CASSEGSRLSYNEQFF	TRBV6-1	TRBJ2-1
TGTGCCAGCAGCCAAGATCCGATTAACGACAAGCATAATGAAAAACTGTTTTTT	CASSQDPINDKHNEKLFF	TRBV14	TRBJ1-4
TGCGCCAGCAGCCAAGAAATTAGGTTAAAGGGAAACACCATATATTTT	CASSQEIRLKGNTIYF	TRBV4-3	TRBJ1-3
TGTGCCACCACCGTTAAAGGGGGGGGCGGTACGCAGTATTTT	CATTVKGGGGTQYF	TRBV24-1	TRBJ2-3
TGTGCTAGTGTACTACCGAATGAGCAGTTCTTC	CASVLPNEQFF	TRBV12-5	TRBJ2-1
TGTGCCAGCAGTGACCCGGTCACAGCCCCCGGTCCCAATCAGCCCCAGCATTTT	CASSDPVTAPGPNQPQHF	TRBV6-1	TRBJ1-5
TGTGCCAGCAGCGCGCTAGACAGGGCGTGGGTAGGTCCTAGGGGGAGCCCCACCGGGGAGCTGTTTTTT	CASSALDRAWVGPRGSPTGELFF	TRBV13	TRBJ2-2
TGTGCCAGCAGCCCCGCTGGCACCGCCTACGAGCAGTACTTC	CASSPAGTAYEQYF	TRBV7-3	TRBJ2-7
TGTGCCAGCAGCGGTGGGGGGCCTGGACATCAGCCCCAGCATTTT	CASSGGGPGHQPQHF	TRBV9	TRBJ1-5
TGTGCCAGCAGCTTAGCTCTACAATGGGCGCGTGGGGCCAACGTCCTGACTTTC	CASSLALQWARGANVLTF	TRBV11-2	TRBJ2-6
TGTGCCAGCAGGAGGGGGAGGGCTAGCACAGATACGCAGTATTTT	CASRRGRASTDTQYF	TRBV27	TRBJ2-3
TGTGCCAGCAGCTATACAGTAGCGGGGGGTCGGGACCAAGAGACCCAGTACTTC	CASSYTVAGGRDQETQYF	TRBV5-4	TRBJ2-5
TGCGCCAGCAGCCAAGATGGTGCGCCGGGGGCCGGATGCACAGATACGCAGTATTTT	CASSQDGAPGAGCTDTQYF	TRBV4-3	TRBJ2-3
TGTGCCACCAGCACCCTAGCCCAAGAGACCCAGTACTTC	CATSTLAQETQYF	TRBV15	TRBJ2-5
TGTGCCAGCAGCGGCGGTATTAGGACGGCGCTATATGGCTACACCTTC	CASSGGIRTALYGYTF	TRBV9	TRBJ1-2
TGTGCCAGCATGACTAGCGGGCCCTACGAGCAGTACTTC	CASMTSGPYEQYF	TRBV7-9	TRBJ2-7
TGTGCCAGCAAAAGCGGGAGCTGTTCCTACGAGCAGTACTTC	CASKSGSCSYEQYF	TRBV6-4	TRBJ2-7
TGTGCCAGCAGCCAAGACCGTGGGGGCAGGCTCGACCCTAACTATGGCTACACCTTC	CASSQDRGGRLDPNYGYTF	TRBV3-1	TRBJ1-2
TGTGCCAGCAGCTTGGCATACAGGGGGCTTTGCACCGGGGAGCTGTTTTTT	CASSLAYRGLCTGELFF	TRBV5-8	TRBJ2-2
TGTGCCAGCAGCCAGGCTTGTAATGGCTACACCTTC	CASSQACNGYTF	TRBV13	TRBJ1-2
TGTGCCAGCAGCCGGGAGGGCAGCTTGACAGATACGCAGTATTTT	CASSREGSLTDTQYF	TRBV6-1	TRBJ2-3
TGTGCCAGCAGCGCGAGGGGATACCGTTCCTACGAGCAGTACTTC	CASSARGYRSYEQYF	TRBV11-3	TRBJ2-7
TGTGCCAGAGGTCCCGGTGTTCAACCCGGGGAGCTGTTTTTT	CARGPGVQPGELFF	TRBV19	TRBJ2-2
TGTGCCATCAGCTGTGTTGAAGATTCACCCCTCCACTTT	CAISCVEDSPLHF	TRBV10-3	TRBJ1-6
TGTGCCACCAGCATCGGACTAGCGGGTTACTCCTACGAGCAGTACTTC	CATSIGLAGYSYEQYF	TRBV15	TRBJ2-7
TGTGCCAGTAGTACAGGGAAGCGCAGGTCCTACGAGCAGTACTTC	CASSTGKRRSYEQYF	TRBV19	TRBJ2-7
TGTGCCACCAGTGATTTTGCCAGAGTCAATCAGCCCCAGCATTTT	CATSDFARVNQPQHF	TRBV24-1	TRBJ1-5
TGTGCCAGCAGTGCACAGGGGGGGACTGGGTACGAGCAGTACTTC	CASSAQGGTGYEQYF	TRBV6-4	TRBJ2-7
TGTGCCAGCAGCTTAGGGTCCTATGGACAGGCCGTTACTAATGAAAAACTGTTTTTT	CASSLGSYGQAVTNEKLFF	TRBV11-2	TRBJ1-4
TGCGCCAGCAGCTTCCTAAGTTGGAACACCGGGGAGCTGTTTTTT	CASSFLSWNTGELFF	TRBV5-1	TRBJ2-2
TGCAGCGTTGTATATGGACTCGGTCCCGGTGAGCAGTTCTTC	CSVVYGLGPGEQFF	TRBV29-1	TRBJ2-1
TGTGCCACCTCAAATCCCAACACAGGGAGCTCTGGGGCCAACGTCCTGACTTTC	CATSNPNTGSSGANVLTF	TRBV24-1	TRBJ2-6
TGCGCCAGCAGTGAGCCCCAGCGGACAGGGGGAAACACCATATATTTT	CASSEPQRTGGNTIYF	TRBV10-1	TRBJ1-3
TGCAGCCGGCGTAAGGAGACCCAGTACTTC	CSRRKETQYF	TRBV29-1	TRBJ2-5
TGTGCCAGCAGCGGACGAGAAAAACTGTTTTTT	CASSGREKLFF	TRBV5-8	TRBJ1-4
TGTGCCAGCAGGAACATGGACAGGCCCCTCGAAAACACTGAAGCTTTCTTT	CASRNMDRPLENTEAFF	TRBV6-1	TRBJ1-1
TGTGCCAGCAGTCGGCTTCAACACAGGGCGGAGCGGGCCACTGAAGCTTTCTTT	CASSRLQHRAERATEAFF	TRBV12-4	TRBJ1-1
TGTGCCAGCAGTTACGTCAGGACCGGGGGCGAGCAGTACTTC	CASSYVRTGGEQYF	TRBV6-5	TRBJ2-7
TGTGCCAGCAGCCAAGTTCATTCAACAGGGCGGGAGACCCAGTACTTC	CASSQVHSTGRETQYF	TRBV3-1	TRBJ2-5
TGCGCCAGCAGCCGAAACAGGGTCTGCTACACCTTC	CASSRNRVCYTF	TRBV4-3	TRBJ1-2
TGCAGTGCTAGGGGGACAGGAAGTGGAAGAGGGGTCACAGATACGCAGTATTTT	CSARGTGSGRGVTDTQYF	TRBV20-1	TRBJ2-3
TGTGCCACCGTATTACGTGACATGTTGAACCACCCTACGCAGTATTTT	CATVLRDMLNHPTQYF	TRBV19	TRBJ2-3
TGTGGCCCGGGCAGCTCCGTGTTCCATGGCTACACCTTC	CGPGSSVFHGYTF	TRBV5-4	TRBJ1-2
TGTGCCAGCAGGCCGGACAGTTTCTACGAGCAGTACTTC	CASRPDSFYEQYF	TRBV25-1	TRBJ2-7
TGTGCCAGCAGTTTATGGGGACAGGGGGCAGGCTATGGCTACACCTTC	CASSLWGQGAGYGYTF	TRBV28	TRBJ1-2
TGTGCCAGCAGTTACGGGACAGGGGGTCGTGCGAACACTGAAGCTTTCTTT	CASSYGTGGRANTEAFF	TRBV6-5	TRBJ1-1
TGTGCCAGCAGTTTCCGACAGGAACCCTCGACTGAAGCTTTCTTT	CASSFRQEPSTEAFF	TRBV12-3	TRBJ1-1
TGTGCCAGCAGCCAAGATTTGCCCGGGACAGGACCTGGAAACACCATATATTTT	CASSQDLPGTGPGNTIYF	TRBV4-2	TRBJ1-3
TGTGCCAGCAGCTGCCAGCTGCTCAGACCGCGTGAGCAGTACTTC	CASSCQLLRPREQYF	TRBV7-8	TRBJ2-7
TGTGCCAGCAGCTTCCCGGGGGGCCCTGGCACCGACGGGCCCTACGAGCAGTACTTC	CASSFPGGPGTDGPYEQYF	TRBV7-2	TRBJ2-7
TGTGCCAGCAGCCAAGCCGGGACAACGAGCATGAACACTGAAGCTTTCTTT	CASSQAGTTSMNTEAFF	TRBV13	TRBJ1-1
TGTGCCAGCAGAACCCGCGGGGGGAGATACGAGCAGTACTTC	CASRTRGGRYEQYF	TRBV6-5	TRBJ2-7
TGTGCCAGCAGTACCCAGAATCGTAGGCCGGTTGCCGAGCAGTACTTC	CASSTQNRRPVAEQYF	TRBV6-5	TRBJ2-7
TGTGCCAGACTGCAGGGGGCCACATTGGGGAGAGGGGAGCTGTTTTTT	CARLQGATLGRGELFF	TRBV3-1	TRBJ2-2
TGCAGTGCTAGATACCGGGCCTACGAGCAGTACTTC	CSARYRAYEQYF	TRBV20-1	TRBJ2-7
TGTGCCAGCAGGGTGGACGAAGCCACAGATACGCAGTATTTT	CASRVDEATDTQYF	TRBV6-6	TRBJ2-3
TGTGCCAGCCCCGATATCCTGAACTCCTACAATGAGCAGTTCTTC	CASPDILNSYNEQFF	TRBV9	TRBJ2-1
TGCATACCGGGCCAAGGGGCTTTCTTT	CIPGQGAFF	TRBV20-1	TRBJ1-1
TGTGCCAGCAGTCCCACTAGCGGGAGCGGCTACGAGCAGTACTTC	CASSPTSGSGYEQYF	TRBV6-5	TRBJ2-7
TGTGCCAGCAGCTTGGAACTCACGGACAGGGATCACACCGGGGAGCTGTTTTTT	CASSLELTDRDHTGELFF	TRBV5-6	TRBJ2-2
TGTGCCAGCAGCTTACACAGGGGGCATGGTCGATATACCGGGGAGCTGTTTTTT	CASSLHRGHGRYTGELFF	TRBV7-4	TRBJ2-2
TGTGCCAGCAGCGACCCGTCCCCCGGGACGGGGCATAATGAAAAACTGTTTTTT	CASSDPSPGTGHNEKLFF	TRBV7-3	TRBJ1-4
TGTGCCAGCTTGGCGGGGATTAGAGAGACCCAGTACTTC	CASLAGIRETQYF	TRBV6-4	TRBJ2-5
TGTGCCAGCAGCTCTAACCGACTAGGGGGGTTCGCTGATGAGCAGTTCTTC	CASSSNRLGGFADEQFF	TRBV11-2	TRBJ2-1
TGTGCCAGCAGCTTATACGGTTGGACTAGCTTCATCTCCTACAATGAGCAGTTCTTC	CASSLYGWTSFISYNEQFF	TRBV7-9	TRBJ2-1
TGTGCCAGCAGGGCAGGGGGCGAGCCCCAGCATTTT	CASRAGGEPQHF	TRBV6-4	TRBJ1-5
TGTGCCAGCAGTTTACCTAGTCGGGCCCTGGCGCATTACGAGCAGTACTTC	CASSLPSRALAHYEQYF	TRBV28	TRBJ2-7
TGTGCCAGCAGGCGGGAGGCTGGCTACACCTTC	CASRREAGYTF	TRBV6-5	TRBJ1-2
TGTGCCAGCTGGGGACGTTACGAGCAGTACTTC	CASWGRYEQYF	TRBV6-4	TRBJ2-7
TGTGCCAGTAGCGTCCCCGGACAGGCCTCCGGGGTAGAGAGCAAAGGCTCCTACAATGAGCAGTTCTTC	CASSVPGQASGVESKGSYNEQFF	TRBV19	TRBJ2-1
TGTGCCAGCTGCCGGGCCCCGCTTCTATCCCCGCAGACCCCCTTGGTAGCTGGGGCCAACGTCCTGACTTTC	CASCRAPLLSPQTPLVAGANVLTF	TRBV27	TRBJ2-6
TGTGCCAGCAGACGAGGACCCCCCTACGAGCAGTACTTC	CASRRGPPYEQYF	TRBV6-1	TRBJ2-7
TGTGCCAGAGGGCGACAGTACTACGAGCAGTACTTC	CARGRQYYEQYF	TRBV28	TRBJ2-7
TGTGCCAGCAGTCGAAGGGACTTCTATAATGAGCAGTTCTTC	CASSRRDFYNEQFF	TRBV6-6	TRBJ2-1
TGTGCCAGCAGTTTCATCGAACAGCCCGGGGGGTCACCCCTCCACTTT	CASSFIEQPGGSPLHF	TRBV12-3	TRBJ1-6
TGTGCCAGCAGTTACAGGGGCTGTGTATACGAGCAGTACTTC	CASSYRGCVYEQYF	TRBV6-3	TRBJ2-7
TGTGCCAGCAGCATGAAGGGACAGACTGAAGCTTTCTTT	CASSMKGQTEAFF	TRBV7-2	TRBJ1-1
TGCGCCAGCAGCGTTTTACCCCGCTCTGGAAACACCATATATTTT	CASSVLPRSGNTIYF	TRBV5-1	TRBJ1-3
TGTGCCCGGGTGGGCCCGAACACCGGGGAGCTGTTTTTT	CARVGPNTGELFF	TRBV6-2	TRBJ2-2
TGTGCCTGGAAGGGGACCATTGTTTCTCGCGGCATTATAGCCAAAAACATTCAGTACTTC	CAWKGTIVSRGIIAKNIQYF	TRBV30	TRBJ2-4
TGTGCCAGCAGTGAATGCGAAGGGGGTAGCGGCTCCAATGAGCAGTTCTTC	CASSECEGGSGSNEQFF	TRBV6-4	TRBJ2-1
TGTGCCAGCAGTTACGGTACGGGAGGGGGGTATGGCTACACCTTC	CASSYGTGGGYGYTF	TRBV6-2	TRBJ1-2
TGTGCCAGCACACCGGGACAGGGCACCGGGGAGCTGTTTTTT	CASTPGQGTGELFF	TRBV6-4	TRBJ2-2
TGTGCCACCAGACACCGGGGACAGGGCTTGAACACTGAAGCTTTCTTT	CATRHRGQGLNTEAFF	TRBV24-1	TRBJ1-1
TGTGCCAGCAGTCCGGGCGGGTCCGGGGAGCTGTTTTTT	CASSPGGSGELFF	TRBV6-2	TRBJ2-2
TGTGCCAGCAGCGGGATTGCAGGAGACACCGGGGAGCTGTTTTTT	CASSGIAGDTGELFF	TRBV13	TRBJ2-2
TGCGCCAGCAGCCAAGATAGGGGACTAGGGGGCACAGATACGCAGTATTTT	CASSQDRGLGGTDTQYF	TRBV4-1	TRBJ2-3
TGTGCCAGCAGCGCCGCCTACCCGGTCCAAGAGACCCAGTACTTC	CASSAAYPVQETQYF	TRBV11-3	TRBJ2-5
TGTGCCAGCAGTTTATCCACTCGGTCGAACACTGAAGCTTTCTTT	CASSLSTRSNTEAFF	TRBV28	TRBJ1-1
TGTGCCAGCCCGATGGACAGGATAGAACTTTCACCCCTCCACTTT	CASPMDRIELSPLHF	TRBV9	TRBJ1-6
TGTGCCAGCAGCCAAGAAAAGGCAACCCGGGACAGGGCCCAGACAACTAATGAAAAACTGTTTTTT	CASSQEKATRDRAQTTNEKLFF	TRBV3-1	TRBJ1-4
TGTGCCAGCAGCATGCGGGGGCACTCCTACGAGCAGTACTTC	CASSMRGHSYEQYF	TRBV13	TRBJ2-7
TGTGCCACCAGCCGTGCCGGGACAGGGGATAGTTCACCCCTCCACTTT	CATSRAGTGDSSPLHF	TRBV24-1	TRBJ1-6
TGTGCCAGCAGCCCACTAGCGGGCGACGAGCAGTACTTC	CASSPLAGDEQYF	TRBV5-6	TRBJ2-7
TGTGCCAGCAAGCCTCGGACAGGACGCGCGGGCTACACCTTC	CASKPRTGRAGYTF	TRBV7-9	TRBJ1-2
TGTGCCAGCAGCGCCGCGGGAGGGGGCAATCAGCCCCAGCATTTT	CASSAAGGGNQPQHF	TRBV6-5	TRBJ1-5
TGTGCCAGCAGGGCGACCGGGGAGCTGTTTTTT	CASRATGELFF	TRBV19	TRBJ2-2
TGCAGTGCTAGAGGAAGGGGGCAGGCGAACACTGAAGCTTTCTTT	CSARGRGQANTEAFF	TRBV20-1	TRBJ1-1
TGTGCCAGCAGCGTCGGAGAGTACGAGCAGTACTTC	CASSVGEYEQYF	TRBV11-3	TRBJ2-7
TGTGCCAGCCGACTAGCGGGGGTGGAGACCCAGTACTTC	CASRLAGVETQYF	TRBV6-4	TRBJ2-5
TGCGCGCCCCGAAAGTACCCAGGGGGCGCGATCCATTCACCCCTCCACTTT	CAPRKYPGGAIHSPLHF	TRBV10-1	TRBJ1-6
TGTGCCAGCAGTGTAAAACAGGGGAGGGAGCAGTACTTC	CASSVKQGREQYF	TRBV27	TRBJ2-7
TGTGCCAGCAGTTACTCGGGGACTTGTGAAAAACTGTTTTTT	CASSYSGTCEKLFF	TRBV6-5	TRBJ1-4
TGTGCCAGCAGCCTCCGGGGCAGCATGTATGGCTACACCTTC	CASSLRGSMYGYTF	TRBV13	TRBJ1-2
TGTGCCAGCAGCTTACTAGCGGGAACCTACGAGCAGTACTTC	CASSLLAGTYEQYF	TRBV11-3	TRBJ2-7
TGTGCCACCAGCCGGGAAGGTAAGAACACTGAAGCTTTCTTT	CATSREGKNTEAFF	TRBV24-1	TRBJ1-1
TGTGCCAGCAGCCAAGAAAGGGGACTAGCGGGTAAACCTACTACCGGGGAGCTGTTTTTT	CASSQERGLAGKPTTGELFF	TRBV4-2	TRBJ2-2
TGCGCCAGCAGCTTGCATTCCGACAGCATTCAGTACTTC	CASSLHSDSIQYF	TRBV5-1	TRBJ2-4
TGTGCCAGCAAAGGGCAGGGTGTCCTGGTCGCTAATGAAAAACTGTTTTTT	CASKGQGVLVANEKLFF	TRBV6-5	TRBJ1-4
TGTGCCAGCAGCCAAGGGGACAACCATTCAAATCAGCCCCAGCATTTT	CASSQGDNHSNQPQHF	TRBV3-1	TRBJ1-5
TGTGCCAGCAGCTGGTTTTCCAAGGACAGGGGGTACGAGCAGTACTTC	CASSWFSKDRGYEQYF	TRBV7-8	TRBJ2-7
TGTGCGAAGATAGCCGCTAGCACAGATACGCAGTATTTT	CAKIAASTDTQYF	TRBV5-8	TRBJ2-3
TGTGCCAGCAGTGTAACAACGAGAAAAGAGACCCAGTACTTC	CASSVTTRKETQYF	TRBV11-3	TRBJ2-5
TGTGCCAGCAGGAAATTGGGACTAGCGGGCCCTCCCCTACGTACGCAGTATTTT	CASRKLGLAGPPLRTQYF	TRBV11-3	TRBJ2-3
TGTGCCAGCAGTTACTCGAAGGACAGGCAACCTAATGAAAAACTGTTTTTT	CASSYSKDRQPNEKLFF	TRBV6-3	TRBJ1-4
TGTGCCAGCAGTACGACTGAAGCTTTCTTT	CASSTTEAFF	TRBV6-6	TRBJ1-1
TGCGCCAGCAGTTCAGCAACCGGCGGACAGGGTTTCAATCAGCCCCAGCATTTT	CASSSATGGQGFNQPQHF	TRBV10-1	TRBJ1-5
TGTGCCAGCTCACACTCCCCCGGATCATTCGAAGCTTTCTTT	CASSHSPGSFEAFF	TRBV18	TRBJ1-1
TGTGCCTGGCGGACTAGCGGGAAGGGTTCAACCCACAATGAGCAGTTCTTC	CAWRTSGKGSTHNEQFF	TRBV6-1	TRBJ2-1
TGTGCCAACACCATCGGACAGGTAGAATGGAGTGAGGATCAGCCCCAGCATTTT	CANTIGQVEWSEDQPQHF	TRBV27	TRBJ1-5
TGTGCCAGCAAATATGGGGGGGGAAGTCCCGCCGCAGATACGCAGTATTTT	CASKYGGGSPAADTQYF	TRBV6-5	TRBJ2-3
TGTGCCAGCCAGGGCAGAAACATTCAGTACTTC	CASQGRNIQYF	TRBV2	TRBJ2-4
TGTGCCAGCAGTTTACTGATCACTGAAGCTTTCTTT	CASSLLITEAFF	TRBV28	TRBJ1-1
TGTGCCAGCTCACCCCAGGGGTGCTACGAGCAGTACTTC	CASSPQGCYEQYF	TRBV18	TRBJ2-7
TGTGCCAGCAGCTTAAGCCGTCCGGGAAACTCTGGAAACACCATATATTTT	CASSLSRPGNSGNTIYF	TRBV7-6	TRBJ1-3
TGTGCCAGCGGGAAGGGACCTGGAAACACCATATATTTT	CASGKGPGNTIYF	TRBV6-2	TRBJ1-3
TGTGCCAGCAGTTTTGGACAATGGGAAAAACTGTTTTTT	CASSFGQWEKLFF	TRBV6-8	TRBJ1-4
TGTGCCAGCAGCGGGCTAGCGGTAACTTCGACCCAGTACTTC	CASSGLAVTSTQYF	TRBV7-2	TRBJ2-5
TGTGCCAGCAGTGAACCTAGGGGATTGACCTACGAGCAGTACTTC	CASSEPRGLTYEQYF	TRBV6-1	TRBJ2-7
TGCAGTGCTAGGCAATGGACAGAAGCTTTCTTT	CSARQWTEAFF	TRBV20-1	TRBJ1-1
TGTGCCAGCAGCGTTGACGTTGGGGCCGGGACAGGGGGGTCGAACACTGAAGCTTTCTTT	CASSVDVGAGTGGSNTEAFF	TRBV13	TRBJ1-1
TGTGCCAGCAGCTTAGATGTAGCGGGTGAGCAGTTCTTC	CASSLDVAGEQFF	TRBV11-2	TRBJ2-1
TGCGCCAGCAGCTTGCGGGAGGGGGGGGGGTCAGATACGCAGTATTTT	CASSLREGGGSDTQYF	TRBV5-1	TRBJ2-3
TGCAGTGCTAGTTGGGACAGGGCAGGCTACACCTTC	CSASWDRAGYTF	TRBV20-1	TRBJ1-2
TGTGCCATCAGTGATAGAACGCGGGAGGAAAAAGAGACCCAGTACTTC	CAISDRTREEKETQYF	TRBV10-3	TRBJ2-5
TGCGCCAGCACCAGGGGGAATGGGGCCTCCTACGAGCAGTACTTC	CASTRGNGASYEQYF	TRBV10-1	TRBJ2-7
TGTGCCAGCAGTTATGACTCCCCTCCAAAGACCCAGTACTTC	CASSYDSPPKTQYF	TRBV6-2	TRBJ2-5
TGTGCCAGCAGCGTAAACCCTTCTACCGTCACCGGGGAGCTGTTTTTT	CASSVNPSTVTGELFF	TRBV9	TRBJ2-2
TGTGCCAGCAGTTACAGATATGGTGGCAATTCACCCCTCCACTTT	CASSYRYGGNSPLHF	TRBV9	TRBJ1-6
TGTGCCAGCAGCGAAAAGGGGAAAATAGAAAAACTGTTTTTT	CASSEKGKIEKLFF	TRBV7-3	TRBJ1-4
TGTGCCAGCTTGTTCCCACTAGCGGGAGCTGGGGCCAAAAACATTCAGTACTTC	CASLFPLAGAGAKNIQYF	TRBV6-4	TRBJ2-4
TGCGCCAGCACGCGGGATACGCAGTATTTT	CASTRDTQYF	TRBV10-1	TRBJ2-3
TGCAAGCTAGCGGTTCAGTACTTC	CKLAVQYF	TRBV20-1	TRBJ2-7
TGTGCCACCAGTGACCCCTTGGGACAAGAGACCCAGTACTTC	CATSDPLGQETQYF	TRBV24-1	TRBJ2-5
TGTGCCTTTACTGGTTCTGACGAGCAGTACTTC	CAFTGSDEQYF	TRBV2	TRBJ2-7
TGTGCCAGCAGTGAGACAGGGGCTGCGGGAAAGCTTTATAGCAATCAGCCCCAGCATTTT	CASSETGAAGKLYSNQPQHF	TRBV25-1	TRBJ1-5
TGCAGTGCTAGCACGGGACAGGGCCCCACCGGGGAGCTGTTTTTT	CSASTGQGPTGELFF	TRBV20-1	TRBJ2-2
TGTGCCATCAGTAAATCTTCTGGAGGAATGAACACTGAAGCTTTCTTT	CAISKSSGGMNTEAFF	TRBV10-3	TRBJ1-1
TGCAGTGCTAGCCTCAGGGTCGGCTACACCTTC	CSASLRVGYTF	TRBV20-1	TRBJ1-2
TGTGCCAGCAGCCAAGATGGGAACCGGGACAGAGCTTTCTTT	CASSQDGNRDRAFF	TRBV14	TRBJ1-1
TGCGCCAGCAGCTTGGGGGCAGGGTACTTC	CASSLGAGYF	TRBV5-1	TRBJ2-7
TGTGCCAGCAGTGAAAGGTCAACTAGCGGGAGGGCATACGGCTATGGCTACACCTTC	CASSERSTSGRAYGYGYTF	TRBV6-1	TRBJ1-2
TGTGCCAGCCCCTCACAGGGAAGGCGGAGAAATAGCAATCAGCCCCAGCATTTT	CASPSQGRRRNSNQPQHF	TRBV12-4	TRBJ1-5
TGCAGCGTTGTGGGGGACAGGGGGAAGGACGAGCAGTACTTC	CSVVGDRGKDEQYF	TRBV29-1	TRBJ2-7
TGTGCCAGCAGCTCCCGCGTGGACAGCCCTGATAATTCACCCCTCCACTTT	CASSSRVDSPDNSPLHF	TRBV7-4	TRBJ1-6
TGTGCCAGCAGTGAAGGTTTAAGACTAGATGGGGAGACCCAGTACTTC	CASSEGLRLDGETQYF	TRBV6-4	TRBJ2-5
TGTGCCAGCAGCGGGTTGACAGTGGATTACACCGGGGAGCTGTTTTTT	CASSGLTVDYTGELFF	TRBV7-3	TRBJ2-2
TGTGCCAGCATTACTAACGGGGGGTATAGCAATCAGCCCCAGCATTTT	CASITNGGYSNQPQHF	TRBV5-4	TRBJ1-5
TGTGCCAGCACCAGGGGCAGCAGGGGAGACTCCGATGAGCAGTTCTTC	CASTRGSRGDSDEQFF	TRBV12-3	TRBJ2-1
TGTGCCAGCAGCTTATGGGACGCCGTGAACACTGAAGCTTTCTTT	CASSLWDAVNTEAFF	TRBV11-2	TRBJ1-1
TGTGCCAGCAGCTGGCTGCATTTT	CASSWLHF	TRBV5-6	TRBJ1-5
TGCAGTGCTGGGGGACAGGCGGACTCTCCACTCCACTTT	CSAGGQADSPLHF	TRBV20-1	TRBJ1-6
TGTGCCAGCAGTTTTCTCACAGGGGATTCACCCCTCCACTTT	CASSFLTGDSPLHF	TRBV6-4	TRBJ1-6
TGTGCTAGCAGCTTAGTAAATCTAGCGGGCGATAATGAGCAGTTCTTC	CASSLVNLAGDNEQFF	TRBV7-7	TRBJ2-1
TGCGCCAGCAGTGAACGGGGACAGGAGTCAGCTTTCTTT	CASSERGQESAFF	TRBV10-1	TRBJ1-1
TGCGCCAGCAGCCATGCCGAGGGCACAGATACGCAGTATTTT	CASSHAEGTDTQYF	TRBV4-3	TRBJ2-3
TGTGCCAGCAGTCCCGAACTCCCCCCGTCGGGGAGTAGCTCCTATAATTCACCCCTCCACTTT	CASSPELPPSGSSSYNSPLHF	TRBV27	TRBJ1-6
TGTGCCAGCAGCCTAAGGCAGCCCCAGCATTTT	CASSLRQPQHF	TRBV7-9	TRBJ1-5
TGTGCCAGCAGTTTCTGTGGACTAAACTGGAGCACAGATACGCAGTATTTT	CASSFCGLNWSTDTQYF	TRBV27	TRBJ2-3
TGCAGTGCCATAGACCTTTATGAGCAGTTCTTC	CSAIDLYEQFF	TRBV20-1	TRBJ2-1
TGTGCCAGCAGCTTTAATCCCGTTTACAGCACTGAAGCTTTCTTT	CASSFNPVYSTEAFF	TRBV5-8	TRBJ1-1
TGTGCCAGCAGCGGGAGCACTAATGAGCAGTTCTTC	CASSGSTNEQFF	TRBV13	TRBJ2-1
TGTGCCAGCAGTGACGACAGGGGTTGGGGGAGGAGCACAGATACGCAGTATTTT	CASSDDRGWGRSTDTQYF	TRBV6-1	TRBJ2-3
TGTGCCACCAGTGATTTCCCAAGGGACTCTAGCACAGATACGCAGTATTTT	CATSDFPRDSSTDTQYF	TRBV24-1	TRBJ2-3
TGTGCCAGCAACTCGCTTCTAGCGGCTGGGCCGGAGCTGTTTTTT	CASNSLLAAGPELFF	TRBV27	TRBJ2-2
TGTGCCAGCAGCGCGAGGGCGGGGGGCACCGGGGAGCTGTTTTTT	CASSARAGGTGELFF	TRBV9	TRBJ2-2
TGTGCCAGCAGCTTCCGTGCGGGACTCCTGGCCACAGATACGCAGTATTTT	CASSFRAGLLATDTQYF	TRBV7-9	TRBJ2-3
TGCGCCAGCAGCCAAGATGACAACGAGCAGTACTTC	CASSQDDNEQYF	TRBV4-1	TRBJ2-7
TGTGCCAGCTCACCACTGTTCCAACCAGGGGCCTTGGGAGGAGGCGGAGACTCCTACGAGCAGTACTTC	CASSPLFQPGALGGGGDSYEQYF	TRBV18	TRBJ2-7
TGTGCCAGTAGTAATGCCCCAACTAGTATGGAGACCCAGTACTTC	CASSNAPTSMETQYF	TRBV19	TRBJ2-5
TGTGCCAGCAGCCAAGATCGAAAAGGGACAGGGATTATTTCGGCTTCCAAAAACATTCAGTACTTC	CASSQDRKGTGIISASKNIQYF	TRBV4-2	TRBJ2-4
TGTGCCACTAGGGGTGGAAACACCATATATTTT	CATRGGNTIYF	TRBV24-1	TRBJ1-3
TGTGCCAGCAGCCCAGGGATAGGGAACACTGAAGCTTTCTTT	CASSPGIGNTEAFF	TRBV6-4	TRBJ1-1
TGTGCCAGCAGCTTTACGTCAGGGGTGGACACTGAAGCTTTCTTT	CASSFTSGVDTEAFF	TRBV11-2	TRBJ1-1
TGTGCCAGCAGTTTCGTGTGGACTAGCGGGAGGGCGGATCGGAATCAGCCCCAGCATTTT	CASSFVWTSGRADRNQPQHF	TRBV27	TRBJ1-5
TGCAAAGGGGGATTTGCTTTCTTT	CKGGFAFF	TRBV29-1	TRBJ1-1
TGTGCCAGCAGCCAGGGGGGAGGCCCGGGGACCCAGTACTTC	CASSQGGGPGTQYF	TRBV13	TRBJ2-5
TGTGCCAGCAGCCAGGGCAATCAGCCCCAGCATTTT	CASSQGNQPQHF	TRBV11-3	TRBJ1-5
TGTCCGACAGGGGGGGGCAACACTGAAGCTTTCTTT	CPTGGGNTEAFF	TRBV6-5	TRBJ1-1
TGCGCCAGCAGCTCAGGGACGGGGTTAGCCAAAAACATTCAGTACTTC	CASSSGTGLAKNIQYF	TRBV5-1	TRBJ2-4
TGCGCCAGCAGCCCCCGGACAAACCAAGAGACCCAGTACTTC	CASSPRTNQETQYF	TRBV4-3	TRBJ2-5
TGTGCCAGTATCCACCGGGGTTGCGAGCAGTACTTC	CASIHRGCEQYF	TRBV19	TRBJ2-7
TGTGCCAGCAGCCGGGGTGGAGGCTATGAAGCTTTCTTT	CASSRGGGYEAFF	TRBV7-3	TRBJ1-1
TGTATTAAACAGGGGAACACTGAAGCTTTCTTT	CIKQGNTEAFF	TRBV27	TRBJ1-1
TGCAGCGCCCAGGGGACAGGGTGGGACGCTGGGGCCAACGTCCTGACTTTC	CSAQGTGWDAGANVLTF	TRBV29-1	TRBJ2-6
TGTGCCAGCAGTTCCGGGACTAGCGGGAGCTTC	CASSSGTSGSF	TRBV27	TRBJ1-2
TGCGCCAGCAGCCCCGGACAGGGGGTAACGGGCTACACCTTC	CASSPGQGVTGYTF	TRBV5-1	TRBJ1-2
TGTGCCACCAGTGACGAGACAGCTCTCACCGGGGAGCTGTTTTTT	CATSDETALTGELFF	TRBV24-1	TRBJ2-2
TGTGCCACGGTAGGGGCCTACGAGCAGTACTTC	CATVGAYEQYF	TRBV6-2	TRBJ2-7
TGTGCCAGCAGCAGCTCGGGGGCTATACCCGGCTACACCTTC	CASSSSGAIPGYTF	TRBV7-3	TRBJ1-2
TGCGCCAGCAGCCAAGTATACCAAAACTGCGATCCGAGCTTCTCCTACAATGAGCAGTTCTTC	CASSQVYQNCDPSFSYNEQFF	TRBV4-1	TRBJ2-1
TGTGCTTCGGCGGGTTATAGCAATCAGCCCCAGCATTTT	CASAGYSNQPQHF	TRBV6-5	TRBJ1-5
TGTGCCAGTAGGACTAGCGTGCCGAGAAGCTCCTACAATGAGCAGTTCTTC	CASRTSVPRSSYNEQFF	TRBV6-4	TRBJ2-1
TGTGCCAGCAGAGAAGAAGACTTGGACACTGAAGCTTTCTTT	CASREEDLDTEAFF	TRBV14	TRBJ1-1
TGTGCCAGCAGTGACTCGAAGGGGACCTCTGGAAACACCATATATTTT	CASSDSKGTSGNTIYF	TRBV6-4	TRBJ1-3
TGTGCCAGCAGCTTCCCGAGGGACTTTGGACCCGTTCAGCCCCAGCATTTT	CASSFPRDFGPVQPQHF	TRBV7-9	TRBJ1-5
TGTGCCAGCATAGGCCCTTCCGCGGACGCCACTGAAGCTTTCTTT	CASIGPSADATEAFF	TRBV28	TRBJ1-1
TGCAGTGCCTCCGGGACAGGGGACTATGGCTACACCTTC	CSASGTGDYGYTF	TRBV20-1	TRBJ1-2
TGCGCCAGCAGTGAGTATCACAGGGGGCGTTACGAGCAGTACTTC	CASSEYHRGRYEQYF	TRBV10-1	TRBJ2-7
TGCGCCAGCAGCCTGGCCTGTGGGGGGCGGAAAGATACGCAGTATTTT	CASSLACGGRKDTQYF	TRBV4-3	TRBJ2-3
TGTGCCAGCAGTCCCCAAGGGACTCCAAAAGCAGATACGCAGTATTTT	CASSPQGTPKADTQYF	TRBV6-5	TRBJ2-3
TGTGCCAGCAGCCCCCCGACCCTCAGCAATCAGCCCCAGCATTTT	CASSPPTLSNQPQHF	TRBV7-3	TRBJ1-5
TGCAGCGTTAGGCGACAGGGTGGAGCTTTCTTT	CSVRRQGGAFF	TRBV29-1	TRBJ1-1
TGTGCCAGCGGCCCCTTTCTCATTCTAAATAGATCCTACGAGCAGTACTTC	CASGPFLILNRSYEQYF	TRBV7-3	TRBJ2-7
TGTGCCAGCAGTGACGGTACCACAGGATCCTACGAGCAGTACTTC	CASSDGTTGSYEQYF	TRBV6-4	TRBJ2-7
TGCGCCAGCACCCCCCGGGGGGCCAAAAACATTCAGTACTTC	CASTPRGAKNIQYF	TRBV10-2	TRBJ2-4
TGCAGCGTTCCTATGATCCGTCCTAGAGGACAGTCTACGCACTACGAGCAGTACTTC	CSVPMIRPRGQSTHYEQYF	TRBV29-1	TRBJ2-7
TGTGCCAGCAGAACCGGGGCACCCTACGAGCAGTACTTC	CASRTGAPYEQYF	TRBV11-3	TRBJ2-7
TGTGCCAGCAGCCCCCAACTAAATGAGCAGTTCTTC	CASSPQLNEQFF	TRBV7-4	TRBJ2-1
TGTGCCAGCATGGGGGACTCCTCTCCGACCTACAATGAGCAGTTCTTC	CASMGDSSPTYNEQFF	TRBV25-1	TRBJ2-1
TGCGCCAGCAATCGACAGAAAGAGACCCAGTACTTC	CASNRQKETQYF	TRBV10-1	TRBJ2-5
TGTGCCAGCCAGGGAGCCGGGTGGGTTGGGGCCACAGATACGCAGTATTTT	CASQGAGWVGATDTQYF	TRBV25-1	TRBJ2-3
TGCAGTGCTAGTCCTACTAGCGGGAATAATGAGCAGTTCTTC	CSASPTSGNNEQFF	TRBV20-1	TRBJ2-1
TGCGCCAGCAGCCGGCCTAGCGGGCCGGGAAACGAGCAGTACTTC	CASSRPSGPGNEQYF	TRBV4-3	TRBJ2-7
TGTGCCAGCAGTTACGGAACAGGGAGGGGTTACGAGCAGTACTTC	CASSYGTGRGYEQYF	TRBV6-2	TRBJ2-7
TGTGCCAGCAGCTTACGTCCCAACTATGGCTACACCTTC	CASSLRPNYGYTF	TRBV7-4	TRBJ1-2
TGCGCCAGCAGCTCCTTGGGGCGCCCCGCTGAAGCTTTCTTT	CASSSLGRPAEAFF	TRBV5-1	TRBJ1-1
TGTGCCAGCAGCTTTCGGGGGGGATGCACAGATACGCAGTATTTT	CASSFRGGCTDTQYF	TRBV5-5	TRBJ2-3
TGTGCCAGCAGCCAGGGGGGTTCGGGGTATAGCAATCAGCCCCAGCATTTT	CASSQGGSGYSNQPQHF	TRBV7-4	TRBJ1-5
TGTGCCACCATTACCAGGAGGAGACAGATGAACACTGAAGCTTTCTTT	CATITRRRQMNTEAFF	TRBV24-1	TRBJ1-1
TGTGCCAGCAGTTACAACTCTGACGGGGACAGGGTAGGCTCTCAGCCCCAGCATTTT	CASSYNSDGDRVGSQPQHF	TRBV6-2	TRBJ1-5
TGTGCCAGCAGGTCGAAGGGACAGGGGGCCACAGATACGCAGTATTTT	CASRSKGQGATDTQYF	TRBV2	TRBJ2-3
TGTGCCAGCAGTGAGGGATTCCAGGGGGCCTACGAGCAGTACTTC	CASSEGFQGAYEQYF	TRBV2	TRBJ2-7
TGCACATATCCACGGTCTCGAGGTAGGAACACCGGGGAGCTGTTTTTT	CTYPRSRGRNTGELFF	TRBV20-1	TRBJ2-2
TGTGCCAGCAGCTTAGGGGCGAGGGCGCCCTACGAGCAGTACTTC	CASSLGARAPYEQYF	TRBV11-3	TRBJ2-7
TGTGCCAGCAGTCTGGGGGGGTGGGAGAGGGGATACAATGAGCAGTTCTTC	CASSLGGWERGYNEQFF	TRBV27	TRBJ2-1
TGTGCCTGGAGGCCCTGGTTCGGACAGGGGGACCGGACGAACACCGGGGAGCTGTTTTTT	CAWRPWFGQGDRTNTGELFF	TRBV30	TRBJ2-2
TGTGCCTGGAGTTCCCCCGGGACAGGGCCAGACCAAGAGACCCAGTACTTC	CAWSSPGTGPDQETQYF	TRBV30	TRBJ2-5
TGTGCCAGCAGCCAGGGTCGACTGGCGAACACTGAAGCTTTCTTT	CASSQGRLANTEAFF	TRBV7-9	TRBJ1-1
TGTGCCAGCAGCGTATTCCCGGACAGGGTAGGGTCTGGGGCCAACGTCCTGACTTTC	CASSVFPDRVGSGANVLTF	TRBV9	TRBJ2-6
TGTGCCAGCAGCTTTCCGACGGGATACACTGAAGCTTTCTTT	CASSFPTGYTEAFF	TRBV7-8	TRBJ1-1
TGTGCCAGCAGCGCTGGGGATTTCTTAACTAGCACAGATACGCAGTATTTT	CASSAGDFLTSTDTQYF	TRBV11-2	TRBJ2-3
TGCGCCAGCAGCATAGGGGGACGCTACACCTTC	CASSIGGRYTF	TRBV5-1	TRBJ1-2
TGCAGCGCGGGGGGGAGGACCGGCAGCTACGAGCAGTACTTC	CSAGGRTGSYEQYF	TRBV29-1	TRBJ2-7
TGTGCCAGCACCTGGGAGAAAGCGGGGTACAATGAGCAGTTCTTC	CASTWEKAGYNEQFF	TRBV7-6	TRBJ2-1
TGTGCCAGCAGTTACAGATGGACGTTCTCCTACGAGCAGTACTTC	CASSYRWTFSYEQYF	TRBV6-2	TRBJ2-7
TGTGCCAGCAGAACCCAGGGGTTACGGAACACTGAAGCTTTCTTT	CASRTQGLRNTEAFF	TRBV12-3	TRBJ1-1
TGCAGTGCTCGTAACAGGGGGGAAAAACTGTTTTTT	CSARNRGEKLFF	TRBV20-1	TRBJ1-4
TGCGCCAGCAGCCCTGACCAAGTTCAGGGAGACACCGGGGAGCTGTTTTTT	CASSPDQVQGDTGELFF	TRBV5-1	TRBJ2-2
TGTGCCAGCAGCCCTTCTCCGGACAGCCCCAACTATGGCTACACCTTC	CASSPSPDSPNYGYTF	TRBV6-2	TRBJ1-2
TGTGCCAGCAGTGGCGGGCAGTATAATGAAAAACTGTTTTTT	CASSGGQYNEKLFF	TRBV6-1	TRBJ1-4
TGTGCCAACAGGGGACACACCATATATTTT	CANRGHTIYF	TRBV6-4	TRBJ1-3
TGTGCCAGCAGTAACACGGTGGGTGCCCGGTGGTACGACAATGAGCAGTTCTTC	CASSNTVGARWYDNEQFF	TRBV27	TRBJ2-1
TGTGCCAGCAGCTTAGGGTTAAGGAGGACAGAACTCAATCAGCCCCAGCATTTT	CASSLGLRRTELNQPQHF	TRBV7-2	TRBJ1-5
TGTGCCAGCTCACCACCCCACCAGGGGGGAGCGGAATACTATCAGCCCCAGCATTTT	CASSPPHQGGAEYYQPQHF	TRBV18	TRBJ1-5
TGTGCCAGCAGCAGGGAGTCACATGAGCAGTTCTTC	CASSRESHEQFF	TRBV6-3	TRBJ2-1
TGTGCCAGCAGCTGCAGGATAGAGACCCAGTACTTC	CASSCRIETQYF	TRBV7-9	TRBJ2-5
TGCAGTGCTAGATCTCAACTACCGGGACAGGGTAAAAGTCAGCCCCAGCATTTT	CSARSQLPGQGKSQPQHF	TRBV20-1	TRBJ1-5
TGTGCCAGCGGGCGCAGAAGCTCCTACGAGCAGTACTTC	CASGRRSSYEQYF	TRBV6-5	TRBJ2-7
TGTGCCAGCAGGTCCGGGACAGTGGCTAGAACTGAAGCTTTCTTT	CASRSGTVARTEAFF	TRBV6-5	TRBJ1-1
TGTGCCAGCAGTCTCGGGTCAAGGGTTCCCGGGGAGCTGTTTTTT	CASSLGSRVPGELFF	TRBV6-2	TRBJ2-2
TGTGCCAGCAGTTACCTTCGTGCGCTAGCGGGGTACCGCTCCTACAATGAGCAGTTCTTC	CASSYLRALAGYRSYNEQFF	TRBV6-2	TRBJ2-1
TGTGCCACCAGTGATGGGACAGGGCTTGAGCCCCAGCATTTT	CATSDGTGLEPQHF	TRBV24-1	TRBJ1-5
TGTGCCAGCAGCGGAGCTTTCGGAGGGCCGAACAATGAGCAGTTCTTC	CASSGAFGGPNNEQFF	TRBV11-1	TRBJ2-1
TGCGCCAGCAGGGATGGCTACACCTTC	CASRDGYTF	TRBV4-1	TRBJ1-2
TGTGCCAGCACCGGTAGGTTTAGCAATCAGCCCCAGCATTTT	CASTGRFSNQPQHF	TRBV19	TRBJ1-5
TGTGCCATGGACAGGGCGAACACCGGGGAGCTGTTTTTT	CAMDRANTGELFF	TRBV7-6	TRBJ2-2
TGTGCCACCAGTGATTTGCATTGGGGGGGCACTAACTATGGCTACACCTTC	CATSDLHWGGTNYGYTF	TRBV24-1	TRBJ1-2
TGTGCCAGCAGGGGAAGGAGACAGGATAATGAAAAACTGTTTTTT	CASRGRRQDNEKLFF	TRBV7-3	TRBJ1-4
TGTGCCATAAGGATGACAGGGCTCACCGACACTGAAGCTTTCTTT	CAIRMTGLTDTEAFF	TRBV7-6	TRBJ1-1
TGTGCCAGCATCACTAGCGGGTTCTATGAGCAGTTCTTC	CASITSGFYEQFF	TRBV7-6	TRBJ2-1
TGCGCCAGCAGCCAAGAGCTTAACGGGGGGTTCGAGCAGTACTTC	CASSQELNGGFEQYF	TRBV4-1	TRBJ2-7
TGTGCCAGCAGTTACTCGAGAACTAGGGCCACAGATACGCAGTATTTT	CASSYSRTRATDTQYF	TRBV6-5	TRBJ2-3
TGCAGTGCTAGGCAGACAGGGGTCCTTGAAGAGACCCAGTACTTC	CSARQTGVLEETQYF	TRBV20-1	TRBJ2-5
TGTGCTAGCAGCGGTGGAGGGTTTCAAGCTTTCTTT	CASSGGGFQAFF	TRBV7-7	TRBJ1-1
TGTGCCAGCGACAGCATCTATGGCTACACCTTC	CASDSIYGYTF	TRBV6-1	TRBJ1-2
TGTGCCAGTCGGCTGGGGCGTAATCTTGAAGCTTTCTTT	CASRLGRNLEAFF	TRBV27	TRBJ1-1
TGCGCCAGCAGTCTTAAGGTAGGACAGGGGTGCTACGAGCAGTACTTC	CASSLKVGQGCYEQYF	TRBV10-1	TRBJ2-7
TGTGCCAGCAGTGACGGGGCCGCCGGGACTAGCGGCTACGAGCAGTACTTC	CASSDGAAGTSGYEQYF	TRBV6-4	TRBJ2-7
TGTGCCAGCAGTGACTCATTACATGGAGTAGGGGAGCGGTCCCCCTACGAGCAGTACTTC	CASSDSLHGVGERSPYEQYF	TRBV6-4	TRBJ2-7
TGTGCTAGTGGTTTGGTGACAGGGATTACGTATAGCAATCAGCCCCAGCATTTT	CASGLVTGITYSNQPQHF	TRBV12-5	TRBJ1-5
TGCGCCAGCAGAATGGGACAGTCGAACACTGAAGCTTTCTTT	CASRMGQSNTEAFF	TRBV10-1	TRBJ1-1
TGCAGTGCTAGAGATGTGCGGTCTTTGAATGAGCAGTTCTTC	CSARDVRSLNEQFF	TRBV20-1	TRBJ2-1
TGTGCCAGCAGATGGTTACACTTTGGCTACACCTTC	CASRWLHFGYTF	TRBV28	TRBJ1-2
TGTGCCAGCTCACTGGGGACAGTTACTGAAGCTTTCTTT	CASSLGTVTEAFF	TRBV18	TRBJ1-1
TGCGCCAGCAGCTCTCCTAGCGGGAACGGGGAGCAGTACTTC	CASSSPSGNGEQYF	TRBV5-1	TRBJ2-7
TGTGCCAACAGGGGAGAGACCCAGTACTTC	CANRGETQYF	TRBV6-5	TRBJ2-5
TGTGCCAGCAGGGGGCAGGCGGACCTCTACCTAGCCCTGCACTCCCTCTCAACTAATGAAAAACTGTTTTTT	CASRGQADLYLALHSLSTNEKLFF	TRBV27	TRBJ1-4
TGTGCCAGCAGTTTTCAGGGGGCTTGGGGCATGAACACTGAAGCTTTCTTT	CASSFQGAWGMNTEAFF	TRBV12-4	TRBJ1-1
TGTGCCAGCAGTTTTTGGTCACAAAGGGACAGGGGTGGTTTAAAACCGAACACTGAAGCTTTCTTT	CASSFWSQRDRGGLKPNTEAFF	TRBV27	TRBJ1-1
TGTGCCAGCAGCAGCAGGACAGGGGGCCGACAGACCCAGTACTTC	CASSSRTGGRQTQYF	TRBV7-3	TRBJ2-5
TGCGCCAGCAGCTTGGAACCGGCTTTGGCTTTCTTT	CASSLEPALAFF	TRBV5-1	TRBJ1-1
TGTGCCAGCAGCGCGGCCCCACAGGGCGAGTACCAAGAGACCCAGTACTTC	CASSAAPQGEYQETQYF	TRBV13	TRBJ2-5
TGCGCCAGCAGTGAACCACACGGGCCCAACACTGAAGCTTTCTTT	CASSEPHGPNTEAFF	TRBV10-1	TRBJ1-1
TGTGCCAGCAGTACTAGCGGGGAGGACTACAATGAGCAGTTCTTC	CASSTSGEDYNEQFF	TRBV2	TRBJ2-1
TGCGCCAGCAGCTTGTCGAATCTAGCGGGCTACGAGCAGTACTTC	CASSLSNLAGYEQYF	TRBV5-1	TRBJ2-7
TGTGCCAGCAGCGCTTGGGGCAAGACCCAGTACTTC	CASSAWGKTQYF	TRBV13	TRBJ2-5
TGTGCCAGCAGCAAAATGGGGGGGGGATGGTCCTACAATGAGCAGTTCTTC	CASSKMGGGWSYNEQFF	TRBV7-4	TRBJ2-1
TGCGCCAGCAGGAACCTAAACAATCAGCCCCAGCATTTT	CASRNLNNQPQHF	TRBV10-2	TRBJ1-5
TGTGCCAGCAGCTTAAAGGGACATAGCAATCAGCCCCAGCATTTT	CASSLKGHSNQPQHF	TRBV7-4	TRBJ1-5
TGCGCCAGCACCCTAGTAAGGGACAATGAGCAGTTCTTC	CASTLVRDNEQFF	TRBV10-1	TRBJ2-1
TGTGCCAGTACCCGGGAAGGTGAAGCTTTCTTT	CASTREGEAFF	TRBV19	TRBJ1-1
TGTGCCCAGACGTTGGGGTTTTACAATGAGCAGTTCTTC	CAQTLGFYNEQFF	TRBV6-4	TRBJ2-1
TGTGCCAGCAGCTTAGCCCCGGGGCAAAGAGGGGCCCACTATGGCTACACCTTC	CASSLAPGQRGAHYGYTF	TRBV7-9	TRBJ1-2
TGTGCCTGGAGTGTACCGACTAGTCGATCCACAGATACGCAGTATTTT	CAWSVPTSRSTDTQYF	TRBV30	TRBJ2-3
TGTGCCAGCCCTAGGAGAGGGACAGGAAACTATGGCTACACCTTC	CASPRRGTGNYGYTF	TRBV6-1	TRBJ1-2
TGTGCCACCAGCAGAGATCCCGGCTCGGCCCCTCGCTACGAGCAGTACTTC	CATSRDPGSAPRYEQYF	TRBV15	TRBJ2-7
TGTGCCTGGAGTTGGCTGTACTATTCAATTGATGCCCTCCACTTT	CAWSWLYYSIDALHF	TRBV30	TRBJ1-6
TGTGCCAGCAGTGACTCCCGGGGGGGGGATGGCATTCTAGAGACCCAGTACTTC	CASSDSRGGDGILETQYF	TRBV6-4	TRBJ2-5
TGCAGCGAATTAACAGGGAGGACTGAAGCTTTCTTT	CSELTGRTEAFF	TRBV29-1	TRBJ1-1
TGTGCCAGCAGCTTACATCCACTAGAGGCGCTAGCCAAAAACATTCAGTACTTC	CASSLHPLEALAKNIQYF	TRBV7-3	TRBJ2-4
TGCAGTGCTAGGGACTGGAATCAGCCCCAGCATTTT	CSARDWNQPQHF	TRBV20-1	TRBJ1-5
TGTGCCACCAGTGCCTTCGGGTGCACAGATACGCAGTATTTT	CATSAFGCTDTQYF	TRBV24-1	TRBJ2-3
TGTGCCAGCAGCTTAGCGATTGGGACTAGCGGGGTTAGCACAGATACGCAGTATTTT	CASSLAIGTSGVSTDTQYF	TRBV7-2	TRBJ2-3
TGTGCCAGCAGGTATCGAGATAGCAATCAGCCCCAGCATTTT	CASRYRDSNQPQHF	TRBV6-8	TRBJ1-5
TGCAGCGTTCGTGACAGGGATATTCTTAGCAATCAGCCCCAGCATTTT	CSVRDRDILSNQPQHF	TRBV29-1	TRBJ1-5
TGTGCCAGCAGCACGATAGCCACCAGCGAAGCCAAAAACATTCAGTACTTC	CASSTIATSEAKNIQYF	TRBV11-3	TRBJ2-4
TGTGCCAGACCGAGGGAAAATAGCACAGATACGCAGTATTTT	CARPRENSTDTQYF	TRBV6-6	TRBJ2-3
TGTGCCAGTAGTCCCGTGACAGGGAGATCCTACGAGCAGTACTTC	CASSPVTGRSYEQYF	TRBV19	TRBJ2-7
TGTGCCAGCAGCCCGGGACATCGGGAGGTACACAGCACAGATACGCAGTATTTT	CASSPGHREVHSTDTQYF	TRBV12-3	TRBJ2-3
TGTGCCAGCAGCTTGACACCGGGACTAGCGGGAGGGAGTGGCTACACCTTC	CASSLTPGLAGGSGYTF	TRBV5-6	TRBJ1-2
TGTGCCAGCAGTGAATTTAGGCAGAGGGCGCGAGAGACCCAGTACTTC	CASSEFRQRARETQYF	TRBV25-1	TRBJ2-5
TGCAGTGCTGGACGGGACAGGGGAATGAACACTGAAGCTTTCTTT	CSAGRDRGMNTEAFF	TRBV20-1	TRBJ1-1
TGTGCCAGCAGCTGGGTCCGGGACAGGGGAGGCCAAGAGACCCAGTACTTC	CASSWVRDRGGQETQYF	TRBV6-1	TRBJ2-5
TGTGCCAGCAGCTTAGACCAATACCCGGACAGGGCGGGACACTATGGCTACACCTTC	CASSLDQYPDRAGHYGYTF	TRBV7-9	TRBJ1-2
TGTGCCAGCAGCGTCCCCGGGACTTCGGACGAGACCCAGTACTTC	CASSVPGTSDETQYF	TRBV7-3	TRBJ2-5
TGTGCCAGCAGCACAGGGAGTAATGAGCAGTTCTTC	CASSTGSNEQFF	TRBV13	TRBJ2-1
TGTGCCAGCAGCGCCCAGACAGCGCTTCAGAACACTGAAGCTTTCTTT	CASSAQTALQNTEAFF	TRBV11-2	TRBJ1-1
TGCAGTGCTTCACCGGGACAGGGCCTAGACGAGCAGTACTTC	CSASPGQGLDEQYF	TRBV20-1	TRBJ2-7
TGCAGTGCTAGGGACAGCCCCTTTCGCAGTGAAAAACTGTTTTTT	CSARDSPFRSEKLFF	TRBV20-1	TRBJ1-4
TGTGCCAGCAGCCAAGCCGGGACAGCGACTGAAGCTTTCTTT	CASSQAGTATEAFF	TRBV3-1	TRBJ1-1
TGTGCCAGCAACCGCCAGGACAGGGATTCTGCAACTAATGAAAAACTGTTTTTT	CASNRQDRDSATNEKLFF	TRBV5-8	TRBJ1-4
TGTGCCAGCAGCAGAGTACAAAACTACGAGCAGTACTTC	CASSRVQNYEQYF	TRBV5-6	TRBJ2-7
TGTGCCAGCAGCACTTCCTTTTCCCGCCGGGACAGGGAGCTAACTGAAGCTTTCTTT	CASSTSFSRRDRELTEAFF	TRBV5-4	TRBJ1-1
TGTGCCAGCAGTTACTCGCCCGTTTGGGGGTTCCTTAGATTGAACACTGAAGCTTTCTTT	CASSYSPVWGFLRLNTEAFF	TRBV6-6	TRBJ1-1
TGTGCCACCAGTGATTTGGGGCTCCAAGACAGGGATACTGAAGCTTTCTTT	CATSDLGLQDRDTEAFF	TRBV24-1	TRBJ1-1
TGTGCCAGCGTACAGGGGAGGGACGAGCAGTACTTC	CASVQGRDEQYF	TRBV5-8	TRBJ2-7
TGTGCCAGCATTGGGACAGGAAACTCCGAGCAGTACTTC	CASIGTGNSEQYF	TRBV6-6	TRBJ2-7
TGTGCCAGCAGCGCCCCTAGTGGCCCGACTTCACCCCTCCACTTT	CASSAPSGPTSPLHF	TRBV13	TRBJ1-6
TGTGCTAGTGGAGGGGGGCGCAATGAGCAGTTCTTC	CASGGGRNEQFF	TRBV12-5	TRBJ2-1
TGTGCCATGTGGGACATTAGGAGAAGCAATCAGCCCCAGCATTTT	CAMWDIRRSNQPQHF	TRBV19	TRBJ1-5
TGTGCCAGCAGCCTGGGGACGTTCGGCTACACCTTC	CASSLGTFGYTF	TRBV13	TRBJ1-2
TGTGCCAGCAGCCAAAGGGAGACTAGCAAAAACACCGGGGAGCTGTTTTTT	CASSQRETSKNTGELFF	TRBV4-2	TRBJ2-2
TGTGCCAGCAGCTTGGCCGGTCAACAACACAATCAGCCCCAGCATTTT	CASSLAGQQHNQPQHF	TRBV5-5	TRBJ1-5
TGTGCCACCGGCGGGGGGGGGGGGAGTGAGGAGAACTATGGCTACACCTTC	CATGGGGGSEENYGYTF	TRBV15	TRBJ1-2
TGCAGTGCTAGCGGGACTCAGGTTACAGATACGCAGTATTTT	CSASGTQVTDTQYF	TRBV20-1	TRBJ2-3
TGTGCCAGCAGTTACTATCCAGCGGCCACTGAAGCTTTCTTT	CASSYYPAATEAFF	TRBV6-5	TRBJ1-1
TGTGCCAGTACCAGGGGACCGCGCTATGGCTACACCTTC	CASTRGPRYGYTF	TRBV19	TRBJ1-2
TGTGAAATAGGACTAGCGGGCCCTTCCTACGAGCAGTACTTC	CEIGLAGPSYEQYF	TRBV12-3	TRBJ2-7
TGTGCCAGCAGCTTGGTTCCGGGGGGCGTGTTTAATGAAAAACTGTTTTTT	CASSLVPGGVFNEKLFF	TRBV5-4	TRBJ1-4
TGTGCCAGTAAAATAGGGGGGTCCTACGAGCAGTACTTC	CASKIGGSYEQYF	TRBV19	TRBJ2-7
TGCAGCGTTAACTGGCAAGAGACCCAGTACTTC	CSVNWQETQYF	TRBV29-1	TRBJ2-5
TGTGCCACCAGTGATTCCCTGCGGGAGCGGAAAGACTATGGCTACACCTTC	CATSDSLRERKDYGYTF	TRBV24-1	TRBJ1-2
TGTGCCAGCAGCTTAGCGGTGGCGGGCGTTGTCTATGGCTACACCTTC	CASSLAVAGVVYGYTF	TRBV7-4	TRBJ1-2
TGCGCCAGCAGGATCACCGTTCAGGGGAAATGTTACTATGGCTACACCTTC	CASRITVQGKCYYGYTF	TRBV5-1	TRBJ1-2
TGCGCCAGCTTCGGGGGTTGCTACGAGCAGTACTTC	CASFGGCYEQYF	TRBV5-1	TRBJ2-7
TGTGCCAGCAGTTCCCCTGCCGGCACCGGGGAGCTGTTTTTT	CASSSPAGTGELFF	TRBV6-3	TRBJ2-2
TGTGCCAGCGGTGACAGGGGCAAGGGGGGCTACACCTTC	CASGDRGKGGYTF	TRBV9	TRBJ1-2
TGTGCCAGCAGCGTAGCGTGCAGGGGGGGTTATGGCTACACCTTC	CASSVACRGGYGYTF	TRBV9	TRBJ1-2
TGTGCCAGCAGCGCGGGTATGGGACTAGCGGGAAGAGCATTAAACATTCAGTACTTC	CASSAGMGLAGRALNIQYF	TRBV9	TRBJ2-4
TGTGCCAGCAGCAGAAGGACTAGCGGATTAGATACGCAGTATTTT	CASSRRTSGLDTQYF	TRBV7-3	TRBJ2-3
TGCGCCAGCAGAATGGACAGGGGGCCGGTTCCCTATGGCTACACCTTC	CASRMDRGPVPYGYTF	TRBV5-1	TRBJ1-2
