TGTGCCAGCAGCCATGACAGCGGAGATACGCAGTATTTT	CASSHDSGDTQYF	TRBV3-1	TRBJ2-3
TGTGCCAGCAGACCAGGTGAGAGGGGCTACACCTTC	CASRPGERGYTF	TRBV6-1	TRBJ1-2
TGCAGTGCTAGCAAGCCTGCAGGGGGCGCCGAATGCAATGAGCAGTTCTTC	CSASKPAGGAECNEQFF	TRBV20-1	TRBJ2-1
TGTGCCATGGTTGGACGCGGTTCACCCCTCCACTTT	CAMVGRGSPLHF	TRBV7-9	TRBJ1-6
TGTGCCAGCAGTTTACGGGGGGCGGATCTGAATGAGCAGTTCTTC	CASSLRGADLNEQFF	TRBV28	TRBJ2-1
TGTGCCAGCAGCTCAACGTGGGGGGATACGGCTAGCACAGATACGCAGTATTTT	CASSSTWGDTASTDTQYF	TRBV5-6	TRBJ2-3
TGCGCCATTAAGGGGTCAACTAATGAAAAACTGTTTTTT	CAIKGSTNEKLFF	TRBV5-1	TRBJ1-4
TGTGCCAGCAGCCAACCCCCCGGGACAGGGGTCGAATCACACACTGAAGCTTTCTTT	CASSQPPGTGVESHTEAFF	TRBV14	TRBJ1-1
TGTGCCAGCAGCTTGGCCAAAGGGACAGGGGGGGACTATGGCTACACCTTC	CASSLAKGTGGDYGYTF	TRBV5-6	TRBJ1-2
TGCGCCAGCAGTGAGGTAGAGCAGTACTTC	CASSEVEQYF	TRBV10-1	TRBJ2-7
TGTGCCAGCAGCTCATTTTGGGACAGGGGGCTAGAATCCCGGATTTCCTACGAGCAGTACTTC	CASSSFWDRGLESRISYEQYF	TRBV27	TRBJ2-7
TGTGCCCGAAACTGCGGGGGGGACCAAGAGACCCAGTACTTC	CARNCGGDQETQYF	TRBV11-3	TRBJ2-5
TGTGCCAGCAGCAGAATTAATGAAAAACTGTTTTTT	CASSRINEKLFF	TRBV6-1	TRBJ1-4
TGTGCCAGCCAGGGCAAAAACATTCAGTACTTC	CASQGKNIQYF	TRBV27	TRBJ2-4
TGCAGCGTTGAAGCGGGACTAGCGGGGGGGGTTTACAATGAGCAGTTCTTC	CSVEAGLAGGVYNEQFF	TRBV29-1	TRBJ2-1
TGTGCCAGCACGGGTAGGACAGGGGGTCTAGCCAAAAACATTCAGTACTTC	CASTGRTGGLAKNIQYF	TRBV27	TRBJ2-4
TGTGCCAGCAGCTTGGTACTCGGGACGAGCTCCTACAATGAGCAGTTCTTC	CASSLVLGTSSYNEQFF	TRBV5-6	TRBJ2-1
TGTGCCAGCAAACCCCCAGGGTTCGCCTACGAGCAGTACTTC	CASKPPGFAYEQYF	TRBV9	TRBJ2-7
TGTGCCAGCACGTCCGGGCCCAGGGTTTACAATGAGCAGTTCTTC	CASTSGPRVYNEQFF	TRBV6-5	TRBJ2-1
TGTGCCAGCAGCGGACAGGCGTTGTCCTACGAGCAGTACTTC	CASSGQALSYEQYF	TRBV7-3	TRBJ2-7
TGTGCCAGCAGTGGAGCCGTCCCGGGGGGCGGCTCCTACGAGCAGTACTTC	CASSGAVPGGGSYEQYF	TRBV6-4	TRBJ2-7
TGTGCCAGCAGGCGGGGGGCGGGAGATACGCAGTATTTT	CASRRGAGDTQYF	TRBV6-3	TRBJ2-3
TGCAGTGCTGCCCGGGGGGGGCGGGGCACAGATACGCAGTATTTT	CSAARGGRGTDTQYF	TRBV20-1	TRBJ2-3
TGTGCCAGCAATGGGAACACTGAAGCTTTCTTT	CASNGNTEAFF	TRBV7-2	TRBJ1-1
TGCGCCAGCAGCCAAGCCCGAAATAGGGGCCAAGAGACCCAGTACTTC	CASSQARNRGQETQYF	TRBV4-3	TRBJ2-5
TGTGCCAGCAGCGTAGGGGTTGAGCAGTTCTTC	CASSVGVEQFF	TRBV9	TRBJ2-1
TGTGCCAGTAGTTGTGGACAGGTAAGGGGGCAAGAGACCCAGTACTTC	CASSCGQVRGQETQYF	TRBV19	TRBJ2-5
TGTGCCAGCGATTTCACCGGGGATGGGGCCAACGTCCTGACTTTC	CASDFTGDGANVLTF	TRBV7-3	TRBJ2-6
TGCGCCAGCAGCTTGCGTCTAGCGGGCAGCCCCACAGATACGCAGTATTTT	CASSLRLAGSPTDTQYF	TRBV5-1	TRBJ2-3
TGCGCCAGCAGCATCGGGGCACGGGGTCCTGTCGAGCAGTACTTC	CASSIGARGPVEQYF	TRBV5-1	TRBJ2-7
TGCGCCAGCAGCCAAGGTGGCGACAGGAATCAGCCCCAGCATTTT	CASSQGGDRNQPQHF	TRBV4-3	TRBJ1-5
TGTGCCAGCAGACAGGGGGGGGGTTTACCCCTCCACTTT	CASRQGGGLPLHF	TRBV6-2	TRBJ1-6
TGTGCCAGCAGCTTCACTAGGGAGACCCAGTACTTC	CASSFTRETQYF	TRBV7-6	TRBJ2-5
TGTGCTAGTGGAAGGACAGGAAATGGAAACACCATATATTTT	CASGRTGNGNTIYF	TRBV12-5	TRBJ1-3
TGTGCCAGCAGCCCCCGAGTCCATGTGGACGAGCAGTACTTC	CASSPRVHVDEQYF	TRBV5-5	TRBJ2-7
TGCAGTGCTAGAGATGGTCCCGACAGGAGGCGCTCCTACGAGCAGTACTTC	CSARDGPDRRRSYEQYF	TRBV20-1	TRBJ2-7
TGTGCCATCAGTGAGTCGAAAACCGGGACCTCGCCGAACACTGAAGCTTTCTTT	CAISESKTGTSPNTEAFF	TRBV10-3	TRBJ1-1
TGTGCCAGCAGGGTGGTCGCCAATGAGCAGTTCTTC	CASRVVANEQFF	TRBV9	TRBJ2-1
TGTGCCAGCAGCGTAGCAGAACAAGCTAGAGCCTACGAGCAGTACTTC	CASSVAEQARAYEQYF	TRBV9	TRBJ2-7
TGTGCCAGCCTCCCCTCCGGGACAGCGGTTTACAATGAGCAGTTCTTC	CASLPSGTAVYNEQFF	TRBV6-2	TRBJ2-1
TGTGCCAGCAGTGTTCAGGGTCACACCGGGGAGCTGTTTTTT	CASSVQGHTGELFF	TRBV28	TRBJ2-2
TGTGCCAGCAGCTTAGACAAGGGCGGGAGAAGCCCCTCCTACAATGAGCAGTTCTTC	CASSLDKGGRSPSYNEQFF	TRBV11-3	TRBJ2-1
TGTGCCAGTAGTATTCCTGGGCTTCCCTACACTGAAGCTTTCTTT	CASSIPGLPYTEAFF	TRBV19	TRBJ1-1
TGTGCCAGCAGCCACCTACGGGGCGATAACACCGGGGAGCTGTTTTTT	CASSHLRGDNTGELFF	TRBV7-4	TRBJ2-2
TGTGCCAGCAGTTTAGGCTGGGGGGTCCACACCGGGGAGCTGTTTTTT	CASSLGWGVHTGELFF	TRBV12-3	TRBJ2-2
TGTGCCAGCAAAGGAATAAAGGTTTTCTACAATGAGCAGTTCTTC	CASKGIKVFYNEQFF	TRBV11-2	TRBJ2-1
TGCATCGAGGGGGCCTACACTGAAGCTTTCTTT	CIEGAYTEAFF	TRBV29-1	TRBJ1-1
TGTGCCAGCAGTGAACGCTGTGGACAGGGCCGTTATTCACCCCTCCACTTT	CASSERCGQGRYSPLHF	TRBV25-1	TRBJ1-6
TGCGCCAGCAGTGAGCCCCCAGAACGGGACACAGGCTACGAGCAGTACTTC	CASSEPPERDTGYEQYF	TRBV10-1	TRBJ2-7
TGTGCCACCACGAGTGGACGCATCTACGAGCAGTACTTC	CATTSGRIYEQYF	TRBV6-2	TRBJ2-7
TGTGCCAGCAGTTACCCGGGCCGACGGATCAATCAGCCCCAGCATTTT	CASSYPGRRINQPQHF	TRBV6-5	TRBJ1-5
TGTGCCAGCAGCCTTCGGCCGGGACAGGAGGACCACACTGAAGCTTTCTTT	CASSLRPGQEDHTEAFF	TRBV13	TRBJ1-1
TGTGCCAGCAGCTTTTTCCCGGGACAGGGGGCGTTGGGTGGCACCTTC	CASSFFPGQGALGGTF	TRBV9	TRBJ1-2
TGCGCCAGGGTAGGGGGCCCAACCGTCTCGAACACTGAAGCTTTCTTT	CARVGGPTVSNTEAFF	TRBV5-1	TRBJ1-1
TGTGCCAGCAGTTTAGGAACCAGGGGACAGGGGAACACTGAAGCTTTCTTT	CASSLGTRGQGNTEAFF	TRBV27	TRBJ1-1
TGTGCCAGCAGCAGAAAGCCTGGGGGGGGCCGCTCCTACAATGAGCAGTTCTTC	CASSRKPGGGRSYNEQFF	TRBV9	TRBJ2-1
TGTGCCACCAGCAGAAGGACAGGGGTGAACACTGAAGCTTTCTTT	CATSRRTGVNTEAFF	TRBV15	TRBJ1-1
TGTGCCAGCAGCCCGAGCCCTTTTCGGGAGGTAATTGAAAAACTGTTTTTT	CASSPSPFREVIEKLFF	TRBV11-3	TRBJ1-4
TGCGCCAGCTGGGAATCAGAAATGGGACAGGGCGTCAGCAATCAGCCCCAGCATTTT	CASWESEMGQGVSNQPQHF	TRBV10-1	TRBJ1-5
TGTGCCAGTAGTTGGAGATCATGGGGGGCCGGGGAGCTGTTTTTT	CASSWRSWGAGELFF	TRBV19	TRBJ2-2
TGTGCCAGCAGCCTTGGGACAGGGAGTACGGAAGAGACCCAGTACTTC	CASSLGTGSTEETQYF	TRBV28	TRBJ2-5
TGTGCCACGGGGAGGTATGAGACCCAGTACTTC	CATGRYETQYF	TRBV24-1	TRBJ2-5
TGCGCCAGCCCGGAACTCGGGGGATACGAGCAGTACTTC	CASPELGGYEQYF	TRBV10-1	TRBJ2-7
TGTGCCAGCAGTGAACCCAAACAGGTGGGGGCTATACCGGATCAGCCCCAGCATTTT	CASSEPKQVGAIPDQPQHF	TRBV6-4	TRBJ1-5
TGCAGCGCCTGTCAACTAGCGTCAAGCCCTAACTCCTACGAGCAGTACTTC	CSACQLASSPNSYEQYF	TRBV29-1	TRBJ2-7
TGTGCCAGCAGTGACCCATCCCAGGGGGCGCTGATCGAGCAGTACTTC	CASSDPSQGALIEQYF	TRBV6-1	TRBJ2-7
TGCGCCAGCAGCTCAAGGACTAGCCCGGGATACAATGAGCAGTTCTTC	CASSSRTSPGYNEQFF	TRBV5-1	TRBJ2-1
TGTGCCAGCAGCGGGGACGGACAGGGATACGGGGCAGACTATGGCTACACCTTC	CASSGDGQGYGADYGYTF	TRBV12-4	TRBJ1-2
TGCAGTGCCGGGAGGGCCCCCACAGATACGCAGTATTTT	CSAGRAPTDTQYF	TRBV20-1	TRBJ2-3
TGTGCCACCAGTGCCCGCAGCCATGACCAGCCCCAGCATTTT	CATSARSHDQPQHF	TRBV24-1	TRBJ1-5
TGTGCCAGCAGCCTGGGGCCTAACTATGGCTACACCTTC	CASSLGPNYGYTF	TRBV11-2	TRBJ1-2
TGCAGTGCTAGGGAGTTGGGGGGACAGGAGCAGTACTTC	CSARELGGQEQYF	TRBV20-1	TRBJ2-7
TGTGCCAGCAGTGACCCCTTCTCCGGATACGAGCAGTACTTC	CASSDPFSGYEQYF	TRBV2	TRBJ2-7
TGCAGCCCGGGGGAGGGGGCCATATATTTT	CSPGEGAIYF	TRBV29-1	TRBJ1-3
TGTGCCAGCAGCACGGGGGACAGATACAATGAGCAGTTCTTC	CASSTGDRYNEQFF	TRBV7-9	TRBJ2-1
TGCAGTGCTAGAGCGTCGAGGGATAGCACAGATACGCAGTATTTT	CSARASRDSTDTQYF	TRBV20-1	TRBJ2-3
TGTGCCTTAGGGAAGGGTAAGAACACTGAAGCTTTCTTT	CALGKGKNTEAFF	TRBV10-3	TRBJ1-1
TGTGCCAGCAGTGACTATCCCGGGGACTCCCGAGGAAACACCATATATTTT	CASSDYPGDSRGNTIYF	TRBV6-4	TRBJ1-3
TGTGCCAGCAGTGACTCGAGGATTCTCAGACGGGAGCGGGAATTTTTGAACACTGAAGCTTTCTTT	CASSDSRILRREREFLNTEAFF	TRBV6-4	TRBJ1-1
TGTGCCAGCAGTGCCTCACGAGGACAGGGGGAGGTCGACTACGAGCAGTACTTC	CASSASRGQGEVDYEQYF	TRBV6-1	TRBJ2-7
TGCAGTGCGTCTGTCAGGGGTAAGACGCCCCAGCATTTT	CSASVRGKTPQHF	TRBV20-1	TRBJ1-5
TGTGCCAGCAGCTTTACAGGGGTAACTTATCAGCCCCAGCATTTT	CASSFTGVTYQPQHF	TRBV7-9	TRBJ1-5
TGTGCCAGCAGTTTCCTTGGGGGGAAGGGTACTGAAGCTTTCTTT	CASSFLGGKGTEAFF	TRBV12-4	TRBJ1-1
TGCAGTGCTAGCACTCAAGCGACAGGGGGCAATCAGCCCCAGCATTTT	CSASTQATGGNQPQHF	TRBV20-1	TRBJ1-5
TGTGCCAGCAGTGACTCCCATCCTGGGGCCCGCTCTGGGGCCAACGTCCTGACTTTC	CASSDSHPGARSGANVLTF	TRBV6-4	TRBJ2-6
TGTGCCAGCAGCAAGGAATCACCCCTCCACTTT	CASSKESPLHF	TRBV13	TRBJ1-6
TGCAGTGCCCCCGGGACGGGGGAGACCCAGTACTTC	CSAPGTGETQYF	TRBV20-1	TRBJ2-5
TGCGCCAGCAGCTTCATAGGGGGGACAGGGCATGGCTACACCTTC	CASSFIGGTGHGYTF	TRBV5-1	TRBJ1-2
TGTGCCAGCAGCTTAGACCCGTGGGGGGTCTGCCAAGAGACCCAGTACTTC	CASSLDPWGVCQETQYF	TRBV11-2	TRBJ2-5
TGTGCCAGCAGTAAGGGACAGCCCCCGAACAATGAGCAGTTCTTC	CASSKGQPPNNEQFF	TRBV12-4	TRBJ2-1
TGTGCCAGTAGTTATCGGCGGGGGGTTAATACTAACACTGAAGCTTTCTTT	CASSYRRGVNTNTEAFF	TRBV19	TRBJ1-1
TGTGCCAGCAGTTACAAGGGGGGTAATGAAAAACTGTTTTTT	CASSYKGGNEKLFF	TRBV6-5	TRBJ1-4
TGTGCCAGCAGCACCCCAGGGGGCGATTGTAGAGAGACCCAGTACTTC	CASSTPGGDCRETQYF	TRBV13	TRBJ2-5
TGTGCCAGCACTCTGGGACTGGGAGTGAGCTCCTATAATTCACCCCTCCACTTT	CASTLGLGVSSYNSPLHF	TRBV6-4	TRBJ1-6
TGTGCCAGCAGCTTAGGCTGGGGAGTACGGGTCTGGCGGGTTGGCTCCTACGAGCAGTACTTC	CASSLGWGVRVWRVGSYEQYF	TRBV7-2	TRBJ2-7
TGTGCCTGGAGTCCCGCAGGGGCTCTGAACACTGAAGCTTTCTTT	CAWSPAGALNTEAFF	TRBV30	TRBJ1-1
TGTGCCAGCAGTGTGGGACCAGATAGCACAGATACGCAGTATTTT	CASSVGPDSTDTQYF	TRBV27	TRBJ2-3
TGTGCCAGCAGCCATGAACGGGCGCCGCCAGCAGACCCTTCTCACACTGAAGCTTTCTTT	CASSHERAPPADPSHTEAFF	TRBV14	TRBJ1-1
TGTGCCAGCAGCCAAAAACACAGGGGGCCCGCGAGATACGAGCAGTACTTC	CASSQKHRGPARYEQYF	TRBV3-1	TRBJ2-7
TGTGCCAGCAGCCATCCGTGCGGGTCCTGCGAGACCCAGTACTTC	CASSHPCGSCETQYF	TRBV4-2	TRBJ2-5
TGTGCCAGCAGTTTATGCCCTCGCCCCGATACGCAGTATTTT	CASSLCPRPDTQYF	TRBV28	TRBJ2-3
TGTGCCAGCAGTTTAAGGGACAGCGCTTATGAAAAACTGTTTTTT	CASSLRDSAYEKLFF	TRBV6-2	TRBJ1-4
TGTGCCACCAGTGACCTAGCGGGTTCAAGCTACGAGCAGTACTTC	CATSDLAGSSYEQYF	TRBV24-1	TRBJ2-7
TGCGCCAGCAGCCAAGACCTACTCGGGAGAGGGGAGCAGTACTTC	CASSQDLLGRGEQYF	TRBV4-1	TRBJ2-7
TGTGCCACCCTAGCGGGAGAATTTTTCTTC	CATLAGEFFF	TRBV24-1	TRBJ2-1
TGCGCCAGCAGCCGGGGGTATTTT	CASSRGYF	TRBV5-1	TRBJ2-3
TGTGCCAGCAGCTTAGCAACCTACGGGAACACCGGGGAGCTGTTTTTT	CASSLATYGNTGELFF	TRBV11-2	TRBJ2-2
TGTGCCAGCAGTTCTGAGTCCCGGAACGAAGACAGGGAAAGTTCCGGAATCTACGAGCAGTACTTC	CASSSESRNEDRESSGIYEQYF	TRBV6-3	TRBJ2-7
TGTGCCAGCAGCCAAGGGGGCTTTCATCAGCCCCAGCATTTT	CASSQGGFHQPQHF	TRBV14	TRBJ1-5
TGCAGTGCTAGAACCGCTGGGAGCTCCTACGAGCAGTACTTC	CSARTAGSSYEQYF	TRBV20-1	TRBJ2-7
TGTGCTAGCTCCGACAGGGAGGGCTTTAAGGCTAATGAAAAACTGTTTTTT	CASSDREGFKANEKLFF	TRBV7-7	TRBJ1-4
TGTGCCAGCAGATTTGATCACCTCCTGAACACTGAAGCTTTCTTT	CASRFDHLLNTEAFF	TRBV9	TRBJ1-1
TGTGCCAGCAGTTACTCGTTGACAGACTATGGCTACACCTTC	CASSYSLTDYGYTF	TRBV6-6	TRBJ1-2
TGTGCCACCAGAGGGGAGGGAGCTTTCTTT	CATRGEGAFF	TRBV24-1	TRBJ1-1
TGCAGTGGGAGAGACCAAGAGACCCAGTACTTC	CSGRDQETQYF	TRBV20-1	TRBJ2-5
TGTGCCAGCAGCTTTTCCCACCGAGTTACGAACACTGAAGCTTTCTTT	CASSFSHRVTNTEAFF	TRBV7-8	TRBJ1-1
TGTGCCAGCAGCTCTACAGGGAACGGGGAGCTGTTTTTT	CASSSTGNGELFF	TRBV5-5	TRBJ2-2
TGCGCCAGCAGTGTTCCCCGGTTGACCTTACCAGAGACCCAGTACTTC	CASSVPRLTLPETQYF	TRBV10-1	TRBJ2-5
TGTGCCTGGAGTGGAAAGGGACAGGGGGCACCATATAATTCACCCCTCCACTTT	CAWSGKGQGAPYNSPLHF	TRBV30	TRBJ1-6
TGTGCCAGCAGCGGGGCGCGAAGGTTTCCTGGCTACACCTTC	CASSGARRFPGYTF	TRBV6-5	TRBJ1-2
TGTGCCAGCAGTAGCCCCGGGACATCTCCGCAGTATTTT	CASSSPGTSPQYF	TRBV6-5	TRBJ2-3
TGTGCCAGCAGACGACAGGATATGGTTACTGAAGCTTTCTTT	CASRRQDMVTEAFF	TRBV2	TRBJ1-1
TGTGCCAGCAGCGGGCCGAGAGTCACCATATATTTT	CASSGPRVTIYF	TRBV11-2	TRBJ1-3
TGTGCCAGCAGCGTTGATGAAGATCGAGGCGGTGTGGAGGAGTACGAGCAGTACTTC	CASSVDEDRGGVEEYEQYF	TRBV28	TRBJ2-7
TGTGCCAGCAGTGGGTATATCGAAGAGACCCAGTACTTC	CASSGYIEETQYF	TRBV25-1	TRBJ2-5
TGTGCCAGCAGTTACAAAGGGGGAGGTGGTCCGGGGGGCATTGTCGGCTACGAGCAGTACTTC	CASSYKGGGGPGGIVGYEQYF	TRBV6-5	TRBJ2-7
TGTGCAGGGGGCCCCGAAAAACTGTTTTTT	CAGGPEKLFF	TRBV6-5	TRBJ1-4
TGTGCCAGCAGTTTAGTGTTACAGGGGAAGTCCTACAATGAGCAGTTCTTC	CASSLVLQGKSYNEQFF	TRBV12-4	TRBJ2-1
TGCAGTGCTTACGGACAGGGGGCAAATCAGCCCCAGCATTTT	CSAYGQGANQPQHF	TRBV20-1	TRBJ1-5
TGTGCCAGCATACGCCCCACAGGGGCTAACAATCAGCCCCAGCATTTT	CASIRPTGANNQPQHF	TRBV27	TRBJ1-5
TGTGCCAGCTCACTTAAGGATGACACTAGCGGGCTTCCGGACCCCCAAGAGACCCAGTACTTC	CASSLKDDTSGLPDPQETQYF	TRBV18	TRBJ2-5
TGTGCCAGCAGCCCCGTAGCGGGAGAGACCCAGTACTTC	CASSPVAGETQYF	TRBV7-9	TRBJ2-5
TGTGCCAGCAGCGTAGCAAAGGACCCGGGGACAGAGCAGTACTTC	CASSVAKDPGTEQYF	TRBV9	TRBJ2-7
TGTGCCAGCAGCTTACCATTAGCGACCTACGAGCAGTACTTC	CASSLPLATYEQYF	TRBV11-3	TRBJ2-7
TGCGCCAGCAGTGAGTCATCGACAGGGGGTATGAGGCAAGAGACCCAGTACTTC	CASSESSTGGMRQETQYF	TRBV10-1	TRBJ2-5
TGTGCCAGCAGCGAGACTTCCTACGAGCAGTACTTC	CASSETSYEQYF	TRBV5-5	TRBJ2-7
TGTGCCAGCAGTCGGGCGGTGTTGGAGTCACCCCTCCACTTT	CASSRAVLESPLHF	TRBV12-3	TRBJ1-6
TGCGCCAGCAGTGACCTACCTCTCAAGTCGTACGAGCAGTACTTC	CASSDLPLKSYEQYF	TRBV10-1	TRBJ2-7
TGCCTAGGGGGATTTGACACTGAAGCTTTCTTT	CLGGFDTEAFF	TRBV5-1	TRBJ1-1
TGTGCCAGCAGCTTAGGGAGCGGGGCATCCTACGAGCAGTACTTC	CASSLGSGASYEQYF	TRBV7-6	TRBJ2-7
TGTGCCAGCAGTTCCGGAGGGTGTGGGACTAGCGGGTTTCTAACAGATACGCAGTATTTT	CASSSGGCGTSGFLTDTQYF	TRBV27	TRBJ2-3
TGTGCCAGCAGCGGGACTGAAGCTTTCTTT	CASSGTEAFF	TRBV7-4	TRBJ1-1
TGCGCCAGCAGCATACCACAGGGATCCAGCTCTGGAAACACCATATATTTT	CASSIPQGSSSGNTIYF	TRBV5-1	TRBJ1-3
TGTGCCATCAGTTCGGGGGGGACAGGGTTTGTCAATCAGCCCCAGCATTTT	CAISSGGTGFVNQPQHF	TRBV10-3	TRBJ1-5
TGTGCCAGCAGCTTCGACAGGAATGAGCAGTTCTTC	CASSFDRNEQFF	TRBV5-4	TRBJ2-1
TGTGCCAGCAGCCGACAAATCTTAAAGTACTTC	CASSRQILKYF	TRBV7-8	TRBJ2-4
TGCAGTGCTAGACCCGAAGGGGTCCATCCTGAAAAACTGTTTTTT	CSARPEGVHPEKLFF	TRBV20-1	TRBJ1-4
TGTGCCAGCAGTATGCAAGTTGTACCGGCTGACTATGGCTACACCTTC	CASSMQVVPADYGYTF	TRBV6-1	TRBJ1-2
TGTGCCAGCAGCTCCTCTCTCTTCACTGAAGCTTTCTTT	CASSSSLFTEAFF	TRBV13	TRBJ1-1
TGCGCCAGCAGCTTGGCCGTGTATCCCCACCCCCCGGGACAGGGAGCCAGCTCTGGAAACACCATATATTTT	CASSLAVYPHPPGQGASSGNTIYF	TRBV5-1	TRBJ1-3
TGCGCCAGCAGTGAGTCCCCTCAGGAAAATCACCCCCAGTACTTC	CASSESPQENHPQYF	TRBV10-1	TRBJ2-5
TGTGCCAGCACGTGGGGTCCCAATCAGCCCCAGCATTTT	CASTWGPNQPQHF	TRBV6-4	TRBJ1-5
TGTGCCAGCAGCCGGACTAGCGGGAGAGAGACCCAGTACTTC	CASSRTSGRETQYF	TRBV7-2	TRBJ2-5
TGTGCCAGCAGATTAGTCACGGACAGGAAGTCTGGGGCCAACGTCCTGACTTTC	CASRLVTDRKSGANVLTF	TRBV7-6	TRBJ2-6
TGTGCCACCAGCGAAGGACAGGAGTACTACGAGCAGTACTTC	CATSEGQEYYEQYF	TRBV24-1	TRBJ2-7
TGTGCCAGCAGCCCGGGCCGTAGCACAGATACGCAGTATTTT	CASSPGRSTDTQYF	TRBV3-1	TRBJ2-3
TGCAGTGCTAGCCAGGACAGATGGGCCTACGAGCAGTACTTC	CSASQDRWAYEQYF	TRBV20-1	TRBJ2-7
TGTGCCAGCAGCAGGGGCCTTAAAGAGACCCAGTACTTC	CASSRGLKETQYF	TRBV13	TRBJ2-5
TGTGCCCATGGGGCCGGGACAGGGACCAGCCTTGAAAAACTGTTTTTT	CAHGAGTGTSLEKLFF	TRBV6-4	TRBJ1-4
TGTGCCAGCGTGGGAAATGAAAAACTGTTTTTT	CASVGNEKLFF	TRBV27	TRBJ1-4
TGTGCCAGCAGCCTTGGACAGGGGGCCAATCAGCCCCAGCATTTT	CASSLGQGANQPQHF	TRBV13	TRBJ1-5
TGCAGTGCTAGAGCGGCCCCAACTAGCGGGAGGAGCGCGCAGTATTTT	CSARAAPTSGRSAQYF	TRBV20-1	TRBJ2-3
TGTGCCAGCAGCGTGTACAGGGTATTCCTAATACGCCCGGGCAATCAGCCCCAGCATTTT	CASSVYRVFLIRPGNQPQHF	TRBV5-6	TRBJ1-5
TGTGCCAGCTCTCCCCGGAGGAAGGGTAGTTATGAGCAGTTCTTC	CASSPRRKGSYEQFF	TRBV18	TRBJ2-1
TGTGCCAGCCAAGCTATAGGGCCCTACGAGCAGTACTTC	CASQAIGPYEQYF	TRBV6-2	TRBJ2-7
TGTGCCACCAGCAGGGGACCCGAAAAACTGTTTTTT	CATSRGPEKLFF	TRBV15	TRBJ1-4
TGCGCCAGCAGCATTTCGGCGAGCTCTGGAAACACCATATATTTT	CASSISASSGNTIYF	TRBV5-1	TRBJ1-3
TGTGCCAGCAGGTGGCGAGGATGTAATCAGCCCCAGCATTTT	CASRWRGCNQPQHF	TRBV6-2	TRBJ1-5
TGTGCCAGCAGTTCGAAAAAAATTTACAATGAGCAGTTCTTC	CASSSKKIYNEQFF	TRBV12-3	TRBJ2-1
TGTGCCAGCAGTCACGGGGAGACGGAGGGGAACACTGAAGCTTTCTTT	CASSHGETEGNTEAFF	TRBV2	TRBJ1-1
TGTGCCAGCAGGAACAGGGGCTCGACTGAAGCTTTCTTT	CASRNRGSTEAFF	TRBV7-3	TRBJ1-1
TGTGCCAGCAGTGAGGGGGAGGACCGGACTGGGTTCACCGGGGAGCTGTTTTTT	CASSEGEDRTGFTGELFF	TRBV2	TRBJ2-2
TGTGCCATCAGTGTAGGGGTCGTGACATACAATGAGCAGTTCTTC	CAISVGVVTYNEQFF	TRBV10-3	TRBJ2-1
TGCAGTGCTAGGGTTCGGGATAGTTATTTT	CSARVRDSYF	TRBV20-1	TRBJ2-3
TGCAGTGCGACCCCGACACGCCACACTGAAGCTTTCTTT	CSATPTRHTEAFF	TRBV20-1	TRBJ1-1
TGTGCCAGCAGCTTATCCTGCATCTCCTACGAGCAGTACTTC	CASSLSCISYEQYF	TRBV7-3	TRBJ2-7
TGTGCCAGCAGTCCAGGGACTGTGGTCTGTATGAACACTGAAGCTTTCTTT	CASSPGTVVCMNTEAFF	TRBV12-3	TRBJ1-1
TGCGCCAGCAGCTCTGCGGGGGGGCAGTGGAATCAGCCCCAGCATTTT	CASSSAGGQWNQPQHF	TRBV4-1	TRBJ1-5
TGTGCCAGCAGTTTACAAGAACGGAAGCCCCAGCATTTT	CASSLQERKPQHF	TRBV27	TRBJ1-5
TGTGCCATAGCGGCCTGCGGGGACTACAATGAGCAGTTCTTC	CAIAACGDYNEQFF	TRBV10-3	TRBJ2-1
TGTGCCAGCAGCCAAGTGGCCCCCCCCGGCCGATTCTACAATGAGCAGTTCTTC	CASSQVAPPGRFYNEQFF	TRBV4-2	TRBJ2-1
TGTGCCAGGGCCATGGGGCCTACCTCCTACGAGCAGTACTTC	CARAMGPTSYEQYF	TRBV4-2	TRBJ2-7
TGTGCCAGCAGTCACCCCGCCGGGACAGGAGAAGCTTTCTTT	CASSHPAGTGEAFF	TRBV12-3	TRBJ1-1
TGTGCCAGCAGTGAATATATCGAGCGCGAGCAGTACTTC	CASSEYIEREQYF	TRBV25-1	TRBJ2-7
TGTGCCAGCAGGGGGCGGGTCGGATCAGATACGCAGTATTTT	CASRGRVGSDTQYF	TRBV12-3	TRBJ2-3
TGTGCCAGCAGTTACGGTCCCGCGGTGGAAAACATTCAGTACTTC	CASSYGPAVENIQYF	TRBV6-2	TRBJ2-4
TGTGCCAGCAGCCAACCCGAAGCCAACGCTAGCGGGAGCTTGATATCCGGGGAGCTGTTTTTT	CASSQPEANASGSLISGELFF	TRBV4-2	TRBJ2-2
TGTGCCAGCAGCCAAGAGAATTTTGTCGGGTTGTACGAGCAGTACTTC	CASSQENFVGLYEQYF	TRBV14	TRBJ2-7
TGTGCTAGTGGTTTGAACGGGGTACTTGATGAATACGAGCAGTACTTC	CASGLNGVLDEYEQYF	TRBV12-5	TRBJ2-7
TGTGCAGCCCATCGGGGCACAGATACGCAGTATTTT	CAAHRGTDTQYF	TRBV7-3	TRBJ2-3
TGTGCCAGCAACGGAGTTGTCGTTCGGGGGGGCTATGGCTACACCTTC	CASNGVVVRGGYGYTF	TRBV4-2	TRBJ1-2
TGTGCCAGCAGCTTAGTAAACGGATATAGCAATCAGCCCCAGCATTTT	CASSLVNGYSNQPQHF	TRBV7-2	TRBJ1-5
TGCGCCAGCAGCTGGGGGGGGGGGAATTGGTACGAGCAGTACTTC	CASSWGGGNWYEQYF	TRBV5-1	TRBJ2-7
TGTGCCAGCAGATCATGGGACCTTAACACTGAAGCTTTCTTT	CASRSWDLNTEAFF	TRBV6-4	TRBJ1-1
TGTGCCAGTAGTATAGATTCCAGACAGGGGGATGGCTACACCTTC	CASSIDSRQGDGYTF	TRBV19	TRBJ1-2
TGTGCCAGCAGCCTAGAACGCGAGCAGTACTTC	CASSLEREQYF	TRBV7-4	TRBJ2-7
TGTGCCAGCAGTTCTCCGTCCCGGGGTCTGAACACTGAAGCTTTCTTT	CASSSPSRGLNTEAFF	TRBV5-4	TRBJ1-1
TGTCATGGACAGGGCTCGGAAAAACTGTTTTTT	CHGQGSEKLFF	TRBV30	TRBJ1-4
TGTGCCAGCAGCTTAGGTGTAGGGGGGGCTGGGCCCGGGGAGCTGTTTTTT	CASSLGVGGAGPGELFF	TRBV7-3	TRBJ2-2
TGTGCCACCAGGACAGGGTTTTTATACGAGCAGTACTTC	CATRTGFLYEQYF	TRBV24-1	TRBJ2-7
TGTGCCAGCAGCCGGATCCACAATGAGCAGTTCTTC	CASSRIHNEQFF	TRBV7-3	TRBJ2-1
TGTGCTAGTGGTTTGAATCTAGGAAATCAGCCCCAGCATTTT	CASGLNLGNQPQHF	TRBV12-5	TRBJ1-5
TGTGCCAGCAGCGGGAGGGTTTCACCCCTCCACTTT	CASSGRVSPLHF	TRBV7-4	TRBJ1-6
TGTGCCAGCAGATCGGGACATCGAAGCTCCTACGAGCAGTACTTC	CASRSGHRSSYEQYF	TRBV28	TRBJ2-7
TGTGCCAGCAGCTTGGACCGCCAACGTCTAGCGGCCGATACGCAGTATTTT	CASSLDRQRLAADTQYF	TRBV11-3	TRBJ2-3
TGCGCCAGCAGCCAAGATCCGACGGGTGAGAATGAGCAGTTCTTC	CASSQDPTGENEQFF	TRBV4-1	TRBJ2-1
TGTGCCAGCAGCCAAGATGGACAGGGCAATCCACACTATTATAGCAATCAGCCCCAGCATTTT	CASSQDGQGNPHYYSNQPQHF	TRBV14	TRBJ1-5
TGTGCCAGCAGTTACAGCTGGACAGGCGACTACGAGCAGTACTTC	CASSYSWTGDYEQYF	TRBV6-5	TRBJ2-7
TGCAGTGCTAGGGGGCAGAGGACTAGGACCAACTACGAGCAGTACTTC	CSARGQRTRTNYEQYF	TRBV20-1	TRBJ2-7
TGTGCCAGCCCCGCTAGCGGGCCGCGGGTACCGCTCTACAATGAGCAGTTCTTC	CASPASGPRVPLYNEQFF	TRBV7-9	TRBJ2-1
TGTGCTAGTGGAGGGGCGTTGGGCTGGTTACTCAATCAGCCCCAGCATTTT	CASGGALGWLLNQPQHF	TRBV12-5	TRBJ1-5
TGTGCCAGCAGTTGTAAGACAGGGGGCACAGATACGCAGTATTTT	CASSCKTGGTDTQYF	TRBV28	TRBJ2-3
TGTGCCAGCAGTTACTTTTCAACAGGGGCCTCCTACAATGAGCAGTTCTTC	CASSYFSTGASYNEQFF	TRBV6-5	TRBJ2-1
TGTGCCAGCAGCTCATTGGAGTACAATGAGCAGTTCTTC	CASSSLEYNEQFF	TRBV6-1	TRBJ2-1
TGTGCCAGCGTACTAGCGGGAGGGACAGATACGCAGTATTTT	CASVLAGGTDTQYF	TRBV13	TRBJ2-3
TGTGCCACCAGTGAAGCCCCCGCCAACAGGGCCGTCGCAGTTTTCTACAATGAGCAGTTCTTC	CATSEAPANRAVAVFYNEQFF	TRBV24-1	TRBJ2-1
TGCGCCAGCAATGGGGGACTAGCGGGGAGAGATGAGCAGTTCTTC	CASNGGLAGRDEQFF	TRBV5-1	TRBJ2-1
TGTGCCAGCAGTCACCGGGACAAGGGGACCGAGCAGTACTTC	CASSHRDKGTEQYF	TRBV6-4	TRBJ2-7
TGTGCCACGGGGAGGAAGGGCTCTGGGGCCAACGTCCTGACTTTC	CATGRKGSGANVLTF	TRBV28	TRBJ2-6
TGTGCCAGCAGCCAGAGGACCCACTATGGCTACACCTTC	CASSQRTHYGYTF	TRBV7-3	TRBJ1-2
TGCGCCAGCAGCTTGGGCCCGGGACAGGGGCCGATTAGCTCCTATAATTCACCCCTCCACTTT	CASSLGPGQGPISSYNSPLHF	TRBV5-1	TRBJ1-6
TGTGCCAGCAGCACATGGGAGGCCGATAACACTGAAGCTTTCTTT	CASSTWEADNTEAFF	TRBV7-6	TRBJ1-1
TGTGCCAGCGGCAAGTACGAGCAGTACTTC	CASGKYEQYF	TRBV27	TRBJ2-7
TGCGCCAGCAGCTTGTCTCCCGGGTACCGCGAGCAGTACTTC	CASSLSPGYREQYF	TRBV5-1	TRBJ2-7
TGCGCCAGCAGCCAAGATATGGGGGGACTAGCGGGAGGGCGAATGGGACATCAGCCCCAGCATTTT	CASSQDMGGLAGGRMGHQPQHF	TRBV4-1	TRBJ1-5
TGCGCCAGCAGTGAGTCCGGAGGGACTAGCGGACATGAGCAGTTCTTC	CASSESGGTSGHEQFF	TRBV10-1	TRBJ2-1
TGTGCCAGCATAACAGGCGGGACCGACTACGAGCAGTACTTC	CASITGGTDYEQYF	TRBV27	TRBJ2-7
TGTGCCAGCAGCCAAGTACCCAGGGTGCACTACGAGCAGTACTTC	CASSQVPRVHYEQYF	TRBV14	TRBJ2-7
TGCAGTGCTAGAGCCGCGGGACAGGGAGCTGAGCAGTACTTC	CSARAAGQGAEQYF	TRBV20-1	TRBJ2-7
TGCGCCCGGGGATCCGAGCAGTACTTC	CARGSEQYF	TRBV10-2	TRBJ2-7
TGCGCCAGCAGCTGGCGAGTTGGGGGGGTGACTAGCACAGATACGCAGTATTTT	CASSWRVGGVTSTDTQYF	TRBV5-1	TRBJ2-3
TGCGCCAGCAGCCAAGACGAGGGGCTCGCTTACGAGCAGTACTTC	CASSQDEGLAYEQYF	TRBV4-1	TRBJ2-7
TGTGCCAGAGGCTTTCCGGGACGTAAGGGTGAAAAACTGTTTTTT	CARGFPGRKGEKLFF	TRBV19	TRBJ1-4
TGTGCCGGGGACATATATTTT	CAGDIYF	TRBV9	TRBJ1-3
TGTGCCAGCAGCAAGGGACAGGGACACACTGAAGCTTTCTTT	CASSKGQGHTEAFF	TRBV13	TRBJ1-1
TGCGCCAGCAGAGCCACTAGCGGCCGATTCTACGAGCAGTACTTC	CASRATSGRFYEQYF	TRBV10-1	TRBJ2-7
TGCAGCGATAGCGGGAGCTCCTTCGGGATGAACACTGAAGCTTTCTTT	CSDSGSSFGMNTEAFF	TRBV29-1	TRBJ1-1
TGTGCCAGCACTCGGGCAACTAATGAAAAACTGTTTTTT	CASTRATNEKLFF	TRBV6-5	TRBJ1-4
TGCGCCAGCAGCCCTAATACAGATCGGGGCACTGAAGCTTTCTTT	CASSPNTDRGTEAFF	TRBV4-1	TRBJ1-1
TGTGCCCCACCGTTCTTTTTAGGGACAGGCCTTGCCAAAAACATTCAGTACTTC	CAPPFFLGTGLAKNIQYF	TRBV27	TRBJ2-4
TGTGCCACCAGCAGATCCCGGGGGTGGGGGCAAGAGACCCAGTACTTC	CATSRSRGWGQETQYF	TRBV15	TRBJ2-5
TGTGCCAGACCGGCAATGGGAGGGAATGGGAACACTGAAGCTTTCTTT	CARPAMGGNGNTEAFF	TRBV19	TRBJ1-1
TGTGCCATCAGCCCCCAAAGGGACGATCTTAGCTCCTACAATGAGCAGTTCTTC	CAISPQRDDLSSYNEQFF	TRBV10-3	TRBJ2-1
TGTGCCAGCAGCCAAGAGACTAGCGGTCCGGCCTACGAGCAGTACTTC	CASSQETSGPAYEQYF	TRBV4-2	TRBJ2-7
TGTGCCAGCAGTGATATACGCAAAAACATTCAGTACTTC	CASSDIRKNIQYF	TRBV6-1	TRBJ2-4
TGCGCCAGCAGCTTTGGCAGGGGGGAGAGCACCGGGGAGCTGTTTTTT	CASSFGRGESTGELFF	TRBV5-1	TRBJ2-2
TGCGCCAGCAGCTGGAATAGACGGGCGGACAGGGGGGTAGACTATGGCTACACCTTC	CASSWNRRADRGVDYGYTF	TRBV5-1	TRBJ1-2
TGTGCCAGCAGCCAACAAGGACTAGCGGGTGCCTACGAGCAGTACTTC	CASSQQGLAGAYEQYF	TRBV3-1	TRBJ2-7
TGTGCCAGCAGTACCCCGAGACTAGTCAAGTACTTC	CASSTPRLVKYF	TRBV6-1	TRBJ2-7
TGTGCCAGCAGCGTCGCCCCCGACGGGGTTCGCCGCAATCAGCCCCAGCATTTT	CASSVAPDGVRRNQPQHF	TRBV7-4	TRBJ1-5
TGTGCCAGTAGTATAACTAATTTGGCTAACTATGGCTACACCTTC	CASSITNLANYGYTF	TRBV19	TRBJ1-2
TGTGCCAGCAGTTTTAGACAGTCCCACAATGAGCAGTTCTTC	CASSFRQSHNEQFF	TRBV27	TRBJ2-1
TGCAGTGCTAGAGACCAAGACCCTTACTATGGCTACACCTTC	CSARDQDPYYGYTF	TRBV20-1	TRBJ1-2
TGTGCCACCAGGGACCAGGGTGGGGGCGAGCAGTACTTC	CATRDQGGGEQYF	TRBV24-1	TRBJ2-7
TGCAGTGCTAGAGATAGACATGAATCCTCTCGACAGGGGTTTAGCAATCAGCCCCAGCATTTT	CSARDRHESSRQGFSNQPQHF	TRBV20-1	TRBJ1-5
TGTGCCAGCAGCCTGGAGGGGGGCCATCAGCCCCAGCATTTT	CASSLEGGHQPQHF	TRBV7-2	TRBJ1-5
TGTGCCAGCAGCGTCGGACAGTCTGGACAGCCCCAGCATTTT	CASSVGQSGQPQHF	TRBV7-2	TRBJ1-5
TGTGCCAGCAGTAGAGCGGGACCGGGTCAGCCCCAGCATTTT	CASSRAGPGQPQHF	TRBV12-4	TRBJ1-5
TGTGCCACCAATGGAGTAGACTACGAGCAGTACTTC	CATNGVDYEQYF	TRBV24-1	TRBJ2-7
TGCAGTGCTGGTCCCCGCGCCCGGGGAGCAGAGACCCAGTACTTC	CSAGPRARGAETQYF	TRBV20-1	TRBJ2-5
TGTGCCAGCAGCTCCGGGGGGGCCGGGATAGAGACCCAGTACTTC	CASSSGGAGIETQYF	TRBV7-9	TRBJ2-5
TGTGCCAGCAGGAGAGGACTAGCGGGGCTTTCCTACAATGAGCAGTTCTTC	CASRRGLAGLSYNEQFF	TRBV6-5	TRBJ2-1
TGTGCCAGCAGTGACGGAGGAAGTGGCACGACCGTTAGCACTGAAGCTTTCTTT	CASSDGGSGTTVSTEAFF	TRBV6-4	TRBJ1-1
TGTGCCAGCAGCTTAGCAAGCGGGAGGGATACGCAGTATTTT	CASSLASGRDTQYF	TRBV11-3	TRBJ2-3
TGTGCCAGCAGTGACTCAACCTTGAGCAATGAGCAGTTCTTC	CASSDSTLSNEQFF	TRBV6-4	TRBJ2-1
TGCGCCAGCAGCTCTCCCAGCGCTCCTCGCGAGCAGTACTTC	CASSSPSAPREQYF	TRBV5-1	TRBJ2-7
TGTGCCTGGAGGGTACAGGGGAGGCAGCCCCAGCATTTT	CAWRVQGRQPQHF	TRBV30	TRBJ1-5
TGTGCCAGCAGCGTAGGAGGGGGCAACACTGAAGCTTTCTTT	CASSVGGGNTEAFF	TRBV9	TRBJ1-1
TGTGCCACCCGGCAGGGGAGCTCTGGGGCCAACGTCCTGACTTTC	CATRQGSSGANVLTF	TRBV24-1	TRBJ2-6
TGTGCCAGCAACCTACAGGGGAAGTACAATGAGCAGTTCTTC	CASNLQGKYNEQFF	TRBV27	TRBJ2-1
TGTGCCAGCAGCACTCCGGGACAGGGGCCTTTGGGCACAGATACGCAGTATTTT	CASSTPGQGPLGTDTQYF	TRBV7-3	TRBJ2-3
TGTGCCAGCAAGACCACGGCCACCTACGAGCAGTACTTC	CASKTTATYEQYF	TRBV27	TRBJ2-7
TGTGCCTGGAGTACCCCAGGGCCCTCCTACGAGCAGTACTTC	CAWSTPGPSYEQYF	TRBV30	TRBJ2-7
TGCAGCGGGGTTACCTTCGCATCAGGCTACACCTTC	CSGVTFASGYTF	TRBV29-1	TRBJ1-2
TGTGCCATGACAGGGCCCTGGTACTATGGCTACACCTTC	CAMTGPWYYGYTF	TRBV19	TRBJ1-2
TGTGCCAGCAGCTGGCGCGGGGCCTGGACTACAGCCCAGCATTTT	CASSWRGAWTTAQHF	TRBV7-3	TRBJ1-5
TGTGCCAGTAGGGGTGGGGGGAGAGAGCCCCAGCATTTT	CASRGGGREPQHF	TRBV19	TRBJ1-5
TGCGCCAGCAGCTCCCTTCGACAGGGAGATACGCAGTATTTT	CASSSLRQGDTQYF	TRBV5-1	TRBJ2-3
TGCGCCAGCAGCCAAAGCCAGGGCTGGTACCCGGGCTACGAGCAGTACTTC	CASSQSQGWYPGYEQYF	TRBV4-1	TRBJ2-7
TGCGCCAGCAGCCAAGATTTAATAGCCGAGAACGAGAGGAGGGACGAGCAGTACTTC	CASSQDLIAENERRDEQYF	TRBV4-1	TRBJ2-7
TGTGCCAGCACCGGGGGGGGAAGCACAGATACGCAGTATTTT	CASTGGGSTDTQYF	TRBV12-3	TRBJ2-3
TGTGCCAGTAGTATATGCCCGACAGGGGAGGAAAAACTGTTTTTT	CASSICPTGEEKLFF	TRBV19	TRBJ1-4
TGCGCCAGCAGCCAAGATCAAAACGAGCACCGCTGGAACACTGAAGCTTTCTTT	CASSQDQNEHRWNTEAFF	TRBV4-1	TRBJ1-1
TGTGCCAGCAGCGGGGGCGGGGAAACCTCCTATAATTCACCCCTCCACTTT	CASSGGGETSYNSPLHF	TRBV7-3	TRBJ1-6
TGTGCCAGCAGCTTCAAACAGAGAGGACAGGGATGGAATGAGCAGTTCTTC	CASSFKQRGQGWNEQFF	TRBV5-5	TRBJ2-1
TGTGCCAGCAGCTGGGGGGTCGAGAACACTGAAGCTTTCTTT	CASSWGVENTEAFF	TRBV3-1	TRBJ1-1
TGTGCCAGCAGCTTGGTCTTGGGGAGGACAGCGAGAAGCAATCAGCCCCAGCATTTT	CASSLVLGRTARSNQPQHF	TRBV5-6	TRBJ1-5
TGTGCCAGCAGTGACTCGACGGTCATGGGGGGGCCTGTGTACCCAGATACGCAGTATTTT	CASSDSTVMGGPVYPDTQYF	TRBV6-4	TRBJ2-3
TGTGCCTGGATCCTCCCGGGGACAGGCCAGCCCCAGCATTTT	CAWILPGTGQPQHF	TRBV30	TRBJ1-5
TGTGCCAGCAGGCCCCAGGGACACACCCCTAACTATGGCTACACCTTC	CASRPQGHTPNYGYTF	TRBV6-1	TRBJ1-2
TGTGCCAGGGCGTTCGAAGGGGGCCAGCGGTATGAAAAACTGTTTTTT	CARAFEGGQRYEKLFF	TRBV9	TRBJ1-4
TGCAGTGCTAGCCAGGCTCAGGATGGAGCTTTCTTT	CSASQAQDGAFF	TRBV20-1	TRBJ1-1
TGTGCCAGCAGCTTGGCGTACAGGGTGGCGGGGGATGAAAAACTGTTTTTT	CASSLAYRVAGDEKLFF	TRBV5-8	TRBJ1-4
TGTGCCAGCAGTTTAACGTCCTGGGGGGACCAGGATACGCAGTATTTT	CASSLTSWGDQDTQYF	TRBV12-3	TRBJ2-3
TGTGCCAGCAGTTTATGTACACCGTCCCGGACTAGCGGGAGTGAGCAGTTCTTC	CASSLCTPSRTSGSEQFF	TRBV28	TRBJ2-1
TGTGCCAGCAGTCGAGGTGAGCAGTTCTTC	CASSRGEQFF	TRBV6-6	TRBJ2-1
TGTGCCATCTTTACAGGGATACGAGATACGCAGTATTTT	CAIFTGIRDTQYF	TRBV10-3	TRBJ2-3
TGTGCCACCAGCAGAGATTCTCGCCACTCCTACGAGCAGTACTTC	CATSRDSRHSYEQYF	TRBV15	TRBJ2-7
TGTGCCAGCAGTGGACGAAGTGTTCCCCAGCATTTT	CASSGRSVPQHF	TRBV6-5	TRBJ1-5
TGTGCCAGCAGCGAAAGCGGGATTCGGTATGAGCAGTTCTTC	CASSESGIRYEQFF	TRBV7-4	TRBJ2-1
TGTGCCAGCAGCCGGTTTATTCAGCCCCAGCATTTT	CASSRFIQPQHF	TRBV27	TRBJ1-5
TGTGCCAGCAGTTACGTGACCCCTTGGAATCAGCCCCAGCATTTT	CASSYVTPWNQPQHF	TRBV6-5	TRBJ1-5
TGCGCCAGCAGCTTGGCTGACCAGGGGCTTAGGAACTATGGCTACACCTTC	CASSLADQGLRNYGYTF	TRBV5-1	TRBJ1-2
TGTGCCAGTAGTTCGACAGGGAATTTGAACACTGAAGCTTTCTTT	CASSSTGNLNTEAFF	TRBV19	TRBJ1-1
TGCGCCAGCATAGGGGGGACTAGGCCAGCGGGGTACGAGCAGTACTTC	CASIGGTRPAGYEQYF	TRBV10-1	TRBJ2-7
TGTGCCAGTAGTATAGATCCGTTAGAACCCTACGAGCAGTACTTC	CASSIDPLEPYEQYF	TRBV19	TRBJ2-7
TGTGCCAGCTTCCTCCTCCTCAGTTCAGGCGCCCGCGGCACCTTC	CASFLLLSSGARGTF	TRBV6-3	TRBJ1-2
TGCAGTGCTCAGTTTAGCTCCTACAATGAGCAGTTCTTC	CSAQFSSYNEQFF	TRBV20-1	TRBJ2-1
TGTGCCCAGGGGTATCAGCCCCAGCATTTT	CAQGYQPQHF	TRBV19	TRBJ1-5
TGTGCCAGCAGCTGGGGTCTAGGAAGTGGCTACACCTTC	CASSWGLGSGYTF	TRBV7-3	TRBJ1-2
TGTGCCAGCATTCCTGGGGGTGGTGAGAACACTGAAGCTTTCTTT	CASIPGGGENTEAFF	TRBV9	TRBJ1-1
TGTGCCAGCCCTCAGAACACTGAAGCTTTCTTT	CASPQNTEAFF	TRBV6-5	TRBJ1-1
TGTGCCAGCAGCCCTCATCTCAGGGAGGGAGATACGCAGTATTTT	CASSPHLREGDTQYF	TRBV7-2	TRBJ2-3
TGTGCCAGCAGCTTAGCCGACTACGGGCAGGGAAGCAATCAGCCCCAGCATTTT	CASSLADYGQGSNQPQHF	TRBV11-2	TRBJ1-5
TGTGCCAGCACGGGAGGGGGAAGCAATCAGCCCCAGCATTTT	CASTGGGSNQPQHF	TRBV7-3	TRBJ1-5
TGTGCCTTAGACCTAGATGTTGCAGATGAGACCCAGTACTTC	CALDLDVADETQYF	TRBV30	TRBJ2-5
TGCGCCAGCAGCTTGCGGGCAGATACGCAGTATTTT	CASSLRADTQYF	TRBV4-3	TRBJ2-3
TGTGCCAGCAGTTTACCCAGCGGGAGAACCAAAAACATTCAGTACTTC	CASSLPSGRTKNIQYF	TRBV12-3	TRBJ2-4
TGTGCCAGCAGCCAAGATCTCGGGGGGCCGGCCGCAGATACGCAGTATTTT	CASSQDLGGPAADTQYF	TRBV3-1	TRBJ2-3
TGTGCCATCAGTGCCTCGTACGGGCGGTTTGGGAACACTGAAGCTTTCTTT	CAISASYGRFGNTEAFF	TRBV10-3	TRBJ1-1
TGTGCCTGGAGTGTACAGAATAAGACAGGGGAGATCAACACTGAAGCTTTCTTT	CAWSVQNKTGEINTEAFF	TRBV30	TRBJ1-1
TGTGCCAGCAGGCCTAACCAGGGAGAAGAAAAACTGTTTTTT	CASRPNQGEEKLFF	TRBV6-1	TRBJ1-4
TGCAGTGCTAGCGAGGAGACCAGACAGGGTAATTGGAGCAATCAGCCCCAGCATTTT	CSASEETRQGNWSNQPQHF	TRBV20-1	TRBJ1-5
TGTGCCACCGGGACAGCGTCTGGCTACACCTTC	CATGTASGYTF	TRBV10-3	TRBJ1-2
TGTGCCACCAGTGATTGGACTAAGCGAGACCGGGAGTACGAGCAGTACTTC	CATSDWTKRDREYEQYF	TRBV24-1	TRBJ2-7
TGTGCCAGCAGCGAACCCCCCCTAGATACGCAGTATTTT	CASSEPPLDTQYF	TRBV9	TRBJ2-3
TGTGCCAGCAGAGTCACAGGGGGCACCGGGGAGCTGTTTTTT	CASRVTGGTGELFF	TRBV27	TRBJ2-2
TGTGCCTGGAGTGTAGGACTAGCGGGAGCGCAGAGAGACATTCAGTACTTC	CAWSVGLAGAQRDIQYF	TRBV30	TRBJ2-4
TGTGCCATCAGTGCCGGACAGGGGGGTGAAGCTTTCTTT	CAISAGQGGEAFF	TRBV10-3	TRBJ1-1
TGTGCCAGCAGCTTAACGTCCGGGCCAGATACGCAGTATTTT	CASSLTSGPDTQYF	TRBV7-3	TRBJ2-3
TGCAGTGCTAATGGGTCAGGGGAGCAGTTCTTC	CSANGSGEQFF	TRBV20-1	TRBJ2-1
TGTGCCAGCCAGGAGGGACTAAACTGGACTAGGGGCTACGAGCAGTACTTC	CASQEGLNWTRGYEQYF	TRBV25-1	TRBJ2-7
TGTGCCAGCCGATTGAGGGGGGGTATCGAGCAGTACTTC	CASRLRGGIEQYF	TRBV2	TRBJ2-7
TGTGCCAGCAGCTTAGCCCGCTCGTCCTACAATGAGCAGTTCTTC	CASSLARSSYNEQFF	TRBV13	TRBJ2-1
TGCGCCAGCAGCTTGCGCCAGCGTTATAGAGATTACAATGAGCAGTTCTTC	CASSLRQRYRDYNEQFF	TRBV5-1	TRBJ2-1
TGCGCCAGCAGCCAAGACAGGCCCGGGGATGAGCAGTTCTTC	CASSQDRPGDEQFF	TRBV4-3	TRBJ2-1
TGTGCCAGCAGGGGCGGGGGGCCAAACAATGAGCAGTTCTTC	CASRGGGPNNEQFF	TRBV13	TRBJ2-1
TGCGCCAGCAGCCAAGGGAGGGACAGGCCGGGTCTTGGCCGGGAGACCCAGTACTTC	CASSQGRDRPGLGRETQYF	TRBV4-1	TRBJ2-5
TGCGCCAGCAGAGGGGGGGGTGACTACTCTGGGGCCAACGTCCTGACTTTC	CASRGGGDYSGANVLTF	TRBV10-1	TRBJ2-6
TGTGCCACCAGTGATACAGGGGGGTTGTCCTACGAGCAGTACTTC	CATSDTGGLSYEQYF	TRBV24-1	TRBJ2-7
TGTGCCAGCAGCGTCAGAGGGCGGGAGGTCGAGAGCCTCTTC	CASSVRGREVESLF	TRBV6-8	TRBJ2-1
TGTGCCAGAATAAAGGGGGGGCCGTACTTC	CARIKGGPYF	TRBV11-2	TRBJ2-4
TGTCTCAACGACAGGGAGAAAGAGACCCAGTACTTC	CLNDREKETQYF	TRBV20-1	TRBJ2-5
TGTGCCAAAGGGACAGGGGGTCGCAATCAGCCCCAGCATTTT	CAKGTGGRNQPQHF	TRBV6-5	TRBJ1-5
TGTGCCAGCAGTTACTGGTGGGGTACGAACACTGAAGCTTTCTTT	CASSYWWGTNTEAFF	TRBV6-5	TRBJ1-1
TGTGCCAGCAGCCAGGAGTCCAAGACAAGACAGAGCAATCAGCCCCAGCATTTT	CASSQESKTRQSNQPQHF	TRBV13	TRBJ1-5
TGTGCCAGCAGTTACCCTTTCCCTGGCAACACCGGGGAGCTGTTTTTT	CASSYPFPGNTGELFF	TRBV6-5	TRBJ2-2
TGTGCCAGCAGCCAAGCACGAACCCTTAGGGGGACCGCCCAGAGCTCTGGGGCCAACGTCCTGACTTTC	CASSQARTLRGTAQSSGANVLTF	TRBV14	TRBJ2-6
TGTGCCAGCAGTTATAGCCCAGGGACAGTCACGGAAAAACTGTTTTTT	CASSYSPGTVTEKLFF	TRBV6-9	TRBJ1-4
TGCAGTGCTAGAGCCGGCCGAACTAACTATGGCTACACCTTC	CSARAGRTNYGYTF	TRBV20-1	TRBJ1-2
TGTGCCACCAGGTCAGGGTACCTCACCGGGGAGCTGTTTTTT	CATRSGYLTGELFF	TRBV24-1	TRBJ2-2
TGTGCCAGCAGCCCCAAGGGAGGAATGGACACTGAAGCTTTCTTT	CASSPKGGMDTEAFF	TRBV7-3	TRBJ1-1
TGTGCCAGCAGTGCCCATGGACTAGCGCCCGACTACAATGAGCAGTTCTTC	CASSAHGLAPDYNEQFF	TRBV6-1	TRBJ2-1
TGTGCCAGCAGCTTGGACCCCAGGGCTCCCCAAAGCTCTGGAAACACCATATATTTT	CASSLDPRAPQSSGNTIYF	TRBV5-8	TRBJ1-3
TGTGCCAGCAGCTTAGCGTCAGGATCAGGGGCAGAAGATACGCAGTATTTT	CASSLASGSGAEDTQYF	TRBV7-9	TRBJ2-3
TGTGCCAGCAGAACGGTCACAGGGGGGGTGAACACTGAAGCTTTCTTT	CASRTVTGGVNTEAFF	TRBV6-4	TRBJ1-1
TGCGCCAGCAGCCAAAGGCTGTTAGACACAGATACGCAGTATTTT	CASSQRLLDTDTQYF	TRBV4-1	TRBJ2-3
TGTGCCAGCAGCCACTACGATCGGGTAGGCACTAGCAATCAGCCCCAGCATTTT	CASSHYDRVGTSNQPQHF	TRBV7-6	TRBJ1-5
TGCAGTGCCATCGGGACAGCAGAGACCCAGTACTTC	CSAIGTAETQYF	TRBV20-1	TRBJ2-5
TGTGCCAGCAGCTGGTCAGGGGCAACCTCCTACGAGCAGTACTTC	CASSWSGATSYEQYF	TRBV13	TRBJ2-7
TGTGCCACCAGCAGTACAGGGGCCTATGGCTACACCTTC	CATSSTGAYGYTF	TRBV15	TRBJ1-2
TGTGCCATCACACAATACCTATTACTCCTAGCCAAAAACATTCAGTACTTC	CAITQYLLLLAKNIQYF	TRBV10-3	TRBJ2-4
TGTGCCCCCGAACCTACTCTAGATCAGCCCCAGCATTTT	CAPEPTLDQPQHF	TRBV12-3	TRBJ1-5
TGTGCCAGCAGTACCCAAACCGTCTACGAGCAGTACTTC	CASSTQTVYEQYF	TRBV6-1	TRBJ2-7
TGTGCCAGCAGTGAACGGGGACTAGCGGGCCGAGGCGAGCAGTTCTTC	CASSERGLAGRGEQFF	TRBV25-1	TRBJ2-1
TGCAGTGCTAGGTTGGGACAGGGTGCCTACGAGCAGTACTTC	CSARLGQGAYEQYF	TRBV20-1	TRBJ2-7
TGTGCCAGCAGAAGGGGCCGGGACAGGGTCACTGAAGCTTTCTTT	CASRRGRDRVTEAFF	TRBV27	TRBJ1-1
TGTGCCAGCAGTTTACCCTACCTTAAAGGGGGGGTTGAGCAGTTCTTC	CASSLPYLKGGVEQFF	TRBV27	TRBJ2-1
TGTGCTAGTGGCTACCAGCGGGATTCAAAGTACGAGCAGTACTTC	CASGYQRDSKYEQYF	TRBV12-5	TRBJ2-7
TGTGCCAGCAGCCACGAGGGACCCGGAGACGAGCAGTACTTC	CASSHEGPGDEQYF	TRBV3-1	TRBJ2-7
TGTGCCAGCAGCTTACGGGAGGCTTACGAGCAGTACTTC	CASSLREAYEQYF	TRBV11-3	TRBJ2-7
TGCGCCAGCAGCCAAGTTCAAGTTGGCTACACCTTC	CASSQVQVGYTF	TRBV4-1	TRBJ1-2
TGCAGTGCTGTAGGGGACAGGTCCCCTGACCAAGAGACCCAGTACTTC	CSAVGDRSPDQETQYF	TRBV20-1	TRBJ2-5
TGTGCCAGCAGCTTGGTTGGACAGGGCACTAATGAAAAACTGTTTTTT	CASSLVGQGTNEKLFF	TRBV5-5	TRBJ1-4
TGTGCCAGCCACGGACAGGGGTACACTGAAGCTTTCTTT	CASHGQGYTEAFF	TRBV6-1	TRBJ1-1
TGCGCCAGCAGCTTCATTACTCGGGGCTCACCCCTCCACTTT	CASSFITRGSPLHF	TRBV5-1	TRBJ1-6
TGTGCCAGCAGCGGACGACTAGAATTCCGTTCAGATACGCAGTATTTT	CASSGRLEFRSDTQYF	TRBV11-3	TRBJ2-3
TGTGCCAGCAGGGAATTAGCGAGGGCCTACAATGAGCAGTTCTTC	CASRELARAYNEQFF	TRBV28	TRBJ2-1
TGCAGTGCTAGAGGAGACAGGCTTGAGGGACCAAATTCACCCCTCCACTTT	CSARGDRLEGPNSPLHF	TRBV20-1	TRBJ1-6
TGTGCCAGCAGCGTAGCTGATTGGGGGCAATTCACAGATACGCAGTATTTT	CASSVADWGQFTDTQYF	TRBV9	TRBJ2-3
TGTGCCAGCAGTGTCGAAACCCAGAACACTGAAGCTTTCTTT	CASSVETQNTEAFF	TRBV2	TRBJ1-1
TGTGCCAGCAGCCAAGATCTCAGAGACAGGGGTGGGATCACTGAAGCTTTCTTT	CASSQDLRDRGGITEAFF	TRBV14	TRBJ1-1
TGTGCCAGTAGTATGCTCACTTTCCGTCGGGGAGTAGAGACCCAGTACTTC	CASSMLTFRRGVETQYF	TRBV19	TRBJ2-5
TGTGCCAGCAGCTTTTACGGAGATGAGACCCAGTACTTC	CASSFYGDETQYF	TRBV5-8	TRBJ2-5
TGTGCCAGCAGTTACCGACTAGGGAGAGAGACCCAGTACTTC	CASSYRLGRETQYF	TRBV6-8	TRBJ2-5
TGCAGTGCCTCAGGCGCCGGGACACCAGAGGGTAACTATGGCTACACCTTC	CSASGAGTPEGNYGYTF	TRBV20-1	TRBJ1-2
TGCAGCGCCCATCGGGTAACTCGAGCCTACGAGCAGTACTTC	CSAHRVTRAYEQYF	TRBV29-1	TRBJ2-7
TGTGCCAGCAGTTACAGCGCCACAGGGGATCATCAAGCTTTCTTT	CASSYSATGDHQAFF	TRBV6-5	TRBJ1-1
TGTGCCACCAGTGAAGGGGTGGATAATGAAAAACTGTTTTTT	CATSEGVDNEKLFF	TRBV24-1	TRBJ1-4
TGCGCCAGCAGCTTTAGTTATGTACCAGACTCTGGGGCCAACGTCCTGACTTTC	CASSFSYVPDSGANVLTF	TRBV5-1	TRBJ2-6
TGTGCCAAAAAGCGGGGACCGGGGACCCAGTACTTC	CAKKRGPGTQYF	TRBV5-6	TRBJ2-5
TGTGCCAGCAGCCGAGACGAGACATCAGATACGCAGTATTTT	CASSRDETSDTQYF	TRBV7-3	TRBJ2-3
TGTGCCAGCAGCACGGCAGGGGACAGCAATCAGCCCCAGCATTTT	CASSTAGDSNQPQHF	TRBV7-3	TRBJ1-5
TGTGCCAGCAGTCTCTTAGAGTTGGGCAACACCGGGGAGCTGTTTTTT	CASSLLELGNTGELFF	TRBV12-3	TRBJ2-2
TGTGCCAGCAGAAAGGTCTCTCAGCCCCAGCATTTT	CASRKVSQPQHF	TRBV12-4	TRBJ1-5
TGTGCCAGCAGAACGACAGGGGGGGCCCCTAGCACAGATACGCAGTATTTT	CASRTTGGAPSTDTQYF	TRBV12-4	TRBJ2-3
TGTGCCTGGAAAAGTAAGGGTCCCCCCCCCAGTTCCTTGGGTAGCGAGCAGTACTTC	CAWKSKGPPPSSLGSEQYF	TRBV30	TRBJ2-7
TGTGCCAGCAGGTCCGGATTGCAAGAGACCCAGTACTTC	CASRSGLQETQYF	TRBV3-1	TRBJ2-5
TGTGCCAGCAGCTTAGAACCAAAGCAGCGGACCCGGGATTCACCCCTCCACTTT	CASSLEPKQRTRDSPLHF	TRBV7-4	TRBJ1-6
TGTGCCAGCAGCCATTTTTCACAGGGGGCCCTAGCCTATAATTCACCCCTCCACTTT	CASSHFSQGALAYNSPLHF	TRBV13	TRBJ1-6
TGTGCCACCAGGGCGGGGGGGCCGTCTGAGACCCAGTACTTC	CATRAGGPSETQYF	TRBV24-1	TRBJ2-5
TGCAGCGTTGAATCACCCCGGGGACAGGGGCGAACCGGGGAGCTGTTTTTT	CSVESPRGQGRTGELFF	TRBV29-1	TRBJ2-2
TGTGCCAGCCAACAGGGGCTCCCCACCGGGGAGCTGTTTTTT	CASQQGLPTGELFF	TRBV5-6	TRBJ2-2
TGTGCCAGCAGCCAAGAGGCCCCGGATTTCCGCCAAGGACTAGAGTACGAGCAGTACTTC	CASSQEAPDFRQGLEYEQYF	TRBV3-1	TRBJ2-7
TGTGCCAGCAGTTTTGACCCGTCCCCTACCCAGGGAGAACAGAACTATGGCTACACCTTC	CASSFDPSPTQGEQNYGYTF	TRBV28	TRBJ1-2
TGTGCCAGTAGTAACAGGCAGCCCCAGCATTTT	CASSNRQPQHF	TRBV19	TRBJ1-5
TGTGCCAGCAGTAAACGGGACAGGGCAATGAACACTGAAGCTTTCTTT	CASSKRDRAMNTEAFF	TRBV6-5	TRBJ1-1
TGTGCCAGTACTTACCCGGGACAGGGGGGCTACACCTTC	CASTYPGQGGYTF	TRBV19	TRBJ1-2
TGTGCCACCAGTGGGCGGCGAGGCGTGAACACTGAAGCTTTCTTT	CATSGRRGVNTEAFF	TRBV24-1	TRBJ1-1
TGTGCCACGAGGGGTCCCTCCTACGAGCAGTACTTC	CATRGPSYEQYF	TRBV13	TRBJ2-7
TGCAGTGGGCCGATGAGGGGCGGGATCCCCATGAACACTGAAGCTTTCTTT	CSGPMRGGIPMNTEAFF	TRBV20-1	TRBJ1-1
TGTGCCAGTAGTCCTCGGGGACTAGCTTATAGCTCCTACGAGCAGTACTTC	CASSPRGLAYSSYEQYF	TRBV19	TRBJ2-7
TGTGCCAGCAGCCAAGATTCCTCCCGGGACTTGGACGCCTACGAGCAGTACTTC	CASSQDSSRDLDAYEQYF	TRBV14	TRBJ2-7
TGCGCCAGCACGCACCGGGACATGGCCTACGAGCAGTACTTC	CASTHRDMAYEQYF	TRBV10-1	TRBJ2-7
TGTGCCTGGAGTCCCTGGAGGAGCTCCTACAATGAGCAGTTCTTC	CAWSPWRSSYNEQFF	TRBV30	TRBJ2-1
TGTGCCAGCAGCTTAACCCCGGATTTTGGCTACACCTTC	CASSLTPDFGYTF	TRBV7-9	TRBJ1-2
TGTGCCAGCAGCCAAGATTGGGGGGTTCGACGGGGTAACTATGGCTACACCTTC	CASSQDWGVRRGNYGYTF	TRBV3-1	TRBJ1-2
TGTGCCAGCAGCTTCTCGGGGAACATTTACAATGAGCAGTTCTTC	CASSFSGNIYNEQFF	TRBV5-6	TRBJ2-1
TGCAGAACGAGGGGGGGCACTGAAGCTTTCTTT	CRTRGGTEAFF	TRBV20-1	TRBJ1-1
TGTGCCAGTAGTATGAATGAGACCAAGGGCCGCTACGAGCAGTACTTC	CASSMNETKGRYEQYF	TRBV19	TRBJ2-7
TGCGCCAGCAGCCAAGTAAGGGACAGGGGAAATAGCAATCAGCCCCAGCATTTT	CASSQVRDRGNSNQPQHF	TRBV4-1	TRBJ1-5
TGTGCCAGCAGCCCGACAGGGTGGAACGTCTATGGCTACACCTTC	CASSPTGWNVYGYTF	TRBV13	TRBJ1-2
TGCAGTGCTAGAGTGCACGAAGGGGACAGGGGGCGCCACCTTAATGAAAAACTGTTTTTT	CSARVHEGDRGRHLNEKLFF	TRBV20-1	TRBJ1-4
TGTGCCAGCAGCCAAGAGAAGACTAGCGGGACTAGCGGTGCCAACTACGAGCAGTACTTC	CASSQEKTSGTSGANYEQYF	TRBV3-1	TRBJ2-7
TGTGCCACCAGCAGAGATCGACCCCCAAACGTTTGCTTACCTGCCTACGAGCAGTACTTC	CATSRDRPPNVCLPAYEQYF	TRBV15	TRBJ2-7
TGTGCCAGCAGAAGGGACCCTTTTAACGAGCAGTACTTC	CASRRDPFNEQYF	TRBV6-5	TRBJ2-7
TGCGCCAGCAGTCCAGAATCGGGAGAAAAACTGTTTTTT	CASSPESGEKLFF	TRBV10-1	TRBJ1-4
TGTGCCAGCAGCAACGCTCCGGTCGAGCAGTACTTC	CASSNAPVEQYF	TRBV9	TRBJ2-7
TGTGCCAGCAGCAAAGTAGCGGGAGACACAGATACGCAGTATTTT	CASSKVAGDTDTQYF	TRBV13	TRBJ2-3
TGTGCCAGCAGCCAAGACCCCTCAGGGGGCGGACACTCGGAGACCCAGTACTTC	CASSQDPSGGGHSETQYF	TRBV3-1	TRBJ2-5
TGTGCCAGCAGCCCGGCCGGGACTAGGCGGGACACCGGGGAGCTGTTTTTT	CASSPAGTRRDTGELFF	TRBV5-6	TRBJ2-2
TGCAGCAGGGGACAAGATACGCAGTATTTT	CSRGQDTQYF	TRBV29-1	TRBJ2-3
TGTGCCAGCTCACACCGAGGACAGGGTGTATCCGGCTTTTCCTACGAGCAGTACTTC	CASSHRGQGVSGFSYEQYF	TRBV18	TRBJ2-7
TGTGCCAGCAGTCAAGTCGCGGGGTTTAGTTATAGCAATCAGCCCCAGCATTTT	CASSQVAGFSYSNQPQHF	TRBV6-6	TRBJ1-5
TGTGCCAGCAGCTTACAGGATATGAACACTGAAGCTTTCTTT	CASSLQDMNTEAFF	TRBV7-9	TRBJ1-1
TGCAGTACCTTACGGGCATCTCACTCCTACGAGCAGTACTTC	CSTLRASHSYEQYF	TRBV20-1	TRBJ2-7
TGTGCCAGCAGTACGAGGATAGCCTACGAGCAGTACTTC	CASSTRIAYEQYF	TRBV12-4	TRBJ2-7
TGCATCCGTGGGCGGGGACTTACGGGCTACACCTTC	CIRGRGLTGYTF	TRBV20-1	TRBJ1-2
TGCAGTGGGGATGGGGCTAGGGCCCGATATGGCTACACCTTC	CSGDGARARYGYTF	TRBV20-1	TRBJ1-2
TGTGCCACCCTAGGACTCGGGTCAGAGACCCAGTACTTC	CATLGLGSETQYF	TRBV24-1	TRBJ2-5
TGTGCCTGGACAGGGGGAAGGGTAACTAACTATGGCTACACCTTC	CAWTGGRVTNYGYTF	TRBV30	TRBJ1-2
TGTGCCAGCACCGGCGGGGGGACCGGCACAGATACGCAGTATTTT	CASTGGGTGTDTQYF	TRBV6-3	TRBJ2-3
TGTGCCAGCCTTAGAATCTCTGGAAACACCATATATTTT	CASLRISGNTIYF	TRBV28	TRBJ1-3
TGTGCCAGCTCACCACCGGGGCGTCGTGAAGCTTTCTTT	CASSPPGRREAFF	TRBV18	TRBJ1-1
TGTGCCAGCGGGAAACTTCGCGGGAGCTTACAGTACTTC	CASGKLRGSLQYF	TRBV6-1	TRBJ2-5
TGCAGTGCTAGCATCTCCCGGGGCCAAACCGGGGAGCTGTTTTTT	CSASISRGQTGELFF	TRBV20-1	TRBJ2-2
TGTGCCAGCTCACCAACCAACGGGGGGCCGAGGAACTTC	CASSPTNGGPRNF	TRBV18	TRBJ2-7
TGTGCCAGCAGTTTCCCCCTTAAACGACTGAACACTGAAGCTTTCTTT	CASSFPLKRLNTEAFF	TRBV27	TRBJ1-1
TGTGCCAGCAGCCCTGGAAACAGGGCGGACGAGCAGTACTTC	CASSPGNRADEQYF	TRBV7-3	TRBJ2-7
TGCAGTGCAACTTTGGGGGGCACAGCTTACAATGAGCAGTTCTTC	CSATLGGTAYNEQFF	TRBV20-1	TRBJ2-1
TGCGCCAGCAGCTTGAGGTGGACAGGGTTTCCCAATGGCTACACCTTC	CASSLRWTGFPNGYTF	TRBV5-1	TRBJ1-2
TGTGCCAGCAGAATCCTAGCGGGCCGCACAGATACGCAGTATTTT	CASRILAGRTDTQYF	TRBV7-3	TRBJ2-3
TGTGCCAGCAGCTTAAGGGTGACAGGGCGACAGCCCCAGCATTTT	CASSLRVTGRQPQHF	TRBV7-3	TRBJ1-5
TGTGCCAGTGCCACAGATTCGGCATCCAACTATGGCTACACCTTC	CASATDSASNYGYTF	TRBV19	TRBJ1-2
TGTGCTAGCAGCTGGGGCAATGAGCAGTTCTTC	CASSWGNEQFF	TRBV7-7	TRBJ2-1
TGCGCCAGCAGCCAAGCCGCCAACTCTGGGGCCAACGTCCTGACTTTC	CASSQAANSGANVLTF	TRBV4-1	TRBJ2-6
TGTGCCAGTATTGATCGGCTTGAGGATGAGCAGTTCTTC	CASIDRLEDEQFF	TRBV19	TRBJ2-1
TGTGCCAGTAGTATCGCTCAAGAGACCCAGTACTTC	CASSIAQETQYF	TRBV19	TRBJ2-5
TGTGCCATCTGCCGTAACTATATGGCCCCAGATACGCAGTATTTT	CAICRNYMAPDTQYF	TRBV10-3	TRBJ2-3
TGTGCCAGCAGCCGTTACCTGGGACAGGGGGCCTACGAGCAGTACTTC	CASSRYLGQGAYEQYF	TRBV11-3	TRBJ2-7
TGTGCCAGCATAATGATCCCGGGACAGGTAAAGGTCTACGAGCAGTACTTC	CASIMIPGQVKVYEQYF	TRBV7-2	TRBJ2-7
TGTGCCAGCAGCGCGTCACTTTGCTCTGGAAACACCATATATTTT	CASSASLCSGNTIYF	TRBV12-3	TRBJ1-3
TGTGCCAGCAGATCGGTTCACTTGAACGAGCAGTACTTC	CASRSVHLNEQYF	TRBV6-4	TRBJ2-7
TGTGCCACCAGCAGCGCAGTTAGTATTCTGTTTTTT	CATSSAVSILFF	TRBV15	TRBJ1-4
TGTGCCAGCAGTGAAAAGAGCAGGGGGAGTGGCTACACCTTC	CASSEKSRGSGYTF	TRBV6-1	TRBJ1-2
TGTGCCAGCAGTTACGGTGGTCTAGCGGGGGACTACGAGCAGTACTTC	CASSYGGLAGDYEQYF	TRBV6-5	TRBJ2-7
TGTGCCAGCTGTGGAAAGCGGGACCGGAATGAAAAACTGTTTTTT	CASCGKRDRNEKLFF	TRBV27	TRBJ1-4
TGTGCCACACATGGGCGGGGGGATAGCAATCAGCCCCAGCATTTT	CATHGRGDSNQPQHF	TRBV19	TRBJ1-5
TGTGCCAGCAGCCAAGATCGGACTAGCGGGGGACAACCCTACAATGAGCAGTTCTTC	CASSQDRTSGGQPYNEQFF	TRBV3-1	TRBJ2-1
TGTGCCACCTACCCAACATGTTATCCAGGGCACTCCTACAATGAGCAGTTCTTC	CATYPTCYPGHSYNEQFF	TRBV15	TRBJ2-1
TGTGCCATCAGTGGAGGACGAATACGCTGCGAATGGGGGGTCGTCAGTAGCTCCTACAATGAGCAGTTCTTC	CAISGGRIRCEWGVVSSSYNEQFF	TRBV10-3	TRBJ2-1
TGTGCCACCAGTGTCCCGGCGGGGGATAACACTGAAGCTTTCTTT	CATSVPAGDNTEAFF	TRBV24-1	TRBJ1-1
TGTGCCAGCAGCGGGGGAGGGACATGGAATTCACCCCTCCACTTT	CASSGGGTWNSPLHF	TRBV7-4	TRBJ1-6
TGTGCCAGCAGTGACCCGAAACTGCCTACCTACGAGCAGTACTTC	CASSDPKLPTYEQYF	TRBV6-4	TRBJ2-7
TGTGCCAGCAGGGGACAGGTAGGAGAGCAGTACTTC	CASRGQVGEQYF	TRBV6-4	TRBJ2-7
TGTGCCAGCAAAACGGGACCCAAAAACATTCAGTACTTC	CASKTGPKNIQYF	TRBV12-3	TRBJ2-4
TGTGCCAGCAGTCGGATTTGCTTGACTGAAGCTTTCTTT	CASSRICLTEAFF	TRBV28	TRBJ1-1
TGTGCTAGTGGTATGCGGGAGATGGATTTATACACTGAAGCTTTCTTT	CASGMREMDLYTEAFF	TRBV12-5	TRBJ1-1
TGTGCCAGCAGTTTAGCCGGGACCCGGAATTCACCCCTCCACTTT	CASSLAGTRNSPLHF	TRBV27	TRBJ1-6
TGCGCCAGCAGCCAAGATGTTAAACCCGGTAGGAACTACAATGAGCAGTTCTTC	CASSQDVKPGRNYNEQFF	TRBV4-1	TRBJ2-1
TGCAGCGGGGACGGAGAGGGCGAGCAGTACTTC	CSGDGEGEQYF	TRBV29-1	TRBJ2-7
TGTGCCACCAGTGATTTGCGCGGGACAGGGGCTTACTACACCTTC	CATSDLRGTGAYYTF	TRBV24-1	TRBJ1-2
TGTGCCACAAACCAGCGGGAATCCGAGCAGTACTTC	CATNQRESEQYF	TRBV11-3	TRBJ2-7
TGTGCCAGCAGTTTACCAGGACAGGAGGCTGATAACTATGGCTACACCTTC	CASSLPGQEADNYGYTF	TRBV28	TRBJ1-2
TGTGCCAGCCCACGAGGGGAAAACCGATACAATGAGCAGTTCTTC	CASPRGENRYNEQFF	TRBV27	TRBJ2-1
TGCGCCAGCAGCTTGTATTCGAAAGTGACAGGGTTAGAAAAACTGTTTTTT	CASSLYSKVTGLEKLFF	TRBV5-1	TRBJ1-4
TGCGCCAGCAGCCCCCTGTATTCGTTATGGACCCGGAAAAGAGATACGCAGTATTTT	CASSPLYSLWTRKRDTQYF	TRBV4-1	TRBJ2-3
TGTGCCAGCAGTGCCCGGGGGGCCTACGAGAATGAGCAGTTCTTC	CASSARGAYENEQFF	TRBV6-5	TRBJ2-1
TGTGCCAGCAAGGATTGTTCGGGGGAAGAGACCCAGTACTTC	CASKDCSGEETQYF	TRBV3-1	TRBJ2-5
TGTGCCAGCAGCGGGACGGGTGAAAAACTGTTTTTT	CASSGTGEKLFF	TRBV13	TRBJ1-4
TGTGCCAGCAGCTTGGTCCCAGGGGGCCCCGATAACACTGAAGCTTTCTTT	CASSLVPGGPDNTEAFF	TRBV5-6	TRBJ1-1
TGCGCCAGCAGCGGAGGGGGTAACGAGCAGTACTTC	CASSGGGNEQYF	TRBV4-1	TRBJ2-7
TGTGCCAGCAGCTTGAGGGCATTCACTGAGCAGGGAGCGGGCGCAACTAATGAAAAACTGTTTTTT	CASSLRAFTEQGAGATNEKLFF	TRBV5-5	TRBJ1-4
TGTGCCAGCACCGTCCTGAGCCACACTGAAGCTTTCTTT	CASTVLSHTEAFF	TRBV7-8	TRBJ1-1
TGTGCCAGCAGCAGGGTGATCGAGACCCAGTACTTC	CASSRVIETQYF	TRBV12-3	TRBJ2-5
TGTGCCAGCAGATTCTCGTTGGACAGGGCGGGACCGGAAAAACTGTTTTTT	CASRFSLDRAGPEKLFF	TRBV5-8	TRBJ1-4
TGTGCCAGCAGCTTCGGATACTGGGACGAGCAGTACTTC	CASSFGYWDEQYF	TRBV13	TRBJ2-7
TGTGCCACCAGCAGAGCGGTACCCTTCCCCGGGACTAGGGGAAGGTTGGACACCGGGGAGCTGTTTTTT	CATSRAVPFPGTRGRLDTGELFF	TRBV15	TRBJ2-2
TGTGCCAAAGTGGGGGGGGCCGGCCCGAGCAACACCGGGGAGCTGTTTTTT	CAKVGGAGPSNTGELFF	TRBV6-5	TRBJ2-2
TGTGCCAGTAGACCGCATAGGGGGTGGGACACTGAAGCTTTCTTT	CASRPHRGWDTEAFF	TRBV19	TRBJ1-1
TGTGCCAGCAGTTTACCTTGCCCGGGACAGGGGGAAAACTATGGCTACACCTTC	CASSLPCPGQGENYGYTF	TRBV27	TRBJ1-2
TGTGCCAGCGCGGCCGGAGGGGGAGGCTACACCTTC	CASAAGGGGYTF	TRBV7-2	TRBJ1-2
TGCGCCAGCAGCTTGGGTCCGGACAGGCTGGGGGGTGGCTACACCTTC	CASSLGPDRLGGGYTF	TRBV5-1	TRBJ1-2
TGTGCCAGCAGCCTCACCCCGGGAAGGCCCTACACTGAAGCTTTCTTT	CASSLTPGRPYTEAFF	TRBV7-3	TRBJ1-1
TGTGCCAGCAGCGTAGCCGCATGGGGGGGGGGCTACGAGCAGTACTTC	CASSVAAWGGGYEQYF	TRBV13	TRBJ2-7
TGCAGTGCGTCTAGAGTAGAGCTGTTTTTT	CSASRVELFF	TRBV20-1	TRBJ2-2
TGCAGTGCTATCCCTAAGAGCGGCTACGAGCAGTACTTC	CSAIPKSGYEQYF	TRBV20-1	TRBJ2-7
TGTGCCAGCGGCCAACAAAGCGTTCGGGACAGGGACTATGGCTACACCTTC	CASGQQSVRDRDYGYTF	TRBV2	TRBJ1-2
TGTGCCAGCAGTTTGTTGGGGAAAGGCGACACTGAAGCTTTCTTT	CASSLLGKGDTEAFF	TRBV12-3	TRBJ1-1
TGTGCCAGCAGTGAAGCGGACAGCTTCATTTACAATGAGCAGTTCTTC	CASSEADSFIYNEQFF	TRBV6-1	TRBJ2-1
TGTGCCAGCGGCGGGGGCGCATGGAACACTGAAGCTTTCTTT	CASGGGAWNTEAFF	TRBV9	TRBJ1-1
TGCAGTGCTAGCCGCTTGAGGGGGTCTTCCGGGGAGCTGTTTTTT	CSASRLRGSSGELFF	TRBV20-1	TRBJ2-2
TGTGCCAGCAGCCAAGGGAACCGGGACGGGCACACTGAAGCTTTCTTT	CASSQGNRDGHTEAFF	TRBV3-1	TRBJ1-1
TGTGCCAGCAGCGTAGAAGCACGGAGCAGGCAGTATTTT	CASSVEARSRQYF	TRBV9	TRBJ2-3
TGTGCCAGCAGCTTAGGTCAGACACTAGCGGGAGTAGAATCGCAGTTCTTC	CASSLGQTLAGVESQFF	TRBV7-2	TRBJ2-1
TGTGCCAGCAGCCAAGATCCCAAAACGGGGACTCTACAGCCCCAGCATTTT	CASSQDPKTGTLQPQHF	TRBV4-2	TRBJ1-5
TGCAGTGTTTGGGGGGCCTTTCAGCCCCAGCATTTT	CSVWGAFQPQHF	TRBV20-1	TRBJ1-5
TGTGCCAGCAGACCGACAGCCCAGTACTTC	CASRPTAQYF	TRBV2	TRBJ2-5
TGTGCCAGCAGCGGAGCCGTAGCGGGATCAGAGACCCAGTACTTC	CASSGAVAGSETQYF	TRBV7-3	TRBJ2-5
TGTGCCAGCAGCCAAGTAGCAGCGGAAGCTAGCACAGATACGCAGTATTTT	CASSQVAAEASTDTQYF	TRBV4-2	TRBJ2-3
TGTGCCAGCAGCCCGGGTCCGGGACAGGCGGGGAACACCGGGGAGCTGTTTTTT	CASSPGPGQAGNTGELFF	TRBV5-4	TRBJ2-2
TGCAGTCTGTCTGCGGGCTGCAATCAGCCCCAGCATTTT	CSLSAGCNQPQHF	TRBV20-1	TRBJ1-5
TGTGCCAGTAGTCCTATCAGGTCCTCTGGAAACACCATATATTTT	CASSPIRSSGNTIYF	TRBV19	TRBJ1-3
TGTGCCAGCAGTTACCCCGGAGTGTACAGGGTCAGGAACACTGAAGCTTTCTTT	CASSYPGVYRVRNTEAFF	TRBV6-5	TRBJ1-1
TGTGCCAGCAGCGCGGGTGGACAGGGGGTCACTGAAGCTTTCTTT	CASSAGGQGVTEAFF	TRBV7-3	TRBJ1-1
TGTGCCAGCAGCCTACTGACTGAGCAGTTCTTC	CASSLLTEQFF	TRBV9	TRBJ2-1
TGCGCCAATCCGGGACAGGGCTACGAGCAGTACTTC	CANPGQGYEQYF	TRBV10-1	TRBJ2-7
TGCGCCAGCAGCTTGGAGGAGGGGACTGGCAATCAGCCCCAGCATTTT	CASSLEEGTGNQPQHF	TRBV5-1	TRBJ1-5
TGTGCCAGCAGCTTAAAGCGAAGCTCCTACGAGCAGTACTTC	CASSLKRSSYEQYF	TRBV7-2	TRBJ2-7
TGCAGTGCTATTCCAGGGCCTTTTGAGCAGTACTTC	CSAIPGPFEQYF	TRBV20-1	TRBJ2-7
TGCCGAAGCGGGACTGAAGCTTTCTTT	CRSGTEAFF	TRBV10-1	TRBJ1-1
TGCAGTGCTAGAGATAACCTCTCGACAGGGCCCAACACTGAAGCTTTCTTT	CSARDNLSTGPNTEAFF	TRBV20-1	TRBJ1-1
TGTGCCAGCAGCGCCCAAAACTACGGGGGGCAGATAGATACGCAGTATTTT	CASSAQNYGGQIDTQYF	TRBV9	TRBJ2-3
TGTGCCAGAGGGACGCGGACGTACTCCTACGAGCAGTACTTC	CARGTRTYSYEQYF	TRBV28	TRBJ2-7
TGTGCCAGCAGTGTTATTTCTGGACGATACCAAGAGACCCAGTACTTC	CASSVISGRYQETQYF	TRBV25-1	TRBJ2-5
TGTGCCATGGGGGATGGCTACACCTTC	CAMGDGYTF	TRBV28	TRBJ1-2
TGTGCCAGCAGCGTTACGAGGCTGGGAACATGGGGGGAGCTGTTTTTT	CASSVTRLGTWGELFF	TRBV7-3	TRBJ2-2
TGCGCCAGCAGCCCTCTAAAGTCTGGGGGGGCAAGGGGCTACACCTTC	CASSPLKSGGARGYTF	TRBV5-1	TRBJ1-2
TGTGCTAGTGGTTGGGAACGGCAAAGGAAGGGTTCACCCCTCCACTTT	CASGWERQRKGSPLHF	TRBV12-5	TRBJ1-6
TGTGCCAGCAGTGGGCTAGCGGAGAATGAGCAGTTCTTC	CASSGLAENEQFF	TRBV6-4	TRBJ2-1
TGTGCCAGCAGTTACTCGAATCCAGGGTGTTTGCCCCAGCATTTT	CASSYSNPGCLPQHF	TRBV6-6	TRBJ1-5
TGCAGTGCCTACCCGGGACTAGCGGGAGCCGCCTACGAGCAGTACTTC	CSAYPGLAGAAYEQYF	TRBV20-1	TRBJ2-7
TGTGCCAGCAGCTTAGAGCAGGGTCTAGTTGCCCGGGTCGGCCCCCTGAACTATGGCTACACCTTC	CASSLEQGLVARVGPLNYGYTF	TRBV7-3	TRBJ1-2
TGCGCCAACGGGGGCGGGTCCGGCTCACCCCTCCACTTT	CANGGGSGSPLHF	TRBV10-1	TRBJ1-6
TGTGCCGTCGTCAGAGTGGATTCGGGCACTGAAGCTTTCTTT	CAVVRVDSGTEAFF	TRBV10-3	TRBJ1-1
TGTGCCAGCAGCTTAGGGGACGAAAACATTCAGTACTTC	CASSLGDENIQYF	TRBV7-8	TRBJ2-4
TGCGCCAGCAGCCAATCGGAGACAGGGGGCTACACCTTC	CASSQSETGGYTF	TRBV4-1	TRBJ1-2
TGCAGTGCTAGCAGGCATTGGACCATCAATGAGCAGTTCTTC	CSASRHWTINEQFF	TRBV20-1	TRBJ2-1
TGTGCCAGCAGCGTAAGTTGTGGGACTAGCGGGAGACGGGAGCAGTTCTTC	CASSVSCGTSGRREQFF	TRBV9	TRBJ2-1
TGCAGTGCTAGTCCTATTTCCGACAGGGCCTTC	CSASPISDRAF	TRBV20-1	TRBJ2-7
TGTGCCAGCTTGGACGTCACTGAAGCTTTCTTT	CASLDVTEAFF	TRBV7-3	TRBJ1-1
TGTGCCAGCAGCCCCTGGAGTAGGGGAAGCAATCAGCCCCAGCATTTT	CASSPWSRGSNQPQHF	TRBV7-4	TRBJ1-5
TGCGCCAGCAGCTCATCGGCGTCCCTCAATCAGCCCCAGCATTTT	CASSSSASLNQPQHF	TRBV5-1	TRBJ1-5
TGCGCCAGCAGCTCCGTCGAGGGACGAGCTTTCGGGGGACAGGGAATAAGCTATGGCTACACCTTC	CASSSVEGRAFGGQGISYGYTF	TRBV5-1	TRBJ1-2
TGTGCCAGCCCCCTAGTGAAAAACATTCAGTACTTC	CASPLVKNIQYF	TRBV27	TRBJ2-4
TGTGCCAGCAGCTTACTAGCAGGGTGTAATGAAAAACTGTTTTTT	CASSLLAGCNEKLFF	TRBV7-9	TRBJ1-4
TGTGCCAGCAGCTTAGGCTCTGGAAACACCATATATTTT	CASSLGSGNTIYF	TRBV11-3	TRBJ1-3
TGTGCCAGCAGGCCTAACCCCAATGAAAAACTGTTTTTT	CASRPNPNEKLFF	TRBV27	TRBJ1-4
TGTGCCAGCAGCCAAGAGGACAGAGGAGGATTCGAGCAGTACTTC	CASSQEDRGGFEQYF	TRBV3-1	TRBJ2-7
TGTGCTAGTGGACGGACAGGGGAACGCAAACCCGAGCAGTACTTC	CASGRTGERKPEQYF	TRBV12-5	TRBJ2-7
TGCAGCGTTCCGGGACAGGGGACCAATCAGCCCCAGCATTTT	CSVPGQGTNQPQHF	TRBV29-1	TRBJ1-5
TGTGCCAGCAGTGCCCTCCGGACAGGGACCTCATCTTATGGCTACACCTTC	CASSALRTGTSSYGYTF	TRBV6-1	TRBJ1-2
TGTGCCAGCAGTGGGCTGGGACTAGCGGGAGGTCGGTCCTACGAGCAGTACTTC	CASSGLGLAGGRSYEQYF	TRBV28	TRBJ2-7
TGTGCCACCAGTGATTACGGGGCCTCAAGAAATAATGAAAAACTGTTTTTT	CATSDYGASRNNEKLFF	TRBV24-1	TRBJ1-4
TGTGCCAGCAGTGCGTGGGACTACGAGCAGTACTTC	CASSAWDYEQYF	TRBV6-4	TRBJ2-7
TGTGCCACGAACAGGGCAAGAGGGGGTTCCTACGAGCAGTACTTC	CATNRARGGSYEQYF	TRBV12-3	TRBJ2-7
TGTGCTAGTAGCTTATCCACCGGGGAGCTGTTTTTT	CASSLSTGELFF	TRBV12-5	TRBJ2-2
TGTGCCAGCAGCCGTGCCGGGGGCTTGGAAGGCACAGATACGCAGTATTTT	CASSRAGGLEGTDTQYF	TRBV9	TRBJ2-3
TGTGCCCAGGACGGACAGGAGGCAGTGGCTACCGGGGAGCTGTTTTTT	CAQDGQEAVATGELFF	TRBV5-6	TRBJ2-2
TGTGCCAGCAGCGTAGTCGGTGCGGGGGGCACAGATACGCAGTATTTT	CASSVVGAGGTDTQYF	TRBV9	TRBJ2-3
TGTGCCTGGAGTAAGACAGAGGGGGGGGCCCCCACTGAAGCTTTCTTT	CAWSKTEGGAPTEAFF	TRBV30	TRBJ1-1
TGTGCCACCAGTGGGGGGGGACAGGGCTACGAGCAGTACTTC	CATSGGGQGYEQYF	TRBV24-1	TRBJ2-7
TGTGCCAGCAGCTCTTCGGGACGACAAACTGAAGCTTTCTTT	CASSSSGRQTEAFF	TRBV7-4	TRBJ1-1
TGTGCCAGCAGTTTAGACCGGGAGGGCCATATGAAGCAGCCGAATCAGCCCCAGCATTTT	CASSLDREGHMKQPNQPQHF	TRBV12-3	TRBJ1-5
TGTGCCAGCAGTGCCCTCCGGGCTCAAAACAATGAGCAGTTCTTC	CASSALRAQNNEQFF	TRBV6-3	TRBJ2-1
TGTGACCAAGTAAAACAGGACACAGATACGCAGTATTTT	CDQVKQDTDTQYF	TRBV6-4	TRBJ2-3
TGTGATGGGGTGTATGGCTACACCTTC	CDGVYGYTF	TRBV6-2	TRBJ1-2
TGCGCCAGCAGCCCGATAGTCACAGGGAGCTTGGGGCAGCCCCAGCATTTT	CASSPIVTGSLGQPQHF	TRBV5-1	TRBJ1-5
TGTGCCAGCAGCCAAGTCAGGGGAGACTTCGAGCAGTACTTC	CASSQVRGDFEQYF	TRBV14	TRBJ2-7
TGTGCCAGCAGGATGGACTACGAGCAGTACTTC	CASRMDYEQYF	TRBV9	TRBJ2-7
TGCGCCAGCAGCCAAGTTGGACTAGGGGCTAACGAGCAGTACTTC	CASSQVGLGANEQYF	TRBV5-1	TRBJ2-7
TGCAGTGCTAGCAACAGGACAGGGATTGGCTACGAGCAGTACTTC	CSASNRTGIGYEQYF	TRBV20-1	TRBJ2-7
TGTGCCAGTACGTCGGAGCCCTTCCCTAGATCGGCGAACACCGGGGAGCTGTTTTTT	CASTSEPFPRSANTGELFF	TRBV19	TRBJ2-2
TGTGCCAGCAGCTTAGAACCGCCCCGGGGGGGGGATCATACCGCCGGGGAGCTGTTTTTT	CASSLEPPRGGDHTAGELFF	TRBV7-2	TRBJ2-2
TGTGCCAGCCCTTCAAATGGACCTAGGCCTAGCTCCTACGAGCAGTACTTC	CASPSNGPRPSSYEQYF	TRBV7-9	TRBJ2-7
TGCGCCAGCAGTTCCCCGGGACGTAGCAATCAGCCCCAGCATTTT	CASSSPGRSNQPQHF	TRBV5-1	TRBJ1-5
TGTGCCAGCGTTACGAACCGCCTCTACGAGCAGTACTTC	CASVTNRLYEQYF	TRBV7-9	TRBJ2-7
TGTGCCAGCAGCGTAGGTAAGGGGATCCTGCAGTACTTC	CASSVGKGILQYF	TRBV9	TRBJ2-7
TGCGCCCGGGGAAGGCAAGGGGGCGGAGAAAAACTGTTTTTT	CARGRQGGGEKLFF	TRBV5-1	TRBJ1-4
TGTGCCAGCAGCTCCGGACAGTACAATGAGCAGTTCTTC	CASSSGQYNEQFF	TRBV13	TRBJ2-1
TGTGCCAGCAGGCCGACGACAGAGTCAAGCTACGAGCAGTACTTC	CASRPTTESSYEQYF	TRBV12-4	TRBJ2-7
TGTGCCAGCAGGCCTAATCCCCCAGAGGGGAGAACTGAAGCTTTCTTT	CASRPNPPEGRTEAFF	TRBV28	TRBJ1-1
TGCAGTGCTAGAGAGGTCGGACAGCCTGAAGAGACCCAGTACTTC	CSAREVGQPEETQYF	TRBV20-1	TRBJ2-5
TGCAGTGCATGGAGCCCGGGACAGCCTCTGGGGACACTTAGGGTGAATGAAAAACTGTTTTTT	CSAWSPGQPLGTLRVNEKLFF	TRBV20-1	TRBJ1-4
TGTGCCAGCAGCTCGAACATGAACACTGAAGCTTTCTTT	CASSSNMNTEAFF	TRBV7-3	TRBJ1-1
TGTGCCAGCTCGACAGGGTGGGCTGGAAACACCATATATTTT	CASSTGWAGNTIYF	TRBV10-3	TRBJ1-3
TGCGCCAGCAGTGATGGGGGCTTGACCTACAATGAGCAGTTCTTC	CASSDGGLTYNEQFF	TRBV10-1	TRBJ2-1
TGCGCCAGCAGGCGTTCAAGGGACAGGGGCTACACCTTC	CASRRSRDRGYTF	TRBV10-1	TRBJ1-2
TGTGCCAGCAGCTTCGCTAGCCAAGAGACCCAGTACTTC	CASSFASQETQYF	TRBV7-3	TRBJ2-5
TGTGCCAGCAGCGGACCCCGGGGGGGGGGGACCGGGGAGCTGTTTTTT	CASSGPRGGGTGELFF	TRBV13	TRBJ2-2
TGTGCCACTGACTCCACAGATACGCAGTATTTT	CATDSTDTQYF	TRBV6-3	TRBJ2-3
TGTGCCAGCAGTTGTGACGACAATCAGCCCCAGCATTTT	CASSCDDNQPQHF	TRBV27	TRBJ1-5
TGCGCCGGCCGAAGGATTGAGGGGGGGGTATATCAGCCCCAGCATTTT	CAGRRIEGGVYQPQHF	TRBV4-3	TRBJ1-5
TGCGCCAGCAGCCCCACCCGACAGGGTAGGCTCTACGAGCAGTACTTC	CASSPTRQGRLYEQYF	TRBV5-1	TRBJ2-7
TGTCACCCGCCCTCCTACGAGCAGTACTTC	CHPPSYEQYF	TRBV10-3	TRBJ2-7
TGTGCCAGCAGTTACTTTAAGCGGGGGGGCTCGAGGTCAAACAATGAGCAGTTCTTC	CASSYFKRGGSRSNNEQFF	TRBV6-6	TRBJ2-1
TGTGCCAGCAGTTGCCGTAAAGGGGCCGGTGAGACCCAGTACTTC	CASSCRKGAGETQYF	TRBV27	TRBJ2-5
TGTGCCAGCAGCTCGCCGGAAATAACGCGGTTTTATAGCAATCAGCCCCAGCATTTT	CASSSPEITRFYSNQPQHF	TRBV7-3	TRBJ1-5
TGTGCCAGCAGCTTAGCGCCCGTCGTTAGCGGGGGGGGCGGACGGAATGAGCAGTTCTTC	CASSLAPVVSGGGGRNEQFF	TRBV7-4	TRBJ2-1
TGTGCCACCAGTGATGGTGGAAGCATGAACACTGAAGCTTTCTTT	CATSDGGSMNTEAFF	TRBV24-1	TRBJ1-1
TGTGCCAGTTCCCTGGAGAATCAGCCCCAGCATTTT	CASSLENQPQHF	TRBV19	TRBJ1-5
TGTGCCAGCAGCCAGAACAGGGGTAAGGCTCACGAGCAGTACTTC	CASSQNRGKAHEQYF	TRBV13	TRBJ2-7
TGTGCCAGCAGCCACCCGGTTCCCCAGAACACTGAAGCTTTCTTT	CASSHPVPQNTEAFF	TRBV3-1	TRBJ1-1
TGTGCCAGCAGGGCAATTCTAGCAATCGGGCCCATATACGAGCAGTACTTC	CASRAILAIGPIYEQYF	TRBV25-1	TRBJ2-7
TGTGCCATCAGTGAGTCGAAACGGCGTGGGCAATCACACGAGCAGTACTTC	CAISESKRRGQSHEQYF	TRBV10-3	TRBJ2-7
TGTGCCAGCAGCCGGGGGGGACTAGCGGGAGAAGACACCGGGGAGCTGTTTTTT	CASSRGGLAGEDTGELFF	TRBV9	TRBJ2-2
TGTGCCAGCAGTTCGTGCACACAGGGGAACACTGAAGCTTTCTTT	CASSSCTQGNTEAFF	TRBV27	TRBJ1-1
TGCGCCAGCAGCTTGCACCCGGGGACCTACGAGCAGTACTTC	CASSLHPGTYEQYF	TRBV5-1	TRBJ2-7
TGTGCCAGCAGTTTATCCCCTAGCGAGTACAATGAGCAGTTCTTC	CASSLSPSEYNEQFF	TRBV27	TRBJ2-1
TGTGCCAGCCCGCCAAGACAGGGTAATGAAAAACTGTTTTTT	CASPPRQGNEKLFF	TRBV3-1	TRBJ1-4
TGCGCCAGCAGCTTGTCTTCGGGACAGCAAGAGCAGTTCTTC	CASSLSSGQQEQFF	TRBV5-1	TRBJ2-1
TGTGCCAGCAGCGTCTTCCTGCCCAGGGTTCTTTGCAATCAGCCCCAGCATTTT	CASSVFLPRVLCNQPQHF	TRBV5-6	TRBJ1-5
TGCGCCAGCTATCCTCAGGGGAACACTGAAGCTTTCTTT	CASYPQGNTEAFF	TRBV4-1	TRBJ1-1
TGTGCCAGCAGTGAAAAGGGGGGGCGAAGCGAGCAGTACTTC	CASSEKGGRSEQYF	TRBV6-1	TRBJ2-7
TGTGCCAGCAGCTTAGACCAGGGGGCCCTATTGGGGTCCTACGAGCAGTACTTC	CASSLDQGALLGSYEQYF	TRBV7-4	TRBJ2-7
TGTGCCAGTAGTATAGATCGGGGAAGGCAATTGAGAGATACGCAGTATTTT	CASSIDRGRQLRDTQYF	TRBV19	TRBJ2-3
TGTGCCAGCAGCTTATCGGTAGGGACTAGCGGGGGCTACGAGCAGTACTTC	CASSLSVGTSGGYEQYF	TRBV7-6	TRBJ2-7
TGTGCCATCACACCCTTTCCTCGGGGAGAGACCCAGTACTTC	CAITPFPRGETQYF	TRBV10-3	TRBJ2-5
TGTGCCAGCAGCTTCCGAGCTAGCGGGTGTCAATCTTACGAGCAGTACTTC	CASSFRASGCQSYEQYF	TRBV7-9	TRBJ2-7
TGTGCCAGCCAGAGAAGGAAGCGAGATAGCAATCAGCCCCAGCATTTT	CASQRRKRDSNQPQHF	TRBV12-3	TRBJ1-5
TGTGCCAGCAGCTACTCCCCTCTATATGAGCAGTTCTTC	CASSYSPLYEQFF	TRBV5-6	TRBJ2-1
TGTGCTAGCAGCTTAACGGGACAGGGGACCAGGGAAGAAAAACTGTTTTTT	CASSLTGQGTREEKLFF	TRBV7-7	TRBJ1-4
TGTGCCAGCAACCGTCGGGAATCAGCCAAAAACATTCAGTACTTC	CASNRRESAKNIQYF	TRBV7-9	TRBJ2-4
TGTGCCAGCAGTTTATGCAGGGAATACTACGAGCAGTACTTC	CASSLCREYYEQYF	TRBV28	TRBJ2-7
TGTGCCAGCAGCTTGAACCGGGTAGCGGAAGAGCAGTTCTTC	CASSLNRVAEEQFF	TRBV5-4	TRBJ2-1
TGCGCCAGCAGCTTGATGAAGGCCGCTTCACCTGGGGGCACCTACGAGCAGTACTTC	CASSLMKAASPGGTYEQYF	TRBV5-1	TRBJ2-7
TGTGCCAGCAGCGGGGGGGGGGATACGCAGTATTTT	CASSGGGDTQYF	TRBV5-6	TRBJ2-3
TGTGCCAGCAGTTACTGCCATGAGGGGGACCATAGCAATCAGCCCCAGCATTTT	CASSYCHEGDHSNQPQHF	TRBV6-5	TRBJ1-5
TGTGCCAGCAGCCGGGGCACAGATACGCAGTATTTT	CASSRGTDTQYF	TRBV7-3	TRBJ2-3
TGTGCCAGCAGAGGGGAATACTATGGCTACACCTTC	CASRGEYYGYTF	TRBV5-4	TRBJ1-2
TGTGCCAGCAGTTTCCGGGACAGGGGCGACTCCTACAATGAGCAGTTCTTC	CASSFRDRGDSYNEQFF	TRBV12-3	TRBJ2-1
TGTGCCAGCAGCTTGGGACTAGTACAAGAGACCCAGTACTTC	CASSLGLVQETQYF	TRBV5-4	TRBJ2-5
TGTGCCTCCTGGGAGTACGAGCAGTACTTC	CASWEYEQYF	TRBV5-8	TRBJ2-7
TGTGCCAGCAGCTTCCTCTTTGACAGGAAGTCTGAAGCTTTCTTT	CASSFLFDRKSEAFF	TRBV7-4	TRBJ1-1
TGTGCCAGCAGCTTGGCGGGAGGGGGGTTTTACGAGCAGTACTTC	CASSLAGGGFYEQYF	TRBV5-6	TRBJ2-7
TGTGCCAGCAGGGCTGGGAAGCACTCGGGAGGTTCTTTTGGCAATCAGCCCCAGCATTTT	CASRAGKHSGGSFGNQPQHF	TRBV27	TRBJ1-5
TGCGCCAGCAGTCGACTAGCGGGAGATAACTACGAGCAGTACTTC	CASSRLAGDNYEQYF	TRBV5-1	TRBJ2-7
TGTGCCAGCAGCGTCGACAGGGAACACGGGTCACCCCTCCACTTT	CASSVDREHGSPLHF	TRBV7-3	TRBJ1-6
TGTGCCAGCAGTCGGGGGACAGGGGTCGGAGAGACCCAGTACTTC	CASSRGTGVGETQYF	TRBV6-5	TRBJ2-5
TGTGCCAGCAGGTCGAGGAATCAGCCCCAGCATTTT	CASRSRNQPQHF	TRBV6-1	TRBJ1-5
TGTGCCAGCAGTAGAACGACAGGGCTTCATCAGTACTTC	CASSRTTGLHQYF	TRBV6-2	TRBJ2-7
TGTGCCAGCAGATACACCCCTCCGGGACTATATGATGAGCAGTTCTTC	CASRYTPPGLYDEQFF	TRBV6-4	TRBJ2-1
TGTGCCGACGGTACCCGCTTGAACACTGAAGCTTTCTTT	CADGTRLNTEAFF	TRBV19	TRBJ1-1
TGTGCCAGCAGCCAGGGAACGCTGGGGGCGGGAAGAAACTATGGCTACACCTTC	CASSQGTLGAGRNYGYTF	TRBV7-3	TRBJ1-2
TGTGCCAGCAGCTTGGTTCAACAGGGGGCGTGTGGCTACACCTTC	CASSLVQQGACGYTF	TRBV5-6	TRBJ1-2
TGTGCCTGGAGGCCAGACCAAGAGACCCAGTACTTC	CAWRPDQETQYF	TRBV30	TRBJ2-5
TGTGCCAGCAGTGAAGCGTCACGACAGGCCTACGAGCAGTACTTC	CASSEASRQAYEQYF	TRBV6-4	TRBJ2-7
TGTGCCAGCAGCAACCGGGGTAATGAAAAACTGTTTTTT	CASSNRGNEKLFF	TRBV13	TRBJ1-4
TGTGCCAGCAGCCAAGATCCCTCCGGCCCAGGGGCGGTCCACTATGGCTACACCTTC	CASSQDPSGPGAVHYGYTF	TRBV4-2	TRBJ1-2
TGCATTTTCCCGACAGGAACTACAACTAATGAAAAACTGTTTTTT	CIFPTGTTTNEKLFF	TRBV29-1	TRBJ1-4
TGTGCCAGCAGGGGCTGGACAGGGGGGGGCGCTTCACCCCTCCACTTT	CASRGWTGGGASPLHF	TRBV27	TRBJ1-6
TGTGCCAGCAGCTTGTTTAACAGGGTCGACGGGGAGCTGTTTTTT	CASSLFNRVDGELFF	TRBV5-6	TRBJ2-2
TGCGCCAGCAGCTTGGAGAATGGAGACAGGGGGGGGAATGAGCAGTTCTTC	CASSLENGDRGGNEQFF	TRBV5-1	TRBJ2-1
TGTGCTAGTGGTTTGGTACCTGACAGGGGTTGTAGTAGGACTGAAGCTTTCTTT	CASGLVPDRGCSRTEAFF	TRBV12-5	TRBJ1-1
TGCGCCAGCAGCTCACACCGGGACAGAACCCCCTACGAGCAGTACTTC	CASSSHRDRTPYEQYF	TRBV4-3	TRBJ2-7
TGTGCCAGCATTACCCCGCGGGAGAGAGAGCAGTTCTTC	CASITPREREQFF	TRBV6-5	TRBJ2-1
TGTGCCAGCAGCTGGATGGGGGCAACGCCCAATCAGCCCCAGCATTTT	CASSWMGATPNQPQHF	TRBV7-6	TRBJ1-5
TGCGCCAGCAGCTTCCAACGCAAACTGGTCGGTGAGCAGTTCTTC	CASSFQRKLVGEQFF	TRBV5-1	TRBJ2-1
TGCGCCAGCCGTCCTCTCGCGGGAGAGAATTCACCCCTCCACTTT	CASRPLAGENSPLHF	TRBV10-1	TRBJ1-6
TGTGCCAGCAGCGACAGGGGTGGGGCCAACGTCCTGACTTTC	CASSDRGGANVLTF	TRBV14	TRBJ2-6
TGTGCCTGGGATGGAACTTCCTGCGGACAGGGGGCCTACGAGCAGTACTTC	CAWDGTSCGQGAYEQYF	TRBV30	TRBJ2-7
TGTGCCAGCAGCGTGGAGGGCCCGAACACCGGGGAGCTGTTTTTT	CASSVEGPNTGELFF	TRBV7-9	TRBJ2-2
TGCGCCAGCAGTGAGTCGGTCGGGGAGCTGTTTTTT	CASSESVGELFF	TRBV10-2	TRBJ2-2
TGTGCCAGCAGCGGAAAATTCCACAGGGGGCCGGGAGCTGAAGCTTTCTTT	CASSGKFHRGPGAEAFF	TRBV11-2	TRBJ1-1
TGTGCCAGCAGCGCGGACTCCTACAATGAGCAGTTCTTC	CASSADSYNEQFF	TRBV12-3	TRBJ2-1
TGTGCCAGTAGTATTGGGACAGAGTCTGGAAACACCATATATTTT	CASSIGTESGNTIYF	TRBV19	TRBJ1-3
TGTGCCAGCAGCGTAGCCGGGGGCGGGCCGCCCCTCTACGAGCAGTACTTC	CASSVAGGGPPLYEQYF	TRBV9	TRBJ2-7
TGCGCCAGCAGCCGGGACACAGATACGCAGTATTTT	CASSRDTDTQYF	TRBV4-3	TRBJ2-3
TGTGCCAGCAGACCAAATCAGCCCCAGCATTTT	CASRPNQPQHF	TRBV6-5	TRBJ1-5
TGTGCCAGCTCACCACGGCCCTATGGCTACACCTTC	CASSPRPYGYTF	TRBV18	TRBJ1-2
TGCGCCAGCAGCATCCGGAGCCACGAGCAGTACTTC	CASSIRSHEQYF	TRBV5-1	TRBJ2-7
TGTGCCAGCAGCGGACATGGGACAGAGGACTATGGCTACACCTTC	CASSGHGTEDYGYTF	TRBV13	TRBJ1-2
TGTGCCAGCAGCCAAGTAACCGGAGGACTAGCGGGATTAGCTAGCACAGATACGCAGTATTTT	CASSQVTGGLAGLASTDTQYF	TRBV14	TRBJ2-3
TGTGCCAGTGGCAGGGATCTTTCCTACGAGCAGTACTTC	CASGRDLSYEQYF	TRBV7-4	TRBJ2-7
TGTGCCAGCAGCCTACTCCCCCCAACTACAGGGGTGGGTGGCTACACCTTC	CASSLLPPTTGVGGYTF	TRBV14	TRBJ1-2
TGTGCCAGCAAGGAGCCAGCCGGGAACACTGAAGCTTTCTTT	CASKEPAGNTEAFF	TRBV27	TRBJ1-1
TGTGCCAGCAGGATGCGGGAGCCAACCCGCTTTTCACCCCTCCACTTT	CASRMREPTRFSPLHF	TRBV6-4	TRBJ1-6
TGTGCTAGTGGTTCCCCTAGCTGGTGGTGTTACCCTGAAGCTTTCTTT	CASGSPSWWCYPEAFF	TRBV12-5	TRBJ1-1
TGTGCCAGCAGTGAAGCCCCCCCAGAGGTTAGATACGAGCAGTACTTC	CASSEAPPEVRYEQYF	TRBV2	TRBJ2-7
TGTGCCAGCAGCCTTCGGGGGAGGGGTAGCAGAGGGAATGAGCAGTTCTTC	CASSLRGRGSRGNEQFF	TRBV7-2	TRBJ2-1
TGTGCCAGCAGTCACAGGGGCGGCTACGAGCAGTACTTC	CASSHRGGYEQYF	TRBV27	TRBJ2-7
TGTGCCACAGCAGTCGGTGGCAATCAGCCCCAGCATTTT	CATAVGGNQPQHF	TRBV24-1	TRBJ1-5
TGTGCCAGCAGCTCTCGTGGGCAGCCCCAGCATTTT	CASSSRGQPQHF	TRBV7-2	TRBJ1-5
TGTGCCAGCAGCCAAGAAGCGCCCGAGCCTATCATGAACACTGAAGCTTTCTTT	CASSQEAPEPIMNTEAFF	TRBV4-2	TRBJ1-1
TGTGCCAGTACCGCCCTAGCGGGTGTCGACGAGCAGTACTTC	CASTALAGVDEQYF	TRBV19	TRBJ2-7
TGTGCCAGCAGCTTAGGGACTTGTCCGTCCTACGAGCAGTACTTC	CASSLGTCPSYEQYF	TRBV7-2	TRBJ2-7
TGTGCCAGCAGTTTATTTTACAGGGGAGGTGCAACTAATGAAAAACTGTTTTTT	CASSLFYRGGATNEKLFF	TRBV12-3	TRBJ1-4
TGCGCCAGCAGCTGCCCTCACCACGGATTTCGCACTGAAGCTTTCTTT	CASSCPHHGFRTEAFF	TRBV5-1	TRBJ1-1
TGTGCCCTCCAACGGACTAGCGGGGTCTACGAGCAGTACTTC	CALQRTSGVYEQYF	TRBV27	TRBJ2-7
TGTGCCAGCACGACCGGGACAGGAACTAATGAAAAACTGTTTTTT	CASTTGTGTNEKLFF	TRBV7-9	TRBJ1-4
TGCGCCAGCAGTGAATACAACGAGAATCAGCCCCAGCATTTT	CASSEYNENQPQHF	TRBV10-1	TRBJ1-5
TGTGCCAGCAGTTGCCAGTGGTATGGCCCGGGACCTCCTTCCATTCAGTACTTC	CASSCQWYGPGPPSIQYF	TRBV7-4	TRBJ2-4
TGCAGTGCTAGACGGTACGAGGGTAGCTCCTACAATGAGCAGTTCTTC	CSARRYEGSSYNEQFF	TRBV20-1	TRBJ2-1
TGTGCCAGCAGCCACAAGTGGATAAGAAAACTGTTTTTT	CASSHKWIRKLFF	TRBV3-1	TRBJ1-4
TGTGCCAGCAGCACCCGCCGGGAGGGAAACACCATATATTTT	CASSTRREGNTIYF	TRBV13	TRBJ1-3
TGTGCCAGCAGCTTGTTTCCCAGGGGGCTTAGCTCTGGGGCCAACGTCCTGACTTTC	CASSLFPRGLSSGANVLTF	TRBV5-4	TRBJ2-6
TGTGCCAGCGTGCTGGAACTTCCTGTCACCGGGGAGCTGTTTTTT	CASVLELPVTGELFF	TRBV6-4	TRBJ2-2
TGTGCCAGCAGCGAGCCTACGGGAGGGCCCTGCTTCTCTGGGGCCAACGTCCTGACTTTC	CASSEPTGGPCFSGANVLTF	TRBV13	TRBJ2-6
TGTGCCACCCGAAAGGGGGGGGCCAACGCTTTCTTT	CATRKGGANAFF	TRBV28	TRBJ1-1
TGTGCCAGTAGTATTCCCGGGACCACTGAAGCTTTCTTT	CASSIPGTTEAFF	TRBV19	TRBJ1-1
TGCGCCAGCAGTGACGGGGGCGACCTAGCCAAAAACATTCAGTACTTC	CASSDGGDLAKNIQYF	TRBV10-2	TRBJ2-4
TGTGCCAGCAGCAGGAGGGGTGGCTACACCTTC	CASSRRGGYTF	TRBV7-9	TRBJ1-2
TGTGCCAGCAGCTTGGGGGGGCTCCCATCCTTGAACAATGAGCAGTTCTTC	CASSLGGLPSLNNEQFF	TRBV5-6	TRBJ2-1
TGCAGTGCTAGCCCTCAGGGAGATGAAAAACTGTTTTTT	CSASPQGDEKLFF	TRBV20-1	TRBJ1-4
TGCAAGAGGCTGGGACAGTCTGAAGCTTTCTTT	CKRLGQSEAFF	TRBV20-1	TRBJ1-1
TGTGCCAGCAGCGCTTTTGCTAGCGGAACTAGCACAGATACGCAGTATTTT	CASSAFASGTSTDTQYF	TRBV5-6	TRBJ2-3
TGTGCCAGCAGCTTAGATAGACAGGAAGTTCTGTACGAGCAGTACTTC	CASSLDRQEVLYEQYF	TRBV11-2	TRBJ2-7
TGTGCCAGCAAGAGACTAGTGGAGGAGACCCAGTACTTC	CASKRLVEETQYF	TRBV7-8	TRBJ2-5
TGTGCCAGCAGCCAAGGATCCCCGTTGGACAGGACCGGGTGCAATCAGCCCCAGCATTTT	CASSQGSPLDRTGCNQPQHF	TRBV14	TRBJ1-5
TGTGCCAGCAGTTATTTCAGGGGGGCTTCCTACGAGCAGTACTTC	CASSYFRGASYEQYF	TRBV6-6	TRBJ2-7
TGTGCCAGCAGCCTAACAGGGTTAGATAGCAATCAGCCCCAGCATTTT	CASSLTGLDSNQPQHF	TRBV7-9	TRBJ1-5
TGTGCCATCAGTGAGAGGGGCAACCGGGACGGTGGAAACACCATATATTTT	CAISERGNRDGGNTIYF	TRBV10-3	TRBJ1-3
TGTGCCAGCAGCCATTGTTCGTCTATCTTC	CASSHCSSIF	TRBV7-3	TRBJ2-1
TGTGCCACCATCATCGAACTCTACGAGCAGTACTTC	CATIIELYEQYF	TRBV24-1	TRBJ2-7
TGCAGTGCTAGGTATCTGAGACAAGGAAACCCGGGACTCAGACTTGAGCAGTTCTTC	CSARYLRQGNPGLRLEQFF	TRBV20-1	TRBJ2-1
TGCGCCAGCAGCTTGCCCCTGGACATTCAGTACTTC	CASSLPLDIQYF	TRBV5-1	TRBJ2-4
TGTGCCAGGCCGGGGAATGAAAAACTGTTTTTT	CARPGNEKLFF	TRBV12-3	TRBJ1-4
TGCAGCGTTGAACCCGGGACTAGCGGGGGGGCGATTGATCATGAGCAGTTCTTC	CSVEPGTSGGAIDHEQFF	TRBV29-1	TRBJ2-1
TGTGCCAGCAGCAACCGCTGCGGACAGTATCGGTCCTATGGCTACACCTTC	CASSNRCGQYRSYGYTF	TRBV6-6	TRBJ1-2
TGTGCCAGCAGCCCTAGCGGGCTCTCCTACGAGCAGTACTTC	CASSPSGLSYEQYF	TRBV9	TRBJ2-7
TGTGCCAGCAGCAAACCTAGCGGACTCTTC	CASSKPSGLF	TRBV13	TRBJ2-1
TGTGCCAGCAGCTTGAGACTCCGGGGGGGCCGAAATGAGCAGTTCTTC	CASSLRLRGGRNEQFF	TRBV5-5	TRBJ2-1
TGTGCCAGCAGTTTAGGTCGGTGGAGGGTCGGCTACACCTTC	CASSLGRWRVGYTF	TRBV27	TRBJ1-2
TGTGCCAGCAGCGTCTTCAGGACAGGGAAGGCTGGCTACACCTTC	CASSVFRTGKAGYTF	TRBV9	TRBJ1-2
TGTGCCAGTAGTAAGAAGCCCGGGGGAACTTCACCCCTCCACTTT	CASSKKPGGTSPLHF	TRBV19	TRBJ1-6
TGCAGTGCTAGAGTAGGGCCCCACACCGGGGAGCTGTTTTTT	CSARVGPHTGELFF	TRBV20-1	TRBJ2-2
TGTGCCAGCAGTTTAGAAATCCGGTGCCGGCCTAGCACAGATACGCAGTATTTT	CASSLEIRCRPSTDTQYF	TRBV27	TRBJ2-3
TGTGCCAGCAGCTTGTTGAGAGAGTTGAAGGATACGCAGTATTTT	CASSLLRELKDTQYF	TRBV5-6	TRBJ2-3
TGTGCCAGCAGCCAAGGGCCTGAGACCCAGTACTTC	CASSQGPETQYF	TRBV3-1	TRBJ2-5
TGTGCCACCAGTCCGGAGGGGAATGGGTCGCAGCCCCAGCATTTT	CATSPEGNGSQPQHF	TRBV24-1	TRBJ1-5
TGTGCCAGCAGCCACCATCCCGCGGGGGATGAGCAGTTCTTC	CASSHHPAGDEQFF	TRBV4-2	TRBJ2-1
TGTGCCAGCTCGATATTTGCGGGAGCTGGGGCCAACGTCCTGACTTTC	CASSIFAGAGANVLTF	TRBV7-3	TRBJ2-6
TGTGCCAGCAGTGACTCGATGAGAGTACAACTAGCGGGAGGGCGAGGAGGAAACACCATATATTTT	CASSDSMRVQLAGGRGGNTIYF	TRBV6-4	TRBJ1-3
TGTGCCAGCAGCCAAGCGGGGACAGGGGATACGCAGTATTTT	CASSQAGTGDTQYF	TRBV3-1	TRBJ2-3
TGTGCCAGCAGCGGGTATGGGGAGGGGGCGACCCAGTACTTC	CASSGYGEGATQYF	TRBV7-6	TRBJ2-5
TGTGCCAGCAGCGTAGGGGGGCAGGAAGACAACCCTGCTTTCTTT	CASSVGGQEDNPAFF	TRBV9	TRBJ1-1
TGTGCCAGCAGAACAGAGCACGAGCAGTACTTC	CASRTEHEQYF	TRBV5-4	TRBJ2-7
TGTGCCAGGAGGGGGCATGGAGGAACCTACGAGCAGTACTTC	CARRGHGGTYEQYF	TRBV6-1	TRBJ2-7
TGTGCCAGCAGCTGGGACAGGGATAATGAAAAACTGTTTTTT	CASSWDRDNEKLFF	TRBV7-3	TRBJ1-4
TGTGCCAGCAGTTTCCCCACTCAGGGGAGCAATGGCTACACCTTC	CASSFPTQGSNGYTF	TRBV28	TRBJ1-2
TGTGCCACAGGGGGTGAAAAACTGTTTTTT	CATGGEKLFF	TRBV6-6	TRBJ1-4
TGTGCCACCGTCCGAGGGCATGCGGACGAGCAGTACTTC	CATVRGHADEQYF	TRBV24-1	TRBJ2-7
TGTGCCAGCAGCTTACCAAGGAGGGGCGGGAGCACAGATACGCAGTATTTT	CASSLPRRGGSTDTQYF	TRBV7-9	TRBJ2-3
TGTGCCAGCACTCGGGAACCGGACAGAAGTTCGAACACCGGGGAGCTGTTTTTT	CASTREPDRSSNTGELFF	TRBV6-5	TRBJ2-2
TGTGCCAGCACCTCCACAGAGGGGGGCTACGAGCAGTACTTC	CASTSTEGGYEQYF	TRBV27	TRBJ2-7
TGTGCCAGCAGTGACATCGTATCCGGGAGTCTCCCGAACACCGGGGAGCTGTTTTTT	CASSDIVSGSLPNTGELFF	TRBV6-4	TRBJ2-2
TGTGCCAGCAGCGCCCAATCGCTGAGAGAGACCCAGTACTTC	CASSAQSLRETQYF	TRBV7-9	TRBJ2-5
TGCAGTGCTAGAGATTTTGGGCCAACAGAGTTCTTC	CSARDFGPTEFF	TRBV20-1	TRBJ2-1
TGTGCCAGCAGCTTCCGGATGCGGCTCACCTACGAGCAGTACTTC	CASSFRMRLTYEQYF	TRBV5-8	TRBJ2-7
TGTGCCAGCGACAGCCCCGGGAATTCACCCCTCCACTTT	CASDSPGNSPLHF	TRBV28	TRBJ1-6
TGTGCCAGCGTCAGGGCACTCTACGAGCAGTACTTC	CASVRALYEQYF	TRBV2	TRBJ2-7
TGTGCCAGCAGTCGGGGAACTAATGAAAAACTGTTTTTT	CASSRGTNEKLFF	TRBV28	TRBJ1-4
TGTGCCAGCAGTACCAGGGGGAGCACAGATACGCAGTATTTT	CASSTRGSTDTQYF	TRBV27	TRBJ2-3
TGTGCCAGCAGGCGGGGGGGAGATCCAGGCGAGCAGTACTTC	CASRRGGDPGEQYF	TRBV28	TRBJ2-7
TGTGCCAGCAGCGGAAGGACTAGCGGGATGGATGAGCAGTTCTTC	CASSGRTSGMDEQFF	TRBV5-6	TRBJ2-1
TGTGCCAGCTTTCCACATCGACTTACTAGCGGGAGAGCCATGAACACTGAAGCTTTCTTT	CASFPHRLTSGRAMNTEAFF	TRBV18	TRBJ1-1
TGTGCCAGCAGGCGGGAGGAAGGGTACAATGAGCAGTTCTTC	CASRREEGYNEQFF	TRBV6-3	TRBJ2-1
TGTGCCACCAGTGAGAAAGCGGCGGGACAGGGGAAGGAGTACGAGCAGTACTTC	CATSEKAAGQGKEYEQYF	TRBV24-1	TRBJ2-7
TGTGCCAGCAGGATAGACGGCGGCACAGATACGCAGTATTTT	CASRIDGGTDTQYF	TRBV28	TRBJ2-3
TGTGCCAGCAGCCGGGGTTCGACAGGGGATCAGCCCCAGCATTTT	CASSRGSTGDQPQHF	TRBV7-3	TRBJ1-5
TGTGCCAGCAGGGACGACAGTCGCTATGGCTACACCTTC	CASRDDSRYGYTF	TRBV2	TRBJ1-2
TGCGCCAGCAGCCCGAGGGCAGGAGGGGCCAAAAACATTCAGTACTTC	CASSPRAGGAKNIQYF	TRBV4-1	TRBJ2-4
TGTGCCAGCGGAGCGGCTTTCTTT	CASGAAFF	TRBV6-4	TRBJ1-1
TGTGCCAGCAGCCGATGTGGGCTAGAAGCTTTCTTT	CASSRCGLEAFF	TRBV6-5	TRBJ1-1
TGTGCCAGCAAGGCGGGCTGGGGCAATGAGCAGTTCTTC	CASKAGWGNEQFF	TRBV6-8	TRBJ2-1
TGCGCCAGCAGCTTGAGCGCGGGACTAGCGACAAGGGACGAGCAGTACTTC	CASSLSAGLATRDEQYF	TRBV5-1	TRBJ2-7
TGTGCCAGCAGTCCCCTATACCGGGTGATTCAGGGGGCCGAGCACGAGCAGTACTTC	CASSPLYRVIQGAEHEQYF	TRBV12-3	TRBJ2-7
TGTGCCAGCAGTTTGGTATTCGGAAGTACCTACGAGCAGTACTTC	CASSLVFGSTYEQYF	TRBV27	TRBJ2-7
TGTGCCAGCAGTCGCCGAGGACAGGACGACTCCTACGAGCAGTACTTC	CASSRRGQDDSYEQYF	TRBV28	TRBJ2-7
TGTGCCAGCAGCTTCAGGGGGGCTAGCAATCAGCCCCAGCATTTT	CASSFRGASNQPQHF	TRBV7-3	TRBJ1-5
TGTGCCAGCAGCTGGGACAGGGAGAACTATGGCTACACCTTC	CASSWDRENYGYTF	TRBV6-5	TRBJ1-2
TGTGCCAGCATCCCGGGACAGGGTATAACCTACGAGCAGTACTTC	CASIPGQGITYEQYF	TRBV11-3	TRBJ2-7
TGTGCCAGCAGCTTAGCAATTTCCCCAACTACTTACGACGAGCAGTACTTC	CASSLAISPTTYDEQYF	TRBV7-8	TRBJ2-7
TGTGCCAGCAGCTTGCCCATGAGTCAGCCCCAGCATTTT	CASSLPMSQPQHF	TRBV5-6	TRBJ1-5
TGTGCCAGCACGGGACTAGCCGCGGGCTCCTACGAGCAGTACTTC	CASTGLAAGSYEQYF	TRBV5-6	TRBJ2-7
TGTGCTAGTGGTTGTATGGACGCACGGGTAAATGAGCAGTTCTTC	CASGCMDARVNEQFF	TRBV12-5	TRBJ2-1
TGTGCCACTAGCGGGGAGACCCAGTACTTC	CATSGETQYF	TRBV27	TRBJ2-5
TGCAGTGCAATTGGGAAGTTGCTTGTAGAGACCCAGTACTTC	CSAIGKLLVETQYF	TRBV20-1	TRBJ2-5
TGCGCCACCGCGCGGACTAGCGGCTTCTTC	CATARTSGFF	TRBV4-1	TRBJ2-1
TGTGCTAGTGGTAGGACGGGGGCTAACTATGGCTACACCTTC	CASGRTGANYGYTF	TRBV12-5	TRBJ1-2
TGTGCCTGGAGGACTAGCGGGGTTGGTAAATCCGGGGAGCTGTTTTTT	CAWRTSGVGKSGELFF	TRBV30	TRBJ2-2
TGTGCCAGCAGTTTGGGACCTGGCCCCATGAACTATGGCTACACCTTC	CASSLGPGPMNYGYTF	TRBV28	TRBJ1-2
TGTGCCAGCAGCAGTTTCCCACAGGGGATGTACGAGCAGTACTTC	CASSSFPQGMYEQYF	TRBV7-3	TRBJ2-7
TGCGCCAGCAGCCCCGGGACAGGAAACACCATATATTTT	CASSPGTGNTIYF	TRBV4-1	TRBJ1-3
TGTGCCAGCACTTCCCATGAAGGGGGACAGTCCCTACGTTACGAGCAGTACTTC	CASTSHEGGQSLRYEQYF	TRBV2	TRBJ2-7
TGTGCCACCCACAGGGGGGGTCCCCATGAAGCTTTCTTT	CATHRGGPHEAFF	TRBV24-1	TRBJ1-1
TGTGCCAGCAGACATACATTAAACAATGAGCAGTTCTTC	CASRHTLNNEQFF	TRBV12-4	TRBJ2-1
TGTGCCAGCAGCGATGGGCCTTTCCTACTGTTTTTT	CASSDGPFLLFF	TRBV12-3	TRBJ1-4
TGTGCCAGCAGCCTCCACGGAAGGGATGGCTACACCTTC	CASSLHGRDGYTF	TRBV2	TRBJ1-2
TGTGCCAGAGGGCTAGGCAACACCGGGGAGCTGTTTTTT	CARGLGNTGELFF	TRBV10-3	TRBJ2-2
TGTGCCTGGAGGCAACGGGGACTAGCGGGAAGTGGCACAGATACGCAGTATTTT	CAWRQRGLAGSGTDTQYF	TRBV30	TRBJ2-3
TGTGCCAACGACAGGGACTACAATGAGCAGTTCTTC	CANDRDYNEQFF	TRBV27	TRBJ2-1
TGCGCCAGCAGCCAAGATGGGAATTCATCTTCCCAGTACTTC	CASSQDGNSSSQYF	TRBV4-1	TRBJ2-5
TGCAGTGCTAGAGATCGTCCCGCTTCCCGCAGGAAAGTTACGCCCCAGCATTTT	CSARDRPASRRKVTPQHF	TRBV20-1	TRBJ1-5
TGCAGTGCTAGCCCGACTAGCGGGAGGAGGGCAGATACGCAGTATTTT	CSASPTSGRRADTQYF	TRBV20-1	TRBJ2-3
TGTGCCAGCAGCTTAGCCCCCGGGACTAGCGGGAGCTTGTCCTACAATGAGCAGTTCTTC	CASSLAPGTSGSLSYNEQFF	TRBV7-4	TRBJ2-1
TGTGCCAGCGACGGGACAGGGGGGTGCTACGAGCAGTACTTC	CASDGTGGCYEQYF	TRBV12-3	TRBJ2-7
TGTGCCCCATACAGGCCTGATCAGCCCCAGCATTTT	CAPYRPDQPQHF	TRBV30	TRBJ1-5
TGTGCCAGCAGCTTGCCAGGTACAGGGGGGTCCCGTAACACTGAAGCTTTCTTT	CASSLPGTGGSRNTEAFF	TRBV5-4	TRBJ1-1
TGTGCCACCCGGGGTATATACACTGAAGCTTTCTTT	CATRGIYTEAFF	TRBV15	TRBJ1-1
TGTGCCAGCAGCCTTCAGGCGATTCATCAGCCCCAGCATTTT	CASSLQAIHQPQHF	TRBV7-9	TRBJ1-5
TGTGCCAGCTCCTTGGGGGGCCGTGAAGCTTTCTTT	CASSLGGREAFF	TRBV11-2	TRBJ1-1
TGTGCCAGCAGCCAAGATCTACCCCGGGACGAGACCCAGTACTTC	CASSQDLPRDETQYF	TRBV14	TRBJ2-5
TGCGCCAGCAGGACAGGGAACACTGAAGCTTTCTTT	CASRTGNTEAFF	TRBV10-2	TRBJ1-1
TGCGCCAGCAGTGCTAGAGATCTAGGGGCTAGCACAGATACGCAGTATTTT	CASSARDLGASTDTQYF	TRBV10-1	TRBJ2-3
TGTGCCAGCAGCTTGGGACAGGGCGGCACAGATACGCAGTATTTT	CASSLGQGGTDTQYF	TRBV5-6	TRBJ2-3
TGTGCCCCATTACGCAGGACGGGAAGAATGAACACTGAAGCTTTCTTT	CAPLRRTGRMNTEAFF	TRBV19	TRBJ1-1
TGTGCCAGCATGCAGGGACAGGGGAAGGGAGTCACTGAAGCTTTCTTT	CASMQGQGKGVTEAFF	TRBV7-3	TRBJ1-1
TGTGCCATCAGTGATGATGGACAGGGAAAAAATAAACTGTTTTTT	CAISDDGQGKNKLFF	TRBV10-3	TRBJ1-4
TGTGCCAGCAGTCCCTCCAAGACCCAGTACTTC	CASSPSKTQYF	TRBV6-2	TRBJ2-5
TGTGCCAGCAGTGTGGTTCCTGGACGTGACACCGGGGAGCTGTTTTTT	CASSVVPGRDTGELFF	TRBV27	TRBJ2-2
TGTGCCAGCAGCCGGGAGCCGGGACTAGCGGGAGGGGGAAATGAGCAGTTCTTC	CASSREPGLAGGGNEQFF	TRBV7-7	TRBJ2-1
TGTGCCTGGACAAAAGGGACTAGCGGTGACACCGGGGAGCTGTTTTTT	CAWTKGTSGDTGELFF	TRBV30	TRBJ2-2
TGTGCCAGCAGCCAAGGCTTACCGGGACAGGGCCTAAAGTTTGAAAAACTGTTTTTT	CASSQGLPGQGLKFEKLFF	TRBV14	TRBJ1-4
TGCGCCAGCAGCCAAGGGCCGAATAGGAGGAATACCTACGAGCAGTACTTC	CASSQGPNRRNTYEQYF	TRBV4-1	TRBJ2-7
TGCGCCAGCACGGGGGGGTTTGCTAGGGACACCGGGGAGCTGTTTTTT	CASTGGFARDTGELFF	TRBV10-2	TRBJ2-2
TGTGCCAGCAGCTTGAGTTTGGTTAGGAACTATGAAGCTTTCTTT	CASSLSLVRNYEAFF	TRBV5-4	TRBJ1-1
TGTGCCTTAGCAACAGGGTCTGGGGCCAACGTCCTGACTTTC	CALATGSGANVLTF	TRBV24-1	TRBJ2-6
TGTGCCAGCATGGTCGTCAGGATTACAGAGACCCAGTACTTC	CASMVVRITETQYF	TRBV27	TRBJ2-5
TGTGCCACCCAGAACTTGCGACACGGCTTAGGGGATTCCCATGAAAAACTGTTTTTT	CATQNLRHGLGDSHEKLFF	TRBV24-1	TRBJ1-4
TGTGCCAGCAGCTTTCAGGGGGGGCAAAGTAGCACAGATACGCAGTATTTT	CASSFQGGQSSTDTQYF	TRBV7-9	TRBJ2-3
TGTGCCAGCAGTGATCGGCTGACGAAGGGCGGGGAGCTGTTTTTT	CASSDRLTKGGELFF	TRBV2	TRBJ2-2
TGTGCCAGCAGCCTCGCCTATCTACGACAGCCCCAGCATTTT	CASSLAYLRQPQHF	TRBV7-6	TRBJ1-5
TGTGCCAGCAGTCACCTATTCCCGGGACTAGAGGGTACCGGGGAGCTGTTTTTT	CASSHLFPGLEGTGELFF	TRBV6-3	TRBJ2-2
TGTGCCTGGAGGGGACAGGGTGTCTACGAGCAGTACTTC	CAWRGQGVYEQYF	TRBV30	TRBJ2-7
TGTGCCAGCAGTTTAGCCACACGGGGCTTTACAGATACGCAGTATTTT	CASSLATRGFTDTQYF	TRBV12-3	TRBJ2-3
TGTGCCAGCAGCGAGGGAGGTGGCAGCAATCAGCCCCAGCATTTT	CASSEGGGSNQPQHF	TRBV6-4	TRBJ1-5
TGTGCCAGCAGCAACGGACTAGCGGGACCGGATGAGCAGTTCTTC	CASSNGLAGPDEQFF	TRBV7-3	TRBJ2-1
TGTGCCAGCAGCCTTCAACCGGGACAGGGAGAGCAGTACTTC	CASSLQPGQGEQYF	TRBV5-8	TRBJ2-7
TGTGCCAGCAGTTTAGCGCGGACTCACGTAGACAGGGGCGTTGAGACCCAGTACTTC	CASSLARTHVDRGVETQYF	TRBV12-4	TRBJ2-5
TGTGCCAGCAGTCCTCAGGGAAGCCCCAATTCACCCCTCCACTTT	CASSPQGSPNSPLHF	TRBV6-5	TRBJ1-6
TGTGCCAGCCGGGACAGGCCCCCCTACGAGCAGTACTTC	CASRDRPPYEQYF	TRBV13	TRBJ2-7
TGTGCCAGCAGCTACACAAATCAGGGGGCCTTACGAAACACCATATATTTT	CASSYTNQGALRNTIYF	TRBV9	TRBJ1-3
TGTGCCAGCAGTTCAAAAGCTACAGGGTCTATGGGAAACACCATATATTTT	CASSSKATGSMGNTIYF	TRBV6-6	TRBJ1-3
TGTGCCAGCAGCTGTAGCGCCTACGAGCAGTACTTC	CASSCSAYEQYF	TRBV12-3	TRBJ2-7
TGTGCCAGCGGAGGGGGGCCTACCGTACACTACGAGCAGTACTTC	CASGGGPTVHYEQYF	TRBV6-1	TRBJ2-7
TGCGCCAGCAAAGCCCCCGGGACAGGTAACCTTACTGAAGCTTTCTTT	CASKAPGTGNLTEAFF	TRBV10-1	TRBJ1-1
TGTGCCAGCTCACGGGACAGGGTTTACTACGAGCAGTACTTC	CASSRDRVYYEQYF	TRBV18	TRBJ2-7
TGTGCCAGCAGCCAAGATAAGATCTGGGACGTCAAGGCCTACGAGCAGTACTTC	CASSQDKIWDVKAYEQYF	TRBV14	TRBJ2-7
TGTGCCAGCAGCCCCCGGGGGGTAGGAAAACTGTTTTTT	CASSPRGVGKLFF	TRBV13	TRBJ1-4
TGTGCCAGGACGGGAGAATGCATGTATGGCTACACCTTC	CARTGECMYGYTF	TRBV25-1	TRBJ1-2
TGTGCCAGCAGTTTAACCCCCAAGTCGCCCCAGCATTTT	CASSLTPKSPQHF	TRBV12-3	TRBJ1-5
TGTGCCAGCAGCCGGGGGCTCCGCAATCAGCCCCAGCATTTT	CASSRGLRNQPQHF	TRBV7-2	TRBJ1-5
TGTGCCAGCAGCGTCCGGGACAGGGGGAACACCATATATTTT	CASSVRDRGNTIYF	TRBV7-3	TRBJ1-3
TGCGCCAGCAGCCAAAAGGTATTCTACACAGATACGCAGTATTTT	CASSQKVFYTDTQYF	TRBV4-1	TRBJ2-3
TGTGCCAGCAGTGAAGCTGAGCGTTCAGGCGGGAGCGGGGAGCTGTTTTTT	CASSEAERSGGSGELFF	TRBV2	TRBJ2-2
TGTGCCAGCAGCTACCGTAGACAGGGGGCGCGCACCGGGGAGCTGTTTTTT	CASSYRRQGARTGELFF	TRBV7-9	TRBJ2-2
TGCAGTGCTAGCCGTGGACTAGTATTAGAGACCCAGTACTTC	CSASRGLVLETQYF	TRBV20-1	TRBJ2-5
TGTGCCAGCAGCCAGGGGGGTCCCTCCTACAATGAGCAGTTCTTC	CASSQGGPSYNEQFF	TRBV6-6	TRBJ2-1
TGTGCCAGCAGTTACCCCAGGTCTTGGAACACTGAAGCTTTCTTT	CASSYPRSWNTEAFF	TRBV6-5	TRBJ1-1
TGTGCCTGGAGTGTAACAACCCCGAGGCACGGATATGGCTACACCTTC	CAWSVTTPRHGYGYTF	TRBV30	TRBJ1-2
TGCAGCGTTGACCAGGACCAAGGGGACGCCTACGAGCAGTACTTC	CSVDQDQGDAYEQYF	TRBV29-1	TRBJ2-7
TGTGCCAGCAGCCTGGGACAGGGCCGGAATTCACCCCTCCACTTT	CASSLGQGRNSPLHF	TRBV9	TRBJ1-6
TGTGCCACAGGGATAAATCAGCCCCAGCATTTT	CATGINQPQHF	TRBV3-1	TRBJ1-5
TGTGCCAGCCGGGGTTCAGGAAACACTGAAGCTTTCTTT	CASRGSGNTEAFF	TRBV27	TRBJ1-1
TGTGCCAGCAGTATGGACCGCTACGAGCAGTACTTC	CASSMDRYEQYF	TRBV12-4	TRBJ2-7
TGTGCCTGGATGGTCACAGGGGGGCGCTACGAGCAGTACTTC	CAWMVTGGRYEQYF	TRBV30	TRBJ2-7
TGTGCCAGCAGCGGGGGACTGAACACTGAAGCTTTCTTT	CASSGGLNTEAFF	TRBV9	TRBJ1-1
TGCAGCATCCCCCGGGGCAGCCCTAGCAATCAGCCCCAGCATTTT	CSIPRGSPSNQPQHF	TRBV29-1	TRBJ1-5
TGTGCCACCAGCAGCGGGCTAGCCATAGAGCAGTTCTTC	CATSSGLAIEQFF	TRBV15	TRBJ2-1
TGTGCCATCTGGGCCATAAGGGGACAGCGCTCTGGAAACACCATATATTTT	CAIWAIRGQRSGNTIYF	TRBV27	TRBJ1-3
TGTGCCAGCAGTGACCCTCCTTTACTCGGGGGTAACTATGGCTACACCTTC	CASSDPPLLGGNYGYTF	TRBV6-4	TRBJ1-2
TGTGCCAGCAGTACCCAGGGTGGGAGGGCAACTAATGAAAAACTGTTTTTT	CASSTQGGRATNEKLFF	TRBV28	TRBJ1-4
TGTGCCTCATCCCCGGACAGGGGGTCCGCGACCTACGAGCAGTACTTC	CASSPDRGSATYEQYF	TRBV6-4	TRBJ2-7
TGTGCCAGCAGCATGGGGGGACGGTTTGAGTACGAGCAGTACTTC	CASSMGGRFEYEQYF	TRBV13	TRBJ2-7
TGCAGTGCTAGAGATAGGGGGGGGCGTCCACTGAGCTCTGGGGCCAACGTCCTGACTTTC	CSARDRGGRPLSSGANVLTF	TRBV20-1	TRBJ2-6
TGTGCCAGCAGCTTGGGATTATATCTCTTTGAGCAGTTCTTC	CASSLGLYLFEQFF	TRBV5-6	TRBJ2-1
TGTGCCAGCAGCGAGGGGGGCTTTTACAATGAGCAGTTCTTC	CASSEGGFYNEQFF	TRBV7-4	TRBJ2-1
TGTGCCAGCAGCTTAGGGCCGCTAAGCGGGAAAGCGATTTCCTACGAGCAGTACTTC	CASSLGPLSGKAISYEQYF	TRBV7-9	TRBJ2-7
TGTGCCACACAGCCCGGACAGGACCAAGAGACCCAGTACTTC	CATQPGQDQETQYF	TRBV28	TRBJ2-5
TGTGCCAGCAGCTTCCGGAACACTGGGTATGAGCAGTTCTTC	CASSFRNTGYEQFF	TRBV5-5	TRBJ2-1
TGTGCGTCCGACCTTAACGTAAGGGACAGTTCGGGCGAAAAACTGTTTTTT	CASDLNVRDSSGEKLFF	TRBV7-7	TRBJ1-4
TGTGCCAGCAGCTTGGTCTGGTCGAGACAGTCTACTGAAGCTTTCTTT	CASSLVWSRQSTEAFF	TRBV5-6	TRBJ1-1
TGCAGTGCTATTAAGGATAGACAGGGTTTGGCGGGGGGCTATGGCTACACCTTC	CSAIKDRQGLAGGYGYTF	TRBV20-1	TRBJ1-2
TGTGCCAGCATGCGTAATGGAGATACGCAGTATTTT	CASMRNGDTQYF	TRBV25-1	TRBJ2-3
TGTGCCAGCAGCTCCCCGGGGAGCTCCTACGAGCAGTACTTC	CASSSPGSSYEQYF	TRBV5-6	TRBJ2-7
TGTGCCAGCAGTTATAGAGGGCACGAGCAGTACTTC	CASSYRGHEQYF	TRBV6-5	TRBJ2-7
TGCAGCGCCGGCGGACAGGGCAGAGCTTTCTTT	CSAGGQGRAFF	TRBV29-1	TRBJ1-1
TGCAGTGGGGGCCGTCTAGCTTTCTTT	CSGGRLAFF	TRBV20-1	TRBJ1-1
TGTGCCAGCAGCTACCCCTTGACGGACGATACGCAGTATTTT	CASSYPLTDDTQYF	TRBV5-4	TRBJ2-3
TGTGCCAGCAGTTACTTAGGGACAGGGAATCAGCCCCAGCATTTT	CASSYLGTGNQPQHF	TRBV6-6	TRBJ1-5
TGCGCCAGCAGCCAAGTGGGGGCAGAGACCCAGTACTTC	CASSQVGAETQYF	TRBV4-3	TRBJ2-5
TGTGCCAGCAGTTCTCTGTTGACAGGTAGCAATCAGCCCCAGCATTTT	CASSSLLTGSNQPQHF	TRBV5-5	TRBJ1-5
TGTGCCAGCAGCAAGGCCCTAGCGGGAATCGAGCAGTTCTTC	CASSKALAGIEQFF	TRBV7-3	TRBJ2-1
TGTGCCAGCAGCTTGGCGACCGGGACAGCGTTTACGGATACGCAGTATTTT	CASSLATGTAFTDTQYF	TRBV5-4	TRBJ2-3
TGTGCCACCGTCAAGATTACACCGGGACCAGATACGCAGTATTTT	CATVKITPGPDTQYF	TRBV24-1	TRBJ2-3
TGTGCCAGCATCACGGGGAGGAACCTAGAGACCCAGTACTTC	CASITGRNLETQYF	TRBV3-1	TRBJ2-5
TGTGCCACCAGCAGAGAGGTCAGGGGGCTCCTTTTCTACGAGCAGTACTTC	CATSREVRGLLFYEQYF	TRBV15	TRBJ2-7
TGCAGTGCTAGCACTAGCGCTAGCACAGATACGCAGTATTTT	CSASTSASTDTQYF	TRBV20-1	TRBJ2-3
TGTGCCAGCAGCCTCCACAGAGGAGTTACAGATACGCAGTATTTT	CASSLHRGVTDTQYF	TRBV7-4	TRBJ2-3
TGTGCCAGCAGAGCCGGGGCAAGCTCCTACGAGCAGTACTTC	CASRAGASSYEQYF	TRBV28	TRBJ2-7
TGTGCCAGCAGATGGGGACAGGGCCAGTCGTTACGGGATGGCTACACCTTC	CASRWGQGQSLRDGYTF	TRBV27	TRBJ1-2
TGCGCCAAACATGACAGGGGAGGCTACGAGCAGTACTTC	CAKHDRGGYEQYF	TRBV5-1	TRBJ2-7
TGCAGCGGCCACCAACTAGCGGGGGGTGAGACCCAGTACTTC	CSGHQLAGGETQYF	TRBV29-1	TRBJ2-5
TGTGCCAGCAGCGTAGTCTTACCGGGTGATGAAAAACTGTTTTTT	CASSVVLPGDEKLFF	TRBV9	TRBJ1-4
TGTGCCAAGGGTCGCAATCAGCCCCAGCATTTT	CAKGRNQPQHF	TRBV7-9	TRBJ1-5
TGCGCCAGCAGAGTGACAAGGGACTTTCGTAACACCGGGGAGCTGTTTTTT	CASRVTRDFRNTGELFF	TRBV10-1	TRBJ2-2
TGCGCCAGCAGCTTGGGCCAACATAAGGGGATTCTCGGGGAGCTGTTTTTT	CASSLGQHKGILGELFF	TRBV5-1	TRBJ2-2
TGTGCCAGTACGGCACGGCCGCATAGCAATCAGCCCCAGCATTTT	CASTARPHSNQPQHF	TRBV19	TRBJ1-5
TGTGCCAGCAGTGCCCGCTGGGCAGGGATCCTGTCCGAGACCCAGTACTTC	CASSARWAGILSETQYF	TRBV12-3	TRBJ2-5
TGTGCCAGCAGCTCTGCGTCCGATGAAAAACTGTTTTTT	CASSSASDEKLFF	TRBV11-2	TRBJ1-4
TGTGCCAGCAGACCTAGTGAGGGTGACAATGAGCAGTTCTTC	CASRPSEGDNEQFF	TRBV6-5	TRBJ2-1
TGCAGCGTTGACCTTCTGAGGGGGGCCAACGTCCTGACTTTC	CSVDLLRGANVLTF	TRBV29-1	TRBJ2-6
TGTGCCAGCAGCGTAGCCAGAGCGGGAGAATACGAGCAGTACTTC	CASSVARAGEYEQYF	TRBV9	TRBJ2-7
TGTGCCAGCATGGCGGACAGGCTCACTAATCAGCCCCAGCATTTT	CASMADRLTNQPQHF	TRBV6-3	TRBJ1-5
TGCAGTGCCCCTGGACTAGCGGGGAGCACAGATACGCAGTATTTT	CSAPGLAGSTDTQYF	TRBV20-1	TRBJ2-3
TGCAGTGCTACAGGGGGCGATGAAAAACTGTTTTTT	CSATGGDEKLFF	TRBV20-1	TRBJ1-4
TGTGCCAGCAGTTCAACTAGCGGGAGAGACGGGGAGCTGTTTTTT	CASSSTSGRDGELFF	TRBV6-2	TRBJ2-2
TGTGCCAGCAGTGACAGGTTCGGGAATGAGCAGTTCTTC	CASSDRFGNEQFF	TRBV6-4	TRBJ2-1
TGTGCCAGCCTGGGGGGGGGGAGCACAGATACGCAGTATTTT	CASLGGGSTDTQYF	TRBV6-2	TRBJ2-3
TGTGCCAGCAGCGCTAAACTCTCCTATAATTCACCCCTCCACTTT	CASSAKLSYNSPLHF	TRBV7-3	TRBJ1-6
TGTGCCAGCAGTGAACGGCGGGGGGCAGGCAATCAGCCCCAGCATTTT	CASSERRGAGNQPQHF	TRBV6-1	TRBJ1-5
TGTGCCAGCAGTTTGAGGCAGGGGTGTATGAACACTGAAGCTTTCTTT	CASSLRQGCMNTEAFF	TRBV6-6	TRBJ1-1
TGTGCCTGGAGTGTAGCGGTTCAGGGCCAGCCCCAGCATTTT	CAWSVAVQGQPQHF	TRBV30	TRBJ1-5
TGTGCCAGCAGCTCAGCTCCCGGGACGGCTAACACTGAAGCTTTCTTT	CASSSAPGTANTEAFF	TRBV11-3	TRBJ1-1
TGTGCCAGCAGCTTTACGTCTTGGAGGGAGCCCCAGCATTTT	CASSFTSWREPQHF	TRBV7-9	TRBJ1-5
TGTGCCAGCAGCACCCGTTCGGGTGAGACCCAGTACTTC	CASSTRSGETQYF	TRBV5-8	TRBJ2-5
TGCGCCAGCAGCCAAAGGTTATCACGTAGTCCGCACTACGAGCAGTACTTC	CASSQRLSRSPHYEQYF	TRBV4-3	TRBJ2-7
TGCGCCAGCAGGTCCCACAGGGATACGCAGTATTTT	CASRSHRDTQYF	TRBV10-1	TRBJ2-3
TGTGCCAGCGTAGCTGGCTACACCTTC	CASVAGYTF	TRBV6-1	TRBJ1-2
TGTGCCAGCTGCCAACGAACCGGGAGCCAAGAGACCCAGTACTTC	CASCQRTGSQETQYF	TRBV6-4	TRBJ2-5
TGCAGTGCTAGAGAACGGCGGGAGAGCTATGGCTACACCTTC	CSARERRESYGYTF	TRBV20-1	TRBJ1-2
TGTGCCAGCAGCTGCCCGGAAGGTATTCGCTACGAGCAGTACTTC	CASSCPEGIRYEQYF	TRBV7-6	TRBJ2-7
TGTGCCACCAGCAGAATCACCGGGACAAAGGAGGACCATACGCAGTATTTT	CATSRITGTKEDHTQYF	TRBV15	TRBJ2-3
TGTGCCAGCAGCGGGAACCACGAGCAGTACTTC	CASSGNHEQYF	TRBV5-4	TRBJ2-7
TGTGCCAGCAGCTACGGGCCGGTAGAGACCCAGTACTTC	CASSYGPVETQYF	TRBV7-2	TRBJ2-5
TGTGCAAGGGCCGACGGGACACCTCGCAATCAGCCCCAGCATTTT	CARADGTPRNQPQHF	TRBV5-4	TRBJ1-5
TGCGCCAGCTTGGTCAGGGGTATGTGGAATCAGCCCCAGCATTTT	CASLVRGMWNQPQHF	TRBV10-1	TRBJ1-5
TGTGCCAGAGGACAGGGGCATCGTCCTCTGAATGACTTC	CARGQGHRPLNDF	TRBV12-3	TRBJ2-7
TGTGCCACCGACTCCAAACGGACAGGGACGGGTAACTATGGCTACACCTTC	CATDSKRTGTGNYGYTF	TRBV15	TRBJ1-2
TGTGCCAGCAGTTTATGGGCGTACACAATCTACGAGCAGTACTTC	CASSLWAYTIYEQYF	TRBV12-4	TRBJ2-7
TGTGCCAGCAGCGTAGGCCAAGAGCTCCGGGACAGTAGCTACGAGCAGTACTTC	CASSVGQELRDSSYEQYF	TRBV9	TRBJ2-7
TGTGCCAGCAGTATTGCCGGCCGGGGCGGAAACACCATATATTTT	CASSIAGRGGNTIYF	TRBV27	TRBJ1-3
TGTGCCAGCAGTGAGAGGGCAGGGGCCCCCGAGCAGTACTTC	CASSERAGAPEQYF	TRBV25-1	TRBJ2-7
TGTGCCAGCAGTGAGGGGCCCAAGGAACGTAAAACCTACGAGCAGTACTTC	CASSEGPKERKTYEQYF	TRBV6-4	TRBJ2-7
TGTGCCAGCAGTGCCTCTGGACGAGCCTCCTACGAGCAGTACTTC	CASSASGRASYEQYF	TRBV27	TRBJ2-7
TGTGCCAGCAGCTCGAGGACAGAACCAGGCCAGGGCAATCAGCCCCAGCATTTT	CASSSRTEPGQGNQPQHF	TRBV3-1	TRBJ1-5
TGTGCCAGCAGCTTCCTTGCAGGGTCCTACGAGCAGTACTTC	CASSFLAGSYEQYF	TRBV7-6	TRBJ2-7
TGCAGCGTTGATGACAGACAGGGGAACACTGAAGCTTTCTTT	CSVDDRQGNTEAFF	TRBV29-1	TRBJ1-1
TGCGCCACGGAGGACAGGGTTATAAGTTATGGCTACACCTTC	CATEDRVISYGYTF	TRBV4-1	TRBJ1-2
TGTGCCAGCAGCGGCTGGGCGAACACCGGGGAGCTGTTTTTT	CASSGWANTGELFF	TRBV7-2	TRBJ2-2
TGTGCCAGCAGCCGCCAGGAGGGGGGAGCTTTCTTT	CASSRQEGGAFF	TRBV7-3	TRBJ1-1
TGTGCCAGCAGTCCCCCGACAGGGCCGTACGAGCAGTACTTC	CASSPPTGPYEQYF	TRBV6-5	TRBJ2-7
TGTGCCAGCAGGAGGACTAGCGGGTTTAAGGCCATCTACGAGCAGTACTTC	CASRRTSGFKAIYEQYF	TRBV6-5	TRBJ2-7
TGCAGCGTTGCGGCCGTGGGCCCGGGAACGCAAGAGACCCAGTACTTC	CSVAAVGPGTQETQYF	TRBV29-1	TRBJ2-5
TGTGCCAGCAGCCGGGGTCCTTGCAATCAGCCCCAGCATTTT	CASSRGPCNQPQHF	TRBV11-3	TRBJ1-5
TGTGCCAGCAGTTTTAGTTCGAGAGGGTCCACAGATACGCAGTATTTT	CASSFSSRGSTDTQYF	TRBV27	TRBJ2-3
TGTGCCACCAGTGTAATCCATTGGGACAGGGCTTCCACTGAAGCTTTCTTT	CATSVIHWDRASTEAFF	TRBV24-1	TRBJ1-1
TGTGCCAGGTCAAGGCGACGGGATGAGCAGTTCTTC	CARSRRRDEQFF	TRBV19	TRBJ2-1
TGTGCCAGCAGCGTAGACCCTACCCGACAGCCTCGCTACGAGCAGTACTTC	CASSVDPTRQPRYEQYF	TRBV9	TRBJ2-7
TGTGCCAGCCGACGGGGAATAGATACGCAGTATTTT	CASRRGIDTQYF	TRBV12-3	TRBJ2-3
TGTGCCAGCAAACTGACTGAGGTTAACAATGAGCAGTTCTTC	CASKLTEVNNEQFF	TRBV11-3	TRBJ2-1
TGTGCCAGCAGCTCCATTTGGGGGCCCGTCTCCTACGAGCAGTACTTC	CASSSIWGPVSYEQYF	TRBV11-2	TRBJ2-7
TGCAGTGCTAGTAGCCCCACGGCAGATACGCAGTATTTT	CSASSPTADTQYF	TRBV20-1	TRBJ2-3
TGTGCCAGCAGTTTCGTCATCCTCGGGACAGGGGTGGGACCCAATCAGCCCCAGCATTTT	CASSFVILGTGVGPNQPQHF	TRBV12-4	TRBJ1-5
TGTGCCAGCAGACCGGGAGGGGGCACTGAAGCTTTCTTT	CASRPGGGTEAFF	TRBV27	TRBJ1-1
TGTGCCAGCAGTTACCTAGCGGGATTAGACAGGTCCTACAATGAGCAGTTCTTC	CASSYLAGLDRSYNEQFF	TRBV6-5	TRBJ2-1
TGTGCCAGCAGCGGACGGGGGTTATACAATGAGCAGTTCTTC	CASSGRGLYNEQFF	TRBV13	TRBJ2-1
TGTGCCAGCAGTTACCGTAGTAACTACAATGAGCAGTTCTTC	CASSYRSNYNEQFF	TRBV6-6	TRBJ2-1
TGTGCCAGCAGCGAGACAGGTGACAAGTTTTCGGAGACCCAGTACTTC	CASSETGDKFSETQYF	TRBV13	TRBJ2-5
TGTGCGGACCAGCCCCAGCATTTT	CADQPQHF	TRBV28	TRBJ1-5
TGCAGCGTTGAAGACGCGGCTCGGTTCCGAGATAGCAATCAGCCCCAGCATTTT	CSVEDAARFRDSNQPQHF	TRBV29-1	TRBJ1-5
TGTGCCAGCCCTTTTGGTAGCAGGAACACTGAAGCTTTCTTT	CASPFGSRNTEAFF	TRBV28	TRBJ1-1
TGTGCCAGCAGTGACTCACTAGCGGGAGTACACATTCAGTACTTC	CASSDSLAGVHIQYF	TRBV6-1	TRBJ2-4
TGTGCCACCAGTGACGCAGGCCCCGGTGGCAGTGAAAAACTGTTTTTT	CATSDAGPGGSEKLFF	TRBV24-1	TRBJ1-4
TGTGCCAGCAGCCGGGCCGCAGGGGACGAGGAGACCCAGTACTTC	CASSRAAGDEETQYF	TRBV2	TRBJ2-5
TGCAGTGCTAGAGATCCCCGAACAAATGAGCAGTTCTTC	CSARDPRTNEQFF	TRBV20-1	TRBJ2-1
TGTGCCAGCAGCTTGGTACCCGGGCCCCGGGGGAGCACCGGGGAGCTGTTTTTT	CASSLVPGPRGSTGELFF	TRBV5-6	TRBJ2-2
TGCGCCAGCAGGGGACCCGCGGGAGATCCCGCGAACACCGGGGAGCTGTTTTTT	CASRGPAGDPANTGELFF	TRBV5-1	TRBJ2-2
TGTGCCCCCACTCTAACCGGGCGCGTGAACACTGAAGCTTTCTTT	CAPTLTGRVNTEAFF	TRBV7-6	TRBJ1-1
TGTGCCAGTAGCAAGTTGACAGGGGGCTCGAACACTGAAGCTTTCTTT	CASSKLTGGSNTEAFF	TRBV19	TRBJ1-1
TGTGCCAGCAGTCAAGGCCGCCGTAACTCCTACGAGCAGTACTTC	CASSQGRRNSYEQYF	TRBV12-3	TRBJ2-7
TGTGCCAGCAGCAGGGACGGAGGGTTTATTGCCAACACTGAAGCTTTCTTT	CASSRDGGFIANTEAFF	TRBV7-3	TRBJ1-1
TGCGCCAGCAGCGTAGGTGGACGGGAGTACGAGCAGTACTTC	CASSVGGREYEQYF	TRBV5-1	TRBJ2-7
TGTGCCAGCAGTGAGTGCGGGAGTCTAAACACCATATATTTT	CASSECGSLNTIYF	TRBV6-4	TRBJ1-3
TGTGCCAGCAGCATCCCAATCGACAGCGGGACAAGACAAGAGACCCAGTACTTC	CASSIPIDSGTRQETQYF	TRBV5-6	TRBJ2-5
TGCGCCAGCAGCCAAGGACAGGGGGTTAACTATGGCTACACCTTC	CASSQGQGVNYGYTF	TRBV4-1	TRBJ1-2
TGTGCCAGCAGTGAATCGGCCGTGTCCCGGGCCCACTACGAGCAGTACTTC	CASSESAVSRAHYEQYF	TRBV25-1	TRBJ2-7
TGTGCCAGCAGTTTAGATGGGACAGCTACTGAAGCTTTCTTT	CASSLDGTATEAFF	TRBV12-3	TRBJ1-1
TGTGCCAGCAGTGACGGGATACGGGGTCCAGGAGGGGGAGTAACCTACGAGCAGTACTTC	CASSDGIRGPGGGVTYEQYF	TRBV6-4	TRBJ2-7
TGCAGTGCTACGTGCCAGGTGCAGGTTATGAACACTGAAGCTTTCTTT	CSATCQVQVMNTEAFF	TRBV20-1	TRBJ1-1
TGTGCCATACCCCAGGGCTTCGGAAATTCACCCCTCCACTTT	CAIPQGFGNSPLHF	TRBV3-1	TRBJ1-6
TGTGCCACCAGTGCCGGTATCAGGGGGGGCCTCTATTTT	CATSAGIRGGLYF	TRBV24-1	TRBJ2-3
TGCAGTGCTAGTTACACAGAAGGCTATTCACCCCTCCACTTT	CSASYTEGYSPLHF	TRBV20-1	TRBJ1-6
TGCGCCAGCAGCCCCGGGGACCGTGGCTACACCTTC	CASSPGDRGYTF	TRBV5-1	TRBJ1-2
TGTGCCAGCAGCGTTTCTGGGGGGGGGGGCGAGCAGTACTTC	CASSVSGGGGEQYF	TRBV9	TRBJ2-7
TGTGCCAGCAGCTTACGGTATGGATGGAACACTGAAGCTTTCTTT	CASSLRYGWNTEAFF	TRBV7-8	TRBJ1-1
TGTGCCAGCAGGAGTAGCTTCGAGCAGTACTTC	CASRSSFEQYF	TRBV6-4	TRBJ2-7
TGTGCCAGCAGCATCGTAGGACAGATCCAGAACACTGAAGCTTTCTTT	CASSIVGQIQNTEAFF	TRBV6-4	TRBJ1-1
TGTGCCCCGAATGGACTAGCGACAGATACGCAGTATTTT	CAPNGLATDTQYF	TRBV10-3	TRBJ2-3
