TGTGCCACCACAGACCGAGAGAATGAAAAACTGTTTTTT	CATTDRENEKLFF	TRBV24-1	TRBJ1-4
TGTGCCAGCAGCCTCCCAGGGCAGACCGAGCAGTACTTC	CASSLPGQTEQYF	TRBV7-9	TRBJ2-7
TGTGCCAGCAGCTTGGCGGGGAACGGCCGAAACACTGAAGCTTTCTTT	CASSLAGNGRNTEAFF	TRBV5-5	TRBJ1-1
TGTGCCAGCCACTCCTACGAGCAGTACTTC	CASHSYEQYF	TRBV6-1	TRBJ2-7
TGTGCCAGCAGCCCCCGCCAGCCCCAGCATTTT	CASSPRQPQHF	TRBV9	TRBJ1-5
TGTGCCAGGGCCCTCTGGAACCTTGAGACCCAGTACTTC	CARALWNLETQYF	TRBV7-3	TRBJ2-5
TGTGCCACCAGCAGAGATAAAAGGGGGGGTACTGAGCAGTACTTC	CATSRDKRGGTEQYF	TRBV15	TRBJ2-7
TGCAGCGTTGGCTGGGGTGTCCCATCCCCCTACAATGAGCAGTTCTTC	CSVGWGVPSPYNEQFF	TRBV29-1	TRBJ2-1
TGTGCCAGCAGCTTACTGGAGGGGAAGACCCGTGAGCAGTTCTTC	CASSLLEGKTREQFF	TRBV11-2	TRBJ2-1
TGTGCCAGCAGTGGTACAGGGTGTGGCTTAAACACCGGGGAGCTGTTTTTT	CASSGTGCGLNTGELFF	TRBV12-4	TRBJ2-2
TGTGCCAGCAGGGAGCAGACCCAGCCCCAGCATTTT	CASREQTQPQHF	TRBV12-3	TRBJ1-5
TGTGCCAGCTACAACAGGGGGGTCAGGGGCGTGGGTAATGAGCAGTTCTTC	CASYNRGVRGVGNEQFF	TRBV18	TRBJ2-1
TGTGCCAGCAGCCAACGCCCGGGACAGAGCCACGAGCAGTTCTTC	CASSQRPGQSHEQFF	TRBV3-1	TRBJ2-1
TGTGCCAGCAGTTACTGTGGGACAGGGGGAACCTATAGCAATCAGCCCCAGCATTTT	CASSYCGTGGTYSNQPQHF	TRBV6-5	TRBJ1-5
TGTGCCAGCAGCTCGTTCGGCACAGGGCGGACGAACACCGGGGAGCTGTTTTTT	CASSSFGTGRTNTGELFF	TRBV13	TRBJ2-2
TGTGCCACCAGTGATAGGGGCGGGAGTCGTTCCTACGAGCAGTACTTC	CATSDRGGSRSYEQYF	TRBV24-1	TRBJ2-7
TGTGCCAGCAAGCAGGGGGCATCCCTTTACGAGCAGTACTTC	CASKQGASLYEQYF	TRBV2	TRBJ2-7
TGTGCCAGCAGCCCAGGGTCTAGCGCTGAGAACACCGGGGAGCTGTTTTTT	CASSPGSSAENTGELFF	TRBV6-6	TRBJ2-2
TGTGCCAGCAGCTTAGAAAGAAGGGGATCCGGGGAGCTGTTTTTT	CASSLERRGSGELFF	TRBV7-4	TRBJ2-2
TGTGCCAGCAGTGGCACCGACAGGGGTTCACCCCTCCACTTT	CASSGTDRGSPLHF	TRBV12-3	TRBJ1-6
TGTGCCAGCAGGGAGGTAAAATCCGACTACGAGCAGTACTTC	CASREVKSDYEQYF	TRBV6-2	TRBJ2-7
TGTGCCAGCAGAGGGGGTTTAGACACTGAAGCTTTCTTT	CASRGGLDTEAFF	TRBV6-6	TRBJ1-1
TGTGCCAGCAGCTTAGTTGCAACCGGCTATGGCTACACCTTC	CASSLVATGYGYTF	TRBV11-2	TRBJ1-2
TGTGCCAGCAGTGAAAACAGATACGAGCAGTACTTC	CASSENRYEQYF	TRBV6-1	TRBJ2-7
TGTGCCAGCAGCTTACCGCAACCAGTCCCCGAGACCCAGTACTTC	CASSLPQPVPETQYF	TRBV7-9	TRBJ2-5
TGCAGTGCCGCGGCTCAGCCCCAGCATTTT	CSAAAQPQHF	TRBV20-1	TRBJ1-5
TGTGCCAGCAGTCCCTACAGGGGTACTGGGTACTCTGGAAACACCATATATTTT	CASSPYRGTGYSGNTIYF	TRBV6-2	TRBJ1-3
TGTGCCTGGAGTATCGGACAGCGCGAAGCTTTCTTT	CAWSIGQREAFF	TRBV30	TRBJ1-1
TGTGCCAGCCCAGGGAGGACCTACGAGCAGTACTTC	CASPGRTYEQYF	TRBV27	TRBJ2-7
TGTGCCAGCAGGGTTGTAGGCAGGGTAATAGAACTGGGGGTAAAGACAGATACGCAGTATTTT	CASRVVGRVIELGVKTDTQYF	TRBV28	TRBJ2-3
TGCGCCAGCAGCTTGTGCGTAACAGGGAAGACCGGGGAGCTGTTTTTT	CASSLCVTGKTGELFF	TRBV5-1	TRBJ2-2
TGTGCCAGCAGCTCTCCCCGGGAGGGGGGTGAAGTTTCCTTGAACACTGAAGCTTTCTTT	CASSSPREGGEVSLNTEAFF	TRBV7-4	TRBJ1-1
TGTGCCAGTAGTATTTTACCCGACAGGGGGCCCTACGAGCAGTACTTC	CASSILPDRGPYEQYF	TRBV19	TRBJ2-7
TGTGCCAGCAATCCCGGGAGGCGGTACGAGCAGTACTTC	CASNPGRRYEQYF	TRBV9	TRBJ2-7
TGTGCCAGCAGTTATTCTTGGGTGGCCTACGAGCAGTACTTC	CASSYSWVAYEQYF	TRBV6-9	TRBJ2-7
TGTGCCAGCAGCTTAGAGATTTCACAGCCCCAGCATTTT	CASSLEISQPQHF	TRBV11-2	TRBJ1-5
TGTGCCAGCGGAGGGGCAGGAGGTGGGCCAGATACGCAGTATTTT	CASGGAGGGPDTQYF	TRBV9	TRBJ2-3
TGTGCCACCAGTGATTTAGACCCGACCCCCGGGACAGGGTCGTACCAAGAGACCCAGTACTTC	CATSDLDPTPGTGSYQETQYF	TRBV24-1	TRBJ2-5
TGTGCCACCAGTGAGACAGGGGTTAAAGCATGCAATCAGCCCCAGCATTTT	CATSETGVKACNQPQHF	TRBV24-1	TRBJ1-5
TGTGCCAGCAGGGGAGGGTCTAACACCGGGGAGCTGTTTTTT	CASRGGSNTGELFF	TRBV28	TRBJ2-2
TGTGCCAGCAGCCAAGAACCCAGTAGACCGGGGATCTCTGGAAACACCATATATTTT	CASSQEPSRPGISGNTIYF	TRBV3-1	TRBJ1-3
TGTGCCAGCAGCTTGGACGGGGGAGGGGCCATTTGCTATGGCTACACCTTC	CASSLDGGGAICYGYTF	TRBV5-4	TRBJ1-2
TGTGCCAGCATCATAGGGGAGATAAGCTATGGCTACACCTTC	CASIIGEISYGYTF	TRBV2	TRBJ1-2
TGTGCCAGAACTAGCGGGGGTCAGCAGTACTTC	CARTSGGQQYF	TRBV14	TRBJ2-7
TGTGCCTGGAGTGTACCCGGTGGGGGGGCCTACGAGCAGTACTTC	CAWSVPGGGAYEQYF	TRBV30	TRBJ2-7
TGTGCCAGCAGCTGCGGGCAAGCGGGACATTACAATGAGCAGTTCTTC	CASSCGQAGHYNEQFF	TRBV7-4	TRBJ2-1
TGTGCCAGCAGCCCGGGGACAGCCTACGAGCAGTACTTC	CASSPGTAYEQYF	TRBV14	TRBJ2-7
TGTGCCAGCAGCTTCAACGGGGGGGCCAGCTCCTACAATGAGCAGTTCTTC	CASSFNGGASSYNEQFF	TRBV11-3	TRBJ2-1
TGTGATCCTCGTACTAGCGGGAGGGCGGGGGCAGTAGAGCAGTACTTC	CDPRTSGRAGAVEQYF	TRBV25-1	TRBJ2-7
TGTGCCAGCAGCCAAGAGATGATACCGTGGGCCAACGTCCTGACTTTC	CASSQEMIPWANVLTF	TRBV4-2	TRBJ2-6
TGTGCCTGCGACCCTAACGAATACAATGAGCAGTTCTTC	CACDPNEYNEQFF	TRBV30	TRBJ2-1
TGTGCCAGCAGCTTGGGCCGTCGGGGCAAGCGTGGGGGGGGCTACGAGCAGTACTTC	CASSLGRRGKRGGGYEQYF	TRBV5-8	TRBJ2-7
TGCAGCGCACTAGCGGGAGCAAGCTCCTACGAGCAGTACTTC	CSALAGASSYEQYF	TRBV29-1	TRBJ2-7
TGTGCCAGCAGCTTAGTTGGGACGGAATGGGGAAACACCATATATTTT	CASSLVGTEWGNTIYF	TRBV7-9	TRBJ1-3
TGTGCCACCAGTGATGCTCGAGCCCTCCACTTT	CATSDARALHF	TRBV24-1	TRBJ1-6
TGTGCCAGCAGTCACCACGCCCGCGATACGCAGTATTTT	CASSHHARDTQYF	TRBV6-4	TRBJ2-3
TGTGCCACCGGCAGGGGGGTCTCTCGAGATGAGCAGTTCTTC	CATGRGVSRDEQFF	TRBV19	TRBJ2-1
TGTGCCTCCCCTTGGTTAGACAGGGAAGTCACCTTC	CASPWLDREVTF	TRBV30	TRBJ1-2
TGTGCCAGCAAGTTAGTTCCCCCCGGGACTAGGCTAGATACGCAGTATTTT	CASKLVPPGTRLDTQYF	TRBV6-4	TRBJ2-3
TGTGCCAGCAGTGAAGCGAGAGTTGTGTACGAGCAGTACTTC	CASSEARVVYEQYF	TRBV6-1	TRBJ2-7
TGTGCCAGCGGGGGACAGCTTTCAGAGACCCAGTACTTC	CASGGQLSETQYF	TRBV27	TRBJ2-5
TGTGCCAGCTCACGCAGCCCTAAAGGGGATACGCAGTATTTT	CASSRSPKGDTQYF	TRBV18	TRBJ2-3
TGCGCCAGCTGGGACTGCTCTAGCTCCTACAATGAGCAGTTCTTC	CASWDCSSSYNEQFF	TRBV10-1	TRBJ2-1
TGCAGCGCCAGTAACTTTCCCGGGACTCCAACCACCTACAATGAGCAGTTCTTC	CSASNFPGTPTTYNEQFF	TRBV29-1	TRBJ2-1
TGCAGTGCTCCGGACCATTCCGCCCTCCACTTT	CSAPDHSALHF	TRBV20-1	TRBJ1-6
TGTGCCAGCAGCCAAGTAAGACATTCCTACGAGCAGTACTTC	CASSQVRHSYEQYF	TRBV3-1	TRBJ2-7
TGTGCCAACGACAGGGGGGCCGAGTCCTATAATTCACCCCTCCACTTT	CANDRGAESYNSPLHF	TRBV7-2	TRBJ1-6
TGCGCCAGCAGCTTGACTCTCGACAGGGTTCAGACTGGAAACACCATATATTTT	CASSLTLDRVQTGNTIYF	TRBV5-1	TRBJ1-3
TGTGCCAGCAGCCAAATAAGGGAGGGTCAGCCCCAGCATTTT	CASSQIREGQPQHF	TRBV14	TRBJ1-5
TGTGCCAGTAGTGTCCCCCAGGGGAAACCTGGGGCCAACGTCCTGACTTTC	CASSVPQGKPGANVLTF	TRBV19	TRBJ2-6
TGTGCCAGCAGCCTTCAGGGGGGACCCTACGAGCAGTACTTC	CASSLQGGPYEQYF	TRBV13	TRBJ2-7
TGTGCCACCAGCAGAGATTTCTGGACTAGCGGCTTC	CATSRDFWTSGF	TRBV15	TRBJ2-7
TGTGCCAGCAAGAGACCCAATCAGCCCCAGCATTTT	CASKRPNQPQHF	TRBV6-4	TRBJ1-5
TGTGCCAGCAGCCTCAGGGCTAGACAGGGCCTAGGAAAAACTAATCAGCCCCAGCATTTT	CASSLRARQGLGKTNQPQHF	TRBV13	TRBJ1-5
TGTGCCAGCAGGGACAGGGATCCATGCAATCAGCCCCAGCATTTT	CASRDRDPCNQPQHF	TRBV5-6	TRBJ1-5
TGCGCCATAGGGACCTATGGCTACACCTTC	CAIGTYGYTF	TRBV10-1	TRBJ1-2
TGTGCCAGCAATAGCGACGGATACAATGAGCAGTTCTTC	CASNSDGYNEQFF	TRBV6-4	TRBJ2-1
TGTGCCAGCAGCTCAAGGGATGGGGGCGCCGGGGTGGGCTACACCTTC	CASSSRDGGAGVGYTF	TRBV7-9	TRBJ1-2
TGCGCCAGCAGTGCCCTACAGTACCAAGAGACCCAGTACTTC	CASSALQYQETQYF	TRBV10-1	TRBJ2-5
TGTGCCAGCAGTGAGACAGGGGGATTAAACACCATATATTTT	CASSETGGLNTIYF	TRBV6-4	TRBJ1-3
TGTGCCAGCAGCTCCGTTTTTTTGGGGGGGGGGATCAATGAGCAGTTCTTC	CASSSVFLGGGINEQFF	TRBV13	TRBJ2-1
TGTGCCAGCTCACCAGGGGGGGACTCTAGCAATCAGCCCCAGCATTTT	CASSPGGDSSNQPQHF	TRBV18	TRBJ1-5
TGTGCCAGCAGTATCAGTTCCAAGGGCTACACCTTC	CASSISSKGYTF	TRBV12-4	TRBJ1-2
TGTGCCAGAATCCCCAGGGCTAAGCCTGGGGCCAACGTCCTGACTTTC	CARIPRAKPGANVLTF	TRBV27	TRBJ2-6
TGCGCCAGCACCAAGCGGGACGAAAACACCGGGGAGCTGTTTTTT	CASTKRDENTGELFF	TRBV10-1	TRBJ2-2
TGTGCCACCCTGACAGGGGCAAAACTGTTTTTT	CATLTGAKLFF	TRBV27	TRBJ1-4
TGTGCCAGTAGTCAGGGAGAGGGGGCGGGCTCTAACTATGGCTACACCTTC	CASSQGEGAGSNYGYTF	TRBV19	TRBJ1-2
TGCGCCAGCAGCCGGGGGCGGGGGGGGCATCACTACGAGCAGTACTTC	CASSRGRGGHHYEQYF	TRBV4-1	TRBJ2-7
TGTGCCAGCAGTGAACCCAGGGGGATGATCATGAACACTGAAGCTTTCTTT	CASSEPRGMIMNTEAFF	TRBV6-1	TRBJ1-1
TGTGCCAGCAAAAAGTTGAGACAGCCCCAGCATTTT	CASKKLRQPQHF	TRBV12-3	TRBJ1-5
TGTGCCACCAGTGCGCTGTCGACTATGGGGGATGGCTACACCTTC	CATSALSTMGDGYTF	TRBV24-1	TRBJ1-2
TGTGCCAGTAGTATCATCTGTTCACCCCTCCACTTT	CASSIICSPLHF	TRBV19	TRBJ1-6
TGCAGTGCTAGAGTGACGGACCGGGACCCCCACGAGCAGTACTTC	CSARVTDRDPHEQYF	TRBV20-1	TRBJ2-7
TGTGCCAGGCCTTGGGGGCTCGGCTATGGCTACACCTTC	CARPWGLGYGYTF	TRBV28	TRBJ1-2
TGTGCCAGCAGCATCAAGCTAAGACCCGGGGGTGCTCATCAGCCCCAGCATTTT	CASSIKLRPGGAHQPQHF	TRBV11-2	TRBJ1-5
TGTGCCAGCAGTCACAGGGGTTCAGAAGCTTTCTTT	CASSHRGSEAFF	TRBV5-6	TRBJ1-1
TGTGCCAGCAGTTGCCACTCAGGGGGGTTCTATAATTCACCCCTCCACTTT	CASSCHSGGFYNSPLHF	TRBV12-3	TRBJ1-6
TGCAGCGTTGGCAGTTTGGGGCGAAATTCACCCCTCCACTTT	CSVGSLGRNSPLHF	TRBV29-1	TRBJ1-6
TGTGCCAGCAGCTCGGAAATGGAATACCGGGAGTTGGCCTACGAGCAGTACTTC	CASSSEMEYRELAYEQYF	TRBV5-6	TRBJ2-7
TGTGCCACCAGTGATTTGCGTAGGTGGGGCGACGAGCAGTACTTC	CATSDLRRWGDEQYF	TRBV24-1	TRBJ2-7
TGCAGTGCTAGAGATCCAGCCCCGATATCCTACAATGAGCAGTTCTTC	CSARDPAPISYNEQFF	TRBV20-1	TRBJ2-1
TGTGCCAGCAGTTACTCGAAGGACAGGGGGCCGGGTACAGATACGCAGTATTTT	CASSYSKDRGPGTDTQYF	TRBV6-5	TRBJ2-3
TGTGCCAGCAGTTTCACCTCCTACAATGAGCAGTTCTTC	CASSFTSYNEQFF	TRBV12-4	TRBJ2-1
TGTGCCACCAGTGACAAAGGGAGGGGGAATCGACGCACTGAAGCTTTCTTT	CATSDKGRGNRRTEAFF	TRBV24-1	TRBJ1-1
TGCGCCAGCAGCCTCCTCCGGAGGCTATGGCGGTACAATGAGCAGTTCTTC	CASSLLRRLWRYNEQFF	TRBV5-1	TRBJ2-1
TGTGCCAGCTCACCACGTTGGGCCCGTGGAGGGGGGACCTACAATGAGCAGTTCTTC	CASSPRWARGGGTYNEQFF	TRBV18	TRBJ2-1
TGTGCCAGCTCACTAGGGAGTGGAAATGAGCAGTTCTTC	CASSLGSGNEQFF	TRBV18	TRBJ2-1
TGCAGCGCGTCGGGTAGCGAGACCCAGTACTTC	CSASGSETQYF	TRBV29-1	TRBJ2-5
TGCAAAGATGACAACGGGGGACATCAGCCCCAGCATTTT	CKDDNGGHQPQHF	TRBV20-1	TRBJ1-5
TGTGCCAGCAGCTTAACTTACAAGAATATCAGCCACTACGAGCAGTACTTC	CASSLTYKNISHYEQYF	TRBV7-2	TRBJ2-7
TGTGCCAGCACCGACAGGGTAATCTACACCTTC	CASTDRVIYTF	TRBV2	TRBJ1-2
TGCAGTGCCCCCCGGGACGGAGCTTTCTTT	CSAPRDGAFF	TRBV20-1	TRBJ1-1
TGTGCCAGCAGTGTTTGGGGACAGGGAAAGGGGGAGTCCTACGAGCAGTACTTC	CASSVWGQGKGESYEQYF	TRBV6-4	TRBJ2-7
TGCGCCAGGCGCAGGGGAGGCTATGGCTACACCTTC	CARRRGGYGYTF	TRBV10-1	TRBJ1-2
TGTGCCAGCAGTGCAGGGTCCTCTGGAAACACCATATATTTT	CASSAGSSGNTIYF	TRBV2	TRBJ1-3
TGCGCCAGCAGCGGGCCACGAGGGGATAATCAGCCCCAGCATTTT	CASSGPRGDNQPQHF	TRBV5-1	TRBJ1-5
TGTGCCAGCACGGGGACGTTTCTTGCTAATGAAAAACTGTTTTTT	CASTGTFLANEKLFF	TRBV6-3	TRBJ1-4
TGTGCCAGCAGCTTCCCGGGGGCGGAGCACTACGAGCAGTACTTC	CASSFPGAEHYEQYF	TRBV7-2	TRBJ2-7
TGTGCCAGCCAAGTACGGGGCAGGAGGGGTGAAGCTTTCTTT	CASQVRGRRGEAFF	TRBV27	TRBJ1-1
TGTGCCACCCCCACCCCCCCTTCAGGTGCGGCTTTCTTT	CATPTPPSGAAFF	TRBV24-1	TRBJ1-1
TGTGCCACAGTCAGTACAAAGTTGCCCCAGCATTTT	CATVSTKLPQHF	TRBV7-9	TRBJ1-5
TGTGCCAGCCGCGGGAGCCGCTCAGAGACCCAGTACTTC	CASRGSRSETQYF	TRBV12-3	TRBJ2-5
TGCAGTGCTAGAGTAAGCAATGAGGAGACCCAGTACTTC	CSARVSNEETQYF	TRBV20-1	TRBJ2-5
TGTGCCAGCAGCAATAAGAAGGTGGACTCTGGAAACACCATATATTTT	CASSNKKVDSGNTIYF	TRBV7-3	TRBJ1-3
TGTGCTAGTGGTTTGGCCCACAGGGGGACCGGGGAGCTGTTTTTT	CASGLAHRGTGELFF	TRBV12-5	TRBJ2-2
TGTGCCAGCAGCCAAGAAGGGGGGGTGGCCGGCTACACCTTC	CASSQEGGVAGYTF	TRBV3-1	TRBJ1-2
TGTGCCAGCACTCGAGGGACTAGCGACCTAAAAAGTGAGCAGTTCTTC	CASTRGTSDLKSEQFF	TRBV27	TRBJ2-1
TGTGCCAGCAGCCAAGACCCGGTCGACTCCTACGAGCAGTACTTC	CASSQDPVDSYEQYF	TRBV4-2	TRBJ2-7
TGTGCCAGCAGTTACGGGGGGCCCTACGAGCAGTACTTC	CASSYGGPYEQYF	TRBV6-2	TRBJ2-7
TGTGCCAGCAGTGATTATCGGGGGGCCGGGACTAGCACAGATACGCAGTATTTT	CASSDYRGAGTSTDTQYF	TRBV25-1	TRBJ2-3
TGTGCCTGGAGTCTACTGGGTAATTCACCCCTCCACTTT	CAWSLLGNSPLHF	TRBV30	TRBJ1-6
TGCGCCAATAAGCTGACCCTGTTTTTT	CANKLTLFF	TRBV10-1	TRBJ1-4
TGTGCCAGCAGGAGGGAGTCCTACGAGCAGTACTTC	CASRRESYEQYF	TRBV5-4	TRBJ2-7
TGCGCCAGCAGTGAGTCTCTGAGTGACAGTCCAGATACGCAGTATTTT	CASSESLSDSPDTQYF	TRBV10-1	TRBJ2-3
TGTGCCAGCAGCGAGGCTTCGGGGCGCAACAATCAGCCCCAGCATTTT	CASSEASGRNNQPQHF	TRBV11-3	TRBJ1-5
TGTGCCAGCAGTACACAGGGGGGGTATAGCAATCAGCCCCAGCATTTT	CASSTQGGYSNQPQHF	TRBV27	TRBJ1-5
TGTGCCAGCTCACCACGGAGAGAAGGCACAGATACGCAGTATTTT	CASSPRREGTDTQYF	TRBV18	TRBJ2-3
TGTGCCAGTACAGGGGCCGGTACTGAAGCTTTCTTT	CASTGAGTEAFF	TRBV2	TRBJ1-1
TGTGCCTGGAGTCCGAAATCCGACAATGAGCAGTTCTTC	CAWSPKSDNEQFF	TRBV30	TRBJ2-1
TGCGCCAGCAGCCAAGATACCCCCTACGACTCCGGGGAGCTGTTTTTT	CASSQDTPYDSGELFF	TRBV4-1	TRBJ2-2
TGTGCCACACTAGCGGGAGAGTACCTGGGCGAGCAGTACTTC	CATLAGEYLGEQYF	TRBV13	TRBJ2-7
TGCAGTGCTAGAGACCTCGGGGTTAGAGGTGAGCAGTTCTTC	CSARDLGVRGEQFF	TRBV20-1	TRBJ2-1
TGTGCCAGCAGTTTATATGGGGCACCTAAGGTAGCCAAAAACATTCAGTACTTC	CASSLYGAPKVAKNIQYF	TRBV27	TRBJ2-4
TGTGCCTGGAGTGGGACAGGATATAGCAATCAGCCCCAGCATTTT	CAWSGTGYSNQPQHF	TRBV30	TRBJ1-5
TGTGCCAGCAGCCGCTACCGGGACCTCACTGAAGCTTTCTTT	CASSRYRDLTEAFF	TRBV7-3	TRBJ1-1
TGTGCCAGCAGCGACGACAGGGATGAGCAGTTCTTC	CASSDDRDEQFF	TRBV11-3	TRBJ2-1
TGTGCCAGTAGTAGGGGGGTAAACATTCAGTACTTC	CASSRGVNIQYF	TRBV19	TRBJ2-4
TGTGCTAGTGGTCCTGACTACTATGGCTACACCTTC	CASGPDYYGYTF	TRBV12-5	TRBJ1-2
TGCGCCAGCCCTCAGGGGATATATTTT	CASPQGIYF	TRBV5-1	TRBJ1-3
TGTGCCAGCAGCAGGGGGAGTCACACTGAAGCTTTCTTT	CASSRGSHTEAFF	TRBV13	TRBJ1-1
TGTGCCAGCAGCCTCACGCTTTATAGCAATCAGCCCCAGCATTTT	CASSLTLYSNQPQHF	TRBV7-3	TRBJ1-5
TGCAGTGCGTGGACTACGGCTGGGGCCAACGTCCTGACTTTC	CSAWTTAGANVLTF	TRBV20-1	TRBJ2-6
TGTGCCAGCGACGTAATTTTGGGGGGAGGGCCCGGAGCGGATAGCAATCAGCCCCAGCATTTT	CASDVILGGGPGADSNQPQHF	TRBV27	TRBJ1-5
TGCAGCAATAGGGTGGGCCACGAGCAGTACTTC	CSNRVGHEQYF	TRBV29-1	TRBJ2-7
TGTGCCAGCAGTATTATAGATACCCGCAATCAGCCCCAGCATTTT	CASSIIDTRNQPQHF	TRBV6-1	TRBJ1-5
TGTGCCAGCAGTGGACAGGAGGACCACCGAGCTTACTACGAGCAGTACTTC	CASSGQEDHRAYYEQYF	TRBV6-5	TRBJ2-7
TGCAGTGCCGTTAAAATACCTTATGAGATGTCGGATGAGCAGTTCTTC	CSAVKIPYEMSDEQFF	TRBV20-1	TRBJ2-1
TGTGCCAGCAGTGAACACGGGTTCACAGATACGCAGTATTTT	CASSEHGFTDTQYF	TRBV2	TRBJ2-3
TGCGCCAGGGGACCAGAGTCTAACTATGGCTACACCTTC	CARGPESNYGYTF	TRBV10-1	TRBJ1-2
TGTGCCAGTCAAGGAAAGACAGGGCCAGCCTATGGCTACACCTTC	CASQGKTGPAYGYTF	TRBV6-1	TRBJ1-2
TGTGCCAGCAGCTTGGGGGGGGGGGCCGACTACGAGCAGTACTTC	CASSLGGGADYEQYF	TRBV5-6	TRBJ2-7
TGCAGTGCTAGAGATCGGTTGGCTGCTTACACCGGGGAGCTGTTTTTT	CSARDRLAAYTGELFF	TRBV20-1	TRBJ2-2
TGTGCCAGCAGCTTCATAGTCGGGGAGCTGTTTTTT	CASSFIVGELFF	TRBV5-4	TRBJ2-2
TGTGCCAGCAGCGTAAACCCATATCCCCAGAGGAACACTGAAGCTTTCTTT	CASSVNPYPQRNTEAFF	TRBV9	TRBJ1-1
TGTGCTAGTGGTTCCAATAAGGGGAGTACCTTCGGCGGTGTTCCCTACGAGCAGTACTTC	CASGSNKGSTFGGVPYEQYF	TRBV12-5	TRBJ2-7
TGTGCCACCAGCAGAGGATTTAATCGGGTTAATGAACTGCAGGGCGAGCAGTACTTC	CATSRGFNRVNELQGEQYF	TRBV15	TRBJ2-7
TGTGCCAGCAGCTTTCGCAGAAGACTTACGGCCTCCTACGAGCAGTACTTC	CASSFRRRLTASYEQYF	TRBV7-4	TRBJ2-7
TGTGCCATCTCCCCCGGGACTAGCGGTTTCCAAGAGACCCAGTACTTC	CAISPGTSGFQETQYF	TRBV10-3	TRBJ2-5
TGTGCCAGCAGCCTTTTAGGGAACACCGGGGAGCTGTTTTTT	CASSLLGNTGELFF	TRBV11-2	TRBJ2-2
TGTGCCAGCAGCTTTGGCCGGGACAGGGGTAATTCACCCCTCCACTTT	CASSFGRDRGNSPLHF	TRBV7-9	TRBJ1-6
TGTGCCAGTAGTATCAGCGGGAGCTACAATGAGCAGTTCTTC	CASSISGSYNEQFF	TRBV19	TRBJ2-1
TGTGCCTGGAGCAGGGCGCATTACGAGCAGTACTTC	CAWSRAHYEQYF	TRBV30	TRBJ2-7
TGTGCCTGGAAACAAGGCTACGAGCAGTACTTC	CAWKQGYEQYF	TRBV30	TRBJ2-7
TGTGCCAGTCCTTCCGGGGGCACCATATATTTT	CASPSGGTIYF	TRBV6-3	TRBJ1-3
TGCAGTGCTAGCATCCGGACTAGGGATGACTACAATGAGCAGTTCTTC	CSASIRTRDDYNEQFF	TRBV20-1	TRBJ2-1
TGTGCCAGCAGAGCCTCTCGAGGGGGGGGGCTCTCCTACGAGCAGTACTTC	CASRASRGGGLSYEQYF	TRBV11-2	TRBJ2-7
TGTGCCAGCAGCCACAAACGCCGGGACAGGGCATGCACAGATACGCAGTATTTT	CASSHKRRDRACTDTQYF	TRBV6-1	TRBJ2-3
TGCAGTGCTAGTATAAAGGGACAGGCCGTAAGCAATCAGCCCCAGCATTTT	CSASIKGQAVSNQPQHF	TRBV20-1	TRBJ1-5
TGTGCCACCAGGGCTCGCGACAGGGGGGGACCCCTCCACTTT	CATRARDRGGPLHF	TRBV24-1	TRBJ1-6
TGCGCCAGCAGAAACAGCGGGAAACGAAGCTCCTACGAGCAGTACTTC	CASRNSGKRSSYEQYF	TRBV5-1	TRBJ2-7
TGCGCCAGCAGCACTCGGTGGGGACAGAACTATGGCTACACCTTC	CASSTRWGQNYGYTF	TRBV5-1	TRBJ1-2
TGTGCCAGTAGTATCAACCGGGGGCGCAATCAGCCCCAGCATTTT	CASSINRGRNQPQHF	TRBV19	TRBJ1-5
TGTGCCACCCAGCGATGGCCTCCAGTAGACTCCTACGAGCAGTACTTC	CATQRWPPVDSYEQYF	TRBV7-8	TRBJ2-7
TGTGCCAGCAGCTCAATCCGAAGGACGAAAGTCGCAAACTACGAGCAGTACTTC	CASSSIRRTKVANYEQYF	TRBV7-9	TRBJ2-7
TGTGCCAGCAGTTTTCTTTCGGGAGGTCGGAGCTCCTACAATGAGCAGTTCTTC	CASSFLSGGRSSYNEQFF	TRBV27	TRBJ2-1
TGTGCCAGCAGTGGTTGGACTAGCGGGAGTGGTAGGCTGGGCCATGAGCAGTTCTTC	CASSGWTSGSGRLGHEQFF	TRBV12-3	TRBJ2-1
TGCAGTGCTAGAGTCGGCGGGGGACGCAACGTGTGGGATAACACCGGGGAGCTGTTTTTT	CSARVGGGRNVWDNTGELFF	TRBV20-1	TRBJ2-2
TGTGCCAGCAGCGGAGGGAAGGGACTAGCGGGTTGGAATAACACCGGGGAGCTGTTTTTT	CASSGGKGLAGWNNTGELFF	TRBV3-1	TRBJ2-2
TGCAGTTCTTGGGGACCTATCGCCCCCCCGAACACTGAAGCTTTCTTT	CSSWGPIAPPNTEAFF	TRBV20-1	TRBJ1-1
TGTGCCAGCAGGGGGTTCGGGAACGAGCAGTACTTC	CASRGFGNEQYF	TRBV6-5	TRBJ2-7
TGTGCCCCCACCGAGGGCACTGAAGCTTTCTTT	CAPTEGTEAFF	TRBV11-2	TRBJ1-1
TGTGCCAGCAGTACTGGAGGACAGCGGCAGCCCCAGCATTTT	CASSTGGQRQPQHF	TRBV27	TRBJ1-5
TGTGCCAGCAGAAGACTTAGGGACCCCACTGAAGCTTTCTTT	CASRRLRDPTEAFF	TRBV7-9	TRBJ1-1
TGTGCCAGCAGCTGTAAACTAGCGGGAGACGAGCAGTACTTC	CASSCKLAGDEQYF	TRBV7-2	TRBJ2-7
TGTGCCAGCAGTTTAATGGGCATCTACACCTTC	CASSLMGIYTF	TRBV28	TRBJ1-2
TGTGCCAGCAGTTTATTACAGCCAGGGGCTTCGTGCGGGGAGCTGTTTTTT	CASSLLQPGASCGELFF	TRBV6-5	TRBJ2-2
TGTGCCAGTTCCGGACACGAGCAGTACTTC	CASSGHEQYF	TRBV19	TRBJ2-7
TGTGCCAGCAGCATGGGACTAGTTGATCAAGAGACCCAGTACTTC	CASSMGLVDQETQYF	TRBV13	TRBJ2-5
TGTGCCAGCAGTTTTCAAACTTACGAGCAGTACTTC	CASSFQTYEQYF	TRBV6-1	TRBJ2-7
TGTGCCGTGGACAGGGGTTATGGCTACACCTTC	CAVDRGYGYTF	TRBV25-1	TRBJ1-2
TGTGCCAGCAGTGATGGCAGGGAGTGCTACACCTTC	CASSDGRECYTF	TRBV2	TRBJ1-2
TGTGCCAGCAGCTTAGCCCCCGGGACAGCCCACACTGAAGCTTTCTTT	CASSLAPGTAHTEAFF	TRBV11-1	TRBJ1-1
TGTGCCAGCAGTTACCCCAATACAAGTTACCAGACAACTTCACCCCTCCACTTT	CASSYPNTSYQTTSPLHF	TRBV6-5	TRBJ1-6
TGCAGTGCTGTCCAGGGGGACAAACACACCTTC	CSAVQGDKHTF	TRBV20-1	TRBJ1-2
TGCGCCAGCAGCCGGTCAGGCCGGGGGGTCATTCAGTACTTC	CASSRSGRGVIQYF	TRBV4-1	TRBJ2-4
TGTGCCAGCAGTGGTAGGCCCGGCTCAAAGTACTTC	CASSGRPGSKYF	TRBV27	TRBJ2-7
TGTGCCACCAGTCTGGGGGACACCGGGGAGCTGTTTTTT	CATSLGDTGELFF	TRBV24-1	TRBJ2-2
TGCAGTGCTAGCTTCCGGCGGGAGTACGAGCAGTACTTC	CSASFRREYEQYF	TRBV20-1	TRBJ2-7
TGTGCCAGCAGTTGCCTTCCACCGGCCTACGAGCAGTACTTC	CASSCLPPAYEQYF	TRBV6-5	TRBJ2-7
TGTGCTAGTGGTTTGGTACCGTTTATTAGGGCGATACGACAGGGGAATCAGCCCCAGCATTTT	CASGLVPFIRAIRQGNQPQHF	TRBV12-5	TRBJ1-5
TGTGCCAGCAGTGAAGCCGACAGGGCCAGCTCCTATAATTCACCCCTCCACTTT	CASSEADRASSYNSPLHF	TRBV6-1	TRBJ1-6
TGTGCCAGCAGCATCCGGACAGGGTCCTATAATTCACCCCTCCACTTT	CASSIRTGSYNSPLHF	TRBV9	TRBJ1-6
TGTGCCAGCAGCGGGAATCGAACTTGCGGGAGGTCCCGGGAGACCCAGTACTTC	CASSGNRTCGRSRETQYF	TRBV13	TRBJ2-5
TGCGCCAGTGGGGAAAGGGACAATGAGCAGTTCTTC	CASGERDNEQFF	TRBV10-1	TRBJ2-1
TGTGCCAGCAGTTCCCCGTTATTGGGACAGGGATGCCCGAACACTGAAGCTTTCTTT	CASSSPLLGQGCPNTEAFF	TRBV28	TRBJ1-1
TGTGCCAGCAGTGATGCTTCGGGGGACAGGGAGACCACTGAAGCTTTCTTT	CASSDASGDRETTEAFF	TRBV6-6	TRBJ1-1
TGCAGCGATTGGACAGGCAATACGCAGTATTTT	CSDWTGNTQYF	TRBV29-1	TRBJ2-3
TGCGCCAGCAGCGGGGACCGGGGTGGCTACACCTTC	CASSGDRGGYTF	TRBV5-1	TRBJ1-2
TGCAGTGCTAGAGAACGACAGGGTTACACAGATACGCAGTATTTT	CSARERQGYTDTQYF	TRBV20-1	TRBJ2-3
TGTGCCAGCAGCTTTTTCGACAGGGGGGGGTACTTC	CASSFFDRGGYF	TRBV7-2	TRBJ2-5
TGTGCGCCAACGGGACAGGGGGAAACAGATACGCAGTATTTT	CAPTGQGETDTQYF	TRBV7-7	TRBJ2-3
TGTGCCTGGAGGGGGGCGTTATGGGAGGGTTTCTTC	CAWRGALWEGFF	TRBV30	TRBJ2-1
TGTGCCAGCATTGGAGGATCCATATATCAGCCCCAGCATTTT	CASIGGSIYQPQHF	TRBV27	TRBJ1-5
TGTGCCAGTAGTATACGAGCCCGGACTAGCCAAGAGACCCAGTACTTC	CASSIRARTSQETQYF	TRBV19	TRBJ2-5
TGTGCCAGCAGCTTCGATCCCTACGAGCAGTACTTC	CASSFDPYEQYF	TRBV5-6	TRBJ2-7
TGTGCCAGCAGCTTAACGTGCCTTGTGGACAGTAAGGCCTACGAGCAGTACTTC	CASSLTCLVDSKAYEQYF	TRBV11-2	TRBJ2-7
TGTGCCATCAGTGGACTTGAGAGCACAGATACGCAGTATTTT	CAISGLESTDTQYF	TRBV10-3	TRBJ2-3
TGTGCCACCAGGGGCGAGGGTAAGGTTGAGCAGTTCTTC	CATRGEGKVEQFF	TRBV24-1	TRBJ2-1
TGTGCCAGCAGCTTGGGGGTAAACTATGGCTACACCTTC	CASSLGVNYGYTF	TRBV7-2	TRBJ1-2
TGCGCCAGCCCGACTCAGGATACGCAGTATTTT	CASPTQDTQYF	TRBV5-1	TRBJ2-3
TGTGCCAGTAGTATAGGACCCTACAATGAGCAGTTCTTC	CASSIGPYNEQFF	TRBV19	TRBJ2-1
TGTGCCAGTAGTCCCGTCCCTCCGAGCGACAATTGCACAGATACGCAGTATTTT	CASSPVPPSDNCTDTQYF	TRBV19	TRBJ2-3
TGTGCCAGCAGCCGGCCCAGGGGTTACTATGGCTACACCTTC	CASSRPRGYYGYTF	TRBV4-2	TRBJ1-2
TGCGCCAGCAGCCGGGCTTCCCCGGGACAAACGCCGTCACCAGGCAACTATGGCTACACCTTC	CASSRASPGQTPSPGNYGYTF	TRBV5-1	TRBJ1-2
TGTGCCACAAGTCATGAAGCGGGGGCCAGAAGTGGTAAGAGGTACGAGCAGTACTTC	CATSHEAGARSGKRYEQYF	TRBV10-3	TRBJ2-7
TGTGCCAGCAGCCGTTTGGGGGACACTGAAGCTTTCTTT	CASSRLGDTEAFF	TRBV14	TRBJ1-1
TGTGCCAGCAGCCCACAGTTGGACACCTTC	CASSPQLDTF	TRBV13	TRBJ1-2
TGTGCCAGCAGGGGCCTCCAGGGCCTCAACACTGAAGCTTTCTTT	CASRGLQGLNTEAFF	TRBV12-4	TRBJ1-1
TGTGCCAGCAGGGGCCCCGCCTTCCCGACTAGCTACGAGCAGTACTTC	CASRGPAFPTSYEQYF	TRBV5-6	TRBJ2-7
TGTGCCAGCACAGACACCCGCGGAACCCGGGAAGAGACCCAGTACTTC	CASTDTRGTREETQYF	TRBV2	TRBJ2-5
TGTGCCAGCAGCGTACGATACGAGCAGTACTTC	CASSVRYEQYF	TRBV9	TRBJ2-7
TGTGCCAGCCAAGGCCGGGACTCTAATGAGCAGTTCTTC	CASQGRDSNEQFF	TRBV11-3	TRBJ2-1
TGTGCCACCGAAGGACTAGCGGTCAATGAGCAGTTCTTC	CATEGLAVNEQFF	TRBV15	TRBJ2-1
TGTGCCAGCAGCAGAAACCTAGCGGGAGGGGCCAAAAACATTCAGTACTTC	CASSRNLAGGAKNIQYF	TRBV5-6	TRBJ2-4
TGTGCCAGCAGCTCAGTTGGGACAGGGATTATCTACGAGCAGTACTTC	CASSSVGTGIIYEQYF	TRBV27	TRBJ2-7
TGTGCCAGCAGTGTTCGGGACACCCAACCGGGACAGGGGGGAACTGAAGCTTTCTTT	CASSVRDTQPGQGGTEAFF	TRBV25-1	TRBJ1-1
TGTGCCAGCAGCTTGGGATATCCTAGCGGGATGTCAGGTAACTATGGCTACACCTTC	CASSLGYPSGMSGNYGYTF	TRBV5-6	TRBJ1-2
TGTGCCAGTAAAGTCGACACAAAGGGAGTCCCTACTGAAGCTTTCTTT	CASKVDTKGVPTEAFF	TRBV19	TRBJ1-1
TGTGCCAGCAGTTTACCCTTGGGCCTAATGGCAGATACGCAGTATTTT	CASSLPLGLMADTQYF	TRBV27	TRBJ2-3
TGTGCCAGCAGTGAAAAACCTTGGCCAGCCGAGACCCAGTACTTC	CASSEKPWPAETQYF	TRBV6-1	TRBJ2-5
TGTGCCAGCAGGCGTGAGGGTACAGGGCCCAAACGAACCTATAATTCACCCCTCCACTTT	CASRREGTGPKRTYNSPLHF	TRBV12-4	TRBJ1-6
TGCGCCAGCACCGTCCCAGGTGTGGTAGTAGCCAAAAACATTCAGTACTTC	CASTVPGVVVAKNIQYF	TRBV4-1	TRBJ2-4
TGTGCCTGGAGTGAAGGGGGGGACATAGCCAAAAACATTCAGTACTTC	CAWSEGGDIAKNIQYF	TRBV30	TRBJ2-4
TGTGCCAGCAGCCAACAACGGGCCCGGCAAGAGACCCAGTACTTC	CASSQQRARQETQYF	TRBV14	TRBJ2-5
TGTGCCAGCAGTGTGGCTCCCGTCCGCAGCGGGACCACAAATGAAAAACTGTTTTTT	CASSVAPVRSGTTNEKLFF	TRBV25-1	TRBJ1-4
TGTGCTAGTGGGAAGGGCGGTCCCTACGAGCAGTACTTC	CASGKGGPYEQYF	TRBV12-5	TRBJ2-7
TGCAGTGCTAGAGGAGGTGAACTGAGGGGTGCAACTAATGAAAAACTGTTTTTT	CSARGGELRGATNEKLFF	TRBV20-1	TRBJ1-4
TGTGCCAGCAGTATAGTAGGGAGCCCTCCGACCCAGTACTTC	CASSIVGSPPTQYF	TRBV6-5	TRBJ2-5
TGTGCCAGCAGGATAGCGGGCTACGAGCAGTACTTC	CASRIAGYEQYF	TRBV5-6	TRBJ2-7
TGCACCGATGCACCTCGGAATCAGCCCCAGCATTTT	CTDAPRNQPQHF	TRBV20-1	TRBJ1-5
TGTGCCAGCAGCTCACGGACAGGAAAAGACTACGAGCAGTACTTC	CASSSRTGKDYEQYF	TRBV5-5	TRBJ2-7
TGTGCCAGCAGTGAACAACCCGACAGTCGCCTAATGGAGCAGTTCTTC	CASSEQPDSRLMEQFF	TRBV6-1	TRBJ2-1
TGCGCCACCCGGCCGGGACAGGGGGGGGACGAGCAGTACTTC	CATRPGQGGDEQYF	TRBV10-1	TRBJ2-7
TGCAGTGGTCGGGCCCCAAAGCCTGGGCAGTACTTC	CSGRAPKPGQYF	TRBV20-1	TRBJ2-7
TGTGCCAGCAGTGGGGACAGGCGGGCCAAAAACATTCAGTACTTC	CASSGDRRAKNIQYF	TRBV28	TRBJ2-4
TGTGCCAGCAGCCTTGGGGGGGCCATTGGCTACGAGCAGTACTTC	CASSLGGAIGYEQYF	TRBV27	TRBJ2-7
TGTGCCAGCAGTTACTCGGACAAGGGCGCTAATCAGCCCCAGCATTTT	CASSYSDKGANQPQHF	TRBV6-6	TRBJ1-5
TGTGCCTGGAGTGCTTTCTCAGGGGCCTACGAGCAGTACTTC	CAWSAFSGAYEQYF	TRBV30	TRBJ2-7
TGTGCCACCAGTGGGAGGACAGACTACGAGCAGTACTTC	CATSGRTDYEQYF	TRBV24-1	TRBJ2-7
TGTGCCAGCAGTTTTTTCTCAGGGACCTGGGAACCCTACGAGCAGTACTTC	CASSFFSGTWEPYEQYF	TRBV12-3	TRBJ2-7
TGTGCCAGCAGACGGGGGGGGGGGAATCAGCCCCAGCATTTT	CASRRGGGNQPQHF	TRBV28	TRBJ1-5
TGCAGTGCTACGCCCCACAGGGACACTGAAGCTTTCTTT	CSATPHRDTEAFF	TRBV20-1	TRBJ1-1
TGTGCCAGCAGCTTATATGGGGGCCGTAATGGACAGGGTAGCAATCAGCCCCAGCATTTT	CASSLYGGRNGQGSNQPQHF	TRBV5-4	TRBJ1-5
TGCGCCAGCAGCCAAATTAACGGGGAAGTGGAGGGGTTCTCCTACAATGAGCAGTTCTTC	CASSQINGEVEGFSYNEQFF	TRBV4-1	TRBJ2-1
TGTGCCAGCAGGCCGGCGTGCGGACAGTGCGGCTACACCTTC	CASRPACGQCGYTF	TRBV12-3	TRBJ1-2
TGCAGTGCTAGAATCTTTCCCAGGGAAGTATTGAACACTGAAGCTTTCTTT	CSARIFPREVLNTEAFF	TRBV20-1	TRBJ1-1
TGTGCCAGTAGTATAGATGATTGGGACAGGGGGTCGTACCAAGAGACCCAGTACTTC	CASSIDDWDRGSYQETQYF	TRBV19	TRBJ2-5
TGTGCCAGCAGCCCGGCAGTGGGGGGTGGAGAGACCCAGTACTTC	CASSPAVGGGETQYF	TRBV7-9	TRBJ2-5
TGTGCCAGCAGCCAGGGGAGCGGAGAGACCCAGTACTTC	CASSQGSGETQYF	TRBV4-2	TRBJ2-5
TGTGCCAGCAGCCATGTTTGGGGGTGGGGCACTGAAGCTTTCTTT	CASSHVWGWGTEAFF	TRBV14	TRBJ1-1
TGCGCCAGCAGCTTGGTCCGAGCTAGGCCCGGGAGGAATGGCTACACCTTC	CASSLVRARPGRNGYTF	TRBV5-1	TRBJ1-2
TGCGCCAGCAAAGCGGACACAGATACGCAGTATTTT	CASKADTDTQYF	TRBV10-1	TRBJ2-3
TGTGCCAGCAGCGACCGGGACAGGGCGTGGCCCCAGCATTTT	CASSDRDRAWPQHF	TRBV7-9	TRBJ1-5
TGTGCCAGAGCTGGTAAAATCGCAGTGCAGGGAGAGACCCAGTACTTC	CARAGKIAVQGETQYF	TRBV19	TRBJ2-5
TGTGCCAGCAGCCCACTTCCGGGACGTACATTTGATACGCAGTATTTT	CASSPLPGRTFDTQYF	TRBV7-9	TRBJ2-3
TGCGCCAGCAGCCCCACTACAAGGGTAAGGGCAGCTGAGTACTTC	CASSPTTRVRAAEYF	TRBV4-3	TRBJ2-7
TGCAACGCCCGAGATGAGCAGTTCTTC	CNARDEQFF	TRBV20-1	TRBJ2-1
TGTGCCGCTCGACTAGGCGTGTGCACAGATACGCAGTATTTT	CAARLGVCTDTQYF	TRBV6-4	TRBJ2-3
TGTGCCAGCAGCCCTACCTCCGGGACTAGCGGGATCCATTCCTACAATGAGCAGTTCTTC	CASSPTSGTSGIHSYNEQFF	TRBV6-6	TRBJ2-1
TGTGCCAGCAGCTCAGCGGGACCCGGGGAGACCCAGTACTTC	CASSSAGPGETQYF	TRBV7-4	TRBJ2-5
TGTGCCAGCAGCTTAGGAGGAGCTTTCTTT	CASSLGGAFF	TRBV16	TRBJ1-1
TGCGCCAGCAGCTCGCGGGAAATGCGGCGCTCCTACGAGCAGTACTTC	CASSSREMRRSYEQYF	TRBV5-1	TRBJ2-7
TGCAGTGCCCCCCCGGGACATTGTGGAAACACCATATATTTT	CSAPPGHCGNTIYF	TRBV20-1	TRBJ1-3
TGCAGTGCGGCGGCAAGCTATGGCTACACCTTC	CSAAASYGYTF	TRBV20-1	TRBJ1-2
TGTGCCAGGGCAGGCTACACCTTC	CARAGYTF	TRBV6-3	TRBJ1-2
TGTGCCAGGGACTCGGCCGACACTGAAGCTTTCTTT	CARDSADTEAFF	TRBV9	TRBJ1-1
TGTGCCAGCAGCTTTGCGCGCGGTTTTGAGCAGTTCTTC	CASSFARGFEQFF	TRBV7-3	TRBJ2-1
TGCGCCAGCAATCAAAAGTCAGAAATTTCAGGTGAAGCTTTCTTT	CASNQKSEISGEAFF	TRBV10-1	TRBJ1-1
TGTGCCAGCAGCTTAGTAAGCCGGGACAGGTATAACTATGGCTACACCTTC	CASSLVSRDRYNYGYTF	TRBV7-6	TRBJ1-2
TGCGCCAGCTCCGGGGTTGGGGCTGGGGCCAACGTCCTGACTTTC	CASSGVGAGANVLTF	TRBV5-1	TRBJ2-6
TGTGCCAGCAGCCGTCCGGGGCAGCGGGAAGATGGCTACACCTTC	CASSRPGQREDGYTF	TRBV4-2	TRBJ1-2
TGTGCCAGCAGCAGCGCGGGGCGCACCTTC	CASSSAGRTF	TRBV7-4	TRBJ1-2
TGCAGTGCCAGGCAGCCCCAGCATTTT	CSARQPQHF	TRBV20-1	TRBJ1-5
TGCGCCAGCTTCTTCCGGGGGGGACAGGCCAATGAGCAGTTCTTC	CASFFRGGQANEQFF	TRBV10-1	TRBJ2-1
TGTGCCAGCAGTTCTAACCCTAGTCGACAGGGGGGGATCGACGAGCAGTACTTC	CASSSNPSRQGGIDEQYF	TRBV12-4	TRBJ2-7
TGTGCCACCAGCAGAACAGATTGTCAGGGGATTGAAAAACTGTTTTTT	CATSRTDCQGIEKLFF	TRBV15	TRBJ1-4
TGTGCCAGCAGCCTAGGACTTAACGACAGGTGGGTATACAATGAGCAGTTCTTC	CASSLGLNDRWVYNEQFF	TRBV7-9	TRBJ2-1
TGTGCCAGCAGCTCCCGGGGGCCGTCCCTAGCCAAAAACATTCAGTACTTC	CASSSRGPSLAKNIQYF	TRBV7-3	TRBJ2-4
TGTGCCAGCAGTTCCCGGGACACGATAAGCACAGATACGCAGTATTTT	CASSSRDTISTDTQYF	TRBV27	TRBJ2-3
TGTGCCAGGAAAAGCAAAAAGGGGGCTGGGGCCAACGTCCTGACTTTC	CARKSKKGAGANVLTF	TRBV25-1	TRBJ2-6
TGTGCCAGCATGTGGACAGGGGGCCCTAATCAGCCCCAGCATTTT	CASMWTGGPNQPQHF	TRBV6-5	TRBJ1-5
TGTGCCAGCAGCGTAGGGAGGGAGGACACAGAGACCCAGTACTTC	CASSVGREDTETQYF	TRBV9	TRBJ2-5
TGCAGTGCTCGCCCGGGGGGGCCTCCGTCCTACGAGCAGTACTTC	CSARPGGPPSYEQYF	TRBV20-1	TRBJ2-7
TGCGCCAGCAGCCAAGCTCCCGGGACAGGGATGAGCGGGGAGCTGTTTTTT	CASSQAPGTGMSGELFF	TRBV4-3	TRBJ2-2
TGTGCCAGCAGCTTGGACGCCGGCACTGAAGCTTTCTTT	CASSLDAGTEAFF	TRBV5-6	TRBJ1-1
TGTGCCAGCAGTGAGGGATTCACTGAAGCTTTCTTT	CASSEGFTEAFF	TRBV6-6	TRBJ1-1
TGCGCCTTCGGCATCACAGATACGCAGTATTTT	CAFGITDTQYF	TRBV4-1	TRBJ2-3
TGCAGTGCTAACGGGAGGGCCTATGAGCAGTTCTTC	CSANGRAYEQFF	TRBV20-1	TRBJ2-1
TGTGCCATAGGACGGACAACTAATGAAAAACTGTTTTTT	CAIGRTTNEKLFF	TRBV6-1	TRBJ1-4
TGTGCCAGCAGCGTAGACCACAGGGGGCCCCAGCTCATGCAGCCTAACCATAGCAATCAGCCCCAGCATTTT	CASSVDHRGPQLMQPNHSNQPQHF	TRBV9	TRBJ1-5
TGTGCCACCAGCAGAGTTGGGCCCGGCTACACCTTC	CATSRVGPGYTF	TRBV15	TRBJ1-2
TGTGCCACCAGTGATTTGGCCGGGACAGGGGTACACTATGGCTACACCTTC	CATSDLAGTGVHYGYTF	TRBV24-1	TRBJ1-2
TGTGCCAGCACCTCGGTTAAAGGGGTAGATCAGCCCCAGCATTTT	CASTSVKGVDQPQHF	TRBV5-5	TRBJ1-5
TGTGCCAGCAGCGACAGGTTTACCAAAGCCAAAAACATTCAGTACTTC	CASSDRFTKAKNIQYF	TRBV13	TRBJ2-4
TGTGCCAGTAGTATCCCCCTAGCGAGGCCCTGGCGGACCACCGGGGAGCTGTTTTTT	CASSIPLARPWRTTGELFF	TRBV19	TRBJ2-2
TGCGCCAGCAGCCAAGGTACAGGCGAGCAGTACTTC	CASSQGTGEQYF	TRBV4-1	TRBJ2-7
TGCAGCGTTGAGCTAAAAGGACTAGCGGGGGGGGCGTCGTATTTT	CSVELKGLAGGASYF	TRBV29-1	TRBJ2-3
TGTGCCAGCAATTCGCGACAGGGGGAGAGCGACGAGCAGTACTTC	CASNSRQGESDEQYF	TRBV6-1	TRBJ2-7
TGTGCCAGCCCGGGACAGGCCTACGAGCAGTACTTC	CASPGQAYEQYF	TRBV18	TRBJ2-7
TGTGCCAGCAGCCGCAGATCCGGGACAGAGTACCAAGAGACCCAGTACTTC	CASSRRSGTEYQETQYF	TRBV5-4	TRBJ2-5
TGTGCCACCAGCAGAGACACGGGCAGAAGTAGGGGCAATCAGCCCCAGCATTTT	CATSRDTGRSRGNQPQHF	TRBV15	TRBJ1-5
TGTGCCAGCAGTTTAGCTGGCGACAGGCTAGATGAGCAGTTCTTC	CASSLAGDRLDEQFF	TRBV27	TRBJ2-1
TGTGCCAGCAGTCGCAGGGGAGGCGGGGAGCTGTTTTTT	CASSRRGGGELFF	TRBV6-4	TRBJ2-2
TGTGCCAGCAGAGGGAACACCGGGGAGCTGTTTTTT	CASRGNTGELFF	TRBV11-2	TRBJ2-2
TGTGCCAGCAGCCCTATTGTTGGTTACTTC	CASSPIVGYF	TRBV9	TRBJ2-5
TGCGCCAGCAGCTCGGAGATACAGTCAGATCAGCCCCAGCATTTT	CASSSEIQSDQPQHF	TRBV5-1	TRBJ1-5
TGTGCCAGCAGTGAAGTCAGGCACAATCAGCCCCAGCATTTT	CASSEVRHNQPQHF	TRBV6-1	TRBJ1-5
TGCAGTGCTAGACCCCTCCCGAATAGGGGCTCTAACACTGAAGCTTTCTTT	CSARPLPNRGSNTEAFF	TRBV20-1	TRBJ1-1
TGTGCCAGCAGTTACAACGGACACTTACTGCGGGCCTACGAGCAGTACTTC	CASSYNGHLLRAYEQYF	TRBV6-5	TRBJ2-7
TGCGCCAGCAGTGTTCTTGACGGGCCTGAAGCTTTCTTT	CASSVLDGPEAFF	TRBV10-1	TRBJ1-1
TGTGCCTGGAGTGGCAGGATCAGCTCCTACAATGAGCAGTTCTTC	CAWSGRISSYNEQFF	TRBV30	TRBJ2-1
TGCAGCGTTGGACAGGCGGGAAACATTCAGTACTTC	CSVGQAGNIQYF	TRBV29-1	TRBJ2-4
TGTGCCAGCACAGGGGGCGCTGGCTACACCTTC	CASTGGAGYTF	TRBV6-8	TRBJ1-2
TGTGCCAGCAGCTTCAGCCTAGGGTCCATTGCTTACGAGCAGTACTTC	CASSFSLGSIAYEQYF	TRBV7-8	TRBJ2-7
TGTGCCAGCAGGCGGGGGCGGCCTCTTGAGACCTACGAGCAGTACTTC	CASRRGRPLETYEQYF	TRBV27	TRBJ2-7
TGTGCCAGCACTACCCGCGGGAACACTGAAGCTTTCTTT	CASTTRGNTEAFF	TRBV27	TRBJ1-1
TGTGCCAGCAGGCAGGGGGGGAGCTCCTACGAGCAGTACTTC	CASRQGGSSYEQYF	TRBV25-1	TRBJ2-7
TGTGCCAGCCAACGGGGGGTGGTGCAGTACTTC	CASQRGVVQYF	TRBV7-6	TRBJ2-7
TGCAGTGCTAGAGATCTCCGGAGTGGCGGGAGATCTTATGGCTACACCTTC	CSARDLRSGGRSYGYTF	TRBV20-1	TRBJ1-2
TGTGCCAGCAGCCCAGAGACAGGGGGTTTGGAGCAGTACTTC	CASSPETGGLEQYF	TRBV3-1	TRBJ2-7
TGTGCCAGCAAGGTGAAGGGGCCCACAGATACGCAGTATTTT	CASKVKGPTDTQYF	TRBV27	TRBJ2-3
TGTGCCAGCAGTAGGGAGGGGCAACCCACTGAAGCTTTCTTT	CASSREGQPTEAFF	TRBV6-2	TRBJ1-1
TGTGCCTGGAGTGTAGTCATAGCGGGAACTGAAGCTTTCTTT	CAWSVVIAGTEAFF	TRBV30	TRBJ1-1
TGTGCCAGCAGCCTCGGGGGGCCCCTTGGGGGGAGAAAGACCCAGTACTTC	CASSLGGPLGGRKTQYF	TRBV12-3	TRBJ2-5
TGTGCCAGCAGTCCTCCGGGCATGGAGCAGTACTTC	CASSPPGMEQYF	TRBV6-8	TRBJ2-7
TGTGCCAGCAGTTCCTCCCCGCGGCTGGGACAGGAGGAGGAAGCTTTCTTT	CASSSSPRLGQEEEAFF	TRBV27	TRBJ1-1
TGTGCCAGCAGCCCTCTGATCGGACCCTTCTTCAATGAGCAGTTCTTC	CASSPLIGPFFNEQFF	TRBV7-4	TRBJ2-1
TGTGCCAGCAGCCGGGTGGGGGGGCCCCGTTGGGAAAGCACAGATACGCAGTATTTT	CASSRVGGPRWESTDTQYF	TRBV7-3	TRBJ2-3
TGTGCCAGCAGTTTGGTATATCGGGGAACTGGCTACACCTTC	CASSLVYRGTGYTF	TRBV27	TRBJ1-2
TGTGCCACGTCGAGCAGGCCTAATGAAAAACTGTTTTTT	CATSSRPNEKLFF	TRBV28	TRBJ1-4
TGTGCTAGTGGTTCGACCACCAGGGCCCATGGGACTGAAAAACTGTTTTTT	CASGSTTRAHGTEKLFF	TRBV12-5	TRBJ1-4
TGTGCCAGCAGCTTAGTCTTCAGGGGGCGGGGGGATAATTCACCCCTCCACTTT	CASSLVFRGRGDNSPLHF	TRBV7-6	TRBJ1-6
TGTGCCAGCAGTGACCCGGCCTACGAGCAGTACTTC	CASSDPAYEQYF	TRBV6-4	TRBJ2-7
TGTGCCAGCAGCTTAAACCGGGACAGGGGCACCTACGAGCAGTACTTC	CASSLNRDRGTYEQYF	TRBV7-4	TRBJ2-7
TGTGCCAGCAGTTACTCGAACAGCCGGGACAGGCAGCCCCAGCATTTT	CASSYSNSRDRQPQHF	TRBV6-6	TRBJ1-5
TGTGCCAGCAGTGACATTCAGCTATACCAAAATGAAAAACTGTTTTTT	CASSDIQLYQNEKLFF	TRBV6-4	TRBJ1-4
TGTGCCAGTAGTAGACGGAGTATCAATGAGCAGTTCTTC	CASSRRSINEQFF	TRBV19	TRBJ2-1
TGTGCCAGCAGCTTGCAAGAATGTAGACCACGGGATTTTCAAGGGACCTATGGCTACACCTTC	CASSLQECRPRDFQGTYGYTF	TRBV5-4	TRBJ1-2
TGTGCTAGTGGTTTGGTACAACGAGAGGGCTTATATAGCAATCAGCCCCAGCATTTT	CASGLVQREGLYSNQPQHF	TRBV12-5	TRBJ1-5
TGCAGTGCTAGAACCAAGGGGACAGGGGGAACCGGGGAGCTGTTTTTT	CSARTKGTGGTGELFF	TRBV20-1	TRBJ2-2
TGTGCCAGCAGCGGAGTAACGGCGGAGACCCAGTACTTC	CASSGVTAETQYF	TRBV5-5	TRBJ2-5
TGTGCCAGCAGTTACTGGTTAAGCAATCAGCCCCAGCATTTT	CASSYWLSNQPQHF	TRBV6-5	TRBJ1-5
TGTGCCAGCAGCTTTGTGAGCCGGGCGGGACAGGGGGACGAGCAGTACTTC	CASSFVSRAGQGDEQYF	TRBV11-2	TRBJ2-7
TGTGCCAGCACCCCGATTCTAATGAACACTGAAGCTTTCTTT	CASTPILMNTEAFF	TRBV27	TRBJ1-1
TGCGCCAGCAGTGACCAGAGATGTGGCTACACCTTC	CASSDQRCGYTF	TRBV10-1	TRBJ1-2
TGTGCCAGTAGTATGGGGAATACCGGGGAGCTGTTTTTT	CASSMGNTGELFF	TRBV19	TRBJ2-2
TGTGCCAGCAGCGACTGGGGACTGGAAGCCTACGAGACCCAGTACTTC	CASSDWGLEAYETQYF	TRBV7-4	TRBJ2-5
TGTGCCAGCAGCCAAGGGTCAGAAGGGGCTAATGAAAAACTGTTTTTT	CASSQGSEGANEKLFF	TRBV4-2	TRBJ1-4
TGTGCCTTACCGGGTCAAGAGACCCAGTACTTC	CALPGQETQYF	TRBV24-1	TRBJ2-5
TGTGCCAGTAATCCTAGCGGGACGGGCACAGATACGCAGTATTTT	CASNPSGTGTDTQYF	TRBV19	TRBJ2-3
TGTGCCAGCAGCCAAGATACAGAGGGACTGGGCACAGATACGCAGTATTTT	CASSQDTEGLGTDTQYF	TRBV3-1	TRBJ2-3
TGTGCCACCAGCCGGCAGGGGTGCCAAGAGACCCAGTACTTC	CATSRQGCQETQYF	TRBV15	TRBJ2-5
TGTGCCAGCAGCTCCTCCCGACGGGGCGGAGCCAAAAACATTCAGTACTTC	CASSSSRRGGAKNIQYF	TRBV13	TRBJ2-4
TGCGCCAGCAGTGCCATTTATCGGACTAGCGGGGAAACCTACGAGCAGTACTTC	CASSAIYRTSGETYEQYF	TRBV10-1	TRBJ2-7
TGCAGTGCTAGAGATCCCGGGACTAGCGGGAGGTACGAGCAGTACTTC	CSARDPGTSGRYEQYF	TRBV20-1	TRBJ2-7
TGCGCCAGCAGCCATCGACCACTAGCGGTCAACCTAGAGACCCAGTACTTC	CASSHRPLAVNLETQYF	TRBV4-1	TRBJ2-5
TGTGCCAGCAGAAGGCCCGGGCTGTTTTTT	CASRRPGLFF	TRBV6-1	TRBJ2-2
TGTGTCCGGTACTGCAATCAGCCCCAGCATTTT	CVRYCNQPQHF	TRBV12-3	TRBJ1-5
TGTGCCAGCAGCAATACCCCCCGCGGGGGGGCAACTAATGAAAAACTGTTTTTT	CASSNTPRGGATNEKLFF	TRBV7-3	TRBJ1-4
TGCGCCAGCAGCTGTATGATAATACGGAGGGCGAACACCGGGGAGCTGTTTTTT	CASSCMIIRRANTGELFF	TRBV4-1	TRBJ2-2
TGTGCCAGCTCCGGGGGGAGCAATGAGCAGTTCTTC	CASSGGSNEQFF	TRBV18	TRBJ2-1
TGTGCAAAACAAGGGACAAACCCTGGCTACACCTTC	CAKQGTNPGYTF	TRBV24-1	TRBJ1-2
TGTGCCAGCAGCGCTAATAGTCAAGGTGAAAAACTGTTTTTT	CASSANSQGEKLFF	TRBV7-3	TRBJ1-4
TGTGCCAGCAGCCACGGAGAGACCCAGTACTTC	CASSHGETQYF	TRBV5-6	TRBJ2-5
TGTGCCAGCAGCTCGCCGGGACAGGGGTTAAGCAATCAGCCCCAGCATTTT	CASSSPGQGLSNQPQHF	TRBV7-3	TRBJ1-5
TGTGCCAGCAGTCCGGGGGGGCGATTAACAGATACGCAGTATTTT	CASSPGGRLTDTQYF	TRBV6-5	TRBJ2-3
TGTGCCAGCAGCCTCCAGGGTCTCCCCGGGACCCTCAATGAGCAGTTCTTC	CASSLQGLPGTLNEQFF	TRBV7-2	TRBJ2-1
TGTGCCAGCAGCGTTGGACAGGGGAATGAGAGGTATGGCTACACCTTC	CASSVGQGNERYGYTF	TRBV13	TRBJ1-2
TGTGCCAGTAGTATGCCGGGGCAGCGCCGCAATCAGCCCCAGCATTTT	CASSMPGQRRNQPQHF	TRBV19	TRBJ1-5
TGTGCCAGCAGTTTTTGGACAGGGCGGAATTCACCCCTCCACTTT	CASSFWTGRNSPLHF	TRBV28	TRBJ1-6
TGTGCCAGCAGCCAATCCCGAATGGACACGCCCGAGCAGTACTTC	CASSQSRMDTPEQYF	TRBV14	TRBJ2-7
TGTGCCAGCAGCCGGGACAGGGGGGCCCCGAAGGATACGCAGTATTTT	CASSRDRGAPKDTQYF	TRBV7-3	TRBJ2-3
TGCAGTGCTCGGAAGGGTGTACCGTATGGCTACACCTTC	CSARKGVPYGYTF	TRBV20-1	TRBJ1-2
TGTGCCAGCAGTTTACTGACTAGCGGGAGGGTATACGAGCAGTACTTC	CASSLLTSGRVYEQYF	TRBV12-3	TRBJ2-7
TGTGCCAGCAGCCGGGACAGGGGCCGAGAGAACACTGAAGCTTTCTTT	CASSRDRGRENTEAFF	TRBV6-1	TRBJ1-1
TGTGCCAGCAGCCTACTTACGGACGGGCATAATGAAAAACTGTTTTTT	CASSLLTDGHNEKLFF	TRBV7-9	TRBJ1-4
TGTGCCACCGCTCTGGGGACTAGCGGGCTCTACGAGCAGTACTTC	CATALGTSGLYEQYF	TRBV24-1	TRBJ2-7
TGTGCTAGGAAATATAGCAATCAGCCCCAGCATTTT	CARKYSNQPQHF	TRBV7-7	TRBJ1-5
TGTGCCATCGTAGCGGGACGTTACAATGAGCAGTTCTTC	CAIVAGRYNEQFF	TRBV6-5	TRBJ2-1
TGTGCCACCAGGGGGCTCTACGAGCAGTACTTC	CATRGLYEQYF	TRBV24-1	TRBJ2-7
TGTGCCAGCAGCTACCCCTTTAGGGGTGTAGTTCGCAATCAGCCCCAGCATTTT	CASSYPFRGVVRNQPQHF	TRBV11-1	TRBJ1-5
TGTGCCAGCAGCAATGCGGGGACTACCTCCTACGAGCAGTACTTC	CASSNAGTTSYEQYF	TRBV5-6	TRBJ2-7
TGTGCCAGCAGCTTTCCCCCGTTGGCCCGGTACAATGAGCAGTTCTTC	CASSFPPLARYNEQFF	TRBV11-2	TRBJ2-1
TGTGCCAGCAGCATCAGTACCTCTGGAAACACCATATATTTT	CASSISTSGNTIYF	TRBV13	TRBJ1-3
TGTGGAGTTAGTGGGGTATACAATGAGCAGTTCTTC	CGVSGVYNEQFF	TRBV5-4	TRBJ2-1
TGTGCCAGCTGGTCCTGGGGGGTAAACACTGAAGCTTTCTTT	CASWSWGVNTEAFF	TRBV9	TRBJ1-1
TGCGCCAGCAGTTTAAAAGGCCGAAAGGGCTACACCTTC	CASSLKGRKGYTF	TRBV10-1	TRBJ1-2
TGTGCCAGCAGTACTTCTAGCGGGACAGGGTACAATGAGCAGTTCTTC	CASSTSSGTGYNEQFF	TRBV6-8	TRBJ2-1
TGCGCCAGCAGTGATAAAGGGGGGGAGAGCTACGAGCAGTACTTC	CASSDKGGESYEQYF	TRBV10-1	TRBJ2-7
TGTGCCAGTCCCCCTGGACAGGCTGGCTACACCTTC	CASPPGQAGYTF	TRBV19	TRBJ1-2
TGTGCCAGCAGCTTGGGGGACAGGGTTAGTGGGCGAACCGGGGAGCTGTTTTTT	CASSLGDRVSGRTGELFF	TRBV5-5	TRBJ2-2
TGTGCCACCAGTGATTTGTCGACAGGCATCCAGCTCGAGCAGTACTTC	CATSDLSTGIQLEQYF	TRBV24-1	TRBJ2-7
TGTGCCAGCAGCTTATCCCCCGGGACACACGAGCAGTACTTC	CASSLSPGTHEQYF	TRBV7-3	TRBJ2-7
TGTGCTAGTGGTTTAAGTGTTAGCGTCGGTTATCAGCCCCAGCATTTT	CASGLSVSVGYQPQHF	TRBV12-5	TRBJ1-5
TGTGCCAGCAGTTACCCGCCGCGGGCCCAGGGGTGCACAGATACGCAGTATTTT	CASSYPPRAQGCTDTQYF	TRBV6-5	TRBJ2-3
TGTGCCAGCAGCGATCGATGGGGACAGGGCTTGTCAGAGACCCAGTACTTC	CASSDRWGQGLSETQYF	TRBV7-9	TRBJ2-5
TGTGCCAGCAGCTTAGGGACTAGGATCTTCTACGAGCAGTACTTC	CASSLGTRIFYEQYF	TRBV7-2	TRBJ2-7
TGTGCCACCAGTGATTTCGTTCTAGCGGACCCCCCCACCGGGGAGCTGTTTTTT	CATSDFVLADPPTGELFF	TRBV24-1	TRBJ2-2
TGTGCCAGCAGCTGGGACAGAGCGAACACCGGGGAGCTGTTTTTT	CASSWDRANTGELFF	TRBV7-8	TRBJ2-2
TGCGCCAGCAGCTTGGAGGCGGAAGATGCCTACGAGCAGTACTTC	CASSLEAEDAYEQYF	TRBV5-1	TRBJ2-7
TGTGCCAGCAGCTTTACGGTAGCAGCGGGATCCAACAATGAGCAGTTCTTC	CASSFTVAAGSNNEQFF	TRBV7-2	TRBJ2-1
TGTGCCAGCAGCTACTCCAGGGCAGGGGTTTACGAGCAGTACTTC	CASSYSRAGVYEQYF	TRBV7-9	TRBJ2-7
TGCAGTGCTAGGGGGCGTTGGTTGACTGAAGCTTTCTTT	CSARGRWLTEAFF	TRBV20-1	TRBJ1-1
TGTGCCATCAGTGAGTCTCAGGGACGGGAGCCCCAGCATTTT	CAISESQGREPQHF	TRBV10-3	TRBJ1-5
TGTGCCAGCCCCGACAGGCCCAGATGGCCCTATGGCTACACCTTC	CASPDRPRWPYGYTF	TRBV7-6	TRBJ1-2
TGTGCCAGCAGTACGGACGAGCAGTACTTC	CASSTDEQYF	TRBV5-5	TRBJ2-7
TGTGCCGACAGGGGCGAAATGAACACTGAAGCTTTCTTT	CADRGEMNTEAFF	TRBV6-2	TRBJ1-1
TGCGCCAGCAGCTGCAGAGGGGCCAGGGAAGAAAAACTGTTTTTT	CASSCRGAREEKLFF	TRBV5-1	TRBJ1-4
TGTGCCAGCAGCAGGCAGGGGGAGGCTACCTCTGGAAACACCATATATTTT	CASSRQGEATSGNTIYF	TRBV9	TRBJ1-3
TGTGCCAGCAGCGTAGAGGCAGGTGGCTACACCTTC	CASSVEAGGYTF	TRBV9	TRBJ1-2
TGTGCCAGCAGCAGAGGCACAGATACGCAGTATTTT	CASSRGTDTQYF	TRBV7-9	TRBJ2-3
TGTGCCAGCAGCTTACAGGGGGAGCAGCCCCAGCATTTT	CASSLQGEQPQHF	TRBV5-4	TRBJ1-5
TGTGCCAGCAGCTTGGTTCGGCTTACTGAAGCTTTCTTT	CASSLVRLTEAFF	TRBV5-6	TRBJ1-1
TGTGCCAGCAGACGAACGCCGGGACAGGGCTTC	CASRRTPGQGF	TRBV6-3	TRBJ2-7
TGTGCCAGCAGTTACGGGGTACCCGGGACAGGGACTGTCTATTTT	CASSYGVPGTGTVYF	TRBV6-3	TRBJ1-3
TGTGCCAGCAGCTTAGCCTCGGGCCTTAAGGACGCAGATACGCAGTATTTT	CASSLASGLKDADTQYF	TRBV11-2	TRBJ2-3
TGCGCCAGCAGCCAAGATCTGTTGCGGGACAGTTGTACCTACGAGCAGTACTTC	CASSQDLLRDSCTYEQYF	TRBV4-1	TRBJ2-7
TGTGCCAGCAAACTATTCGGTAGCTCTGGAAACACCATATATTTT	CASKLFGSSGNTIYF	TRBV12-3	TRBJ1-3
TGTGCCAGCAGTTTAGCGTGGTTAGACAGGGGAGGCACTGAAGCTTTCTTT	CASSLAWLDRGGTEAFF	TRBV12-3	TRBJ1-1
TGCAGTGCTACACGCGACCGGACAGGGGGAGACTATGGCTACACCTTC	CSATRDRTGGDYGYTF	TRBV20-1	TRBJ1-2
TGTGCCAGCAGCCATCCACAGAGACTTCACGCCAAAAACATTCAGTACTTC	CASSHPQRLHAKNIQYF	TRBV12-4	TRBJ2-4
TGTGCCCCCACAGGTATAGACTCAGGGGGCCTAGATACGCAGTATTTT	CAPTGIDSGGLDTQYF	TRBV19	TRBJ2-3
TGCGCCAGTAGAGGGAACACCGGGGAGCTGTTTTTT	CASRGNTGELFF	TRBV5-1	TRBJ2-2
TGTGCCAGCAGCGGGGCGGGAGTGGATGAGCAGTTCTTC	CASSGAGVDEQFF	TRBV13	TRBJ2-1
TGTGCCAGTAGTGACCCTATAGGAGGGTGGGATGGCTACACCTTC	CASSDPIGGWDGYTF	TRBV19	TRBJ1-2
TGTGCCAGCAGTTTGTTCCCGACCTCTGGAAACACCATATATTTT	CASSLFPTSGNTIYF	TRBV12-3	TRBJ1-3
TGTGCCAGCAGGCCGGGACAATTAGAGAGAAGGACGAACACCGGGGAGCTGTTTTTT	CASRPGQLERRTNTGELFF	TRBV7-3	TRBJ2-2
TGTGCCAGCAGAGTCCGGACCCCGGGAACACAAGCTTTCTTT	CASRVRTPGTQAFF	TRBV13	TRBJ1-1
TGTGCCAGCAGTTTAGATGGGATACCGGGTGAAAAACTGTTTTTT	CASSLDGIPGEKLFF	TRBV12-3	TRBJ1-4
TGTGCCAGCAGCTTATTCTCCAACCGGGACAGGGCAGATACGCAGTATTTT	CASSLFSNRDRADTQYF	TRBV11-3	TRBJ2-3
TGTGCCTGGAGTGTAGTGAAGCCGCTAAAGAACCGATCAGAGACCCAGTACTTC	CAWSVVKPLKNRSETQYF	TRBV30	TRBJ2-5
TGTGCCAGCAGCGGAGGAGGGAACGAGCAGTTCTTC	CASSGGGNEQFF	TRBV7-9	TRBJ2-1
TGTGCCAGCAGCCCTACAGGGCTAAGAACCCACCGCAATCAGCCCCAGCATTTT	CASSPTGLRTHRNQPQHF	TRBV4-2	TRBJ1-5
TGTGCCAGCAGCACAACCTCCCGGCGCACCATATATTTT	CASSTTSRRTIYF	TRBV7-3	TRBJ1-3
TGTGCCAGCAGCTTAGGCCGCGGGAGCACAGATACGCAGTATTTT	CASSLGRGSTDTQYF	TRBV11-2	TRBJ2-3
TGCGCCAGCAGCGTCTTACTAGCGGGAGGGCCTTCGAGCTACGAGCAGTACTTC	CASSVLLAGGPSSYEQYF	TRBV4-1	TRBJ2-7
TGTGCCACCCCTCCGGGACTAGCGTTAAACACCGGGGAGCTGTTTTTT	CATPPGLALNTGELFF	TRBV6-4	TRBJ2-2
TGTGCCACCCGGCCTACCGTATGGGGCCCCGGGGACGAGCAGTACTTC	CATRPTVWGPGDEQYF	TRBV24-1	TRBJ2-7
TGTGCCTTCTTTTTAGGGACAGGGTATCTTTCGGGGCAGAAACTTTACTACGAGCAGTACTTC	CAFFLGTGYLSGQKLYYEQYF	TRBV25-1	TRBJ2-7
TGCAGTGCTAGCCTCCGACAGGGAGTTGCTAACTATGGCTACACCTTC	CSASLRQGVANYGYTF	TRBV20-1	TRBJ1-2
TGTGCCAGCAGCCCCCCCCCGGGACAGGGGGCCTACGAGCAGTACTTC	CASSPPPGQGAYEQYF	TRBV11-2	TRBJ2-7
TGTGCCAGTAGTATTCGGACAGGGAATGAGCAGTTCTTC	CASSIRTGNEQFF	TRBV19	TRBJ2-1
TGTGCCAGCAGCTTAAAACCTACGGATCAGCCCCAGCATTTT	CASSLKPTDQPQHF	TRBV7-3	TRBJ1-5
TGTGCCAGCAGCTTGGGACAGACGATAACCTACGAGCAGTACTTC	CASSLGQTITYEQYF	TRBV5-6	TRBJ2-7
TGCGCCAGCAGCTGCACAGTCACTGGGGCCAACGTCCTGACTTTC	CASSCTVTGANVLTF	TRBV5-1	TRBJ2-6
TGTGCTAGTGGTTTGTGGGCTCCCGGGACACTAATAGGCTACACCTTC	CASGLWAPGTLIGYTF	TRBV12-5	TRBJ1-2
TGTGCCAGCAGCTCGGGGGGACCCCTGGGCTACGAGCAGTACTTC	CASSSGGPLGYEQYF	TRBV5-4	TRBJ2-7
TGTGCCAGCAGCCAGACCCACTACCCCACCTCGCGGTATGTCCTGAATGGCTACACCTTC	CASSQTHYPTSRYVLNGYTF	TRBV7-2	TRBJ1-2
TGTGCCAGCAGGGACAGGAGGAGCAATCAGCCCCAGCATTTT	CASRDRRSNQPQHF	TRBV6-5	TRBJ1-5
TGTGCCAGCAGTGACTCGAGGGCACCCGAGCCGACAGGGGGGAACTACGAGCAGTACTTC	CASSDSRAPEPTGGNYEQYF	TRBV6-4	TRBJ2-7
TGTGCCAGCAGCTTAGCCACATTTAATACTAGCGGGAGATACATTCAGTACTTC	CASSLATFNTSGRYIQYF	TRBV11-3	TRBJ2-4
TGTGCCACCAGTGATTGTAAGGACAGGGAGGGGGAAAATCAGCCCCAGCATTTT	CATSDCKDREGENQPQHF	TRBV24-1	TRBJ1-5
TGTGCCAGGGAGAGGGAAGTTTACACTGAAGCTTTCTTT	CAREREVYTEAFF	TRBV6-6	TRBJ1-1
TGTGCCAGCAGCTTAGTCTCCCTGGGACTTAATAATCAGCCCCAGCATTTT	CASSLVSLGLNNQPQHF	TRBV7-9	TRBJ1-5
TGTGCCAGTAACGAGCCAACGCTTAAACAGAATCTTTGGGTCTTC	CASNEPTLKQNLWVF	TRBV2	TRBJ2-1
TGTGCCAGCACCCGGAGGGATTCTAGTAGTAGACAAGAGACCCAGTACTTC	CASTRRDSSSRQETQYF	TRBV12-4	TRBJ2-5
TGTGCCAGCTCACCACCGCGGTATGTAGGGACAGGGGGTTTTTTAGAGGGCTACACCTTC	CASSPPRYVGTGGFLEGYTF	TRBV18	TRBJ1-2
TGTGCCAGCAGTTTACGCTCCTACGAGCAGTACTTC	CASSLRSYEQYF	TRBV12-3	TRBJ2-7
TGCAGTGCGGCGGTCCGAAGGTTTGGGGAGACCCAGTACTTC	CSAAVRRFGETQYF	TRBV20-1	TRBJ2-5
TGTGCCAGCAGCTTACATGGCTCAGGAATTAATGAAAAACTGTTTTTT	CASSLHGSGINEKLFF	TRBV11-3	TRBJ1-4
TGTGCCAGCAAACCCCCGGGACAGGGGGCAGACGGAAACATTCAGTACTTC	CASKPPGQGADGNIQYF	TRBV12-3	TRBJ2-4
TGCAGTGCTCCCACTGGGACAGCGACTTGCAATCAGCCCCAGCATTTT	CSAPTGTATCNQPQHF	TRBV20-1	TRBJ1-5
TGTGCCAGCGCCGGGACTGGCGAGGGGGTTCAGCCCCAGCATTTT	CASAGTGEGVQPQHF	TRBV7-9	TRBJ1-5
TGTGCCACCAGCAGAGTACGAGCTGAGCAGTTCTTC	CATSRVRAEQFF	TRBV15	TRBJ2-1
TGTGCCAGCAGTGACTCGAGGGGCGGGACAGTCGGAGGCTACACCTTC	CASSDSRGGTVGGYTF	TRBV6-4	TRBJ1-2
TGTGCCACCAGCAGGCAGGGGAAACAGGGGGCTGCTTCAAAACTGTTTTTT	CATSRQGKQGAASKLFF	TRBV15	TRBJ1-4
TGTGCCAGCAGCACCTCCGGGGGGCTCCAGTACGAGCAGTACTTC	CASSTSGGLQYEQYF	TRBV5-5	TRBJ2-7
TGCGCCAGCAGCCACCGACGAACGAACACCGGGGAGCTGTTTTTT	CASSHRRTNTGELFF	TRBV4-1	TRBJ2-2
TGTGCCAGCAGTGAAGGACTAGCGGGAGAGACCCAGTACTTC	CASSEGLAGETQYF	TRBV6-1	TRBJ2-5
TGTGCCAGCCAGGGATCCCGTCTTAGACCGTACGAGCAGTACTTC	CASQGSRLRPYEQYF	TRBV12-4	TRBJ2-7
TGTGCCACCAGTGTGAGTGGGGGGAATGAGCAGTTCTTC	CATSVSGGNEQFF	TRBV24-1	TRBJ2-1
TGTGCCAGCAGCCGACCGCAGGGGGGGAACTATGGCTACACCTTC	CASSRPQGGNYGYTF	TRBV13	TRBJ1-2
TGCAGTGCTGAATTTAGGGGCCGGGGGACCTACGAGCAGTACTTC	CSAEFRGRGTYEQYF	TRBV20-1	TRBJ2-7
TGCGCCAGCAGCCGGCACAGGGAAGGAAAGGGGACTGAAGCTTTCTTT	CASSRHREGKGTEAFF	TRBV5-1	TRBJ1-1
TGTGCCAGCAGCCACAGTCAGCCCCAGCATTTT	CASSHSQPQHF	TRBV14	TRBJ1-5
TGCGCCAGCAGCAGGGGGGTAAGTAACACTGAAGCTTTCTTT	CASSRGVSNTEAFF	TRBV5-1	TRBJ1-1
TGTGCCAGCATCCGGGCGTTGGCTGGAAACACCATATATTTT	CASIRALAGNTIYF	TRBV6-2	TRBJ1-3
TGTGCCAGCAGCGGGATGGGGGCAACTAATGAAAAACTGTTTTTT	CASSGMGATNEKLFF	TRBV7-3	TRBJ1-4
TGTGCCACCGGGGGTTCCTACGAGCAGTACTTC	CATGGSYEQYF	TRBV24-1	TRBJ2-7
TGCAGTGCTCCACAGGGGACAGATATGGGCTATGGCTACACCTTC	CSAPQGTDMGYGYTF	TRBV20-1	TRBJ1-2
TGTGCCAGCAGCTTGGGAGACAGGGAGAGCTACGAGCAGTACTTC	CASSLGDRESYEQYF	TRBV7-3	TRBJ2-7
TGTGCCAGCAGCGTAGATAGGGACCGGCCCCCCAATCAGCCCCAGCATTTT	CASSVDRDRPPNQPQHF	TRBV7-4	TRBJ1-5
TGTGCCAGCAGCTTAGGCGGACCTCAGCACACCGGGGAGCTGTTTTTT	CASSLGGPQHTGELFF	TRBV7-2	TRBJ2-2
TGTGCCAGCAGTTTCCGACAGGGGAGCGTCTCCTACGAGCAGTACTTC	CASSFRQGSVSYEQYF	TRBV27	TRBJ2-7
TGTGCCAGCCTCGGGTACAGAAAGGAAACTGAAGCTTTCTTT	CASLGYRKETEAFF	TRBV9	TRBJ1-1
TGTGCCTGGAGTCAGGGGAGGGAGGGCTTGGGCTACACCTTC	CAWSQGREGLGYTF	TRBV30	TRBJ1-2
TGTGCCAGCAGCCAAGATCCGTCAAAGCAAGAGACCCAGTACTTC	CASSQDPSKQETQYF	TRBV3-1	TRBJ2-5
TGTGCCCGTCCCCGGGACAGGGAGTCAACTAATGAAAAACTGTTTTTT	CARPRDRESTNEKLFF	TRBV7-4	TRBJ1-4
TGTGCCAGCAGACCGCACCGCAGGCGGTTGACTAATGAAAAACTGTTTTTT	CASRPHRRRLTNEKLFF	TRBV27	TRBJ1-4
TGTGCCAGCAGCGACACAGGGGAGACCCAGTACTTC	CASSDTGETQYF	TRBV9	TRBJ2-5
TGTGCCAGCAGCTTGCCCGAGGGCTCCTACGAGCAGTACTTC	CASSLPEGSYEQYF	TRBV5-4	TRBJ2-7
TGTGCCAGTACACCCCTAACGAGGGGGAAGGTCGCAAAGCCCCAGCATTTT	CASTPLTRGKVAKPQHF	TRBV19	TRBJ1-5
TGTGCCAGCATGTGTCAGGCTAGGAATGACAATGAGCAGTTCTTC	CASMCQARNDNEQFF	TRBV7-2	TRBJ2-1
TGTGCCAGCAGCCAAGCGGGATTCAATGAGCAGTTCTTC	CASSQAGFNEQFF	TRBV14	TRBJ2-1
TGTGCCAGCAGACACCTGGTCGGGGGGCTCGCGTACGAGCAGTACTTC	CASRHLVGGLAYEQYF	TRBV11-3	TRBJ2-7
TGTGCCAGCAGCTTCATCCATGGACAGAGGGACTACGAGCAGTACTTC	CASSFIHGQRDYEQYF	TRBV11-3	TRBJ2-7
TGTGCCAGCAGTAACCTAACCCTCTGGGCTCGCGAGCAGTACTTC	CASSNLTLWAREQYF	TRBV27	TRBJ2-7
TGTGCCAGCAGCTTAGCCTTGGGGGGGGACCTCTTC	CASSLALGGDLF	TRBV7-2	TRBJ2-1
TGTGCCAGCAGCCGTAGAAAATACAGGGGGGATTCACCCCTCCACTTT	CASSRRKYRGDSPLHF	TRBV6-5	TRBJ1-6
TGTGCCAGCTCACCTAGTTCTCCAATCGGATTGACAGGGGGCAATTTCTACGAGCAGTACTTC	CASSPSSPIGLTGGNFYEQYF	TRBV18	TRBJ2-7
TGTGCCAGCAGTTCACAGGAAACGGGACAGAAACGGGACTATGGCTACACCTTC	CASSSQETGQKRDYGYTF	TRBV6-5	TRBJ1-2
TGTGCCAGCCCCCGGGGGGATGAGCAGTTCTTC	CASPRGDEQFF	TRBV2	TRBJ2-1
TGTGCCAGCAGCCAAGATCAACCCCAGGGCGGACACAACGTCCTGACTTTC	CASSQDQPQGGHNVLTF	TRBV3-1	TRBJ2-6
TGTGCCAGCAGTTTTCATAGACTAGCGGGAGATAAAAGGAACGAGCAGTACTTC	CASSFHRLAGDKRNEQYF	TRBV28	TRBJ2-7
TGTGCCACGAGAACAGGGGGCTCGAATCAGCCCCAGCATTTT	CATRTGGSNQPQHF	TRBV24-1	TRBJ1-5
TGTGCCAGCAGTCCCCGGGACAGAGCAGCCCTCCACTTT	CASSPRDRAALHF	TRBV6-5	TRBJ1-6
TGCGCCAGCAGCTCTATGGGCAGCTATATTCTCGAGCAGTACTTC	CASSSMGSYILEQYF	TRBV5-1	TRBJ2-7
TGTGCCAGCAGTTATCAGGGGGCCTCCTACAATGAGCAGTTCTTC	CASSYQGASYNEQFF	TRBV6-5	TRBJ2-1
TGTGCCAGCAGCCGGCTTGGGAACTACGAGCAGTACTTC	CASSRLGNYEQYF	TRBV14	TRBJ2-7
TGTGCCAGCAGTTGGGTTCGGGACTACATCTACAATGAGCAGTTCTTC	CASSWVRDYIYNEQFF	TRBV6-6	TRBJ2-1
TGTGCCAGCTCGTCGGGACAGGATGATGGGAAGAACACCGGGGAGCTGTTTTTT	CASSSGQDDGKNTGELFF	TRBV5-4	TRBJ2-2
TGTGCCAGCAGTGAAGGTAGGTATAGCAATCAGCCCCAGCATTTT	CASSEGRYSNQPQHF	TRBV6-1	TRBJ1-5
TGTGCCACCAGTTGGACCGGGACAGGGCTGAGGGCGCACACTGAAGCTTTCTTT	CATSWTGTGLRAHTEAFF	TRBV24-1	TRBJ1-1
TGTGCCATCCAGGGGGTCCACTCTGGAAACACCATATATTTT	CAIQGVHSGNTIYF	TRBV10-3	TRBJ1-3
TGTGCCAGCAGGGGGGGGCCAGGGAAGGAAGCCTACGAGCAGTACTTC	CASRGGPGKEAYEQYF	TRBV6-1	TRBJ2-7
TGTGCCTGGAGTGTCCCACCCCTTGCAGGTCGGGTGGCGGGGCAGTACTTC	CAWSVPPLAGRVAGQYF	TRBV30	TRBJ2-7
TGTGCCAGCAGTTACCCCCGGGACAGGGGGGGCTCAGATACGCAGTATTTT	CASSYPRDRGGSDTQYF	TRBV6-5	TRBJ2-3
TGTGCCAGCAGCCGAGTAAAGGGGGGGAGGGATCAGCCCCAGCATTTT	CASSRVKGGRDQPQHF	TRBV14	TRBJ1-5
TGTGCCATCAGTGGAGGCTTGACTGGAACAGATACGCAGTATTTT	CAISGGLTGTDTQYF	TRBV10-3	TRBJ2-3
TGTGCCAGCAGTCTCCAGGTTACAGGGGAGTTTTCCAATGAGCAGTTCTTC	CASSLQVTGEFSNEQFF	TRBV2	TRBJ2-1
TGTGCCAGCAGCGTTCTGGAGCGGGAGCGCCGAGGCAATCAGCCCCAGCATTTT	CASSVLERERRGNQPQHF	TRBV9	TRBJ1-5
TGTGCCAGCAGCTCACCCGTAGGGGGTGTCCCTTATCAGCCCCAGCATTTT	CASSSPVGGVPYQPQHF	TRBV7-2	TRBJ1-5
TGTGCCAGCAGTGTGGACGAGGGACAGGGGGCAATGAACTATGGCTACACCTTC	CASSVDEGQGAMNYGYTF	TRBV12-3	TRBJ1-2
TGTGCCAGCATTTCCGGGACAGAGAGTGTCTACGAGCAGTACTTC	CASISGTESVYEQYF	TRBV11-2	TRBJ2-7
TGTGCCAGCAGTGACCCTGGGGACAGGGACGACTACGAGCAGTACTTC	CASSDPGDRDDYEQYF	TRBV6-4	TRBJ2-7
TGTGCCAGCAGTCTCGGGGGGACGGCGGTGAACACTGAAGCTTTCTTT	CASSLGGTAVNTEAFF	TRBV27	TRBJ1-1
TGTGCCCCCCTTCGGTACGCAGGCGAGCAGTACTTC	CAPLRYAGEQYF	TRBV6-1	TRBJ2-7
TGTGCCAGCATTGGGACCTATAGGGCTGAGACCCAGTACTTC	CASIGTYRAETQYF	TRBV2	TRBJ2-5
TGTGCCACCAGCAGCGGGGAGACAGGGTTAAAGACCGCCAAAAACATTCAGTACTTC	CATSSGETGLKTAKNIQYF	TRBV15	TRBJ2-4
TGTGCCACGGGGGACGGACAAGAGACCCAGTACTTC	CATGDGQETQYF	TRBV6-4	TRBJ2-5
TGTGCCAGCAACCTTAGACGGGACGAGAAAGATACGCAGTATTTT	CASNLRRDEKDTQYF	TRBV9	TRBJ2-3
TGTGCCATCAGTGACACACCTGGGAGGGTCCGCGAGACCCAGTACTTC	CAISDTPGRVRETQYF	TRBV10-3	TRBJ2-5
TGTGCCAGCAGGGACCGGGACAGGGGGCAAGTCTACGAGCAGTACTTC	CASRDRDRGQVYEQYF	TRBV6-4	TRBJ2-7
TGTGCCAGCAGCCCTGCGGGAGACATCGGGAACACCGGGGAGCTGTTTTTT	CASSPAGDIGNTGELFF	TRBV11-3	TRBJ2-2
TGTGCCAGGCCCCCGGGGAAGCGCTACAATGAGCAGTTCTTC	CARPPGKRYNEQFF	TRBV11-3	TRBJ2-1
TGTGCCAGCAGTGGAGGGGGACGTCTTACCTACGAGCAGTACTTC	CASSGGGRLTYEQYF	TRBV28	TRBJ2-7
TGCGCCAGCAGGGCCGGGACTAGGGATCATACGCAGTATTTT	CASRAGTRDHTQYF	TRBV5-1	TRBJ2-3
TGCAGTGCTAGACTGACAGTCTATAGCAATCAGCCCCAGCATTTT	CSARLTVYSNQPQHF	TRBV20-1	TRBJ1-5
TGTGCCAGTAGTACCCCCTTAACGGGTTTCAGGGGTAGTTACGAGCAGTACTTC	CASSTPLTGFRGSYEQYF	TRBV19	TRBJ2-7
TGTGCCAGCTCAGATTGGACTAGCGGGGGGGCCACACTGAGTGAGCGCAGCACAGATACGCAGTATTTT	CASSDWTSGGATLSERSTDTQYF	TRBV18	TRBJ2-3
TGCAGTGCTAGCAGGGGGGCAGTGGTGGATAAACTAGGACACTACGAGCAGTACTTC	CSASRGAVVDKLGHYEQYF	TRBV20-1	TRBJ2-7
TGCAGTGCACCTCCGGACCCAGTAAGGGATGCTTTCTTT	CSAPPDPVRDAFF	TRBV20-1	TRBJ1-1
TGTGCCAGTGGACTAGTGAACACCGGGGAGCTGTTTTTT	CASGLVNTGELFF	TRBV12-4	TRBJ2-2
TGTGCCAGCAGCACCTGGATCGAGGGGGGCAGCACAGATACGCAGTATTTT	CASSTWIEGGSTDTQYF	TRBV7-9	TRBJ2-3
TGCAAGGGACAGGAGAAAGAGCAGTACTTC	CKGQEKEQYF	TRBV5-1	TRBJ2-7
TGCGCCAGCAGTGAGACAGGGGGGCGCACTGAAGCTTTCTTT	CASSETGGRTEAFF	TRBV10-1	TRBJ1-1
TGTGCCAGCAGCAGGTCCGGGACAGGGGTGGGAAACACCATATATTTT	CASSRSGTGVGNTIYF	TRBV13	TRBJ1-3
TGTGCCAGCAGCTTAGTCACCATAGCTAACTATGGCTACACCTTC	CASSLVTIANYGYTF	TRBV7-6	TRBJ1-2
TGTGCCAGCAGTTCGACCCCGGGGGGGCCTACTGACAGCGAGCAGTACTTC	CASSSTPGGPTDSEQYF	TRBV12-4	TRBJ2-7
TGTGCCAGGAATCCCACTATGCCGTACAATGAGCAGTTCTTC	CARNPTMPYNEQFF	TRBV11-3	TRBJ2-1
TGCGCCAGCAGCTTCACAGGGGGCGGACCGTACTCCTACGAGCAGTACTTC	CASSFTGGGPYSYEQYF	TRBV5-1	TRBJ2-7
TGTGCCAGCAGCTTTGTGGGTTTAGATAAAATGAAGCTTAGCAATCAGCCCCAGCATTTT	CASSFVGLDKMKLSNQPQHF	TRBV7-2	TRBJ1-5
TGTGCCAGCAGCTTAGGCACCGGCCCGCGCACAGATACGCAGTATTTT	CASSLGTGPRTDTQYF	TRBV7-2	TRBJ2-3
TGTGCCAGCAGGGGTGGGGGGGCGGGGGGATACAATGAGCAGTTCTTC	CASRGGGAGGYNEQFF	TRBV2	TRBJ2-1
TGTGCCAGTAGACCCTGGAGGGAAACGGACTACGAGCAGTACTTC	CASRPWRETDYEQYF	TRBV19	TRBJ2-7
TGTGCCAGCAGCTCCGGGGCGGGGACAGGGACAGATACGCAGTATTTT	CASSSGAGTGTDTQYF	TRBV13	TRBJ2-3
TGTGCCAGCAGCCAAGATCACGGGGGGGCTTACTCTCGTACGCAGTATTTT	CASSQDHGGAYSRTQYF	TRBV4-2	TRBJ2-3
TGCGCCAGCAGCCAAGAGGTGACCGGGACAGGGGGGTATGGCTACACCTTC	CASSQEVTGTGGYGYTF	TRBV4-3	TRBJ1-2
TGTGCCAGCAGCCAACGGACAGGGAGGGTGGGGGCCAACGTCCTGACTTTC	CASSQRTGRVGANVLTF	TRBV5-4	TRBJ2-6
TGTGCCAGCAGAGGGGACAGGAGCAATCAGCCCCAGCATTTT	CASRGDRSNQPQHF	TRBV6-2	TRBJ1-5
TGTGCCAGCAGTGACGAACCATTTTCCCGAGCTCGGTACGAGCAGTACTTC	CASSDEPFSRARYEQYF	TRBV6-4	TRBJ2-7
TGCAGTGCGAAGGGGGCACCGCGACGATCCGTCAAGGGGCGCTCTGGGGCCAACGTCCTGACTTTC	CSAKGAPRRSVKGRSGANVLTF	TRBV20-1	TRBJ2-6
TGTGCCAGCAGTTTAGGGCCGGGACACGGCTACACCTTC	CASSLGPGHGYTF	TRBV27	TRBJ1-2
TGTGCCACCAGCAGCCTGAGGAAGGGGGGTAATCGCGGGGAGCTGTTTTTT	CATSSLRKGGNRGELFF	TRBV15	TRBJ2-2
TGCAGTGCTAGAGATCCCCCACAGGGATCGAACACTGAAGCTTTCTTT	CSARDPPQGSNTEAFF	TRBV20-1	TRBJ1-1
TGCCGGGTGGGGGGCTGGAAAAGGGCCTCCTACGAGCAGTACTTC	CRVGGWKRASYEQYF	TRBV20-1	TRBJ2-7
TGCAGTGCGTCCATGGGATATACTGAAGCTTTCTTT	CSASMGYTEAFF	TRBV20-1	TRBJ1-1
TGTGCCAGTAGCCCGACAGGGGGAGAGAACACTGAAGCTTTCTTT	CASSPTGGENTEAFF	TRBV19	TRBJ1-1
TGCAGTGCTAGGTGGGGGCTTGAGAGCAATCAGCCCCAGCATTTT	CSARWGLESNQPQHF	TRBV20-1	TRBJ1-5
TGTGCCAACTTAGGAGGACTAGCGGGGAACACCGGGGAGCTGTTTTTT	CANLGGLAGNTGELFF	TRBV7-2	TRBJ2-2
TGTGCCAGCAGGAAGACAGGGGAAAATTCACCCCTCCACTTT	CASRKTGENSPLHF	TRBV9	TRBJ1-6
TGTGCCAGCAGTGAGGGTAGGCGTGGTAGGGTACCTTACCCACCCCTCCACTTT	CASSEGRRGRVPYPPLHF	TRBV6-1	TRBJ1-6
TGTGCCAGCAGCATTAGGGACAACACCGGGGAGCTGTTTTTT	CASSIRDNTGELFF	TRBV13	TRBJ2-2
TGTGCCAGCAGCCCGATAGAGGGAAAAAGCTCTGGAAACACCATATATTTT	CASSPIEGKSSGNTIYF	TRBV7-3	TRBJ1-3
TGTGCCAGCAGCCAAGCAAGTCTAGCAGGGTGGCCCACTGAAGCTTTCTTT	CASSQASLAGWPTEAFF	TRBV3-1	TRBJ1-1
TGTGCCAGCAGCTTAGCGCGGCCTGGGGGGGTGTACACAGATACGCAGTATTTT	CASSLARPGGVYTDTQYF	TRBV7-2	TRBJ2-3
TGTGCCAGCAGGGACAGGGGGGACAGTAATTCAAACACCATATATTTT	CASRDRGDSNSNTIYF	TRBV14	TRBJ1-3
TGTGCCAGCAGTTCCGACAGGGGGAGATATGGCTACACCTTC	CASSSDRGRYGYTF	TRBV6-5	TRBJ1-2
TGTGCCAGCAGCCTCTGGGGGCAGGGCTCCTACGAGCAGTACTTC	CASSLWGQGSYEQYF	TRBV27	TRBJ2-7
TGTGCCAGCACGAGGGGGGGCCCCCGATACGAGCAGTACTTC	CASTRGGPRYEQYF	TRBV7-2	TRBJ2-7
TGTGCCAGCAGTCCGGACTCAAACTATGGCTACACCTTC	CASSPDSNYGYTF	TRBV6-5	TRBJ1-2
TGCGCCAGCAGTAGCAGGGGGGACGCACGCGGCTACACCTTC	CASSSRGDARGYTF	TRBV10-2	TRBJ1-2
TGTGCCAGCAGCAGAACACTAGCGGGAGTCGACCAAGAGACCCAGTACTTC	CASSRTLAGVDQETQYF	TRBV11-3	TRBJ2-5
TGTGCCAGGGTACCCGGCGACCGGAATTCACCCCTCCACTTT	CARVPGDRNSPLHF	TRBV7-4	TRBJ1-6
TGTGCCATCATCTGCAGGAATAGCAATCAGCCCCAGCATTTT	CAIICRNSNQPQHF	TRBV6-1	TRBJ1-5
TGTGCCAGCAGCCCTACTAACTATGGCTACACCTTC	CASSPTNYGYTF	TRBV7-2	TRBJ1-2
TGTGCCAGCAGCTTAAAGAGAGTTCTAGCCAAAAACATTCAGTACTTC	CASSLKRVLAKNIQYF	TRBV7-3	TRBJ2-4
TGTGCCAGCCTGACAGCGGGCAATCAGCCCCAGCATTTT	CASLTAGNQPQHF	TRBV6-3	TRBJ1-5
TGTGCCAGCATATCGCTGCCAGGGGGTCAGCCCCAGCATTTT	CASISLPGGQPQHF	TRBV28	TRBJ1-5
TGTGCCACCAGTGATTTGAATCGGACACTGTCGCATTATGGCTACACCTTC	CATSDLNRTLSHYGYTF	TRBV24-1	TRBJ1-2
TGTGCTAGTTGGAGCGGGAGTGGGTATTGGAATGAAAAACTGTTTTTT	CASWSGSGYWNEKLFF	TRBV12-5	TRBJ1-4
TGTGCCACCAGTGATTTGCGGACAGGGGGCCCGAATGGCTACACCTTC	CATSDLRTGGPNGYTF	TRBV24-1	TRBJ1-2
TGTGCCTGGAGAGGACGGAACAATGAGCAGTTCTTC	CAWRGRNNEQFF	TRBV30	TRBJ2-1
TGCGCCAGCAGCTTGGACGGCGCCACCTGGAGCGCTTTCTTT	CASSLDGATWSAFF	TRBV5-1	TRBJ1-1
TGTGCCTGGCCCCCAGGGAGTGGATACAATGAGCAGTTCTTC	CAWPPGSGYNEQFF	TRBV30	TRBJ2-1
TGTGCCAGCAGCTTGTGGGACAAGTCCCCCCGGGACAATAGGGATAATGAAAAACTGTTTTTT	CASSLWDKSPRDNRDNEKLFF	TRBV5-4	TRBJ1-4
TGTGCCAGCAGCGTAGCTGGTAGCGGGGATACGCAGTATTTT	CASSVAGSGDTQYF	TRBV9	TRBJ2-3
TGTGCCAGCAGCCAAGGTCAAACCCGACAGGACCGAAACTATGGCTACACCTTC	CASSQGQTRQDRNYGYTF	TRBV14	TRBJ1-2
TGTGCCAGCAGTTTAGGATTAGTAGGACTAGCGGGTCCAGATACGCAGTATTTT	CASSLGLVGLAGPDTQYF	TRBV28	TRBJ2-3
TGCGCCAGCAGCTTCCACCTTTGGGGATCTCAGCCCCAGCATTTT	CASSFHLWGSQPQHF	TRBV5-1	TRBJ1-5
TGTGCCAGCAGCTTAGAAAAGGGGGTTAGAAACCCAGATACGCAGTATTTT	CASSLEKGVRNPDTQYF	TRBV7-2	TRBJ2-3
TGTGCCAGCAGTGATAGTTTGAGGGAAAACTACGAGCAGTACTTC	CASSDSLRENYEQYF	TRBV6-1	TRBJ2-7
TGTGCCAGCAGCAGGGCAATTCAAATAGCCTACGAGCAGTACTTC	CASSRAIQIAYEQYF	TRBV13	TRBJ2-7
TGTGCCAGCAGTGACGAATTATTATGCTCCTACGAGCAGTACTTC	CASSDELLCSYEQYF	TRBV6-4	TRBJ2-7
TGTGCCAGCAGCCCGGCAGACAAAGAGACCCAGTACTTC	CASSPADKETQYF	TRBV27	TRBJ2-5
TGCAGTGCTACCGGGGGACCCTATAATTCACCCCTCCACTTT	CSATGGPYNSPLHF	TRBV20-1	TRBJ1-6
TGTGCCAGCAGCTTAAAGCAAGGTCCCTATGGCTACACCTTC	CASSLKQGPYGYTF	TRBV7-3	TRBJ1-2
TGTGCCAGCAGCCCAAGGCCGACTAGCGGGAGGGCCCGGACTAACGAGCAGTACTTC	CASSPRPTSGRARTNEQYF	TRBV5-5	TRBJ2-7
TGTGCCACCAGCAGAGCCCGGGACAGGAACTATGGCTACACCTTC	CATSRARDRNYGYTF	TRBV15	TRBJ1-2
TGTGCCAATACGGAGACAGGGCTGAGTAAACCTGGAAACACCATATATTTT	CANTETGLSKPGNTIYF	TRBV6-1	TRBJ1-3
TGTGCCAGCAGAGGCTTGGCCCCAGGACTAGAGACCCAGTACTTC	CASRGLAPGLETQYF	TRBV5-4	TRBJ2-5
TGTGCCAGCAGTCTAGTGTACTACGAGCAGTACTTC	CASSLVYYEQYF	TRBV6-4	TRBJ2-7
TGTGCCAGCAGCCAGTGGGTCGGGACAGATTTAAATGGAAACACCATATATTTT	CASSQWVGTDLNGNTIYF	TRBV4-2	TRBJ1-3
TGTGCCAGCGACCGGGGACCATATCAGCCCCAGCATTTT	CASDRGPYQPQHF	TRBV27	TRBJ1-5
TGTGCCAGCAGCTACCCTCGGCCCCCGTCTAGCACAGATACGCAGTATTTT	CASSYPRPPSSTDTQYF	TRBV5-6	TRBJ2-3
TGTGCCAGCAGTGTAGGCAGCAGCTCCTACGAGCAGTACTTC	CASSVGSSSYEQYF	TRBV28	TRBJ2-7
TGCAGTGCTAGAGCCGAATTCAGGACCGGACCTACAACTAATGAAAAACTGTTTTTT	CSARAEFRTGPTTNEKLFF	TRBV20-1	TRBJ1-4
TGTGCCAGCAGTGCGGAGGACATATTCTTTAACAACTATGGCTACACCTTC	CASSAEDIFFNNYGYTF	TRBV6-3	TRBJ1-2
TGCGCCAGCAGCCCTATGCGGGGGGAAGACTACGAGCAGTACTTC	CASSPMRGEDYEQYF	TRBV4-1	TRBJ2-7
TGTGCCAGCAGTTACGGGCCCCAGGGGCTAAAAAATGAAAAACTGTTTTTT	CASSYGPQGLKNEKLFF	TRBV6-3	TRBJ1-4
TGTGCCAGCAGCTTAGCTCCCCGACCTGACAGGGGCGACAATGAGCAGTTCTTC	CASSLAPRPDRGDNEQFF	TRBV7-9	TRBJ2-1
TGTGCCAGCAGCAACAGGACGTCCTCCTATAATTCACCCCTCCACTTT	CASSNRTSSYNSPLHF	TRBV13	TRBJ1-6
TGCAGCGTTGAAGAGCTTCCTCTACTGGCAGCCACTGAAGCTTTCTTT	CSVEELPLLAATEAFF	TRBV29-1	TRBJ1-1
TGTGCCAGCAGCCACACAGGGGCTGGGACTGAAGCTTTCTTT	CASSHTGAGTEAFF	TRBV5-6	TRBJ1-1
TGCGCCAGCATGGTCGGGGCAGTCTACTCCTACGAGCAGTACTTC	CASMVGAVYSYEQYF	TRBV10-1	TRBJ2-7
TGCGCCAGCAGTGACTCCGATCGAAGGGGCCAAGAGACCCAGTACTTC	CASSDSDRRGQETQYF	TRBV10-1	TRBJ2-5
TGTGCCAGCAGCCAGGGGTCCTGGACGCAGTATTTT	CASSQGSWTQYF	TRBV13	TRBJ2-3
TGTGCCAGCAGCCCCTATGGGCCCGGGGAAAAAGAGCAGTACTTC	CASSPYGPGEKEQYF	TRBV7-7	TRBJ2-7
TGTGCCAGCAGCCAAGATCTCACCGGGACAGAAAACATTCAGTACTTC	CASSQDLTGTENIQYF	TRBV14	TRBJ2-4
TGTGCCAGCAGCCAACCGGCTTTATCTAGCACAGATACGCAGTATTTT	CASSQPALSSTDTQYF	TRBV11-2	TRBJ2-3
TGTGCCAGCAGCAGCCCTTTCCGTAGGGGGGCGGGACATGAAAAACTGTTTTTT	CASSSPFRRGAGHEKLFF	TRBV7-3	TRBJ1-4
TGCGCCAGCAGCGACTTGGGGACTAGCAAGTCCTACAATGAGCAGTTCTTC	CASSDLGTSKSYNEQFF	TRBV5-1	TRBJ2-1
TGTGCCATCAAAGAAGACGAGACCCAGTACTTC	CAIKEDETQYF	TRBV10-3	TRBJ2-5
TGTGCCAGCAGCCCGACTCCCCATCCCGGGGATGAGCAGTTCTTC	CASSPTPHPGDEQFF	TRBV9	TRBJ2-1
TGTGCCACCAGTGAAGAGGGCGAGGGGACAGGTTTGTCTGCGACTGAAGCTTTCTTT	CATSEEGEGTGLSATEAFF	TRBV24-1	TRBJ1-1
TGTGCCAGCAGCTACCGGGATCCTTTAAGCTACGAGCAGTACTTC	CASSYRDPLSYEQYF	TRBV7-3	TRBJ2-7
TGTGCCAGCAGTTACCTAGTCGAGTTGTGCCAAGAGACCCAGTACTTC	CASSYLVELCQETQYF	TRBV6-6	TRBJ2-5
TGTGCCAGCCCCCTGTCTGGGGGGGGTCACGAGCAGTACTTC	CASPLSGGGHEQYF	TRBV14	TRBJ2-7
TGTGCCAGCAGCTTCACAGGGGGGGTTGGTAATTCACCCCTCCACTTT	CASSFTGGVGNSPLHF	TRBV7-2	TRBJ1-6
TGTGCCACCAGTGATACCACACAACAGGACAGGGTCGTGGCCACCTACGAGCAGTACTTC	CATSDTTQQDRVVATYEQYF	TRBV24-1	TRBJ2-7
TGCGCCAGCAGCCAAGATAGATTGACGTCCAGCACAGATACGCAGTATTTT	CASSQDRLTSSTDTQYF	TRBV4-3	TRBJ2-3
TGCAGTGCTAGTCCCCCAGGGCAGTACAATGAGCAGTTCTTC	CSASPPGQYNEQFF	TRBV20-1	TRBJ2-1
TGTGCCAGCAGCTTAATAGGAATTAGCGGGGTTCTCGATGAGCAGTACTTC	CASSLIGISGVLDEQYF	TRBV7-3	TRBJ2-7
TGTGCCACCAGCTCCAGCGGGAGGGCTGTTTACAATGAGCAGTTCTTC	CATSSSGRAVYNEQFF	TRBV15	TRBJ2-1
TGTGCCATCAGCCCCCTGGGAAGGGGGACCGGGGAGCTGTTTTTT	CAISPLGRGTGELFF	TRBV10-3	TRBJ2-2
TGCGCCAGCAGCTTGGGGAAAATAGACAGCTATGGCTACACCTTC	CASSLGKIDSYGYTF	TRBV5-1	TRBJ1-2
TGCAGCGGCGGGACACGAACCTACGAGCAGTACTTC	CSGGTRTYEQYF	TRBV29-1	TRBJ2-7
TGTGCCAAAGCCAGGGACTGGGGAACCTACAATGAGCAGTTCTTC	CAKARDWGTYNEQFF	TRBV13	TRBJ2-1
TGTGCCAGCAGTCTGGGCCAAGATACGCAGTATTTT	CASSLGQDTQYF	TRBV6-2	TRBJ2-3
TGTGCCAGCAGCGGGAGGGGGAGGGAGGGCAATGAGCAGTTCTTC	CASSGRGREGNEQFF	TRBV6-4	TRBJ2-1
TGTGCCAGCAGCTTGGGGGTTTTTTCTGATAAAATATACCCGAACACCGGGGAGCTGTTTTTT	CASSLGVFSDKIYPNTGELFF	TRBV5-6	TRBJ2-2
TGTGCCAGCGGGGACAGCGGGTGGATGAACACTGAAGCTTTCTTT	CASGDSGWMNTEAFF	TRBV6-4	TRBJ1-1
TGTGCCTTTTTGCAGGGGGGACGACTGGTCTCTGGGGCCAACGTCCTGACTTTC	CAFLQGGRLVSGANVLTF	TRBV30	TRBJ2-6
TGTGCCAGCAGTTACGGCCAAGACCGGGATCTATTCTACGAGCAGTACTTC	CASSYGQDRDLFYEQYF	TRBV6-2	TRBJ2-7
TGTGCCAGCAGTGTGGACGGCACAGATACGCAGTATTTT	CASSVDGTDTQYF	TRBV2	TRBJ2-3
TGTGCCAGCAGTGTCCTAGCGGGCGAGACCCAGTACTTC	CASSVLAGETQYF	TRBV28	TRBJ2-5
TGTGCCAGCCGTAACGGAGGGGTTTCCTACGAGCAGTACTTC	CASRNGGVSYEQYF	TRBV6-4	TRBJ2-7
TGTGCCAGCAGTCCTAGCGGGGCAGTCAATGAGCAGTTCTTC	CASSPSGAVNEQFF	TRBV28	TRBJ2-1
TGTGCCAGCAGCCAAGAAAACGTAGCGGGGCTGACCCTAGCCGACACCGGGGAGCTGTTTTTT	CASSQENVAGLTLADTGELFF	TRBV14	TRBJ2-2
TGTGCCAGCAGCTTACCCGCGGGGGGACTAGCGGTGCTGTACGAGCAGTACTTC	CASSLPAGGLAVLYEQYF	TRBV11-2	TRBJ2-7
TGTGCCAGCAGAAGACTTGAACCTGGAGAAATCGAGCAGTACTTC	CASRRLEPGEIEQYF	TRBV5-6	TRBJ2-7
TGTGCCAGCAGTTACACCCTAGGGACAGATACGCAGTATTTT	CASSYTLGTDTQYF	TRBV27	TRBJ2-3
TGTGCCAGCCCACAGGGAAATGGAAACACCATATATTTT	CASPQGNGNTIYF	TRBV27	TRBJ1-3
TGTGCCAGCCGACAACAGCCAATGTTGATATGGCAGTTCTTC	CASRQQPMLIWQFF	TRBV6-1	TRBJ2-1
TGTGCCAGCAGGGTATGGCTCCTAGCGGGGTACACCGGGGAGCTGTTTTTT	CASRVWLLAGYTGELFF	TRBV6-5	TRBJ2-2
TGTGCCAGCTCCCCCTTGACAGTCTCTGGAAACACCATATATTTT	CASSPLTVSGNTIYF	TRBV18	TRBJ1-3
TGTGCCACCAGTGGGCCCCCGCCCGGGACAGTTGTCGAGACCCAGTACTTC	CATSGPPPGTVVETQYF	TRBV24-1	TRBJ2-5
TGCGCCAGCCCACACAGACGGGCCTACGAGCAGTACTTC	CASPHRRAYEQYF	TRBV10-2	TRBJ2-7
TGCAGTGCTGAGGAGGGCTCTCTTACGCAGTATTTT	CSAEEGSLTQYF	TRBV20-1	TRBJ2-3
TGCGCCAGCAGTGAGTGGATCGGGGACTGCCGTAATGAGCAGTTCTTC	CASSEWIGDCRNEQFF	TRBV10-1	TRBJ2-1
TGTGCCAGCAGTTGTGGAGACGAGCAGTACTTC	CASSCGDEQYF	TRBV27	TRBJ2-7
TGTGCCACCAGTGATAATTCAGGGGGCGGGGCCTCTGGAAACACCATATATTTT	CATSDNSGGGASGNTIYF	TRBV24-1	TRBJ1-3
TGTGCCAGCAGCCAAGAGGGGAAATTTGGCTACACCTTC	CASSQEGKFGYTF	TRBV14	TRBJ1-2
TGTGCTAGCAGCGACTATGAGGGACAGGGAGGCAATCAGCCCCAGCATTTT	CASSDYEGQGGNQPQHF	TRBV7-7	TRBJ1-5
TGTGCCAGCAGTGAACATCCGACAGGTGGCTACACCTTC	CASSEHPTGGYTF	TRBV6-1	TRBJ1-2
TGTGCCAGCAGCGAGGGGGGGACCGATAGGCCCGAGCAGTACTTC	CASSEGGTDRPEQYF	TRBV11-2	TRBJ2-7
TGTGCCAGCAGTTCACTCTTTCAGGGGTCATTAATCACAGATACGCAGTATTTT	CASSSLFQGSLITDTQYF	TRBV6-2	TRBJ2-3
TGTGCCAGCGGGGGGCTGGCTACTGAAGCTTTCTTT	CASGGLATEAFF	TRBV28	TRBJ1-1
TGTGCCACCAGCAGAGTGGGGCGGACAGGGGGTAGCTACGAGCAGTACTTC	CATSRVGRTGGSYEQYF	TRBV15	TRBJ2-7
TGTGCCAGTAGCCTCGGACTAGGGTTGGATGTCCAAGAGACCCAGTACTTC	CASSLGLGLDVQETQYF	TRBV19	TRBJ2-5
TGCAGTGCTAGACCAGGGGACACCGGGGAGCTGTTTTTT	CSARPGDTGELFF	TRBV20-1	TRBJ2-2
TGCGCCAGCAGCCACCACCCTAGGTTTAATACAGATACGCAGTATTTT	CASSHHPRFNTDTQYF	TRBV4-1	TRBJ2-3
TGTGCCAGCCCCTGCGGGAGGGGGTACGAGCAGTACTTC	CASPCGRGYEQYF	TRBV11-3	TRBJ2-7
TGTGCCAGCCCAACCTGGTGCGCTTTCTTT	CASPTWCAFF	TRBV27	TRBJ1-1
TGTGCCAGTAGTAACACCAAAACGGGGGGATCGGGTGAAAAACTGTTTTTT	CASSNTKTGGSGEKLFF	TRBV19	TRBJ1-4
TGCGCTAGGGGGGGGAGGGACTACGAGCAGTACTTC	CARGGRDYEQYF	TRBV10-1	TRBJ2-7
TGTGCCAGCAGTGACAATACCTGGACAGGCCCAGTCTATGGCTACACCTTC	CASSDNTWTGPVYGYTF	TRBV6-4	TRBJ1-2
TGTGCCTTAAACATAACCTCTACTGAAGCTTTCTTT	CALNITSTEAFF	TRBV30	TRBJ1-1
TGTGCCAGCAGTACTAGTACGAGCTCCTACGAGCAGTACTTC	CASSTSTSSYEQYF	TRBV7-9	TRBJ2-7
TGTGCCAGCAGCCAAGATCGATTGCTAGGCTCTGGAAACACCATATATTTT	CASSQDRLLGSGNTIYF	TRBV3-1	TRBJ1-3
TGCAGCGTTGTTGCCGGGACAGGGGATTGGATCCGCACTGAAGCTTTCTTT	CSVVAGTGDWIRTEAFF	TRBV29-1	TRBJ1-1
TGTGCCACCAGCAGCCTACGCACAGATACGCAGTATTTT	CATSSLRTDTQYF	TRBV15	TRBJ2-3
TGTGCCAGCAGTCTGCCCGACTTTGGCTACACCTTC	CASSLPDFGYTF	TRBV6-2	TRBJ1-2
TGTGCCAGCAGCGACCTAGCGGGGGGCACAGATACGCAGTATTTT	CASSDLAGGTDTQYF	TRBV7-3	TRBJ2-3
TGCGCCAGCAGCAATCGCGGGGGCATTCAGTACTTC	CASSNRGGIQYF	TRBV5-1	TRBJ2-4
TGTGCCAGCAGTACCCCAGGTCAAGAAGAGCGTGGGGACAGTATTGAAGTCTATGGCTACACCTTC	CASSTPGQEERGDSIEVYGYTF	TRBV27	TRBJ1-2
TGTGCCAGCAGGTTCCGTACGTCATATGAGCAGTTCTTC	CASRFRTSYEQFF	TRBV5-6	TRBJ2-1
TGCGCCAGCATTCGAGGGGGGCATCAGCCCCAGCATTTT	CASIRGGHQPQHF	TRBV10-1	TRBJ1-5
TGCAGTGCCCAGACAGGGACTGAAGCTTTCTTT	CSAQTGTEAFF	TRBV20-1	TRBJ1-1
TGTGCCACCAGCAGTTTTCCGCCGGGACAGGGGAAAGCCTACGAGCAGTACTTC	CATSSFPPGQGKAYEQYF	TRBV15	TRBJ2-7
TGCGCCAGCAGCTTGGCAAAAGAGTTTTACGAGCAGTACTTC	CASSLAKEFYEQYF	TRBV5-1	TRBJ2-7
TGTGCCAGCAGCGAACCCGGTTACATGCATGGCTACACCTTC	CASSEPGYMHGYTF	TRBV11-2	TRBJ1-2
TGTGCCAGCTCACTTAGGGGCCAAGAGACCCAGTACTTC	CASSLRGQETQYF	TRBV18	TRBJ2-5
TGTGCCAGCAGCCGTAATACAAACACAGATACGCAGTATTTT	CASSRNTNTDTQYF	TRBV13	TRBJ2-3
TGTGCCAGTAGTATAAAGGTGAGCCGGGACAGGAGGATCGGCTATGGCTACACCTTC	CASSIKVSRDRRIGYGYTF	TRBV19	TRBJ1-2
TGTGCCAGGGAGGGGGGGGAGACAACTAGCACAGATACGCAGTATTTT	CAREGGETTSTDTQYF	TRBV9	TRBJ2-3
TGTGCCAGCAGGGCCCTAGACCCAGTCTCACGAAACGCAGATACGCAGTATTTT	CASRALDPVSRNADTQYF	TRBV27	TRBJ2-3
TGTGCCAGCAGCGCTGGTGGGACAGAAGGCTCCTACGAGCAGTACTTC	CASSAGGTEGSYEQYF	TRBV11-3	TRBJ2-7
TGTGCCACCAGTGAAGGGACAGAGAACAATAATGGCTACACCTTC	CATSEGTENNNGYTF	TRBV24-1	TRBJ1-2
TGTGCCAGCTTCAAGGGTACCCAGGGAACCTCTGGAAACACCATATATTTT	CASFKGTQGTSGNTIYF	TRBV2	TRBJ1-3
TGTGGAGGGAGGACGTTGTCCAAGGTTGATACGCAGTATTTT	CGGRTLSKVDTQYF	TRBV19	TRBJ2-3
TGTGCCAGCAGCTCCGGACCAGGGGAGGCTTTTTCGAACACTGAAGCTTTCTTT	CASSSGPGEAFSNTEAFF	TRBV5-6	TRBJ1-1
TGTGCCAGCAGTTATATATACAGCGGGGCGGAGCTGTTTTTT	CASSYIYSGAELFF	TRBV6-5	TRBJ2-2
TGTGCCAGCAGCCCTCGGGGGGCAGATACGCAGTATTTT	CASSPRGADTQYF	TRBV13	TRBJ2-3
TGTGCCAGCTCACCACCCCCGGACGTGAACTATGGCTACACCTTC	CASSPPPDVNYGYTF	TRBV18	TRBJ1-2
TGTGCCAGCACCACGCGGGAAAAGGCCGCCGGGGAGCTGTTTTTT	CASTTREKAAGELFF	TRBV11-3	TRBJ2-2
TGTGCCAGCAATGGGTGGGGTAGATATAATTCACCCCTCCACTTT	CASNGWGRYNSPLHF	TRBV6-1	TRBJ1-6
TGTGCCAGCAGCGGGGGGGACACCGGGGAGCTGTTTTTT	CASSGGDTGELFF	TRBV13	TRBJ2-2
TGCGCCAGAAAGACAGGGCACTATGGCTACACCTTC	CARKTGHYGYTF	TRBV10-1	TRBJ1-2
TGTGCCAGCAGCAGCCGCCAGGGGGGGGAAATCGCAACTAATGAAAAACTGTTTTTT	CASSSRQGGEIATNEKLFF	TRBV7-2	TRBJ1-4
TGCGCCAGCAGCGAAGGATACGGGACTAGCGGCGAGGATACGCAGTATTTT	CASSEGYGTSGEDTQYF	TRBV5-1	TRBJ2-3
TGTGCCAGCATAAGGACAGGGTTCTCTGGAAACACCATATATTTT	CASIRTGFSGNTIYF	TRBV11-2	TRBJ1-3
TGTGCCAGGAACAGCCGTGGCCATGAAGCTTTCTTT	CARNSRGHEAFF	TRBV19	TRBJ1-1
TGTGCCAGCAGTGCAACCGACAGGGCCGGGGAGCTGTTTTTT	CASSATDRAGELFF	TRBV6-2	TRBJ2-2
TGTGCCAGTGTCAACTCAGGGGACAGTCCGCATCAGCCCCAGCATTTT	CASVNSGDSPHQPQHF	TRBV25-1	TRBJ1-5
TGTGCCAGCACGGGGGGGATCCCTAGGTACAATGAGCAGTTCTTC	CASTGGIPRYNEQFF	TRBV25-1	TRBJ2-1
TGTGCCAGCAGTGACTCACAAGGGGGTTCATGGTCCTACGAGCAGTACTTC	CASSDSQGGSWSYEQYF	TRBV6-4	TRBJ2-7
TGTGCCAGCAGTTTGTTTCGGCGGTGTCTACTGTACAATGAGCAGTTCTTC	CASSLFRRCLLYNEQFF	TRBV27	TRBJ2-1
TGTGCCAAGGGAAGCCCTATGACTGAAGCTTTCTTT	CAKGSPMTEAFF	TRBV19	TRBJ1-1
TGCGCCAGCAGTGACAGGGAAGAGACCCAGTACTTC	CASSDREETQYF	TRBV10-1	TRBJ2-5
TGTGCCAGCGACGGAGAGAGCTATGGCTACACCTTC	CASDGESYGYTF	TRBV2	TRBJ1-2
TGTGCCAGCTCACCCTCGGAGACAGGGCTAGCTAATGAAAAACTGTTTTTT	CASSPSETGLANEKLFF	TRBV18	TRBJ1-4
TGCGCCAGCAGCCTGTTTGTCGAAGGACTAGTCTCCTACGAGCAGTACTTC	CASSLFVEGLVSYEQYF	TRBV4-1	TRBJ2-7
TGTGCCAGCAGTTTTTCCCGACAGCGGGCGTACACCGGGGAGCTGTTTTTT	CASSFSRQRAYTGELFF	TRBV28	TRBJ2-2
TGTGCTAGTGCCCCGACGAGGACTGAAGCTTTCTTT	CASAPTRTEAFF	TRBV12-5	TRBJ1-1
TGTGCCAGTAGTCGCCACCCGGGACAGGATGGCTACACCTTC	CASSRHPGQDGYTF	TRBV19	TRBJ1-2
TGCGCCAGCAGCTTGATTGGGACAGACAATGAGCAGTTCTTC	CASSLIGTDNEQFF	TRBV5-1	TRBJ2-1
TGTGCCAGCAGCCCGCAGGCTGAAGCTTTCTTT	CASSPQAEAFF	TRBV7-9	TRBJ1-1
TGTGCCAGCAGCCGTGGCAGAGCCAACACCGGGGAGCTGTTTTTT	CASSRGRANTGELFF	TRBV13	TRBJ2-2
TGTGCCAGCAGTGAACCTGCAGGGGTCGGTCAGAGCCACACCGGGGAGCTGTTTTTT	CASSEPAGVGQSHTGELFF	TRBV2	TRBJ2-2
TGCAGTGCTGGGGACAGATACTACGAGCAGTACTTC	CSAGDRYYEQYF	TRBV20-1	TRBJ2-7
TGCGCCAGCAGCCTTGGAGAGGAGCAGTACTTC	CASSLGEEQYF	TRBV10-2	TRBJ2-7
TGTGCCAGCAGTCGAGTCCACCCATACGAGCAGTACTTC	CASSRVHPYEQYF	TRBV6-2	TRBJ2-7
TGTGCCAGTACATTCGACATCGGGGATGGCTACACCTTC	CASTFDIGDGYTF	TRBV19	TRBJ1-2
TGTGCCAGCAGTTACCTCGGGGGCTACGAGCAGTACTTC	CASSYLGGYEQYF	TRBV6-5	TRBJ2-7
TGTGCCAGCAGCTTAGGGCGGAAAGATGAGCAGTTCTTC	CASSLGRKDEQFF	TRBV7-9	TRBJ2-1
TGTGCCATCAGGAGGAGGACGCGGGACGGGAAAAACATTCAGTACTTC	CAIRRRTRDGKNIQYF	TRBV10-3	TRBJ2-4
TGCAGTGCTGGACAGGGGGCTATCACTGAAGCTTTCTTT	CSAGQGAITEAFF	TRBV20-1	TRBJ1-1
TGTGCCAGCAGTTTATGCCGGGTGGGGACAGCAGGGAGCCAAGAGACCCAGTACTTC	CASSLCRVGTAGSQETQYF	TRBV28	TRBJ2-5
TGTGCCATAATCCCACGGGAGGTCCCAGTCTTT	CAIIPREVPVF	TRBV28	TRBJ1-1
TGTGCCAGCAGCTTGGGCAGGTTCGGGAGGGACGTCCCCTACGAGCAGTACTTC	CASSLGRFGRDVPYEQYF	TRBV5-6	TRBJ2-7
TGTGCCATCAGTCCAGACAGGGTGTCAGATACGCAGTATTTT	CAISPDRVSDTQYF	TRBV10-3	TRBJ2-3
TGTGCCAGCAGCGGAGTGGACAGGGGCCACGGGGATTTTACTCCGAATCAGCCCCAGCATTTT	CASSGVDRGHGDFTPNQPQHF	TRBV7-4	TRBJ1-5
TGTGCCAGCAGTCTCGAGCAGCCCCAGCATTTT	CASSLEQPQHF	TRBV27	TRBJ1-5
TGTGCCAGGATCAGGTTGACTAGGTATAGCTCCTACGAGCAGTACTTC	CARIRLTRYSSYEQYF	TRBV9	TRBJ2-7
TGTGCCAGCAGAAAGGGGGTTAGGAACACTGAAGCTTTCTTT	CASRKGVRNTEAFF	TRBV28	TRBJ1-1
TGTGCCAGCAGTGAAATTTCGGGGGACTATGGCTACACCTTC	CASSEISGDYGYTF	TRBV2	TRBJ1-2
TGTGCCAGCAGCGTAGAAGGGACTGGATCGATCTTC	CASSVEGTGSIF	TRBV9	TRBJ2-1
TGTGCCAGCAGCCGGTCGGGAGGCCAGGGCTACACCTTC	CASSRSGGQGYTF	TRBV5-6	TRBJ1-2
TGTGCCATCTCTGGACCCACGAACACTGAAGCTTTCTTT	CAISGPTNTEAFF	TRBV27	TRBJ1-1
TGTGCCACCGGCTGGGGGACTGAAGCTTTCTTT	CATGWGTEAFF	TRBV24-1	TRBJ1-1
TGTGCCAGCAGCCCACGAGTTCGGGGTGAAGCTTTCTTT	CASSPRVRGEAFF	TRBV7-4	TRBJ1-1
TGTGCCAGCAGTTTTGGGATACAGGGGATCGGCTATGGCTACACCTTC	CASSFGIQGIGYGYTF	TRBV27	TRBJ1-2
TGTGCCAGCAGTGTCAAAAGGTCAGGGGCGCAACCCCTCCACTTT	CASSVKRSGAQPLHF	TRBV25-1	TRBJ1-6
TGTGCCAGCAGTTACGGGACAGGGAATTACGAGCAGTACTTC	CASSYGTGNYEQYF	TRBV6-5	TRBJ2-7
TGTGCCAGCAGCTTGGTGGGACAATCCTACAATGAGCAGTTCTTC	CASSLVGQSYNEQFF	TRBV7-9	TRBJ2-1
TGTGCCAGCAGCTTAGATTCTCGGCCCTACTACGAGCAGTACTTC	CASSLDSRPYYEQYF	TRBV11-2	TRBJ2-7
TGTGCCAGCAGCTTTCTGCGGGGGAAGAACTATGGCTACACCTTC	CASSFLRGKNYGYTF	TRBV7-2	TRBJ1-2
TGTGCCACCCCTCCCTGGGGACTTACTGAAGCTTTCTTT	CATPPWGLTEAFF	TRBV24-1	TRBJ1-1
TGTGCCAGCAATGGGGACGAGCAGTACTTC	CASNGDEQYF	TRBV27	TRBJ2-7
TGTGCCAGCCCCAGGGCTCATACTGTTCTTAGCAATCAGCCCCAGCATTTT	CASPRAHTVLSNQPQHF	TRBV11-2	TRBJ1-5
TGTGCCAGCAGGCACAGGGGGGGGAGAGAGACCCAGTACTTC	CASRHRGGRETQYF	TRBV6-3	TRBJ2-5
TGTGCCAGCTCACCAGGGCAGGGAATGACATGGGAAAAACTGTTTTTT	CASSPGQGMTWEKLFF	TRBV18	TRBJ1-4
TGTGCCAGCAGCTTGACTAGGAGCACAGATACGCAGTATTTT	CASSLTRSTDTQYF	TRBV7-9	TRBJ2-3
TGTGCCAGCAGTTACCCCCCCCTCCCGGGGGGATACAATGAGCAGTTCTTC	CASSYPPLPGGYNEQFF	TRBV6-3	TRBJ2-1
TGTGCTAGCAGCTTAATTCGACAGCACAACACCATATATTTT	CASSLIRQHNTIYF	TRBV7-7	TRBJ1-3
TGTGCCAGCAGCTGGGGACAGGGGCGGAAAGTCACAGATACGCAGTATTTT	CASSWGQGRKVTDTQYF	TRBV11-2	TRBJ2-3
TGTGCCAGTCTCGCAGGTCATCAGCCCCAGCATTTT	CASLAGHQPQHF	TRBV19	TRBJ1-5
TGTGCCAGCTCACCACAGGGAGACAGGGTCCCCTACGAGCAGTACTTC	CASSPQGDRVPYEQYF	TRBV18	TRBJ2-7
TGTGCCACCCCACAGGGGGCCAAGGGGGGGAGCTACGAGCAGTACTTC	CATPQGAKGGSYEQYF	TRBV24-1	TRBJ2-7
TGTGCCAGCAGAATGGGGGGGGAACAAGGGCAGTTCTTC	CASRMGGEQGQFF	TRBV7-3	TRBJ2-1
TGCAGTGCTAGAGGGGGGGTCGGGACAGGAAGCAATCAGCCCCAGCATTTT	CSARGGVGTGSNQPQHF	TRBV20-1	TRBJ1-5
TGCAGTGCCTGGAACTCGAGCTCCTACGAGCAGTACTTC	CSAWNSSSYEQYF	TRBV20-1	TRBJ2-7
TGCAGCGCACCCAGGGACGAGCAGTACTTC	CSAPRDEQYF	TRBV29-1	TRBJ2-7
TGCGCCAGCAGCTTGGAGCCCCTAGCGGGGGGGCACAACTACGAGCAGTACTTC	CASSLEPLAGGHNYEQYF	TRBV5-1	TRBJ2-7
TGCGCCAGCAGTAACCCAGGACCCTTGAGGAACACTGAAGCTTTCTTT	CASSNPGPLRNTEAFF	TRBV10-1	TRBJ1-1
TGCAGTGCTAGAGTCTCACAGGGAAAAGAGCAGTACTTC	CSARVSQGKEQYF	TRBV20-1	TRBJ2-7
TGTGCCAGCAGCTTGCGGGAGAATGAGCAGTTCTTC	CASSLRENEQFF	TRBV7-9	TRBJ2-1
TGTGCCAGCAGCTGCGGGAGCCAGGAAGATACGCAGTATTTT	CASSCGSQEDTQYF	TRBV7-3	TRBJ2-3
TGCAGTGCTAGAGTAAAGGGAGGGGGGCTAACGGTGAACACTGAAGCTTTCTTT	CSARVKGGGLTVNTEAFF	TRBV20-1	TRBJ1-1
TGTGCCAGCAGTCGTATTCCAGAGGTTAGCAATCAGCCCCAGCATTTT	CASSRIPEVSNQPQHF	TRBV7-9	TRBJ1-5
TGTGCCAGCAGTGAAGCGACGAGGGCAACCGGGGAGCTGTTTTTT	CASSEATRATGELFF	TRBV6-1	TRBJ2-2
TGTGCCAGCAGCGAGCCGGCGGAGGAATTATCAGATACGCAGTATTTT	CASSEPAEELSDTQYF	TRBV7-3	TRBJ2-3
TGCAGTGCTAGGGGAAAGGACAGGGTAAATGAAAAACTGTTTTTT	CSARGKDRVNEKLFF	TRBV20-1	TRBJ1-4
TGTGCCAGCAGTTTAGGCAGCACTGAAGCTTTCTTT	CASSLGSTEAFF	TRBV12-3	TRBJ1-1
TGCACCTTGACAGGTACGCCCCAGCATTTT	CTLTGTPQHF	TRBV20-1	TRBJ1-5
TGTGCCAGCAGCCAAGTCCGGACAGATCCGGACAATGAGCAGTTCTTC	CASSQVRTDPDNEQFF	TRBV14	TRBJ2-1
TGCAGTGCTAGCGTAGGGATCGAATATAAAACCAGCAATCAGCCCCAGCATTTT	CSASVGIEYKTSNQPQHF	TRBV20-1	TRBJ1-5
TGCAGCTCCTTCGGCGACAGGGGGAATGAAAAACTGTTTTTT	CSSFGDRGNEKLFF	TRBV29-1	TRBJ1-4
TGCGCCAGCAGCCAGGACAGACGTGAAAAACTGTTTTTT	CASSQDRREKLFF	TRBV4-1	TRBJ1-4
TGTGCCAGCAGCCAAGAGTTGGGGAGCTTC	CASSQELGSF	TRBV14	TRBJ2-5
TGTGCCAGCAGCCCGACTAGCGATTACGAGCAGTACTTC	CASSPTSDYEQYF	TRBV7-9	TRBJ2-7
TGTGCCAGCAGCTTAAGGCCAGGACTAGCGGGCTCCTACGAGCAGTACTTC	CASSLRPGLAGSYEQYF	TRBV7-2	TRBJ2-7
TGTGCCATCATTCCCGCTTGTCAGGGCCCGGAAGACTACGAGCAGTACTTC	CAIIPACQGPEDYEQYF	TRBV10-3	TRBJ2-7
TGTGCCAGCAGTACGGGGGGAAACACCATATATTTT	CASSTGGNTIYF	TRBV27	TRBJ1-3
TGTGCCAGCAGTTACTCGATGTTCCGGGAGACTAGCATAAGGGTAAATGAGCAGTTCTTC	CASSYSMFRETSIRVNEQFF	TRBV6-5	TRBJ2-1
TGTGCCATCAGTGAGAGACACGGAGATACGCAGTATTTT	CAISERHGDTQYF	TRBV10-3	TRBJ2-3
TGTGCCAGCAGTGAAGTAAGGGAGAAGGAGAACACCGGGGAGCTGTTTTTT	CASSEVREKENTGELFF	TRBV6-1	TRBJ2-2
TGCAGTGCTAGAGAGGTACAGGGGAAAGGGGACGAGCAGTACTTC	CSAREVQGKGDEQYF	TRBV20-1	TRBJ2-7
TGCGCCAGCAGCTTGGTTAGCGACAGGGACTATGGCTACACCTTC	CASSLVSDRDYGYTF	TRBV5-1	TRBJ1-2
TGTGCCAGCAGCTTCAGGGGGCCTGAAGCTTTCTTT	CASSFRGPEAFF	TRBV5-6	TRBJ1-1
TGTGCCAGCAGTTACCTCGGGACGACAGGGATCAATGAGCAGTTCTTC	CASSYLGTTGINEQFF	TRBV6-6	TRBJ2-1
TGTGCCAGCAGCGGGGGCACAGGGGGCGAGCAGTACTTC	CASSGGTGGEQYF	TRBV9	TRBJ2-7
TGTGCCAGCAGCTTTCCCCTCCCACCCAATGAGCAGTTCTTC	CASSFPLPPNEQFF	TRBV11-3	TRBJ2-1
TGCGCCAGCAGCCAAGGAAAACTAGCGGGGGCGGGGGCAGATACGCAGTATTTT	CASSQGKLAGAGADTQYF	TRBV4-1	TRBJ2-3
TGCAGTGCTAGAGATCCCAGGGAGGTAAGCTCCTACGAGCAGTACTTC	CSARDPREVSSYEQYF	TRBV20-1	TRBJ2-7
TGTGCCAGTAGTACAGGGGTTGGCGGCGGGGAGCTGTTTTTT	CASSTGVGGGELFF	TRBV19	TRBJ2-2
TGTGCCAGCAGTGGGGGGCCCTACTCTTCCTACGAGCAGTACTTC	CASSGGPYSSYEQYF	TRBV6-3	TRBJ2-7
TGCAGTGCGGGGGACAGGAACACTGAAGCTTTCTTT	CSAGDRNTEAFF	TRBV20-1	TRBJ1-1
TGTGCCTGGAGATCTGGGGACAGGGCTGGTACGCAGTATTTT	CAWRSGDRAGTQYF	TRBV30	TRBJ2-3
TGTGCCAGCAGCCATGACTCTAGCGGGCCAAATGAGCAGTTCTTC	CASSHDSSGPNEQFF	TRBV4-2	TRBJ2-1
TGTGCCAGCAGCTTAGCACCGGGACAGGGCCCAGATACGCAGTATTTT	CASSLAPGQGPDTQYF	TRBV5-4	TRBJ2-3
TGCAGTGCGGGGGACAGGGGGGATCAGCCCCAGCATTTT	CSAGDRGDQPQHF	TRBV20-1	TRBJ1-5
TGTGCCAGTAGTATCTCTACAGGTAATGAGACCCAGTACTTC	CASSISTGNETQYF	TRBV19	TRBJ2-5
TGTGCCAGCAGCCACAAGTTCCCAGGGGGCTCGGGCAATCAGCCCCAGCATTTT	CASSHKFPGGSGNQPQHF	TRBV7-9	TRBJ1-5
TGTGCCAGCAGCTGCCCGGGGGGGCAAGACTACAATGAGCAGTTCTTC	CASSCPGGQDYNEQFF	TRBV5-5	TRBJ2-1
TGCAGCGCACATGTTCAACCTGGGGCCAACGTCCTGACTTTC	CSAHVQPGANVLTF	TRBV29-1	TRBJ2-6
TGTGCCAGCAGCGGGGGAGCCCGTTCCTACGAGCAGTACTTC	CASSGGARSYEQYF	TRBV7-9	TRBJ2-7
TGCGCCAGCAGCCAAGTTGACAGGAAAGCTTTCTTT	CASSQVDRKAFF	TRBV4-3	TRBJ1-1
TGTGCCAGCAGTTGGGTTGGAAATCCGACGGGCACCGGGGAGCTGTTTTTT	CASSWVGNPTGTGELFF	TRBV28	TRBJ2-2
TGTGCCAGCAGCTTGCGGGAGGTAGCTAAGGGCCAAGAGACCCAGTACTTC	CASSLREVAKGQETQYF	TRBV5-6	TRBJ2-5
TGTGCCAGCAGGGCCAAGAACGCTAAGACCCAGTACTTC	CASRAKNAKTQYF	TRBV28	TRBJ2-5
TGTGCCAGCAGCCCCCAAGGGCGACAGGGGGGACTGAACACTGAAGCTTTCTTT	CASSPQGRQGGLNTEAFF	TRBV4-2	TRBJ1-1
TGTGCCAGCTCACCACCTGATGCTAGCACAGATACGCAGTATTTT	CASSPPDASTDTQYF	TRBV18	TRBJ2-3
TGTGCCAGCAGTTACGGGCAACAGGGCCGGTTCGACGAGCAGTACTTC	CASSYGQQGRFDEQYF	TRBV6-6	TRBJ2-7
TGTGCCAGCAGCGACAACCGACACGGTCCCAGAAACACCATATATTTT	CASSDNRHGPRNTIYF	TRBV13	TRBJ1-3
TGTGCCAGCAGAACCGGTACCTCCTACAATGAGCAGTTCTTC	CASRTGTSYNEQFF	TRBV11-3	TRBJ2-1
TGTGCCACCAGTGATCGCACAAAAACAGGGGGGGCCCAAGAGACCCAGTACTTC	CATSDRTKTGGAQETQYF	TRBV24-1	TRBJ2-5
TGCGCCAGCAGCCAACTAAAAGGGGGCGCGGGCTATGGCTACACCTTC	CASSQLKGGAGYGYTF	TRBV4-1	TRBJ1-2
TGCGCCAGCAGCCAACCTGAAGTAAGGCCGGGACTAACACCCGGGGAGCTGTTTTTT	CASSQPEVRPGLTPGELFF	TRBV4-3	TRBJ2-2
TGTGCCAGCAGTTTGGAAAGCCCTTGGGGGGTCGTCCAGGCGAGCAATAGCAATCAGCCCCAGCATTTT	CASSLESPWGVVQASNSNQPQHF	TRBV27	TRBJ1-5
TGTGCCAGCAGAAACGGGGTTAACACTGAAGCTTTCTTT	CASRNGVNTEAFF	TRBV6-2	TRBJ1-1
TGTGCCATCAGGCGAGGGGGCTCAAAAGCTAGCACAGATACGCAGTATTTT	CAIRRGGSKASTDTQYF	TRBV10-3	TRBJ2-3
TGCGCCAGCAGCTTGGACTGGGACAGGGCCGTCTATGGCTACACCTTC	CASSLDWDRAVYGYTF	TRBV5-1	TRBJ1-2
TGTGCCAGCAGCGGGGGGGACCTTTTTGAGCAGTTCTTC	CASSGGDLFEQFF	TRBV13	TRBJ2-1
TGCAGTGCTAGAGATGCGGGGGTTGGTAATGAGCAGTTCTTC	CSARDAGVGNEQFF	TRBV20-1	TRBJ2-1
TGCGCCAGCATAATGGGGGGGGGAGAGGGCTACACCTTC	CASIMGGGEGYTF	TRBV10-2	TRBJ1-2
TGTGCCAGCACCCAAGTGACAGTTTGGTCAAACACCATATATTTT	CASTQVTVWSNTIYF	TRBV12-3	TRBJ1-3
TGCGCCAGCAGCTCCGCAAACGCCAATGGCTACACCTTC	CASSSANANGYTF	TRBV5-1	TRBJ1-2
TGTGCCAGCAGCTTAGATAAGAGGGGCACGCTGACGAACACTGAAGCTTTCTTT	CASSLDKRGTLTNTEAFF	TRBV11-3	TRBJ1-1
TGCAGTGCAGCGAAGGACATAAAGTGGTACGAGCAGTACTTC	CSAAKDIKWYEQYF	TRBV20-1	TRBJ2-7
TGTGCCACCAGCAGAGGGTCCGCGGTGATTTACGAGCAGTACTTC	CATSRGSAVIYEQYF	TRBV15	TRBJ2-7
TGTGCCAGCAGGCACGTTCGGCGACAGCCTAGGACCGGGGAGCTGTTTTTT	CASRHVRRQPRTGELFF	TRBV28	TRBJ2-2
TGTGCCAGCGGCACTGATCGTCACTATGGCTACACCTTC	CASGTDRHYGYTF	TRBV5-4	TRBJ1-2
TGTGCCAGCAATACGCGGGACGAATACAATGAGCAGTTCTTC	CASNTRDEYNEQFF	TRBV6-5	TRBJ2-1
TGTGGTGGACAGGGGTTGGGGGCGAACACTGAAGCTTTCTTT	CGGQGLGANTEAFF	TRBV2	TRBJ1-1
TGTGCCAGCTCACGGGGTTATACCTACGAGCAGTACTTC	CASSRGYTYEQYF	TRBV18	TRBJ2-7
TGTGCCACCAGTGTGCGGGCTTCCTACGAGCAGTACTTC	CATSVRASYEQYF	TRBV24-1	TRBJ2-7
TGTGCTAGTGGTTTGGTACACCTGGCTTATAAAACAGATACGCAGTATTTT	CASGLVHLAYKTDTQYF	TRBV12-5	TRBJ2-3
TGTGCCAGCACCCGGCGCGACAGGGTCCAGGCCTATGGCTACACCTTC	CASTRRDRVQAYGYTF	TRBV6-6	TRBJ1-2
TGCAGTGCTAGAGATCCTGTGGGACGTCGACCGAGCAATCAGCCCCAGCATTTT	CSARDPVGRRPSNQPQHF	TRBV20-1	TRBJ1-5
TGTGCCACCAGTGATTTGCATCGCTTCGGACAGGGTGGAGCCTACGAGCAGTACTTC	CATSDLHRFGQGGAYEQYF	TRBV24-1	TRBJ2-7
TGTGCCAGCAGTTTACAGCACCCAGGCGGCAATGGCTACACCTTC	CASSLQHPGGNGYTF	TRBV27	TRBJ1-2
TGTGCCAGCAGCCAAGGAAAACTACTAGCGGTATGGCTCAATGAGCAGTTCTTC	CASSQGKLLAVWLNEQFF	TRBV3-1	TRBJ2-1
TGTGCCAGCAGACCTGATTGTCGGGATGGGGGACTCTACGAGCAGTACTTC	CASRPDCRDGGLYEQYF	TRBV25-1	TRBJ2-7
TGTGCCACCAGCAGAGGTCATTTACAGCATAATGAAAAACTGTTTTTT	CATSRGHLQHNEKLFF	TRBV15	TRBJ1-4
TGTGCCAGTAGTATAGTTTGCAATCGGGCGCTGTCCCACTACGAGCAGTACTTC	CASSIVCNRALSHYEQYF	TRBV19	TRBJ2-7
TGTGCCAGCAGCCCCCCAAGGTGTTCAAGGGACGCCAAAAACATTCAGTACTTC	CASSPPRCSRDAKNIQYF	TRBV13	TRBJ2-4
TGCAGTGCTATCACCGGGACAGGGAGTCAGTACTTC	CSAITGTGSQYF	TRBV20-1	TRBJ2-5
TGTGCCAGCAGCCTGATCCAAGAGACCCAGTACTTC	CASSLIQETQYF	TRBV9	TRBJ2-5
TGTGCCAGCAGTGAGGGCACAGATACGCAGTATTTT	CASSEGTDTQYF	TRBV6-1	TRBJ2-3
TGTGCCAGCAGTGAGGGGGACTGGGTCGGGGCAGATACGCAGTATTTT	CASSEGDWVGADTQYF	TRBV6-5	TRBJ2-3
TGCGCCAGCAGGCAGGGTAATGAAAAACTGTTTTTT	CASRQGNEKLFF	TRBV5-1	TRBJ1-4
TGTGCCAGCATTACGAGACTAGCGGGAGCCCTTGGCACCGGGGAGCTGTTTTTT	CASITRLAGALGTGELFF	TRBV6-4	TRBJ2-2
TGTGCCAGCAGTTACTCGCCCCTCGAAGAATGCACTAGCCGGAGGATGAACGAGCAGTACTTC	CASSYSPLEECTSRRMNEQYF	TRBV6-5	TRBJ2-7
TGTGCCTTTGGGCGGTTGGGGGGAGAGACCCAGTACTTC	CAFGRLGGETQYF	TRBV30	TRBJ2-5
TGTGCCAGCAGCCCCTCCGGTGAAGGGGGCACCGTACGCGAGCAGTACTTC	CASSPSGEGGTVREQYF	TRBV14	TRBJ2-7
TGTGCCTTCGAGGGGGTCTATGGCTACACCTTC	CAFEGVYGYTF	TRBV6-4	TRBJ1-2
TGCAGCGTTGAAGAGAAAATAGCGGATGGCTACACCTTC	CSVEEKIADGYTF	TRBV29-1	TRBJ1-2
TGTGCCAGCAGCGCCCTGGGGGGCCCGTATTTTCTACCAGAGCAGTTCTTC	CASSALGGPYFLPEQFF	TRBV13	TRBJ2-1
TGTGCCAGCAGCTTCCGGGAAAGGACAGTTACAGCGGTCCCTCCTGGGGCCAACGTCCTGACTTTC	CASSFRERTVTAVPPGANVLTF	TRBV7-6	TRBJ2-6
TGTGCCAGCAGCTCCCGGGCGGGGGGGACGGAGAGAGTGGTCCCTTTGGGCAATCAGCCCCAGCATTTT	CASSSRAGGTERVVPLGNQPQHF	TRBV9	TRBJ1-5
TGTGCCACCAGTGACGGGGGACAACCCACTGAAGCTTTCTTT	CATSDGGQPTEAFF	TRBV24-1	TRBJ1-1
TGTGCCAGCAGCTTCGGGACAGGGGGTGGTGGAACTGTTAGGGGTCTACACAATGAGCAGTTCTTC	CASSFGTGGGGTVRGLHNEQFF	TRBV13	TRBJ2-1
TGTGCCTGGAGTGCTGGGCGTTATAGGCAGTTCTTC	CAWSAGRYRQFF	TRBV30	TRBJ2-1
TGTGCCAGCAGCGTGTTAAAAACGGACGAGCAGTACTTC	CASSVLKTDEQYF	TRBV9	TRBJ2-7
TGTGCCAGCACAGCTAGGGTGGCGCTGTCCTACGAGCAGTACTTC	CASTARVALSYEQYF	TRBV12-3	TRBJ2-7
TGTGCCAGCAGCCAATCCGTCGACAGGGCCTATAGCAATCAGCCCCAGCATTTT	CASSQSVDRAYSNQPQHF	TRBV16	TRBJ1-5
TGTGCCAGCTCACCACGCCTAAGGGGCCCCATAGAGTACGAGCAGTACTTC	CASSPRLRGPIEYEQYF	TRBV18	TRBJ2-7
TGTGCCAGCAGCTTAGGCCCACTAGCGGGAGTCAGCGAGCAGTACTTC	CASSLGPLAGVSEQYF	TRBV7-9	TRBJ2-7
TGCAGTGCTCCGGGGTGGCATTACGAGCAGTACTTC	CSAPGWHYEQYF	TRBV20-1	TRBJ2-7
TGTGCCATCAGTGAACCAGGACAGGGTGGGAGGGCCAAAAACATTCAGTACTTC	CAISEPGQGGRAKNIQYF	TRBV10-3	TRBJ2-4
TGTGCCAGCAGCCCAAAAGGGTTAAAAAAGGGGGGGCCCACAGACTACGAGCAGTACTTC	CASSPKGLKKGGPTDYEQYF	TRBV7-3	TRBJ2-7
TGTGCCAGCAGCAACCGGGACAGAGCCGCAACTAATGAAAAACTGTTTTTT	CASSNRDRAATNEKLFF	TRBV5-6	TRBJ1-4
TGTGCCAGCAGCTTGTACGACGGACAGGTTGATGGCTACACCTTC	CASSLYDGQVDGYTF	TRBV7-3	TRBJ1-2
TGTGCCAGCAGTTACAAGAAGACTAGCGGGAATAAGTACGAGCAGTACTTC	CASSYKKTSGNKYEQYF	TRBV6-6	TRBJ2-7
TGCGCCAGCAGCCACGAAAGTGGGGGGGGGGAAATGAACACTGAAGCTTTCTTT	CASSHESGGGEMNTEAFF	TRBV4-1	TRBJ1-1
TGTGCCACCAGTCTGACAGTGACAGGGAGCAATCAGCCCCAGCATTTT	CATSLTVTGSNQPQHF	TRBV24-1	TRBJ1-5
TGTGCCAGCTCACCACGAGGCCGGACGCGGATGTACGAGCAGTACTTC	CASSPRGRTRMYEQYF	TRBV18	TRBJ2-7
TGTGCCACCAGCCCACAGGGAGATCAGCCCCAGCATTTT	CATSPQGDQPQHF	TRBV24-1	TRBJ1-5
TGTGCCAGCAGCTTAGATGTGTGTACAGCGGGACTGGCCCGTCCTTGGTACTTC	CASSLDVCTAGLARPWYF	TRBV11-3	TRBJ2-7
TGTGCCAGCTCACCAGGGGGGAAAGATCATGGCTACACCTTC	CASSPGGKDHGYTF	TRBV18	TRBJ1-2
TGTGCCAGCAGTATCGAAATCCGGGACAGGGGTGGGTACAATGAGCAGTTCTTC	CASSIEIRDRGGYNEQFF	TRBV6-6	TRBJ2-1
TGTGCCAGCAGAATGGGACTAGCGGGGAGTCATACGCAGTATTTT	CASRMGLAGSHTQYF	TRBV6-4	TRBJ2-3
TGCGCCAGCAGCTTGGTACACAGTACGGCGAACGCCGGGGAGCTGTTTTTT	CASSLVHSTANAGELFF	TRBV5-1	TRBJ2-2
TGTGCCAGCAGTGAAGGTTTCGCCGTCCCGGGGGGTGAAAAACTGTTTTTT	CASSEGFAVPGGEKLFF	TRBV6-1	TRBJ1-4
TGTGCCACCAGCAAAGGACCAGGACACTATGGCTACACCTTC	CATSKGPGHYGYTF	TRBV15	TRBJ1-2
TGTGCCAGCAGCACGACAGGGATCTCCTACGAGCAGTACTTC	CASSTTGISYEQYF	TRBV7-3	TRBJ2-7
TGTGCCAGCAGCTTAGGATTGACAGCCGATGCAACTAATGAAAAACTGTTTTTT	CASSLGLTADATNEKLFF	TRBV7-9	TRBJ1-4
TGCGCCAGCAGCTTGGGGAGTACCAGCGCTGGAAACACCATATATTTT	CASSLGSTSAGNTIYF	TRBV5-1	TRBJ1-3
TGTGCCATCAGTTCCAGGGACAGCGGGGAGCTGTTTTTT	CAISSRDSGELFF	TRBV10-3	TRBJ2-2
TGTGCCAGCAGCTTGGGGGGACTAGCGGGGGTCGGGAGGAATGAGCAGTTCTTC	CASSLGGLAGVGRNEQFF	TRBV5-6	TRBJ2-1
TGTGCCAGCAGCTTACAGAGGACAGCTGAAGCTTTCTTT	CASSLQRTAEAFF	TRBV5-6	TRBJ1-1
TGTGCCAGCAGCTTAGCATGGGGGAGACAGGGTGGCACAGATACGCAGTATTTT	CASSLAWGRQGGTDTQYF	TRBV11-2	TRBJ2-3
TGCAGTGCCGGTACAGGGGACCGGAGCTCGAACACTGAAGCTTTCTTT	CSAGTGDRSSNTEAFF	TRBV20-1	TRBJ1-1
TGCGCCAGCAGCCGGGAGGGTGGGGATCATTCACCCCTCCACTTT	CASSREGGDHSPLHF	TRBV4-3	TRBJ1-6
TGTGCCAGCAGTCAGGGGATTACCGAAAGCGCTGGGGCCAACGTCCTGACTTTC	CASSQGITESAGANVLTF	TRBV6-1	TRBJ2-6
TGTGCCAGCAGGGACAGCGCCTACGAGCAGTACTTC	CASRDSAYEQYF	TRBV11-3	TRBJ2-7
TGCAGCGTTATAGCGGGAGCATTACTTTTGTACAATGAGCAGTTCTTC	CSVIAGALLLYNEQFF	TRBV29-1	TRBJ2-1
TGTGCCAGCAGCGGCAATAGGGGCGTCCCCAGGACTGAAGCTTTCTTT	CASSGNRGVPRTEAFF	TRBV9	TRBJ1-1
TGTGCCAGCAGTTTATTTCCCAGGAGGCCGCGGACAGATACGCAGTATTTT	CASSLFPRRPRTDTQYF	TRBV28	TRBJ2-3
TGCAGTGCTAGAAGTCTTTTGGGAGGGAAGCGCCATATTAGCTCCTACAATGAGCAGTTCTTC	CSARSLLGGKRHISSYNEQFF	TRBV20-1	TRBJ2-1
TGCAGCGTTGAATCAGCCGGGGGGGCCGAGCAGTACTTC	CSVESAGGAEQYF	TRBV29-1	TRBJ2-7
TGCGCCAGCACCGAGAAGCGTTCAGGGGAGCTGTTTTTT	CASTEKRSGELFF	TRBV10-1	TRBJ2-2
TGCAGTGCTAGATCTCAGGGGGAGATCACCTTC	CSARSQGEITF	TRBV20-1	TRBJ1-2
TGTGCCAGCAGCTTATTACGCCGTCTGAGTTACGAGCAGTACTTC	CASSLLRRLSYEQYF	TRBV5-6	TRBJ2-7
TGTGCCAGCAGTGAATATGTCAGGGAAATGGCTAACTATGGCTACACCTTC	CASSEYVREMANYGYTF	TRBV25-1	TRBJ1-2
TGTGCCAGCAGTTACTCGAAGTCCGGGACTAGCGGGGGAGGGTGCTCCTACGAGCAGTACTTC	CASSYSKSGTSGGGCSYEQYF	TRBV6-2	TRBJ2-7
TGTGCCAGCAGCTTAGATCCAGGGAACAATCAGCCCCAGCATTTT	CASSLDPGNNQPQHF	TRBV11-2	TRBJ1-5
TGTGCCAGCAGTTTATACGCAGGTGAAGAGACCCAGTACTTC	CASSLYAGEETQYF	TRBV28	TRBJ2-5
TGTGCCAGTCCGCACAGGGATACCGGGACTAGGCTATGGGCAGACTACAATGAGCAGTTCTTC	CASPHRDTGTRLWADYNEQFF	TRBV6-2	TRBJ2-1
TGTGCCAGGGCTCGGGACATGTCAGGCCAAGAGACCCAGTACTTC	CARARDMSGQETQYF	TRBV6-5	TRBJ2-5
TGTGCCTGGCCAGAGGGCCTAGCCTACGAGCAGTACTTC	CAWPEGLAYEQYF	TRBV30	TRBJ2-7
TGTGCCAGCACTGATCCGTCGGACACTGAAGCTTTCTTT	CASTDPSDTEAFF	TRBV25-1	TRBJ1-1
TGCAGCGTCCGAGGGAAAGACACCATGGGACTATTTTACGAGCAGTACTTC	CSVRGKDTMGLFYEQYF	TRBV29-1	TRBJ2-7
TGTGCCAGCAGCGATCTCAGGGATGAGACTGAAAAACTGTTTTTT	CASSDLRDETEKLFF	TRBV7-2	TRBJ1-4
TGTGCCAGCAGTGGGCCCGTCCGAGGGCCCGAATCCTACGAGCAGTACTTC	CASSGPVRGPESYEQYF	TRBV2	TRBJ2-7
TGTGCCAGCAGCGGACCATGCACAGATACGCAGTATTTT	CASSGPCTDTQYF	TRBV9	TRBJ2-3
TGTGCCAGGGTGGAAGGGCGTGATCATCAGCCCCAGCATTTT	CARVEGRDHQPQHF	TRBV24-1	TRBJ1-5
TGCGCCAGCAGCCAAGGCCGGGGCCTGACAGAGACCCAGTACTTC	CASSQGRGLTETQYF	TRBV4-3	TRBJ2-5
TGTGCCAGCAGCTTAGCCCAGACGACACGGCGGACTGAAGCTTTCTTT	CASSLAQTTRRTEAFF	TRBV11-2	TRBJ1-1
TGTGCCATCAGTGAGTCGGGGACTTCTATGAACACTGAAGCTTTCTTT	CAISESGTSMNTEAFF	TRBV10-3	TRBJ1-1
TGTGCCAGCAGTTTTGTTCCTGAGGGTTTTTATCAGCCCCAGCATTTT	CASSFVPEGFYQPQHF	TRBV27	TRBJ1-5
TGTGCCAGCTCACCCACAGGGCTCCATAAAGAGACCCAGTACTTC	CASSPTGLHKETQYF	TRBV18	TRBJ2-5
TGCAGTGCTAGAGCAGGGGGTGTTAACGGAAACACCATATATTTT	CSARAGGVNGNTIYF	TRBV20-1	TRBJ1-3
TGTGCCAGCAGTTTCGGGACCTATGAGCAGTTCTTC	CASSFGTYEQFF	TRBV28	TRBJ2-1
TGCGCCAGCAGCCAAGGCCAGGCATCTCAGCCCCAGCATTTT	CASSQGQASQPQHF	TRBV4-1	TRBJ1-5
TGTGCCAGCAGTTACATCTTCGGGAAGGCCCAGTACTTC	CASSYIFGKAQYF	TRBV6-5	TRBJ2-5
TGTGCCAGCAGGGCCCCGCGGGTTGTTCACTACGAGCAGTACTTC	CASRAPRVVHYEQYF	TRBV28	TRBJ2-7
TGTGCCAGCAGCGAGCGAGTTTCCTACGAGCAGTACTTC	CASSERVSYEQYF	TRBV7-3	TRBJ2-7
TGTGCCATTCGGGGGCAGTTCTACAATGAGCAGTTCTTC	CAIRGQFYNEQFF	TRBV7-9	TRBJ2-1
TGTGCCAGCAGCTGGGGACCCTTCTGTACCTACGAGCAGTACTTC	CASSWGPFCTYEQYF	TRBV5-6	TRBJ2-7
TGCGCCAGCAGCTTGACAGGGCAGGGGGACTCCTACGAGCAGTACTTC	CASSLTGQGDSYEQYF	TRBV5-1	TRBJ2-7
TGTGCCAGCAGCTTAGAAATGGAGCCTACAGGGAATGAAAAACTGTTTTTT	CASSLEMEPTGNEKLFF	TRBV11-3	TRBJ1-4
TGTGCCAGCACCACAGGGCCGTACGAGCAGTACTTC	CASTTGPYEQYF	TRBV6-4	TRBJ2-7
TGTGCCAGCAGTAATAGACAGGCTTTTCCTCAAGAGACCCAGTACTTC	CASSNRQAFPQETQYF	TRBV6-1	TRBJ2-5
TGTGCCATCAGTGTCCTAGCGAGGCACGACAATGAGCAGTTCTTC	CAISVLARHDNEQFF	TRBV10-3	TRBJ2-1
TGTGCCAGCAGCTGTCCATGCTACATTCAGTACTTC	CASSCPCYIQYF	TRBV7-9	TRBJ2-4
TGTGCCAGCACCACCCCCCCTAGGGGGAGCTCCTACGAGCAGTACTTC	CASTTPPRGSSYEQYF	TRBV12-3	TRBJ2-7
TGCGCCAGCAGAGGGCCCTCCTACGAGCAGTACTTC	CASRGPSYEQYF	TRBV10-1	TRBJ2-7
TGTGCCAGCAGCAAATTTACATGGCATAATTCACCCCTCCACTTT	CASSKFTWHNSPLHF	TRBV7-3	TRBJ1-6
TGTGCCAGCAGCATAAGTGGCGGGCGGATAGACACCGGGGAGCTGTTTTTT	CASSISGGRIDTGELFF	TRBV7-3	TRBJ2-2
TGTGCCACGGTTGCTCCGGGACAGTGGCGTTCTGGGGCCAACGTCCTGACTTTC	CATVAPGQWRSGANVLTF	TRBV24-1	TRBJ2-6
TGTGCCAGCAGCGGAGGGGGGCAGCAGTACTTC	CASSGGGQQYF	TRBV9	TRBJ2-7
TGTGCCAGCAGCTTGTGCCCTCATAGCGTAGAAAAACTGTTTTTT	CASSLCPHSVEKLFF	TRBV5-6	TRBJ1-4
TGTGCCAGCAGCTTAGTATACGGGACAGGGAGATTCTATGGCTACACCTTC	CASSLVYGTGRFYGYTF	TRBV7-9	TRBJ1-2
TGTGCCAGCAGCTTAGGGGGGGACGGGTATGGCTACACCTTC	CASSLGGDGYGYTF	TRBV7-2	TRBJ1-2
TGTGCCAGCAGTTACAGTGCAATCGGCAACGCCCAGCATTTT	CASSYSAIGNAQHF	TRBV6-2	TRBJ1-5
TGTGCCAGCAGACCCTCAGGCGACACTGAAGCTTTCTTT	CASRPSGDTEAFF	TRBV5-4	TRBJ1-1
TGTGCCAGGATACCACTGGGTCCTGTAGGCTACGAGCAGTACTTC	CARIPLGPVGYEQYF	TRBV2	TRBJ2-7
