TGTGCCAGCAGCCTCGTGTCACCCCGGACAGAAGCTACTGAAGCTTTCTTT	CASSLVSPRTEATEAFF	TRBV13	TRBJ1-1
TGTGCCACCAGTGATAGAGTAGTGGAGGGGGTTCACAATGAGCAGTTCTTC	CATSDRVVEGVHNEQFF	TRBV24-1	TRBJ2-1
TGCGCCAGCAGTGAGTCCCATGGGGACAGCTCCTACGAGCAGTACTTC	CASSESHGDSSYEQYF	TRBV10-1	TRBJ2-7
TGCGCCAGCAGAACCGGGACAGAGGTCACTGAAGCTTTCTTT	CASRTGTEVTEAFF	TRBV10-1	TRBJ1-1
TGTGCCACCAGTGATGAGGGGACAGGGGGCCGAGCTCGTTACAATGAGCAGTTCTTC	CATSDEGTGGRARYNEQFF	TRBV24-1	TRBJ2-1
TGTGCCAGCAGAAACGGGGATTGGTCGAGACAAGAGACCCAGTACTTC	CASRNGDWSRQETQYF	TRBV6-5	TRBJ2-5
TGTGCCAGCAGCGCTTCCACGGGGCACACTGAAGCTTTCTTT	CASSASTGHTEAFF	TRBV7-9	TRBJ1-1
TGTGCCAGCAGTTTACTGGTCAGGAGTGGTCAGCCCCAGCATTTT	CASSLLVRSGQPQHF	TRBV12-4	TRBJ1-5
TGTGCCAGCTCAGGGACAGGGCATCTAACTGAAGCTTTCTTT	CASSGTGHLTEAFF	TRBV18	TRBJ1-1
TGTGCTAGCAGCTTAGCGGGGACGGTATATGGCTACACCTTC	CASSLAGTVYGYTF	TRBV7-7	TRBJ1-2
TGTGCCAGCAGTTCAGGGTGGGACGGGAACCCGGTTCACTATGGCTACACCTTC	CASSSGWDGNPVHYGYTF	TRBV6-6	TRBJ1-2
TGTGCCAGCAGTGCCGGGGCCCACAGGGGGGACCGTCGGAACAATCAGCCCCAGCATTTT	CASSAGAHRGDRRNNQPQHF	TRBV6-4	TRBJ1-5
TGCGCCAGCAGCTTGGACGCGTGGGGGAAAAAAGAGACCCAGTACTTC	CASSLDAWGKKETQYF	TRBV5-1	TRBJ2-5
TGTGCCACCAGTGATAGTCTTTCGGGACAAACTATTATGAACACTGAAGCTTTCTTT	CATSDSLSGQTIMNTEAFF	TRBV24-1	TRBJ1-1
TGTGCCACCCGGACAGGGGTATATGGCTACACCTTC	CATRTGVYGYTF	TRBV24-1	TRBJ1-2
TGTGCCAGCAGTTTACCGTACATTAGAGCCGGGGAGCTGTTTTTT	CASSLPYIRAGELFF	TRBV12-3	TRBJ2-2
TGTGCCAGCAGGTTAGTAAAGTCCTACAATGAGCAGTTCTTC	CASRLVKSYNEQFF	TRBV11-3	TRBJ2-1
TGCGCCAGCAGCGCCCAGTGTGGCCTTAATTCACCCCTCCACTTT	CASSAQCGLNSPLHF	TRBV4-1	TRBJ1-6
TGTGCCAGCAGTGTCGGGACCGGTCCCACAGATACGCAGTATTTT	CASSVGTGPTDTQYF	TRBV6-4	TRBJ2-3
TGTGCCAGCAGCTTCCGAGACGGGACTAGCGGCCCGACTAACGAGCAGTACTTC	CASSFRDGTSGPTNEQYF	TRBV7-9	TRBJ2-7
TGTGCCAGCAGTTTGGATAGGGGTGTTAACTATGGCTACACCTTC	CASSLDRGVNYGYTF	TRBV27	TRBJ1-2
TGTGCCAGCAGCCGGGGGAGCTCTGGAAACACCATATATTTT	CASSRGSSGNTIYF	TRBV13	TRBJ1-3
TGTGCCAGCAGCACCACAGGGCCCTATGGCTACACCTTC	CASSTTGPYGYTF	TRBV7-7	TRBJ1-2
TGTGCCAGCAGCTCCCCAGGGGGTGGTAATTCACCCCTCCACTTT	CASSSPGGGNSPLHF	TRBV11-3	TRBJ1-6
TGTGCCAGCAGTGATCTGGCACAGGGGGAAGCTTTCTTT	CASSDLAQGEAFF	TRBV27	TRBJ1-1
TGCACGGACAGGGTGGTTCGGCCCCAGCATTTT	CTDRVVRPQHF	TRBV20-1	TRBJ1-5
TGTGCCAGCAGCTTACGGTCGCAGTATTTT	CASSLRSQYF	TRBV7-3	TRBJ2-3
TGTGCCAGCAGCCAAGAACCCGGGGGACAGGGAGAGTGGAACACTGAAGCTTTCTTT	CASSQEPGGQGEWNTEAFF	TRBV3-1	TRBJ1-1
TGTGCCAGCAGCTTAATGGGACTAGAACAGTTAAAAGGGTGGCAGTTCTTC	CASSLMGLEQLKGWQFF	TRBV7-9	TRBJ2-1
TGTGCCTGGACCGGAGGGGGGAATGAGCAGTTCTTC	CAWTGGGNEQFF	TRBV30	TRBJ2-1
TGTGCCAGCAGTTACCCCACACTAGGATATGAGCAGTTCTTC	CASSYPTLGYEQFF	TRBV6-5	TRBJ2-1
TGCAGTGCTGCACTAGCGGGGCTTAACACTCCCTACAATGAGCAGTTCTTC	CSAALAGLNTPYNEQFF	TRBV20-1	TRBJ2-1
TGCGCCAGCAGGACGCGGGGCATGAACACTGAAGCTTTCTTT	CASRTRGMNTEAFF	TRBV5-1	TRBJ1-1
TGCGCCAGCAGTTGCCCACATCGGGCTAGGTTCTTC	CASSCPHRARFF	TRBV5-1	TRBJ2-1
TGTGCCAGCAGCTCCTCCACTCCGGGGGAGAGCACAGATACGCAGTATTTT	CASSSSTPGESTDTQYF	TRBV7-3	TRBJ2-3
TGTGCCAGCAGCGGTGAAACCTACGAGCAGTACTTC	CASSGETYEQYF	TRBV7-9	TRBJ2-7
TGCAAGGCGACAGGATGGGGCAATCAGCCCCAGCATTTT	CKATGWGNQPQHF	TRBV20-1	TRBJ1-5
TGCAGTGCTAGCCCACGCTACGAGCAGTACTTC	CSASPRYEQYF	TRBV20-1	TRBJ2-7
TGTGCCAGCCACCGGGGGGGACTCCAATACGAGCAGTACTTC	CASHRGGLQYEQYF	TRBV6-4	TRBJ2-7
TGTGCCAGCAGCGGCGGTAATCACCCCATCTACAATGAGCAGTTCTTC	CASSGGNHPIYNEQFF	TRBV7-8	TRBJ2-1
TGTGCCAGCAGCGGCAAGGCAGGGGATTCACCCCTCCACTTT	CASSGKAGDSPLHF	TRBV7-3	TRBJ1-6
TGCGCCAGCAGCTTGCGGGAGTCCACCGGGGAGCTGTTTTTT	CASSLRESTGELFF	TRBV5-1	TRBJ2-2
TGTGCCAGCCCGCTACGGTATAGCAATCAGCCCCAGCATTTT	CASPLRYSNQPQHF	TRBV7-2	TRBJ1-5
TGTGCCAGCACACGACTAGCGAACCAGCAGTATTTT	CASTRLANQQYF	TRBV6-5	TRBJ2-3
TGTGCCAGCAGTACCGGGGGGGGGACCCACGATGAGCAGTTCTTC	CASSTGGGTHDEQFF	TRBV6-8	TRBJ2-1
TGTGCCAGCAGCTCTGAGAGTCCCCAAGAGACCCAGTACTTC	CASSSESPQETQYF	TRBV7-3	TRBJ2-5
TGTGCCACCAGTGATTTGCTAGACGGACTCTCCTACAATGAGCAGTTCTTC	CATSDLLDGLSYNEQFF	TRBV24-1	TRBJ2-1
TGTGCCAGCAGCCAGCCGGGACAGGGGGGCAATCAGCCCCAGCATTTT	CASSQPGQGGNQPQHF	TRBV5-6	TRBJ1-5
TGTGCCACCAGTAGCGACAGGGCAGATACGCAGTATTTT	CATSSDRADTQYF	TRBV24-1	TRBJ2-3
TGTGCCAGCAGTGGGTGGAACCCCTACGAGCAGTACTTC	CASSGWNPYEQYF	TRBV6-1	TRBJ2-7
TGTGCCACCACATCCGGACCTACCCACGACGGGAGAACTGAGCAGTACTTC	CATTSGPTHDGRTEQYF	TRBV24-1	TRBJ2-7
TGTGCCAGCAGCGCCCCGTCACCCTACGAGCAGTACTTC	CASSAPSPYEQYF	TRBV7-4	TRBJ2-7
TGTGCTAGCAGCTTAGAAACCGGCCGGGACAGCTTCCCCTACGAGCAGTACTTC	CASSLETGRDSFPYEQYF	TRBV7-7	TRBJ2-7
TGTGCCAGCAGTCGGCGAGGGGGCTACGAGCAGTACTTC	CASSRRGGYEQYF	TRBV28	TRBJ2-7
TGTGCCAGCAGCTGGAGGGGTGTGGGGAGGGCCTACGAGCAGTACTTC	CASSWRGVGRAYEQYF	TRBV7-3	TRBJ2-7
TGTGCCAGAGGAAGAGGAGCCAAAAACATTCAGTACTTC	CARGRGAKNIQYF	TRBV30	TRBJ2-4
TGTGTCAACACAGTCCAGCCCCAGCATTTT	CVNTVQPQHF	TRBV7-9	TRBJ1-5
TGTGCCAGCAAGAGGGACGATGGCTACACCTTC	CASKRDDGYTF	TRBV6-1	TRBJ1-2
TGTGCCAGCAGCTTAAATGGTATACCGGGACTAGCGGGGGGGCGGCGAAAAACCGGGGAGCTGTTTTTT	CASSLNGIPGLAGGRRKTGELFF	TRBV7-4	TRBJ2-2
TGTGCCAGCAGCTGTTTTTCTTCTAGCGGGGGAGCCGGGCAGTTCTTC	CASSCFSSSGGAGQFF	TRBV7-3	TRBJ2-1
TGCGCCAGCGGGAACAGGGCTAATGAAAAACTGTTTTTT	CASGNRANEKLFF	TRBV10-1	TRBJ1-4
TGTGCCAGCTCACGGCGACCGACTAAGGATACTAACTATGGCTACACCTTC	CASSRRPTKDTNYGYTF	TRBV18	TRBJ1-2
TGTGCCATCATTAAGCGAAACCAACAGGGGGCCCTCTGCACCGGGGAGCTGTTTTTT	CAIIKRNQQGALCTGELFF	TRBV10-3	TRBJ2-2
TGTGCCAGCAGAGGAGGCGGTGAAAAACTGTTTTTT	CASRGGGEKLFF	TRBV2	TRBJ1-4
TGTGCCAGCAGCGTCCCGCCCAGGGACTTATCGAACACCGGGGAGCTGTTTTTT	CASSVPPRDLSNTGELFF	TRBV9	TRBJ2-2
TGTGCCAGCAGCTTAGAGACTAGCGGGGCCTACGAGCAGTACTTC	CASSLETSGAYEQYF	TRBV11-2	TRBJ2-7
TGCAGTGCTCCGGCCCGACTAGCGTCGGCCGGGGAGCTGTTTTTT	CSAPARLASAGELFF	TRBV20-1	TRBJ2-2
TGTGCCAGCAGCGCCGCACAGGGTTTGGCCAACGTCCTGACTTTC	CASSAAQGLANVLTF	TRBV9	TRBJ2-6
TGTGCCAGCAGCTTATTCCGGGACAGGGACTATGGCTACACCTTC	CASSLFRDRDYGYTF	TRBV7-9	TRBJ1-2
TGTGCCAGTAGTAGGAAACCGGGACAGGGAAAAAACACTGAAGCTTTCTTT	CASSRKPGQGKNTEAFF	TRBV19	TRBJ1-1
TGTGCCAGCAGTGCCGACAGCCATAAAGAGACCCAGTACTTC	CASSADSHKETQYF	TRBV27	TRBJ2-5
TGTGCCAGCAGCCCCTTCGAGGGCGAAGAACTCGAGCAGTACTTC	CASSPFEGEELEQYF	TRBV7-9	TRBJ2-7
TGCGCCAGCAGCTGCAGACAGGGTGCGGCCTTC	CASSCRQGAAF	TRBV5-1	TRBJ1-2
TGTGCCAGCAAACGGACTAGTCTCCACAATGAGCAGTTCTTC	CASKRTSLHNEQFF	TRBV5-6	TRBJ2-1
TGTGCGTCCCAGGACGGGAACACTGAAGCTTTCTTT	CASQDGNTEAFF	TRBV3-1	TRBJ1-1
TGTGCCAGCGGGAGGGATGGAACCTACGAGCAGTACTTC	CASGRDGTYEQYF	TRBV7-6	TRBJ2-7
TGCAGTGCTAGCTTCTCGTACCTAGGAGATGGTTACGAGCAGTACTTC	CSASFSYLGDGYEQYF	TRBV20-1	TRBJ2-7
TGTGCCAGCAGCCACGGGCAACAGCATTTAACCCCCACAGATACGCAGTATTTT	CASSHGQQHLTPTDTQYF	TRBV3-1	TRBJ2-3
TGTGCCAGCAGCTTAACCTTTTGTGAGAACACTGAAGCTTTCTTT	CASSLTFCENTEAFF	TRBV7-3	TRBJ1-1
TGCAGCGCCCGGGGGGACAGGGCGTACGAGCAGTACTTC	CSARGDRAYEQYF	TRBV29-1	TRBJ2-7
TGTGCCAGCAGCGTAGTCGGGGGGGGTGTCTACGAGCAGTACTTC	CASSVVGGGVYEQYF	TRBV9	TRBJ2-7
TGCGCCACCCCTTTTCAACGCGACAACTACGAGCAGTACTTC	CATPFQRDNYEQYF	TRBV10-1	TRBJ2-7
TGTGCCAGCAGTCTCCTAGGTCAGGGGGGGGGGGAGACGAACACTGAAGCTTTCTTT	CASSLLGQGGGETNTEAFF	TRBV28	TRBJ1-1
TGTGCCAGCAGTTTAAGGACAAGGGACACTGAAGCTTTCTTT	CASSLRTRDTEAFF	TRBV27	TRBJ1-1
TGTGCCTGTTTGATAAGGTCAGGGGGGGGGGAGCAGTTCTTC	CACLIRSGGGEQFF	TRBV30	TRBJ2-1
TGTGCCACTCCCTCGGGACTAGCGGGTGAAACGTTTGAGCAGTTCTTC	CATPSGLAGETFEQFF	TRBV24-1	TRBJ2-1
TGCGCCAGCAGGGGACCGCCCAGAGGAGGCTACACCTTC	CASRGPPRGGYTF	TRBV5-1	TRBJ1-2
TGTGCCAGCAGGGACAAAGCAGGGGGCCCAGGCACAGATACGCAGTATTTT	CASRDKAGGPGTDTQYF	TRBV6-8	TRBJ2-3
TGCAGTGCTAAGAAAATACAGGGCACTCAAAATAGCAATCAGCCCCAGCATTTT	CSAKKIQGTQNSNQPQHF	TRBV20-1	TRBJ1-5
TGTGCCAGCAGGATCAGGGGGGTCATTATGAACACTGAAGCTTTCTTT	CASRIRGVIMNTEAFF	TRBV7-2	TRBJ1-1
TGCGCCAAAAGACAGGGGGAGCGCTCCTACGAGCAGTACTTC	CAKRQGERSYEQYF	TRBV10-1	TRBJ2-7
TGTGCCAGCAGCGTAGCCAATGGGGATGGACAGAGCTCCTACAATGAGCAGTTCTTC	CASSVANGDGQSSYNEQFF	TRBV9	TRBJ2-1
TGTGCCAGCAGCTTGCGGCCGGGGACAGGGGCCTACGAGCAGTACTTC	CASSLRPGTGAYEQYF	TRBV5-6	TRBJ2-7
TGTGCCAGCAGCTTAAGGGGGGGCACAGGGAGCTCCTATAATTCACCCCTCCACTTT	CASSLRGGTGSSYNSPLHF	TRBV7-7	TRBJ1-6
TGTGCCAGCAGCGTAGGGGGGGAAAAACTGTTTTTT	CASSVGGEKLFF	TRBV9	TRBJ1-4
TGTGCCAGCAGTTGGGAACGGGACGAAAGTTGGGGTAACTATGGCTACACCTTC	CASSWERDESWGNYGYTF	TRBV6-5	TRBJ1-2
TGCGCCAAGAGCCTAATTGGGGTAGGGTGGCAGTTCTTC	CAKSLIGVGWQFF	TRBV5-1	TRBJ2-1
TGTGCCAGCAGTTATGAAATTGATTACGAGCAGTACTTC	CASSYEIDYEQYF	TRBV6-3	TRBJ2-7
TGTGCCAGCAGCCCAGCCCCGGGACTATGGGGGCAATACGAGCAGTACTTC	CASSPAPGLWGQYEQYF	TRBV7-2	TRBJ2-7
TGCAGTGCTAGAGCCCCCGGGCTAAACATTCAGTACTTC	CSARAPGLNIQYF	TRBV20-1	TRBJ2-4
TGTGCCAGCAGCCCCCTAGCGGGGAGTCCCCGGAGCTCCTACGAGCAGTACTTC	CASSPLAGSPRSSYEQYF	TRBV5-6	TRBJ2-7
TGCGCCAGCAGCTTGTCGCCCGCTACGGGGGGGAGGTACGAGCAGTACTTC	CASSLSPATGGRYEQYF	TRBV5-1	TRBJ2-7
TGTGCCACCAGTGCCCGTGACAGGGGGCGAAAAGAGACCCAGTACTTC	CATSARDRGRKETQYF	TRBV24-1	TRBJ2-5
TGTGCCAGCAGTTACGAACGACAGGGGTACGAGCAGTACTTC	CASSYERQGYEQYF	TRBV6-6	TRBJ2-7
TGTGCCAGCAGTCAAGGCCTAGGGGGGGAGGCCTACGAGCAGTACTTC	CASSQGLGGEAYEQYF	TRBV28	TRBJ2-7
TGCAGTGCTAGAGCACCGGGACTAGACGAGCAGTACTTC	CSARAPGLDEQYF	TRBV20-1	TRBJ2-7
TGTGCCAGCAGTTACCCTAAGGGGGGCCACTATGGCTACACCTTC	CASSYPKGGHYGYTF	TRBV6-3	TRBJ1-2
TGTGCCAGCTCACCGGACATCAACCGAGAAGCCATTCAGTACTTC	CASSPDINREAIQYF	TRBV18	TRBJ2-4
TGCGCCAGCAGCATTGGGCGGGGCTACACCTTC	CASSIGRGYTF	TRBV5-1	TRBJ1-2
TGTGCCAGCAGTTTGGCAGTAATGAGCTCCTATAATTCACCCCTCCACTTT	CASSLAVMSSYNSPLHF	TRBV28	TRBJ1-6
TGTGCCAGCAGCGACGGAGTGTGCTATGGCTACACCTTC	CASSDGVCYGYTF	TRBV6-4	TRBJ1-2
TGTGCCAGCAGCTTGGGGACGACATTTCTCGGACAGGGAATCCGGGTAGAGACCCAGTACTTC	CASSLGTTFLGQGIRVETQYF	TRBV5-4	TRBJ2-5
TGTGCCATCAGCCCCCAGGGTGGGGAAAATGGCTACACCTTC	CAISPQGGENGYTF	TRBV10-3	TRBJ1-2
TGTGCCTGGAGTGTATTGTGGCGGCCCTCTGGGGCCAACGTCCTGACTTTC	CAWSVLWRPSGANVLTF	TRBV30	TRBJ2-6
TGTGCCTGGAGTGTCCAACCCCTAACAGTACTGAACACCGGGGAGCTGTTTTTT	CAWSVQPLTVLNTGELFF	TRBV30	TRBJ2-2
TGTGCCAGCGTGGACAGTATCACAGATACGCAGTATTTT	CASVDSITDTQYF	TRBV28	TRBJ2-3
TGTGCCAGCTCCGGGACAGGGGTTACTGAAGCTTTCTTT	CASSGTGVTEAFF	TRBV18	TRBJ1-1
TGTGCCACCAGTATTGGTGGGATCGGGGCGGGCTCTGGGGCCAACGTCCTGACTTTC	CATSIGGIGAGSGANVLTF	TRBV24-1	TRBJ2-6
TGTGCCAGCAGTGATAGGAAGAAAGGACAGATCGGGGAAAAACTGTTTTTT	CASSDRKKGQIGEKLFF	TRBV6-4	TRBJ1-4
TGTGCCACCAGTGATCTAGTCCGTCGGCGGGTCTGCAATGAGCAGTTCTTC	CATSDLVRRRVCNEQFF	TRBV24-1	TRBJ2-1
TGTGCCGAGTCAGGGGGCAAAGAGCAGTACTTC	CAESGGKEQYF	TRBV6-3	TRBJ2-7
TGCCCACAGGGGCCGACTAATGAAAAACTGTTTTTT	CPQGPTNEKLFF	TRBV29-1	TRBJ1-4
TGTGCCAGCAGCTTCCATACTAGCGGGAGTGTTAAATGTAGCACAGATACGCAGTATTTT	CASSFHTSGSVKCSTDTQYF	TRBV5-6	TRBJ2-3
TGTGCCAGTGCTGGGATCGTAACGAGACAGACTATAAACACTGAAGCTTTCTTT	CASAGIVTRQTINTEAFF	TRBV6-4	TRBJ1-1
TGCGCCAGCAGCTTGTCCGCTAGCGGGGAACACCGGGATGGAGATACGCAGTATTTT	CASSLSASGEHRDGDTQYF	TRBV5-1	TRBJ2-3
TGCGCCAGCAGTGAGAACTGTACTGAGCGGGGGACAGGGGAGAAAGAGACCCAGTACTTC	CASSENCTERGTGEKETQYF	TRBV10-1	TRBJ2-5
TGTGCCAGCAGTGAAGGTCGCTTTTGGGACAGGGCTTACGAGCAGTACTTC	CASSEGRFWDRAYEQYF	TRBV6-4	TRBJ2-7
TGTGCCAGTACCCGGGCCCCCTCTGGGGCCAACGTCCTGACTTTC	CASTRAPSGANVLTF	TRBV19	TRBJ2-6
TGCGCCAGCATGGGACAGGGGGGCCAGTACGAGCAGTACTTC	CASMGQGGQYEQYF	TRBV10-1	TRBJ2-7
TGTGCCAGCAGCTTGGACGGACAGGGGTATGGCTACACCTTC	CASSLDGQGYGYTF	TRBV5-4	TRBJ1-2
TGTGCCAGCAGCTTAGACGGGGTTGCCTTC	CASSLDGVAF	TRBV7-3	TRBJ1-2
TGTGCCAGCAGCCAAAGCGGGGCCTGGGGGTCCAAAAACATTCAGTACTTC	CASSQSGAWGSKNIQYF	TRBV3-1	TRBJ2-4
TGCGCCAGCATTCAGCCTCCGGGACTAGCCATAGAGCAGTACTTC	CASIQPPGLAIEQYF	TRBV10-2	TRBJ2-7
TGTGCCAGCAGTTTTTTCGAGTGGGCCACTCCGTGGGGAGGAGGCTACACCTTC	CASSFFEWATPWGGGYTF	TRBV28	TRBJ1-2
TGCAGCGTTGAGGTCATACCCGCGGGAGTTTTTCATCCCACAGATACGCAGTATTTT	CSVEVIPAGVFHPTDTQYF	TRBV29-1	TRBJ2-3
TGTGCCAGCAGCAGGGAGGGAAGGGGTACTCACGAGCAGTACTTC	CASSREGRGTHEQYF	TRBV11-2	TRBJ2-7
TGCAGCTATAGCAATGAGCAGTTCTTC	CSYSNEQFF	TRBV29-1	TRBJ2-1
TGTGCCACCAGTGATTTGGTATCGGGGCGGGGGTGGAGTGACGAGCAGTACTTC	CATSDLVSGRGWSDEQYF	TRBV24-1	TRBJ2-7
TGCAGTGACCCGTGGCTCGGGCTGTTAGTATACAATGAGCAGTTCTTC	CSDPWLGLLVYNEQFF	TRBV20-1	TRBJ2-1
TGTGCTAGTGGTTTGACGCTGTTCGGGGATACGCAGTATTTT	CASGLTLFGDTQYF	TRBV12-5	TRBJ2-3
TGCGCCAGCAGTGTAGAGGCCGGACAGGTCGCTGGGGGGACCTACGAGCAGTACTTC	CASSVEAGQVAGGTYEQYF	TRBV5-1	TRBJ2-7
TGTGCCAGCAGTTATCGCCGGGACAATGGCTACACCTTC	CASSYRRDNGYTF	TRBV27	TRBJ1-2
TGTGCCTGCCGAAAAGGGGAGGACAACTATGGCTACACCTTC	CACRKGEDNYGYTF	TRBV30	TRBJ1-2
TGTGCCACCAGTGATTGCGGGAGGGGTGAGACCCAGTACTTC	CATSDCGRGETQYF	TRBV24-1	TRBJ2-5
TGCGCCAGCAGTGAGACAGGCGAGCAGTTCTTC	CASSETGEQFF	TRBV10-2	TRBJ2-1
TGCAGTGCAGTTGGCCTGGACAGTGTCCTCTATGGCTACACCTTC	CSAVGLDSVLYGYTF	TRBV20-1	TRBJ1-2
TGTGCCAGCAGCTTGGCAAGACCCGATGGTGGGGGGCATCACGAGCAGTACTTC	CASSLARPDGGGHHEQYF	TRBV5-4	TRBJ2-7
TGCAGCGTTCCCAGACTTTCAGGGGGTAACTATGGCTACACCTTC	CSVPRLSGGNYGYTF	TRBV29-1	TRBJ1-2
TGCAGTGCTAGAGACCCGGAGGGGGTAAACGGGAACTATGGCTACACCTTC	CSARDPEGVNGNYGYTF	TRBV20-1	TRBJ1-2
TGTGCCAGCAGTACATATCGCTCCTACAATGAGCAGTTCTTC	CASSTYRSYNEQFF	TRBV27	TRBJ2-1
TGTGCCAGCAGCCCCCCTTACGGCTACGAGCAGTACTTC	CASSPPYGYEQYF	TRBV13	TRBJ2-7
TGCGATATAGCATGGGGCGTTTTTGGAAACACCATATATTTT	CDIAWGVFGNTIYF	TRBV5-1	TRBJ1-3
TGTGCCAGCAGAGGAAGGGGGTTATCCTACAATGAGCAGTTCTTC	CASRGRGLSYNEQFF	TRBV2	TRBJ2-1
TGTGCCAGCAGTTCTGATAAGGTAGCGGGGAGATCAGATACGCAGTATTTT	CASSSDKVAGRSDTQYF	TRBV6-5	TRBJ2-3
TGTGCCAGCAGCGTAGACAGGGGACTGGAGCAGTACTTC	CASSVDRGLEQYF	TRBV11-3	TRBJ2-7
TGTGCCAGCAGTCAGACAGGCCCGAGTATGAACACTGAAGCTTTCTTT	CASSQTGPSMNTEAFF	TRBV6-5	TRBJ1-1
TGCGCCAGCAGCCAAGTCCCACAGGGTCGAGGGTCGCCTCCAGCCCATGAAAATGGCTACACCTTC	CASSQVPQGRGSPPAHENGYTF	TRBV5-1	TRBJ1-2
TGTGCCACCAGGACCACTAGGGGGATATCTAGCAATCAGCCCCAGCATTTT	CATRTTRGISSNQPQHF	TRBV24-1	TRBJ1-5
TGTGCCCGAAAAGGACAGGGCCCCAATCAGCCCCAGCATTTT	CARKGQGPNQPQHF	TRBV19	TRBJ1-5
TGTGCCAGCAGCTGCTGGGAGGGGAGTCGTAGCTCCTACGAGCAGTACTTC	CASSCWEGSRSSYEQYF	TRBV7-2	TRBJ2-7
TGTGCCAGCAACCTGTCCGGGACAGGGTACGGAGCTTTCTTT	CASNLSGTGYGAFF	TRBV2	TRBJ1-1
TGTGCCACCAGTGACCACCGGGCGGGGGATAAAGGCTACGAGCAGTACTTC	CATSDHRAGDKGYEQYF	TRBV24-1	TRBJ2-7
TGTGCCAGCAGCGGGACTAGCGGGTACAATGAGCAGTTCTTC	CASSGTSGYNEQFF	TRBV6-2	TRBJ2-1
TGTGCCAGCAGCTTAAAACCCCACAGGGGGGGGAACTACGAGCAGTACTTC	CASSLKPHRGGNYEQYF	TRBV7-3	TRBJ2-7
TGTGCCAGCAGCCCTAGGGAACGGTCTGGAAACACCATATATTTT	CASSPRERSGNTIYF	TRBV7-9	TRBJ1-3
TGTGCCAGCAGCTGTTGTTCCGCGGGACTAGCGGGTGGGGTAGAGACCCAGTACTTC	CASSCCSAGLAGGVETQYF	TRBV7-9	TRBJ2-5
TGTGCCAGCAGCTCCGGGGGACTAGCGGGCCTTGCCTACGAGCAGTACTTC	CASSSGGLAGLAYEQYF	TRBV5-6	TRBJ2-7
TGTGCCAGCAGTTTGCCGCGACTCCCGTGGGGCTACACCTTC	CASSLPRLPWGYTF	TRBV28	TRBJ1-2
TGCGCCAGCAGCCAAGACGCGGTCCAGAGGGCCTCTACGCAGTATTTT	CASSQDAVQRASTQYF	TRBV4-1	TRBJ2-3
TGTGCCACCCCGGCTAGCGGCCGTACCTACAATGAGCAGTTCTTC	CATPASGRTYNEQFF	TRBV24-1	TRBJ2-1
TGTGCCAGCAGCCTGACTAGGGGCGGTCAAGAGACCCAGTACTTC	CASSLTRGGQETQYF	TRBV9	TRBJ2-5
TGTGCCAGCAGCGTAGGCACAAATGACAGGGATTCACCCCTCCACTTT	CASSVGTNDRDSPLHF	TRBV9	TRBJ1-6
TGTGCCAGCAGCCGGCAGGGGAGGGCTCCTGAAGCTTTCTTT	CASSRQGRAPEAFF	TRBV12-3	TRBJ1-1
TGCGCCAGCAGCTTGGTCGGCGCAGAGATGAACACTGAAGCTTTCTTT	CASSLVGAEMNTEAFF	TRBV5-1	TRBJ1-1
TGTGCCGGTCAGATCCGAGGCTATAATTCACCCCTCCACTTT	CAGQIRGYNSPLHF	TRBV5-6	TRBJ1-6
TGTGCCAGCAGCTTGCCGGGGGGGCTAACGGGAATTCCAGAGACCCAGTACTTC	CASSLPGGLTGIPETQYF	TRBV5-4	TRBJ2-5
TGTGCCAGCAGTTTGACGCGGGGGTATTCTGGGGCCAACGTCCTGACTTTC	CASSLTRGYSGANVLTF	TRBV28	TRBJ2-6
TGTGCCACCCCGGGACTGATCTCGCGACAGTCCTACAATGAGCAGTTCTTC	CATPGLISRQSYNEQFF	TRBV25-1	TRBJ2-1
TGCAGCGTGTACCGGGGGTATAAGGTAAACCCAGGGGGGCACTACGAGCAGTACTTC	CSVYRGYKVNPGGHYEQYF	TRBV29-1	TRBJ2-7
TGCGCCAGCAGGGGCGGCAGGGAGCCCCAGCATTTT	CASRGGREPQHF	TRBV10-2	TRBJ1-5
TGTGCCAGCAGCGTAGCCCAGGCGGCAAGCACCGGGGAGCTGTTTTTT	CASSVAQAASTGELFF	TRBV9	TRBJ2-2
TGTGCCAGCAGTGTTGCGTTGGGAGGGAAGGGGGGCGGATCCTACAATGAGCAGTTCTTC	CASSVALGGKGGGSYNEQFF	TRBV6-6	TRBJ2-1
TGTGCCAGCAATTTAGGATTGCTAGAGACGACGAAGGCCGCCGGGGAGCTGTTTTTT	CASNLGLLETTKAAGELFF	TRBV7-9	TRBJ2-2
TGCAGTGCTAGAGGGGCCTATCGGCCCTTACAGCCCCAGCATTTT	CSARGAYRPLQPQHF	TRBV20-1	TRBJ1-5
TGTGCCAGCACCTCAGTGGGGGGCGGGAGGGATACGCAGTATTTT	CASTSVGGGRDTQYF	TRBV6-4	TRBJ2-3
TGTGCCAGCGGGTCGGGGGGGACTGAAGCTTTCTTT	CASGSGGTEAFF	TRBV7-2	TRBJ1-1
TGTGCCAGCAGCCAACAATTGCCCGGGACTAGCGTTGTTTCCTACGAGCAGTACTTC	CASSQQLPGTSVVSYEQYF	TRBV3-1	TRBJ2-7
TGTGCCAGCAAAAGCGGGAGGAGGAACGAGCAGTACTTC	CASKSGRRNEQYF	TRBV6-4	TRBJ2-7
TGTGCCAGCAGCTGGAGCCCGGACTGCTATGACAATGAGCAGTTCTTC	CASSWSPDCYDNEQFF	TRBV7-9	TRBJ2-1
TGTGCCACCAGGGGGCTCCGATGGCATACGCAGTATTTT	CATRGLRWHTQYF	TRBV24-1	TRBJ2-3
TGCGCCAGCAGTGGACACGGACAGGGCCCAACTAATGAAAAACTGTTTTTT	CASSGHGQGPTNEKLFF	TRBV10-2	TRBJ1-4
TGTGCCAGCAGCTGCAGGAGGGGCGCGGGTCCGACTGGGGCCAACGTCCTGACTTTC	CASSCRRGAGPTGANVLTF	TRBV7-9	TRBJ2-6
TGTGCCACCAGTGATTCCCCCGATGAGACCCAGTACTTC	CATSDSPDETQYF	TRBV24-1	TRBJ2-5
TGTGCCAAGCGACAGGATCATTCACCCCTCCACTTT	CAKRQDHSPLHF	TRBV7-8	TRBJ1-6
TGTGCCAGCAGTTACAGCGAGGGGCCTAATGAAAAACTGTTTTTT	CASSYSEGPNEKLFF	TRBV6-6	TRBJ1-4
TGTGCCAGCAGTTTACGACCGGGACTAGCGGGGCGGGAGCAGTACTTC	CASSLRPGLAGREQYF	TRBV28	TRBJ2-7
TGTGCCAGCAGCGGCTCGCTAGCGGGGCTCGCGAACACCGGGGAGCTGTTTTTT	CASSGSLAGLANTGELFF	TRBV7-9	TRBJ2-2
TGCGCCAGCAGCCAAGATGACAGACCTAACTATGGCTACACCTTC	CASSQDDRPNYGYTF	TRBV4-1	TRBJ1-2
TGTGCCAGCCAAGGCTACGAGCAGTACTTC	CASQGYEQYF	TRBV12-3	TRBJ2-7
TGTGCCAGCAGCCCCCGCGGTCGGGGGTCCGGGGAGCTGTTTTTT	CASSPRGRGSGELFF	TRBV3-1	TRBJ2-2
TGTGCCAGCAGTGGACTAGGCGAAACCAATGAGCAGTTCTTC	CASSGLGETNEQFF	TRBV6-4	TRBJ2-1
TGTGCCAGCAGTTTACCCCCGGGCCAGCGGACGGACCCACTGACCCAGTACTTC	CASSLPPGQRTDPLTQYF	TRBV12-4	TRBJ2-5
TGTGCCAGCAGCTTAAGACGTAATAATCAGCCCCAGCATTTT	CASSLRRNNQPQHF	TRBV7-9	TRBJ1-5
TGTGCCAGCAGCTTGAATTACTCGAGGGACACCGGGGAGCTGTTTTTT	CASSLNYSRDTGELFF	TRBV5-6	TRBJ2-2
TGTGCCAGCAGCCATGTAGCTAGTGTGGGCTATAATTCACCCCTCCACTTT	CASSHVASVGYNSPLHF	TRBV7-3	TRBJ1-6
TGTGCCAGCCCTGGACAGTTACTAGCCAAAAACATTCAGTACTTC	CASPGQLLAKNIQYF	TRBV11-1	TRBJ2-4
TGTGCCAGCGGGGCCCCAGGGGCTCGCTCCTACGAGCAGTACTTC	CASGAPGARSYEQYF	TRBV25-1	TRBJ2-7
TGTGCCCAAGATAAGGCCCGGGGCGTGAACGAGCAGTACTTC	CAQDKARGVNEQYF	TRBV6-1	TRBJ2-7
TGCGCCAGCAGCCAAGCTAGCGGTTACAATGAGCAGTTCTTC	CASSQASGYNEQFF	TRBV4-3	TRBJ2-1
TGTGCCAGCAGCTTGGGGGGGCTTGGAAACACCATATATTTT	CASSLGGLGNTIYF	TRBV7-3	TRBJ1-3
TGCAGTGCTAGAGATTTGGGGTGGGACAGGGTCGGGTTCTCCTACGAGCAGTACTTC	CSARDLGWDRVGFSYEQYF	TRBV20-1	TRBJ2-7
TGTGCCAGCATTACACAGGTCACCTTC	CASITQVTF	TRBV7-3	TRBJ1-2
TGCGCCAGCAGCTTGGGGGGGGATGAGTCAGGGCCGTTAGATGAGCAGTTCTTC	CASSLGGDESGPLDEQFF	TRBV5-1	TRBJ2-1
TGTGCCAGCAGCCTTCTCAGGGGCGGGAATGAGCAGTTCTTC	CASSLLRGGNEQFF	TRBV5-8	TRBJ2-1
TGTGCCACGCGGGAGCTTTTATGCGCTTTCTTT	CATRELLCAFF	TRBV19	TRBJ1-1
TGTGCCAGCAGCTTAGATAGGAAACAGGGGGAAGGGATGAACACTGAAGCTTTCTTT	CASSLDRKQGEGMNTEAFF	TRBV11-2	TRBJ1-1
TGTGCCAGCAGTTCCGGGACTAGCGGGGGCCCTAGTTCCGGGGAGCTGTTTTTT	CASSSGTSGGPSSGELFF	TRBV27	TRBJ2-2
TGTGCCAGCAGGGGAGACCCCCGGGGACAGGGGGCGGGGGCTAACTATGGCTACACCTTC	CASRGDPRGQGAGANYGYTF	TRBV27	TRBJ1-2
TGTGCCACCAGTGATCCGGGGCTACGTCAGTACTTC	CATSDPGLRQYF	TRBV24-1	TRBJ2-5
TGTGCCAGCAGTGATGCTAGCGGGCGCACAGATACGCAGTATTTT	CASSDASGRTDTQYF	TRBV6-1	TRBJ2-3
TGTGCCAGCAGTTCGGGGGGGGACGAGCAGTACTTC	CASSSGGDEQYF	TRBV12-4	TRBJ2-7
TGCGCCAGCAGCCAAGAGGCCCCAGGGACGCGGCGACAAGAGACCCAGTACTTC	CASSQEAPGTRRQETQYF	TRBV4-1	TRBJ2-5
TGTGCCAGCAGCCAGCGGGATCCTCTCACTAACTATGGCTACACCTTC	CASSQRDPLTNYGYTF	TRBV13	TRBJ1-2
TGTGCCAGCAGCCCCGACTCACAAACTAGCGGGAGGAACGAGCAGTACTTC	CASSPDSQTSGRNEQYF	TRBV13	TRBJ2-7
TGTGCCACCAGCAGCCGACAGGGTTCCCTGGGGGAAGAGACCCAGTACTTC	CATSSRQGSLGEETQYF	TRBV15	TRBJ2-5
TGTGCTAGCAGCTCTGCGGGAGGAAACTATAATTCACCCCTCCACTTT	CASSSAGGNYNSPLHF	TRBV7-7	TRBJ1-6
TGTGCCAGCAGACAGGGGCACAAATATTACGAGCAGTACTTC	CASRQGHKYYEQYF	TRBV7-9	TRBJ2-7
TGTGCCAAGGGACAGGGTATCTGGCCCAGCAATCAGCCCCAGCATTTT	CAKGQGIWPSNQPQHF	TRBV19	TRBJ1-5
TGTGCCATCAGACTAGAGGGACACACTGAAGCTTTCTTT	CAIRLEGHTEAFF	TRBV10-3	TRBJ1-1
TGTGCCAGCCCTGGGGATGCCTACGAGCAGTACTTC	CASPGDAYEQYF	TRBV27	TRBJ2-7
TGTGCCAGTAGCGGGGAGGTAGGGTCAGGGGAGCTGTTTTTT	CASSGEVGSGELFF	TRBV19	TRBJ2-2
TGTGCCAGCAGCTCAACACCGGGACTAAATCGCACAGATACGCAGTATTTT	CASSSTPGLNRTDTQYF	TRBV7-2	TRBJ2-3
TGTGCCCGGGGACAGGGGGCTACCTACGAGCAGTACTTC	CARGQGATYEQYF	TRBV7-3	TRBJ2-7
TGCGCCAGCAGCCATTGTCAGGGCGAGACCCAGTACTTC	CASSHCQGETQYF	TRBV4-1	TRBJ2-5
TGCGCCAGCAGCTTTTCTACGCGTAGGGTCAATGAGCAGTTCTTC	CASSFSTRRVNEQFF	TRBV5-1	TRBJ2-1
TGTGCCAGCAGCCCACCCGGGGGCACTGAAGCTTTCTTT	CASSPPGGTEAFF	TRBV12-3	TRBJ1-1
TGTGCCAGCAGCTTGGGGGGACAGGGGATAGAGCAGTACTTC	CASSLGGQGIEQYF	TRBV5-6	TRBJ2-7
TGTGCCAGCAGGGGGGCCGTTCAGTTAAAAGAGACCCAGTACTTC	CASRGAVQLKETQYF	TRBV11-2	TRBJ2-5
TGTGCCAGCGACAGGGGTTGTTACAATGAGCAGTTCTTC	CASDRGCYNEQFF	TRBV6-2	TRBJ2-1
TGCGCCAGCAGTGTTCGGGGGGACAGGGGCCGAGCTCAGCCCCAGCATTTT	CASSVRGDRGRAQPQHF	TRBV10-1	TRBJ1-5
TGTGCCAGCAGCTTAGGACAGGGCCACACTGAAGCTTTCTTT	CASSLGQGHTEAFF	TRBV7-8	TRBJ1-1
TGTGCCAGCAGTCAGCGGGGGGATAGGAAAGAGACCCAGTACTTC	CASSQRGDRKETQYF	TRBV12-3	TRBJ2-5
TGTGCCAGCAGTTACCCTGTACGACTGGAGACCAACACTGAAGCTTTCTTT	CASSYPVRLETNTEAFF	TRBV6-2	TRBJ1-1
TGCAGCGTTGTTTGCCCCCAGTCTGGGGGGTTGGGTGAAAAACTGTTTTTT	CSVVCPQSGGLGEKLFF	TRBV29-1	TRBJ1-4
TGTGCCAGCAGCCAAGAATTTCCGTCGGGAGACAATCAGCCCCAGCATTTT	CASSQEFPSGDNQPQHF	TRBV3-1	TRBJ1-5
TGTGCCAGCAGCCAAGACGCGGGAGGCAACAAAGCCACAGATACGCAGTATTTT	CASSQDAGGNKATDTQYF	TRBV14	TRBJ2-3
TGTGCCAGCAGTGGCGATGGGGGAATAGCTTTCTTT	CASSGDGGIAFF	TRBV2	TRBJ1-1
TGTGCCTGGAGTGTACCATGCATCCAGAAGTTTGGATGGAACACTGAAGCTTTCTTT	CAWSVPCIQKFGWNTEAFF	TRBV30	TRBJ1-1
TGTGCCAGCAGTGCGGTTGGCCGACAGGGGGCGCCCTTCTTGGAAGAGACCCAGTACTTC	CASSAVGRQGAPFLEETQYF	TRBV6-4	TRBJ2-5
TGCGCCAGCAGCGACCCGGCGGGGACCCACGAGCAGTACTTC	CASSDPAGTHEQYF	TRBV5-1	TRBJ2-7
TGTGCCAGCAGTGACTCTAGTTGGGCCATCCGGGGAGGGCCCCTCCACTTT	CASSDSSWAIRGGPLHF	TRBV6-4	TRBJ1-6
TGTGCCAGCAGCTCTGTTTTTAAAGATTCGGGACTAGCGGGTCATGACCCGACAGATACGCAGTATTTT	CASSSVFKDSGLAGHDPTDTQYF	TRBV7-6	TRBJ2-3
TGTGCCAGCCTAAGGATGCAGCCCCAGCATTTT	CASLRMQPQHF	TRBV18	TRBJ1-5
TGTGCCAGCAGCGACCTAGCGGGCTCCTACGAGCAGTACTTC	CASSDLAGSYEQYF	TRBV12-3	TRBJ2-7
TGCAGTGGGTTACTCGGTACAGATACGCAGTATTTT	CSGLLGTDTQYF	TRBV20-1	TRBJ2-3
TGTGCCAGCACTTTCCGGGGCAATCAGCCCCAGCATTTT	CASTFRGNQPQHF	TRBV7-2	TRBJ1-5
TGCAGCGTTGTCCCGGGGGGCCCAGATACGCAGTATTTT	CSVVPGGPDTQYF	TRBV29-1	TRBJ2-3
TGCGCCAGCAGAGGGGGTATTTCACCCCTCCACTTT	CASRGGISPLHF	TRBV10-1	TRBJ1-6
TGCGCCAGCAGTGAAAGAGACAGGGCTTGCAATCAGCCCCAGCATTTT	CASSERDRACNQPQHF	TRBV10-2	TRBJ1-5
TGTGCCAGCAGCTACTCGGAGGAGGACTTTTTCTATGGCTACACCTTC	CASSYSEEDFFYGYTF	TRBV5-6	TRBJ1-2
TGTGCCATCAGGGCCCATCACCAAGAGACCCAGTACTTC	CAIRAHHQETQYF	TRBV10-3	TRBJ2-5
TGTGCCAGCAGTGAATCCGACAGGGCTCATGGCTACACCTTC	CASSESDRAHGYTF	TRBV25-1	TRBJ1-2
TGTGCCAGCAGGTCCCACCACGGTACCTACGAGCAGTACTTC	CASRSHHGTYEQYF	TRBV6-5	TRBJ2-7
TGCGCCAGCAGCGTTCTTGGAAGCGGACCGGGTTCACCCCTCCACTTT	CASSVLGSGPGSPLHF	TRBV5-1	TRBJ1-6
TGTGCCAGCAGCTTGGACAGGGGCAGGAACTATGGCTACACCTTC	CASSLDRGRNYGYTF	TRBV5-8	TRBJ1-2
TGTGCCAGCAGTGCCCTATGGGTGAATGAGCAGTTCTTC	CASSALWVNEQFF	TRBV6-4	TRBJ2-1
TGTGCCAGCACGTCAGAAAAGAGACGGAATGAGCAGTTCTTC	CASTSEKRRNEQFF	TRBV25-1	TRBJ2-1
TGTGCCAGCAGTTCCCAGGGTCGTTATAATTCACCCCTCCACTTT	CASSSQGRYNSPLHF	TRBV7-6	TRBJ1-6
TGTGCCGTCTGCAATCAGCCCCAGCATTTT	CAVCNQPQHF	TRBV27	TRBJ1-5
TGTGCCAGTAGTATAGCTAGCGGGGAGACCGGGGAGCTGTTTTTT	CASSIASGETGELFF	TRBV19	TRBJ2-2
TGTGCCAGCAGCTTTATGGCTGGACACGCCGTACTGCACGAGCAGTACTTC	CASSFMAGHAVLHEQYF	TRBV7-4	TRBJ2-7
TGTGCCAGCAGCAGACTAGGGGCGCGGAACAATCAGCCCCAGCATTTT	CASSRLGARNNQPQHF	TRBV13	TRBJ1-5
TGTGCCAGCAGCGTAGGTAACGGGGCTAGCTCCTACGAGCAGTACTTC	CASSVGNGASSYEQYF	TRBV9	TRBJ2-7
TGTGCCAGCAGCATGAGCACATCCCTTAGCTCCTACGAGCAGTACTTC	CASSMSTSLSSYEQYF	TRBV9	TRBJ2-7
TGTGCCTGGAACCTGGGGGAGGGGGACGAGCAGTACTTC	CAWNLGEGDEQYF	TRBV30	TRBJ2-7
TGTGCCAGCAGCTTAGCAAGGACAGGGCCGGCTCGGGGACCTGATAGCAATCAGCCCCAGCATTTT	CASSLARTGPARGPDSNQPQHF	TRBV7-2	TRBJ1-5
TGTGCCAGCAGTTTCCGGGACAGAAAATATGGCTACACCTTC	CASSFRDRKYGYTF	TRBV28	TRBJ1-2
TGTGCCACCAGTGATCTTGCTCCGGGACAGAATGGCTACACCTTC	CATSDLAPGQNGYTF	TRBV24-1	TRBJ1-2
TGTGCCAGCAGATCAGGGGTGTGGGAGCAGTACTTC	CASRSGVWEQYF	TRBV11-2	TRBJ2-7
TGTGCCAGCAGCGGTAAGGGAGGGGCCGGATCGCGTGAAGCTTTCTTT	CASSGKGGAGSREAFF	TRBV11-2	TRBJ1-1
TGTGCCAGCAGCGATTCAGGGTCGATTGGGGACACTGAAGCTTTCTTT	CASSDSGSIGDTEAFF	TRBV7-3	TRBJ1-1
TGTTCCTGTGCCTACGAGCAGTACTTC	CSCAYEQYF	TRBV7-9	TRBJ2-7
TGTGCCAGCAGTGAGGTCGTCGAGACAGGGGGGGAGGACACCGGGGAGCTGTTTTTT	CASSEVVETGGEDTGELFF	TRBV6-4	TRBJ2-2
TGTGCCAGCAGCCTAAATAGAGCCTACGAGCAGTACTTC	CASSLNRAYEQYF	TRBV4-2	TRBJ2-7
TGTGCCAGCAGCGCCACCCGGATAATCCACGAGCAGTACTTC	CASSATRIIHEQYF	TRBV13	TRBJ2-7
TGTGCCAGCAAATATGGCTCCGGGACAGGGTGTTTGGAATCACCCCTCCACTTT	CASKYGSGTGCLESPLHF	TRBV25-1	TRBJ1-6
TGTGCCAGCAGCTCCGGGGGGGTAGCTAACTATGGCTACACCTTC	CASSSGGVANYGYTF	TRBV7-3	TRBJ1-2
TGTGCCAGCAGGGGGGGCCACGGAAATTCACCCCTCCACTTT	CASRGGHGNSPLHF	TRBV12-3	TRBJ1-6
TGTGCCAGCAGCTCGACGTATCAGAGAGGGTCCATTAAAGCTTTCTTT	CASSSTYQRGSIKAFF	TRBV5-6	TRBJ1-1
TGTGCCAGCAGTTTCTTGAGCAAGACTAGCAAAATCTACGAGCAGTACTTC	CASSFLSKTSKIYEQYF	TRBV12-3	TRBJ2-7
TGTGCCAGCAGCCGACAGGAGGTCCTAGCTTTCTTT	CASSRQEVLAFF	TRBV11-1	TRBJ1-1
TGTGCCAGCAGCTTGGCCTTTAGTCCAAGGACAGGGGACAACCAGGAGCAGTACTTC	CASSLAFSPRTGDNQEQYF	TRBV5-5	TRBJ2-7
TGCAGCGTTGAGGGGGCTACTGGGAGCAATCAGCCCCAGCATTTT	CSVEGATGSNQPQHF	TRBV29-1	TRBJ1-5
TGCAGCGTTGAGCAGGGGGCGACCAGTGAGTTTGAAGCTTTCTTT	CSVEQGATSEFEAFF	TRBV29-1	TRBJ1-1
TGTGCCAGCAGATCGGAACTGAACACTGAAGCTTTCTTT	CASRSELNTEAFF	TRBV6-4	TRBJ1-1
TGTGCCAGCAGCCAAAGCCCGGACGCAGGTAATTCACCCCTCCACTTT	CASSQSPDAGNSPLHF	TRBV3-1	TRBJ1-6
TGTGCCAGCAGTAGGGGGGCGGACTATGGCTACACCTTC	CASSRGADYGYTF	TRBV6-5	TRBJ1-2
TGTGCCAACCGATTGGATAGCAATCAGCCCCAGCATTTT	CANRLDSNQPQHF	TRBV28	TRBJ1-5
TGTGCCAGCAGTTACCCCAGTGGGGCCACAGATACGCAGTATTTT	CASSYPSGATDTQYF	TRBV6-6	TRBJ2-3
TGTGCCAGCCAATGGCGGTCGGGACGTCAGCCCCAGCATTTT	CASQWRSGRQPQHF	TRBV11-3	TRBJ1-5
TGTGCCAGCAGTCCTACCACAGGGTTAAAAGACTCTGGGGCCAACGTCCTGACTTTC	CASSPTTGLKDSGANVLTF	TRBV6-5	TRBJ2-6
TGTGCTAGTGGTTTGCCTCTAGCGGGCGAGCAGTACTTC	CASGLPLAGEQYF	TRBV12-5	TRBJ2-7
TGTGCCAGCAGCCGTACCGGCAGGAGCTCCTACAATGAGCAGTTCTTC	CASSRTGRSSYNEQFF	TRBV7-8	TRBJ2-1
TGCGCCAGCAGCTTTTCCTGGAACACTGAAGCTTTCTTT	CASSFSWNTEAFF	TRBV5-1	TRBJ1-1
TGTGCCAGCATACAGGGGCCGTTGACCCAGTACTTC	CASIQGPLTQYF	TRBV6-4	TRBJ2-5
TGCGCCAGCAGCTTGGACAGCCGGGACTTCGAGACCCAGTACTTC	CASSLDSRDFETQYF	TRBV5-1	TRBJ2-5
TGTGCCACCAGTGGCCAACGTAGCTCTTTCGAGCAGTACTTC	CATSGQRSSFEQYF	TRBV24-1	TRBJ2-7
TGCGCCAGCAGCTTGCGTCACAGGGGGATTGGGGGGAGCTCCTACAATGAGCAGTTCTTC	CASSLRHRGIGGSSYNEQFF	TRBV5-1	TRBJ2-1
TGTGCAGTCCCCGAGGCCAGCTGCTACGAGCAGTACTTC	CAVPEASCYEQYF	TRBV6-2	TRBJ2-7
TGTGCCCTACCGCAGGTTAACACTGAAGCTTTCTTT	CALPQVNTEAFF	TRBV24-1	TRBJ1-1
TGTGCTAGCAGCTTAGGGACAGGTCCCGAGTACTTC	CASSLGTGPEYF	TRBV7-7	TRBJ2-7
TGTGCCAGCAGTGACGTTGGCCGGGACAGGGGCAGCCTTGTCCGCTACGAGCAGTACTTC	CASSDVGRDRGSLVRYEQYF	TRBV2	TRBJ2-7
TGCGCCAGCCGCAAAGAGGGACTTTCCTACGAGCAGTACTTC	CASRKEGLSYEQYF	TRBV4-3	TRBJ2-7
TGTGCCAGCTCTCTACGGACTAGTGAGCAGTTCTTC	CASSLRTSEQFF	TRBV6-6	TRBJ2-1
TGTGCCCACCGGACCAGATTAAACACCTTC	CAHRTRLNTF	TRBV6-6	TRBJ1-2
TGTGCCAGCTCCGGGGACAGGGGATCTGTCAGAGGATATGAAAAACTGTTTTTT	CASSGDRGSVRGYEKLFF	TRBV14	TRBJ1-4
TGTGCCAGCAGTTTATGGTCGAACACCGGGGAGCTGTTTTTT	CASSLWSNTGELFF	TRBV27	TRBJ2-2
TGCGCCAGCAGCTTGGTACGGCCCACGCCGGGCGGACTAGGGATTTGGTCACCCTACGAGCAGTACTTC	CASSLVRPTPGGLGIWSPYEQYF	TRBV5-1	TRBJ2-7
TGTGCCAGCAGCTTAATATTCCGGACAGGGGCCCTGATCAATCAGCCCCAGCATTTT	CASSLIFRTGALINQPQHF	TRBV11-2	TRBJ1-5
TGCGCCAGCAGCCGGACAGGGGGGGCCAAAAACATTCAGTACTTC	CASSRTGGAKNIQYF	TRBV4-1	TRBJ2-4
TGTGCCAGCAGCGGGGGACTAGCGGGAGGGGAGCAGTACTTC	CASSGGLAGGEQYF	TRBV7-7	TRBJ2-7
TGTGCCAGCAGCGTTAGCCCTGAAAGCACAGATACGCAGTATTTT	CASSVSPESTDTQYF	TRBV9	TRBJ2-3
TGTGCCAGCAGCCACCCCTTCTCCGCTTCCTCCTACGAGCAGTACTTC	CASSHPFSASSYEQYF	TRBV14	TRBJ2-7
TGTGCCACCAGTGACCCATCGGGGGGGTGCAATCAGCCCCAGCATTTT	CATSDPSGGCNQPQHF	TRBV24-1	TRBJ1-5
TGCGCCAGCAGCTTGGACTCGAACGGGCCGAACTACAATGAGCAGTTCTTC	CASSLDSNGPNYNEQFF	TRBV5-1	TRBJ2-1
TGTGCCAGCAGCTTCAATAAGGGACAGAGTCAGGAGACCCAGTACTTC	CASSFNKGQSQETQYF	TRBV5-4	TRBJ2-5
TGTGCCAGCACCCGGACAGGGTTCAACACCATATATTTT	CASTRTGFNTIYF	TRBV25-1	TRBJ1-3
TGTGCCTTCCCGGGACAGGGGGCCTACGAGCAGTACTTC	CAFPGQGAYEQYF	TRBV19	TRBJ2-7
TGCAGTGCTAGAGGGTCTGAGCAGTTCTTC	CSARGSEQFF	TRBV20-1	TRBJ2-1
TGCGCCGAGACCAGGGGAAGGAACACTGAAGCTTTCTTT	CAETRGRNTEAFF	TRBV10-1	TRBJ1-1
TGTGCCAGCAGTGACTCGAAAGCAGGCAATCAGCCCCAGCATTTT	CASSDSKAGNQPQHF	TRBV6-4	TRBJ1-5
TGTGCCAGCAGCCGGCCGACAGTTTACAATGAGCAGTTCTTC	CASSRPTVYNEQFF	TRBV7-9	TRBJ2-1
TGTGCCAGCAACGGGACAGGGTCGGACACTGAAGCTTTCTTT	CASNGTGSDTEAFF	TRBV11-3	TRBJ1-1
TGTGCCAGCATCCAGGGAGAACATGGCTACACCTTC	CASIQGEHGYTF	TRBV11-2	TRBJ1-2
TGTGCCACCAGTGTTTGGACAGGGTACGCTAATAGCACAGATACGCAGTATTTT	CATSVWTGYANSTDTQYF	TRBV24-1	TRBJ2-3
TGTGCCAGCAGCTTAAGGGGGAGGGGGAATCGGATCATTTACGAGCAGTACTTC	CASSLRGRGNRIIYEQYF	TRBV7-3	TRBJ2-7
TGTGCCAGCAGCCAAGGGGGGGGTAACTACGAGCAGTACTTC	CASSQGGGNYEQYF	TRBV14	TRBJ2-7
TGTGCCACCCGGGGACCAAACGAACTGTTTTTT	CATRGPNELFF	TRBV6-1	TRBJ1-4
TGTGCCAGGGGGGACAGCGAGCAGTACTTC	CARGDSEQYF	TRBV2	TRBJ2-7
TGTGCCAGCAAGAAACGTGGGGGGGGAGATGAGCAGTTCTTC	CASKKRGGGDEQFF	TRBV6-1	TRBJ2-1
TGCAGCGTTGGTGGGTATAGCTACGAGCAGTACTTC	CSVGGYSYEQYF	TRBV29-1	TRBJ2-7
TGTGCCACCAGTGTTAACCCTACCAGGGGGGGACGAAGGGACGAGCAGTACTTC	CATSVNPTRGGRRDEQYF	TRBV24-1	TRBJ2-7
TGTGCCAGCGAGGGTGTTACGACAGAGTCGCCCGGTGACGAGCAGTACTTC	CASEGVTTESPGDEQYF	TRBV25-1	TRBJ2-7
TGTGCCAGCTCACACCGGGACAGGGTAGAGCAGTACTTC	CASSHRDRVEQYF	TRBV18	TRBJ2-7
TGTGCCAGCAGTCTCCACAGGGGGCACTACGAGCAGTACTTC	CASSLHRGHYEQYF	TRBV6-2	TRBJ2-7
TGTGCCAGCAGCGGGGGACAGCCGGGGCACGAGCAGTACTTC	CASSGGQPGHEQYF	TRBV5-4	TRBJ2-7
TGTGCCAGCAGCTTGGCGGGGAACGAGCGGGGGGCAAGGGATACGCAGTATTTT	CASSLAGNERGARDTQYF	TRBV5-6	TRBJ2-3
TGTGCCAGCAGCCGTACGGGGACAGGGTGGAACACTGAAGCTTTCTTT	CASSRTGTGWNTEAFF	TRBV6-5	TRBJ1-1
TGTGCCTGGAGTGTACTAGAAGAGACCCAGTACTTC	CAWSVLEETQYF	TRBV30	TRBJ2-5
TGTGCCAGCAGCCAAGCACGGACTAGTGAGCAGTTCTTC	CASSQARTSEQFF	TRBV4-2	TRBJ2-1
TGTGCCAGCAGTACCCGGCTTGACAGGGGTGAAGCTTTCTTT	CASSTRLDRGEAFF	TRBV12-3	TRBJ1-1
TGTGCCAGCAGCCCCATACGGCGAGATACGCAGTATTTT	CASSPIRRDTQYF	TRBV7-4	TRBJ2-3
TGTGCCACCAGTGATGTAACAGGGCTTGGCTACACCTTC	CATSDVTGLGYTF	TRBV24-1	TRBJ1-2
TGTGCCAGCAGTTCCCGAGGGCCGCCGGTCTACGAGCAGTACTTC	CASSSRGPPVYEQYF	TRBV27	TRBJ2-7
TGTGCCAGCAGCTTCGGGACTAGCGGGTACTACAATGAGCAGTTCTTC	CASSFGTSGYYNEQFF	TRBV5-6	TRBJ2-1
TGTGCCAGCAGTTGGAGGGGGCCCGGGGGTAGCACAGATACGCAGTATTTT	CASSWRGPGGSTDTQYF	TRBV6-4	TRBJ2-3
TGTGCCAGCTTATCCCAGCGGGAGGAGTATAATTCACCCCTCCACTTT	CASLSQREEYNSPLHF	TRBV28	TRBJ1-6
TGTGCCAGAGCTGGCTACACCTTC	CARAGYTF	TRBV6-1	TRBJ1-2
TGTGCCATCCCGGCCGGGGATAGTCAGCCCCAGCATTTT	CAIPAGDSQPQHF	TRBV28	TRBJ1-5
TGTGCCAGCAGTTACTCGCTCGGGGTTCCGAGAAACACCATATATTTT	CASSYSLGVPRNTIYF	TRBV6-3	TRBJ1-3
TGTGCCAGCAGCTTACCCCCTAGCGGGGGGGCCTACCGGGAATCCTACGAGCAGTACTTC	CASSLPPSGGAYRESYEQYF	TRBV7-3	TRBJ2-7
TGTGCCAGCTCACCACGCAGGCGTATGCAGCCCTACGAGCAGTACTTC	CASSPRRRMQPYEQYF	TRBV18	TRBJ2-7
TGTGCCAGCAGTGCGCACAGGGGGGGTAATGAGCAGTTCTTC	CASSAHRGGNEQFF	TRBV6-1	TRBJ2-1
TGTGCTAAACACATCCCCTCTGGAAACACCATATATTTT	CAKHIPSGNTIYF	TRBV12-3	TRBJ1-3
TGTGCCAGCAGCTTAGCCCAAGGACAGGGAGGCGACACTGAAGCTTTCTTT	CASSLAQGQGGDTEAFF	TRBV11-2	TRBJ1-1
TGTGCCAGCAGCTTAGCTCCAAGCGGACATATAGGGTACGAGCAGTACTTC	CASSLAPSGHIGYEQYF	TRBV11-3	TRBJ2-7
TGTGCCAGCAGCGCCGGTAGCGGGGCCTACAATGAGCAGTTCTTC	CASSAGSGAYNEQFF	TRBV6-1	TRBJ2-1
TGTGCCATCAGTGGTTCGGGGACAGGGGACGCTGAAGCTTTCTTT	CAISGSGTGDAEAFF	TRBV10-3	TRBJ1-1
TGCAGCGTTGATGTCGGCTTCCGCGTAACTAGCGGGAGGAGCAGAGATACGCAGTATTTT	CSVDVGFRVTSGRSRDTQYF	TRBV29-1	TRBJ2-3
TGTGCCAGCAGTAAACCCTGGGACTCCCTATACGAGCAGTACTTC	CASSKPWDSLYEQYF	TRBV28	TRBJ2-7
TGTGCCAGCAGTTCCCGGGAGCCCGGGGATAGCAATCAGCCCCAGCATTTT	CASSSREPGDSNQPQHF	TRBV6-5	TRBJ1-5
TGTGCCAGCAGCGTAGCCCTGCAGGAAGGCAATCAGCCCCAGCATTTT	CASSVALQEGNQPQHF	TRBV9	TRBJ1-5
TGTGCCAGCAGTGAGTCACCCGGGACGTCGCAGTACTTC	CASSESPGTSQYF	TRBV6-4	TRBJ2-7
TGTGCCAGCAGCAGACAGGAGTATCAGCCCCAGCATTTT	CASSRQEYQPQHF	TRBV7-2	TRBJ1-5
TGTGCCAGCAGCGAGACCCGCACTGAAGAAGAGACCCAGTACTTC	CASSETRTEEETQYF	TRBV7-3	TRBJ2-5
TGCGCCAGCAGCTCGGTTCAGGGGGCCGAGTACTTC	CASSSVQGAEYF	TRBV5-1	TRBJ2-7
TGTGCCAGCAGCTTAGAGAGCCATGACAACGGTCGAGAGACCCAGTACTTC	CASSLESHDNGRETQYF	TRBV7-8	TRBJ2-5
TGTGCCAGCAGCCTAGGTGGGGGGATCACTGAAGCTTTCTTT	CASSLGGGITEAFF	TRBV3-1	TRBJ1-1
TGTGCCACCCAGGGGTGGTCGGGGTTCGGCTACACCTTC	CATQGWSGFGYTF	TRBV15	TRBJ1-2
TGTGCCAGCAGCTTAGCCCGGGATAGGGACAGGGCAATGAACACTGAAGCTTTCTTT	CASSLARDRDRAMNTEAFF	TRBV11-2	TRBJ1-1
TGTGCCAGCAGCCAAGATAGGCAGGGTTACTATGGCTACACCTTC	CASSQDRQGYYGYTF	TRBV3-1	TRBJ1-2
TGTGCCAGCAGTTTATGTCCATCTGTGGGCCACTCTGGGGCCAACGTCCTGACTTTC	CASSLCPSVGHSGANVLTF	TRBV27	TRBJ2-6
TGTGCCAGCAGCCAGCCCGGGACTAGCGGGAGGGGGGGTCTAGGCGAGCAGTACTTC	CASSQPGTSGRGGLGEQYF	TRBV7-6	TRBJ2-7
TGCGCCAGGTATCTCATCCACGGGTTCCATCAGCCCCAGCATTTT	CARYLIHGFHQPQHF	TRBV5-1	TRBJ1-5
TGTGCCACCTTTAGAGTATACACTGAAGCTTTCTTT	CATFRVYTEAFF	TRBV24-1	TRBJ1-1
TGTGCCAGCAGCTTTCGGGAGGAAGCTAACTATGGCTACACCTTC	CASSFREEANYGYTF	TRBV11-3	TRBJ1-2
TGTGCCAGCAGTTACTCGCCCCGCCTCAAAAGGACTAGGTATGGCTACACCTTC	CASSYSPRLKRTRYGYTF	TRBV6-6	TRBJ1-2
TGTGCCAGCAGCTTAAGCAAGGGGCAAGCTAACTATGGCTACACCTTC	CASSLSKGQANYGYTF	TRBV7-3	TRBJ1-2
TGCAGTGCACGTTGGGCCCAGAGGATGGTCGGGGAGCTGTTTTTT	CSARWAQRMVGELFF	TRBV20-1	TRBJ2-2
TGTGCCAGCAGTGTCCCGGGACAGGAATACGAGCAGTACTTC	CASSVPGQEYEQYF	TRBV6-1	TRBJ2-7
TGCAGTGCGCGAAGGAACAAATTCAATCAGCCCCAGCATTTT	CSARRNKFNQPQHF	TRBV20-1	TRBJ1-5
TGTGCCAGCAGCGGTAAACGGTACACCGGGGAGCTGTTTTTT	CASSGKRYTGELFF	TRBV13	TRBJ2-2
TGTGCCAGCAGCTTGGACCGGGGGGGCACCGAGCAGTACTTC	CASSLDRGGTEQYF	TRBV11-2	TRBJ2-7
TGCGCCAGCAGCGCTTTGCGATTGGTGAGAAACAATGAGCAGTTCTTC	CASSALRLVRNNEQFF	TRBV5-1	TRBJ2-1
TGTGCCAGCCATTTTGGGGGGGAAGGGCAGTTCTTC	CASHFGGEGQFF	TRBV9	TRBJ2-1
TGTGCCAGCAGCCGGGGGATCCGGAAGGATCAGCCCCAGCATTTT	CASSRGIRKDQPQHF	TRBV9	TRBJ1-5
TGTGCTAGCAGCTTAGCGACACAGGTAGGGTTCTTGATTTGGGGCAGGACTGAAGCTTTCTTT	CASSLATQVGFLIWGRTEAFF	TRBV7-7	TRBJ1-1
TGTGCTAGCAGCCCCCGTGCCCCAGGACAGGGTTGCACTGAAGCTTTCTTT	CASSPRAPGQGCTEAFF	TRBV7-7	TRBJ1-1
TGTGCCACCGAGGGAGACAGAAGACTCTTC	CATEGDRRLF	TRBV24-1	TRBJ1-2
TGTGCCAGCAGCGGGTTAAAACCCTTAATACCAGCCTACTTC	CASSGLKPLIPAYF	TRBV7-9	TRBJ2-4
TGTGCCAGCAGCCAAGAAATTTTATGGCAGGGAGAGACCCAGTACTTC	CASSQEILWQGETQYF	TRBV3-1	TRBJ2-5
TGTGCCACGAGGGGGACCGCAACTAATGAAAAACTGTTTTTT	CATRGTATNEKLFF	TRBV7-9	TRBJ1-4
TGTGCCAGTCCCGGGGGAAACATTCAGTACTTC	CASPGGNIQYF	TRBV13	TRBJ2-4
TGTGCCACCAGTGTATACTCGCCCGCGGGAGCCTACAATGAGCAGTTCTTC	CATSVYSPAGAYNEQFF	TRBV24-1	TRBJ2-1
TGTGCCAGCAGTGAAGGTTACTCCGGCTTCGGCTACACCTTC	CASSEGYSGFGYTF	TRBV6-1	TRBJ1-2
TGTGCCAGCAGTTTAGCATCCCGGACAGGGGAGGGGTTCGAAAAACTGTTTTTT	CASSLASRTGEGFEKLFF	TRBV27	TRBJ1-4
TGTGCCATCAGGGGACAGCGGTACGTCTCCTACAATGAGCAGTTCTTC	CAIRGQRYVSYNEQFF	TRBV10-3	TRBJ2-1
TGTGCCAGCTTGACGGAAGGGTCCTACGAGCAGTACTTC	CASLTEGSYEQYF	TRBV7-9	TRBJ2-7
TGTGAACGGGGGGGGTACTGTCATCAGCCCCAGCATTTT	CERGGYCHQPQHF	TRBV27	TRBJ1-5
TGCAGTGCTAGAAGGGACCTGTCCAAGGGGGCCAACGTCCTGACTTTC	CSARRDLSKGANVLTF	TRBV20-1	TRBJ2-6
TGCAGTGCTAGTTGGAGGGATTATTACGAGCAGTACTTC	CSASWRDYYEQYF	TRBV20-1	TRBJ2-7
TGTGCCAGCAGCCAAGCCTTGGGCCTAAGCTACGAGCAGTACTTC	CASSQALGLSYEQYF	TRBV14	TRBJ2-7
TGTGCCAGCAGCCTAGCGGCCTGCACCGGGGAGCTGTTTTTT	CASSLAACTGELFF	TRBV7-3	TRBJ2-2
TGTGCCAGCAGCGGGCCGTTCCCCTCCGGGACGATTCCAGATACGCAGTATTTT	CASSGPFPSGTIPDTQYF	TRBV13	TRBJ2-3
TGCAGTGCTGGCGGAGGAGCTGGCTACACCTTC	CSAGGGAGYTF	TRBV20-1	TRBJ1-2
TGTGCCAGCAGCCCGCACCAGGGGGCGGGAAGAGGGGGACGGCAGTTCTTC	CASSPHQGAGRGGRQFF	TRBV7-2	TRBJ2-1
TGTGCCAGCAGCCCTACTAGAGGGGAAAAACTGTTTTTT	CASSPTRGEKLFF	TRBV13	TRBJ1-4
TGTGCCAGCAGGACCGACAGGGGGGACGAAGCTTTCTTT	CASRTDRGDEAFF	TRBV27	TRBJ1-1
TGTGCCAGCAGCCCCCCCACCCCCGCAACAGGTAGGGTGTACAATGAGCAGTTCTTC	CASSPPTPATGRVYNEQFF	TRBV5-4	TRBJ2-1
TGTGCCAGCAGCGTAGGGGGAGCCCCGGCGAGAAACACCATATATTTT	CASSVGGAPARNTIYF	TRBV9	TRBJ1-3
TGTGCCCCTACCGGGGGTGGAAGTGGAGGAAACACCATATATTTT	CAPTGGGSGGNTIYF	TRBV9	TRBJ1-3
TGTGCTAGTGGTTCCACCGACAGTTCCTACGAGCAGTACTTC	CASGSTDSSYEQYF	TRBV12-5	TRBJ2-7
TGTGCCAGCAGTGACCCCGGGACAGGGCCAGCCTATGGCTACACCTTC	CASSDPGTGPAYGYTF	TRBV6-1	TRBJ1-2
TGTGCCAGCAGCTTAGCCTCACTCATCGAGCAGTACTTC	CASSLASLIEQYF	TRBV9	TRBJ2-7
TGTGCCAGCAGGCCAAACCGGACAGGGGACTACTCTGGGGCCAACGTCCTGACTTTC	CASRPNRTGDYSGANVLTF	TRBV12-3	TRBJ2-6
TGTGCCAGCAGCTTGGGAGGGGGGTACGAGCAGTACTTC	CASSLGGGYEQYF	TRBV7-2	TRBJ2-7
TGTGCCAGCAGTGGGAGGTTGTGGTCTGCTTTCTTT	CASSGRLWSAFF	TRBV6-1	TRBJ1-1
TGTGCCAGCAGGTTACCCCGGCAGTACTTC	CASRLPRQYF	TRBV28	TRBJ2-7
TGTGCCAGCAGCTTAGATGACCCTACCGGCTACACCTTC	CASSLDDPTGYTF	TRBV7-2	TRBJ1-2
TGTGCTAGTGGTTTTGGGACAAGGGATTTTGAAAAACTGTTTTTT	CASGFGTRDFEKLFF	TRBV12-5	TRBJ1-4
TGTGCCAGCAGTCGGCATCTGATCACCGGGGAGCTGTTTTTT	CASSRHLITGELFF	TRBV2	TRBJ2-2
TGTGCCAGCAGCTGGGACTTTAAGCAGTTCTTC	CASSWDFKQFF	TRBV13	TRBJ2-1
TGTGCCAGCAGTCTCCTAGCGGGCAGCCAAGAGACCCAGTACTTC	CASSLLAGSQETQYF	TRBV28	TRBJ2-5
TGCGCCAGCAGCCAAGGATTTCGTCAGGGGGCCTACGAGCAGTACTTC	CASSQGFRQGAYEQYF	TRBV4-1	TRBJ2-7
TGTGCCAGCAGTTACTTACTTGAGGCCAGTCCGGGACAGGGGCTCGGGTACTTC	CASSYLLEASPGQGLGYF	TRBV6-5	TRBJ2-5
TGCGCCAGCGTTGCCACTAGCACGGGTTCCGAGACCCAGTACTTC	CASVATSTGSETQYF	TRBV10-1	TRBJ2-5
TGTGCCACCAGCCTCCCCCAACCAGGCTCGGCTAGCGGGGATACGCAGTATTTT	CATSLPQPGSASGDTQYF	TRBV24-1	TRBJ2-3
TGTGCCAGCAGTTTCCAACCGGGGGACACTGAAGCTTTCTTT	CASSFQPGDTEAFF	TRBV12-3	TRBJ1-1
TGCGCCAGCAGCCAAAGGACAAAGGGCACCGGGGAGCTGTTTTTT	CASSQRTKGTGELFF	TRBV5-1	TRBJ2-2
TGTGCCAGCAGTTTAGCGGCAGATACTAACTATGGCTACACCTTC	CASSLAADTNYGYTF	TRBV27	TRBJ1-2
TGTGCCAGCAGCGTAGGGACAGGGGAAAGTGAAGCTTTCTTT	CASSVGTGESEAFF	TRBV9	TRBJ1-1
TGTGCCAGCAGCGTGTGGGGACTAGGATACGAGCAGTACTTC	CASSVWGLGYEQYF	TRBV9	TRBJ2-7
TGCGCCAGCAGCTTTCGAATGGGGGGGAGTGAGCAGTTCTTC	CASSFRMGGSEQFF	TRBV5-1	TRBJ2-1
TGTGCCAGCAGTTTTGATCGGGGGGAGGCCGGAAACACCATATATTTT	CASSFDRGEAGNTIYF	TRBV12-3	TRBJ1-3
TGTGCCAGCAGTAGAGTTGTCCCGGGAATCTACGAGCAGTACTTC	CASSRVVPGIYEQYF	TRBV6-6	TRBJ2-7
TGTGCCAGCAGTTACTCGAGGATAGGGAGTAAAGTTTGCTACACCTTC	CASSYSRIGSKVCYTF	TRBV6-5	TRBJ1-2
TGTGCCAGTAAGCGGGACATGACTGGGGCCAACGTCCTGACTTTC	CASKRDMTGANVLTF	TRBV19	TRBJ2-6
TGTGCCAGCAGTCACTGGTCCCCGGACGCAACTAATGAAAAACTGTTTTTT	CASSHWSPDATNEKLFF	TRBV6-5	TRBJ1-4
TGTGCCAGCACGACGTCGGCGCACTATGGCTACACCTTC	CASTTSAHYGYTF	TRBV11-3	TRBJ1-2
TGTGCCTGGGGAATCCCCCAGTTGGATCGGGGGCAGAAACACTTC	CAWGIPQLDRGQKHF	TRBV30	TRBJ2-7
TGTGCCTGGATGAAAAATCCGGGACAGTTAAATGAAAAACTGTTTTTT	CAWMKNPGQLNEKLFF	TRBV30	TRBJ1-4
TGTGCCAGCAGCTTATCGACCGTCACTCAGCCCCAGCATTTT	CASSLSTVTQPQHF	TRBV7-9	TRBJ1-5
TGCAGCGTTGATTACCGGGACGCAGGCACGCAGTATTTT	CSVDYRDAGTQYF	TRBV29-1	TRBJ2-3
TGTGCCAGCACATTACTTGCTTTCTTT	CASTLLAFF	TRBV9	TRBJ1-1
TGTGCCAGCTCACCACCGGGGGATTACAATGAGCAGTTCTTC	CASSPPGDYNEQFF	TRBV18	TRBJ2-1
TGTGCTAGCAGCGGCACAAAAAACTATAATTCACCCCTCCACTTT	CASSGTKNYNSPLHF	TRBV7-7	TRBJ1-6
TGTGCCAGCAGTCAGGAGGGTTGGGGGCACTATGGCTACACCTTC	CASSQEGWGHYGYTF	TRBV6-2	TRBJ1-2
TGTGCCAGCAGCCAAGATATCGTTACCCGGACTGGATACCCTGATACGCAGTATTTT	CASSQDIVTRTGYPDTQYF	TRBV3-1	TRBJ2-3
TGTGCCAGCAGCTCCTGTCTCTACGAGCAGTACTTC	CASSSCLYEQYF	TRBV13	TRBJ2-7
TGTGCCAGCACCAGAGGGCAAAGCTCCTACGAGCAGTACTTC	CASTRGQSSYEQYF	TRBV6-4	TRBJ2-7
TGTGCCAGCAGTTTGCCTTGGGGAGGGCGTTGGCAGCCCCAGCATTTT	CASSLPWGGRWQPQHF	TRBV28	TRBJ1-5
TGTGCCACCAGCAGAGAGTATTGGGAGACCCAGTACTTC	CATSREYWETQYF	TRBV15	TRBJ2-5
TGTGCCAGCAGCCAAGATAAAGACGACTGTGGTTCCTACGAGCAGTACTTC	CASSQDKDDCGSYEQYF	TRBV3-1	TRBJ2-7
TGTGCCAGCAGCGGGACAGGGGGGATCAATCAGCCCCAGCATTTT	CASSGTGGINQPQHF	TRBV7-3	TRBJ1-5
TGCAGTGCTATAGGAGGCCAGGATGTCCAGCCCCAGCATTTT	CSAIGGQDVQPQHF	TRBV20-1	TRBJ1-5
TGTGCCACCAGTGATAATCAATCCCGGGACTTGAGATCGAACACCGGGGAGCTGTTTTTT	CATSDNQSRDLRSNTGELFF	TRBV24-1	TRBJ2-2
TGTGCCACCAAACCACGGGTTCCCTACGAGCAGTACTTC	CATKPRVPYEQYF	TRBV6-1	TRBJ2-7
TGTGCCAGCCCGGGCAGGGGGCCTAGGTACGAGCAGTACTTC	CASPGRGPRYEQYF	TRBV12-3	TRBJ2-7
TGTGCCAGCAGTGGTAGGGCAACTCTGAGCTCCTACAATGAGCAGTTCTTC	CASSGRATLSSYNEQFF	TRBV2	TRBJ2-1
TGTGCCAGCAGCCGGGACACATTGAAAGAAAAACTGTTTTTT	CASSRDTLKEKLFF	TRBV6-4	TRBJ1-4
TGTGCCAGCAGCGGATTGGGCTACAGACTAGGCTACACCTTC	CASSGLGYRLGYTF	TRBV9	TRBJ1-2
TGTGCCAGCAGACCGGGGGTGGAGATGCGGGGCTTGGAAAACATTCAGTACTTC	CASRPGVEMRGLENIQYF	TRBV13	TRBJ2-4
TGCGCCAGCAGCCAAGATTCGGGAGGGGCAGCGGCGAACACCGGGGAGCTGTTTTTT	CASSQDSGGAAANTGELFF	TRBV4-1	TRBJ2-2
TGTGCCATCACTGGAGGGGGGGCGGAAGGGGAGCCCGGGGAGCTGTTTTTT	CAITGGGAEGEPGELFF	TRBV10-3	TRBJ2-2
TGCGCCAGCAGTTGGCGGGGGGCCAAAATAGGCAATGAGCAGTTCTTC	CASSWRGAKIGNEQFF	TRBV10-1	TRBJ2-1
TGTGCCAGCAGTGCCTCGGCGGGGACAACAGATACGCAGTATTTT	CASSASAGTTDTQYF	TRBV6-4	TRBJ2-3
TGTGCCAGCAGCTTAGCGCAACCTCTGATTTATGAGCAGTTCTTC	CASSLAQPLIYEQFF	TRBV7-2	TRBJ2-1
TGTGCCAGCAATCGGTCTTTCGGCAATCAGCCCCAGCATTTT	CASNRSFGNQPQHF	TRBV7-9	TRBJ1-5
TGTGCCATAGTCCCCGGGACTAGTCTATACAATGAGCAGTTCTTC	CAIVPGTSLYNEQFF	TRBV6-2	TRBJ2-1
TGTGCCAGCAGCTTAGCGGGGGGTGAAAAACTGTTTTTT	CASSLAGGEKLFF	TRBV7-9	TRBJ1-4
TGTGCCAGCAGCGCGAACGGCTGGGGTACCGGGGAGCTGTTTTTT	CASSANGWGTGELFF	TRBV9	TRBJ2-2
TGTGCCAGCGTGAAAGGCAGCCTCACAGATACGCAGTATTTT	CASVKGSLTDTQYF	TRBV12-3	TRBJ2-3
TGTGCCAGGAAGTATCAAAGAGCGGGAGCCACCTATGGCTACACCTTC	CARKYQRAGATYGYTF	TRBV2	TRBJ1-2
TGTGCCTGGACAGGGCTAGACTACGAGCAGTACTTC	CAWTGLDYEQYF	TRBV30	TRBJ2-7
TGCGCCAGCAGCTTGGGGACAGGGGAACCAGATACGCAGTATTTT	CASSLGTGEPDTQYF	TRBV5-1	TRBJ2-3
TGCAGTGCTAGATGTAGGGACTACTCTCGACCCCGCCAAGAGACCCAGTACTTC	CSARCRDYSRPRQETQYF	TRBV20-1	TRBJ2-5
TGCGCCAGCAGCTTGGAGGGACAGGATAGCACAGATACGCAGTATTTT	CASSLEGQDSTDTQYF	TRBV5-1	TRBJ2-3
TGTGCCAGCAGCGTGGACTTGAAGGAGCAGTACTTC	CASSVDLKEQYF	TRBV9	TRBJ2-7
TGTGCCAGCAGTACTCCCCCAGGGGGGCAAAGCAATGAGCAGTTCTTC	CASSTPPGGQSNEQFF	TRBV28	TRBJ2-1
TGTGCCAGCAGCAGGGTGGGGGGGCCCGTAGACCAAGAGACCCAGTACTTC	CASSRVGGPVDQETQYF	TRBV7-4	TRBJ2-5
TGTGCCTGGAGTGACAGAGGGGGCGATAGCAATCAGCCCCAGCATTTT	CAWSDRGGDSNQPQHF	TRBV30	TRBJ1-5
TGTGCCACGACAAGGGGGACTGAAGCTTTCTTT	CATTRGTEAFF	TRBV18	TRBJ1-1
TGTGCCAGCAGCGCGCTAGGGTGCCGACGGTTTAACACCGGGGAGCTGTTTTTT	CASSALGCRRFNTGELFF	TRBV7-3	TRBJ2-2
TGCGCCAGCATGTCTATTGGAGACGATTTGCAAGAGACCCAGTACTTC	CASMSIGDDLQETQYF	TRBV10-1	TRBJ2-5
TGTGCCAGGGACAGTCGGCCCACCGGGGAGCTGTTTTTT	CARDSRPTGELFF	TRBV12-3	TRBJ2-2
TGTGCCAGCAGCTTGGAAAAGGGGCGGGAGCAGTACTTC	CASSLEKGREQYF	TRBV5-8	TRBJ2-7
TGCGCCAGCAGCCTCCCACCTATGGAAAAACTGTTTTTT	CASSLPPMEKLFF	TRBV4-1	TRBJ1-4
TGTGCCACCAGGTACCTAGCGGCTTCGTACCAAGAGACCCAGTACTTC	CATRYLAASYQETQYF	TRBV24-1	TRBJ2-5
TGTGCCAGCAGTTTTACGTCGAGAGGAAGGGAGAGGGTAGACGAGCAGTACTTC	CASSFTSRGRERVDEQYF	TRBV28	TRBJ2-7
TGTGCCAGCAGCGCGGGGTCCGATGTGGCCTGGTCCTACGAGCAGTACTTC	CASSAGSDVAWSYEQYF	TRBV5-4	TRBJ2-7
TGTGCCAGCAGCTTAGTCCAGGAGACGGGCTACGAGCAGTACTTC	CASSLVQETGYEQYF	TRBV11-2	TRBJ2-7
TGTGCCAGCAGCCAAGATCTCTCGGGGACTAGCGGCTTTTTCTCCTACGAGCAGTACTTC	CASSQDLSGTSGFFSYEQYF	TRBV3-1	TRBJ2-7
TGTGCCGTGCGGACTAGGACCCAGTACTTC	CAVRTRTQYF	TRBV24-1	TRBJ2-5
TGTGCCGGCACAGGGTACATCACTGAAGCTTTCTTT	CAGTGYITEAFF	TRBV6-1	TRBJ1-1
TGTGCCAGCAGCCTGCCAGAAGCTTTCAGGAACACTGAAGCTTTCTTT	CASSLPEAFRNTEAFF	TRBV7-6	TRBJ1-1
TGTGCCAGCAGCATCGGATTAACCTCTAGCACAGATACGCAGTATTTT	CASSIGLTSSTDTQYF	TRBV7-9	TRBJ2-3
TGTGCCAGCAGCTGGAGGGCACCCAGCAATCAGCCCCAGCATTTT	CASSWRAPSNQPQHF	TRBV7-3	TRBJ1-5
TGTGCCAGCAGTAAGGACAGGGCCGTTCGCAATGAGCAGTTCTTC	CASSKDRAVRNEQFF	TRBV6-1	TRBJ2-1
TGTGCCAGCAGCTTACTAGTCGCTGGACAGATCCCCTACGAGCAGTACTTC	CASSLLVAGQIPYEQYF	TRBV7-3	TRBJ2-7
TGTGCCAGCAGTCCTTTAGCGGGGAACAATGAGCAGTTCTTC	CASSPLAGNNEQFF	TRBV6-4	TRBJ2-1
TGTGCCAGCAGGGTGTACCGGGGACAGGTCTCCTACGAGCAGTACTTC	CASRVYRGQVSYEQYF	TRBV6-5	TRBJ2-7
TGTGCCTGGGTAGACTTGCGTTCCTATGGCTACACCTTC	CAWVDLRSYGYTF	TRBV30	TRBJ1-2
TGTGCCAGCAGTTACATGGGGGGGGGACACACCGGGGAGCTGTTTTTT	CASSYMGGGHTGELFF	TRBV6-5	TRBJ2-2
TGTGCCAGCAGCGTAATCCAGGGCTATGGCTACACCTTC	CASSVIQGYGYTF	TRBV9	TRBJ1-2
TGTGCCAGCAGTGCTCCTATAGACAGGGTCAATCAGCCCCAGCATTTT	CASSAPIDRVNQPQHF	TRBV6-1	TRBJ1-5
TGTGCCAGCAGTGACTCGATCAGACCGGGACTAGCGGGGTACCAAGAGACCCAGTACTTC	CASSDSIRPGLAGYQETQYF	TRBV6-4	TRBJ2-5
TGTGCCACCAGTGAGTCGGGGACTGTAAGCAATCAGCCCCAGCATTTT	CATSESGTVSNQPQHF	TRBV24-1	TRBJ1-5
TGTGCCAGCACCCCAGGGTGGACAGGAAGGAAAAACGACGAGCAGTACTTC	CASTPGWTGRKNDEQYF	TRBV27	TRBJ2-7
TGTGCCAGCAGTTACCCATGGGAGGATCAGCCCCAGCATTTT	CASSYPWEDQPQHF	TRBV6-5	TRBJ1-5
TGCGCCAGCAAACGGCCAGCGAACACCGGGGAGCTGTTTTTT	CASKRPANTGELFF	TRBV4-1	TRBJ2-2
TGCGCCAGCAGCTTGTTCCCAGACCAGTGGAACACTGAAGCTTTCTTT	CASSLFPDQWNTEAFF	TRBV5-1	TRBJ1-1
TGTGCCAGCAGCAGACGACGAAACCCTAGCACAGATACGCAGTATTTT	CASSRRRNPSTDTQYF	TRBV13	TRBJ2-3
TGCGCCAGCAGCCAAGATTGGGAGTGGGGGGCAGAGAACACTGAAGCTTTCTTT	CASSQDWEWGAENTEAFF	TRBV4-3	TRBJ1-1
TGTGCCGGGACGGGGGGGCCCACAGATACGCAGTATTTT	CAGTGGPTDTQYF	TRBV5-4	TRBJ2-3
TGCGCCAGCAGCGGCAGGGGCAATTCACCCCTCCACTTT	CASSGRGNSPLHF	TRBV5-1	TRBJ1-6
TGTGCCAGCAGCCTTTGCAGCAACTATAGCAATCAGCCCCAGCATTTT	CASSLCSNYSNQPQHF	TRBV5-6	TRBJ1-5
TGTGCCTGGGATTCTGCCTACGAGCAGTACTTC	CAWDSAYEQYF	TRBV30	TRBJ2-7
TGTGCCAGTAGTATAGGACTAGCGGGGGGGCAAGCCGGAGGGGCCCACGAGCAGTACTTC	CASSIGLAGGQAGGAHEQYF	TRBV19	TRBJ2-7
TGTGCCAGCAGCATACGGGACGGTAGCTCCTATAATTCACCCCTCCACTTT	CASSIRDGSSYNSPLHF	TRBV13	TRBJ1-6
TGCAGTGCTAGAAAAAATGGGGGGGGCACCAATGAGCAGTTCTTC	CSARKNGGGTNEQFF	TRBV20-1	TRBJ2-1
TGTGCCAGCTCACCACGAGAAGGAGTAAACACCGGGGAGCTGTTTTTT	CASSPREGVNTGELFF	TRBV18	TRBJ2-2
TGTGCCAGCAGTTACTCGGTAGGGCTTTGCTATAGCAATCAGCCCCAGCATTTT	CASSYSVGLCYSNQPQHF	TRBV6-5	TRBJ1-5
TGCAGTGCTAAAGGGCTTGCTGGACTAGACGGAGATGAAGAGTACGAGCAGTACTTC	CSAKGLAGLDGDEEYEQYF	TRBV20-1	TRBJ2-7
TGTGCCAGCAGCTTGGGATCGGCGGGCTTTACGACTGAAGCTTTCTTT	CASSLGSAGFTTEAFF	TRBV5-4	TRBJ1-1
TGTGCCAGCCGGGGCAGGGCATTGATTCGATTCCTCTATGGCTACACCTTC	CASRGRALIRFLYGYTF	TRBV12-4	TRBJ1-2
TGTGCCCCAGCCCCCAATCCCACAGGGGACGTCTACGAGCAGTACTTC	CAPAPNPTGDVYEQYF	TRBV6-5	TRBJ2-7
TGTGCCAGCAGCAGCGGCAGGGGCACTGAAGCTTTCTTT	CASSSGRGTEAFF	TRBV9	TRBJ1-1
TGTGCCAGCAGTACTAACCCTCCAGGGAGGGGTGGGAATGAGCAGTTCTTC	CASSTNPPGRGGNEQFF	TRBV6-1	TRBJ2-1
TGTGCCAGCTCACCCTCAAGCGGGAGGGGTAGCTCCTACGAGCAGTACTTC	CASSPSSGRGSSYEQYF	TRBV18	TRBJ2-7
TGCAGTGCTAGAGTCCTTCGGCTAGCGGTCACGGGAGAGTATGAGCAGTTCTTC	CSARVLRLAVTGEYEQFF	TRBV20-1	TRBJ2-1
TGTGCCATCAGCATCGGGTTCAGAAGGTACACAGATACGCAGTATTTT	CAISIGFRRYTDTQYF	TRBV10-3	TRBJ2-3
TGTGCCAGCAGCTTAGTGGGGCCACGCTATGGCTACACCTTC	CASSLVGPRYGYTF	TRBV7-8	TRBJ1-2
TGTGCCAGTAGTAGAGACATAAGGTATACGCAGTATTTT	CASSRDIRYTQYF	TRBV19	TRBJ2-3
TGTGCCAGCAGCTTCCAGACCGGGACTAGCGGGCGTCGGAGCAGCCCCAATGAGCAGTTCTTC	CASSFQTGTSGRRSSPNEQFF	TRBV7-9	TRBJ2-1
TGTGCCAGCAGCTTAATACGGGGGCCCCTGCTGATTTACAATGAGCAGTTCTTC	CASSLIRGPLLIYNEQFF	TRBV13	TRBJ2-1
TGTGCTAGTGGTTTGGTGCCCAACTCAAGAAACACCTTCAAAACTGAAGCTTTCTTT	CASGLVPNSRNTFKTEAFF	TRBV12-5	TRBJ1-1
TGTGCCAGTACAACGGCGGAAAGGAGTGGCGAAAAACTGTTTTTT	CASTTAERSGEKLFF	TRBV19	TRBJ1-4
TGTGCCAGCAGCTTACTAGAACAGGCCGACGCCACTGAAGCTTTCTTT	CASSLLEQADATEAFF	TRBV5-6	TRBJ1-1
TGTGCCAGGGGACAGGACGTGGAGAACACTGAAGCTTTCTTT	CARGQDVENTEAFF	TRBV19	TRBJ1-1
TGTGCCAGCAGTTTGGGAGACGAGTCTGGCTACACCTTC	CASSLGDESGYTF	TRBV28	TRBJ1-2
TGCAGCGACGGGCAGCCAGAGCAGTACTTC	CSDGQPEQYF	TRBV29-1	TRBJ2-7
TGTGCCAGCAGGGAGAACAGGGTAGTGAACACTGAAGCTTTCTTT	CASRENRVVNTEAFF	TRBV6-5	TRBJ1-1
TGTGCCTGGGGATCCCGGGGGTCGGTCTACGAGCAGTACTTC	CAWGSRGSVYEQYF	TRBV30	TRBJ2-7
TGTGCCAGCAGCACAGAAGGACTAGCGGGAGAGGGCTACGAGCAGTACTTC	CASSTEGLAGEGYEQYF	TRBV13	TRBJ2-7
TGTGCCATCAGTGAGCCAATAAGGGAATCTACAACAGACGAGCAGTACTTC	CAISEPIRESTTDEQYF	TRBV10-3	TRBJ2-7
TGTGCCAGCGACAGGAAGCTGACTTCTGAGACCCAGTACTTC	CASDRKLTSETQYF	TRBV27	TRBJ2-5
TGTGCCACCAGCAGAGATCGAAGAGCGCCCCCCGTCTACGAGCAGTACTTC	CATSRDRRAPPVYEQYF	TRBV15	TRBJ2-7
TGTGCCAGCAGCTTATTGCCCGGGACTAGAGGCTACGAGCAGTACTTC	CASSLLPGTRGYEQYF	TRBV7-2	TRBJ2-7
TGTGCCAGGTCGGGAACTAATGGCTACACCTTC	CARSGTNGYTF	TRBV6-5	TRBJ1-2
TGTGCCAGCAGCTCCTCGCGGGGGATCAACACCGGGGAGCTGTTTTTT	CASSSSRGINTGELFF	TRBV5-6	TRBJ2-2
TGTGCTAGTGGTTCCCTATTAGCGGGCCAGGTACACAATGAGCAGTTCTTC	CASGSLLAGQVHNEQFF	TRBV12-5	TRBJ2-1
TGCGCCAGCAGCTTGGAAGGAATAGAGCAGCCCCAGCATTTT	CASSLEGIEQPQHF	TRBV5-1	TRBJ1-5
TGTGCCAGCAGTTTAGAGACAGGGGAGCAGTACTTC	CASSLETGEQYF	TRBV12-4	TRBJ2-7
TGTGCCAGCAGCAACCAGGGAAATTCACCCCTCCACTTT	CASSNQGNSPLHF	TRBV6-4	TRBJ1-6
TGTGCCAGCAGCTTGGCCCATCTAACTCGGGAGTCGTTCACTGAAGCTTTCTTT	CASSLAHLTRESFTEAFF	TRBV11-3	TRBJ1-1
TGTGCCAGCAGTTTACCACCGACGGGGCTGAGATACGAGCAGTACTTC	CASSLPPTGLRYEQYF	TRBV27	TRBJ2-7
TGTGCCAGTCGGTCCGCAGACAGAAGGGTCATGAACACTGAAGCTTTCTTT	CASRSADRRVMNTEAFF	TRBV28	TRBJ1-1
TGTGCCACCACCGGGACTTTCAACACCGGGGAGCTGTTTTTT	CATTGTFNTGELFF	TRBV24-1	TRBJ2-2
TGTGCCAGCAGCTATCGTAGGGAAAAACTGTTTTTT	CASSYRREKLFF	TRBV7-9	TRBJ1-4
TGTGCCAGCAGCCCCCGACAGGTATCGCCATCCTACAATGAGCAGTTCTTC	CASSPRQVSPSYNEQFF	TRBV3-1	TRBJ2-1
TGTGCCAGCAGCTTGGGAATTCATATTGAGCAGTTCTTC	CASSLGIHIEQFF	TRBV5-5	TRBJ2-1
TGTGCCAGCAGTATCGACAGGGGGCCTAGCTCTGGAAACACCATATATTTT	CASSIDRGPSSGNTIYF	TRBV27	TRBJ1-3
TGTGCCAGCAGCACCGGACTAGCGGGACCCGAGCAGTTCTTC	CASSTGLAGPEQFF	TRBV7-2	TRBJ2-1
TGTGCCAGCAGCTACGTCGGACAGGACTCTGGGGCCAACGTCCTGACTTTC	CASSYVGQDSGANVLTF	TRBV7-3	TRBJ2-6
TGTGCCAGCAGCAGTCGACGACTAGCGGTAGGGGAATTGGCAGACTACAATGAGCAGTTCTTC	CASSSRRLAVGELADYNEQFF	TRBV9	TRBJ2-1
TGTGCCACCAAGAAGAGCGGACCCTACAATGAGCAGTTCTTC	CATKKSGPYNEQFF	TRBV24-1	TRBJ2-1
TGTGCCAGCAGTCTGAGAACAGAGCAGTTCTTC	CASSLRTEQFF	TRBV2	TRBJ2-1
TGTGCCAGCAGCATTACCGTCCCCGAAACTAGCGGGAGGGCATGGGAGATGCAGTTCTTC	CASSITVPETSGRAWEMQFF	TRBV13	TRBJ2-1
TGTGCCACCAGTGGTCGAGTACAAGGGGGGCCAATTCAAGAGACCCAGTACTTC	CATSGRVQGGPIQETQYF	TRBV24-1	TRBJ2-5
TGTGCCAGCAGTGTTCGGCAAGGGAACTTCTACGAGCAGTACTTC	CASSVRQGNFYEQYF	TRBV28	TRBJ2-7
TGTGCCAGCAGTAATAAGACGGGACAGGGAGCCTACAATGAGCAGTTCTTC	CASSNKTGQGAYNEQFF	TRBV6-3	TRBJ2-1
TGCGCCAGCAGCTTGGGGGACCTAGATGCAACTAATGAAAAACTGTTTTTT	CASSLGDLDATNEKLFF	TRBV5-1	TRBJ1-4
TGTGCCAGCAGCTGTCCCTCGAACACTGAAGCTTTCTTT	CASSCPSNTEAFF	TRBV13	TRBJ1-1
TGTGCCAGCAGCCAAGAGGTCGCCGTAGCCGGCGTCTACGAGCAGTACTTC	CASSQEVAVAGVYEQYF	TRBV14	TRBJ2-7
TGTGCCAGGGGGGGGGCCCCACTTTGTAGGAGTTCCACAGATACGCAGTATTTT	CARGGAPLCRSSTDTQYF	TRBV19	TRBJ2-3
TGTGCCAGCAGTTACCAGGGGGTATTCAATCAGCCCCAGCATTTT	CASSYQGVFNQPQHF	TRBV6-6	TRBJ1-5
TGTGCCAGCAGTTCAGGACAGGGGAAGCAGCCCCAGCATTTT	CASSSGQGKQPQHF	TRBV6-1	TRBJ1-5
TGTGCCAGCAGTGGTAGGACTAGCGTCAGGAGGGCCGAGCAGTACTTC	CASSGRTSVRRAEQYF	TRBV25-1	TRBJ2-7
TGTGCCAGCAGCTTAGAACGAGAGGGAGGGACAGATACGCAGTATTTT	CASSLEREGGTDTQYF	TRBV7-4	TRBJ2-3
TGTGCCAGCAGTGACTCGAAGCTGGGTTTGGCCCGACTAGCGGAGAAAAGATCGAGCACAGATACGCAGTATTTT	CASSDSKLGLARLAEKRSSTDTQYF	TRBV6-4	TRBJ2-3
TGTGCCAGCAGAGTTACTAGCGGGAGTATGGAGGGGAAACGGAATGAAAAACTGTTTTTT	CASRVTSGSMEGKRNEKLFF	TRBV28	TRBJ1-4
TGTGCAAAAGGGGCGCGGCCTAATGAAAAACTGTTTTTT	CAKGARPNEKLFF	TRBV12-5	TRBJ1-4
TGTGCCAGCAGCCAAGGCGGTGACAGGGGGCAGTTTGCTTTCTTT	CASSQGGDRGQFAFF	TRBV4-2	TRBJ1-1
TGCGCCAGCAGCTTGGCTACCAGGGCCAGGATAAACATTCAGTACTTC	CASSLATRARINIQYF	TRBV5-1	TRBJ2-4
TGCAGTGCCCAAATCTGGGACAGGGGGGGAGAAAAACTGTTTTTT	CSAQIWDRGGEKLFF	TRBV20-1	TRBJ1-4
TGTGCCAGCAGTGCTGCGGACTGGGGCCCTTTTCAGCCCCAGCATTTT	CASSAADWGPFQPQHF	TRBV25-1	TRBJ1-5
TGTGCCAGCCGTTCGGGAGCCGGGGAGCTGTTTTTT	CASRSGAGELFF	TRBV7-2	TRBJ2-2
TGTGCCACCAGTGAATCGACACTCGCCGGTATTAACACCGGGGAGCTGTTTTTT	CATSESTLAGINTGELFF	TRBV24-1	TRBJ2-2
TGCGCCAGCAGTGAGTATCAGATAGGGACAGGGTGTGAAAAACTGTTTTTT	CASSEYQIGTGCEKLFF	TRBV10-2	TRBJ1-4
TGTGCCAGCAGCCCGGGACAGTATAACAGATACACTGAAGCTTTCTTT	CASSPGQYNRYTEAFF	TRBV13	TRBJ1-1
TGTGCCTATCGTGACAGGGGAGGGTATGGCTACACCTTC	CAYRDRGGYGYTF	TRBV30	TRBJ1-2
TGCGCCAGCAGTGACACTTATCCGGGACAGCCCAGCTACGAGCAGTACTTC	CASSDTYPGQPSYEQYF	TRBV10-1	TRBJ2-7
TGCGCCAGCAGCTCCGATGCGCCCGAGCAGTACTTC	CASSSDAPEQYF	TRBV5-1	TRBJ2-7
TGTGCCAGCAATGCGGACAGGGGTGGGGGGGGAAACACCATATATTTT	CASNADRGGGGNTIYF	TRBV6-2	TRBJ1-3
TGCGCCAGCAGCTTGGCTAGCGGGGAATCCTACGAGCAGTACTTC	CASSLASGESYEQYF	TRBV5-1	TRBJ2-7
TGTGCTAGTGTACCGGGACTAGCGGGGGGAAGCATTCAGTACTTC	CASVPGLAGGSIQYF	TRBV12-5	TRBJ2-4
TGTGCCAGCAGATTCGAAAGGAGGACAGGGCCCGAGGGACAGCCCCAGCATTTT	CASRFERRTGPEGQPQHF	TRBV5-4	TRBJ1-5
TGTGCCAGCAAGAGACAGGGTCGTGAAGCTTTCTTT	CASKRQGREAFF	TRBV7-9	TRBJ1-1
TGTGCCAGCAGTGCTCGGAGGGAAGCACCCCTCCACTTT	CASSARREAPLHF	TRBV6-1	TRBJ1-6
TGTGCCAGCAGCCAAGATTACCTCGGCACAGGGTCCCCGAACACTGAAGCTTTCTTT	CASSQDYLGTGSPNTEAFF	TRBV14	TRBJ1-1
TGCGCCAGCAGCGCCCAAGGGGATACGCAGTATTTT	CASSAQGDTQYF	TRBV5-1	TRBJ2-3
TGCGCCAGCAGTGAGTCGGCCACAGGTGATTCGAACACCGGGGAGCTGTTTTTT	CASSESATGDSNTGELFF	TRBV10-2	TRBJ2-2
TGTGCCAGCAGTGACTCGCGTTGGGACAGGGGATACACTGAAGCTTTCTTT	CASSDSRWDRGYTEAFF	TRBV6-4	TRBJ1-1
TGTGCCAGCAGCTTAGATCTCGGGACCCAGTTCTTT	CASSLDLGTQFF	TRBV11-3	TRBJ1-1
TGTGCCAGCAGGATGAGGGGCACTGAAGCTTTCTTT	CASRMRGTEAFF	TRBV12-4	TRBJ1-1
TGTGCCAGCAGTACTAGCGGGAGGTTAGAGACCCAGTACTTC	CASSTSGRLETQYF	TRBV6-4	TRBJ2-5
TGTGCTAGTGGTTTGGTATTGGGATCTGGGGGCGGGAGCATAGAGACCCAGTACTTC	CASGLVLGSGGGSIETQYF	TRBV12-5	TRBJ2-5
TGTGCCAGCAGCGGACAGCCCAGCTACGAGCAGTACTTC	CASSGQPSYEQYF	TRBV12-3	TRBJ2-7
TGTGCCAGCAGCTATGGCCCCCTAGGAGTCAATGAGCAGTTCTTC	CASSYGPLGVNEQFF	TRBV11-2	TRBJ2-1
TGTGCCAGCAGCCGAGGACTAGCGGGGGATGAGCAGTTCTTC	CASSRGLAGDEQFF	TRBV6-4	TRBJ2-1
TGCGCCAGCAGCGCTTGCTCCGAACCGGGACTGACGGCGCATTACAATGAGCAGTTCTTC	CASSACSEPGLTAHYNEQFF	TRBV5-1	TRBJ2-1
TGCAGTGCGTCGGTGGGGGGGCCCGACCCCCCCAATGAGCAGTTCTTC	CSASVGGPDPPNEQFF	TRBV20-1	TRBJ2-1
TGTGCCAGCAGCTTAATACGGTCGTCCTATGGCTACACCTTC	CASSLIRSSYGYTF	TRBV7-3	TRBJ1-2
TGCAGCGTTGAACCGGGACTAGGGGACATTCAGTACTTC	CSVEPGLGDIQYF	TRBV29-1	TRBJ2-4
TGTGCCAGCAGCCAAGGGGTCCCCGAGGCTAATGAAAAACTGTTTTTT	CASSQGVPEANEKLFF	TRBV14	TRBJ1-4
TGCGCCAGCAGCTTGGCCGAGACCGGGACTAGCGGTTTACTGTTACACACAGATACGCAGTATTTT	CASSLAETGTSGLLLHTDTQYF	TRBV5-1	TRBJ2-3
TGTGCCAGCAGCTTAGGAAACGTGGGACAGGGGGCGAACACCGGGGAGCTGTTTTTT	CASSLGNVGQGANTGELFF	TRBV7-9	TRBJ2-2
TGTGCCAGTAGTAGTGGCGCCCTCGAGGGCGAGCAGTACTTC	CASSSGALEGEQYF	TRBV19	TRBJ2-7
TGCGCCAGCAGTGAGGAACATAGCTACGAGCAGTACTTC	CASSEEHSYEQYF	TRBV10-1	TRBJ2-7
TGTGCTAGTGGTTCCTCGACAGAGCAGCCCCAGCATTTT	CASGSSTEQPQHF	TRBV12-5	TRBJ1-5
TGTGCCAGCAGCTGCGGGGTCGGGACCCGTGGGAGGCCCGGCAATCAGCCCCAGCATTTT	CASSCGVGTRGRPGNQPQHF	TRBV7-6	TRBJ1-5
TGTGCCAGCAGTTACGGACGGTGTGAGCAGTTCTTC	CASSYGRCEQFF	TRBV6-1	TRBJ2-1
TGTGCCAGCAGCACACTTCAACTAGCGGGAGACTTGAACACTGAAGCTTTCTTT	CASSTLQLAGDLNTEAFF	TRBV7-3	TRBJ1-1
TGTGCCAGGCTAGTAGTGCTCAACGAAGGCTACGAGCAGTACTTC	CARLVVLNEGYEQYF	TRBV27	TRBJ2-7
TGTGCCACCCACAGGGCGATTAACACCGGGGAGCTGTTTTTT	CATHRAINTGELFF	TRBV24-1	TRBJ2-2
TGTGCCAGCAGCGTAGGCGGCAGGGCCCTGAACACTGAAGCTTTCTTT	CASSVGGRALNTEAFF	TRBV9	TRBJ1-1
TGCGCCAGCAGCTTGCACGTAACAGGAAGTGACACCGGGGAGCTGTTTTTT	CASSLHVTGSDTGELFF	TRBV5-1	TRBJ2-2
TGTGCCAGCAGCCAAGATCCTTTAACCCAGGGGAAGGCGACCGGGGAGCTGTTTTTT	CASSQDPLTQGKATGELFF	TRBV4-2	TRBJ2-2
TGCGCCAGCAGCCCGGGGGGCCCGTATTCACCCCTCCACTTT	CASSPGGPYSPLHF	TRBV5-1	TRBJ1-6
TGTGCCAGCAGTTTGTGGATCCGGGGGAGGGGCTATAATTCACCCCTCCACTTT	CASSLWIRGRGYNSPLHF	TRBV12-3	TRBJ1-6
TGTGCCAGCAGCCGCCCCGGGACAGAATACTACGAGCAGTACTTC	CASSRPGTEYYEQYF	TRBV11-2	TRBJ2-7
TGCGCCAGCAGCCATGAACCTTATAGCAATCAGCCCCAGCATTTT	CASSHEPYSNQPQHF	TRBV4-1	TRBJ1-5
TGTGCCAGCTCTCCGATGGGGCACTGTCAGCCCCAGCATTTT	CASSPMGHCQPQHF	TRBV18	TRBJ1-5
TGCGCCAGCAGCTTGAGTGGTCGGGGGGAAGGACCAAGCCCCTACGAGCAGTACTTC	CASSLSGRGEGPSPYEQYF	TRBV5-1	TRBJ2-7
TGTGCCAGCAGTTACGTCAGCGGGGAAATGCAAGAGACCCAGTACTTC	CASSYVSGEMQETQYF	TRBV6-5	TRBJ2-5
TGTGCCAGCAGAGAAGCCTACTATGGCTACACCTTC	CASREAYYGYTF	TRBV11-3	TRBJ1-2
TGTGCCAGCATTCCAAACCAGCATCATGGCTACACCTTC	CASIPNQHHGYTF	TRBV6-1	TRBJ1-2
TGCAGCGTTATGGGCAGGGGCAACGGACAGGGGGCCCAGCTAGCCAAAAACATTCAGTACTTC	CSVMGRGNGQGAQLAKNIQYF	TRBV29-1	TRBJ2-4
TGTGCCAGCCGGGACAGGGGCCAATACAGGCTGAACACCGGGGAGCTGTTTTTT	CASRDRGQYRLNTGELFF	TRBV5-6	TRBJ2-2
TGTGCCAGCAGCGGGGGGCGCAGGTATTGTTCTGACACTGAAGCTTTCTTT	CASSGGRRYCSDTEAFF	TRBV7-3	TRBJ1-1
TGCACAAGGATGGGTCGCACAGATACGCAGTATTTT	CTRMGRTDTQYF	TRBV20-1	TRBJ2-3
TGTGCCAGCAGCTTAGGTGTACTGTCGACTAATGAAAAACTGTTTTTT	CASSLGVLSTNEKLFF	TRBV7-9	TRBJ1-4
TGTGCCAGCAGCTTAATTCAGTGCCATGAAGCTTTCTTT	CASSLIQCHEAFF	TRBV7-9	TRBJ1-1
TGCGCCAGCAGCCGAGCCCCCCATTTCTTC	CASSRAPHFF	TRBV4-3	TRBJ2-7
TGTGCCAGCAGCCCCGGACAGCTCATGAACACTGAAGCTTTCTTT	CASSPGQLMNTEAFF	TRBV6-5	TRBJ1-1
TGTGCCAGCTCACCAATCCAAGCAGTGTGCACAGATACGCAGTATTTT	CASSPIQAVCTDTQYF	TRBV18	TRBJ2-3
TGCGCCAGCAGTGAGAGTCGGGCCGTCACAGATACGCAGTATTTT	CASSESRAVTDTQYF	TRBV10-1	TRBJ2-3
TGCGCCAGCAGCCAAGATCAGGGGGCCCGTTTACACGAGCAGTACTTC	CASSQDQGARLHEQYF	TRBV4-3	TRBJ2-7
TGTGCCAGCAGCCTCGGGGGTGGAGGCAACACTGAAGCTTTCTTT	CASSLGGGGNTEAFF	TRBV7-2	TRBJ1-1
TGTGCCAGCAGCCAAGTTGGACAGGGGGGGGTCCTCCACTTT	CASSQVGQGGVLHF	TRBV14	TRBJ1-6
TGCAGTGCTCCATTCTCGCATTGGTTCTACGAGCAGTACTTC	CSAPFSHWFYEQYF	TRBV20-1	TRBJ2-7
TGTGCCAGCAGCGTAGTAGAAGTCCCGCTGGTGTCAGAGGCTGGGGCCAACGTCCTGACTTTC	CASSVVEVPLVSEAGANVLTF	TRBV9	TRBJ2-6
TGTGCCAGCAGCAGGGGGAGTCAATCCCAGCATTTT	CASSRGSQSQHF	TRBV28	TRBJ1-5
TGTGCCAGTAGTATCTCCCATCGACTTAGCAATGAGCAGTTCTTC	CASSISHRLSNEQFF	TRBV19	TRBJ2-1
TGTGCCAGCAGCTCCCCAGGGGGCACCCAAGAGACCCAGTACTTC	CASSSPGGTQETQYF	TRBV7-9	TRBJ2-5
TGTGCCTGGAGTGCTTTAGGTACAGAGACCCAGTACTTC	CAWSALGTETQYF	TRBV30	TRBJ2-5
TGTGCCAGCCTCCCTAGGGAAACTAACACCATATATTTT	CASLPRETNTIYF	TRBV6-5	TRBJ1-3
TGTGCCAGCAGTGATGGGGTCACCCATGGAAACACCATATATTTT	CASSDGVTHGNTIYF	TRBV6-4	TRBJ1-3
TGTGCCACGGACGTAGGGAATGAAAAACTGTTTTTT	CATDVGNEKLFF	TRBV24-1	TRBJ1-4
TGTGCCAGCAGCCTCCGGGCTGGAGATACGCAGTATTTT	CASSLRAGDTQYF	TRBV7-9	TRBJ2-3
TGTGCCAGCACCGGACGGGTCGAGCAGTACTTC	CASTGRVEQYF	TRBV6-4	TRBJ2-7
TGTGCCAGCAGGTCGCGTGCGGCCCGAGGGAGTTCTGGGGCCAACGTCCTGACTTTC	CASRSRAARGSSGANVLTF	TRBV12-4	TRBJ2-6
TGTGCCAGCAGCCAAGGGGGGGATACCGGGGAGCTGTTTTTT	CASSQGGDTGELFF	TRBV14	TRBJ2-2
TGCGCCAGCAGCCCCCCTAACAGGGCATACAATGAGCAGTTCTTC	CASSPPNRAYNEQFF	TRBV5-1	TRBJ2-1
TGTGCCAGCAGCTTAGTGCTAGCTTGGAGGGGCACAGATACGCAGTATTTT	CASSLVLAWRGTDTQYF	TRBV7-2	TRBJ2-3
TGTGCCAGCAGTTTATCTAGACAGGGGGCTAATGGCTACACCTTC	CASSLSRQGANGYTF	TRBV28	TRBJ1-2
TGTGCCAGCAGTGAACGGACTTGGACAGATACGCAGTATTTT	CASSERTWTDTQYF	TRBV6-1	TRBJ2-3
TGCAGTGCTAGAGCCTGGACAGGGTCTCGGGGGCCTGACTGTGGCTACACCTTC	CSARAWTGSRGPDCGYTF	TRBV20-1	TRBJ1-2
TGTGCCAGCAGTTTTCAAACGGCCTACGAGCAGTACTTC	CASSFQTAYEQYF	TRBV28	TRBJ2-7
TGTGCCAGCAGTTTCCGGCCAATCGGCGAGACCCAGTACTTC	CASSFRPIGETQYF	TRBV28	TRBJ2-5
TGTGCCAGCAGCTTATGGGGGACGTGCTCTGGAAACACCATATATTTT	CASSLWGTCSGNTIYF	TRBV13	TRBJ1-3
TGCGCCAGCAGCCAAGATACTCCCGGACAGGGTAACTATGGCTACACCTTC	CASSQDTPGQGNYGYTF	TRBV4-3	TRBJ1-2
TGTGCCAGCACAATGGCGGAAAACAGCGCCTACAATGAGCAGTTCTTC	CASTMAENSAYNEQFF	TRBV6-4	TRBJ2-1
TGTGCCAGCAGTTTACGGGGACTACTTCCTCACAAGCGCACAGATACGCAGTATTTT	CASSLRGLLPHKRTDTQYF	TRBV27	TRBJ2-3
TGCGCCAGCAGTGGCCGGGAGGAAGAGGTGGTAAACACCATATATTTT	CASSGREEEVVNTIYF	TRBV10-2	TRBJ1-3
TGTGCCAGCAGTTTAAAGCACTATAATTCACCCCTCCACTTT	CASSLKHYNSPLHF	TRBV28	TRBJ1-6
TGTGTCGAGGGAGCTTTCTTT	CVEGAFF	TRBV7-9	TRBJ1-1
TGTGCCAGCAGCTCCCCTGGACAGGGGAGTATTGAAGCTTTCTTT	CASSSPGQGSIEAFF	TRBV7-8	TRBJ1-1
TGCGCCAGCAGCCAAGAGAGGGGCTGGGCCTACGAGCAGTACTTC	CASSQERGWAYEQYF	TRBV4-1	TRBJ2-7
TGCAGTGCTAGAGATCGGCGAAAACGGACCGACCTAGAGACCCAGTACTTC	CSARDRRKRTDLETQYF	TRBV20-1	TRBJ2-5
TGTGCCAGCCCCCTTGTCCGGACAGGGGGCGCACACTCCTACGAGCAGTACTTC	CASPLVRTGGAHSYEQYF	TRBV6-1	TRBJ2-7
TGTGCCAGCAGCCCAAGAAAGCTGCAGGGGCTAGGGGGACCTTGTTATGGCTACACCTTC	CASSPRKLQGLGGPCYGYTF	TRBV3-1	TRBJ1-2
TGTGCCACAGAATGGGACTTAAGCAATCAGCCCCAGCATTTT	CATEWDLSNQPQHF	TRBV24-1	TRBJ1-5
TGCAGCGGGGTAAAATCTAACTATGGCTACACCTTC	CSGVKSNYGYTF	TRBV29-1	TRBJ1-2
TGTGCCAGCAGCTTAATGGAGGGGGGGAGGCAGTACTTC	CASSLMEGGRQYF	TRBV11-2	TRBJ2-7
TGTGCCAAACGCCAGCGGGATGCCACTGAAGCTTTCTTT	CAKRQRDATEAFF	TRBV6-1	TRBJ1-1
TGTGCCAGCAGCTTAGAGGGGGAAGCTTTCTTT	CASSLEGEAFF	TRBV11-2	TRBJ1-1
TGTGCCTGGACCAGCAGTAGGGGCCTGAATGGCTACACCTTC	CAWTSSRGLNGYTF	TRBV30	TRBJ1-2
TGTGCCAGCAGTCCTATAGAAAAACTGTTTTTT	CASSPIEKLFF	TRBV28	TRBJ1-4
TGTGCCACCGGGGCGTCGCCTCAAGGAGAGACCCAGTACTTC	CATGASPQGETQYF	TRBV15	TRBJ2-5
TGTGCCAGCAGCCCCGCCCTAGGACTAGCGGGGTGTAAGCACGAGCAGTACTTC	CASSPALGLAGCKHEQYF	TRBV13	TRBJ2-7
TGTGCCAGCAGCCCTCCCTGGGGGGGCCGGGAGCAGTATTTT	CASSPPWGGREQYF	TRBV13	TRBJ2-3
TGTGCCAGCAGTTACGGACATTCTGGTCACAATGAGCAGTTCTTC	CASSYGHSGHNEQFF	TRBV6-5	TRBJ2-1
TGTGCCAGCAGTCTCGGGGGGGAATCCTATAATTCACCCCTCCACTTT	CASSLGGESYNSPLHF	TRBV6-2	TRBJ1-6
TGCAGTGCTAGGAAACGGGGGGCCCGCAATGAGCAGTTCTTC	CSARKRGARNEQFF	TRBV20-1	TRBJ2-1
TGTGCCAGCAGCTTAGTGATCAAGGGGCTCCCCATTCAGTACTTC	CASSLVIKGLPIQYF	TRBV7-9	TRBJ2-4
TGTGCCAGCAGCCTTCAGGGGTTTGGCTACACCTTC	CASSLQGFGYTF	TRBV7-4	TRBJ1-2
TGTGCCAGCAGCTTAGTCTGGGGGAGTCAGCGAAGCTCCTACGAGCAGTACTTC	CASSLVWGSQRSSYEQYF	TRBV7-6	TRBJ2-7
TGTGCCAGTACTTCCTCCGGGACTAGGGATACGCAGTATTTT	CASTSSGTRDTQYF	TRBV2	TRBJ2-3
TGTGCCAGCAGCTTAGCATGGGACAGGAGCCGGTCCACAGATACGCAGTATTTT	CASSLAWDRSRSTDTQYF	TRBV7-2	TRBJ2-3
TGTGCCAGCAGCCCATTCCGACCCTTGGGCACCATATATTTT	CASSPFRPLGTIYF	TRBV6-4	TRBJ1-3
TGTGCCAGCAGTTTATGGACAGGGCCGACTGAAGCTTTCTTT	CASSLWTGPTEAFF	TRBV27	TRBJ1-1
TGCAGTGCTAGAGCCTCGGCTCATCCCTACGAGCAGTACTTC	CSARASAHPYEQYF	TRBV20-1	TRBJ2-7
TGTGCCAGCAGCACTCCTCCCCGGGATGGCGGGGAGCTGTTTTTT	CASSTPPRDGGELFF	TRBV5-6	TRBJ2-2
TGTGCCAGCAGCACCCCAATGACAGGGTCTTCCCACAGCTCCTACGAGCAGTACTTC	CASSTPMTGSSHSSYEQYF	TRBV7-2	TRBJ2-7
TGTGCTAGTGGTGGGGGGCAAGAAGCTTTCTTT	CASGGGQEAFF	TRBV12-5	TRBJ1-1
TGTGCCGTGGGACTAGCCAGGCAAGAGACCCAGTACTTC	CAVGLARQETQYF	TRBV30	TRBJ2-5
TGTGCCAGCAGCGTAGTGCGGGAGACCCCTGGGAAACCTGTAGCCCAAGAGACCCAGTACTTC	CASSVVRETPGKPVAQETQYF	TRBV9	TRBJ2-5
TGTGCCAGCAGTGAATATGACCAGGCGCCAGCTAACTATGGCTACACCTTC	CASSEYDQAPANYGYTF	TRBV25-1	TRBJ1-2
TGTGCCAGCATCCCGACTAGCGGGAGGATTAATGAAAAACTGTTTTTT	CASIPTSGRINEKLFF	TRBV6-4	TRBJ1-4
TGTGCCAGCAGCAGTAGACGGACGTTGCCCCCGAAGGACAGATTTAGCAATCAGCCCCAGCATTTT	CASSSRRTLPPKDRFSNQPQHF	TRBV11-3	TRBJ1-5
TGTGCCAGCAGCTTAGAAGGGGGGGGATTGGTTAACACTGAAGCTTTCTTT	CASSLEGGGLVNTEAFF	TRBV11-2	TRBJ1-1
TGTGCCAGCAGCTTAACGGGGACAGGGGTTTATAGCTCCTACAATGAGCAGTTCTTC	CASSLTGTGVYSSYNEQFF	TRBV7-3	TRBJ2-1
TGTGCCAGCAGCCCAGGGGGAGTGGGCAATCAGCCCCAGCATTTT	CASSPGGVGNQPQHF	TRBV13	TRBJ1-5
TGCGCCAGCAGCTTGCTTTCGACCGGGACTAGCACCACAGATACGCAGTATTTT	CASSLLSTGTSTTDTQYF	TRBV5-1	TRBJ2-3
TGTGCCAGTAGTATAGAGGTGGAGGACCCGTCTGTCTTC	CASSIEVEDPSVF	TRBV19	TRBJ2-1
TGTGCCAGCAGCGCAGGGGGGGCGGGTGAGCAGTTCTTC	CASSAGGAGEQFF	TRBV11-3	TRBJ2-1
TGTGCCAGCAGCCAAGTGGACCAGGGGGGGGCGGGGGTTTGGGGAGCTGAGCAGTTCTTC	CASSQVDQGGAGVWGAEQFF	TRBV4-2	TRBJ2-1
TGTGCCAGCAGCCCCGACAGGGATAGCAATCAGCCCCAGCATTTT	CASSPDRDSNQPQHF	TRBV3-1	TRBJ1-5
TGTGCCACTATCGTTAGGAATTCACCCCTCCACTTT	CATIVRNSPLHF	TRBV24-1	TRBJ1-6
TGTGCCAGCAGCGGGACTGGCACAGATACGCAGTATTTT	CASSGTGTDTQYF	TRBV5-4	TRBJ2-3
TGTGCCAGCAGTTTACCCGGCAGGGCCTACGAGCAGTACTTC	CASSLPGRAYEQYF	TRBV27	TRBJ2-7
TGTGCCAGGGTGGGTTTCGCCTCCAACAGGGGAATAAAAAAGGCGGCCCACGAGCAGTACTTC	CARVGFASNRGIKKAAHEQYF	TRBV19	TRBJ2-7
TGCGCCAGCAGCTTGACATCGGGGGACCAAAACATTCAGTACTTC	CASSLTSGDQNIQYF	TRBV5-1	TRBJ2-4
TGTGCCAGCAGCTTAGTGTGGGGGGGGGACCCCTACGAGCAGTACTTC	CASSLVWGGDPYEQYF	TRBV11-3	TRBJ2-7
TGTGCCAGCAGCGCAGGGGGGACCATCTACATCTACTCTGGGGCCAACGTCCTGACTTTC	CASSAGGTIYIYSGANVLTF	TRBV13	TRBJ2-6
TGTGCCAGCAGCAGAGGTCGAGGGGGGGCCAGACCACACATTCAGTACTTC	CASSRGRGGARPHIQYF	TRBV7-7	TRBJ2-4
TGTGCCAGCAGCGCCCAGGTCAGGTCTAACGAGCAGTACTTC	CASSAQVRSNEQYF	TRBV13	TRBJ2-7
TGTGCCAGCACCCGACAGTCCGGGGGCTACACCTTC	CASTRQSGGYTF	TRBV6-4	TRBJ1-2
TGTGCCAGCAGCCAAGATTACTCCAGGGGGTCAGATACGCAGTATTTT	CASSQDYSRGSDTQYF	TRBV3-1	TRBJ2-3
TGTGCCAGCAGCTTCGAGGGGGGGCCGGGTGATGAGCAGTTCTTC	CASSFEGGPGDEQFF	TRBV7-2	TRBJ2-1
TGTGCCAGCAGTTTACTAGCGGGAGGGACCGGGGAGCTGTTTTTT	CASSLLAGGTGELFF	TRBV2	TRBJ2-2
TGTGCCAGCGTCAGCCTTAGGAACACTGAAGCTTTCTTT	CASVSLRNTEAFF	TRBV13	TRBJ1-1
TGTGCCAGCAGCCAACACACGGGAACAGGGTCCTACGAGCAGTACTTC	CASSQHTGTGSYEQYF	TRBV3-1	TRBJ2-7
TGTGCCAGCAGCAGGCGAGGGCCTAGCTTTGCCACGAAGAACACTGAAGCTTTCTTT	CASSRRGPSFATKNTEAFF	TRBV7-3	TRBJ1-1
TGTGCCAAAAGAAAGGCCTCCTACGAGCAGTACTTC	CAKRKASYEQYF	TRBV19	TRBJ2-7
TGTGCCAGCGACAGGGCCGGGGAGCTGTTTTTT	CASDRAGELFF	TRBV9	TRBJ2-2
TGTGCCAGCAGCTTGGCCGGAAAGGGGGCGAACTACAATGAGCAGTTCTTC	CASSLAGKGANYNEQFF	TRBV5-4	TRBJ2-1
TGTGCCATCCCGGGTGTCGCCCTCTACGAGCAGTACTTC	CAIPGVALYEQYF	TRBV10-3	TRBJ2-7
TGTGCCAGCAGCAACGGTACATCCCAAGAGACCCAGTACTTC	CASSNGTSQETQYF	TRBV5-4	TRBJ2-5
TGTGCCAGCAGCTGGAACGGGACTACATTGATAAATCTAGAGACCCAGTACTTC	CASSWNGTTLINLETQYF	TRBV5-6	TRBJ2-5
TGTGCCAGCAGGAATACGATTAAACTCACCGGGGAGCTGTTTTTT	CASRNTIKLTGELFF	TRBV12-4	TRBJ2-2
TGTGCCAGCAGCTTATTAAAAGGGGGGAGAAGCACAGATACGCAGTATTTT	CASSLLKGGRSTDTQYF	TRBV7-2	TRBJ2-3
TGTGCCACCAGTGATGCCAGCCTTAGTTCTGCTGAAGCTTTCTTT	CATSDASLSSAEAFF	TRBV24-1	TRBJ1-1
TGTGCCAGCAGTCGGTTGGGATGGCGTAGAAACACCATATATTTT	CASSRLGWRRNTIYF	TRBV6-1	TRBJ1-3
TGTGCCAGCAGCCCGGGGACAGTAGACACTGAAGCTTTCTTT	CASSPGTVDTEAFF	TRBV11-3	TRBJ1-1
TGCAGGAGACTAGCGGGTATGGGCACAGATACGCAGTATTTT	CRRLAGMGTDTQYF	TRBV20-1	TRBJ2-3
TGCAGTGCGTTGGGGGCCTTAAAAGATAGCAATCAGCCCCAGCATTTT	CSALGALKDSNQPQHF	TRBV20-1	TRBJ1-5
TGTGCCAGCAGGGGACGAATTGGCTACACCTTC	CASRGRIGYTF	TRBV25-1	TRBJ1-2
TGTGCCAGCAGTTACGGGGGGGGCGGGGATGAGCAGTTCTTC	CASSYGGGGDEQFF	TRBV6-5	TRBJ2-1
TGCGCCAGCAGCTTGGTTAACGAGCAGTACTTC	CASSLVNEQYF	TRBV5-1	TRBJ2-7
TGTGCCAGCAGTGCCCAGGGTATGAACACTGAAGCTTTCTTT	CASSAQGMNTEAFF	TRBV25-1	TRBJ1-1
TGTGCCAGCAGCTTGGCTGGGGACTACAATGAGCAGTTCTTC	CASSLAGDYNEQFF	TRBV5-6	TRBJ2-1
TGTGCTAGTGGTCGGATCTCCTACGAGCAGTACTTC	CASGRISYEQYF	TRBV12-5	TRBJ2-7
TGTGCTAGTGGTACGAGGGACAAAGAGACCCAGTACTTC	CASGTRDKETQYF	TRBV12-5	TRBJ2-5
TGTGCCAGCAGCTTCGACAGGTTTCGGTATGGCTACACCTTC	CASSFDRFRYGYTF	TRBV11-2	TRBJ1-2
TGTGCCAGCAGCCTACCCGAGGCCACCCCTGAAGCTTTCTTT	CASSLPEATPEAFF	TRBV7-6	TRBJ1-1
TGTGCCAGCAGCCATAGAGACAGGGCATGCAATCAGCCCCAGCATTTT	CASSHRDRACNQPQHF	TRBV9	TRBJ1-5
TGTGCCAGCAGTGATCGTACGACCTGCTCCTACGAGCAGTACTTC	CASSDRTTCSYEQYF	TRBV25-1	TRBJ2-7
TGTGCCAGCAGCACCGAAGAAATGGGGAGCACAGATACGCAGTATTTT	CASSTEEMGSTDTQYF	TRBV13	TRBJ2-3
TGTGCCAGCAGCCAAGATCCCGGGGTGTACAATGAGCAGTTCTTC	CASSQDPGVYNEQFF	TRBV14	TRBJ2-1
TGTGCCAGCAGCGAACGAGACAGGGAGCCGTACGAGCAGTACTTC	CASSERDREPYEQYF	TRBV3-1	TRBJ2-7
TGTGCCAGCAGTGGCGGGAGAGGGGAGCTGTTTTTT	CASSGGRGELFF	TRBV2	TRBJ2-2
TGTGCCAGCAGTTTATTCGAGATTAATTCACCCCTCCACTTT	CASSLFEINSPLHF	TRBV27	TRBJ1-6
TGTGCCAGCAGGTACAAAAACATTCAGTACTTC	CASRYKNIQYF	TRBV6-4	TRBJ2-4
TGTGCCAGCAGAGGGGGTAAATCAAATGAGCAGTTCTTC	CASRGGKSNEQFF	TRBV7-2	TRBJ2-1
TGCGCCAGCAGTCTGATTGGTGGGAACCTCCCTAACTATGGCTACACCTTC	CASSLIGGNLPNYGYTF	TRBV5-1	TRBJ1-2
TGTGCCAGCAGTGTGTCGCACAGGGAGCCCCAACATTCACCCCTCCACTTT	CASSVSHREPQHSPLHF	TRBV6-1	TRBJ1-6
TGCAGTGCTAGGGCACAGGGGCAGGGAGCCAAAAACATTCAGTACTTC	CSARAQGQGAKNIQYF	TRBV20-1	TRBJ2-4
TGTGCCTCCCGCATCCCGGGACAGGTCCACTTCGGTTTCTCCTACAATGAGCAGTTCTTC	CASRIPGQVHFGFSYNEQFF	TRBV30	TRBJ2-1
TGTGCCAGCTCTGGGACTAATTATGGCTACACCTTC	CASSGTNYGYTF	TRBV18	TRBJ1-2
TGTGCCAGCAGCTTAGGCAAGCGGTCCTGCTCCTACAATGAGCAGTTCTTC	CASSLGKRSCSYNEQFF	TRBV11-2	TRBJ2-1
TGTGCCAGCAGCTTAGATGGTAAGCCGGGACAGGGGCACAACACTGAAGCTTTCTTT	CASSLDGKPGQGHNTEAFF	TRBV7-8	TRBJ1-1
TGCGCCAGCAGTGTTCCGGGACAGGGGGCAAACCCCTACGAGCAGTACTTC	CASSVPGQGANPYEQYF	TRBV10-1	TRBJ2-7
TGTGCCAGCAGTTTCCGGACCAGGGGGCGGGAGACTGAAGCTTTCTTT	CASSFRTRGRETEAFF	TRBV12-4	TRBJ1-1
TGTGCCAGCAGTTTATCGCTAGGGACAGGGGGCACAGATACGCAGTATTTT	CASSLSLGTGGTDTQYF	TRBV27	TRBJ2-3
TGTGCCAGCAGCAGCCGGGGTCCGGATCAGCCCCAGCATTTT	CASSSRGPDQPQHF	TRBV7-3	TRBJ1-5
TGTGCCAGGTCCGTCAGGGGGCCTTATTCACCCCTCCACTTT	CARSVRGPYSPLHF	TRBV19	TRBJ1-6
TGTGCCAGCAGCCAAAAGCAGCGGGAGGGGACAGATACGCAGTATTTT	CASSQKQREGTDTQYF	TRBV3-1	TRBJ2-3
TGCGCCAGCAGCTTGCCCGGGCCTCGTGGAAACACCATATATTTT	CASSLPGPRGNTIYF	TRBV5-1	TRBJ1-3
TGCAGTGCTAGAGTGGGGGGGGCGGCCGCGCGGGATTGTGAGCAGTTCTTC	CSARVGGAAARDCEQFF	TRBV20-1	TRBJ2-1
TGTGCCAGCAGTTGCAGGGCCCGGACTGAAGCTTTCTTT	CASSCRARTEAFF	TRBV12-3	TRBJ1-1
TGTGCCAGCACGGCAGGGGGCGACCTCACAGATACGCAGTATTTT	CASTAGGDLTDTQYF	TRBV4-2	TRBJ2-3
TGCAGTGCTAGAGATGTGCAGGGGGCGCTCGATGGCTACACCTTC	CSARDVQGALDGYTF	TRBV20-1	TRBJ1-2
TGTGCCAGCAGGGACGACACTGAAGCTTTCTTT	CASRDDTEAFF	TRBV5-4	TRBJ1-1
TGCGCCAGCAGCCAAGACCACCGACAGGGCGAGGGAAACACCATATATTTT	CASSQDHRQGEGNTIYF	TRBV4-1	TRBJ1-3
TGTGCCACCAGCAGATTCAAAAGGGGCTCTGGAAACACCATATATTTT	CATSRFKRGSGNTIYF	TRBV15	TRBJ1-3
TGTGCCAGCAGGACTAACAAGGCCGAGGACAATGAGCAGTTCTTC	CASRTNKAEDNEQFF	TRBV6-4	TRBJ2-1
TGCGCCAGCAGGCCCTTAACCCAAGAGACCCAGTACTTC	CASRPLTQETQYF	TRBV10-2	TRBJ2-5
TGTGCCAGCAGCCATCAAGCTGCTAAGCAGAACGTAGATCAGCCCCAGCATTTT	CASSHQAAKQNVDQPQHF	TRBV4-2	TRBJ1-5
TGTGCCAGCAGTGACTCGACTAAGACAGGCCCCTCCTACGAGCAGTACTTC	CASSDSTKTGPSYEQYF	TRBV6-4	TRBJ2-7
TGTGCCAGCAGTGGCACCGGGACTAGCGGGAGAGGCAACACTGAAGCTTTCTTT	CASSGTGTSGRGNTEAFF	TRBV6-4	TRBJ1-1
TGCGCCAGCAGCTGTTCTAGCGCCGGAACGATACATACGCAGTATTTT	CASSCSSAGTIHTQYF	TRBV5-1	TRBJ2-3
TGTGCCAGCAGTAGCCGGGACAGGGGAGGTCGGACTGAAGCTTTCTTT	CASSSRDRGGRTEAFF	TRBV27	TRBJ1-1
TGTGCCAGCAGCCAAGAGAGCGGGGTCAAAGGTCGCTACGAGCAGTACTTC	CASSQESGVKGRYEQYF	TRBV3-1	TRBJ2-7
TGTGCCAGCAGCCACGACAGGGAGACCCAGTACTTC	CASSHDRETQYF	TRBV3-1	TRBJ2-5
TGTGCCTGGCCTGGGCCCGGAATCTACGAGCAGTACTTC	CAWPGPGIYEQYF	TRBV30	TRBJ2-7
TGTGCCACCAGTGATTTAGCAACGTGGTTAATCCCGGTCCTTCAGGCTCGGGGGCTACGCACTGAAGCTTTCTTT	CATSDLATWLIPVLQARGLRTEAFF	TRBV24-1	TRBJ1-1
TGTGCCAGCATACGGGGGGGGCCCTACGAGCAGTACTTC	CASIRGGPYEQYF	TRBV6-4	TRBJ2-7
TGTGCCAGCAGCCGGGGGCCAAGGAGGGTAGAGACCCAGTACTTC	CASSRGPRRVETQYF	TRBV3-1	TRBJ2-5
TGTGCCAGCAGTGAAGTAGCCCAACCCCCTCGGGGACAGCACTCCTACGAGCAGTACTTC	CASSEVAQPPRGQHSYEQYF	TRBV2	TRBJ2-7
TGTGCCAGCAGTGAGAACCGGGACGAGGATCAGCCCCAGCATTTT	CASSENRDEDQPQHF	TRBV2	TRBJ1-5
TGTGCCAGCAGTGACTCCTGGGGACAGGGTCAGAACTATGGCTACACCTTC	CASSDSWGQGQNYGYTF	TRBV6-4	TRBJ1-2
TGCGCCAGCAGCAACAGGGGAGGTGCTTTCTTT	CASSNRGGAFF	TRBV10-1	TRBJ1-1
TGTGCCAGTAGTTATAGGGACTATGGCTACACCTTC	CASSYRDYGYTF	TRBV19	TRBJ1-2
TGTGCCAGCAGTAATGGGGTAGACACTATAGAGACCCAGTACTTC	CASSNGVDTIETQYF	TRBV2	TRBJ2-5
TGTGCCAGCAGCAGACCGGACAGGAACACTGAAGCTTTCTTT	CASSRPDRNTEAFF	TRBV13	TRBJ1-1
TGTGCCAGCAGCGGTGGCTCAGGGATGGGGGTAGCTAACTATGGCTACACCTTC	CASSGGSGMGVANYGYTF	TRBV9	TRBJ1-2
TGTGCCAGCAGCGTAGGCCGGACTAGGAGCTCCTACAATGAGCAGTTCTTC	CASSVGRTRSSYNEQFF	TRBV9	TRBJ2-1
TGTGCCAGCAGCCCCTGGCAGGATGGCTACACCTTC	CASSPWQDGYTF	TRBV7-9	TRBJ1-2
TGTGCCAGCAGCCCCCCCGTGACGGGACAGAGAACTCCGCCAGCCAAAAACATTCAGTACTTC	CASSPPVTGQRTPPAKNIQYF	TRBV6-1	TRBJ2-4
TGTGCCAGCTCTCTGGGGGGGCCTGATAGCACAGATACGCAGTATTTT	CASSLGGPDSTDTQYF	TRBV18	TRBJ2-3
TGTGCCAGCAGAGGGACGGCCTATGGCTACACCTTC	CASRGTAYGYTF	TRBV6-4	TRBJ1-2
TGTGCCAGCAGTTACTCGACGTTCGTGACAGGTAACCCTGGAAACACCATATATTTT	CASSYSTFVTGNPGNTIYF	TRBV6-3	TRBJ1-3
TGTGCCAGCAGCATTGCCAGGTGTGGCTACACCTTC	CASSIARCGYTF	TRBV6-5	TRBJ1-2
TGTGCCACCAGCAGACTGGGGGGCCCTAGCACAGATACGCAGTATTTT	CATSRLGGPSTDTQYF	TRBV15	TRBJ2-3
TGTGCCAGCAGTTATGGCGGGACTAGCGGGTTAGGTAACGAGCAGTACTTC	CASSYGGTSGLGNEQYF	TRBV6-3	TRBJ2-7
TGTGCCAGGGGATTTCCTAATGAAAAACTGTTTTTT	CARGFPNEKLFF	TRBV2	TRBJ1-4
TGTGCCAGCGGCCTAGCCCGGGACAGGAACACCGGGGAGCTGTTTTTT	CASGLARDRNTGELFF	TRBV7-9	TRBJ2-2
TGTGCCAGCAGTGACCCATCAGAAGTAGTCTACGAGCAGTACTTC	CASSDPSEVVYEQYF	TRBV6-1	TRBJ2-7
TGTGCCAGCAGCTACCCCAGCGACACAGATACGCAGTATTTT	CASSYPSDTDTQYF	TRBV7-9	TRBJ2-3
TGTGCCAGCAGCTGGGAAGACCGCCACCAAGAGACCCAGTACTTC	CASSWEDRHQETQYF	TRBV25-1	TRBJ2-5
TGTGCCAGCACTAGCGGTGGGGTCCTGTTCAGCAGTACGCAGTTCTTC	CASTSGGVLFSSTQFF	TRBV2	TRBJ2-1
TGTGCCAGCAGCCACCCGAATGGGGCGGAAGACCAAGAGACCCAGTACTTC	CASSHPNGAEDQETQYF	TRBV7-2	TRBJ2-5
TGTGCTAGTGGTTTGGTACCCGGAGCAGACCGATATGGCTACACCTTC	CASGLVPGADRYGYTF	TRBV12-5	TRBJ1-2
TGTGCCACCAGTGATTTGCCGTCTCGGGAAGCATATAATGAAAAACTGTTTTTT	CATSDLPSREAYNEKLFF	TRBV24-1	TRBJ1-4
TGTGCCAGCAGCTTTAAGGTATGGGTGGGATTGGATGAAAAACTGTTTTTT	CASSFKVWVGLDEKLFF	TRBV9	TRBJ1-4
TGTGCCAGTAGCGCTAGCGGGAGTAGCACAGATACGCAGTATTTT	CASSASGSSTDTQYF	TRBV19	TRBJ2-3
TGTGCCAGCAGCCACGGGACAGGGGCGGAGACCCAGTACTTC	CASSHGTGAETQYF	TRBV3-1	TRBJ2-5
TGTGCTCGGGGCCTCTTCTTT	CARGLFF	TRBV5-4	TRBJ1-1
TGTGCCAGCAGGTTACGAGGCGGGAGTGTCGATAGCAATCAGCCCCAGCATTTT	CASRLRGGSVDSNQPQHF	TRBV14	TRBJ1-5
TGCGCCAGCAGGAGGCCACGCCAAGAGACCCAGTACTTC	CASRRPRQETQYF	TRBV5-1	TRBJ2-5
TGTGCTAGTGGTTTGGGGACAGGGGGCCTATTATACAATGAGCAGTTCTTC	CASGLGTGGLLYNEQFF	TRBV12-5	TRBJ2-1
TGTGCCAGCAGCCGGGGCGGGGGGGTTAGCGGCTACGAGCAGTACTTC	CASSRGGGVSGYEQYF	TRBV14	TRBJ2-7
TGTGCTAGCAGCTTGGTCCACATCAGGGAAATCCTCTGCCCCTCCTACAATGAGCAGTTCTTC	CASSLVHIREILCPSYNEQFF	TRBV7-7	TRBJ2-1
TGCGCCAGCAGCTTTGGCGGGTACGAGCAGTACTTC	CASSFGGYEQYF	TRBV5-1	TRBJ2-7
TGTGCCAGCAAGAGGGGTACCCCGACGACGAGCTCCTACAATGAGCAGTTCTTC	CASKRGTPTTSSYNEQFF	TRBV6-2	TRBJ2-1
TGCGCCAGCAGTGAGTATAGCGGGCATAGTATTAACACAGATACGCAGTATTTT	CASSEYSGHSINTDTQYF	TRBV10-2	TRBJ2-3
TGTGCCAGCAGCGCAGAAAATCAGCCCCAGCATTTT	CASSAENQPQHF	TRBV9	TRBJ1-5
TGTGCCAGCAGCCCGTTCACAGAACATGAAAAACTGTTTTTT	CASSPFTEHEKLFF	TRBV7-2	TRBJ1-4
TGTGCCAGCAGCCTTCACGGACAGGGGGAGGGCTCCTATAATTCACCCCTCCACTTT	CASSLHGQGEGSYNSPLHF	TRBV7-6	TRBJ1-6
TGCGCCAGCAGCTACAGGGGTGAACGCACAGATACGCAGTATTTT	CASSYRGERTDTQYF	TRBV5-1	TRBJ2-3
TGTGCCTGGAACAGAAAGGTTCCACAGCCCCAGCATTTT	CAWNRKVPQPQHF	TRBV30	TRBJ1-5
TGTGCCAGTAGTCACAACCCCGGGACGTTGCCCCACTCCTACAATGAGCAGTTCTTC	CASSHNPGTLPHSYNEQFF	TRBV19	TRBJ2-1
TGTGCCACCAGCAAAGAGCCCCTAGAAGCATACGAGCAGTACTTC	CATSKEPLEAYEQYF	TRBV15	TRBJ2-7
TGCGCCAGCAGTTACGGGAGCAGTAGGTCTGAGCAGTTCTTC	CASSYGSSRSEQFF	TRBV10-1	TRBJ2-1
TGCAGCGTTGACGCGAGGGCCCCCCCGGCCAAAAACATTCAGTACTTC	CSVDARAPPAKNIQYF	TRBV29-1	TRBJ2-4
TGTGCCAGCAGCCCAGAGTCGGACAGGGGGTTTTCCTACGAGCAGTACTTC	CASSPESDRGFSYEQYF	TRBV9	TRBJ2-7
TGTGCCAGCAGGCACTTGAACGAGCAGTACTTC	CASRHLNEQYF	TRBV5-6	TRBJ2-7
TGTGCCACGGGACAGGGCGATAGCAATCAGCCCCAGCATTTT	CATGQGDSNQPQHF	TRBV24-1	TRBJ1-5
TGTGCCAGCAGAGTGCTTCTGGGACAGGGACAGCCCCAGCATTTT	CASRVLLGQGQPQHF	TRBV25-1	TRBJ1-5
TGCAGTGCTGCCAAACTGGGGGAAGGGAACACTGAAGCTTTCTTT	CSAAKLGEGNTEAFF	TRBV20-1	TRBJ1-1
TGCAGTGCCCGGTTGCAAGGCTACGAGCAGTACTTC	CSARLQGYEQYF	TRBV20-1	TRBJ2-7
TGTGCCAGCAGTTTGGGCTCCACCGGGGAGCTGTTTTTT	CASSLGSTGELFF	TRBV12-3	TRBJ2-2
TGTGCCAGCAGTCCGCTAGAACCTACTAATGAAAAACTGTTTTTT	CASSPLEPTNEKLFF	TRBV12-3	TRBJ1-4
TGTGCCAGCAGCTTTTTAAGACACCAGCCCCAGCATTTT	CASSFLRHQPQHF	TRBV7-4	TRBJ1-5
TGTGCCAGCAGCTCGGGGGCCCAATGCTACGAGCAGTACTTC	CASSSGAQCYEQYF	TRBV5-4	TRBJ2-7
TGTGCCAGCAGCCCTAATTCAGGGCCTGGGGGAAACTACGAGCAGTACTTC	CASSPNSGPGGNYEQYF	TRBV13	TRBJ2-7
TGTGCCAGCAAGGCACGAGATGAGCAGTTCTTC	CASKARDEQFF	TRBV6-1	TRBJ2-1
TGCAGTGCCAGAAGTCGAGGGGAACCGATGAACACTGAAGCTTTCTTT	CSARSRGEPMNTEAFF	TRBV20-1	TRBJ1-1
TGTGCCAGCAGACTCCAAGGACAGATCAAGGGGGGACGAAGGACCTACGAGCAGTACTTC	CASRLQGQIKGGRRTYEQYF	TRBV12-4	TRBJ2-7
TGCAGTGCTAGGACAGGGGGTAGCACAGATACGCAGTATTTT	CSARTGGSTDTQYF	TRBV20-1	TRBJ2-3
TGCAGTGAAGCGGGACTCCCACTTGAGCAGTTCTTC	CSEAGLPLEQFF	TRBV20-1	TRBJ2-1
TGTGCCAGCAGCTTATTGGAGGCGCTGACGTTTTTGACCCAGTACTTC	CASSLLEALTFLTQYF	TRBV7-9	TRBJ2-5
TGTGCCAGCAGCGGTCGTCCGACTAGCAACAATGAGCAGTTCTTC	CASSGRPTSNNEQFF	TRBV9	TRBJ2-1
TGTGCCAGCAGCCGAAGCGGGACCAGCTCTGGGGCCAACGTCCTGACTTTC	CASSRSGTSSGANVLTF	TRBV7-2	TRBJ2-6
TGTGCCATCAGTCTCCTAGCGGGTTGGTATGAGCAGTTCTTC	CAISLLAGWYEQFF	TRBV10-3	TRBJ2-1
TGTGCCAGCAGTTTAGAGCGGGGCTCCTACGAGCAGTACTTC	CASSLERGSYEQYF	TRBV27	TRBJ2-7
TGTGCCAGCAGCGTAGTAGGGGGGGATGGCTACACCTTC	CASSVVGGDGYTF	TRBV9	TRBJ1-2
TGTGCCAGCAGGAACAGACCTTCAGGGGCCCTGAACACTGAAGCTTTCTTT	CASRNRPSGALNTEAFF	TRBV7-3	TRBJ1-1
TGTGCTAGTGTGCAACTAGCGCGAGGCACAGATACGCAGTATTTT	CASVQLARGTDTQYF	TRBV12-5	TRBJ2-3
TGCGCCAGCAGCCAAGGAGGGGGACAGGGCGAAAAACTGTTTTTT	CASSQGGGQGEKLFF	TRBV4-1	TRBJ1-4
TGCAGTGCCGTGAGAAGCTCCTACGAGCAGTACTTC	CSAVRSSYEQYF	TRBV20-1	TRBJ2-7
TGTGCCAGCAGCAAAGGACAGATGAACACTGAAGCTTTCTTT	CASSKGQMNTEAFF	TRBV7-3	TRBJ1-1
TGTGCCAGCAGCAGCGAGCAGTACTTC	CASSSEQYF	TRBV7-3	TRBJ2-7
TGTGCTAGTGGTTTGGTACGAGGCCCAGTAGAGACCCAGTACTTC	CASGLVRGPVETQYF	TRBV12-5	TRBJ2-5
TGTGCCATTTATAGCTGGCCTTGGCAAGAGACCCAGTACTTC	CAIYSWPWQETQYF	TRBV6-1	TRBJ2-5
TGTGCCAGCAGCCAAGATCAGTCTCGGGACACCAATGAAAAACTGTTTTTT	CASSQDQSRDTNEKLFF	TRBV4-2	TRBJ1-4
TGCAGTGCTAGGGGAAACATGGGGGGAGAGAACACCGGGGAGCTGTTTTTT	CSARGNMGGENTGELFF	TRBV20-1	TRBJ2-2
TGCGCCAGCAGCTTGGAACTTGGACAGGGGCGGTCCACTGAAGCTTTCTTT	CASSLELGQGRSTEAFF	TRBV5-1	TRBJ1-1
TGTGCCAGTGCATCCGGGACAGCGGGACCAGATCAGCCCCAGCATTTT	CASASGTAGPDQPQHF	TRBV7-4	TRBJ1-5
TGTGCCAGCAACAGGGCACTATACGAGCAGTACTTC	CASNRALYEQYF	TRBV6-5	TRBJ2-7
TGTGCCAGCAGTGGCGACAGCCTTCGGAGCACCGGGGAGCTGTTTTTT	CASSGDSLRSTGELFF	TRBV6-4	TRBJ2-2
TGCAGCGTTGAGGAAACCAGCTGGGCGCAGTTCTTC	CSVEETSWAQFF	TRBV29-1	TRBJ2-1
TGTGCCACCACAGGGACAGGGAAAGCTGCAGATACGCAGTATTTT	CATTGTGKAADTQYF	TRBV24-1	TRBJ2-3
TGTGCCAGTAGTCCTTCGGTTGGACTAGCGGGTCAATATGATACGCAGTATTTT	CASSPSVGLAGQYDTQYF	TRBV19	TRBJ2-3
TGCAGTGCTGGCAGGGGAGAGACCCAGTACTTC	CSAGRGETQYF	TRBV20-1	TRBJ2-5
TGTGCCACCAGAAATTGGACAGGGTTTTCTTACGAGCAGTACTTC	CATRNWTGFSYEQYF	TRBV24-1	TRBJ2-7
TGTGCCAGCGGGGGGTTATTCGGCTACACCTTC	CASGGLFGYTF	TRBV25-1	TRBJ1-2
TGTGCCAGTAATAGGCTAGCGGGTGGGGGGGCCTACGAGCAGTACTTC	CASNRLAGGGAYEQYF	TRBV19	TRBJ2-7
TGTGCCAGCAGTTGTGACAGGGTCTATGGCTACACCTTC	CASSCDRVYGYTF	TRBV27	TRBJ1-2
TGTGCCAGCAGCAGGGCCCCCAAGGGGGCCCCCCTTTTCGCGAACACCGGGGAGCTGTTTTTT	CASSRAPKGAPLFANTGELFF	TRBV13	TRBJ2-2
TGTGCCAGCAGTTACTCGATCCGATGGCACAGCGGGGCCAACGTCCTGACTTTC	CASSYSIRWHSGANVLTF	TRBV6-5	TRBJ2-6
TGTGCCACCAGCCCTGACAGTCCCGGGTATAGCAATCAGCCCCAGCATTTT	CATSPDSPGYSNQPQHF	TRBV15	TRBJ1-5
TGTGCCAGCAGGGGCGACGAGCAGTACTTC	CASRGDEQYF	TRBV27	TRBJ2-7
TGCGCCAGCAGCCACTCTCGGGACACCGGGGAGCTGTTTTTT	CASSHSRDTGELFF	TRBV5-1	TRBJ2-2
TGTGCCAGCAGCCGCAGGACCCCCCATTCACCCCTCCACTTT	CASSRRTPHSPLHF	TRBV3-1	TRBJ1-6
TGTGCCAGCAGTTTAACTGACAGGCGGGAAGCTTTCTTT	CASSLTDRREAFF	TRBV12-3	TRBJ1-1
TGTGCCATCACGAACAGGGGCTTGAGGGTTTATGCCTCCTACGAGCAGTACTTC	CAITNRGLRVYASYEQYF	TRBV10-3	TRBJ2-7
TGTCTCCAGGGTCAGCCCCAGCATTTT	CLQGQPQHF	TRBV27	TRBJ1-5
TGCGCCAGCAGCCAAGCATCCGGGACAGGAGCGGTCGCGCCGGCCTACGAGCAGTACTTC	CASSQASGTGAVAPAYEQYF	TRBV4-3	TRBJ2-7
TGTGCCAGCAGCGAAGGGGGCTACGAGCAGTACTTC	CASSEGGYEQYF	TRBV13	TRBJ2-7
TGCAGTGCTAGCGAGGGACAGAACTACAATGAGCAGTTCTTC	CSASEGQNYNEQFF	TRBV20-1	TRBJ2-1
TGTGCCAGCAGCGACTGTTCTACCGACAGATCAGGCTACACCTTC	CASSDCSTDRSGYTF	TRBV7-3	TRBJ1-2
TGTGCCACCAGTGACCAGGTCCAAGGGGCTGGCACAGATACGCAGTATTTT	CATSDQVQGAGTDTQYF	TRBV24-1	TRBJ2-3
TGTGCCAGCAGTTTGGGGACTAGCCCCGACAATGAGCAGTTCTTC	CASSLGTSPDNEQFF	TRBV12-4	TRBJ2-1
TGCAGTGCTAGAGAACCGACAGGGCTAGGGTTCCCCGACACTGAAGCTTTCTTT	CSAREPTGLGFPDTEAFF	TRBV20-1	TRBJ1-1
TGTGCCAGCAGTTGGACAGGGATACATGAAAAACTGTTTTTT	CASSWTGIHEKLFF	TRBV6-1	TRBJ1-4
TGTGCCAGCAGTGATACCAACGATACACGACTAGCGGATAGGGTGATCGAGCAGTACTTC	CASSDTNDTRLADRVIEQYF	TRBV6-4	TRBJ2-7
TGTGCCAGCAGCCGGACGAGGGGCGAGCAGTACTTC	CASSRTRGEQYF	TRBV3-1	TRBJ2-7
TGTGCCAGCAGCGGCCCAGGGTACTCCTACGAGCAGTACTTC	CASSGPGYSYEQYF	TRBV13	TRBJ2-7
TGTGCCAGCAGCTTGGCCCGCTTGGTAGGTGAAGCTATATTTGAAGCTTTCTTT	CASSLARLVGEAIFEAFF	TRBV5-6	TRBJ1-1
TGTGCCAGCAGTTACATTTGGGGGGGGGCCTACGAGCAGTACTTC	CASSYIWGGAYEQYF	TRBV6-5	TRBJ2-7
TGTGCCAGCAGCTTGAAGTTTACCTGGACAGACGGTTGGACCCAGTACTTC	CASSLKFTWTDGWTQYF	TRBV5-4	TRBJ2-5
TGTGCCTGGAGTAGGTTGGATCAGCCCCAGCATTTT	CAWSRLDQPQHF	TRBV30	TRBJ1-5
TGTGCCAGCTCAGGGGAGGGGGAGACGAACACTGAAGCTTTCTTT	CASSGEGETNTEAFF	TRBV5-4	TRBJ1-1
TGTGCCAGCAGCGTAGTTGGGACAGGGGGAAACTATGGCTACACCTTC	CASSVVGTGGNYGYTF	TRBV9	TRBJ1-2
TGTGCCAGCTCACCAGGGGCCCGGAATCAGCCCCAGCATTTT	CASSPGARNQPQHF	TRBV18	TRBJ1-5
TGCAGTGCACAGCTCTGCTACACTGAAGCTTTCTTT	CSAQLCYTEAFF	TRBV20-1	TRBJ1-1
TGTGCCAGCAGTTACACTTCGATCCCAAGTAGATGTCCAGATACGCAGTATTTT	CASSYTSIPSRCPDTQYF	TRBV6-5	TRBJ2-3
TGCGCCTCCGGGACTAAGGACGAGCAGTACTTC	CASGTKDEQYF	TRBV10-1	TRBJ2-7
TGTGCCAGCAGCGTGGGGGAGGATACGCAGTATTTT	CASSVGEDTQYF	TRBV11-2	TRBJ2-3
TGTGCCAGCAGCTTAGGGAAGGAGACCCAGTACTTC	CASSLGKETQYF	TRBV7-4	TRBJ2-5
TGTGCCAGCAGTGAAGATCATCCAGGGTTATTAGTTAGCTCCTACAATGAGCAGTTCTTC	CASSEDHPGLLVSSYNEQFF	TRBV2	TRBJ2-1
TGCGCCAGCAGCTTGGGTTGGACAGGGAGCGGCTACACCTTC	CASSLGWTGSGYTF	TRBV5-1	TRBJ1-2
TGTGCCATCAGTCCAGCTACCGGGGGAGGCTACACCTTC	CAISPATGGGYTF	TRBV10-3	TRBJ1-2
TGTGCCAGCAGTTCCCCACACAAAAGGCCGGAGCCAGATACGCAGTATTTT	CASSSPHKRPEPDTQYF	TRBV12-4	TRBJ2-3
TGTGCCAGCAACACCGTCGCCGGGACAGGGGGAATTTTCTACGAGCAGTACTTC	CASNTVAGTGGIFYEQYF	TRBV12-3	TRBJ2-7
TGTGCCAGCAGCTTGGTTGCCTATTGGGACAGAATCGGGGAGCTGTTTTTT	CASSLVAYWDRIGELFF	TRBV5-5	TRBJ2-2
TGCGCCAGCAGCTTGAGGGGGGTCCCCTACGAGCAGTACTTC	CASSLRGVPYEQYF	TRBV5-1	TRBJ2-7
TGTGCCAGCAGGACAGGGCAGGGCGTTCGTTACGAGCAGTACTTC	CASRTGQGVRYEQYF	TRBV6-5	TRBJ2-7
TGTGCCAGCAGTGAAGCAGGTAGTCAGGGGGCAGGTGAAAAACTGTTTTTT	CASSEAGSQGAGEKLFF	TRBV6-1	TRBJ1-4
TGCAGTGCTAGAGTACCGCCAGGTGCCTACAATGAGCAGTTCTTC	CSARVPPGAYNEQFF	TRBV20-1	TRBJ2-1
TGTGCCAGCAGCGTAGCTGGCCAAGGGGGATATCAGCCCCAGCATTTT	CASSVAGQGGYQPQHF	TRBV9	TRBJ1-5
TGTGCCAGCATCGAGAACTATGGCTACACCTTC	CASIENYGYTF	TRBV6-5	TRBJ1-2
TGTGCCAGCAGCGGGGGGGGGCCTGCCAATGAGCAGTTCTTC	CASSGGGPANEQFF	TRBV7-3	TRBJ2-1
TGTGCCAGCAGCTTAGCCCGGGAGGGTACAAGGTACTTC	CASSLAREGTRYF	TRBV11-3	TRBJ2-7
TGTGCCAGCAGGGCCAGCTCTGGGGCCAACGTCCTGACTTTC	CASRASSGANVLTF	TRBV3-1	TRBJ2-6
TGTGCCAGCAGACTCCAGCAGGGTCCTGGGGCTTTCTTT	CASRLQQGPGAFF	TRBV3-1	TRBJ1-1
TGTGCCAGGGTGACCAACACCACTCACAGGGTAGCCAAAAACATTCAGTACTTC	CARVTNTTHRVAKNIQYF	TRBV6-6	TRBJ2-4
TGTGCCAGCAGCTTAGCACAGGGGGCGGAAGTTGGCTACACCTTC	CASSLAQGAEVGYTF	TRBV7-2	TRBJ1-2
TGTGCCAGCAGCTTGATAGTCAACACTAGCTCTATCGCCTACAATGAGCAGTTCTTC	CASSLIVNTSSIAYNEQFF	TRBV11-2	TRBJ2-1
TGTGCCAGCAGCACCGGGACAGAGGCTGAAGCTTTCTTT	CASSTGTEAEAFF	TRBV13	TRBJ1-1
TGTGCCAGCAACAATCCTCTCCCGTCTAATGAAAAACTGTTTTTT	CASNNPLPSNEKLFF	TRBV6-5	TRBJ1-4
TGTGCCAGCAGTGACCTCCTAGCGGGGGGCGATAGCTCCTACGAGCAGTACTTC	CASSDLLAGGDSSYEQYF	TRBV25-1	TRBJ2-7
TGCAGCGTTGAACTTCAGGGGAGGGACACCGGGGAGCTGTTTTTT	CSVELQGRDTGELFF	TRBV29-1	TRBJ2-2
TGTGCCAAGGTAGCGGGAAGAGGCAACGATGAGCAGTTCTTC	CAKVAGRGNDEQFF	TRBV10-3	TRBJ2-1
TGTGCCAGCAGCCAAGATGGTAAACATGGCCGGGACGGGGTCAAAAACATTCAGTACTTC	CASSQDGKHGRDGVKNIQYF	TRBV3-1	TRBJ2-4
TGTGCCAGCAGTGGGTCCGGGAGGGCCCTGGGTCAAGATACGCAGTATTTT	CASSGSGRALGQDTQYF	TRBV27	TRBJ2-3
TGTGCCAGCAGCTGGGGGCGCGGGGGCTATGGCTACACCTTC	CASSWGRGGYGYTF	TRBV7-4	TRBJ1-2
TGTGCCAGTAGTATAGGAGGGGGACAGTACGTGGTAGGTAGGGGGGCCAACGTCCTGACTTTC	CASSIGGGQYVVGRGANVLTF	TRBV19	TRBJ2-6
TGTGCCAGCTCACCACTGCCAGGGGCGCAGTACTTC	CASSPLPGAQYF	TRBV18	TRBJ2-7
TGTGCCAGCAGCAAGGGTAAGGGTAACTACGAGCAGTACTTC	CASSKGKGNYEQYF	TRBV13	TRBJ2-7
TGTGCTAGTGGTTTGGGATGTCCTACGAGCAATGAGCAGTTCTTC	CASGLGCPTSNEQFF	TRBV12-5	TRBJ2-1
TGTGCCAGCAGCTTGATGTTAAAGTTGACAGGGGCGGGCGGGAGCCAAGAGACCCAGTACTTC	CASSLMLKLTGAGGSQETQYF	TRBV7-8	TRBJ2-5
TGTGCCAGCAGCTCTTTAGGGGAGGACAGGCATGGCTACACCTTC	CASSSLGEDRHGYTF	TRBV7-8	TRBJ1-2
TGTGCCTGGCGATGGGAGGGATTTGCGTACGAGCAGTACTTC	CAWRWEGFAYEQYF	TRBV30	TRBJ2-7
TGTGCCAGTAGGGACTTCACGAGGGGGGGGGACGAGCAGTACTTC	CASRDFTRGGDEQYF	TRBV19	TRBJ2-7
TGTGCCAGCAGCCTGGGGTTGGCTTTGAGGAACACTGAAGCTTTCTTT	CASSLGLALRNTEAFF	TRBV2	TRBJ1-1
TGTGCCAGCAGTGGCGGGGTAAAGATCTATGGCTACACCTTC	CASSGGVKIYGYTF	TRBV28	TRBJ1-2
TGCAGTGCCCCAGGGGTACAAGCTTTCTTT	CSAPGVQAFF	TRBV20-1	TRBJ1-1
TGCGCCAGCAGTGAGTTTTCCCCTGCGGAAGGGGAAGGACAGGCCTCAGGGGACGAGCAGTACTTC	CASSEFSPAEGEGQASGDEQYF	TRBV10-1	TRBJ2-7
TGTGCCAGCAGGGACAGATACGAGCAGTACTTC	CASRDRYEQYF	TRBV9	TRBJ2-7
TGCGCCAGCCCTCTCCATTTTCCCGACCGAGGAGACGAGCAGTACTTC	CASPLHFPDRGDEQYF	TRBV10-2	TRBJ2-7
TGTGCCAGCAGTGAAAGAAAGGGTACAAACGGGACAGATAGCAATCAGCCCCAGCATTTT	CASSERKGTNGTDSNQPQHF	TRBV25-1	TRBJ1-5
TGTGCCAGCAGTGACTCGGGGGGGCACCCAGGCGAGCAGTACTTC	CASSDSGGHPGEQYF	TRBV6-4	TRBJ2-7
TGCAGTGCTAGAGATAGAATAGTGACAGGGAAGATCTCCTACGAGCAGTACTTC	CSARDRIVTGKISYEQYF	TRBV20-1	TRBJ2-7
TGTGCCAGCAGAGATCACCTAAAGCCGCATAGCAATCAGCCCCAGCATTTT	CASRDHLKPHSNQPQHF	TRBV27	TRBJ1-5
TGTGCCAGCAGTTTGACAGGGGTGAACACTGAAGCTTTCTTT	CASSLTGVNTEAFF	TRBV6-5	TRBJ1-1
TGTGCCAGCAGCTGGCCGGGACAGAGGGAAAAACTGTTTTTT	CASSWPGQREKLFF	TRBV7-9	TRBJ1-4
TGTGCCATCTACCGACTAGCGGAGACCCAGTACTTC	CAIYRLAETQYF	TRBV10-3	TRBJ2-5
TGCGCCAGCAGCTCAGAAAGGGAGGCTCAGCCCCAGCATTTT	CASSSEREAQPQHF	TRBV5-1	TRBJ1-5
TGTGCCAGCAGCCAAGATGTCTCAACCGGTAGCACGTCCTACAATGAGCAGTTCTTC	CASSQDVSTGSTSYNEQFF	TRBV3-1	TRBJ2-1
TGTGCCAGCAAGGGGGGGGCCACAGGCAATGAGCAGTTCTTC	CASKGGATGNEQFF	TRBV5-4	TRBJ2-1
TGTGCCAGCTCACCACCTTGCTCAGGGCGAGCTCAGCCCCAGCATTTT	CASSPPCSGRAQPQHF	TRBV18	TRBJ1-5
TGCAGTGCACGACTAGCGGGACGGAAGCATTTCAGCACAGATACGCAGTATTTT	CSARLAGRKHFSTDTQYF	TRBV20-1	TRBJ2-3
TGTGCCAGCAGCGATAATGAAGGGGCTGATAACTATGGCTACACCTTC	CASSDNEGADNYGYTF	TRBV7-3	TRBJ1-2
TGTGCCAGCAGACGCGGGATTAATGGCTACACCTTC	CASRRGINGYTF	TRBV6-1	TRBJ1-2
TGCAGTGCTAGAAGGGGGGGGGGAGGAAACACCATATATTTT	CSARRGGGGNTIYF	TRBV20-1	TRBJ1-3
TGTGCCAGCAGCCTTGGGGGGGGGGGTAGGACAGATACGCAGTATTTT	CASSLGGGGRTDTQYF	TRBV11-3	TRBJ2-3
TGTGCCAGCAGTGACTCGAAAGTAGGGAACACTGAAGCTTTCTTT	CASSDSKVGNTEAFF	TRBV6-4	TRBJ1-1
TGCAGTGCTAGAGAGGTGGCGAGCGGAGAAACTTTTCTAAAAAACATTCAGTACTTC	CSAREVASGETFLKNIQYF	TRBV20-1	TRBJ2-4
TGTGCCAGCAGCTCCCCCGCCCGGGGGGACTATGGCTACACCTTC	CASSSPARGDYGYTF	TRBV13	TRBJ1-2
TGTGCCCACGGCAGGGTCTACGAGCAGTACTTC	CAHGRVYEQYF	TRBV12-3	TRBJ2-7
TGTGCCCGCGACAGGTATGGCTACACCTTC	CARDRYGYTF	TRBV28	TRBJ1-2
TGTGCCAGCTCCCAGGGGGCTGAAAAACTGTTTTTT	CASSQGAEKLFF	TRBV2	TRBJ1-4
TGCAGCGCACCAGGGGAATCAGAGACCCAGTACTTC	CSAPGESETQYF	TRBV29-1	TRBJ2-5
TGTGCCAGCAGCCCGGGATCCGGCTACACCTTC	CASSPGSGYTF	TRBV27	TRBJ1-2
TGTGCCAGCAGCCGTGACAGCCTTTATAGCAATCAGCCCCAGCATTTT	CASSRDSLYSNQPQHF	TRBV13	TRBJ1-5
TGTGCCAGCAGCTTAGCAGGGATGCAGAGCTCTGGAAACACCATATATTTT	CASSLAGMQSSGNTIYF	TRBV11-2	TRBJ1-3
