TGTGCCAGCAGCTTAACTCAGTCAAGAGGGGAGCAGTTCTTC	CASSLTQSRGEQFF	TRBV7-8	TRBJ2-1
TGTGCCAGCAGCCAAGATGCCTGTGGGGCCCTTAATGAGCAGTTCTTC	CASSQDACGALNEQFF	TRBV4-2	TRBJ2-1
TGTGCCAGCAGCGTGAGGGGGGGCGATGAGACCGGGGAGCTGTTTTTT	CASSVRGGDETGELFF	TRBV9	TRBJ2-2
TGTGCCAGCAGTGGGCTTTTGCGGTGTGGGGAGCTGTTTTTT	CASSGLLRCGELFF	TRBV6-4	TRBJ2-2
TGTGCCGCCCCGACAGGGGGCGGGGGAAACACTGAAGCTTTCTTT	CAAPTGGGGNTEAFF	TRBV12-3	TRBJ1-1
TGTGCCGACATCTTTTACGAGCAGTACTTC	CADIFYEQYF	TRBV10-3	TRBJ2-7
TGTGCCAGCTCACCTCCCCGGGACAGGGGCGCGAGCAATCAGCCCCAGCATTTT	CASSPPRDRGASNQPQHF	TRBV18	TRBJ1-5
TGTGCCAGCAGCTTCCAGGGGGATGAAAAACTGTTTTTT	CASSFQGDEKLFF	TRBV7-2	TRBJ1-4
TGTGCCAGCAGTGGGGTGGATCTCCACTACGAGCAGTACTTC	CASSGVDLHYEQYF	TRBV12-4	TRBJ2-7
TGTGCCAGCAGTGACTGGGCTCATATCAAGACCCAGTACTTC	CASSDWAHIKTQYF	TRBV6-4	TRBJ2-5
TGTGCCTGGAGTGTAACTAGGGCGAGGGGGGGTTCCTCCTACGAGCAGTACTTC	CAWSVTRARGGSSYEQYF	TRBV30	TRBJ2-7
TGTGCCAGCAGCCCAGGGGTCGCCTACGAGCAGTACTTC	CASSPGVAYEQYF	TRBV4-2	TRBJ2-7
TGTGCCTGGAGTCCGGGTTTGGGGTTCCCGCGTCTGAACACTGAAGCTTTCTTT	CAWSPGLGFPRLNTEAFF	TRBV30	TRBJ1-1
TGCAGCGTTGATGGGGGGGGTAATTCACCCCTCCACTTT	CSVDGGGNSPLHF	TRBV29-1	TRBJ1-6
TGTGCCAGCAGAGTTGGGACGTACAATGAGCAGTTCTTC	CASRVGTYNEQFF	TRBV7-9	TRBJ2-1
TGCAGTGCCTGGGACAGGGGGCCTTTTTACTGGCCCCAGCATTTT	CSAWDRGPFYWPQHF	TRBV20-1	TRBJ1-5
TGTGCCAGCAGTAGAGGGGGCTACGAGCAGTACTTC	CASSRGGYEQYF	TRBV2	TRBJ2-7
TGTGCCAGCAGCTTGGAAGTATCGGGGAGAGACAATGAGCAGTTCTTC	CASSLEVSGRDNEQFF	TRBV7-7	TRBJ2-1
TGTGCCAGCAGTCTGTCGGGACTAGCGGGGCTTTGCACAGATACGCAGTATTTT	CASSLSGLAGLCTDTQYF	TRBV6-6	TRBJ2-3
TGTGCCAGCAGCTTAGGGTCCGGACTGGGCACCGGGGAGCTGTTTTTT	CASSLGSGLGTGELFF	TRBV7-6	TRBJ2-2
TGTGCCAGCAGTGAAGGGGGGGCGCAGTATTTT	CASSEGGAQYF	TRBV6-1	TRBJ2-3
TGTGCCAGCAGCCCCGACAGAGTCGCGCATAATGAAAAACTGTTTTTT	CASSPDRVAHNEKLFF	TRBV5-6	TRBJ1-4
TGCGCCAGCAAAGGGGGGGACGAGCAGTACTTC	CASKGGDEQYF	TRBV10-1	TRBJ2-7
TGTGCCACCAGTGGCCTCGGGGGGGGGTACAATCAGCCCCAGCATTTT	CATSGLGGGYNQPQHF	TRBV24-1	TRBJ1-5
TGTGCCAGCAGTTATTTCCGATTCAATGAGCAGTTCTTC	CASSYFRFNEQFF	TRBV6-8	TRBJ2-1
TGTGCCAGCAGTTTAGGGGGCAATCAGCCCCAGCATTTT	CASSLGGNQPQHF	TRBV27	TRBJ1-5
TGTGCCAGCAGCCCACGTCTGTACACTGAAGCTTTCTTT	CASSPRLYTEAFF	TRBV9	TRBJ1-1
TGTGCCAGCAGCCAATGTACCCCGGGACAGCCCAGCAATCAGCCCCAGCATTTT	CASSQCTPGQPSNQPQHF	TRBV3-1	TRBJ1-5
TGTGCCACCAGTGATGGGAGAGGGACAGGAATACCCGGGGAGCTGTTTTTT	CATSDGRGTGIPGELFF	TRBV24-1	TRBJ2-2
TGTGCCAGCAGCCCGCACTCCCGCAGCTTGAGCTCCTACGAGCAGTACTTC	CASSPHSRSLSSYEQYF	TRBV11-2	TRBJ2-7
TGTGCCAGATGGCCGTTGTACAATGAGCAGTTCTTC	CARWPLYNEQFF	TRBV7-9	TRBJ2-1
TGTGCCAGCAGTTCTAGGACAGGCGGGGACACTGAAGCTTTCTTT	CASSSRTGGDTEAFF	TRBV6-5	TRBJ1-1
TGTGCCAGCAGTAGAAGGGTTTTCTACGAGCAGTACTTC	CASSRRVFYEQYF	TRBV6-3	TRBJ2-7
TGTGCCAAGAGTTCCAGGGGGGGGGGAAACACCATATATTTT	CAKSSRGGGNTIYF	TRBV12-4	TRBJ1-3
TGTGCCAGTAGTAACCTAGCGGTGGCCAAAAACATTCAGTACTTC	CASSNLAVAKNIQYF	TRBV19	TRBJ2-4
TGCGCCAGCAGCTTGGTATGGGGATTTCATAGCAATCAGCCCCAGCATTTT	CASSLVWGFHSNQPQHF	TRBV5-1	TRBJ1-5
TGCAGTGCACCCCGCGTGGCTAACTATGGCTACACCTTC	CSAPRVANYGYTF	TRBV20-1	TRBJ1-2
TGTGCCAGCAGTTTCAGTGGACGGGCAGTGAATGAAAAACTGTTTTTT	CASSFSGRAVNEKLFF	TRBV12-3	TRBJ1-4
TGCAAACAGGGGGCGCGGGGCTCTGGAAACACCATATATTTT	CKQGARGSGNTIYF	TRBV29-1	TRBJ1-3
TGTGCCATCACCTTAGCCGGGACTAGGGGGGGGAAAGAGACCCAGTACTTC	CAITLAGTRGGKETQYF	TRBV10-3	TRBJ2-5
TGCGCCAGCAGCTTGGACAGGGGGCACCAGGGGGGGTCTAGCTCCTACGAGCAGTACTTC	CASSLDRGHQGGSSSYEQYF	TRBV5-1	TRBJ2-7
TGTGCCAGCAGCCCTCCGATCCCCGGGACAGTTCAGCCCCAGCATTTT	CASSPPIPGTVQPQHF	TRBV9	TRBJ1-5
TGTGCCAGCAGGAGAATGACTAGCGGAGGCTCCGGGGAGCTGTTTTTT	CASRRMTSGGSGELFF	TRBV27	TRBJ2-2
TGCAGTGCTCCCGGTGACTTGAACACTGAAGCTTTCTTT	CSAPGDLNTEAFF	TRBV20-1	TRBJ1-1
TGTGCCAGCAGCCTTCATACGAGGGACGTGAACACTGAAGCTTTCTTT	CASSLHTRDVNTEAFF	TRBV13	TRBJ1-1
TGTGCCAGCAGCTTGCCTCCGGGACTCGGTGGAAACACCATATATTTT	CASSLPPGLGGNTIYF	TRBV7-2	TRBJ1-3
TGTGCCAGCAGCTTGTGCGCCACAAGGGGGAGTAGCAATCAGCCCCAGCATTTT	CASSLCATRGSSNQPQHF	TRBV7-3	TRBJ1-5
TGTGCCATCAGTGACCTCCAGGAGGAGGTATCCTACAATGAGCAGTTCTTC	CAISDLQEEVSYNEQFF	TRBV10-3	TRBJ2-1
TGTGCCAGCAGCCAAGATCCCCTCACGGAGCAGTATTTT	CASSQDPLTEQYF	TRBV3-1	TRBJ2-3
TGCAGTGCTAGAGATTGGCAGGTTTTGCAGCAGTACTTC	CSARDWQVLQQYF	TRBV20-1	TRBJ2-7
TGCGCCAGCAGTGAGCCGGGACTATACGAGCAGTACTTC	CASSEPGLYEQYF	TRBV10-1	TRBJ2-7
TGTGCCAGCAGCTTTCCCCGACAGGGGACCACAGATACGCAGTATTTT	CASSFPRQGTTDTQYF	TRBV5-8	TRBJ2-3
TGCAGTGCTAGCCCCACTAGCGGATACAATGAGCAGTTCTTC	CSASPTSGYNEQFF	TRBV20-1	TRBJ2-1
TGTGCCGCATCCAGCGGCGGGTCCTACGAGCAGTACTTC	CAASSGGSYEQYF	TRBV27	TRBJ2-7
TGCGCCAGCAGTCGGTGTACGGCGGCCAAAAACATTCAGTACTTC	CASSRCTAAKNIQYF	TRBV10-1	TRBJ2-4
TGCGCCAGCAGCGGGACAGGGGAGAATGGCTACACCTTC	CASSGTGENGYTF	TRBV5-1	TRBJ1-2
TGCAGCGAAGAAGACAGCTGGGACGAGCAGTACTTC	CSEEDSWDEQYF	TRBV29-1	TRBJ2-7
TGTGCCAGCAGCGTAGCTTTTGTCACAGGGGGCGCGGCTAAAACAGATACGCAGTATTTT	CASSVAFVTGGAAKTDTQYF	TRBV9	TRBJ2-3
TGTGCCAGCAGCCACAGCGGGAAGAAAAGCTCCTACGAGCAGTACTTC	CASSHSGKKSSYEQYF	TRBV5-6	TRBJ2-7
TGTGCCAGCAGCAAAACGCCGCCAGATACGCAGTATTTT	CASSKTPPDTQYF	TRBV14	TRBJ2-3
TGTGCCAGCAGTTATCGGACAGGTCGGGGGACCCAGTACTTC	CASSYRTGRGTQYF	TRBV6-2	TRBJ2-5
TGTGCCACCAGTGATTTTTCGGGACTAGCGGGCCAAGAGACCCAGTACTTC	CATSDFSGLAGQETQYF	TRBV24-1	TRBJ2-5
TGTGCCAGCAGTTACTCGGCTGGGGGGGGGATAGGGAGTCAGGACAGTGAGCAGTTCTTC	CASSYSAGGGIGSQDSEQFF	TRBV6-5	TRBJ2-1
TGTGCCAGCAGTTTAAGGGGACAGGAAGAGACCCAGTACTTC	CASSLRGQEETQYF	TRBV12-3	TRBJ2-5
TGTGCCAGCTCGTTATCTAGTCCCGTCGCTCCCGCTCCGCCCCAGCATTTT	CASSLSSPVAPAPPQHF	TRBV18	TRBJ1-5
TGTGCCAGCAGCCCCAGCGGGATAAATGAGCAGTTCTTC	CASSPSGINEQFF	TRBV7-2	TRBJ2-1
TGTGCCAGCAGCTGTCGGGATAACTATGGCTACACCTTC	CASSCRDNYGYTF	TRBV7-9	TRBJ1-2
TGTGCCAGCAGTGAATACAGGGTGACTAGGAACACCGGGGAGCTGTTTTTT	CASSEYRVTRNTGELFF	TRBV25-1	TRBJ2-2
TGTGCCACCAACCGGGACAGGGATAATGAAAAACTGTTTTTT	CATNRDRDNEKLFF	TRBV24-1	TRBJ1-4
TGTGCCAGCAGCAAGGGGAAATCGAGTTCAACAGATACGCAGTATTTT	CASSKGKSSSTDTQYF	TRBV7-6	TRBJ2-3
TGTGCCAGCTCACCCCCTAAGGACCCGGGACAGGGGCAGGCAACTGAAAAACTGTTTTTT	CASSPPKDPGQGQATEKLFF	TRBV18	TRBJ1-4
TGCAGTGCTAGAGGGCGACAGGGGAATGGTAACTATGGCTACACCTTC	CSARGRQGNGNYGYTF	TRBV20-1	TRBJ1-2
TGTGCCAGCAACAGGGGGGGTGGGGATCCTGGGGCCAACGTCCTGACTTTC	CASNRGGGDPGANVLTF	TRBV3-1	TRBJ2-6
TGTGCCAGCAGTTTCCCTAGATGGAGGGAGGACTATGGCTACACCTTC	CASSFPRWREDYGYTF	TRBV27	TRBJ1-2
TGTGCCAGCAGCTTACAACAGGGCTATGGCTACACCTTC	CASSLQQGYGYTF	TRBV11-3	TRBJ1-2
TGTGCCAGCAGCGGGGGGGGGCCCTACGAGCAGTACTTC	CASSGGGPYEQYF	TRBV11-3	TRBJ2-7
TGTGCCCCACGGCGAGACGAGCAGTACTTC	CAPRRDEQYF	TRBV14	TRBJ2-7
TGTGCCAGCAGCCAATTCAGGAGATTCTTGGGGGCCAACGTCCTGACTTTC	CASSQFRRFLGANVLTF	TRBV14	TRBJ2-6
TGTGCCAGCAGCTTGGAGGGCCCTCGACATTCACCCCTCCACTTT	CASSLEGPRHSPLHF	TRBV5-6	TRBJ1-6
TGCGCCAGCTCCCCCCCGGGCCTAAGGGGGCGGGGGGGCTACACCTTC	CASSPPGLRGRGGYTF	TRBV10-2	TRBJ1-2
TGTGCCAGCCCGACTAGCGGGCTCCAAGAGACCCAGTACTTC	CASPTSGLQETQYF	TRBV6-4	TRBJ2-5
TGTGCCAGTAACGGGTCGGAGGAGGACTGGGTTGGTTACGAGCAGTACTTC	CASNGSEEDWVGYEQYF	TRBV19	TRBJ2-7
TGTGCCAGCAGCAATGGGGGCTACAATGAGCAGTTCTTC	CASSNGGYNEQFF	TRBV7-9	TRBJ2-1
TGTGCCAGCAGTGAGGCTAGACAGGGGGCTCCGTATGGCTACACCTTC	CASSEARQGAPYGYTF	TRBV2	TRBJ1-2
TGTGCCAGCAGTGAGGCGGACAGCTTCCGCTATGGCTACACCTTC	CASSEADSFRYGYTF	TRBV28	TRBJ1-2
TGTGCCAGCAGCTGCCCCAGGGGACGGAAGCAGTACTTC	CASSCPRGRKQYF	TRBV5-6	TRBJ2-7
TGTGCCAGCAGCCAAGATTCGGGCGCAGACTCCTATAATTCACCCCTCCACTTT	CASSQDSGADSYNSPLHF	TRBV4-2	TRBJ1-6
TGTGCCAGCAGCTTAGTGGCGTTTTCGGAGAGCACCGGGGAGCTGTTTTTT	CASSLVAFSESTGELFF	TRBV7-2	TRBJ2-2
TGTGCCAGTCCCAGGGGTAACATGAACACTGAAGCTTTCTTT	CASPRGNMNTEAFF	TRBV6-5	TRBJ1-1
TGTGGGAAAGGGACAAGGGACGAGCAGTACTTC	CGKGTRDEQYF	TRBV6-5	TRBJ2-7
TGTGCCAGTAGTATGGGAGGGGCCGTCATGTCCCGCCCGGACCAAGAGACCCAGTACTTC	CASSMGGAVMSRPDQETQYF	TRBV19	TRBJ2-5
TGTGCCAGCAGTGAAAGGGACAGGGGTCTCTACGAGCAGTACTTC	CASSERDRGLYEQYF	TRBV6-4	TRBJ2-7
TGTGCCAGCAGCTTAGTCCGCTTTGGGCGATTGCAAGAGACCCAGTACTTC	CASSLVRFGRLQETQYF	TRBV7-9	TRBJ2-5
TGTGGGGAGGGAACCAGCAATCAGCCCCAGCATTTT	CGEGTSNQPQHF	TRBV20-1	TRBJ1-5
TGTGCCGGATATGCAGAGGGTGCCTACGAGCAGTACTTC	CAGYAEGAYEQYF	TRBV27	TRBJ2-7
TGTGCCAGCTTACAGGGACCGACGCTCACAGATACGCAGTATTTT	CASLQGPTLTDTQYF	TRBV9	TRBJ2-3
TGCGCCAGCAGGTTCTATTTATGGAATCAGCCCCAGCATTTT	CASRFYLWNQPQHF	TRBV5-1	TRBJ1-5
TGCGCCAGCAGGTGGCACAGGGGCCGGGTAAAGGGGGTAGGGGGCGACTATGGCTACACCTTC	CASRWHRGRVKGVGGDYGYTF	TRBV10-1	TRBJ1-2
TGCAGTGCTAGAGATTATGGCAGAGAGACCCAGTACTTC	CSARDYGRETQYF	TRBV20-1	TRBJ2-5
TGTGCCAACGGTCCGCTCGTGGTTGGAGGCTACACCTTC	CANGPLVVGGYTF	TRBV6-5	TRBJ1-2
TGTGCCCGTGGGCTAGCGGGCAGTTACGAGCAGTACTTC	CARGLAGSYEQYF	TRBV9	TRBJ2-7
TGCGCCAGCAGCCACCGGCGGGGACCGATCAATGAGCAGTTCTTC	CASSHRRGPINEQFF	TRBV4-3	TRBJ2-1
TGTGCCAGCAGCGGCGGGGAAGGAGGAACTGAAGCTTTCTTT	CASSGGEGGTEAFF	TRBV7-9	TRBJ1-1
TGTGCCAGCAGCGGGGGACTGAACACTGAAGCTTTCTTT	CASSGGLNTEAFF	TRBV5-6	TRBJ1-1
TGTGCCAGCAGTTCACAGGGAACCGAGCAGTACTTC	CASSSQGTEQYF	TRBV12-3	TRBJ2-7
TGTGCCAGCAGCATATCGGACCGGGACATAGGAGGAGGGTACGAGCAGTACTTC	CASSISDRDIGGGYEQYF	TRBV13	TRBJ2-7
TGTGCCAGCAGTAGGTTCTCCAGAGCGCACAATCAGCCCCAGCATTTT	CASSRFSRAHNQPQHF	TRBV6-5	TRBJ1-5
TGTGCTAGCTCCAGGGGGAGCCAAGAGACCCAGTACTTC	CASSRGSQETQYF	TRBV7-7	TRBJ2-5
TGTGCCAGCAGCCTGAGTTATGAGCAGTTCTTC	CASSLSYEQFF	TRBV5-6	TRBJ2-1
TGCGCCAGCAGCTCGGGGGTGGGACCTACAGGGACTGAAGCTTTCTTT	CASSSGVGPTGTEAFF	TRBV5-1	TRBJ1-1
TGTGCCAGACAGGGGTGGTGGCGCACAGATACGCAGTATTTT	CARQGWWRTDTQYF	TRBV6-5	TRBJ2-3
TGTGCCAGCAGCCAAGTGGGGGGGGGGGATAATGAAAAACTGTTTTTT	CASSQVGGGDNEKLFF	TRBV13	TRBJ1-4
TGTGCCAGCAGCTTACTAGGGGACAGGGTTGTGGGTGTTTTCATGTGGGGGCATGGCTACGAGCAGTACTTC	CASSLLGDRVVGVFMWGHGYEQYF	TRBV11-3	TRBJ2-7
TGCGCCAGCAGCCTGCACAGGTGGAACATACCTGAAAAACTGTTTTTT	CASSLHRWNIPEKLFF	TRBV5-1	TRBJ1-4
TGTGCCAGCAGTCGGATGGGACAGGGGTGGGTAGTTTCCTCCTTGAACACCGGGGAGCTGTTTTTT	CASSRMGQGWVVSSLNTGELFF	TRBV27	TRBJ2-2
TGTGCCAGCAGTTCCCCTCAAGAGACCCAGTACTTC	CASSSPQETQYF	TRBV6-5	TRBJ2-5
TGTGCCAGCAGCGGCGGACACCTGTACGAGCAGTACTTC	CASSGGHLYEQYF	TRBV7-3	TRBJ2-7
TGTGCCACCAGTGATAGGGGAGGGGGGAAGAGCGATAGCAATCAGCCCCAGCATTTT	CATSDRGGGKSDSNQPQHF	TRBV24-1	TRBJ1-5
TGTGCCAGCAGGGACGGGAACACTGAAGCTTTCTTT	CASRDGNTEAFF	TRBV28	TRBJ1-1
TGTGCCAGCATACACAGGGGGCGGGGCTACGAGCAGTACTTC	CASIHRGRGYEQYF	TRBV12-4	TRBJ2-7
TGTGCCAGCAGCTTAGCGGACGAGCAGTACTTC	CASSLADEQYF	TRBV7-9	TRBJ2-7
TGCAGCGTGACGTTAGTCTGCTACGAGCAGTACTTC	CSVTLVCYEQYF	TRBV29-1	TRBJ2-7
TGTGCCAGCAGTCGAATCAGAGGGGGGAAAAACATTCAGTACTTC	CASSRIRGGKNIQYF	TRBV6-5	TRBJ2-4
TGTGCCAGCAGCCAAGATTTAGTGATTACTGACTACAACAATGAGCAGTTCTTC	CASSQDLVITDYNNEQFF	TRBV4-2	TRBJ2-1
TGTGCCAGCAGCGGGGAGGATAGCAATCAGCCCCAGCATTTT	CASSGEDSNQPQHF	TRBV9	TRBJ1-5
TGTGCCAGCAGCCAAGATACGGGGGTCATCCACACCGGGGAGCTGTTTTTT	CASSQDTGVIHTGELFF	TRBV14	TRBJ2-2
TGTGCCAGCAGCTGCCCGGACAGGGGGTGTTTAAATCCCCAGCATTTT	CASSCPDRGCLNPQHF	TRBV5-4	TRBJ1-5
TGTGCCAGCAGCGGTAGAGGGTACATTCAGTACTTC	CASSGRGYIQYF	TRBV7-3	TRBJ2-4
TGTGCCAGCTCACCCCAGGGCCCGACTAGCTCCTACGAGCAGTACTTC	CASSPQGPTSSYEQYF	TRBV18	TRBJ2-7
TGTGCCAGCTCAGATCGAGCGCTAGCCGGGGAGCTGTTTTTT	CASSDRALAGELFF	TRBV18	TRBJ2-2
TGCGCCAGCAGCCAAGAATACGACAGGCAGCCCCAGCATTTT	CASSQEYDRQPQHF	TRBV4-1	TRBJ1-5
TGTGCCAGCAGTTGGGGGGGGGGTCCTGCAGATACGCAGTATTTT	CASSWGGGPADTQYF	TRBV6-9	TRBJ2-3
TGTGCCAGCAGCACCCCCCACTACGAGCAGTACTTC	CASSTPHYEQYF	TRBV7-7	TRBJ2-7
TGCGCCAGCAGCCAAGAGGTAGTGAGTGGGACCGGGGAGCTGTTTTTT	CASSQEVVSGTGELFF	TRBV4-1	TRBJ2-2
TGTGCCAGCAGTTTATGTTTAAGGGGGGCCTACTTCAATGAGCAGTTCTTC	CASSLCLRGAYFNEQFF	TRBV28	TRBJ2-1
TGTGCCTGGGGGACTAGCGGAGAGACCCAGTACTTC	CAWGTSGETQYF	TRBV30	TRBJ2-5
TGCAGTGCTAGACCCCTGGGGCAGGGTACCTACGAGCAGTACTTC	CSARPLGQGTYEQYF	TRBV20-1	TRBJ2-7
TGTGCCAGCAGTTACGATGATGACTATGGCTACACCTTC	CASSYDDDYGYTF	TRBV6-8	TRBJ1-2
TGTGCCAGCAGCTCAAGGGTCCGAGGGTCGCGAGAGCAGTACTTC	CASSSRVRGSREQYF	TRBV7-4	TRBJ2-7
TGTGCCAGCAGTAACCTCGGACAGGGAACCCAGATTAGCAATCAGCCCCAGCATTTT	CASSNLGQGTQISNQPQHF	TRBV14	TRBJ1-5
TGTGCCAGCAGCGTATTTACAGGGGGCTATCAGCCCCAGCATTTT	CASSVFTGGYQPQHF	TRBV13	TRBJ1-5
TGTGCCAGCCATGGCCCTTGGAACACTGAAGCTTTCTTT	CASHGPWNTEAFF	TRBV11-3	TRBJ1-1
TGTGCTAGTGCCTTCGAGGAGTTACCCTACGAGCAGTACTTC	CASAFEELPYEQYF	TRBV12-5	TRBJ2-7
TGTGCCAGCAGTTGTGGGACAGCACCCGAGCAGTACTTC	CASSCGTAPEQYF	TRBV7-3	TRBJ2-7
TGCAGTGCTAGAGATCTATTATATGAAAAACTGTTTTTT	CSARDLLYEKLFF	TRBV20-1	TRBJ1-4
TGTGCCAGCAGTTACCCTAGCGGGCGTCCCGTCCAAGAGACCCAGTACTTC	CASSYPSGRPVQETQYF	TRBV6-5	TRBJ2-5
TGCAGTGCACTTGGGACAGCGGCTTTCTTT	CSALGTAAFF	TRBV20-1	TRBJ1-1
TGTGCCAGCAGTTTATCCGGGGGCCTGGACAATGAGCAGTTCTTC	CASSLSGGLDNEQFF	TRBV28	TRBJ2-1
TGTGCCAGCAGCCAAGATAAAGTCCCGACGGGGGAGGGGGACGAGCAGTACTTC	CASSQDKVPTGEGDEQYF	TRBV4-2	TRBJ2-7
TGCGCCAGCAGTGATGAAACCAGAGATATCGAGCAGTACTTC	CASSDETRDIEQYF	TRBV10-1	TRBJ2-7
TGCAGTGCCCCCCAGAGCATACTCCATGAGCAGTTCTTC	CSAPQSILHEQFF	TRBV20-1	TRBJ2-1
TGTGCCAGCAGCCAAGAAACGGCTCCGGTGTGCTCTGGGGCCAACGTCCTGACTTTC	CASSQETAPVCSGANVLTF	TRBV3-1	TRBJ2-6
TGTGCCAGCAGCCCGTTCGCTACAGGGGGCGCCCTAGCCAAAAACATTCAGTACTTC	CASSPFATGGALAKNIQYF	TRBV7-3	TRBJ2-4
TGCGCCAGCAGCTCCCTGCGGGAGAGGGTCTTCAATGAGCAGTTCTTC	CASSSLRERVFNEQFF	TRBV5-1	TRBJ2-1
TGTGCCAGTAGGCCGGGGGGAAACACCATATATTTT	CASRPGGNTIYF	TRBV19	TRBJ1-3
TGCGCCAGCAGGTCGTTCATGAACACTGAAGCTTTCTTT	CASRSFMNTEAFF	TRBV10-1	TRBJ1-1
TGTGCCAGCAGACGTCACTTCCCTACAGGGGGCGCGACCGGGGAGCTGTTTTTT	CASRRHFPTGGATGELFF	TRBV12-3	TRBJ2-2
TGTGCCAGCAGCGTAGCCCGGGGCGAAGGACAGTCTACTAATGAAAAACTGTTTTTT	CASSVARGEGQSTNEKLFF	TRBV9	TRBJ1-4
TGCACCCGACGGGGGTGGCCGAACACCGGGGAGCTGTTTTTT	CTRRGWPNTGELFF	TRBV20-1	TRBJ2-2
TGTGCCAGCTTCCACGCGCAGGGACCCCGCGCCTACGAGCAGTACTTC	CASFHAQGPRAYEQYF	TRBV6-1	TRBJ2-7
TGCGCCAGCAGCTTGGACCCGGGACTAGGGTCCACCGGGGAGCTGTTTTTT	CASSLDPGLGSTGELFF	TRBV5-1	TRBJ2-2
TGTGCCAGCAGCGGGGGGTTTGCCTATGGCTACACCTTC	CASSGGFAYGYTF	TRBV12-3	TRBJ1-2
TGCGCCAGCGAGTCCAGTAGGACTAGCGGGAGGGTACAGCAGTTCTTC	CASESSRTSGRVQQFF	TRBV5-1	TRBJ2-1
TGTGCCAGCAGCATTGACGGGGGGGGTAAGAACACCGGGGAGCTGTTTTTT	CASSIDGGGKNTGELFF	TRBV7-9	TRBJ2-2
TGCAGTGCTAGAGATCAGATCCTGGGCCGCACATATTTT	CSARDQILGRTYF	TRBV20-1	TRBJ2-3
TGTGCCAGCAGCTGGAGAGGGAGCAATCAGCCCCAGCATTTT	CASSWRGSNQPQHF	TRBV5-6	TRBJ1-5
TGTGCCAGCAGCTGCCCCAGGGGCCGCGGGGAGCTGTTTTTT	CASSCPRGRGELFF	TRBV5-6	TRBJ2-2
TGTGCCAGCAGTTACCTTTTTGCCTCGGTACCCGGAAGCAATCAGCCCCAGCATTTT	CASSYLFASVPGSNQPQHF	TRBV6-5	TRBJ1-5
TGTGCCAGCAGTTACTCGCAAACCCCCCACTGCTCCTACGAGCAGTACTTC	CASSYSQTPHCSYEQYF	TRBV6-5	TRBJ2-7
TGCGCCAGCAGTGTTACGGTGACCCAGTACTTC	CASSVTVTQYF	TRBV10-2	TRBJ2-5
TGCAGTGCTAGACGCACAGGGAATTCACCCCTCCACTTT	CSARRTGNSPLHF	TRBV20-1	TRBJ1-6
TGTGCCAGCAGCTTGACAGAAAAACTGTTTTTT	CASSLTEKLFF	TRBV13	TRBJ1-4
TGTGCCAGCAGCCCCAGACGGGGGGAAATAAGGGATGAAAAACTGTTTTTT	CASSPRRGEIRDEKLFF	TRBV3-1	TRBJ1-4
TGCAGTGCTACTAACAGCCCTGGAAACACCATATATTTT	CSATNSPGNTIYF	TRBV20-1	TRBJ1-3
TGTGCCATATTATCTCGGGGGCCTTCCCAGCCCCAGCATTTT	CAILSRGPSQPQHF	TRBV25-1	TRBJ1-5
TGTGCCATCACCCCGTCCGGGACAGGGGCCTCGACCCAAGAGACCCAGTACTTC	CAITPSGTGASTQETQYF	TRBV10-3	TRBJ2-5
TGTGCCAGCAGTGGCCTTAGGGGGCGGGAGGTCTACGAGCAGTACTTC	CASSGLRGREVYEQYF	TRBV12-3	TRBJ2-7
TGCGCCAGCAGCTGGGGGCAAGAGACCCAGTACTTC	CASSWGQETQYF	TRBV5-1	TRBJ2-5
TGTGCCAGCAGCAGAGGTTTGGACACTGAAGCTTTCTTT	CASSRGLDTEAFF	TRBV7-3	TRBJ1-1
TGCAGTGGCATTGCGGGCTATAACAATGAGCAGTTCTTC	CSGIAGYNNEQFF	TRBV20-1	TRBJ2-1
TGCAGCGTTGAACGAGGAGTCGGGTCGACTGAAAAACTGTTTTTT	CSVERGVGSTEKLFF	TRBV29-1	TRBJ1-4
TGCAGTGCTAGGTTCCGGGACGGCACAGATACGCAGTATTTT	CSARFRDGTDTQYF	TRBV20-1	TRBJ2-3
TGTGCCAGCAGTCTCGATGAGCAGTTCTTC	CASSLDEQFF	TRBV7-9	TRBJ2-1
TGTGCCAGCAGACCCAGGGCGGGTGAAGCTTTCTTT	CASRPRAGEAFF	TRBV11-3	TRBJ1-1
TGTGCCAGCAACCCGACCAGGGCAGGGGTCTCTGGAAACACCATATATTTT	CASNPTRAGVSGNTIYF	TRBV9	TRBJ1-3
TGTGCCAGCAGCTTAAACAGGATTCGCAGTCAGCCCCAGCATTTT	CASSLNRIRSQPQHF	TRBV5-6	TRBJ1-5
TGCGCCAGCAGCTTGCTTTCCCGGACTAGCGCCTCCCAAGAGACCCAGTACTTC	CASSLLSRTSASQETQYF	TRBV5-1	TRBJ2-5
TGCGCCAGCCGTCCGGGAATGGTCGACACCGGGGAGCTGTTTTTT	CASRPGMVDTGELFF	TRBV5-1	TRBJ2-2
TGCAGTGCTTTGGGGCAAGCCGCTTTCTTT	CSALGQAAFF	TRBV20-1	TRBJ1-1
TGCGCCAGCAGCCAAGAGGCTTCGGATAAACTGTTTTTT	CASSQEASDKLFF	TRBV4-1	TRBJ1-4
TGTGCCAGCAGCTTAGGTTTTCAGTCTGAGACCCAGTACTTC	CASSLGFQSETQYF	TRBV7-2	TRBJ2-5
TGTGCCAGCAGGCACAGGGACTCACCCCTCCACTTT	CASRHRDSPLHF	TRBV28	TRBJ1-6
TGTGCCAGCAGCAGAGAGGGACAGGGCCATGAGCAGTTCTTC	CASSREGQGHEQFF	TRBV6-3	TRBJ2-1
TGTGCCAGCAGTCCGGGGGCGCTCGACTACGAGCAGTACTTC	CASSPGALDYEQYF	TRBV27	TRBJ2-7
TGTGCCAGCAGCTTACGTCCGGGGCATAGCACAGATACGCAGTATTTT	CASSLRPGHSTDTQYF	TRBV7-2	TRBJ2-3
TGTGCCAGCGGCAGGGAGGATGGGTCACCCCTCCACTTT	CASGREDGSPLHF	TRBV9	TRBJ1-6
TGTGCCAGCAGCTTAGTGCGCGGCCCGGGGGGCTACACCTTC	CASSLVRGPGGYTF	TRBV11-2	TRBJ1-2
TGTGCCACCAGTGAGTTAAAACTAGGAGCCTACGAGCAGTACTTC	CATSELKLGAYEQYF	TRBV24-1	TRBJ2-7
TGTGCCAGCAGCGTAGAAGTTTCGGCTTCCTACGAGCAGTACTTC	CASSVEVSASYEQYF	TRBV9	TRBJ2-7
TGTGCCAGCAGCCTTTCGCGTCAGGAGGGATGGAAGAGGACAAGGGAGCAGTACTTC	CASSLSRQEGWKRTREQYF	TRBV13	TRBJ2-7
TGTGCCAGCAGCCAAGATAGTCTTGCCGACGACCAGCCCACCGGGGAGCTGTTTTTT	CASSQDSLADDQPTGELFF	TRBV4-2	TRBJ2-2
TGTGCCACCAGCTTCTCGTCGACCCTAGGAATGAGCACCGGGGAGCTGTTTTTT	CATSFSSTLGMSTGELFF	TRBV24-1	TRBJ2-2
TGCGCCAGCGGATTACTGGCCGGGGTGGATGAAAAACTGTTTTTT	CASGLLAGVDEKLFF	TRBV5-1	TRBJ1-4
TGCGCCAATTCAGGGTCCCAGGGCGGGGAGCTGTTTTTT	CANSGSQGGELFF	TRBV10-1	TRBJ2-2
TGTGCCAGCAGCGCCGGGGACCAGCCCCAGCATTTT	CASSAGDQPQHF	TRBV5-6	TRBJ1-5
TGTGCCAGAGTAAGGGAGAGAAACACCATATATTTT	CARVRERNTIYF	TRBV6-5	TRBJ1-3
TGTGCCAGCAAGTCGCGGGACAGGGTGAGAGCTTTCTTT	CASKSRDRVRAFF	TRBV25-1	TRBJ1-1
TGTGCCAGCAGCTTACCAAGGGGCCGTCGGTACCAAGAGACCCAGTACTTC	CASSLPRGRRYQETQYF	TRBV7-6	TRBJ2-5
TGTGCCAGCAGCTTTGCGGGGCGGCTCAGGGTTCTTAGCAATCAGCCCCAGCATTTT	CASSFAGRLRVLSNQPQHF	TRBV5-4	TRBJ1-5
TGTGCCAGCTCACCCCGGAGGGGAAGCAATCAGCCCCAGCATTTT	CASSPRRGSNQPQHF	TRBV18	TRBJ1-5
TGCGCCAGCAGCTTGGTTTCTCGAAGGGGGATCGAGCAGTTCTTC	CASSLVSRRGIEQFF	TRBV5-1	TRBJ2-1
TGTGCCAGCAGCCCAAATAGGGATACAGATACGCAGTATTTT	CASSPNRDTDTQYF	TRBV14	TRBJ2-3
TGTGCCAGCGTCCTAGTACAGGGTTTGAGGAACACCGGGGAGCTGTTTTTT	CASVLVQGLRNTGELFF	TRBV27	TRBJ2-2
TGCAGCGAAGGACAGGCGCATAGTGGCTACACCTTC	CSEGQAHSGYTF	TRBV29-1	TRBJ1-2
TGTGCCAGCAGTTACGTAGAACTATGGGGCGACACTGAAGCTTTCTTT	CASSYVELWGDTEAFF	TRBV6-5	TRBJ1-1
TGTGCCAGGGGGGTGGACACCTTC	CARGVDTF	TRBV6-1	TRBJ1-2
TGTGCCAGCAGCCATTTAGGCAGGCGAGGAGCCAAAAACATTCAGTACTTC	CASSHLGRRGAKNIQYF	TRBV3-1	TRBJ2-4
TGCAGTGCTGGGGGTGGACTAGCGGGGACCAGCTCCTACGAGCAGTACTTC	CSAGGGLAGTSSYEQYF	TRBV20-1	TRBJ2-7
TGCAGTGCCGTCTTAGACCTCAGGGGGAACACTGAAGCTTTCTTT	CSAVLDLRGNTEAFF	TRBV20-1	TRBJ1-1
TGTGCCTGGTCGGGGGGAGTTATGAACACTGAAGCTTTCTTT	CAWSGGVMNTEAFF	TRBV30	TRBJ1-1
TGCAGTGCTAGACGAGGGACAGGGGGCTACGAGCAGTACTTC	CSARRGTGGYEQYF	TRBV20-1	TRBJ2-7
TGTGCCAGCAGTGGGACAGATAATCAGCCCCAGCATTTT	CASSGTDNQPQHF	TRBV6-5	TRBJ1-5
TGTGCCAGCAGGATTGCGAGAAAGGGTGGCTACACCTTC	CASRIARKGGYTF	TRBV6-2	TRBJ1-2
TGTGCCAGCAGTGAGGGAAAGGGCCCGCTAGAAAATGAGCAGTTCTTC	CASSEGKGPLENEQFF	TRBV6-1	TRBJ2-1
TGTGCCAGCAGTGGCAGCTCCTCAGGGGCTATCATAGCTAGCACAGATACGCAGTATTTT	CASSGSSSGAIIASTDTQYF	TRBV6-4	TRBJ2-3
TGTGCCAGCACCCGGACTAGCACGGGTAACACCGGGGAGCTGTTTTTT	CASTRTSTGNTGELFF	TRBV9	TRBJ2-2
TGCAGCGAGACACCCTGGGACAGGCTAATGAACACTGAAGCTTTCTTT	CSETPWDRLMNTEAFF	TRBV29-1	TRBJ1-1
TGTGCCAGCCCCAAAGATCAGCCCCAGCATTTT	CASPKDQPQHF	TRBV27	TRBJ1-5
TGTGCCAGCAACGTGGAGAAAGAGACCCAGTACTTC	CASNVEKETQYF	TRBV6-1	TRBJ2-5
TGCGCCAGCAGCTCGGGGGCGGACAGGGTTTACGAGCAGTACTTC	CASSSGADRVYEQYF	TRBV5-1	TRBJ2-7
TGTGCCAGCAGTTACTCGATGACGACAGGAACAGAGACCCAGTACTTC	CASSYSMTTGTETQYF	TRBV6-2	TRBJ2-5
TGTGCCACCAGCAGAGACCTAGGGAGCGAGCAGTACTTC	CATSRDLGSEQYF	TRBV15	TRBJ2-7
TGTGCCAGCAGTCGGCGACGAGGAGGCCCAGCCAAAAACATTCAGTACTTC	CASSRRRGGPAKNIQYF	TRBV12-4	TRBJ2-4
TGCAGTGCAGTCCAAATTTATGAAAAACTGTTTTTT	CSAVQIYEKLFF	TRBV20-1	TRBJ1-4
TGTGCCAGCAGCCAAGATATGCTTCCTATGGAGCAGTTCTTC	CASSQDMLPMEQFF	TRBV3-1	TRBJ2-1
TGCGCCAGCATCCCTAGGGACACTGAAGCTTTCTTT	CASIPRDTEAFF	TRBV4-1	TRBJ1-1
TGTGCCAGCAGCCATGAATCTGAGTACGAGCAGTACTTC	CASSHESEYEQYF	TRBV14	TRBJ2-7
TGTGCCAGCGACAAAGGGACTAGTGACTACGAGCAGTACTTC	CASDKGTSDYEQYF	TRBV27	TRBJ2-7
TGTGCCAGCAGCTTATCAAGGCCTAACAGGGAGAGGTTTGAGCAGTACTTC	CASSLSRPNRERFEQYF	TRBV7-9	TRBJ2-7
TGTGCCAGCAGCTTGTCTAGGAAATACGAGCAGTACTTC	CASSLSRKYEQYF	TRBV7-2	TRBJ2-7
TGTCCCGGACAGGGAGGACGCAATCAGCCCCAGCATTTT	CPGQGGRNQPQHF	TRBV27	TRBJ1-5
TGTGCCACCAACAGGGTAATGGATAGTAATGAAAAACTGTTTTTT	CATNRVMDSNEKLFF	TRBV27	TRBJ1-4
TGCAGTGCCCAGCGACAGGTAGTGGATGAGCAGTTCTTC	CSAQRQVVDEQFF	TRBV20-1	TRBJ2-1
TGTGCCAGCAGGCCGACAGGCGCTAACTATGGCTACACCTTC	CASRPTGANYGYTF	TRBV7-8	TRBJ1-2
TGCGCCAGCAGTGAGTCTTCAGGGACAGGGGGCGGCTACACCTTC	CASSESSGTGGGYTF	TRBV10-1	TRBJ1-2
TGTGCCACCATACCAAAACCCGACAGTGTCCGAGCTTTCTTT	CATIPKPDSVRAFF	TRBV24-1	TRBJ1-1
TGTGCCACCAGCCACCGGGGTCAAAATGAAAAACTGTTTTTT	CATSHRGQNEKLFF	TRBV24-1	TRBJ1-4
TGCGCCAGCAGCTTGGCACAGCGATTTGGCTACACCTTC	CASSLAQRFGYTF	TRBV5-1	TRBJ1-2
TGTGCCAGTAGTGGGGGGGCTAAAGTCACAGATACGCAGTATTTT	CASSGGAKVTDTQYF	TRBV19	TRBJ2-3
TGTGCCAGCAGCTTTCGGGGGCTCTCCAACGTCCTGACTTTC	CASSFRGLSNVLTF	TRBV7-2	TRBJ2-6
TGTGCCAGCAGCCGCCCGAGCGGAGCTCGGCTCTTC	CASSRPSGARLF	TRBV11-3	TRBJ2-1
TGTGCCTGTAAGGGACAGGGTTATAACACCGGGGAGCTGTTTTTT	CACKGQGYNTGELFF	TRBV30	TRBJ2-2
TGTGCCAGCATTCGAGGGGGGGGGGACGGGGATCAAGAGACCCAGTACTTC	CASIRGGGDGDQETQYF	TRBV7-6	TRBJ2-5
TGTGCCAGTAGTGACCCCAGGAAGGGGGGACATTGCTACGAGCAGTACTTC	CASSDPRKGGHCYEQYF	TRBV19	TRBJ2-7
TGTGCCAGCAGACTGGGACTAGCGTTAGAGCAGTACTTC	CASRLGLALEQYF	TRBV9	TRBJ2-7
TGTGCCAGCAACCAGGCTTTTCCCACAGATACGCAGTATTTT	CASNQAFPTDTQYF	TRBV6-4	TRBJ2-3
TGTGCCAGCAGGTGGCTTGGGAGGACTGGGGGCTACACCTTC	CASRWLGRTGGYTF	TRBV28	TRBJ1-2
TGTGCCAGCAGCTTAGTCGGGTGGTACGGGGAAGGATATTTT	CASSLVGWYGEGYF	TRBV7-2	TRBJ1-3
TGCAGCGTTGAGGCCATATTAACCGATAATTCACCCCTCCACTTT	CSVEAILTDNSPLHF	TRBV29-1	TRBJ1-6
TGCAGCGCGGGGGGGGTATTGAGGACCTACAATGAGCAGTTCTTC	CSAGGVLRTYNEQFF	TRBV29-1	TRBJ2-1
TGTGCCAGCAGCTTGCGACTATGGGGGGGTTGCGAGCAGTACTTC	CASSLRLWGGCEQYF	TRBV7-7	TRBJ2-7
TGCAGTGCTACCTCCCGGCGGGGCAATGAGCAGTTCTTC	CSATSRRGNEQFF	TRBV20-1	TRBJ2-1
TGTGCCAGCAGTTTACTCCTACCGGGACAGGGGGCGACCGGGGAGCTGTTTTTT	CASSLLLPGQGATGELFF	TRBV28	TRBJ2-2
TGTGCCAGCCGGGGTAATGAGCAGTTCTTC	CASRGNEQFF	TRBV7-4	TRBJ2-1
TGTGCCAGCACTCGGAGCCTTGGCACAGATACGCAGTATTTT	CASTRSLGTDTQYF	TRBV7-3	TRBJ2-3
TGTGCCAGCAGTTTGATTACGCTGACAGGGATGGTGAGCCGGGCTTTCTTT	CASSLITLTGMVSRAFF	TRBV6-6	TRBJ1-1
TGTGCCACCAGTGATTTGCCCCGGGGGACTGGGGCCGGGGAGCTGTTTTTT	CATSDLPRGTGAGELFF	TRBV24-1	TRBJ2-2
TGCAGTGCTAGCACAGGGCCGAACACCGGGGAGCTGTTTTTT	CSASTGPNTGELFF	TRBV20-1	TRBJ2-2
TGCGCCAGCAGCTTGTTATGGGCGGAGATGAACACTGAAGCTTTCTTT	CASSLLWAEMNTEAFF	TRBV5-1	TRBJ1-1
TGTGCCAGAGAGGGGGGCCCGTACAATGAGCAGTTCTTC	CAREGGPYNEQFF	TRBV6-4	TRBJ2-1
TGCGCCAGCAGCATGGGGACAGCCTTGGTTGCCGGAACGGGGGGACCGAGGGCTGGGGCCAACGTCCTGACTTTC	CASSMGTALVAGTGGPRAGANVLTF	TRBV5-1	TRBJ2-6
TGTGCCAGCTCACCCGGAACTGAGGGGGAGGAAAAACTGTTTTTT	CASSPGTEGEEKLFF	TRBV18	TRBJ1-4
TGTGCCAGCAGTTACGGGCGGGAGGCCCTGACCCAGTACTTC	CASSYGREALTQYF	TRBV6-5	TRBJ2-5
TGCGCCAGCAGCCAAGATCCCAGTAGGACTTCCCTGAACACTGAAGCTTTCTTT	CASSQDPSRTSLNTEAFF	TRBV4-1	TRBJ1-1
TGTGCCAGCACTTTTTGGACAGGGGGCGATGGCTACACCTTC	CASTFWTGGDGYTF	TRBV9	TRBJ1-2
TGTGCTAGTGGTTTGGCATGCGGGGGCCTCGCGGCATGGCGCAGGGATGAAGCTTTCTTT	CASGLACGGLAAWRRDEAFF	TRBV12-5	TRBJ1-1
TGCGCCAGCAGCTTGCGCGGGACAGGACGCACCGGGGAGCTGTTTTTT	CASSLRGTGRTGELFF	TRBV5-1	TRBJ2-2
TGTGCCAGCAGTTACCTTAAGTATCTACGGGACGGTTCCGCAAAGCCCCTCCACTTT	CASSYLKYLRDGSAKPLHF	TRBV6-6	TRBJ1-6
TGTGCCAGCAGCTTGGCGGGAACCGCGGGAGCCTCCGCAGATACGCAGTATTTT	CASSLAGTAGASADTQYF	TRBV7-2	TRBJ2-3
TGTGCCAATGGGGGACAGGGTGGTAACTATGGCTACACCTTC	CANGGQGGNYGYTF	TRBV24-1	TRBJ1-2
TGTGCCAGCAGCGTAAGTGAAGGAGACAGGGGCCTAGCCACTGAAGCTTTCTTT	CASSVSEGDRGLATEAFF	TRBV13	TRBJ1-1
TGTGCCAGCAGTCCCGGGACAGCGGGATCCTACGAGCAGTACTTC	CASSPGTAGSYEQYF	TRBV6-5	TRBJ2-7
TGTGCCAGCAGCTGGACAGGGGGCGTACTCGACTATGGCTACACCTTC	CASSWTGGVLDYGYTF	TRBV11-3	TRBJ1-2
TGTGCCAGCAGTGAAGCGTTCCGTCGAAACACCGGGGAGCTGTTTTTT	CASSEAFRRNTGELFF	TRBV6-1	TRBJ2-2
TGCAGTGCTCAGGGACAGCTCCAAATTAATGAAAAACTGTTTTTT	CSAQGQLQINEKLFF	TRBV20-1	TRBJ1-4
TGTGCCAGCCCTTCTAGCGGGCGGCCTAGCTCCTACGAGCAGTACTTC	CASPSSGRPSSYEQYF	TRBV5-6	TRBJ2-7
TGTGCCAGCAGCTCGGGACTAGCGGGTATTCAGCAGTACTTC	CASSSGLAGIQQYF	TRBV9	TRBJ2-7
TGTGCCAGCAGCGTAGGAGCGGACCGAGGGGACACCGGGGAGCTGTTTTTT	CASSVGADRGDTGELFF	TRBV9	TRBJ2-2
TGTGCCTGGCATAGTCCGGCGGGAGCGAGAGCCCAGCATTTT	CAWHSPAGARAQHF	TRBV30	TRBJ1-5
TGTGCCAGCAGCTTAAGACCGCGGGAGGGAGGTTGCTACAATGAGCAGTTCTTC	CASSLRPREGGCYNEQFF	TRBV7-3	TRBJ2-1
TGTGCCAGCAGGGTGGGCAGGGACCACTACGTTAGCTCCTACGAGCAGTACTTC	CASRVGRDHYVSSYEQYF	TRBV9	TRBJ2-7
TGCGCCAGCAGCCAAGACGTAGGCGCCTATGGCTACACCTTC	CASSQDVGAYGYTF	TRBV4-1	TRBJ1-2
TGTGCCAGCAGCCGTGGAGGGGCCGGGGGTAACTATGGCTACACCTTC	CASSRGGAGGNYGYTF	TRBV14	TRBJ1-2
TGTGCCAGCAGCTTACATCCAGGGGGGGTTCAGCCCCAGCATTTT	CASSLHPGGVQPQHF	TRBV7-9	TRBJ1-5
TGTGCCAGCAGCCAAGATGGACGGACAGGGTTTTTAGGCTACGAGCAGTACTTC	CASSQDGRTGFLGYEQYF	TRBV3-1	TRBJ2-7
TGTGCCAGCAGTTTAGAAAATTCGGGACTAGCGGGCAACCGCTCCTACGAGCAGTACTTC	CASSLENSGLAGNRSYEQYF	TRBV28	TRBJ2-7
TGCAGTGCTATCGCACGTAAGACCCAGTACTTC	CSAIARKTQYF	TRBV20-1	TRBJ2-5
TGTGCCAGCAGTTTCCCGGGGGGGGGTCCCAATGAGCAGTTCTTC	CASSFPGGGPNEQFF	TRBV28	TRBJ2-1
TGTGCCAGCAGCGAGCCCCCCTGGCGGCACACTGAAGCTTTCTTT	CASSEPPWRHTEAFF	TRBV7-2	TRBJ1-1
TGTGCCACCAGTGATGGAGACAGGGAGCTCTCTGGGGCCAACGTCCTGACTTTC	CATSDGDRELSGANVLTF	TRBV24-1	TRBJ2-6
TGTGCCCTCACACTAGCGGGAGCCGCCGCTGGGGCCAACGTCCTGACTTTC	CALTLAGAAAGANVLTF	TRBV30	TRBJ2-6
TGTGCCAGCAGCTTCCGGGACAGCGGGGGGTTGTACAATGAGCAGTTCTTC	CASSFRDSGGLYNEQFF	TRBV13	TRBJ2-1
TGTGCCAGCAGTTACTCGGGGCAAACCTGGACAGGGAGGTACGAGCAGTACTTC	CASSYSGQTWTGRYEQYF	TRBV6-5	TRBJ2-7
TGTGCTAAGCGGCCGGGTACGACGGTAGCCTCCACTGAAGCTTTCTTT	CAKRPGTTVASTEAFF	TRBV12-5	TRBJ1-1
TGTGCCAGCAGCTTCCCGTTACAGTCACAAGAGACCCAGTACTTC	CASSFPLQSQETQYF	TRBV11-2	TRBJ2-5
TGTGCCAGCAGCTTAGTTAGCGACAGGTACACTGAAGCTTTCTTT	CASSLVSDRYTEAFF	TRBV7-9	TRBJ1-1
TGTGCTAGCAGCTTAGCGCCAACCCTAATTCAGCCCCAGCATTTT	CASSLAPTLIQPQHF	TRBV7-7	TRBJ1-5
TGCAGCGTTGCCCGACAATGTAATCAGCCCCAGCATTTT	CSVARQCNQPQHF	TRBV29-1	TRBJ1-5
TGTGCCAGCAGTGAAAGGGGAAGTTCGGGGGCGGGCGATCAGCCCCAGCATTTT	CASSERGSSGAGDQPQHF	TRBV6-1	TRBJ1-5
TGTGCCAGCACGCAACTTTGGGGGGACAGGGAGGAGACCCAGTACTTC	CASTQLWGDREETQYF	TRBV6-4	TRBJ2-5
TGCGCCAGCAGCCAAGATAAACGAGTTGAAGCTTTCTTT	CASSQDKRVEAFF	TRBV4-1	TRBJ1-1
TGCGCCAGCAGCTTGGAATACAGGGGGGAAAGCACAGATACGCAGTATTTT	CASSLEYRGESTDTQYF	TRBV5-1	TRBJ2-3
TGTGCCAGCAGCGCTACCGACAGGTCCGCTGAAGCTTTCTTT	CASSATDRSAEAFF	TRBV7-2	TRBJ1-1
TGTGCCAGCAGCTGGAAGGACAGGCGGGAGAGCACAGATACGCAGTATTTT	CASSWKDRRESTDTQYF	TRBV7-2	TRBJ2-3
TGTGCCAGCAGTTACCGTCGACAGGGTACTAACTATGGCTACACCTTC	CASSYRRQGTNYGYTF	TRBV6-2	TRBJ1-2
TGCGCCGGCACATTAAATGAAAAACTGTTTTTT	CAGTLNEKLFF	TRBV4-3	TRBJ1-4
TGTGCCAGCAGCCAAGATGTGCTCTCGGATACAAGGGGGAACAATGAGCAGTTCTTC	CASSQDVLSDTRGNNEQFF	TRBV4-2	TRBJ2-1
TGCGCCAGCAGCCAAGACGCGGACAGCTCCTACAATGAGCAGTTCTTC	CASSQDADSSYNEQFF	TRBV5-1	TRBJ2-1
TGTGCCGCAAATCAGCCCCAGCATTTT	CAANQPQHF	TRBV7-9	TRBJ1-5
TGCGCCAGCAGAAGCGGACAGCCCCAGCATTTT	CASRSGQPQHF	TRBV10-1	TRBJ1-5
TGTGCCAGCAATGAGACTAGCGGGTGGGGCAATGAGCAGTTCTTC	CASNETSGWGNEQFF	TRBV7-2	TRBJ2-1
TGTGCCAGCAGCTTAGACAGCCGGGGGGTAAGACAATTCACCAATGAGCAGTTCTTC	CASSLDSRGVRQFTNEQFF	TRBV7-9	TRBJ2-1
TGTGCCAGCAGTCCTTCTGAGCCGGACTATGGCTACACCTTC	CASSPSEPDYGYTF	TRBV2	TRBJ1-2
TGCAGTGCGGACGGTAGGACAGGGCGCACAGATACGCAGTATTTT	CSADGRTGRTDTQYF	TRBV20-1	TRBJ2-3
TGCGCCAGCAGTGCGAGGGAGGTGTACGAGCAGTACTTC	CASSAREVYEQYF	TRBV10-2	TRBJ2-7
TGCAGCGTCCGGACAGGGGGCCGCACAGATACGCAGTATTTT	CSVRTGGRTDTQYF	TRBV29-1	TRBJ2-3
TGCAGTGCTAGTCACCTACCCAATGAGCAGTTCTTC	CSASHLPNEQFF	TRBV20-1	TRBJ2-1
TGTGCCAGCAGTCCGGGGGTCTGCAAAGTGGAGCAGTACTTC	CASSPGVCKVEQYF	TRBV7-4	TRBJ2-7
TGTGCCAGCAGCCCGACAGCGAACACTGAAGCTTTCTTT	CASSPTANTEAFF	TRBV9	TRBJ1-1
TGCAGCGTTGACCCAAGCTGTTTGTCAGAGACCCAGTACTTC	CSVDPSCLSETQYF	TRBV29-1	TRBJ2-5
TGCGCCAGCCTAAACGAGCAGTACTTC	CASLNEQYF	TRBV10-1	TRBJ2-7
TGTGCCAGCCAAGGATTGATAGAACAGCCCCAGCATTTT	CASQGLIEQPQHF	TRBV9	TRBJ1-5
TGTGCCACGCAACGAGGACCCATTTCCAAAAACATTCAGTACTTC	CATQRGPISKNIQYF	TRBV19	TRBJ2-4
TGTGCCAGCAGCTTCCCGGGTAGCACAGATACGCAGTATTTT	CASSFPGSTDTQYF	TRBV7-9	TRBJ2-3
TGCGCCAGCAGCGGGGATTGGACGTCTCCCCTTCCGTCTAACTATGGCTACACCTTC	CASSGDWTSPLPSNYGYTF	TRBV5-1	TRBJ1-2
TGCGCCAGCAGCCAAGAACCGGCCTACGAGCAGTACTTC	CASSQEPAYEQYF	TRBV4-3	TRBJ2-7
TGTGCCATCAGTGGGACGACCTTTCAGTACAATGAGCAGTTCTTC	CAISGTTFQYNEQFF	TRBV10-3	TRBJ2-1
TGTGCCAGCAGCTTATGCGGGGAGGGGTTGAACACTGAAGCTTTCTTT	CASSLCGEGLNTEAFF	TRBV7-3	TRBJ1-1
TGTGCCAGCAGTTACCTACATGGAAAAAACACCGGGGAGCTGTTTTTT	CASSYLHGKNTGELFF	TRBV6-5	TRBJ2-2
TGTGCCAGCAGGGACAGGGATCAGCCCCAGCATTTT	CASRDRDQPQHF	TRBV7-3	TRBJ1-5
TGTGCCAGCAGCCTCAGTCCAGCCGAGACCCAGTACTTC	CASSLSPAETQYF	TRBV3-1	TRBJ2-5
TGTCGGTGTTTCGGGACTAGGGGAGAGACCCAGTACTTC	CRCFGTRGETQYF	TRBV27	TRBJ2-5
TGTGCCAGTATCTCACAAGATAATGAAAAACTGTTTTTT	CASISQDNEKLFF	TRBV19	TRBJ1-4
TGCGCCAGCAGCCAAGACCTACACCACACTGAAGCTTTCTTT	CASSQDLHHTEAFF	TRBV4-1	TRBJ1-1
TGTGCCAGCAGTGAAAGGTCCACGGACAGGGTCGGAGGAAATCAGCCCCAGCATTTT	CASSERSTDRVGGNQPQHF	TRBV6-5	TRBJ1-5
TGTGCCAGCCGCTCCATCGGCTATAATTCACCCCTCCACTTT	CASRSIGYNSPLHF	TRBV19	TRBJ1-6
TGTGCCAGGGGGCCCCCGCATCGGGGGAGAGGAGCTAACTATGGCTACACCTTC	CARGPPHRGRGANYGYTF	TRBV6-5	TRBJ1-2
TGTGCCAGCAGCGCTTCTGGGTCGCCGGGACAGGAAAGAACTGGAAACACCATATATTTT	CASSASGSPGQERTGNTIYF	TRBV9	TRBJ1-3
TGTGCCAGCAGCGCATCCCGTTTTCCACCATCTCTAGCCAAAAACATTCAGTACTTC	CASSASRFPPSLAKNIQYF	TRBV7-3	TRBJ2-4
TGCGCCAGCAGGAATCACGATACCGGGGAGCTGTTTTTT	CASRNHDTGELFF	TRBV10-1	TRBJ2-2
TGCAGAGTTCTTGGCGGGGAGCTGTTTTTT	CRVLGGELFF	TRBV29-1	TRBJ2-2
TGTGCCAGCGGGCTAGCGGATACAGATACGCAGTATTTT	CASGLADTDTQYF	TRBV6-5	TRBJ2-3
TGTGCCACCAGTGAGAGAAACATTCAGTACTTC	CATSERNIQYF	TRBV24-1	TRBJ2-4
TGTGCCAGCAGTCGGAGAGGGGAGCTGTTTTTT	CASSRRGELFF	TRBV6-1	TRBJ2-2
TGTGCTGAGAGGGGCCAGGATGAGCAGTTCTTC	CAERGQDEQFF	TRBV28	TRBJ2-1
TGCAGTGCTAGACCCGGGACACTGCAGTTCTTC	CSARPGTLQFF	TRBV20-1	TRBJ2-1
TGCAGTGCTAGCTTTCTCTACGAGCAGTACTTC	CSASFLYEQYF	TRBV20-1	TRBJ2-7
TGTGCCAGCAGTTTGTCCGCGGGGCCAAAGCAGCCCCAGCATTTT	CASSLSAGPKQPQHF	TRBV27	TRBJ1-5
TGTGCCAGCAGCAAGACCGAGGAGTCTTATATTATCGCCCTAGATGAGCAGTTCTTC	CASSKTEESYIIALDEQFF	TRBV5-4	TRBJ2-1
TGTGCCAGCAGGGCCCGGGACAGGCGTGCCTACGAGCAGTACTTC	CASRARDRRAYEQYF	TRBV6-5	TRBJ2-7
TGTGCCAGCACTTCCTTTCAGGGAGGGGGCCATGAGCAGTTCTTC	CASTSFQGGGHEQFF	TRBV7-2	TRBJ2-1
TGTGCCAGCAGCGCTAGTTACAATGAGCAGTTCTTC	CASSASYNEQFF	TRBV3-1	TRBJ2-1
TGTGCCGGACCGACTAGCGGGACCTACGAGCAGTACTTC	CAGPTSGTYEQYF	TRBV30	TRBJ2-7
TGTGCTAGCAGCTTAGCGAGGGGGGCTACTGAAGCTTTCTTT	CASSLARGATEAFF	TRBV7-7	TRBJ1-1
TGTGCCAGCAGCTTAGACGAGGGGGGTAACTATGGCTACACCTTC	CASSLDEGGNYGYTF	TRBV11-2	TRBJ1-2
TGTGCCAGCAGTTTATCGGACGCCTACGAGCAGTACTTC	CASSLSDAYEQYF	TRBV27	TRBJ2-7
TGTGCCAGCAGCTTTTACTTTCGACCAGGGGTCCAGACCGGGGAGCTGTTTTTT	CASSFYFRPGVQTGELFF	TRBV7-6	TRBJ2-2
TGTGCCAGCAGCTTGGGGAGATGGCTGTACGAGCAGTACTTC	CASSLGRWLYEQYF	TRBV7-7	TRBJ2-7
TGTGCCAGTCACAACCGGGGGCACCCCATCTCTGGAAACACCATATATTTT	CASHNRGHPISGNTIYF	TRBV27	TRBJ1-3
TGTGCCAGCAGTACGCCGCGACCGGACAGGACGAGCAATCAGCCCCAGCATTTT	CASSTPRPDRTSNQPQHF	TRBV12-3	TRBJ1-5
TGTGCCAGCAGTGACTCCGGGTCAGGGGCCCGTGAGCAGTTCTTC	CASSDSGSGAREQFF	TRBV6-4	TRBJ2-1
TGCGCCAGCAGCGGGCCCAATGACAGGGAAGGCACCTTC	CASSGPNDREGTF	TRBV5-1	TRBJ1-2
TGTGCCAGCAGTTATTCAGGACCCCGCACCGGGGAGCTGTTTTTT	CASSYSGPRTGELFF	TRBV6-5	TRBJ2-2
TGCAGTGCTGAAGCGGACGAGCAGTACTTC	CSAEADEQYF	TRBV20-1	TRBJ2-7
TGTGCTAGTGGTTTGGTATGGGGTACAGTTATTGCTAACTATGGCTACACCTTC	CASGLVWGTVIANYGYTF	TRBV12-5	TRBJ1-2
TGTGCCACGGGCCCGGGGAGCTCCTACAATGAGCAGTTCTTC	CATGPGSSYNEQFF	TRBV19	TRBJ2-1
TGTGCCACCAGTGAGCGGGGGTCAAATGGCTACACCTTC	CATSERGSNGYTF	TRBV24-1	TRBJ1-2
TGCGCCAGCAGTGAGGGAGTGAAACAAGAGACCCAGTACTTC	CASSEGVKQETQYF	TRBV10-1	TRBJ2-5
TGTGCCAGCAGTTCACAGGGTGGTGCAACTAATGAAAAACTGTTTTTT	CASSSQGGATNEKLFF	TRBV28	TRBJ1-4
TGCGCCAGCAGCTTGAGAACAGGGGGCGGGTATGGCTACACCTTC	CASSLRTGGGYGYTF	TRBV5-1	TRBJ1-2
TGTGCCAGCAGCCACCCGCAAGAGACCCAGTACTTC	CASSHPQETQYF	TRBV11-2	TRBJ2-5
TGTGCCAGCAGTTCTCCCAGCCTGAGCGGGAGGAGAAACTATGGCTACACCTTC	CASSSPSLSGRRNYGYTF	TRBV27	TRBJ1-2
TGTGCCAGCAGCGTAGACGGACTAGCGGGCATTGGGGGTTACAATGAGCAGTTCTTC	CASSVDGLAGIGGYNEQFF	TRBV9	TRBJ2-1
TGTGCCAGCACCGGAAGCTCCTACAATGAGCAGTTCTTC	CASTGSSYNEQFF	TRBV6-2	TRBJ2-1
TGTGCCAGCAGAACCAGGGACCCCCGGCACTATGGCTACACCTTC	CASRTRDPRHYGYTF	TRBV6-3	TRBJ1-2
TGTGCCACCAGTGATTTTGTTGACAGGGAATGGGAGCTGTTTTTT	CATSDFVDREWELFF	TRBV24-1	TRBJ2-2
TGCGCCAGCAGCGGCGCCCGGAGCTCCTACGAGCAGTACTTC	CASSGARSSYEQYF	TRBV5-1	TRBJ2-7
TGTGCCAGCAGCAGAGAACTAGGGCGTGCTAGTATAGATACGCAGTATTTT	CASSRELGRASIDTQYF	TRBV7-3	TRBJ2-3
TGCGCCAGCAGCCTTCAACGTCGCAATAGCAATCAGCCCCAGCATTTT	CASSLQRRNSNQPQHF	TRBV5-1	TRBJ1-5
TGTTTGTTTCGGGTCTCGAACACTGAAGCTTTCTTT	CLFRVSNTEAFF	TRBV7-9	TRBJ1-1
TGTGCCATCACTCTGACAGGGAACACTGAAGCTTTCTTT	CAITLTGNTEAFF	TRBV10-3	TRBJ1-1
TGTGCCAGCAGCTACACTAGCGGGCAGAACGGGCGCGAGCAGTACTTC	CASSYTSGQNGREQYF	TRBV9	TRBJ2-7
TGTGCCAGCAGAGGAGACAGAGTAACTAACTATGGCTACACCTTC	CASRGDRVTNYGYTF	TRBV7-9	TRBJ1-2
TGTGCCAGCAGCTTCGGGACTATCGGTGAGCAGTTCTTC	CASSFGTIGEQFF	TRBV7-9	TRBJ2-1
TGTGCCAGCTCCCCCCTGGCCTACAATGAGCAGTTCTTC	CASSPLAYNEQFF	TRBV12-4	TRBJ2-1
TGTGCCAGCAGCTTAGATTGGAAGACAGGGCCGGAAAGGGCAAACCACTATGGCTACACCTTC	CASSLDWKTGPERANHYGYTF	TRBV11-3	TRBJ1-2
TGTGCCAGCAGTGAAGAAACCCAGCATTTT	CASSEETQHF	TRBV25-1	TRBJ1-5
TGCAGCGTTGCCCCAGCGCTAGAGTACTTC	CSVAPALEYF	TRBV29-1	TRBJ2-7
TGTGCCAGCAGCCCTCGGACGAATGAGCAGTTCTTC	CASSPRTNEQFF	TRBV13	TRBJ2-1
TGTGCCAGCAGTGACGGGGCCGGCCCCTACGAGCAGTACTTC	CASSDGAGPYEQYF	TRBV2	TRBJ2-7
TGTGCCAGCAGATCACTTCAGCCCCAGCATTTT	CASRSLQPQHF	TRBV28	TRBJ1-5
TGTGCCAGCAGTGAATATCAAAGGGGGACACGCTCCTACAATGAGCAGTTCTTC	CASSEYQRGTRSYNEQFF	TRBV25-1	TRBJ2-1
TGTGCCAGCAGCCACCGGGACAGGGGGCTTGAAACTAATGAAAAACTGTTTTTT	CASSHRDRGLETNEKLFF	TRBV7-9	TRBJ1-4
TGTGCCAGCAGTGACGCTACTTACGAGCAGTACTTC	CASSDATYEQYF	TRBV6-4	TRBJ2-7
TGTGCCAGCAGTTACTGCCCGGGACTAGCGGGAGGGAATCAGCCCCAGCATTTT	CASSYCPGLAGGNQPQHF	TRBV6-3	TRBJ1-5
TGTGCCACCACTTTCGACAGGCGGAAACAGTCACCCCTCCACTTT	CATTFDRRKQSPLHF	TRBV24-1	TRBJ1-6
TGTGCCGGCCGGGACACAACCGGTTACAATTCACCCCTCCACTTT	CAGRDTTGYNSPLHF	TRBV24-1	TRBJ1-6
TGTGCCAGCAGTTTGACCCCGGGTCGGAGTTACGAGCAGTACTTC	CASSLTPGRSYEQYF	TRBV27	TRBJ2-7
TGCAGCGAATCGACAGGGGGCTCTGGAAACACCATATATTTT	CSESTGGSGNTIYF	TRBV29-1	TRBJ1-3
TGTGCCAGCAGTGCGTGGCGATCTTTCTTT	CASSAWRSFF	TRBV27	TRBJ1-1
TGCGCCAGCAGCTATAGCGGGAGGGGCGTTTCCTACAATGAGCAGTTCTTC	CASSYSGRGVSYNEQFF	TRBV5-1	TRBJ2-1
TGTGCCAGCGGACGACAGGGGGCTGTCCTTCAGTCCGAGGACCAAGAGACCCAGTACTTC	CASGRQGAVLQSEDQETQYF	TRBV12-4	TRBJ2-5
TGTGCCAGCAGCTTAGCAAGGGTTCCCCTTCAGGGGGGCATCGTGAACACTGAAGCTTTCTTT	CASSLARVPLQGGIVNTEAFF	TRBV7-2	TRBJ1-1
TGTGCCAGCAGCAATCTGGCGGATAGCACAGATACGCAGTATTTT	CASSNLADSTDTQYF	TRBV5-4	TRBJ2-3
TGTGCCAGCGCGGGCCAAGGGGGCAGCGACTACGAGCAGTACTTC	CASAGQGGSDYEQYF	TRBV5-5	TRBJ2-7
TGTGCCACAGCGGGACGACATGAAGCTTTCTTT	CATAGRHEAFF	TRBV24-1	TRBJ1-1
TGCAGTGGGACGAGTGAAGCTTTCTTT	CSGTSEAFF	TRBV20-1	TRBJ1-1
TGTGAAATGGCGGGAGTACTTACCTTCCACACTGAAGCTTTCTTT	CEMAGVLTFHTEAFF	TRBV30	TRBJ1-1
TGTGCCAGCAGCCCGGGTAGGCCCTGCACAGATACGCAGTATTTT	CASSPGRPCTDTQYF	TRBV6-4	TRBJ2-3
TGCGCCAGCAGTGAGGAGGGGGGCCTAGCCTTAGAGACCCAGTACTTC	CASSEEGGLALETQYF	TRBV10-2	TRBJ2-5
TGTGCCAGCAGTGACCCGACCGCTAGCTCGGGGGGCGACTTC	CASSDPTASSGGDF	TRBV6-4	TRBJ2-7
TGTGCCAGCGTCTGGACAGGGGTGGGAGGGACTGGGTGGATAAACTCTGGGGCCAACGTCCTGACTTTC	CASVWTGVGGTGWINSGANVLTF	TRBV6-3	TRBJ2-6
TGTGCCAGCAGGTATTCGACTAGCGGGAGAGCTAAGCCTGGCCAAGAGACCCAGTACTTC	CASRYSTSGRAKPGQETQYF	TRBV6-5	TRBJ2-5
TGTGCCAGCAGTTGTCAGGACAGGAACTATGGCTACACCTTC	CASSCQDRNYGYTF	TRBV28	TRBJ1-2
TGTGCCACCAGCAGAAAGCGGGGGGGACAGGGCTATGGCTACACCTTC	CATSRKRGGQGYGYTF	TRBV15	TRBJ1-2
TGTGCCAGCAGTGGCTCGGGGACAGATACGAGAGGTTCACCCCTCCACTTT	CASSGSGTDTRGSPLHF	TRBV6-1	TRBJ1-6
TGTGCCAGCAGCCAAGATCGGCCGTTACTAGCGGGAGTATCACCCTACAATGAGCAGTTCTTC	CASSQDRPLLAGVSPYNEQFF	TRBV3-1	TRBJ2-1
TGTGCCTGGAACGGGGCCTACGAGCAGTACTTC	CAWNGAYEQYF	TRBV30	TRBJ2-7
TGTGCCAGCAGCCAAGATCCGGGGCCCCGGGGGGCCAGGTACGAGACCCAGTACTTC	CASSQDPGPRGARYETQYF	TRBV14	TRBJ2-5
TGTGCCTGGAGCGACCGAAGGGGGGCCGTCAATGAGCAGTTCTTC	CAWSDRRGAVNEQFF	TRBV30	TRBJ2-1
TGTGCCAGCAGTTACAGGGCGTACACTGAAGCTTTCTTT	CASSYRAYTEAFF	TRBV6-5	TRBJ1-1
TGCGCCAGCAATAGTCTGGGGACTCTACAGAGCACCGGGGAGCTGTTTTTT	CASNSLGTLQSTGELFF	TRBV4-3	TRBJ2-2
TGTGCCAGCTCACCCCCTCAGGGATTATATGGGCCCAATCAGCCCCAGCATTTT	CASSPPQGLYGPNQPQHF	TRBV18	TRBJ1-5
TGTGCCAGCAGCTTATACAGGGGGGGCTACACCTTC	CASSLYRGGYTF	TRBV11-2	TRBJ1-2
TGTGCCACCAGTGATTGTTGGGGCGAGCAGTACTTC	CATSDCWGEQYF	TRBV24-1	TRBJ2-7
TGTGCTAGTGGTTGGGGGGGAGGGGCAGATACGCAGTATTTT	CASGWGGGADTQYF	TRBV12-5	TRBJ2-3
TGTGCCAGCAGCCCCATGTTCTTAGGCAGCTCTGGGGCCAACGTCCTGACTTTC	CASSPMFLGSSGANVLTF	TRBV7-8	TRBJ2-6
TGCAGTGCTATTACGGTTCTTCAAGGGTCTGAGCAAGAGACCCAGTACTTC	CSAITVLQGSEQETQYF	TRBV20-1	TRBJ2-5
TGCGCCAGCAGCTTTCCCCAGACAGGGGGATACACTGAAGCTTTCTTT	CASSFPQTGGYTEAFF	TRBV5-1	TRBJ1-1
TGCAGTGCTAGATGGGACAGGAGCTCCTACGAGCAGTACTTC	CSARWDRSSYEQYF	TRBV20-1	TRBJ2-7
TGTGCCAGCAGTTTAGGGTGTAGCGGCAAAGAAGAGACCCAGTACTTC	CASSLGCSGKEETQYF	TRBV28	TRBJ2-5
TGCAGTGCAATTAGGGCGGACAGGGCTAACGAGCAGTACTTC	CSAIRADRANEQYF	TRBV20-1	TRBJ2-7
TGTGCCAGTAGTTCCTCCTACGAGCAGTACTTC	CASSSSYEQYF	TRBV19	TRBJ2-7
TGTGCCAGCAGTGAGCCAGGGGTGTACGAGCAGTACTTC	CASSEPGVYEQYF	TRBV25-1	TRBJ2-7
TGTGCCAGCAGCACTAGCGGGAGGTGGTCTGGGGCCAACGTCCTGACTTTC	CASSTSGRWSGANVLTF	TRBV7-4	TRBJ2-6
TGTGCCAGCAGCCCTAAGGGATGGCAAGAGACCCAGTACTTC	CASSPKGWQETQYF	TRBV7-9	TRBJ2-5
TGTGCTAGTGGTTACGGTAGGCGGGGCCCAGGTAAGCAAGAGACCCAGTACTTC	CASGYGRRGPGKQETQYF	TRBV12-5	TRBJ2-5
TGTGCCACCCGGGGCTTC	CATRGF	TRBV24-1	TRBJ1-2
TGTGCCTGGTCCAACACTGGGGACCCGTTTTACGAGCAGTACTTC	CAWSNTGDPFYEQYF	TRBV30	TRBJ2-7
TGTGCCAGCAGTTACCCGGGGCCGCGGGGTAACTATGGCTACACCTTC	CASSYPGPRGNYGYTF	TRBV6-2	TRBJ1-2
TGTGCCAGCAATGGGGAAATCCCCAGCCCGACTGGCTACACCTTC	CASNGEIPSPTGYTF	TRBV12-3	TRBJ1-2
TGTGCCAGCATTGGCAGGGGAGAAAAACTGTTTTTT	CASIGRGEKLFF	TRBV13	TRBJ1-4
TGCAGTGATCGACAGGTGCATCAGCCCCAGCATTTT	CSDRQVHQPQHF	TRBV20-1	TRBJ1-5
TGTGCCAGACGTCTGACAGAGTCAGATACGCAGTATTTT	CARRLTESDTQYF	TRBV28	TRBJ2-3
TGCAGTGCTTACCAAAACAGGGGGGCGATGCCCTACGAGCAGTACTTC	CSAYQNRGAMPYEQYF	TRBV20-1	TRBJ2-7
TGCAGTGGACAGTATAGCAATCAGCCCCAGCATTTT	CSGQYSNQPQHF	TRBV20-1	TRBJ1-5
TGTGCCAGCACCGACAGGACCCCCTACAATGAGCAGTTCTTC	CASTDRTPYNEQFF	TRBV6-2	TRBJ2-1
TGTGCCAGCAGAAGGACAGGGAATGAAAAACTGTTTTTT	CASRRTGNEKLFF	TRBV6-4	TRBJ1-4
TGTGCCAGCAGCGTAAGGGGCCGACTCTACGAGCAGTACTTC	CASSVRGRLYEQYF	TRBV6-1	TRBJ2-7
TGTAGGGGAATAGGTAGACAAAGCTCTGGAAACACCATATATTTT	CRGIGRQSSGNTIYF	TRBV6-1	TRBJ1-3
TGCGCCAGCAGCTACCTAAAAGTCGGACGGCGATGTAGCTCCTATAATTCACCCCTCCACTTT	CASSYLKVGRRCSSYNSPLHF	TRBV5-1	TRBJ1-6
TGTGCCAGCAGTGACTCGAAAAGAAGGAGGGTTTCCTCTGGAAACACCATATATTTT	CASSDSKRRRVSSGNTIYF	TRBV6-4	TRBJ1-3
TGTGCCAGCAGCAAACTCGATGGGGGGGCCAATGAGCAGTTCTTC	CASSKLDGGANEQFF	TRBV5-6	TRBJ2-1
TGCGCCAGCTTGTCGAGGGGGGGCAATCAGCCCCAGCATTTT	CASLSRGGNQPQHF	TRBV5-1	TRBJ1-5
TGTGCCAGCAGCTTGAACCGGGGGTCCCTAGGTAGCAATCAGCCCCAGCATTTT	CASSLNRGSLGSNQPQHF	TRBV5-6	TRBJ1-5
TGTGCCAGCAGCTTCGTAGGGGAGACCCAGTACTTC	CASSFVGETQYF	TRBV7-2	TRBJ2-5
TGTGCCAGCAGACCCGAGGTGGGAGAGACCCAGTACTTC	CASRPEVGETQYF	TRBV5-4	TRBJ2-5
TGTGCCAGCAGTTCCGGTTGGGCCCTCCACTTT	CASSSGWALHF	TRBV6-3	TRBJ1-6
TGTGCCAGCAGCCTTGCCGGGACAGGGCGGTACGAGCAGTACTTC	CASSLAGTGRYEQYF	TRBV7-3	TRBJ2-7
TGCGCCACGTACAGGGACCCCTACGAGCAGTACTTC	CATYRDPYEQYF	TRBV10-1	TRBJ2-7
TGTGCCAGCAGTGATCGGACAGGGGGCAATGATTCACCCCTCCACTTT	CASSDRTGGNDSPLHF	TRBV2	TRBJ1-6
TGCGCCAGCAGCTTGTCCTCTAGCGGGGATGAGCAGTTCTTC	CASSLSSSGDEQFF	TRBV5-1	TRBJ2-1
TGTGCCAGCACCGAAAACGGACAGGGCGTGAAACGCTACGAGCAGTACTTC	CASTENGQGVKRYEQYF	TRBV7-3	TRBJ2-7
TGCGCCAGCAGCGCGGTACTTAAAAAACTCTTC	CASSAVLKKLF	TRBV5-1	TRBJ2-1
TGTGCCAGCAGCACCCCAAAGCGTAATGAAAAACTGTTTTTT	CASSTPKRNEKLFF	TRBV6-1	TRBJ1-4
TGTGCCAGCAGTGGGCCCCAAGGGGGCGAGCCCACAGATACGCAGTATTTT	CASSGPQGGEPTDTQYF	TRBV27	TRBJ2-3
TGTGCCAGCAGTGAAGCGCTTACCACTCAGCCCCAGCATTTT	CASSEALTTQPQHF	TRBV6-1	TRBJ1-5
TGTGCCAGCAGCGTCCGGGACAGGGGCACAGATACGCAGTATTTT	CASSVRDRGTDTQYF	TRBV7-6	TRBJ2-3
TGTGCCACCAGCAGTTGGACTAGCGGGCCCCCCGAGCAGTACTTC	CATSSWTSGPPEQYF	TRBV15	TRBJ2-7
TGTGCCAGCAGCCAGTCAGCTGGAAACACCATATATTTT	CASSQSAGNTIYF	TRBV14	TRBJ1-3
TGTGCCAGCAGTTTACAACCCGTGCCGGGACGAAGCTCCTATAATTCACCCCTCCACTTT	CASSLQPVPGRSSYNSPLHF	TRBV27	TRBJ1-6
TGCAGCGTTGACCCTCCCTCAGGAGCACTTGCCGATACGCAGTATTTT	CSVDPPSGALADTQYF	TRBV29-1	TRBJ2-3
TGTGCCAGCAGCTTAGCAGGTTGGACAGGCTACGAGCAGTACTTC	CASSLAGWTGYEQYF	TRBV11-2	TRBJ2-7
TGTGCCAGCAGCTTAAATACGACTAGCGGCTTAGATACGCAGTATTTT	CASSLNTTSGLDTQYF	TRBV11-3	TRBJ2-3
TGTGCCAGCAGTTACAGTGTTACTCTAGTGAACACCGGGGAGCTGTTTTTT	CASSYSVTLVNTGELFF	TRBV6-5	TRBJ2-2
TGTGCCAGCAGCCCAGTCGTGCAAGAGACCCAGTACTTC	CASSPVVQETQYF	TRBV7-2	TRBJ2-5
TGTGCCACAAATCAGAAAGGCTACACCTTC	CATNQKGYTF	TRBV27	TRBJ1-2
TGTGCCACCAACAAACAGGGGGAAGCTGGCTACACCTTC	CATNKQGEAGYTF	TRBV24-1	TRBJ1-2
TGTGCCAGCAGTTTAAAGGTGAACACAGGGGGGGGGTCCTACGAGCAGTACTTC	CASSLKVNTGGGSYEQYF	TRBV12-4	TRBJ2-7
TGTGCCATCAGTCCTTCCTCGAAGCGGGAGCTAGCCAAAAACATTCAGTACTTC	CAISPSSKRELAKNIQYF	TRBV10-3	TRBJ2-4
TGTGCCAGCAGCTTAGGGGACAGGGGTGAGTTCTATGGCTACACCTTC	CASSLGDRGEFYGYTF	TRBV7-9	TRBJ1-2
TGCAGTGCTAGAGGAGGGCTATTTAACGAGCAGTACTTC	CSARGGLFNEQYF	TRBV20-1	TRBJ2-7
TGTGCCAGCTCACCACGAGACAGGGGGTTCTCCTACGAGCAGTACTTC	CASSPRDRGFSYEQYF	TRBV18	TRBJ2-7
TGTGCCAGCAGGGGGCACGGCTACGAGCAGTACTTC	CASRGHGYEQYF	TRBV6-1	TRBJ2-7
TGTGCCAGCAGTGAAGCATGTCCGGGACTCAAGGGCACTGAAGCTTTCTTT	CASSEACPGLKGTEAFF	TRBV6-1	TRBJ1-1
TGCAGTGCTAGAGGGAACCGCCGGACAGGCCTTCACACAGATACGCAGTATTTT	CSARGNRRTGLHTDTQYF	TRBV20-1	TRBJ2-3
TGTGCCAGCAGCAGTCTAGCCGACAGGGACGAGCAGTACTTC	CASSSLADRDEQYF	TRBV7-8	TRBJ2-7
TGTGCCAGCAAATCAGGGGAAGACAGGGGTGAAAAGACTGAAGCTTTCTTT	CASKSGEDRGEKTEAFF	TRBV7-8	TRBJ1-1
TGTGCCTTTAGCGGGGAAGGTTCATTAACCGGGGAGCTGTTTTTT	CAFSGEGSLTGELFF	TRBV6-2	TRBJ2-2
TGCAGCCACAACGGACAGTCGACCCAGTACTTC	CSHNGQSTQYF	TRBV29-1	TRBJ2-5
TGTGCCAGCAGGACGGGATCCTTACAAGAGACCCAGTACTTC	CASRTGSLQETQYF	TRBV6-4	TRBJ2-5
TGCAGTGCTAGAGATACCAGAGCGAAGGGGGGGGGGTACGAGCAGTACTTC	CSARDTRAKGGGYEQYF	TRBV20-1	TRBJ2-7
TGTGCCAGCAGTTACCGGCCGGGACAGGGGGGGACAGACTATGGCTACACCTTC	CASSYRPGQGGTDYGYTF	TRBV6-2	TRBJ1-2
TGCAGCGTTCGATCTGAAAACAATGAGCAGTTCTTC	CSVRSENNEQFF	TRBV29-1	TRBJ2-1
TGTGCCAGCACAGTCCTGGGGACAGGGAATTTTGGAAACACCATATATTTT	CASTVLGTGNFGNTIYF	TRBV28	TRBJ1-3
TGTGCCAGCAGTTTGTACGGACAGGGTAAACTGTTTTTT	CASSLYGQGKLFF	TRBV28	TRBJ1-4
TGTGCCAGCAGCCAAGATCCCGGGACAGCGGCGTCCTACGAGCAGTACTTC	CASSQDPGTAASYEQYF	TRBV14	TRBJ2-7
TGTGCCTGGAGTGTGGACAGGGCCACCTTC	CAWSVDRATF	TRBV30	TRBJ1-2
TGTGCCAGCAGCAGGGGGGCGCACTACGAGCAGTACTTC	CASSRGAHYEQYF	TRBV13	TRBJ2-7
TGCGCCAGCAGCCAAGAGCAGGGGGGTTACCTTAAAAGTCGTGGCTACACCTTC	CASSQEQGGYLKSRGYTF	TRBV4-3	TRBJ1-2
TGTGCCAGCTCACCACCACTAGGCTCCTACGAGCAGTACTTC	CASSPPLGSYEQYF	TRBV18	TRBJ2-7
TGTGCCAGCACCTTAGCGGGCTGGGAGACCCAGTACTTC	CASTLAGWETQYF	TRBV6-5	TRBJ2-5
TGTGCCAGCAGTTGGTTAATGCTAGGGGGCGGGAACACCGGGGAGCTGTTTTTT	CASSWLMLGGGNTGELFF	TRBV27	TRBJ2-2
TGTACTGCCTCCAGGGACCACTACGAGCAGTACTTC	CTASRDHYEQYF	TRBV20-1	TRBJ2-7
TGTGCCAGCAGCTGTGACGAAGGCCAGCCCCAGCATTTT	CASSCDEGQPQHF	TRBV13	TRBJ1-5
TGTGCCAGCAGCTCCTTGAAGGCCCAGGGGGTTAGGAATCAGCCCCAGCATTTT	CASSSLKAQGVRNQPQHF	TRBV13	TRBJ1-5
TGTGCCAGCAGCTTGGTAAAGGGACAGGGCATGGGCTACACCTTC	CASSLVKGQGMGYTF	TRBV7-2	TRBJ1-2
TGCGCCAGCAGTGAACCTGGGAAGCCCACCTTC	CASSEPGKPTF	TRBV10-1	TRBJ1-2
TGTGCCAGCAGTGACTGGCAGGGGGATAATGAGCAGTTCTTC	CASSDWQGDNEQFF	TRBV6-4	TRBJ2-1
TGTGCCAGCAGCGTAGGGGACAGGGGGACCACTGAAGCTTTCTTT	CASSVGDRGTTEAFF	TRBV9	TRBJ1-1
TGCGCCAGCAGCTTCCCTCCGGGACAGTTTCGCAATCAGCCCCAGCATTTT	CASSFPPGQFRNQPQHF	TRBV5-1	TRBJ1-5
TGTGCCAAGCGTTGGGGGAACACTGAAGCTTTCTTT	CAKRWGNTEAFF	TRBV6-6	TRBJ1-1
TGTGCCAGCTTCCGGGGGGCTGAAAAACTGTTTTTT	CASFRGAEKLFF	TRBV6-1	TRBJ1-4
TGTGCCAGCAGTCGAGGGTGGGGACTAGATCTATACAATGAGCAGTTCTTC	CASSRGWGLDLYNEQFF	TRBV27	TRBJ2-1
TGTGCCAGCAGCCGGAGGGACAGGGGGCTGCAAAGAGCTAACTATGGCTACACCTTC	CASSRRDRGLQRANYGYTF	TRBV7-4	TRBJ1-2
TGCGCCAGCAGCCAAGATGAAATGGCGGGGGCCGGAGAGAGCACAGATACGCAGTATTTT	CASSQDEMAGAGESTDTQYF	TRBV4-3	TRBJ2-3
TGTGCCAGCAGAGTCCGGGACAGGGCCCGGACGGGTTTTACCGGAAGCAATCAGCCCCAGCATTTT	CASRVRDRARTGFTGSNQPQHF	TRBV7-9	TRBJ1-5
TGTGCCAGCAGCTCTGCAGGGAGGGGCGACTATAATTCACCCCTCCACTTT	CASSSAGRGDYNSPLHF	TRBV13	TRBJ1-6
TGTGCCAGCAGCTTAGGGACAGGAGGACGGAACACTGAAGCTTTCTTT	CASSLGTGGRNTEAFF	TRBV7-9	TRBJ1-1
TGTGCCAGCAGTTACACTAGCGGGAGAATATCCACCGGGGAGCTGTTTTTT	CASSYTSGRISTGELFF	TRBV6-5	TRBJ2-2
TGTGCCACCAGTGTCTCCCACCACCAAGAGACCCAGTACTTC	CATSVSHHQETQYF	TRBV24-1	TRBJ2-5
TGTGCCAGCCTAGGGTATTCAGGCTACGAGCAGTACTTC	CASLGYSGYEQYF	TRBV28	TRBJ2-7
TGCAGTGCTAGAGATAGGGAATACCCCCGGGACAGGGCTTGTTTGTACTTC	CSARDREYPRDRACLYF	TRBV20-1	TRBJ2-4
TGTGCCAGCAGTGTTGGGACCGGCCCGTACAATGAGCAGTTCTTC	CASSVGTGPYNEQFF	TRBV6-4	TRBJ2-1
TGTGCCAGCTCGCGGGAGCGCACAGATACGCAGTATTTT	CASSRERTDTQYF	TRBV18	TRBJ2-3
TGTGCCACCAGTGATTTGCAAGACAACGAGCAGTACTTC	CATSDLQDNEQYF	TRBV24-1	TRBJ2-7
TGCAGCGTAAGGGGGGCCCCACATGAGCAGTTCTTC	CSVRGAPHEQFF	TRBV29-1	TRBJ2-1
TGTGCCGAGCATTCAGGGAACTATGGCTACACCTTC	CAEHSGNYGYTF	TRBV19	TRBJ1-2
TGTGCCAGCAGTTGGGAAGGGGGGGCTCGGACGCTACGCTACAATGAGCAGTTCTTC	CASSWEGGARTLRYNEQFF	TRBV12-3	TRBJ2-1
TGTGCCAGCAACAGGACAGATTACTCTAATGAAAAACTGTTTTTT	CASNRTDYSNEKLFF	TRBV6-5	TRBJ1-4
TGTGCCAGCACGGAGGGACTAGCGGGAATGGATGGGGGGGCCTCCTACAATGAGCAGTTCTTC	CASTEGLAGMDGGASYNEQFF	TRBV5-5	TRBJ2-1
TGCGCCAGCAGCCAAGGGTTAGGGATCTACGAGCAGTACTTC	CASSQGLGIYEQYF	TRBV4-3	TRBJ2-7
TGCGCCAGCAGCCGCGCGGGAGAAACCGGGGAGCTGTTTTTT	CASSRAGETGELFF	TRBV4-1	TRBJ2-2
TGCAGTGCTAGCGGGAGACCCTACAATGAGCAGTTCTTC	CSASGRPYNEQFF	TRBV20-1	TRBJ2-1
TGCGCCAGCAGCATTGCCGCTACGGACATGGGAAACACCATATATTTT	CASSIAATDMGNTIYF	TRBV5-1	TRBJ1-3
TGTGCCAGCAGTTACACAGGCTACGAGCAGTACTTC	CASSYTGYEQYF	TRBV28	TRBJ2-7
TGTGCCAGCAGCTTGGGGTCTCGCAATGAGCAGTTCTTC	CASSLGSRNEQFF	TRBV5-5	TRBJ2-1
TGCAGCCCCACCAAGATCCGCTCCTACGAGCAGTACTTC	CSPTKIRSYEQYF	TRBV29-1	TRBJ2-7
TGTGCCAGCAGTGAGGGACAGGAGGCAGGGGCCAACGTCCTGACTTTC	CASSEGQEAGANVLTF	TRBV6-3	TRBJ2-6
TGTGCCAGCAGCCAAGCCCAACCCACGCAAGCCTTAGCCAAAAACATTCAGTACTTC	CASSQAQPTQALAKNIQYF	TRBV3-1	TRBJ2-4
TGCAGTGCTAGACCGCCCGTCCCGCATCCTTCCGGGACAGGGGAGAACACTGAAGCTTTCTTT	CSARPPVPHPSGTGENTEAFF	TRBV20-1	TRBJ1-1
TGCGCCAGCAGCCAAGAGTTGGGGCAGGCCCAGTACTTC	CASSQELGQAQYF	TRBV4-1	TRBJ2-5
TGTGCCAGCAGTGAAGCGCTTATTCCTAGACAGGGGTTGGAAAACATTCAGTACTTC	CASSEALIPRQGLENIQYF	TRBV2	TRBJ2-4
TGTGCCACCAGCAGACCCCGACAGGGGCGGTCATCCTACGAGCAGTACTTC	CATSRPRQGRSSYEQYF	TRBV15	TRBJ2-7
TGCGCCAGCAGGAACACGGCTCGGAGCCAGGACACCGGGGAGCTGTTTTTT	CASRNTARSQDTGELFF	TRBV10-1	TRBJ2-2
TGTGCCAGCAGCCCCCGACACAGGGGGCAAATCTACGAGCAGTACTTC	CASSPRHRGQIYEQYF	TRBV4-2	TRBJ2-7
TGTGCCAGCAGCGGGGCGAACACCGGGGAGCTGTTTTTT	CASSGANTGELFF	TRBV7-3	TRBJ2-2
TGTGCCAGCAGTTACTCTCCCGTAACAGATACGCAGTATTTT	CASSYSPVTDTQYF	TRBV6-2	TRBJ2-3
TGTGCCAGCAGCCCGAAATTGCCATTGGGGACTAGCGGCACAGATACGCAGTATTTT	CASSPKLPLGTSGTDTQYF	TRBV4-2	TRBJ2-3
TGCGCCAGCAAGGGAGGAAGCTCCTACGAGCAGTACTTC	CASKGGSSYEQYF	TRBV10-1	TRBJ2-7
TGTGCCAGCATCCCAACTTTACTATGGGGGTACGAGCAGTACTTC	CASIPTLLWGYEQYF	TRBV6-4	TRBJ2-7
TGTGCCAGCGGGCCAGGGACTGAAGCTTTCTTT	CASGPGTEAFF	TRBV6-5	TRBJ1-1
TGTGCCTGGAGTGTACGATACGGGCTCAGCTACAACACTGAAGCTTTCTTT	CAWSVRYGLSYNTEAFF	TRBV30	TRBJ1-1
TGTGCCAGCAGTGAAGAGGGGGAAATCTATGGCTACACCTTC	CASSEEGEIYGYTF	TRBV2	TRBJ1-2
TGTGCCACCAGTGACGTAGATTCCGGGACAGTCCTTGAGACCCAGTACTTC	CATSDVDSGTVLETQYF	TRBV24-1	TRBJ2-5
TGCGCCAGCAGTGAGCGCAGGCCGAACAATGAGCAGTTCTTC	CASSERRPNNEQFF	TRBV10-1	TRBJ2-1
TGTGCCAGCAGCTTACATGGGGTTAGCAATCAGCCCCAGCATTTT	CASSLHGVSNQPQHF	TRBV7-3	TRBJ1-5
TGTGCCAGGGACGGGACTAGGAATGAGCAGTTCTTC	CARDGTRNEQFF	TRBV9	TRBJ2-1
TGTGCCAGCAGCCAAGAAATAAAGGCCAAAAACATTCAGTACTTC	CASSQEIKAKNIQYF	TRBV14	TRBJ2-4
TGTGCCAGCGTCATCCAGCCATACTTC	CASVIQPYF	TRBV2	TRBJ2-7
TGTGCCTGGAGTTACCTTGGTCGGGCCACCTACAATGAGCAGTTCTTC	CAWSYLGRATYNEQFF	TRBV30	TRBJ2-1
TGTGCCAGCAGCGTTAACCTTTCGTCCGTGTCAATAGGACGAGATTTAAATCAGCCCCAGCATTTT	CASSVNLSSVSIGRDLNQPQHF	TRBV9	TRBJ1-5
TGTGCCAGCAGCTTAGATCTAGAAACCAATGAGCAGTTCTTC	CASSLDLETNEQFF	TRBV11-2	TRBJ2-1
TGTGCCAGCAGCCCTAAGGTACGGACGACCAGAAGATCACCTTGGAATTCACCCCTCCACTTT	CASSPKVRTTRRSPWNSPLHF	TRBV25-1	TRBJ1-6
TGTGCCACCAGTGCGGGACAGGTGCATGTCAATGAGCAGTTCTTC	CATSAGQVHVNEQFF	TRBV24-1	TRBJ2-1
TGCGCCAGCAGCCAAGATATGGGGTCCCAAAAGGAAGAGACCCAGTACTTC	CASSQDMGSQKEETQYF	TRBV4-1	TRBJ2-5
TGTGCCAGCAGGAACAGGTGTTATTCCGGGACTAGTTACAATGAGCAGTTCTTC	CASRNRCYSGTSYNEQFF	TRBV3-1	TRBJ2-1
TGTGCCAGCAGCTTAGACGACGGGGGAGCCATTCAGTACTTC	CASSLDDGGAIQYF	TRBV13	TRBJ2-4
TGCAGTGCTAGAGAAGACCCGAAAACTAGCTACGAGCAGTACTTC	CSAREDPKTSYEQYF	TRBV20-1	TRBJ2-7
TGTGCCAGCAGTGCCCCCCGGACCACGATGACAGATACGCAGTATTTT	CASSAPRTTMTDTQYF	TRBV6-3	TRBJ2-3
TGCAGTGCTAGAATGACAGGTTCCACAGATACGCAGTATTTT	CSARMTGSTDTQYF	TRBV20-1	TRBJ2-3
TGTGCCACCAGCAGAGACGGACTACTAGCATCCTACAATGAGCAGTTCTTC	CATSRDGLLASYNEQFF	TRBV15	TRBJ2-1
TGTGCCAGGGGCAGTCTTTATGGCTACACCTTC	CARGSLYGYTF	TRBV6-3	TRBJ1-2
TGTGCCAGCAGCCAAGATGAACTAGCGGGAGTCGAGTCCTACAATGAGCAGTTCTTC	CASSQDELAGVESYNEQFF	TRBV3-1	TRBJ2-1
TGTGCCAGCAGTTTAATCACGCGGTTAGACTGGGACTATGGCTACACCTTC	CASSLITRLDWDYGYTF	TRBV12-3	TRBJ1-2
TGCAGTGCTAGGTTCAGGGTACGGAGGGGCTACACCTTC	CSARFRVRRGYTF	TRBV20-1	TRBJ1-2
TGTGCCAGCAGCTTAGGACACGAGCAGTACTTC	CASSLGHEQYF	TRBV7-6	TRBJ2-7
TGTGCCCTCGGGACTAGCGGGGGCGGGGAGCTGTTTTTT	CALGTSGGGELFF	TRBV3-1	TRBJ2-2
TGTGCCAGCAGCCAAGGGGAGCCTAGCACAGATACGCAGTATTTT	CASSQGEPSTDTQYF	TRBV13	TRBJ2-3
TGTGCCACCAACCCTCCCTACGAGCAGTACTTC	CATNPPYEQYF	TRBV24-1	TRBJ2-7
TGTGCTAGTGGTTTGGGCGGGAGCTCCTACGAGCAGTACTTC	CASGLGGSSYEQYF	TRBV12-5	TRBJ2-7
TGTGCCAGCAGTTTAGGAACTCCCTACAATGAGCAGTTCTTC	CASSLGTPYNEQFF	TRBV28	TRBJ2-1
TGTGCCAGCAGCCAAGACGACCCCGGGGAGCTGTTTTTT	CASSQDDPGELFF	TRBV3-1	TRBJ2-2
TGTGCCAGCAGCTTGTCGGGACTCTATCAGCCCCAGCATTTT	CASSLSGLYQPQHF	TRBV7-9	TRBJ1-5
TGTGCCAGCACAGGGCGAATGAACACTGAAGCTTTCTTT	CASTGRMNTEAFF	TRBV6-1	TRBJ1-1
TGTGCCAGCAGTTACTCGAGGGAGCGGTTGGCGCAAGAGACCCAGTACTTC	CASSYSRERLAQETQYF	TRBV6-8	TRBJ2-5
TGTGCCAGCAGCCGGGGGGGGGCTTCGTTTTACTACGAGCAGTACTTC	CASSRGGASFYYEQYF	TRBV13	TRBJ2-7
TGTGCCAGCAGCCTTCACCATAATTGGGACAGGGGGTGGAACACTGAAGCTTTCTTT	CASSLHHNWDRGWNTEAFF	TRBV9	TRBJ1-1
TGTGCCAGCAGCTTTTCTCGACAGTGTAATCAGCCCCAGCATTTT	CASSFSRQCNQPQHF	TRBV13	TRBJ1-5
TGTGCCAGCAGTTTGATGCCGGACAGTACCTACGAGCAGTACTTC	CASSLMPDSTYEQYF	TRBV27	TRBJ2-7
TGTGCCAGCAGTTTTACGGCTGGGACAGGGACAGATACGCAGTATTTT	CASSFTAGTGTDTQYF	TRBV27	TRBJ2-3
TGTGCCAGCAGTTACGAGGGGCACTACGAGCAGTACTTC	CASSYEGHYEQYF	TRBV6-6	TRBJ2-7
TGTGCCAGCAGCTTCGCGACAGGGTACGAGCAGTACTTC	CASSFATGYEQYF	TRBV7-9	TRBJ2-7
TGCGCCAGCAGGTTCCCAAGGGCACTCAATCAGCCCCAGCATTTT	CASRFPRALNQPQHF	TRBV4-1	TRBJ1-5
TGTGCCAGTAGTATATTGGGACATTTCTACGAGCAGTACTTC	CASSILGHFYEQYF	TRBV19	TRBJ2-7
TGTGCCAGCAGCTTAGCGGGGGGAACTGAAGCTTTCTTT	CASSLAGGTEAFF	TRBV11-2	TRBJ1-1
TGCAGTGCGTTCCCTTCGGGGATTTGGAACACTGAAGCTTTCTTT	CSAFPSGIWNTEAFF	TRBV20-1	TRBJ1-1
TGTGCCTGGAGTGTTAGAAGCACTAGCGGGAGGGCCACAGATACGCAGTATTTT	CAWSVRSTSGRATDTQYF	TRBV30	TRBJ2-3
TGTGCCAGCAGCGGGACATTCGAGCAGTACTTC	CASSGTFEQYF	TRBV9	TRBJ2-7
TGTGCCAGCGGCGGGGGGGCGGGGGAAATAGCCTACGAGCAGTACTTC	CASGGGAGEIAYEQYF	TRBV9	TRBJ2-7
TGCAGCGTTGACGGACTAGCCCTCTTGCCCACAGATACGCAGTATTTT	CSVDGLALLPTDTQYF	TRBV29-1	TRBJ2-3
TGCAGATCCCAAGCAGGACTTCCCGGTAACTATGGCTACACCTTC	CRSQAGLPGNYGYTF	TRBV20-1	TRBJ1-2
TGTGCCAGCGGGGCTAGCGGAACAGGCAATGAGCAGTTCTTC	CASGASGTGNEQFF	TRBV13	TRBJ2-1
TGTGCCAGCAGCTGTCCCAGACACAGCAATCAGCCCCAGCATTTT	CASSCPRHSNQPQHF	TRBV5-6	TRBJ1-5
TGTGCCAGCAGTTTAGAAAGAGCGGGGGCGTACGAGCAGTACTTC	CASSLERAGAYEQYF	TRBV27	TRBJ2-7
TGTGCCAGCAGTATTAAGGGGGCCTACGAGCAGTACTTC	CASSIKGAYEQYF	TRBV6-2	TRBJ2-7
TGTGTCCAGGTAAGGGTCGGGCACCGGATTGAGACCCAGTACTTC	CVQVRVGHRIETQYF	TRBV19	TRBJ2-5
TGCAGTGCTCAGGATGATGGCTACACCTTC	CSAQDDGYTF	TRBV20-1	TRBJ1-2
TGTGCCAGCAGTTACTCGACGCAGTTCGACAGGGGGCGCTCTCAGCCCCAGCATTTT	CASSYSTQFDRGRSQPQHF	TRBV6-8	TRBJ1-5
TGTGCCACCAGTGATCGGTTCTACGAGCAGTACTTC	CATSDRFYEQYF	TRBV24-1	TRBJ2-7
TGCAGTGCTAGAAAAAAGGGGGGACCGTCCTACGAGCAGTACTTC	CSARKKGGPSYEQYF	TRBV20-1	TRBJ2-7
TGCGCCAGCAGTGAGATCCAGGGGTCGACCGGGGAGCTGTTTTTT	CASSEIQGSTGELFF	TRBV10-1	TRBJ2-2
TGTGCCAGCAGAAAGGACAGGGCGGGCGAGCAGTACTTC	CASRKDRAGEQYF	TRBV7-7	TRBJ2-7
TGTGCCAGCAGTGCCGGACTGGGCTACACCTTC	CASSAGLGYTF	TRBV2	TRBJ1-2
TGTGCCAGCAGTTCAGGGGGGCAGTTACTGAACACTGAAGCTTTCTTT	CASSSGGQLLNTEAFF	TRBV28	TRBJ1-1
TGTGCCAGCAGCTCCCCAGGGGGGGCCCTACGGGATGAGCAGTTCTTC	CASSSPGGALRDEQFF	TRBV7-6	TRBJ2-1
TGTGCCAGCAGCAACTCCGGGGAATACACTGAAGCTTTCTTT	CASSNSGEYTEAFF	TRBV13	TRBJ1-1
TGTGCCAGCAGCTTAAGCTATGGCCGTCCGGTACAGTACAGGCGTGGGGCCAACGTCCTGACTTTC	CASSLSYGRPVQYRRGANVLTF	TRBV7-3	TRBJ2-6
TGTGCCACCAGTGCGGAAATCGAGGTTTATAGCAATCAGCCCCAGCATTTT	CATSAEIEVYSNQPQHF	TRBV24-1	TRBJ1-5
TGTGCCAGCAGTTACTCCGGAGCAGGGACCACCACTGGTTCCTATAATTCACCCCTCCACTTT	CASSYSGAGTTTGSYNSPLHF	TRBV6-2	TRBJ1-6
TGTGAGGCGGTTAGGGGAATCGCGAACACTGAAGCTTTCTTT	CEAVRGIANTEAFF	TRBV7-9	TRBJ1-1
TGTGCCAGCATAAAGAAAAGGACTAGCGGGAATTCCTACGAGCAGTACTTC	CASIKKRTSGNSYEQYF	TRBV6-4	TRBJ2-7
TGTGCCAGCAGCTGGGGATGCAGGGGCCCTCGTGGCTACACCTTC	CASSWGCRGPRGYTF	TRBV11-3	TRBJ1-2
TGTGCCAGAGGACATTTTAATGAAAAACTGTTTTTT	CARGHFNEKLFF	TRBV6-6	TRBJ1-4
TGTGCCAGCAGTTTTCTCTCGAGAGAAACGAATTACAATGAGCAGTTCTTC	CASSFLSRETNYNEQFF	TRBV28	TRBJ2-1
TGTGCCACCAGTGATTGGACTGCCTTGTCAGATACGCAGTATTTT	CATSDWTALSDTQYF	TRBV24-1	TRBJ2-3
TGTGCCAGCAGTTTCTGGACAGGGCGGTTTAATGAAAAACTGTTTTTT	CASSFWTGRFNEKLFF	TRBV28	TRBJ1-4
TGTGCCAGCAGCCCCCCGGGACGGGACGAGCAGTACTTC	CASSPPGRDEQYF	TRBV9	TRBJ2-7
TGCATGCATCGCCCCGACTCCTACAATGAGCAGTTCTTC	CMHRPDSYNEQFF	TRBV20-1	TRBJ2-1
TGTGCTAGCAGCTTAGGTGGGGAGAGCTCTGGGGCCAACGTCCTGACTTTC	CASSLGGESSGANVLTF	TRBV7-7	TRBJ2-6
TGCGCCAGCGTATCCCGATTAGTCTACGAGCAGTACTTC	CASVSRLVYEQYF	TRBV10-1	TRBJ2-7
TGTGCCAGCAGCCCCCACACGAGTAGCAATCAGCCCCAGCATTTT	CASSPHTSSNQPQHF	TRBV7-3	TRBJ1-5
TGTGCTAGTGGTTTGGCAGGGGCAAATGAGACCCAGTACTTC	CASGLAGANETQYF	TRBV12-5	TRBJ2-5
TGTGCCACCACGCTCAGTGACACAGATACGCAGTATTTT	CATTLSDTDTQYF	TRBV24-1	TRBJ2-3
TGCGCCAGCAGCTCTCGGCTAAGTAAGGGGACGGTGTACAATGAGCAGTTCTTC	CASSSRLSKGTVYNEQFF	TRBV5-1	TRBJ2-1
TGTGCCAGCAGCTGCCAAGGGACAGGGATCCAAAACATTCAGTACTTC	CASSCQGTGIQNIQYF	TRBV7-8	TRBJ2-4
TGTGCCAGCAGCGGACTGCTCTATGGCTACACCTTC	CASSGLLYGYTF	TRBV7-7	TRBJ1-2
TGTGCCAGCAGTTTCCACTCCCGATATCGGTGGGACAATGAGCAGTTCTTC	CASSFHSRYRWDNEQFF	TRBV27	TRBJ2-1
TGCAGCGTTGACTCCCCAGCTAACTATGGCTACACCTTC	CSVDSPANYGYTF	TRBV29-1	TRBJ1-2
TGTGCCAGCAGCTTCCGGGGGCCAGGGAATCAGCCCCAGCATTTT	CASSFRGPGNQPQHF	TRBV5-5	TRBJ1-5
TGTGCCAGCAGCATGGTGGAGAATGGTTACTACGAGCAGTACTTC	CASSMVENGYYEQYF	TRBV9	TRBJ2-7
TGTGCCAGCAGCGCAGGGTTTTGTAATGAAAAACTGTTTTTT	CASSAGFCNEKLFF	TRBV9	TRBJ1-4
TGTGCCAGCAGCCCCCTCTGCCACTACAATGAGCAGTTCTTC	CASSPLCHYNEQFF	TRBV13	TRBJ2-1
TGCAAAGGTAGGCCGCAGAACGAGCAGTACTTC	CKGRPQNEQYF	TRBV29-1	TRBJ2-7
TGCAGTGCTAGACCGGGACTAGCGGCGGGCTCCTACAATGAGCAGTTCTTC	CSARPGLAAGSYNEQFF	TRBV20-1	TRBJ2-1
TGTGCCACCAGTGATCGGGCCCAGTTAGAAATCTCCTACGAGCAGTACTTC	CATSDRAQLEISYEQYF	TRBV24-1	TRBJ2-7
TGTGCCACCATTTCCGGGACAGGGTTTGAGCAGTTCTTC	CATISGTGFEQFF	TRBV24-1	TRBJ2-1
TGTGCCTGGAGTGAGGGAGGCCTGCGGGAGGCTGGCTACACCTTC	CAWSEGGLREAGYTF	TRBV30	TRBJ1-2
TGTGCCAGCAGCCAAGCCCTAGACAGGGTTGAAGTGAACACTGAAGCTTTCTTT	CASSQALDRVEVNTEAFF	TRBV4-2	TRBJ1-1
TGTGCCCTCGGGGGGACCTATGGCTACACCTTC	CALGGTYGYTF	TRBV28	TRBJ1-2
TGTGCCTGGAGTGGAGAGCGGGAATTCTACGAGCAGTACTTC	CAWSGEREFYEQYF	TRBV30	TRBJ2-7
TGTGCCACCGGGTGTAATTCACCCCTCCACTTT	CATGCNSPLHF	TRBV11-3	TRBJ1-6
TGCAGTGCTAGAGTAAGACAGGCAGAGACCCAGTACTTC	CSARVRQAETQYF	TRBV20-1	TRBJ2-5
TGTGCCAGCAGCCCTTTCCTACAGTATTACACCGGGGAGCTGTTTTTT	CASSPFLQYYTGELFF	TRBV13	TRBJ2-2
TGTGCCAGCAGTCTCTCGAAATGGCGGCTTGATACTGAAGCTTTCTTT	CASSLSKWRLDTEAFF	TRBV12-3	TRBJ1-1
TGCGCCAGCAGCTTAAGTAAGGGACAGTTCTGCTCTGGGGCCAACGTCCTGACTTTC	CASSLSKGQFCSGANVLTF	TRBV5-1	TRBJ2-6
TGTGCCAGGAGGCTCCGGGACAGGGTCGTTGAAAAACTGTTTTTT	CARRLRDRVVEKLFF	TRBV6-2	TRBJ1-4
TGTGCCAGCAGCGTAGAGTATACCTCCTACAATGAGCAGTTCTTC	CASSVEYTSYNEQFF	TRBV9	TRBJ2-1
TGTGCCAGTTCGGGACACGACCTGGAAGGACGGTATAGCAATCAGCCCCAGCATTTT	CASSGHDLEGRYSNQPQHF	TRBV19	TRBJ1-5
TGCAGTGCCCGGGGCAGAGTCTCCTACGAGCAGTACTTC	CSARGRVSYEQYF	TRBV20-1	TRBJ2-7
TGTGCCAGCAGCCCTTGGGACTGGAAGGGGGGCTACACCTTC	CASSPWDWKGGYTF	TRBV5-8	TRBJ1-2
TGTGCCAGCAGCCATAGCGGCACCGGACCCAGCAATCAGCCCCAGCATTTT	CASSHSGTGPSNQPQHF	TRBV14	TRBJ1-5
TGTGCCAGCAGCTGTGATAAGGAGCCCCAGCATTTT	CASSCDKEPQHF	TRBV5-5	TRBJ1-5
TGTGCCAGCAGCGCCGGACTAGCGGGAAAAATGCAGACCGGGGAGCTGTTTTTT	CASSAGLAGKMQTGELFF	TRBV13	TRBJ2-2
TGTGCCAGCAGCCAAGATTTAGAGAATGAGCAGTTCTTC	CASSQDLENEQFF	TRBV3-1	TRBJ2-1
TGTGCCAGCAGCTTAAGAAGGCTCGGGACAGCCGGCTACACCTTC	CASSLRRLGTAGYTF	TRBV7-3	TRBJ1-2
TGCAGTGCAAGAGAGGATGAGCAGTTCTTC	CSAREDEQFF	TRBV20-1	TRBJ2-1
TGTGCCAGCAGCCTATACCCTCACGCAGCGGGGGTCCCCTACGAGCAGTACTTC	CASSLYPHAAGVPYEQYF	TRBV3-1	TRBJ2-7
TGTGCCAGCAGCTTAGCGCCCCCCGGGGGGCGGGGCACAGATACGCAGTATTTT	CASSLAPPGGRGTDTQYF	TRBV7-9	TRBJ2-3
TGTGCCAGCAGCGGCCGGGACAGAGCTGGGGCCAACGTCCTGACTTTC	CASSGRDRAGANVLTF	TRBV7-3	TRBJ2-6
TGTGCCAGTAGACTGTTCCGCTACACCTTC	CASRLFRYTF	TRBV19	TRBJ1-2
TGCGCCAGCAGCCGATTAAGGGCCAGTGAAAAACTGTTTTTT	CASSRLRASEKLFF	TRBV4-1	TRBJ1-4
TGTGCCAGCAGCTCGGGGGCGCTTGATCAGCCCCAGCATTTT	CASSSGALDQPQHF	TRBV5-6	TRBJ1-5
TGCAGTGCTAGACCTGGGGTTTCACCCCTCCACTTT	CSARPGVSPLHF	TRBV20-1	TRBJ1-6
TGTGCCAGCAGAAGGGGTGACGGGGCTGGCTACACCTTC	CASRRGDGAGYTF	TRBV6-1	TRBJ1-2
TGTGCCAGCAGCTCAAACCGGACAGCCTATGGCTACACCTTC	CASSSNRTAYGYTF	TRBV11-2	TRBJ1-2
TGTGCCAGCAGCACTCAGAGCTTTCAGGCCTACGAGCAGTACTTC	CASSTQSFQAYEQYF	TRBV13	TRBJ2-7
TGTGCCAGCAGCTTTGAGGAGAGAACAAACCGCAATCAGCCCCAGCATTTT	CASSFEERTNRNQPQHF	TRBV7-9	TRBJ1-5
TGCAGTGCTCCCGAGACTAGCGGGGGGGCCTTCCGATATTTT	CSAPETSGGAFRYF	TRBV20-1	TRBJ2-3
TGCGCCAGCAGCTTGAATGACGAGTCGAGTGCGTTCCGTGAAAAACTGTTTTTT	CASSLNDESSAFREKLFF	TRBV5-1	TRBJ1-4
TGCAGTGCTACGGTAGTGAACCCAGGAATGAACACTGAAGCTTTCTTT	CSATVVNPGMNTEAFF	TRBV20-1	TRBJ1-1
TGCAGTGCTAGAGATGGGCGGGAGGGCCGAAAACTGTTTTTT	CSARDGREGRKLFF	TRBV20-1	TRBJ1-4
TGTGCCAGTAGTCGGGGGACGAACGAGCAGTACTTC	CASSRGTNEQYF	TRBV19	TRBJ2-7
TGTGCCTGGACACCGGACAGCGTGGGCCCAGGCAATCAGCCCCAGCATTTT	CAWTPDSVGPGNQPQHF	TRBV30	TRBJ1-5
TGTGCCAGCAGCCAAGATCGGGACAGGGAGGAAGAGACCCAGTACTTC	CASSQDRDREEETQYF	TRBV14	TRBJ2-5
TGCGCCAGCGAACCCGCCTCCGGACCCGGCCTAGCCAAAAACATTCAGTACTTC	CASEPASGPGLAKNIQYF	TRBV10-1	TRBJ2-4
TGCGCCAGCAGCAGTGAGGCCACAGATACGCAGTATTTT	CASSSEATDTQYF	TRBV5-1	TRBJ2-3
TGTGCCAGCAGCGCACTGGGCGGGACCAATGAGCAGTTCTTC	CASSALGGTNEQFF	TRBV7-9	TRBJ2-1
TGCAGCGTCCCGGGAAAACTAGCGGGAGGTCCCCCCGAGCAGTACTTC	CSVPGKLAGGPPEQYF	TRBV29-1	TRBJ2-7
TGTGCCAGCAGTCCGCGGCCAGGCGCAACTAATGAAAAACTGTTTTTT	CASSPRPGATNEKLFF	TRBV6-1	TRBJ1-4
TGCGCCAATAGGGGGAACACTGAAGCTTTCTTT	CANRGNTEAFF	TRBV5-1	TRBJ1-1
TGTGCCAGCAGCGCCCCGAAACGGACTAGCCAATCCTCCTACGAGCAGTACTTC	CASSAPKRTSQSSYEQYF	TRBV5-5	TRBJ2-7
TGTGCCAGCAGCAGATCCCTCATGAATTCCTATAATTCACCCCTCCACTTT	CASSRSLMNSYNSPLHF	TRBV5-5	TRBJ1-6
TGTGCCAGCAGCTTATCGATGACAGGGAAGGAGACCCAGTACTTC	CASSLSMTGKETQYF	TRBV7-3	TRBJ2-5
TGTGCCATCAGGAGTCATTGTGACAGAACTAGGGTTGGGGGGTGGAACACTGAAGCTTTCTTT	CAIRSHCDRTRVGGWNTEAFF	TRBV10-3	TRBJ1-1
TGTGCCAGCAGGGGGGGCAGGGTCTTTAATGAAAAACTGTTTTTT	CASRGGRVFNEKLFF	TRBV11-1	TRBJ1-4
TGCAGCCCTAGTCAAAGCGGGATCCTGAGCACAGATACGCAGTATTTT	CSPSQSGILSTDTQYF	TRBV29-1	TRBJ2-3
TGTGCCACCAGTGATTATTTGGCCTGGGAGGGCCCTCACGTGCCCCAGCATTTT	CATSDYLAWEGPHVPQHF	TRBV24-1	TRBJ1-5
TGTGCCAGCAGTGACTTAGATAGCAATCAGCCCCAGCATTTT	CASSDLDSNQPQHF	TRBV6-4	TRBJ1-5
TGTGCCATGAAAGGGGGCACTGAAGCTTTCTTT	CAMKGGTEAFF	TRBV6-4	TRBJ1-1
TGTGCCAGCAGCGGGCAGGACAGGGTAAATGAAAAACTGTTTTTT	CASSGQDRVNEKLFF	TRBV7-8	TRBJ1-4
TGTGCTAGCAGCTTACTCAAACCGGGACAGGTCCAGCAGATTCAGCCCCAGCATTTT	CASSLLKPGQVQQIQPQHF	TRBV7-7	TRBJ1-5
TGTGCCAGCACGGACATGAGGCGGGAAAAACTGTTTTTT	CASTDMRREKLFF	TRBV6-2	TRBJ1-4
TGTGCCAGCAGTTTACCTGGCGGAGGCTACACCTTC	CASSLPGGGYTF	TRBV12-3	TRBJ1-2
TGTGCCAGCATCGCCCCTGATACTAACTATGGCTACACCTTC	CASIAPDTNYGYTF	TRBV6-2	TRBJ1-2
TGTGCCAGCAGCCAAGGGGTACCCGGGACAGGGAATAGAAAACTGTTTTTT	CASSQGVPGTGNRKLFF	TRBV4-2	TRBJ1-4
TGTGCCAGCACCAGAGGGGCCTCGGTCAATGAGCAGTTCTTC	CASTRGASVNEQFF	TRBV28	TRBJ2-1
TGCAGTGCTCCTCTAGCGGGAAGACTTGAGCAGTTCTTC	CSAPLAGRLEQFF	TRBV20-1	TRBJ2-1
TGTGCCAGCAGCTCCGGAGGGGGGCCGGTTAATGAAAAACTGTTTTTT	CASSSGGGPVNEKLFF	TRBV7-3	TRBJ1-4
TGTGCCAGCAGTTGGACAGGGGTTAGGAACACCGGGGAGCTGTTTTTT	CASSWTGVRNTGELFF	TRBV27	TRBJ2-2
TGCGCCAGCAGCGCGACTAGGGACAGGGTAGCCGGCAGGGACACGTCACCCCTCCACTTT	CASSATRDRVAGRDTSPLHF	TRBV5-1	TRBJ1-6
TGTGCCAGCAGTAGTAGGGGGGGTACAGACGAGCAGTACTTC	CASSSRGGTDEQYF	TRBV12-3	TRBJ2-7
TGTGCCAGCAGCCAAGATCGGAAGCCGGCCGTGACCGGGAACACCGGGGAGCTGTTTTTT	CASSQDRKPAVTGNTGELFF	TRBV14	TRBJ2-2
TGTGCCAGCAGCCAAGTCCTCGGACCCATAGCTCGGTTCGTCCCCTCTGGAAACACCATATATTTT	CASSQVLGPIARFVPSGNTIYF	TRBV14	TRBJ1-3
TGTGCCAGCACAGGGGCTAACTATGGCTACACCTTC	CASTGANYGYTF	TRBV11-2	TRBJ1-2
TGCGCCAAGGGGGGGCGCAATCAGCCCCAGCATTTT	CAKGGRNQPQHF	TRBV5-1	TRBJ1-5
TGTTGTGAGGGGGACATAGCTCGGGGCAGGAAAGATACGCAGTATTTT	CCEGDIARGRKDTQYF	TRBV27	TRBJ2-3
TGTGCCAGCGTCCAGGGACAGGGAAAGTTGGGCTACACCTTC	CASVQGQGKLGYTF	TRBV6-4	TRBJ1-2
TGTGCCAGCAGCAATCTTAGGATCACTGAAGCTTTCTTT	CASSNLRITEAFF	TRBV13	TRBJ1-1
TGTGCCAGCACCAGGTCAATGGACAGGCCCGATCCCAGCTCCTATAATTCACCCCTCCACTTT	CASTRSMDRPDPSSYNSPLHF	TRBV27	TRBJ1-6
TGTGCCAGCAGCTTAGTTCCCCTACATCAGCCCCAGCATTTT	CASSLVPLHQPQHF	TRBV11-3	TRBJ1-5
TGTGCCAGCAGTTACGGGACTAGCGGCTATGAGCAGTTCTTC	CASSYGTSGYEQFF	TRBV6-5	TRBJ2-1
TGTGCCAGCAGTGCACAGGGGGATCTGACTTTC	CASSAQGDLTF	TRBV12-4	TRBJ2-6
TGCAGTGCCGCGGTAACTAGCGGGAGCCTAGCCTACAATGAGCAGTTCTTC	CSAAVTSGSLAYNEQFF	TRBV20-1	TRBJ2-1
TGCGCCAGCAGCCTTGATCCCGTAGGGGGGCCGGACGAGCAGTACTTC	CASSLDPVGGPDEQYF	TRBV5-1	TRBJ2-7
TGTGCCAGCAGCTTAGACTTAGAGACAGCCACCGGGGAGCTGTTTTTT	CASSLDLETATGELFF	TRBV7-4	TRBJ2-2
TGTGCCTGGAATAGCGGGGAGCTGTTTTTT	CAWNSGELFF	TRBV30	TRBJ2-2
TGTGCCACCGGGGGCTATCTAGCCAAAAACATTCAGTACTTC	CATGGYLAKNIQYF	TRBV6-4	TRBJ2-4
TGCGCCAGCCTTGTCGCGGGAGGGCCCTTCTACGAGCAGTACTTC	CASLVAGGPFYEQYF	TRBV10-1	TRBJ2-7
TGTGCCAGCAGCTCCCCCCTAAGCGATCAGCCCCAGCATTTT	CASSSPLSDQPQHF	TRBV11-2	TRBJ1-5
TGTGCCAGCAATTTGGGACTGGATGAGCAGTTCTTC	CASNLGLDEQFF	TRBV7-9	TRBJ2-1
TGTGCCAGCAGGAAACCAGGAGTGTGCACAGATACGCAGTATTTT	CASRKPGVCTDTQYF	TRBV11-2	TRBJ2-3
TGTGCCATCAGTGAGTCGGAGGTGCTCACAGGGTTTGCAGCTTTCTTT	CAISESEVLTGFAAFF	TRBV10-3	TRBJ1-1
TGTGCCAGTAGTATAGGATCGGATTATCCTGAAAAACTGTTTTTT	CASSIGSDYPEKLFF	TRBV19	TRBJ1-4
TGTGCCAGCAGCGACAGGCGTGACGAGCAGTACTTC	CASSDRRDEQYF	TRBV7-9	TRBJ2-7
TGTGCCAGCAGTTTAAATGACAGGAGCGCTGAAGCTTTCTTT	CASSLNDRSAEAFF	TRBV12-4	TRBJ1-1
TGTGCCAGCAGCCATACAGGGACCAGAATGAACACTGAAGCTTTCTTT	CASSHTGTRMNTEAFF	TRBV2	TRBJ1-1
TGTGCCATCTATCAGGGCTTGTGCTACGAGCAGTACTTC	CAIYQGLCYEQYF	TRBV10-3	TRBJ2-7
TGTGCCAGCAGGTTTGCTACTAGCGGGAGCTACGAGCAGTACTTC	CASRFATSGSYEQYF	TRBV28	TRBJ2-7
TGTGCCAGCAGCTTCCGGGGGGTCTTCGAGCAGTACTTC	CASSFRGVFEQYF	TRBV7-3	TRBJ2-7
TGTGCCAGCAGTTTAGCAAAAGGACAGGCTGGGGCTGAAGCTTTCTTT	CASSLAKGQAGAEAFF	TRBV12-4	TRBJ1-1
TGTGCCAGCAGCCAATGTGGGGCAAGCTGTGAAGATAACACCGGGGAGCTGTTTTTT	CASSQCGASCEDNTGELFF	TRBV3-1	TRBJ2-2
TGTGCCTTCGGGGACAGGGAGGATAGCTCCTACGAGCAGTACTTC	CAFGDREDSSYEQYF	TRBV30	TRBJ2-7
TGTGCCAGGTCGATCAGCGGACCGCCTGGCTACACCTTC	CARSISGPPGYTF	TRBV19	TRBJ1-2
TGTGCCCCGAGGGACAGCTACGAGCAGTACTTC	CAPRDSYEQYF	TRBV25-1	TRBJ2-7
TGTGCCAGCAAGGTTCTGGAACTAGAGACCCAGTACTTC	CASKVLELETQYF	TRBV6-1	TRBJ2-5
TGTGCCAGCAGTTTTCCCGGGACTAGGACCACCGGGGAGCTGTTTTTT	CASSFPGTRTTGELFF	TRBV27	TRBJ2-2
TGTGCCAAGAAGGCAGAGACCCAGTACTTC	CAKKAETQYF	TRBV19	TRBJ2-5
TGTGCCAGCAGCTTGGGGGACAGGGGAAAAAACTATGGCTACACCTTC	CASSLGDRGKNYGYTF	TRBV11-3	TRBJ1-2
TGTGCCAGCAGTGAAGATCCAATCACGGACAGGCTGAACACTGAAGCTTTCTTT	CASSEDPITDRLNTEAFF	TRBV6-1	TRBJ1-1
TGTGCCAGTACCCCCCTTGGAAGGGAATGGTGCACTGAAGCTTTCTTT	CASTPLGREWCTEAFF	TRBV19	TRBJ1-1
TGCAGCGTCCGTCGACCCGGACGGCGTCAGCCCCAGCATTTT	CSVRRPGRRQPQHF	TRBV29-1	TRBJ1-5
TGTGCCAGCACAGGGGGGATTAACACTGAAGCTTTCTTT	CASTGGINTEAFF	TRBV5-5	TRBJ1-1
TGCAGTGCTAGAGAGGGGGGCACAGATACGCAGTATTTT	CSAREGGTDTQYF	TRBV20-1	TRBJ2-3
TGTGCCAGCAGTTATCCCCTTGGATCAACTAGCGGCCTGGCATACAATGAGCAGTTCTTC	CASSYPLGSTSGLAYNEQFF	TRBV6-5	TRBJ2-1
TGTGCCAGCAGCCAGACAGGGTTGGTCAAAGCTTTCTTT	CASSQTGLVKAFF	TRBV9	TRBJ1-1
TGTGCCAGCAGCAGGAAGGGGTATCGTGAGTACTTC	CASSRKGYREYF	TRBV9	TRBJ2-7
TGTGCCAGCAGCATTCAAGGGGCGGAAATTCAGCCCCAGCATTTT	CASSIQGAEIQPQHF	TRBV9	TRBJ1-5
TGTGCCATCCTCTTCGATACCAAGGGCCGGGGGAGGCCGTATAACACCGGGGAGCTGTTTTTT	CAILFDTKGRGRPYNTGELFF	TRBV10-3	TRBJ2-2
TGTGCCAGCATACCGGACAGGAGGACTGCCGGGGAGCTGTTTTTT	CASIPDRRTAGELFF	TRBV9	TRBJ2-2
TGTGCCAGCAGTGACAGTGCCTACGAGCAGTACTTC	CASSDSAYEQYF	TRBV6-4	TRBJ2-7
TGTGCCAGGGTGGTACGACAAGAGACCCAGTACTTC	CARVVRQETQYF	TRBV24-1	TRBJ2-5
TGTGCCAGCAGTGACAGGCCCGCTATAGGAACCAAAGACGAGCAGTACTTC	CASSDRPAIGTKDEQYF	TRBV6-4	TRBJ2-7
TGTGCCAGCAGTTACTCTATCTCAGGGGGAGGGATCTTT	CASSYSISGGGIF	TRBV6-3	TRBJ1-1
TGTGCCAGCAGCCCCGGACGATACGAGCAGTACTTC	CASSPGRYEQYF	TRBV7-9	TRBJ2-7
TGCAGCGTTGAAGGTTCAGGGATGCTCAACTATGGCTACACCTTC	CSVEGSGMLNYGYTF	TRBV29-1	TRBJ1-2
TGTGCCAGCAGTGCGGACGGGGCCCAGTACTTC	CASSADGAQYF	TRBV6-1	TRBJ2-5
TGTGCCAGCAGCCCCAGACAGGGGTTGGGACATCAGCCCCAGCATTTT	CASSPRQGLGHQPQHF	TRBV7-2	TRBJ1-5
TGCAGTGCAACCGGGGGCGAGCAGTACTTC	CSATGGEQYF	TRBV20-1	TRBJ2-7
TGTGCCAGCAGTGAGGGGGCTGACAGGGGTCCCGGGGAGCTGTTTTTT	CASSEGADRGPGELFF	TRBV6-4	TRBJ2-2
TGCAGCGCAAGCGAAACTAGCCCTCAGGGCAACACTGAAGCTTTCTTT	CSASETSPQGNTEAFF	TRBV29-1	TRBJ1-1
TGTGCCAGCAGTGAATATAGAGCAACGATAGGGTCTGAGAATCAGCCCCAGCATTTT	CASSEYRATIGSENQPQHF	TRBV25-1	TRBJ1-5
TGTGCTAGTGGTTCCTACAGGGGGAATAACTATGGCTACACCTTC	CASGSYRGNNYGYTF	TRBV12-5	TRBJ1-2
TGTGCCAGCAGTGAACCCCGGGACAATGAGCAGTTCTTC	CASSEPRDNEQFF	TRBV6-3	TRBJ2-1
TGTGCCAGCAGCTTTACTGTCTACAATGAGCAGTTCTTC	CASSFTVYNEQFF	TRBV7-2	TRBJ2-1
TGCGCCAGCAGCCGGACAGGGGAGCAGTTCTTC	CASSRTGEQFF	TRBV4-1	TRBJ2-1
TGCAGTGCTAGAGAGACCTGGGGGACAGATGGAAGGGACCGTCAGCCCCAGCATTTT	CSARETWGTDGRDRQPQHF	TRBV20-1	TRBJ1-5
TGTGCCAGCAGCTTGATTCCAGGGCGGCCGGCAGGGAGCAGTAGATACGAGCAGTACTTC	CASSLIPGRPAGSSRYEQYF	TRBV5-6	TRBJ2-7
TGCGCCGATGATAAAATTGAAGGGCCCTATGGCTACACCTTC	CADDKIEGPYGYTF	TRBV10-1	TRBJ1-2
TGCGCCAGCAGCCACCACAGGGAGGGGGTCTCAGATACGCAGTATTTT	CASSHHREGVSDTQYF	TRBV4-1	TRBJ2-3
TGTGCCAGCCTACAGGTGCTCACCGTGAACACTGAAGCTTTCTTT	CASLQVLTVNTEAFF	TRBV11-3	TRBJ1-1
TGTGCCAGCAGCCAAGATCTAGCGGGAGGCGAAGATACGCAGTATTTT	CASSQDLAGGEDTQYF	TRBV3-1	TRBJ2-3
TGTGCCAGCAGCTTAACTGTGTTCTGGGGCTACACCTTC	CASSLTVFWGYTF	TRBV7-3	TRBJ1-2
TGTGCCACCAGTGATTCGACCCGACAGGGACTATGTACAGGCTACACCTTC	CATSDSTRQGLCTGYTF	TRBV24-1	TRBJ1-2
TGCGCCAGCAGCCCCCCAGACAGAGATAGCACAGATACGCAGTATTTT	CASSPPDRDSTDTQYF	TRBV5-1	TRBJ2-3
TGTGCCACGCGCCTACCAACCGGGACTCGGGTCCGAATCTCCTACGAGCAGTACTTC	CATRLPTGTRVRISYEQYF	TRBV6-1	TRBJ2-7
TGCAGTGCTAGAGCACCCCTGGGGGAGGGAGCTTTCTTT	CSARAPLGEGAFF	TRBV20-1	TRBJ1-1
TGTGCCAGCACGTCAGGTCTATCGAACACCGGGGAGCTGTTTTTT	CASTSGLSNTGELFF	TRBV2	TRBJ2-2
TGTGCCAGCAGTGCACTAGGGGTAAATGAAAAACTGTTTTTT	CASSALGVNEKLFF	TRBV25-1	TRBJ1-4
TGTGCCAGCAGCAGCAAACAGGGAGCTTTCTTT	CASSSKQGAFF	TRBV5-5	TRBJ1-1
TGTGCCAGCAGCTCAGGGAACTATGGCTACACCTTC	CASSSGNYGYTF	TRBV5-8	TRBJ1-2
TGTGCCACCAGCAGCCGGCCGGGACGGGGAGATACGCAGTATTTT	CATSSRPGRGDTQYF	TRBV15	TRBJ2-3
TGTGCCAGCAGTGAGGAAAGGGGGTACACTGAAGCTTTCTTT	CASSEERGYTEAFF	TRBV25-1	TRBJ1-1
TGTGCCAGCAGTGAAGGGAGTACCGGTATAACGGGGGGCCGGACCTTTAAGGTCGAGCAGTACTTC	CASSEGSTGITGGRTFKVEQYF	TRBV6-1	TRBJ2-7
TGTGCCAGGAGTGGTTTAGGGCACGAGCAGTACTTC	CARSGLGHEQYF	TRBV6-3	TRBJ2-7
TGTGCCAGTTCGGGGGGCAAGAAGGATGGCTACACCTTC	CASSGGKKDGYTF	TRBV9	TRBJ1-2
TGTGCCAGCCGGATAGCCAACACCGGGGAGCTGTTTTTT	CASRIANTGELFF	TRBV7-6	TRBJ2-2
TGTGCCAGCAGCATATCGTCGAACACCGGGGAGCTGTTTTTT	CASSISSNTGELFF	TRBV6-1	TRBJ2-2
TGTGCCAGCAGTTTCCTTGGGGACACTGGGATTTACAAAAACATTCAGTACTTC	CASSFLGDTGIYKNIQYF	TRBV12-4	TRBJ2-4
TGTGCCAGCAGGGGTGCTAGAGGAGAGGCTGAGCAGTTCTTC	CASRGARGEAEQFF	TRBV25-1	TRBJ2-1
TGTGCCAGCAGCCAAGATGGAGGCGGGGAGCTGTTTTTT	CASSQDGGGELFF	TRBV4-2	TRBJ2-2
TGTGCCAGCAGCTTAGCGCTTGCAAGCGGGAGTTGTTACAATGAGCAGTTCTTC	CASSLALASGSCYNEQFF	TRBV7-9	TRBJ2-1
TGTGCCAGCAGCTCCGTTCAGGGCGGGGGGGGCAATCAGCCCCAGCATTTT	CASSSVQGGGGNQPQHF	TRBV5-6	TRBJ1-5
TGTGCCAGCAGCCGCGAGAGGGGGCACGCTTGGTTCGAAAAACTGTTTTTT	CASSRERGHAWFEKLFF	TRBV6-4	TRBJ1-4
TGTGCTAGTGGTTTCCGGGGTAAAAGCTATGGCTACACCTTC	CASGFRGKSYGYTF	TRBV12-5	TRBJ1-2
TGTGCCAGTAGTAAAGGCGGCGGCTACACCTTC	CASSKGGGYTF	TRBV19	TRBJ1-2
TGTGCCAGCAGCGTAGGCTCCTTCAGGAGAAGGAACACTGAAGCTTTCTTT	CASSVGSFRRRNTEAFF	TRBV9	TRBJ1-1
TGTGCCAGCAGTGAACCAACAGGTTGGCCTAACTATGGCTACACCTTC	CASSEPTGWPNYGYTF	TRBV6-1	TRBJ1-2
TGTGCCAGCAGTTATGCTTTGCGGGGATTGGCCCCCAGCACAGATACGCAGTATTTT	CASSYALRGLAPSTDTQYF	TRBV6-5	TRBJ2-3
TGTGCCAGCAGTGAATTCCAGAGGGGGAACATTCAGTACTTC	CASSEFQRGNIQYF	TRBV25-1	TRBJ2-4
TGTGCCAGCAGCAACTCGAGCGTAGCCATTGCTGGGGGCACAGATACGCAGTATTTT	CASSNSSVAIAGGTDTQYF	TRBV5-6	TRBJ2-3
TGCGCCAGCACCTCGGCTGGACAGAAGGATAGCAATCAGCCCCAGCATTTT	CASTSAGQKDSNQPQHF	TRBV10-1	TRBJ1-5
TGTGCCAGCAGCTCCAAGGGGACAGGGGGCGGGGCCTACGAGCAGTACTTC	CASSSKGTGGGAYEQYF	TRBV11-3	TRBJ2-7
TGTGCCACCAGTGATTTGAAAAGTCTTGGGGGCATAGATGAGCAGTTCTTC	CATSDLKSLGGIDEQFF	TRBV24-1	TRBJ2-1
TGTGCCAGCAGGTACGCGGGACAGGGTGTTTACGAGCAGTACTTC	CASRYAGQGVYEQYF	TRBV2	TRBJ2-7
TGTGCCAGCAGTAAGGCCGGACAGGGGGCGGGAACCGGGGAGCTGTTTTTT	CASSKAGQGAGTGELFF	TRBV6-5	TRBJ2-2
TGCGCCAGCACGTCCCCAACTTCAGGGAGTGGAAACACCATATATTTT	CASTSPTSGSGNTIYF	TRBV10-2	TRBJ1-3
TGTGCCAGCAGTTTATCCGGGACGCCGAACACTGAAGCTTTCTTT	CASSLSGTPNTEAFF	TRBV28	TRBJ1-1
TGTGCCAGCAGCTTAGGGAACAGGGGGCGTAGACAGCATTTT	CASSLGNRGRRQHF	TRBV7-2	TRBJ1-5
TGTGCCAGCAGCTTGGACGCCCCAGGGGCCGGTGGAGGTAATGAAAAACTGTTTTTT	CASSLDAPGAGGGNEKLFF	TRBV5-4	TRBJ1-4
TGTGCCATCAGACTGAGCTACGTCGGTAGGGTTACCGCTTTCTTT	CAIRLSYVGRVTAFF	TRBV10-3	TRBJ1-1
TGCAGCGCCCGGGGGGGGGGTGGCTACACCTTC	CSARGGGGYTF	TRBV29-1	TRBJ1-2
TGCGCCAGCAGCCTATCGGCAGGCGAGCAGTACTTC	CASSLSAGEQYF	TRBV10-1	TRBJ2-7
TGTGCCAGCAGTTCAACTAGTCTAGCCGGGGAGCTGTTTTTT	CASSSTSLAGELFF	TRBV6-2	TRBJ2-2
TGCAGTGCTAGACCCCCCACTAGCGGGAGAACGCAAGAGACCCAGTACTTC	CSARPPTSGRTQETQYF	TRBV20-1	TRBJ2-5
TGTGCCAGCAGTTACTCGAAACCTCGGGGGTGTCAGCAGTTCTTC	CASSYSKPRGCQQFF	TRBV6-5	TRBJ2-1
TGTGCCAGCAGTGAAAATGGGGACACCTCTCACTATGGCTACACCTTC	CASSENGDTSHYGYTF	TRBV6-1	TRBJ1-2
TGTGCCAGCAGCGACTCCTCGACATGGCGGGGTAACTATGGCTACACCTTC	CASSDSSTWRGNYGYTF	TRBV11-2	TRBJ1-2
TGTGCCAGCAGCTTGGGGGCACAGGGAGCCAATGAGCAGTTCTTC	CASSLGAQGANEQFF	TRBV5-6	TRBJ2-1
TGTGCCATCACAGACAGACAAGCTGAAGCTTTCTTT	CAITDRQAEAFF	TRBV10-3	TRBJ1-1
TGCGCCAGCAGCTGGGGGGTCTACACTGAAGCTTTCTTT	CASSWGVYTEAFF	TRBV5-1	TRBJ1-1
TGTGCCAGCAGCTTAAAGGGGTGTGGGTCGTCCTACGAGCAGTACTTC	CASSLKGCGSSYEQYF	TRBV7-6	TRBJ2-7
TGTGCCGCTGGGACAGGGCTCCCCCGAAGAGACTACGAGCAGTACTTC	CAAGTGLPRRDYEQYF	TRBV30	TRBJ2-7
TGTGCCAGCAAAGGGACTAGCGGGGACGAGCAGTACTTC	CASKGTSGDEQYF	TRBV7-8	TRBJ2-7
TGTGCCAGCAGCTTAGTCGGACTAGCGGCCGGGAAAGGCTACGAGCAGTACTTC	CASSLVGLAAGKGYEQYF	TRBV7-8	TRBJ2-7
TGTGCCAGAGAGTCCGGGGGCCACGAGCAGTACTTC	CARESGGHEQYF	TRBV27	TRBJ2-7
TGCGCCAGCTCCGGGACAGGGGTTGCAACTAATGAAAAACTGTTTTTT	CASSGTGVATNEKLFF	TRBV5-1	TRBJ1-4
TGCAGTGCTAGTCGAGACAGGGAAAAACTGTTTTTT	CSASRDREKLFF	TRBV20-1	TRBJ1-4
TGCGCCAGCAGCGTAGACAGGGTTGGCTACACCTTC	CASSVDRVGYTF	TRBV5-1	TRBJ1-2
TGTGCCAGCAGCCAAGAAGCAGGGGTGACTGAAGCTTTCTTT	CASSQEAGVTEAFF	TRBV4-2	TRBJ1-1
TGCGCCAGCAGCTTGCGGACAGGGGCCGCTTGTCACACTGAAGCTTTCTTT	CASSLRTGAACHTEAFF	TRBV5-1	TRBJ1-1
TGCGCCAGCAGCACGAGCTATTCCGTGGAGCAGTACTTC	CASSTSYSVEQYF	TRBV5-1	TRBJ2-7
TGTGCCAGCAGCGGGAGACAAGGGACCCCTAGGGAGCAGTACTTC	CASSGRQGTPREQYF	TRBV13	TRBJ2-7
TGTGCCTGGAGTGCGCCGCCGGGACAGTATAGCAATCAGCCCCAGCATTTT	CAWSAPPGQYSNQPQHF	TRBV30	TRBJ1-5
TGCGCCAGCAGCCAAGATGGGGGGAACGGGGAGCTGTTTTTT	CASSQDGGNGELFF	TRBV4-1	TRBJ2-2
TGCAGTGCGCATACCCAGTACTTC	CSAHTQYF	TRBV20-1	TRBJ2-5
TGTGCCAGCAGTTTAGCCCCCCAGGAGCAGTACTTC	CASSLAPQEQYF	TRBV12-3	TRBJ2-7
TGTGCCAGCACCCCGGGGGAACTAAGCTCCTACGAGCAGTACTTC	CASTPGELSSYEQYF	TRBV6-1	TRBJ2-7
TGTGCCAGCAGCGGTCCTGAGCGGGAGGTCGAGCAGTACTTC	CASSGPEREVEQYF	TRBV9	TRBJ2-7
TGCAGCGTTGTACCGGGCAGGGACCGATACACAGATACGCAGTATTTT	CSVVPGRDRYTDTQYF	TRBV29-1	TRBJ2-3
TGTGCCAGCAGCGTAGGCCGGGACAGCGCCACAGATACGCAGTATTTT	CASSVGRDSATDTQYF	TRBV9	TRBJ2-3
TGTGCCAGTACCCCACTAGCGGGAGGGGAGTTTGGAGTGCAAGAGACCCAGTACTTC	CASTPLAGGEFGVQETQYF	TRBV19	TRBJ2-5
TGTGCCAGCAGTTTATACCTAGGCTACGAGCAGTACTTC	CASSLYLGYEQYF	TRBV27	TRBJ2-7
TGCAGTGCTAGTACAGGGCGATCCTACGAGCAGTACTTC	CSASTGRSYEQYF	TRBV20-1	TRBJ2-7
TGTGCCAGCAACCCTTCTAAACAGGGCGGTTATTTT	CASNPSKQGGYF	TRBV6-1	TRBJ1-3
TGTGCCATCAGTGGAGAAGGGGGAATGAAGAGGGGCTACGAGCAGTACTTC	CAISGEGGMKRGYEQYF	TRBV10-3	TRBJ2-7
TGTGCCAGCAGCCGGAGGGCCAGGACCTATAATTCACCCCTCCACTTT	CASSRRARTYNSPLHF	TRBV13	TRBJ1-6
TGTGCCAGCAGCCGCCCAGTCGTTCCGGGGAAGACTGAAGCTTTCTTT	CASSRPVVPGKTEAFF	TRBV5-5	TRBJ1-1
TGTGCCAGCAGAATGGGGGTCCCAGATACGCAGTATTTT	CASRMGVPDTQYF	TRBV6-2	TRBJ2-3
TGTGCCAGCAGAGTCACGGAGGGGGGACATGAGCAGTTCTTC	CASRVTEGGHEQFF	TRBV7-9	TRBJ2-1
TGTGCCAGCACGGGAAACCTTGAAGCTTTCTTT	CASTGNLEAFF	TRBV6-4	TRBJ1-1
TGTGCCAGCAGTAACATGGGGGCGAATGGCTACACCTTC	CASSNMGANGYTF	TRBV28	TRBJ1-2
TGTGCCAGCAGCCCCCTTCCCGGGGAAGCCGGGGAGCTGTTTTTT	CASSPLPGEAGELFF	TRBV14	TRBJ2-2
TGTGCCAGCAGCTGCGGGGCTCCGGGAGGCGTTTGGGGAAACACCATATATTTT	CASSCGAPGGVWGNTIYF	TRBV7-3	TRBJ1-3
TGTGCCAGCAGCAGGAGAGACAGGTATAGCAATCAGCCCCAGCATTTT	CASSRRDRYSNQPQHF	TRBV11-3	TRBJ1-5
TGTGCCAGCAGTTTACCACAGGGGTCCTGGGCCTACGAGCAGTACTTC	CASSLPQGSWAYEQYF	TRBV28	TRBJ2-7
TGTGCCAGCAGCTTGGCAGGCGGGAGGTATCAGGTCGAGTATAGCAATCAGCCCCAGCATTTT	CASSLAGGRYQVEYSNQPQHF	TRBV5-4	TRBJ1-5
TGTGCCACCCAGGCAAGGAGCAATCAGCCCCAGCATTTT	CATQARSNQPQHF	TRBV24-1	TRBJ1-5
TGTGCCAGCAGGGACAGGGGGATATTGGGGGCCAACGTCCTGACTTTC	CASRDRGILGANVLTF	TRBV12-4	TRBJ2-6
TGTGCCAGACCAACAGGAATGCCCCAGCATTTT	CARPTGMPQHF	TRBV13	TRBJ1-5
TGTGCCAGCAGGTTTGAGGTGGGTTACAATGAGCAGTTCTTC	CASRFEVGYNEQFF	TRBV11-3	TRBJ2-1
TGTGCCAGCAGCGTCCGGGGGTATCAGCCCCAGCATTTT	CASSVRGYQPQHF	TRBV7-3	TRBJ1-5
TGCAGTGCCCAAACGGGACATGTCGAACAAGAGACCCAGTACTTC	CSAQTGHVEQETQYF	TRBV20-1	TRBJ2-5
TGCGCCAGCCCCTATCCTCCCAACAGGGTTACGCTCCAAGAGACCCAGTACTTC	CASPYPPNRVTLQETQYF	TRBV10-1	TRBJ2-5
TGCGCCAGCAGCACCGGCTGGGATCTAGAGACCCAGTACTTC	CASSTGWDLETQYF	TRBV5-1	TRBJ2-5
TGCGCCAGCAGTGAGGGGTCAGACACGGAGACCCAGTACTTC	CASSEGSDTETQYF	TRBV10-1	TRBJ2-5
TGTGCCAGCAGTTTACTACTGTTAGGAAACACCATATATTTT	CASSLLLLGNTIYF	TRBV27	TRBJ1-3
TGTGCCAGCAGTTTAGGCAGGAGGCATTCCTCCTACAATGAGCAGTTCTTC	CASSLGRRHSSYNEQFF	TRBV27	TRBJ2-1
TGCAGTGCATCGGGGGCGGCCGCCGAGCAGTACTTC	CSASGAAAEQYF	TRBV20-1	TRBJ2-7
TGTGCCAGTAGTACTACTTCAGGGGGCTCCTACGAGCAGTACTTC	CASSTTSGGSYEQYF	TRBV19	TRBJ2-7
TGTGCCAGCAGTTTAACCCTTGGGAGGCGGTGCTGGTCCGGGGAGCTGTTTTTT	CASSLTLGRRCWSGELFF	TRBV27	TRBJ2-2
TGTGCCAGCAGCCGGGGACAGGAAAGGGATCAGCCCCAGCATTTT	CASSRGQERDQPQHF	TRBV7-3	TRBJ1-5
TGCGCCAGCAGCGATCCCCCGGTAACTGGGGCCAACGTCCTGACTTTC	CASSDPPVTGANVLTF	TRBV4-3	TRBJ2-6
TGTGCCAGCAGTGACCGGACTAGCGGACACAATGAGCAGTTCTTC	CASSDRTSGHNEQFF	TRBV6-4	TRBJ2-1
TGCGCCAGCAGCTCCGGCCGACTAGCGGGTGCTCCCGCCAATGAGCAGTTCTTC	CASSSGRLAGAPANEQFF	TRBV5-1	TRBJ2-1
TGTGCCAGCAGTTCGCAGGGGGTTCGCAATCAGCCCCAGCATTTT	CASSSQGVRNQPQHF	TRBV6-1	TRBJ1-5
TGCGCCAGCAGCTCCCAGATAGCTAACTATGGCTACACCTTC	CASSSQIANYGYTF	TRBV5-1	TRBJ1-2
TGTGCCAGCAGCCGGGACGGGATACTAAGCTATGGCTACACCTTC	CASSRDGILSYGYTF	TRBV5-6	TRBJ1-2
TGTGCCAGCAGTTTAACACCGAGGACGACTAACTATGGCTACACCTTC	CASSLTPRTTNYGYTF	TRBV27	TRBJ1-2
TGTGCCAGCAGCTTAAATAGGGGGGACTATGGCTACACCTTC	CASSLNRGDYGYTF	TRBV7-9	TRBJ1-2
TGTGCCAGCAGCGGGACCGGGACTAGCGGGAGTACAGCTTTCTTT	CASSGTGTSGSTAFF	TRBV13	TRBJ1-1
TGCACCTTACGGGGGGGAGCTTCGTCAGATACGCAGTATTTT	CTLRGGASSDTQYF	TRBV20-1	TRBJ2-3
TGTGCCAGCAGTGACGGGGCGGGCAATCAGCCCCAGCATTTT	CASSDGAGNQPQHF	TRBV2	TRBJ1-5
TGCGCCAGCAGCTTTTTGGGATGCACCGGGGAGCTGTTTTTT	CASSFLGCTGELFF	TRBV5-1	TRBJ2-2
TGCGCCAGCAGCCAAGACCCTAGCGGGCGCCCGGCTTACGAGCAGTACTTC	CASSQDPSGRPAYEQYF	TRBV4-1	TRBJ2-7
TGCAGTGCTAGACATAAGGTGAACACTGAAGCTTTCTTT	CSARHKVNTEAFF	TRBV20-1	TRBJ1-1
TGTGCCAGCAGTTTAAAAAGGGCGGGACCCCCCGCGGGTCGTGAAAAACTGTTTTTT	CASSLKRAGPPAGREKLFF	TRBV27	TRBJ1-4
TGTGCCAGCAGCTTGGACAGGGCTGGACCCGCGAACACTGAAGCTTTCTTT	CASSLDRAGPANTEAFF	TRBV5-5	TRBJ1-1
TGTGCCAGCAGCGGCTTTACTCAGCCCCAGCATTTT	CASSGFTQPQHF	TRBV13	TRBJ1-5
TGTGCCAGCAGCTTAGATCTTCACGGGGGCGATACGCAGTATTTT	CASSLDLHGGDTQYF	TRBV7-8	TRBJ2-3
TGCGCCAGCAGGAACGGGGGCTATGGCTACACCTTC	CASRNGGYGYTF	TRBV10-2	TRBJ1-2
TGTGCCAGCTCACCAAACCCCTTTACAGGGGCCCAGCAGTACTTC	CASSPNPFTGAQQYF	TRBV18	TRBJ2-7
TGTGCCATTTTGGGGGGGGTCTCCTACGAGCAGTACTTC	CAILGGVSYEQYF	TRBV12-3	TRBJ2-7
TGTGCCAGTAGTGCCGACAGGGCGACTGAAGCTTTCTTT	CASSADRATEAFF	TRBV19	TRBJ1-1
TGTGCCAGCAGCTCCAGGAGACCTTGCAGGGGGGGCAGCTCCTACAATGAGCAGTTCTTC	CASSSRRPCRGGSSYNEQFF	TRBV7-8	TRBJ2-1
TGTGCCAGCAGCTTAGGGAATAGGGGTAGCTACGAGCAGTACTTC	CASSLGNRGSYEQYF	TRBV11-3	TRBJ2-7
TGTGCCAGCAGACCGGGGGGAGACACCGGGGAGCTGTTTTTT	CASRPGGDTGELFF	TRBV6-1	TRBJ2-2
TGTGCCAGCAAGTACAGCGTTAACTATGGCTACACCTTC	CASKYSVNYGYTF	TRBV6-4	TRBJ1-2
TGTGCCAGCAGCGGGGTCCAGGGACAGGGCACAAGCTCCTACAATGAGCAGTTCTTC	CASSGVQGQGTSSYNEQFF	TRBV9	TRBJ2-1
TGTGCCAGCAGCATCTTGACAGGGAGTTTCCATCCCCAGGGCTCCTACAATGAGCAGTTCTTC	CASSILTGSFHPQGSYNEQFF	TRBV11-2	TRBJ2-1
TGTGCCAGCAGTTACGATTACAGGGGGCACGGTTCCAATCAGCCCCAGCATTTT	CASSYDYRGHGSNQPQHF	TRBV6-3	TRBJ1-5
TGTGCCAGCACGGGGGACTCCTACGAGCAGTACTTC	CASTGDSYEQYF	TRBV9	TRBJ2-7
TGTGCCAGCAGCTTGACAGGGGGGAATGAGCAGTTCTTC	CASSLTGGNEQFF	TRBV5-6	TRBJ2-1
TGTGCCAGCAGCTCAGGACAGCTGAATTCTCTAAAAGACTATGGCTACACCTTC	CASSSGQLNSLKDYGYTF	TRBV11-3	TRBJ1-2
TGTGCCAGCAGCTTAAGCTCCCCGGGACAACAGTACGAGCAGTACTTC	CASSLSSPGQQYEQYF	TRBV5-8	TRBJ2-7
TGTGCCAGCAGCTCCCATCGTGGGACAGGCTCTGGAAACACCATATATTTT	CASSSHRGTGSGNTIYF	TRBV5-6	TRBJ1-3
TGCGCCAGCTTACGGGGACAGGGTGAAGGGGGGAACACTGAAGCTTTCTTT	CASLRGQGEGGNTEAFF	TRBV5-1	TRBJ1-1
TGTGCCAGCTACAAACCAACCCAAGAGACCCAGTACTTC	CASYKPTQETQYF	TRBV12-4	TRBJ2-5
TGTGCCAGCAGCCAAGACCGGGACAGGAGGGGGAGCTATGGCTACACCTTC	CASSQDRDRRGSYGYTF	TRBV3-1	TRBJ1-2
TGCGCCAGCAGCCAAGATACAAATCAAGAGACCCAGTACTTC	CASSQDTNQETQYF	TRBV4-3	TRBJ2-5
TGTGCCAGCAGCCGGTTGGGTCGGCGGTCGGGACAGGGGGCCTATCAGCCCCAGCATTTT	CASSRLGRRSGQGAYQPQHF	TRBV4-2	TRBJ1-5
TGTGCCAGCGAAGGAAGACCGACAGGATACGAGCAGTACTTC	CASEGRPTGYEQYF	TRBV9	TRBJ2-7
TGTGCCAGCAGCTGGGGAGAAAGGCGGGAGGCCTTC	CASSWGERREAF	TRBV5-6	TRBJ1-2
TGCGCCAGCAGCTTGGGCGGCACCGGAGGCTACGAGCAGTACTTC	CASSLGGTGGYEQYF	TRBV5-1	TRBJ2-7
TGTGCCAGCAGTTTACTCATCCGGGACAGGAGCAATCAGCCCCAGCATTTT	CASSLLIRDRSNQPQHF	TRBV28	TRBJ1-5
TGTGCCAGTAGGGATGGCCGAACCGATCTAGTGAATGAGCAGTTCTTC	CASRDGRTDLVNEQFF	TRBV19	TRBJ2-1
TGTGCCAGCAGTGAACCTGCACCGGGACTAGCGGTTGAAAGCTCCTACGAGCAGTACTTC	CASSEPAPGLAVESSYEQYF	TRBV6-1	TRBJ2-7
TGTGCCACATCGGGGCAGGCACAGCCCCAGCATTTT	CATSGQAQPQHF	TRBV7-3	TRBJ1-5
TGTGCCAGCAGCCAAGATCTCCAGGGGGAAAACGCGGAGGAATCCAATCAGCCCCAGCATTTT	CASSQDLQGENAEESNQPQHF	TRBV4-2	TRBJ1-5
TGTGCCAGCAAGTTTGGGGGGGGGACCTACGAGCAGTACTTC	CASKFGGGTYEQYF	TRBV12-3	TRBJ2-7
TGTGCCAGCAGCGCACAGGGGGCCCTGTTTTTT	CASSAQGALFF	TRBV7-3	TRBJ1-4
TGCGCCAGCAGCCAAGGCCCCGGGGGCGGGGAGCTGTTTTTT	CASSQGPGGGELFF	TRBV4-1	TRBJ2-2
TGTGCCATAATGAGGGAGAAGAATCAGCCCCAGCATTTT	CAIMREKNQPQHF	TRBV6-5	TRBJ1-5
TGTGCCAGCAGCTTAATTTGCGGGAATGAGCCAGATACGCAGTATTTT	CASSLICGNEPDTQYF	TRBV7-3	TRBJ2-3
TGTGCCACCAGCCGACTTACGACGGCTAGCGGGGGTGATACGCAGTATTTT	CATSRLTTASGGDTQYF	TRBV15	TRBJ2-3
TGCAGTGCTAGAGAAGGACAGGGCGAGCAGTACTTC	CSAREGQGEQYF	TRBV20-1	TRBJ2-7
TGTGCCTGTGGACATAGGGACGGCTCTGGGGCCAACGTCCTGACTTTC	CACGHRDGSGANVLTF	TRBV30	TRBJ2-6
TGTGCCAGCAGCGTAGAAGCACATTCCACAGGGTCCTACGAGCAGTACTTC	CASSVEAHSTGSYEQYF	TRBV9	TRBJ2-7
TGTGCCAGTAAAACTCCGGGGAGCACGCCCTACAATGAGCAGTTCTTC	CASKTPGSTPYNEQFF	TRBV19	TRBJ2-1
TGCAGCGCTCACAGCGGGATCTGGGAGTTGTTACATCAGCCCCAGCATTTT	CSAHSGIWELLHQPQHF	TRBV29-1	TRBJ1-5
TGTGCCAGGGGTAGTAACAGGGCTAATGAAGCTTTCTTT	CARGSNRANEAFF	TRBV6-6	TRBJ1-1
TGCGCCAGCAGCTTGCAAGGAGTGTGGGCCCGGAAGCGTGGCTACGAGCAGTACTTC	CASSLQGVWARKRGYEQYF	TRBV5-1	TRBJ2-7
TGTGCCAGCAAACAGCTCTACGAGCAGTACTTC	CASKQLYEQYF	TRBV25-1	TRBJ2-7
TGCAGCGACAGGGGAGTCACCGGGGAGCTGTTTTTT	CSDRGVTGELFF	TRBV29-1	TRBJ2-2
TGTGCCAGCAGTTCCCCGCTCGACACCGGGGAGCTGTTTTTT	CASSSPLDTGELFF	TRBV6-2	TRBJ2-2
TGTGCCAGCATCGCTGGGGAAGAGACCCAGTACTTC	CASIAGEETQYF	TRBV6-1	TRBJ2-5
TGTGCCACCAGCAAGCCCCAGGACAGGGGTGGCTTGGCGTACAATGAGCAGTTCTTC	CATSKPQDRGGLAYNEQFF	TRBV15	TRBJ2-1
TGCAGTGCTAGAGCTACGACAGGACTGACTGACGAGCAGTACTTC	CSARATTGLTDEQYF	TRBV20-1	TRBJ2-7
TGTGGGGGGGGGGCCAACGTCCTGACTTTC	CGGGANVLTF	TRBV27	TRBJ2-6
TGTGCCAGCAGAGGGACAGGGAATCGACTCGAGCAGTACTTC	CASRGTGNRLEQYF	TRBV6-5	TRBJ2-7
TGTGCCAGCAGCTTAGTAGAAACGGGGGATCAGCCCCAGCATTTT	CASSLVETGDQPQHF	TRBV7-6	TRBJ1-5
TGTGCCAGCAGTCGACTAGCGGGACACACCGGGGAGCTGTTTTTT	CASSRLAGHTGELFF	TRBV6-5	TRBJ2-2
TGTGCCAGCAGCAAACATTGGGTCGACCTCTTAACTAATGAAAAACTGTTTTTT	CASSKHWVDLLTNEKLFF	TRBV11-3	TRBJ1-4
TGTGCCAGCAGCCTGAGGACTAGCGGGCTGGAGTATTTT	CASSLRTSGLEYF	TRBV13	TRBJ2-3
TGCGCCAGCAGCTTGGCCAACAGGGGGCCGCGAGGTCATAGCAATCAGCCCCAGCATTTT	CASSLANRGPRGHSNQPQHF	TRBV5-1	TRBJ1-5
TGCAGCGCCAAGCGGCCCGGCAGGACAGATACGCAGTATTTT	CSAKRPGRTDTQYF	TRBV29-1	TRBJ2-3
TGTGCCAGCAGCCCCCTTCCGGGACTCCGGAGCTCCTACAATGAGCAGTTCTTC	CASSPLPGLRSSYNEQFF	TRBV11-2	TRBJ2-1
TGTGCCAGCAGTGCATCGGGACAGGGCCCCTACGAGCAGTACTTC	CASSASGQGPYEQYF	TRBV2	TRBJ2-7
TGTGCTAGTGGTTCCAAGCCTTTGAACGAGCAGTACTTC	CASGSKPLNEQYF	TRBV12-5	TRBJ2-7
TGTGCCATCAGTGAGGACGTAGGGCGCCACTATTCTAATGAGCAGTTCTTC	CAISEDVGRHYSNEQFF	TRBV10-3	TRBJ2-1
TGTGCCAGCAGCTTACGTCGACAGGTGAGGGGTACCTACGAGCAGTACTTC	CASSLRRQVRGTYEQYF	TRBV11-2	TRBJ2-7
TGCGCCAGCAGCTTGCCCCCCAGGGTCCGTGGCTACACCTTC	CASSLPPRVRGYTF	TRBV5-1	TRBJ1-2
TGTGCCACTCCCCCCCTGACAGGGGTCGAGCAGTACTTC	CATPPLTGVEQYF	TRBV7-9	TRBJ2-7
TGTGCCAGCATAGCCCCCGTCGGATTTAGGTCCTACAATGAGCAGTTCTTC	CASIAPVGFRSYNEQFF	TRBV12-3	TRBJ2-1
TGTGCCAGCAGCTGGCAGGGGTTTACTGAAGCTTTCTTT	CASSWQGFTEAFF	TRBV7-3	TRBJ1-1
TGTGCCAGCAGCTTAGCGAGGGACAGGGAGGGGTCTAATCAGCCCCAGCATTTT	CASSLARDREGSNQPQHF	TRBV7-6	TRBJ1-5
TGTGCCAGCAGCTACCATATAGCAGGGGGCTGCAGTCCTGATGAAGCTTTCTTT	CASSYHIAGGCSPDEAFF	TRBV13	TRBJ1-1
TGTGCCAGCAGCCAAAAACGGGGATACTCGACACGTTTAAGTGATGAGCAGTTCTTC	CASSQKRGYSTRLSDEQFF	TRBV14	TRBJ2-1
TGTGAATGGGGAAGGGATACGCAGTATTTT	CEWGRDTQYF	TRBV11-1	TRBJ2-3
TGTGCCACCAGTGATTTGGGACGGGACAGCTATGGCTACACCTTC	CATSDLGRDSYGYTF	TRBV24-1	TRBJ1-2
TGTGCCAGCCGCAGGGGGGACGGTTCAGCTAACTATGGCTACACCTTC	CASRRGDGSANYGYTF	TRBV6-4	TRBJ1-2
TGTGCCAGCATCGAAACCAGTGGGGGGGCCCTCCACTACAATGAGCAGTTCTTC	CASIETSGGALHYNEQFF	TRBV9	TRBJ2-1
TGTGCCAGCAGCCCTCCCGATAACCGGGACAGGGTTGATCAGCCCCAGCATTTT	CASSPPDNRDRVDQPQHF	TRBV27	TRBJ1-5
TGTGCCAGCAGCTTAGCGGGGGGCTCAGATACGCAGTATTTT	CASSLAGGSDTQYF	TRBV11-1	TRBJ2-3
TGTGCCAGCAGCTTACCGGGGGTCAGAGAGCAGTACTTC	CASSLPGVREQYF	TRBV7-6	TRBJ2-7
TGTGCCACCAGTGAAACCTATCCAAACAGCTCCTACGAGCAGTACTTC	CATSETYPNSSYEQYF	TRBV24-1	TRBJ2-7
TGTGCCAGCAGTCGACAGTACAATGAGCAGTTCTTC	CASSRQYNEQFF	TRBV6-3	TRBJ2-1
TGTGCCAGCAGTTACTGTCCGGACAGGGAAAACAGAAATGAAAAACTGTTTTTT	CASSYCPDRENRNEKLFF	TRBV6-5	TRBJ1-4
TGTGCCAGCAGCTGGGGGGACAGGGCCAGCTCGAACACTGAAGCTTTCTTT	CASSWGDRASSNTEAFF	TRBV7-9	TRBJ1-1
TGTGCCAGCTCTGCTGGTGTCCGCCTAGGGGGCTCGAACACAGATACGCAGTATTTT	CASSAGVRLGGSNTDTQYF	TRBV18	TRBJ2-3
TGTGCCAGCAGTATGGGTTCGTGGGTCCCGTGCACAGATACGCAGTATTTT	CASSMGSWVPCTDTQYF	TRBV27	TRBJ2-3
TGCAGTGCTTTTCCCCGGTACAGTAAATGGTCTGGCACCGGGGAGCTGTTTTTT	CSAFPRYSKWSGTGELFF	TRBV20-1	TRBJ2-2
TGTGCCAGCACCGAGGACAGGGTGACGAACACTGAAGCTTTCTTT	CASTEDRVTNTEAFF	TRBV11-2	TRBJ1-1
TGTGCCAGGAGGGTCAGATTCTGCAATCAGCCCCAGCATTTT	CARRVRFCNQPQHF	TRBV28	TRBJ1-5
TGTGCCAGCAGCCAAGGGAGGGGCGTACCCTACGAGCAGTACTTC	CASSQGRGVPYEQYF	TRBV3-1	TRBJ2-7
TGTGCCAGCAGCCAAGAAAGGAAATGCAGAACTAGCAATCAGCCCCAGCATTTT	CASSQERKCRTSNQPQHF	TRBV14	TRBJ1-5
TGTGCCAGCAGCTTAGCCACAGGGACTTTTCGAATCTACGAGCAGTACTTC	CASSLATGTFRIYEQYF	TRBV7-2	TRBJ2-7
TGTGCCAGCAGTTGGTCTGCGACAGGTGTGTCAGATACGCAGTATTTT	CASSWSATGVSDTQYF	TRBV12-3	TRBJ2-3
TGTGCCAGCAGTTTTAGGAGGACCGCATACGAGCAGTACTTC	CASSFRRTAYEQYF	TRBV27	TRBJ2-7
TGTGCCAGCAGCGCGGGGGTGAAGGCAGCTTTCTTT	CASSAGVKAAFF	TRBV3-1	TRBJ1-1
