TGTGCCAGTAGTAAGAAGACTAGCGGGAGGAGGACGCGCAATCAGCCCCAGCATTTT	CASSKKTSGRRTRNQPQHF	TRBV19	TRBJ1-5
TGCGCCAGCAAGGGGGGGGAAATCTGGAACACTGAAGCTTTCTTT	CASKGGEIWNTEAFF	TRBV5-1	TRBJ1-1
TGCAGCGTTGCCGCTAGCGGGACGGCGCACACCGGGGAGCTGTTTTTT	CSVAASGTAHTGELFF	TRBV29-1	TRBJ2-2
TGTGCCACCAGTGAACCCAGGTACGCCTACAATGAGCAGTTCTTC	CATSEPRYAYNEQFF	TRBV24-1	TRBJ2-1
TGTGCCAGCAGTTGGGTAAAGGGACGGACGTACAATGAGCAGTTCTTC	CASSWVKGRTYNEQFF	TRBV6-2	TRBJ2-1
TGTGCCCCGACAGGTAAGAGCAATCAGCCCCAGCATTTT	CAPTGKSNQPQHF	TRBV11-3	TRBJ1-5
TGCGCCAGCAGCCAAGATCCTGTCACAGGGTACGAGCAGTACTTC	CASSQDPVTGYEQYF	TRBV4-1	TRBJ2-7
TGTGCCAGCAGCGGGGGACTAGCGGGGAACTACAATGAGCAGTTCTTC	CASSGGLAGNYNEQFF	TRBV13	TRBJ2-1
TGTGCCTTCCGCAGAGGCACAGATACGCAGTATTTT	CAFRRGTDTQYF	TRBV6-5	TRBJ2-3
TGTGCCACCAGTTTGTGGCTCAGGGGGCGGGCTGCTAACTATGGCTACACCTTC	CATSLWLRGRAANYGYTF	TRBV24-1	TRBJ1-2
TGTGCCAGCAGCTATTGGGACAGGGGGCGCCAGTATAGCAATCAGCCCCAGCATTTT	CASSYWDRGRQYSNQPQHF	TRBV9	TRBJ1-5
TGCGCCAGCAGTGAGTCGTCCGGGGCGGAGCAGTACTTC	CASSESSGAEQYF	TRBV10-1	TRBJ2-7
TGTGCCAGCAGCTTGATATGGTTAAGCTCCTACGAGCAGTACTTC	CASSLIWLSSYEQYF	TRBV11-3	TRBJ2-7
TGTGCCACCAGTGATGAAGGGACAGGGGGCCCGAACAACACCATATATTTT	CATSDEGTGGPNNTIYF	TRBV24-1	TRBJ1-3
TGTGCCAGCAGTTATTCCCGGGACAGGGATCAGCCCCAGCATTTT	CASSYSRDRDQPQHF	TRBV27	TRBJ1-5
TGTGCCAGTAGCCAGGCCTACTACACAGGGCCAGGCGATGAGCAGTTCTTC	CASSQAYYTGPGDEQFF	TRBV19	TRBJ2-1
TGTGCCAGCAGTGACGGGAGTCGAGGATATGGCTACACCTTC	CASSDGSRGYGYTF	TRBV6-4	TRBJ1-2
TGCGCCAGCGGGGGGAGTACTCGCAATCAGCCCCAGCATTTT	CASGGSTRNQPQHF	TRBV10-1	TRBJ1-5
TGTGCCAGCAAAAGGACAGGGGGAAACTATGGCTACACCTTC	CASKRTGGNYGYTF	TRBV9	TRBJ1-2
TGTGCCAGCAGTGCCGGGGATTACAATGAGCAGTTCTTC	CASSAGDYNEQFF	TRBV6-4	TRBJ2-1
TGTGCCACCGACCCGCCTACTGAGACCCAGTACTTC	CATDPPTETQYF	TRBV24-1	TRBJ2-5
TGTGCCAGCAGGCTAGTTAAACAGGGGGGTTATTCACCCCTCCACTTT	CASRLVKQGGYSPLHF	TRBV6-6	TRBJ1-6
TGTGCCAGCAGTTACTGGGACAGGGGGCGAGGTGTCACAGATACGCAGTATTTT	CASSYWDRGRGVTDTQYF	TRBV27	TRBJ2-3
TGTGCCAGCAGCTCCTACAGGGCGAATGAAAAACTGTTTTTT	CASSSYRANEKLFF	TRBV7-6	TRBJ1-4
TGTGCCAGCGGTTTGGGGGCCGGAGGCTACGAGCAGTACTTC	CASGLGAGGYEQYF	TRBV6-8	TRBJ2-7
TGCGCCAGCAGCTTGGCGAGAGCCTCTAGCGGGGATGAGCAGTTCTTC	CASSLARASSGDEQFF	TRBV5-1	TRBJ2-1
TGCGCCAGCAGCTTGGTGGCCGCTTACTACGAGCAGTACTTC	CASSLVAAYYEQYF	TRBV5-1	TRBJ2-7
TGTGCCAGCAGCTTAGGGGGGACCCAAGTAGTTATCCCCCGTTCCAATGAGCAGTTCTTC	CASSLGGTQVVIPRSNEQFF	TRBV7-8	TRBJ2-1
TGTGCCAGCAGCCTGCACCCAAGCTCGGGACAGGGTAAGGGCGAGCAGTACTTC	CASSLHPSSGQGKGEQYF	TRBV4-2	TRBJ2-7
TGTGCCAGCAGCTTGTGTACCTTTATCTTT	CASSLCTFIF	TRBV5-6	TRBJ1-1
TGTGAACGGGGGGGCCGTTACAATGAGCAGTTCTTC	CERGGRYNEQFF	TRBV24-1	TRBJ2-1
TGTGCCAGCAGCTCCCGTACGATCGGACTAGCGGGGCCCTCCTACGAGCAGTACTTC	CASSSRTIGLAGPSYEQYF	TRBV7-3	TRBJ2-7
TGTGCCTGGGTGAGCGATCAGCCCCAGCATTTT	CAWVSDQPQHF	TRBV30	TRBJ1-5
TGTGCCAGCAGCGTAGGCTCTCTGGGTGGACTATTCAATCAGCCCCAGCATTTT	CASSVGSLGGLFNQPQHF	TRBV9	TRBJ1-5
TGTGCCAGCATCGAATCGGGGGGCCCCGGGTACGAGCAGTACTTC	CASIESGGPGYEQYF	TRBV3-1	TRBJ2-7
TGTGCCACCATAAGTCCGTCAGATCAGCCCCAGCATTTT	CATISPSDQPQHF	TRBV24-1	TRBJ1-5
TGCGCCAGCAGCTCTCGTGCAGGGACACTGGGCTACACCTTC	CASSSRAGTLGYTF	TRBV5-1	TRBJ1-2
TGTGCCAGCAGCGCTAGCGGGAACGAGCAGTACTTC	CASSASGNEQYF	TRBV5-4	TRBJ2-7
TGTGCCAGCAGTGCGGGAGACAGGGGGCACGAGCAGTACTTC	CASSAGDRGHEQYF	TRBV12-3	TRBJ2-7
TGTGCCAGTAGTAAGGGCCCCCCCTATGGCTACACCTTC	CASSKGPPYGYTF	TRBV19	TRBJ1-2
TGTGCCAGCAGTTTACTTCTCGATTGGGGGGGCATAGGGTACTTCACAGATACGCAGTATTTT	CASSLLLDWGGIGYFTDTQYF	TRBV12-3	TRBJ2-3
TGTGCCAGCAGCCAAGATTACTGGGCAGGGGAAATGTCCTACGAGCAGTACTTC	CASSQDYWAGEMSYEQYF	TRBV4-2	TRBJ2-7
TGTGCCAGCTCACCCCTCGACAGGACAGGCCTCCACTTT	CASSPLDRTGLHF	TRBV18	TRBJ1-6
TGTGCCAGTAGTATGGGACAGGGCCTCAGCACAGATACGCAGTATTTT	CASSMGQGLSTDTQYF	TRBV19	TRBJ2-3
TGTGCCTGGAGTGAGCTACATGCGATTTTCCTCTCCTACGAGCAGTACTTC	CAWSELHAIFLSYEQYF	TRBV30	TRBJ2-7
TGTGCCTGGAGTGCACAGGGGGACAATGAGCAGTTCTTC	CAWSAQGDNEQFF	TRBV30	TRBJ2-1
TGTGCCAGCAGCTTACCACACCGCAATCAGCCCCAGCATTTT	CASSLPHRNQPQHF	TRBV11-3	TRBJ1-5
TGTGCCAGCAGCCCGGGGGCGCAGCCCCAGCATTTT	CASSPGAQPQHF	TRBV13	TRBJ1-5
TGCGCCAGCAGCTTGCCCCGGGGGGGCGGCTACGAGCAGTACTTC	CASSLPRGGGYEQYF	TRBV5-1	TRBJ2-7
TGCGCCAGCGACCCTAGGTCCTACGAGCAGTACTTC	CASDPRSYEQYF	TRBV5-1	TRBJ2-7
TGTGCAGGGGCGGCAGACATTCAGTACTTC	CAGAADIQYF	TRBV12-3	TRBJ2-4
TGTGCCAGCAGTTCACCGTGCGGGACTAGCGGACGGGGTATGAAGCAGTTCTTC	CASSSPCGTSGRGMKQFF	TRBV12-4	TRBJ2-1
TGTGCCAGCAGCTCAGGAAACAGGGGGGGGCCACCTAACTATGGCTACACCTTC	CASSSGNRGGPPNYGYTF	TRBV7-3	TRBJ1-2
TGTGCCAGCACCCGGGACAGAAAGGACACTGAAGCTTTCTTT	CASTRDRKDTEAFF	TRBV6-5	TRBJ1-1
TGTGCCAGCAGTAGTCATAACTATGGCTACACCTTC	CASSSHNYGYTF	TRBV3-1	TRBJ1-2
TGCGCCAGCGGAAGAACACTCGTTCTTCATGGCTACACCTTC	CASGRTLVLHGYTF	TRBV5-1	TRBJ1-2
TGTGCCAGCAGCAGGGGGGGCTCCGCATATTCCTTTTACGAGCAGTACTTC	CASSRGGSAYSFYEQYF	TRBV6-3	TRBJ2-7
TGTGCCAGCAGCCCCGGGTCCCAAGAGACCCAGTACTTC	CASSPGSQETQYF	TRBV7-8	TRBJ2-5
TGCGGGAATCCGACCTACGAGCAGTACTTC	CGNPTYEQYF	TRBV20-1	TRBJ2-7
TGTGCCACCATACGGGGTTACAATGAGCAGTTCTTC	CATIRGYNEQFF	TRBV24-1	TRBJ2-1
TGTGCCAGCAGAGGGACAGGGCGGGAATACGAGCAGTACTTC	CASRGTGREYEQYF	TRBV6-5	TRBJ2-7
TGTGCCAGCAGCTCCTTGGACAGGGGAGGTCCGGGCTACACCTTC	CASSSLDRGGPGYTF	TRBV28	TRBJ1-2
TGTGCCAGCAGTTTTAACCAACCCAACGTCCCATTCCTTGGGGGGAAAGAGACCCAGTACTTC	CASSFNQPNVPFLGGKETQYF	TRBV28	TRBJ2-5
TGTGCCAGCAGGAGGGGGGCCAGAGTGACCGGGGAGCTGTTTTTT	CASRRGARVTGELFF	TRBV7-9	TRBJ2-2
TGTGCCAGCAGCTTAACGTGGGAGGTCAGCGGTTATTACCAAGAGACCCAGTACTTC	CASSLTWEVSGYYQETQYF	TRBV7-3	TRBJ2-5
TGCAGTGCCAGGCCCAGCTCCTATAATTCACCCCTCCACTTT	CSARPSSYNSPLHF	TRBV20-1	TRBJ1-6
TGTGCCGGGGGCAGTAGATATAGCAATCAGCCCCAGCATTTT	CAGGSRYSNQPQHF	TRBV5-4	TRBJ1-5
TGTGCCAGCAGCTGCTGGGTCTGCAAGGTCACTGAAGCTTTCTTT	CASSCWVCKVTEAFF	TRBV5-5	TRBJ1-1
TGTGCCAGCAGTTTGCGTCCCGGCCAACAGCCCCAGCATTTT	CASSLRPGQQPQHF	TRBV28	TRBJ1-5
TGTGCCAGCAGCTACAGGGCGGCCAAAAACATTCAGTACTTC	CASSYRAAKNIQYF	TRBV5-6	TRBJ2-4
TGCAGTGCTACCAAAATCGACACTAGGAGCACAGATACGCAGTATTTT	CSATKIDTRSTDTQYF	TRBV20-1	TRBJ2-3
TGCAGTGCTAGAGATCCAATACCGTGTTTTCTAGCGTGGAGGCAAGATACGCAGTATTTT	CSARDPIPCFLAWRQDTQYF	TRBV20-1	TRBJ2-3
TGCGCCAGCAGCCTCGCTTCTTGGGGGATGGTCTACACCTTC	CASSLASWGMVYTF	TRBV5-1	TRBJ1-2
TGTGCCAGCAGCTGGGCGGGGATCGAGCAGTACTTC	CASSWAGIEQYF	TRBV7-8	TRBJ2-7
TGTGCCAGCAGCTTAGACACAGGAGGCTCCACCAATCAGCCCCAGCATTTT	CASSLDTGGSTNQPQHF	TRBV7-2	TRBJ1-5
TGTGCCAGCAGCGTAGAGGACAGCGGCTACGAGCAGTACTTC	CASSVEDSGYEQYF	TRBV9	TRBJ2-7
TGTGCCAGCAGCGTCCTTGAGGGAAACCCTTATGATACGCAGTATTTT	CASSVLEGNPYDTQYF	TRBV9	TRBJ2-3
TGTGCCAGCAGTGACCAACGATCGGAGGCCGCTAGCACAGATACGCAGTATTTT	CASSDQRSEAASTDTQYF	TRBV6-4	TRBJ2-3
TGTGCCAGCAGTTCAGGGGTTTTACAGCGTAATTCACCCCTCCACTTT	CASSSGVLQRNSPLHF	TRBV28	TRBJ1-6
TGTGCCAGCAGTTACGTTAGACCCGTGCCTTTTTCTTACAATGAGCAGTTCTTC	CASSYVRPVPFSYNEQFF	TRBV6-5	TRBJ2-1
TGTGCCAGCAGCTTACCTCGGCAGGGCTACGAGCAGTACTTC	CASSLPRQGYEQYF	TRBV7-3	TRBJ2-7
TGTGCCACCAGTCCCCGCGGGAGAGCTCAGCCCCAGCATTTT	CATSPRGRAQPQHF	TRBV15	TRBJ1-5
TGTGCCAGCAGCTTAGCAGGGGGCGAAGCTAGCACAGATACGCAGTATTTT	CASSLAGGEASTDTQYF	TRBV11-3	TRBJ2-3
TGTGCCAGCAGCTTTTACAATTCGACAGGGGCTCTGTTTTTT	CASSFYNSTGALFF	TRBV7-2	TRBJ1-4
TGTGCCAGCAGGCTCGGGGGGCCAACAGATACGCAGTATTTT	CASRLGGPTDTQYF	TRBV6-2	TRBJ2-3
TGTGCCAGCACCAAACGGACTAGCGGGGCTCTGGGGGACAATGAGCAGTTCTTC	CASTKRTSGALGDNEQFF	TRBV6-5	TRBJ2-1
TGTGCCCCGCCAAGACAGGGATTACGCATTGAGCAGTTCTTC	CAPPRQGLRIEQFF	TRBV27	TRBJ2-1
TGTGCCAGCAGTGCGGCGGGACGGAAGGAAGTGGGCTACACCTTC	CASSAAGRKEVGYTF	TRBV12-3	TRBJ1-2
TGCAGCCCGGAGTCGTTCGCGAGGGTTTTCGGTCCCTCTGGAAACACCATATATTTT	CSPESFARVFGPSGNTIYF	TRBV29-1	TRBJ1-3
TGTGCCAGCAGCCCACGGGGGCGTGGTTCACCCCTCCACTTT	CASSPRGRGSPLHF	TRBV7-9	TRBJ1-6
TGTGCCCTGGCGGCACGGCCGCTTCATGAGCAGTTCTTC	CALAARPLHEQFF	TRBV27	TRBJ2-1
TGCAGACAGGGGGCGGGGGAGGAGACCCAGTACTTC	CRQGAGEETQYF	TRBV20-1	TRBJ2-5
TGTGCCAGCAGCTTGGGGGGGTGCACAGATACGCAGTATTTT	CASSLGGCTDTQYF	TRBV5-5	TRBJ2-3
TGTGCCAGTAGTATTGCCGGGGGAAAGCTAGAGACCCAGTACTTC	CASSIAGGKLETQYF	TRBV19	TRBJ2-5
TGTGCCAGCAGATCGCTGGGACAGGGGAACACTGAAGCTTTCTTT	CASRSLGQGNTEAFF	TRBV12-3	TRBJ1-1
TGCAGTGCCCGGACAGAAGGAATGAACACTGAAGCTTTCTTT	CSARTEGMNTEAFF	TRBV20-1	TRBJ1-1
TGCAGTGCTAGGGGGGCGAGACCCCTCCACTTT	CSARGARPLHF	TRBV20-1	TRBJ1-6
TGTGCCAGCAGTTTACGGGGGGACGGCTATGGCTACACCTTC	CASSLRGDGYGYTF	TRBV6-6	TRBJ1-2
TGTGCCAATCTGCAGGGGGCTACCTCCTACGAGCAGTACTTC	CANLQGATSYEQYF	TRBV7-9	TRBJ2-7
TGCGCCAGCAGCTTCACTGGGAGGGGTGTAGATACGCAGTATTTT	CASSFTGRGVDTQYF	TRBV5-1	TRBJ2-3
TGTGCCAGCAGCTCCGGGGGGACGTCCTACGAGCAGTACTTC	CASSSGGTSYEQYF	TRBV11-3	TRBJ2-7
TGTGCCAGCAGTTACAGAGGGGCACGGTGGACCTACGAGCAGTACTTC	CASSYRGARWTYEQYF	TRBV6-3	TRBJ2-7
TGTGCCAGCAGCGCTTCAAACCAACTAGCGATGACTGAATACGGGCGGGATGAGCAGTTCTTC	CASSASNQLAMTEYGRDEQFF	TRBV9	TRBJ2-1
TGTGCCACCAGCAGAGGTCTCGGGTCCTACGAGCAGTACTTC	CATSRGLGSYEQYF	TRBV15	TRBJ2-7
TGCGCCAGCAGCCAAGATAGGGGGGCCGAGCAGTACTTC	CASSQDRGAEQYF	TRBV4-1	TRBJ2-7
TGCGCCAGCAGCCCTGACAGGAAAGGTAATTCACCCCTCCACTTT	CASSPDRKGNSPLHF	TRBV5-1	TRBJ1-6
TGTGCCAGCAGCCGGGGGACCTACGAGCAGTACTTC	CASSRGTYEQYF	TRBV5-4	TRBJ2-7
TGCGCCAGCAGCCAATCCGGGTTCAGAAATCAGCCCCAGCATTTT	CASSQSGFRNQPQHF	TRBV4-3	TRBJ1-5
TGCGCCAGCAGCTTGGATAGGGGGGGGATCTCTGGAAACACCATATATTTT	CASSLDRGGISGNTIYF	TRBV5-1	TRBJ1-3
TGTGCCAGCAGGTTGACAGTGCAGCCCCAGCATTTT	CASRLTVQPQHF	TRBV6-4	TRBJ1-5
TGTGCCAGCAGCTTAGCTTCGACGATAATCGAGCAGTACTTC	CASSLASTIIEQYF	TRBV7-9	TRBJ2-7
TGCGCCAGCAGCCAAGTGGGCTCTGAAGCTTTCTTT	CASSQVGSEAFF	TRBV4-1	TRBJ1-1
TGTGCCAGCAGCCAGGGGGGGGCCTCTCAAGAGACCCAGTACTTC	CASSQGGASQETQYF	TRBV9	TRBJ2-5
TGTGCCAGCAGTGACTCCTTACTAGCGGGAGGGGAGACCCAGTACTTC	CASSDSLLAGGETQYF	TRBV6-4	TRBJ2-5
TGCAGTGCTTTCGGGGAAACTGGGAGGCAGCCCCAGCATTTT	CSAFGETGRQPQHF	TRBV20-1	TRBJ1-5
TGTGCCAGCGGAACTGACAGGGAATCGGACACTGAAGCTTTCTTT	CASGTDRESDTEAFF	TRBV27	TRBJ1-1
TGTGCCAGCAGTATTCCAAACTTGACGGTCAATATCGAGCAGTACTTC	CASSIPNLTVNIEQYF	TRBV27	TRBJ2-7
TGCAGCGTTGACCCCCGGGACAGAGGGGAGAAGCCACCCACTGAAGCTTTCTTT	CSVDPRDRGEKPPTEAFF	TRBV29-1	TRBJ1-1
TGCAGTGCTAGTGACGGCACAGATACGCAGTATTTT	CSASDGTDTQYF	TRBV20-1	TRBJ2-3
TGCGCCAGCGGAGGGGGGGCCGCCACAGATACGCAGTATTTT	CASGGGAATDTQYF	TRBV10-1	TRBJ2-3
TGCGCCAGCAGCTTGCCTTTAGAAGGGGGCGGTATGAACACTGAAGCTTTCTTT	CASSLPLEGGGMNTEAFF	TRBV5-1	TRBJ1-1
TGTGCCAGCAGTTTATGGACCGGGGCCCGGGCAGATACGCAGTATTTT	CASSLWTGARADTQYF	TRBV27	TRBJ2-3
TGCAGTGCTAGAGAGGGAATTTGGGGGTTGGCCAACACTGAAGCTTTCTTT	CSAREGIWGLANTEAFF	TRBV20-1	TRBJ1-1
TGCAGTGCTAGACGTGACAGGGTAATGAAAGAGTCTCATGGCTACACCTTC	CSARRDRVMKESHGYTF	TRBV20-1	TRBJ1-2
TGTGCCAGCAGCAAAGGACAGATGGGGGGCAGAAACACCATATATTTT	CASSKGQMGGRNTIYF	TRBV9	TRBJ1-3
TGCAGTGCTAGAGACACGGGACCACTAGCGGGAGTCCGGACGCAGCCCCAGCATTTT	CSARDTGPLAGVRTQPQHF	TRBV20-1	TRBJ1-5
TGCGCCAGCAGCTCGCCCCCCAAGGGGCCTACCTACGAGCAGTACTTC	CASSSPPKGPTYEQYF	TRBV5-1	TRBJ2-7
TGTGCCAGCAGCCAAGAACCCCCGATACCAGGGAGTGGCTACACCTTC	CASSQEPPIPGSGYTF	TRBV14	TRBJ1-2
TGTGCCACCAACGGGGGCAATGAGCAGTTCTTC	CATNGGNEQFF	TRBV24-1	TRBJ2-1
TGTGCCAGCAGTCAGCAGCCCCAGCATTTT	CASSQQPQHF	TRBV27	TRBJ1-5
TGCGCCAGCAGCCAAGATCCTCAGGGAACTCGGGGGAAATACGAGCAGTACTTC	CASSQDPQGTRGKYEQYF	TRBV4-3	TRBJ2-7
TGTGCCAGCAACCTTTTCTGGCTTAGCACAGATACGCAGTATTTT	CASNLFWLSTDTQYF	TRBV6-5	TRBJ2-3
TGTGCCAGTAGTATAGACTCGGGACTAGGATGGGACGAGCAGTACTTC	CASSIDSGLGWDEQYF	TRBV19	TRBJ2-7
TGCGCCAGCAGCCAAGATGGCTACCCACAGGGCGGGTATCAGCCCCAGCATTTT	CASSQDGYPQGGYQPQHF	TRBV4-1	TRBJ1-5
TGTGCCACCTATGACCGTCAGCCCCAGCATTTT	CATYDRQPQHF	TRBV24-1	TRBJ1-5
TGTGCCAGCAGCGGGGGAGGACAGGTCAATCAGCCCCAGCATTTT	CASSGGGQVNQPQHF	TRBV25-1	TRBJ1-5
TGTGCCAGCAGCCAAGATCCCCCCGGGCACGGACTGAACACTGAAGCTTTCTTT	CASSQDPPGHGLNTEAFF	TRBV4-2	TRBJ1-1
TGCGCCAGCAGCCAGGGCAGACCGAACACCGGGGAGCTGTTTTTT	CASSQGRPNTGELFF	TRBV5-1	TRBJ2-2
TGCAGTGCTAGACGTAGGGGACAGGATAGGGAATCACCCCTCCACTTT	CSARRRGQDRESPLHF	TRBV20-1	TRBJ1-6
TGCGCCAGCAGGCGTAGGGCAGGCTACGAGCAGTACTTC	CASRRRAGYEQYF	TRBV4-1	TRBJ2-7
TGTGCCATCAGTGAAACCCTACATCACGGGGGGGTGAACACTGAAGCTTTCTTT	CAISETLHHGGVNTEAFF	TRBV10-3	TRBJ1-1
TGTGCCAGCAGTGAGCTACAGGGATTCCCTTCACCCCTCCACTTT	CASSELQGFPSPLHF	TRBV6-1	TRBJ1-6
TGTGCCAGCAGTACGCCTGACTCCTACGAGCAGTACTTC	CASSTPDSYEQYF	TRBV11-2	TRBJ2-7
TGTGCCAGCAGTCCCTCCTCGGGAGGAATGAACACTGAAGCTTTCTTT	CASSPSSGGMNTEAFF	TRBV6-1	TRBJ1-1
TGTGCCAGCAGTCCAGGATTACAGGACAGGGGAGCGAATCCGACCCAGTACTTC	CASSPGLQDRGANPTQYF	TRBV6-3	TRBJ2-5
TGTGCCAGCAGCTTAGATCGAGTCCCTCTAGCGGGCTGCTTTCCGACCCAGTACTTC	CASSLDRVPLAGCFPTQYF	TRBV11-2	TRBJ2-5
TGTGCCAGCAGGCCCGGGACAGCCGTGAATAGGCGGCAGAACACTGAAGCTTTCTTT	CASRPGTAVNRRQNTEAFF	TRBV6-5	TRBJ1-1
TGCGCCAGCAGCCTCAGTTCCAATCAGCCCCAGCATTTT	CASSLSSNQPQHF	TRBV4-3	TRBJ1-5
TGCGCCAGCAGCTTGGCAACCACCAGGACCGGGCATTTT	CASSLATTRTGHF	TRBV5-1	TRBJ1-5
TGTGCCAGCAGCCGAAGACTAGGATGTCAAAAACTAGCCAAAAACATTCAGTACTTC	CASSRRLGCQKLAKNIQYF	TRBV9	TRBJ2-4
TGTGCCAGCAGTTACTGGTCCGGGACTAGCGGGGGGGCGAGGGCCAACGTCCTGACTTTC	CASSYWSGTSGGARANVLTF	TRBV6-5	TRBJ2-6
TGTGCCCGTCGGGAGGGACTAGGATACAATGAGCAGTTCTTC	CARREGLGYNEQFF	TRBV2	TRBJ2-1
TGTGCCAGCAGCCAAGAACCCCTTACGCGCCTTGAGACCCAGTACTTC	CASSQEPLTRLETQYF	TRBV4-2	TRBJ2-5
TGTGCCAGCAGCCCACACAGGCTTCTGGGCTACACCTTC	CASSPHRLLGYTF	TRBV7-4	TRBJ1-2
TGTGCCAGCAGCTTACGGGACAACATTCCGAGCAATCAGCCCCAGCATTTT	CASSLRDNIPSNQPQHF	TRBV7-9	TRBJ1-5
TGTGCCAGCAGCTCTCCCCCTAGCAACACCGGGGAGCTGTTTTTT	CASSSPPSNTGELFF	TRBV11-3	TRBJ2-2
TGTGCCTGGAGTGGGGGGACGGGACAGAGCCTCACCTACGAGCAGTACTTC	CAWSGGTGQSLTYEQYF	TRBV30	TRBJ2-7
TGCGCCAGCAGTGTTACTAGCATCCAAGAGACCCAGTACTTC	CASSVTSIQETQYF	TRBV10-1	TRBJ2-5
TGTGCCAGCAGTACCGGACGATACTCCTACGAGCAGTACTTC	CASSTGRYSYEQYF	TRBV27	TRBJ2-7
TGCGCCAGCAGCTTGGGCGAGGGGGCCGAGACCCAGTACTTC	CASSLGEGAETQYF	TRBV5-1	TRBJ2-5
TGTGCCTGGAGTGTAGCGCCCGAGGACAGCGATAGAGAGACCCAGTACTTC	CAWSVAPEDSDRETQYF	TRBV30	TRBJ2-5
TGTGCCAGCAGCTTGCCCGGGACAGTTGGGGGATATGGCTACACCTTC	CASSLPGTVGGYGYTF	TRBV5-6	TRBJ1-2
TGTGCCAGCAGCTTCGTTACCAGGCGGCTGGCTGAAGCTTTCTTT	CASSFVTRRLAEAFF	TRBV11-2	TRBJ1-1
TGTGCCAGAAGCGGGAAAAAGACCCAGTACTTC	CARSGKKTQYF	TRBV19	TRBJ2-5
TGTGCCAGCAGCCGGACAGGGAAGAACAATCAGCCCCAGCATTTT	CASSRTGKNNQPQHF	TRBV4-2	TRBJ1-5
TGTGCCAGCAGTGACAACTGGCCGGGACCCGCCACTGAAGCTTTCTTT	CASSDNWPGPATEAFF	TRBV6-4	TRBJ1-1
TGTGCCACCAGTGAGTGGGAGGACAGGGGGCACAATGAGCAGTTCTTC	CATSEWEDRGHNEQFF	TRBV24-1	TRBJ2-1
TGTGCCAGCAGCTATGCAGGGGTCTACGAGCAGTACTTC	CASSYAGVYEQYF	TRBV13	TRBJ2-7
TGTGCCAGCTCACCACCCCTCTCTGGAAACACCATATATTTT	CASSPPLSGNTIYF	TRBV18	TRBJ1-3
TGTGCCAGCAGGACCCGTCCTGGTCCTTTTCAGCCACAAGAGACCCAGTACTTC	CASRTRPGPFQPQETQYF	TRBV6-2	TRBJ2-5
TGCAGCGGGGGCACTGAAGCTTTCTTT	CSGGTEAFF	TRBV29-1	TRBJ1-1
TGTGCCAGCAGCTTAAGGGACGCGGGGAATCAGCCCCAGCATTTT	CASSLRDAGNQPQHF	TRBV7-2	TRBJ1-5
TGTGCCAGCAGCGACGACATGCGACTAGGTACCAATGAGCAGTTCTTC	CASSDDMRLGTNEQFF	TRBV9	TRBJ2-1
TGTGCCAGCAGCATGACCCCATTAATGGTTCTGTTTTTT	CASSMTPLMVLFF	TRBV7-3	TRBJ1-4
TGTGCCAGTAGTATAGAGCGGGCTGGCAGTAGCACAGATACGCAGTATTTT	CASSIERAGSSTDTQYF	TRBV19	TRBJ2-3
TGTGCCAGCAGCAGGACCTTTCCGGGAGGGGCCAGGGATACGCAGTATTTT	CASSRTFPGGARDTQYF	TRBV13	TRBJ2-3
TGCGCCAGCAGCCAAGATCCCCCGGCCGAGGGGACCGGGGAGCTGTTTTTT	CASSQDPPAEGTGELFF	TRBV4-1	TRBJ2-2
TGTGCCAGCAGCTTAGTTCAACAGACAGCCCATGGCTACACCTTC	CASSLVQQTAHGYTF	TRBV11-2	TRBJ1-2
TGTGCCAGCAGCAATGTAGGCGAATCCACTGAAGCTTTCTTT	CASSNVGESTEAFF	TRBV13	TRBJ1-1
TGTGCCAGCAGACGGACAGGGGGCGCATGGGAGCAGTACTTC	CASRRTGGAWEQYF	TRBV28	TRBJ2-7
TGTGCCAGCAGCTGGCCGGGGTACAATGAGCAGTTCTTC	CASSWPGYNEQFF	TRBV11-2	TRBJ2-1
TGTGCCTGGAGTGTACAGCGGCGGGCTTACAATGAGCAGTTCTTC	CAWSVQRRAYNEQFF	TRBV30	TRBJ2-1
TGTGCCAGCAGCCAAGACTCCCCTAGCGCCCCCAATGAGCAGTTCTTC	CASSQDSPSAPNEQFF	TRBV14	TRBJ2-1
TGTGCCATCAGTCAAAGGGGTCCCGATACGCAGTATTTT	CAISQRGPDTQYF	TRBV10-3	TRBJ2-3
TGCAGTGCTAGACCCTCTGGGCCTATCTTGGCCAATCAGCCCCAGCATTTT	CSARPSGPILANQPQHF	TRBV20-1	TRBJ1-5
TGTGCCAGCATCCCGGGGGGGTGCACAGATACGCAGTATTTT	CASIPGGCTDTQYF	TRBV6-4	TRBJ2-3
TGTGCCAGCAGTGAATTTCAGGGGGCGAAGCCCCAGCATTTT	CASSEFQGAKPQHF	TRBV25-1	TRBJ1-5
TGTGCCAGCATCAGACTAGCGGGCGGGGACTACAATGAGCAGTTCTTC	CASIRLAGGDYNEQFF	TRBV6-3	TRBJ2-1
TGTGCCCTTCTCGAGCAGTACTTC	CALLEQYF	TRBV3-1	TRBJ2-7
TGTGCCAGCAGTGATACCGGGACAGGGGGGTGGGGCCGAAGTACCGAGCAGTACTTC	CASSDTGTGGWGRSTEQYF	TRBV6-1	TRBJ2-7
TGCGCCAGGAATATACTAGCGGGGTTTGGGCAAGAGACCCAGTACTTC	CARNILAGFGQETQYF	TRBV10-1	TRBJ2-5
TGTGCCAGCAGCTTACTCAGGGGGTATAGCAATCAGCCCCAGCATTTT	CASSLLRGYSNQPQHF	TRBV7-2	TRBJ1-5
TGTGCCAGCAACCCCGGGGTGGCCTACGAGCAGTACTTC	CASNPGVAYEQYF	TRBV6-4	TRBJ2-7
TGCGCCAGCAGTGATTATCCGGACCAAGAGACCCAGTACTTC	CASSDYPDQETQYF	TRBV10-1	TRBJ2-5
TGTGCCAGCTCACCGAGTCCGTTCCCTTACGAGCAGTACTTC	CASSPSPFPYEQYF	TRBV18	TRBJ2-7
TGCAGCGTTCCATTCTCTAGCGGGATCATTAGGCAACATGAGCAGTTCTTC	CSVPFSSGIIRQHEQFF	TRBV29-1	TRBJ2-1
TGTGCCAGCAGCCCGGCACAGGAACCCTCCTACAATGAGCAGTTCTTC	CASSPAQEPSYNEQFF	TRBV5-6	TRBJ2-1
TGCGCCAGCAGCTTGGGGACGCCAGCTGACACCGGGGAGCTGTTTTTT	CASSLGTPADTGELFF	TRBV5-1	TRBJ2-2
TGTGCCACCAGTGACCCCCGACGGCGCGAGCAGTACTTC	CATSDPRRREQYF	TRBV24-1	TRBJ2-7
TGTGCCAGCAGCCCCCACATTCCGTTTCGGCCCGGTGCTTTCTTT	CASSPHIPFRPGAFF	TRBV7-3	TRBJ1-1
TGCAGTGCTAGAGATAGAGGAACACTAGATACGCAGTATTTT	CSARDRGTLDTQYF	TRBV20-1	TRBJ2-3
TGTGCCAGCAAACCAGCGGGAGGTATCAATCAGCCCCAGCATTTT	CASKPAGGINQPQHF	TRBV6-8	TRBJ1-5
TGTGCCAGCAGCTTTCCGGGACAGCGACCCCTGTTTTTT	CASSFPGQRPLFF	TRBV5-6	TRBJ1-4
TGTGCCAGCAGCGGGGACCTGCATGGCTACACCTTC	CASSGDLHGYTF	TRBV5-8	TRBJ1-2
TGTGCCAGCCTCCCCTCACGGGGGGCAGAACCCTACAATGAGCAGTTCTTC	CASLPSRGAEPYNEQFF	TRBV12-4	TRBJ2-1
TGTGCCACCAGTGAGAGACAGCATACCAGCTCCTATAATTCACCCCTCCACTTT	CATSERQHTSSYNSPLHF	TRBV24-1	TRBJ1-6
TGTGCCAGCAGCACGTTAGGGACTAGCGGGCTCCCTTTGGACCATTACGAGCAGTACTTC	CASSTLGTSGLPLDHYEQYF	TRBV13	TRBJ2-7
TGCAGTGCTAGAAGTCCAAAGGGGGGTTCCGAGTCCTTGCTGCCATACAATGAGCAGTTCTTC	CSARSPKGGSESLLPYNEQFF	TRBV20-1	TRBJ2-1
TGTGCCACCAGTGAGGGGCGCGATGAAGCTTTCTTT	CATSEGRDEAFF	TRBV24-1	TRBJ1-1
TGTGCCAGCAGTGAAACTAGCGGGGTCGACATTCAGTACTTC	CASSETSGVDIQYF	TRBV12-4	TRBJ2-4
TGTGCCAGCAGCTTGTTGCCTAACCGGGACAGGGGCGAGGCCGGGGACTACGAGCAGTACTTC	CASSLLPNRDRGEAGDYEQYF	TRBV5-6	TRBJ2-7
TGTGCCAGCAGCCAAGATGACAGGGCCATGAGCTCCTACGAGCAGTACTTC	CASSQDDRAMSSYEQYF	TRBV3-1	TRBJ2-7
TGTGCCAGCAGTGACCGTTTTTTGGCTTGTGGAGAGCCCCAGCATTTT	CASSDRFLACGEPQHF	TRBV6-4	TRBJ1-5
TGCAGCGTGAGCAGGGGCTCAGGGGCTAGCACAGATACGCAGTATTTT	CSVSRGSGASTDTQYF	TRBV29-1	TRBJ2-3
TGTGCCAGCCGCCTATGGGAAAACATTCAGTACTTC	CASRLWENIQYF	TRBV27	TRBJ2-4
TGTGCCAGCAGCTTACAACAGGGACATTTGGGCAATCAGCCCCAGCATTTT	CASSLQQGHLGNQPQHF	TRBV13	TRBJ1-5
TGTGCCAGCAGTTTAAAGGAGGCAGATACGCAGTATTTT	CASSLKEADTQYF	TRBV28	TRBJ2-3
TGTGCCAGCAGCTTAGAAAAGGTGGGGAGAAACACCGGGGAGCTGTTTTTT	CASSLEKVGRNTGELFF	TRBV7-9	TRBJ2-2
TGTGCCAGCAGCAGGGGGGCCGGCTACAATGAGCAGTTCTTC	CASSRGAGYNEQFF	TRBV6-1	TRBJ2-1
TGCAGTGCAAAAAAGACCACTGAAGCTTTCTTT	CSAKKTTEAFF	TRBV20-1	TRBJ1-1
TGTGCCAGTAGTATGGGGGCTTGGGGCGAGCAGTACTTC	CASSMGAWGEQYF	TRBV19	TRBJ2-7
TGCAGCCCCCCAATTCCTAATTCACCCCTCCACTTT	CSPPIPNSPLHF	TRBV29-1	TRBJ1-6
TGTGCCACCAGTGATTTCCGGGCGGGACAGGGGATCTACTCCAACACCTATAATTCACCCCTCCACTTT	CATSDFRAGQGIYSNTYNSPLHF	TRBV24-1	TRBJ1-6
TGTGCCAGCAGTTTTTACCAAGCCTTCACAGATACGCAGTATTTT	CASSFYQAFTDTQYF	TRBV27	TRBJ2-3
TGCAGTGCTCTAAGTTTAATGGGGAAAAGCAATCAGCCCCAGCATTTT	CSALSLMGKSNQPQHF	TRBV20-1	TRBJ1-5
TGTGCCAGCAGTAAGCGCGGGCCGTACGAGCAGTACTTC	CASSKRGPYEQYF	TRBV28	TRBJ2-7
TGTGCCAGCATTCTAACTTTTGTGACGAGCACAGATACGCAGTATTTT	CASILTFVTSTDTQYF	TRBV28	TRBJ2-3
TGTGCCAGCAGTTACCAAGCGGAAGCAGTCCCGTGCTACAATGAGCAGTTCTTC	CASSYQAEAVPCYNEQFF	TRBV6-2	TRBJ2-1
TGTGCCAGCAGCGGCCCGGGAGGATGCACCGGGGAGCTGTTTTTT	CASSGPGGCTGELFF	TRBV9	TRBJ2-2
TGTGCCAGCAGCCTTTCACACGGACGGTACGAGCAGTACTTC	CASSLSHGRYEQYF	TRBV3-1	TRBJ2-7
TGCAGTCTTATGGGGGAGCTGTTTTTT	CSLMGELFF	TRBV20-1	TRBJ1-4
TGTGCCATCAGTGAGTCTGTCTGGACTCATACGCAGTATTTT	CAISESVWTHTQYF	TRBV10-3	TRBJ2-3
TGTGCCAGCAGAGCTACAGGGTACAATGAGCAGTTCTTC	CASRATGYNEQFF	TRBV9	TRBJ2-1
TGCGCCAGCAGCTTGGCGGTCAACGGAGGGAAACTCTCCTACGAGCAGTACTTC	CASSLAVNGGKLSYEQYF	TRBV5-1	TRBJ2-7
TGCGCCAGCAGTGAGCACAGGCTCACAGTCGGGGAGCTGTTTTTT	CASSEHRLTVGELFF	TRBV10-2	TRBJ2-2
TGCGCCTATCCGAGCCCGGACCAAGAGACCCAGTACTTC	CAYPSPDQETQYF	TRBV10-1	TRBJ2-5
TGTGCCAGCTCACCCCCCGGGGGGGTCGAGCAGTACTTC	CASSPPGGVEQYF	TRBV18	TRBJ2-7
TGTGCCAGCAGTTACACTAGCTCCTACGAGCAGTACTTC	CASSYTSSYEQYF	TRBV6-2	TRBJ2-7
TGTGCCAGCAGCTCTTTGGGGGGGCTAGACAATGAGCAGTTCTTC	CASSSLGGLDNEQFF	TRBV11-2	TRBJ2-1
TGTGCCAGCAGTGCTAGCGGACGGTTTCACTATGGCTACACCTTC	CASSASGRFHYGYTF	TRBV6-1	TRBJ1-2
TGTGCCAGCATTTCGGGGCATAGGAGATCCTCTGGAAACACCATATATTTT	CASISGHRRSSGNTIYF	TRBV6-3	TRBJ1-3
TGTGCCACCAGTGAACTGGGCGGTGCAGATACGCAGTATTTT	CATSELGGADTQYF	TRBV24-1	TRBJ2-3
TGTGCCAGCCCACCGACAATGGAAAAACTGTTTTTT	CASPPTMEKLFF	TRBV7-3	TRBJ1-4
TGTGCCAGCAGCTTAACCTCGCGGGACAGGGCCTTAGGAAACACCATATATTTT	CASSLTSRDRALGNTIYF	TRBV7-2	TRBJ1-3
TGTGCCATTTGGCCCGTCTACGAGCAGTACTTC	CAIWPVYEQYF	TRBV6-4	TRBJ2-7
TGCGCCAGCAGCTTGTCGGTCTGGACGCGCTACGAGCAGTACTTC	CASSLSVWTRYEQYF	TRBV5-1	TRBJ2-7
TGTGCCAGCAGCCTCGGTTGGTATTTCCGGACAGTCTGCCCGGGCTACACCTTC	CASSLGWYFRTVCPGYTF	TRBV7-9	TRBJ1-2
TGTGCCAGCAGCGCCTTCAAAGGGTCTGGGGCCAACGTCCTGACTTTC	CASSAFKGSGANVLTF	TRBV11-2	TRBJ2-6
TGCGCCAGCAGCCAAGATAAAAGGTGGGACAGGGGTCCGTGCATTACTGAAGCTTTCTTT	CASSQDKRWDRGPCITEAFF	TRBV4-1	TRBJ1-1
TGTGCCAGCAGTATCAAGCATCTTAAGAAGTGTCATCAGCCCCAGCATTTT	CASSIKHLKKCHQPQHF	TRBV28	TRBJ1-5
TGTGCTAGTGGTCCTATCGGGACGGGACAGGGGGCGTGGGCGCATGATGGCTACACCTTC	CASGPIGTGQGAWAHDGYTF	TRBV12-5	TRBJ1-2
TGCGCCAGCAGCTTGGGGGGGCCCGGCCAGTACTTC	CASSLGGPGQYF	TRBV5-1	TRBJ2-5
TGTGCCAGCAGCGGAGACAGAATTAGGTATAGCAATCAGCCCCAGCATTTT	CASSGDRIRYSNQPQHF	TRBV12-3	TRBJ1-5
TGTGCCTCTAAGCGTGGAACTGAAGCTTTCTTT	CASKRGTEAFF	TRBV19	TRBJ1-1
TGTGCCAGCAGTTACTCGAACAATGTACTGCGATGGAGCTCCTATAATTCACCCCTCCACTTT	CASSYSNNVLRWSSYNSPLHF	TRBV6-5	TRBJ1-6
TGTGCCAGCAGCATCTCAGGGAGGGTTACTGGGGCCAACGTCCTGACTTTC	CASSISGRVTGANVLTF	TRBV7-4	TRBJ2-6
TGTGCCAGCAGCCCGTCGACTGAGCAGTTCTTC	CASSPSTEQFF	TRBV7-3	TRBJ2-1
TGTGCCAGCAGCTCCAGGAACTCTGGAAACACCATATATTTT	CASSSRNSGNTIYF	TRBV7-6	TRBJ1-3
TGCAGCGCGCAGGGACAGGGACAAGAGACCCAGTACTTC	CSAQGQGQETQYF	TRBV29-1	TRBJ2-5
TGCGCCAGCAGCTTGCCGGAGGGTAGCAGGGGGGCTAGCCTCTACGAGCAGTACTTC	CASSLPEGSRGASLYEQYF	TRBV5-1	TRBJ2-7
TGTGCCAGCAGGAACCAGGGGAGCAGCAATCAGCCCCAGCATTTT	CASRNQGSSNQPQHF	TRBV6-5	TRBJ1-5
TGTGCCAGCAGCTGGGGGGGGGGGAGGGAGTCCTACGAGCAGTACTTC	CASSWGGGRESYEQYF	TRBV13	TRBJ2-7
TGTGCCAGCAGCTTATTGGGGGAATCCTACGAGCAGTACTTC	CASSLLGESYEQYF	TRBV7-6	TRBJ2-7
TGCGCCAGCAGCCAAGATCGGGACAGTGAGTGTCAGCCCCAGCATTTT	CASSQDRDSECQPQHF	TRBV4-1	TRBJ1-5
TGTGCCAGCAGTTCAGGGGCTAATGAAAAACTGTTTTTT	CASSSGANEKLFF	TRBV3-1	TRBJ1-4
TGTGCCAGCAGCCCTCGGTCCATTGTGACAGGGGGAAACGAGCAGTACTTC	CASSPRSIVTGGNEQYF	TRBV11-3	TRBJ2-7
TGTGCCAGCAGCCTAGACCAGCTCCGGGTTCAGCCCCAGCATTTT	CASSLDQLRVQPQHF	TRBV6-2	TRBJ1-5
TGTGCCACCTTTCCCGACAGGTTCCATAGCAATCAGCCCCAGCATTTT	CATFPDRFHSNQPQHF	TRBV24-1	TRBJ1-5
TGCAGTGCTAGACAGCTTTATAATTCACCCCTCCACTTT	CSARQLYNSPLHF	TRBV20-1	TRBJ1-6
TGTGCCAGCAGCGCAAGGTGGCAGACCCTCTATGGCTACACCTTC	CASSARWQTLYGYTF	TRBV7-9	TRBJ1-2
TGTGCCAGCAAAACTAACTCCTGTTGGCCTAGCAATCAGCCCCAGCATTTT	CASKTNSCWPSNQPQHF	TRBV6-1	TRBJ1-5
TGTGCCAGCAGCCAAGATCTTAAAGGGCCCTGCTACACCTTC	CASSQDLKGPCYTF	TRBV4-2	TRBJ1-2
TGTGCCTGGAGTGGGCCAGCCCGGTGGGAAAATGAAAAACTGTTTTTT	CAWSGPARWENEKLFF	TRBV30	TRBJ1-4
TGTGCCAGCAGTGAGGGATCTGGGGGCCCTCAGGGTGGCTACACCTTC	CASSEGSGGPQGGYTF	TRBV25-1	TRBJ1-2
TGTGCCAGCAGCTTAGTCATGGTACAGGGTTTTGGCTACACCTTC	CASSLVMVQGFGYTF	TRBV7-6	TRBJ1-2
TGCGCCAGCAGCCTTCTCAAACTGTTTTTT	CASSLLKLFF	TRBV5-1	TRBJ1-4
TGTGCCAGCAGTTTGCTAAAAAATAGGGACTATGGCTACACCTTC	CASSLLKNRDYGYTF	TRBV28	TRBJ1-2
TGTGCCACCAGTGATGCAGGGGGCCTCACAGATACGCAGTATTTT	CATSDAGGLTDTQYF	TRBV24-1	TRBJ2-3
TGCAGTGCTAGTACAGGGTGTTATAATTCACCCCTCCACTTT	CSASTGCYNSPLHF	TRBV20-1	TRBJ1-6
TGTGCCAGCAGCGCTCTCCCCGAGGGCGGCTACGAGCAGTACTTC	CASSALPEGGYEQYF	TRBV7-9	TRBJ2-7
TGCGCCAGCAGCCACCGCCCCGGGACATACCGTAGCGCCAAAAACATTCAGTACTTC	CASSHRPGTYRSAKNIQYF	TRBV4-1	TRBJ2-4
TGTGCCAGCAGCCTAGGGACAGGGTACGAGCAGTACTTC	CASSLGTGYEQYF	TRBV5-6	TRBJ2-7
TGTGCCAGCAGCGAACGCGAGTCAGGGGCTCCGGAAAAACTGTTTTTT	CASSERESGAPEKLFF	TRBV7-3	TRBJ1-4
TGTGCCAGCTCACTGGACAGCCTCTTTCCCCAGCATTTT	CASSLDSLFPQHF	TRBV18	TRBJ1-5
TGTGCCAGCAGCTCCGGACTAGCAGGATGCGCAGATACGCAGTATTTT	CASSSGLAGCADTQYF	TRBV7-9	TRBJ2-3
TGCGCCAGCTCCCTGAGAGTGAAAGACACAGATACGCAGTATTTT	CASSLRVKDTDTQYF	TRBV5-1	TRBJ2-3
TGTGCCAGTAGCCAGAGACAGTGGGGAATGCCCCAGCATTTT	CASSQRQWGMPQHF	TRBV19	TRBJ1-5
TGTGCCACCAGATCCCAGGGACAGCTCAAAGGGCAGCCCCAGCATTTT	CATRSQGQLKGQPQHF	TRBV24-1	TRBJ1-5
TGTGCCAGCAGTTTCCGGGACAGGGTTGGGAACACTGAAGCTTTCTTT	CASSFRDRVGNTEAFF	TRBV28	TRBJ1-1
TGTGCCAGCAGCGACAGGGGTTACTATGGCTACACCTTC	CASSDRGYYGYTF	TRBV11-1	TRBJ1-2
TGCGCCAGCAGCTTGTACCACAGGGGGCATTTT	CASSLYHRGHF	TRBV5-1	TRBJ1-5
TGTGCCAGCAGAGGGAAGGGGGCGACGTGGGATGGCTACACCTTC	CASRGKGATWDGYTF	TRBV28	TRBJ1-2
TGTGCCTGGAGTGCAGGGGGAGAGACCCAGTACTTC	CAWSAGGETQYF	TRBV30	TRBJ2-5
TGTGCCACCAGTGGGCCGGGGGTAGCGGGAAAAAAGTCGGCCGCAAATGAAAAACTGTTTTTT	CATSGPGVAGKKSAANEKLFF	TRBV24-1	TRBJ1-4
TGTGCCACGGACAGGAGGGACACCTTC	CATDRRDTF	TRBV6-1	TRBJ1-2
TGCGCCAGCAGCTGGGGACAGGATAATGAAAAACTGTTTTTT	CASSWGQDNEKLFF	TRBV5-1	TRBJ1-4
TGCGCCAGCAGTGATGTTCAGGGGGCAATGAGCACAGATACGCAGTATTTT	CASSDVQGAMSTDTQYF	TRBV10-2	TRBJ2-3
TGTGCCACCGGACAGGCCAAAAACATTCAGTACTTC	CATGQAKNIQYF	TRBV15	TRBJ2-4
TGTGCCAGCAGGTCTGGGGTGGATCAGCCCCAGCATTTT	CASRSGVDQPQHF	TRBV12-4	TRBJ1-5
TGTGCCAGCAGTCCAGGGGAAAAGCATGGACGGTATGGCTACACCTTC	CASSPGEKHGRYGYTF	TRBV6-5	TRBJ1-2
TGTGCCAGATTAGACAGGGATGAAAAACTGTTTTTT	CARLDRDEKLFF	TRBV27	TRBJ1-4
TGTGCCAGCAGTTCCGAAACTGTCAATGAGCAGTTCTTC	CASSSETVNEQFF	TRBV6-3	TRBJ2-1
TGTGCCAGCAGCAGGAGGACCTCAGGGCCTTATGGCTACACCTTC	CASSRRTSGPYGYTF	TRBV7-2	TRBJ1-2
TGTGCCAGCAGTCCCGGTTGGAGGGCGAACCAAAGGAGGAATTCACCCCTCCACTTT	CASSPGWRANQRRNSPLHF	TRBV6-5	TRBJ1-6
TGTGCCAGCAGGAGATTTGAAGGCTACACCTTC	CASRRFEGYTF	TRBV6-4	TRBJ1-2
TGTGCCACCAGTGAAGCTACCGGAGATCAGCCCCAGCATTTT	CATSEATGDQPQHF	TRBV24-1	TRBJ1-5
TGTGCCAGCAGCTTATTCGCGAAATCAGTAGTTGCGGGAAAACGGGAGACCCAGTACTTC	CASSLFAKSVVAGKRETQYF	TRBV7-6	TRBJ2-5
TGTGCCACCGGGCCCGGGGAAGGTAACAATCAGCCCCAGCATTTT	CATGPGEGNNQPQHF	TRBV2	TRBJ1-5
TGTGCCAGCAGATGCAACCTCCGAGTTTCCTACGAGCAGTACTTC	CASRCNLRVSYEQYF	TRBV6-4	TRBJ2-7
TGTGCTAGTGGATCCGCGGCGGGGGAAAATGCAAGGGGAAAAGATACGCAGTATTTT	CASGSAAGENARGKDTQYF	TRBV12-5	TRBJ2-3
TGTGCCATTTACGCGAATACGGGTAGGGTGGGGAGAAAACTGTTTTTT	CAIYANTGRVGRKLFF	TRBV6-8	TRBJ1-4
TGTGCCAGCAGCCTGGCTGGAGAGCAGTACTTC	CASSLAGEQYF	TRBV6-5	TRBJ2-7
TGTGCCAGCAGCCAAGATCCGCCAGTACTGGGGGCAGAAAAACTGTTTTTT	CASSQDPPVLGAEKLFF	TRBV14	TRBJ1-4
TGCAGCGTAACCAGGCCCGCCATGTACATTCAGTACTTC	CSVTRPAMYIQYF	TRBV29-1	TRBJ2-4
TGTGCCAGCAGTTACTGGCTCCGCCAGGGAGAGCAGTACTTC	CASSYWLRQGEQYF	TRBV6-5	TRBJ2-7
TGTGCCAGTAGTCCCAATCCTTTAGTGGACACCGGGGAGCTGTTTTTT	CASSPNPLVDTGELFF	TRBV19	TRBJ2-2
TGTGCCAGAGGCAGGGTGCAGCCCCAGCATTTT	CARGRVQPQHF	TRBV6-1	TRBJ1-5
TGTAGACCCACTAGCGGGAGGGCTACAGAGACCCAGTACTTC	CRPTSGRATETQYF	TRBV7-9	TRBJ2-5
TGCGCCAGCAGCTTGCATCCCGGGGGGTACAATGAGCAGTTCTTC	CASSLHPGGYNEQFF	TRBV5-1	TRBJ2-1
TGTGCCAGCAGTACTGCGGGTGTAATGGGTCCAGATACGCAGTATTTT	CASSTAGVMGPDTQYF	TRBV6-5	TRBJ2-3
TGTGCCAGCAGTTCAGGTCTCAGACAGGGCAGAAGTATTGGGGAGACCCAGTACTTC	CASSSGLRQGRSIGETQYF	TRBV6-2	TRBJ2-5
TGTGCTAGTGGTTTGAACTTGGCGGTATACGAGCAGTACTTC	CASGLNLAVYEQYF	TRBV12-5	TRBJ2-7
TGCAGCAATGGGAGGGGGACGAATGTGTCCTATAATTCACCCCTCCACTTT	CSNGRGTNVSYNSPLHF	TRBV29-1	TRBJ1-6
TGTGCCAGCAGCTACCGTTCAACAGTATGCACAGATACGCAGTATTTT	CASSYRSTVCTDTQYF	TRBV7-3	TRBJ2-3
TGTGCCAGCAGGGTTCACGCAGGGGACTCCTACGAGCAGTACTTC	CASRVHAGDSYEQYF	TRBV11-2	TRBJ2-7
TGTGCCAGCAGCGTCGCAACTAAACGGACCCTGTTTTTT	CASSVATKRTLFF	TRBV7-4	TRBJ1-4
TGTGCCAGCAGCGTAGTAGGGGGTCCCCGGAGCATAAGCACTGAAGCTTTCTTT	CASSVVGGPRSISTEAFF	TRBV9	TRBJ1-1
TGTGCCAGCAGTGCCCAGGGAAACACTGAAGCTTTCTTT	CASSAQGNTEAFF	TRBV12-3	TRBJ1-1
TGCGCCAGCAGCCCACAGGGGAGCGAGCAGTACTTC	CASSPQGSEQYF	TRBV4-1	TRBJ2-7
TGTGCCAGCAGCTGGCCGGGACTAGCTCCCCGTCCCTCCTACGAGCAGTACTTC	CASSWPGLAPRPSYEQYF	TRBV7-9	TRBJ2-7
TGTGCCAGCAGCTTAGCCCAGGGAAAGAACACTGAAGCTTTCTTT	CASSLAQGKNTEAFF	TRBV11-2	TRBJ1-1
TGTGCCAGCAGTGACTCCGTCGGACTAGCCCGCACCGGGGAGCTGTTTTTT	CASSDSVGLARTGELFF	TRBV6-4	TRBJ2-2
TGTGCCACCAGTGATTTGCTTCCGCGAACGTGGGGAATCTCCTACGAGCAGTACTTC	CATSDLLPRTWGISYEQYF	TRBV24-1	TRBJ2-7
TGTGCCAGCAGCGTAGCCCTCCCAAGGAGTGCCCGCTACGAGCAGTACTTC	CASSVALPRSARYEQYF	TRBV9	TRBJ2-7
TGTGCCAGCAGCTTAGTTCCTGAAGACAGGGACTTAAGGGGGAACACTGAAGCTTTCTTT	CASSLVPEDRDLRGNTEAFF	TRBV7-4	TRBJ1-1
TGTGCCAGCAGCTTCAAAAAGAAGGGCCCGAAAAGCTCCTACAATGAGCAGTTCTTC	CASSFKKKGPKSSYNEQFF	TRBV7-4	TRBJ2-1
TGTGCCAGCAGCCAAGATCTTGCGGAGGGTTACAATCAGCCCCAGCATTTT	CASSQDLAEGYNQPQHF	TRBV14	TRBJ1-5
TGTGCCAGCAGCTTACGACAGGGCTCAGGTGGCTACACCTTC	CASSLRQGSGGYTF	TRBV11-1	TRBJ1-2
TGCAGTCTAGGAGGAGAGACCCAGTACTTC	CSLGGETQYF	TRBV20-1	TRBJ2-5
TGTGCCAGCAGTTACGACAAACTAGCGGGTGAGGAGACCCAGTACTTC	CASSYDKLAGEETQYF	TRBV27	TRBJ2-5
TGTGCCAGCAGCTACCGACAGGTAGGGGGGACCTACAATGAGCAGTTCTTC	CASSYRQVGGTYNEQFF	TRBV7-3	TRBJ2-1
TGTGCCAGCAGCAAGGTGGACAGGAGGGAATATGGCTACACCTTC	CASSKVDRREYGYTF	TRBV2	TRBJ1-2
TGTGCCAGCAGCTCCACCTATAGAGGGAGGGATCCTATCTACGAGCAGTACTTC	CASSSTYRGRDPIYEQYF	TRBV5-8	TRBJ2-7
TGTGCCAGCAGTTTATGCGGGGGCGCTCGGATTGAGCAGTTCTTC	CASSLCGGARIEQFF	TRBV28	TRBJ2-1
TGTGCCACCAAGGGGGCTAGGATTAGGGACACTGAAGCTTTCTTT	CATKGARIRDTEAFF	TRBV5-4	TRBJ1-1
TGCGCCAGCATAAAAGGGGGGGCAATCACCGGGGAGCTGTTTTTT	CASIKGGAITGELFF	TRBV10-1	TRBJ2-2
TGCAGTGCTTCCCTTCCAGGGTTATGCGACTATGGCTACACCTTC	CSASLPGLCDYGYTF	TRBV20-1	TRBJ1-2
TGCAGTGCTTTAGTAAGGAGTAGTTCCGGGGAGCTGTTTTTT	CSALVRSSSGELFF	TRBV20-1	TRBJ2-2
TGTGCCAGCAGCAGGGTCCGGTACGAGCAGTACTTC	CASSRVRYEQYF	TRBV11-2	TRBJ2-7
TGTGCCAGCAGCTTAGCCCTCAGGGGGTGGACCGGGGAGCTGTTTTTT	CASSLALRGWTGELFF	TRBV11-2	TRBJ2-2
TGTGCCAGCAGTCGGGACAGGGTGGACCGAAAAACGCAGTTCGGGGCCCGCCAAGAGACCCAGTACTTC	CASSRDRVDRKTQFGARQETQYF	TRBV6-3	TRBJ2-5
TGTGCCAGCAGCGTAGCTCCGCGAGTAAGCGGGAGAACAGATACGCAGTATTTT	CASSVAPRVSGRTDTQYF	TRBV9	TRBJ2-3
TGTGCCACTGTTCCCCACCCTCTGGGGAGCTCCTATAATTCACCCCTCCACTTT	CATVPHPLGSSYNSPLHF	TRBV6-6	TRBJ1-6
TGTGCCAGCAGCCCGATGGGTTCCCCCCAGGGTGAAGCTTTCTTT	CASSPMGSPQGEAFF	TRBV14	TRBJ1-1
TGCAGTGCTAGAGCTTGCGGGATGTATAGCAATCAGCCCCAGCATTTT	CSARACGMYSNQPQHF	TRBV20-1	TRBJ1-5
TGTGCCAGCAGTTTACATGGGACCGACATTCAGTACTTC	CASSLHGTDIQYF	TRBV12-4	TRBJ2-4
TGTGCCAGCAGTGACCCCCAAACAGGGACAGGGTGGTCGTCACGGGGAGGGGCTGGCTACGAGCAGTACTTC	CASSDPQTGTGWSSRGGAGYEQYF	TRBV6-4	TRBJ2-7
TGCGCCAGCAGCCAATGGGGAGGGCCGTTTCCCGGGGAGCTGTTTTTT	CASSQWGGPFPGELFF	TRBV4-1	TRBJ2-2
TGTGCCTGGAGTGTGCCATGGAGGGGCGTAAACCGCTACACCTTC	CAWSVPWRGVNRYTF	TRBV30	TRBJ1-2
TGCGCCAGCAGTGAGTCGGAACCCCTCCACTTT	CASSESEPLHF	TRBV10-2	TRBJ1-6
TGTGCCACGTTCGACAGGGTTTACAATCAGCCCCAGCATTTT	CATFDRVYNQPQHF	TRBV24-1	TRBJ1-5
TGTGCCAGGAAGGAAAATAGCGGGATCGACTACTACGAGCAGTACTTC	CARKENSGIDYYEQYF	TRBV3-1	TRBJ2-7
TGTGCCAGCAGGCTAGCGGGAGTAGCTCGGTACGAGCAGTACTTC	CASRLAGVARYEQYF	TRBV6-4	TRBJ2-7
TGTGCCAGCAAAGGGCGGGGCACAGATACGCAGTATTTT	CASKGRGTDTQYF	TRBV6-4	TRBJ2-3
TGCGCCAGCACCATATGGGGGTTCTTC	CASTIWGFF	TRBV5-1	TRBJ2-1
TGTGCCAGCAGCCCCCGGACTAGCGGCAGTGAGCAGTACTTC	CASSPRTSGSEQYF	TRBV14	TRBJ2-7
TGTGCCAGCAGTTCCAGACAGGGGATTGAGCGGGGTAACTATGGCTACACCTTC	CASSSRQGIERGNYGYTF	TRBV27	TRBJ1-2
TGTGCCAGCAGTTTCTGGACAGGGGGCCGATTTAAAGAGCAGTACTTC	CASSFWTGGRFKEQYF	TRBV6-5	TRBJ2-7
TGTGCCAGCAGCCGACTAGCGGGGGACAATGAGCAGTTCTTC	CASSRLAGDNEQFF	TRBV7-4	TRBJ2-1
TGCGCCAGCAGCCAAGATGAGGGGCAGGGGCGACTTCAGCCCCAGCATTTT	CASSQDEGQGRLQPQHF	TRBV4-1	TRBJ1-5
TGTGCCAGCAGAGATCGGCCCCCCTACGAGCAGTACTTC	CASRDRPPYEQYF	TRBV6-5	TRBJ2-7
TGTGCCAGCAGAGTAGCTCGCTACAATGAGCAGTTCTTC	CASRVARYNEQFF	TRBV28	TRBJ2-1
TGTGTAGGTAATTTGACAGGGTCCGATGGCTACACCTTC	CVGNLTGSDGYTF	TRBV5-4	TRBJ1-2
TGTGCCAGCAGCTTGGGCGACCGTAGGACCGGGGCCAATTCTGGAAACACCATATATTTT	CASSLGDRRTGANSGNTIYF	TRBV5-6	TRBJ1-3
TGTGCCAGCAGCCCCAGGGGACTAGCGGGTGGTCACTACGAGCAGTACTTC	CASSPRGLAGGHYEQYF	TRBV4-2	TRBJ2-7
TGTGCCAGCAAGGGGGCCAACGTCCTGACTTTC	CASKGANVLTF	TRBV12-3	TRBJ2-6
TGTGCCAGCAGCCAAGACCCATCAGGGACTAGACGCTACAATGAGCAGTTCTTC	CASSQDPSGTRRYNEQFF	TRBV4-2	TRBJ2-1
TGTGCCAGCAGCTTGGGGACAGGGGGCGACACCGGGGAGCTGTTTTTT	CASSLGTGGDTGELFF	TRBV5-8	TRBJ2-2
TGTGCCAGCAGTCCGAGGACAGGGTTCCTAGTGAACACTGAAGCTTTCTTT	CASSPRTGFLVNTEAFF	TRBV27	TRBJ1-1
TGCAGTGCAGGATCACGGTCCTACGAGCAGTACTTC	CSAGSRSYEQYF	TRBV20-1	TRBJ2-7
TGTGCCAGTAGGACAGGGTATGAAGCTTTCTTT	CASRTGYEAFF	TRBV19	TRBJ1-1
TGTGCCAGTAGTATTACGGGACATAATCAATTGAACACTGAAGCTTTCTTT	CASSITGHNQLNTEAFF	TRBV19	TRBJ1-1
TGTGCCAGCAGCGTCGGGGGGCGAGGCTACACCTTC	CASSVGGRGYTF	TRBV5-6	TRBJ1-2
TGTGCCAGCAGCTTCGCTCCAATTCGCAGCGGGACTCTGAGCGAGCAGTACTTC	CASSFAPIRSGTLSEQYF	TRBV5-4	TRBJ2-7
TGTGCCACCAGTGATTGTACTTACGAGCAGTACTTC	CATSDCTYEQYF	TRBV24-1	TRBJ2-7
TGTGCCAGCAGCTTAACGCATGGTCCGGGACAGATAGCTTTCTTT	CASSLTHGPGQIAFF	TRBV7-3	TRBJ1-1
TGTGCCAGCAGCGTCCCTGAGGAGACCCAGTACTTC	CASSVPEETQYF	TRBV13	TRBJ2-5
TGTGCCAGTAGTATAGATAGCACCTTAAATTGGGACAAGATGAACACTGAAGCTTTCTTT	CASSIDSTLNWDKMNTEAFF	TRBV19	TRBJ1-1
TGTGCCCAGCAATACGTTCCCGAGCAGTACTTC	CAQQYVPEQYF	TRBV10-3	TRBJ2-7
TGCGCCAGCAGGACAGGGGACCCCCCTAACTATGGCTACACCTTC	CASRTGDPPNYGYTF	TRBV10-1	TRBJ1-2
TGCGCCAGCAGTCGTAGGGTAGATACGCAGTATTTT	CASSRRVDTQYF	TRBV5-1	TRBJ2-3
TGTGCCAGCAGTTTAGCGGGGGGCCGTCACACCGGGGAGCTGTTTTTT	CASSLAGGRHTGELFF	TRBV28	TRBJ2-2
TGTGCCTGGTTACAAGCTGAGGGCCTTCGTACCCGCTATACGCAGTATTTT	CAWLQAEGLRTRYTQYF	TRBV30	TRBJ2-3
TGCAAAACCCTAGCCAACACTGAAGCTTTCTTT	CKTLANTEAFF	TRBV20-1	TRBJ1-1
TGTGCCTGGAGCAAAGTACTCGGAAGGAGGGGAAAAGGGTGGCTCGGTACCACCGGGGAGCTGTTTTTT	CAWSKVLGRRGKGWLGTTGELFF	TRBV30	TRBJ2-2
TGTGCCACGGTCCGGGCCCGGTACTTC	CATVRARYF	TRBV5-4	TRBJ2-7
TGTGCCAGCCAAGGGGCAATGACCTACAATGAGCAGTTCTTC	CASQGAMTYNEQFF	TRBV6-3	TRBJ2-1
TGCGCCAGCAGCTTGGATGCCGGGACAGGGTGGTCTAACTATGGCTACACCTTC	CASSLDAGTGWSNYGYTF	TRBV5-1	TRBJ1-2
TGTGCCAGCACCACTAGCGGGAGTGACGAGCAGTACTTC	CASTTSGSDEQYF	TRBV5-6	TRBJ2-7
TGCAGTGGCAATCAGCCCCAGCATTTT	CSGNQPQHF	TRBV20-1	TRBJ1-5
TGTGCCAGCAGCTTAGATCAGGGGGGTTATAACAGCAATCAGCCCCAGCATTTT	CASSLDQGGYNSNQPQHF	TRBV7-9	TRBJ1-5
TGTGCCAGCAGTGATGCCCCCCCTCTCATAGCGGGGGGCTACGAGCAGTACTTC	CASSDAPPLIAGGYEQYF	TRBV6-1	TRBJ2-7
TGTGCCAGCAGCTTGACGGAGAGGGGGGTTTTCGAGCAGTACTTC	CASSLTERGVFEQYF	TRBV11-3	TRBJ2-7
TGCGCCAGCAGTGAGGTTGGGGTAGAGCCCCAGCATTTT	CASSEVGVEPQHF	TRBV10-1	TRBJ1-5
TGTGCCAGCAGCGGTAGTGACAGAACTTACGAGCAGTACTTC	CASSGSDRTYEQYF	TRBV7-4	TRBJ2-7
TGTGCCAGCACCCCCTGGGGCTCTGGGGCCAACGTCCTGACTTTC	CASTPWGSGANVLTF	TRBV12-3	TRBJ2-6
TGTGCCAGCCCCCGCTTGGGGGGGGGCCCGTATGAGCAGTTCTTC	CASPRLGGGPYEQFF	TRBV19	TRBJ2-1
TGTGCCAGCAAAGGACAGGGCTGCCACTCCCAAGAGACCCAGTACTTC	CASKGQGCHSQETQYF	TRBV27	TRBJ2-5
TGTGCCAGCAGCATATGCACGAGGGGGGCAAATCAGCCCCAGCATTTT	CASSICTRGANQPQHF	TRBV6-5	TRBJ1-5
TGTGCCAGCAGCGGTGTGGGGCAGCCCCAGCATTTT	CASSGVGQPQHF	TRBV7-9	TRBJ1-5
TGTGCCAGCAGTGACCTCCCCCTCTTGGTAGTAGGGGGGGATCTTGAGCAGTACTTC	CASSDLPLLVVGGDLEQYF	TRBV6-4	TRBJ2-7
TGTGCCAGTAGGGGAGTTCAGGATGAGCAGTTCTTC	CASRGVQDEQFF	TRBV19	TRBJ2-1
TGTGCCAAGTTAGACCCCTACAATGAGCAGTTCTTC	CAKLDPYNEQFF	TRBV6-4	TRBJ2-1
TGTGCCAGCAGTTTAAAAACGACTCCCGGGGGGGAAAAACTGTTTTTT	CASSLKTTPGGEKLFF	TRBV27	TRBJ1-4
TGTGCCAGCAGTGGACTCATTGGAAACACCATATATTTT	CASSGLIGNTIYF	TRBV5-6	TRBJ1-3
TGTGCCAGCAGGACCCTACCTACATACAATGAGCAGTTCTTC	CASRTLPTYNEQFF	TRBV12-4	TRBJ2-1
TGTGCCAGCAGTACTTCCTACAATGAGCAGTTCTTC	CASSTSYNEQFF	TRBV6-2	TRBJ2-1
TGTGCCAGCAGCACCTCGGAAGGGGAAGAAACGCGGCAGGACGAGCAGTACTTC	CASSTSEGEETRQDEQYF	TRBV5-5	TRBJ2-7
TGTGCCAGCAGTCCCCCAGGGGGCTACACCTTC	CASSPPGGYTF	TRBV6-8	TRBJ1-2
TGTGCCAGCAGATTACTAGCGGGAGGGAGAAATGAAAAACTGTTTTTT	CASRLLAGGRNEKLFF	TRBV6-4	TRBJ1-4
TGTGCCAGCAGGAGCCACAGGGGGGGTACCACTGAAGCTTTCTTT	CASRSHRGGTTEAFF	TRBV7-3	TRBJ1-1
TGTGCCAGCAGCTTAGGAACCACACTAGCGGGAGACCAAAACACCGGGGAGCTGTTTTTT	CASSLGTTLAGDQNTGELFF	TRBV7-8	TRBJ2-2
TGTGCCAGCAGTTCGGGCCAGAATACGCAGTATTTT	CASSSGQNTQYF	TRBV6-1	TRBJ2-3
TGTGCCAGCAGTGACCCGGGCCGATTGGGCTCCTACAATGAGCAGTTCTTC	CASSDPGRLGSYNEQFF	TRBV6-1	TRBJ2-1
TGTGCCACCAGTGCCCCCCGTGGGGGGGTCCGGTTCCAAGAGACCCAGTACTTC	CATSAPRGGVRFQETQYF	TRBV24-1	TRBJ2-5
TGTGCCAGCGTGGGGGGGACGAAGGGTTCGATACCCTACGAGCAGTACTTC	CASVGGTKGSIPYEQYF	TRBV14	TRBJ2-7
TGTGCCAGCAGTGACTCCTTTAGGACGATTCAGCCCCAGCATTTT	CASSDSFRTIQPQHF	TRBV2	TRBJ1-5
TGCAGCGTGCGGGAGCCCTACGAGCAGTACTTC	CSVREPYEQYF	TRBV20-1	TRBJ2-7
TGTGCCAGCAGCCAAGCGCCGGCAGCGAACACCGGGGAGCTGTTTTTT	CASSQAPAANTGELFF	TRBV14	TRBJ2-2
TGTGCCAGCAGCCCAGTTTCAGGTACTATCTATGGCTACACCTTC	CASSPVSGTIYGYTF	TRBV4-2	TRBJ1-2
TGTGCCAGCAGCCCCCAGAGTTCCGCTAGGCCGGGCTCCTACAATGAGCAGTTCTTC	CASSPQSSARPGSYNEQFF	TRBV5-5	TRBJ2-1
TGTGCCAGCAGGACCACCGGCTGGGGGGGGACCCGGGAAGCTTTCTTT	CASRTTGWGGTREAFF	TRBV7-8	TRBJ1-1
TGTGCCTCGAGGGGAGAGACCCAGTACTTC	CASRGETQYF	TRBV2	TRBJ2-5
TGTGCCAGTAGTATCTCGGGGGCCGAGCAGTACTTC	CASSISGAEQYF	TRBV19	TRBJ2-7
TGTGCCACCAGTTTTCCAAGCAAGAGGAATGAGCAGTTCTTC	CATSFPSKRNEQFF	TRBV24-1	TRBJ2-1
TGTGCCAGCAGCATGGACAGGGTCGAGCAGTACTTC	CASSMDRVEQYF	TRBV7-6	TRBJ2-7
TGTGCCACCAGCAGAGATCACTTCCTAGGGGACAATGAGCAGTTCTTC	CATSRDHFLGDNEQFF	TRBV15	TRBJ2-1
TGTGCCAGCAGCTGTCCAAAGATGGACAGGGGGCCAGGGGTTGGCTACACCTTC	CASSCPKMDRGPGVGYTF	TRBV5-5	TRBJ1-2
TGTGCCAGCAGTGTAGGCGGGTGCGGGCCCCAGCATTTT	CASSVGGCGPQHF	TRBV6-5	TRBJ1-5
TGTGCCAGCAGGAGGCTAGCGGGAGAAATGGCCAATGAGCAGTTCTTC	CASRRLAGEMANEQFF	TRBV28	TRBJ2-1
TGTGCCAGCAGACTAGCGGGCTACCAAGAGACCCAGTACTTC	CASRLAGYQETQYF	TRBV28	TRBJ2-5
TGTGCCAGCAGGCAGGCTGGGAACTCCTACGAGCAGTACTTC	CASRQAGNSYEQYF	TRBV9	TRBJ2-7
TGTGCCAGCAGACCGGGACAGGGTTACTATGGCTACACCTTC	CASRPGQGYYGYTF	TRBV27	TRBJ1-2
TGTGCCAGCAGCGTTCTCGTAACCGGGACAGGCTACTATGGCTACACCTTC	CASSVLVTGTGYYGYTF	TRBV7-4	TRBJ1-2
TGTGCCAGCAGCATCGGGGGGGGAAGGAACAATGAGCAGTTCTTC	CASSIGGGRNNEQFF	TRBV11-2	TRBJ2-1
TGTGCCAGCAGCTTAACTGGGCGGGGGAGGGAAGGGAGGGGCTATGGCTACACCTTC	CASSLTGRGREGRGYGYTF	TRBV7-2	TRBJ1-2
TGCGCCAGCAGCTTGTTTGAGGGGCTCCCCAATCAGCCCCAGCATTTT	CASSLFEGLPNQPQHF	TRBV5-1	TRBJ1-5
TGTGCCAGCAGCGGCTTTGTACGGAGTTCGGCAAACTACGAGCAGTACTTC	CASSGFVRSSANYEQYF	TRBV5-6	TRBJ2-7
TGTGCCAGCAGGGGACGAACCACCGAGCAGTACTTC	CASRGRTTEQYF	TRBV6-5	TRBJ2-7
TGCAGTGCTAGAGAGTCGGGACAGGGTTACAATGAGCAGTTCTTC	CSARESGQGYNEQFF	TRBV20-1	TRBJ2-1
TGTGCCAGCAGGGCGGGGATCAGGTCCTACGAGCAGTACTTC	CASRAGIRSYEQYF	TRBV28	TRBJ2-7
TGTGCCATTGCAGGCGGAGGCTACACCTTC	CAIAGGGYTF	TRBV6-4	TRBJ1-2
TGCGCCACACCTGGGGCGCTGCTAGGCTACACCTTC	CATPGALLGYTF	TRBV10-2	TRBJ1-2
TGTGTGGAGGACAGTTTAGGAACGGCGACCTACGAGCAGTACTTC	CVEDSLGTATYEQYF	TRBV14	TRBJ2-7
TGCAGTGTAAATCAGCCCCAGCATTTT	CSVNQPQHF	TRBV20-1	TRBJ1-5
TGTGCCAGCTTCAGGGGGGGACCTGAAGCTTTCTTT	CASFRGGPEAFF	TRBV25-1	TRBJ1-1
TGCAGTGCTAGAGGGCTCCCAGGAGGGATAACGGCCAACGTCCTGACTTTC	CSARGLPGGITANVLTF	TRBV20-1	TRBJ2-6
TGTGCCAGCAGCTTAGATGCAAACGGACGGCGATTGGACACCGGGGAGCTGTTTTTT	CASSLDANGRRLDTGELFF	TRBV11-3	TRBJ2-2
TGTGCCAGCAGTTACTCGATCACCAGGCCCAGTCTTTCCCTAGGCCCGGTCAACACTGAAGCTTTCTTT	CASSYSITRPSLSLGPVNTEAFF	TRBV6-5	TRBJ1-1
TGCAGTGCTACCCTAGCGGGCTTTAACTCCTACAATGAGCAGTTCTTC	CSATLAGFNSYNEQFF	TRBV20-1	TRBJ2-1
TGTGCCATCAGTGTGGGGTCGGGACCTCCTAAGGGACAGCCCCAGCATTTT	CAISVGSGPPKGQPQHF	TRBV10-3	TRBJ1-5
TGTGCCAGAGGACTAGCGGGAGTAGCAATTTTGCAAAACATTCAGTACTTC	CARGLAGVAILQNIQYF	TRBV6-1	TRBJ2-4
TGTGCTAGCAGCTTATCCCAACCGGGTCCCGGTAGCTATGCAGATACGCAGTATTTT	CASSLSQPGPGSYADTQYF	TRBV7-7	TRBJ2-3
TGTGCCAGCAGTTGTAGGGTGAATGGCGAGCAGTACTTC	CASSCRVNGEQYF	TRBV6-5	TRBJ2-7
TGCGCCAGCAGCTTGACTCAGGGTGCCGGCTACACCTTC	CASSLTQGAGYTF	TRBV5-1	TRBJ1-2
TGCGCCATAGCAACAGGGAGAGATGAGTGCACTGAAGCTTTCTTT	CAIATGRDECTEAFF	TRBV5-1	TRBJ1-1
TGTGCCAGCCACGGGACTAGCGGGGGGTCCTTTGAGCAGTTCTTC	CASHGTSGGSFEQFF	TRBV12-3	TRBJ2-1
TGCGCCAGCAGCCAGGAACCTGGACAGGGTGAGTGGGTCTCCGGGGAGCTGTTTTTT	CASSQEPGQGEWVSGELFF	TRBV4-1	TRBJ2-2
TGTGCCAGCAGTTATCTCAGAGGATCGACTAGCGGGAGACGTGTAGACACCATATATTTT	CASSYLRGSTSGRRVDTIYF	TRBV6-3	TRBJ1-3
TGTGCCAGCAGTGAATCAATCAGGCCTCAATACAATGAGCAGTTCTTC	CASSESIRPQYNEQFF	TRBV25-1	TRBJ2-1
TGTGCCACCAGGCGAGTTAGACTAGCGGGGGCTGAGACAGATACGCAGTATTTT	CATRRVRLAGAETDTQYF	TRBV24-1	TRBJ2-3
TGTGCCAGCTGGGGGGGTGGAAACACCATATATTTT	CASWGGGNTIYF	TRBV6-1	TRBJ1-3
TGTGCCAGCAGCAATTGGGGGGGGGGGCACTTC	CASSNWGGGHF	TRBV9	TRBJ2-7
TGTGCCAGCAGCTTAGGCCGTCGGGACAGCTACGAGCAGTACTTC	CASSLGRRDSYEQYF	TRBV7-7	TRBJ2-7
TGTGCCACCAGTGATTTCAAACCGGGAAGCTCCTACAATGAGCAGTTCTTC	CATSDFKPGSSYNEQFF	TRBV24-1	TRBJ2-1
TGTGCCAGCAGTTACGTCCTAGCCCCATGGAGGAAAGTCTATGGCTACACCTTC	CASSYVLAPWRKVYGYTF	TRBV6-5	TRBJ1-2
TGTGCCAGCAGCCAAGATTTGGGGGGGGCCAATGAGCAGTTCTTC	CASSQDLGGANEQFF	TRBV3-1	TRBJ2-1
TGTGCCAGCAATCAGGGGGGTGACTATGGCTACACCTTC	CASNQGGDYGYTF	TRBV27	TRBJ1-2
TGTGCCAGCAGTGACTCTCGAGGACGGGAGACCCAGTACTTC	CASSDSRGRETQYF	TRBV6-4	TRBJ2-5
TGCGCCAGCACCGGAGGGGCCCACACTGAAGCTTTCTTT	CASTGGAHTEAFF	TRBV5-1	TRBJ1-1
TGCGCCAGCCCCCGGACAGGGGGCGGGGGGTGCTACGAGCAGTACTTC	CASPRTGGGGCYEQYF	TRBV10-1	TRBJ2-7
TGTGCCACTGTGGGAGGACTAGCGGCCTACGAGCAGTACTTC	CATVGGLAAYEQYF	TRBV24-1	TRBJ2-7
TGTGCCAGCAGCTTAAGGGAGTGGACTGAGCAGTTCTTC	CASSLREWTEQFF	TRBV5-6	TRBJ2-1
TGTGCCACCAGCGGGACAGGGCGAAAGTCCACCTACGAGCAGTACTTC	CATSGTGRKSTYEQYF	TRBV15	TRBJ2-7
TGCAGTGCTACGGTCCCCAGACCCGGCGGGGGATACATTCAGTACTTC	CSATVPRPGGGYIQYF	TRBV20-1	TRBJ2-4
TGTGCCAGCACTACCAGGGAGACTGACACTGAAGCTTTCTTT	CASTTRETDTEAFF	TRBV6-5	TRBJ1-1
TGTGCCAGCAATAGTAAGGGGGGCTCTGGAAACACCATATATTTT	CASNSKGGSGNTIYF	TRBV6-4	TRBJ1-3
TGTGCCAGTTGCACAGGGGGGGCGTGCTACGAGCAGTACTTC	CASCTGGACYEQYF	TRBV24-1	TRBJ2-7
TGTGCCGGACTGTATCCGGCGGAAAAACTGTTTTTT	CAGLYPAEKLFF	TRBV19	TRBJ1-4
TGTGCCAGCAAAGTCCGTGCGGGAGGTGAAAAACTGTTTTTT	CASKVRAGGEKLFF	TRBV6-2	TRBJ1-4
TGTGCCAGTAGTATCAAGGGGCGGCGTAATGAAAAACTGTTTTTT	CASSIKGRRNEKLFF	TRBV19	TRBJ1-4
TGTGCCAGCAGGCGGGGTTACAATGAGCAGTTCTTC	CASRRGYNEQFF	TRBV6-6	TRBJ2-1
TGTGCCAGCAACACCCTCCAGTACTTC	CASNTLQYF	TRBV5-4	TRBJ2-7
TGTGCCAGCAGACGATGGGACAGCAAGAGAAATTCACCCCTCCACTTT	CASRRWDSKRNSPLHF	TRBV6-1	TRBJ1-6
TGTGCCAGCAGCTGTACCCGGGGTAACTATGGCTACACCTTC	CASSCTRGNYGYTF	TRBV11-2	TRBJ1-2
TGTGCCTACGGGGAGCTGTTTTTT	CAYGELFF	TRBV6-5	TRBJ2-2
TGCGCCAGCAGCCAAGCGCCGGGACTAGCTTTACAGCGAGTCTTC	CASSQAPGLALQRVF	TRBV4-1	TRBJ2-1
TGTGCCAGCACCACTCTAGCGGGCGATTTAAGGGACAATGAGCAGTTCTTC	CASTTLAGDLRDNEQFF	TRBV7-2	TRBJ2-1
TGCGCCAGCAGCTTGCGACTCGCAACGAACACCGGGGAGCTGTTTTTT	CASSLRLATNTGELFF	TRBV5-1	TRBJ2-2
TGTGCCAGTAACCGAGGGCATAATGAGCAGTTCTTC	CASNRGHNEQFF	TRBV19	TRBJ2-1
TGTGCCAGCAGTGACAGAACTAAGCCAGGCTCCTACGAGCAGTACTTC	CASSDRTKPGSYEQYF	TRBV6-1	TRBJ2-7
TGCAGTGCTAGGGGGAAACAGGGACACGAGCAGTACTTC	CSARGKQGHEQYF	TRBV20-1	TRBJ2-7
TGTGCCAGCAGCCAAGATAGTACAGCGCTGCGGGGTGGCTACACCTTC	CASSQDSTALRGGYTF	TRBV14	TRBJ1-2
TGTGCCAGCAGTTACCGGAAATGGGAGAACACTGAAGCTTTCTTT	CASSYRKWENTEAFF	TRBV6-3	TRBJ1-1
TGCGCCAGCAGTGACGAGCTTTACTACGAGCAGTACTTC	CASSDELYYEQYF	TRBV10-2	TRBJ2-7
TGTGCCAGCAGCTTGATCAGCTTTTATGGCTACACCTTC	CASSLISFYGYTF	TRBV5-6	TRBJ1-2
TGTGCCTGGAGCCCACTAGCGGGAGGGCGTCGCGGGGAGCTGTTTTTT	CAWSPLAGGRRGELFF	TRBV30	TRBJ2-2
TGCGCCAGCAGCGGACGGGCCCGCTCAGGGCCGTCCTACGAGCAGTACTTC	CASSGRARSGPSYEQYF	TRBV4-1	TRBJ2-7
TGTGCCAGCAGCTTAGCAGGGAGCTACGAGCAGTACTTC	CASSLAGSYEQYF	TRBV7-4	TRBJ2-7
TGCAGTGCGGACAGCGGGAGAATTCGGTCGAACACCGGGGAGCTGTTTTTT	CSADSGRIRSNTGELFF	TRBV20-1	TRBJ2-2
TGTGCCAGCAGTTTGCCAGTCGGGGAGGACTATGGCTACACCTTC	CASSLPVGEDYGYTF	TRBV27	TRBJ1-2
TGTGCCAGCAGCCCTGGTGGGCCTCGGGGAAGGGTCACGAGCTCCTACAATGAGCAGTTCTTC	CASSPGGPRGRVTSSYNEQFF	TRBV13	TRBJ2-1
TGTGCCAGCAGCATCAGGGGGCAAGTTAGCTCCTATAATTCACCCCTCCACTTT	CASSIRGQVSSYNSPLHF	TRBV13	TRBJ1-6
TGCAGCTCTAAAAGGGGGCAAATGAACACTGAAGCTTTCTTT	CSSKRGQMNTEAFF	TRBV29-1	TRBJ1-1
TGTGCCAGCAGCCAAGTCCCACCGGGACAGAATATCGAGGATCAGCCCCAGCATTTT	CASSQVPPGQNIEDQPQHF	TRBV6-5	TRBJ1-5
TGTGCCAGCAGCACTTTCCAACCTAGCGGGGAGGATGAGCAGTTCTTC	CASSTFQPSGEDEQFF	TRBV28	TRBJ2-1
TGTGCCAGCAGTCCACTAGCGGGTAGACGAGCCAAAAACATTCAGTACTTC	CASSPLAGRRAKNIQYF	TRBV6-5	TRBJ2-4
TGTGCCAGCAGTTGTCAACCCCAGCTGAACACTGAAGCTTTCTTT	CASSCQPQLNTEAFF	TRBV6-9	TRBJ1-1
TGTGCCAGCAGCCTAGGGGGACAGAGTGGCGATGAAGCTTTCTTT	CASSLGGQSGDEAFF	TRBV7-8	TRBJ1-1
TGCGCCAGCAGCGAGGACAGGGGAGACAATCAGCCCCAGCATTTT	CASSEDRGDNQPQHF	TRBV5-1	TRBJ1-5
TGCAGTAATAACGGTGATGGCTACGAGCAGTACTTC	CSNNGDGYEQYF	TRBV20-1	TRBJ2-7
TGTGCCACCTGCTACCTGGGGGCCTACGAGCAGTACTTC	CATCYLGAYEQYF	TRBV24-1	TRBJ2-7
TGTGCCAGCTCACACCGGGGACAGGGCGAATTGCGGATCTCTGGGGCCAACGTCCTGACTTTC	CASSHRGQGELRISGANVLTF	TRBV18	TRBJ2-6
TGTGCCAGCAGCGCCACCTCCCATAGCAATCAGCCCCAGCATTTT	CASSATSHSNQPQHF	TRBV5-4	TRBJ1-5
TGCGCCAGCAGTGAGTCCAACCTGATGAACACCGGGGAGCTGTTTTTT	CASSESNLMNTGELFF	TRBV10-1	TRBJ2-2
TGTGCCAGCAGCTTGCCCGGCCAAACCAAAAACATTCAGTACTTC	CASSLPGQTKNIQYF	TRBV11-2	TRBJ2-4
TGTGCCAGCTGTCCGGGACTAGCCCTCGATAGCTCCTACAATGAGCAGTTCTTC	CASCPGLALDSSYNEQFF	TRBV9	TRBJ2-1
TGTGCCAGCAGGTCTAGCGGGTCGGGGGACTACGAGCAGTACTTC	CASRSSGSGDYEQYF	TRBV7-4	TRBJ2-7
TGCGCCAGCAGCCCTAAAGTCGGACGTTCCTATAATTCACCCCTCCACTTT	CASSPKVGRSYNSPLHF	TRBV4-1	TRBJ1-6
TGTGCTAGTGGTTTGGTGCGCTCAGGGGGAAATGGCTACACCTTC	CASGLVRSGGNGYTF	TRBV12-5	TRBJ1-2
TGTGCCAGCTCACTTTTCCAAGTAGGGAAAGCCGCCTACGAGCAGTACTTC	CASSLFQVGKAAYEQYF	TRBV18	TRBJ2-7
TGTGCCAGCAGCAGAAGTCGCGAGGGGAGCGGATCCTACGAGCAGTACTTC	CASSRSREGSGSYEQYF	TRBV7-9	TRBJ2-7
TGTGCCAGCAGTGACAGGGGGGGACACAATGAGCAGTTCTTC	CASSDRGGHNEQFF	TRBV27	TRBJ2-1
TGTGCCAGTAACTCGACTGGGACAGGGAAGTACGAGCAGTACTTC	CASNSTGTGKYEQYF	TRBV19	TRBJ2-7
TGTGCCAGCAGTTACTGGAGGGGTGAATGGTTTTATAGCAATCAGCCCCAGCATTTT	CASSYWRGEWFYSNQPQHF	TRBV6-3	TRBJ1-5
TGTGCCAGCAGCACACATGGGCCGGGCTACACCTTC	CASSTHGPGYTF	TRBV3-1	TRBJ1-2
TGTGCCAGCAGCGGAAAGCCTAAAGATGGCTACACCTTC	CASSGKPKDGYTF	TRBV7-4	TRBJ1-2
TGTGCCAGCAGCCGATATGGGGGAATTATCTCCTACGAGCAGTACTTC	CASSRYGGIISYEQYF	TRBV14	TRBJ2-7
TGTGCCTGCCACAGACCTAAAGACTACGAGCAGTACTTC	CACHRPKDYEQYF	TRBV30	TRBJ2-7
TGTGCCAGCAGTTGGGGGGTAGGTTATACCCAAGAGACCCAGTACTTC	CASSWGVGYTQETQYF	TRBV27	TRBJ2-5
TGCAGTGCTAGGCGACCGGGACTAGCGGCGAACACCGGGGAGCTGTTTTTT	CSARRPGLAANTGELFF	TRBV20-1	TRBJ2-2
TGCAGTGCTAGAGGTAAAGCCGCAGGGGAGAATCAGCCCCAGCATTTT	CSARGKAAGENQPQHF	TRBV20-1	TRBJ1-5
TGCGCCCGGCCCCCTGCACCGGACAGGGAAGTCCAAGCTTTCTTT	CARPPAPDREVQAFF	TRBV5-1	TRBJ1-1
TGCGCCAGCAGCCAAGCACAGGGGCCGACCTACGAGCAGTACTTC	CASSQAQGPTYEQYF	TRBV4-1	TRBJ2-7
TGTGCCTGGAGGGGACAGGGGGGGGAAGACACTGAAGCTTTCTTT	CAWRGQGGEDTEAFF	TRBV30	TRBJ1-1
TGTGCCAGCAGCTTAAGATTCTCACGGCAACTGGGCTGCGAGCAGTACTTC	CASSLRFSRQLGCEQYF	TRBV7-9	TRBJ2-7
TGTGCCAGCAGTACGACGGGGGACCCGCGGCTTTATGGCTACACCTTC	CASSTTGDPRLYGYTF	TRBV6-4	TRBJ1-2
TGTGCCAGCAGGGAGTCGGGGCGGGAGGGGAGGGATAATTCACCCCTCCACTTT	CASRESGREGRDNSPLHF	TRBV27	TRBJ1-6
TGTGCCAGCAGTGAACGAACAGGGGGCTCCCACACTGAAGCTTTCTTT	CASSERTGGSHTEAFF	TRBV25-1	TRBJ1-1
TGTGCCAGCAGCTTTGGGTCCCGGGGGACAGGGGTTAGCTCTGGAAACACCATATATTTT	CASSFGSRGTGVSSGNTIYF	TRBV7-4	TRBJ1-3
TGTGCCACCAGTGATTTCTCGACTCCGGGGGAGCAGTTCTTC	CATSDFSTPGEQFF	TRBV24-1	TRBJ2-1
TGTGCCCCCCCCTTCCAGGGACTAGCGGGAACCGGGGAGCTGTTTTTT	CAPPFQGLAGTGELFF	TRBV19	TRBJ2-2
TGTGCCAGCAGTGCTGTGCGGGAGGAATACGAGCAGTACTTC	CASSAVREEYEQYF	TRBV6-1	TRBJ2-7
TGTGCCAGCAGTGCGGTTGGCGGGGGAAGACCTTCACCCCTCCACTTT	CASSAVGGGRPSPLHF	TRBV6-4	TRBJ1-6
TGCGCCAGCAGCCTCCGCGGGAGTGAGACCCAGTACTTC	CASSLRGSETQYF	TRBV4-1	TRBJ2-5
TGCAGTGCACGGACCTGTGGCAGGGGGGTGGGTTGGGATTGCCCAGGGGAAAAACTGTTTTTT	CSARTCGRGVGWDCPGEKLFF	TRBV20-1	TRBJ1-4
TGCAGTGCAAGGATTAGGGGGAAGAGGGCCAAAAACATTCAGTACTTC	CSARIRGKRAKNIQYF	TRBV20-1	TRBJ2-4
TGCAACTCCAACGCCGGGACTAGCGGGGAAGCAGATACGCAGTATTTT	CNSNAGTSGEADTQYF	TRBV20-1	TRBJ2-3
TGTGCCAGCAGCGGGGCTTCCTGCGAGCCCCAGCATTTT	CASSGASCEPQHF	TRBV9	TRBJ1-5
TGCGCCAGCAGCTTGGGACAGGGTAACGAGCAGTACTTC	CASSLGQGNEQYF	TRBV5-1	TRBJ2-7
TGTGCCAGCAGTCTCCTGGACGGCTACACCTTC	CASSLLDGYTF	TRBV28	TRBJ1-2
TGTGCTAGTGGTTGTGATCCTACAGGGGGCTCTGCAGATACGCAGTATTTT	CASGCDPTGGSADTQYF	TRBV12-5	TRBJ2-3
TGTGCCAGCAGTTGGGCGTACGAGCAGTACTTC	CASSWAYEQYF	TRBV28	TRBJ2-7
TGTGCCAGACTTGACAGGGGGAACTATGGCTACACCTTC	CARLDRGNYGYTF	TRBV28	TRBJ1-2
TGTGCCAGCAGCTCCAAGGACCCGGGGCCCTATGGCTACACCTTC	CASSSKDPGPYGYTF	TRBV7-3	TRBJ1-2
TGTGCTAGTGGCTCCTGGGGAACCAAAAACATTCAGTACTTC	CASGSWGTKNIQYF	TRBV12-5	TRBJ2-4
TGTGCCAGCAGCCCGGGACAAAACAAAGATTTCTACGAGCAGTACTTC	CASSPGQNKDFYEQYF	TRBV11-2	TRBJ2-7
TGTGCCACAAGGGGCAGGAGGACTACGCAGTATTTT	CATRGRRTTQYF	TRBV24-1	TRBJ2-3
TGTGCCAGCAGTAGGACCCTCGGGACGGCCCAAGGGAGTGGCTACACCTTC	CASSRTLGTAQGSGYTF	TRBV27	TRBJ1-2
TGTGCCAGCAGTAGTCCTGAAGACAGAAGCTACGAGCAGTACTTC	CASSSPEDRSYEQYF	TRBV6-5	TRBJ2-7
TGTGCCACCAGTGATAAGGATCAGCGGAATCAGCCCCAGCATTTT	CATSDKDQRNQPQHF	TRBV24-1	TRBJ1-5
TGTGTCGACAGGGGCCGGGACACTGAAGCTTTCTTT	CVDRGRDTEAFF	TRBV9	TRBJ1-1
TGTGCCAGCAGCTCAAAACTCATCGCCGTAGTCACCGGGGAGCTGTTTTTT	CASSSKLIAVVTGELFF	TRBV5-6	TRBJ2-2
TGTGTAGAGCCCAGGGGCGTGAATCAGCCCCAGCATTTT	CVEPRGVNQPQHF	TRBV7-9	TRBJ1-5
TGCGCCCTACAGCGGGACAACACCGGGGAGCTGTTTTTT	CALQRDNTGELFF	TRBV5-1	TRBJ2-2
TGTGCCAGCAGTTCCCTACGGACCAAAGAGGCTAACTATGGCTACACCTTC	CASSSLRTKEANYGYTF	TRBV28	TRBJ1-2
TGCGCCAGCAGGAGGGGGAGGAACCGGTCGAACTATGGCTACACCTTC	CASRRGRNRSNYGYTF	TRBV10-1	TRBJ1-2
TGCAGTGCTAGCCCGGGAGGGCGTCCTGAGGCTTTCTTT	CSASPGGRPEAFF	TRBV20-1	TRBJ1-1
TGTGCCAGCAGCGCGGGGACTAGCACCGGGGAGCTGTTTTTT	CASSAGTSTGELFF	TRBV9	TRBJ2-2
TGTGCCAGCAGCCCAAGGGACAGAGGCTACACCTTC	CASSPRDRGYTF	TRBV3-1	TRBJ1-2
TGTGCCAGTAGTCTCGGGGGGGACGGGTATAATTCACCCCTCCACTTT	CASSLGGDGYNSPLHF	TRBV19	TRBJ1-6
TGCGCCAGCAGCTTGGACGAGCATGGCTCCTACGAGCAGTACTTC	CASSLDEHGSYEQYF	TRBV10-1	TRBJ2-7
TGTGCCAGCAGCCAATCCCACAGGGGGGGGGGGGCAGATACGCAGTATTTT	CASSQSHRGGGADTQYF	TRBV3-1	TRBJ2-3
TGTGCCAGCAGCTTAGGGACGTCCCTTCCCCAGGGGGGCGGGGAGCTGTTTTTT	CASSLGTSLPQGGGELFF	TRBV7-9	TRBJ2-2
TGCGCCAGCGGACTCCGGGACAGAAGGGGCTATGGCTACACCTTC	CASGLRDRRGYGYTF	TRBV10-2	TRBJ1-2
TGCCTAGGGGGGGGCCGGAAGAACACCGGGGAGCTGTTTTTT	CLGGGRKNTGELFF	TRBV20-1	TRBJ2-2
TGTGCCAGCAGCAGGGGACTTGGGGGAAAGGAAAATGAAAAACTGTTTTTT	CASSRGLGGKENEKLFF	TRBV9	TRBJ1-4
TGTGCCAGCACCAGACGCAATCAGCCCCAGCATTTT	CASTRRNQPQHF	TRBV27	TRBJ1-5
TGCAGTGCTAGAGATAGGGGGGGGGCCTCACACACCATATATTTT	CSARDRGGASHTIYF	TRBV20-1	TRBJ1-3
TGCGCCAGCAGCTTGTCCAGGGGACCCTACGAGCAGTACTTC	CASSLSRGPYEQYF	TRBV5-1	TRBJ2-7
TGTGCCAGCAGGCGGGACAGGGGAATGGCTTCCTATAATTCACCCCTCCACTTT	CASRRDRGMASYNSPLHF	TRBV12-3	TRBJ1-6
TGTGCCTGGCAGACCGGGGAGCTGTTTTTT	CAWQTGELFF	TRBV6-5	TRBJ2-2
TGTGCCACCAGCAGAGAAGGGGGGACAGGGAGGCTTCGAACCCAGTACTTC	CATSREGGTGRLRTQYF	TRBV15	TRBJ2-5
TGTGCCAGCAGCACGAGGGGGTTGAACACTGAAGCTTTCTTT	CASSTRGLNTEAFF	TRBV11-2	TRBJ1-1
TGTGCCAGTAGTTATAGGGGCATTTACAATGAGCAGTTCTTC	CASSYRGIYNEQFF	TRBV19	TRBJ2-1
TGTGCCAGCAGCCTAGGACCAGATCAGCCCCAGCATTTT	CASSLGPDQPQHF	TRBV28	TRBJ1-5
TGTGCCAGCAGCTTAGTACCGGGTCAGCCCCAGCATTTT	CASSLVPGQPQHF	TRBV11-2	TRBJ1-5
TGTGCCAGTAGTATAGATCCGGGACAGGGGGATGAGCCCCAGCATTTT	CASSIDPGQGDEPQHF	TRBV19	TRBJ1-5
TGTGCCAGCAGTTGGGGTGGGGAAAAACTGTTTTTT	CASSWGGEKLFF	TRBV27	TRBJ1-4
TGCGCCAGCAGCCGCCGGGCCCGGGACCCATACGAGCAGTACTTC	CASSRRARDPYEQYF	TRBV4-1	TRBJ2-7
TGCAGTGCCGAAGCCTCGGGGATCTACTACGAGCAGTACTTC	CSAEASGIYYEQYF	TRBV20-1	TRBJ2-7
TGCAGTGCAGGGGGGAAGGGGTCACCCCTCCACTTT	CSAGGKGSPLHF	TRBV20-1	TRBJ1-6
TGTGCCAGCAGCTTAGGCTCCTACGAGCAGTACTTC	CASSLGSYEQYF	TRBV11-3	TRBJ2-7
TGTGCCACCAGTGGTTTCCACGAAGGGGGGGGACCTTATAATTCACCCCTCCACTTT	CATSGFHEGGGPYNSPLHF	TRBV24-1	TRBJ1-6
TGTGCCAGCAGCCTAGCGGGAAAATACAATGAGCAGTTCTTC	CASSLAGKYNEQFF	TRBV7-3	TRBJ2-1
TGTGCCAGCAGCACCCCGGGCAACTACGAGCAGTACTTC	CASSTPGNYEQYF	TRBV7-3	TRBJ2-7
TGTGCTAGCAGCTGTACGGAAGGAAATCAGCCCCAGCATTTT	CASSCTEGNQPQHF	TRBV7-7	TRBJ1-5
TGCGCCAGCAGCTTGAAGGGACAGGGACCCCCTAGCTCTGGAAACACCATATATTTT	CASSLKGQGPPSSGNTIYF	TRBV5-1	TRBJ1-3
TGCGCCAGCAGTGAGAGACATCTACCTAGCACAGATACGCAGTATTTT	CASSERHLPSTDTQYF	TRBV10-2	TRBJ2-3
TGTGCCAGCAGCAGAAGGACTAGCGGGGGGGGGGATGCTTGCGAACCCGTCACAGATACGCAGTATTTT	CASSRRTSGGGDACEPVTDTQYF	TRBV7-4	TRBJ2-3
TGTGCCACAACGCCAGGAGAAAACACTGAAGCTTTCTTT	CATTPGENTEAFF	TRBV24-1	TRBJ1-1
TGTGCCAGCGGTCGGGGGGCGTCAGATACGCAGTATTTT	CASGRGASDTQYF	TRBV28	TRBJ2-3
TGTGCCAGCAGCGTAGGCCCCAGCAGGGGGGACACTGAAGCTTTCTTT	CASSVGPSRGDTEAFF	TRBV9	TRBJ1-1
TGCGCCAGCAGCTTGACCTGCACCCCGGGGCCGACACAGGGCTACGAGCAGTACTTC	CASSLTCTPGPTQGYEQYF	TRBV5-1	TRBJ2-7
TGTGCCAGCATCGACGAGTCGGGGAATCAAGTGCAGCCCCAGCATTTT	CASIDESGNQVQPQHF	TRBV12-4	TRBJ1-5
TGCAGCGTTGGGGTGTTGGCCGGGGATGAGCAGTTCTTC	CSVGVLAGDEQFF	TRBV29-1	TRBJ2-1
TGCGCCAGCCCTGGGGCTCAAGACTATGGCTACACCTTC	CASPGAQDYGYTF	TRBV10-1	TRBJ1-2
TGTGCCAGCAGTGGGCTCAACAGGACTGAAGCCCAGCATTTT	CASSGLNRTEAQHF	TRBV9	TRBJ1-5
TGTGCCAGCAGCGACAGGGGAGGTCTTGGCTACACCTTC	CASSDRGGLGYTF	TRBV5-4	TRBJ1-2
TGCGCCAGGGGGCGGACGATGGTTAGCTACACCTTC	CARGRTMVSYTF	TRBV5-1	TRBJ1-2
TGTGCCAGCAGGGTAAGACTAGCGGGGGAGACCCAGTACTTC	CASRVRLAGETQYF	TRBV11-3	TRBJ2-5
TGTGCCAGCAGCCAAGGATATCAGGTGGGCACTGAAGCTTTCTTT	CASSQGYQVGTEAFF	TRBV3-1	TRBJ1-1
TGTGCCAGCAGTTTATGTTCTATAATTGTGGGGGCCAGTCCGGACACCATATATTTT	CASSLCSIIVGASPDTIYF	TRBV27	TRBJ1-3
TGCGCCAGCAGTGATCGCCGCTATGGCTACACCTTC	CASSDRRYGYTF	TRBV10-1	TRBJ1-2
TGTGCCAGCAGCCAAGAGGTTGGGGTCAGGGTTAGTAATTCACCCCTCCACTTT	CASSQEVGVRVSNSPLHF	TRBV14	TRBJ1-6
TGCGCCAGCAGCTTGTCAAGACAGTTTCACTATGGCTACACCTTC	CASSLSRQFHYGYTF	TRBV5-1	TRBJ1-2
TGCAGTGCTAGAGACCGACACATAATGCCGGGACAGACATATAGCAATCAGCCCCAGCATTTT	CSARDRHIMPGQTYSNQPQHF	TRBV20-1	TRBJ1-5
TGCGCCAGCAAACTCACCCCAACTGAAGCTTTCTTT	CASKLTPTEAFF	TRBV10-1	TRBJ1-1
TGCAGTGCTAGAGGGAGGGGAGGGGGGAACTACGAGCAGTACTTC	CSARGRGGGNYEQYF	TRBV20-1	TRBJ2-7
TGTGCCAGCAGCGCAGGGAGGAACACTGAAGCTTTCTTT	CASSAGRNTEAFF	TRBV9	TRBJ1-1
TGTGCCAGCAGTCGAGAGGGGCGGCTTCCGGACTTC	CASSREGRLPDF	TRBV6-3	TRBJ2-7
TGCAGTGCTAGAGATCCCCACCACAGCGCCCAAAGGAGCTCCTACGAGCAGTACTTC	CSARDPHHSAQRSSYEQYF	TRBV20-1	TRBJ2-7
TGTGCCACCAGTCTGATGGGAGTAGACGGGGAGCTGTTTTTT	CATSLMGVDGELFF	TRBV24-1	TRBJ2-2
TGTGCCATCACGCGGGAGCAGGGCACTGAAGCTTTCTTT	CAITREQGTEAFF	TRBV10-3	TRBJ1-1
TGCAGTGCTCCTCATCGGGAGAGCTACGAGCAGTACTTC	CSAPHRESYEQYF	TRBV20-1	TRBJ2-7
TGTGCCAGCACTGGGACTTCGGGGTACACCGGGGAGCTGTTTTTT	CASTGTSGYTGELFF	TRBV18	TRBJ2-2
TGTGCCTGGTGTAGAAGGGGTTCTGGACGTAGAACCGGGGAGCTGTTTTTT	CAWCRRGSGRRTGELFF	TRBV30	TRBJ2-2
TGTGCCAAGGGGGGGGGGGAATACAATGAGCAGTTCTTC	CAKGGGEYNEQFF	TRBV6-6	TRBJ2-1
TGTGCTAGTGGTTTGAAGACAGATGAAAAACTGTTTTTT	CASGLKTDEKLFF	TRBV12-5	TRBJ1-4
TGTGCCAGCAGCTTGGTCTCCTGGTCGAAGGGGGTAGCCAAAAACATTCAGTACTTC	CASSLVSWSKGVAKNIQYF	TRBV5-6	TRBJ2-4
TGTGCCAGTAGTATAGATTCGGCGGCTGCTAGCACAGATACGCAGTATTTT	CASSIDSAAASTDTQYF	TRBV19	TRBJ2-3
TGTGCCAGCAGCTCGCAACCGGGACAGTTAGTCGAGCAGTACTTC	CASSSQPGQLVEQYF	TRBV11-3	TRBJ2-7
TGCGCCAGCAGCTTAGCAGGGAGGGACCGCAATCAGCCCCAGCATTTT	CASSLAGRDRNQPQHF	TRBV5-1	TRBJ1-5
TGCGCCAGCATTCTGAGTGGGGACAGCTACAATGAGCAGTTCTTC	CASILSGDSYNEQFF	TRBV10-2	TRBJ2-1
TGTGCCAGCAGCCAAGAACAGGCAGAGACCAGTAGTCAGCCCCAGCATTTT	CASSQEQAETSSQPQHF	TRBV3-1	TRBJ1-5
TGTGCCAGCAGTGAACAGGGACTCTACGAGCAGTACTTC	CASSEQGLYEQYF	TRBV6-4	TRBJ2-7
TGTGCCAAACAGGGGAAATACGAGCAGTACTTC	CAKQGKYEQYF	TRBV30	TRBJ2-7
TGTGCCAGCAGCTTTGAACCTCTGTTTAGATACAATGAGCAGTTCTTC	CASSFEPLFRYNEQFF	TRBV9	TRBJ2-1
TGCGCCAGCAGCAAATGGACAGCTTACTACGAGCAGTACTTC	CASSKWTAYYEQYF	TRBV5-1	TRBJ2-7
TGTGCCAGCAGTTTCCGGACAAACACAAGGTGTGAAGCTCAGCCCCAGCATTTT	CASSFRTNTRCEAQPQHF	TRBV27	TRBJ1-5
TGTGCCAGCAGCTTAGGAAGCAGGGGGCTGGTAGTCTACAATGAGCAGTTCTTC	CASSLGSRGLVVYNEQFF	TRBV7-6	TRBJ2-1
TGTGCCAGCAGTTTAATACGGACAGGCTCTGGGGCCAACGTCCTGACTTTC	CASSLIRTGSGANVLTF	TRBV27	TRBJ2-6
TGTGCCGATAGTATCCCGGGACAGGGGGCGCTATCCCTTCAGCCCCAGCATTTT	CADSIPGQGALSLQPQHF	TRBV3-1	TRBJ1-5
TGTGCCAGCAGTAGGAGGACGGAGGAACGCACAGATACGCAGTATTTT	CASSRRTEERTDTQYF	TRBV28	TRBJ2-3
TGTGCCAGCAGTGACAGGAACTATGAGACCCAGTACTTC	CASSDRNYETQYF	TRBV6-1	TRBJ2-5
TGTGCCAGCAGCGGGAACAGCCGCCAAGAGACCCAGTACTTC	CASSGNSRQETQYF	TRBV9	TRBJ2-5
TGTGCCAGCAGCCAAGCGCGCGATTCACCCCTCCACTTT	CASSQARDSPLHF	TRBV3-1	TRBJ1-6
TGTGCCAGCAGTACTCCACAGGGCAATAGCAATCAGCCCCAGCATTTT	CASSTPQGNSNQPQHF	TRBV28	TRBJ1-5
TGTGCCAGCAGCGCGAGCGCGGGACGGACTGAAGCTTTCTTT	CASSASAGRTEAFF	TRBV5-5	TRBJ1-1
TGCAGCGTTGAAGGACTAGTTATTAACTACTCCTACAATGAGCAGTTCTTC	CSVEGLVINYSYNEQFF	TRBV29-1	TRBJ2-1
TGTGCCAGCAGTCCTCAATGCGGGATATGCTATGGCTACACCTTC	CASSPQCGICYGYTF	TRBV12-3	TRBJ1-2
TGTGCCAGCAGTGAATGGAAGATCGTTTCGGGCAGGGTCAATCAGCCCCAGCATTTT	CASSEWKIVSGRVNQPQHF	TRBV25-1	TRBJ1-5
TGCAGTGCTCAATCGACAGGTGAGCAGTTCTTC	CSAQSTGEQFF	TRBV20-1	TRBJ2-1
TGCGCCAGCCCGATTTACGAGCAGTACTTC	CASPIYEQYF	TRBV10-1	TRBJ2-7
TGTGCCAGCAGAAGATGCGGTGTTAATTCACCCCTCCACTTT	CASRRCGVNSPLHF	TRBV6-4	TRBJ1-6
TGTGCCAGCAGCTTATCCGGGACTAGCGGGCAGGGCTACGAGCAGTACTTC	CASSLSGTSGQGYEQYF	TRBV7-4	TRBJ2-7
TGCAGTGCTAGGGGAGGCGCCAAGGAGACCCAGTACTTC	CSARGGAKETQYF	TRBV20-1	TRBJ2-5
TGTGCCAGCAGCGGGAGGGGACCCCGTGAAAAACTGTTTTTT	CASSGRGPREKLFF	TRBV4-2	TRBJ1-4
TGCGCCAGCAGCTTGGCCCAAACTAGCGGGGGGTCTAGCACAGATACGCAGTATTTT	CASSLAQTSGGSSTDTQYF	TRBV5-1	TRBJ2-3
TGTGCCAGCAGTGATACATCGACAGGGGCAGCCCTCCGGATTGGCACAGATACGCAGTATTTT	CASSDTSTGAALRIGTDTQYF	TRBV6-1	TRBJ2-3
TGTGCCAGCGAGCTAGCTGTTGGTGAGACCCAGTACTTC	CASELAVGETQYF	TRBV6-5	TRBJ2-5
TGCGCCAGCACAGGGCGGAGAAGTAGAGAGACCCAGTACTTC	CASTGRRSRETQYF	TRBV5-1	TRBJ2-5
TGTGCCAGCAGCCAAGGATCCGCCCTTCTTCAGGGGGACTACACCTTC	CASSQGSALLQGDYTF	TRBV3-1	TRBJ1-2
TGTGCCAGCAGTCCCGAGGGACTGGGGCTCTGCGAGCAGTACTTC	CASSPEGLGLCEQYF	TRBV6-5	TRBJ2-7
TGTGCCAGCAGACGGAGGCAGGGGAAGTGGAGGCTTGGCTACACCTTC	CASRRRQGKWRLGYTF	TRBV27	TRBJ1-2
TGTGCCACCAGCAGAGATAAACGGCGGGGAGGACAGGTCAATGAAAAACTGTTTTTT	CATSRDKRRGGQVNEKLFF	TRBV15	TRBJ1-4
TGCATTGGGCGTGGCTATGGCTACACCTTC	CIGRGYGYTF	TRBV20-1	TRBJ1-2
TGCAGTGCGGTCAGGACCAAAAACATTCAGTACTTC	CSAVRTKNIQYF	TRBV20-1	TRBJ2-4
TGTGCCAGCAGCTTGGGGATGACGAAGACCTTGTTTGACTTC	CASSLGMTKTLFDF	TRBV7-4	TRBJ2-7
TGTGCCAGCAGGGAGGACAGGGCTGAAGCTTTCTTT	CASREDRAEAFF	TRBV28	TRBJ1-1
TGTGCCAGCAGCTATCATTTACAGACAGGGATGTGGGAAGGTAAAAACGGGACAGCTAACTATGGCTACACCTTC	CASSYHLQTGMWEGKNGTANYGYTF	TRBV5-4	TRBJ1-2
TGCGCCAGCAGCCAAGTGATAGGACAGCCCCAGCATTTT	CASSQVIGQPQHF	TRBV4-3	TRBJ1-5
TGTGCCAGCAGTCGCAACTCCGGGACTAGCGGGAGGAATCAGCCCCAGCATTTT	CASSRNSGTSGRNQPQHF	TRBV6-4	TRBJ1-5
TGTGCCACCAGTGATACGTGGGGACAGGGGGCGGGCGAGCAGTACTTC	CATSDTWGQGAGEQYF	TRBV24-1	TRBJ2-7
TGTGCCAGCAGTTATCGGCCACAGCCCCAGCATTTT	CASSYRPQPQHF	TRBV27	TRBJ1-5
TGTGCCAGCAGCGTACAGCGTTTAGGCTACACCTTC	CASSVQRLGYTF	TRBV7-6	TRBJ1-2
TGTGCCATCATCGGCATTCAAGGGGGGGGCTTCGAGCAGTACTTC	CAIIGIQGGGFEQYF	TRBV10-3	TRBJ2-7
TGTGCCACCCCAAGGGGTGGAACCTACGAGCAGTACTTC	CATPRGGTYEQYF	TRBV15	TRBJ2-7
TGTGCCAGCTCAGCTGTACGGACGGTTGGCGAAAAACTGTTTTTT	CASSAVRTVGEKLFF	TRBV18	TRBJ1-4
TGTGCCAGCAGCCAAGCGGGTAGCTACAATGAGCAGTTCTTC	CASSQAGSYNEQFF	TRBV14	TRBJ2-1
TGTGCCAGCAGCTTCCGACCGAGGCCCCCGCCGGGGCTCAACGACACTGAAGCTTTCTTT	CASSFRPRPPPGLNDTEAFF	TRBV12-4	TRBJ1-1
TGTGCCATCAGTGAGAATAAGCGGGATGGGGACGAGCAGTACTTC	CAISENKRDGDEQYF	TRBV10-3	TRBJ2-7
TGTGCCAGCAGCGGGGGGGGGAAGATAGCCAAAAACATTCAGTACTTC	CASSGGGKIAKNIQYF	TRBV9	TRBJ2-4
TGTGCCAGCAGCAGGCCGGGGGCTCTTTCAAAGGACAACACCGGGGAGCTGTTTTTT	CASSRPGALSKDNTGELFF	TRBV11-1	TRBJ2-2
TGCGCCAGCAGCTCGGGGGTACTAGGGGACTACACCGGGGAGCTGTTTTTT	CASSSGVLGDYTGELFF	TRBV5-1	TRBJ2-2
TGCGCCAGCAGCCAAGAACCGGGACAGGGAGGGATAGCTTTCTTT	CASSQEPGQGGIAFF	TRBV4-3	TRBJ1-1
TGTGCCAGTAGTATAGTGGGAGGGGGGCGCGACACCGGGGAGCTGTTTTTT	CASSIVGGGRDTGELFF	TRBV19	TRBJ2-2
TGCGCCAGCAGCCAAGACTCGGGAATCAATCAGCCCCAGCATTTT	CASSQDSGINQPQHF	TRBV4-1	TRBJ1-5
TGTGCCAGCAGCCTTAGGGACAGTGGGGGGGATCAGCCCCAGCATTTT	CASSLRDSGGDQPQHF	TRBV13	TRBJ1-5
TGTGCCAGCTCACTCTTCAACCCAGGGGTTAACAATGAGCAGTTCTTC	CASSLFNPGVNNEQFF	TRBV18	TRBJ2-1
TGTGCCAGCAGTGGACAGGGGTTTGAAGCTTTCTTT	CASSGQGFEAFF	TRBV28	TRBJ1-1
TGCAGTGCAGGGGGCACAGATACGCAGTATTTT	CSAGGTDTQYF	TRBV20-1	TRBJ2-3
TGTGCCAGCAGTTACTCGTTTCGGGCCGACTCCTACGAGCAGTACTTC	CASSYSFRADSYEQYF	TRBV6-2	TRBJ2-7
TGTGCCAGCAGCCCGGGAGGTGAAGCTTTCTTT	CASSPGGEAFF	TRBV27	TRBJ1-1
TGCGCCAGCAGCTCAAAGTCTAGCGGGGCCGAGCAGTACTTC	CASSSKSSGAEQYF	TRBV5-1	TRBJ2-7
TGTGCCAGCAGCCAAGATTATGGACGTAACTATGGCTACACCTTC	CASSQDYGRNYGYTF	TRBV3-1	TRBJ1-2
TGTGCCAGCAGCGTCGCGGGGCAGCAGTACTTC	CASSVAGQQYF	TRBV9	TRBJ2-7
TGTGCCAGCAGTTACAGAGGGGCTAACAGCTCCTACAATGAGCAGTTCTTC	CASSYRGANSSYNEQFF	TRBV6-3	TRBJ2-1
TGCGCCAGCATTCCCGGGGGGGCCGTCTATGGCTACACCTTC	CASIPGGAVYGYTF	TRBV5-1	TRBJ1-2
TGTGCCTCTCGGGGGCCGCATGGCTACACCTTC	CASRGPHGYTF	TRBV2	TRBJ1-2
TGTGCTAGTGACGGGTCCAGGGGGACTGAAGCTTTCTTT	CASDGSRGTEAFF	TRBV12-5	TRBJ1-1
TGTGCCAGCAGCGGACTTCAAGAGCAGTACTTC	CASSGLQEQYF	TRBV2	TRBJ2-7
TGTGCCAGTTTAAAGGACGGGACAGGGGGGGGCTCGAACACTGAAGCTTTCTTT	CASLKDGTGGGSNTEAFF	TRBV6-4	TRBJ1-1
TGTGCCAGCAGCTTCCATACAAAGCTAGCGGGGCGGTTGGCGAATGAGCAGTTCTTC	CASSFHTKLAGRLANEQFF	TRBV7-9	TRBJ2-1
TGTGCCAGCGTTACAGGGGGGCGAATCAACACTGAAGCTTTCTTT	CASVTGGRINTEAFF	TRBV19	TRBJ1-1
TGCGCCAGCAGCCAGGAGTCCGTCCTCGGGGTCCGGTACGAGCAGTACTTC	CASSQESVLGVRYEQYF	TRBV4-1	TRBJ2-7
TGTGCCAGCAGCCAAGATCTAGGGGCCACAGATACGCAGTATTTT	CASSQDLGATDTQYF	TRBV14	TRBJ2-3
TGTGCCAGCAGTGACGAGTCCGGGGGGGGCCCCTACGAGCAGTACTTC	CASSDESGGGPYEQYF	TRBV6-4	TRBJ2-7
TGTGCCAGCCAATTGGCACAGGGGGCGGTATACAATGAGCAGTTCTTC	CASQLAQGAVYNEQFF	TRBV27	TRBJ2-1
TGCGCCAGCAGCTTGGGAGGGGGCAGGAATTCACCCCTCCACTTT	CASSLGGGRNSPLHF	TRBV5-1	TRBJ1-6
TGTGCCAGCAGCCACACGAATCGTTGGGGCAAAAACATTCAGTACTTC	CASSHTNRWGKNIQYF	TRBV7-3	TRBJ2-4
TGTGCCATCCAGGGGATTAACAATGAGCAGTTCTTC	CAIQGINNEQFF	TRBV18	TRBJ2-1
TGTGCCAGCAGTTGCTCGTTGCTAGTATTTGAACAAGAGACCCAGTACTTC	CASSCSLLVFEQETQYF	TRBV6-5	TRBJ2-5
TGTGCCAGCAGTGTCCAATCGGTGGGACTAGCGGGCAATGAGCAGTTCTTC	CASSVQSVGLAGNEQFF	TRBV2	TRBJ2-1
TGTGCCAGCAGGTATTATGACAGGGGTCGTCCTGAAGCTTTCTTT	CASRYYDRGRPEAFF	TRBV12-4	TRBJ1-1
TGTGCCAGCAGCCAGAATGGGGGGGCCGAGCAGTACTTC	CASSQNGGAEQYF	TRBV4-2	TRBJ2-7
TGTGCCAGGGACGACGAGCAGTACTTC	CARDDEQYF	TRBV27	TRBJ2-7
TGTGCCAGCAGTTTGGTAGGGGGGGGGTCAGTGCCCAATCAGCCCCAGCATTTT	CASSLVGGGSVPNQPQHF	TRBV27	TRBJ1-5
TGTGCCAGCAGCTTAAAGGGGACAGAACACACTGAAGCTTTCTTT	CASSLKGTEHTEAFF	TRBV7-9	TRBJ1-1
TGTGCCAGCAGCTGGGTACACAGGCGGAGCACAGATACGCAGTATTTT	CASSWVHRRSTDTQYF	TRBV5-4	TRBJ2-3
TGCGCCAGCAGGGACAGGGGTTTAGAGCAGTACTTC	CASRDRGLEQYF	TRBV10-1	TRBJ2-7
TGTGCCAGTATAGTAACCTACAATGAGCAGTTCTTC	CASIVTYNEQFF	TRBV19	TRBJ2-1
TGTGCCAGCAAGCCGGGACTAGATTTAAGCTCCTACAATGAGCAGTTCTTC	CASKPGLDLSSYNEQFF	TRBV7-9	TRBJ2-1
TGTGCCAGCAGCGGGGAAGAGACCCAGTACTTC	CASSGEETQYF	TRBV13	TRBJ2-5
TGTGCCAGCAGCTTGGTTGACTCGAAGGGTAAAACCGGGTACTTC	CASSLVDSKGKTGYF	TRBV5-6	TRBJ2-7
TGTGCCAGCGGTGGTAGGGAACATGAAAAACTGTTTTTT	CASGGREHEKLFF	TRBV27	TRBJ1-4
TGTGCTAGCAGCTTGGAGAGGATTACTGAAGCTTTCTTT	CASSLERITEAFF	TRBV7-7	TRBJ1-1
TGTGCCAGCAGACCAGGCCGACAGGGTAATCAGCCCCAGCATTTT	CASRPGRQGNQPQHF	TRBV11-2	TRBJ1-5
TGTGCCCCCGGGCCTCTTCACACTGAAGCTTTCTTT	CAPGPLHTEAFF	TRBV30	TRBJ1-1
TGTGCCTGGAGCCCGCCCCTTGAGCGGGACGAGCAGTACTTC	CAWSPPLERDEQYF	TRBV30	TRBJ2-7
TGTGCCAGCCCCTGTGGGGGTCCTGGGACAGGGGGCACGGATAATTCACCCCTCCACTTT	CASPCGGPGTGGTDNSPLHF	TRBV5-6	TRBJ1-6
TGCGCCAGCAGCCAAGACCCGGGGGGGCTCTACAATGAGCAGTTCTTC	CASSQDPGGLYNEQFF	TRBV4-3	TRBJ2-1
TGCGCCAGCAGCACAGGGGAGCAGTACTTC	CASSTGEQYF	TRBV5-1	TRBJ2-7
TGTGCCAGCAGCATGGCCGGGACAGGGTTTGATGGCTACACCTTC	CASSMAGTGFDGYTF	TRBV7-3	TRBJ1-2
TGTGCCAGCAGACCCGCGAATAATGAAAAACTGTTTTTT	CASRPANNEKLFF	TRBV6-4	TRBJ1-4
TGTGCCAGGGGGGGCCTCCAGAGAGTGAACACTGAAGCTTTCTTT	CARGGLQRVNTEAFF	TRBV6-5	TRBJ1-1
TGTGCCAGCAGCCGGGACTCTGGAAACACCATATATTTT	CASSRDSGNTIYF	TRBV12-3	TRBJ1-3
TGCGCCTGCTACCGGACAGTAAGACGGAATCAGCCCCAGCATTTT	CACYRTVRRNQPQHF	TRBV10-2	TRBJ1-5
TGTGCTAGTGGTCCCTCATATGAGCAGTTCTTC	CASGPSYEQFF	TRBV12-5	TRBJ2-1
TGTGCCAGCAGCGCGAGACAGGGGTCGAACACCGGGGAGCTGTTTTTT	CASSARQGSNTGELFF	TRBV7-4	TRBJ2-2
TGTGCCAGCAGCTTGGGACTAGCGGGTGCATACAATGAGCAGTTCTTC	CASSLGLAGAYNEQFF	TRBV7-4	TRBJ2-1
TGTGCCAGCAGCTTCAGGGGGAGACACACCGGGGAGCTGTTTTTT	CASSFRGRHTGELFF	TRBV7-2	TRBJ2-2
TGTGCCAGCAGTTTATTGCGAAACAGGGCTGGGGAGCAGTACTTC	CASSLLRNRAGEQYF	TRBV27	TRBJ2-7
TGTGCCAGCAGAGGGGGGTTGGATACGCAGTATTTT	CASRGGLDTQYF	TRBV6-5	TRBJ2-3
TGTGCCAGCAGACCCGCTAGGGGTTCTGGCCGGACCCAGTACTTC	CASRPARGSGRTQYF	TRBV13	TRBJ2-5
TGTGCCACCAAGCGGGACGGGGAAGGTGAAAAACTGTTTTTT	CATKRDGEGEKLFF	TRBV24-1	TRBJ1-4
TGCAGCGTTGTGTGTGTGGCTAGCAATGAGCAGTTCTTC	CSVVCVASNEQFF	TRBV29-1	TRBJ2-1
TGTGCCACCAGCGGACGGAGCATCGAGCAGTACTTC	CATSGRSIEQYF	TRBV24-1	TRBJ2-7
TGTGCCAGCAGTGGGGTGGGACTAGCGGTTTCGAACACCGGGGAGCTGTTTTTT	CASSGVGLAVSNTGELFF	TRBV6-1	TRBJ2-2
TGTGCCAGCAGCTTAGGTAATGGGGCGGGAAATCAGCCCCAGCATTTT	CASSLGNGAGNQPQHF	TRBV7-8	TRBJ1-5
TGTGCCAGGCCCACAGGGGGCGGGGGCTACACCTTC	CARPTGGGGYTF	TRBV11-3	TRBJ1-2
TGTGCCACCGAGTCTCCACAGGGCCTTCAGCCCCAGCATTTT	CATESPQGLQPQHF	TRBV24-1	TRBJ1-5
TGTGCCAGCAGCGTAGAGAGACAACGCCAACCTTATTTAGCTTTCTTT	CASSVERQRQPYLAFF	TRBV9	TRBJ1-1
TGCAGTGCTAGAGAACCGAACCTCTACGAGCAGTACTTC	CSAREPNLYEQYF	TRBV20-1	TRBJ2-7
TGCAGTGCTATATGGGGGACCGGGGAGCTGTTTTTT	CSAIWGTGELFF	TRBV20-1	TRBJ2-2
TGTGCCATGGGCCCGGGACTAGCGGGCGCAGATACGCAGTATTTT	CAMGPGLAGADTQYF	TRBV12-3	TRBJ2-3
TGCAGTGCAGTTCAGGACCGGGATGAGCAGTTCTTC	CSAVQDRDEQFF	TRBV20-1	TRBJ2-1
TGTGCCACCCACAGGGGGGGCGTGAACTCCTACGAGCAGTACTTC	CATHRGGVNSYEQYF	TRBV24-1	TRBJ2-7
TGTGCTAGTGGTACAGGGAACACTGAAGCTTTCTTT	CASGTGNTEAFF	TRBV12-5	TRBJ1-1
TGTGCCAGCAGTTTATTCGACTCAGGGACTGAAGCTTTCTTT	CASSLFDSGTEAFF	TRBV27	TRBJ1-1
TGTGCCAGCAGTGAGATACCCTCGTATTCCTATTCACCCCTCCACTTT	CASSEIPSYSYSPLHF	TRBV6-4	TRBJ1-6
TGTGCCACCAGTGACTATGCCGGGACAGCCGGTGGAAACACCATATATTTT	CATSDYAGTAGGNTIYF	TRBV24-1	TRBJ1-3
TGTGCCAGCAGCGGACGGGGGTTCGAGCCCCAGCATTTT	CASSGRGFEPQHF	TRBV7-9	TRBJ1-5
TGTGCCAGCAGTTACACTGGCCGAGCGACTAGCGGGGGATGTTCCAACACCGGGGAGCTGTTTTTT	CASSYTGRATSGGCSNTGELFF	TRBV6-2	TRBJ2-2
TGTGCCAGCAGCCTCCTAAAGAGCGGGAGACTCGAGGGTAGTGGAGACGAGCAGTACTTC	CASSLLKSGRLEGSGDEQYF	TRBV5-5	TRBJ2-7
TGCAGCGTTGATCGGCGGGCCGGGGAGCTGTTTTTT	CSVDRRAGELFF	TRBV29-1	TRBJ2-2
TGTGCCAGCAGCTTAGATCCTTGGGACAGGTTAGAGAGCTCCTACAATGAGCAGTTCTTC	CASSLDPWDRLESSYNEQFF	TRBV11-3	TRBJ2-1
TGTGCCAGCAGCATGCCGGGAAGGACGGGGGGGTGTAATGAAAAACTGTTTTTT	CASSMPGRTGGCNEKLFF	TRBV5-8	TRBJ1-4
TGTGCCAGCAGCTTAGGTCCCAGCTCCTACAATGAGCAGTTCTTC	CASSLGPSSYNEQFF	TRBV11-2	TRBJ2-1
TGTGCCAGCATCATGACGGGAGGGTCCTACGAGCAGTACTTC	CASIMTGGSYEQYF	TRBV2	TRBJ2-7
TGCAGTGCAATCCCCATTAGGGGGCGGGGGGAGCTGTTTTTT	CSAIPIRGRGELFF	TRBV20-1	TRBJ2-2
TGCAGCGTTGCTTACAGGGCATACGAGCAGTACTTC	CSVAYRAYEQYF	TRBV29-1	TRBJ2-7
TGTGCCAGCAGGGCGACAGGGCATACAACTAATGAAAAACTGTTTTTT	CASRATGHTTNEKLFF	TRBV9	TRBJ1-4
TGTGCCAGCAGTTACTCGGAGGCTTACACCTTC	CASSYSEAYTF	TRBV6-5	TRBJ1-2
TGTGCGCCCGGTAGCTCCTACAATGAGCAGTTCTTC	CAPGSSYNEQFF	TRBV7-9	TRBJ2-1
TGTGCCTATGTGGGGGACAGATACAATGAGCAGTTCTTC	CAYVGDRYNEQFF	TRBV11-3	TRBJ2-1
TGTGCCAGCAGTGCTAGGGCGGCTAACACCGGGGAGCTGTTTTTT	CASSARAANTGELFF	TRBV6-4	TRBJ2-2
TGTGCCAGCAGACACTGGCAGGGGTATTATGATGAGCAGTTCTTC	CASRHWQGYYDEQFF	TRBV7-2	TRBJ2-1
TGTCTGCCCTCTGGGGGTACCCACGGCACAGATACGCAGTATTTT	CLPSGGTHGTDTQYF	TRBV10-3	TRBJ2-3
TGCAGCGGTCCACCACCTCACAGGGCTGAAGCTTTCTTT	CSGPPPHRAEAFF	TRBV29-1	TRBJ1-1
TGCGCCAGGACTAGGACCCCACACACCGGGGAGCTGTTTTTT	CARTRTPHTGELFF	TRBV5-1	TRBJ2-2
TGTGCCAGCAGCGCGAAAACGACTAAAGATAGTCTCGGTCCCGGGGAGCAGTACTTC	CASSAKTTKDSLGPGEQYF	TRBV5-5	TRBJ2-7
TGTGCCAGCGAATTACAGAATCAAAACATTCAGTACTTC	CASELQNQNIQYF	TRBV27	TRBJ2-4
TGTGCCAGCAGTCCCTATCGCAATCAGCCCCAGCATTTT	CASSPYRNQPQHF	TRBV6-1	TRBJ1-5
TGCAGTGCTAGAGAACAAACTAGGGACCCTTTAACCTACAATGAGCAGTTCTTC	CSAREQTRDPLTYNEQFF	TRBV20-1	TRBJ2-1
TGTGCCAGCAGGGCCTTCCCCCTTCTAGCGGACAATGAGCAGTTCTTC	CASRAFPLLADNEQFF	TRBV5-4	TRBJ2-1
TGCAGTGCTAGCTCCCCGGGACAGGCTGACTATGGCTACACCTTC	CSASSPGQADYGYTF	TRBV20-1	TRBJ1-2
TGTGCCAGCAGTGAGGGACAGGGTTGGGCTTTCTTT	CASSEGQGWAFF	TRBV2	TRBJ1-1
TGTGCCAGCAGCTTAAAACCTCCGGGACAGGGGGTGGCCAGGGGGACCTATGGCTACACCTTC	CASSLKPPGQGVARGTYGYTF	TRBV7-2	TRBJ1-2
TGTGCCAGCAGCTTGCCTCCTACTAGGGGTCTTAGGAGCAATCAGCCCCAGCATTTT	CASSLPPTRGLRSNQPQHF	TRBV5-6	TRBJ1-5
TGTGCCAGCAGAACAGAGGAGGGTCAGCCCCAGCATTTT	CASRTEEGQPQHF	TRBV12-3	TRBJ1-5
TGTGCCAGCAACCCGGGACAGGGATGTACCTCCTACGAGCAGTACTTC	CASNPGQGCTSYEQYF	TRBV6-3	TRBJ2-7
TGCAGTGCTACCCCGTCCGGGACAGGGGAACTTGAAAAACTGTTTTTT	CSATPSGTGELEKLFF	TRBV20-1	TRBJ1-4
TGTGCCAGCAGCGTAGAAGACAGGGGTGACTACGAGCAGTACTTC	CASSVEDRGDYEQYF	TRBV9	TRBJ2-7
TGTGCCAGCAGCCCCGGAGGTGACAGGCGCCCCGGAGGCTACACCTTC	CASSPGGDRRPGGYTF	TRBV13	TRBJ1-2
TGTGCCAGCAGCGTAGTCGACAGGGATGGTCCAACTAATGAAAAACTGTTTTTT	CASSVVDRDGPTNEKLFF	TRBV9	TRBJ1-4
TGTGCCATGAAAAGCGGGGGGGGGCCCTACGAGCAGTACTTC	CAMKSGGGPYEQYF	TRBV6-5	TRBJ2-7
TGTGCCAGCAGCTGGCTCCCCTGTACAGGTAGCCACCAATGCAATCAGCCCCAGCATTTT	CASSWLPCTGSHQCNQPQHF	TRBV7-9	TRBJ1-5
TGTGCCAGCAGCGTAGGTGCCCGGGGGACCCCCCTTAACACCATATATTTT	CASSVGARGTPLNTIYF	TRBV9	TRBJ1-3
TGTGCCAGCAGCTTAATGGTAGTGTTATCCCGCACAGATACGCAGTATTTT	CASSLMVVLSRTDTQYF	TRBV7-2	TRBJ2-3
TGTGCCAGCAACCACGATGGGAGGGGGCGGATGCAGTTCTTC	CASNHDGRGRMQFF	TRBV28	TRBJ2-1
TGTGCCAGCAGCTCCCGGGGGTTTCCCTACGAGCAGTACTTC	CASSSRGFPYEQYF	TRBV11-3	TRBJ2-7
TGTGCCAGCATACCGGGACAGTTCAGGAACAATCAGCCCCAGCATTTT	CASIPGQFRNNQPQHF	TRBV6-1	TRBJ1-5
TGTGCCGCCAAGACGAACAGGAGGACCCAGTACTTC	CAAKTNRRTQYF	TRBV5-4	TRBJ2-5
TGTGCCACCAGTGCTAAGGGACTAGCGGCCCTCACAGATACGCAGTATTTT	CATSAKGLAALTDTQYF	TRBV24-1	TRBJ2-3
TGTGCCAGCAGCTTGGACAGGGGGGGCACCGGGGAGCTGTTTTTT	CASSLDRGGTGELFF	TRBV5-6	TRBJ2-2
TGCGCCAGCAGCCAGGGGGACAGGAGGGCGTACTTC	CASSQGDRRAYF	TRBV4-3	TRBJ2-7
TGTGCCAGCAGCTTGCCGACGGCTCTAGCGCGGCAGTTCTTC	CASSLPTALARQFF	TRBV5-4	TRBJ2-1
TGTGCCAGTTATGCGGGGAAGGTATACAATGAGCAGTTCTTC	CASYAGKVYNEQFF	TRBV28	TRBJ2-1
TGTGCCAGCAGCCCCCCGGGACAGGGGGGTGTGGGCTCTGGGGCCAACGTCCTGACTTTC	CASSPPGQGGVGSGANVLTF	TRBV14	TRBJ2-6
TGTGCCAGCAGCGGGTTGATTGGTGAAAAACTGTTTTTT	CASSGLIGEKLFF	TRBV7-9	TRBJ1-4
TGTGCCAGCAGCTACCCTGGCTGGCAAGAGACCCAGTACTTC	CASSYPGWQETQYF	TRBV7-3	TRBJ2-5
TGTGCCAGCAGCCTTCGGGACAAGAACACTGAAGCTTTCTTT	CASSLRDKNTEAFF	TRBV6-1	TRBJ1-1
TGTGCCAGCAGTTACTGCTATAGGGGGGCTGCCACAGATACGCAGTATTTT	CASSYCYRGAATDTQYF	TRBV6-5	TRBJ2-3
TGTGCCACAGGGGCTCGGATCGTGTATAGCAATCAGCCCCAGCATTTT	CATGARIVYSNQPQHF	TRBV7-9	TRBJ1-5
TGTGCCAGCAGTTTGGTTCCATCTGGGAATAGCTATGGCTACACCTTC	CASSLVPSGNSYGYTF	TRBV27	TRBJ1-2
TGTGCCAGCAGCTTAACGGGCTGGAGGTCCTACGAGCAGTACTTC	CASSLTGWRSYEQYF	TRBV7-3	TRBJ2-7
TGTGCCAGCAGTAGATCGCAAGAGACCCAGTACTTC	CASSRSQETQYF	TRBV6-4	TRBJ2-5
TGTGCCAGCAGCCAAGCCCTCTTGGATGAGCAGTTCTTC	CASSQALLDEQFF	TRBV3-1	TRBJ2-1
TGTGCTAGCAGCTGGGAATCCCGAGAGACAATATATAGCAATCAGCCCCAGCATTTT	CASSWESRETIYSNQPQHF	TRBV7-7	TRBJ1-5
TGTGCCAGCAGCCAAGATCAACATAATGAAAAACTGTTTTTT	CASSQDQHNEKLFF	TRBV3-1	TRBJ1-4
TGTGCCATCAATAGTACGTACAATGAGCAGTTCTTC	CAINSTYNEQFF	TRBV10-3	TRBJ2-1
TGCGCCAGCAGCCAAGATTACGACAGGGCAGGAGCTGGGGCCAACGTCCTGACTTTC	CASSQDYDRAGAGANVLTF	TRBV4-1	TRBJ2-6
TGCGCCAGCAGCCAATCTGAACCCCCGGGGGGGGTCGAGGCGCAGCCCCAGCATTTT	CASSQSEPPGGVEAQPQHF	TRBV4-3	TRBJ1-5
TGTGCCCCGGGGCGGATCTGTGCCTACGAGCAGTACTTC	CAPGRICAYEQYF	TRBV9	TRBJ2-7
TGTGCCAGCAGGAGCACCTCTGCGGGGACCTACGAGCAGTACTTC	CASRSTSAGTYEQYF	TRBV7-9	TRBJ2-7
TGTGCCAGCAGCGTATTTCCCCGGTGGACTGACAATGAGCAGTTCTTC	CASSVFPRWTDNEQFF	TRBV9	TRBJ2-1
TGTGCCGGGCGGCTGCTAGGGTACAATGAGCAGTTCTTC	CAGRLLGYNEQFF	TRBV12-3	TRBJ2-1
TGTGCCAGCAGGGTACCGGGACTAGTGGTAAATGAGCAGTTCTTC	CASRVPGLVVNEQFF	TRBV6-1	TRBJ2-1
TGTGCCACCAGTGATTTGCACGACGGGGCAGTGACCGGGGAGCTGTTTTTT	CATSDLHDGAVTGELFF	TRBV24-1	TRBJ2-2
TGTGCCACCGAGGGGGCAGATACGCAGTATTTT	CATEGADTQYF	TRBV28	TRBJ2-3
TGTGCCAGCAGCCAAGAACCGCGGGTGCACATGCAGCAGTTCTTC	CASSQEPRVHMQQFF	TRBV3-1	TRBJ2-1
TGCACTCTTAGTATCCGCTACGAGCAGTACTTC	CTLSIRYEQYF	TRBV29-1	TRBJ2-7
TGCAGCGTTGAAGATTTAATCGTACAGGGATTTGAAAAACTGTTTTTT	CSVEDLIVQGFEKLFF	TRBV29-1	TRBJ1-4
TGTGCCAGCAGTGCGGAACTAGCGGGAGGGCGAAAGGACACCATATATTTT	CASSAELAGGRKDTIYF	TRBV6-4	TRBJ1-3
TGTGCCAGCAGCTTAGACTCATCCGATGAGCAGTTCTTC	CASSLDSSDEQFF	TRBV7-8	TRBJ2-1
TGCGCCAGCCCCCGTTCCCGGGGGGAGACCCAGTACTTC	CASPRSRGETQYF	TRBV5-1	TRBJ2-5
TGTGCCAGCAGTTACTGGGGGGGCATCAGGAGCTCCTACGAGCAGTACTTC	CASSYWGGIRSSYEQYF	TRBV6-6	TRBJ2-7
TGCGCCAGCAGTGAGGGGACAGGGCACAATGAGCAGTTCTTC	CASSEGTGHNEQFF	TRBV10-1	TRBJ2-1
TGTGCCACCCCAGCAAGCGGGATTGGGACTGAAGCTTTCTTT	CATPASGIGTEAFF	TRBV24-1	TRBJ1-1
TGTGCCAGCACGCGGGAGGGGAGGGCTGGTGAGCAGTTCTTC	CASTREGRAGEQFF	TRBV27	TRBJ2-1
TGCAGCGCTCCCGCGGGTAACACCTTGGAATCAATCTACGAGCAGTACTTC	CSAPAGNTLESIYEQYF	TRBV29-1	TRBJ2-7
TGTGCCACAGTTACGGAGAGGGGCTCCTACGAGCAGTACTTC	CATVTERGSYEQYF	TRBV28	TRBJ2-7
TGTGCTAGTGGTTTGGTAGAGGAGGGCTGGAGAGAAAAACTGTTTTTT	CASGLVEEGWREKLFF	TRBV12-5	TRBJ1-4
TGTGCCACCAGTGCGCTAGGGAACACTGAAGCTTTCTTT	CATSALGNTEAFF	TRBV24-1	TRBJ1-1
TGCAGTGCTAGAGTTATAATAGATACGCAGTATTTT	CSARVIIDTQYF	TRBV20-1	TRBJ2-3
TGTGCCAGCAGCCAAGGAAGATTGGAGGACAGGAGAAACTATGGCTACACCTTC	CASSQGRLEDRRNYGYTF	TRBV4-2	TRBJ1-2
TGTGCCAGCAGCCCGCTGAGGGGGACTAGCACCGGGGAGCTGTTTTTT	CASSPLRGTSTGELFF	TRBV5-6	TRBJ2-2
TGTGCCAGCAGCCAAGAGGAACAGGGTAGGAACACTGAAGCTTTCTTT	CASSQEEQGRNTEAFF	TRBV3-1	TRBJ1-1
TGTGCCAGCAGTATAAAGCGGGACAGACTGTTTCTAAACAACGGGGAGCTGTTTTTT	CASSIKRDRLFLNNGELFF	TRBV2	TRBJ2-2
TGTGCCAGCAGTTTACCCCGGGACAGGGGGCGCGGTTACAATGAGCAGTTCTTC	CASSLPRDRGRGYNEQFF	TRBV27	TRBJ2-1
TGTGCCAGCAGCCAAGAGGGGTTTGTGAAACGACAGGACAACTATGGCTACACCTTC	CASSQEGFVKRQDNYGYTF	TRBV14	TRBJ1-2
TGTGCCAGCTCAACCGAGGGGGGGGTCTCTGGGGCCAACGTCCTGACTTTC	CASSTEGGVSGANVLTF	TRBV18	TRBJ2-6
TGTGCCACCAGTGATTATTGGTCGGGAAAGTGTGCAGGCTACACCTTC	CATSDYWSGKCAGYTF	TRBV24-1	TRBJ1-2
TGTGCCACCAGTGGGCGGGAGGCCGGGACCTACAATGAGCAGTTCTTC	CATSGREAGTYNEQFF	TRBV24-1	TRBJ2-1
TGTGCCAGCAGCTTAGGACGGCGGCTTGAAGCTTTCTTT	CASSLGRRLEAFF	TRBV7-9	TRBJ1-1
TGTGCTTCGGGAGGGAGGCAGTACTTC	CASGGRQYF	TRBV6-4	TRBJ2-7
TGTGCCACCAGTGAGATCACAGAGGGCCCAGGAAACACTGAAGCTTTCTTT	CATSEITEGPGNTEAFF	TRBV24-1	TRBJ1-1
TGTGCCAGCAGCTACAGGGACACCGGGGAGCTGTTTTTT	CASSYRDTGELFF	TRBV12-3	TRBJ2-2
TGTGCCACCAGTGATTCCCCCAAAATTCTGGGAAACACCATATATTTT	CATSDSPKILGNTIYF	TRBV24-1	TRBJ1-3
TGTGCCAGCAGCATTCGGGAAAGGAGCCTCCAAGCGAACACCGGGGAGCTGTTTTTT	CASSIRERSLQANTGELFF	TRBV7-9	TRBJ2-2
TGTGCCAGCAGCTTGGGGGGGGCAGCTCTCACAGATACGCAGTATTTT	CASSLGGAALTDTQYF	TRBV7-4	TRBJ2-3
TGTGCCAGCAGTCGTATCATTGCAATCCAGGGGGATAGCAATCAGCCCCAGCATTTT	CASSRIIAIQGDSNQPQHF	TRBV27	TRBJ1-5
TGCGCCAGCAGCTTGCCCCCCTTGCGGGAGCAGTACTTC	CASSLPPLREQYF	TRBV5-1	TRBJ2-7
TGCGCCAGCAGCCCCTCAGGGTTTCAGCCCCAGCATTTT	CASSPSGFQPQHF	TRBV5-1	TRBJ1-5
TGTGCCAGCAGCTTACGATGGGGAGGCAATCAGCCCCAGCATTTT	CASSLRWGGNQPQHF	TRBV7-6	TRBJ1-5
TGTGCCAGCAGCTTAACGTTCTTGACTAGCGGGACCGGGGAGCTGTTTTTT	CASSLTFLTSGTGELFF	TRBV7-2	TRBJ2-2
TGCAGTTCCACCGGACAGGGGTCGTACAATGAGCAGTTCTTC	CSSTGQGSYNEQFF	TRBV20-1	TRBJ2-1
TGTGCCACCAGTGGGGGCACCTATGGCTACACCTTC	CATSGGTYGYTF	TRBV24-1	TRBJ1-2
TGCAGTGCCGGCCCGAGCCAGCGGGAAGACCAAGAGACCCAGTACTTC	CSAGPSQREDQETQYF	TRBV20-1	TRBJ2-5
TGTGCCACCAGTGACGGGACGGGAGATACGCAGTATTTT	CATSDGTGDTQYF	TRBV24-1	TRBJ2-3
TGTGCCAGCACTAGTCCGGCGGAGTTCTACGAGCAGTACTTC	CASTSPAEFYEQYF	TRBV6-4	TRBJ2-7
TGTGCCAGCAGAAGGGGCGAGGCTACCTCTGGAAACACCATATATTTT	CASRRGEATSGNTIYF	TRBV27	TRBJ1-3
TGCGCCAGCATATACTATTTTTTTCAGCCCCAGCATTTT	CASIYYFFQPQHF	TRBV10-1	TRBJ1-5
TGTGCCAGCAGTAGATGGGGGGGGACAGGGGAGTATTTT	CASSRWGGTGEYF	TRBV28	TRBJ2-3
TGTGCCAGCAGCCGACCCCGGCGGGGTACCGGGGGGGAGCTGTTTTTT	CASSRPRRGTGGELFF	TRBV7-8	TRBJ2-2
TGTGCCAGCAGGGTGAGTAGGCGACAGGTACCGGAAAACATTCAGTACTTC	CASRVSRRQVPENIQYF	TRBV2	TRBJ2-4
TGTGCCAGCAGTGCCGGGGTTCGTAGGGGGGACTACAATGAGCAGTTCTTC	CASSAGVRRGDYNEQFF	TRBV6-1	TRBJ2-1
TGTGCCACCAAGACAGATTACGAGCAGTACTTC	CATKTDYEQYF	TRBV24-1	TRBJ2-7
TGTGCCAGCAGCGCCCCAATATTGGACTACGGGAACACCGGGGAGCTGTTTTTT	CASSAPILDYGNTGELFF	TRBV13	TRBJ2-2
TGTGCCAGCAGTTACTCCCGAGTGACGAACACCGGGGAGCTGTTTTTT	CASSYSRVTNTGELFF	TRBV6-6	TRBJ2-2
TGCAGTGCTAGAGATGGTGTGACAGTGGGATCTAATCAGCCCCAGCATTTT	CSARDGVTVGSNQPQHF	TRBV20-1	TRBJ1-5
TGTGCCAGCACCCGGGGGGCCAGGGCCAACGTCCTGACTTTC	CASTRGARANVLTF	TRBV6-2	TRBJ2-6
TGTGCCAGGGACCAACGGGACAGTAACCCCCCCGATGGCTACACCTTC	CARDQRDSNPPDGYTF	TRBV5-4	TRBJ1-2
TGTGCCAGCAGCATGCGAAAGAAGCAGGGGCCAAGCTCCTACAATGAGCAGTTCTTC	CASSMRKKQGPSSYNEQFF	TRBV13	TRBJ2-1
TGTGCCAGCAGCTGGGGACAGGGGAGGCGACCCGGGGAGCTGTTTTTT	CASSWGQGRRPGELFF	TRBV11-2	TRBJ2-2
TGCAGTGCTAGAGAGGACAGCAAAAACATTCAGTACTTC	CSAREDSKNIQYF	TRBV20-1	TRBJ2-4
TGTGCCAGCAGCTTAAGGGGGGGCAACACTGAAGCTTTCTTT	CASSLRGGNTEAFF	TRBV7-2	TRBJ1-1
TGTGCCACCAGCATGCCTTATACAGGGGCGGAGACCCAGTACTTC	CATSMPYTGAETQYF	TRBV15	TRBJ2-5
TGCGCCAGCAGCTCTGGGGGGAAAACGCAGTACTTC	CASSSGGKTQYF	TRBV5-1	TRBJ2-7
TGTGCCAGCAGCTGGGGACGGAGGGGAAGAGATACGCAGTATTTT	CASSWGRRGRDTQYF	TRBV6-5	TRBJ2-3
TGTGCCAGCAGCCCCCCAGGAGCAACCTCCTACGAGCAGTACTTC	CASSPPGATSYEQYF	TRBV11-2	TRBJ2-7
TGTGCCAGCAGTGAGACAGGGGGCGCGGATCGTCTTTTCCGAGGCGAGCAGTACTTC	CASSETGGADRLFRGEQYF	TRBV12-4	TRBJ2-7
TGTGCCAGCAGTTTTCACGGCCGAGGGACAGGGACTGAAGCTTTCTTT	CASSFHGRGTGTEAFF	TRBV28	TRBJ1-1
TGTGCCAGCAGCCAAGTACCTAAAGCAGGGATTTCGTCTGGGGCCAACGTCCTGACTTTC	CASSQVPKAGISSGANVLTF	TRBV3-1	TRBJ2-6
TGTGCCAGCAGCCAAGCTCCGGCGTACACTGAAGCTTTCTTT	CASSQAPAYTEAFF	TRBV3-1	TRBJ1-1
TGTGCCAGCAGTTTCCCCTACACCCCCCCCTCCTTTTGGGACCCAAGCACTGAAGCTTTCTTT	CASSFPYTPPSFWDPSTEAFF	TRBV28	TRBJ1-1
TGTGCCAGCAGGCAGAATATGGCGGGAGGGTCCTCCTACAATGAGCAGTTCTTC	CASRQNMAGGSSYNEQFF	TRBV6-3	TRBJ2-1
TGTGCCAGCAGCCGGCAGGGATCGTACTTC	CASSRQGSYF	TRBV7-9	TRBJ2-4
TGTGCCAGCAGGGAGGGGAACACTGAAGCTTTCTTT	CASREGNTEAFF	TRBV27	TRBJ1-1
TGTGCCATCAGCCCACTAGCGGGAGTGATCTACAATGAGCAGTTCTTC	CAISPLAGVIYNEQFF	TRBV10-3	TRBJ2-1
TGTGCCAGCAGTTACTCGCTCTGGGAGGGACAGGGAGAAGCTGGCTACACCTTC	CASSYSLWEGQGEAGYTF	TRBV6-3	TRBJ1-2
TGTGCCAGCAGCTTAGGGACAGGGACCGATCAGCCCCAGCATTTT	CASSLGTGTDQPQHF	TRBV7-8	TRBJ1-5
TGTGCCAGCAGTGCAGGAGGGGATGAAGCTTTCTTT	CASSAGGDEAFF	TRBV6-1	TRBJ1-1
TGTGCCAGCATCGGACTCCCCGGGGCCATTGGGACCTTGAACACTGAAGCTTTCTTT	CASIGLPGAIGTLNTEAFF	TRBV6-5	TRBJ1-1
TGCAGTGCTAGCGGGGGACATACTGGAAACACCATATATTTT	CSASGGHTGNTIYF	TRBV20-1	TRBJ1-3
TGTGCCAGCAAGCCGGTTTGGACGGATCAGCCCCAGCATTTT	CASKPVWTDQPQHF	TRBV27	TRBJ1-5
TGTGCCAGCTCACCACGTACCGGACGGAGATACACTGAAGCTTTCTTT	CASSPRTGRRYTEAFF	TRBV18	TRBJ1-1
TGTGCCAGCAGCCCCCTCGCGGGGGGCGGGGAGCTGTTTTTT	CASSPLAGGGELFF	TRBV2	TRBJ2-2
TGTGCCAGCAGCTTAACGCTGGCCTACGAGCAGTACTTC	CASSLTLAYEQYF	TRBV7-7	TRBJ2-7
TGTGCCAGCAGCTTAGGGACAGGGCGCTACGAGCAGTACTTC	CASSLGTGRYEQYF	TRBV11-2	TRBJ2-7
TGCGCCAGCAGTTTTGGGACCCAGCCCCAGCATTTT	CASSFGTQPQHF	TRBV5-1	TRBJ1-5
TGTGCCAGCAGCCAAGCCCGGGGACAGTACGGCTACACCTTC	CASSQARGQYGYTF	TRBV3-1	TRBJ1-2
TGTGCCAGCAGCCAACCCCCCTTGGACAGGGGGCAAGGCTACACCTTC	CASSQPPLDRGQGYTF	TRBV3-1	TRBJ1-2
TGTGCCAGCAGCGGGGAGGGGGGTTCCTATAGCAATCAGCCCCAGCATTTT	CASSGEGGSYSNQPQHF	TRBV11-2	TRBJ1-5
TGTGCCAGCAGCCGGCAACAGGGCAGTTCACCCCTCCACTTT	CASSRQQGSSPLHF	TRBV7-6	TRBJ1-6
TGTGCCAGCAAGGGCGAGGCAAGGGCGGCAGATGAAAAACTGTTTTTT	CASKGEARAADEKLFF	TRBV25-1	TRBJ1-4
TGTGCCAGCGGCCACGCTACTCTAGCCAAAAACATTCAGTACTTC	CASGHATLAKNIQYF	TRBV9	TRBJ2-4
TGTGCCAGTAGTATTAATTACCGATTTTCCTACGAGCAGTACTTC	CASSINYRFSYEQYF	TRBV19	TRBJ2-7
TGTGCCAGCAGTGACCAGAAGTGGACAGGGCAGGGCACCATATATTTT	CASSDQKWTGQGTIYF	TRBV6-4	TRBJ1-3
TGTGCCAGCACTTTCAGTACCACAGGTGGCACTGAAGCTTTCTTT	CASTFSTTGGTEAFF	TRBV12-3	TRBJ1-1
TGTGCCAGCAGCTTCCGGACTAGCAAGTGGGCCTATGAGCAGTTCTTC	CASSFRTSKWAYEQFF	TRBV11-3	TRBJ2-1
TGCGCCAGCAGCTTGGAGGTTGTCCGGCCCTTTTACAAAAACATTCAGTACTTC	CASSLEVVRPFYKNIQYF	TRBV5-1	TRBJ2-4
TGTGCCAGCAGCGACCGGGGGGTTAGGGGCTCCTACGAGCAGTACTTC	CASSDRGVRGSYEQYF	TRBV7-3	TRBJ2-7
TGTGCTAGTGGTTTAGCTAAGGGACTAGCGGTGATTGATCCCTACGAGCAGTACTTC	CASGLAKGLAVIDPYEQYF	TRBV12-5	TRBJ2-7
TGCGCCAGCAGCACCGACAGGGTGAACACTGAAGCTTTCTTT	CASSTDRVNTEAFF	TRBV5-1	TRBJ1-1
TGTGCCAGTAGTATCCAAGGTAACTCAAACAATGAGCAGTTCTTC	CASSIQGNSNNEQFF	TRBV19	TRBJ2-1
TGTGCCAGCAGCTTAGATAACACCTCGCCCAAGGGCTACGAGCAGTACTTC	CASSLDNTSPKGYEQYF	TRBV11-3	TRBJ2-7
TGTGCCACCACGGGGGGAGGGAGGGTACAAAACTTCGAGCAGTACTTC	CATTGGGRVQNFEQYF	TRBV24-1	TRBJ2-7
TGTGCCAGCAGCCCGCCAGGGACAGGGGGATTGAACACCGGGGAGCTGTTTTTT	CASSPPGTGGLNTGELFF	TRBV13	TRBJ2-2
TGTGCCACCAGTGAGCGGGACACTGAAGCTTTCTTT	CATSERDTEAFF	TRBV24-1	TRBJ1-1
TGTGCCAGCAGAGGAGGGTTAGATACGCAGTATTTT	CASRGGLDTQYF	TRBV6-5	TRBJ2-3
TGTGCCAGCAGCGGTCGACTCCCTCCTCAGTACCAAGAGACCCAGTACTTC	CASSGRLPPQYQETQYF	TRBV6-4	TRBJ2-5
TGTGCCAGTGGGGCTTCGAACACCGGGGAGCTGTTTTTT	CASGASNTGELFF	TRBV6-5	TRBJ2-2
TGTGCCAGCAGCCAAGAAGGGAGGAGCAATGAGCAGTTCTTC	CASSQEGRSNEQFF	TRBV4-2	TRBJ2-1
TGTGCCAGCAATTTGCGGGAGGTGGACGAAGAGCAGTACTTC	CASNLREVDEEQYF	TRBV6-5	TRBJ2-7
TGTGCCAGTAGTATAGATGTTAGCCGGGACAGGGGGGGGTTTAATGAAAAACTGTTTTTT	CASSIDVSRDRGGFNEKLFF	TRBV19	TRBJ1-4
TGTGCCAGCAGCAGGAGAGTACTGAACACTGAAGCTTTCTTT	CASSRRVLNTEAFF	TRBV7-2	TRBJ1-1
TGTGCCAGCGCCCGGACAGCCTGTCCTTCACCCCTCCACTTT	CASARTACPSPLHF	TRBV7-3	TRBJ1-6
TGTGCCAGCAGTGCGGGGGGGCGACTCACAGATACGCAGTATTTT	CASSAGGRLTDTQYF	TRBV6-1	TRBJ2-3
TGCAGTGCTAGTCCAGGGGCTAACTATGGCTACACCTTC	CSASPGANYGYTF	TRBV20-1	TRBJ1-2
TGCGCCAGCCGGGCCGGGAATCAGCCCCAGCATTTT	CASRAGNQPQHF	TRBV5-1	TRBJ1-5
TGTGCCACCAGTGATCCCGAGGGACAGGTTGAGGAGCAGTACTTC	CATSDPEGQVEEQYF	TRBV24-1	TRBJ2-7
TGTGCCAGCAAGCGCCCCCGAGTTCAAGGAACCGGCGGGGAGCTGTTTTTT	CASKRPRVQGTGGELFF	TRBV2	TRBJ2-2
TGTGCCAGCAGTGAAGCGCGCAAAGGGACAGGGGGGACGAGGAGCGGCTACACCTTC	CASSEARKGTGGTRSGYTF	TRBV2	TRBJ1-2
TGTGCCAGCAGATTACTAGCGGGTCATGTCGAGCAGTACTTC	CASRLLAGHVEQYF	TRBV6-5	TRBJ2-7
TGTGCCAGCAGTATCTCCTACGAGCAGTACTTC	CASSISYEQYF	TRBV6-3	TRBJ2-7
TGTGCCAGCAGCTCAGCCAATGAAGCTTTCTTT	CASSSANEAFF	TRBV7-4	TRBJ1-1
TGTGCCAGTAGTATCGGACAGCGGAGGCGGACCGGGGAGCTGTTTTTT	CASSIGQRRRTGELFF	TRBV19	TRBJ2-2
TGTGCCTGGAGTGTACTACCCATTTCTCTGAACACTGAAGCTTTCTTT	CAWSVLPISLNTEAFF	TRBV30	TRBJ1-1
TGCGCCAGCAGCTTGCAGGCGGGACACAGGGCCTACGAGCAGTACTTC	CASSLQAGHRAYEQYF	TRBV5-1	TRBJ2-7
TGTGCCAGCAGCAATGGGCAGCGTGGCTACGAGCAGTACTTC	CASSNGQRGYEQYF	TRBV7-2	TRBJ2-7
TGTGCCAGCAGTTACCAAACCGGGACAGGGTCCCAGTACTTC	CASSYQTGTGSQYF	TRBV6-5	TRBJ2-5
TGCGCCAGCAGCTTGGATACGGGACGGGAGACCCAGTACTTC	CASSLDTGRETQYF	TRBV5-1	TRBJ2-5
TGTGCCAGCAGTACAGTAAGGCGCTACAATGAGCAGTTCTTC	CASSTVRRYNEQFF	TRBV2	TRBJ2-1
TGTGCCAGCAGCCAACCTGAGGACAGGGGGATGAACACTGAAGCTTTCTTT	CASSQPEDRGMNTEAFF	TRBV4-2	TRBJ1-1
TGTGCCAGCAGCCAAGATTTGCCCGGGACTAGCGGGAGCATTACGTACTTC	CASSQDLPGTSGSITYF	TRBV14	TRBJ2-5
TGCGCCAGCAGCTTGCCGCGGGGGCAGGGGGTGGTAAATAGCAATCAGCCCCAGCATTTT	CASSLPRGQGVVNSNQPQHF	TRBV5-1	TRBJ1-5
TGTGCCAGAGGAGATGACCCGCATCGCTCCTACAATGAGCAGTTCTTC	CARGDDPHRSYNEQFF	TRBV2	TRBJ2-1
TGTGCTAGCAGCTTTTTAGGGGACAGGGGGCGAGGGTGTAATGAAAAACTGTTTTTT	CASSFLGDRGRGCNEKLFF	TRBV7-7	TRBJ1-4
TGTGCCAGCAGCTTAGCGGAGACCTACTACGAGCAGTACTTC	CASSLAETYYEQYF	TRBV7-9	TRBJ2-7
TGTGCCAGCAGCCCACTCAACAACACCTTC	CASSPLNNTF	TRBV14	TRBJ1-2
TGTGCCAGCAGAGCCGGGACAGAAGGAGCCAAAAACATTCAGTACTTC	CASRAGTEGAKNIQYF	TRBV11-2	TRBJ2-4
TGTGCCAGCAGCGAGAACCCCCCAGGGGTGTCGGGTAGCAATCAGCCCCAGCATTTT	CASSENPPGVSGSNQPQHF	TRBV13	TRBJ1-5
TGTGCCAGCAGCCCACGGGGGGGCCAAGAGACCCAGTACTTC	CASSPRGGQETQYF	TRBV3-1	TRBJ2-5
TGTGCCAGCAGCTGGAGGGCGTATAAAAAAGCCAGCAATCAGCCCCAGCATTTT	CASSWRAYKKASNQPQHF	TRBV6-1	TRBJ1-5
TGTGCCAGCAGCCAAGATCTCCGAAGCGAAAATAGCGGGAATAGGCGATCCTACAATGAGCAGTTCTTC	CASSQDLRSENSGNRRSYNEQFF	TRBV4-2	TRBJ2-1
TGTGCCAGCAGCCCGGAGCGACTACGGCGGCCTCGAGCAGATACGCAGTATTTT	CASSPERLRRPRADTQYF	TRBV3-1	TRBJ2-3
TGTGCCAGTAACGTGACTTGGGAGACCCAGTACTTC	CASNVTWETQYF	TRBV19	TRBJ2-5
TGTGCCAGCAGTGAGCTAGCGGGGCGCTACGAGCAGTACTTC	CASSELAGRYEQYF	TRBV6-4	TRBJ2-7
TGTGCCAGCAGCCGGAAGGCTGCGGATACGCAGTATTTT	CASSRKAADTQYF	TRBV13	TRBJ2-3
TGTGCCAGCAGCCGGGTTTCCCCGGGACTAGTATCCTTAGGGAGCCCCTACGAGCAGTACTTC	CASSRVSPGLVSLGSPYEQYF	TRBV3-1	TRBJ2-7
TGTGCCAGCAGCTTAGGTAGGAGAGGAGGGAAGTACGAGCAGTACTTC	CASSLGRRGGKYEQYF	TRBV7-2	TRBJ2-7
TGCGCCAGCCCCCCTCGGGTCACAGATACGCAGTATTTT	CASPPRVTDTQYF	TRBV10-1	TRBJ2-3
TGCAGTGCTGGTTTTCCCGCTTACAATGAGCAGTTCTTC	CSAGFPAYNEQFF	TRBV20-1	TRBJ2-1
TGCAGTGCTAGAGTCCATGTAGGACGACGGAACACTGAAGCTTTCTTT	CSARVHVGRRNTEAFF	TRBV20-1	TRBJ1-1
TGTGCCAGCAGCTTAGTGGACAGTGGGTACGAGCAGTACTTC	CASSLVDSGYEQYF	TRBV7-2	TRBJ2-7
TGCAGCGTGGGGGGGGGGGCCTACGAGCAGTACTTC	CSVGGGAYEQYF	TRBV29-1	TRBJ2-7
TGTGCCAGCAGTTATCGGGCAGGGCTGCCAACTAACTATGGCTACACCTTC	CASSYRAGLPTNYGYTF	TRBV6-9	TRBJ1-2
TGTGCCAGCATGTTCACTAGCGGGAGGGATGAGCAGTTCTTC	CASMFTSGRDEQFF	TRBV12-3	TRBJ2-1
TGTGCCAGCGAGACAGGGGAGTTTGTAGATTGGCGCTACGAGCAGTACTTC	CASETGEFVDWRYEQYF	TRBV13	TRBJ2-7
TGTGCCAGCAGCGTACCCGACAGGGGCAGAGCTAACTATGGCTACACCTTC	CASSVPDRGRANYGYTF	TRBV13	TRBJ1-2
TGCAGTGCTAGAGGGGAATCCCATAATCAGCCCCAGCATTTT	CSARGESHNQPQHF	TRBV20-1	TRBJ1-5
TGTGCCAGCAGGAGACAGGTAAGAGACAGCAATCAGCCCCAGCATTTT	CASRRQVRDSNQPQHF	TRBV6-1	TRBJ1-5
TGCGCCAGCAGCTCACAGGGGAGCACTGAAGCTTTCTTT	CASSSQGSTEAFF	TRBV5-1	TRBJ1-1
TGTGCCAGCAGCGGAGACATAGGGACCTGGAACACTGAAGCTTTCTTT	CASSGDIGTWNTEAFF	TRBV13	TRBJ1-1
TGTGCCAGCTCACCCCAACCTTTTTTACCCCCCAGTGCTAGCGGGTGCGAGACCCAGTACTTC	CASSPQPFLPPSASGCETQYF	TRBV18	TRBJ2-5
TGTGCCAGCAGCGGGGAGGGGTCCTACGAGCAGTACTTC	CASSGEGSYEQYF	TRBV7-6	TRBJ2-7
TGTGCCAGCAGTTACCCCAACAGGGTGGAAAAGGGCTACACCTTC	CASSYPNRVEKGYTF	TRBV6-3	TRBJ1-2
TGCGCCAGCAGGGCAGGGGCCAACGTCCTGACTTTC	CASRAGANVLTF	TRBV5-1	TRBJ2-6
