TGCGCCAGCAAGGGGTTCATCCACTTC	CASKGFIHF	TRBV10-1	TRBJ2-7
TGTGCCAGCAGCGTATCAAGCTGTTACGAGCAGTACTTC	CASSVSSCYEQYF	TRBV9	TRBJ2-7
TGTGCGACTAGCTTTGATGAGCAGTTCTTC	CATSFDEQFF	TRBV12-3	TRBJ2-1
TGCGCCAGCAGCTTCCGACGCTATGAGCAGTTCTTC	CASSFRRYEQFF	TRBV5-1	TRBJ2-1
TGTGCCAGCAGCACTATACCGCCTCTCCGGGGGGATGGCTACACCTTC	CASSTIPPLRGDGYTF	TRBV9	TRBJ1-2
TGTGCCAGCAGCCGGTCGGGGGGAAAATCCTACGAGCAGTACTTC	CASSRSGGKSYEQYF	TRBV4-2	TRBJ2-7
TGTGCCAGCAGTAAAACGGGACAGAGCAATCAGCCCCAGCATTTT	CASSKTGQSNQPQHF	TRBV6-4	TRBJ1-5
TGTGCCAGGAGCCAATTCCCCATCCCTAGCGGGTCTGGACTGTACAATGAGCAGTTCTTC	CARSQFPIPSGSGLYNEQFF	TRBV6-4	TRBJ2-1
TGTGCCAGTGGGGACGGGGACACTAGCACAGATACGCAGTATTTT	CASGDGDTSTDTQYF	TRBV7-9	TRBJ2-3
TGCAGTGCATCCGGGAGCGATGAGCAGTTCTTC	CSASGSDEQFF	TRBV20-1	TRBJ2-1
TGCAGCGTTGAGGTACATGAAGAGGTGGGTGAGACCCAGTACTTC	CSVEVHEEVGETQYF	TRBV29-1	TRBJ2-5
TGTGCCAGCAGCTTACAGGGGGTTGAGCAGTACTTC	CASSLQGVEQYF	TRBV5-4	TRBJ2-7
TGTGCCAGCACTGCCGGGACAGGGGCAGGAAACACCATATATTTT	CASTAGTGAGNTIYF	TRBV6-4	TRBJ1-3
TGCGCCAGCAGCCAAGTGCAGCGGGAGATAGAAGGTGCAACTAATGAAAAACTGTTTTTT	CASSQVQREIEGATNEKLFF	TRBV4-1	TRBJ1-4
TGTGCCATCCCAGCCCAGGCTAACTATGGCTACACCTTC	CAIPAQANYGYTF	TRBV10-3	TRBJ1-2
TGTGCCAGCAGCCTTGGACTAGCGGGGAGGCGCTACAATGAGCAGTTCTTC	CASSLGLAGRRYNEQFF	TRBV7-6	TRBJ2-1
TGTGCCAGCAGCTCCGCGCTAAGGGGGCCAAAGAATGGCTACACCTTC	CASSSALRGPKNGYTF	TRBV7-2	TRBJ1-2
TGTGCCAGCAGTCTGGGGTATGGCTACACCTTC	CASSLGYGYTF	TRBV7-3	TRBJ1-2
TGCGCCAGCAGTGACCCGATAATCCATAGCAATCAGCCCCAGCATTTT	CASSDPIIHSNQPQHF	TRBV10-1	TRBJ1-5
TGCGCCAGCAGTCCCGGGACTAGCGGGGGGGCGCCAAAAGAGACCCAGTACTTC	CASSPGTSGGAPKETQYF	TRBV10-1	TRBJ2-5
TGTGCCAGCTCAAACCGGGGGGGTTTCCACCTGTACTACGAGCAGTACTTC	CASSNRGGFHLYYEQYF	TRBV28	TRBJ2-7
TGTGCCAGCTCACCTAGAAACCCGGGGGCGCGGGATAGCAATCAGCCCCAGCATTTT	CASSPRNPGARDSNQPQHF	TRBV18	TRBJ1-5
TGTGCCAGCAGTTTTCCAACGGGGCTTACAGATACGCAGTATTTT	CASSFPTGLTDTQYF	TRBV6-1	TRBJ2-3
TGCAGTGCTAGCAAACTGCCAGGGAGGGTAGCCAAAAACATTCAGTACTTC	CSASKLPGRVAKNIQYF	TRBV20-1	TRBJ2-4
TGTGCCAGCAGCTTGGCCTTGAGCCTGTACGAGCAGTACTTC	CASSLALSLYEQYF	TRBV5-5	TRBJ2-7
TGTGCCAGCAGTTTCCCGGGACTAGCGGGGGGGCCGTGCGAGCAGTACTTC	CASSFPGLAGGPCEQYF	TRBV27	TRBJ2-7
TGCGCCAGCAGCTTGACCCGCGGGAGCGACGGGGAGCTGTTTTTT	CASSLTRGSDGELFF	TRBV5-1	TRBJ2-2
TGCAGCGTTGAAGGACGTCCGGGAGGGCCCTGGTACACCGGGGAGCTGTTTTTT	CSVEGRPGGPWYTGELFF	TRBV29-1	TRBJ2-2
TGCGCCAGCAGAGACAGGGGTAGGCAGTACTTC	CASRDRGRQYF	TRBV10-1	TRBJ2-7
TGTGCCAGCAGTTCCTCTTGGGGGACAGGGGAGTTGGGTGAGCAGTACTTC	CASSSSWGTGELGEQYF	TRBV6-9	TRBJ2-7
TGTGCCAGCAGCTTGCCTTTCACAGGAGGCCGCCTCGAACACTACGAGCAGTACTTC	CASSLPFTGGRLEHYEQYF	TRBV7-3	TRBJ2-7
TGTGCCAGCAGCCCCCGGGCATATAGCAATCAGCCCCAGCATTTT	CASSPRAYSNQPQHF	TRBV3-1	TRBJ1-5
TGCAGCGTCGCAACCACCCACTATGGCTACACCTTC	CSVATTHYGYTF	TRBV29-1	TRBJ1-2
TGTGCCAGCAGCTCCGTAGGGGCGGGGCGACACGATAGCAATCAGCCCCAGCATTTT	CASSSVGAGRHDSNQPQHF	TRBV13	TRBJ1-5
TGTGCCAGCAGCGATCCCACTAGCGGGGGGGCCTTCTACGAGCAGTACTTC	CASSDPTSGGAFYEQYF	TRBV7-3	TRBJ2-7
TGTGCCAGCAGTTTCGGTTTGGGGGGACAGGAAAAACTGTTTTTT	CASSFGLGGQEKLFF	TRBV27	TRBJ1-4
TGTGCCATCGGGACAAATAGAGAGCAGTTCTTC	CAIGTNREQFF	TRBV6-3	TRBJ2-1
TGTGCCAGCAGAGGACGGAACACTGAAGCTTTCTTT	CASRGRNTEAFF	TRBV6-4	TRBJ1-1
TGTGCCAGCACTGGACGGCCCAACCATGAAAAACTGTTTTTT	CASTGRPNHEKLFF	TRBV2	TRBJ1-4
TGTGCCAGCAGCTTATTCGGGAACGTCTATGGCTACACCTTC	CASSLFGNVYGYTF	TRBV7-3	TRBJ1-2
TGTGCCAGCAGGGACAGGGAAAGCTCTGGAAACACCATATATTTT	CASRDRESSGNTIYF	TRBV6-5	TRBJ1-3
TGTGCCTGGCCACAGAGGGGGGCTGGCTACACCTTC	CAWPQRGAGYTF	TRBV30	TRBJ1-2
TGTGCCAGCAGCTTGTTAACAGGGGCAGGGGATAGCAATCAGCCCCAGCATTTT	CASSLLTGAGDSNQPQHF	TRBV5-8	TRBJ1-5
TGTGCCAGCACCAAGATGAGGGTATCACAAGGGATGAACACTGAAGCTTTCTTT	CASTKMRVSQGMNTEAFF	TRBV3-1	TRBJ1-1
TGTGCCAGCAGTTCCTTCACTAGCGGGGGGTACAATGAGCAGTTCTTC	CASSSFTSGGYNEQFF	TRBV27	TRBJ2-1
TGTGCCAGTACCGTTGGACTAGCGGGACGGAACACCGGGGAGCTGTTTTTT	CASTVGLAGRNTGELFF	TRBV19	TRBJ2-2
TGTGCCAGTAGTATCCGGACAGGGAGGCAGCCCCAGCATTTT	CASSIRTGRQPQHF	TRBV19	TRBJ1-5
TGTGCCAGCAGTGAAGCGGGGGAGAAAGAAAAACTGTTTTTT	CASSEAGEKEKLFF	TRBV2	TRBJ1-4
TGTGCCAGCAGCTTACTTAGACAAGAATACGAGCAGTACTTC	CASSLLRQEYEQYF	TRBV7-6	TRBJ2-7
TGTGCCAGCAGTCCCAAATCTAGGGGAACGAATCAGCCCCAGCATTTT	CASSPKSRGTNQPQHF	TRBV14	TRBJ1-5
TGTGCCAGCAGCGCAATAAAGCTCTACCAGGGTGACTATGGCTACACCTTC	CASSAIKLYQGDYGYTF	TRBV11-2	TRBJ1-2
TGCAGTGCACGCAGGGGGCACGAGCAGTACTTC	CSARRGHEQYF	TRBV20-1	TRBJ2-7
TGTGCCAGCAGTTACTCGAGGGGGACAGGGGCTAGGGCCTACGAGCAGTACTTC	CASSYSRGTGARAYEQYF	TRBV6-5	TRBJ2-7
TGTGCCAGCTCCCGGGGGGGGGTCGGCACAGATACGCAGTATTTT	CASSRGGVGTDTQYF	TRBV18	TRBJ2-3
TGTGCCAGCACCGGGTCAGGCACAGATACGCAGTATTTT	CASTGSGTDTQYF	TRBV6-5	TRBJ2-3
TGTGCCAGCAGCCCACTACGGGAATCTCATAATCAGCCCCAGCATTTT	CASSPLRESHNQPQHF	TRBV4-2	TRBJ1-5
TGCAGCCCCTTGGACAGCTGGAAGAGCTCCTACAATGAGCAGTTCTTC	CSPLDSWKSSYNEQFF	TRBV29-1	TRBJ2-1
TGTGCCAGCAGCTTTACAGGCTCCGAGATCTTC	CASSFTGSEIF	TRBV5-4	TRBJ2-1
TGCAGTGCTAGAGATCTCCGAAACGGGACTAGCGGGGGGGCCGGGGAGACCCAGTACTTC	CSARDLRNGTSGGAGETQYF	TRBV20-1	TRBJ2-5
TGTGCCAGCAGCTTGGGCCGCTGCCTATACTTC	CASSLGRCLYF	TRBV5-6	TRBJ2-5
TGTGCCAGCAGCTTGAAGGACAGGGACAATCAGCCCCAGCATTTT	CASSLKDRDNQPQHF	TRBV5-8	TRBJ1-5
TGTGCCAGCAGTGGTGTGGTACAAGCTTTCTTT	CASSGVVQAFF	TRBV6-6	TRBJ1-1
TGTGCCACCAGTGACATAGTCCCTAGCGGGCGAATGCGGACAGATACGCAGTATTTT	CATSDIVPSGRMRTDTQYF	TRBV24-1	TRBJ2-3
TGTGCCAGCAGCCTAGCGGGGGAAAGAGATACGCAGTATTTT	CASSLAGERDTQYF	TRBV27	TRBJ2-3
TGTGCCAGCAGCGTAGAGTGTAGGGGCGCAGAGACCGGGGAGCTGTTTTTT	CASSVECRGAETGELFF	TRBV9	TRBJ2-2
TGCGCCATTAACAGGGGGCAGACGCAGTACTTC	CAINRGQTQYF	TRBV10-1	TRBJ2-7
TGTGCCAGCAGCCCCCGGGACAGCAATCAGCCCCAGCATTTT	CASSPRDSNQPQHF	TRBV7-4	TRBJ1-5
TGTGCCAGCACATGGACAGGGGCCCACTATGGCTACACCTTC	CASTWTGAHYGYTF	TRBV13	TRBJ1-2
TGTGCCAGCAGCTTCGTGGACGAGCAGTACTTC	CASSFVDEQYF	TRBV5-4	TRBJ2-7
TGTGCCAGCAGCCAAGTGGCTAGCTACGAGCAGTACTTC	CASSQVASYEQYF	TRBV4-2	TRBJ2-7
TGTGCCAGCAGCCCCCTCAGGTACGAGCAGTACTTC	CASSPLRYEQYF	TRBV7-3	TRBJ2-7
TGTGCCAGCAGCTTAGGTTTAGGCGGGTCCTACGAGCAGTACTTC	CASSLGLGGSYEQYF	TRBV7-4	TRBJ2-7
TGTGCCAGCAGCTGGAAGACTAGATACATCGGTTTCTACGAGCAGTACTTC	CASSWKTRYIGFYEQYF	TRBV7-2	TRBJ2-7
TGCGCCAGCAGCGGAGGACTAGCGGGGGGGCGGGAGCAGTTCTTC	CASSGGLAGGREQFF	TRBV10-1	TRBJ2-1
TGCGCCAGCGTCAGGGGGTATAAAAATGAAAAACTGTTTTTT	CASVRGYKNEKLFF	TRBV10-1	TRBJ1-4
TGTGCCAGCAGCCAAGATTTGCATCACAGGGGAAATGTCCAGCCCCAGCATTTT	CASSQDLHHRGNVQPQHF	TRBV14	TRBJ1-5
TGCGCCAGCAGCAAAGCTAGCGGGGCAACGGGCCAGACTCGTCTTACGCAGTATTTT	CASSKASGATGQTRLTQYF	TRBV5-1	TRBJ2-3
TGTGCCAGCAGCTTAGAAACCATCGGACAGCGGGAGTACAATGAGCAGTTCTTC	CASSLETIGQREYNEQFF	TRBV11-3	TRBJ2-1
TGTGCCAGCAGCTTAAGTGCGGGTGATTTGAGCCACGAGCAGTACTTC	CASSLSAGDLSHEQYF	TRBV7-3	TRBJ2-7
TGTGCCTGGAGTGGACAGGGAGGCTACACCTTC	CAWSGQGGYTF	TRBV30	TRBJ1-2
TGCGCCAGCAACCCGGAGCGCGGCACAGATACGCAGTATTTT	CASNPERGTDTQYF	TRBV5-1	TRBJ2-3
TGCGCCAGCAGCCAAGACGCACCCCTAGGGGTAAACGAGCAGTACTTC	CASSQDAPLGVNEQYF	TRBV4-1	TRBJ2-7
TGTGCCAGCAGCTTCCGGACAGGGAACACCGGGGAGCTGTTTTTT	CASSFRTGNTGELFF	TRBV11-2	TRBJ2-2
TGCAGTGCTAGAGATAGGGGGCCAGTGTATAGCAATCAGCCCCAGCATTTT	CSARDRGPVYSNQPQHF	TRBV20-1	TRBJ1-5
TGTGCCAGCACTCTATGCATTGAAGCTTTCTTT	CASTLCIEAFF	TRBV6-2	TRBJ1-1
TGTGCCAGCAGCAAAGCAACACGAACAGGTAAGTCCTACGAGCAGTACTTC	CASSKATRTGKSYEQYF	TRBV9	TRBJ2-7
TGTGCCAGCAGCAACCAGTGTCCGGGACAGGGGAGGCGCTATGGCTACACCTTC	CASSNQCPGQGRRYGYTF	TRBV7-9	TRBJ1-2
TGTGCCAGCAGCTTAGGACAGGTCAGTAACTATGGCTACACCTTC	CASSLGQVSNYGYTF	TRBV7-9	TRBJ1-2
TGTGCCAGCAGTGATGAAGGAACTCCCAGGCTCATGGTGGAGGATGAGCAGTTCTTC	CASSDEGTPRLMVEDEQFF	TRBV6-1	TRBJ2-1
TGTGCCAGCAGCTACCCCGGGACTAGCCTTTCAGATACGCAGTATTTT	CASSYPGTSLSDTQYF	TRBV7-3	TRBJ2-3
TGTGCCAGCAGCTTAGGCGGGGGCACTCTCAATGAAAAACTGTTTTTT	CASSLGGGTLNEKLFF	TRBV5-6	TRBJ1-4
TGTGCCAGCAGTTACGGAGGGGGCGTCGACACCGGGGAGCTGTTTTTT	CASSYGGGVDTGELFF	TRBV6-3	TRBJ2-2
TGTGCCAGCAGCCGGTTCCCGGGACTAGTTGGGTACGGGCGACAAGAGACCCAGTACTTC	CASSRFPGLVGYGRQETQYF	TRBV6-1	TRBJ2-5
TGTGCCAGCAGCGTGGACAGGAATAGCTCCTATAATTCACCCCTCCACTTT	CASSVDRNSSYNSPLHF	TRBV13	TRBJ1-6
TGTGCCAGCAGCATTCGGACGGGGCATCAGCCCCAGCATTTT	CASSIRTGHQPQHF	TRBV7-3	TRBJ1-5
TGCAGTGCTAGAGATCAGTACTACGAGCAGTACTTC	CSARDQYYEQYF	TRBV20-1	TRBJ2-7
TGTGCCAGCAGCCTCCGCGTTGGGGGGCTAGAGGGCTACACCTTC	CASSLRVGGLEGYTF	TRBV13	TRBJ1-2
TGTGCCAGCAGCCAAGTCGACAGGGATAGTTGCATTTCGAACACTGAAGCTTTCTTT	CASSQVDRDSCISNTEAFF	TRBV3-1	TRBJ1-1
TGTGCCAGCAGCCAAGGAACAGGGGTAGGCTACGAGCAGTACTTC	CASSQGTGVGYEQYF	TRBV13	TRBJ2-7
TGTGCCAGCAGGACTAGGGGTGAGACCCAGTACTTC	CASRTRGETQYF	TRBV5-6	TRBJ2-5
TGTGCCAGCAGTGAAGTGGGGGGGTTTTATGGCTACACCTTC	CASSEVGGFYGYTF	TRBV2	TRBJ1-2
TGTGCCAGCAGTGAAGCGCGACAGGGGAAAAATGGCTACACCTTC	CASSEARQGKNGYTF	TRBV6-1	TRBJ1-2
TGTGCCCTGACGAGGGAAAATGAGCAGTTCTTC	CALTRENEQFF	TRBV24-1	TRBJ2-1
TGTGCCAGCAGTGCATGTCGGACAGGGCTACTCCACTTT	CASSACRTGLLHF	TRBV12-4	TRBJ1-6
TGTGCCAGCAGGCTAGAGGATAACCCTGAGCAGTACTTC	CASRLEDNPEQYF	TRBV28	TRBJ2-7
TGTGCCAGCAGTTACTCCTGGGGACTTTTTACCACCTACAATGAGCAGTTCTTC	CASSYSWGLFTTYNEQFF	TRBV6-5	TRBJ2-1
TGCGCCAGCAGCTGGGGGACTAGCGGGTTCCGAGAGACCCAGTACTTC	CASSWGTSGFRETQYF	TRBV5-1	TRBJ2-5
TGTGCCAGCAGCTTAACGGTGGTCTACACCGGGGAGCTGTTTTTT	CASSLTVVYTGELFF	TRBV11-2	TRBJ2-2
TGTGCCAGCTCGGAGCGGGGGTACGAGCAGTACTTC	CASSERGYEQYF	TRBV6-4	TRBJ2-7
TGTGCAAACTCCGGGGGCGTAAGGCTAGCCAAAAACATTCAGTACTTC	CANSGGVRLAKNIQYF	TRBV24-1	TRBJ2-4
TGTGCCTGGAGTGTAGTTTCCCTTGGGGAACTCGGCAATTCACCCCTCCACTTT	CAWSVVSLGELGNSPLHF	TRBV30	TRBJ1-6
TGCGCCAGCAGCTTGATGACTAGACGAATGGTCATGTACAATGAGCAGTTCTTC	CASSLMTRRMVMYNEQFF	TRBV5-1	TRBJ2-1
TGTGCCAGCAGCAATACCCAGGTTTTTTATAATGAAAAACTGTTTTTT	CASSNTQVFYNEKLFF	TRBV11-3	TRBJ1-4
TGTGCCAGCAGTTTCTTACAGGGGGCCACAGATACGCAGTATTTT	CASSFLQGATDTQYF	TRBV12-3	TRBJ2-3
TGCGCCACCCTGCGGGAGCGGACACACGAGCAGTACTTC	CATLRERTHEQYF	TRBV5-1	TRBJ2-7
TGTGCCAGCAGTGAGCGGGGGAATAGCAATCAGCCCCAGCATTTT	CASSERGNSNQPQHF	TRBV12-3	TRBJ1-5
TGTGCCAGCAGCCAAGATGGTATCCTGGGCCCCTCCTACAATGAGCAGTTCTTC	CASSQDGILGPSYNEQFF	TRBV14	TRBJ2-1
TGCGCCAGCAGCATGCGCTCGGACTACCAAATCTACGAGCAGTACTTC	CASSMRSDYQIYEQYF	TRBV5-1	TRBJ2-7
TGTGCCACCAGCCTCGGGACAGGGGGCGGTAACGAGCAGTACTTC	CATSLGTGGGNEQYF	TRBV24-1	TRBJ2-7
TGTGCCAGCCCCTGGGTGCCGTGCGGGGAGCTGTTTTTT	CASPWVPCGELFF	TRBV11-2	TRBJ2-2
TGTGCCTGGAGTGTAGTCCGTCCCCCAAACACCTACGAGCAGTACTTC	CAWSVVRPPNTYEQYF	TRBV30	TRBJ2-7
TGTGCCAGCAGAGACAGGGGAATAACTGAAGCTTTCTTT	CASRDRGITEAFF	TRBV27	TRBJ1-1
TGTGCCAGCATTCCATGGGCTCCGAGGGTAGGCTACACCTTC	CASIPWAPRVGYTF	TRBV25-1	TRBJ1-2
TGCAAACTTAGCGGGGTCACAGATACGCAGTATTTT	CKLSGVTDTQYF	TRBV20-1	TRBJ2-3
TGTGCCTGGAGTAAACTGCCTCATTACTACGAGCAGTACTTC	CAWSKLPHYYEQYF	TRBV30	TRBJ2-7
TGCGCCAGCAGTGAACTAGGGGGCCCGAAAATCGTGTATTTT	CASSELGGPKIVYF	TRBV5-1	TRBJ2-3
TGTGCCAGCAGTGACCCAGGGGGCTATGGCCAGCCCCAGCATTTT	CASSDPGGYGQPQHF	TRBV2	TRBJ1-5
TGTGCCAGCAGCAGGCCAGGGGGCGTGAGCTCCTACAATGAGCAGTTCTTC	CASSRPGGVSSYNEQFF	TRBV13	TRBJ2-1
TGCGTCCTGAGGGGAGGAGGGGATTTCTTT	CVLRGGGDFF	TRBV20-1	TRBJ1-1
TGTGCCAGGGGACAGAAGAACGAGCAGTACTTC	CARGQKNEQYF	TRBV28	TRBJ2-7
TGTGCCTGGAGGGGGGCCGGGACACCGAACACTGAAGCTTTCTTT	CAWRGAGTPNTEAFF	TRBV30	TRBJ1-1
TGTGCCAGCAGCTTAATCAGCTACTACGAGCAGTACTTC	CASSLISYYEQYF	TRBV11-2	TRBJ2-7
TGTGCCAGCAGCTTCCGCAACCGGGACAGGGGGCAGTTCCGGAACACCGGGGAGCTGTTTTTT	CASSFRNRDRGQFRNTGELFF	TRBV7-9	TRBJ2-2
TGTGCCAGCAGGGGTAGGGGAGTTCACGAGCAGTACTTC	CASRGRGVHEQYF	TRBV6-5	TRBJ2-7
TGTGCCAGCACTGGTAGCGGCGAGCAGTACTTC	CASTGSGEQYF	TRBV28	TRBJ2-7
TGTGCCAGCAGCTTAGCCGGGGCGTGGCTAGCCAAAAACATTCAGTACTTC	CASSLAGAWLAKNIQYF	TRBV7-6	TRBJ2-4
TGTGCCAGCAGCGAAGACAGGGGGCCAACTGGAAACACCATATATTTT	CASSEDRGPTGNTIYF	TRBV7-2	TRBJ1-3
TGCAGTGCCGGGAGGGGGGGCCGGGCCGGGGAGCTGTTTTTT	CSAGRGGRAGELFF	TRBV20-1	TRBJ2-2
TGCGCCAGCAGCCGTAAAGAGAGGCCCCCGGGACGGGGGAGCCAAAGTGGAAACACCATATATTTT	CASSRKERPPGRGSQSGNTIYF	TRBV4-3	TRBJ1-3
TGTGCCAGCAGCCAGTTGACCGGGCGACCAGCCCAGCATTTT	CASSQLTGRPAQHF	TRBV27	TRBJ1-5
TGTGCCAGCATTCAAAAGGGGGCTTTCTTT	CASIQKGAFF	TRBV6-3	TRBJ1-1
TGTGCCAGCAGCTTGGCCTATCTGGGGGCATCTCAGCCCCAGCATTTT	CASSLAYLGASQPQHF	TRBV5-6	TRBJ1-5
TGTGCCAGCAGCTTGGCCCCCAGGAACACTGAAGCTTTCTTT	CASSLAPRNTEAFF	TRBV5-4	TRBJ1-1
TGTGCCAGCAGCCAAATAAGAAATCGGGGGCGGAAAACAGGAAACACCATATATTTT	CASSQIRNRGRKTGNTIYF	TRBV14	TRBJ1-3
TGTGCCAGCAGTTTAAGAGGACAGGGGAGAGCCTCCTACGAGCAGTACTTC	CASSLRGQGRASYEQYF	TRBV27	TRBJ2-7
TGCGCCAGTGGGACATACTCCTCTGGGGCCAACGTCCTGACTTTC	CASGTYSSGANVLTF	TRBV5-1	TRBJ2-6
TGCAGCGTTGAACCAGGATCCACCGACAGGGGGTCCTACGAGCAGTACTTC	CSVEPGSTDRGSYEQYF	TRBV29-1	TRBJ2-7
TGTGCCAGCAGCTTAGAGCGACTAGCGGGAGTACGGGAGGGGAGTGGCACAGATACGCAGTATTTT	CASSLERLAGVREGSGTDTQYF	TRBV7-8	TRBJ2-3
TGTGCCAGCAGTAACCCGGGACAGAGGTCGGAAAAACTGTTTTTT	CASSNPGQRSEKLFF	TRBV6-5	TRBJ1-4
TGTGCCAGCAGCCGACCACCGAACACTGAAGCTTTCTTT	CASSRPPNTEAFF	TRBV11-2	TRBJ1-1
TGTGCCAGCAGCTTCAGGGCCTTC	CASSFRAF	TRBV5-8	TRBJ1-2
TGTGCCAGCAGTTACCTCTGGTCTCGAGTGGGCACTGAAGCTTTCTTT	CASSYLWSRVGTEAFF	TRBV6-5	TRBJ1-1
TGTGCCAGCAGAGGTCAAGGGGACTTC	CASRGQGDF	TRBV12-4	TRBJ2-5
TGCGCCAGGTTGGGGGGAGCCTACAATGAGCAGTTCTTC	CARLGGAYNEQFF	TRBV4-1	TRBJ2-1
TGCGCCAGCAGCTTTACCAAACTGTTTTTT	CASSFTKLFF	TRBV5-1	TRBJ1-4
TGTGCCAGCAGTCTAAAGACGGGTTCCTCTAATGAAAAACTGTTTTTT	CASSLKTGSSNEKLFF	TRBV27	TRBJ1-4
TGCGCCAGTGCGGAAGGACAGGGAGAGCAGTTCTTC	CASAEGQGEQFF	TRBV10-1	TRBJ2-1
TGCGCCAGCAGCCAAGATTCTCTTCAAAGGAGGTATAGCAATCAGCCCCAGCATTTT	CASSQDSLQRRYSNQPQHF	TRBV4-1	TRBJ1-5
TGTGCCACCAGACCTAGCTACACCGGGGAGCTGTTTTTT	CATRPSYTGELFF	TRBV24-1	TRBJ2-2
TGTGCCAGCAGCCACACCCAACTAGAAACGGCAGATACGCAGTATTTT	CASSHTQLETADTQYF	TRBV3-1	TRBJ2-3
TGTGCCAGCAGCCCCAAGCAGCGGGACCAAGAGACCCAGTACTTC	CASSPKQRDQETQYF	TRBV6-1	TRBJ2-5
TGTGCCAGCAGTAAGAGGGGCACCCAAGTAGTGAACACTGAAGCTTTCTTT	CASSKRGTQVVNTEAFF	TRBV27	TRBJ1-1
TGTGCCAGCAGCTTCGGGCGGGACAGGGGTGGCACTGAATCCCGGGGAAACACCATATATTTT	CASSFGRDRGGTESRGNTIYF	TRBV7-9	TRBJ1-3
TGTGCCAGCAGCTTACTACAAACACCGGGACGCGTTCGAGATACGCAGTATTTT	CASSLLQTPGRVRDTQYF	TRBV7-2	TRBJ2-3
TGCAGTGCTAGCTTCCGGGACAGGCTTGAAGGGGAAGCTTTCTTT	CSASFRDRLEGEAFF	TRBV20-1	TRBJ1-1
TGTGCCATCAGTGAGGTGGGACTAGCGGGCGGGGAGCTGTTTTTT	CAISEVGLAGGELFF	TRBV10-3	TRBJ2-2
TGTGCCAGCAGGATAAACGACGGCTACAATGAGCAGTTCTTC	CASRINDGYNEQFF	TRBV27	TRBJ2-1
TGTGCCAGCAGCAGGAGCTCCGGGACCGCTTTCTTT	CASSRSSGTAFF	TRBV7-4	TRBJ1-1
TGCAGTGCATCTTGGGGGCTCGAGCAGTACTTC	CSASWGLEQYF	TRBV20-1	TRBJ2-7
TGTGCCAGCAGCTTTACGGACAGGGAGCTGCACTCTGGAAACACCATATATTTT	CASSFTDRELHSGNTIYF	TRBV7-2	TRBJ1-3
TGCGCCAGCAGCCAAGCTAGGGTCGACTCGGATGGCTACACCTTC	CASSQARVDSDGYTF	TRBV4-1	TRBJ1-2
TGCGCCAGCAGCTTAACAGAGCCGGGAGAGGGACTCCAAGAGACCCAGTACTTC	CASSLTEPGEGLQETQYF	TRBV5-1	TRBJ2-5
TGTGCCAGTAGTATAGCCGGACAGTGTCCCTACGAGCAGTACTTC	CASSIAGQCPYEQYF	TRBV19	TRBJ2-7
TGTGCCAGCAGTTTGTCAGTTTACGGAAACACCATATATTTT	CASSLSVYGNTIYF	TRBV6-1	TRBJ1-3
TGCAGTGCGCTGGCAAATCCGGGACACAATGGCTACACCTTC	CSALANPGHNGYTF	TRBV20-1	TRBJ1-2
TGTGCCAGCAGCCGGACAGGGCATCCAGAGACCCAGTACTTC	CASSRTGHPETQYF	TRBV7-9	TRBJ2-5
TGTGCCAGCAGAAGCGGGATGTTCTACGAGCAGTACTTC	CASRSGMFYEQYF	TRBV6-1	TRBJ2-7
TGCGCCAGCAGCCAAGACCGTAATTCAGATACGCAGTATTTT	CASSQDRNSDTQYF	TRBV4-1	TRBJ2-3
TGTGCCAGCAGGAGCGGAAAGTATAATTCACCCCTCCACTTT	CASRSGKYNSPLHF	TRBV28	TRBJ1-6
TGTGCCAGCAGTTACTCGAGGGGACAAGAGACCCAGTACTTC	CASSYSRGQETQYF	TRBV6-5	TRBJ2-5
TGTGCCAGGGGGGGGGGGCTACCTAATGGCTACACCTTC	CARGGGLPNGYTF	TRBV6-4	TRBJ1-2
TGTGCCAGCAGTTCAGAGGGGGGGTATGCTTTCTTT	CASSSEGGYAFF	TRBV6-8	TRBJ1-1
TGTGCCAGCAAAACCCGTAACGGGGTAAATGAAGCTTTCTTT	CASKTRNGVNEAFF	TRBV2	TRBJ1-1
TGTGCCAGCAGTGTAATCCGGCGATGCAAAAAACCCTACAATGAGCAGTTCTTC	CASSVIRRCKKPYNEQFF	TRBV2	TRBJ2-1
TGTGCCAGCAGCTTAGCAAGGGACAGGACGGACACAGATACGCAGTATTTT	CASSLARDRTDTDTQYF	TRBV7-9	TRBJ2-3
TGCGCCAGCAGCTTGAGGTTCAGGGGAGAGCAGTACTTC	CASSLRFRGEQYF	TRBV5-1	TRBJ2-7
TGTGCCAGCATTTGCGGGGTGGAGCAGTACTTC	CASICGVEQYF	TRBV2	TRBJ2-7
TGTGCCAGCAGTCCAGGCGGGACAGGGGAAAAATCCTACAATGAGCAGTTCTTC	CASSPGGTGEKSYNEQFF	TRBV27	TRBJ2-1
TGTGCCGGAGGACAGGGGTCTCCCTACGAGCAGTACTTC	CAGGQGSPYEQYF	TRBV19	TRBJ2-7
TGTGCCAGCAGCTTAGAAGGGGCCTACGAGCAGTACTTC	CASSLEGAYEQYF	TRBV7-2	TRBJ2-7
TGTGCCAGTAGTCCGGCGGCAAGCCGGGACAGCTCCTACGAGCAGTACTTC	CASSPAASRDSSYEQYF	TRBV19	TRBJ2-7
TGTGCCAGCTCACCACCGAAGAAAACCGTTAGGAGGAATCAGCCCCAGCATTTT	CASSPPKKTVRRNQPQHF	TRBV18	TRBJ1-5
TGTGCCACCAGTTCCATGACGGGACTTGTGAACACCGGGGAGCTGTTTTTT	CATSSMTGLVNTGELFF	TRBV24-1	TRBJ2-2
TGTGCCAGCAGTTACTCGAACCCCGAGGGGGACAGGGGAAACTCTTTGAAGCACGAGCAGTACTTC	CASSYSNPEGDRGNSLKHEQYF	TRBV6-2	TRBJ2-7
TGTGCTTCGGCCCGCTATGGCTACACCTTC	CASARYGYTF	TRBV6-5	TRBJ1-2
TGTGCCAGCCCGCCGGGGGCCGAAAAACTGTTTTTT	CASPPGAEKLFF	TRBV6-4	TRBJ1-4
TGTGCCAGCAGCGGAGATTGGGACATAGGGAACTATGGCTACACCTTC	CASSGDWDIGNYGYTF	TRBV7-3	TRBJ1-2
TGTGCCAGCAGCTTGATGGGCAGACAAAGGTACGAGCAGTACTTC	CASSLMGRQRYEQYF	TRBV5-8	TRBJ2-7
TGTGCCAGCAGTTTACCACAGGGGGTGGCCTCAGCAGATACGCAGTATTTT	CASSLPQGVASADTQYF	TRBV27	TRBJ2-3
TGTGCCACCAGTGATTTACCTCCGGGACAGGGGTCACTCTACGAGCAGTACTTC	CATSDLPPGQGSLYEQYF	TRBV24-1	TRBJ2-7
TGTGCCACCAGTGAAGGGCAGGGAACTAATGAAAAACTGTTTTTT	CATSEGQGTNEKLFF	TRBV24-1	TRBJ1-4
TGTGCCAGCTCACCAGGGCTCGAGAACGAGCAGTACTTC	CASSPGLENEQYF	TRBV18	TRBJ2-7
TGTGCCAGCAGCCGTCGGTGGGGGGCCTCCTACGAGCAGTACTTC	CASSRRWGASYEQYF	TRBV7-9	TRBJ2-7
TGTGCCAGCAGCCTCCGCCCTACAACCAGGGGAAGGGCCGAAAGGGCCGGGGAGCTGTTTTTT	CASSLRPTTRGRAERAGELFF	TRBV3-1	TRBJ2-2
TGTGCCAGCAGTGCCTGGGGGATTAATGGGGAGTCCATATATTTT	CASSAWGINGESIYF	TRBV25-1	TRBJ1-3
TGTGCCACCAGCAGGGCGAGGGACAGGGACAATGAGCAGTTCTTC	CATSRARDRDNEQFF	TRBV15	TRBJ2-1
TGTGCCAGCAGCGGGGGACAGGGCGCCTACGAGCAGTACTTC	CASSGGQGAYEQYF	TRBV7-3	TRBJ2-7
TGTGCCAGCACCATTCTAGGAGGTTACGAGCAGTACTTC	CASTILGGYEQYF	TRBV6-4	TRBJ2-7
TGCGCCAGCAGCTTGCCAAAAGGGAGCACAGATACGCAGTATTTT	CASSLPKGSTDTQYF	TRBV5-1	TRBJ2-3
TGCGCCAGCAGGTCCCGTACTCAGATCTTCTACGAGCAGTACTTC	CASRSRTQIFYEQYF	TRBV10-1	TRBJ2-7
TGTGCCAGCAGTTTAAATCGGCGGGACAGAGGCTTTGGTAACACCATATATTTT	CASSLNRRDRGFGNTIYF	TRBV12-3	TRBJ1-3
TGCAGTGCTAGCCCGGGGAGGGGGTACAATCAGCCCCAGCATTTT	CSASPGRGYNQPQHF	TRBV20-1	TRBJ1-5
TGTGCCAGCAATGATACTAGCACAGATACGCAGTATTTT	CASNDTSTDTQYF	TRBV7-9	TRBJ2-3
TGCGGGGCTGGGTACGATGAAGCTTTCTTT	CGAGYDEAFF	TRBV20-1	TRBJ1-1
TGTGCCAGCAGCATGCAGGGACGAAACACAGATACGCAGTATTTT	CASSMQGRNTDTQYF	TRBV11-3	TRBJ2-3
TGTGCCACCAGTGAACCCGGGACAGGGGCAAGGAACACTGAAGCTTTCTTT	CATSEPGTGARNTEAFF	TRBV24-1	TRBJ1-1
TGTGCCAGCAGCCCGGCGGCCAAAAACATTCAGTACTTC	CASSPAAKNIQYF	TRBV7-3	TRBJ2-4
TGTGCCAGCAGACCACAGGTTCAGGCTAATGAAAAACTGTTTTTT	CASRPQVQANEKLFF	TRBV2	TRBJ1-4
TGTGCCAGCAGCACCGGACTAGCGGGGGGCATTCAGTACTTC	CASSTGLAGGIQYF	TRBV11-3	TRBJ2-4
TGCAGTGCTAGGCGACAGGCACGGTACGAGCAGTACTTC	CSARRQARYEQYF	TRBV20-1	TRBJ2-7
TGTGCCAGCAGTTTCCGTCAACCTCCAACAGGGTTAGGCGACAGCAATCAGCCCCAGCATTTT	CASSFRQPPTGLGDSNQPQHF	TRBV27	TRBJ1-5
TGTGCCAGCAGCCAGATTCGGGGGGCTTTTGCAACTAATGAAAAACTGTTTTTT	CASSQIRGAFATNEKLFF	TRBV3-1	TRBJ1-4
TGTGCCAGCCCCGGGGAAGATAGGAGCAATCAGCCCCAGCATTTT	CASPGEDRSNQPQHF	TRBV6-4	TRBJ1-5
TGTGCCAGCAGTGAAGCCAGACAGGGGACTGAAGCTTTCTTT	CASSEARQGTEAFF	TRBV25-1	TRBJ1-1
TGTGCCAGCTGCAATGGTGCCTACGAGCAGTACTTC	CASCNGAYEQYF	TRBV5-6	TRBJ2-7
TGCGCCAGCAGTGAGAGGAGGAGTCAAGAGACCCAGTACTTC	CASSERRSQETQYF	TRBV10-2	TRBJ2-5
TGTGCCAGCAGTTTATCGGCCATGGGAAGACAGGTTCCCCACGAGCAGTACTTC	CASSLSAMGRQVPHEQYF	TRBV27	TRBJ2-7
TGCGCCAGCAGCTGTGCTAGCGGGGGGTACAATGAGCAGTTCTTC	CASSCASGGYNEQFF	TRBV5-1	TRBJ2-1
TGTGCCAGCAGTTACTCGAAACCCCCCGAAGGGAGCCTCTTAAAAGAGACCCAGTACTTC	CASSYSKPPEGSLLKETQYF	TRBV6-5	TRBJ2-5
TGCAGATTTCCTATGGGGCTAGAGACCCAGTACTTC	CRFPMGLETQYF	TRBV20-1	TRBJ2-5
TGTGCCAGCAGCGGTGAGGACAGGTTTCATGGCTACACCTTC	CASSGEDRFHGYTF	TRBV27	TRBJ1-2
TGTGCCAGCAGGGCGGGTGTCTGCCTCTACAATGAGCAGTTCTTC	CASRAGVCLYNEQFF	TRBV2	TRBJ2-1
TGCGCCAGCAGTGAAAAGACCTATGGCTACACCTTC	CASSEKTYGYTF	TRBV10-1	TRBJ1-2
TGTGCCAGCAGTGACTCGACCGGACAGGGGGCTATGACGAGGTGGGCCTACGAGCAGTACTTC	CASSDSTGQGAMTRWAYEQYF	TRBV6-4	TRBJ2-7
TGTGCCAGCAGCCGACAGGGGCCCCGGGCCTACGAGCAGTACTTC	CASSRQGPRAYEQYF	TRBV12-3	TRBJ2-7
TGTGCCTGGATCGAGGACAGGGTACATGAAGCTTTCTTT	CAWIEDRVHEAFF	TRBV30	TRBJ1-1
TGTGCCAGCAGGGAGCGGACAGGGTTGACAGATACGCAGTATTTT	CASRERTGLTDTQYF	TRBV6-5	TRBJ2-3
TGTGCCAGCAGTTACCAGGGACAGGGACGGTACGAGCAGTACTTC	CASSYQGQGRYEQYF	TRBV6-5	TRBJ2-7
TGTGCCAGTAGTATAGATGACAGGAGACAGGAGAACACTGAAGCTTTCTTT	CASSIDDRRQENTEAFF	TRBV19	TRBJ1-1
TGCGCCAGCAGCGAAAGAGTTGACGGCCGACACGAGCAGTACTTC	CASSERVDGRHEQYF	TRBV4-1	TRBJ2-7
TGCGCAGCGGGATCCGGCCACACCGGGGAGCTGTTTTTT	CAAGSGHTGELFF	TRBV5-1	TRBJ2-2
TGTGCCAGCAGCGAAGGGGGCCCATCTACTGAAGCTTTCTTT	CASSEGGPSTEAFF	TRBV11-3	TRBJ1-1
TGTGCCAGCGCCCGAGGCTTTACCACTGAAGCTTTCTTT	CASARGFTTEAFF	TRBV12-3	TRBJ1-1
TGTGCCACCGAGATGGTGACGCAGTATTTT	CATEMVTQYF	TRBV10-3	TRBJ2-3
TGTGCCAGCAGTTTCCCTCTAGCGGGGATTACCACAGATACGCAGTATTTT	CASSFPLAGITTDTQYF	TRBV12-4	TRBJ2-3
TGTGCCAGCAATGGAACGCCCAATGAGCAGTTCTTC	CASNGTPNEQFF	TRBV6-5	TRBJ2-1
TGCAGTGCACCCCAGGGCCATTATAGCAATCAGCCCCAGCATTTT	CSAPQGHYSNQPQHF	TRBV20-1	TRBJ1-5
TGTGCCAGCAGCCCGTTGTCACCGATATTTACGGGACTAGAAACGGCTAGCACAGATACGCAGTATTTT	CASSPLSPIFTGLETASTDTQYF	TRBV27	TRBJ2-3
TGCGCCAGCAGCTTGCCGGTAACACGCCCTAGCACAGATACGCAGTATTTT	CASSLPVTRPSTDTQYF	TRBV5-1	TRBJ2-3
TGCAGTGCTGGGTGGACTAGTTTCAATGAGCAGTTCTTC	CSAGWTSFNEQFF	TRBV20-1	TRBJ2-1
TGTGCCAGCAGTTACCCGTCTGAATACGAGCAGTACTTC	CASSYPSEYEQYF	TRBV6-5	TRBJ2-7
TGCGCCAGCAGAAGGACAGGGGGATCTAATCAGCCCCAGCATTTT	CASRRTGGSNQPQHF	TRBV4-1	TRBJ1-5
TGTGCCAGCATAGTAGGGCGGTCCTACGAGCAGTACTTC	CASIVGRSYEQYF	TRBV27	TRBJ2-7
TGTGCCAGCAGGACAGGGGGTGGAAACACCATATATTTT	CASRTGGGNTIYF	TRBV27	TRBJ1-3
TGTGCCAGCAGCTTAGCCCTTCCCCTGGGGGATGATGAGCAGTTCTTC	CASSLALPLGDDEQFF	TRBV7-9	TRBJ2-1
TGTGCCAGCAGTTACAGACAGGGCGGATCCCGGGTTCAGCCCCAGCATTTT	CASSYRQGGSRVQPQHF	TRBV6-6	TRBJ1-5
TGTGCCAGCAGCGCCTACCACCGGGACAGGGGTTATGGCTACACCTTC	CASSAYHRDRGYGYTF	TRBV13	TRBJ1-2
TGTGCCAGCAGGGGACAGGGGGCCACTGAGCAGTTCTTC	CASRGQGATEQFF	TRBV5-8	TRBJ2-1
TGTGCCAGCTCTGCGGGACAGGGGGCGGGGCGTGCTTTCTTT	CASSAGQGAGRAFF	TRBV27	TRBJ1-1
TGTGCCATCAGTGATCCCCGCCGGACAGCCGTCCGGAATGAAAAACTGTTTTTT	CAISDPRRTAVRNEKLFF	TRBV10-3	TRBJ1-4
TGTGCCAGCAGCCCTCTTACTACTAATGAAAAACTGTTTTTT	CASSPLTTNEKLFF	TRBV3-1	TRBJ1-4
TGCAGTGCTAGTGCAGCTAACACCGGGGAGCTGTTTTTT	CSASAANTGELFF	TRBV20-1	TRBJ2-2
TGTGCCAGCAGCCAAGACGGAACTGAATATGAGCAGTTCTTC	CASSQDGTEYEQFF	TRBV14	TRBJ2-1
TGTGCCAGCAGCTTGCAGACATCACCCCTCCACTTT	CASSLQTSPLHF	TRBV5-6	TRBJ1-6
TGCGCCAGCAGCCGTGTACAGTTACCCTACGAGCAGTACTTC	CASSRVQLPYEQYF	TRBV4-1	TRBJ2-7
TGTGCCAGTAATAGTGGGCCGATGTCTAACTACGAGCAGTACTTC	CASNSGPMSNYEQYF	TRBV19	TRBJ2-7
TGTGCCAGCACATCGGGAGCAGGGCGGGGGTATGCTTTCTTT	CASTSGAGRGYAFF	TRBV27	TRBJ1-1
TGTGCCAGCAGCCAAGATCGTGGGACAGGGGGTCACGAGCAGTACTTC	CASSQDRGTGGHEQYF	TRBV3-1	TRBJ2-7
TGTGCCAGCAGCCGGACTCCAGAGGCCTACGAGCAGTACTTC	CASSRTPEAYEQYF	TRBV7-4	TRBJ2-7
TGTGCCTGGAGTGTACAGTCCCGGGGGTGGTTGGGGGCCTGGTCCAATGAAAAACTGTTTTTT	CAWSVQSRGWLGAWSNEKLFF	TRBV30	TRBJ1-4
TGCGCCAGCAGCCTACCGGGACTAGCGGGAGGGATAGTCTCCTACGAGCAGTACTTC	CASSLPGLAGGIVSYEQYF	TRBV4-1	TRBJ2-7
TGTGCCAGCAACAGAGCGGGAGAATGGGAAAAACTGTTTTTT	CASNRAGEWEKLFF	TRBV9	TRBJ1-4
TGCGCCAGCAGCTTGGGTGAAACGCGGTGCAATGAGCAGTTCTTC	CASSLGETRCNEQFF	TRBV5-1	TRBJ2-1
TGTGCCAGCAGCCCCTTAAGGAGGACCTCCTACAATGAGCAGTTCTTC	CASSPLRRTSYNEQFF	TRBV13	TRBJ2-1
TGTGCCATCAGTGAAAACTCCCTAGATCAGAGACCAGAGACCCAGTACTTC	CAISENSLDQRPETQYF	TRBV10-3	TRBJ2-5
TGTGCCAGCAGCTCGGCTCAGGGACACCCCACGGACTCTGGAAACACCATATATTTT	CASSSAQGHPTDSGNTIYF	TRBV7-2	TRBJ1-3
TGTGCCACCATTGACACTGAAGCTTTCTTT	CATIDTEAFF	TRBV5-8	TRBJ1-1
TGTGCCAGCAGCTCCAGGACAGGGGGCTGTCGGAGCTCCTATAATTCACCCCTCCACTTT	CASSSRTGGCRSSYNSPLHF	TRBV6-6	TRBJ1-6
TGTGCCAGCAGCGGACGGGACGGCACAGATACGCAGTATTTT	CASSGRDGTDTQYF	TRBV13	TRBJ2-3
TGTGCCTGGAACACAAACCACGGTGTCAGCTCCTACGAGCAGTACTTC	CAWNTNHGVSSYEQYF	TRBV30	TRBJ2-7
TGTGCCAAAAAAGCTCACACTGCAAAGGGGCAGCCCCAGCATTTT	CAKKAHTAKGQPQHF	TRBV10-3	TRBJ1-5
TGTGCCAGCAGCTCAGGAGACCCGGCAGGGGGCAAGCCCCAGCCCCAGCATTTT	CASSSGDPAGGKPQPQHF	TRBV7-3	TRBJ1-5
TGCGCCAGGGGGTTGGGACAGGGTAGCGGGAGTGATGAGCAGTTCTTC	CARGLGQGSGSDEQFF	TRBV10-1	TRBJ2-1
TGTGCCAGCAACAGGGCAATGAATAGCAATCAGCCCCAGCATTTT	CASNRAMNSNQPQHF	TRBV11-3	TRBJ1-5
TGTGCCAGCAGTGGTTTCAGACAGGCTGGGGGCGAGCAGTACTTC	CASSGFRQAGGEQYF	TRBV6-1	TRBJ2-7
TGTGCCAGCAGCTCCCTATGGGGAGCCTACGAGCAGTACTTC	CASSSLWGAYEQYF	TRBV9	TRBJ2-7
TGTGCCAGTAGTATAGATCCCCATTGGGGGCGCGGAAAGCAGTACTTC	CASSIDPHWGRGKQYF	TRBV19	TRBJ2-7
TGTGCCAGCTCACCACAAGGGGTTCCGAATGAAAAACTGTTTTTT	CASSPQGVPNEKLFF	TRBV18	TRBJ1-4
TGTGCCAGTAGTCCCTCATTTGGAGGAGAGACCCAGTACTTC	CASSPSFGGETQYF	TRBV19	TRBJ2-5
TGTGCCAGCAGCTTATCCGCCCACAGGGGCGATCAGCCCCAGCATTTT	CASSLSAHRGDQPQHF	TRBV7-3	TRBJ1-5
TGTGCCAGTAGTAGCGGGACAGTGGGAGCTTTCTTT	CASSSGTVGAFF	TRBV19	TRBJ1-1
TGTGCCAGCAGCGTAGACAGGGGGCTTGCATATGGCTACACCTTC	CASSVDRGLAYGYTF	TRBV9	TRBJ1-2
TGTGCCAGCAGTTCACGCCGACAGATACTCCCGGGAAGGAACACTGAAGCTTTCTTT	CASSSRRQILPGRNTEAFF	TRBV27	TRBJ1-1
TGTGCCAAGGGGGGGTATAGCAATCAGCCCCAGCATTTT	CAKGGYSNQPQHF	TRBV7-8	TRBJ1-5
TGTGCCTGGAGAATTGGGCGGGCGACTGAAGCTTTCTTT	CAWRIGRATEAFF	TRBV30	TRBJ1-1
TGTGCCAGCAGCTTTCTCGAGGGGGCCCTGTATTCCCAATCCTACGAGCAGTACTTC	CASSFLEGALYSQSYEQYF	TRBV9	TRBJ2-7
TGTGCCAGCAGCCTACTCTCTGGGGCCAACGTCCTGACTTTC	CASSLLSGANVLTF	TRBV7-2	TRBJ2-6
TGTGCCAGCAAAGTCCCTCCGCAGGGGGACACTGAAGCTTTCTTT	CASKVPPQGDTEAFF	TRBV28	TRBJ1-1
TGCGCCAGCCCCGGGGGGACCGTCAATCAGCCCCAGCATTTT	CASPGGTVNQPQHF	TRBV5-1	TRBJ1-5
TGCGCCAGCAGCTTGGTACAGGGGGACTCCTACGAGCAGTACTTC	CASSLVQGDSYEQYF	TRBV5-1	TRBJ2-7
TGTGCCAGCAGTGAAGGCAGGGATAATGAAAAACTGTTTTTT	CASSEGRDNEKLFF	TRBV6-1	TRBJ1-4
TGTGCCAGCAGTGACGGGGGGGACAGGAATGAAAAACTGTTTTTT	CASSDGGDRNEKLFF	TRBV6-4	TRBJ1-4
TGTGCCAGCAGTTTAAGGGTAGCGGGAGTGGCCTACGAGCAGTACTTC	CASSLRVAGVAYEQYF	TRBV12-4	TRBJ2-7
TGTGCCAGCAGCTTGGGCAGACAACCCGATCAGCCCCAGCATTTT	CASSLGRQPDQPQHF	TRBV5-6	TRBJ1-5
TGTGCCAGCAGCCAAGTCCGCCCTCCCCGGTTGTGCAAAAACATTCAGTACTTC	CASSQVRPPRLCKNIQYF	TRBV3-1	TRBJ2-4
TGTGCCACCAGTGCCCCTCAGGGGGCGTGGGGCTACACCTTC	CATSAPQGAWGYTF	TRBV24-1	TRBJ1-2
TGTGCCAGCAGAGAATCAGGGGGCGGTTCCGGGGAGCTGTTTTTT	CASRESGGGSGELFF	TRBV6-2	TRBJ2-2
TGTGCCAGCAGTGGGGGGGCCGGGGCTTTCTTT	CASSGGAGAFF	TRBV27	TRBJ1-1
TGTGCCAGCAGCGACTATAGCACCGGGGAGCTGTTTTTT	CASSDYSTGELFF	TRBV5-6	TRBJ2-2
TGCGCCAGCAGGGGCGCGGGACAGGAACTGGGAGCCTACAATGAGCAGTTCTTC	CASRGAGQELGAYNEQFF	TRBV10-1	TRBJ2-1
TGCGCCAGCAGCCAAGATCAGGGGGCTGAAGCTTTCTTT	CASSQDQGAEAFF	TRBV4-1	TRBJ1-1
TGTGCCAGCGCTGGGGGTAGCAATCAGCCCCAGCATTTT	CASAGGSNQPQHF	TRBV6-1	TRBJ1-5
TGCAGTGCTGGCCCGGACAGGGCCGCTTATCCCGAGCAGTACTTC	CSAGPDRAAYPEQYF	TRBV20-1	TRBJ2-7
TGCAGTGCTAGACGTACAACCCGGGACAGGGGGTCCCTCCACTTT	CSARRTTRDRGSLHF	TRBV20-1	TRBJ1-6
TGCAGCGTTGAACGGTTAGCTAGCGGCCTACATGGTAGCACAGATACGCAGTATTTT	CSVERLASGLHGSTDTQYF	TRBV29-1	TRBJ2-3
TGTGCCAGCAGCCGGAACGGGGTCGGGGCAGAGACCCAGTACTTC	CASSRNGVGAETQYF	TRBV4-2	TRBJ2-5
TGCGCCAGCAGCCAACAAACCCGGGTTTCTGAAGCTTTCTTT	CASSQQTRVSEAFF	TRBV4-3	TRBJ1-1
TGTGCCAGCAGCTTAGGGCCTTTCGTTACGGTGACAGCACTCCACTTT	CASSLGPFVTVTALHF	TRBV7-9	TRBJ1-6
TGTGCCAGCAGCCAACCAGCAGGGGACCCCTATGGCTACACCTTC	CASSQPAGDPYGYTF	TRBV3-1	TRBJ1-2
TGCGCCAGCAGCCACCCCAACAGGTGTGAACGCTACGAGCAGTACTTC	CASSHPNRCERYEQYF	TRBV4-1	TRBJ2-7
TGTGCCAGCAGCAATGAGGAAATTTGGGATAACACTGAAGCTTTCTTT	CASSNEEIWDNTEAFF	TRBV7-2	TRBJ1-1
TGTGCCACCAGGGACACCGAGCAGTACTTC	CATRDTEQYF	TRBV24-1	TRBJ2-7
TGTGCCAGCAGATACTTAGGCCGTAAGGAGCAGTACTTC	CASRYLGRKEQYF	TRBV7-2	TRBJ2-7
TGTGCCAGCAGCTTAGGGGCGCAGGGTCCCCATTTTAGCACAGATACGCAGTATTTT	CASSLGAQGPHFSTDTQYF	TRBV11-2	TRBJ2-3
TGTGCCAGTGGCTACACCTTC	CASGYTF	TRBV19	TRBJ1-2
TGTGCCAGCAGCCAAGAATCTAGCGGGCACGGGGAGCTGTTTTTT	CASSQESSGHGELFF	TRBV14	TRBJ2-2
TGTGCCAGCAGTAAGGGGGGGGCCGGGCCCTCTCAAGAAGAGACCCAGTACTTC	CASSKGGAGPSQEETQYF	TRBV6-2	TRBJ2-5
TGCGCCAAGGGGAAGAACACCATATATTTT	CAKGKNTIYF	TRBV10-1	TRBJ1-3
TGTGCCAGCAGTGGAGGGACTCCCGGGAATCAGCCCCAGCATTTT	CASSGGTPGNQPQHF	TRBV2	TRBJ1-5
TGCACTTGGGACGACCCCGGGGAGCTGTTTTTT	CTWDDPGELFF	TRBV20-1	TRBJ2-2
TGTGCCAGCATCCTCGATACGGCCTACGAGCAGTACTTC	CASILDTAYEQYF	TRBV6-6	TRBJ2-7
TGTGCCAGCAAACCCAGCTGGACGGGCCTAAAACTGTTTTTT	CASKPSWTGLKLFF	TRBV6-6	TRBJ1-4
TGCAGTGCTAGGAAAACGACAGGGGAACCGAACACCGGGGAGCTGTTTTTT	CSARKTTGEPNTGELFF	TRBV20-1	TRBJ2-2
TGTGCCAGCAGCTACGGGCAAGGCAATGAGCAGTTCTTC	CASSYGQGNEQFF	TRBV7-3	TRBJ2-1
TGTGCCAGCAGCTTACTTGGTTCGAGGGCCGGGCAGTTCTTC	CASSLLGSRAGQFF	TRBV7-9	TRBJ2-1
TGCAGTGCACTCCCGCGGGACCCCAGCTCCTACGAGCAGTACTTC	CSALPRDPSSYEQYF	TRBV20-1	TRBJ2-7
TGTGCCTGGTCGGGGGGGCATTACGAGCAGTACTTC	CAWSGGHYEQYF	TRBV30	TRBJ2-7
TGTGCCAGCAGCCAAGATGTTTTAAGGGGCTGGGATACGCAGTATTTT	CASSQDVLRGWDTQYF	TRBV3-1	TRBJ2-3
TGTGCCAGCAGGTATCTGCTAGCGGACCAGACCCAGTACTTC	CASRYLLADQTQYF	TRBV4-2	TRBJ2-5
TGTGCCAGCAGCTTCACCCCCCAGGACTCCTACGAGCAGTACTTC	CASSFTPQDSYEQYF	TRBV13	TRBJ2-7
TGTGCCAGCAGCTTGGGCAGTAGAGACTACGAGCAGTACTTC	CASSLGSRDYEQYF	TRBV7-9	TRBJ2-7
TGTGCCAGCAGCGTACTCCCGGCAAGCGAGCAGTACTTC	CASSVLPASEQYF	TRBV9	TRBJ2-7
TGTGCCAGCAGCCAAGGGGGTATGGATCAGCCCCAGCATTTT	CASSQGGMDQPQHF	TRBV3-1	TRBJ1-5
TGTGCCAGCAGTCCCGGGGACAGGGTTCACGGGGCCAACGTCCTGACTTTC	CASSPGDRVHGANVLTF	TRBV14	TRBJ2-6
TGCGCCAGCAGTGAGTGGGCGAGAACACTAAGTAGACGGGGTGAAGCTTTCTTT	CASSEWARTLSRRGEAFF	TRBV10-1	TRBJ1-1
TGTGCCAGCAGTTTATGGCCAAGGAGGCGCAATCAGCCCCAGCATTTT	CASSLWPRRRNQPQHF	TRBV27	TRBJ1-5
TGTGCCAGCAGCCAAGTCCCGGACAGGGGGGCCTACAATGAGCAGTTCTTC	CASSQVPDRGAYNEQFF	TRBV3-1	TRBJ2-1
TGTGCCAGCAGTTCCATATCCAGGGGATTCACTGAAGCTTTCTTT	CASSSISRGFTEAFF	TRBV6-3	TRBJ1-1
TGCAGTGCTTCTAGCACTGAGCAGTTCTTC	CSASSTEQFF	TRBV20-1	TRBJ2-1
TGTGCCAGCAGCTGTACTGAGAAAAACTCCTACAATGAGCAGTTCTTC	CASSCTEKNSYNEQFF	TRBV13	TRBJ2-1
TGCGCCAGCAGCGGAGGAAGGGGGGAGTCAGATACGCAGTATTTT	CASSGGRGESDTQYF	TRBV5-1	TRBJ2-3
TGTGCCAGCAGTTGTGACCAACCTCCGGGGACCACAACTAATGAAAAACTGTTTTTT	CASSCDQPPGTTTNEKLFF	TRBV6-5	TRBJ1-4
TGTGCCACCAGTGATTTTGGCCTTGCTCGGGACAGGGGGTGTGGCTACACCTTC	CATSDFGLARDRGCGYTF	TRBV24-1	TRBJ1-2
TGTGCTAGTGGTTCGGGAGCGACTAGCGGGGCCGGGGAGCTGTTTTTT	CASGSGATSGAGELFF	TRBV12-5	TRBJ2-2
TGCAGTGCTAGAGATCACTGGACAGGGTATCAGCCCCAGCATTTT	CSARDHWTGYQPQHF	TRBV20-1	TRBJ1-5
TGTGCCAGCAGCCAAGCCTGCCTCTTAGGGCAGCCCCAGCATTTT	CASSQACLLGQPQHF	TRBV14	TRBJ1-5
TGTGCCAGCAGGGTACAGGGGAGGGATGAAAAACTGTTTTTT	CASRVQGRDEKLFF	TRBV7-2	TRBJ1-4
TGCAGTGCTAGAGAAACAGGCCCCCCGAACTATGGCTACACCTTC	CSARETGPPNYGYTF	TRBV20-1	TRBJ1-2
TGTGCCACCAGGTTCTTCTTGTGGGATCAGAATGAAGCTTTCTTT	CATRFFLWDQNEAFF	TRBV24-1	TRBJ1-1
TGTGCCAGCAGTGAAGTCCCAGGGGACAATGAGCAGTTCTTC	CASSEVPGDNEQFF	TRBV6-1	TRBJ2-1
TGTGCCAGCAGTGAACCCCGGGCGAGGGCTTTCTACGAGCAGTACTTC	CASSEPRARAFYEQYF	TRBV6-1	TRBJ2-7
TGTGCCAGCAGCTGGGCGGGGGGGGGGGATACGCAGTATTTT	CASSWAGGGDTQYF	TRBV11-2	TRBJ2-3
TGCAGCGTTCGTGGGTCTACAGGGCCAAGTAGCCAAGAGACCCAGTACTTC	CSVRGSTGPSSQETQYF	TRBV29-1	TRBJ2-5
TGTGCCAGCACCCCCGATCGTAAGCGGCTATATAGCAATCAGCCCCAGCATTTT	CASTPDRKRLYSNQPQHF	TRBV3-1	TRBJ1-5
TGCGCCAGCAGCCAAGGCAGGACAGCCAGGAGTACCTTATACAATGAGCAGTTCTTC	CASSQGRTARSTLYNEQFF	TRBV4-1	TRBJ2-1
TGCGCCAGAGACAGTACCCCGATTAGCAACGTCCTGACTTTC	CARDSTPISNVLTF	TRBV5-1	TRBJ2-6
TGTGCCAGCAGCAAAAACACCAGGGAAGCTTTCTTT	CASSKNTREAFF	TRBV13	TRBJ1-1
TGTGCCAGCAGTTCCACTAGTTCCTCCTACGAGCAGTACTTC	CASSSTSSSYEQYF	TRBV28	TRBJ2-7
TGTGCCAGCAGCGTAGCGACTCAGGATACGCAGTATTTT	CASSVATQDTQYF	TRBV9	TRBJ2-3
TGCAGTGCTGGGGCTTCTAGCGGGGACTACAATGAGCAGTTCTTC	CSAGASSGDYNEQFF	TRBV20-1	TRBJ2-1
TGTGCCAGTACCGGAGTGACTAATGAAAAACTGTTTTTT	CASTGVTNEKLFF	TRBV19	TRBJ1-4
TGTGCCAGCAGCTTAGATCCGTATGCTACTAGCGGGGGTACCGGGGAGCTGTTTTTT	CASSLDPYATSGGTGELFF	TRBV11-2	TRBJ2-2
TGTGCCAGCAGCGTGGGGGGGCGCTACGAGCAGTACTTC	CASSVGGRYEQYF	TRBV11-3	TRBJ2-7
TGTGCCAGCAGTTACCAACGTCGGGACAGGGACCCCGGGGAGCTGTTTTTT	CASSYQRRDRDPGELFF	TRBV6-6	TRBJ2-2
TGTGCCAGCAGCGCCCCGGGGGTAGGCTATGGCTACACCTTC	CASSAPGVGYGYTF	TRBV9	TRBJ1-2
TGCGCCAGCAGCAGGCACCCACTAGCGGGGGGGCGGGCCTACAATGAGCAGTTCTTC	CASSRHPLAGGRAYNEQFF	TRBV5-1	TRBJ2-1
TGTGCCAGCAGCCAACGGCCGGGACGGGGGGTCAACTATGGCTACACCTTC	CASSQRPGRGVNYGYTF	TRBV7-4	TRBJ1-2
TGTGCCAGCAGCTCCCGGGGAGGGTGGCCGAACACTGAAGCTTTCTTT	CASSSRGGWPNTEAFF	TRBV5-6	TRBJ1-1
TGTGCCAGCAGCACGGTCCCGGGGACAGGGGAGACTGAAAAACTGTTTTTT	CASSTVPGTGETEKLFF	TRBV7-3	TRBJ1-4
TGTGCCAGCAGCTTAGGGCACCTAGCGGGACGGAGGGGAGACGAGCAGTACTTC	CASSLGHLAGRRGDEQYF	TRBV7-9	TRBJ2-7
TGCGCCAGCAGGTATACGGACAGGGTCCTTTACGAGCAGTACTTC	CASRYTDRVLYEQYF	TRBV10-1	TRBJ2-7
TGTGCCAGAACGTACCTCCAAGAGACCCAGTACTTC	CARTYLQETQYF	TRBV7-7	TRBJ2-5
TGTGCCAGCAGTTACAAGGTCGGACTAGGGTACGAGCAGTACTTC	CASSYKVGLGYEQYF	TRBV6-2	TRBJ2-7
TGTGCCAGCAGCTTAAATCGACTATACGAGCAGTACTTC	CASSLNRLYEQYF	TRBV11-3	TRBJ2-7
TGTGCCAGCAGCTTCCGGACGGGTAGCAATCAGCCCCAGCATTTT	CASSFRTGSNQPQHF	TRBV7-2	TRBJ1-5
TGCGCCAGCAGCCAACAGGATGAAAAACTGTTTTTT	CASSQQDEKLFF	TRBV4-1	TRBJ1-4
TGTGCCAGCAGCTCTTGGGCACAGGGGCCCGGCTACACCTTC	CASSSWAQGPGYTF	TRBV11-3	TRBJ1-2
TGTGCCAGCAGCTTGTACGGCCGGGACAGAGGTAACACTGAAGCTTTCTTT	CASSLYGRDRGNTEAFF	TRBV5-4	TRBJ1-1
TGTGCCAGCAGCCTTCCCCAGGGGGATCTTTCGAACACCGGGGAGCTGTTTTTT	CASSLPQGDLSNTGELFF	TRBV13	TRBJ2-2
TGTGCCAGCAGGGGGGCAGGGTATGAGACCCAGTACTTC	CASRGAGYETQYF	TRBV6-5	TRBJ2-5
TGTGCCAGTAGTATCCAGATCGGACTGGAAGAGACCCAGTACTTC	CASSIQIGLEETQYF	TRBV19	TRBJ2-5
TGTGCCAGCCCCTTCAGGGGGCGAGCGGTGCAAGAGACCCAGTACTTC	CASPFRGRAVQETQYF	TRBV28	TRBJ2-5
TGTGCCAGCAGCCCTGGGGGCGCAGCAACTAATGAAAAACTGTTTTTT	CASSPGGAATNEKLFF	TRBV3-1	TRBJ1-4
TGCAGTGCTAGTAACGACCCGGGACAGAAACTACAGAACACTGAAGCTTTCTTT	CSASNDPGQKLQNTEAFF	TRBV20-1	TRBJ1-1
TGCAGCGTTCCCCAGTGCAGGGGGGAAGGGGAGTGGGGGGTTCTTGGCTACACCTTC	CSVPQCRGEGEWGVLGYTF	TRBV29-1	TRBJ1-2
TGTGCCAGCGGCCTCGGCGGGACGGGTGCCAAAAACATTCAGTACTTC	CASGLGGTGAKNIQYF	TRBV9	TRBJ2-4
TGTGCCAGCTCCCAGGGTGCCAGGGTTACTGAAGCTTTCTTT	CASSQGARVTEAFF	TRBV18	TRBJ1-1
TGTGCCAGCAGCCTAGTGAGCTCCTACAATGAGCAGTTCTTC	CASSLVSSYNEQFF	TRBV7-2	TRBJ2-1
TGTGCCAGCAGTGGACAGACAGGGGCGAAGTTCCAGCCCCAGCATTTT	CASSGQTGAKFQPQHF	TRBV6-4	TRBJ1-5
TGCGCCAGCAGCCAAGATAGCTGGGGAGACATCTACAATGAGCAGTTCTTC	CASSQDSWGDIYNEQFF	TRBV4-1	TRBJ2-1
TGTGCCATATCCAGCTTTGACAGTAGAGAGACCCAGTACTTC	CAISSFDSRETQYF	TRBV10-3	TRBJ2-5
TGTGCCAGTAGTATGCCGCGGGAGTTGTGGAAACCGAACACTGAAGCTTTCTTT	CASSMPRELWKPNTEAFF	TRBV19	TRBJ1-1
TGTGCCAGCAGTGAAGCAAAGTCGTTGTTTGAAAAACTGTTTTTT	CASSEAKSLFEKLFF	TRBV2	TRBJ1-4
TGTGCCAGCACAGTGTTCATTCTCACCGGGGAGCTGTTTTTT	CASTVFILTGELFF	TRBV27	TRBJ2-2
TGCGCCAGCAGCAACCCTGGGGGGGCCTACGCCACGAACACCGGGGAGCTGTTTTTT	CASSNPGGAYATNTGELFF	TRBV5-1	TRBJ2-2
TGTGCCAGCAGAGGGACGGGTTACACAGATACGCAGTATTTT	CASRGTGYTDTQYF	TRBV6-6	TRBJ2-3
TGTGCCAGCAGTAAACCCATCTCGTACCACGAGCAGTACTTC	CASSKPISYHEQYF	TRBV6-5	TRBJ2-7
TGTGCACCCCAGGGGACAGGGGATGAGCAGTTCTTC	CAPQGTGDEQFF	TRBV5-5	TRBJ2-1
TGTGCCAGCAGCCTCCTCTTACCCAGCTCCTACGAGCAGTACTTC	CASSLLLPSSYEQYF	TRBV13	TRBJ2-7
TGTGCTAGCAGCCCACACGAACCCTACGAGCAGTACTTC	CASSPHEPYEQYF	TRBV7-7	TRBJ2-7
TGCAGTGCCTCCCGACGCCCTAGAGGCTACAATGAGCAGTTCTTC	CSASRRPRGYNEQFF	TRBV20-1	TRBJ2-1
TGTGCCAGCAGCCAAGGGGGGTCTCGAGGGTATCGTACCCTCCACTTT	CASSQGGSRGYRTLHF	TRBV7-3	TRBJ1-6
TGTGCCAGCAGCAGGGTCCTAGGCGACGAGCAGTACTTC	CASSRVLGDEQYF	TRBV6-4	TRBJ2-7
TGCAGTGGTCTCCGGTGGGGGGGCTACACCTTC	CSGLRWGGYTF	TRBV20-1	TRBJ1-2
TGTGCCAGCAGCGAGGGGCCGCCCCAGCATTTT	CASSEGPPQHF	TRBV6-4	TRBJ1-5
TGTGCCAGCACGTTGACAGGCGACGAGCAGTACTTC	CASTLTGDEQYF	TRBV6-2	TRBJ2-7
TGCAGTGCTAGAGATGATTGTACCGACGAGCAGTACTTC	CSARDDCTDEQYF	TRBV20-1	TRBJ2-7
TGTGCCACCAGAATTTTTACTAGTGTGTCCGGTTCTTTCTACAATGAGCAGTTCTTC	CATRIFTSVSGSFYNEQFF	TRBV15	TRBJ2-1
TGTGCCAGCAGCTCTGTCTACGAGCAGTACTTC	CASSSVYEQYF	TRBV7-7	TRBJ2-7
TGTGCCAGCGCGTATCCAGGGGTTGCTCAGCCCCAGCATTTT	CASAYPGVAQPQHF	TRBV2	TRBJ1-5
TGTGCCAGCAGCAGAAGATGGGGTTACTCAGGCAGGTCCTACGAGCAGTACTTC	CASSRRWGYSGRSYEQYF	TRBV7-9	TRBJ2-7
TGTGCCAGCTGGACAGGGGACGCCTATAATTCACCCCTCCACTTT	CASWTGDAYNSPLHF	TRBV7-2	TRBJ1-6
TGTGCCAGCAGCTATCGAATTGACTATGGCTACACCTTC	CASSYRIDYGYTF	TRBV27	TRBJ1-2
TGTGCCAGCAGCCAAGCCGGGACAGGGGGGGGGGTGGCCTACGAGCAGTACTTC	CASSQAGTGGGVAYEQYF	TRBV14	TRBJ2-7
TGTGCCAGCAGCCCCGACAAGCCCCAGCATTTT	CASSPDKPQHF	TRBV6-5	TRBJ1-5
TGTGCCAGCAGCGAAAAACCGAGTCCGACAGGGTCTGAGCAAGAGACCCAGTACTTC	CASSEKPSPTGSEQETQYF	TRBV7-3	TRBJ2-5
TGTGCCAGCACGGGAATTCCACGTTCACCCCTCCACTTT	CASTGIPRSPLHF	TRBV2	TRBJ1-6
TGTGCCAGCAGCAGGGCAAGGGAGTACTTC	CASSRAREYF	TRBV4-2	TRBJ2-7
TGTGCCACGCCCCCGGGGACAGGGACCTTTGGGACCGGCTACACCTTC	CATPPGTGTFGTGYTF	TRBV6-4	TRBJ1-2
TGTGCCAGCAGTCGGGAGAGGGACAGGGGGGGAGGAAATCAGCCCCAGCATTTT	CASSRERDRGGGNQPQHF	TRBV27	TRBJ1-5
TGTGCCAGCAGTTCGGGGGACATAAAATTCTTC	CASSSGDIKFF	TRBV6-9	TRBJ2-1
TGCAGTGCTCTCCCATTTCGCAATCAGCCCCAGCATTTT	CSALPFRNQPQHF	TRBV20-1	TRBJ1-5
TGCGCCAGCAGCCAAGATTATGGAGGTGAAAGACCGGGGGGGCGTTCCAATGAGCAGTTCTTC	CASSQDYGGERPGGRSNEQFF	TRBV4-3	TRBJ2-1
TGTGCCAGCAGCCTGACCGGGACAGGGGGAGCTTTCTTT	CASSLTGTGGAFF	TRBV6-5	TRBJ1-1
TGCAGTGCTAGCCTGTTCGCGGTGCCCCAGCATTTT	CSASLFAVPQHF	TRBV20-1	TRBJ1-5
TGCAGTGCTAGAGAGGACAGGGGCAGAGAGACCCAGTACTTC	CSAREDRGRETQYF	TRBV20-1	TRBJ2-5
TGTGCCAGCAGTTACGATCACTCCAGGGGTCCCAAAAACATTCAGTACTTC	CASSYDHSRGPKNIQYF	TRBV6-5	TRBJ2-4
TGTGCCAGCAGCTTAGGTCCAAGGGTACTTCGCACAGATACGCAGTATTTT	CASSLGPRVLRTDTQYF	TRBV11-2	TRBJ2-3
TGTGCCAGCAGGAACAAGTCAGGGGCAGGGGACACAGATACGCAGTATTTT	CASRNKSGAGDTDTQYF	TRBV6-5	TRBJ2-3
TGTGCCAGCAGCGAAGCGGGCTCCTATAATTCACCCCTCCACTTT	CASSEAGSYNSPLHF	TRBV11-2	TRBJ1-6
TGTGCCAGCAGCGAAATAGGGACAGGGCTCCGCGAGACCCAGTACTTC	CASSEIGTGLRETQYF	TRBV7-3	TRBJ2-5
TGCGGGACAGGCCCGAACACCGGGGAGCTGTTTTTT	CGTGPNTGELFF	TRBV5-1	TRBJ2-2
TGTGCCAGCAGCAAGGGGGAGTCTAACACTGAAGCTTTCTTT	CASSKGESNTEAFF	TRBV13	TRBJ1-1
TGCGCCATTAGGCTAGCACGCTACGAGCAGTACTTC	CAIRLARYEQYF	TRBV5-1	TRBJ2-7
TGCGCCAGCCTCTCCCTCAGGGGTGACAATCAGCCCCAGCATTTT	CASLSLRGDNQPQHF	TRBV10-1	TRBJ1-5
TGTGCCAGCAGCGTATGGGCAGGGGATACGAACACCGGGGAGCTGTTTTTT	CASSVWAGDTNTGELFF	TRBV9	TRBJ2-2
TGCGCCAGCAGCTCCTGGAGTGAGCAGTTCTTC	CASSSWSEQFF	TRBV5-1	TRBJ2-1
TGCAGCGTTAATACAACTAACCACGAGCAGTACTTC	CSVNTTNHEQYF	TRBV29-1	TRBJ2-7
TGCAAACGCGAACGGAGAGAGACCCAGTACTTC	CKRERRETQYF	TRBV29-1	TRBJ2-5
TGTGCCAGCAGGTCCGGGACAGGGGATTCACCCCTCCACTTT	CASRSGTGDSPLHF	TRBV7-3	TRBJ1-6
TGTGCCAGCAGAGAGCCGGTCGGGACAGGGGTTTTTCCGTACGAGCAGTACTTC	CASREPVGTGVFPYEQYF	TRBV5-5	TRBJ2-7
TGTGCCAGCAGTGACTCGGTCGACAGGGTTCATGAGCAGTTCTTC	CASSDSVDRVHEQFF	TRBV6-4	TRBJ2-1
TGTGCCAGCAGGACCTCCAGGGCGAGCACAGATACGCAGTATTTT	CASRTSRASTDTQYF	TRBV12-3	TRBJ2-3
TGTGCCAGCAGCTCGAACCGCGGGAGTATTGGCGAGCAGTACTTC	CASSSNRGSIGEQYF	TRBV13	TRBJ2-7
TGTGCCAGCAGCTCGGGACAGGGACGAAACACTGAAGCTTTCTTT	CASSSGQGRNTEAFF	TRBV7-9	TRBJ1-1
TGTGCCAGCAGCCGAAAGCAGAGCCAGCGAGTCACTAATGAAAAACTGTTTTTT	CASSRKQSQRVTNEKLFF	TRBV13	TRBJ1-4
TGTGCCAGCAGTTACCAGGAGCGACTGATTCCTTGCGGGGAGCTGTTTTTT	CASSYQERLIPCGELFF	TRBV6-6	TRBJ2-2
TGTGCCAGCATGCCGGTTGCTCGGGCGAACACCGGGGAGCTGTTTTTT	CASMPVARANTGELFF	TRBV5-4	TRBJ2-2
TGTGCCAGCCCAGGGGGCACAGATACGCAGTATTTT	CASPGGTDTQYF	TRBV19	TRBJ2-3
TGTGCCAGCACGGGGCGGGAGGAAGACATTCAGTACTTC	CASTGREEDIQYF	TRBV28	TRBJ2-4
TGTGCCAGCGGGGAAATCAGGGGGCGGCATCAGCCCCAGCATTTT	CASGEIRGRHQPQHF	TRBV13	TRBJ1-5
TGTGCCAGCAGTTTCGGACTAGTAAAGAACACTGAAGCTTTCTTT	CASSFGLVKNTEAFF	TRBV6-2	TRBJ1-1
TGTGCCAGCAGCAGTTTTCCCGATTCGACCGCGCAGTATTTT	CASSSFPDSTAQYF	TRBV13	TRBJ2-3
TGTGCCAGCAGTTACCCTTCACCGGGACAGGGCGAGCAGTACTTC	CASSYPSPGQGEQYF	TRBV6-8	TRBJ2-7
TGTGCCAGCAGTCCCCCGGGAGGAGAAGAGACCCAGTACTTC	CASSPPGGEETQYF	TRBV27	TRBJ2-5
TGCGCCAGCAGCCCGGGGATGTGGCGTAACTATGGCTACACCTTC	CASSPGMWRNYGYTF	TRBV5-1	TRBJ1-2
TGTGCCAGCAGCGTAGTGAGTATGAGTTTCCGGACAGATACGCAGTATTTT	CASSVVSMSFRTDTQYF	TRBV9	TRBJ2-3
TGTGCCAGCAGCCCGTCCGTGACAGGGGCTGCTAACTATGGCTACACCTTC	CASSPSVTGAANYGYTF	TRBV5-5	TRBJ1-2
TGCGCCAGCAGCCAAACCCGGGACAAAGACTATGGCTACACCTTC	CASSQTRDKDYGYTF	TRBV4-1	TRBJ1-2
TGTGCCCGGGGACTTAACAACACCGGGGAGCTGTTTTTT	CARGLNNTGELFF	TRBV28	TRBJ2-2
TGTGCCAGCAGTTATAGGGAATTCCCTACCTACGAGCAGTACTTC	CASSYREFPTYEQYF	TRBV6-6	TRBJ2-7
TGTGCCAGCAGTGACCTCCCCAAAACGGATGGGGGGGGGGAGACCCAGTACTTC	CASSDLPKTDGGGETQYF	TRBV2	TRBJ2-5
TGTGCCAGCAGCTTGGGCGACAGGGCTTTCTTT	CASSLGDRAFF	TRBV5-4	TRBJ1-1
TGTGCCAGCAGCAAGTCTAACTTATGCGGGAGGGCAGATACGCAGTATTTT	CASSKSNLCGRADTQYF	TRBV7-3	TRBJ2-3
TGTGCCAGCAGTAAAGGGGCTAGGAACACTGAAGCTTTCTTT	CASSKGARNTEAFF	TRBV6-5	TRBJ1-1
TGCAGTGCTAGAGATAGGATTCACGCAGGGGACATTCAGCCCCAGCATTTT	CSARDRIHAGDIQPQHF	TRBV20-1	TRBJ1-5
TGTGCCAGCAGCAGGGGGCCCGCAAGTTCTGGGGCCAACGTCCTGACTTTC	CASSRGPASSGANVLTF	TRBV6-5	TRBJ2-6
TGTGCCAGCAGACCCCCGGACAGGGGAATGAAAGAGACCCAGTACTTC	CASRPPDRGMKETQYF	TRBV6-2	TRBJ2-5
TGCAGCGTCGGACAGTTCTCTGGAAACACCATATATTTT	CSVGQFSGNTIYF	TRBV29-1	TRBJ1-3
TGTGCCAAACTTCGGGCCCTGTACAATGAGCAGTTCTTC	CAKLRALYNEQFF	TRBV19	TRBJ2-1
TGCGCCAGCAGCCAAGAAAGGACTAGCGGGGGGGAGACCCAGTACTTC	CASSQERTSGGETQYF	TRBV4-1	TRBJ2-5
TGTGCCAGCAGTGGCGGGACCCCCCTTGATACGCAGTATTTT	CASSGGTPLDTQYF	TRBV6-4	TRBJ2-3
TGCGCCAGCAGCCCCAACGGGGGGGCGCAAGAGACCCAGTACTTC	CASSPNGGAQETQYF	TRBV5-1	TRBJ2-5
TGTGCCAGCAGCTTATCCCAGCCCCGCCTCGGGACACTAACAACTACCACTGAAGCTTTCTTT	CASSLSQPRLGTLTTTTEAFF	TRBV5-6	TRBJ1-1
TGCAACACAGCCCAGGGTCAGCCCCAGCATTTT	CNTAQGQPQHF	TRBV20-1	TRBJ1-5
TGTGCCAGCTCACCGTTCCGTATTTCAGCCAGGGGCAGAATGAACACTGAAGCTTTCTTT	CASSPFRISARGRMNTEAFF	TRBV18	TRBJ1-1
TGTGCCAGCAGCCCCCCACCGGGACATTCTAACATTCAGTACTTC	CASSPPPGHSNIQYF	TRBV7-4	TRBJ2-4
TGTGCCAGTAGTATAGAACCAATCCAGGCTGGCTCTGGGGCCAACGTCCTGACTTTC	CASSIEPIQAGSGANVLTF	TRBV19	TRBJ2-6
TGTGCCAGCAGCTCCATGTATAGGTATGGAGGTTACGAGCAGTACTTC	CASSSMYRYGGYEQYF	TRBV7-2	TRBJ2-7
TGTGCCAGCAGTTTTTTCGGACTAGGCTTCTACAATGAGCAGTTCTTC	CASSFFGLGFYNEQFF	TRBV6-5	TRBJ2-1
TGTGCCAGCAGCTTATCGACAGGGGGGGTAGCTTTCTTT	CASSLSTGGVAFF	TRBV7-7	TRBJ1-1
TGTGCCAGCAGCTTAATTTCCCGAGGGGCCCGGCATGGAAACACCATATATTTT	CASSLISRGARHGNTIYF	TRBV7-7	TRBJ1-3
TGTGCCAGCAGCCCGGACAGGCCTCCAAGAGAGCAGTACTTC	CASSPDRPPREQYF	TRBV5-6	TRBJ2-7
TGTGCCAGCAGCCCTCGTTCGGGCCTCAGGAAAAGAAATGAAAAACTGTTTTTT	CASSPRSGLRKRNEKLFF	TRBV5-4	TRBJ1-4
TGTGCCACCAGTGACGTCGGGGGGCCTACGGAAGGGCGGGAGCTGTTTTTT	CATSDVGGPTEGRELFF	TRBV24-1	TRBJ2-2
TGTGCCAGCAGCGCTACACAGACCGGGGAGCTGTTTTTT	CASSATQTGELFF	TRBV7-8	TRBJ2-2
TGTGCCAGCAGCGGTGGCTACAGGGATGGCTACACCTTC	CASSGGYRDGYTF	TRBV7-3	TRBJ1-2
TGTGCCAGCAGCTTACCCCCGGCGACAGGACCAGAGACCCAGTACTTC	CASSLPPATGPETQYF	TRBV11-3	TRBJ2-5
TGTGCCAGAATATATAGGGGGTCTTTTGACGAGCAGTACTTC	CARIYRGSFDEQYF	TRBV19	TRBJ2-7
TGTGCGAGACCCGAGGGCTACGAGCAGTACTTC	CARPEGYEQYF	TRBV9	TRBJ2-7
TGTGCCAGCCTCAATAAAGAGGGGGGGTCACCCCTCCACTTT	CASLNKEGGSPLHF	TRBV6-5	TRBJ1-6
TGTGCCAGCATTTGGGGACAGGTTGAGCAGTTCTTC	CASIWGQVEQFF	TRBV27	TRBJ2-1
TGTGCCACCCCATTCGATGGCTACACCTTC	CATPFDGYTF	TRBV19	TRBJ1-2
TGCGCCAGCAGCGCTTTAGACAGGCTACAGGTCACTGAAGCTTTCTTT	CASSALDRLQVTEAFF	TRBV4-1	TRBJ1-1
TGTGCCATCCGGGACGAGAATTCACCCCTCCACTTT	CAIRDENSPLHF	TRBV27	TRBJ1-6
TGTGCCACCAGTGATTTCCGAGCGGGAGATACCTACGAGCAGTACTTC	CATSDFRAGDTYEQYF	TRBV24-1	TRBJ2-7
TGTGCCAGCAGCTTGGGGTCGGGACCCAGAGAAGCTTTCTTT	CASSLGSGPREAFF	TRBV5-4	TRBJ1-1
TGCGCCAGCAGCCAAGGGGGCCATAGATCCAAAAACATTCAGTACTTC	CASSQGGHRSKNIQYF	TRBV4-3	TRBJ2-4
TGTGCCAGCAGCTCTATCAGTTGCGAGCAGTACTTC	CASSSISCEQYF	TRBV28	TRBJ2-7
TGCAGCGTTGCTCAGGGACTAGCGGAGGGCACAGATACGCAGTATTTT	CSVAQGLAEGTDTQYF	TRBV29-1	TRBJ2-3
TGTGCCAGCAGTCCCTGGACGGCTAATTCACCCCTCCACTTT	CASSPWTANSPLHF	TRBV6-4	TRBJ1-6
TGCGCCAGCAGCTCACAGGGAGGCCAAGAGACCCAGTACTTC	CASSSQGGQETQYF	TRBV5-1	TRBJ2-5
TGTGCCAGCAGCACTAGCGCGTTGGGCTCTGGGGCCAACGTCCTGACTTTC	CASSTSALGSGANVLTF	TRBV9	TRBJ2-6
TGTGCCAGCGGTTGGGGGCGGTACCGAGGGCACTCTGGGGCCAACGTCCTGACTTTC	CASGWGRYRGHSGANVLTF	TRBV2	TRBJ2-6
TGTGCCATGTCCCCCGATGGGGTTTACCAAGAGACCCAGTACTTC	CAMSPDGVYQETQYF	TRBV6-4	TRBJ2-5
TGTGCCAGCAGTTACAAGGACAGGGGGCATCACGAGCAGTACTTC	CASSYKDRGHHEQYF	TRBV6-6	TRBJ2-7
TGTGCCAGCTCACCAAAGGACCGCTCTGGGGCCAACGTCCTGACTTTC	CASSPKDRSGANVLTF	TRBV18	TRBJ2-6
TGTGCCAGTAGTCGAGGGGGTTCCTACGAGCAGTACTTC	CASSRGGSYEQYF	TRBV19	TRBJ2-7
TGTGCCAGCAGCCAAGAACGTGGGGGCAAACGCACTGAAGCTTTCTTT	CASSQERGGKRTEAFF	TRBV14	TRBJ1-1
TGTGCCACCAAACCATTGCCGGGACAGGGAGGGAACACTGAAGCTTTCTTT	CATKPLPGQGGNTEAFF	TRBV24-1	TRBJ1-1
TGTGCCAGCAGAAGAGACACCACTGAAGCTTTCTTT	CASRRDTTEAFF	TRBV6-4	TRBJ1-1
TGTGCCACCAGCAGAGGTGGGGACAGAGTTGAAGCTTTCTTT	CATSRGGDRVEAFF	TRBV15	TRBJ1-1
TGTGCCAGCAGCGGGTTCCCCGGGACAGGGAATTGGTATAGCAATCAGCCCCAGCATTTT	CASSGFPGTGNWYSNQPQHF	TRBV7-9	TRBJ1-5
TGCGCCAGCAGTGAGGACCCCCCCAATTGCTACGAGCAGTACTTC	CASSEDPPNCYEQYF	TRBV10-2	TRBJ2-7
TGTGCCAGCAGAAGGACTAGCGGGGAGACCCAGTACTTC	CASRRTSGETQYF	TRBV5-5	TRBJ2-5
TGTGCCAGCAGCTTATTAACAGGGGACTATGGCTACACCTTC	CASSLLTGDYGYTF	TRBV7-3	TRBJ1-2
TGCAGTGCGTCCGGGGGGGGGTACTACAATGAGCAGTTCTTC	CSASGGGYYNEQFF	TRBV20-1	TRBJ2-1
TGTGCCACCAGGACCCGGGACAGTCATCCCTACGAGCAGTACTTC	CATRTRDSHPYEQYF	TRBV24-1	TRBJ2-7
TGTGCCAGCAGCCGGCGGAACGAGCAGTTCTTC	CASSRRNEQFF	TRBV13	TRBJ2-1
TGTGCCAGCATTCAGGGAACTAGCAATCAGCCCCAGCATTTT	CASIQGTSNQPQHF	TRBV7-3	TRBJ1-5
TGTGCCACCAGCAGAGACCTCCGCGTGCGGGAGTTTAAATGCGCCTACAATGAGCAGTTCTTC	CATSRDLRVREFKCAYNEQFF	TRBV15	TRBJ2-1
TGTGCCAGCAGCTTGTTGGGCGCTCACCCAACTGAAGCTTTCTTT	CASSLLGAHPTEAFF	TRBV5-4	TRBJ1-1
TGTGCCAGCAGCTGTTCCCCGGGACAAGAAGAAGACCCCTTCTTT	CASSCSPGQEEDPFF	TRBV13	TRBJ1-1
TGTGCCAGCAGCGTGTGGGGATCATGCACAGATACGCAGTATTTT	CASSVWGSCTDTQYF	TRBV9	TRBJ2-3
TGTGCCAGCAGTTATGGAGATACGCAGTATTTT	CASSYGDTQYF	TRBV27	TRBJ2-3
TGTGCCAGCAGCACTTCGGGTCACGAGCAGTACTTC	CASSTSGHEQYF	TRBV11-3	TRBJ2-7
TGTGCCAGCAGTTTGGTTACGCGGATCGGGGGTGGAAACACCATATATTTT	CASSLVTRIGGGNTIYF	TRBV27	TRBJ1-3
TGTGCCAGCAGCTCATGGGACAGGGGGCGAACAGATACGCAGTATTTT	CASSSWDRGRTDTQYF	TRBV5-6	TRBJ2-3
TGTGCCAGCAGCGGGAGGGAATGTGAGCAGTACTTC	CASSGRECEQYF	TRBV11-3	TRBJ2-7
TGTGCCAGCAGCGAAGGACTACCGACCGGGGAGCTGTTTTTT	CASSEGLPTGELFF	TRBV13	TRBJ2-2
TGTGCCAGCAGGGCCGGGACTAGCGGCGCAGCTGAGCAGTTCTTC	CASRAGTSGAAEQFF	TRBV3-1	TRBJ2-1
TGCGCCAGCAGCCGGTGGACAGGGCTTCAAGAGACCCAGTACTTC	CASSRWTGLQETQYF	TRBV4-1	TRBJ2-5
TGTGCCACCAGCAGAGATGGACAGGGTAACTATGGCTACACCTTC	CATSRDGQGNYGYTF	TRBV15	TRBJ1-2
TGTGCCAATTGGTCCCCGGGCGGGGAATACAATGAGCAGTTCTTC	CANWSPGGEYNEQFF	TRBV6-4	TRBJ2-1
TGTGCCAGCATAGAGCCCCAGGGGGGTAGCAATCAGCCCCAGCATTTT	CASIEPQGGSNQPQHF	TRBV7-3	TRBJ1-5
TGTGCCAGCAACCACAACGAATCACCCCTCCACTTT	CASNHNESPLHF	TRBV6-4	TRBJ1-6
TGTGCCAGCAGCAGGGCTGTTCGGTGCCCCTATGGCTACACCTTC	CASSRAVRCPYGYTF	TRBV11-3	TRBJ1-2
TGTGCCAAGGGTATATTATTTTCACCCCTCCACTTT	CAKGILFSPLHF	TRBV10-3	TRBJ1-6
TGCGCCAGCAGCTACTCGGGACACCGAATTCAGCCCCAGCATTTT	CASSYSGHRIQPQHF	TRBV5-1	TRBJ1-5
TGTGCCAGCAGTACTAGCGGGAGGCAGTACTTC	CASSTSGRQYF	TRBV6-1	TRBJ2-7
TGTGCCAGCATGGGCAGGGGGGATACCCGGAACACTGAAGCTTTCTTT	CASMGRGDTRNTEAFF	TRBV7-9	TRBJ1-1
TGTGCCAGCAGCTTTCTAGCGGGGGACAATGAGCAGTTCTTC	CASSFLAGDNEQFF	TRBV7-6	TRBJ2-1
TGTGCCAGCAGCCAACATCCACGGGACAACAATGAGCAGTTCTTC	CASSQHPRDNNEQFF	TRBV3-1	TRBJ2-1
TGCGCCAGCAGGAGGGATCCCTACAATGAGCAGTTCTTC	CASRRDPYNEQFF	TRBV10-1	TRBJ2-1
TGCGCCAGCAGCTTCCTGGGGATTCCTAGCGGGGGCACACTCGAGCAGTACTTC	CASSFLGIPSGGTLEQYF	TRBV5-1	TRBJ2-7
TGTGCCAGCTCACCTCCGGGACGGGGGGGGAGCACAGATACGCAGTATTTT	CASSPPGRGGSTDTQYF	TRBV18	TRBJ2-3
TGTGCCAGCAGTGCCGGACAGGCTCGCAATCAGCCCCAGCATTTT	CASSAGQARNQPQHF	TRBV6-1	TRBJ1-5
TGTGCCAGCAGGGACAGCAACATTCAGTACTTC	CASRDSNIQYF	TRBV19	TRBJ2-4
TGCAGCGACTGGGAATCCGGGACTTTAGGTGAGCAGTTCTTC	CSDWESGTLGEQFF	TRBV29-1	TRBJ2-1
TGTGCCAGCAAACAAATATCAGGGGTACCCTACGAGCAGTACTTC	CASKQISGVPYEQYF	TRBV28	TRBJ2-7
TGTGCCAGCAGTATGACTCGGGGCTCTTATGGCTACACCTTC	CASSMTRGSYGYTF	TRBV12-3	TRBJ1-2
TGCGCCAGCAGCTTGCGCAGGGGTTACGAGCAGTACTTC	CASSLRRGYEQYF	TRBV5-1	TRBJ2-7
TGTGCCAGCGATTCCGGGACAGTGCATGATGAGCAGTTCTTC	CASDSGTVHDEQFF	TRBV5-8	TRBJ2-1
TGCAGCGTTGAAGATCCCCCCGGGCCGGGACTGTTCGATGAGCAGTTCTTC	CSVEDPPGPGLFDEQFF	TRBV29-1	TRBJ2-1
TGTGCCAGCAGCCGAGCAGGGTTCGGCTACGAGCAGTACTTC	CASSRAGFGYEQYF	TRBV7-3	TRBJ2-7
TGTGCCAGCAGCCGTCAGGTTAACGGCTACACCTTC	CASSRQVNGYTF	TRBV7-3	TRBJ1-2
TGTGCCACCAGTGAGGTAAGTCCCTTTTCTGACTACGAGCAGTACTTC	CATSEVSPFSDYEQYF	TRBV24-1	TRBJ2-7
TGTGCCAGTAGTATATACGGGCATCACGAGCAGTACTTC	CASSIYGHHEQYF	TRBV19	TRBJ2-7
TGTGTTCGCTGGGGGGAGGTCACTAATGAAAAACTGTTTTTT	CVRWGEVTNEKLFF	TRBV5-4	TRBJ1-4
TGTGCCAGCAGCAGGACGGCAGGGGACAAGAACACTGAAGCTTTCTTT	CASSRTAGDKNTEAFF	TRBV13	TRBJ1-1
TGTGCCAGCAGCTCGGGGGGCCGGTATAGCAATCAGCCCCAGCATTTT	CASSSGGRYSNQPQHF	TRBV7-9	TRBJ1-5
TGTGCCAGCAGCTTTTCCGGGACTTCCTACGAGCAGTACTTC	CASSFSGTSYEQYF	TRBV7-9	TRBJ2-7
TGTGCCAGCAGCCAAGATGGCGACGGCGAGCAGTACTTC	CASSQDGDGEQYF	TRBV3-1	TRBJ2-7
TGTGCCAGCAGCGTACTAACTTCTAGCGGGACGTTTCTCCCACTGGCCTACGAGCAGTACTTC	CASSVLTSSGTFLPLAYEQYF	TRBV9	TRBJ2-7
TGTGCCTGGAGTCTTTTAGTGCTCTCCTACGAGCAGTACTTC	CAWSLLVLSYEQYF	TRBV30	TRBJ2-7
TGTGCCAGCAGTGATCTAGGAATGAACACTGAAGCTTTCTTT	CASSDLGMNTEAFF	TRBV25-1	TRBJ1-1
TGTGCCAGCAAAATTAAGCCGGCCTTGAATTCACCCCTCCACTTT	CASKIKPALNSPLHF	TRBV14	TRBJ1-6
TGTGCCAGCAGACGGGGTACAGGGTCGGTCGACGAGCAGTACTTC	CASRRGTGSVDEQYF	TRBV7-9	TRBJ2-7
TGTGCCAGCAGCTTAGATGACAGGGGATTATATGGCTACACCTTC	CASSLDDRGLYGYTF	TRBV11-2	TRBJ1-2
TGTGCCAGCAGGAGGGGAAAACACACCATATATTTT	CASRRGKHTIYF	TRBV6-1	TRBJ1-3
TGCGCCAGCAGCTTGCCGGGGAGCTCCTACAATGAGCAGTTCTTC	CASSLPGSSYNEQFF	TRBV5-1	TRBJ2-1
TGCGCCAGCAGCCAAGAAACAGGCCCCAATCAGCCCCAGCATTTT	CASSQETGPNQPQHF	TRBV4-1	TRBJ1-5
TGTGCCACCCTAGGACTAGCGGGGTGTACTGAGCAGTTCTTC	CATLGLAGCTEQFF	TRBV24-1	TRBJ2-1
TGTGCCAGCAGTTTAAACCCCACAGTCACAGATACGCAGTATTTT	CASSLNPTVTDTQYF	TRBV28	TRBJ2-3
TGTGCTAGTGGTGGGGGAGGGGAGACCCAGTACTTC	CASGGGGETQYF	TRBV12-5	TRBJ2-5
TGCGCCAGCAGCTTGGTATCTAGTCGGGAATGGACGCCCTACGAGCAGTACTTC	CASSLVSSREWTPYEQYF	TRBV5-1	TRBJ2-7
TGTGCCAGCAGTTACCGACAGATGTATTACTATGGCTACACCTTC	CASSYRQMYYYGYTF	TRBV6-5	TRBJ1-2
TGTGCCAGCAGTCCGCCTAGGACAGGGTGGGGAAACACCATATATTTT	CASSPPRTGWGNTIYF	TRBV2	TRBJ1-3
TGTGCCAAAATACCTTACTACGAGCAGTACTTC	CAKIPYYEQYF	TRBV10-3	TRBJ2-7
TGTGCCAGCCTACAGAGCCCTGGGGCCAACGTCCTGACTTTC	CASLQSPGANVLTF	TRBV2	TRBJ2-6
TGTGCCAGCCTCTACCCATATGGCTACACCTTC	CASLYPYGYTF	TRBV11-3	TRBJ1-2
TGTGCCACCAGCAGAGAAATCAGACTAGCGGAGGGCAATGAGCAGTTCTTC	CATSREIRLAEGNEQFF	TRBV15	TRBJ2-1
TGTGCCAGCAGCCCTGGGGGACAGGGTTACACTGAAGCTTTCTTT	CASSPGGQGYTEAFF	TRBV7-3	TRBJ1-1
TGTGCCAGCAGCTCCACCTTTGATTGCGAGCAGTACTTC	CASSSTFDCEQYF	TRBV7-9	TRBJ2-7
TGCAGTGCAGTACGGGGGGTTACCTACGAGCAGTACTTC	CSAVRGVTYEQYF	TRBV20-1	TRBJ2-7
TGTGCCAGCAGCTTATCTCCGGGACAAACTTACAATGAGCAGTTCTTC	CASSLSPGQTYNEQFF	TRBV7-9	TRBJ2-1
TGTGCCAGCAGCTTGGCCAACAGGGACTATGGCTACACCTTC	CASSLANRDYGYTF	TRBV5-4	TRBJ1-2
TGCAGCGTTGGGGGGGGGACTAGGAGCTCCTATAATTCACCCCTCCACTTT	CSVGGGTRSSYNSPLHF	TRBV29-1	TRBJ1-6
TGTGCCAGCAGCTTCTTACTAGCGGGTCTCACAGATACGCAGTATTTT	CASSFLLAGLTDTQYF	TRBV7-9	TRBJ2-3
TGCAGTGCTAGAGCCCGCCAGGGAGTACTTGATACGCAGTATTTT	CSARARQGVLDTQYF	TRBV20-1	TRBJ2-3
TGTGCCAGCAGCCTACAGTGCTACAATGAGCAGTTCTTC	CASSLQCYNEQFF	TRBV13	TRBJ2-1
TGTGCCAGCAGCTGGATGGCCGACAGGGTCACTCAGCCCCAGCATTTT	CASSWMADRVTQPQHF	TRBV11-3	TRBJ1-5
TGTGCCGCTGACAGAGCCAATCAGCCCCAGCATTTT	CAADRANQPQHF	TRBV10-3	TRBJ1-5
TGTGCCAGCAGCTTAGAAGTGACTTTCACAACTAATGAGCAGTTCTTC	CASSLEVTFTTNEQFF	TRBV11-2	TRBJ2-1
TGCGCCAGCAGCCAAGATGTGTGGACAGGGTTCCTAGTCTACGAGCAGTACTTC	CASSQDVWTGFLVYEQYF	TRBV4-3	TRBJ2-7
TGTGCCAGCAGCCTGGCAAGTATGCTGGAGACCCAGTACTTC	CASSLASMLETQYF	TRBV27	TRBJ2-5
TGTGCCAGCAGTGACGGCCAGGGTGCACGTTCACCCCTCCACTTT	CASSDGQGARSPLHF	TRBV2	TRBJ1-6
TGTGCCAGCAGCTATACAGGGGATCAGCAGGGAGATACGCAGTATTTT	CASSYTGDQQGDTQYF	TRBV5-8	TRBJ2-3
TGTGCCAGCAGCTGGGGGAAGGGCTCCTACGAGCAGTACTTC	CASSWGKGSYEQYF	TRBV7-3	TRBJ2-7
TGTGCCAGCAGTTTTGGCGGGGGAGAACATCAGCCCCAGCATTTT	CASSFGGGEHQPQHF	TRBV27	TRBJ1-5
TGTGCTAGCAGCAAAAGGGGAAATGAGCAAGAGACCCAGTACTTC	CASSKRGNEQETQYF	TRBV7-7	TRBJ2-5
TGTGCCAGCAGCCAACTCCGAGTGAACACTGAAGCTTTCTTT	CASSQLRVNTEAFF	TRBV14	TRBJ1-1
TGTGGGGAAGCGACAGCCCACGAGCAGTACTTC	CGEATAHEQYF	TRBV6-2	TRBJ2-7
TGCGCCAGCGAACCTACAGGGGGGCGGTCCTACGAGCAGTACTTC	CASEPTGGRSYEQYF	TRBV10-1	TRBJ2-7
TGTGCCAGCAGCTTACCCTCCCCGGGGACGAACACTGAAGCTTTCTTT	CASSLPSPGTNTEAFF	TRBV7-6	TRBJ1-1
TGTGCCAGCAGCTTGTCAAGCGATTACGAGCAGTACTTC	CASSLSSDYEQYF	TRBV5-4	TRBJ2-7
TGTGCCAGCTCCGGGACATGGGCGCCCGGGGAGCTGTTTTTT	CASSGTWAPGELFF	TRBV19	TRBJ2-2
TGTGCCAGCAGCGGACAGGGGGGCACCCAAAATCAGCCCCAGCATTTT	CASSGQGGTQNQPQHF	TRBV27	TRBJ1-5
TGTGCCAGCAGCAGAAATCATCACAGGGGTGACTTTCTGGGCGACACTGAAGCTTTCTTT	CASSRNHHRGDFLGDTEAFF	TRBV5-4	TRBJ1-1
TGTGCCAGCAGCCGGCTACAGGGATTCAATGAGCAGTTCTTC	CASSRLQGFNEQFF	TRBV13	TRBJ2-1
TGCAGTGCTAGAGATTTTGGTTCGGCATTGGATCAGCCCCAGCATTTT	CSARDFGSALDQPQHF	TRBV20-1	TRBJ1-5
TGTGCCTGGAAAACCAAGGGTTCGGGAGGGGAATCCAGTCAGCCCCAGCATTTT	CAWKTKGSGGESSQPQHF	TRBV30	TRBJ1-5
TGTGCCAGTAGTATAGCCCGGGACGGCAATCAGCCCCAGCATTTT	CASSIARDGNQPQHF	TRBV19	TRBJ1-5
TGTGCCAGCAGGCCATCCGTGACAGGGTTGGGTTTGACAGATACGCAGTATTTT	CASRPSVTGLGLTDTQYF	TRBV6-2	TRBJ2-3
TGTGCCAGCAGCAATACAGACCAACAGGGCCTACAAGCTGGCAATCAGCCCCAGCATTTT	CASSNTDQQGLQAGNQPQHF	TRBV7-3	TRBJ1-5
TGTGCCAGCAGTAAGGAGTTTCAGGGGTTTTGCTACGAGCAGTACTTC	CASSKEFQGFCYEQYF	TRBV6-1	TRBJ2-7
TGTGCCATACTAGCGGGAGTTCATAGCAATCAGCCCCAGCATTTT	CAILAGVHSNQPQHF	TRBV10-3	TRBJ1-5
TGTGCCATCAGTGTCCGACGGTCGAGCGAGCAGTACTTC	CAISVRRSSEQYF	TRBV10-3	TRBJ2-7
TGTGCCAGCAGCCGGATATGGAAGCGGGAGTGTAACGAGCAGTACTTC	CASSRIWKRECNEQYF	TRBV14	TRBJ2-7
TGTGCCAGCAGGCTTCGGTGGACAGCGGATAGGAGGGCCGGGGAGCTGTTTTTT	CASRLRWTADRRAGELFF	TRBV5-4	TRBJ2-2
TGTGCCAGCAGACGAACTACTAGCGGGAGAGGGTTGAACACTGAAGCTTTCTTT	CASRRTTSGRGLNTEAFF	TRBV6-5	TRBJ1-1
TGTGCCAGCTCACCACCCCGGGGGGGGGGCACCGGGGAGCTGTTTTTT	CASSPPRGGGTGELFF	TRBV18	TRBJ2-2
TGTGCCAGCAGCTTAGATGAGCAGTTCTTC	CASSLDEQFF	TRBV6-1	TRBJ2-1
TGTGCCAGTAGGTGGGACAGGGGGACGAACACCGGGGAGCTGTTTTTT	CASRWDRGTNTGELFF	TRBV19	TRBJ2-2
TGTGCCAGCAGTTGCGGTAGGGGACGAGTGACTGGGGCCAACGTCCTGACTTTC	CASSCGRGRVTGANVLTF	TRBV6-8	TRBJ2-6
TGTGCCAGCAGCCAAGAGAACGCCTACGAGCAGTACTTC	CASSQENAYEQYF	TRBV3-1	TRBJ2-7
TGCAGTGCTAGAGGGAGCGAGGGGAACACTGAAGCTTTCTTT	CSARGSEGNTEAFF	TRBV20-1	TRBJ1-1
TGCAGTGCTAAGAGCGGCACCGACCTCTATGGCTACACCTTC	CSAKSGTDLYGYTF	TRBV20-1	TRBJ1-2
TGTGCCAGTAAGGGGACAGGGACGACTGGGGCCAACGTCCTGACTTTC	CASKGTGTTGANVLTF	TRBV6-6	TRBJ2-6
TGTGCCAGCAGCGTACCCGGGGGGGTATCTAACAATGAGCAGTTCTTC	CASSVPGGVSNNEQFF	TRBV9	TRBJ2-1
TGTGCCAGCAGCTGGAGCGACGCGGGGCTAGCCAAAAACATTCAGTACTTC	CASSWSDAGLAKNIQYF	TRBV5-6	TRBJ2-4
TGTGCCAGCAGTTTTACGGACAGGGGGCGGGCTGAAGCTTTCTTT	CASSFTDRGRAEAFF	TRBV7-9	TRBJ1-1
TGTGCCACCAGTGATTCGGGGGACAGGGAAACAAGGACCCAGTACTTC	CATSDSGDRETRTQYF	TRBV24-1	TRBJ2-5
TGTGCCACCAGTGATGGTGGCGGGGCCAAACCAGACAATGAGCAGTTCTTC	CATSDGGGAKPDNEQFF	TRBV24-1	TRBJ2-1
TGTGCCAGTAAACCAGGGGGGGGGGCTAATTCACCCCTCCACTTT	CASKPGGGANSPLHF	TRBV19	TRBJ1-6
TGTGCGTCTCCCCCTGGCCCACTAGCGGGAGGATATAATTCACCCCTCCACTTT	CASPPGPLAGGYNSPLHF	TRBV27	TRBJ1-6
TGTGCCAGCAGCCATCCCCTTAGCGGGATCACCGAGCAGTACTTC	CASSHPLSGITEQYF	TRBV14	TRBJ2-7
TGCGCCAGCAGCCATACCGGGGGGGACACAGATACGCAGTATTTT	CASSHTGGDTDTQYF	TRBV4-1	TRBJ2-3
TGTGCCAGCAGTTACGACAAAAACACCGGGGAGCTGTTTTTT	CASSYDKNTGELFF	TRBV6-5	TRBJ2-2
TGTGCCATCGGGGACAGGGGGCGAAACACTGAAGCTTTCTTT	CAIGDRGRNTEAFF	TRBV10-3	TRBJ1-1
TGCATGACCCAGGGACAGGGGAACACTGAAGCTTTCTTT	CMTQGQGNTEAFF	TRBV20-1	TRBJ1-1
TGTGCCAGCAGCTTGGACACGGCCGGGACAGGTGTTGCCAGCAATGAGCAGTTCTTC	CASSLDTAGTGVASNEQFF	TRBV5-6	TRBJ2-1
TGTGCCAGTCAGACATCGAGGGAAAAACTGTTTTTT	CASQTSREKLFF	TRBV6-5	TRBJ1-4
TGTGCCAGGCAGGCCAATCAGCCCCAGCATTTT	CARQANQPQHF	TRBV27	TRBJ1-5
TGTGCCAGAGCGAGGAGCTCTGGGGCCAACGTCCTGACTTTC	CARARSSGANVLTF	TRBV27	TRBJ2-6
TGCGCCAGCAGCCAAGTCTGTAAAACTAGGGTAGCAGAGCAGTTCTTC	CASSQVCKTRVAEQFF	TRBV4-1	TRBJ2-1
TGTGCCAGCAGCCCAGAAGACATAGCGGTTCGGGGGAATGAGCAGTTCTTC	CASSPEDIAVRGNEQFF	TRBV7-3	TRBJ2-1
TGTGCCATCAGTGAGCCTAACATGATCCGAGAACCGGGAGCAGATACGCAGTATTTT	CAISEPNMIREPGADTQYF	TRBV10-3	TRBJ2-3
TGTGCCAGCAACCCCCGGGACAGCCAGTACTTC	CASNPRDSQYF	TRBV2	TRBJ2-5
TGTGCCAGCAGGGACCCCATGCCGGGGGACCAGTTTCCCGGGGAGCTGTTTTTT	CASRDPMPGDQFPGELFF	TRBV27	TRBJ2-2
TGTGCCAGCAGTTTCCTCGCCCAGCATTTT	CASSFLAQHF	TRBV27	TRBJ1-5
TGCGCCAGCAGGGGGTCCTATAATTCACCCCTCCACTTT	CASRGSYNSPLHF	TRBV10-1	TRBJ1-6
TGTGCCAGCAGCTTAACGGCGTGGGCCCTCTCTTCGAACACCGGGGAGCTGTTTTTT	CASSLTAWALSSNTGELFF	TRBV13	TRBJ2-2
TGTGCCACCAACAGGGGGCGGGTAGGGCTCCCCTCTAGCACAGATACGCAGTATTTT	CATNRGRVGLPSSTDTQYF	TRBV24-1	TRBJ2-3
TGTGCCAGCAGAAGCTGGGACAGCCTCGCCCAGTACTTC	CASRSWDSLAQYF	TRBV14	TRBJ2-5
TGTGCCAGTCGTTGGTCGAACAAATTTGGGTACTTC	CASRWSNKFGYF	TRBV19	TRBJ2-7
TGTGCCAGCAGCTCAAAGGGTGATGACCTCTTGAGCCTTAGGACTGACGAGCAGTACTTC	CASSSKGDDLLSLRTDEQYF	TRBV7-2	TRBJ2-7
TGCAGTGCTATGTCCGAAGGCGAGGCAGCAATAAGGAATCAGCCCCAGCATTTT	CSAMSEGEAAIRNQPQHF	TRBV20-1	TRBJ1-5
TGTGCCAGCATCCGCAGTTACAATGAGCAGTTCTTC	CASIRSYNEQFF	TRBV5-4	TRBJ2-1
TGTGCCAGCAGTGAACCCCTATGGTACTACGAGCAGTACTTC	CASSEPLWYYEQYF	TRBV6-4	TRBJ2-7
TGTGCTAGTGGTCCTAGAAAGGGGGTAAGCAATCAGCCCCAGCATTTT	CASGPRKGVSNQPQHF	TRBV12-5	TRBJ1-5
TGTGCCAGCAGGTCCGGGACAGGGTTAAGCGAGCAGTACTTC	CASRSGTGLSEQYF	TRBV11-3	TRBJ2-7
TGTGCCAGCAGTTTAGCTGGGGACAGGGTCTGGCTGTTTTTT	CASSLAGDRVWLFF	TRBV12-4	TRBJ1-4
TGTGCCACCAGTGACCCCGGAGCGGACACTGAAGCTTTCTTT	CATSDPGADTEAFF	TRBV24-1	TRBJ1-1
TGCGCCAGCAGCCAAGGGATTTCACCCCTCCACTTT	CASSQGISPLHF	TRBV4-3	TRBJ1-6
TGTGCCACCAGCAGGGTGGGAAAACAGGGGCAGATAGCCAAAAACATTCAGTACTTC	CATSRVGKQGQIAKNIQYF	TRBV15	TRBJ2-4
TGTGCCAGCAGTGAAAACTTAGATCTCTGGCGGACAGGGCAGCAGCCCCAGCATTTT	CASSENLDLWRTGQQPQHF	TRBV6-4	TRBJ1-5
TGTGCCAGCCAGGGAGGTGGCTACACCTTC	CASQGGGYTF	TRBV12-3	TRBJ1-2
TGCGCCAGCAGCGCCCCGGGACTAGCGCAGTTCTTC	CASSAPGLAQFF	TRBV5-1	TRBJ2-1
TGCAGTGCTAGAGATCCCGGTCAGCCCCAGCATTTT	CSARDPGQPQHF	TRBV20-1	TRBJ1-5
TGTGCCAGCAGTGGCCGAGGGCCCCATGGCTACACCTTC	CASSGRGPHGYTF	TRBV6-1	TRBJ1-2
TGCAGTGCTAGAGACAAACTAGCGGGAGATATGAACACTGAAGCTTTCTTT	CSARDKLAGDMNTEAFF	TRBV20-1	TRBJ1-1
TGTGCCAGCAGCCGCGACAGGGTACGAAGGAATGAAAAACTGTTTTTT	CASSRDRVRRNEKLFF	TRBV7-9	TRBJ1-4
TGTGCCAGCAGTCCCGCCGGGACTAGAACCTTCACAGATACGCAGTATTTT	CASSPAGTRTFTDTQYF	TRBV5-6	TRBJ2-3
TGTGCCAGCAGCGTAGCCCCAGTTTTAGCCGGGAATAAGGGGCCTGAAGCTTTCTTT	CASSVAPVLAGNKGPEAFF	TRBV9	TRBJ1-1
TGTGCCAGCAGCCCCGGGACTATTTACGCGAACACCGGGGAGCTGTTTTTT	CASSPGTIYANTGELFF	TRBV7-9	TRBJ2-2
TGTGCCAGCAGCGCCAGGCTGGGCACAGATACGCAGTATTTT	CASSARLGTDTQYF	TRBV7-9	TRBJ2-3
TGCAGTGCTAGAGGAACTATGAATGGTCCGGACAGGGTTTGCTCCTACGAGCAGTACTTC	CSARGTMNGPDRVCSYEQYF	TRBV20-1	TRBJ2-7
TGTGCTAGTGGTTTGGTAGGGCTCAAAAACATTCAGTACTTC	CASGLVGLKNIQYF	TRBV12-5	TRBJ2-4
TGTGCCAGCAGCGTGACAGCCCTGTTTAGCAATCAGCCCCAGCATTTT	CASSVTALFSNQPQHF	TRBV11-2	TRBJ1-5
TGCGCCAGCAGCGACCGGGGGCCCTACGAGCAGTACTTC	CASSDRGPYEQYF	TRBV5-1	TRBJ2-7
TGCGCCAGCAGCCAAGATACCATCCGGACAGGGCGCGCGGATGGCTACACCTTC	CASSQDTIRTGRADGYTF	TRBV4-3	TRBJ1-2
TGTGCCAGCAGCTTAGTGGGAAGGCCTTCGGGGGCGGCTGGAAACACCATATATTTT	CASSLVGRPSGAAGNTIYF	TRBV11-1	TRBJ1-3
TGTGCCAGCAGCGGGGAACCACAGGGGATTTACGAGCAGTACTTC	CASSGEPQGIYEQYF	TRBV5-4	TRBJ2-7
TGTGCCAGCAGTTACTCGTTGTGCCCGCAGTATAGCAATCAGCCCCAGCATTTT	CASSYSLCPQYSNQPQHF	TRBV6-3	TRBJ1-5
TGTGCCAGCAGCCAAGATTTTAGCTCCTACAATGAGCAGTTCTTC	CASSQDFSSYNEQFF	TRBV14	TRBJ2-1
TGTGCCAGCAGCTGGAGCAAAACCCGAACCTACGAGCAGTACTTC	CASSWSKTRTYEQYF	TRBV7-8	TRBJ2-7
TGTGCCAGCAGTTGGAGGGTAGGGGAGACCCAGTACTTC	CASSWRVGETQYF	TRBV11-3	TRBJ2-5
TGCGCCAGCAGCTTCCCGTATGTTACTAGCGGGCTGGAGACCCAGTACTTC	CASSFPYVTSGLETQYF	TRBV5-1	TRBJ2-5
TGTGCCAGCAGTGAACACTCCCCTCCGAGGGTCGCAGGCCCGAACACTGAAGCTTTCTTT	CASSEHSPPRVAGPNTEAFF	TRBV2	TRBJ1-1
TGTGCCAGTAGTAGGGCTAGCGGGGGAACAGATACGCAGTATTTT	CASSRASGGTDTQYF	TRBV19	TRBJ2-3
TGTGCCAGCAGCTTGGATCTTCAGCCCCAGCATTTT	CASSLDLQPQHF	TRBV5-6	TRBJ1-5
TGTGCCAGCAGCCAAGCAGGGACACTGGAGCTGTTTTTT	CASSQAGTLELFF	TRBV3-1	TRBJ2-2
TGCGCCAGCAGCTTGGCGACCCTCGGGGGGAGCTATGGCTACACCTTC	CASSLATLGGSYGYTF	TRBV5-1	TRBJ1-2
TGTGCTAGCAGCTTATTAGCCGGGGGCAATGGCTACACCTTC	CASSLLAGGNGYTF	TRBV7-7	TRBJ1-2
TGTGCCTCAGCCTGGACACCGCCCATCGACAGGGTCTCTGGGGCCAACGTCCTGACTTTC	CASAWTPPIDRVSGANVLTF	TRBV30	TRBJ2-6
TGTGCCAGCAGCGGAGGGACAGGGGAGGGCAATCAGCCCCAGCATTTT	CASSGGTGEGNQPQHF	TRBV7-9	TRBJ1-5
TGCGCCAGCAGCTTGGGTAGCCCTATTGAAGCTTTCTTT	CASSLGSPIEAFF	TRBV5-1	TRBJ1-1
TGTGCCACCAGCTTTAAGGGACAATTCTCCGTACAGCCCCAGCATTTT	CATSFKGQFSVQPQHF	TRBV24-1	TRBJ1-5
TGTGCTTCGGCGGGGGTTTCGAACTCCTATAATTCACCCCTCCACTTT	CASAGVSNSYNSPLHF	TRBV2	TRBJ1-6
TGTGCCAGCAGTTCAAGTGCCGGGACAGGGATACACCCCTACAATGAGCAGTTCTTC	CASSSSAGTGIHPYNEQFF	TRBV12-4	TRBJ2-1
TGTGCCACCAAGCCTGGGGCTTCCTATGGCTACACCTTC	CATKPGASYGYTF	TRBV24-1	TRBJ1-2
TGCAGTGCCCTCCCGACAGGCACTGAAGCTTTCTTT	CSALPTGTEAFF	TRBV20-1	TRBJ1-1
TGCAGCGTTGACTACAATGAGCAGTTCTTC	CSVDYNEQFF	TRBV29-1	TRBJ2-1
TGTGCCATCAACAGGCCGCCGAAGTACTTC	CAINRPPKYF	TRBV6-4	TRBJ2-7
TGTGCCAGCAGTTACTCGAGGACGGAGTCTGCGGGACGGAAGAATCCATATGGCTACACCTTC	CASSYSRTESAGRKNPYGYTF	TRBV6-5	TRBJ1-2
TGTGCCAGCAGCTCTCAAGCAGGGTTGCCTGGGGCCAACGTCCTGACTTTC	CASSSQAGLPGANVLTF	TRBV7-2	TRBJ2-6
TGTGCCAGCAGCGTACTAGCGGGGAATGCCAGCTCCTACAATGAGCAGTTCTTC	CASSVLAGNASSYNEQFF	TRBV7-9	TRBJ2-1
TGTGCCAGCAAGGGGACTAGCGGGAAGATTGAGCAGTTCTTC	CASKGTSGKIEQFF	TRBV6-2	TRBJ2-1
TGTGCCAGCACCAATCCGGGCTGCCTGGCCTACGAGCAGTACTTC	CASTNPGCLAYEQYF	TRBV12-3	TRBJ2-7
TGTGCCAGCAGCCAATCCGTAGCGGTCTACGAGCAGTACTTC	CASSQSVAVYEQYF	TRBV14	TRBJ2-7
TGTGCCAGCAGCCCGGAAGATGAGCAGTTCTTC	CASSPEDEQFF	TRBV7-3	TRBJ2-1
TGTGCCAGCAGCTCGCAACGGGGGACCTTAGATAATGAAAAACTGTTTTTT	CASSSQRGTLDNEKLFF	TRBV7-2	TRBJ1-4
TGCAGTGCTGGGGGGAAGCAAGAGACCCAGTACTTC	CSAGGKQETQYF	TRBV20-1	TRBJ2-5
TGTGCTAGTGGTTTGGTAGGGACGTCCTATGGCTACACCTTC	CASGLVGTSYGYTF	TRBV12-5	TRBJ1-2
TGTGCCAGCAGACGACTAGCGGGTTATGAGCAGTTCTTC	CASRRLAGYEQFF	TRBV2	TRBJ2-1
TGCAGTGCTAGAGGATGCGCGCAAGAGACCCAGTACTTC	CSARGCAQETQYF	TRBV20-1	TRBJ2-5
TGCGCCAGCAGCTCCGGCCCACCCCGGGGGACCGGGCATAGCAATCAGCCCCAGCATTTT	CASSSGPPRGTGHSNQPQHF	TRBV5-1	TRBJ1-5
TGCGCCAGCAAACCCAGGATGGTTAGCACTGAAGCTTTCTTT	CASKPRMVSTEAFF	TRBV5-1	TRBJ1-1
TGTGCCAGTAGAGACAGGGGGTATAGCAATCAGCCCCAGCATTTT	CASRDRGYSNQPQHF	TRBV19	TRBJ1-5
TGCGCCAGCAGCAAGAATAGAGACACCGGGGAGCTGTTTTTT	CASSKNRDTGELFF	TRBV4-1	TRBJ2-2
TGTGCCAGCAGCCATGGACGGGAGGGGCAGCCCCAGCATTTT	CASSHGREGQPQHF	TRBV14	TRBJ1-5
TGTGCCAGCAGCAACCAAACCAGGGAGACCCAGTACTTC	CASSNQTRETQYF	TRBV12-3	TRBJ2-5
TGTGCCAGCAGCCCCTCCGGGACAGGGGTGACATACCGGGGCGAGCAGTACTTC	CASSPSGTGVTYRGEQYF	TRBV14	TRBJ2-7
TGTGCCAGCAGCTCGGAATCTAACAGGGGAGGTGGGGATCATCAGCCCCAGCATTTT	CASSSESNRGGGDHQPQHF	TRBV7-4	TRBJ1-5
TGTGCCAGCCATTTGGGCTCTGGAAACACCATATATTTT	CASHLGSGNTIYF	TRBV7-4	TRBJ1-3
TGTGCCAGCAGCGCGTTCCCCGGATATAGCAATCAGCCCCAGCATTTT	CASSAFPGYSNQPQHF	TRBV7-7	TRBJ1-5
TGTGCCAGCAGGGACGTTGACAGGGGGCCGGACAATGAGCAGTTCTTC	CASRDVDRGPDNEQFF	TRBV11-3	TRBJ2-1
TGTGCCAGCGGGCGGGACACCGATAGCAATCAGCCCCAGCATTTT	CASGRDTDSNQPQHF	TRBV6-1	TRBJ1-5
TGTGCCAGCAGGTCTAGCAGGGGGAGCGAGCAGTACTTC	CASRSSRGSEQYF	TRBV6-4	TRBJ2-7
TGTGCCAGCAGTGTATCCCCAGGAGCCGGTGAAGCTTTCTTT	CASSVSPGAGEAFF	TRBV6-1	TRBJ1-1
TGTGCCAGCAGCGCAGGAAAACGGCAGGGGGGAACCGGGGAGCTGTTTTTT	CASSAGKRQGGTGELFF	TRBV13	TRBJ2-2
TGCGCCAGCAGCCTATTTGGGGGGGGGACAGGGGGGAACAATGAGCAGTTCTTC	CASSLFGGGTGGNNEQFF	TRBV5-1	TRBJ2-1
TGTGCCAGTGCCCCCGGCACAGAAGAGCAGTTCTTC	CASAPGTEEQFF	TRBV28	TRBJ2-1
TGTGCCTGGAGTGTACCGGGACAGGGCCCCTCTAACTATGGCTACACCTTC	CAWSVPGQGPSNYGYTF	TRBV30	TRBJ1-2
TGTGCCAGCAGCTCCCCCCGGACAGGGGTTACTGAAGCTTTCTTT	CASSSPRTGVTEAFF	TRBV7-4	TRBJ1-1
TGTGCCAGCAGCAGGGGACAGGGGCTGAACACTGAAGCTTTCTTT	CASSRGQGLNTEAFF	TRBV13	TRBJ1-1
TGTGCCAGCAGTCTGGACTTAGAAAAACTGTTTTTT	CASSLDLEKLFF	TRBV2	TRBJ1-4
TGTGCCAGCAGCCAACCAGAACCCCCGCAACAGTTGACCCAGTACTTC	CASSQPEPPQQLTQYF	TRBV14	TRBJ2-5
TGTGCCAGCAAATGCCCCCAGACGTGGCAAGAGACCCAGTACTTC	CASKCPQTWQETQYF	TRBV27	TRBJ2-5
TGTGCCAGCAGCATCGGGGTTGCCCGGGGTGAAGCTTTCTTT	CASSIGVARGEAFF	TRBV6-1	TRBJ1-1
TGTGCCAGCAGCTCCCCGACAGGGGGCTCGCGGAGCTCCTACGAGCAGTACTTC	CASSSPTGGSRSSYEQYF	TRBV7-2	TRBJ2-7
TGTGCCAGCAGACCCCCTCCGGCATTTATTGATGAAGCTTTCTTT	CASRPPPAFIDEAFF	TRBV7-2	TRBJ1-1
TGTGCCAGCAGAAAACCGGGGGCCACAGATACGCAGTATTTT	CASRKPGATDTQYF	TRBV11-3	TRBJ2-3
TGTGCCAGCAGTTTCATTCAGGGGGGGACTGAAGCTTTCTTT	CASSFIQGGTEAFF	TRBV12-4	TRBJ1-1
TGTGCCAGCCAAAAACAGCCAGGGCCGCTAGCGGGCCGGGTTGCTCAAGAGACCCAGTACTTC	CASQKQPGPLAGRVAQETQYF	TRBV5-4	TRBJ2-5
TGCAGTGCGGCCCAGTCACAGGGGCCCTACGAGCAGTACTTC	CSAAQSQGPYEQYF	TRBV20-1	TRBJ2-7
TGCTCCCAGGGCGGACAGGGGACGGCAACTAATGAAAAACTGTTTTTT	CSQGGQGTATNEKLFF	TRBV20-1	TRBJ1-4
TGTGCCAGCAGTGAGACCGGGGGGGGTTCCTACAATGAGCAGTTCTTC	CASSETGGGSYNEQFF	TRBV6-1	TRBJ2-1
TGTGCCAGCAGGCCCAGAACTGAAGCTTTCTTT	CASRPRTEAFF	TRBV14	TRBJ1-1
TGTGCCAGCAGCTGTTTCGATAGGTCCTACAATGAGCAGTTCTTC	CASSCFDRSYNEQFF	TRBV11-3	TRBJ2-1
TGTGCCAGCAGCTCGGGGCTAACGAAGTACACTGAAGCTTTCTTT	CASSSGLTKYTEAFF	TRBV13	TRBJ1-1
TGTGCCAGCAGTCACGGGGACGGCTACACCTTC	CASSHGDGYTF	TRBV6-1	TRBJ1-2
TGTGCCAGCGGGGGAGATGAGCAGTACTTC	CASGGDEQYF	TRBV6-1	TRBJ2-7
TGTGCCAGCAGTGATAGGTTCCGGGACAGGGGGAACACTGAAGCTTTCTTT	CASSDRFRDRGNTEAFF	TRBV6-4	TRBJ1-1
TGTGCCAAGGCAGGCTGGAACACTGAAGCTTTCTTT	CAKAGWNTEAFF	TRBV7-8	TRBJ1-1
TGCAGTGCTAGAGAATTGAGGTACATGAACACTGAAGCTTTCTTT	CSARELRYMNTEAFF	TRBV20-1	TRBJ1-1
TGTGCCAGCAGCAAGGGGAGGAACGGGAGCGAGCAGTACTTC	CASSKGRNGSEQYF	TRBV7-3	TRBJ2-7
TGTGCCAGCAGCTGGGAACTAGGCCCACACTGCTATGGCTACACCTTC	CASSWELGPHCYGYTF	TRBV5-6	TRBJ1-2
TGTGCCAGCAGCTCTAGCGGGGTGAATTCAGATACGCAGTATTTT	CASSSSGVNSDTQYF	TRBV7-3	TRBJ2-3
TGTGCCAGCCCCCCCCGGACAGTTGATACGCAGTATTTT	CASPPRTVDTQYF	TRBV28	TRBJ2-3
TGTGCCAGCAGCTTGCCGAAAACGGGCCTGTACGAGCAGTACTTC	CASSLPKTGLYEQYF	TRBV5-4	TRBJ2-7
TGTGCCAGCAAACGGACAGGGCCGACCGAAAAACTGTTTTTT	CASKRTGPTEKLFF	TRBV7-9	TRBJ1-4
TGTGCCACCAGTAGCGGACCGGGGGGGCTTCAGCCCCAGCATTTT	CATSSGPGGLQPQHF	TRBV24-1	TRBJ1-5
TGTGCCACCAGTGATAGATCGCCCGGGACAGGGGTGGACTATGGCTACACCTTC	CATSDRSPGTGVDYGYTF	TRBV24-1	TRBJ1-2
TGTGCCAGCAGCGGCTGTAACAGGGGTAACACCATATATTTT	CASSGCNRGNTIYF	TRBV13	TRBJ1-3
TGTGCCAGCAGCCAAGTCGGCACAGGGGTGGAGGCCCCAGATACGCAGTATTTT	CASSQVGTGVEAPDTQYF	TRBV4-2	TRBJ2-3
TGTGCCAGCATAGGGGACTCTAATGAAAAACTGTTTTTT	CASIGDSNEKLFF	TRBV11-2	TRBJ1-4
TGCAGTGCTATACGAGCGGGAGGAAACACCATATATTTT	CSAIRAGGNTIYF	TRBV20-1	TRBJ1-3
TGCGCCAGCAGCTCCCCTCGGAAGGGGTACAGAGCCTACGAGCAGTACTTC	CASSSPRKGYRAYEQYF	TRBV5-1	TRBJ2-7
TGCAGCGTTGAAGATTCTTCGTGGGGACTTAGTGGCTACACCTTC	CSVEDSSWGLSGYTF	TRBV29-1	TRBJ1-2
TGTGCCTGGGGCCGGGACAGGGTTTGGGACACTAACTATGGCTACACCTTC	CAWGRDRVWDTNYGYTF	TRBV30	TRBJ1-2
TGTGCCAGCACCCCGGTCTACAATGAGCAGTTCTTC	CASTPVYNEQFF	TRBV6-4	TRBJ2-1
TGTGCCAGCGTTTCTCTCTATGGCTACACCTTC	CASVSLYGYTF	TRBV14	TRBJ1-2
TGTGCCATCGGAATTCGTAAACTGCAATGTCACTCCTACGAGCAGTACTTC	CAIGIRKLQCHSYEQYF	TRBV10-3	TRBJ2-7
TGTGCCAGCAGCGCTACAGATGTAACGAACACCGGGGAGCTGTTTTTT	CASSATDVTNTGELFF	TRBV9	TRBJ2-2
TGCAGTGCTACGGGGGGTTCCAGCTCCTACGAGCAGTACTTC	CSATGGSSSYEQYF	TRBV20-1	TRBJ2-7
TGCGCCAGCATCCAAGGGGAGGGTGGCAGCAATCAGCCCCAGCATTTT	CASIQGEGGSNQPQHF	TRBV10-1	TRBJ1-5
TGTGCCAGCAGCTTAACAGGAGGGGGCGCAAAAAAAGAGACCCAGTACTTC	CASSLTGGGAKKETQYF	TRBV7-3	TRBJ2-5
TGCGCCAGCAGTGAGTTTTCAGGGATGAGGGCCTACGAGCAGTACTTC	CASSEFSGMRAYEQYF	TRBV10-1	TRBJ2-7
TGTGCCAGCAGCCCCTGCAGATGGGGGGTCCCCTACGAGCAGTACTTC	CASSPCRWGVPYEQYF	TRBV11-3	TRBJ2-7
TGCGCCAGCAGCTGCCAGGACAGGGGGCGGAGTGGCTACACCTTC	CASSCQDRGRSGYTF	TRBV4-1	TRBJ1-2
TGTGCCAGCGCCCGGGCAAGGGGAAAAGACGAGCAGTACTTC	CASARARGKDEQYF	TRBV12-4	TRBJ2-7
TGCGCCAGCAGCATACCGTCGGGGCAATCCGAGCAGTACTTC	CASSIPSGQSEQYF	TRBV5-1	TRBJ2-7
TGTGCCAGCAGTTACAGGAACTTTCGCGGACAGGGGGCAAATTCACCCCTCCACTTT	CASSYRNFRGQGANSPLHF	TRBV6-5	TRBJ1-6
TGTGCCAGCAGCTTGGCAGGGGGGGCTGAAGCTTTCTTT	CASSLAGGAEAFF	TRBV7-4	TRBJ1-1
TGTGCCATGGGACAGGGGGGAGCCGGGGAGCTGTTTTTT	CAMGQGGAGELFF	TRBV10-3	TRBJ2-2
TGTGCCAGCATCGATGGGGGGGGCTACACCTTC	CASIDGGGYTF	TRBV6-1	TRBJ1-2
TGTGCCAGCAGCCCAGGGGGGGGCTACAATGAGCAGTTCTTC	CASSPGGGYNEQFF	TRBV3-1	TRBJ2-1
TGCAGTGCTACCGGGACCGTCCTCGAGCAGTACTTC	CSATGTVLEQYF	TRBV20-1	TRBJ2-7
TGTGCCAGCACGAACCCTTCCCACAGGGATGAAAAACTGTTTTTT	CASTNPSHRDEKLFF	TRBV7-3	TRBJ1-4
TGTGCCACCAGTGATTTGGTTAGCAGGCGATTACCTTTTTATAGCAATCAGCCCCAGCATTTT	CATSDLVSRRLPFYSNQPQHF	TRBV24-1	TRBJ1-5
TGTGCCACCACCCCCACTTCGGGACCTCCTCCAGACAATGAGCAGTTCTTC	CATTPTSGPPPDNEQFF	TRBV24-1	TRBJ2-1
TGTGGGGGACTCTCCTATAATTCACCCCTCCACTTT	CGGLSYNSPLHF	TRBV28	TRBJ1-6
TGTGCCAGCAGTTTCGGGGACAGTTATCAGCCCCAGCATTTT	CASSFGDSYQPQHF	TRBV27	TRBJ1-5
TGTGCCAGCAGCCAAGACACCAGTCAGCAAGGGGGTGGGCGGCCTAATGAAAAACTGTTTTTT	CASSQDTSQQGGGRPNEKLFF	TRBV14	TRBJ1-4
TGTGCCAGCAGCTTAGGAGGGGGGGGAGATACGCAGTATTTT	CASSLGGGGDTQYF	TRBV7-2	TRBJ2-3
TGCGCCAGCAGCCAACACCATTCCCCCCCCGGGACAAATGATTTCTCCTACGAGCAGTACTTC	CASSQHHSPPGTNDFSYEQYF	TRBV4-3	TRBJ2-7
TGTGCCAGCAGCCAAGAGCCGCCCGGGGGCACAGATACGCAGTATTTT	CASSQEPPGGTDTQYF	TRBV14	TRBJ2-3
TGTGCCAGCAGTAACACACAGATCTACTTGGTATGGACTGAAGCTTTCTTT	CASSNTQIYLVWTEAFF	TRBV27	TRBJ1-1
TGCGCCAGCAGGGGTGTGGGCCGGGTCACTGAAGCTTTCTTT	CASRGVGRVTEAFF	TRBV10-1	TRBJ1-1
TGTGCCAGCAGTGCCCTCATAATCCTAATGAAGGCCTACGAGCAGTACTTC	CASSALIILMKAYEQYF	TRBV6-4	TRBJ2-7
TGCAGTGCTACCCCCTCGGGGCTGGACTATGGCTACACCTTC	CSATPSGLDYGYTF	TRBV20-1	TRBJ1-2
TGTGCCTGGAGTGTAATTAGAATAACGAACACTGAAGCTTTCTTT	CAWSVIRITNTEAFF	TRBV30	TRBJ1-1
TGTGCCAGCAGCAGAGAGAGGGAGAGTAGCTCCTATAATTCACCCCTCCACTTT	CASSRERESSSYNSPLHF	TRBV13	TRBJ1-6
TGTGCCAGCAGTTTACGCGGGACGTGGGGTCAGCCCCAGCATTTT	CASSLRGTWGQPQHF	TRBV27	TRBJ1-5
TGTGCTAGTGGTTTGTGGCTTCAGGAGGAAAAACTGTTTTTT	CASGLWLQEEKLFF	TRBV12-5	TRBJ1-4
TGTGCCAGCAGTCCCATTTCAGGTTATGAGCAGTTCTTC	CASSPISGYEQFF	TRBV6-5	TRBJ2-1
TGTGCCAGCAGTTTCTGCAGTAGCATCGGTCAGCCCCAGCATTTT	CASSFCSSIGQPQHF	TRBV12-4	TRBJ1-5
TGTGCCAGCAGCGTAGGCCGGAAGGCTCGTACTTACACTGAAGCTTTCTTT	CASSVGRKARTYTEAFF	TRBV9	TRBJ1-1
TGTGCCAGCAGCTTAGGAAGCGGGAACGGCTACACCTTC	CASSLGSGNGYTF	TRBV7-8	TRBJ1-2
TGTGCCAGCAGCCCTACGGCCGGAGTCAGAACCCATCAGCCCCAGCATTTT	CASSPTAGVRTHQPQHF	TRBV7-2	TRBJ1-5
TGTGCCAGCAGTTTGCTTGACAGGCACAATCAGCCCCAGCATTTT	CASSLLDRHNQPQHF	TRBV27	TRBJ1-5
TGCGCCAGCAGCTTGAATATTTCCGACGAGACCCAGTACTTC	CASSLNISDETQYF	TRBV5-1	TRBJ2-5
TGTGCCAGCAGCGTCCTAACAGGGGATACCCCCGAGACCCAGTACTTC	CASSVLTGDTPETQYF	TRBV9	TRBJ2-5
TGTGCCTGGAGTTCCCTCCGGGACGGGGCTGGAAACACCATATATTTT	CAWSSLRDGAGNTIYF	TRBV30	TRBJ1-3
TGTGCCAGCAGCTTGTGGGGGAAGAGGGAAGGCTACACCTTC	CASSLWGKREGYTF	TRBV5-4	TRBJ1-2
TGCAGTGCTAGAGATCCGTCTGGCCCGGGACGCGTCCGGTCGGACACCATATATTTT	CSARDPSGPGRVRSDTIYF	TRBV20-1	TRBJ1-3
TGCGCCAGCAGCTGGGGGGGGAACAATGAGCAGTTCTTC	CASSWGGNNEQFF	TRBV5-1	TRBJ2-1
TGCGCCAGCAGCCAGCTTATCGGGACATGTGACTACAATGAGCAGTTCTTC	CASSQLIGTCDYNEQFF	TRBV4-1	TRBJ2-1
TGTGCCAGTACAACCGTGGGACAGATGAATCAGCCCCAGCATTTT	CASTTVGQMNQPQHF	TRBV19	TRBJ1-5
TGTGCCAGCACTTGTCACGGGGTTAATCAGCCCCAGCATTTT	CASTCHGVNQPQHF	TRBV7-3	TRBJ1-5
TGTGCCAGCAGCCAAGGGGGGAGGGACAGGCTTGGGTCTAATGAAAAACTGTTTTTT	CASSQGGRDRLGSNEKLFF	TRBV3-1	TRBJ1-4
TGTGCCAGCAGCCAAGAAACCTTTCTAGGGAAGCCGCAGTTAGGAGGCACAGATACGCAGTATTTT	CASSQETFLGKPQLGGTDTQYF	TRBV14	TRBJ2-3
TGTGCCAGCAACCAGGTGACCAATCAGCCCCAGCATTTT	CASNQVTNQPQHF	TRBV5-6	TRBJ1-5
TGTGCCATCAGTGACAGGGGCGGGAACACTGAAGCTTTCTTT	CAISDRGGNTEAFF	TRBV10-3	TRBJ1-1
TGTGCCAGCAGCTTCCCCGAGACTGGAGGTCCCCGTCCCGCCCCGGTCAGTTACCTCTGCACCGGGGAGCTGTTTTTT	CASSFPETGGPRPAPVSYLCTGELFF	TRBV11-2	TRBJ2-2
TGTGCCAGCAGCTCCCTACCTTGGTGGCATGGCGAGACCCAGTACTTC	CASSSLPWWHGETQYF	TRBV13	TRBJ2-5
TGTGCCAGCAGCCCTCCGCCACTAGCGGGGCCTTATGAGCAGTTCTTC	CASSPPPLAGPYEQFF	TRBV5-6	TRBJ2-1
TGTGCCAGCAAACTAGCGGGGGTTTACGAGCAGTACTTC	CASKLAGVYEQYF	TRBV6-3	TRBJ2-7
TGTGCCAGCAGCCAAGCAAGGGCCCCGACAGCTACTGCAACTAATGAAAAACTGTTTTTT	CASSQARAPTATATNEKLFF	TRBV4-2	TRBJ1-4
TGTGCCAGCAGCCAGGGGCTCCACTTT	CASSQGLHF	TRBV4-2	TRBJ1-6
TGTGCCAAATTTCCAGGCCGCAGATCCCGGGAGCCTCCCTATGGCTACACCTTC	CAKFPGRRSREPPYGYTF	TRBV6-1	TRBJ1-2
TGTGCCATCAGTGAGAGGGACAGATTTCAGCCCCAGCATTTT	CAISERDRFQPQHF	TRBV10-3	TRBJ1-5
TGTGCCAGCAGTGAATCGGCTATATTAGGGGTCGAGCAGTACTTC	CASSESAILGVEQYF	TRBV6-1	TRBJ2-7
TGTGCCAGCAGCACTGTACCATGGGGTCGGGCCTACGAGCAGTACTTC	CASSTVPWGRAYEQYF	TRBV13	TRBJ2-7
TGTGCCAGCAGCCGGGACAGGGGGCGTGCAACTAATGAAAAACTGTTTTTT	CASSRDRGRATNEKLFF	TRBV13	TRBJ1-4
TGTGCCAGCAGTTACTCGAGGACAGGACGCTACGAGCAGTACTTC	CASSYSRTGRYEQYF	TRBV6-6	TRBJ2-7
TGTGCCAGCAGCCCTGACAGGGACGGGACCGGGGAGCTGTTTTTT	CASSPDRDGTGELFF	TRBV7-3	TRBJ2-2
TGTGCCAGCAGTTTAGAAAGGACAGGGGGCTACACAGATACGCAGTATTTT	CASSLERTGGYTDTQYF	TRBV12-4	TRBJ2-3
TGTGCCAGCATCGATCCCCGTGGACAGGGGGGGCGTTTGAAGTACAATCAGCCCCAGCATTTT	CASIDPRGQGGRLKYNQPQHF	TRBV6-5	TRBJ1-5
TGCATCTCTGTGGGACAGGGGAATAGCAATCAGCCCCAGCATTTT	CISVGQGNSNQPQHF	TRBV20-1	TRBJ1-5
TGCGCCAGCAGCCAAGTAAGGGACAGATACTATGGCTACACCTTC	CASSQVRDRYYGYTF	TRBV4-1	TRBJ1-2
TGTGCCAGCAGGGGCCGGATAGCCGCCTACGAGCAGTACTTC	CASRGRIAAYEQYF	TRBV6-4	TRBJ2-7
TGTGCCAGCAGCTTATTCACGCCACTAGCGGCTAATGAGCAGTTCTTC	CASSLFTPLAANEQFF	TRBV11-2	TRBJ2-1
TGTGCTAGTGGGGTAAAATGTGGGACAGGGGAGGACGAGCAGTACTTC	CASGVKCGTGEDEQYF	TRBV12-5	TRBJ2-7
TGCGCCAGCAGCTCCGCCAGGTTTGAAGCTTTCTTT	CASSSARFEAFF	TRBV5-1	TRBJ1-1
TGTGCCAGCAGCGGATGGAGGGATACGCAGTATTTT	CASSGWRDTQYF	TRBV7-4	TRBJ2-3
TGCAGTGCTAGAGATGATTCCTGGGTGGTGGGAGGGGCCCCCGGGGAGCTGTTTTTT	CSARDDSWVVGGAPGELFF	TRBV20-1	TRBJ2-2
TGTGCCAGCATGGACAGGGAGACTGAGCAGTACTTC	CASMDRETEQYF	TRBV12-4	TRBJ2-7
TGTGCCAGCAGTTCGACTGCTGAGACCCAGTACTTC	CASSSTAETQYF	TRBV6-8	TRBJ2-5
TGCAGTGCTAGAGATGAAAACCAAGGCCAGGGGGCGGTCGGTGAAGCTTTCTTT	CSARDENQGQGAVGEAFF	TRBV20-1	TRBJ1-1
TGTGCCAGCAGCCTCGGGGCCGGTGACAATCCGAGGGACACTGAAGCTTTCTTT	CASSLGAGDNPRDTEAFF	TRBV7-3	TRBJ1-1
TGTGCCTGGCGACCCCGTATTATCCCTGGCCGCTGGAGCAATCAGCCCCAGCATTTT	CAWRPRIIPGRWSNQPQHF	TRBV30	TRBJ1-5
TGTGCCAAACTTGGTCCCCGGACACGACCCTACGAGCAGTACTTC	CAKLGPRTRPYEQYF	TRBV19	TRBJ2-7
TGTGCCAGCAGCAGCTATGGCTACACCTTC	CASSSYGYTF	TRBV6-5	TRBJ1-2
TGTGCCAGCAGCCGGGGGGGGGGATACAATGAGCAGTTCTTC	CASSRGGGYNEQFF	TRBV3-1	TRBJ2-1
TGTGCCACCAGCAGAGCACCAAAAGGGGGGCTTCGATCCTACAATGAGCAGTTCTTC	CATSRAPKGGLRSYNEQFF	TRBV15	TRBJ2-1
TGCGCCAGCATGGGGCTAGGCCAAGCTTTCTTT	CASMGLGQAFF	TRBV10-1	TRBJ1-1
TGCGCCAGCAGCTTGGCCCAGGAGGGACAGGGGGCCCGGGATGGCTACACCTTC	CASSLAQEGQGARDGYTF	TRBV5-1	TRBJ1-2
TGCAGTGCTTCCCGTTGGACAGGCCGGTTATGGGACGAGCAGTACTTC	CSASRWTGRLWDEQYF	TRBV20-1	TRBJ2-7
TGTGCCAGCAGAGGTGCCGGGACAAAACTGTTTTTT	CASRGAGTKLFF	TRBV13	TRBJ1-4
TGCAGTGCTAGAGATCTGTCAGGGTTCCATCAGCCCCAGCATTTT	CSARDLSGFHQPQHF	TRBV20-1	TRBJ1-5
TGTGCCAGCAGCTGGGTTTTAAACACCGGGGAGCTGTTTTTT	CASSWVLNTGELFF	TRBV7-9	TRBJ2-2
TGTGCCAGCATTAGGGGTAGGGGCGATGGCTACACCTTC	CASIRGRGDGYTF	TRBV9	TRBJ1-2
TGTGCCAGCAGTTCCGGGACAGGGGGAAGTTTAACCGAGCAGTACTTC	CASSSGTGGSLTEQYF	TRBV28	TRBJ2-7
TGTGCCATAATGTTGGGACTAGCGGGTATAGAGACCCAGTACTTC	CAIMLGLAGIETQYF	TRBV27	TRBJ2-5
TGTGCCAGCGGTGGCCGAGACATCTACGAGCAGTACTTC	CASGGRDIYEQYF	TRBV30	TRBJ2-7
TGTGCCACCAGTGATTTCCCGTTCCACATTAGCGGGGCACTGACCGGGGAGCTGTTTTTT	CATSDFPFHISGALTGELFF	TRBV24-1	TRBJ2-2
TGTGCCAGCAGCATGGGAGGGGAATACGAGCAGTACTTC	CASSMGGEYEQYF	TRBV13	TRBJ2-7
TGTGCCAGCAGCTCCCGGGACGAGAACTATGGCTACACCTTC	CASSSRDENYGYTF	TRBV13	TRBJ1-2
TGTGCCAGCATACCCCACCCCCTTCGGGGACCGTCCTACGAGCAGTACTTC	CASIPHPLRGPSYEQYF	TRBV7-3	TRBJ2-7
TGTGCCAGCAGCGGTGGAGTGGAGGGACGATATAGCAATCAGCCCCAGCATTTT	CASSGGVEGRYSNQPQHF	TRBV11-3	TRBJ1-5
TGTGCCAGCAGCTTCCAAGGGTGGGGGAACTGGTACGAGCAGTACTTC	CASSFQGWGNWYEQYF	TRBV7-9	TRBJ2-7
TGTGCCACCAGTGATTTTCCGGAAAAGACAGGGGGCGAGAATGAGCAGTTCTTC	CATSDFPEKTGGENEQFF	TRBV24-1	TRBJ2-1
TGTGCCAGCACTGGGCTCAGGGGAGAGGTCTATGGCTACACCTTC	CASTGLRGEVYGYTF	TRBV2	TRBJ1-2
TGTGCCAGAGGGAGCACAACTAATGAAAAACTGTTTTTT	CARGSTTNEKLFF	TRBV19	TRBJ1-4
TGTGCCAGCAGCGGTCAGGACAGGGGGAACGTCACAGATACGCAGTATTTT	CASSGQDRGNVTDTQYF	TRBV11-2	TRBJ2-3
TGTGCCAGCAGTTCGGCATCGGAGACTAGCGGGGACGGGGTCTTC	CASSSASETSGDGVF	TRBV12-4	TRBJ2-1
TGTGCCCTCACCAATCAGCCCCAGCATTTT	CALTNQPQHF	TRBV6-5	TRBJ1-5
TGCAGCGTTGATTTTGAGGGTTTTTACTACGAGCAGTACTTC	CSVDFEGFYYEQYF	TRBV29-1	TRBJ2-7
TGTGCCAGGAGAGGTGACAGGAAACCTAGCAATCAGCCCCAGCATTTT	CARRGDRKPSNQPQHF	TRBV6-4	TRBJ1-5
TGCGCCAGCAGCCCCAACACAGGGGGAGTGAACACTGAAGCTTTCTTT	CASSPNTGGVNTEAFF	TRBV5-1	TRBJ1-1
TGTGCCAGCAGTTACTCGAGGGACTGGATCGTGGGAGCCTACGAGCAGTACTTC	CASSYSRDWIVGAYEQYF	TRBV6-5	TRBJ2-7
TGTGCCAGCCGTAGTGAGTACGAGCAGTACTTC	CASRSEYEQYF	TRBV5-6	TRBJ2-7
TGTGCCAGCAGCCGCACGGGAGAGGTCCCGGGACAGACTGAAGCTTTCTTT	CASSRTGEVPGQTEAFF	TRBV11-2	TRBJ1-1
TGTGCCCCCGGGCTGAGAGGACTGTTTTTT	CAPGLRGLFF	TRBV30	TRBJ1-4
TGTGCCAGCAGTGTTAAGACTAGCGGGGCGGGGCCGAGTTGCACAGATACGCAGTATTTT	CASSVKTSGAGPSCTDTQYF	TRBV2	TRBJ2-3
TGTGCCTGGAGTGCCCTACCGGGACTAGGAGTTAATGAGCAGTTCTTC	CAWSALPGLGVNEQFF	TRBV30	TRBJ2-1
TGTGCCAGCAGCCTCGTGGGACAGGGGGCGCGAAGTTTAAGCTCCTACGAGCAGTACTTC	CASSLVGQGARSLSSYEQYF	TRBV3-1	TRBJ2-7
TGTGCCTGGTTTGGGGACGGTCAAGAGACCCAGTACTTC	CAWFGDGQETQYF	TRBV30	TRBJ2-5
TGTGCCAGCAGTTACGGATCACCGCAGGGGTACGAGCAGTACTTC	CASSYGSPQGYEQYF	TRBV6-5	TRBJ2-7
TGTGCCAGCAGTTTATTTACAGGCTACGAGCAGTACTTC	CASSLFTGYEQYF	TRBV28	TRBJ2-7
TGTGCCAGCAACAGGGGGGAGTCGAACACCGGGGAGCTGTTTTTT	CASNRGESNTGELFF	TRBV6-5	TRBJ2-2
TGCAGCGTGGAGGGTTCTATGGCAGCAACTAATGAAAAACTGTTTTTT	CSVEGSMAATNEKLFF	TRBV29-1	TRBJ1-4
TGCGCCAGACAGACTGCAACTAATGAAAAACTGTTTTTT	CARQTATNEKLFF	TRBV10-2	TRBJ1-4
TGTGCCAGCAGTCGGATACTTCGGGACAGGGGGAAGGTCCAGCCCCAGCATTTT	CASSRILRDRGKVQPQHF	TRBV6-6	TRBJ1-5
TGTGCCACCATTGCGAAGGGGACAGGGATAGGTGAAAAACTGTTTTTT	CATIAKGTGIGEKLFF	TRBV24-1	TRBJ1-4
TGTGCCAGCCCAAGGGGGGGGCGTGAGACCCAGTACTTC	CASPRGGRETQYF	TRBV9	TRBJ2-5
TGTGCCAGCAGTGACTCTAAGGGACTGAGGGAGACCCAGTACTTC	CASSDSKGLRETQYF	TRBV6-4	TRBJ2-5
TGTGCCAGCAGCAGGGGACAGGGCCCACCTAACTATGGCTACACCTTC	CASSRGQGPPNYGYTF	TRBV7-3	TRBJ1-2
TGTGCCAGCAGTTCTCCCCAGGGCCCGTACAATGAGCAGTTCTTC	CASSSPQGPYNEQFF	TRBV28	TRBJ2-1
TGTGCCGCCGACAGGGGCTACGAGCAGTACTTC	CAADRGYEQYF	TRBV9	TRBJ2-7
TGTGCCAGCAAAGTAGGTCGATCCTACAATGAGCAGTTCTTC	CASKVGRSYNEQFF	TRBV28	TRBJ2-1
TGTGCCACCAGACCCGGGGGGGTAGCGGGTTTCACGATCTCCTACAATGAGCAGTTCTTC	CATRPGGVAGFTISYNEQFF	TRBV24-1	TRBJ2-1
TGTGCTAGTGGTTTGGTAGGTTACAGGGGCTGCTATGGCTACACCTTC	CASGLVGYRGCYGYTF	TRBV12-5	TRBJ1-2
TGTGCCAGCAGAATGGGTCTGTGGGGGGGAACCTACAATGAGCAGTTCTTC	CASRMGLWGGTYNEQFF	TRBV6-4	TRBJ2-1
TGCGCCAGCAGCACCTTAAGTCCTGGCTACACCTTC	CASSTLSPGYTF	TRBV5-1	TRBJ1-2
TGTGCCAGCCAGTTCGGGGGCTACGAGCAGTACTTC	CASQFGGYEQYF	TRBV6-1	TRBJ2-7
TGTGCCAGCAGCCAAGATCAGTGTACCCCACAGGGAAAACTCGAGAGCTACACTGAAGCTTTCTTT	CASSQDQCTPQGKLESYTEAFF	TRBV14	TRBJ1-1
TGTGCCAGCAGTGCCGGTAAGTTATCCCGGGGGCTCACTGAAGCTTTCTTT	CASSAGKLSRGLTEAFF	TRBV6-1	TRBJ1-1
TGTGCCAGCAGCGCCCGACTAGCGGGAGGGGAGCAGTACTTC	CASSARLAGGEQYF	TRBV7-3	TRBJ2-7
TGTGCCAGCAGCGACCTGGGACATAGCTCTGGAAACACCATATATTTT	CASSDLGHSSGNTIYF	TRBV9	TRBJ1-3
TGTGCCAGTAGGACTTGTCCGGTCTGTAGCTACGAGCAGTACTTC	CASRTCPVCSYEQYF	TRBV19	TRBJ2-7
TGTGCCATCAGTGAAGCGGACAGCGGGCCGGAGTACGAGCAGTACTTC	CAISEADSGPEYEQYF	TRBV10-3	TRBJ2-7
TGTGCCACACAGCCACAGAACTACGAGCAGTACTTC	CATQPQNYEQYF	TRBV6-3	TRBJ2-7
TGTGCCAGTAGACCATCTCCGAATTTTCCCACAGATACGCAGTATTTT	CASRPSPNFPTDTQYF	TRBV27	TRBJ2-3
TGTGCCAGCAGCGTTCTCCATAGGGTCCCCATTAGCAATCAGCCCCAGCATTTT	CASSVLHRVPISNQPQHF	TRBV9	TRBJ1-5
TGTGCCAGCAGCCAAAGGGCCCACAGGGGGCGAAGCTACGAGCAGTACTTC	CASSQRAHRGRSYEQYF	TRBV14	TRBJ2-7
TGTGCCAGCAGTGACGGACAGGGGTTATACATTCAGTACTTC	CASSDGQGLYIQYF	TRBV6-4	TRBJ2-4
TGCAGCGCCGGGACAGGGCCGTACGAGCAGTACTTC	CSAGTGPYEQYF	TRBV29-1	TRBJ2-7
TGTGCCAGCAGTTCAGGGGGCTCTAATTCACCCCTCCACTTT	CASSSGGSNSPLHF	TRBV28	TRBJ1-6
TGTGCCAGCAGTCGACAGGGCGATAACTATGGCTACACCTTC	CASSRQGDNYGYTF	TRBV12-4	TRBJ1-2
TGCAGTGCTAGAGCCGCAGGGTTTCAGGAGAACACCGGGGAGCTGTTTTTT	CSARAAGFQENTGELFF	TRBV20-1	TRBJ2-2
TGTGCCAGTTGCAATAGGGGTGGTTGCTGCAATCAGCCCCAGCATTTT	CASCNRGGCCNQPQHF	TRBV10-3	TRBJ1-5
TGTGCCAGCATCCCCTCCGGGACGCGGAACTACGAGCAGTACTTC	CASIPSGTRNYEQYF	TRBV27	TRBJ2-7
TGCGCCAGCAGATTCCGGGACAGTAGCTACGAGCAGTACTTC	CASRFRDSSYEQYF	TRBV5-1	TRBJ2-7
TGTGCCAGCAGCGTCCCGGGACACTACGAGCAGTACTTC	CASSVPGHYEQYF	TRBV13	TRBJ2-7
TGTGCCTGGAGTGTAAATGAGTCCAGGGCTTTGAGAGAGAACACTGAAGCTTTCTTT	CAWSVNESRALRENTEAFF	TRBV30	TRBJ1-1
TGCGCCAGCAGCTTGGTTCGGACAGGGACGAGTCAGCCCCAGCATTTT	CASSLVRTGTSQPQHF	TRBV5-1	TRBJ1-5
TGTGCCAGCAGCCACGACGCCCTTTCACCCCTCCACTTT	CASSHDALSPLHF	TRBV7-3	TRBJ1-6
TGTGCCAGCAGCGGCCGGGACACACGGAGTGGCTACACCTTC	CASSGRDTRSGYTF	TRBV3-1	TRBJ1-2
TGTGCCAGCAGCAACAGTCACTATGGCTACACCTTC	CASSNSHYGYTF	TRBV11-2	TRBJ1-2
TGTGCCAGCAGCCAAGATTTTAAGAGCAGATACTCTGGGGCCAACGTCCTGACTTTC	CASSQDFKSRYSGANVLTF	TRBV14	TRBJ2-6
TGTGCTAGTGGTTCTCTCGAGACAGGGGAGACGGGGATGAACACTGAAGCTTTCTTT	CASGSLETGETGMNTEAFF	TRBV12-5	TRBJ1-1
TGTGCCAGCAGCACAACCATGAACACTGAAGCTTTCTTT	CASSTTMNTEAFF	TRBV13	TRBJ1-1
TGTGCCAGCAGCGGGCAATGCTCCTACGAGCAGTACTTC	CASSGQCSYEQYF	TRBV9	TRBJ2-7
TGTGCCAGCAGTGAATTCGGGACTAGCGGGGACCCTCCTCGGAGCACAGATACGCAGTATTTT	CASSEFGTSGDPPRSTDTQYF	TRBV25-1	TRBJ2-3
TGTGCCAGCAGCTTGCTGGGGCAGTACTTC	CASSLLGQYF	TRBV5-5	TRBJ2-7
TGTGCCAGCAGCCAAGGTCCGTCGTGGACAGACGACACCATATATTTT	CASSQGPSWTDDTIYF	TRBV14	TRBJ1-3
TGCGCCAGCAGCGCAGGGATAAACAATCAGCCCCAGCATTTT	CASSAGINNQPQHF	TRBV5-1	TRBJ1-5
TGTGCCAGCATGGGGGATGACACCGGGGAGCTGTTTTTT	CASMGDDTGELFF	TRBV6-2	TRBJ2-2
TGCAGTGCTAGAGTGATCCGGGACACAACCTACAATGAGCAGTTCTTC	CSARVIRDTTYNEQFF	TRBV20-1	TRBJ2-1
TGTGCCAGCAGGGAGAGGGAACCTACCGAGCAGTACTTC	CASREREPTEQYF	TRBV12-4	TRBJ2-7
TGTGCCAGCAGCTTGGCCATACTAGCGGGCAACAAACCCTACGAGCAGTACTTC	CASSLAILAGNKPYEQYF	TRBV5-4	TRBJ2-7
TGTGCCAGCGCGGCTAGCGGGGTTATGTCAGATACGCAGTATTTT	CASAASGVMSDTQYF	TRBV27	TRBJ2-3
TGTGCCAGCAGCTTAGCGGTCTCAGTTAATGAAAAACTGTTTTTT	CASSLAVSVNEKLFF	TRBV7-8	TRBJ1-4
TGCGCCAGCAGCCAAGCTAAACGAATACTTCACACCGGGGAGCTGTTTTTT	CASSQAKRILHTGELFF	TRBV4-3	TRBJ2-2
TGTGCCAGCAGTGACTTCTCTGCGGGAGGGGCTAACTATGGCTACACCTTC	CASSDFSAGGANYGYTF	TRBV6-4	TRBJ1-2
TGTGCCAGCAGCTTGGTCAGCGGAAGCTACAATGAGCAGTTCTTC	CASSLVSGSYNEQFF	TRBV5-6	TRBJ2-1
TGTGCCAGCAGCTTAGGCAGGGGACTAGCGGTAGACTCCTACAATGAGCAGTTCTTC	CASSLGRGLAVDSYNEQFF	TRBV11-2	TRBJ2-1
TGTGCCATTGACGGGGGAAACACCATATATTTT	CAIDGGNTIYF	TRBV19	TRBJ1-3
TGTGCCAGCAGTTACAACAAGGGACAGTACTTTTTTGGAAACACCATATATTTT	CASSYNKGQYFFGNTIYF	TRBV12-3	TRBJ1-3
TGTGCCACCAGCCGACATGGCAATCAGCCCCAGCATTTT	CATSRHGNQPQHF	TRBV15	TRBJ1-5
TGTGCCACCAGCTCTCGGGACAGGGGCCACGATTCACCCCTCCACTTT	CATSSRDRGHDSPLHF	TRBV15	TRBJ1-6
TGTGCCAGCACCCTAGCGCTTCTTAGCTCCTACGAGCAGTACTTC	CASTLALLSSYEQYF	TRBV6-3	TRBJ2-7
TGCAGTGCTGACCAAGCCCCCGAGACCCAGTACTTC	CSADQAPETQYF	TRBV20-1	TRBJ2-5
TGTGCCTGGAAGACCAGGGGGAACTATGGCTACACCTTC	CAWKTRGNYGYTF	TRBV30	TRBJ1-2
TGTGCCAGCAGCCCCCGGCAAAACATTCAGTACTTC	CASSPRQNIQYF	TRBV5-4	TRBJ2-4
TGTGCCAGCAGTTACGACTATGAGGGGGACGAGCAGTACTTC	CASSYDYEGDEQYF	TRBV6-6	TRBJ2-7
TGTGCCAGCAGGCGGGGCGGAGGTGGACTAGCGGGTAAAGTCGCCTACAATGAGCAGTTCTTC	CASRRGGGGLAGKVAYNEQFF	TRBV6-5	TRBJ2-1
TGTGCCAGCAGCTTAGGTGGACTAGTCAGTAAGCAGTACTTC	CASSLGGLVSKQYF	TRBV7-2	TRBJ2-7
TGTGCCAGCACCCGCATCAGTAGGGGCTACAATGAGCAGTTCTTC	CASTRISRGYNEQFF	TRBV4-2	TRBJ2-1
TGTGCCAGCAGCCCGAGGGAATTGGTCTATGGCTACACCTTC	CASSPRELVYGYTF	TRBV9	TRBJ1-2
TGTGCCAGCAGTCTTCCAGTGGGCCTGGAGAGAACAGTGGGAGGATCGAGCGAGCAGTACTTC	CASSLPVGLERTVGGSSEQYF	TRBV27	TRBJ2-7
TGTGCCAGCCGTGGTGGGACTAGCGGCACAGATACGCAGTATTTT	CASRGGTSGTDTQYF	TRBV19	TRBJ2-3
TGTGGAATCGACCAGCCGGGACTAGCGGGAGCGTGTTGCAATCAGCCCCAGCATTTT	CGIDQPGLAGACCNQPQHF	TRBV2	TRBJ1-5
TGTGCCAGCAGCCTCCCGACAGGGGGCGACCAAGCTTTCTTT	CASSLPTGGDQAFF	TRBV5-4	TRBJ1-1
TGTGCCAGCAGCAAACTAGCGGGGCCTGGGGCCAACGTCCTGACTTTC	CASSKLAGPGANVLTF	TRBV13	TRBJ2-6
TGTGCCAGCAGCTTAGCTTTAGAGGGCTGGATCCAGAACATTCAGTACTTC	CASSLALEGWIQNIQYF	TRBV7-4	TRBJ2-4
TGTGCCAGCAGCCAAGCGGGACAGGGGGCTCTACTCACTGAAGCTTTCTTT	CASSQAGQGALLTEAFF	TRBV3-1	TRBJ1-1
TGTGCCAGCAGAGCGGGACAGGGCATTTACACTGAAGCTTTCTTT	CASRAGQGIYTEAFF	TRBV3-1	TRBJ1-1
TGCGCCAGCAGTGAGTACCTCCGGGTTACTCACACCGGGGAGCTGTTTTTT	CASSEYLRVTHTGELFF	TRBV10-1	TRBJ2-2
TGTGCCAGCAGTGACTTTAGACAGGGTATCTACAATGAGCAGTTCTTC	CASSDFRQGIYNEQFF	TRBV6-4	TRBJ2-1
TGTGCCAGCAGCGACGTGACAGTCCAGCGCAATCAGCCCCAGCATTTT	CASSDVTVQRNQPQHF	TRBV13	TRBJ1-5
TGCGCCAGCAGCCAAAGGGGGCTTTTCAGAAACAATGAGCAGTTCTTC	CASSQRGLFRNNEQFF	TRBV4-1	TRBJ2-1
TGTGCCAGCAGCACACAGGGGGAACCAACTAATGAAAAACTGTTTTTT	CASSTQGEPTNEKLFF	TRBV13	TRBJ1-4
TGTGCCAGTAGTAGTCGGGAATACGAGCAGTACTTC	CASSSREYEQYF	TRBV19	TRBJ2-7
TGCAGAGGGCAGGGCTATAATTCACCCCTCCACTTT	CRGQGYNSPLHF	TRBV20-1	TRBJ1-6
TGTGCCAGCAGTAGGAGGACAGATACGCAGTATTTT	CASSRRTDTQYF	TRBV6-4	TRBJ2-3
TGTGCCAGCAGCTGGGGCCTCAACCCATGTGATACGCAGTATTTT	CASSWGLNPCDTQYF	TRBV11-3	TRBJ2-3
TGTGCCAGCAGCGAGGGGACGGACACTGAAGCTTTCTTT	CASSEGTDTEAFF	TRBV7-3	TRBJ1-1
TGCAGTGCTAAAGAGTTACGGGCGGTGTACGAGCAGTACTTC	CSAKELRAVYEQYF	TRBV20-1	TRBJ2-7
TGTGCCAGCAGTTACGGGTCCCACAGGGGGTGGAGAAACTATGGCTACACCTTC	CASSYGSHRGWRNYGYTF	TRBV6-6	TRBJ1-2
TGCGCCAGCAGCTTGAGGGTAGCAGTGAGCTCCTACGAGCAGTACTTC	CASSLRVAVSSYEQYF	TRBV5-1	TRBJ2-7
TGTGAGTGGGGGGGGCCTACAAGGGATCGCACAGATACGCAGTATTTT	CEWGGPTRDRTDTQYF	TRBV27	TRBJ2-3
TGTGCCAGCAGCTTCGCCCCTTCTTACAGGGATATCCTGTATGGCTACACCTTC	CASSFAPSYRDILYGYTF	TRBV7-9	TRBJ1-2
TGTGCCAGCAGCCGTGACAGGCTGAACTATGGCTACACCTTC	CASSRDRLNYGYTF	TRBV3-1	TRBJ1-2
TGTGCCAGCAGAGTGGTCCCGGGGGAAAACATTCAGTACTTC	CASRVVPGENIQYF	TRBV9	TRBJ2-4
TGTGCCTGGCTCGAAGGGGTCGGCTATGGCTACACCTTC	CAWLEGVGYGYTF	TRBV30	TRBJ1-2
