TGTGCCAGCAGTTTATCCTTAATGAGGCTAGCGGGCGGGCGGTGCAATGAGCAGTTCTTC	CASSLSLMRLAGGRCNEQFF	TRBV28	TRBJ2-1
TGTGCCAGCAGCGTAGCTAGCGGGACTTCGCTGTTTTTT	CASSVASGTSLFF	TRBV9	TRBJ2-2
TGTGCCACCAGTGACCAATCCCGGGACAGGGGAATCAATGAGCAGTTCTTC	CATSDQSRDRGINEQFF	TRBV24-1	TRBJ2-1
TGTGCCAGCAGCCATAAGTCGCCCAGGGCTTTAGAAGCCAAAAACATTCAGTACTTC	CASSHKSPRALEAKNIQYF	TRBV14	TRBJ2-4
TGTGCCAGCTCACCACTGCAAGGCCCCGCGGGAGAGTTTAGTTACGAGCAGTACTTC	CASSPLQGPAGEFSYEQYF	TRBV18	TRBJ2-7
TGCGCCAGCAGTGGTCGGGGATTTACCGGGGAGCTGTTTTTT	CASSGRGFTGELFF	TRBV10-1	TRBJ2-2
TGCGCCAGCAGCGACGGGGAGGGGGAGGTGGGAAACACCATATATTTT	CASSDGEGEVGNTIYF	TRBV5-1	TRBJ1-3
TGCGCCAGCAGAGCCGGTTCAGAGCCCTACGAGCAGTACTTC	CASRAGSEPYEQYF	TRBV10-1	TRBJ2-7
TGTGCCAGCAGCTTGGGGTTGGGTTATGGACTAGGGCCGGGCTACAATGAGCAGTTCTTC	CASSLGLGYGLGPGYNEQFF	TRBV5-4	TRBJ2-1
TGTGCCAGCAGCCCCGCCGACGGGAGGCATACGCAGTATTTT	CASSPADGRHTQYF	TRBV7-3	TRBJ2-3
TGTGCCAGCAGCTGTCCTGGGAGACTAGCCAGGCATACGCAGTATTTT	CASSCPGRLARHTQYF	TRBV5-4	TRBJ2-3
TGTGCCAGCAGAGCCGGACAGGGGAGTGTAAGCTCCTACGAGCAGTACTTC	CASRAGQGSVSSYEQYF	TRBV2	TRBJ2-7
TGTGCCAGCAGTTACCCCCGAGTTCAGCCCACTGAAGCTTTCTTT	CASSYPRVQPTEAFF	TRBV6-5	TRBJ1-1
TGTGCCAGCTCCAACAGGGGGGATGAAAAACTGTTTTTT	CASSNRGDEKLFF	TRBV18	TRBJ1-4
TGTGCCACTAGCGGAGAGACCCAGTACTTC	CATSGETQYF	TRBV7-8	TRBJ2-5
TGTGCCAGCAGCTGCGGGACATTCGCGGCAACTAATGAAAAACTGTTTTTT	CASSCGTFAATNEKLFF	TRBV11-3	TRBJ1-4
TGTGCCTGGATGATTTGGTACTATGGCTACACCTTC	CAWMIWYYGYTF	TRBV30	TRBJ1-2
TGTGCCAGCAGTGACTCACGACGCTTAGAGACCCAGTACTTC	CASSDSRRLETQYF	TRBV6-4	TRBJ2-5
TGTGCCAGCGACAGGGCCGAGCAGTACTTC	CASDRAEQYF	TRBV28	TRBJ2-7
TGTGCCACCAGCAGAGGGACTAGCGGGGGGGCCTATGAATACGAGCAGTACTTC	CATSRGTSGGAYEYEQYF	TRBV15	TRBJ2-7
TGTGCCATCAGTGCAGCGGGACAGTGGGGCAATGAGCAGTTCTTC	CAISAAGQWGNEQFF	TRBV10-3	TRBJ2-1
TGTGCCAGCAGACTCCGGGAGCTCATGAACACTGAAGCTTTCTTT	CASRLRELMNTEAFF	TRBV7-4	TRBJ1-1
TGCATAGGGACGACCTCCTACGAGCAGTACTTC	CIGTTSYEQYF	TRBV20-1	TRBJ2-7
TGCGCCAGCAGCCAAGATTCCCAGGGCCCACCGGGCGAGCAGTACTTC	CASSQDSQGPPGEQYF	TRBV4-1	TRBJ2-7
TGCGCCAGCAGCCTGCTCGTCATCAGAGAAAAACTGTTTTTT	CASSLLVIREKLFF	TRBV4-1	TRBJ1-4
TGTGCCAGCAGCTTTTCCCTCCCCAGGGGGTCTGGAAACACCATATATTTT	CASSFSLPRGSGNTIYF	TRBV11-3	TRBJ1-3
TGCGCCAGCAGTGAGGGACAGGAGACCCAGTACTTC	CASSEGQETQYF	TRBV10-1	TRBJ2-5
TGTGCCAGCAGTTACAACAGGGGCGGGGAGCTGTTTTTT	CASSYNRGGELFF	TRBV12-4	TRBJ2-2
TGTGCCAGCAGCAATAGCGGGTGCAGCTCCTACAATGAGCAGTTCTTC	CASSNSGCSSYNEQFF	TRBV7-9	TRBJ2-1
TGTGCCAGCAGGGTCTACACTAGGGGTGAGACCCAGTACTTC	CASRVYTRGETQYF	TRBV28	TRBJ2-5
TGTGCCACCAGTGATTTTGATCACAGGGACCTCCGGAGGGCTTTCTTT	CATSDFDHRDLRRAFF	TRBV24-1	TRBJ1-1
TGTGCCAGCAGCGTGTCTAGAACCTCCTTCACTGAAGCTTTCTTT	CASSVSRTSFTEAFF	TRBV13	TRBJ1-1
TGTGCCAGCAATCTAAGTGGGACCCCGAATGAGCAGTTCTTC	CASNLSGTPNEQFF	TRBV12-3	TRBJ2-1
TGTGCCAGCCGTAGCGAAAAGACCCAGTACTTC	CASRSEKTQYF	TRBV9	TRBJ2-5
TGTGCCAGCAGCCAAGGCAGGGCCCAGGCGTATGTCATGGCTGAAGCTTTCTTT	CASSQGRAQAYVMAEAFF	TRBV14	TRBJ1-1
TGTGCCAGCAGTTTACGGAACAGCCTCTATGGCTACACCTTC	CASSLRNSLYGYTF	TRBV27	TRBJ1-2
TGCGCCAGCAAGGCACCTATCGACGGCTTGCAGTTCTTC	CASKAPIDGLQFF	TRBV10-2	TRBJ2-1
TGTGCCAGCAAGACCTTGTCGCCCAGGGGAGACGTCTATGGCTACACCTTC	CASKTLSPRGDVYGYTF	TRBV11-3	TRBJ1-2
TGTGCCAGCACTCCCCGGGGGATCACTGAAGCTTTCTTT	CASTPRGITEAFF	TRBV9	TRBJ1-1
TGTGCCACCAGCAATAAGATAGAATACAGGGGCCCCGAGCAGTACTTC	CATSNKIEYRGPEQYF	TRBV24-1	TRBJ2-7
TGCAGTGCTAGAGGGAAGACTTGGGACAGGGGCTTCCCGAAGCGGGTTAGCAATCAGCCCCAGCATTTT	CSARGKTWDRGFPKRVSNQPQHF	TRBV20-1	TRBJ1-5
TGTGCCAGCAGGACGACAGCACGCGGGACTGAAGCTTTCTTT	CASRTTARGTEAFF	TRBV27	TRBJ1-1
TGTGCCAGCAGCTTCGCAGGGGTTTTTTCTAATGAAAAACTGTTTTTT	CASSFAGVFSNEKLFF	TRBV5-4	TRBJ1-4
TGCGCCAGCAATACAGGCCCCTACACCTTC	CASNTGPYTF	TRBV10-1	TRBJ1-2
TGTGCCAGCAGGGAGCCACAGGGAAGACATCAGCCCCAGCATTTT	CASREPQGRHQPQHF	TRBV3-1	TRBJ1-5
TGTGCCAGCAGCCAAGATCCCGCACGAGGGGGCCAAAGTCAGCCCCAGCATTTT	CASSQDPARGGQSQPQHF	TRBV14	TRBJ1-5
TGTGCCAGCAGCTTAGGGCCCACGGACCTAGCGGGATTTGAGCAGTACTTC	CASSLGPTDLAGFEQYF	TRBV11-2	TRBJ2-7
TGTGCCAGCGGTAAGGGGATAGATACGCAGTATTTT	CASGKGIDTQYF	TRBV6-1	TRBJ2-3
TGTGCCACCAGTGACGACTACGAGCAGTACTTC	CATSDDYEQYF	TRBV24-1	TRBJ2-7
TGTGCCAGCTCACGGGGACTAGCGGGAGAGACGTACGAGCAGTACTTC	CASSRGLAGETYEQYF	TRBV18	TRBJ2-7
TGTGCCAGCAGTGACAACAGTAAAGCAGCTTTCTTT	CASSDNSKAAFF	TRBV6-4	TRBJ1-1
TGCAGTGCTAGAGATTATTCCCAGGGAGGCCATCAGCCCCAGCATTTT	CSARDYSQGGHQPQHF	TRBV20-1	TRBJ1-5
TGTGCCAGCAGCGCGTCAAACAGGGGGGTTAATGAAAAACTGTTTTTT	CASSASNRGVNEKLFF	TRBV5-6	TRBJ1-4
TGTGCCAGCTCACCAAACGAGCATACAGGATACAATGAGCAGTTCTTC	CASSPNEHTGYNEQFF	TRBV18	TRBJ2-1
TGTGCCAGCATCGGCAATTATGGCTACACCTTC	CASIGNYGYTF	TRBV9	TRBJ1-2
TGTGCCAGCTCCAGGGGCCCCCGGGCTTCCTACGAGCAGTACTTC	CASSRGPRASYEQYF	TRBV27	TRBJ2-7
TGTGCCAGCAGCCGGCGGGGGGACTATGGCTACACCTTC	CASSRRGDYGYTF	TRBV5-8	TRBJ1-2
TGTGTTTTGGACAGGCGAAACACCATATATTTT	CVLDRRNTIYF	TRBV7-9	TRBJ1-3
TGCGCCAGCAGCCAAGATTACCCGACTAGGTCTAACGAGCAGTACTTC	CASSQDYPTRSNEQYF	TRBV4-1	TRBJ2-7
TGTGCCAGCGCACCGGGACTAGCGGGAGCAACCTACGAGCAGTACTTC	CASAPGLAGATYEQYF	TRBV6-5	TRBJ2-7
TGTGCCAGCAGTCCTAGCGGAAAAAACATTCAGTACTTC	CASSPSGKNIQYF	TRBV27	TRBJ2-4
TGCAGTGCCAGAATTAGGGCACCTGAAGCTTTCTTT	CSARIRAPEAFF	TRBV20-1	TRBJ1-1
TGTGCCAGCAGCCAAGAGACCCCGGGAGGGGAGGATGAGCAGTTCTTC	CASSQETPGGEDEQFF	TRBV14	TRBJ2-1
TGCAGTGCGGGACTAGCGGGAGGGTCCGGGTATAATTCACCCCTCCACTTT	CSAGLAGGSGYNSPLHF	TRBV20-1	TRBJ1-6
TGTGCCAGCACCAGGGAGAGGGAATTACAGCCCCAGCATTTT	CASTRERELQPQHF	TRBV7-6	TRBJ1-5
TGTGCCAGCAGCTTAGAGGGACCCCATCACGGACTACGGCAAGAGACCCAGTACTTC	CASSLEGPHHGLRQETQYF	TRBV7-2	TRBJ2-5
TGTGCCAGCAGCTTAGCCTACATGAACACTGAAGCTTTCTTT	CASSLAYMNTEAFF	TRBV7-4	TRBJ1-1
TGTGCCACTTGCCTCCGGACTAGCGGGGGGGCCGGGGGAGAGTATTTT	CATCLRTSGGAGGEYF	TRBV25-1	TRBJ2-3
TGCGCCAGCAGCTTGGTCTATCCCGGACAGAGCGATGACACTGAAGCTTTCTTT	CASSLVYPGQSDDTEAFF	TRBV5-1	TRBJ1-1
TGTGCCAGCAGCTTAGCCAGGGTGAGCAATCAGCCCCAGCATTTT	CASSLARVSNQPQHF	TRBV7-8	TRBJ1-5
TGTGCCAGCAGCTATGCCGGACTCGGCAGCAATCAGCCCCAGCATTTT	CASSYAGLGSNQPQHF	TRBV13	TRBJ1-5
TGTGCCAGCAGCTTGTTTCGTATATACGACAATGAGCAGTTCTTC	CASSLFRIYDNEQFF	TRBV5-8	TRBJ2-1
TGCAGTGCTAGAGCCGACAGGGGGGTACTACTGTTTTTT	CSARADRGVLLFF	TRBV20-1	TRBJ1-4
TGTGCCAGCAGCATGGGGCCTGATGAGCAGTTCTTC	CASSMGPDEQFF	TRBV6-1	TRBJ2-1
TGTGCCAGCTCACCACGCCCCGGGACAGGGGCGAAGGTGCAGTACTTC	CASSPRPGTGAKVQYF	TRBV18	TRBJ2-7
TGTGCCAGCAGGACACGAAAAATATCCGGGACAGCCAGAGAGACGAACACCGGGGAGCTGTTTTTT	CASRTRKISGTARETNTGELFF	TRBV28	TRBJ2-2
TGTGCCAGCAGTTTAGTCGGACTAGCGGGCGAGATGGGCGAAGAGACCCAGTACTTC	CASSLVGLAGEMGEETQYF	TRBV27	TRBJ2-5
TGCGCCATCTCTTTCGGAGCATACGGGGAGCTGTTTTTT	CAISFGAYGELFF	TRBV5-1	TRBJ2-2
TGTGCCAGCAGTGCCCCCCTGGTTTGCTATGGCTACACCTTC	CASSAPLVCYGYTF	TRBV2	TRBJ1-2
TGTGCCACCAGTGATTTGCATGGCACAAACTCCTACAATGAGCAGTTCTTC	CATSDLHGTNSYNEQFF	TRBV24-1	TRBJ2-1
TGTGCCAGCAGCGGTCCTCTAATCACAGATACGCAGTATTTT	CASSGPLITDTQYF	TRBV7-6	TRBJ2-3
TGTGCCAGCAGTTATTATGGGGGATTAGGAAGCATTCAGTACTTC	CASSYYGGLGSIQYF	TRBV27	TRBJ2-4
TGTGCCAGCAGCCAAGACCTGTTAATTGGGACGTACAATGAGCAGTTCTTC	CASSQDLLIGTYNEQFF	TRBV14	TRBJ2-1
TGCGCCAGCAGTGAGTCGGCAGGGGGCGAGTACTATGGCTACACCTTC	CASSESAGGEYYGYTF	TRBV10-1	TRBJ1-2
TGCGCCAGCAGCTTGGCCCTTCTAGCTGAGCAGTTCTTC	CASSLALLAEQFF	TRBV5-1	TRBJ2-1
TGTGCCAGCAGAACAGACCGCCAAGAGACCCAGTACTTC	CASRTDRQETQYF	TRBV5-6	TRBJ2-5
TGCAGTGCTTTGGCTCCACTGGGGACGCAATGTAGACAAGAGACCCAGTACTTC	CSALAPLGTQCRQETQYF	TRBV20-1	TRBJ2-5
TGTGCCAGCAGTGCAGTAGCCCGGGACAGGGACGTTGAAGCTTTCTTT	CASSAVARDRDVEAFF	TRBV12-4	TRBJ1-1
TGCGCCAGCAGCGGATCGACAGAAGGCTACACCTTC	CASSGSTEGYTF	TRBV5-1	TRBJ1-2
TGCGCCAGCAGTGAGCGGGACAGGGAATACGAGCAGTACTTC	CASSERDREYEQYF	TRBV10-2	TRBJ2-7
TGTGCCACCACGAACAGGGTTAGTTCGGATCAGCCCCAGCATTTT	CATTNRVSSDQPQHF	TRBV24-1	TRBJ1-5
TGCGCCAGCAGTGCTAAGGTGGAGTCAGATACGCAGTATTTT	CASSAKVESDTQYF	TRBV10-1	TRBJ2-3
TGTGCCAGCAGGCAAGAGACTAGCAATCAGCCCCAGCATTTT	CASRQETSNQPQHF	TRBV2	TRBJ1-5
TGTGCCAGCAGCTTGGGACAGACGGACCCCTACGAGCAGTACTTC	CASSLGQTDPYEQYF	TRBV7-9	TRBJ2-7
TGTGCCAGCAGCTCTCCGGCCTTGATAGCCTACGAGCAGTACTTC	CASSSPALIAYEQYF	TRBV7-2	TRBJ2-7
TGTGCCGGTAAGACAGGGGGCCGAAACTTAGAGACCCAGTACTTC	CAGKTGGRNLETQYF	TRBV7-9	TRBJ2-5
TGTGCCAGCAGCTTGGCGGCGTCGACAGGGTATGGCTACACCTTC	CASSLAASTGYGYTF	TRBV5-6	TRBJ1-2
TGTGCCAGCAGTTTCATTGCTGGGGGGTTAGCCTCTAACTATGGCTACACCTTC	CASSFIAGGLASNYGYTF	TRBV12-3	TRBJ1-2
TGTGCCAGCAGCTTAAGCATTACCGTTGGCTACACCTTC	CASSLSITVGYTF	TRBV11-3	TRBJ1-2
TGTGCCAGCAGAGAAGCGGGACAGGAAGAGCAGTACTTC	CASREAGQEEQYF	TRBV9	TRBJ2-7
TGTGCCAGCAGCGTGGGGGCGTGGCCCCAGCATTTT	CASSVGAWPQHF	TRBV9	TRBJ1-5
TGTGCCAGCAGTTACGCCCCCGGACGGCCCGGGGAGCTGTTTTTT	CASSYAPGRPGELFF	TRBV6-2	TRBJ2-2
TGTGCCATCAGTGTGGTAGTAGAGACCCAGTACTTC	CAISVVVETQYF	TRBV10-3	TRBJ2-5
TGTGCCAGCAGTGATCCACCGTTCTATGGCTACACCTTC	CASSDPPFYGYTF	TRBV25-1	TRBJ1-2
TGTGCCAGCAGTTACACGGGTGTCTCCTACGAGCAGTACTTC	CASSYTGVSYEQYF	TRBV6-2	TRBJ2-7
TGTGCCAGCAGGAGGGGGCCCGGGGCCCATAACACTGAAGCTTTCTTT	CASRRGPGAHNTEAFF	TRBV28	TRBJ1-1
TGTGCCAGCAGGATTACCCTCGGGGTAAGAGAGACCCAGTACTTC	CASRITLGVRETQYF	TRBV6-4	TRBJ2-5
TGTGCTAGTGGTTTGGATAAATCGCCGGGTCCCGGGCAAGAGACCCAGTACTTC	CASGLDKSPGPGQETQYF	TRBV12-5	TRBJ2-5
TGTGCCCCGGGACTAGCGGGAGATAGCTCCTACGAGCAGTACTTC	CAPGLAGDSSYEQYF	TRBV24-1	TRBJ2-7
TGTGCCAGCAGCAGTACAACACCCGGGACTAGTGAGCAGTTCTTC	CASSSTTPGTSEQFF	TRBV7-4	TRBJ2-1
TGTGCCACCAGTGACGGATCGGACAGGGGAAGTTTCATGAACACTGAAGCTTTCTTT	CATSDGSDRGSFMNTEAFF	TRBV24-1	TRBJ1-1
TGTGCCAGCAGTGAACTAGGGTCGAAGACAGGGGGACCGCTCTCGGGGGGCTACACCTTC	CASSELGSKTGGPLSGGYTF	TRBV6-1	TRBJ1-2
TGTGCCAGCAGCCTGGGGGGCTATAATTCACCCCTCCACTTT	CASSLGGYNSPLHF	TRBV3-1	TRBJ1-6
TGTGCCAGCAGTTTACCCCCTACTCAAGAAAAACTGTTTTTT	CASSLPPTQEKLFF	TRBV27	TRBJ1-4
TGCGCCAGCAGGTGCCTAGGGACGGATCAGCCCCAGCATTTT	CASRCLGTDQPQHF	TRBV10-1	TRBJ1-5
TGTGCCAGCAGCCGAGGACTAGTAGGAAACATTCAGTACTTC	CASSRGLVGNIQYF	TRBV7-6	TRBJ2-4
TGTGCCAGCAGCTTAGCGAGGACAGGGGGCAATCAGCCCCAGCATTTT	CASSLARTGGNQPQHF	TRBV11-2	TRBJ1-5
TGTGCCAGCAGCCGCCCCGGGGTCCAAGAGACCCAGTACTTC	CASSRPGVQETQYF	TRBV7-9	TRBJ2-5
TGTGCCAGCAGTCAGGTGTGGGACTTGGCATCCTACGAGCAGTACTTC	CASSQVWDLASYEQYF	TRBV12-3	TRBJ2-7
TGTGCCAGCAGCATTACCCACTATAGCAATCAGCCCCAGCATTTT	CASSITHYSNQPQHF	TRBV5-4	TRBJ1-5
TGTGCCAGCAAGGGGCTTCAGGGACCTAATGAAAAACTGTTTTTT	CASKGLQGPNEKLFF	TRBV6-3	TRBJ1-4
TGTGCCTGGAAGTTGGGAGAACACGAGCAGTACTTC	CAWKLGEHEQYF	TRBV30	TRBJ2-7
TGCAGTGCTAGGTTAACAGCCGACCTTAATTATAAGGAGACCCAGTACTTC	CSARLTADLNYKETQYF	TRBV20-1	TRBJ2-5
TGCAGTGCTAGGGTTCGGGGAGCATACTGTAGGGGCTACGAGCAGTACTTC	CSARVRGAYCRGYEQYF	TRBV20-1	TRBJ2-7
TGCAGTGCTAGAAAAATGTGGGACAGGGGCTCCTACGAGCAGTACTTC	CSARKMWDRGSYEQYF	TRBV20-1	TRBJ2-7
TGTGCCAGCAGTAAAGCGAAGGCGCCGCACACCATATATTTT	CASSKAKAPHTIYF	TRBV27	TRBJ1-3
TGTGCCAGCAGCCAAGGAGTAACCGTCCCGGGAAAACTGTTTTTT	CASSQGVTVPGKLFF	TRBV4-2	TRBJ1-4
TGTGCCAGCAGTTATGGACAGGGGGCTTTCTACGAGCAGTACTTC	CASSYGQGAFYEQYF	TRBV28	TRBJ2-7
TGTGCCAGCAAGGGGGGGACAAGAACAGATACGCAGTATTTT	CASKGGTRTDTQYF	TRBV6-3	TRBJ2-3
TGTGCCAGCAGCTTTAAGGGGGAAACCACTGAAGCTTTCTTT	CASSFKGETTEAFF	TRBV7-3	TRBJ1-1
TGTGCCAGCAGTCCGACAGGTTCTAATCAGCCCCAGCATTTT	CASSPTGSNQPQHF	TRBV12-3	TRBJ1-5
TGTGCCAGCAGTTACAGGGGCTCTGGGGCCAACGTCCTGACTTTC	CASSYRGSGANVLTF	TRBV6-5	TRBJ2-6
TGTGCCAGCAGCCCCGCGGGGGGGGCCAGAACAGGAAAAGGGAATTCACCCCTCCACTTT	CASSPAGGARTGKGNSPLHF	TRBV3-1	TRBJ1-6
TGTGCTAGTGGTTTGTTCGAGCTTTATAGCAATCAGCCCCAGCATTTT	CASGLFELYSNQPQHF	TRBV12-5	TRBJ1-5
TGTGCCAGCAGTTACGGGGCGGCTGATAGCGAGCAGTACTTC	CASSYGAADSEQYF	TRBV6-3	TRBJ2-7
TGTGCCAGCAGGAGTCAGGGGGGGGGGCCAGATACGCAGTATTTT	CASRSQGGGPDTQYF	TRBV7-3	TRBJ2-3
TGCAGTGCTAGATCCCGGACAGGGAGCTCTGCAACTAATGAAAAACTGTTTTTT	CSARSRTGSSATNEKLFF	TRBV20-1	TRBJ1-4
TGTGCCAGCAGTCCTGGGGGGGGAGCAGCCTATGGCTACACCTTC	CASSPGGGAAYGYTF	TRBV27	TRBJ1-2
TGTGCCAGCAGGCCCCGGGACAGGGGGGAGTACGAGCAGTACTTC	CASRPRDRGEYEQYF	TRBV7-6	TRBJ2-7
TGTGCCAGCAGCTTAGTCCAACAGGGCTACTATGGCTACACCTTC	CASSLVQQGYYGYTF	TRBV7-6	TRBJ1-2
TGCAGTGCTAGATCTGGACAGGGTACCGAGCAGTACTTC	CSARSGQGTEQYF	TRBV20-1	TRBJ2-7
TGCGCCAGCAGCTTGGGGCTGGGACAGGGGGCCGGCCGCTCCTACAATGAGCAGTTCTTC	CASSLGLGQGAGRSYNEQFF	TRBV5-1	TRBJ2-1
TGTGCCAGCAGTTACCCCCTAGGCGAGAATCAGCCCCAGCATTTT	CASSYPLGENQPQHF	TRBV6-2	TRBJ1-5
TGTGCCAGCAGGTCAACCCTCGACAGAGAACTAGGGACAACTAATGAAAAACTGTTTTTT	CASRSTLDRELGTTNEKLFF	TRBV12-3	TRBJ1-4
TGTGCCAGCAGTTACTCAGACGCAAGGGAATCTCAAGAGACCCAGTACTTC	CASSYSDARESQETQYF	TRBV6-5	TRBJ2-5
TGCAGTGCTAAAGGACAGGACAGGGAAAAAGTACAGCTCTACAATGAGCAGTTCTTC	CSAKGQDREKVQLYNEQFF	TRBV20-1	TRBJ2-1
TGTGCCACCAGTATGACAGGGTGCAATCAGCCCCAGCATTTT	CATSMTGCNQPQHF	TRBV24-1	TRBJ1-5
TGCAGTGCTCCGAAGTGGAGGGGGTATTACTACGAGCAGTACTTC	CSAPKWRGYYYEQYF	TRBV20-1	TRBJ2-7
TGTGCCAGCCCCAAGGGGGGAACCGGGGAGCTGTTTTTT	CASPKGGTGELFF	TRBV6-4	TRBJ2-2
TGTGCCAGCAGCATCACCTCTCAGACCCCCCCGGGAAAACTGTTTTTT	CASSITSQTPPGKLFF	TRBV5-4	TRBJ1-4
TGTGCCAGCAGTGCCGGGACTAGCGGAGAGACCCAGTACTTC	CASSAGTSGETQYF	TRBV27	TRBJ2-5
TGTGCCTGGAGTGACAGGGGGGTCAACTATGGCTACACCTTC	CAWSDRGVNYGYTF	TRBV30	TRBJ1-2
TGTGCCACCAGTGATTTCGCCAGGGGGCTCCTCACTGAAGCTTTCTTT	CATSDFARGLLTEAFF	TRBV24-1	TRBJ1-1
TGTGCCAGCAGCTTAGAACCAGACAGGAAGAGGGGGACTTACGGAAACACCATATATTTT	CASSLEPDRKRGTYGNTIYF	TRBV7-9	TRBJ1-3
TGTAGGCCGGGACCCATCTCCTATAATTCACCCCTCCACTTT	CRPGPISYNSPLHF	TRBV20-1	TRBJ1-6
TGTGCCAGCAGCCCCAGGTTCCCGACAGGGGTAACTAATGAAAAACTGTTTTTT	CASSPRFPTGVTNEKLFF	TRBV13	TRBJ1-4
TGTGCCAGCAGCCTAGAACAAAACAGGGCGATCTATGGCTACACCTTC	CASSLEQNRAIYGYTF	TRBV14	TRBJ1-2
TGCGCCAGCAGTGAGCCTAGCGGATACAATGAGCAGTTCTTC	CASSEPSGYNEQFF	TRBV10-1	TRBJ2-1
TGCAGCGTTGGACGGGTAGGGGAAGACTGGGAAAAACTGTTTTTT	CSVGRVGEDWEKLFF	TRBV29-1	TRBJ1-4
TGTGCCAGCAGCCGCCTAAACCTACCCCGGGACACAGGCATGGGTAGCACAGATACGCAGTATTTT	CASSRLNLPRDTGMGSTDTQYF	TRBV7-9	TRBJ2-3
TGTGCCAGCAGCTTCCACCCAGGGACTAGCGGGTACGAGCAGTACTTC	CASSFHPGTSGYEQYF	TRBV7-9	TRBJ2-7
TGCGCCAGCAGCGTGTTACAGGGCGCGGGGGTCTACGAGCAGTACTTC	CASSVLQGAGVYEQYF	TRBV5-1	TRBJ2-7
TGTGCCAGCAAGTGGGGGCTGTGCTACGAGCAGTACTTC	CASKWGLCYEQYF	TRBV27	TRBJ2-7
TGTGCCAGCAGCTTTCTGATAACACAGGGAGGGGGCTACACCTTC	CASSFLITQGGGYTF	TRBV7-9	TRBJ1-2
TGTGCCAGCAGTGGAGGCGGGGGCCGTCAGGGGAACACTGAAGCTTTCTTT	CASSGGGGRQGNTEAFF	TRBV6-3	TRBJ1-1
TGTGCCAGCAGCCAGTTTGGACGCGTCTATGGCTACACCTTC	CASSQFGRVYGYTF	TRBV4-2	TRBJ1-2
TGTGCCAGTAGTGGTAGGCTAAATGAAAAACTGTTTTTT	CASSGRLNEKLFF	TRBV19	TRBJ1-4
TGTGCCAGCAGCGAGAGCGGGACTACTAACTATGGCTACACCTTC	CASSESGTTNYGYTF	TRBV2	TRBJ1-2
TGTGCCACCCCGGCAGGGAGCACAGATACGCAGTATTTT	CATPAGSTDTQYF	TRBV5-6	TRBJ2-3
TGTGCCAGCAGGGCTCCCCCAAAGAGTACTGAGCAGTTCTTC	CASRAPPKSTEQFF	TRBV7-9	TRBJ2-1
TGTGCCAGCATGAGGCGGGAGGCCAAAAACATTCAGTACTTC	CASMRREAKNIQYF	TRBV28	TRBJ2-4
TGCGCCAGCCTAAGAGGGGGCAAACTTCGCAATCAGCCCCAGCATTTT	CASLRGGKLRNQPQHF	TRBV10-1	TRBJ1-5
TGTGCCACCAGCAACTGCTTCTTCACAGGGCGGGGTGAGCAGTACTTC	CATSNCFFTGRGEQYF	TRBV15	TRBJ2-7
TGTGCCAGCAGTGGACTTGGGACTAGCGGTGGCGAGCAGTACTTC	CASSGLGTSGGEQYF	TRBV25-1	TRBJ2-7
TGCAGTGCTAGGTGGGGTAAATCCCGAAACACCATATATTTT	CSARWGKSRNTIYF	TRBV20-1	TRBJ1-3
TGTGCCAGCAGCCAAGTTCACCGCTTACCACCGGTGCGGGCCGGGACAGCTCCCCCTTTCGACTATGGCTACACCTTC	CASSQVHRLPPVRAGTAPPFDYGYTF	TRBV14	TRBJ1-2
TGCGCCAGCAGCCTCTGCATCAGCTATGGCTACACCTTC	CASSLCISYGYTF	TRBV5-1	TRBJ1-2
TGTGCCACCAGCAGGGGCACAGGGGGTGCCCGGGGCTACACCTTC	CATSRGTGGARGYTF	TRBV15	TRBJ1-2
TGTGCCAGCAGCTTAACCCGCGGGAGAAGAGGGCAAGAGACCCAGTACTTC	CASSLTRGRRGQETQYF	TRBV7-3	TRBJ2-5
TGCAGCTACGGGAGCTCCTACAATGAGCAGTTCTTC	CSYGSSYNEQFF	TRBV29-1	TRBJ2-1
TGCAGTGCCGTCCAACAGGGCGGTAAAGAAAAACTGTTTTTT	CSAVQQGGKEKLFF	TRBV20-1	TRBJ1-4
TGTGCCACACCCAACCACCGCCGCCCGGTTCAGCCCCAGCATTTT	CATPNHRRPVQPQHF	TRBV24-1	TRBJ1-5
TGCGCCAGCAGCTTGTCATTGGGACTAGCGGGGGGGGCCTACGAGCAGTACTTC	CASSLSLGLAGGAYEQYF	TRBV5-1	TRBJ2-7
TGCGCCAGCAGCTTTATCTGGGGCAGCCAAGGGAACTATGGCTACACCTTC	CASSFIWGSQGNYGYTF	TRBV5-1	TRBJ1-2
TGTGCCAGCAGCGGGAAGGGGAGCGGAAATGAAAAACTGTTTTTT	CASSGKGSGNEKLFF	TRBV9	TRBJ1-4
TGCGCCAGCAGCCAAGTCAGGGGCGGGGGCACTGAAAAACTGTTTTTT	CASSQVRGGGTEKLFF	TRBV4-1	TRBJ1-4
TGTGCCAGCAGCTTTTGTCAGGGGAGGGAGGCGAATTCACCCCTCCACTTT	CASSFCQGREANSPLHF	TRBV6-2	TRBJ1-6
TGTGCCAGCAGCAGGTACCAGCGGGACCTCCATGAGCAGTTCTTC	CASSRYQRDLHEQFF	TRBV13	TRBJ2-1
TGTGCCTGGAGTCAAGGACGAGAAAACTCCTACGAGCAGTACTTC	CAWSQGRENSYEQYF	TRBV30	TRBJ2-7
TGCAGTGCGTTCCGTTTTAAGAAATCTGCAGGAAGTTGGATTTGCAAACTGTTTTTT	CSAFRFKKSAGSWICKLFF	TRBV20-1	TRBJ1-4
TGTGCCAGCAGTGAATCTACAGGGGGGATCATAGATCAGCCCCAGCATTTT	CASSESTGGIIDQPQHF	TRBV25-1	TRBJ1-5
TGCAGTGCTAAATCGGGCCCGGGAGAGACCCAGTACTTC	CSAKSGPGETQYF	TRBV20-1	TRBJ2-5
TGTGCCAGCAGTGATGAGTGCACTGAGCAGTTCTTC	CASSDECTEQFF	TRBV6-4	TRBJ2-1
TGTGCCAGCAGTGAACCGGGAGGACTAGCGGGCATCAATGAGCAGTTCTTC	CASSEPGGLAGINEQFF	TRBV25-1	TRBJ2-1
TGTGCCAGCAGCCAAGTACTTCGGGCCTACAATGAGCAGTTCTTC	CASSQVLRAYNEQFF	TRBV3-1	TRBJ2-1
TGTGCCAGCAGCTCGCACGTTCAGCCCCAGCATTTT	CASSSHVQPQHF	TRBV5-5	TRBJ1-5
TGTGCCAGCCGGATGGGGGGGGACACCGGGGAGCTGTTTTTT	CASRMGGDTGELFF	TRBV6-1	TRBJ2-2
TGTGCCAGCAGCGAGGCTGGGGGCGATCTTAGCACAGATACGCAGTATTTT	CASSEAGGDLSTDTQYF	TRBV9	TRBJ2-3
TGTGCCAGCTCGGACCGAGGACAGGGGGTCTATGGCTACACCTTC	CASSDRGQGVYGYTF	TRBV18	TRBJ1-2
TGTGCCAGCAGCAACGACTACGGGGCAGAGCAGTACTTC	CASSNDYGAEQYF	TRBV7-2	TRBJ2-7
TGCAGTGCTAGTACCAGCGTGGGACGTTTGAGAGGCACAGATACGCAGTATTTT	CSASTSVGRLRGTDTQYF	TRBV20-1	TRBJ2-3
TGTGAGTCGTTCCCCGGGGAGGAGACCCAGTACTTC	CESFPGEETQYF	TRBV7-9	TRBJ2-5
TGTGCCAGCAGCCAAGTTCTCCAGTACACTGAAGCTTTCTTT	CASSQVLQYTEAFF	TRBV3-1	TRBJ1-1
TGTGCCAGCAGTTTGGCGGTGACGGACGAGCAGTACTTC	CASSLAVTDEQYF	TRBV28	TRBJ2-7
TGCAGTGCGAAGGGCCAACGGAAATTGCATAGCAATCAGCCCCAGCATTTT	CSAKGQRKLHSNQPQHF	TRBV20-1	TRBJ1-5
TGCAGTGCCCCCGGACGACAGGGAACGCAGTACTTC	CSAPGRQGTQYF	TRBV20-1	TRBJ2-7
TGTGCCAGCAGTGATGACAGGGGGCCTTTAGACGAGCAGTACTTC	CASSDDRGPLDEQYF	TRBV6-5	TRBJ2-7
TGTGCCAGCATCCAAGGGGAGGTGTCCTATAATTCACCCCTCCACTTT	CASIQGEVSYNSPLHF	TRBV5-8	TRBJ1-6
TGTGCCAAACCGGGGGGAGGGTACCGGGTAACCGAGCAGTACTTC	CAKPGGGYRVTEQYF	TRBV9	TRBJ2-7
TGTGCCACCAAGTCCTTGGGGGGGCGCGGGTTATCAAAACCGACCGGGGAGCTGTTTTTT	CATKSLGGRGLSKPTGELFF	TRBV24-1	TRBJ2-2
TGTGCCAGCAGCCAAGATGACAGCGGGACTACAAAACCCTCCTACGAGCAGTACTTC	CASSQDDSGTTKPSYEQYF	TRBV14	TRBJ2-7
TGTGCCAGCAGCTTCCAGAGGGATTATGGCTACACCTTC	CASSFQRDYGYTF	TRBV2	TRBJ1-2
TGTGCCAGCAGTTTACGCTGCGGACAGGCAGATGAAAAACTGTTTTTT	CASSLRCGQADEKLFF	TRBV28	TRBJ1-4
TGTGCCAGCATTTTACTAGCGATTAGAGGGGGGGAGCTGTTTTTT	CASILLAIRGGELFF	TRBV28	TRBJ2-2
TGTGCCAGCAGCGAATTTCGCAGGGACTACGAGCAGTACTTC	CASSEFRRDYEQYF	TRBV7-4	TRBJ2-7
TGTGCCAGCAGCTGGGAGGCGGGACATGAGCAGTTCTTC	CASSWEAGHEQFF	TRBV9	TRBJ2-1
TGCGCCAGCAGCTTCCCAAACGGTGGGGAAAACAACATTCAGTACTTC	CASSFPNGGENNIQYF	TRBV5-1	TRBJ2-4
TGCAGTGCTAGGGGGCCCCGGTCCGATACGCAGTATTTT	CSARGPRSDTQYF	TRBV20-1	TRBJ2-3
TGCGCCAGCAGCAAAGCCCTAAGGGGGACCGGGGAGCTGTTTTTT	CASSKALRGTGELFF	TRBV5-1	TRBJ2-2
TGTGCCAGCAGTAGCGCGGCCTCCTACGAGCAGTACTTC	CASSSAASYEQYF	TRBV9	TRBJ2-7
TGCAGTGCTAGAGCAGGGACAGGTTTTAGCAATGAGCAGTTCTTC	CSARAGTGFSNEQFF	TRBV20-1	TRBJ2-1
TGTGCCAGCAGTCGGGGGGGAGAGACCCAGTACTTC	CASSRGGETQYF	TRBV6-5	TRBJ2-5
TGCGCCAGCAGCTTGTTCGGAGGTCGCAGGGGGAGTAAGGGGAGTATGAACACTGAAGCTTTCTTT	CASSLFGGRRGSKGSMNTEAFF	TRBV5-1	TRBJ1-1
TGCGCCAGCAGTGGTCGACAGGGGGTGGGCACTGAAGCTTTCTTT	CASSGRQGVGTEAFF	TRBV10-2	TRBJ1-1
TGTGCCAGCAGCGGGGCGGGGCGGCATGGAAGCTACGAGCAGTACTTC	CASSGAGRHGSYEQYF	TRBV9	TRBJ2-7
TGTGCCAGCAGAGGCGGGAGAAGGGAGCAGTACTTC	CASRGGRREQYF	TRBV6-3	TRBJ2-7
TGCAGTGCAGCGGGGGACATTCAGTACTTC	CSAAGDIQYF	TRBV20-1	TRBJ2-4
TGTGCCAGCAGCTTCCCGTGCAGGGTGAGCAATCAGCCCCAGCATTTT	CASSFPCRVSNQPQHF	TRBV7-9	TRBJ1-5
TGCGCCAGCAGCTTGCCGCTAGCTCGGACAGACTACGAGCAGTACTTC	CASSLPLARTDYEQYF	TRBV5-1	TRBJ2-7
TGTGCCATCAGTGAGCAGCAGGGCTGGATTAATGAAAAACTGTTTTTT	CAISEQQGWINEKLFF	TRBV10-3	TRBJ1-4
TGTGCCAGCAGGACTAGCGGGGTAGACACAGATACGCAGTATTTT	CASRTSGVDTDTQYF	TRBV28	TRBJ2-3
TGTGCCAGCAGTTACTCGGCCTTGGGACTAGCGGGGGATACCGGGGAGCTGTTTTTT	CASSYSALGLAGDTGELFF	TRBV6-5	TRBJ2-2
TGTGCCACCAGTGATTTCCTTCCGGACGGGGAGCTGTTTTTT	CATSDFLPDGELFF	TRBV24-1	TRBJ2-2
TGCGCCAGCAGCTTGGGCAATAGCGGGGTCCCCGGGGAGCTGTTTTTT	CASSLGNSGVPGELFF	TRBV5-1	TRBJ2-2
TGTGCCAGCAGCCGGTGTATCCCTGGGACAGGGGAAAACACCATATATTTT	CASSRCIPGTGENTIYF	TRBV6-5	TRBJ1-3
TGTGCCAGCAGCGACTCTGGGGAGCGAAGCTATGGCTACACCTTC	CASSDSGERSYGYTF	TRBV13	TRBJ1-2
TGCAGCGTTCCATGGGGGGCACGAGATGATACGCAGTATTTT	CSVPWGARDDTQYF	TRBV29-1	TRBJ2-3
TGTGCCAGCAGAGGGAGGAACTATGGCTACACCTTC	CASRGRNYGYTF	TRBV2	TRBJ1-2
TGTGCCACCGCAGGGGGCGCGGGAGCGGACTATGGCTACACCTTC	CATAGGAGADYGYTF	TRBV24-1	TRBJ1-2
TGTGCCGAGACGCCTGGCTACACCTTC	CAETPGYTF	TRBV2	TRBJ1-2
TGTGCCAGCAGTTGCTGCAGGGGGGTAGAGACCCAGTACTTC	CASSCCRGVETQYF	TRBV11-2	TRBJ2-5
TGTGCCAGCAGCGAAAGGACTAGAGTCTCCTACAATGAGCAGTTCTTC	CASSERTRVSYNEQFF	TRBV11-2	TRBJ2-1
TGTGCCAGCCTTAAGACTAGCGGGAGAGATACGCAGTATTTT	CASLKTSGRDTQYF	TRBV2	TRBJ2-3
TGCGCCAGCAGCCCCGGAAGACAGGGAGGTGACACCGGGGAGCTGTTTTTT	CASSPGRQGGDTGELFF	TRBV5-1	TRBJ2-2
TGTGCCAGCAGTTTGACCTTAAGCTCCTACGAGCAGTACTTC	CASSLTLSSYEQYF	TRBV27	TRBJ2-7
TGTGCCAGCAGCTTATCCCGGGACAGACTCTATAATTCACCCCTCCACTTT	CASSLSRDRLYNSPLHF	TRBV7-6	TRBJ1-6
TGTGCCAGCAGTTACAAGCTTACTTGGGGGGACCTTTTCGGAGAGGGCCCGGACACCGGGGAGCTGTTTTTT	CASSYKLTWGDLFGEGPDTGELFF	TRBV6-9	TRBJ2-2
TGTGCCAGCAGCGCTTGGACAGGGAGGAACAATTCACCCCTCCACTTT	CASSAWTGRNNSPLHF	TRBV13	TRBJ1-6
TGTGCCACCAGTGAAAGAGGGCCGAACGGGACTAGCGGGCAGAAACCAGATACGCAGTATTTT	CATSERGPNGTSGQKPDTQYF	TRBV24-1	TRBJ2-3
TGCAGCGTTGAAAGGGCCGGCAATCAGCCCCAGCATTTT	CSVERAGNQPQHF	TRBV29-1	TRBJ1-5
TGTGCCAGCAGGGCGGCCTACGAGCAGTACTTC	CASRAAYEQYF	TRBV9	TRBJ2-7
TGCAGTGCGGGGAAGGGGGGTGGCTACACCTTC	CSAGKGGGYTF	TRBV20-1	TRBJ1-2
TGTGCCTGGGTTATTCAACCAACTAGAGACGAGCAGTACTTC	CAWVIQPTRDEQYF	TRBV30	TRBJ2-7
TGTGCCAGCAGCTCTCCCGCCGGGACTAACTATGGCTACACCTTC	CASSSPAGTNYGYTF	TRBV7-3	TRBJ1-2
TGTGCCAGCAGCGACTCGGGGTGCGCCTATGGCTACACCTTC	CASSDSGCAYGYTF	TRBV9	TRBJ1-2
TGTGCCACCGGGGGTCTACCGGCGCTCTCCTACGAGCAGTACTTC	CATGGLPALSYEQYF	TRBV6-2	TRBJ2-7
TGTGCCAGCAGCCTAACAGCGATGAGTCAGCCCCAGCATTTT	CASSLTAMSQPQHF	TRBV7-3	TRBJ1-5
TGTGCCAGCAGTTTGGTATTAAAAGAGACCCAGTACTTC	CASSLVLKETQYF	TRBV6-5	TRBJ2-5
TGTGCCAGTAGTTGGCCGTTTTATGGCTACACCTTC	CASSWPFYGYTF	TRBV19	TRBJ1-2
TGTGCCAGCAGTGGGGGGACCGAGCAGTACTTC	CASSGGTEQYF	TRBV6-1	TRBJ2-7
TGTGCCACGGCCACTCGACCAGACGGGAGCAATCAGCCCCAGCATTTT	CATATRPDGSNQPQHF	TRBV24-1	TRBJ1-5
TGCGCCAGCAGCCCCCACAGGGGGAATGAGCAGTTCTTC	CASSPHRGNEQFF	TRBV5-1	TRBJ2-1
TGTGCCAGCAGCTTCTGCTGGTACGAGCAGTACTTC	CASSFCWYEQYF	TRBV5-6	TRBJ2-7
TGTGCCAGCTCACATGGGACAGGGGGCAACGAGCAGTACTTC	CASSHGTGGNEQYF	TRBV18	TRBJ2-7
TGTGCCAGCAGCTATAGACGCATCTCCTACGAGCAGTACTTC	CASSYRRISYEQYF	TRBV7-3	TRBJ2-7
TGTGCCATCAGTAAGACAGCTAACTATGGCTACACCTTC	CAISKTANYGYTF	TRBV10-3	TRBJ1-2
TGCGCCAGCACTGCGAGGGTAAACACCATATATTTT	CASTARVNTIYF	TRBV10-2	TRBJ1-3
TGTGCTAGTGCAATAGTCTCCTACGAGCAGTACTTC	CASAIVSYEQYF	TRBV12-5	TRBJ2-7
TGTGCCAGCAGCTTATCCCCAGCCCCAGGGGGCGGTCCTACCTCCTACGAGCAGTACTTC	CASSLSPAPGGGPTSYEQYF	TRBV7-2	TRBJ2-7
TGTGCCAGCAGCTGCAGGGATAGCTCCTATAATTCACCCCTCCACTTT	CASSCRDSSYNSPLHF	TRBV5-4	TRBJ1-6
TGTGCCAGCAAAACAGGAGGTTGCGGGGAGCTGTTTTTT	CASKTGGCGELFF	TRBV6-5	TRBJ2-2
TGTGCCAGGTGGGGACAGGGGACGTACGAGCAGTACTTC	CARWGQGTYEQYF	TRBV19	TRBJ2-7
TGTGCCGAGCAGGGAGAGACCCAGTACTTC	CAEQGETQYF	TRBV24-1	TRBJ2-5
TGTGCCAGCAGCGTACGAGGCTACGAGCAGTACTTC	CASSVRGYEQYF	TRBV7-4	TRBJ2-7
TGTGCCAGCAGTCCTAGCCGTCGATATAACACTGAAGCTTTCTTT	CASSPSRRYNTEAFF	TRBV27	TRBJ1-1
TGCGCCAGCAGGGTGGGGCGCGGGAGCCGGAACACTGAAGCTTTCTTT	CASRVGRGSRNTEAFF	TRBV10-1	TRBJ1-1
TGTGCCAGCAGTTTGGGCGGCGTAGATCAGCCCCAGCATTTT	CASSLGGVDQPQHF	TRBV27	TRBJ1-5
TGTGCCAGCAGCTTAGAGGAAGACCGTGGGCAGGGGGAAAATCAGCCCCAGCATTTT	CASSLEEDRGQGENQPQHF	TRBV7-8	TRBJ1-5
TGTGCCAGTTGTCCCATCAGGGTGGGGGGCGTACAGCCCCAGCATTTT	CASCPIRVGGVQPQHF	TRBV12-3	TRBJ1-5
TGCGCCAGCAGCGTGGACAGGGATCCCACTGAAGCTTTCTTT	CASSVDRDPTEAFF	TRBV5-1	TRBJ1-1
TGTGCCCTAGCTCTAGTGTACGAGCAGTACTTC	CALALVYEQYF	TRBV30	TRBJ2-7
TGTGCCAGCAGCTTCGTCATAAAACAGGGGCGAGAAAAACTGTTTTTT	CASSFVIKQGREKLFF	TRBV7-6	TRBJ1-4
TGCAGTGCTCTAGCGGGGAGAACCTACAATGAGCAGTTCTTC	CSALAGRTYNEQFF	TRBV20-1	TRBJ2-1
TGTGCCAGCAGCTTAATCAGGGACCTTAGGGGTGAAAAACTGTTTTTT	CASSLIRDLRGEKLFF	TRBV7-9	TRBJ1-4
TGTGCCAGCAGCTCCAACAAACTAGCGCCGTTGACCCTTGCCTACGAGCAGTACTTC	CASSSNKLAPLTLAYEQYF	TRBV7-2	TRBJ2-7
TGTGCCAGCAGCTTAGGTAAACAGGGGGGGACCTTC	CASSLGKQGGTF	TRBV7-2	TRBJ1-2
TGTGCCATCAGTGAGGGAGGGCACAGGGGCACAGATACGCAGTATTTT	CAISEGGHRGTDTQYF	TRBV10-3	TRBJ2-3
TGCAGCGTGACAGGGGATGGAATGAACACCGGGGAGCTGTTTTTT	CSVTGDGMNTGELFF	TRBV29-1	TRBJ2-2
TGTGCCACCACGGGTGGCTCCTACGAGCAGTACTTC	CATTGGSYEQYF	TRBV24-1	TRBJ2-7
TGTGCCAGCAGCCAAGGATGGAGGGAAGATTCACCCCTCCACTTT	CASSQGWREDSPLHF	TRBV4-2	TRBJ1-6
TGCGCCAGCAGCTTGATAACAGGGACCTACGAGCAGTACTTC	CASSLITGTYEQYF	TRBV5-1	TRBJ2-7
TGCGCCAGCAGCTTGCTCCCGCGGGAGGGGGGATATGGCTACACCTTC	CASSLLPREGGYGYTF	TRBV5-1	TRBJ1-2
TGTGCCAGCAGTTATAGGGGACTAGCGGGGACTGGGGCCAACGTCCTGACTTTC	CASSYRGLAGTGANVLTF	TRBV6-2	TRBJ2-6
TGCGCCAGCATCCGGGGAGGAGGCTCCTACGAGCAGTACTTC	CASIRGGGSYEQYF	TRBV4-3	TRBJ2-7
TGTGCCAGCAGTTACTCGTGGACAATTATTATTAATTCACCCCTCCACTTT	CASSYSWTIIINSPLHF	TRBV6-5	TRBJ1-6
TGTGCCAGCAGCTTGGTCCCCAGGTATGGCTACACCTTC	CASSLVPRYGYTF	TRBV5-4	TRBJ1-2
TGTGCCAGCAGCCGGGACAGGGTTGCAACGAACACTGAAGCTTTCTTT	CASSRDRVATNTEAFF	TRBV9	TRBJ1-1
TGTGCCAGCCAAAGGACAGGTCACCGCAATCAGCCCCAGCATTTT	CASQRTGHRNQPQHF	TRBV6-4	TRBJ1-5
TGTGCCAGCAGTTCCGTTATGACTAGCGGGGGGGCCAAGGACGCCTACAATGAGCAGTTCTTC	CASSSVMTSGGAKDAYNEQFF	TRBV27	TRBJ2-1
TGTGCCAGCAGTTACCCTAGTAAGAACAATGAGCAGTTCTTC	CASSYPSKNNEQFF	TRBV6-6	TRBJ2-1
TGTGCCAGCACCCGGGACAGGTTCCGGAACACTGAAGCTTTCTTT	CASTRDRFRNTEAFF	TRBV6-4	TRBJ1-1
TGTGCCAGCAGCCAAGCCTTCGGGACTCCCACCGGGGAGCTGTTTTTT	CASSQAFGTPTGELFF	TRBV14	TRBJ2-2
TGCGCCAGCAGCTTCTTTAAAGTGGGACAGGGGTTAAGTGAGACCCAGTACTTC	CASSFFKVGQGLSETQYF	TRBV4-1	TRBJ2-5
TGTGCCAGCAGTTTAGAGGGACAGGGTGGAAGCTCCTACGAGCAGTACTTC	CASSLEGQGGSSYEQYF	TRBV28	TRBJ2-7
TGCGCCAGCAGCTCGGGGAGGCGCGGGCAGTTCTTC	CASSSGRRGQFF	TRBV5-1	TRBJ2-1
TGCAGTGCTAGAGATCGACCCCCGACAGGGTGTCAGCTGGACGAGCAGTACTTC	CSARDRPPTGCQLDEQYF	TRBV20-1	TRBJ2-7
TGCGCCAGCAAAGGCGGGGGGGGGAACACCGGGGAGCTGTTTTTT	CASKGGGGNTGELFF	TRBV5-1	TRBJ2-2
TGCGCCAGCAGCCAACGTGGGAGCTCCTACAATGAGCAGTTCTTC	CASSQRGSSYNEQFF	TRBV4-1	TRBJ2-1
TGTGTAGACAGGGGGCACGGGGAAAAACTGTTTTTT	CVDRGHGEKLFF	TRBV4-2	TRBJ1-4
TGTGCCAGTAGTGGGGGAGGGTTGCCGGACACTGAAGCTTTCTTT	CASSGGGLPDTEAFF	TRBV19	TRBJ1-1
TGTGCCATCCCCGGGACTAGCGGGTACAATGAGCAGTTCTTC	CAIPGTSGYNEQFF	TRBV10-3	TRBJ2-1
TGCAGTGCTAGCCCCCGGGGGGAGGAGGAAGCAGATACGCAGTATTTT	CSASPRGEEEADTQYF	TRBV20-1	TRBJ2-3
TGTGCCAGAGAGGGCAAGGGAAACATTCAGTACTTC	CAREGKGNIQYF	TRBV6-4	TRBJ2-4
TGTGCCAGCAGTTACTCACATTTCAGGCCTGATTTGTACTCCTACAATGAGCAGTTCTTC	CASSYSHFRPDLYSYNEQFF	TRBV6-3	TRBJ2-1
TGTGCCAGCAGCCCCCTCGGGGGTTCGGCTGAAGCTTTCTTT	CASSPLGGSAEAFF	TRBV7-9	TRBJ1-1
TGTGCCAGCAGTGCAGACAGGGTGCCGAACACCGGGGAGCTGTTTTTT	CASSADRVPNTGELFF	TRBV6-1	TRBJ2-2
TGTGCCAGCAGCCCCCCCGAGGACAGCGGACAAGCTTTCTTT	CASSPPEDSGQAFF	TRBV5-5	TRBJ1-1
TGTGCCAGCATGATATCGACGCTCCCTGAAGCTTTCTTT	CASMISTLPEAFF	TRBV4-2	TRBJ1-1
TGTGCCTGGAGTAGACAGATCCGGGGGGATAGCAATCAGCCCCAGCATTTT	CAWSRQIRGDSNQPQHF	TRBV30	TRBJ1-5
TGTGCCAGCAATGGGGGGTCTACGTATGGCTACACCTTC	CASNGGSTYGYTF	TRBV5-5	TRBJ1-2
TGTGCCAGCAGTGACTCCGTGGGACTACCCAAAAACATTCAGTACTTC	CASSDSVGLPKNIQYF	TRBV6-4	TRBJ2-4
TGTGCCAGCAGTTTCAATCCCCGGGACAGGGGGCGGGGGCACGAGCAGTACTTC	CASSFNPRDRGRGHEQYF	TRBV27	TRBJ2-7
TGTGCCAGACCTTTGGGGAGGGATGAGCAGTTCTTC	CARPLGRDEQFF	TRBV12-3	TRBJ2-1
TGTGCCACCAGTGATTTCCCCTCTGACAGCCCGACAGATACGCAGTATTTT	CATSDFPSDSPTDTQYF	TRBV24-1	TRBJ2-3
TGCAGTGCTAGAAACACGGCGGAGCGTAACACAGATACGCAGTATTTT	CSARNTAERNTDTQYF	TRBV20-1	TRBJ2-3
TGTGCCAGCAGCGGGTTAAGCGGGTCTTCAGAGACCCAGTACTTC	CASSGLSGSSETQYF	TRBV7-2	TRBJ2-5
TGTGCCAGCAGCTACCACAACCTCCAGGGAACCGGGGAGCTGTTTTTT	CASSYHNLQGTGELFF	TRBV7-2	TRBJ2-2
TGCAGTGCTAGAGGGAGGACGGACACTGAAGCTTTCTTT	CSARGRTDTEAFF	TRBV20-1	TRBJ1-1
TGCGCCAGCACGACCCCCAGCCAAGCTTTCTTT	CASTTPSQAFF	TRBV5-1	TRBJ1-1
TGTGCCAGGGCTCTAGATGATGAGCAGTTCTTC	CARALDDEQFF	TRBV6-6	TRBJ2-1
TGCAGCGACCGAGCGAGCTCCTACAATGAGCAGTTCTTC	CSDRASSYNEQFF	TRBV29-1	TRBJ2-1
TGTGCCTGGGGACCCGATTACAATGAGCAGTTCTTC	CAWGPDYNEQFF	TRBV2	TRBJ2-1
TGTGCCAGCAGTTGCAGCGGGAACTTCGGGGGGAAAAACATTCAGTACTTC	CASSCSGNFGGKNIQYF	TRBV27	TRBJ2-4
TGTGCCAGCAAGACAGGGCGCAAAAACATTCAGTACTTC	CASKTGRKNIQYF	TRBV14	TRBJ2-4
TGCAGTGCTAGAAAGGGGGGGCCCGGGGCACAGCTTGCCAAATACGAGCAGTACTTC	CSARKGGPGAQLAKYEQYF	TRBV20-1	TRBJ2-7
TGTGGATTCGGACCTGTTAACTATGGCTACACCTTC	CGFGPVNYGYTF	TRBV25-1	TRBJ1-2
TGTGCCAGTAGACGAAAGGGCCCGTATGGCTACACCTTC	CASRRKGPYGYTF	TRBV19	TRBJ1-2
TGCAGTGCCAGTTCGGCCTACGAGCAGTACTTC	CSASSAYEQYF	TRBV20-1	TRBJ2-7
TGTGCCAGCATAACCATTAGACGTTCCTCTGGGGCCAACGTCCTGACTTTC	CASITIRRSSGANVLTF	TRBV6-1	TRBJ2-6
TGTGCCAGCAGCACCCCGCGGACAGGGCGGAACACCGGGGAGCTGTTTTTT	CASSTPRTGRNTGELFF	TRBV7-2	TRBJ2-2
TGTGCCAGCAGCTACTCCAGGGCGGGAGACTATGGCTACACCTTC	CASSYSRAGDYGYTF	TRBV9	TRBJ1-2
TGTGCCAGCAGTTATCCTTGGGGACAGGGAGGGGGGGAAGGGGACACAGATACGCAGTATTTT	CASSYPWGQGGGEGDTDTQYF	TRBV6-5	TRBJ2-3
TGTGCCTGGAGTGTTCCGGGACAGGCGGCTGGGGCCAACGTCCTGACTTTC	CAWSVPGQAAGANVLTF	TRBV30	TRBJ2-6
TGTGCCAGCAACCCAGGGGGAGAAGAGCAGTACTTC	CASNPGGEEQYF	TRBV7-6	TRBJ2-7
TGCAGTGCTAGAGATATAAAGGGGGCTGCTTTCTTT	CSARDIKGAAFF	TRBV20-1	TRBJ1-1
TGCAGCGTTTTAGATCCTATAACAGGGCCCGATACTGAAGCTTTCTTT	CSVLDPITGPDTEAFF	TRBV29-1	TRBJ1-1
TGTGCCAGCAGGGGGGGACAGACTAGCAATCAGCCCCAGCATTTT	CASRGGQTSNQPQHF	TRBV2	TRBJ1-5
TGTGCCAGCAGCTGGGGGGTCGTTACTGAAGCTTTCTTT	CASSWGVVTEAFF	TRBV14	TRBJ1-1
TGTGCCAGCAGACGTCAAAGGGACGGGACAGGGGCCGAGTCTGGGGCCAACGTCCTGACTTTC	CASRRQRDGTGAESGANVLTF	TRBV6-2	TRBJ2-6
TGTGCCACCAGCAGAGATTTCAGGGGACAAGAGACCCAGTACTTC	CATSRDFRGQETQYF	TRBV15	TRBJ2-5
TGTGCCAGCAGTTATACGGACAGTGAAAAACTGTTTTTT	CASSYTDSEKLFF	TRBV6-5	TRBJ1-4
TGTGCCAGCAGCTTAGGGGGACTAGGTGGAGGCAACTCCTACAATGAGCAGTTCTTC	CASSLGGLGGGNSYNEQFF	TRBV11-3	TRBJ2-1
TGTGCCTGGACTGGGGCGGGCCAAGAGACCCAGTACTTC	CAWTGAGQETQYF	TRBV30	TRBJ2-5
TGTGCCACCGGTGCGGGGAATCAGCCCCAGCATTTT	CATGAGNQPQHF	TRBV24-1	TRBJ1-5
TGCGCCAGCAGCCTTGTGACAGGGGTGGCGCGAAGATGGGAGAACACCGGGGAGCTGTTTTTT	CASSLVTGVARRWENTGELFF	TRBV4-1	TRBJ2-2
TGTGCCAGCAGCAAGACCCCGGGACAGGGGACCGGGGAGCTGTTTTTT	CASSKTPGQGTGELFF	TRBV11-3	TRBJ2-2
TGCGCCAGCTGGGGCTACAACACCGGGGAGCTGTTTTTT	CASWGYNTGELFF	TRBV10-1	TRBJ2-2
TGCAGCGTTGAGGACTGGTATAGCAATCAGCCCCAGCATTTT	CSVEDWYSNQPQHF	TRBV29-1	TRBJ1-5
TGTGCCAGCAGCCAAGCCCCACTGGGGGGCAGTTACTTCGGAGGAGGCTACACCTTC	CASSQAPLGGSYFGGGYTF	TRBV14	TRBJ1-2
TGTGCCAGAAGGGGGAATAAGATAGATACGCAGTATTTT	CARRGNKIDTQYF	TRBV27	TRBJ2-3
TGTGCCACCAGCAGAGATGAGTACCCAGGGACTACCTACGAGCAGTACTTC	CATSRDEYPGTTYEQYF	TRBV15	TRBJ2-7
TGCGCCAGCAGTGAGTCGCATAGAAGAGAAGAACACAATGAGCAGTTCTTC	CASSESHRREEHNEQFF	TRBV10-1	TRBJ2-1
TGTGCCAGCAGCCACAGTCGGGGGACTAACTATGGCTACACCTTC	CASSHSRGTNYGYTF	TRBV3-1	TRBJ1-2
TGTGCCAGCAGCATCTGGGAGGGCCCACGTAATGAAAAACTGTTTTTT	CASSIWEGPRNEKLFF	TRBV13	TRBJ1-4
TGTGCCTGGAGTACTGCCTTCGACACCGGACTGGTGGAGCAGTACTTC	CAWSTAFDTGLVEQYF	TRBV30	TRBJ2-7
TGTGCCGGACTAGCGACAGATACGCAGTATTTT	CAGLATDTQYF	TRBV7-9	TRBJ2-3
TGCGCCAGCAGCTCCAACCGGGACACAAGCGAGCAGTACTTC	CASSSNRDTSEQYF	TRBV5-1	TRBJ2-7
TGCAGTGCTAGCGGGGGGCCCGACAATGAGCAGTTCTTC	CSASGGPDNEQFF	TRBV20-1	TRBJ2-1
TGTGCCAGGGAGGGACAGGTCGAGACCCAGTACTTC	CAREGQVETQYF	TRBV9	TRBJ2-5
TGCGCCAGCAGCACTCATCCCATACGGGGGACAGATGAAAAACTGTTTTTT	CASSTHPIRGTDEKLFF	TRBV4-3	TRBJ1-4
TGTGCCCCTGTCTCCGGACGAGAAGCTAATGAAAAACTGTTTTTT	CAPVSGREANEKLFF	TRBV6-1	TRBJ1-4
TGTGCCAGCAGTTACGCGCGGACAGATACGCAGTATTTT	CASSYARTDTQYF	TRBV6-5	TRBJ2-3
TGTGCCAGTAGCTCATCGTCGGGTGCGAACACCGGGGAGCTGTTTTTT	CASSSSSGANTGELFF	TRBV19	TRBJ2-2
TGTGCCAGCAGCGGATTAGCGGTGTGGTACTTCTCTAGCACAGATACGCAGTATTTT	CASSGLAVWYFSSTDTQYF	TRBV7-3	TRBJ2-3
TGTGCCAGCAGTGACAGGGACTATGGCTACACCTTC	CASSDRDYGYTF	TRBV6-8	TRBJ1-2
TGTGCCAGCAGCTGTAGTCGGGAATTAAGCTCCTACAATGAGCAGTTCTTC	CASSCSRELSSYNEQFF	TRBV5-6	TRBJ2-1
TGTGCCAGCAGCGCGCAGACTTACACTGAAGCTTTCTTT	CASSAQTYTEAFF	TRBV5-4	TRBJ1-1
TGTGCCAGCAACCTATGGGACCTCTATGGCTACACCTTC	CASNLWDLYGYTF	TRBV28	TRBJ1-2
TGTGCCAGCCGGGTAGAGTACTTC	CASRVEYF	TRBV6-1	TRBJ2-7
TGTGCCAGCAAACGAGGGAAACATAGGCTCCCCTACAATGAGCAGTTCTTC	CASKRGKHRLPYNEQFF	TRBV14	TRBJ2-1
TGTGCCAGCAGGCTGCTGGCCACTCAGCCCCAGCATTTT	CASRLLATQPQHF	TRBV6-6	TRBJ1-5
TGCAGCGTTGAAGAAAAGGACAGTCAAGAGACCCAGTACTTC	CSVEEKDSQETQYF	TRBV29-1	TRBJ2-5
TGTGCCAGCAGCTCAGAAGAATGGGACAGGGGGGGGAGGAACTACGAGCAGTACTTC	CASSSEEWDRGGRNYEQYF	TRBV7-3	TRBJ2-7
TGTGCCAGCAGTTACCAAGGGGGGAGATCGAGCTCCTACGAGCAGTACTTC	CASSYQGGRSSSYEQYF	TRBV6-5	TRBJ2-7
TGTGCCAGTGGACCATACTCGGTCGAAGAGTCAGGTTATGGCTACACCTTC	CASGPYSVEESGYGYTF	TRBV12-3	TRBJ1-2
TGTGCCAGCAGTTTTTTCACCCCCACCATCCAGCCCCAGCATTTT	CASSFFTPTIQPQHF	TRBV12-3	TRBJ1-5
TGTGCCAGGTACCCGAGCAATGAGCAGTTCTTC	CARYPSNEQFF	TRBV6-5	TRBJ2-1
TGCGCCAGCAGCAGGCCCAAGCAAACCTACGAGCAGTACTTC	CASSRPKQTYEQYF	TRBV5-1	TRBJ2-7
TGTGCCAGCACCGAAGGGGGGCGCTACGAGCAGTACTTC	CASTEGGRYEQYF	TRBV2	TRBJ2-7
TGTGCCAGCAGTTACACGCAGGGCCGCAATCAGCCCCAGCATTTT	CASSYTQGRNQPQHF	TRBV6-6	TRBJ1-5
TGTGCCAGCAGCATTTTTCTCCCAGGGCCGTATGAGCAGTTCTTC	CASSIFLPGPYEQFF	TRBV7-4	TRBJ2-1
TGTGCCAGCAGCTTGCATTACCTTGGGGGGTCAGAGACCCAGTACTTC	CASSLHYLGGSETQYF	TRBV5-4	TRBJ2-5
TGTGCCACCAGGGAAAGACTGAACCCTTACGAGCAGTACTTC	CATRERLNPYEQYF	TRBV24-1	TRBJ2-7
TGCAGTGCAGGTATTTTTCGTGCTTTCTTT	CSAGIFRAFF	TRBV20-1	TRBJ1-1
TGTGCCAGCAGCTTGGCCCCCCCTAGGCACCCTCATTCACCCCTCCACTTT	CASSLAPPRHPHSPLHF	TRBV5-4	TRBJ1-6
TGTGCCAGCAGCGGACTTGGACAGGCTAACTATGGCTACACCTTC	CASSGLGQANYGYTF	TRBV7-2	TRBJ1-2
TGTGCCTGGAGTCTCCCCTGGGACAAGGGTATGAACACTGAAGCTTTCTTT	CAWSLPWDKGMNTEAFF	TRBV30	TRBJ1-1
TGTGCCAGCAGTGAAGACGGTCCCAGGGGGGAGGGGCTTTACACTGAAGCTTTCTTT	CASSEDGPRGEGLYTEAFF	TRBV6-1	TRBJ1-1
TGTGCCAGCAGCGGGAGGGTGAACACTGAAGCTTTCTTT	CASSGRVNTEAFF	TRBV28	TRBJ1-1
TGCGCCAGCAGCTTGGGACAGGGTGGTGAAGCTTTCTTT	CASSLGQGGEAFF	TRBV5-1	TRBJ1-1
TGTGCCAGTAGTATGGGGGGGTATGGCTACACCTTC	CASSMGGYGYTF	TRBV19	TRBJ1-2
TGTGCCAGCAAACCGCGGCGGACAGGTCCGGAGACCCAGTACTTC	CASKPRRTGPETQYF	TRBV7-8	TRBJ2-5
TGTGCCAGCAGCTTAGGGAGGGAAGAAAAACTGTTTTTT	CASSLGREEKLFF	TRBV7-3	TRBJ1-4
TGCGCCAGCAGCCAAGATCTAGGGGACAGGGGAGACTACGAGCAGTACTTC	CASSQDLGDRGDYEQYF	TRBV4-1	TRBJ2-7
TGTGCCAGCAGCCAAGGCAGGGGCTGGGGGTACGAGCAGTACTTC	CASSQGRGWGYEQYF	TRBV3-1	TRBJ2-7
TGTGCCAGCAGCGTAGAGCGGGGTCAAGAGACCCAGTACTTC	CASSVERGQETQYF	TRBV9	TRBJ2-5
TGTGCCAGCAGCCCCCTCCTTAACCATAGCAATCAGCCCCAGCATTTT	CASSPLLNHSNQPQHF	TRBV6-1	TRBJ1-5
TGCGCCAGCAGCGCCCCAACTGCCAGGGGATTTCCTCTAGCCAAAAACATTCAGTACTTC	CASSAPTARGFPLAKNIQYF	TRBV5-1	TRBJ2-4
TGCAGTGCTCGGGGTGAGCAGTACTTC	CSARGEQYF	TRBV20-1	TRBJ2-7
TGCAGCGTTGAAGTAGCGGGTGTCTACGAGCAGTACTTC	CSVEVAGVYEQYF	TRBV29-1	TRBJ2-7
TGTGCCAGTAGTATAGATCGACAGGGGTGCACTGAAGCTTTCTTT	CASSIDRQGCTEAFF	TRBV19	TRBJ1-1
TGTGCCAGTAGTTGGGACGGGAGGGCCTACGAGCAGTACTTC	CASSWDGRAYEQYF	TRBV19	TRBJ2-7
TGTGCCAGCAGCTTAAGTCATGTTTACCCGGGGAAGAGATGTAACTATGGCTACACCTTC	CASSLSHVYPGKRCNYGYTF	TRBV7-9	TRBJ1-2
TGTGCCACCAGCAGTACCCGGGGATACAAAAACATTCAGTACTTC	CATSSTRGYKNIQYF	TRBV15	TRBJ2-4
TGTGCCAGCAACCACGGACAGGGGGCGTCTCAGCCCCAGCATTTT	CASNHGQGASQPQHF	TRBV7-9	TRBJ1-5
TGCAGCGTTGAAACTTTCCGGGGAGTGGTGCAGTACTTC	CSVETFRGVVQYF	TRBV29-1	TRBJ2-7
TGTGCCACCAGACTCCAACTAGCGGGGGCTCGTGAGCAGTTCTTC	CATRLQLAGAREQFF	TRBV24-1	TRBJ2-1
TGTGCCAGCATCTTCTACATTATGCGGGGGGGGAACTCCTACGAGCAGTACTTC	CASIFYIMRGGNSYEQYF	TRBV27	TRBJ2-7
TGTGCCAGCAGCGGTATGACAGGGGCGGAGGAGCAGTACTTC	CASSGMTGAEEQYF	TRBV9	TRBJ2-7
TGTGCCAGTAGATTAAAAGGCGAGCAGTACTTC	CASRLKGEQYF	TRBV19	TRBJ2-7
TGTGCCAGCAGCACCGGGACAGGGCAAGATAGAACTAATGAAAAACTGTTTTTT	CASSTGTGQDRTNEKLFF	TRBV7-3	TRBJ1-4
TGTGCCAGCACAAACGAGAATGGCTACACCTTC	CASTNENGYTF	TRBV27	TRBJ1-2
TGTGCCAGCAGCTTGGTTCCCCAGACAGCTACTCAGCCCCAGCATTTT	CASSLVPQTATQPQHF	TRBV7-6	TRBJ1-5
TGTGCCAGCAGTTGGACAGGGGGCTCCGAAAAACTGTTTTTT	CASSWTGGSEKLFF	TRBV7-3	TRBJ1-4
TGTGCCAGCAGCCTCGCCAATGAGCAGTTCTTC	CASSLANEQFF	TRBV11-3	TRBJ2-1
TGTGCCAGCAGCCAAGATGGACGACCTAACCTAGCTTCCAGGGAGACCCAGTACTTC	CASSQDGRPNLASRETQYF	TRBV14	TRBJ2-5
TGCAGCGTGGTGCCCTGGACGGGGACTGATACGCAGTATTTT	CSVVPWTGTDTQYF	TRBV29-1	TRBJ2-3
TGTGCTAGTGGTGGTGCTTACCCGGGGGGAAATGAGCAGTTCTTC	CASGGAYPGGNEQFF	TRBV12-5	TRBJ2-1
TGTGCCAGCAGGTCCCGGGACTGGACCCAGTACTTC	CASRSRDWTQYF	TRBV6-6	TRBJ2-5
TGCAGCGGGGCCCCTCGCAATGAGCAGTTCTTC	CSGAPRNEQFF	TRBV29-1	TRBJ2-1
TGTGCCAGCAGCCTGACTAGCGGACTTTGGTGGCACTCCTACGAGCAGTACTTC	CASSLTSGLWWHSYEQYF	TRBV13	TRBJ2-7
TGTGCCAGGATCGGGCGACTCTATGGCTACACCTTC	CARIGRLYGYTF	TRBV2	TRBJ1-2
TGTGCCAGCAGCTATCCCTTTCGGAATGAAAAACTGTTTTTT	CASSYPFRNEKLFF	TRBV7-4	TRBJ1-4
TGCGCCAGCAACCAGGGGTCCACTGAAGCTTTCTTT	CASNQGSTEAFF	TRBV5-1	TRBJ1-1
TGTGCCTGGAATCTTGGGAGGCAGTTCTTC	CAWNLGRQFF	TRBV30	TRBJ2-1
TGTGCTCCATTCGGGATTTATGGCTACACCTTC	CAPFGIYGYTF	TRBV5-8	TRBJ1-2
TGTGCCAGCAGTTACAAGTGGGGCGAGCCCCAGCATTTT	CASSYKWGEPQHF	TRBV6-5	TRBJ1-5
TGCGCCAGCAGCTTGGCGCCACAGGGGGCACTTAATCGGAGCGGGGAGCTGTTTTTT	CASSLAPQGALNRSGELFF	TRBV5-1	TRBJ2-2
TGTGCCAGCAGAACAGAAGGACTAGCGGGATATGAGCAGTTCTTC	CASRTEGLAGYEQFF	TRBV3-1	TRBJ2-1
TGTGCCAGCAGCTTCCCAAAAACGGGATACAGGTTGGATGCTTTCTTT	CASSFPKTGYRLDAFF	TRBV7-2	TRBJ1-1
TGTGCCAGCAGTGAACAGAAAGTCACGCCTCCTTACGAGCAGTACTTC	CASSEQKVTPPYEQYF	TRBV25-1	TRBJ2-7
TGTGCCAGCAGCTTAGTAAGAGAGCTCGGAAGTCCCACCGGGGAGCTGTTTTTT	CASSLVRELGSPTGELFF	TRBV7-2	TRBJ2-2
TGTGAAGGGAAACTTCTAGAGACTAACAATCAGCCCCAGCATTTT	CEGKLLETNNQPQHF	TRBV24-1	TRBJ1-5
TGTGCCAGCAGTTCATTCCATGGGAGGGGTCGAACCCAGTACTTC	CASSSFHGRGRTQYF	TRBV6-6	TRBJ2-5
TGTGCCAGCGACAGGGGGGGAACCGATCAGCCCCAGCATTTT	CASDRGGTDQPQHF	TRBV18	TRBJ1-5
TGCGCCAGCAGCTGGCCCCTCACGGAAGCTTTCTTT	CASSWPLTEAFF	TRBV5-1	TRBJ1-1
TGTGCCAGCAGTTTCGCCGGGACAGGGATGGAGCTGTTTTTT	CASSFAGTGMELFF	TRBV28	TRBJ2-2
TGCGCCAGCGAAGGGACAGGATTCGAGGCTTTCTTT	CASEGTGFEAFF	TRBV10-2	TRBJ1-1
TGTGCCAGCAGCTCCGACAGAGACTCCTACAATGAGCAGTTCTTC	CASSSDRDSYNEQFF	TRBV27	TRBJ2-1
TGCAGTGCTAGACCAATACAAGATACGCAGTATTTT	CSARPIQDTQYF	TRBV20-1	TRBJ2-3
TGTGCTAGTGGTTTGGATTATACTAGGGACAGCACTGAAGCTTTCTTT	CASGLDYTRDSTEAFF	TRBV12-5	TRBJ1-1
TGTGCCAGTAGTATAGAGGCCCTTTGTGGCGGCGGCCCGGGACGATGCAATCAGCCCCAGCATTTT	CASSIEALCGGGPGRCNQPQHF	TRBV19	TRBJ1-5
TGCAGCGATAGCTTCGGGATAGCTAACTATGGCTACACCTTC	CSDSFGIANYGYTF	TRBV29-1	TRBJ1-2
TGTGCCAGCAGTTTATCCCGGATTTCACCCCTCCACTTT	CASSLSRISPLHF	TRBV27	TRBJ1-6
TGTGCCAGGGGTAGCTTAGAGAGGGGCACTGAAGCTTTCTTT	CARGSLERGTEAFF	TRBV2	TRBJ1-1
TGTGCCAGCGGGTCCAACGGTGGGAAAATAGGGGAGCTGTTTTTT	CASGSNGGKIGELFF	TRBV6-4	TRBJ2-2
TGCAGCGTTGAAAGGACGGCGGGAGTAAACTATGGCTACACCTTC	CSVERTAGVNYGYTF	TRBV29-1	TRBJ1-2
TGTGCCAGCAGCCGCCCGACGCCGGGAGGGGGGAAGGAGCAGTACTTC	CASSRPTPGGGKEQYF	TRBV7-4	TRBJ2-7
TGTGCCACCGTAAGGACAGTGCTTCTGTTTTTT	CATVRTVLLFF	TRBV24-1	TRBJ1-4
TGTGCCAGCAGCCAGGGGGCTAATGGGAACTATGGCTACACCTTC	CASSQGANGNYGYTF	TRBV27	TRBJ1-2
TGTGCCAGCAGGACGGGACGTGTCTACGAGCAGTACTTC	CASRTGRVYEQYF	TRBV6-2	TRBJ2-7
TGTGCCAGCAGCCAGGATGGGGACAGGGGGCAGGGGAGCACTGAAGCTTTCTTT	CASSQDGDRGQGSTEAFF	TRBV9	TRBJ1-1
TGTGCCAGCAGTCCAGACTCCGGGTCTGAAGCTTTCTTT	CASSPDSGSEAFF	TRBV25-1	TRBJ1-1
TGTGCCAGCAGCTATAGCGGGCTGGGCACCTACGAGCAGTACTTC	CASSYSGLGTYEQYF	TRBV7-2	TRBJ2-7
TGTGCCAGCAGTTTAGAAGGGGGACTAGAGTGGCCTCCTTCCTACGAGCAGTACTTC	CASSLEGGLEWPPSYEQYF	TRBV12-4	TRBJ2-7
TGTGCCAGCAGCGTAGGTACGGAGCAGCAAGAGTATTTT	CASSVGTEQQEYF	TRBV9	TRBJ2-3
TGCGCCAGCAGCCAAGCCAGGAGAGCCACAGATACGCAGTATTTT	CASSQARRATDTQYF	TRBV4-3	TRBJ2-3
TGTGCTAGTGGTCCCCAGGGACAGGGGACCTACTCCTACGAGCAGTACTTC	CASGPQGQGTYSYEQYF	TRBV12-5	TRBJ2-7
TGTGCCAGCTCTGGGGCCTATAGCAATCAGCCCCAGCATTTT	CASSGAYSNQPQHF	TRBV5-8	TRBJ1-5
TGTGCCAGCAGTGGGGACAGGGTAATTTGGCCCATCTATGGCTACACCTTC	CASSGDRVIWPIYGYTF	TRBV25-1	TRBJ1-2
TGTGCCAGCAGCTTGAACCTGGGACAGGCTGGGGCCAACGTCCTGACTTTC	CASSLNLGQAGANVLTF	TRBV5-6	TRBJ2-6
TGTGCCAGCAGTTTCCTAGTAGGGGATCTAGCCAAAAACATTCAGTACTTC	CASSFLVGDLAKNIQYF	TRBV28	TRBJ2-4
TGTGCCAGCAGTTCGGGCGACAGGACCTACGAGCAGTACTTC	CASSSGDRTYEQYF	TRBV6-5	TRBJ2-7
TGTGCCAGCCTAGGGACAGACAATGCAACTAATGAAAAACTGTTTTTT	CASLGTDNATNEKLFF	TRBV6-5	TRBJ1-4
TGTGCCAGCAGCCCGGACGACAATGAGCAGTTCTTC	CASSPDDNEQFF	TRBV9	TRBJ2-1
TGTGCCAGCAGCCAAGAAGGAGTATTCATACGACCTAACTATGGCTACACCTTC	CASSQEGVFIRPNYGYTF	TRBV4-2	TRBJ1-2
TGCGCCAGCAGCTTCAACAGGGCCTACGAGCAGTACTTC	CASSFNRAYEQYF	TRBV5-1	TRBJ2-7
TGCGCCAGCAGCTTGAGACAGGGGGCACCTAGCGCCTATAATTCACCCCTCCACTTT	CASSLRQGAPSAYNSPLHF	TRBV5-1	TRBJ1-6
TGCAGTGCTAGCTCAGGGGTCCCGGAGACAGATACGCAGTATTTT	CSASSGVPETDTQYF	TRBV20-1	TRBJ2-3
TGCGCCAGCAGCTTGGCCTACGGGGGTTTTGAGCAGTACTTC	CASSLAYGGFEQYF	TRBV5-1	TRBJ2-7
TGCGCCAGCAGTGAGTCCTGGTACAGGGGGAAGTATGTGAACACTGAAGCTTTCTTT	CASSESWYRGKYVNTEAFF	TRBV10-1	TRBJ1-1
TGTGCCAGCAGCATCTCCAAGTGCAATGAGCAGTTCTTC	CASSISKCNEQFF	TRBV9	TRBJ2-1
TGTGCCAGCAGCCGCTCCGTGGGGTCCGCTGGCCCCTACGAGCAGTACTTC	CASSRSVGSAGPYEQYF	TRBV9	TRBJ2-7
TGTGCCAGCAGCTTAGGTTCTTTAGCGGGGCATGGGGACGAGCAGTACTTC	CASSLGSLAGHGDEQYF	TRBV11-2	TRBJ2-7
TGTGCCACCAGTGATTGTGGGGAGGAAACACCTACTGAAGCTTTCTTT	CATSDCGEETPTEAFF	TRBV24-1	TRBJ1-1
TGTGCCAGCAGCTTGGATCTAGACGGGCAACTTGGGTTAGGGGAAGAGACCCAGTACTTC	CASSLDLDGQLGLGEETQYF	TRBV5-5	TRBJ2-5
TGTGCCGGGCGGGAGCGCAATAATCAGCCCCAGCATTTT	CAGRERNNQPQHF	TRBV19	TRBJ1-5
TGTGCCAGCAGCTTGGCCGGGGGGGCCGGGGAGCCAGAGACCCAGTACTTC	CASSLAGGAGEPETQYF	TRBV5-6	TRBJ2-5
TGTGCCAGCAGCACAGGTGAGTCACCCCTCCACTTT	CASSTGESPLHF	TRBV28	TRBJ1-6
TGTGAAACTACTCCGGATAATTCACCCCTCCACTTT	CETTPDNSPLHF	TRBV5-6	TRBJ1-6
TGCGCCAGCAGTAGGGCGTCCCGGGCGGTCTTATACTCGTATGAGCAGTTCTTC	CASSRASRAVLYSYEQFF	TRBV10-2	TRBJ2-1
TGTGCCAGCAGCTTAGATCCCCCCTGTTTACCAGGGTGGAAAAACATTCAGTACTTC	CASSLDPPCLPGWKNIQYF	TRBV11-2	TRBJ2-4
TGTGCCAGCAGCAGGGGGAGCGAGCAGTACTTC	CASSRGSEQYF	TRBV6-5	TRBJ2-7
TGTGCCAGCTCACCGGCGGGAGGGAAGCGGTACTTC	CASSPAGGKRYF	TRBV18	TRBJ2-5
TGTGCCAGCAGTGAATATACGGTATGGTATTTT	CASSEYTVWYF	TRBV25-1	TRBJ2-3
TGTGCCAGCAGCAGACCGGGACAGGGGATACCAGGGACTGAAGCTTTCTTT	CASSRPGQGIPGTEAFF	TRBV5-6	TRBJ1-1
TGTGCCACCAGTGATTGGGGAGAACGCTACGAGCAGTACTTC	CATSDWGERYEQYF	TRBV24-1	TRBJ2-7
TGTGCCAGCAGCGGGAAGAACCTAGCGGGGGGGACTGAGCAGTTCTTC	CASSGKNLAGGTEQFF	TRBV9	TRBJ2-1
TGTGCCAGCCCGTCCTGCGGGAGCCCTGAAGCTTTCTTT	CASPSCGSPEAFF	TRBV6-1	TRBJ1-1
TGTGCCAGCAGTATAGAGGGGAGTTTTGGGGCCACCATATATTTT	CASSIEGSFGATIYF	TRBV27	TRBJ1-3
TGTGCCAGCAGCCGCGAGAACTCACCCCTCCACTTT	CASSRENSPLHF	TRBV7-9	TRBJ1-6
TGTGCCAGCAGCGGGGGTGACCAATTGCAAGGGGCCAACGTCCTGACTTTC	CASSGGDQLQGANVLTF	TRBV13	TRBJ2-6
TGTGCCAGTTTCTCCCAGTTGGACAGGGGAAATGAGCAGTTCTTC	CASFSQLDRGNEQFF	TRBV10-3	TRBJ2-1
TGTGCCAGCTCACCCCCTAAGGGGACAGTTTTTCCGAACACTGAAGCTTTCTTT	CASSPPKGTVFPNTEAFF	TRBV18	TRBJ1-1
TGTGCCAGCAGTAATGACAGGGAAGAGCAGTACTTC	CASSNDREEQYF	TRBV6-1	TRBJ2-7
TGTGCCAGCACAACTTGCCCTCGGGGGGCCGGAGGCGTCCCTATCGAGCAGTACTTC	CASTTCPRGAGGVPIEQYF	TRBV5-4	TRBJ2-7
TGTGCCAGCAGTACGGGACAGGGGTGGAGGAACGAGCAGTACTTC	CASSTGQGWRNEQYF	TRBV12-3	TRBJ2-7
TGTGCCAGCAGCCGTCGAAGGGGTTCGGCGAACACCGGGGAGCTGTTTTTT	CASSRRRGSANTGELFF	TRBV13	TRBJ2-2
TGTGCCAGCAGTTTCAAGTATACAGGGTTCAAAAACATTCAGTACTTC	CASSFKYTGFKNIQYF	TRBV27	TRBJ2-4
TGTGCCAGCAGTTTAGTGAGGGGCCCACAGGCCTACGAGCAGTACTTC	CASSLVRGPQAYEQYF	TRBV12-4	TRBJ2-7
TGTGCTAGTGGTTTCCGCGTCTTC	CASGFRVF	TRBV12-5	TRBJ2-1
TGTGCCAGCAGCTTAAGCGACAGGGGTCCTGGAAACACCATATATTTT	CASSLSDRGPGNTIYF	TRBV6-5	TRBJ1-3
TGCGCCAGCAGCCAAGATAAAATCTCAGGGGGCTACACCTTC	CASSQDKISGGYTF	TRBV4-3	TRBJ1-2
TGTGCCAGCAGCTTGGCACCTAACTATGGCTACACCTTC	CASSLAPNYGYTF	TRBV7-3	TRBJ1-2
TGTGCCAGCAGCCAGGTAAGGACAACCGGGACTGAGCAGTACTTC	CASSQVRTTGTEQYF	TRBV3-1	TRBJ2-7
TGTGCCAGCTCTCTTCAGACTTCCTACGAGCAGTACTTC	CASSLQTSYEQYF	TRBV27	TRBJ2-7
TGTGCCAGCAGCCTCGGGCAAGAGACCCAGTACTTC	CASSLGQETQYF	TRBV2	TRBJ2-5
TGCAGTGCTCTTGGGACAGTGGGTCCAGAATCCTACGAGCAGTACTTC	CSALGTVGPESYEQYF	TRBV20-1	TRBJ2-7
TGTGCCAGCAGTGACGGATTCAAAGAGACCCAGTACTTC	CASSDGFKETQYF	TRBV6-1	TRBJ2-5
TGTGCCAGCAGCTTAGTGGTGACTGGGTGCTACGAGCAGTACTTC	CASSLVVTGCYEQYF	TRBV7-9	TRBJ2-7
TGTGCCAGCAGCTTACTTCCCGGGTCGGAACTGTTTTTT	CASSLLPGSELFF	TRBV7-9	TRBJ1-4
TGTGCCAGCAGTGACGTCCTTCTAGGACCTCCGCCTGAGCAGTACTTC	CASSDVLLGPPPEQYF	TRBV25-1	TRBJ2-7
TGTGCCACCAGTGATAGTGAGGGTTCTGAAGCTTTCTTT	CATSDSEGSEAFF	TRBV24-1	TRBJ1-1
TGTGCCAGCAGTAAAGCTAGCGGGATATTGAGGAACGAGCAGTACTTC	CASSKASGILRNEQYF	TRBV6-3	TRBJ2-7
TGCAGTGCTAGATCCCGGACTGGTGAGACCCAGTACTTC	CSARSRTGETQYF	TRBV20-1	TRBJ2-5
TGCAGCGTTCTAGAGCGAGGACTAGCGGGAGACGAGGCCGGGGAGCTGTTTTTT	CSVLERGLAGDEAGELFF	TRBV29-1	TRBJ2-2
TGCAGTGCTGGCCGGGCTGGGGGTGAGCAGTACTTC	CSAGRAGGEQYF	TRBV20-1	TRBJ2-7
TGTGCCAGACGGGCCGGGACAGGGTTGAATCAGCCCCAGCATTTT	CARRAGTGLNQPQHF	TRBV7-4	TRBJ1-5
TGTGCCAGCAGCAGGGCAACTGAAGCTTTCTTT	CASSRATEAFF	TRBV13	TRBJ1-1
TGTGCCAGCTACACCGGGACCGGTAATATGGTCAGCAATCAGCCCCAGCATTTT	CASYTGTGNMVSNQPQHF	TRBV9	TRBJ1-5
TGTGCCAGCAGTTTCCCTGATAGCCAGGGGTTCTGTGAAAAACTGTTTTTT	CASSFPDSQGFCEKLFF	TRBV6-2	TRBJ1-4
TGTGCCAGCAGCTTCGGGAACGTCAAGGGACAAGAGACCCAGTACTTC	CASSFGNVKGQETQYF	TRBV7-9	TRBJ2-5
TGTGCCAGCAGTTTCTCGGGCCCGGCCTACAATGAGCAGTTCTTC	CASSFSGPAYNEQFF	TRBV12-3	TRBJ2-1
TGTGCCAGCAGCTTTCCGGATAGGAGTTCCGAAGAGACCCAGTACTTC	CASSFPDRSSEETQYF	TRBV7-8	TRBJ2-5
TGTGCCAGCAGCTGGGGGACAGGGGACGGGGACGATACGCAGTATTTT	CASSWGTGDGDDTQYF	TRBV13	TRBJ2-3
TGTGCCAGCAGCTTAGTATCACCCCTTAAAAGGGCAACTAATGAAAAACTGTTTTTT	CASSLVSPLKRATNEKLFF	TRBV7-9	TRBJ1-4
TGTGCCAGCAGCTTACCGGACAGGGTCCGAGACTATGGCTACACCTTC	CASSLPDRVRDYGYTF	TRBV7-9	TRBJ1-2
TGTGCCAGCAGCTTAGGGAAGACCTTGGACAGTTACTACGAGCAGTACTTC	CASSLGKTLDSYYEQYF	TRBV7-9	TRBJ2-7
TGTGCCAGCAGCTTTCATAAAAGCCCTTTCCTCCCGGGACTAGCGGGGGTAGTGATGAGGGGCACAGATACGCAGTATTTT	CASSFHKSPFLPGLAGVVMRGTDTQYF	TRBV9	TRBJ2-3
TGTGCCAGCAGTATACTCCGGGACAGAATCTACGAGCAGTACTTC	CASSILRDRIYEQYF	TRBV28	TRBJ2-7
TGTGCCAGCAGCTTTCGGACTAGCGGGGATACGCAGTATTTT	CASSFRTSGDTQYF	TRBV11-2	TRBJ2-3
TGTGCCAGCAGCTTAGGGGTTGATAGATTCTCTGGAAACACCATATATTTT	CASSLGVDRFSGNTIYF	TRBV7-6	TRBJ1-3
TGTGCCAGGACGTACACTGAAGCTTTCTTT	CARTYTEAFF	TRBV27	TRBJ1-1
TGCAGCGTTGAAGTCCAACAGGGGGCAGGGAATGGCTACACCTTC	CSVEVQQGAGNGYTF	TRBV29-1	TRBJ1-2
TGTGCCAGCAGCTTAGCGTTGCGGGAGGTGTACGAGCAGTACTTC	CASSLALREVYEQYF	TRBV11-2	TRBJ2-7
TGTGCCACCAGTGAAGGGCCTTACCGGGACAGTCACGAGCAGTACTTC	CATSEGPYRDSHEQYF	TRBV24-1	TRBJ2-7
TGTGCCAGCAGCCAAGATGGCGCAGGGGCACCCGGCGGGATCAATCAGCCCCAGCATTTT	CASSQDGAGAPGGINQPQHF	TRBV3-1	TRBJ1-5
TGTGCCAGCAGAACAAACGAGCAGTACTTC	CASRTNEQYF	TRBV13	TRBJ2-7
TGTGCCAGTCTTGCGACTTTGAACACCGGGGAGCTGTTTTTT	CASLATLNTGELFF	TRBV3-1	TRBJ2-2
TGTGCCAGGGGTTTCCTAGCAAACAATACGCAGTATTTT	CARGFLANNTQYF	TRBV7-3	TRBJ2-3
TGTGCCAGCAGCTCTAGCGGAGAATACAATGAGCAGTTCTTC	CASSSSGEYNEQFF	TRBV5-5	TRBJ2-1
TGTGCCAGCAGTTTAGTGGAAACAGGGGGCGCCAAGGCAGATATAAGTCTGTATAATTCACCCCTCCACTTT	CASSLVETGGAKADISLYNSPLHF	TRBV27	TRBJ1-6
TGTGCCAGCAGCCGATGGGGGGCGGGCTACGAGCAGTACTTC	CASSRWGAGYEQYF	TRBV11-2	TRBJ2-7
TGTGCCAGCGCGAGGGGCGGCTACACCTTC	CASARGGYTF	TRBV7-8	TRBJ1-2
TGTGCCAGCAGCACCCCGCAGATCATAATGAACACTGAAGCTTTCTTT	CASSTPQIIMNTEAFF	TRBV5-6	TRBJ1-1
TGTGCCAGCAGTTACTTCACCCGGGGGGGCACCGGGGAGCTGTTTTTT	CASSYFTRGGTGELFF	TRBV6-5	TRBJ2-2
TGCGCCAGCAGTGAGCCACACCCCGGGACAGGCAATCAGCCCCAGCATTTT	CASSEPHPGTGNQPQHF	TRBV10-1	TRBJ1-5
TGTGCCAGCAGTAAGGGGGCTTTAGTGAATGGCTACACCTTC	CASSKGALVNGYTF	TRBV28	TRBJ1-2
TGTGCCAGCAGCCAACCAACTAGGGGAGCCCAGCCCCAGCATTTT	CASSQPTRGAQPQHF	TRBV14	TRBJ1-5
TGCAGTGCCCGGGACAGGAGGTATTCACCCCTCCACTTT	CSARDRRYSPLHF	TRBV20-1	TRBJ1-6
TGTGCCAGCAGCCGGGTTGGTGAGCAGTACTTC	CASSRVGEQYF	TRBV3-1	TRBJ2-7
TGTGCCATCCGGCACAGGCAGGGGATCTACGAGCAGTACTTC	CAIRHRQGIYEQYF	TRBV10-3	TRBJ2-7
TGCAGTGCCCCAAACTCGATCCAGGACGCGTCCTCCTACGAGCAGTACTTC	CSAPNSIQDASSYEQYF	TRBV20-1	TRBJ2-7
TGTGCCAGCAGCCCCGGGCGAAGGGACAGGGGGCACTATGGCTACACCTTC	CASSPGRRDRGHYGYTF	TRBV7-3	TRBJ1-2
TGCGCCAGCAGCCAAGTCGGAGGCTTCACTGACACCATATATTTT	CASSQVGGFTDTIYF	TRBV4-3	TRBJ1-3
TGTGCCAGCAGTCCGGGGGGAAGCTACGAGCAGTACTTC	CASSPGGSYEQYF	TRBV6-2	TRBJ2-7
TGTGCCAGCAGAACGGGACGACGTACCTACCTGGGAAGCTCCTACAATGAGCAGTTCTTC	CASRTGRRTYLGSSYNEQFF	TRBV6-6	TRBJ2-1
TGCAGTGCTATAGGGGACAGGGGCGCCTACGAGCAGTACTTC	CSAIGDRGAYEQYF	TRBV20-1	TRBJ2-7
TGTGCCAGCAGCACGGATGACAGTTTCCACTACGAGCAGTACTTC	CASSTDDSFHYEQYF	TRBV7-3	TRBJ2-7
TGCAAAGAGGGGGGGCCCCCAATGAAAGGTTGGACGAACACCGGGGAGCTGTTTTTT	CKEGGPPMKGWTNTGELFF	TRBV20-1	TRBJ2-2
TGTGCCAGCAGTTGGGGGGGCCGAAGTCTAGGGGGGAACGAGCAGTACTTC	CASSWGGRSLGGNEQYF	TRBV28	TRBJ2-7
TGTGCCAGCAGCTTCCCCCAGGGCGGCCCAGAGACCCAGTACTTC	CASSFPQGGPETQYF	TRBV5-4	TRBJ2-5
TGTGCCCCTTTAGCACTAGCGGGAGGCACTGAAGCTTTCTTT	CAPLALAGGTEAFF	TRBV7-9	TRBJ1-1
TGTGCCAGCAGCGGGAAATATTCCCCTCTAACCAAGAATGAAAAACTGTTTTTT	CASSGKYSPLTKNEKLFF	TRBV5-4	TRBJ1-4
TGTGCCAGCAGCTTTTGCGGACAGGGGTCGACCTTT	CASSFCGQGSTF	TRBV11-3	TRBJ1-1
TGTGCCAGCAGTGACCAGGCCCTGGAGGTCTTC	CASSDQALEVF	TRBV6-4	TRBJ2-1
TGTGCCATCAGTGAGTCCCTCCTCAAGGGAAACATTCAGTACTTC	CAISESLLKGNIQYF	TRBV10-3	TRBJ2-4
TGCAGTGCTATCCGGGACAGGTGTCGAACTAATGAAAAACTGTTTTTT	CSAIRDRCRTNEKLFF	TRBV20-1	TRBJ1-4
TGCGCCAGCAGCCAAGTCGTACCTTCGCCGGGGTGGTATAATTCACCCCTCCACTTT	CASSQVVPSPGWYNSPLHF	TRBV4-3	TRBJ1-6
TGTGCCAGCAGCCAAGCATTTCAAGGCTACGAGCAGTACTTC	CASSQAFQGYEQYF	TRBV14	TRBJ2-7
TGTGCCAGCAGCCCCGCCCCAGAGAACCCGGGGGGCATACGGCAGTTCTTC	CASSPAPENPGGIRQFF	TRBV7-3	TRBJ2-1
TGTGCCAGCAGCGCCAAGGATCAGGGTTATTGCAATCAGCCCCAGCATTTT	CASSAKDQGYCNQPQHF	TRBV9	TRBJ1-5
TGTGCCAGCCCCATACCGTACGGGGAGCTGTTTTTT	CASPIPYGELFF	TRBV18	TRBJ2-2
TGCGCCAGCAGCTTGTGGGGGCGACTGGAAGAGACCCAGTACTTC	CASSLWGRLEETQYF	TRBV5-1	TRBJ2-5
TGCAGTGCTAGATTTCAACAGGGGGCCGAGCGTAACTATGGCTACACCTTC	CSARFQQGAERNYGYTF	TRBV20-1	TRBJ1-2
TGTGCCAGGCCCCTTCCGGGACTAGCGGGGATAACCGAGCAGTACTTC	CARPLPGLAGITEQYF	TRBV28	TRBJ2-7
TGCGCCAGCAGCTTGGACCCCCTTTCCGATATTGTCTATGGCTACACCTTC	CASSLDPLSDIVYGYTF	TRBV5-1	TRBJ1-2
TGCGCCAGCAGCCCGACTAGCCTCCAAGAGACCCAGTACTTC	CASSPTSLQETQYF	TRBV5-1	TRBJ2-5
TGTGCCAGCAGCTTGGCTTCGAGAACTTTGGGGACTGAAGCTTTCTTT	CASSLASRTLGTEAFF	TRBV11-2	TRBJ1-1
TGTGCCAGCAGCTACAGGGTTTTAGAGACCCAGTACTTC	CASSYRVLETQYF	TRBV11-2	TRBJ2-5
TGCAGTGCTAGACCGTCCGGCGCCAAAAACATTCAGTACTTC	CSARPSGAKNIQYF	TRBV20-1	TRBJ2-4
TGCGCCACTAAAAGAGGGGTAGCCAAAAACATTCAGTACTTC	CATKRGVAKNIQYF	TRBV10-1	TRBJ2-4
TGTGCCTGGACAGGGGACCCCTCCTACGAGCAGTACTTC	CAWTGDPSYEQYF	TRBV30	TRBJ2-7
TGTGCCAGCAGCCCCCCCGCGTGGGGGGCAGGGACCGGGGAGCAGTTCTTC	CASSPPAWGAGTGEQFF	TRBV9	TRBJ2-1
TGCAGCGTAAGGGACAGGGGCAATCAGCCCCAGCATTTT	CSVRDRGNQPQHF	TRBV29-1	TRBJ1-5
TGCAGTGCTAGTCCCTTTGCAGGGAGTGTCAATCAGCCCCAGCATTTT	CSASPFAGSVNQPQHF	TRBV20-1	TRBJ1-5
TGTGCCAGCAGCCAAAGTTACAGGGCACCGAACACTGAAGCTTTCTTT	CASSQSYRAPNTEAFF	TRBV12-4	TRBJ1-1
TGTGCCAGCTCACCGGACGGGCCAGAGAGCAATCAGCCCCAGCATTTT	CASSPDGPESNQPQHF	TRBV18	TRBJ1-5
TGTGCCAGCACAGAACAGTCCTATAGCAATCAGCCCCAGCATTTT	CASTEQSYSNQPQHF	TRBV9	TRBJ1-5
TGTGCTAGTGCCCCGGGACGGATCAACACCGGGGAGCTGTTTTTT	CASAPGRINTGELFF	TRBV12-5	TRBJ2-2
TGTGCCACCCGACTAGACGATACGCAGTATTTT	CATRLDDTQYF	TRBV24-1	TRBJ2-3
TGTGCCAGCAGCTTACTGGGGGGCTCCTACGAGCAGTACTTC	CASSLLGGSYEQYF	TRBV7-9	TRBJ2-7
TGTGCCAGCAGCGAAACGCCCCAGCATTTT	CASSETPQHF	TRBV13	TRBJ1-5
TGCACCAGATTTTCGTTTGAGGAGCTCTCCTACGAGCAGTACTTC	CTRFSFEELSYEQYF	TRBV5-1	TRBJ2-7
TGCATGACCGTAAACCCAGACGGCACAGATACGCAGTATTTT	CMTVNPDGTDTQYF	TRBV20-1	TRBJ2-3
TGTGCCAGCAGAACTGGGACGAGTGGGGACACCATATATTTT	CASRTGTSGDTIYF	TRBV6-5	TRBJ1-3
TGCGCCAGCAGCGTACCTAGCGGGGGCAACGAGCAGTACTTC	CASSVPSGGNEQYF	TRBV5-1	TRBJ2-7
TGTGCCAGCAGCCCTTTGGCGGCACAGCAGGGATTAAGCTCCTATAATTCACCCCTCCACTTT	CASSPLAAQQGLSSYNSPLHF	TRBV13	TRBJ1-6
TGTGCCAGCAGTTTATTGGGGGACGGTCAGCCCCAGCATTTT	CASSLLGDGQPQHF	TRBV27	TRBJ1-5
TGCAGTGCTAGAGATCAGGACAGGAGTAATGAAAAACTGTTTTTT	CSARDQDRSNEKLFF	TRBV20-1	TRBJ1-4
TGTGCCAGCAGCTTACCACTAGCGGGAGGTTCCATTCTGAACACTGAAGCTTTCTTT	CASSLPLAGGSILNTEAFF	TRBV7-9	TRBJ1-1
TGTGCCAGCATCAAAACGAGTCGAGTGGTGGAGGGCTACTACAATGAGCAGTTCTTC	CASIKTSRVVEGYYNEQFF	TRBV7-3	TRBJ2-1
TGTGCCAGCAGCGGAGCAGTGAACACTGAAGCTTTCTTT	CASSGAVNTEAFF	TRBV7-9	TRBJ1-1
TGTGCCAGCTCACCCCCCGGGACAGGGGCATGGGGAAGGAGGCCCGGGGAGCTGTTTTTT	CASSPPGTGAWGRRPGELFF	TRBV18	TRBJ2-2
TGTGCCAGCAGCGGCCCCCGCTTCCGGGGTGGCTATGGCTACACCTTC	CASSGPRFRGGYGYTF	TRBV5-6	TRBJ1-2
TGTGCCAGCAAAGGGACATCCTACAATGAGCAGTTCTTC	CASKGTSYNEQFF	TRBV12-4	TRBJ2-1
TGTGCCAGCAGCTCCCCTGACAGACGGGTTTCCTACGAGCAGTACTTC	CASSSPDRRVSYEQYF	TRBV5-6	TRBJ2-7
TGTGCCAGCAGCCTCGGGACTAGGAAGGGTTACGAGCAGTACTTC	CASSLGTRKGYEQYF	TRBV5-8	TRBJ2-7
TGTGCCAGCAGCAGGGCTAGCGGGTTTCCTCATGAGCAGTTCTTC	CASSRASGFPHEQFF	TRBV5-4	TRBJ2-1
TGTGCCACCAGTGAGAGAGGTGACGACGTCCAAGAGACCCAGTACTTC	CATSERGDDVQETQYF	TRBV24-1	TRBJ2-5
TGCGCCGTCCTGCCGACTCTTTGCTCCTACGAGCAGTACTTC	CAVLPTLCSYEQYF	TRBV4-1	TRBJ2-7
TGCGCCAGCAGCTTGTGCGGGGAGGGAAGGGGATACAATGAGCAGTTCTTC	CASSLCGEGRGYNEQFF	TRBV5-1	TRBJ2-1
TGTGCCAGCAGCCATTCCCCACAGGGGGCCTCCTACGAGCAGTACTTC	CASSHSPQGASYEQYF	TRBV13	TRBJ2-7
TGTGCCAGCAGGAAGGGGGGGGCGACAGATACGCAGTATTTT	CASRKGGATDTQYF	TRBV6-4	TRBJ2-3
TGTGCCAGCAGCTCGGGTTCCCGCTGGCAGGGAGGCAACATGAACACTGAAGCTTTCTTT	CASSSGSRWQGGNMNTEAFF	TRBV7-9	TRBJ1-1
TGTGCCACTCAGACGGCCTACGAGCAGTACTTC	CATQTAYEQYF	TRBV24-1	TRBJ2-7
TGCGCCAGCAGCCAAGAGTCTCAACCGACGGCCCGCCCAGATAGGAAGCCCCAGCATTTT	CASSQESQPTARPDRKPQHF	TRBV4-1	TRBJ1-5
TGCGCCAGCAGTGAGTCTTTCGGTGGGGGCCCTTCACCCCTCCACTTT	CASSESFGGGPSPLHF	TRBV10-1	TRBJ1-6
TGTGCCAGCAGTACTTCTCGCAAAATACAGGGGAAACCAGACTCTGGGGCCAACGTCCTGACTTTC	CASSTSRKIQGKPDSGANVLTF	TRBV6-2	TRBJ2-6
TGTGCTAGTGGTTTGGTACAAGTCCTAGGACTTGGGGACAGGGCCTCCTACGAGCAGTACTTC	CASGLVQVLGLGDRASYEQYF	TRBV12-5	TRBJ2-7
TGTGCCAGCGCAGGGCACACCGGGGAGCTGTTTTTT	CASAGHTGELFF	TRBV2	TRBJ2-2
TGTGCCTGGAGTATTGAGGCAAGACAGGCAACTAATGAAAAACTGTTTTTT	CAWSIEARQATNEKLFF	TRBV30	TRBJ1-4
TGCGCCAGCAGCTTCCTCCCCAAACCGGCGGGACAGGGACCTGAGTACGATGAGCAGTTCTTC	CASSFLPKPAGQGPEYDEQFF	TRBV5-1	TRBJ2-1
TGCGCCAGCAGCTCAGGTCTCGAAGACGGGTACAGGGACACCGGGGAGCTGTTTTTT	CASSSGLEDGYRDTGELFF	TRBV5-1	TRBJ2-2
TGTGCCACCAGCAGCAAAGGACAGGTAGGGACTAATGAAAAACTGTTTTTT	CATSSKGQVGTNEKLFF	TRBV15	TRBJ1-4
TGTGCCAGCAGCTTGGGGCGGGGGGAACCCCCCACTGAAGCTTTCTTT	CASSLGRGEPPTEAFF	TRBV5-4	TRBJ1-1
TGTGCCAGCAGTGACTCCGTTTGGGCCAGGTACGAGCAGTACTTC	CASSDSVWARYEQYF	TRBV6-4	TRBJ2-7
TGTGCCAGCAGGAATGAGCAGTTCTTC	CASRNEQFF	TRBV27	TRBJ2-1
TGTGCCAGCAGTGACTCGTCACTAGGGGCAGATACGCAGTATTTT	CASSDSSLGADTQYF	TRBV6-4	TRBJ2-3
TGTGCCAGCAGCTTAGCGCTGGGACGACAGCCCGAAAACTATGGCTACACCTTC	CASSLALGRQPENYGYTF	TRBV7-2	TRBJ1-2
TGTGCCAGCAGTCTTAAACAGGAGGTTCCTGGCAGCAATGAGCAGTTCTTC	CASSLKQEVPGSNEQFF	TRBV6-4	TRBJ2-1
TGTGCCAGCACACCTTCCCCCGATATCCAAGAGACCCAGTACTTC	CASTPSPDIQETQYF	TRBV27	TRBJ2-5
TGTGCCAGCAGTGATGTCGGCCCCACCACTGAAGCTTTCTTT	CASSDVGPTTEAFF	TRBV6-1	TRBJ1-1
TGTGCCAGCAGCTTAGAATGGGGGACCACTGAAGCTTTCTTT	CASSLEWGTTEAFF	TRBV7-6	TRBJ1-1
TGTGCCAGCAGTGTAGGGACAGGGGATGAGCAGTTCTTC	CASSVGTGDEQFF	TRBV6-4	TRBJ2-1
TGTGCCAGCAGCCAAGATGACACGGTTGGCACAGATACGCAGTATTTT	CASSQDDTVGTDTQYF	TRBV14	TRBJ2-3
TGTGCCAGCAGTTCACGACAGAGCACCTTC	CASSSRQSTF	TRBV6-5	TRBJ1-2
TGTGCCAGCAGCGTCAGAGGGTGCACTGAAGCTTTCTTT	CASSVRGCTEAFF	TRBV5-5	TRBJ1-1
TGTGCCAGCAGCCCGGGACAGGGCCCAACCCCCAAGGAGAACACTGAAGCTTTCTTT	CASSPGQGPTPKENTEAFF	TRBV9	TRBJ1-1
TGCAGTGCTCGGTTACAAGACAGGGTCGCATGCTACGAGCAGTACTTC	CSARLQDRVACYEQYF	TRBV20-1	TRBJ2-7
TGTGCCAGCAGCATACCGCGCGGGGGATCCGCAGATACGCAGTATTTT	CASSIPRGGSADTQYF	TRBV7-3	TRBJ2-3
TGCGCCAGCACCGAGCCATACCGGGAGGATCAGCCCCAGCATTTT	CASTEPYREDQPQHF	TRBV10-1	TRBJ1-5
TGTGCCAGATGGACTAGCGGACACAATGAGCAGTTCTTC	CARWTSGHNEQFF	TRBV27	TRBJ2-1
TGTGCCAGCAGTTTGACACCCGTTGAGGGTCCCGAGGACACTGAAGCTTTCTTT	CASSLTPVEGPEDTEAFF	TRBV28	TRBJ1-1
TGCAAGGGCGGTACCGAGCAGTACTTC	CKGGTEQYF	TRBV20-1	TRBJ2-7
TGCGCCAGCAGCGTCGAGGGAGAGGGCAATCAGCCCCAGCATTTT	CASSVEGEGNQPQHF	TRBV10-1	TRBJ1-5
TGCGCCAGCAGCCAAGGACAGGGAGGGCAAGAGACCCAGTACTTC	CASSQGQGGQETQYF	TRBV5-1	TRBJ2-5
TGTGCCCTACAAGCAGGACAGGCCTTTGCAACTAATGAAAAACTGTTTTTT	CALQAGQAFATNEKLFF	TRBV11-2	TRBJ1-4
TGCGCCAGCAGCTTTGGAGAGGGGGGGGGACAAGAGACCCAGTACTTC	CASSFGEGGGQETQYF	TRBV5-1	TRBJ2-5
TGCGCCAGCAGTAGCCGACTTCAAGAGACCCAGTACTTC	CASSSRLQETQYF	TRBV10-1	TRBJ2-5
TGTGCCTGGAGCCCTTTCATTTTAAGCTATAAGTACTTTAATGAAAAACTGTTTTTT	CAWSPFILSYKYFNEKLFF	TRBV30	TRBJ1-4
TGTGCCAGCAGCTCCCGGGACACAGATACGCAGTATTTT	CASSSRDTDTQYF	TRBV7-9	TRBJ2-3
TGTGCCACCAGTGATTTTCCATCAGCGGGGGTCATGACAGATACGCAGTATTTT	CATSDFPSAGVMTDTQYF	TRBV24-1	TRBJ2-3
TGTGCCAGCAGCACCCCCGGGGCGCCCCTTGTTGAAAAACTGTTTTTT	CASSTPGAPLVEKLFF	TRBV7-8	TRBJ1-4
TGTGCTAGTGGTTCAGCCCCCGGGACAGGGGGACCGCGGACCGGAACGGGCGACGAGCAGTACTTC	CASGSAPGTGGPRTGTGDEQYF	TRBV12-5	TRBJ2-7
TGTGCCAGCAGTTTGCGGGACAGGAAGGCCTACGAGCAGTACTTC	CASSLRDRKAYEQYF	TRBV27	TRBJ2-7
TGTGCCAGCAGAAATAGGGGGACGGGCGGCTACGAGCAGTACTTC	CASRNRGTGGYEQYF	TRBV7-4	TRBJ2-7
TGTGCCAGCAGCCTGGACGGACGGACGGACTCCTACAATGAGCAGTTCTTC	CASSLDGRTDSYNEQFF	TRBV7-3	TRBJ2-1
TGTGCCAGCAGCTTAGAAAGGGGACTAGCGGGGTTGAAATATGAGCAGTTCTTC	CASSLERGLAGLKYEQFF	TRBV13	TRBJ2-1
TGTGCCAGCAGCTTACAGGGGGTGCCGGGACAGGGTGAAAAACTGTTTTTT	CASSLQGVPGQGEKLFF	TRBV7-9	TRBJ1-4
TGTGCCAGCAGCTTAGGTGGGGGCTCTGGGGCCAACGTCCTGACTTTC	CASSLGGGSGANVLTF	TRBV7-2	TRBJ2-6
TGTGCCAGCAGTTTATCCCGGGACAGCGTTACTACCTACGAGCAGTACTTC	CASSLSRDSVTTYEQYF	TRBV12-4	TRBJ2-7
TGTGCCATTCCCCGACTAGCGGGAGGATCACCCCTCCACTTT	CAIPRLAGGSPLHF	TRBV10-3	TRBJ1-6
TGTGCCAGCAGCGTGAGGTCGAACACTGAAGCTTTCTTT	CASSVRSNTEAFF	TRBV9	TRBJ1-1
TGCAGTGCTAGATCGGACAGGGGAGACGAGCAGTACTTC	CSARSDRGDEQYF	TRBV20-1	TRBJ2-7
TGTGCCAGCAGCCCACCCGAGGCAGGGGGGGTACCCTACGAGCAGTACTTC	CASSPPEAGGVPYEQYF	TRBV6-1	TRBJ2-7
TGTGCCAGCAGCGCCCCCCCGTTCGGTCCGTACAATGAGCAGTTCTTC	CASSAPPFGPYNEQFF	TRBV13	TRBJ2-1
TGTGCCTGGAGTTACGGGGGGCCTGACTACGAGCAGTACTTC	CAWSYGGPDYEQYF	TRBV30	TRBJ2-7
TGTGCCAGCATTATGGACAGGGCAAGGTACGAGCAGTACTTC	CASIMDRARYEQYF	TRBV9	TRBJ2-7
TGTGCCAGCAGTGAGGCCCCTCGCGGGGCCACAGATACGCAGTATTTT	CASSEAPRGATDTQYF	TRBV6-1	TRBJ2-3
TGTGCCAGCAGGAGGATGAGGGGGATTCCCAATGAGCAGTTCTTC	CASRRMRGIPNEQFF	TRBV5-4	TRBJ2-1
TGCGCCAGCATGAATAAACGACAGGGCCTGCTAACCACTGAAGCTTTCTTT	CASMNKRQGLLTTEAFF	TRBV10-1	TRBJ1-1
TGCAGTGCTAGTCGGGGAATTAGCACAGATACGCAGTATTTT	CSASRGISTDTQYF	TRBV20-1	TRBJ2-3
TGCGCCAGCAGCCCAGGGGGATACACTGAAGCTTTCTTT	CASSPGGYTEAFF	TRBV5-1	TRBJ1-1
TGCGCCAGCAGCTTGGATACGGTATCCTCCTACGAGCAGTACTTC	CASSLDTVSSYEQYF	TRBV5-1	TRBJ2-7
TGTGCCATCAGTGAGGCCCTATCCCCCGCGGGAGGCGGTAAACTTTACGAGCAGTACTTC	CAISEALSPAGGGKLYEQYF	TRBV10-3	TRBJ2-7
TGTGCCATCCCGCCCGACAAACCAAAGGAGACCCAGTACTTC	CAIPPDKPKETQYF	TRBV6-5	TRBJ2-5
TGCAGTGCTGTAACGGGGTCCTCCTACGAGCAGTACTTC	CSAVTGSSYEQYF	TRBV20-1	TRBJ2-7
TGTGCCAGCAGGACGGGGAAGAGCACAGATACGCAGTATTTT	CASRTGKSTDTQYF	TRBV6-4	TRBJ2-3
TGCAGTGCTAGTGGACAGGCGTACCAAGAGACCCAGTACTTC	CSASGQAYQETQYF	TRBV20-1	TRBJ2-5
TGCGCCAGCAGCCAAGATCCCGACCCCCGGACAGGGACGAATGGCTACACCTTC	CASSQDPDPRTGTNGYTF	TRBV4-3	TRBJ1-2
TGTGCCAGCAGCCAAGACCCGGGACAGGGTGTAGGAGATGATCAGCCCCAGCATTTT	CASSQDPGQGVGDDQPQHF	TRBV3-1	TRBJ1-5
TGTGCTAGTGGTTTGGTACAACCCAGGGGGGCCTATGGCTACACCTTC	CASGLVQPRGAYGYTF	TRBV12-5	TRBJ1-2
TGTGCCAGCAGTGATCAAGGGAGGTCCATCAACGAGCAGTACTTC	CASSDQGRSINEQYF	TRBV6-4	TRBJ2-7
TGTGCCAGCACTACAACTAGCGGGAGGTTTTGTACTCATAGCAATCAGCCCCAGCATTTT	CASTTTSGRFCTHSNQPQHF	TRBV6-2	TRBJ1-5
TGTGCCCCAGGGGGGGGAAATGAGCAGTTCTTC	CAPGGGNEQFF	TRBV24-1	TRBJ2-1
TGTGCCAGCAGCCACAGGGAAGATACGCAGTATTTT	CASSHREDTQYF	TRBV7-4	TRBJ2-3
TGCAGTGCTCGCGGGGGTTCCTACGAGCAGTACTTC	CSARGGSYEQYF	TRBV20-1	TRBJ2-7
TGTGCCAGCAGTTACCCCGAGGGCTACACCTTC	CASSYPEGYTF	TRBV6-8	TRBJ1-2
TGCAGCGTTGAAGATTTTAGGACAGCAGCTTTCTTT	CSVEDFRTAAFF	TRBV29-1	TRBJ1-1
TGTGCCAGCAGTGAGTCGGCACTAGCGGGAGTCCCAGAATACAATGAGCAGTTCTTC	CASSESALAGVPEYNEQFF	TRBV2	TRBJ2-1
TGCGCCAGCAGCCAGCGGGATATAAACTATGGCTACACCTTC	CASSQRDINYGYTF	TRBV10-1	TRBJ1-2
TGTGCCAGCACCCTGACAGGCGGACGTGATTTATACAACACTGAAGCTTTCTTT	CASTLTGGRDLYNTEAFF	TRBV6-4	TRBJ1-1
TGTGCCAGCAGCGGGCCCCAAATAAGGTATGGCTACACCTTC	CASSGPQIRYGYTF	TRBV7-4	TRBJ1-2
TGTGCCAGCAGCTTGGAACGGGGTGCCGAGCAGTACTTC	CASSLERGAEQYF	TRBV14	TRBJ2-7
TGTGCCAGCAGTTGGGGGACCGGTAGCTCCTACAATGAGCAGTTCTTC	CASSWGTGSSYNEQFF	TRBV6-5	TRBJ2-1
TGTGCCAGCAGTGTTGGGGGGAGCAATCAGCCCCAGCATTTT	CASSVGGSNQPQHF	TRBV6-1	TRBJ1-5
TGTGCCAGCAGTGACCTCAACAAACAGGGGCATGAAGCTTTCTTT	CASSDLNKQGHEAFF	TRBV6-4	TRBJ1-1
TGTGCCAGCCTAGGGGGGGAGATTCGTGATACGCAGTATTTT	CASLGGEIRDTQYF	TRBV19	TRBJ2-3
TGCAGCGTTATACGGTTGGGCCGCAATGAGCAGTTCTTC	CSVIRLGRNEQFF	TRBV29-1	TRBJ2-1
TGTGCCATCACAGGTCGACCAGGGACTAGCGGGCTAGCTAGCACAGATACGCAGTATTTT	CAITGRPGTSGLASTDTQYF	TRBV10-3	TRBJ2-3
TGTGCCACCAGTGAGGAGAGGGATAAGGGGCAGGGCAATCAGCCCCAGCATTTT	CATSEERDKGQGNQPQHF	TRBV24-1	TRBJ1-5
TGTGCCAGCAGCTTATATCCAAAACAAGCGCCACAGGGGTTGGAAAAACTGTTTTTT	CASSLYPKQAPQGLEKLFF	TRBV7-9	TRBJ1-4
TGTGCCAGCAGCGTGGAAAAGGGGACAATTTGGCATCAGCCCCAGCATTTT	CASSVEKGTIWHQPQHF	TRBV11-3	TRBJ1-5
TGTGCCACCAACCAGGGCGAACATTCACCCCTCCACTTT	CATNQGEHSPLHF	TRBV24-1	TRBJ1-6
TGTGCCAGCAGTTTATGTACGAATGGCTACACCTTC	CASSLCTNGYTF	TRBV27	TRBJ1-2
TGTGCCAGCAGCGCCTTGAGAGGAGCTAACTATGGCTACACCTTC	CASSALRGANYGYTF	TRBV9	TRBJ1-2
TGTGCCAGCAGCTTGGACCCGGACAGGGGGCGGAGTTCTGGGGCCAACGTCCTGACTTTC	CASSLDPDRGRSSGANVLTF	TRBV5-5	TRBJ2-6
TGTGCCAGCAGCGCGGGACATTCTGGGGCCAACGTCCTGACTTTC	CASSAGHSGANVLTF	TRBV6-4	TRBJ2-6
TGCGCCAGCAGTACAGGGAATACGCAGTATTTT	CASSTGNTQYF	TRBV10-1	TRBJ2-3
TGTGCCAGCAGCACTACAGGGAATCAGCCCCAGCATTTT	CASSTTGNQPQHF	TRBV9	TRBJ1-5
TGCGCCGAGGCGATCAATAGCAATCAGCCCCAGCATTTT	CAEAINSNQPQHF	TRBV5-1	TRBJ1-5
TGTGCCAGCAGACTTCTCAACAATGAGCAGTTCTTC	CASRLLNNEQFF	TRBV27	TRBJ2-1
TGTGCCAGCAGCCGTAGGGTACCGGGACAAGGTGGCTACACCTTC	CASSRRVPGQGGYTF	TRBV7-9	TRBJ1-2
TGTGCCAGCAGCTTTACGGGGGGAATCACTGAAGCTTTCTTT	CASSFTGGITEAFF	TRBV5-6	TRBJ1-1
TGCGCCAGCAGCCTGTCCCTGGCCGGGACAGCGGAAAAACTGTTTTTT	CASSLSLAGTAEKLFF	TRBV4-1	TRBJ1-4
TGTGCCAGCAGCCAGCAATTGGGTGGCTACACCTTC	CASSQQLGGYTF	TRBV14	TRBJ1-2
TGTGCCAGCAGTAATTTTCCTAAAGGGGGATCTAGGTATGGCTACACCTTC	CASSNFPKGGSRYGYTF	TRBV6-4	TRBJ1-2
TGTGCCACCAGCAGAGACAGGGGCAATCAGCCCCAGCATTTT	CATSRDRGNQPQHF	TRBV15	TRBJ1-5
TGTGCCAGCAGCGGGGCGCCCTCTAGGTATGGCTACACCTTC	CASSGAPSRYGYTF	TRBV7-3	TRBJ1-2
TGTGCCAGCAGCTTAAGAGTACGCACAGATACGCAGTATTTT	CASSLRVRTDTQYF	TRBV7-8	TRBJ2-3
TGTGCCAGCAGTAGACGACAGGAAAGCTATGGCTACACCTTC	CASSRRQESYGYTF	TRBV6-2	TRBJ1-2
TGCGCCAGCAGCTTGGCTCATCTAGGCAATCAGCCCCAGCATTTT	CASSLAHLGNQPQHF	TRBV5-1	TRBJ1-5
TGTGCCTGGAGAGGAGAGGACTCGTACGAGCAGTACTTC	CAWRGEDSYEQYF	TRBV30	TRBJ2-7
TGTGCCAGCAGCCATAAACGGCGACATGGCTACACCTTC	CASSHKRRHGYTF	TRBV14	TRBJ1-2
TGTGCCAGCAGCTTAGATAGCACAGATACGCAGTATTTT	CASSLDSTDTQYF	TRBV11-2	TRBJ2-3
TGTGCCAGCAGCCTTCCCACTCGAACGGGACATGGAAACACCATATATTTT	CASSLPTRTGHGNTIYF	TRBV7-9	TRBJ1-3
TGTGCCAGCAGCGGGGACACCGGGGAGACCCAGTACTTC	CASSGDTGETQYF	TRBV7-8	TRBJ2-5
TGTGCCAGCAGTTTATGGGGAAAACTAGCGGGAGTAGGGAAATCCTACAATGAGCAGTTCTTC	CASSLWGKLAGVGKSYNEQFF	TRBV28	TRBJ2-1
TGTGCCAGTAGCCAGAGGGCGGGAAGGGGGTTCAGGTCGAGCTCCTATAATTCACCCCTCCACTTT	CASSQRAGRGFRSSSYNSPLHF	TRBV19	TRBJ1-6
TGTGCCAGCAGTTACCCACCCTGGTTCCTTATTAATTCACCCCTCCACTTT	CASSYPPWFLINSPLHF	TRBV6-5	TRBJ1-6
TGTGCCAGCAGTGACTCGATAGTCGCCATCACCGGGGAGCTGTTTTTT	CASSDSIVAITGELFF	TRBV6-4	TRBJ2-2
TGTGCCAGCAGCTTCCGACAGGGTAGGCCTGGCTACACCTTC	CASSFRQGRPGYTF	TRBV7-9	TRBJ1-2
TGTGCCAGCAGTGGTGGAGGGAACCGGAACACTGAAGCTTTCTTT	CASSGGGNRNTEAFF	TRBV6-4	TRBJ1-1
TGTGCCAGCAGCTTAAGTCAGGGGGGAAGCAATCAGCCCCAGCATTTT	CASSLSQGGSNQPQHF	TRBV7-3	TRBJ1-5
TGTGCCAGCAGCACGCGTCCAGCCCCGACTGAAGCTTTCTTT	CASSTRPAPTEAFF	TRBV7-3	TRBJ1-1
TGCGCCAGCAGAGCGGGAACGGGTTTGGCCGGCTACACCTTC	CASRAGTGLAGYTF	TRBV5-1	TRBJ1-2
TGTGCCACCTCAGAGGGCGAGCAGTACTTC	CATSEGEQYF	TRBV24-1	TRBJ2-7
TGTGCCAGCAGAGGGGTACCTTGGAGAAAGGATGGCTACACCTTC	CASRGVPWRKDGYTF	TRBV12-3	TRBJ1-2
TGTGCCAGCAGCTTGGTGACAGGGTCCAATGAGCAGTTCTTC	CASSLVTGSNEQFF	TRBV5-4	TRBJ2-1
TGTGCCAGCAGTTTACCCGGCCTAGAGACCCAGTACTTC	CASSLPGLETQYF	TRBV27	TRBJ2-5
TGTGCCAGCAGTGCTTCTAACTATGGCTACACCTTC	CASSASNYGYTF	TRBV5-4	TRBJ1-2
TGCGCCAGCAGCTTGCTGGTCTCAGGAGATACGCAGTATTTT	CASSLLVSGDTQYF	TRBV5-1	TRBJ2-3
TGTGCCAGCTCACTGGGGCAGAGCTCCTACGAGCAGTACTTC	CASSLGQSSYEQYF	TRBV18	TRBJ2-7
TGTGCCAGCAGCCCCCACCCTCAGGGTAACTATGGCTACACCTTC	CASSPHPQGNYGYTF	TRBV28	TRBJ1-2
TGTGCCAGCAGCTTAGGGGGCTCGTATGGCTACACCTTC	CASSLGGSYGYTF	TRBV11-2	TRBJ1-2
TGCGCCAGCAGCTTGGATGGACAAGGGGGGGCAAAGGGCCTCCCCGGGGAGCTGTTTTTT	CASSLDGQGGAKGLPGELFF	TRBV5-1	TRBJ2-2
TGTGCCAGCAGCCAACCAGGACAGGAGGCCTACGAGCAGTACTTC	CASSQPGQEAYEQYF	TRBV14	TRBJ2-7
TGTGCCAGCAGTTATGTGTTACGGGGCTATAGCAATCAGCCCCAGCATTTT	CASSYVLRGYSNQPQHF	TRBV6-2	TRBJ1-5
TGTGCCAGCAGCCCCGACGGACCTCCGCAGCCCCAGCATTTT	CASSPDGPPQPQHF	TRBV5-6	TRBJ1-5
TGTGCCCCCTTAACCATGAACACTGAAGCTTTCTTT	CAPLTMNTEAFF	TRBV30	TRBJ1-1
TGTGCCAGCAGTTACCTAGTGACCGGGACAGGGGGCGCCACTGGCTACACCTTC	CASSYLVTGTGGATGYTF	TRBV6-3	TRBJ1-2
TGCAGTGCTAGAGCGCGCCGTTCGGAACAGGGCGGCGATGGCTACACCTTC	CSARARRSEQGGDGYTF	TRBV20-1	TRBJ1-2
TGCGCCAGCAGCTTGGCAACCGGGGGCCGTCGAGACTATGGCTACACCTTC	CASSLATGGRRDYGYTF	TRBV5-1	TRBJ1-2
TGTGCCAGCAGCCGCGCCTTATCGAACACCGGGGAGCTGTTTTTT	CASSRALSNTGELFF	TRBV13	TRBJ2-2
TGTGCCAGCAGTGTGGTGGAGAGGGGACCGGGCTACACCTTC	CASSVVERGPGYTF	TRBV6-4	TRBJ1-2
TGTGCCAGCAGTGACTCGACCGCCCGGGGGGCTCGCTGGACTGAAGCTTTCTTT	CASSDSTARGARWTEAFF	TRBV6-4	TRBJ1-1
TGTGCCAGCAGCTTAACTAACCCACTAGCGGGTTGGAATGAGCAGTTCTTC	CASSLTNPLAGWNEQFF	TRBV7-3	TRBJ2-1
TGCGCCAGCAGCCAATGGGGTTTGTCAGATACGCAGTATTTT	CASSQWGLSDTQYF	TRBV4-1	TRBJ2-3
TGTGCCAGCAGCCCGTCTCCTAGCACAGATACGCAGTATTTT	CASSPSPSTDTQYF	TRBV11-2	TRBJ2-3
TGTGCCAGCAGCCAAGATTATACGGGAGGAAATGAGCAGTTCTTC	CASSQDYTGGNEQFF	TRBV14	TRBJ2-1
TGTGCCACCAGTGGCCGGGGAGGGGGGGGGACTGATTACAATGAGCAGTTCTTC	CATSGRGGGGTDYNEQFF	TRBV24-1	TRBJ2-1
TGTGCCACCAGCAGTGGGCCGGGACAGGGCCCATTAGCAGATACGCAGTATTTT	CATSSGPGQGPLADTQYF	TRBV15	TRBJ2-3
TGTGCCAGCAGCACCCGACTTGTGTACCAAGAGACCCAGTACTTC	CASSTRLVYQETQYF	TRBV11-2	TRBJ2-5
TGTGCCACCAGCAGAGATCCTTCCCCCACAGGGACCACTGAAGCTTTCTTT	CATSRDPSPTGTTEAFF	TRBV15	TRBJ1-1
TGTGCCAGCAGTTCAAAAGGCGTGTTGGCCAACACTGAAGCTTTCTTT	CASSSKGVLANTEAFF	TRBV6-2	TRBJ1-1
TGTGCCAGCAGGAGGGACAGGGGACCTTACTTC	CASRRDRGPYF	TRBV27	TRBJ2-7
TGTGCCAGTACCATCCGGGACGTTGTCGGTATGGAAAAACTGTTTTTT	CASTIRDVVGMEKLFF	TRBV19	TRBJ1-4
TGTGCCAGCACCGAACAGTGCAGGGGACATGGCTACACCTTC	CASTEQCRGHGYTF	TRBV6-6	TRBJ1-2
TGTGCCAGCTCACCACCGTGGGGACAGGGACCGGATAACTATGGCTACACCTTC	CASSPPWGQGPDNYGYTF	TRBV18	TRBJ1-2
TGTGCCAGCAGCTTGGCCGGGACAGCTGCCTACGAGCAGTACTTC	CASSLAGTAAYEQYF	TRBV7-3	TRBJ2-7
TGTGCCACTAGCGGCCTAGTTGAATCCGAGCAGTACTTC	CATSGLVESEQYF	TRBV7-9	TRBJ2-7
TGCAGTGCTAGAGCTTCCTGGACTAGCGGGGGCAATGAGCAGTTCTTC	CSARASWTSGGNEQFF	TRBV20-1	TRBJ2-1
TGCAGCGTCCCTATTACACTTAACACTGAAGCTTTCTTT	CSVPITLNTEAFF	TRBV29-1	TRBJ1-1
TGTGCCAGCAGCCAGAGCTGGGGCAATGAGCAGTTCTTC	CASSQSWGNEQFF	TRBV13	TRBJ2-1
TGCGCCAGCAGCCACGGCGCTGTTGGCTACACCTTC	CASSHGAVGYTF	TRBV4-3	TRBJ1-2
TGTGCCAGCAGCCTCCCCCTTCGCCCCTACGAGCAGTACTTC	CASSLPLRPYEQYF	TRBV13	TRBJ2-7
TGTGCCAGCAGCAAAGGGACAGGGAAGACTCTGTTTTTT	CASSKGTGKTLFF	TRBV7-9	TRBJ1-4
TGTGCCAGCAGCCCCGGAGGGCGAATCTACAATGAGCAGTTCTTC	CASSPGGRIYNEQFF	TRBV7-4	TRBJ2-1
TGTGCCAGCTCACCTTCTCAGACAGCCGGGACAGGGCACTATGGCTACACCTTC	CASSPSQTAGTGHYGYTF	TRBV18	TRBJ1-2
TGTGCCAGCAGCCGTGACTGTATCCTCCACTTT	CASSRDCILHF	TRBV11-3	TRBJ1-6
TGTGCCAGCAGCAGGATGGGCGCGAAGGAGGGAGACTCTGGGGCCAACGTCCTGACTTTC	CASSRMGAKEGDSGANVLTF	TRBV14	TRBJ2-6
TGTGCCAGCAGCTTAGGCAGTCTTGGACTAGCGGGTTACAATGAGCAGTTCTTC	CASSLGSLGLAGYNEQFF	TRBV7-7	TRBJ2-1
TGTGCCAGCAGCTTAAGGGAAACACACGAGGACAGGGAATGGGATGAAAAACTGTTTTTT	CASSLRETHEDREWDEKLFF	TRBV7-3	TRBJ1-4
TGTGCTAGCAGCTCCCAGGAAGGAAAAGCCAACGTCCTGACTTTC	CASSSQEGKANVLTF	TRBV7-7	TRBJ2-6
TGTGCCAGCACCTGGAGGGGTTGCTACGAGCAGTACTTC	CASTWRGCYEQYF	TRBV27	TRBJ2-7
TGTGCCAGCAGTTTCCCTCCGGGACAGGGAGAGACCCAGTACTTC	CASSFPPGQGETQYF	TRBV12-3	TRBJ2-5
TGTGCCAGCAGCCAAGATCTCCACACAGATACGCAGTATTTT	CASSQDLHTDTQYF	TRBV3-1	TRBJ2-3
TGTGCCAGCAGACTAGCGGGGGGGCAAAAAGAGACCCAGTACTTC	CASRLAGGQKETQYF	TRBV6-4	TRBJ2-5
TGCGCCAGCAGCCCTCGGCCGGGACTAGCGGGAGATGAGCAGTTCTTC	CASSPRPGLAGDEQFF	TRBV5-1	TRBJ2-1
TGCGCCAGCAGCTTAAACAGGGCTCATGGCTACACCTTC	CASSLNRAHGYTF	TRBV5-1	TRBJ1-2
TGTGCCACCATTTCCGGGGGGAAAACTAATGAAAAACTGTTTTTT	CATISGGKTNEKLFF	TRBV24-1	TRBJ1-4
TGCGCCAGCAGTGAGTCGAGCGGGAGGACTGCCTCCTACAATGAGCAGTTCTTC	CASSESSGRTASYNEQFF	TRBV10-1	TRBJ2-1
TGCAGTGCTCTCAGGGTACAAGAGACCCAGTACTTC	CSALRVQETQYF	TRBV20-1	TRBJ2-5
TGTGCCACAGGGACTAACACTGAAGCTTTCTTT	CATGTNTEAFF	TRBV24-1	TRBJ1-1
TGTGCCAGCAGCTCCCCCGTGGGGTGGTGCGAGCAGTACTTC	CASSSPVGWCEQYF	TRBV7-9	TRBJ2-7
TGCAGTGCTACGGAGAGCTCCTACGAGCAGTACTTC	CSATESSYEQYF	TRBV20-1	TRBJ2-7
TGCAGTGCTAGAGGGGCCCGTCAAGAGACCCAGTACTTC	CSARGARQETQYF	TRBV20-1	TRBJ2-5
TGTGCCAGCAGTTGCGCGGGCCAACCAGATACGCAGTATTTT	CASSCAGQPDTQYF	TRBV28	TRBJ2-3
TGCGCCAGCAGCCAAGTACCATCAAACAGGTCCTACGAGCAGTACTTC	CASSQVPSNRSYEQYF	TRBV4-3	TRBJ2-7
TGTGCCAGCTTACAGGCAGAAAAACTGTTTTTT	CASLQAEKLFF	TRBV27	TRBJ1-4
TGTGCCTGGAGCCCAGGGGGCGGGAGCACAGATACGCAGTATTTT	CAWSPGGGSTDTQYF	TRBV30	TRBJ2-3
TGCGCCAGCACAACAGGGCAGGGCAGCTACGAGCAGTACTTC	CASTTGQGSYEQYF	TRBV10-1	TRBJ2-7
TGTGCTAGTGGTCGGGGATTGGGACAGGGCCCCGGGAACACTGAAGCTTTCTTT	CASGRGLGQGPGNTEAFF	TRBV12-5	TRBJ1-1
TGTGCCAGCAGCTTAGGGAGGGGGGATCAGCCCCAGCATTTT	CASSLGRGDQPQHF	TRBV11-3	TRBJ1-5
TGTGCCAGCAGCCAAGACCCCAGACAAGCTGAAGCTTTCTTT	CASSQDPRQAEAFF	TRBV14	TRBJ1-1
TGTGCCAGCAGTTTACCACCCGGGCGGCCACTACTGGAGACCCAGTACTTC	CASSLPPGRPLLETQYF	TRBV27	TRBJ2-5
TGTGCCAGCAGCTTAGAACATATTGAAAGGGGAGACACTGGCTACACCTTC	CASSLEHIERGDTGYTF	TRBV11-2	TRBJ1-2
TGTGCCAGCAGAGAGGGGCATGAAGCTTTCTTT	CASREGHEAFF	TRBV6-6	TRBJ1-1
TGTGCCAGCAGCCCCCTGGACAGGGGGCGCTTCACAGATACGCAGTATTTT	CASSPLDRGRFTDTQYF	TRBV7-4	TRBJ2-3
TGTGCCAGCAGAAAAAGGAGGCCTTTCAGGAAGGAAGAGACCCAGTACTTC	CASRKRRPFRKEETQYF	TRBV12-3	TRBJ2-5
TGTGCCAGCAGCATCCTAGCGGGGGCTCCCCATAGCTCCTACGAGCAGTACTTC	CASSILAGAPHSSYEQYF	TRBV7-3	TRBJ2-7
TGTGCCAAAATTCCTTCCGTCCCACAGGGTTATAATAGCAATCAGCCCCAGCATTTT	CAKIPSVPQGYNSNQPQHF	TRBV3-1	TRBJ1-5
TGTGCCAGCCCTCGTGGTTTGTGGATGAACACTGAAGCTTTCTTT	CASPRGLWMNTEAFF	TRBV6-8	TRBJ1-1
TGTGCCAGCAGTTTACCGACGGGAGCGGTTGGGAACACCATATATTTT	CASSLPTGAVGNTIYF	TRBV27	TRBJ1-3
TGCGCCAGCAGCATGGGGGGACCTGGCTACGAGCAGTACTTC	CASSMGGPGYEQYF	TRBV5-1	TRBJ2-7
TGTGCCAGCAGGTCTCCAGAGAAGGGGAGGGGAAAACTGTTTTTT	CASRSPEKGRGKLFF	TRBV6-4	TRBJ1-4
TGCGCCAGCAGCCCCGAACTAGCGGGAGGCCCCTACAATGAGCAGTTCTTC	CASSPELAGGPYNEQFF	TRBV4-1	TRBJ2-1
TGTGCCAGCAGCTCCCCCAATCAGTTGGCTGGAAACACCATATATTTT	CASSSPNQLAGNTIYF	TRBV11-2	TRBJ1-3
TGCGCCAGCTACAGGAGGCCAGAGACCCAGTACTTC	CASYRRPETQYF	TRBV5-1	TRBJ2-5
TGCAGTGCTAGAGGACAGGAGGAGACCCAGTACTTC	CSARGQEETQYF	TRBV20-1	TRBJ2-5
TGTGCCAGCAGCGTAGCCACTAGCGGGCTCAGCTACGAGCAGTACTTC	CASSVATSGLSYEQYF	TRBV9	TRBJ2-7
TGTGCCAGCAGCTTGCCCCCACCGGGGACTAGCGGGCTTCTGGCGGACTACGAGCAGTACTTC	CASSLPPPGTSGLLADYEQYF	TRBV5-4	TRBJ2-7
TGCAGTGCTAGTAAGAGGGGCCAAGGCTACACCTTC	CSASKRGQGYTF	TRBV20-1	TRBJ1-2
TGTGCTAGTGGTTTGGAAGGTCAGTTCGCGACTTCCAATCAGCCCCAGCATTTT	CASGLEGQFATSNQPQHF	TRBV12-5	TRBJ1-5
TGTGCCAGCAGCCTAGGGCGCACTGAAGCTTTCTTT	CASSLGRTEAFF	TRBV13	TRBJ1-1
TGCACTTCCTCCCCCCGGGACAGGGATACCTACGAGCAGTACTTC	CTSSPRDRDTYEQYF	TRBV20-1	TRBJ2-7
TGTGCCAGCAGTTACGGGGGCGCAGGCTATGGCTACACCTTC	CASSYGGAGYGYTF	TRBV6-2	TRBJ1-2
TGTGCCAGCAGTCGGGTAAAGTGGGACTGTCCCCTGAACATTCAGTACTTC	CASSRVKWDCPLNIQYF	TRBV6-1	TRBJ2-4
TGCGCCAGCAGCCAAGGTCATAGACGAGAAGAGACCCAGTACTTC	CASSQGHRREETQYF	TRBV4-1	TRBJ2-5
TGCGCCAGCAGTGACTCGACAGCTTTGAATGAGCAGTTCTTC	CASSDSTALNEQFF	TRBV10-1	TRBJ2-1
TGTGCCAGCAGCTTAGGTACCACCCCCTACGAGCAGTACTTC	CASSLGTTPYEQYF	TRBV11-3	TRBJ2-7
TGCAGCGTTGAGGGCGTGGGGAACACTGAAGCTTTCTTT	CSVEGVGNTEAFF	TRBV29-1	TRBJ1-1
TGTGCCAGCAGTAAAGGCCCCATAATGGGTCGTACTGAAGCTTTCTTT	CASSKGPIMGRTEAFF	TRBV27	TRBJ1-1
TGTGCCAGCAGCCGGGGGGGGCTGCAAAAGGCTGAGACCCAGTACTTC	CASSRGGLQKAETQYF	TRBV28	TRBJ2-5
TGTGCCAGCAGTTACCCCACCGACAGGGCCGGACACACTGAAGCTTTCTTT	CASSYPTDRAGHTEAFF	TRBV6-2	TRBJ1-1
TGCGCCAGCAGTGAAGCCAGGGGGCGCCCCTCCTACGAGCAGTACTTC	CASSEARGRPSYEQYF	TRBV10-1	TRBJ2-7
TGTGCCGGGCGCTATGGCTACACCTTC	CAGRYGYTF	TRBV30	TRBJ1-2
TGTGCCAGCAGCTTATATTACGACAATCAGCCCCAGCATTTT	CASSLYYDNQPQHF	TRBV11-2	TRBJ1-5
TGTGCCAGCAGTGAATGCCTCCCTACCACAGATACGCAGTATTTT	CASSECLPTTDTQYF	TRBV6-4	TRBJ2-3
TGCGCCAGCAGCTTGGGGGAGGTTCTGAGCTCCTATAATTCACCCCTCCACTTT	CASSLGEVLSSYNSPLHF	TRBV5-1	TRBJ1-6
TGTGCCAGCATTTCCTTCCCGCACGAGATCGAGCAGTACTTC	CASISFPHEIEQYF	TRBV9	TRBJ2-7
TGTGCCAGCTGCGAGAACAATGAGCAGTTCTTC	CASCENNEQFF	TRBV7-2	TRBJ2-1
TGTGCCAGCAGCTTAACCCCAAACCTACGCTCTCGGGGCTACACCGGGGAGCTGTTTTTT	CASSLTPNLRSRGYTGELFF	TRBV7-3	TRBJ2-2
TGCAGTGCGATCCATAATGGCTACACCTTC	CSAIHNGYTF	TRBV20-1	TRBJ1-2
TGTGCCTGGAGTGTAAACTTACAGTACGAGCAGTACTTC	CAWSVNLQYEQYF	TRBV30	TRBJ2-7
TGTGCCAGCAGCTTGTTCTCTGCGTTCGGACTAGCGGGGATGGAGCAGTACTTC	CASSLFSAFGLAGMEQYF	TRBV7-9	TRBJ2-7
TGTGCCAGCAGCGATAATAGATTACTATACGAGCAGTACTTC	CASSDNRLLYEQYF	TRBV13	TRBJ2-7
TGTGCCAGCCCCACAGGGGGCCCCTATGGCTACACCTTC	CASPTGGPYGYTF	TRBV27	TRBJ1-2
TGTGCCAGCAGGCTCATCGGGGTTGGCCAGCCCCAGCATTTT	CASRLIGVGQPQHF	TRBV12-4	TRBJ1-5
TGTGCCAGCAGCTTAGCCCTGGGGTTCTTC	CASSLALGFF	TRBV11-2	TRBJ2-1
TGTGCCAGCAGTAATAGACAGGGGCAAGTATATTATTTT	CASSNRQGQVYYF	TRBV6-4	TRBJ1-3
TGTGCCAGCAGCCTAGATATAGAGACCCAGTACTTC	CASSLDIETQYF	TRBV13	TRBJ2-5
TGTGCCAGCAGTGATACAAGCCCAGTGGAGAGGGGGTATGGCTACACCTTC	CASSDTSPVERGYGYTF	TRBV2	TRBJ1-2
TGTGCCACCAGTGCGCCGGGACTAGGGGCACTCACAGATACGCAGTATTTT	CATSAPGLGALTDTQYF	TRBV24-1	TRBJ2-3
TGTGCCAGCTCACCACAGCCAGAGGAGTTAGGGACTGAAGCTTTCTTT	CASSPQPEELGTEAFF	TRBV18	TRBJ1-1
TGCGCCAGCAGCTTGGACCCCTTTGGACGGCGAACCAATCAGCCCCAGCATTTT	CASSLDPFGRRTNQPQHF	TRBV5-1	TRBJ1-5
TGTGCCAGCAGCCAAGACTGGACGGTCTACGAGCAGTACTTC	CASSQDWTVYEQYF	TRBV3-1	TRBJ2-7
TGTGCCAGCAGTGCAGGACTAGCGGGTCTCCGCTCTGGGGCCAACGTCCTGACTTTC	CASSAGLAGLRSGANVLTF	TRBV27	TRBJ2-6
TGTGCCAGCAGTTTATTTGGCACTAGCGGGAGACGTTTTTCGATCCAGCATTTT	CASSLFGTSGRRFSIQHF	TRBV27	TRBJ1-5
TGTGCCAGCACCGGGGGGGGGAACACTGAAGCTTTCTTT	CASTGGGNTEAFF	TRBV7-2	TRBJ1-1
TGTGCCTGGGGCGTCCCCTGGGGACACAATGAGCAGTTCTTC	CAWGVPWGHNEQFF	TRBV5-4	TRBJ2-1
TGTGCCAGCAGTAGATCCTACAGGGGGGGTAACGAGCAGTACTTC	CASSRSYRGGNEQYF	TRBV6-1	TRBJ2-7
TGTGCCACCAGCAGATCCGTACAGGGCGGTAACTATGGCTACACCTTC	CATSRSVQGGNYGYTF	TRBV15	TRBJ1-2
TGTGCCAGTAAGAGATCAACCGACGAGACCCAGTACTTC	CASKRSTDETQYF	TRBV19	TRBJ2-5
TGTGCCAGCAGGCGACGGGAGGCTGAGCATAAAGAGACCCAGTACTTC	CASRRREAEHKETQYF	TRBV12-4	TRBJ2-5
TGTGCCAGCAGCTTTGGTAGGGGGGGGGCTACCGGGGAGCTGTTTTTT	CASSFGRGGATGELFF	TRBV7-9	TRBJ2-2
TGTGCCACCTTAGGTGACGAGGTGAACACTGAAGCTTTCTTT	CATLGDEVNTEAFF	TRBV24-1	TRBJ1-1
TGTGCCAGCAGTGACTCATACGGGGGCGTTAAACTTTCTACAACGGAGCAGTACTTC	CASSDSYGGVKLSTTEQYF	TRBV6-4	TRBJ2-7
TGTGCCAGCAGCTTGAATGACAGGGACTACGAGCAGTACTTC	CASSLNDRDYEQYF	TRBV5-4	TRBJ2-7
TGCAGCGTTGGAAGGTTGCAGGGACGCTACTCGGAAGACACCGGGGAGCTGTTTTTT	CSVGRLQGRYSEDTGELFF	TRBV29-1	TRBJ2-2
TGTGCCAGTAGTAACTACAGGGGGTATCCCCGTGGCTACACCTTC	CASSNYRGYPRGYTF	TRBV19	TRBJ1-2
TGTGCCACCCGTTGGGGGGCGGGGAGCTATGGCTACACCTTC	CATRWGAGSYGYTF	TRBV24-1	TRBJ1-2
TGTGCCACTGGGACCGTGGGAGATACGCAGTATTTT	CATGTVGDTQYF	TRBV19	TRBJ2-3
TGTGCCAGCTCACCGAGGACAGGGGCGCAAGAGACCCAGTACTTC	CASSPRTGAQETQYF	TRBV18	TRBJ2-5
TGCGCCAGCAGCCAGCGAAACCCAGGTAGGGGGGCGGTGCCGTTCGACCAAGAGACCCAGTACTTC	CASSQRNPGRGAVPFDQETQYF	TRBV4-3	TRBJ2-5
TGTGCCAGCAGCTCGGAGGGGGAGGAGCAGTACTTC	CASSSEGEEQYF	TRBV7-4	TRBJ2-7
TGTGCCAGCAGCCAAAGGTGGCGGGACAGGGTTTCCAAAACAAATCAGCCCCAGCATTTT	CASSQRWRDRVSKTNQPQHF	TRBV3-1	TRBJ1-5
TGTGCCAGCAGCAGTATCAGTCTCCAGGGGATTCAGGGGGCTGCAGATACGCAGTATTTT	CASSSISLQGIQGAADTQYF	TRBV9	TRBJ2-3
TGTGCCAGCAAGACCCCCAATGACAGGCCCCAGCATTTT	CASKTPNDRPQHF	TRBV6-1	TRBJ1-5
TGTGCCAGCAGTTACCAGAGGGGGATTGGGAGGGACCCAGAGACCCAGTACTTC	CASSYQRGIGRDPETQYF	TRBV6-6	TRBJ2-5
TGTGCCAGCAGTTACTCGAGATATCAGGTTGAGCAGTACTTC	CASSYSRYQVEQYF	TRBV6-3	TRBJ2-7
TGCGCCAGCAGCCAAGGGGTCTCACTCTTGACCTACGAGCAGTACTTC	CASSQGVSLLTYEQYF	TRBV4-1	TRBJ2-7
TGTGCCAGCAGTGAACGGGGGCGTGCAACTAATGAAAAACTGTTTTTT	CASSERGRATNEKLFF	TRBV27	TRBJ1-4
TGTGCCAGCAGCAGCTATCCCTTCGAGGGACAGGGCGTCCAGCATTTT	CASSSYPFEGQGVQHF	TRBV7-9	TRBJ1-5
TGTGCCAGCAGCCAAGACCACAGGGGGAGGGGGGGTGAAGCTTTCTTT	CASSQDHRGRGGEAFF	TRBV3-1	TRBJ1-1
TGTGCCAGCAGCTTAGAGCGAGCGGGGGCCAACGTCCTGACTTTC	CASSLERAGANVLTF	TRBV11-2	TRBJ2-6
TGTGCCATCAGATCAGGACTGGTTCCACTCTATGGCTACACCTTC	CAIRSGLVPLYGYTF	TRBV10-3	TRBJ1-2
TGTGCCAGCAGCTTAACAAACAGGGGGAATCAGCCCCAGCATTTT	CASSLTNRGNQPQHF	TRBV7-3	TRBJ1-5
TGTGCCAGCAGCTTAGCAGGGGTGAGTTGTAATACTGAAGCTTTCTTT	CASSLAGVSCNTEAFF	TRBV11-2	TRBJ1-1
TGTGCCACCCCAACCGCGGGGCAGTACTTC	CATPTAGQYF	TRBV24-1	TRBJ2-7
TGCAGTGCATCTCTAGCGGAACCGCCTTTCACAGATACGCAGTATTTT	CSASLAEPPFTDTQYF	TRBV20-1	TRBJ2-3
TGTGCCACAGCGGTGCTCTACAATGAGCAGTTCTTC	CATAVLYNEQFF	TRBV28	TRBJ2-1
TGTGCCAGCAGTGAGGGGGGGGGGGCCGAGACCCAGTACTTC	CASSEGGGAETQYF	TRBV6-1	TRBJ2-5
TGTGCCAGCAGTGACCTGACAGGGAAATGCTTC	CASSDLTGKCF	TRBV12-4	TRBJ1-2
TGCAGCGTTGGAGGATCTAGCGGGCCCGGGGAATCCTACAATGAGCAGTTCTTC	CSVGGSSGPGESYNEQFF	TRBV29-1	TRBJ2-1
TGTGCCAGCAGCCAGGACTCGTGGGAAGAGACCCAGTACTTC	CASSQDSWEETQYF	TRBV3-1	TRBJ2-5
TGTGCCAGCAGCCAGCGGCTGAGCACCGGGGAGCTGTTTTTT	CASSQRLSTGELFF	TRBV13	TRBJ2-2
TGTGCCAGCTCACCGAAGGGACTAGGGTGTAGCACAGATACGCAGTATTTT	CASSPKGLGCSTDTQYF	TRBV18	TRBJ2-3
TGTGCCAGCAGACGGTATCTGGCAGATACGCAGTATTTT	CASRRYLADTQYF	TRBV28	TRBJ2-3
TGTGCCAGCAGCTTAGAGGGACTAGCGCCTCTGCTCGCCTCAGCCACAGATACGCAGTATTTT	CASSLEGLAPLLASATDTQYF	TRBV7-9	TRBJ2-3
TGCAGTGCCGGCAGGGGGGTCTACGAGCAGTACTTC	CSAGRGVYEQYF	TRBV20-1	TRBJ2-7
TGTGCCAGCAGCCAAGACGGGACTAGCGGTCCAAGCCAAGAGACCCAGTACTTC	CASSQDGTSGPSQETQYF	TRBV4-2	TRBJ2-5
TGTGCTAGTGGTTTGCTCCACAGGGGGCCACTAGCCAAAAACATTCAGTACTTC	CASGLLHRGPLAKNIQYF	TRBV12-5	TRBJ2-4
TGTGCCTGCGGACAGGGGGCTTTTGGCACAGATACGCAGTATTTT	CACGQGAFGTDTQYF	TRBV30	TRBJ2-3
TGTGCCAGCAGGCGAAGGACTAGCTACGAGCAGTACTTC	CASRRRTSYEQYF	TRBV6-5	TRBJ2-7
TGTGCCAGCTCGGGACACGTCGGTGAAAAACTGTTTTTT	CASSGHVGEKLFF	TRBV6-5	TRBJ1-4
TGTGCCAGCAGCCAAGCCGACCGGGACAGGGGGGGTCCCGGCACTGAAGCTTTCTTT	CASSQADRDRGGPGTEAFF	TRBV3-1	TRBJ1-1
TGTGCCAGCGGGGGCGAACCCTACGAGCAGTACTTC	CASGGEPYEQYF	TRBV7-3	TRBJ2-7
TGTGCCAGCAGTGACGACCCAAACCAGCGGGAAAAAAACATTCAGTACTTC	CASSDDPNQREKNIQYF	TRBV6-4	TRBJ2-4
TGCGCCAGCAGTGGGGGGGGGGGGAGCAATGAGCAGTTCTTC	CASSGGGGSNEQFF	TRBV10-1	TRBJ2-1
TGTGCCAGCAGCCATGGGACAGACCCCGAATTTAACTATGGCTACACCTTC	CASSHGTDPEFNYGYTF	TRBV13	TRBJ1-2
TGTGCCAGCAGTGCCCCCCAAAGGGGAAATCCTAGGGACTCCTACGAGCAGTACTTC	CASSAPQRGNPRDSYEQYF	TRBV6-1	TRBJ2-7
TGTGCCAGCAGCCCAGGGGTCGGTAGTAGCTACGAGCAGTACTTC	CASSPGVGSSYEQYF	TRBV28	TRBJ2-7
TGTGCCAGCATAAGGCAGGGGGGGCTTCCCGGGGAGCTGTTTTTT	CASIRQGGLPGELFF	TRBV11-3	TRBJ2-2
TGTGCCAGCAAAAAGGGGGCAGCGTTCTACGAGCAGTACTTC	CASKKGAAFYEQYF	TRBV28	TRBJ2-7
TGTGCCAGCAGCAAAGCAGGGAACGAGCAGTACTTC	CASSKAGNEQYF	TRBV7-3	TRBJ2-7
TGTGCCAGCAGCGGGACAGTCCTTAGAAACATTCAGTACTTC	CASSGTVLRNIQYF	TRBV7-9	TRBJ2-4
TGTGCCATCACCGGGACAGCAAAGAGGCCCGGGGAGCTGTTTTTT	CAITGTAKRPGELFF	TRBV10-3	TRBJ2-2
TGCGCCAGCGAGGGGGGACCAACGCAGCCCCAGCATTTT	CASEGGPTQPQHF	TRBV5-1	TRBJ1-5
TGTGCCAGCAGTCAGATGACAGCTGGCAGAGCCAAAAACATTCAGTACTTC	CASSQMTAGRAKNIQYF	TRBV6-1	TRBJ2-4
TGTGCCAGCAGGATAGGTCCGGCAACTAATGAAAAACTGTTTTTT	CASRIGPATNEKLFF	TRBV6-4	TRBJ1-4
TGCGCCAGCAGCCAAGCTGTACAGACAGGGTCCTACAATGAGCAGTTCTTC	CASSQAVQTGSYNEQFF	TRBV4-1	TRBJ2-1
TGCAGCGTTGAGGGTAGCGGGACTAGCGGGCACACCGGGGAGCTGTTTTTT	CSVEGSGTSGHTGELFF	TRBV29-1	TRBJ2-2
TGCGCCAGCAGCTTGTTGGGACAGTCAGAGGGAAACACCATATATTTT	CASSLLGQSEGNTIYF	TRBV5-1	TRBJ1-3
TGTGCCAGCAGCTTATCCAAACAGGGCGCCCGCGATCAGCCCCAGCATTTT	CASSLSKQGARDQPQHF	TRBV7-2	TRBJ1-5
TGCAGTGCCTGCTCAGGGGTTCCAGCCTATGGCTACACCTTC	CSACSGVPAYGYTF	TRBV20-1	TRBJ1-2
TGTGCCAGCAGTTACTCCCAGGAATCCACAGCAGGTAGTAGCTCCTACAATGAGCAGTTCTTC	CASSYSQESTAGSSSYNEQFF	TRBV6-3	TRBJ2-1
TGTGCCAGCAGCTTATTCCAGGGGAGAATCTATGGCTACACCTTC	CASSLFQGRIYGYTF	TRBV5-6	TRBJ1-2
TGCGCCAGCAGTGACGCCGGGCGCAATGAGCAGTTCTTC	CASSDAGRNEQFF	TRBV10-1	TRBJ2-1
TGTGCCAGCAGCGACAGGGCACCCGGGGAGCTGTTTTTT	CASSDRAPGELFF	TRBV9	TRBJ2-2
TGTGCCAGCAGCTGTGACGGGAGCTCCTACAATGAGCAGTTCTTC	CASSCDGSSYNEQFF	TRBV6-1	TRBJ2-1
TGTGCCAGCAGCCGCGTAGTGGTGTACAATGAGCAGTTCTTC	CASSRVVVYNEQFF	TRBV13	TRBJ2-1
TGCGCCAGCTTAGGTCAGGGGCTAAGGGTATCCTACGAGCAGTACTTC	CASLGQGLRVSYEQYF	TRBV10-1	TRBJ2-7
TGTGCCAGCAGCATCCTATGGAAGAGTGACAATGAGCAGTTCTTC	CASSILWKSDNEQFF	TRBV11-2	TRBJ2-1
TGTGCCAGCAGTTTGCGGGTCTTGATCGCGAACACTGAAGCTTTCTTT	CASSLRVLIANTEAFF	TRBV6-2	TRBJ1-1
TGTGCCAGCCGAGACCGGAGCAAGGGACCGAACACTGAAGCTTTCTTT	CASRDRSKGPNTEAFF	TRBV9	TRBJ1-1
TGTGCCATCAGTGAGCACTCTTTAGGGACAGGGATTAGCTCCTACAATGAGCAGTTCTTC	CAISEHSLGTGISSYNEQFF	TRBV10-3	TRBJ2-1
TGTGCCACCAGTGATTTGTTAGGGGACTACGAGCAGTACTTC	CATSDLLGDYEQYF	TRBV24-1	TRBJ2-7
TGTGCCTGGAGTGTATATTATATCAATGAGCAGTTCTTC	CAWSVYYINEQFF	TRBV30	TRBJ2-1
TGTGCCAGCAGCGACCTTAGAAGTAACAATCAGCCCCAGCATTTT	CASSDLRSNNQPQHF	TRBV13	TRBJ1-5
TGTGCCACCAGTGATTTGAAAGGAGCCACCGGGGAGCTGTTTTTT	CATSDLKGATGELFF	TRBV24-1	TRBJ2-2
TGTGCCAGCAGCGTAGGTGAGGACCTAGACACCGGGGAGCTGTTTTTT	CASSVGEDLDTGELFF	TRBV9	TRBJ2-2
TGTGCCAGCAGTGAAGGTGATAGGGGAACACGGCGCCCCGGCCAAGAGACCCAGTACTTC	CASSEGDRGTRRPGQETQYF	TRBV2	TRBJ2-5
TGTGCCAGTAGTTCACAGGGCATACAAGAGACCCAGTACTTC	CASSSQGIQETQYF	TRBV19	TRBJ2-5
TGTGCCACCAGTGATTTGAGGACACAGGGCCTTGAAGCTTTCTTT	CATSDLRTQGLEAFF	TRBV24-1	TRBJ1-1
TGTGCCAGCAGTCGAGGTCAAGAGACCCAGTACTTC	CASSRGQETQYF	TRBV11-3	TRBJ2-5
TGCAGTGCTCTGGGAACGGGACAGGGTAACGAGCAGTACTTC	CSALGTGQGNEQYF	TRBV20-1	TRBJ2-7
TGCAGCCCCGGCAGAGGGGTCTATGGCTACACCTTC	CSPGRGVYGYTF	TRBV29-1	TRBJ1-2
TGTGCATTTAACCGGGACTGTGAGACCCAGTACTTC	CAFNRDCETQYF	TRBV7-3	TRBJ2-5
TGTGCCGGTAGGGTTGACGAGCAGTACTTC	CAGRVDEQYF	TRBV19	TRBJ2-7
TGTGCCAGCAGCTATGGCGGTCCGTACGAGCAGTACTTC	CASSYGGPYEQYF	TRBV7-3	TRBJ2-7
TGTGCCTGGAGTCGGGTCGGGGGGGCGACTGAGCAGTTCTTC	CAWSRVGGATEQFF	TRBV30	TRBJ2-1
TGTGCCAGCAGCGGGAGGAACGACGAGCAGTACTTC	CASSGRNDEQYF	TRBV7-2	TRBJ2-7
TGTGCCAGCAGCTTACCCAGAGTTTCTTCGGAGACCCAGTACTTC	CASSLPRVSSETQYF	TRBV7-2	TRBJ2-5
TGTGCCAGAGAAAGCTGGGGCTATGGCTACACCTTC	CARESWGYGYTF	TRBV27	TRBJ1-2
TGTGCCACTTTTGGACAGGGCTCCATCAGGCTTCTACCCAGCTCCTACAATGAGCAGTTCTTC	CATFGQGSIRLLPSSYNEQFF	TRBV27	TRBJ2-1
TGTGCCAGCAGCCAAGACGGGGAAGGGCATGGCTACACCTTC	CASSQDGEGHGYTF	TRBV14	TRBJ1-2
TGTGCCTGGGGGAGCGGATCCTACAATGAGCAGTTCTTC	CAWGSGSYNEQFF	TRBV30	TRBJ2-1
TGTGCCAGCAGTGGGTCGAGACAGGGGGACAATGAGCAGTTCTTC	CASSGSRQGDNEQFF	TRBV2	TRBJ2-1
TGCGCCAGCGGAGCCTGGAAAGCCAAAAACATTCAGTACTTC	CASGAWKAKNIQYF	TRBV10-1	TRBJ2-4
TGTGCCAGCAGCTTGGCCCAGGGGGGGCCTTCCAACACCGGGGAGCTGTTTTTT	CASSLAQGGPSNTGELFF	TRBV5-4	TRBJ2-2
TGCAGTGCTAGAGAACTTGGGACAGGGTCACCCCTCCACTTT	CSARELGTGSPLHF	TRBV20-1	TRBJ1-6
TGTGCCAGCATCAAGGACAGGGACTATGGCTACACCTTC	CASIKDRDYGYTF	TRBV27	TRBJ1-2
TGTGCCAGCAGCCAAGGGTTAAGGGAGGGATACAATGAGCAGTTCTTC	CASSQGLREGYNEQFF	TRBV14	TRBJ2-1
TGCAGCGTCCCAGGGCCTCAGCCCCAGCATTTT	CSVPGPQPQHF	TRBV29-1	TRBJ1-5
TGTGCCAGCAGCAGACCCGATACGCAGTATTTT	CASSRPDTQYF	TRBV7-9	TRBJ2-3
TGTGCCAGCAGTTACTGGAAAGGACAGGGGGCCTACAATGAGCAGTTCTTC	CASSYWKGQGAYNEQFF	TRBV6-3	TRBJ2-1
TGTGCCAGAACGCCTATTCCCCCCGGGACTAGCGGGAGATCAGATACGCAGTATTTT	CARTPIPPGTSGRSDTQYF	TRBV25-1	TRBJ2-3
TGTGCCAGCAGCGAATCGAAGGCCGGGGAGCTGTTTTTT	CASSESKAGELFF	TRBV7-9	TRBJ2-2
TGTGCCACCAGCAGGCGAAACAGGGCCCGGGACAGGGGTACTGGGGCCAACGTCCTGACTTTC	CATSRRNRARDRGTGANVLTF	TRBV15	TRBJ2-6
TGCGCCAGCAGTGGCCGGGACAGGGAGTGGCGTTACTCTGGAAACACCATATATTTT	CASSGRDREWRYSGNTIYF	TRBV5-1	TRBJ1-3
TGCGCCAGCAGTGACCCCGGACAGCCTAATGAAAAACTGTTTTTT	CASSDPGQPNEKLFF	TRBV10-1	TRBJ1-4
TGTGCCAGCAGCACGGGACTGAACGAGCAGTACTTC	CASSTGLNEQYF	TRBV7-3	TRBJ2-7
TGTGCCAGCAGCTTACGGACTAGCGGGATGTACAATGAGCAGTTCTTC	CASSLRTSGMYNEQFF	TRBV13	TRBJ2-1
TGTGCCAGCAGTGGCCCGGGAGTAGGGCCGATGAACACTGAAGCTTTCTTT	CASSGPGVGPMNTEAFF	TRBV6-5	TRBJ1-1
TGTGCCAGCAGGAGCACGGGGGGAAAATGGCATGAAAAACTGTTTTTT	CASRSTGGKWHEKLFF	TRBV12-4	TRBJ1-4
TGTGCCAGCAGCACTGGATCCCGTGAGGGGGTACGGGAAAAACTGTTTTTT	CASSTGSREGVREKLFF	TRBV11-1	TRBJ1-4
TGTGCCAGCAGAATGAAGCGAAGCGGGATTTATAGCAATCAGCCCCAGCATTTT	CASRMKRSGIYSNQPQHF	TRBV11-3	TRBJ1-5
TGTGCCAGCAGCTGGGTTTGCCCGGGACAGCTTTATGAGCAGTTCTTC	CASSWVCPGQLYEQFF	TRBV7-3	TRBJ2-1
TGTGCCAGCAGTTTACCTACAGGGAATCGTGGGACTAATGAAAAACTGTTTTTT	CASSLPTGNRGTNEKLFF	TRBV27	TRBJ1-4
TGCGCCAGCAGCTTGAGCCAGGGACACTCTGGGGCCAACGTCCTGACTTTC	CASSLSQGHSGANVLTF	TRBV5-1	TRBJ2-6
TGTGCCACCAACCCCCCGGACAGCCCTGAGCAGTTCTTC	CATNPPDSPEQFF	TRBV14	TRBJ2-1
TGCAGCGTTGAGGCCGCCCCCAGCTCCTACGAGCAGTACTTC	CSVEAAPSSYEQYF	TRBV29-1	TRBJ2-7
TGCAGTGCTAGCGAGACAGGCCTTTCCTACAATGAGCAGTTCTTC	CSASETGLSYNEQFF	TRBV20-1	TRBJ2-1
TGTGCCAGCAGCATCGGACGTTGTAACTATGGCTACACCTTC	CASSIGRCNYGYTF	TRBV13	TRBJ1-2
TGTGCCAGCAGCCTGGAAACAGGGCTTCTGAGCACTGAAGCTTTCTTT	CASSLETGLLSTEAFF	TRBV14	TRBJ1-1
TGTGCCAGCAGCTTGAAGACGACAGTCAATCAGCCCCAGCATTTT	CASSLKTTVNQPQHF	TRBV5-4	TRBJ1-5
TGCGCCAGCAGCTTAGGTAAACCGGGACTAGCGGGGGGACGAAAAGAGGTTGGGGAGACCCAGTACTTC	CASSLGKPGLAGGRKEVGETQYF	TRBV5-1	TRBJ2-5
TGTGCCAGGACAGGGTGGACTTCACCCCTCCACTTT	CARTGWTSPLHF	TRBV24-1	TRBJ1-6
