TGTGCCAGCAGTGAATCGACTAGCAATGCCTACGAGCAGTACTTC	CASSESTSNAYEQYF	TRBV25-1	TRBJ2-7
TGTGCCAGCAGCGGACAGGGCAGGAGCTCCTACAATGAGCAGTTCTTC	CASSGQGRSSYNEQFF	TRBV7-3	TRBJ2-1
TGTGCCAGCAGCCGATGGACAGGGGGCTACACCTTC	CASSRWTGGYTF	TRBV13	TRBJ1-2
TGTGCCAGCAGCTCGCCGGACCGGGCTATGTGCAATCAGCCCCAGCATTTT	CASSSPDRAMCNQPQHF	TRBV11-3	TRBJ1-5
TGCGCCAGCATGCATCAGCAGGGAACAGCCCAGCATTTT	CASMHQQGTAQHF	TRBV10-2	TRBJ1-5
TGTGCCACCAGCAGAGCATCAATCAGGGGCAACTATGGCTACACCTTC	CATSRASIRGNYGYTF	TRBV15	TRBJ1-2
TGTGCCAGCAGCGACAGTGTGAAAGAACGGCCAGATACGCAGTATTTT	CASSDSVKERPDTQYF	TRBV13	TRBJ2-3
TGTGCCAGCACTACGACTAGACCCCGCTACTACGAGCAGTACTTC	CASTTTRPRYYEQYF	TRBV6-5	TRBJ2-7
TGTGCCAGCAGTGACACAGGGGGCCCGGTCTACGAGCAGTACTTC	CASSDTGGPVYEQYF	TRBV6-4	TRBJ2-7
TGTGCCACCAGTGTACAGGGGGGCACAGATACGCAGTATTTT	CATSVQGGTDTQYF	TRBV24-1	TRBJ2-3
TGTGCCAGCAGCTTAGCACGACTAGGGGGCCACCTGAACACTGAAGCTTTCTTT	CASSLARLGGHLNTEAFF	TRBV7-4	TRBJ1-1
TGTGCCATCGTTACTGACAGGGGGCGTAATCAGCCCCAGCATTTT	CAIVTDRGRNQPQHF	TRBV10-3	TRBJ1-5
TGTGCTAGACCTCGAAACACTGAAGCTTTCTTT	CARPRNTEAFF	TRBV12-5	TRBJ1-1
TGTGCCAGCAGTGACAGGGGGACTGAAGCTTTCTTT	CASSDRGTEAFF	TRBV6-1	TRBJ1-1
TGCAGTGCTAGAAAAGGGGACAGGCTAGGCTACGAGCAGTACTTC	CSARKGDRLGYEQYF	TRBV20-1	TRBJ2-7
TGTGCCAGCAGCTTATACCCCGGGGGCTGGGGCAATCAGCCCCAGCATTTT	CASSLYPGGWGNQPQHF	TRBV7-2	TRBJ1-5
TGTGCCAGCAGCGTCAGGCAGCGTGGTAGGAGCTCCTATAATTCACCCCTCCACTTT	CASSVRQRGRSSYNSPLHF	TRBV9	TRBJ1-6
TGTGCCAGCAGCTCCCACCATGGAGGGAATGATGGCTACACCTTC	CASSSHHGGNDGYTF	TRBV12-4	TRBJ1-2
TGTGCCAGCAGCTTGGTTAACTGGCAGTTGGTTCAAGAGACCCAGTACTTC	CASSLVNWQLVQETQYF	TRBV5-4	TRBJ2-5
TGTGCCAGCAGTTTAACGCGTTACCCGTGGGATAGCAATCAGCCCCAGCATTTT	CASSLTRYPWDSNQPQHF	TRBV27	TRBJ1-5
TGTGCCAGCTTGTCATACGGAGGGGAAAACATTCAGTACTTC	CASLSYGGENIQYF	TRBV6-3	TRBJ2-4
TGTGCCACCAGTGAAGTAGGGGTGACGACAACTAATGAAAAACTGTTTTTT	CATSEVGVTTTNEKLFF	TRBV24-1	TRBJ1-4
TGCGCCAGCAGCTTCCCCCACAGGGCCTACGAGCAGTACTTC	CASSFPHRAYEQYF	TRBV5-1	TRBJ2-7
TGCGCCAGCAGCCTCCGCTTGTTGGGACACTATGGCTACACCTTC	CASSLRLLGHYGYTF	TRBV5-1	TRBJ1-2
TGTGCCAGCAGCCCAAGCGGGAGGGAGACCTACGAGCAGTACTTC	CASSPSGRETYEQYF	TRBV5-4	TRBJ2-7
TGCAGTGCTAGACCCCTGCGGTCCTACGAGCAGTACTTC	CSARPLRSYEQYF	TRBV20-1	TRBJ2-7
TGCGCCAGCATCCCACTACACAGGGGGAATCAGCCCCAGCATTTT	CASIPLHRGNQPQHF	TRBV10-1	TRBJ1-5
TGTGCCAGCAGCGTCCGGCCAAGGGGTACCTACGAGCAGTACTTC	CASSVRPRGTYEQYF	TRBV13	TRBJ2-7
TGTGCCAGTAAGGGTTCCGAGACCCAGTACTTC	CASKGSETQYF	TRBV19	TRBJ2-5
TGTTTGGGGGAACGCTACAATGAGCAGTTCTTC	CLGERYNEQFF	TRBV6-6	TRBJ2-1
TGTGCCAGCAGCTCTTGCGGGTTACTAGCGGGGGGGGTCTACAATGAGCAGTTCTTC	CASSSCGLLAGGVYNEQFF	TRBV7-9	TRBJ2-1
TGTGCCAGCCGCCCCCCGAAAGAGACCCAGTACTTC	CASRPPKETQYF	TRBV7-3	TRBJ2-5
TGTGCCAGCAGCTTTGGCGGCACGGGGGGGCCCGACGGCTTCTATGGCTACACCTTC	CASSFGGTGGPDGFYGYTF	TRBV11-3	TRBJ1-2
TGTGCCAGCAGCTTAATAGGCCCTTGGGGAGGAAGGAAGGCGAACACCGGGGAGCTGTTTTTT	CASSLIGPWGGRKANTGELFF	TRBV7-3	TRBJ2-2
TGCGCCAGCGGTCCGGGCCTTCCTGGAAACACCATATATTTT	CASGPGLPGNTIYF	TRBV10-1	TRBJ1-3
TGTGCCAGCAGCCAAGATGACGGACTAGCCCGCGGGGAGCTGTTTTTT	CASSQDDGLARGELFF	TRBV14	TRBJ2-2
TGTGCCAGCGGGGGGGACGCCAATCAGCCCCAGCATTTT	CASGGDANQPQHF	TRBV6-5	TRBJ1-5
TGTGCCTCCCGGCCGGGGGCTTTCTTT	CASRPGAFF	TRBV6-5	TRBJ1-1
TGTGCCAGCAGCACAGGGGGTTCGTCGGATAAGGCAGATACGCAGTATTTT	CASSTGGSSDKADTQYF	TRBV7-3	TRBJ2-3
TGTGCGAAAACCAGTACAGGAACTCAGCCCCAGCATTTT	CAKTSTGTQPQHF	TRBV5-4	TRBJ1-5
TGTGCCAGCAGAAGCGGAGGCTCCTACAATGAGCAGTTCTTC	CASRSGGSYNEQFF	TRBV6-5	TRBJ2-1
TGTGCCAGTAGAAAGGCCAGGGACTCCTACAATGAGCAGTTCTTC	CASRKARDSYNEQFF	TRBV19	TRBJ2-1
TGCAGCGTCGGCAGGAACAACGAGCAGTACTTC	CSVGRNNEQYF	TRBV29-1	TRBJ2-7
TGCAGTGCAATAGGGTTAGCCTACGAGCAGTACTTC	CSAIGLAYEQYF	TRBV20-1	TRBJ2-7
TGTGCCAGCAGTCCAACCAAAGCCACCGATACGTCCTATAATTCACCCCTCCACTTT	CASSPTKATDTSYNSPLHF	TRBV6-3	TRBJ1-6
TGCCCCCCCCGGACTAGCGGGGGTGATACGCAGTATTTT	CPPRTSGGDTQYF	TRBV10-2	TRBJ2-3
TGCGCCAGCAGCCTTCAGGGGGGGTTAATTAGCAATCAGCCCCAGCATTTT	CASSLQGGLISNQPQHF	TRBV4-1	TRBJ1-5
TGTGCCAGCAGTGGACTAGCGGGAGCCCTCGAGCAGTACTTC	CASSGLAGALEQYF	TRBV28	TRBJ2-7
TGTGCCAGCACCTCGGTGCGCGGTTGGGATTGGAACACTGAAGCTTTCTTT	CASTSVRGWDWNTEAFF	TRBV9	TRBJ1-1
TGTGCCAGCAGTTACGAAGTGACTAGCGGGAGGGCCCAGACCACAGATACGCAGTATTTT	CASSYEVTSGRAQTTDTQYF	TRBV6-3	TRBJ2-3
TGTGCCCCCTCTTCGACAGGGGGCTATGGCTACACCTTC	CAPSSTGGYGYTF	TRBV24-1	TRBJ1-2
TGTGCCAGCAGTGGTTATATGTTGCTAGGGTTGAGTCCGGCTGAGCAGTTCTTC	CASSGYMLLGLSPAEQFF	TRBV2	TRBJ2-1
TGTGCCAGCAGTTACCGCTCCGGGTACACTGAAGCTTTCTTT	CASSYRSGYTEAFF	TRBV6-5	TRBJ1-1
TGTGCCAGCAGCTTAGATCGTCGTCAGCTGTGGAAAGCTTTCTTT	CASSLDRRQLWKAFF	TRBV7-9	TRBJ1-1
TGTGCCATCAGGAATAGCGGGATCGATGAGCAGTTCTTC	CAIRNSGIDEQFF	TRBV10-3	TRBJ2-1
TGTGCCAGCAGTAATCCCGACAGGGTTCATAGCAATCAGCCCCAGCATTTT	CASSNPDRVHSNQPQHF	TRBV6-4	TRBJ1-5
TGTGCCAGCAGTTTTCCGACCCTTCGGGGACACGGTAACGAAAAACTGTTTTTT	CASSFPTLRGHGNEKLFF	TRBV27	TRBJ1-4
TGTGCCAGCAGCTCTACCCATAGCATTCAGTACTTC	CASSSTHSIQYF	TRBV5-6	TRBJ2-4
TGTGCCACCAGTGGGGGGGCTAGCAATCAGCCCCAGCATTTT	CATSGGASNQPQHF	TRBV24-1	TRBJ1-5
TGCAGCGCGGGACAGCGGAATCAGCCCCAGCATTTT	CSAGQRNQPQHF	TRBV29-1	TRBJ1-5
TGCAGTGCAAGAACAGGTACCAGCTCCTACGAGCAGTACTTC	CSARTGTSSYEQYF	TRBV20-1	TRBJ2-7
TGTGCCAGCAGTGATAGTCCATATGGGCACACTGAAGCTTTCTTT	CASSDSPYGHTEAFF	TRBV6-4	TRBJ1-1
TGTGCAATGGGGGGAAGTGAGCAGTTCTTC	CAMGGSEQFF	TRBV28	TRBJ2-1
TGTGCCAGCAGCTTACCGACTAGCGGAGCTTCCTACAATGAGCAGTTCTTC	CASSLPTSGASYNEQFF	TRBV7-4	TRBJ2-1
TGTGCCAGCAGCCCGGTGTGCACAGATACGCAGTATTTT	CASSPVCTDTQYF	TRBV7-9	TRBJ2-3
TGTGCCTGGAGGGGGGTCTCCTACGAGCAGTACTTC	CAWRGVSYEQYF	TRBV30	TRBJ2-7
TGCGCCAGCCCTCGGTGGAATAAGAGGGCCTACGAGCAGTACTTC	CASPRWNKRAYEQYF	TRBV10-1	TRBJ2-7
TGTGCCAGCAGCTTAGTTAGGGAAAGCTCCTACGAGCAGTACTTC	CASSLVRESSYEQYF	TRBV7-2	TRBJ2-7
TGTGCCAGCAGCTTACCTGCTGTTGGCCACGCGGGAGGATGGGGGGCCAACGTCCTGACTTTC	CASSLPAVGHAGGWGANVLTF	TRBV7-4	TRBJ2-6
TGCGCCAGCAGCTTGGGTTCAGACCTTTGCGTGTGCACAGATACGCAGTATTTT	CASSLGSDLCVCTDTQYF	TRBV5-1	TRBJ2-3
TGTGCCAGCAGCGTCAGGGAGGAGGGGGCTAACTATGGCTACACCTTC	CASSVREEGANYGYTF	TRBV13	TRBJ1-2
TGTGCCAGCAGTGTCGAGGACAGAAGCCGCAATCAGCCCCAGCATTTT	CASSVEDRSRNQPQHF	TRBV27	TRBJ1-5
TGTGCCAGCAGCCAGGTAGATGAGCAGTTCTTC	CASSQVDEQFF	TRBV11-2	TRBJ2-1
TGTGCCAGCAGCTCGGTCGGGGGCGGCTCTGGAAACACCATATATTTT	CASSSVGGGSGNTIYF	TRBV5-4	TRBJ1-3
TGTGCCAGCAGCCACCGTGGGACAGGTAACACCGGGGAGCTGTTTTTT	CASSHRGTGNTGELFF	TRBV5-6	TRBJ2-2
TGCGGCCTATTAGATTACAATGAGCAGTTCTTC	CGLLDYNEQFF	TRBV10-2	TRBJ2-1
TGTGCCAGCAGCGTAATTTATTTTCTCGAGCAGTACTTC	CASSVIYFLEQYF	TRBV7-6	TRBJ2-7
TGTGCCAGCAGTTCGACAGGGGTCGGCACTGAAGCTTTCTTT	CASSSTGVGTEAFF	TRBV13	TRBJ1-1
TGTGCCAGTAGTAGTAGGGGAGGGCGCAATCAGCCCCAGCATTTT	CASSSRGGRNQPQHF	TRBV19	TRBJ1-5
TGTGCCAGCAGCGGACAAGGCTTACCCGGCTCCTACGAGCAGTACTTC	CASSGQGLPGSYEQYF	TRBV11-1	TRBJ2-7
TGTGCCAGTAGTATTAAGCCGAAACAGGGCAAACCCTACGAGCAGTACTTC	CASSIKPKQGKPYEQYF	TRBV19	TRBJ2-7
TGTGCCAGCAAGGTCCTTCCTAGCGGCGGCGATGAGCAGTTCTTC	CASKVLPSGGDEQFF	TRBV6-5	TRBJ2-1
TGTGCCAGCAGCTTAAGGACAGGGGCGCTAGCCAAAAACATTCAGTACTTC	CASSLRTGALAKNIQYF	TRBV11-3	TRBJ2-4
TGTGCCAGCAGCCCCGTTGTAAAATCGGGGGCGGGCTATGGCTACACCTTC	CASSPVVKSGAGYGYTF	TRBV7-8	TRBJ1-2
TGTGCCAGCAGCGAGGGGGGCGGGAGTGGATTGGGCTCTGGAAACACCATATATTTT	CASSEGGGSGLGSGNTIYF	TRBV11-2	TRBJ1-3
TGTGCCAGCAGCTTCGGACAGATTGAAGAGACCCAGTACTTC	CASSFGQIEETQYF	TRBV6-2	TRBJ2-5
TGTGCCAGCAGTGAGGCCCGGGACAACACCGGGGAGCTGTTTTTT	CASSEARDNTGELFF	TRBV25-1	TRBJ2-2
TGTGCCAGCAGCCCGGACAGGGAATTCTACGAGCAGTACTTC	CASSPDREFYEQYF	TRBV4-2	TRBJ2-7
TGTGCCAGCAGCTTACCGGGACAGGGGACAGATACGCAGTATTTT	CASSLPGQGTDTQYF	TRBV7-9	TRBJ2-3
TGTGCCAGCAGCGTAACCGCCGGGTGGGGAAGGGCTGGGGCCAACGTCCTGACTTTC	CASSVTAGWGRAGANVLTF	TRBV9	TRBJ2-6
TGCGCCAGCAGCTTGGTAACATCCAGGGCCCGTGAAGCTTTCTTT	CASSLVTSRAREAFF	TRBV5-1	TRBJ1-1
TGCAGTGCTGGGGGCCCCCGGACCTCTGAAGCTTTCTTT	CSAGGPRTSEAFF	TRBV20-1	TRBJ1-1
TGCGCCAGCAGCCTCTGCGGACAGGGGGCTCAAGACAATCAGCCCCAGCATTTT	CASSLCGQGAQDNQPQHF	TRBV5-1	TRBJ1-5
TGTTGTATCGGCTCCTACAATGAGCAGTTCTTC	CCIGSYNEQFF	TRBV19	TRBJ2-1
TGTGCCAGCAGCTTCGGCCCCAGGGAAAAGTACTTC	CASSFGPREKYF	TRBV7-9	TRBJ2-7
TGTGCCAGCAGCTTCCCTGTCATCGTACTTAGTCGAAGCAATCAGCCCCAGCATTTT	CASSFPVIVLSRSNQPQHF	TRBV7-8	TRBJ1-5
TGTGCCAGCAGGGTTAAACCCCTAGGGGGGGAGACCCAGTACTTC	CASRVKPLGGETQYF	TRBV27	TRBJ2-5
TGTGCCAGCAGCGTAGATGGGGCGTTCGAGCAGTACTTC	CASSVDGAFEQYF	TRBV9	TRBJ2-7
TGTGCCAGCACCCTGGGGGGGCGATTCGAGCAGTACTTC	CASTLGGRFEQYF	TRBV13	TRBJ2-7
TGTGCCAGCAGCTTGGGGCCGGACAGGGGCTATGGCTACACCTTC	CASSLGPDRGYGYTF	TRBV5-4	TRBJ1-2
TGTGCCAGCAGTGACTCGATAAATCGGGAATCTTACGAGCAGTACTTC	CASSDSINRESYEQYF	TRBV6-4	TRBJ2-7
TGTGCCAGCAGCTTAGCTAGGGGGGAAGGGACCCTAGAGACCCAGTACTTC	CASSLARGEGTLETQYF	TRBV11-3	TRBJ2-5
TGCGCCAGCATCAGGGGTAATGGCTACACCTTC	CASIRGNGYTF	TRBV10-1	TRBJ1-2
TGTGCCAGTAGGGACACCCCACTTGGCTACACCTTC	CASRDTPLGYTF	TRBV19	TRBJ1-2
TGTGCCAGCAGCGCGACTTTCCGGGCTGGGAGGACGGGACTAGCGCCCCGTGAGCAGTTCTTC	CASSATFRAGRTGLAPREQFF	TRBV3-1	TRBJ2-1
TGTGCCAGCAGTGAAGGGGGGAAAAAGTGGGGGGGAGATACGCAGTATTTT	CASSEGGKKWGGDTQYF	TRBV6-1	TRBJ2-3
TGTGCCAGCAGCTTACTAGCGGGAGGGCCGGGACACTTC	CASSLLAGGPGHF	TRBV5-8	TRBJ2-7
TGTGCCAGCAGTTTATTCCCCACCCTGGACCCACGGGGCAATCAGCCCCAGCATTTT	CASSLFPTLDPRGNQPQHF	TRBV27	TRBJ1-5
TGTGCTAGTGGTTTGGTACCGGCAAGCCGAAACGCTAGCGGTGATGGCTACGAGCAGTACTTC	CASGLVPASRNASGDGYEQYF	TRBV12-5	TRBJ2-7
TGTGCCAGCAGCAAAACCGGACAGGGGGTAAGCAATCAGCCCCAGCATTTT	CASSKTGQGVSNQPQHF	TRBV7-3	TRBJ1-5
TGTGCCAGCAGCCAAGGACATGGGACAGGGGACTCCTATGGCTACACCTTC	CASSQGHGTGDSYGYTF	TRBV14	TRBJ1-2
TGTGCCAGCAGCGTAGCTGAGAGCACAGATACGCAGTATTTT	CASSVAESTDTQYF	TRBV9	TRBJ2-3
TGTGCCAGCAGCCAAGCAACACCATGGCTCACTCTAGCGGGGGGCGATGAGCAGTTCTTC	CASSQATPWLTLAGGDEQFF	TRBV3-1	TRBJ2-1
TGTGCCAGCAGCAAAAAGACGGGACAGAGATCACCCCTCCACTTT	CASSKKTGQRSPLHF	TRBV5-8	TRBJ1-6
TGTGCCAGCAGGGAGAGGACACGGGGTAACTATGGCTACACCTTC	CASRERTRGNYGYTF	TRBV6-5	TRBJ1-2
TGCAGTGCGCAGGGAGCGCCACGTATTGGAAACACCATATATTTT	CSAQGAPRIGNTIYF	TRBV20-1	TRBJ1-3
TGTGCCAGCAGCGGGGGGACGAAAAAGCCCCAGCATTTT	CASSGGTKKPQHF	TRBV7-3	TRBJ1-5
TGTGCCAGCAGCGTACACCCACAGGGGGATTCTGAAGCTTTCTTT	CASSVHPQGDSEAFF	TRBV13	TRBJ1-1
TGCAGTGCTATTTCTAGCGGGTGGAGGCGCGAGCAGTACTTC	CSAISSGWRREQYF	TRBV20-1	TRBJ2-7
TGTGCCAGCAGCTACACAACTGAAGCTTTCTTT	CASSYTTEAFF	TRBV11-2	TRBJ1-1
TGTGCCGGACGCCCGGTAACGTCCAGGGGGAAATCACCCCTCCACTTT	CAGRPVTSRGKSPLHF	TRBV6-4	TRBJ1-6
TGCGCCAGCAGCCGAACGGGGGGCGCCGGGGAGCTGTTTTTT	CASSRTGGAGELFF	TRBV5-1	TRBJ2-2
TGTGCCAGCAGCCAATATGACGCAGGGGGCGGGGGCAATCAGCCCCAGCATTTT	CASSQYDAGGGGNQPQHF	TRBV7-4	TRBJ1-5
TGTGCCAGCAGCGTAGGGGCCTATGGCTACACCTTC	CASSVGAYGYTF	TRBV9	TRBJ1-2
TGCGCCCACATGAGCTCAACTATGCGGGGGTGGTTGCACGAGCAGTACTTC	CAHMSSTMRGWLHEQYF	TRBV10-1	TRBJ2-7
TGTGCCAGCAGCGGGAGCTACGAGCAGTACTTC	CASSGSYEQYF	TRBV6-5	TRBJ2-7
TGCGCCAGCAGTGACCAGGCCAGGGCCCCATTAGAAGCTTTCTTT	CASSDQARAPLEAFF	TRBV10-1	TRBJ1-1
TGTGCCACCAGTGAAGGGGGTCAGGGGGCTCACTACGAGCAGTACTTC	CATSEGGQGAHYEQYF	TRBV24-1	TRBJ2-7
TGTGCCAGCAAGAAGGAGGGGGGTGTTTTGGACACTGAAGCTTTCTTT	CASKKEGGVLDTEAFF	TRBV6-5	TRBJ1-1
TGTGCCAGCAGTGACGTAAAGAGGGGAAGCTGGGGTGGCTACACCTTC	CASSDVKRGSWGGYTF	TRBV6-4	TRBJ1-2
TGTGCCACTCACGGACTAGCGGTAGGGGGCGAGCAGTACTTC	CATHGLAVGGEQYF	TRBV7-7	TRBJ2-7
TGCGCCAGCAGTGTTGGCCCCGCTCTGTGGACAGATACGCAGTATTTT	CASSVGPALWTDTQYF	TRBV10-1	TRBJ2-3
TGTGCCTGGAGTGTACCAGAATCGGGACTTGGTTCCTACGAGCAGTACTTC	CAWSVPESGLGSYEQYF	TRBV30	TRBJ2-7
TGCGCCAGCAACCCTGGCCTTTTAGGAGCTTTCTTT	CASNPGLLGAFF	TRBV5-1	TRBJ1-1
TGCAGTGCTAGCAGGGATTTGAACACTGAAGCTTTCTTT	CSASRDLNTEAFF	TRBV20-1	TRBJ1-1
TGCGCCAGCAGTCCCCGTGGGGACAGGGATCAGCCCCAGCATTTT	CASSPRGDRDQPQHF	TRBV10-1	TRBJ1-5
TGTGCCAGCAGCCCCGTCTCGGTGGGGGGAAATAGCGGCAGCGATACGCAGTATTTT	CASSPVSVGGNSGSDTQYF	TRBV5-8	TRBJ2-3
TGTGCCAGCTCACCACTGGGAACAGGCTTCTATGGCTACACCTTC	CASSPLGTGFYGYTF	TRBV18	TRBJ1-2
TGTAGACCAAGGGTGAACGAGCAGTACTTC	CRPRVNEQYF	TRBV11-2	TRBJ2-7
TGTCGGCCTGAAGCTTTCTTT	CRPEAFF	TRBV7-9	TRBJ1-1
TGTGCCAGCAGCGGTACTTGGACAGGAAGACCGACTAATGAAAAACTGTTTTTT	CASSGTWTGRPTNEKLFF	TRBV11-3	TRBJ1-4
TGTGCCAGCAGCGACTTGGGCTACACCTTC	CASSDLGYTF	TRBV7-3	TRBJ1-2
TGCGCCAGCAGCTTGGATTGGTACGGGGGGATAAGACTTGAGCAGTACTTC	CASSLDWYGGIRLEQYF	TRBV5-1	TRBJ2-7
TGTGCCAGCAGAAATCCCGGGACAGGGGGGCGGCAAGAGACCCAGTACTTC	CASRNPGTGGRQETQYF	TRBV6-1	TRBJ2-5
TGTCGGGGGGCCAAGGATGGCTACACCTTC	CRGAKDGYTF	TRBV6-1	TRBJ1-2
TGTGCCAGCAGCCAAACACATTTCCCCCCCCAGCGGGAGCCCCAGGAAGACCATCAGCCCCAGCATTTT	CASSQTHFPPQREPQEDHQPQHF	TRBV3-1	TRBJ1-5
TGTGCCAGCAGTGAAAGTTCTGACTTAGGCGGGTACGAGCAGTACTTC	CASSESSDLGGYEQYF	TRBV6-1	TRBJ2-7
TGTGCTAGCAGCACGGGGACGGGGCGGTATTTT	CASSTGTGRYF	TRBV7-7	TRBJ2-3
TGTGCCAGCAGTTTCCATGAAGGGGGAGAGACCCAGTACTTC	CASSFHEGGETQYF	TRBV27	TRBJ2-5
TGTGCCAGCAGCCCCGGGACAGTCTGCTCACCCCTCCACTTT	CASSPGTVCSPLHF	TRBV7-9	TRBJ1-6
TGTGCCAGCAGTCACAGGGCCTACGAGCAGTACTTC	CASSHRAYEQYF	TRBV6-1	TRBJ2-7
TGTGCCAGCAGTGACTCCCCCCGACTAGCGGGGGGGTCCAGCTCCTACAATGAGCAGTTCTTC	CASSDSPRLAGGSSSYNEQFF	TRBV6-4	TRBJ2-1
TGTGCCAGCAGTTACCTCGTCAGGGGCTACGAGCAGTACTTC	CASSYLVRGYEQYF	TRBV6-5	TRBJ2-7
TGTGCCAGCAGTGAAGCGGTCAACAGAGAGACCCAGTACTTC	CASSEAVNRETQYF	TRBV6-1	TRBJ2-5
TGTGCCAGCAGCTTACGGGGCAATCCTCCCTACGAGCAGTACTTC	CASSLRGNPPYEQYF	TRBV7-6	TRBJ2-7
TGTGCTAGTGGTTTGGTAACCCCAGGGGAGGGGGAGGACTACGAGCAGTACTTC	CASGLVTPGEGEDYEQYF	TRBV12-5	TRBJ2-7
TGCAGCGTTGACCCAGACAAGTCGACCTACGAGCAGTACTTC	CSVDPDKSTYEQYF	TRBV29-1	TRBJ2-7
TGTGCCAGCAGTTTCGATAGTCCCGGGACAGGGGATGAAAAACTGTTTTTT	CASSFDSPGTGDEKLFF	TRBV28	TRBJ1-4
TGTGCCAGCAGCACCCCCCCCCGTGGGACAACCATTCAGTACTTC	CASSTPPRGTTIQYF	TRBV7-2	TRBJ2-4
TGCGCCAGCAGCCGGGGTCAGAAAGCCTACGAGCAGTACTTC	CASSRGQKAYEQYF	TRBV4-1	TRBJ2-7
TGTGCCAGCAGCCAAGCGGACAGGGATCCCCAAGAGACCCAGTACTTC	CASSQADRDPQETQYF	TRBV3-1	TRBJ2-5
TGTGCCAGCAGTTATCGGTCCCAGTACTTC	CASSYRSQYF	TRBV6-6	TRBJ2-5
TGTGCCAGCAGCCCGGGACAGGCCTTCTTAAAAGAGACCCAGTACTTC	CASSPGQAFLKETQYF	TRBV11-1	TRBJ2-5
TGTGCCACCAGTGACGTACCTCAGGGGGATACCTACGAGCAGTACTTC	CATSDVPQGDTYEQYF	TRBV24-1	TRBJ2-7
TGTGCCAGCAGCGGGGCGTCGAACACTGAAGCTTTCTTT	CASSGASNTEAFF	TRBV28	TRBJ1-1
TGTGCCAGCAGCTTACGCCCCGGGACTAGCGGGAGGGGCGTTAGCACAGATACGCAGTATTTT	CASSLRPGTSGRGVSTDTQYF	TRBV7-3	TRBJ2-3
TGCGCCAGCACCCAGGACAGGGGAAAAAACATTCAGTACTTC	CASTQDRGKNIQYF	TRBV10-1	TRBJ2-4
TGTGCCAGCAGCTCAGGGGGGACTAGGAAGGTAAATGAGCAGTTCTTC	CASSSGGTRKVNEQFF	TRBV13	TRBJ2-1
TGTGCCAGCAACTGGGCTAGGAATGGCTACACCTTC	CASNWARNGYTF	TRBV7-2	TRBJ1-2
TGCAGGCGTGGAGACAGAAGCAATCAGCCCCAGCATTTT	CRRGDRSNQPQHF	TRBV29-1	TRBJ1-5
TGCAGTGCCCTTGAAGAGGGAACTCAAGAGACCCAGTACTTC	CSALEEGTQETQYF	TRBV20-1	TRBJ2-5
TGTGCCAGCAGCTGGGGACTAGCGGGCCGTAGCACAGATACGCAGTATTTT	CASSWGLAGRSTDTQYF	TRBV7-9	TRBJ2-3
TGTGCCAGCAGCTACGACAGGGCCGTTCCCTCTGGGGCCAACGTCCTGACTTTC	CASSYDRAVPSGANVLTF	TRBV5-5	TRBJ2-6
TGTGCCAGCAGCAACCGGAGTAGACGGAGCGGGGAGCTGTTTTTT	CASSNRSRRSGELFF	TRBV7-4	TRBJ2-2
TGCGCCAGCTTGGGGGTCCGCGGACTTTTTCTCGGGGAGCTGTTTTTT	CASLGVRGLFLGELFF	TRBV10-1	TRBJ2-2
TGTGCCAGCAGTGACTCGGGGGACAGTAGTTCACCCCTCCACTTT	CASSDSGDSSSPLHF	TRBV6-4	TRBJ1-6
TGTGCCAGCAGCCCTCAGGGGGGACAAAACTATGGCTACACCTTC	CASSPQGGQNYGYTF	TRBV12-3	TRBJ1-2
TGCGCCAGCATAGGTGAGGATCATCGTTCACCCCTCCACTTT	CASIGEDHRSPLHF	TRBV10-1	TRBJ1-6
TGTGCCAGCAGCCAACCCAGGGGTGCCCAAGAGACCCAGTACTTC	CASSQPRGAQETQYF	TRBV5-8	TRBJ2-5
TGTGCCAGCAGCCGGATCGGTACTGAAGCTTTCTTT	CASSRIGTEAFF	TRBV6-1	TRBJ1-1
TGTGCCAGCATCGGCCCGGGGATCAGGGATGACAATCAGCCCCAGCATTTT	CASIGPGIRDDNQPQHF	TRBV14	TRBJ1-5
TGTGCCAGCAGCTGGGGAACAGAATTCACCTTC	CASSWGTEFTF	TRBV5-4	TRBJ1-2
TGTGCCAGCAGCTCTCCAACAGGGAGCTCCTACAATGAGCAGTTCTTC	CASSSPTGSSYNEQFF	TRBV11-3	TRBJ2-1
TGTGCCTGGAGTGTAGGTGGGCGGTACACCTTC	CAWSVGGRYTF	TRBV30	TRBJ1-2
TGTGCCAGCAGTGAGGGGGGTCTGCAGGGGGTAGGAGCTGGTCCAGATACGCAGTATTTT	CASSEGGLQGVGAGPDTQYF	TRBV2	TRBJ2-3
TGTGCCACCAGTGCCGACAGGGGGCCCTGCAGCTCCTACGAGCAGTACTTC	CATSADRGPCSSYEQYF	TRBV24-1	TRBJ2-7
TGTGCCAGCAGCTTTAGGTGGGGAGACGAGCAGTACTTC	CASSFRWGDEQYF	TRBV5-5	TRBJ2-7
TGTGCCAGCAGCCCCCCCTCAGCCAGTAGGGGGCCCACAGATACGCAGTATTTT	CASSPPSASRGPTDTQYF	TRBV7-9	TRBJ2-3
TGTGCCAGCAGCTTCGTGCGGACAGGGGCGAAAAGCACAGATACGCAGTATTTT	CASSFVRTGAKSTDTQYF	TRBV7-9	TRBJ2-3
TGCGCCAGCAGCGGAACCGGGGGCGGCTACAATGAGCAGTTCTTC	CASSGTGGGYNEQFF	TRBV5-1	TRBJ2-1
TGCAGCGTTGAGATCGGACAGGGGGCTCTAGGAGATACGCAGTATTTT	CSVEIGQGALGDTQYF	TRBV29-1	TRBJ2-3
TGTGCCAGCAGCGTTCCCGCGGGACTAGGACATGAGCAGTTCTTC	CASSVPAGLGHEQFF	TRBV28	TRBJ2-1
TGTGCCAGCAGCCAGATCGAGGCCCGACAGGGGGGCTATGGCTACACCTTC	CASSQIEARQGGYGYTF	TRBV14	TRBJ1-2
TGCAGTGCTAGAGCGCGGGAGCGGCACTATGGCTACACCTTC	CSARARERHYGYTF	TRBV20-1	TRBJ1-2
TGTGCCAGCAGTGACTACCCGAGGTTTGGGACAGGGGGGGAAAAACTGTTTTTT	CASSDYPRFGTGGEKLFF	TRBV6-4	TRBJ1-4
TGTGCCAGCAGCTCTAATCCGCCCTACGAGCAGTACTTC	CASSSNPPYEQYF	TRBV7-3	TRBJ2-7
TGTGCCAGCAGTGGATCCTTCCATCCCGGGACTAGCACCCCCTACGAGCAGTACTTC	CASSGSFHPGTSTPYEQYF	TRBV6-6	TRBJ2-7
TGTGCCAGCAGCGACAGGGGGTCTGGAAACACCATATATTTT	CASSDRGSGNTIYF	TRBV13	TRBJ1-3
TGTGCCAGCAGCCAAGATAATAATCCAGGGCACACCGGGGAGCTGTTTTTT	CASSQDNNPGHTGELFF	TRBV3-1	TRBJ2-2
TGTGCCAGTACCGGACTAGTAGGGTCCTACGAGCAGTACTTC	CASTGLVGSYEQYF	TRBV19	TRBJ2-7
TGTGCCAGCAGTTACAAGAATAGGACAGGTCCGGTCTCCTACGAGCAGTACTTC	CASSYKNRTGPVSYEQYF	TRBV6-5	TRBJ2-7
TGTGCCAGCAGCAACGAGGCCATAGCGGGTACCGGGGAGCTGTTTTTT	CASSNEAIAGTGELFF	TRBV5-4	TRBJ2-2
TGTGCCAGCTCACCAATCGACAGGGACTTTAGCACAGATACGCAGTATTTT	CASSPIDRDFSTDTQYF	TRBV18	TRBJ2-3
TGTGCCACCAGTGATATAGTTAGCGGGAGGGACTACAATGAGCAGTTCTTC	CATSDIVSGRDYNEQFF	TRBV24-1	TRBJ2-1
TGTGCCAGCAGTTTTAAGGGCACAGATACGCAGTATTTT	CASSFKGTDTQYF	TRBV6-3	TRBJ2-3
TGTGCCAGCAGTGCCCTAGACAGAGCTAACTATGGCTACACCTTC	CASSALDRANYGYTF	TRBV6-1	TRBJ1-2
TGTGCCAGCAGTTACTTTACACCGCCGGGACGGCGTGCCCAAGAGACCCAGTACTTC	CASSYFTPPGRRAQETQYF	TRBV6-2	TRBJ2-5
TGCAGTGCTAGAGATAGGGAGGGGTACGAAGAAGAAAGGGGGTACTTC	CSARDREGYEEERGYF	TRBV20-1	TRBJ2-7
TGCAGTGCTAGACTCCTTAGAGGCCCATACTCCTACGAGCAGTACTTC	CSARLLRGPYSYEQYF	TRBV20-1	TRBJ2-7
TGCGCCAGCAGCCAAGATATGGACAGGGCCGGGGAGCTGTTTTTT	CASSQDMDRAGELFF	TRBV4-1	TRBJ2-2
TGCGCCAGCGCATTCCACTGTCGGGACCAATCGGGTAAAGCCAAAAACATTCAGTACTTC	CASAFHCRDQSGKAKNIQYF	TRBV5-1	TRBJ2-4
TGTGCCAGCGCGAGGGAAACTAAGTATAGCAATCAGCCCCAGCATTTT	CASARETKYSNQPQHF	TRBV12-3	TRBJ1-5
TGCGCCAGCAGCCGGGGCTCCTACGAGCAGTACTTC	CASSRGSYEQYF	TRBV4-1	TRBJ2-7
TGTGCCAGCAGTGAAGGGGAGGGCGGTTTCGATACGCAGTATTTT	CASSEGEGGFDTQYF	TRBV25-1	TRBJ2-3
TGTGCCACTGCTAGCGGACCAGGGTACACCGGGGAGCTGTTTTTT	CATASGPGYTGELFF	TRBV15	TRBJ2-2
TGCGCCAGCAGTGGTAGGGCCGGGCCTGTAGGAGGCTCCTACGAGCAGTACTTC	CASSGRAGPVGGSYEQYF	TRBV10-1	TRBJ2-7
TGTGCCACCCCATTACGGAGGGACAAGCCCTACGAGCAGTACTTC	CATPLRRDKPYEQYF	TRBV24-1	TRBJ2-7
TGTGCCAGCAGCTTAGCCAGAGTAAAGGGAAACGAGCAGTACTTC	CASSLARVKGNEQYF	TRBV7-9	TRBJ2-7
TGTGCCAGCTCACCTAGCGGGGCTTGCACAGATACGCAGTATTTT	CASSPSGACTDTQYF	TRBV18	TRBJ2-3
TGTGCCAGCTCACCACGCGGATACGAGCAGTACTTC	CASSPRGYEQYF	TRBV18	TRBJ2-7
TGTGCCAGCAGCCATGACCGGGGCCGGCGAAATCAGCCCCAGCATTTT	CASSHDRGRRNQPQHF	TRBV14	TRBJ1-5
TGTGCCAGCAGTTGCCCCCATGGGGGAAATACTGGTGAGAACACTGAAGCTTTCTTT	CASSCPHGGNTGENTEAFF	TRBV12-3	TRBJ1-1
TGTGCCTGGAGTCTCGCTATCGGTGTAGGGCAGCCGGACGAGCAGTACTTC	CAWSLAIGVGQPDEQYF	TRBV30	TRBJ2-7
TGTGCCACCAGTGAGAGACTAGCGGGAGGTTGGCAGCCCCAGCATTTT	CATSERLAGGWQPQHF	TRBV24-1	TRBJ1-5
TGTGCCACCAGTGCCCTCGACAGGGGGCACGAGCAGTACTTC	CATSALDRGHEQYF	TRBV24-1	TRBJ2-7
TGTGCCTGGTCATCAGGACTAGCGGGGATGCCCTACGAGCAGTACTTC	CAWSSGLAGMPYEQYF	TRBV30	TRBJ2-7
TGCAGTGCTAGAGCCATACCCCTTCCCATCATGGGTGAAAAACTGTTTTTT	CSARAIPLPIMGEKLFF	TRBV20-1	TRBJ1-4
TGTGCCAGCAGTCTCCTCCGACATCAAAGCTCCTACAATGAGCAGTTCTTC	CASSLLRHQSSYNEQFF	TRBV28	TRBJ2-1
TGTGCCAGTCCCGTGGGCCCCTTGTTTGGCACAGATACGCAGTATTTT	CASPVGPLFGTDTQYF	TRBV7-9	TRBJ2-3
TGCGCCAGCAGCCAAGATCTACTAGGGGGAAGGGGCTATGGCTACACCTTC	CASSQDLLGGRGYGYTF	TRBV4-1	TRBJ1-2
TGTGCCAGCAGCCCTAAGTCGGGACACGGTAGCAATCAGCCCCAGCATTTT	CASSPKSGHGSNQPQHF	TRBV13	TRBJ1-5
TGTGCCAGCAGTTACGGGAGGCAGACCAAAAACATTCAGTACTTC	CASSYGRQTKNIQYF	TRBV6-2	TRBJ2-4
TGCAGTGCGCTGGGGACAGGGCCGGGGTGGGATGAGCAGTTCTTC	CSALGTGPGWDEQFF	TRBV20-1	TRBJ2-1
TGCGCCAGCACCCCCTGGGCTGACCCTGGAAACACCATATATTTT	CASTPWADPGNTIYF	TRBV10-1	TRBJ1-3
TGCAGTGCTCTGCCCCTTATAGCGGGGGAGCACACCGGGGAGCTGTTTTTT	CSALPLIAGEHTGELFF	TRBV20-1	TRBJ2-2
TGTGCCAGCAGCTTAGTACCTTTTAAGCCACGCCTTCTCTGGCCCAACTATGGCTACACCTTC	CASSLVPFKPRLLWPNYGYTF	TRBV7-6	TRBJ1-2
TGTGCCAGCAGCTTTTCATTGAATGGCTACACCTTC	CASSFSLNGYTF	TRBV7-6	TRBJ1-2
TGTGCCAGCATCGGAACTAGACTAGCGGGTTGTCGGGTCCCTGAGACCCAGTACTTC	CASIGTRLAGCRVPETQYF	TRBV6-2	TRBJ2-5
TGTGCCAGCAGCTACGCGACAGGGAGGTCCGTAGCCAGCTCTGGAAACACCATATATTTT	CASSYATGRSVASSGNTIYF	TRBV5-4	TRBJ1-3
TGTGCCACCAGTGCCCCCTTCCTAGCGAGTATCTACGAGCAGTACTTC	CATSAPFLASIYEQYF	TRBV24-1	TRBJ2-7
TGTGCCAAAAGGGGACGGGGGGACACAGATACGCAGTATTTT	CAKRGRGDTDTQYF	TRBV28	TRBJ2-3
TGTGCCAGCACCACCGGGACTAGCGGTGGAGAGACCCAGTACTTC	CASTTGTSGGETQYF	TRBV12-4	TRBJ2-5
TGTGCCAGCAGCTTCAAGGGGGAGCTTCCCAAGTATAGCAATCAGCCCCAGCATTTT	CASSFKGELPKYSNQPQHF	TRBV11-2	TRBJ1-5
TGTGCCAGCAGGACTGGACTAGACCTCTCCACCGGGGAGCTGTTTTTT	CASRTGLDLSTGELFF	TRBV6-4	TRBJ2-2
TGTGCCAGCAGTTTGACAGAGAGCAATAATTCACCCCTCCACTTT	CASSLTESNNSPLHF	TRBV27	TRBJ1-6
TGTGCCAGCAGACCGGGCGGGAGCTATGGCTACACCTTC	CASRPGGSYGYTF	TRBV12-3	TRBJ1-2
TGCAGTGCTAGCCCGACAGGGGCCAGTACTGAAGCTTTCTTT	CSASPTGASTEAFF	TRBV20-1	TRBJ1-1
TGCAGTGCTAGAGGTAGGACAGGGGGCTGGATAGAGGGGATTTACTACGAGCAGTACTTC	CSARGRTGGWIEGIYYEQYF	TRBV20-1	TRBJ2-7
TGCGCCAGCAGTGAGGGGCTATGCTTGACTAATGAAAAACTGTTTTTT	CASSEGLCLTNEKLFF	TRBV10-2	TRBJ1-4
TGCGCCAGCAGCCACTCAAAACAGGGACAGGGCCTTCGAGGGTTTTGGAACACTGAAGCTTTCTTT	CASSHSKQGQGLRGFWNTEAFF	TRBV4-1	TRBJ1-1
TGCGCCAGCAGCTTGTTGGGGACTAGCGGGCGGGGGCAGTACTTC	CASSLLGTSGRGQYF	TRBV5-1	TRBJ2-7
TGCAGTGCTAGAGGGGTCAGGGGAGAGACCCAGTACTTC	CSARGVRGETQYF	TRBV20-1	TRBJ2-5
TGTGCGGGGTGGCGGAGGGAGGCTTTCTTT	CAGWRREAFF	TRBV12-5	TRBJ1-1
TGTGCCAGCAGTCAGGGCTCATCCGCCTACGAGCAGTACTTC	CASSQGSSAYEQYF	TRBV6-1	TRBJ2-7
TGTGCCAGCAGTGAAGGGCGTTGGGGTACTGAAGCTTTCTTT	CASSEGRWGTEAFF	TRBV6-1	TRBJ1-1
TGTGCCACCAGCAGAGGGACAAATAAGAATCAGCCCCAGCATTTT	CATSRGTNKNQPQHF	TRBV15	TRBJ1-5
TGTGCCAGCAGCCTCATATTCGGTGAGCAGTTCTTC	CASSLIFGEQFF	TRBV7-9	TRBJ2-1
TGTGCCACCAGTGACTGGGGGGGGCCTAAAAGCTCCTACAATGAGCAGTTCTTC	CATSDWGGPKSSYNEQFF	TRBV24-1	TRBJ2-1
TGTGCCAGCAGCGAAGTTCAGGGGGGGCATGGCTACACCTTC	CASSEVQGGHGYTF	TRBV9	TRBJ1-2
TGTGCCAGCAGCTTGGGAGGGTTGGACAGGGGGGGCTCCTATAATTCACCCCTCCACTTT	CASSLGGLDRGGSYNSPLHF	TRBV5-4	TRBJ1-6
TGTGCCAGCGCTGACTGGACATATAGCAATCAGCCCCAGCATTTT	CASADWTYSNQPQHF	TRBV27	TRBJ1-5
TGTGCCAGCATAGTTACAGGGGGCGAACGGTCCGGGTCACCCCTCCACTTT	CASIVTGGERSGSPLHF	TRBV11-1	TRBJ1-6
TGTGCCAGCAGGGGTAACGAGCAGTACTTC	CASRGNEQYF	TRBV9	TRBJ2-7
TGTGCCAGCAGTTCGTTCCACAGGGGTTGCGAGACCCAGTACTTC	CASSSFHRGCETQYF	TRBV6-5	TRBJ2-5
TGTGCCAGCAGCCTGTGGGGGCCTATAGGAAACACCATATATTTT	CASSLWGPIGNTIYF	TRBV6-1	TRBJ1-3
TGTGCCAGCAGGTTACCTGGGTTAACTAATGAAAAACTGTTTTTT	CASRLPGLTNEKLFF	TRBV7-9	TRBJ1-4
TGTGCCCGCAGGGGGACAGATACGCAGTATTTT	CARRGTDTQYF	TRBV27	TRBJ2-3
TGTGCCAGCAGCCTGTTTGCAGCGGTTCCAGAGGGGGGTAACTATGGCTACACCTTC	CASSLFAAVPEGGNYGYTF	TRBV3-1	TRBJ1-2
TGTGCCAGCAGTGATACAGGGGGCGCCATTCAAACCTACGAGCAGTACTTC	CASSDTGGAIQTYEQYF	TRBV2	TRBJ2-7
TGTGCCAGGGGAACTGAAGCTTTCTTT	CARGTEAFF	TRBV6-5	TRBJ1-1
TGTGCCAGCAGTTACTCGGGAGCAGGACTCAATGAGCAGTTCTTC	CASSYSGAGLNEQFF	TRBV6-5	TRBJ2-1
TGTGCTAGTGGTTTGCGACAGGGAGAAGCTTTCTTT	CASGLRQGEAFF	TRBV12-5	TRBJ1-1
TGTGCCAGCAGCCAAGTAGGGGCCAAAAACATTCAGTACTTC	CASSQVGAKNIQYF	TRBV4-2	TRBJ2-4
TGTGCCAGCAGGTCAGATTCATCCTACGAGCAGTACTTC	CASRSDSSYEQYF	TRBV28	TRBJ2-7
TGCGCCAGAAACTATGAGCAGTTCTTC	CARNYEQFF	TRBV10-1	TRBJ2-1
TGTGCCAGCAGCTTGCGTGACAGGGGGCTTCGCCATTCACCCCTCCACTTT	CASSLRDRGLRHSPLHF	TRBV5-6	TRBJ1-6
TGTGCCAGCAGCTTTAGGTTGGACAGGTCATTTGACACTGAAGCTTTCTTT	CASSFRLDRSFDTEAFF	TRBV7-8	TRBJ1-1
TGTACCGGGGGTAAGGCTTTCTTT	CTGGKAFF	TRBV7-9	TRBJ1-1
TGCGCCAGCAGCCGGGGGGACCACAATGAGCAGTTCTTC	CASSRGDHNEQFF	TRBV5-1	TRBJ2-1
TGCGCCAGCAGTAGGACAGGCGCTATTTTCTACAATGAGCAGTTCTTC	CASSRTGAIFYNEQFF	TRBV10-1	TRBJ2-1
TGCACAACCGGGGGGGTCCGTCAGAGCGATACGCAGTATTTT	CTTGGVRQSDTQYF	TRBV20-1	TRBJ2-3
TGCAGTGCTCTAGGATTCGAGACCCAGTACTTC	CSALGFETQYF	TRBV20-1	TRBJ2-5
TGTGCCAGCTCACCCGCGGGGACGCAGGTGAACACTGAAGCTTTCTTT	CASSPAGTQVNTEAFF	TRBV18	TRBJ1-1
TGCGCCAGCCTTCCGGGAACGGAGGATGGCTACACCTTC	CASLPGTEDGYTF	TRBV10-1	TRBJ1-2
TGTGCCAGCAGCTGGAAAACCGGGACAGGGGAGGAAGGAAACACCATATATTTT	CASSWKTGTGEEGNTIYF	TRBV7-6	TRBJ1-3
TGTGCCAGCAGCTTAACAGGGTGGCCCCAGCATTTT	CASSLTGWPQHF	TRBV7-2	TRBJ1-5
TGTGCCAGCAGATACGGGGGGGGTGGTTCCCAAGAGACCCAGTACTTC	CASRYGGGGSQETQYF	TRBV6-5	TRBJ2-5
TGTGCCAGCAGTAATCCCCCATGGGACAGGGGGCAAGCCCTCACCTTC	CASSNPPWDRGQALTF	TRBV28	TRBJ1-2
TGTGCCAGCAGTCCCCCTCGGGAGGGGTTGGACACCATATATTTT	CASSPPREGLDTIYF	TRBV28	TRBJ1-3
TGTGCCAGCAGCGTGGTGGCTATTCCTGGGGCCAACGTCCTGACTTTC	CASSVVAIPGANVLTF	TRBV13	TRBJ2-6
TGCGCCAGCAGCTTGGCCCGGAGCGGGAGGTGGAACTACGAGCAGTACTTC	CASSLARSGRWNYEQYF	TRBV5-1	TRBJ2-7
TGTGCCAGCAGCCAAGACCGGGACCAAGAGACCCAGTACTTC	CASSQDRDQETQYF	TRBV3-1	TRBJ2-5
TGCGCCAGCAGCTATATCTGGGGGAATGAGCAGTTCTTC	CASSYIWGNEQFF	TRBV5-1	TRBJ2-1
TGTGCCAGCAGGGACAGGCGGACTACTGAAGCTTTCTTT	CASRDRRTTEAFF	TRBV28	TRBJ1-1
TGTGCCAGCAGCTTATGGGGGGGACAGCGTGACGAGCAGTACTTC	CASSLWGGQRDEQYF	TRBV11-2	TRBJ2-7
TGTGCCAGCAGTTTAAGGGCCCAAATAGGGATTGACTATGGCTACACCTTC	CASSLRAQIGIDYGYTF	TRBV27	TRBJ1-2
TGTGCCAGCCCGGGACAGGGAGAGCAGTACTTC	CASPGQGEQYF	TRBV6-4	TRBJ2-7
TGTGCCAGCAGTGAAGAAAGACAGGGAGATACGCAGTATTTT	CASSEERQGDTQYF	TRBV6-1	TRBJ2-3
TGCAGTGCGTTCGCGGGTCGGTCCTACGAGCAGTACTTC	CSAFAGRSYEQYF	TRBV20-1	TRBJ2-7
TGTGCCAGCAGCCAGGACAGGGGTACCACTGAAGCTTTCTTT	CASSQDRGTTEAFF	TRBV5-4	TRBJ1-1
TGTGCCAGCAGTTTACAGGCGAACACTGAAGCTTTCTTT	CASSLQANTEAFF	TRBV12-4	TRBJ1-1
TGTGCCAGCAGCTTAGGCCGGGATGAGCAGTTCTTC	CASSLGRDEQFF	TRBV11-1	TRBJ2-1
TGCGCCAGCAGCTTGGCCTTCATAAACGGGCAGTGGGGCGAGACCCAGTACTTC	CASSLAFINGQWGETQYF	TRBV5-1	TRBJ2-5
TGCGCCAGAGCTCATGGAGCGCGGGGTCGAGAGGCGGGTTATTACAATGAGCAGTTCTTC	CARAHGARGREAGYYNEQFF	TRBV10-1	TRBJ2-1
TGTGCCATCAGTGGGGGAGCGGGACAGGATGCCGGGGAGCTGTTTTTT	CAISGGAGQDAGELFF	TRBV10-3	TRBJ2-2
TGCGCCATTCACATGTCCCCGGCAGGGGGCTACGAGCAGTACTTC	CAIHMSPAGGYEQYF	TRBV5-1	TRBJ2-7
TGCGCCAGCAGTGAACCCTCGGCGGACAGGGAGAACTATGGCTACACCTTC	CASSEPSADRENYGYTF	TRBV10-1	TRBJ1-2
TGTGCCAGCAGTTTAAACCACTACAATGAGCAGTTCTTC	CASSLNHYNEQFF	TRBV27	TRBJ2-1
TGTGCCAGCAGCTTGGACACTTGGGTGAACACTGAAGCTTTCTTT	CASSLDTWVNTEAFF	TRBV7-8	TRBJ1-1
TGTGCCAGCAGGAACGCAGCCAGGGGGCCCGTTAGCAATCAGCCCCAGCATTTT	CASRNAARGPVSNQPQHF	TRBV27	TRBJ1-5
TGTGCCACCATCAACAGCTGGGGGACAGATACGCAGTATTTT	CATINSWGTDTQYF	TRBV24-1	TRBJ2-3
TGTGCCAGCAGCCCTCAGGGGGAACATGAGCAGTTCTTC	CASSPQGEHEQFF	TRBV7-9	TRBJ2-1
TGTGCCAGCAGAGGCTGTCCGTCCAGCACTGGAAACACCATATATTTT	CASRGCPSSTGNTIYF	TRBV28	TRBJ1-3
TGTGCCAACAGCCCGAATGAGCAGTTCTTC	CANSPNEQFF	TRBV10-3	TRBJ2-1
TGCGCCAGCAGCCAACGAGGTGCGGGACTAGCGGAACGGTCAGGATACGAGCAGTACTTC	CASSQRGAGLAERSGYEQYF	TRBV4-1	TRBJ2-7
TGTGCCAGTAGTATCCCGGGGGGGAACTACGAGCAGTACTTC	CASSIPGGNYEQYF	TRBV19	TRBJ2-7
TGTGCCAGCAGCGCGAAGGGGGCTAACTTCTCCTATAATTCACCCCTCCACTTT	CASSAKGANFSYNSPLHF	TRBV3-1	TRBJ1-6
TGTGCCAGCAGCAGGACCGGGACAGGGTCCACTGAAGCTTTCTTT	CASSRTGTGSTEAFF	TRBV6-2	TRBJ1-1
TGTGCTAGTGGTCCTCGCGGGGTACCCGAGCAGTACTTC	CASGPRGVPEQYF	TRBV12-5	TRBJ2-7
TGTGCCAGCCGTTCGGGAAGACCGTATAGGACCTACAATGAGCAGTTCTTC	CASRSGRPYRTYNEQFF	TRBV27	TRBJ2-1
TGTGCCAGCAGATCTGCCCCTCAGGGTGGAAACTATGGCTACACCTTC	CASRSAPQGGNYGYTF	TRBV5-8	TRBJ1-2
TGCAGTGCTAGAGATCGGCGACCCTACGAGCAGTACTTC	CSARDRRPYEQYF	TRBV20-1	TRBJ2-7
TGCGCCAGTAACTCGTACCCCACCGGGGAGCTGTTTTTT	CASNSYPTGELFF	TRBV10-1	TRBJ2-2
TGCGCCAGCAGCCTGGGACAGGGGCTGGCAACCTACGAGCAGTACTTC	CASSLGQGLATYEQYF	TRBV4-3	TRBJ2-7
TGTGCCAGCAGCCATGGATCCATCAAGGGACTAGCGGGGGCCTACAATGAGCAGTTCTTC	CASSHGSIKGLAGAYNEQFF	TRBV5-4	TRBJ2-1
TGCAGTGCTGCGGGAGCAGATACGCAGTATTTT	CSAAGADTQYF	TRBV20-1	TRBJ2-3
TGCAGTGCTTCTCTCCCTCCTAGAGAGACCCAGTACTTC	CSASLPPRETQYF	TRBV20-1	TRBJ2-5
TGCGCCAGCAGCTTGGCGGACAGGGATCAGCCCCAGCATTTT	CASSLADRDQPQHF	TRBV5-1	TRBJ1-5
TGTGCCACACCGGGGGCAGCTCTCCACCAAGAGACCCAGTACTTC	CATPGAALHQETQYF	TRBV28	TRBJ2-5
TGTGCCAGCAGTTACCAGGGGGCCGGGAACACTGAAGCTTTCTTT	CASSYQGAGNTEAFF	TRBV6-5	TRBJ1-1
TGCAGTGCTAGGGCTGGAAATGAGCAGTTCTTC	CSARAGNEQFF	TRBV20-1	TRBJ2-1
TGTGCCAGCAGTAACCAGCGGGGGGGTGGGGCGAGCACAGATACGCAGTATTTT	CASSNQRGGGASTDTQYF	TRBV28	TRBJ2-3
TGTGCCAGCAGCCAAGGCAGGGCCTCCTACGAGCAGTACTTC	CASSQGRASYEQYF	TRBV14	TRBJ2-7
TGTGCCAGCAGTTATTCTATGATCAGGGGGCGCCGGTCCAAGAACACTGAAGCTTTCTTT	CASSYSMIRGRRSKNTEAFF	TRBV6-2	TRBJ1-1
TGTGCCAGCAGCAAGCAGGGGGGAATCTATGGCTACACCTTC	CASSKQGGIYGYTF	TRBV7-3	TRBJ1-2
TGCAGTGCTAGCCTGGGGTCGTTGTTATATAATTCACCCCTCCACTTT	CSASLGSLLYNSPLHF	TRBV20-1	TRBJ1-6
TGTGCCAGCAGCAGGCAGGCCCAGCCCCAGCATTTT	CASSRQAQPQHF	TRBV13	TRBJ1-5
TGTGCCAGCAGTTACTCGGACAGCCTCTCCTATAATTCACCCCTCCACTTT	CASSYSDSLSYNSPLHF	TRBV6-5	TRBJ1-6
TGCGCCAGCAGTGAAAAGGGGATATTTCTAAACACTGAAGCTTTCTTT	CASSEKGIFLNTEAFF	TRBV10-1	TRBJ1-1
TGCGCCAGCAGAAGCCGTAGGGGGTCTAGCACAGATACGCAGTATTTT	CASRSRRGSSTDTQYF	TRBV5-1	TRBJ2-3
TGTGCCAGCAGCTTAGCCCTTGAGGGTGTGGCCAACGTCCTGACTTTC	CASSLALEGVANVLTF	TRBV11-2	TRBJ2-6
TGTGCCATCATCGGGACTAGCGGGAGGGGTACAAGCGAGCAGTACTTC	CAIIGTSGRGTSEQYF	TRBV10-3	TRBJ2-7
TGTGCCAGCAGCGTTCCAGGGGTTATGCTTGACACCGGGGAGCTGTTTTTT	CASSVPGVMLDTGELFF	TRBV9	TRBJ2-2
TGTGCCAGCAGGATCCCACAGGGGGGTGAAAAACTGTTTTTT	CASRIPQGGEKLFF	TRBV12-3	TRBJ1-4
TGTGCCAGCAGCGGGACAACGACCAAAAACATTCAGTACTTC	CASSGTTTKNIQYF	TRBV6-4	TRBJ2-4
TGCGCCAGCAGCTGTACCGGGACTTTAGGCTACACCTTC	CASSCTGTLGYTF	TRBV5-1	TRBJ1-2
TGTGCCAGCAGTGATCACGGGGCCCGGCACGAGCAGTACTTC	CASSDHGARHEQYF	TRBV6-4	TRBJ2-7
TGTGCCAGCAGTTTAGTGCTTTCCAGGGGTGAGGGTGAGACCCAGTACTTC	CASSLVLSRGEGETQYF	TRBV27	TRBJ2-5
TGTGCCAGCAGCTGGCCTAGCGGGTCCTGCTACGAGCAGTACTTC	CASSWPSGSCYEQYF	TRBV7-8	TRBJ2-7
TGCAGTGCTAGCAACTCATTACCGGGACTAGCGGCTGGGAACAGCTCCTACAATGAGCAGTTCTTC	CSASNSLPGLAAGNSSYNEQFF	TRBV20-1	TRBJ2-1
TGTGCCAGCAGTGCCTTAGACACTGAAGCTTTCTTT	CASSALDTEAFF	TRBV11-2	TRBJ1-1
TGCAGTGCGAGGCATAACCCCGGGACAGGGGATACGGGAGCCAACTATGGCTACACCTTC	CSARHNPGTGDTGANYGYTF	TRBV20-1	TRBJ1-2
TGTGCCAGCAGCATCGTGAAGGGGAACTATAATTCACCCCTCCACTTT	CASSIVKGNYNSPLHF	TRBV7-9	TRBJ1-6
TGCGCCAGGGAGGGGCGGGGTGAAAAACTGTTTTTT	CAREGRGEKLFF	TRBV4-1	TRBJ1-4
TGTGCCAGCAGCTATACAGGGGGCAAATCTGGAAACACCATATATTTT	CASSYTGGKSGNTIYF	TRBV7-2	TRBJ1-3
TGTGCCAGCAGCGTTGAGTCCACAGGGAGGGATCAGCCCCAGCATTTT	CASSVESTGRDQPQHF	TRBV11-3	TRBJ1-5
TGTGCTAGTGGTTTGGACAGGGGCTCTGGAAACACCATATATTTT	CASGLDRGSGNTIYF	TRBV12-5	TRBJ1-3
TGCGCCAGCAGCCAAAAGGATATAGGGGCGAAGCTGGCTAGCTCCTACGAGCAGTACTTC	CASSQKDIGAKLASSYEQYF	TRBV4-3	TRBJ2-7
TGCGCCAGCAGCTGGGGAAGGAGCGGACTTCGCATTAATGAAAAACTGTTTTTT	CASSWGRSGLRINEKLFF	TRBV5-1	TRBJ1-4
TGCAGTGCTGGGGGTTGGCTCCCCTCTGAAGCTTTCTTT	CSAGGWLPSEAFF	TRBV20-1	TRBJ1-1
TGTGCCACCAGCGGGGACAAGGAAGCTTTCTTT	CATSGDKEAFF	TRBV15	TRBJ1-1
TGTGCCAGCAGTGAAGGGCAGGTCCGACAGGGGGCCCAAGGCAATCAGCCCCAGCATTTT	CASSEGQVRQGAQGNQPQHF	TRBV2	TRBJ1-5
TGTGCCAGGGCTTGTCTCTTCATCGGGACTAGCGGGTCATATAACAATGAGCAGTTCTTC	CARACLFIGTSGSYNNEQFF	TRBV6-1	TRBJ2-1
TGTGCCAGCAGCGTAGGGGACCACGAGCAGTACTTC	CASSVGDHEQYF	TRBV9	TRBJ2-7
TGTGCCACGACTAGCGGGAGGGTAGCCAAAAACATTCAGTACTTC	CATTSGRVAKNIQYF	TRBV6-4	TRBJ2-4
TGCGCCAGCAGCTACCCTTTCCTAGAACCGTACGAGCAGTACTTC	CASSYPFLEPYEQYF	TRBV5-1	TRBJ2-7
TGTGCCAGTAGCCGGGACAGTGCCACCGGGGAGCTGTTTTTT	CASSRDSATGELFF	TRBV19	TRBJ2-2
TGTGCCAGCAGCAGGGATGACAGGGACTACGAGCAGTACTTC	CASSRDDRDYEQYF	TRBV13	TRBJ2-7
TGTGCCAGCAGGAGCGGGAACCTTAGCTCCTACGAGCAGTACTTC	CASRSGNLSSYEQYF	TRBV12-4	TRBJ2-7
TGCGCCAGCAGCAATCTAGGTCGGACTAGGGCCGGGGAGCTGTTTTTT	CASSNLGRTRAGELFF	TRBV4-1	TRBJ2-2
TGTGCTAGTGGCCACAGGGAGAGGGATAGCAATCAGCCCCAGCATTTT	CASGHRERDSNQPQHF	TRBV12-5	TRBJ1-5
TGTGCCTGGAAACACCGGGACAGGGTAGATTACACCTACGAGCAGTACTTC	CAWKHRDRVDYTYEQYF	TRBV30	TRBJ2-7
TGTGCCAGCTCACCTATGCTGGGAGCGGGCTGTGAGCAGTTCTTC	CASSPMLGAGCEQFF	TRBV18	TRBJ2-1
TGTGCCAGCCACAGGGAAAACAACACAGATACGCAGTATTTT	CASHRENNTDTQYF	TRBV19	TRBJ2-3
TGCAGTGCTAGCCCCGGGTTAAGCTACGAGCAGTACTTC	CSASPGLSYEQYF	TRBV20-1	TRBJ2-7
TGCGCCAGCAGTCCTGGGGGGCGGACTAATGAAAAACTGTTTTTT	CASSPGGRTNEKLFF	TRBV4-3	TRBJ1-4
TGTGCCAGCAGGTTTCCCCTTGTCTACGAGCAGTACTTC	CASRFPLVYEQYF	TRBV12-4	TRBJ2-7
TGTGCCAGCAGCTTGCTAGAGTACGAGCAGTACTTC	CASSLLEYEQYF	TRBV7-6	TRBJ2-7
TGTGCCTGGACACCAGCAGGGGGACTCGGTGGGGCCAACGTCCTGACTTTC	CAWTPAGGLGGANVLTF	TRBV30	TRBJ2-6
TGTGCCAGCAGTGACCTTCGGGGGCGAGGCAACACTGAAGCTTTCTTT	CASSDLRGRGNTEAFF	TRBV6-4	TRBJ1-1
TGTGCCAGCATAGGGGGCGGGGGGGCGGGTAACGGGGAGCTGTTTTTT	CASIGGGGAGNGELFF	TRBV6-4	TRBJ2-2
TGTGCCAGCAGTTTCTGGGGGGGCTCCCATCAGCCCCAGCATTTT	CASSFWGGSHQPQHF	TRBV12-3	TRBJ1-5
TGTGCCAGCAGCCGCGGGAATGAGCAGTTCTTC	CASSRGNEQFF	TRBV7-9	TRBJ2-1
TGCAGCGTGCGAAATCCGCAGGGGCGGGATAGCAATCAGCCCCAGCATTTT	CSVRNPQGRDSNQPQHF	TRBV29-1	TRBJ1-5
TGTGCCAGCTCACCGCAGATTGGGACAGGGGGGGGAGATGAGCAGTTCTTC	CASSPQIGTGGGDEQFF	TRBV18	TRBJ2-1
TGTGCCAGCAGTACGCAGTATGGCTACACCTTC	CASSTQYGYTF	TRBV27	TRBJ1-2
TGTGCCAGCAGTGAATTCCCCCGGGACAGGGGATATAATTCACCCCTCCACTTT	CASSEFPRDRGYNSPLHF	TRBV25-1	TRBJ1-6
TGTGCCAGCAGCCAGTGGGGCCTGGGAACCTACGAGCAGTACTTC	CASSQWGLGTYEQYF	TRBV14	TRBJ2-7
TGTGCCACCAGTGCCTACGGGGCGACCTATAGCAATCAGCCCCAGCATTTT	CATSAYGATYSNQPQHF	TRBV24-1	TRBJ1-5
TGCGCCAGCAGCCCTGTCCCCCGGAGACTGGTCCGCCAAGAGACCCAGTACTTC	CASSPVPRRLVRQETQYF	TRBV5-1	TRBJ2-5
TGTGCCAGCAGCGCTTACCGGGACGGAGGAGAAGCTTTCTTT	CASSAYRDGGEAFF	TRBV9	TRBJ1-1
TGTGCCAGCAGCACCTACAGATACTTACCTACTGAAGCTTTCTTT	CASSTYRYLPTEAFF	TRBV11-3	TRBJ1-1
TGCGCCAGCATTGCGATTTGTCGGGGACTCTTCTATGGCTACACCTTC	CASIAICRGLFYGYTF	TRBV5-1	TRBJ1-2
TGTGCCAGCAGGGATAGTGGATATTCACGAATGAACACTGAAGCTTTCTTT	CASRDSGYSRMNTEAFF	TRBV7-8	TRBJ1-1
TGCAGTGCTAGACGCTGTCGGGTCTCCTACAATGAGCAGTTCTTC	CSARRCRVSYNEQFF	TRBV20-1	TRBJ2-1
TGCGCCATTGGGGGGGGGCGACTCTCCTACGAGCAGTACTTC	CAIGGGRLSYEQYF	TRBV10-1	TRBJ2-7
TGCGCCACCGGGACCCGGAACACCGGGGAGCTGTTTTTT	CATGTRNTGELFF	TRBV10-1	TRBJ2-2
TGTGCCAGCAGCTTCAAGGGGGCTTCCCAGGACCGACAGGGTGCTAGCAATCAGCCCCAGCATTTT	CASSFKGASQDRQGASNQPQHF	TRBV5-8	TRBJ1-5
TGCAGTGCTGGACAGAAGGGTACCGGGGAGCTGTTTTTT	CSAGQKGTGELFF	TRBV20-1	TRBJ2-2
TGTGCCAGCAGCTCAGGCCTCAGTGGGGGAGGCAATCAGCCCCAGCATTTT	CASSSGLSGGGNQPQHF	TRBV5-6	TRBJ1-5
TGCAGTGCTAGACTGGACAGTGGATCCTATAATTCACCCCTCCACTTT	CSARLDSGSYNSPLHF	TRBV20-1	TRBJ1-6
TGTGCCACCAGTGCCCAGGGGGGACCTCAGCCCCAGCATTTT	CATSAQGGPQPQHF	TRBV24-1	TRBJ1-5
TGTGCCAGCAGCTCGCGGAATAACATTCAGTACTTC	CASSSRNNIQYF	TRBV7-2	TRBJ2-4
TGTGCCAGCAGCGGGCCTGCAGAAAAACTGTTTTTT	CASSGPAEKLFF	TRBV7-2	TRBJ1-4
TGTGCCAGCAGCCTTAGCGGGACTGGTGAGCAGTTCTTC	CASSLSGTGEQFF	TRBV7-9	TRBJ2-1
TGTGCCATCAGACCGGGGGGAGGAAGCTCCTACAATGAGCAGTTCTTC	CAIRPGGGSSYNEQFF	TRBV10-3	TRBJ2-1
TGTGCTAGCGGACCTGGGTCCTCCTACGAGCAGTACTTC	CASGPGSSYEQYF	TRBV7-7	TRBJ2-7
TGTGCGGCAGGGGGGGAATGGCAACTGTTTTTT	CAAGGEWQLFF	TRBV7-3	TRBJ1-4
TGTGCCATCAGCCCCCAACAGGTAGACAATGAGCAGTTCTTC	CAISPQQVDNEQFF	TRBV10-3	TRBJ2-1
TGTGCCAGCAGCACCCCCCCCCCAGCGGGAGGGCTAGCCAAAAACATTCAGTACTTC	CASSTPPPAGGLAKNIQYF	TRBV5-6	TRBJ2-4
TGTGCCAGCAGCTCCACCGCGGCCGATACGCAGTATTTT	CASSSTAADTQYF	TRBV11-3	TRBJ2-3
TGTGCCATCACGGGGGACAGGTTCTCTTTCTTT	CAITGDRFSFF	TRBV10-3	TRBJ1-1
TGTGCCAGCAGCACAGGGAATGCAACTAATGAAAAACTGTTTTTT	CASSTGNATNEKLFF	TRBV7-8	TRBJ1-4
TGTGCCAGCAGTGATACTAGCGGGAGAAAAAGCAATCAGCCCCAGCATTTT	CASSDTSGRKSNQPQHF	TRBV2	TRBJ1-5
TGTGCCACGTCGGGCCCCCGACGCAGGGCAGATACGCAGTATTTT	CATSGPRRRADTQYF	TRBV25-1	TRBJ2-3
TGTGCCAGCTCACCTTCCAGGGTGAACACTGAAGCTTTCTTT	CASSPSRVNTEAFF	TRBV18	TRBJ1-1
TGTGCCAGCTCACCAGATCGGTTGACCTCGGGGAACTTCCCGAACACTGAAGCTTTCTTT	CASSPDRLTSGNFPNTEAFF	TRBV18	TRBJ1-1
TGTGCCAGCAGCTTAACGTTTCCCCTAAAGAGCTCCTACGAGCAGTACTTC	CASSLTFPLKSSYEQYF	TRBV7-3	TRBJ2-7
TGTGCCAGCAGCCAAGGGACAGGGGGCCTCCACACTGAAGCTTTCTTT	CASSQGTGGLHTEAFF	TRBV3-1	TRBJ1-1
TGTGCCAGCAGCGTAGTGAGTCTTTCCATCGGGGCCCACAATGAGCAGTTCTTC	CASSVVSLSIGAHNEQFF	TRBV9	TRBJ2-1
TGTGCCAGCAGCTTCTATAGTCCCTCAGACAGGGGGCCGAATTCACCCCTCCACTTT	CASSFYSPSDRGPNSPLHF	TRBV6-5	TRBJ1-6
TGCATCCACCCGGGGGAATCCTACGAGCAGTACTTC	CIHPGESYEQYF	TRBV20-1	TRBJ2-7
TGCAGTGCTAGAAAGCCAGGGACAGGGGGAGGCTACACCTTC	CSARKPGTGGGYTF	TRBV20-1	TRBJ1-2
TGCAGTGCGCCCGGTATAACTTCGTTGTACTTC	CSAPGITSLYF	TRBV20-1	TRBJ2-7
TGTGCCAGCAGCCCTGAACTAGCGGGAGCTCTGGGGTTTGCGAGCGAGCAGTACTTC	CASSPELAGALGFASEQYF	TRBV14	TRBJ2-7
TGCAGCGAAAAACTAGCGGGAGAGACCTACGAGCAGTACTTC	CSEKLAGETYEQYF	TRBV29-1	TRBJ2-7
TGTGCCAGCATGGGACAGACCAGGTCCTACAATGAGCAGTTCTTC	CASMGQTRSYNEQFF	TRBV27	TRBJ2-1
TGTGCCAGCAGTTATTATGAGGGGGCCGGGAATGAGCAGTTCTTC	CASSYYEGAGNEQFF	TRBV6-2	TRBJ2-1
TGTGCCAGCAGCCCTCGGGACTATGGCTACACCTTC	CASSPRDYGYTF	TRBV13	TRBJ1-2
TGTGCCAGCAGTTGGTGGACTTGGCAGTTCTTC	CASSWWTWQFF	TRBV28	TRBJ2-1
TGTGCCAGCAGGGGGGGGGGCGACAATGAGCAGTTCTTC	CASRGGGDNEQFF	TRBV6-2	TRBJ2-1
TGCGCCAGCAGCCAAGATAGGGATCAAAATGACAGTCCTGGCTACACCTTC	CASSQDRDQNDSPGYTF	TRBV4-1	TRBJ1-2
TGTGCCAGCAGAAGCCGCCAGGTTAGAGGAACCTCTACTCCTGGGGATTATGGCTACACCTTC	CASRSRQVRGTSTPGDYGYTF	TRBV6-1	TRBJ1-2
TGTGCCAGTAGGGTGAAGCCCGAGACCCAGTACTTC	CASRVKPETQYF	TRBV19	TRBJ2-5
TGTGCCAGCTATCGGGGAGCCGATACGCAGTATTTT	CASYRGADTQYF	TRBV6-2	TRBJ2-3
TGTGCCAGCAGTTCTACTTCGGAGCGCTGGGCCTACAATGAGCAGTTCTTC	CASSSTSERWAYNEQFF	TRBV2	TRBJ2-1
TGCAGTGCTAATAGGGGTACGACCGGGGAGCTGTTTTTT	CSANRGTTGELFF	TRBV20-1	TRBJ2-2
TGTGCCACCAGCAGAGATGACCCCGGCCACACTGAAGCTTTCTTT	CATSRDDPGHTEAFF	TRBV15	TRBJ1-1
TGTGCCAGCAGCCCCAGTGGGGGTAGCACAGATACGCAGTATTTT	CASSPSGGSTDTQYF	TRBV2	TRBJ2-3
TGTGCCCAGGGGGCGAGCTCCTACGAGCAGTACTTC	CAQGASSYEQYF	TRBV30	TRBJ2-7
TGTGCCAGCAGCTTAGACGAACCGCGGGCCAATGAGCAGTTCTTC	CASSLDEPRANEQFF	TRBV11-2	TRBJ2-1
TGTAAATTACATGGTCGGAGATTAGGCGGGGAGCTGTTTTTT	CKLHGRRLGGELFF	TRBV10-3	TRBJ2-2
TGTGCCAGCAGCACGGAAACTCCATGCTGGTACTTC	CASSTETPCWYF	TRBV5-4	TRBJ1-2
TGTGCCAGCAGCTTTTCGAAGGGAAACACCATATATTTT	CASSFSKGNTIYF	TRBV11-3	TRBJ1-3
TGTGCCACCAGTGATAGGGGTCCCGACAGGGACAGGGGTGCTTTCTTT	CATSDRGPDRDRGAFF	TRBV24-1	TRBJ1-1
TGTGCCAGCAGCGTAGACGGGTTCTACAGGGGGTACACCGGGGAGCTGTTTTTT	CASSVDGFYRGYTGELFF	TRBV9	TRBJ2-2
TGTGCCAGCAGCTTAGTATTCCCGCTGGAAGCTGAGCAGTTCTTC	CASSLVFPLEAEQFF	TRBV7-9	TRBJ2-1
TGCGCCAGCAGGGGCCATAATGAGCAGTTCTTC	CASRGHNEQFF	TRBV5-1	TRBJ2-1
TGCAGTGCTAGAGGATTTGTTTCGGGACAGGTTACTGAAGCTTTCTTT	CSARGFVSGQVTEAFF	TRBV20-1	TRBJ1-1
TGTGCCATCCGGGGAGTTAGGACAGGGGGCAGTAATGAAAAACTGTTTTTT	CAIRGVRTGGSNEKLFF	TRBV10-3	TRBJ1-4
TGTGCCATCAGTGCTAAGGGAAAAAGTACTCTCAATCAGCCCCAGCATTTT	CAISAKGKSTLNQPQHF	TRBV10-3	TRBJ1-5
TGTGCCAGCAGCGGGCCCGTCAACACCGGGGAGCTGTTTTTT	CASSGPVNTGELFF	TRBV3-1	TRBJ2-2
TGCGCCAGCAGCCAGGGGGGGGGGAGGAGGCAGCCCCAGCATTTT	CASSQGGGRRQPQHF	TRBV4-1	TRBJ1-5
TGCAGTGCTAAAGAGCGGGAGTTAAGCACAGATACGCAGTATTTT	CSAKERELSTDTQYF	TRBV20-1	TRBJ2-3
TGTGCCACCAGTGATTTCTCTGGGACAGAAAACTATGGCTACACCTTC	CATSDFSGTENYGYTF	TRBV24-1	TRBJ1-2
TGTGCCAGCAGCCGGGACAGGAGGGGCTACACCTTC	CASSRDRRGYTF	TRBV14	TRBJ1-2
TGTGCCAGTAGTATGCTGGGACTAGTTGATGAGCAGTTCTTC	CASSMLGLVDEQFF	TRBV19	TRBJ2-1
TGTGCCACCAGCAGTTTGTTAGCGGGGCCCTACAATGAGCAGTTCTTC	CATSSLLAGPYNEQFF	TRBV15	TRBJ2-1
TGTGCCAGCAGCACCCTAGCGGGGCGCCTAGTTCAAAATGAGCAGTTCTTC	CASSTLAGRLVQNEQFF	TRBV5-5	TRBJ2-1
TGCGCCAGCAGCCAAGACTCGACAGTAGACACCGGGGAGCTGTTTTTT	CASSQDSTVDTGELFF	TRBV4-1	TRBJ2-2
TGTGCCAGCAGTGGTGCCCGGTGCAGAACTGAAGCTTTCTTT	CASSGARCRTEAFF	TRBV6-1	TRBJ1-1
TGCGCCAGCAGTGGGCTGGGACTAGCGGATGGCAATGAGCAGTTCTTC	CASSGLGLADGNEQFF	TRBV10-1	TRBJ2-1
TGTGCCAGCAGCTTCTCACAGGGCGACTGCGATAGCAATCAGCCCCAGCATTTT	CASSFSQGDCDSNQPQHF	TRBV7-9	TRBJ1-5
TGTGCCAGCAGTGAGGCAAGGACAGGGCAGCCCCAGCATTTT	CASSEARTGQPQHF	TRBV6-4	TRBJ1-5
TGTGCCAGCAGTTACAAGGGACAGGGATCAAACATTCAGTACTTC	CASSYKGQGSNIQYF	TRBV6-5	TRBJ2-4
TGTGCCAGCAGCACGGTGTGGGGGGAGCCATCACCCCTCCACTTT	CASSTVWGEPSPLHF	TRBV5-8	TRBJ1-6
TGTGCCAGCAGCCTCTCTACAGGAGACGAGCAGTACTTC	CASSLSTGDEQYF	TRBV3-1	TRBJ2-7
TGTATTCGGGACAGGAAGGCCGCTGAAGCTTTCTTT	CIRDRKAAEAFF	TRBV19	TRBJ1-1
TGTGCCAGCAGTAAAATTAACCTAGCCAAAAACATTCAGTACTTC	CASSKINLAKNIQYF	TRBV6-8	TRBJ2-4
TGTGCCAGCAGCGCGATATGCAGGGCTGAAGCTTTCTTT	CASSAICRAEAFF	TRBV9	TRBJ1-1
TGTGCCATCAGTGTCCAGACAGAACCAGCCTATGGCTACACCTTC	CAISVQTEPAYGYTF	TRBV10-3	TRBJ1-2
TGCAGTGCTGCAGGGGGCGCACACAATGAGCAGTTCTTC	CSAAGGAHNEQFF	TRBV20-1	TRBJ2-1
TGTGCCAGCAGCGGTAGCTACGGACTTCTTTCCTATGGCTACACCTTC	CASSGSYGLLSYGYTF	TRBV7-8	TRBJ1-2
TGTGCCAAAGGAAATGCTAGCAAGAACTACAATGAGCAGTTCTTC	CAKGNASKNYNEQFF	TRBV6-1	TRBJ2-1
TGTGCCAGCAGTCCCGGGGGGGCCCTCAATGAGCAGTTCTTC	CASSPGGALNEQFF	TRBV6-2	TRBJ2-1
TGCAGTGCTAGAGAGGGTATTTACAACTATGGCTACACCTTC	CSAREGIYNYGYTF	TRBV20-1	TRBJ1-2
TGTGCCAGCAGCCTAGCGGCTAAGGAGCAGTACTTC	CASSLAAKEQYF	TRBV11-2	TRBJ2-7
TGTGCCAGCAGTGGCGGCCGGGACAGGGACTGCACCGGGGAGCTGTTTTTT	CASSGGRDRDCTGELFF	TRBV27	TRBJ2-2
TGTGCCACTCGCGGCCAAGAGACCCAGTACTTC	CATRGQETQYF	TRBV27	TRBJ2-5
TGTGCCAGCAGCCTGCGGACAGCGCAACACAGGGGGCACGAGCAGTACTTC	CASSLRTAQHRGHEQYF	TRBV7-3	TRBJ2-7
TGTGCCAGCAGCAACCCTGGACGATCCGACAATCAGCCCCAGCATTTT	CASSNPGRSDNQPQHF	TRBV9	TRBJ1-5
TGTGCCTGGAACTCCCGTTCTCTAGCGGGCGAGCAGTTCTTC	CAWNSRSLAGEQFF	TRBV30	TRBJ2-1
TGTGCCAGCAGCCGCGCGGGGGGGCGAGTACCGGAGCTGTTTTTT	CASSRAGGRVPELFF	TRBV14	TRBJ2-2
TGCAGAGCCACTAGCGACTACTACGAGCAGTACTTC	CRATSDYYEQYF	TRBV20-1	TRBJ2-7
TGCGCCAGCAGCCACCCCTCGAGACGCAATCAGCCCCAGCATTTT	CASSHPSRRNQPQHF	TRBV4-1	TRBJ1-5
TGCGCCAGCAGCTTGGCTAGGCTTACAGGACAGGGGGCTAACTATGGCTACACCTTC	CASSLARLTGQGANYGYTF	TRBV5-1	TRBJ1-2
TGCAGTGCTAGAGAGGTGGGGGGATGCTACGAGCAGTACTTC	CSAREVGGCYEQYF	TRBV20-1	TRBJ2-7
TGTGCCAGCAGCGGCCGGTCACTAGCGGGAGGACCGAGCAATCAGCCCCAGCATTTT	CASSGRSLAGGPSNQPQHF	TRBV7-3	TRBJ1-5
TGCGCCAGCAGTGAGTCGAAATCGGGGCGGCCCGGACAGGGAGAAGGTAATGAAAAACTGTTTTTT	CASSESKSGRPGQGEGNEKLFF	TRBV10-1	TRBJ1-4
TGCGCCAGCAGCTTGAGTCCGGGACAGACCTACGAGCAGTACTTC	CASSLSPGQTYEQYF	TRBV5-1	TRBJ2-7
TGTGCCAGCAGTTGTCCCCCCCTCAGGTGGTGTCACTCCTACGAGCAGTACTTC	CASSCPPLRWCHSYEQYF	TRBV12-3	TRBJ2-7
TGTGCCAGCAGGACTCGAGGGGGGAACACTGAAGCTTTCTTT	CASRTRGGNTEAFF	TRBV6-6	TRBJ1-1
TGTGCCAGCAGCGGTTGGGGACAGGGCTACGAGCAGTACTTC	CASSGWGQGYEQYF	TRBV7-4	TRBJ2-7
TGTGCCAGCAGCTCGGGAAAGCATTTT	CASSSGKHF	TRBV7-3	TRBJ1-5
TGTGCCAGCAGCTTCAGGAAGGGGAATGGCTACACCTTC	CASSFRKGNGYTF	TRBV11-2	TRBJ1-2
TGTGCCAGCAGCACATTTACAGGGGGGGATGAAAAACTGTTTTTT	CASSTFTGGDEKLFF	TRBV9	TRBJ1-4
TGTGCCAGCAAATCAAGCCCATCAACAGGAAGGAAGGGAAACACCATATATTTT	CASKSSPSTGRKGNTIYF	TRBV27	TRBJ1-3
TGTGCCAGTAGTATTTTTGTTCCAGGTTTTCTGCCGGAAAAACTGTTTTTT	CASSIFVPGFLPEKLFF	TRBV19	TRBJ1-4
TGTGCCAGCAGCTTACCACAGCCGGGACAGGGGAGCACTGAAGCTTTCTTT	CASSLPQPGQGSTEAFF	TRBV11-2	TRBJ1-1
TGCAGTGCTAGTTCGATCTCCCAAGAGACCCAGTACTTC	CSASSISQETQYF	TRBV20-1	TRBJ2-5
TGTGCCAGCAGCCGTCAAAGGTCGCGCTCAGCCAAAAACATTCAGTACTTC	CASSRQRSRSAKNIQYF	TRBV7-9	TRBJ2-4
TGTGCCAGCAGCCAGCCCGACACAGCAGAGCAGTACTTC	CASSQPDTAEQYF	TRBV14	TRBJ2-7
TGTGCCAGCAGCGTAGTCAGGGAGACCCAGTACTTC	CASSVVRETQYF	TRBV9	TRBJ2-5
TGTGCCAGCAGCGACATAGTCCGCTATGGCTACACCTTC	CASSDIVRYGYTF	TRBV7-4	TRBJ1-2
TGTGCCAGCAGTTTGGTTAACTTCGAGCAGTACTTC	CASSLVNFEQYF	TRBV27	TRBJ2-7
TGTGCCAGCAGCGCCGGACTAGCGGGGGCCTACGAGCAGTACTTC	CASSAGLAGAYEQYF	TRBV7-3	TRBJ2-7
TGCAGTGCCGATAAGAACACCGGGGAGCTGTTTTTT	CSADKNTGELFF	TRBV20-1	TRBJ2-2
TGTGCCAGCGCCTCGCTGGCAATTTCACCCCTCCACTTT	CASASLAISPLHF	TRBV28	TRBJ1-6
TGTGCCAGCAGTTACGCGGGATCAAGGGTTCTGTTTTTT	CASSYAGSRVLFF	TRBV6-5	TRBJ1-4
TGCAGTGCCTCCCGGGAAGAGACCCAGTACTTC	CSASREETQYF	TRBV20-1	TRBJ2-5
TGTGCCAGCAGCCAAGTGGGGGGAGAATCCAATGGCTACACCTTC	CASSQVGGESNGYTF	TRBV14	TRBJ1-2
TGCGCCAGCAGGGCCAGGGACAGCTCCTACGAGCAGTACTTC	CASRARDSSYEQYF	TRBV10-1	TRBJ2-7
TGCGCCAGCAGCTTGGGGGTTTCTAAACGTACCACCAATGAGCAGTTCTTC	CASSLGVSKRTTNEQFF	TRBV5-1	TRBJ2-1
TGTGCCAGCAGCGTACGGGGAGAGGACTACGAGCAGTACTTC	CASSVRGEDYEQYF	TRBV7-3	TRBJ2-7
TGCGCCATCCGGGCCCCTATTTACTACGAGCAGTACTTC	CAIRAPIYYEQYF	TRBV10-1	TRBJ2-7
TGTGCCAGCAGCACCGGGACCAGCACAGATACGCAGTATTTT	CASSTGTSTDTQYF	TRBV7-7	TRBJ2-3
TGTGCCAGCAGGAATCTAGCGGGATGGAACGCGTGCATCGATACGCAGTTCTTC	CASRNLAGWNACIDTQFF	TRBV6-5	TRBJ2-1
TGTGCCTGGGGTAGAGACGAGCAGTACTTC	CAWGRDEQYF	TRBV30	TRBJ2-7
TGTGCCAGTAGTAAGCCGGGGGGGTACCACACCGGGGAGCTGTTTTTT	CASSKPGGYHTGELFF	TRBV19	TRBJ2-2
TGTGCCAGCAGCTGCGACAGGGGGTACTTC	CASSCDRGYF	TRBV7-6	TRBJ2-7
TGTGCCACCAGCAGGGACAGGGGCTGGCAAGAGACCCAGTACTTC	CATSRDRGWQETQYF	TRBV15	TRBJ2-5
TGTGCCAGCAGCGTAGCTAGACAGGGGGCCACCTACGAGCAGTACTTC	CASSVARQGATYEQYF	TRBV9	TRBJ2-7
TGTGCCAGCAGCGAAGGTCCTGACAGGGGAGAAGCAACTAATGAAAAACTGTTTTTT	CASSEGPDRGEATNEKLFF	TRBV7-3	TRBJ1-4
TGTGCCAGCAGCCAAGACCGTCCGGGACTAGCGGGGGGGGCCAACGTCCTGACTTTC	CASSQDRPGLAGGANVLTF	TRBV14	TRBJ2-6
TGTGCCAGCAGCCGGGAATATGGCTACACCTTC	CASSREYGYTF	TRBV5-4	TRBJ1-2
TGTGCTAGTGGTTTGGTATGCCCAGGGTGGTTCGTCCCTGAAGCTTTCTTT	CASGLVCPGWFVPEAFF	TRBV12-5	TRBJ1-1
TGTGCCAGCAGCTTAGGGTCTGTGCCCCTTGGGGGCTTCGAGACCCAGTACTTC	CASSLGSVPLGGFETQYF	TRBV7-9	TRBJ2-5
TGTGCCAGCAGTGAAGGCCAACCGCGTGTTCCTGGCGAGCAGTACTTC	CASSEGQPRVPGEQYF	TRBV6-1	TRBJ2-7
TGCGCCAGCAGCTGTTGGGGGAGGATCGCGAACACCGGGGAGCTGTTTTTT	CASSCWGRIANTGELFF	TRBV5-1	TRBJ2-2
TGTGCCAGCCCCCACAGGGGGAGTCAGCCCCAGCATTTT	CASPHRGSQPQHF	TRBV11-3	TRBJ1-5
TGTGCCAGCAAAGAGACTAGCGGGGGGGCCCTCGAGCAGTACTTC	CASKETSGGALEQYF	TRBV2	TRBJ2-7
TGCGCCACACCCTCGAGCGGAAACAATGAGCAGTTCTTC	CATPSSGNNEQFF	TRBV4-1	TRBJ2-1
TGTGCCACCAGCAGAGCCCGGGGAGCCAAAAACATTCAGTACTTC	CATSRARGAKNIQYF	TRBV15	TRBJ2-4
TGTGCCAGTAGTAGTCTAGCGGGGGAACCCTACAATGAGCAGTTCTTC	CASSSLAGEPYNEQFF	TRBV19	TRBJ2-1
TGTGCCAGCAGCTTATCACAGGACACGGGCTATGGCTACACCTTC	CASSLSQDTGYGYTF	TRBV5-6	TRBJ1-2
TGTGCCAGCAGCAGACAGCATGACTACGAGCAGTACTTC	CASSRQHDYEQYF	TRBV12-3	TRBJ2-7
TGCAGTGCTATGGGCGAGGGGTACGAGCAGTACTTC	CSAMGEGYEQYF	TRBV20-1	TRBJ2-7
TGTGCCACCACAGGGGGGACTAGCGTATACTACAATGAGCAGTTCTTC	CATTGGTSVYYNEQFF	TRBV24-1	TRBJ2-1
TGTGCCAGCAGTGATGGTTCGTCAGGGTGCTCCTACAATGAGCAGTTCTTC	CASSDGSSGCSYNEQFF	TRBV6-1	TRBJ2-1
TGTGCCAGCAGCTTATTAAAACCGGGACTGAACACTGAAGCTTTCTTT	CASSLLKPGLNTEAFF	TRBV7-3	TRBJ1-1
TGTGCCAGCAGTTTCGACAGAGGGCTCAATGAGCAGTTCTTC	CASSFDRGLNEQFF	TRBV12-4	TRBJ2-1
TGCGCCAGCAGTGAATGGCAGGGCGAAGCTTTCTTT	CASSEWQGEAFF	TRBV10-1	TRBJ1-1
TGTGCCAGCAGCTTACTGGCCCTCCTCCTAGATAAGAGCAGACACACTGAAGCTTTCTTT	CASSLLALLLDKSRHTEAFF	TRBV7-3	TRBJ1-1
TGCAGTGCTTACAGCCTAGGTAACAAAAAGGGGGGGGCAACTAATGAAAAACTGTTTTTT	CSAYSLGNKKGGATNEKLFF	TRBV20-1	TRBJ1-4
TGTGCCAGCAGGGACCGGGACAGGGACTATGGCTACACCTTC	CASRDRDRDYGYTF	TRBV2	TRBJ1-2
TGTGCCAGCAGCCATAAGTCTCCCGGGGAGCTGTTTTTT	CASSHKSPGELFF	TRBV14	TRBJ2-2
TGTGCCAGTAGTATCCCCGGGGGGCAGCAGTTCTTC	CASSIPGGQQFF	TRBV19	TRBJ2-1
TGTGCCAGCAGTTTTCGACAGGGTCCATACGAGCAGTACTTC	CASSFRQGPYEQYF	TRBV12-3	TRBJ2-7
TGCGCCAGCAGCCAAGATGCGTACTCTAGAGCTGGAAACACCATATATTTT	CASSQDAYSRAGNTIYF	TRBV4-1	TRBJ1-3
TGTGCACGGGGGAGCTACACCTTC	CARGSYTF	TRBV6-4	TRBJ1-2
TGTGCCAGCAGTTTAGACGGCGGGAAAAGTTACTACGAGCAGTACTTC	CASSLDGGKSYYEQYF	TRBV27	TRBJ2-7
TGTGCCAGCAGCCTAACGCGGGGGGACTCCTATAATTCACCCCTCCACTTT	CASSLTRGDSYNSPLHF	TRBV9	TRBJ1-6
TGTGCCAGCAGAGGGGTCGTCTATTTT	CASRGVVYF	TRBV12-3	TRBJ2-3
TGTGCCAGCAGTTTGGGCGGACAGAACTCCTACAATGAGCAGTTCTTC	CASSLGGQNSYNEQFF	TRBV27	TRBJ2-1
TGTGCCAGCAGCGCGGGGGTGAAGAGGGGGTGGGAGACCCAGTACTTC	CASSAGVKRGWETQYF	TRBV9	TRBJ2-5
TGTGCCAGCAGCCGGAAGGGACAGGGATACGAGCAGTACTTC	CASSRKGQGYEQYF	TRBV9	TRBJ2-7
TGCGCCAGCAGAAACCAAGGGTACTTTACGCAGTATTTT	CASRNQGYFTQYF	TRBV5-1	TRBJ2-3
TGCGCCAGCAGCTTGCCGTGGACTAGCCGCTACGAGCAGTACTTC	CASSLPWTSRYEQYF	TRBV5-1	TRBJ2-7
TGTGCCAGCAGCCTGAGGGGGCGGGGGCTGAACACTGAAGCTTTCTTT	CASSLRGRGLNTEAFF	TRBV14	TRBJ1-1
TGCAGTGACCCAGGGTTGATTCCCTCCTACGAGCAGTACTTC	CSDPGLIPSYEQYF	TRBV20-1	TRBJ2-7
TGTGGATTAGACAGGGGCCCCAGCTCCTACAATGAGCAGTTCTTC	CGLDRGPSSYNEQFF	TRBV7-9	TRBJ2-1
TGTGCCTGGAGTGTACGCAAAAACATTCAGTACTTC	CAWSVRKNIQYF	TRBV30	TRBJ2-4
TGTGCCAGCAGCACCGGGACTATCTATAATTCACCCCTCCACTTT	CASSTGTIYNSPLHF	TRBV3-1	TRBJ1-6
TGTGCCAGCAGTATCCCTGCAGGGCCCAATCAGCCCCAGCATTTT	CASSIPAGPNQPQHF	TRBV3-1	TRBJ1-5
TGCGCCAGCAGCTTGGAGCCACAGGGGTTCAATGAAAAACTGTTTTTT	CASSLEPQGFNEKLFF	TRBV5-1	TRBJ1-4
TGCAGTGCTAGCCCGTTGCCCAGGAACCTAACGATGTGGAACACCGGGGAGCTGTTTTTT	CSASPLPRNLTMWNTGELFF	TRBV20-1	TRBJ2-2
TGCGCCAGCAGGGCGTTCCTTCCAGGATGGAGCAGCACAGATACGCAGTATTTT	CASRAFLPGWSSTDTQYF	TRBV10-1	TRBJ2-3
TGTGCCAGCAGTGAACGCCAGGGGGGATGCTATGGCTACACCTTC	CASSERQGGCYGYTF	TRBV6-4	TRBJ1-2
TGTGCCAGCAGCTGGCGACTAGCGGGAAGGGCGTTGTACGAGCAGTACTTC	CASSWRLAGRALYEQYF	TRBV5-6	TRBJ2-7
TGTGCCAGCAGCTTACTGAGGACAGGGTTTCATCAGCCCCAGCATTTT	CASSLLRTGFHQPQHF	TRBV7-2	TRBJ1-5
TGTGCCAGCAGTGGGGAAGGAGGGGGAATTCCCTCCAATCAGCCCCAGCATTTT	CASSGEGGGIPSNQPQHF	TRBV27	TRBJ1-5
TGCGCCAGCAGCTTGTCCAGAGGGACTGAAGCTTTCTTT	CASSLSRGTEAFF	TRBV5-1	TRBJ1-1
TGTGCCAGCAGCTTGTGTGGGCGGGTCAGTTTTTACGAGCAGTACTTC	CASSLCGRVSFYEQYF	TRBV5-4	TRBJ2-7
TGTGCCAGCAGCTTACCCACTAGCGTCGATGAGCAGTTCTTC	CASSLPTSVDEQFF	TRBV7-3	TRBJ2-1
TGTGCCACCAAGGGAAAATGGCTGGGGGGCTACGAGCAGTACTTC	CATKGKWLGGYEQYF	TRBV24-1	TRBJ2-7
TGTGCCAGCAGCCTTACTAGCGGGAGGAACAAAAACATTCAGTACTTC	CASSLTSGRNKNIQYF	TRBV6-5	TRBJ2-4
TGTGCCAGCAGCAAGGTGACAGGGGTCGTGGGAACCAATCAGCCCCAGCATTTT	CASSKVTGVVGTNQPQHF	TRBV11-2	TRBJ1-5
TGTGCCAGCAGCGATAGGCGTTCACCCCTCCACTTT	CASSDRRSPLHF	TRBV7-3	TRBJ1-6
TGTGCCAGCAGCTTACGACGGTTGCGCGCCAAAAACATTCAGTACTTC	CASSLRRLRAKNIQYF	TRBV7-3	TRBJ2-4
TGCGCCAGCAGCCCCTGGGAAAGACCTATCTCCGGGACGGATGAGCAGTTCTTC	CASSPWERPISGTDEQFF	TRBV5-1	TRBJ2-1
TGTGCCAGTAGTAAAGCGGGACGCGGGGAGCTGTTTTTT	CASSKAGRGELFF	TRBV19	TRBJ2-2
TGTGCCAGCAGCGTAAATTGGCTAGGGAACTACGCCTACAATGAGCAGTTCTTC	CASSVNWLGNYAYNEQFF	TRBV7-9	TRBJ2-1
TGTGCCAGCAGTAACAGGGAACAATATCAGCCCCAGCATTTT	CASSNREQYQPQHF	TRBV6-6	TRBJ1-5
TGTGCCAGCAGTGAGCCATGGGGCTACGAGCAGTACTTC	CASSEPWGYEQYF	TRBV6-4	TRBJ2-7
TGTGCCAGGACACTAGCGGGTAGCTACGAGCAGTACTTC	CARTLAGSYEQYF	TRBV6-4	TRBJ2-7
TGCGCCAGCAGCTTCGGGGGGTACCAAGAGACCCAGTACTTC	CASSFGGYQETQYF	TRBV5-1	TRBJ2-5
TGTGCCAGCGGTACAGACAGGCAGGACCACGAGCAGTACTTC	CASGTDRQDHEQYF	TRBV27	TRBJ2-7
TGTGCCAGCAGCTTAGCCGGGACAGGCGGGAACACCGGGGAGCTGTTTTTT	CASSLAGTGGNTGELFF	TRBV7-4	TRBJ2-2
TGTGCCAGCAGCTTAGTAAATACGGGGGCTGTACCCGGGGCCAACGTCCTGACTTTC	CASSLVNTGAVPGANVLTF	TRBV9	TRBJ2-6
TGCAGTGCTGCTGGGCAAGCTGGGGCCAACGTCCTGACTTTC	CSAAGQAGANVLTF	TRBV20-1	TRBJ2-6
TGTGCCAGCAGCTTGGTAGCGGGCCCGTCCGGGGAGCTGTTTTTT	CASSLVAGPSGELFF	TRBV5-5	TRBJ2-2
TGTGCCAGCAGCTGTACCACAGGGTGGGTCCCTGAAGCTTTCTTT	CASSCTTGWVPEAFF	TRBV11-3	TRBJ1-1
TGTGCCAGCATAGTGGGCAGGGTTCAGCCCCAGCATTTT	CASIVGRVQPQHF	TRBV27	TRBJ1-5
TGCGCCAGCAGCTTGGCCCGCCGAGATGACAGGGTTGTCCCTGTCAATGAGCAGTTCTTC	CASSLARRDDRVVPVNEQFF	TRBV5-1	TRBJ2-1
TGTGCCAGCAGTTACTCAACCCATGGACAGGTAGGGAACACTGAAGCTTTCTTT	CASSYSTHGQVGNTEAFF	TRBV6-3	TRBJ1-1
TGTGCCAGCAGCCAAGATGCCAAATCACTAGCGGGAGAAGCTGGCTACACCTTC	CASSQDAKSLAGEAGYTF	TRBV3-1	TRBJ1-2
TGCAGTGCTAACCTCGTTTCCCGACAGAGCACAGATACGCAGTATTTT	CSANLVSRQSTDTQYF	TRBV20-1	TRBJ2-3
TGCGCCAGCAGCACCCCACAGGGGCACACTGAAGCTTTCTTT	CASSTPQGHTEAFF	TRBV5-1	TRBJ1-1
TGTGCCAGCAGCTTACAGCAGGGCTACGAGCAGTACTTC	CASSLQQGYEQYF	TRBV7-2	TRBJ2-7
TGTGCCATCAAAATCAGGGTTGGGAGTGAGACCCAGTACTTC	CAIKIRVGSETQYF	TRBV10-3	TRBJ2-5
TGTGCCAGCACTTGGACAGGGCGGCAACTGTTTTTT	CASTWTGRQLFF	TRBV19	TRBJ1-4
TGTGCCAGCGGAACCACTGGGGGGCGCTCCTACGAGCAGTACTTC	CASGTTGGRSYEQYF	TRBV2	TRBJ2-7
TGTGCCACCAGTGAAACCTGTGCCCGGACAGGGAGGGATCTCACTAGCAATCAGCCCCAGCATTTT	CATSETCARTGRDLTSNQPQHF	TRBV24-1	TRBJ1-5
TGTGCCAGAGGTAGCAGGGGACTTGCAGATACGCAGTATTTT	CARGSRGLADTQYF	TRBV27	TRBJ2-3
TGTGCCAGCAGCTTAGCGACCCCCAGCAGGGGGGCCAGCGAGCAGTACTTC	CASSLATPSRGASEQYF	TRBV7-9	TRBJ2-7
TGTGCCAGCAGTTTAGACGCCCTTGGCCATCAGCCCCAGCATTTT	CASSLDALGHQPQHF	TRBV7-8	TRBJ1-5
TGTGCTAGTGGTTTGCAGGGGTCCTACAATGAGCAGTTCTTC	CASGLQGSYNEQFF	TRBV12-5	TRBJ2-1
TGTGCCAGTAGTTACGTAGCAGATCAGTATTTT	CASSYVADQYF	TRBV19	TRBJ2-3
TGTGCCATCAGTGAGGGAGGACTAGCGATTTGCAATGAGCAGTTCTTC	CAISEGGLAICNEQFF	TRBV10-3	TRBJ2-1
TGTGCCAGCAGCCGTAGGGACAGGGATAAAACTGAAGCTTTCTTT	CASSRRDRDKTEAFF	TRBV14	TRBJ1-1
TGTGCCAGCAAGGATACGTCACTTAGGGGGCGGGAAAGAAACACCATATATTTT	CASKDTSLRGRERNTIYF	TRBV6-5	TRBJ1-3
TGTGCCAGCAGTGACTCAGGGAGCCCGGGACCATACAATGAGCAGTTCTTC	CASSDSGSPGPYNEQFF	TRBV6-4	TRBJ2-1
TGTGCCACCAGTGAAAGGACTAGCGGGGGGGCCAACGTCCTGACTTTC	CATSERTSGGANVLTF	TRBV24-1	TRBJ2-6
TGTGCCAGCAGTACAATTGGACACCGGGGGGTGACCTACGAGCAGTACTTC	CASSTIGHRGVTYEQYF	TRBV28	TRBJ2-7
TGTGCCAGCAGAGGCCGGGACAGGGGGCCGGGTGGCTACACCTTC	CASRGRDRGPGGYTF	TRBV7-9	TRBJ1-2
TGTGCCACCAGTGAAAGTGAGGACGTGAACACTGAAGCTTTCTTT	CATSESEDVNTEAFF	TRBV24-1	TRBJ1-1
TGTGCCAGCAAAGACAGATCTAGCAATCAGCCCCAGCATTTT	CASKDRSSNQPQHF	TRBV28	TRBJ1-5
TGTGCCAGCAGTTTAGACTACACAGATACGCAGTATTTT	CASSLDYTDTQYF	TRBV12-3	TRBJ2-3
TGTGCCAGCAGCTGGGGGCAGACGTCCTACAATGAGCAGTTCTTC	CASSWGQTSYNEQFF	TRBV7-2	TRBJ2-1
TGTGCCAGCAGCCAAATGGATCAAGGAAATCAGCCCCAGCATTTT	CASSQMDQGNQPQHF	TRBV3-1	TRBJ1-5
TGTGCCACCGGACTAGCGGACTACGAGCAGTACTTC	CATGLADYEQYF	TRBV6-6	TRBJ2-7
TGTGCCAGCAGCTTCGAGGGACTAGCGGATACGCAGTATTTT	CASSFEGLADTQYF	TRBV9	TRBJ2-3
TGTGCCAGACGGCGGGAGGACGAAGTGACAGATACGCAGTATTTT	CARRREDEVTDTQYF	TRBV28	TRBJ2-3
TGTGCCAGCAGCTTGCCCAGGGGCCATAATGAAAAACTGTTTTTT	CASSLPRGHNEKLFF	TRBV5-5	TRBJ1-4
TGTGCCAGCAGTTTATGTAGGAGGAGAGAGACCCAGTACTTC	CASSLCRRRETQYF	TRBV27	TRBJ2-5
TGCGCCAGCAACTGCCGACAGGCCTTGGGCACAGATACGCAGTATTTT	CASNCRQALGTDTQYF	TRBV10-1	TRBJ2-3
TGTGCCAGCAGTTTAGGTACCCCCAACCGGGACAGGGGAATAGGGGTCACCGGGGAGCTGTTTTTT	CASSLGTPNRDRGIGVTGELFF	TRBV12-4	TRBJ2-2
TGTGCCAGCAGTTACCTTAGGTCGGGGGGCGATTACACCGGGGAGCTGTTTTTT	CASSYLRSGGDYTGELFF	TRBV6-2	TRBJ2-2
TGTGCCAGCAGGGAAACTGCGGAGGGGTTAAACATTCAGTACTTC	CASRETAEGLNIQYF	TRBV28	TRBJ2-4
TGTGCCAGACTCAGGACAGGGGAGAGTTTAGCTTTCTTT	CARLRTGESLAFF	TRBV7-2	TRBJ1-1
TGCGCCAGCAGCTTGGGACGGAATGAAAAACTGTTTTTT	CASSLGRNEKLFF	TRBV5-1	TRBJ1-4
TGTGCCATCAGTGCGGGGAGACAGCTCGTAAACACTGAAGCTTTCTTT	CAISAGRQLVNTEAFF	TRBV10-3	TRBJ1-1
TGTGCCAGCAGCGTAGCAGCTCGAATAACCGCTGAAGCTTTCTTT	CASSVAARITAEAFF	TRBV9	TRBJ1-1
TGCAGCGTTGAAGATCCGAAAAGCGGACAGGATTACACCGGGGAGCTGTTTTTT	CSVEDPKSGQDYTGELFF	TRBV29-1	TRBJ2-2
TGTGCCAGTAGTCCGTTAGAAGGACAGCAAGAGACCCAGTACTTC	CASSPLEGQQETQYF	TRBV19	TRBJ2-5
TGTGCCAGCAGGGTTCCGCCTGAAGCTTTCTTT	CASRVPPEAFF	TRBV7-3	TRBJ1-1
TGCAGTGCTAGAGACCAGGGACAGGGGGGGGGTACTGAGCAGTTCTTC	CSARDQGQGGGTEQFF	TRBV20-1	TRBJ2-1
TGTGCCAGCAGCAAAATAGGACAGACGTACGAGCAGTACTTC	CASSKIGQTYEQYF	TRBV7-9	TRBJ2-7
TGTGCCAGCAGCGTACAATTGACTAGCGGGCAAGAGACCCAGTACTTC	CASSVQLTSGQETQYF	TRBV9	TRBJ2-5
TGTGCCAGAGCAGGGGGCCGACACTGGAACACTGAAGCTTTCTTT	CARAGGRHWNTEAFF	TRBV27	TRBJ1-1
TGTGCCAGCACTCTCAGGGGGCGAGGGAATGAGCAGTTCTTC	CASTLRGRGNEQFF	TRBV6-4	TRBJ2-1
TGTGCCAGCAGCCGGTATAAGACCGGGGAGCTGTTTTTT	CASSRYKTGELFF	TRBV7-8	TRBJ2-2
TGTGCCAGCAGCTTGGGACTAGCGGGTTTGGGGCATGAGCAGTTCTTC	CASSLGLAGLGHEQFF	TRBV13	TRBJ2-1
TGTGCCAGCAAGAGCCGGGCGGCAAGCGCAGATACGCAGTATTTT	CASKSRAASADTQYF	TRBV27	TRBJ2-3
TGTGCCATGGACAGTGTAACCGGGGAGCTGTTTTTT	CAMDSVTGELFF	TRBV28	TRBJ2-2
TGTGCCAGCAGTTACTCGACGGGGGCGGATACGCAGTATTTT	CASSYSTGADTQYF	TRBV6-5	TRBJ2-3
TGCGCCAGCACCCTGAGTCTACACCTTAATGAAAAACTGTTTTTT	CASTLSLHLNEKLFF	TRBV10-1	TRBJ1-4
TGTGCCAGCAGTGCGGGAAAGAGCTCCTACAATGAGCAGTTCTTC	CASSAGKSSYNEQFF	TRBV6-4	TRBJ2-1
TGTGCCAGCAGTTACCTTAACCCCGGGGGGCTTTATGGAAACACCATATATTTT	CASSYLNPGGLYGNTIYF	TRBV6-5	TRBJ1-3
TGCAGTGCTAATCAGGGGGGGGAATGCTCCTACGAGCAGTACTTC	CSANQGGECSYEQYF	TRBV20-1	TRBJ2-7
TGTGCCAGCAGTTACGCCCGGGACAGGCATGGCTACACCTTC	CASSYARDRHGYTF	TRBV6-6	TRBJ1-2
TGTGCCAGCAGTGACTCGGACAGCACTGAAGCTTTCTTT	CASSDSDSTEAFF	TRBV6-4	TRBJ1-1
TGCGCCAGCAGCCCGGGAGGGCCGCTGTACAATGAGCAGTTCTTC	CASSPGGPLYNEQFF	TRBV5-1	TRBJ2-1
TGTGCCAGCAGTTGGCCGGAGCGCACAGATACGCAGTATTTT	CASSWPERTDTQYF	TRBV12-4	TRBJ2-3
TGTGCCAGCTCACCAGACTCACCTGGTAGCGGGCTATACGAGCAGTACTTC	CASSPDSPGSGLYEQYF	TRBV18	TRBJ2-7
TGTGCCAGCAGCTTACTCCCGGGGGGCTTGGAAGGGAGCTACAATGAGCAGTTCTTC	CASSLLPGGLEGSYNEQFF	TRBV7-9	TRBJ2-1
TGCAGTGCCCTCGACAGGGTTTGCTACGAGCAGTACTTC	CSALDRVCYEQYF	TRBV20-1	TRBJ2-7
TGTGCCAGCAGACCTGGTGGGGGGGGTTGGTACCAAGAGACCCAGTACTTC	CASRPGGGGWYQETQYF	TRBV6-4	TRBJ2-5
TGTGCCAGCCCCCGAGTGGGACAGGTAGCCTACGAGCAGTACTTC	CASPRVGQVAYEQYF	TRBV6-1	TRBJ2-7
TGTGCCAGCAGCGTAAGGACAGGGCCATCCTACGAGCAGTACTTC	CASSVRTGPSYEQYF	TRBV3-1	TRBJ2-7
TGTGCCACCAGTCGTGTGGGACAGGGCTATAATTCACCCCTCCACTTT	CATSRVGQGYNSPLHF	TRBV24-1	TRBJ1-6
TGTGCCAGCAGTGATGGACTAGGGGGCTACAATGAGCAGTTCTTC	CASSDGLGGYNEQFF	TRBV6-4	TRBJ2-1
TGTGCCACCAGTGAAACCGCAGGGGACAGCAAGGGAAACACCATATATTTT	CATSETAGDSKGNTIYF	TRBV24-1	TRBJ1-3
TGTGCCAGCAGTTACGGGGGCCCAAACATTCAGTACTTC	CASSYGGPNIQYF	TRBV6-5	TRBJ2-4
TGTGCCAGCGGGAGGGACGAGCAGTACTTC	CASGRDEQYF	TRBV11-3	TRBJ2-7
TGTGCCAGCCAACATGGAAGTGCCGAGCAGTACTTC	CASQHGSAEQYF	TRBV7-6	TRBJ2-7
TGTGCCAGCAGTTTAACCCACGGGTTAGCCGCCTACGAGCAGTACTTC	CASSLTHGLAAYEQYF	TRBV12-4	TRBJ2-7
TGTGCCACCAGTGATTTGCCGCCTCCGGGACTAGAGTGCTACAATGAGCAGTTCTTC	CATSDLPPPGLECYNEQFF	TRBV24-1	TRBJ2-1
TGTGCCAGCAGTGGCGCGGGGAACGGTCAGCCCCAGCATTTT	CASSGAGNGQPQHF	TRBV27	TRBJ1-5
TGTGCCAGCAGAAAATTTCGGGACAGGGTCGGGGATACCTTC	CASRKFRDRVGDTF	TRBV16	TRBJ1-2
TGCAGTGGGGGATTAGTGAGCAATCAGCCCCAGCATTTT	CSGGLVSNQPQHF	TRBV20-1	TRBJ1-5
TGCGCCAGCGGCAGGAGGGGAGATGAAGCTTTCTTT	CASGRRGDEAFF	TRBV5-1	TRBJ1-1
TGTGCCAGCAGATTACTAGCGGGAGGGGTTAATTCACCCCTCCACTTT	CASRLLAGGVNSPLHF	TRBV27	TRBJ1-6
TGTGCCAGCAGCCAAGATGGACAGGGAAGAGCCAAAAACATTCAGTACTTC	CASSQDGQGRAKNIQYF	TRBV14	TRBJ2-4
TGTGCCAGCAGTCGGACAGCAGTAGAACAGAGGAGGGCTAGGGAGACCCAGTACTTC	CASSRTAVEQRRARETQYF	TRBV6-4	TRBJ2-5
TGTGCCAGCAGCAGAAGCGGGAGGAACGAGCAGTACTTC	CASSRSGRNEQYF	TRBV9	TRBJ2-7
TGCAGCGTTGTAGGACCCGTACAAGATACGCAGTATTTT	CSVVGPVQDTQYF	TRBV29-1	TRBJ2-3
TGCAGTGCTAGAGTTCTAGCAGGGGGCGGCCGCCAGCCCCAGCATTTT	CSARVLAGGGRQPQHF	TRBV20-1	TRBJ1-5
TGTGCCACCAGCAGAGATATGGTCGGGCGTTCAACTAATGAAAAACTGTTTTTT	CATSRDMVGRSTNEKLFF	TRBV15	TRBJ1-4
TGTGCCAGCAGCCATTTGGGCGGCACCGGGGAGCTGTTTTTT	CASSHLGGTGELFF	TRBV14	TRBJ2-2
TGCGCCAGCAGCTTGGCTGCGGTCACCCAGACAGGGGGCACCGGGGAGCTGTTTTTT	CASSLAAVTQTGGTGELFF	TRBV5-1	TRBJ2-2
TGCAGCGTTGTTGACAGGGGGCACCTTAGCTCTGGAAACACCATATATTTT	CSVVDRGHLSSGNTIYF	TRBV29-1	TRBJ1-3
TGTGCCAGCTTACCTCGACAGACCAATCAGCCCCAGCATTTT	CASLPRQTNQPQHF	TRBV6-2	TRBJ1-5
TGTGCCACCAGTGCCAGGCCCCAGCATTTT	CATSARPQHF	TRBV24-1	TRBJ1-5
TGTGCCAGCAGCGTAGCGGTAGTAGGAGGGGGTATGAACACTGAAGCTTTCTTT	CASSVAVVGGGMNTEAFF	TRBV9	TRBJ1-1
TGCAGTGCTCGCATCACAGGGGGGATTAGGTATGAGCAGTTCTTC	CSARITGGIRYEQFF	TRBV20-1	TRBJ2-1
TGTGCCAGCTCACCCCGTGGGGGCCACGAGCAGTACTTC	CASSPRGGHEQYF	TRBV18	TRBJ2-7
TGTGCCAGCAGCCCCCGAAAAGGGGGGGGCGGTTACGAGCAGTACTTC	CASSPRKGGGGYEQYF	TRBV7-3	TRBJ2-7
TGTGCCAGCAGCTTAAGGGGGACAGGGGTGAAAGAGACCCAGTACTTC	CASSLRGTGVKETQYF	TRBV7-9	TRBJ2-5
TGTGCCAGCAGCTTGTTTAGCGGGCCTTACAATGAGCAGTTCTTC	CASSLFSGPYNEQFF	TRBV5-4	TRBJ2-1
TGTGCCAGCATCGACAGGGGATTTACTGAAGCTTTCTTT	CASIDRGFTEAFF	TRBV27	TRBJ1-1
TGTGCCAGCAGCTTAGACGGCGAAGGGAACACCGGGGAGCTGTTTTTT	CASSLDGEGNTGELFF	TRBV7-9	TRBJ2-2
TGCGCCAGCAGCTATAGGCGACTATCCCCTAACTATGGCTACACCTTC	CASSYRRLSPNYGYTF	TRBV5-1	TRBJ1-2
TGTGCCAGCAGTTTCGGGCCGGGACAGGGGGGTTCCACTGAAGCTTTCTTT	CASSFGPGQGGSTEAFF	TRBV27	TRBJ1-1
TGTGCCACCAGCGCCTCCGGGACAAGTCAGCCCCAGCATTTT	CATSASGTSQPQHF	TRBV15	TRBJ1-5
TGTGCCAGCAGTGAGAAGGGACTAGCGGGGGGGCATTTAAACACAGATACGCAGTATTTT	CASSEKGLAGGHLNTDTQYF	TRBV2	TRBJ2-3
TGTGCCACCAGACACAACGAGCAGTACTTC	CATRHNEQYF	TRBV24-1	TRBJ2-7
TGCGCCAGCAGCCAGGCGCTTTACGAGCAGTACTTC	CASSQALYEQYF	TRBV4-3	TRBJ2-7
TGTGCCAGCAGCGTAGGAGGAAAACGGGGGGTTAGCTCTGGGGCCAACGTCCTGACTTTC	CASSVGGKRGVSSGANVLTF	TRBV9	TRBJ2-6
TGTGCCAGCCCTCTGGGCCAGGGAGAGCGTACCGCAGATACGCAGTATTTT	CASPLGQGERTADTQYF	TRBV27	TRBJ2-3
TGTGCCAGCAGTGGACTCTTCCGGGGGGGAAACGAGCAGTACTTC	CASSGLFRGGNEQYF	TRBV6-5	TRBJ2-7
TGTGCCATCAGAAAAACCGGGACAGAGTGGTTCTCCTACGAGCAGTACTTC	CAIRKTGTEWFSYEQYF	TRBV10-3	TRBJ2-7
TGTGCCAGCAGTGACCTCAGTGGGAACGAGCAGTACTTC	CASSDLSGNEQYF	TRBV6-4	TRBJ2-7
TGTGCCAGTAGGGCCCAAGAGACCCAGTACTTC	CASRAQETQYF	TRBV19	TRBJ2-5
TGCGCCAGCTTTCTTTCCGGGGCCCTCCACTTT	CASFLSGALHF	TRBV10-1	TRBJ1-6
TGTGCCACCAGTGTAATACTCCCCAGGGGCCTGAGGTATTCACCCCTCCACTTT	CATSVILPRGLRYSPLHF	TRBV24-1	TRBJ1-6
TGTGCCAGCAGCGTCCTTCTTAACAGCTCCTCTGGAAACACCATATATTTT	CASSVLLNSSSGNTIYF	TRBV9	TRBJ1-3
TGTGCCAGCAGTATACCCCCCAGGAACTGCTACGAGCAGTACTTC	CASSIPPRNCYEQYF	TRBV27	TRBJ2-7
TGTGCCAGCAGTTCCCTTGGGACAGGGGGTTATCAGCCCCAGCATTTT	CASSSLGTGGYQPQHF	TRBV28	TRBJ1-5
TGTGCCAGCAGCCGCCGCGGGAGCGGATGGCCTGAAGCTTTCTTT	CASSRRGSGWPEAFF	TRBV12-3	TRBJ1-1
TGTGCCAGCAGTGCGCCCGACAGTTCTAACTATGGCTACACCTTC	CASSAPDSSNYGYTF	TRBV6-4	TRBJ1-2
TGTGCCAGCAGCAGCCAGTTGAATACGCAGTATTTT	CASSSQLNTQYF	TRBV9	TRBJ2-3
TGTGCCAGCAGTCCCGGGCATCTGATTGAGCAGTTCTTC	CASSPGHLIEQFF	TRBV6-5	TRBJ2-1
TGTGCCAGCAGTGACTCCTCCCGATCTGACAGGGTGAGGGGAAACACTGAAGCTTTCTTT	CASSDSSRSDRVRGNTEAFF	TRBV6-4	TRBJ1-1
TGTGCCAGCAGCCGAGACCACCATCCATCCGGGGGTCTGGTAGCCAAAAACATTCAGTACTTC	CASSRDHHPSGGLVAKNIQYF	TRBV2	TRBJ2-4
TGTGCCACCAGTGGAGGGGGCTCAAACTATGGCTACACCTTC	CATSGGGSNYGYTF	TRBV24-1	TRBJ1-2
TGTGCCAGCAGTTTATGCCCTCAGGATCTCGGCACTGAAGCTTTCTTT	CASSLCPQDLGTEAFF	TRBV27	TRBJ1-1
TGTGCCAGCAGTGACTCCCCACTAGCGGGTATAGAGACCCAGTACTTC	CASSDSPLAGIETQYF	TRBV6-4	TRBJ2-5
TGTGCCAGCAGCCCCACTAGCGGGAGTCGGAAATACAATGAGCAGTTCTTC	CASSPTSGSRKYNEQFF	TRBV14	TRBJ2-1
TGTGCCAGCAGTTTCCCATCCGGACAGGGTTCCGGGGAGCTGTTTTTT	CASSFPSGQGSGELFF	TRBV27	TRBJ2-2
TGTGCCAGCAGCCAAGATCTGACAGGTTACTTC	CASSQDLTGYF	TRBV14	TRBJ2-4
TGCAGTGCTAGAGTCGCTCCAGGGGTATCCTACGAGCAGTACTTC	CSARVAPGVSYEQYF	TRBV20-1	TRBJ2-7
TGCGCCAGCAGCTCCTCGACCTATGGCTACACCTTC	CASSSSTYGYTF	TRBV5-1	TRBJ1-2
TGTGCCAGCAGTGGCCGGACTAGCACAGATACGCAGTATTTT	CASSGRTSTDTQYF	TRBV27	TRBJ2-3
TGTGCCAGCAGCTTAATATCTCCGGAGAAAGACGAGCAGTACTTC	CASSLISPEKDEQYF	TRBV7-6	TRBJ2-7
TGTGCCAGCAGGTACAACTATAGCAATCAGCCCCAGCATTTT	CASRYNYSNQPQHF	TRBV27	TRBJ1-5
TGCGCCAGCAGCTTGGGAAAGGGATTACCGGCTATAGTATACGAGCAGTACTTC	CASSLGKGLPAIVYEQYF	TRBV5-1	TRBJ2-7
TGCGCCAGCAGCTTGGGTCGACAGGGCGAGAGCGGGTACTTC	CASSLGRQGESGYF	TRBV5-1	TRBJ2-7
TGTGCCAGCAGTTTACGGTTTCTTCCTATACGCTACGAGCAGTACTTC	CASSLRFLPIRYEQYF	TRBV6-6	TRBJ2-7
TGTGCCAGCAGTGTCAGAGCGGGACAAAATGAAAAACTGTTTTTT	CASSVRAGQNEKLFF	TRBV2	TRBJ1-4
TGTGGATCTGGGACAGACCTGCTCTCAGATACGCAGTATTTT	CGSGTDLLSDTQYF	TRBV5-4	TRBJ2-3
TGCAGTGCCGTCCCTCGGACAGGGTTTGGGGGAGAAGTGAACACTGAAGCTTTCTTT	CSAVPRTGFGGEVNTEAFF	TRBV20-1	TRBJ1-1
TGTGCCAGCAGCCAAGATGTCCTAGTGGGCTATGGCTACACCTTC	CASSQDVLVGYGYTF	TRBV3-1	TRBJ1-2
TGTGCCAGCAGTGACAACCCGTCCAGGGGGGACCAAGAGACCCAGTACTTC	CASSDNPSRGDQETQYF	TRBV6-4	TRBJ2-5
TGTGCCAGCAGTTACCCCATGGGCCCGGTCACTGAAGCTTTCTTT	CASSYPMGPVTEAFF	TRBV6-5	TRBJ1-1
TGCAGCACCCGGGACAGGGGTGGAAGGGGATATAGCTACGAGCAGTACTTC	CSTRDRGGRGYSYEQYF	TRBV29-1	TRBJ2-7
TGTGCTAGTGGTTTGGTACCCCGACAGGGGGGGCTACGGGGCGATACGCAGTATTTT	CASGLVPRQGGLRGDTQYF	TRBV12-5	TRBJ2-3
TGTGCCAGCAGCTTAGATGCCGTAATAAACTCCGGGATAACGGACTATGGCTACACCTTC	CASSLDAVINSGITDYGYTF	TRBV11-2	TRBJ1-2
TGTGCGGGTAAGCCATATAGCGGGCCTGGAGATGAGCAGTTCTTC	CAGKPYSGPGDEQFF	TRBV7-3	TRBJ2-1
TGTGCCAGCAGTCCATATCTAGCGGGGGGGGCCAACGTCCTGACTTTC	CASSPYLAGGANVLTF	TRBV27	TRBJ2-6
TGTGCCAGCTCAGAACCTAGCGGGGCAGATACGCAGTATTTT	CASSEPSGADTQYF	TRBV18	TRBJ2-3
TGTGCCAGCAGCAAAAGGCGGCGAGTTAGCGGGTCAGTAGATCCCTCCGAGCAGTACTTC	CASSKRRRVSGSVDPSEQYF	TRBV5-4	TRBJ2-7
TGCGCCAGCAGCTTGGTGTTCCGGGAGGGCGCCTACGAGCAGTACTTC	CASSLVFREGAYEQYF	TRBV5-1	TRBJ2-7
TGTGCCAGCAGGCATTCCAGGACAGGGCACGAGCAGTACTTC	CASRHSRTGHEQYF	TRBV11-3	TRBJ2-7
TGTGCCAGCAGCTTAAGCACGGAAAAACTAGCGGGAGCGAAGACTGCCAAAAACATTCAGTACTTC	CASSLSTEKLAGAKTAKNIQYF	TRBV7-3	TRBJ2-4
TGTGCCACCACAGTGTACGAGCAGTACTTC	CATTVYEQYF	TRBV24-1	TRBJ2-7
TGCGCCAGCGTGCCTCCCAGCAATCAGCCCCAGCATTTT	CASVPPSNQPQHF	TRBV10-1	TRBJ1-5
TGTGCCAGCAGCCAAGTTCACAGGGCCTACGAGCAGTACTTC	CASSQVHRAYEQYF	TRBV3-1	TRBJ2-7
TGTCAAAGGACTAGCGGGTGGACCAATGAGCAGTTCTTC	CQRTSGWTNEQFF	TRBV11-2	TRBJ2-1
TGTGCCAGTAGCCCAGCGGGGCCCGTTTTTCGCTACGAGCAGTACTTC	CASSPAGPVFRYEQYF	TRBV19	TRBJ2-7
TGTGCCTGGAGTGTAGACGGCGCTTCCTACGAGCAGTACTTC	CAWSVDGASYEQYF	TRBV30	TRBJ2-7
TGCAGTGCTAGATCCGAAACCGGGACAGGTACCAATGAGCAGTTCTTC	CSARSETGTGTNEQFF	TRBV20-1	TRBJ2-1
TGTGCCAGCAGCAAGCACCTAAACAGGGGGCTTAAAGGGAGGTGGCCTGGAAACACCATATATTTT	CASSKHLNRGLKGRWPGNTIYF	TRBV7-6	TRBJ1-3
TGCGCCAGCACGTCCAGGGCTAAGCAGTTCTTC	CASTSRAKQFF	TRBV10-1	TRBJ2-1
TGTGCCAGCAGCTTGCCATGTGTTCCCCCCCCAGACAATGAGCAGTTCTTC	CASSLPCVPPPDNEQFF	TRBV5-5	TRBJ2-1
TGTGCCAGCAGCTTGGCTATTGGAATAAAGGGTGGCTACACCTTC	CASSLAIGIKGGYTF	TRBV5-8	TRBJ1-2
TGTGCCAGCAGCCCGGTGACAGGCCTGAACACTGAAGCTTTCTTT	CASSPVTGLNTEAFF	TRBV7-9	TRBJ1-1
TGCGGGGTCCGGGACTTGAACACTGAAGCTTTCTTT	CGVRDLNTEAFF	TRBV10-2	TRBJ1-1
TGCGCCAGCAGCGAGTGGACTAGCGGGAGGGCCCAGATGATGGAGCAGTACTTC	CASSEWTSGRAQMMEQYF	TRBV5-1	TRBJ2-7
TGTGCCATACAGGCATCTGCAACTAATGAAAAACTGTTTTTT	CAIQASATNEKLFF	TRBV27	TRBJ1-4
TGTGCCAGCAGCCGGGTTATGACAGGGGTTCGAACTAGCACAGATACGCAGTATTTT	CASSRVMTGVRTSTDTQYF	TRBV4-2	TRBJ2-3
TGTGCCATCAGGATCCCCAGCTCCTACAATGAGCAGTTCTTC	CAIRIPSSYNEQFF	TRBV10-3	TRBJ2-1
TGTGCCAGCAGTTACGATAGCGGCTACAATGAGCAGTTCTTC	CASSYDSGYNEQFF	TRBV6-3	TRBJ2-1
TGCAGTGCAGGGAACCGGAAAGACAGGACTCCCAGCAATCAGCCCCAGCATTTT	CSAGNRKDRTPSNQPQHF	TRBV20-1	TRBJ1-5
TGTGCCAGCAGCTTGGACTCCGGGACAGGTTACACTGAAGCTTTCTTT	CASSLDSGTGYTEAFF	TRBV5-4	TRBJ1-1
TGTGCCAGCAGCCTAGTTGAGCAGTTCTTC	CASSLVEQFF	TRBV7-9	TRBJ2-1
TGTGCCAGCAGCCCCCGGGGTCGGAGGGAGCCCCAGCATTTT	CASSPRGRREPQHF	TRBV14	TRBJ1-5
TGTGCCAGCAGCTTAACGGGCGCGGGAGGGGGGCAGTACTTC	CASSLTGAGGGQYF	TRBV7-3	TRBJ2-7
TGTGCCAGCAGTTCGGTGGGAAGTGAAAAACTGTTTTTT	CASSSVGSEKLFF	TRBV28	TRBJ1-4
TGTGCCCCCCATCCTCTAAGTTCCGGTGACACCGGGGAGCTGTTTTTT	CAPHPLSSGDTGELFF	TRBV7-9	TRBJ2-2
TGTGCCACCACCGTGACAGGGAGCTCCTACGAGCAGTACTTC	CATTVTGSSYEQYF	TRBV24-1	TRBJ2-7
TGTGCCAGCAGGCGGGACAGAACAAGGTCCGGCTACACCTTC	CASRRDRTRSGYTF	TRBV6-8	TRBJ1-2
TGCGCCAGCAGCCAAGAGACCAGGGAAGCCGAGGGCTCCTACGAGCAGTACTTC	CASSQETREAEGSYEQYF	TRBV4-1	TRBJ2-7
TGCAGTGCTAGATCGGCGGCACTAGCGGTGTCAGAAGAGCAGTTCTTC	CSARSAALAVSEEQFF	TRBV20-1	TRBJ2-1
TGTGCCAGCAGTAGCCGGCAAGGGTTCACAGATACGCAGTATTTT	CASSSRQGFTDTQYF	TRBV27	TRBJ2-3
TGTGCCAGCAGCCAGGTGCCCCTCCGGGACAGGGGTAAAGTTTACGAGCAGTACTTC	CASSQVPLRDRGKVYEQYF	TRBV14	TRBJ2-7
TGTGCTAGCAGCGAACGCCCCGACAGGCAATACTATGGCTACACCTTC	CASSERPDRQYYGYTF	TRBV7-7	TRBJ1-2
TGTGCCAGCAGTTTATCGTCACAGCGGAAAACGTACTTC	CASSLSSQRKTYF	TRBV27	TRBJ2-7
TGTGCCAGCAGGCCACGGACTAGGGGCTCCTACAATGAGCAGTTCTTC	CASRPRTRGSYNEQFF	TRBV12-4	TRBJ2-1
TGTGCCAGCAGACTAGTGAGCTCCTACGAGCAGTACTTC	CASRLVSSYEQYF	TRBV7-3	TRBJ2-7
TGCAGTGCTAGAGCCAGGGGCCTGATTGAGCAGTTCTTC	CSARARGLIEQFF	TRBV20-1	TRBJ2-1
TGCAGTGCTACCCATCGGACAGGCAATGAGCAGTTCTTC	CSATHRTGNEQFF	TRBV20-1	TRBJ2-1
TGCGCCCCGGGACCAGCACCAGCTAACTATGGCTACACCTTC	CAPGPAPANYGYTF	TRBV5-1	TRBJ1-2
TGTGCCAGCAGTTACTCGAATCAGAACACCGGGGAGCTGTTTTTT	CASSYSNQNTGELFF	TRBV6-5	TRBJ2-2
TGTGCCAGCAGCCCCTGGGACACTGGGGCCAACGTCCTGACTTTC	CASSPWDTGANVLTF	TRBV7-3	TRBJ2-6
TGTGCCAGCAGCTTGGGGCGACCAACTAATGAAAAACTGTTTTTT	CASSLGRPTNEKLFF	TRBV9	TRBJ1-4
TGTGCCAGCAGCGTTCTAGATGAGCAGTTCTTC	CASSVLDEQFF	TRBV13	TRBJ2-1
TGTGCCAGCAGCGGAAATACGGGGGCCAATCAGCCCCAGCATTTT	CASSGNTGANQPQHF	TRBV7-3	TRBJ1-5
TGTGCCAGCCGGGGAGGGGGAAGGGTGCACACTGAAGCTTTCTTT	CASRGGGRVHTEAFF	TRBV2	TRBJ1-1
TGTGCCAGCAGCCTTGGGACTAGCGGGGTTCCGGCGAACACCGGGGAGCTGTTTTTT	CASSLGTSGVPANTGELFF	TRBV7-9	TRBJ2-2
TGTGCTAGTGGTTTTGGGACAGGGGAGAACACTGAAGCTTTCTTT	CASGFGTGENTEAFF	TRBV12-5	TRBJ1-1
TGTGCCATCAGTAGAGAGGAGGGGGCTTCGAACACTGAAGCTTTCTTT	CAISREEGASNTEAFF	TRBV10-3	TRBJ1-1
TGCAGCGTTGAAAAGAAGGGGGAGACTAACACTGAAGCTTTCTTT	CSVEKKGETNTEAFF	TRBV29-1	TRBJ1-1
TGCAGTGCTACCGGGGGAGAACGCTTGGTAACCCTCCACTTT	CSATGGERLVTLHF	TRBV20-1	TRBJ1-6
TGTGCCACCAGGACCGGGGGCGGTGAAGCTTTCTTT	CATRTGGGEAFF	TRBV24-1	TRBJ1-1
TGCAGTGCTGCCCTAACTAAGAGCACCGGGGAGCTGTTTTTT	CSAALTKSTGELFF	TRBV20-1	TRBJ2-2
TGTGCCAGCAGCCCCGAGCTGAACACTGAAGCTTTCTTT	CASSPELNTEAFF	TRBV6-8	TRBJ1-1
TGTGCCAGCAGACCGACCCGGGGCTACACCTTC	CASRPTRGYTF	TRBV6-5	TRBJ1-2
TGTGCCAGCAGCCAAGATGACTCGGGACGCACCGGGGAGCTGTTTTTT	CASSQDDSGRTGELFF	TRBV14	TRBJ2-2
TGTGCCAGCAGCTTGGTAGAGGAGTCAGGCAACTATGGCTACACCTTC	CASSLVEESGNYGYTF	TRBV5-5	TRBJ1-2
TGTGCCAGCAGCTTCCACTGGGAGATCTCCGGAGATACGCAGTATTTT	CASSFHWEISGDTQYF	TRBV11-2	TRBJ2-3
TGTGCCAGCAGCAGGGGGGGCCGATTTTACGAGCAGTACTTC	CASSRGGRFYEQYF	TRBV6-2	TRBJ2-7
TGTGCCAGCCCCGCGGGAAGACCCACCAAAAACATTCAGTACTTC	CASPAGRPTKNIQYF	TRBV6-5	TRBJ2-4
TGTGCCTCCGGGGACAGGGGAGGATACTATGGCTACACCTTC	CASGDRGGYYGYTF	TRBV10-3	TRBJ1-2
TGCGCCAGCAGTCGAGCGAGAAGCCTAAGTGGCCGGCCATCCACGAACACCGGGGAGCTGTTTTTT	CASSRARSLSGRPSTNTGELFF	TRBV10-1	TRBJ2-2
TGTGCCACGGCGGGGGGCCCCGAGAGAGAAGGCGAGCAGTACTTC	CATAGGPEREGEQYF	TRBV15	TRBJ2-7
TGTGCCAGTAGTATCCTCCCGGGACAGGAACGCACCTTC	CASSILPGQERTF	TRBV19	TRBJ1-2
TGTGCCAGCAGTAAGGGGGGAGGCACCGGGGAGCTGTTTTTT	CASSKGGGTGELFF	TRBV27	TRBJ2-2
TGCGCCAGCAGCTTGGCCGTCGGCGAGCAGTACTTC	CASSLAVGEQYF	TRBV5-1	TRBJ2-7
TGTGCCAGCAGCCCCGGGACGAATGAGCAGTTCTTC	CASSPGTNEQFF	TRBV14	TRBJ2-1
TGTGCCAGCAGCTGGGACAGTTCTTATAGCAATCAGCCCCAGCATTTT	CASSWDSSYSNQPQHF	TRBV6-4	TRBJ1-5
TGTGCCAGCAGTCGGCGCCCCAGGACTGAAGCTTTCTTT	CASSRRPRTEAFF	TRBV6-1	TRBJ1-1
TGTGCCATATGGGACAGGGGGGGGAACTCTGGAAACACCATATATTTT	CAIWDRGGNSGNTIYF	TRBV6-4	TRBJ1-3
TGTGCCAGCAGTGCCGGGACAGGGAGGTACGGCCGTTGGGGCAATCAGCCCCAGCATTTT	CASSAGTGRYGRWGNQPQHF	TRBV28	TRBJ1-5
TGTGCCAGCAGCCCGAAACAGGGGGGGGGCTACACCTTC	CASSPKQGGGYTF	TRBV14	TRBJ1-2
TGTGCCAGCAGTTACTCGATATCGTTGGGACTGACCGAGCAGTACTTC	CASSYSISLGLTEQYF	TRBV6-5	TRBJ2-7
TGTGCCAGCAGTCCGATTGTGAGCGCCTACGAGCAGTACTTC	CASSPIVSAYEQYF	TRBV27	TRBJ2-7
TGCAGCGTTGCTCCCAGCTTTGGCTACACCTTC	CSVAPSFGYTF	TRBV29-1	TRBJ1-2
TGTGCCAGCAGCGACCACCGGGGGACTAGCGGGGTAGGGCCCTACGAGCAGTACTTC	CASSDHRGTSGVGPYEQYF	TRBV5-6	TRBJ2-7
TGTGCCACCAGTGACGCGAGTACTGCCCAGGGCAGGAGCAATCAGCCCCAGCATTTT	CATSDASTAQGRSNQPQHF	TRBV24-1	TRBJ1-5
TGTGCCAGCAGTTCCAACCCGGGACAGGCCGAAAGGTATGGCTACACCTTC	CASSSNPGQAERYGYTF	TRBV11-2	TRBJ1-2
TGCGCCAGCAGCTCCAGGGGAGGCAATCAGCCCCAGCATTTT	CASSSRGGNQPQHF	TRBV5-1	TRBJ1-5
TGCGCCAGCAGTCCCGGACAGGGGGCGGTAACCCACACTGAAGCTTTCTTT	CASSPGQGAVTHTEAFF	TRBV10-1	TRBJ1-1
TGTGCGGCCAAAGCCTACAGGGAGGTGTCTGGAAACACCATATATTTT	CAAKAYREVSGNTIYF	TRBV7-3	TRBJ1-3
TGTGCCAGCAGCCACAATCGAGTAAGTGGGACAGCTTCCAATCAGCCCCAGCATTTT	CASSHNRVSGTASNQPQHF	TRBV3-1	TRBJ1-5
TGCGCCAGCAGCCAATATGCGGGAGCGGATGACACAAACACCATATATTTT	CASSQYAGADDTNTIYF	TRBV4-1	TRBJ1-3
TGTGCCATCAGCAAATCCCTGCGGGAGTTGCATAGCAATCAGCCCCAGCATTTT	CAISKSLRELHSNQPQHF	TRBV10-3	TRBJ1-5
TGTGCCAGCAGCCTCAGTTTGGGCTATGGCTACACCTTC	CASSLSLGYGYTF	TRBV9	TRBJ1-2
TGTGCCAGCAGTTACCGTGGGACAAGGGTTCTCATTATGAACACTGAAGCTTTCTTT	CASSYRGTRVLIMNTEAFF	TRBV27	TRBJ1-1
TGTGCCAGCAGCTGGAGGGGATATAATTCACCCCTCCACTTT	CASSWRGYNSPLHF	TRBV7-4	TRBJ1-6
TGTGCCAGCAGCGGGTCAACGCAGGGTCGCAGGAGATCTGGAAACACCATATATTTT	CASSGSTQGRRRSGNTIYF	TRBV9	TRBJ1-3
TGTGCCACCAGTGATTCGGTACGAGGGGAGAACACCGGGGAGCTGTTTTTT	CATSDSVRGENTGELFF	TRBV24-1	TRBJ2-2
TGCAGTGCCCCCCTCCCGCGGGTCGAAGGGGAGTGCGGCACCGGGGAGCTGTTTTTT	CSAPLPRVEGECGTGELFF	TRBV20-1	TRBJ2-2
TGTGCCAGCAGCTTAGGATTAGGGACGCAAGATACGCAGTATTTT	CASSLGLGTQDTQYF	TRBV7-9	TRBJ2-3
TGTGCCAGCAGGGGCGCGGGAGTTATCCAAGAGACCCAGTACTTC	CASRGAGVIQETQYF	TRBV28	TRBJ2-5
TGTGCCAGCAGCTCAGAGGGGGCCAACGTCCTGACTTTC	CASSSEGANVLTF	TRBV7-3	TRBJ2-6
TGCAGTGCTAGAGATCTAGCGGGGGCAGAACACACCGGGGAGCTGTTTTTT	CSARDLAGAEHTGELFF	TRBV20-1	TRBJ2-2
TGTGCCAGCAGTGACTCGCTCGGGGGGGTCGGGCGTGAGCAGTTCTTC	CASSDSLGGVGREQFF	TRBV6-4	TRBJ2-1
TGCGCCAGCAATAATTGTCAGTACGAGCAGTACTTC	CASNNCQYEQYF	TRBV10-1	TRBJ2-7
TGCGCCAGGGCAGGGGAGGGTGCAACTAATGAAAAACTGTTTTTT	CARAGEGATNEKLFF	TRBV5-1	TRBJ1-4
TGTGCCAGCAGCCTCTACAGGTCTGCCGGGACGGAGTACAATGAGCAGTTCTTC	CASSLYRSAGTEYNEQFF	TRBV7-6	TRBJ2-1
TGTGCCAGCTCACCCCCGATCCCCTTTTACACTGAAGCTTTCTTT	CASSPPIPFYTEAFF	TRBV18	TRBJ1-1
TGCAGTGCTAGAGCAGGGACTAATTCACCCCTCCACTTT	CSARAGTNSPLHF	TRBV20-1	TRBJ1-6
TGTGCCATCAGTGTTAGCGGGGTATTCTACGAGCAGTACTTC	CAISVSGVFYEQYF	TRBV10-3	TRBJ2-7
TGCGCCAGCAGTGACCTGCCTTACCACCGGGACAGCCTCAATCAGCCCCAGCATTTT	CASSDLPYHRDSLNQPQHF	TRBV10-2	TRBJ1-5
TGTGCCAGCAGTAAGCACAAGGCCGAGCAGTACTTC	CASSKHKAEQYF	TRBV6-1	TRBJ2-7
TGTGCCAGTAGGCCTCAGGGGAAGGGCACAGATACGCAGTATTTT	CASRPQGKGTDTQYF	TRBV19	TRBJ2-3
TGTGCCAGCAGCCAAACGGGGCCTTGGTACTTC	CASSQTGPWYF	TRBV3-1	TRBJ2-5
TGCGCCAGCAGCTTGGACAGGTGGGCTTTCTTT	CASSLDRWAFF	TRBV5-1	TRBJ1-1
TGCGCCAGCAGCCAACTGACAGGGCGAACAAACACTGAAGCTTTCTTT	CASSQLTGRTNTEAFF	TRBV5-1	TRBJ1-1
TGCAGTGCTGGGGCTGGAGAAAAACTGTTTTTT	CSAGAGEKLFF	TRBV20-1	TRBJ1-4
TGTGCCGAGGGGGACAAAATCCGCCGCTCTGGAAACACCATATATTTT	CAEGDKIRRSGNTIYF	TRBV6-2	TRBJ1-3
TGTGCCAGCAGCGTAGCTCGAAGTGCCCCTTATAATTCACCCCTCCACTTT	CASSVARSAPYNSPLHF	TRBV5-6	TRBJ1-6
TGTGCCAGCAGCGTAGCTCCTCCCGGGGGGAGCAATCAGCCCCAGCATTTT	CASSVAPPGGSNQPQHF	TRBV9	TRBJ1-5
TGTGCCAGCACAGCGGGACAGGGGATGAACGAGCAGTACTTC	CASTAGQGMNEQYF	TRBV11-2	TRBJ2-7
TGCAGTGCTAGAGAGCTGGGGGGACACGAGCAGTACTTC	CSARELGGHEQYF	TRBV20-1	TRBJ2-7
TGTGCCAGCAGCCACGTTAGGTACTCCTACGAGCAGTACTTC	CASSHVRYSYEQYF	TRBV3-1	TRBJ2-7
TGTGCCACCAGCCGGAGCCTAGCGGGCAATGAGCAGTTCTTC	CATSRSLAGNEQFF	TRBV15	TRBJ2-1
TGCGCCAACCCCTCTAGCGGGCGAAACCATGAGCAGTTCTTC	CANPSSGRNHEQFF	TRBV10-1	TRBJ2-1
TGTGCCAGCAGCCAAGTTAAGTCAGGGAATGAGCAGTTCTTC	CASSQVKSGNEQFF	TRBV14	TRBJ2-1
TGCAGTGCCGGGACTAGGCTGCAAGAGACCCAGTACTTC	CSAGTRLQETQYF	TRBV20-1	TRBJ2-5
TGTGCCAGCAGCGACGGGACAGGGGGCGGGAACAATGAGCAGTTCTTC	CASSDGTGGGNNEQFF	TRBV7-3	TRBJ2-1
TGTGCCAGTAATCCGCGGGAGGATGAGCAGTTCTTC	CASNPREDEQFF	TRBV19	TRBJ2-1
TGCGCCAGGTTGGGACTAGGAAGCCGCACAGATACGCAGTATTTT	CARLGLGSRTDTQYF	TRBV4-1	TRBJ2-3
TGTGCCAGCAGCACTGGGAGGCAGTTCTTC	CASSTGRQFF	TRBV5-4	TRBJ2-1
TGTGCCAGCAGTGGAAACGGGGGGCCTCCCACCGGGGAGCTGTTTTTT	CASSGNGGPPTGELFF	TRBV6-1	TRBJ2-2
TGCGCCAACGCGGCGAACACCGGGGAGCTGTTTTTT	CANAANTGELFF	TRBV10-2	TRBJ2-2
TGTGCCAGCAGCGGGGAGGACCGCGGGAGCCTGAGAACCTACGAGCAGTACTTC	CASSGEDRGSLRTYEQYF	TRBV9	TRBJ2-7
TGCGCCAGCTCCCTCCAAACTCAGGGTCAAGGATCCCAGCAGTTCTTC	CASSLQTQGQGSQQFF	TRBV10-1	TRBJ2-1
TGTGCCAGCAGCACGGGACAGGGGGGAGGGTATGGCTACACCTTC	CASSTGQGGGYGYTF	TRBV7-9	TRBJ1-2
TGTGCCAGCAGTGACGCCACCCGCCGCGGGACAGGACCGAATCAGCCCCAGCATTTT	CASSDATRRGTGPNQPQHF	TRBV6-4	TRBJ1-5
TGTGCCAGCATAAGGGACAGGGGGCGACAGCCCTACGAGCAGTACTTC	CASIRDRGRQPYEQYF	TRBV11-1	TRBJ2-7
TGTGCCAGCAGTTTCCCGAGGGAGATCGCGGAAACTAACTATGGCTACACCTTC	CASSFPREIAETNYGYTF	TRBV28	TRBJ1-2
TGTGCCAGCAGTCTAGCGGGCAACAATGAGCAGTTCTTC	CASSLAGNNEQFF	TRBV6-1	TRBJ2-1
TGTGCCAAAAGGGACAGGAGATTGTCCTACAATGAGCAGTTCTTC	CAKRDRRLSYNEQFF	TRBV19	TRBJ2-1
TGTGCCAGCAGTCCGGGACTAGCCAAAAACATTCAGTACTTC	CASSPGLAKNIQYF	TRBV6-4	TRBJ2-4
TGTGCCAGCAGCCCGTCTCAGAGACTCCAGAGGTCACCCCTCCACTTT	CASSPSQRLQRSPLHF	TRBV9	TRBJ1-6
TGCGCCAGCAGTGAATCATTTAGAGTCTCAGAGACCCAGTACTTC	CASSESFRVSETQYF	TRBV10-2	TRBJ2-5
TGCAGCGTTGAAGATACTAGCGGCCGGGATGAGCAGTTCTTC	CSVEDTSGRDEQFF	TRBV29-1	TRBJ2-1
TGTGCCAGCAGCGGACAGGGCGTAGGAGAGACCCAGTACTTC	CASSGQGVGETQYF	TRBV11-2	TRBJ2-5
TGTGCCAGTAGTATATGTATTAAACAGGGGTGTGGGTATGAGCAGTTCTTC	CASSICIKQGCGYEQFF	TRBV19	TRBJ2-1
TGTGCCAGCAGCTTAACTACACTAGCGGGAACTGATTGCACAGATACGCAGTATTTT	CASSLTTLAGTDCTDTQYF	TRBV7-4	TRBJ2-3
TGTGCCAGCACGACAGGCACCGGGGAGCTGTTTTTT	CASTTGTGELFF	TRBV6-2	TRBJ2-2
TGTGCCAGCAGCTTAGGAACTAGCAGGGCCTACAATGAGCAGTTCTTC	CASSLGTSRAYNEQFF	TRBV11-2	TRBJ2-1
TGTGCCAGCACCCTCCTGCTTGACAGGGATAATGAGCAGTTCTTC	CASTLLLDRDNEQFF	TRBV11-3	TRBJ2-1
TGCGCCAGCAGCTTGTCAGGACAGCTGGGCTACACCTTC	CASSLSGQLGYTF	TRBV5-1	TRBJ1-2
TGCGCCAGCAGCCAAGATTCCCATGGGGACCAATCTGGAAACACCATATATTTT	CASSQDSHGDQSGNTIYF	TRBV4-3	TRBJ1-3
TGCGCCAGTGTTACAGGGATTGGAGTCATGAACACTGAAGCTTTCTTT	CASVTGIGVMNTEAFF	TRBV10-1	TRBJ1-1
TGTGCCAGCAGCGAAAGGGAGGGGGGGGATTCACCCCTCCACTTT	CASSEREGGDSPLHF	TRBV5-4	TRBJ1-6
TGTGCCAGCAGCAGCGGGACAGTCTGTCCTAACTATGGCTACACCTTC	CASSSGTVCPNYGYTF	TRBV13	TRBJ1-2
TGTGCCAGCAGTTTTCGGGGACAGGCCGGCTGGAGCCAAGAGACCCAGTACTTC	CASSFRGQAGWSQETQYF	TRBV27	TRBJ2-5
TGTGCCAGCAGCCCGGGGATTAATGAGCAGTTCTTC	CASSPGINEQFF	TRBV3-1	TRBJ2-1
TGTGCCCGGCTATCTCCGTACAATGAGCAGTTCTTC	CARLSPYNEQFF	TRBV10-3	TRBJ2-1
TGTGCCAGCAGCTTCTTAAACCGCTCCTACAATGAGCAGTTCTTC	CASSFLNRSYNEQFF	TRBV5-8	TRBJ2-1
TGTGCCAGCAGCGGGTCCGAGGGTGAGCAGTTCTTC	CASSGSEGEQFF	TRBV5-5	TRBJ2-1
TGTGCCAGCACGGGACAGGGAGATACGCAGTATTTT	CASTGQGDTQYF	TRBV6-8	TRBJ2-3
TGTGCCAGCAGCCCTGCTCTCGTAGGTGATACGCAGTATTTT	CASSPALVGDTQYF	TRBV13	TRBJ2-3
TGTGCCAGCAGTGATCGACCGGGACGCACCTACGAGCAGTACTTC	CASSDRPGRTYEQYF	TRBV6-1	TRBJ2-7
TGCAGTAGTGAGGTCTTTATGGGGGACGAGCAGTACTTC	CSSEVFMGDEQYF	TRBV20-1	TRBJ2-7
TGTGCCAGTAGGAGGCTTAAAAGTCACAACTATGGCTACACCTTC	CASRRLKSHNYGYTF	TRBV19	TRBJ1-2
TGTGCCAGCAGCGTGGAGCGGGAGAGAGACACTGAAGCTTTCTTT	CASSVERERDTEAFF	TRBV9	TRBJ1-1
TGTGCCAGCAGATCGGAAAAACTGTTTTTT	CASRSEKLFF	TRBV27	TRBJ1-4
TGTGATTACCCGACAGGGCGTACCGGGGAGCTGTTTTTT	CDYPTGRTGELFF	TRBV28	TRBJ2-2
TGTGCCAGTCGACTTTTTGACGGTTTGCCGAGCTACACCTTC	CASRLFDGLPSYTF	TRBV5-4	TRBJ1-2
TGTGCCAGCAGCCAAGCGCGCCTCGACGGGTATGCCTACGAGCAGTACTTC	CASSQARLDGYAYEQYF	TRBV3-1	TRBJ2-7
TGTGCCAGCAGTGAAAAGTCCCAGCGACGCCAAGAGACCCAGTACTTC	CASSEKSQRRQETQYF	TRBV2	TRBJ2-5
TGCAGTGCTAGAGTCCTTACAGGGTTATGTTTCGGGGAGCTGTTTTTT	CSARVLTGLCFGELFF	TRBV20-1	TRBJ2-2
TGTGCCAGCAGCATACTCAGCCGGGGAGAGACCCAGTACTTC	CASSILSRGETQYF	TRBV12-4	TRBJ2-5
TGCGCCAGCAGCTTGGGTGAGACCTTGGCTGGCACTGAAGCTTTCTTT	CASSLGETLAGTEAFF	TRBV5-1	TRBJ1-1
TGCGCCAGCAGCTATGTACGCGGGAGCCGATCTTCCCCCACTGAAGCTTTCTTT	CASSYVRGSRSSPTEAFF	TRBV5-1	TRBJ1-1
TGTGCCAGCAGTTATCTGGTCAGAGGGTACACCATATATTTT	CASSYLVRGYTIYF	TRBV6-2	TRBJ1-3
TGTGCCAGCAGCGTAAGGCTCGCCGGGACAGGATTCCCCTTC	CASSVRLAGTGFPF	TRBV9	TRBJ1-2
TGTGCCAGCAGCCAAGCCAGTGTCCGGGACTCCTACGAGCAGTACTTC	CASSQASVRDSYEQYF	TRBV14	TRBJ2-7
TGCGCCAGCAGTGAGGGTTCCTCCCTGAGCCCCTACGAGCAGTACTTC	CASSEGSSLSPYEQYF	TRBV10-1	TRBJ2-7
TGTGCCAGCAGCCAAGATGCCGGGACAGGAGAAAGAGGGGCCAACGTCCTGACTTTC	CASSQDAGTGERGANVLTF	TRBV3-1	TRBJ2-6
TGCGCCAGCAGTGTTCTTAGACCCCAAATCACCGGGGAGCTGTTTTTT	CASSVLRPQITGELFF	TRBV10-1	TRBJ2-2
TGTGCCAGCACGACGGGGGGGTGCTTAACCTCGTACCACGAGCAGTACTTC	CASTTGGCLTSYHEQYF	TRBV27	TRBJ2-7
TGTGCCATCAGGTTGGCCGCCGGGACGGTACACTATGGCTACACCTTC	CAIRLAAGTVHYGYTF	TRBV10-3	TRBJ1-2
TGCCTAACAGTGGAACTCCCAGAAAGCAATGAGCAGTTCTTC	CLTVELPESNEQFF	TRBV20-1	TRBJ2-1
TGCGCCAAAGGGACAGGGAGGTACCAAGAGACCCAGTACTTC	CAKGTGRYQETQYF	TRBV10-2	TRBJ2-5
TGTGCCAGCAGCCGGGACACCTATCAGCCCCAGCATTTT	CASSRDTYQPQHF	TRBV13	TRBJ1-5
TGTGCCAGCAGCACCCCACCGGACAGGGGATCAGAAAATCAGCCCCAGCATTTT	CASSTPPDRGSENQPQHF	TRBV11-2	TRBJ1-5
TGTGCCAGCAGCCAAAACTCTAGCGGAACCCCCTACGAGCAGTACTTC	CASSQNSSGTPYEQYF	TRBV3-1	TRBJ2-7
TGCGCCAGCAGTTGGAGGGGGGCCCCGAACACTGAAGCTTTCTTT	CASSWRGAPNTEAFF	TRBV10-1	TRBJ1-1
TGTGCCAGCAGCCACATCCCTAGTGCTACTTGCGCACGAGATACGCAGTATTTT	CASSHIPSATCARDTQYF	TRBV3-1	TRBJ2-3
TGTGCCAGCCTTCCAGGGGGCTGCAATCAGCCCCAGCATTTT	CASLPGGCNQPQHF	TRBV7-6	TRBJ1-5
TGTGCCAGCAGTAAACCTAGTCTTACCTACGAGCAGTACTTC	CASSKPSLTYEQYF	TRBV12-3	TRBJ2-7
TGTGCCAGCAGCGTAGCGACTACAGCTCACTCCTACGAGCAGTACTTC	CASSVATTAHSYEQYF	TRBV9	TRBJ2-7
TGCGCCAGCAGCCCGCGGGCCTCCTACGAGCAGTACTTC	CASSPRASYEQYF	TRBV5-1	TRBJ2-7
TGTGCCAGCAGCCAAAAAGGGGATCCAGGGAGACTAGTCACAGATACGCAGTATTTT	CASSQKGDPGRLVTDTQYF	TRBV7-4	TRBJ2-3
TGCATTTCGCGCGTGAGGGGGAACTACGAGCAGTACTTC	CISRVRGNYEQYF	TRBV20-1	TRBJ2-7
TGTGCCAGCAGCTTACCAGAGGATGGCTACACCTTC	CASSLPEDGYTF	TRBV11-2	TRBJ1-2
TGTGCCAGCAAACGGCAGAAGAATACGCAGTATTTT	CASKRQKNTQYF	TRBV6-5	TRBJ2-3
TGTGCCAGCAGCTTGGGCAGGCCGGGACAGCGTGTGAATAATGAAAAACTGTTTTTT	CASSLGRPGQRVNNEKLFF	TRBV5-6	TRBJ1-4
TGCGCCAGCGGGACAACAAGGACCGACTCCTTGGAAAAACTGTTTTTT	CASGTTRTDSLEKLFF	TRBV10-2	TRBJ1-4
TGTGCCAGCATCCCAGTAGGGGCCGCTAATTCACCCCTCCACTTT	CASIPVGAANSPLHF	TRBV6-8	TRBJ1-6
TGCGCCAGCAGTGGGGTATACCCGTATTTT	CASSGVYPYF	TRBV10-1	TRBJ2-3
TGTGCCACGAGGACGAGCCGTGACACTGAAGCTTTCTTT	CATRTSRDTEAFF	TRBV24-1	TRBJ1-1
TGTGCCAGCAGCTTCCCAGCGGGAGAACATTCACCCCTCCACTTT	CASSFPAGEHSPLHF	TRBV7-6	TRBJ1-6
TGTGCCAGCAGGTGGACCAGGACTCCCGGGTTTCGAGATCAGCCCCAGCATTTT	CASRWTRTPGFRDQPQHF	TRBV6-4	TRBJ1-5
TGTGCCAGTAAAACAGGACCCCCTGAAAAACTGTTTTTT	CASKTGPPEKLFF	TRBV9	TRBJ1-4
TGCGCCAGCAGCCACCAGGAGGAGAACACTGAAGCTTTCTTT	CASSHQEENTEAFF	TRBV4-1	TRBJ1-1
TGCGCCAGCAGTGAGGGGGGGTGGGCCAACGTCCTGACTTTC	CASSEGGWANVLTF	TRBV10-1	TRBJ2-6
TGTGCCAGCAGCTTAGGATCGGTCAGCTCCTATAATTCACCCCTCCACTTT	CASSLGSVSSYNSPLHF	TRBV11-2	TRBJ1-6
TGTGCCACCATAACAGGGGGCTTTTGGTATAGCAATCAGCCCCAGCATTTT	CATITGGFWYSNQPQHF	TRBV24-1	TRBJ1-5
TGTGCCAGCAGCATAGCAGGGAGTAGGTTCAATCAGCCCCAGCATTTT	CASSIAGSRFNQPQHF	TRBV9	TRBJ1-5
TGTGCCAGCACGAAAGACTGGCTCCAGCCCCAGCATTTT	CASTKDWLQPQHF	TRBV6-4	TRBJ1-5
TGTGCCAGCAGTACGAAATGGGGGGGCTCCAGCGCGGAAGGAGGTGAGCAGTTCTTC	CASSTKWGGSSAEGGEQFF	TRBV6-4	TRBJ2-1
TGTGCCAGCAGTTTACTAGGGCCCCAGCTCGAGACCCAGTACTTC	CASSLLGPQLETQYF	TRBV28	TRBJ2-5
TGCGCCAGCAGCCCCCGCAGTACAGGGGGGGGCCCCCATTGCACAGATACGCAGTATTTT	CASSPRSTGGGPHCTDTQYF	TRBV5-1	TRBJ2-3
TGTGCCAGCTCATCAGGGGGGGGGCAGACGGAGACCCAGTACTTC	CASSSGGGQTETQYF	TRBV18	TRBJ2-5
TGCAGCGTTGAAGACGACACCCTAGGGAGCGAAGATTCACCCCTCCACTTT	CSVEDDTLGSEDSPLHF	TRBV29-1	TRBJ1-6
TGTGCCAGTGTCACAGGGGGCCCTGAAGCTTTCTTT	CASVTGGPEAFF	TRBV19	TRBJ1-1
TGCGCCAGGCCCGCGGGACTAGCGGGTGTTGGCCAAGAGACCCAGTACTTC	CARPAGLAGVGQETQYF	TRBV10-1	TRBJ2-5
TGCGCCAGCAGCTTCAGGTTTGGGACAGGGCCTAGAGAGACCCAGTACTTC	CASSFRFGTGPRETQYF	TRBV5-1	TRBJ2-5
TGTGCCAGCAGTACGGGGGAGAGCCGGGAGACCCAGTACTTC	CASSTGESRETQYF	TRBV14	TRBJ2-5
TGTGCCAGCAGCGTACCCTCTTCTTCGAGCTCTGGAAACACCATATATTTT	CASSVPSSSSSGNTIYF	TRBV9	TRBJ1-3
TGTGCCAGCAGTGAGGCGGGCTCCTACGAGCAGTACTTC	CASSEAGSYEQYF	TRBV25-1	TRBJ2-7
TGCAGTGCTGGATTTTCCAATTCACCCCTCCACTTT	CSAGFSNSPLHF	TRBV20-1	TRBJ1-6
TGTGCCAGCAGCCATGTTGGGGTAGTCTACGAGCAGTACTTC	CASSHVGVVYEQYF	TRBV7-2	TRBJ2-7
TGTGCCAGCAGCATTCTGGACAGCTACGAGCAGTACTTC	CASSILDSYEQYF	TRBV9	TRBJ2-7
TGTGCCAGCAGCAAGGGACACACTGAAGCTTTCTTT	CASSKGHTEAFF	TRBV25-1	TRBJ1-1
TGCAGTGCTGTATCCTTGGCGACTAGCGGGGTTGACGACGAGCAGTACTTC	CSAVSLATSGVDDEQYF	TRBV20-1	TRBJ2-7
TGTGCCAGCAGCTTAGTAGGGGACAGGGGCAGCCTGGGCAATCAGCCCCAGCATTTT	CASSLVGDRGSLGNQPQHF	TRBV13	TRBJ1-5
TGTGCCAGCAGTCCCAGCCCACTAGCGGTAGGCCCCGGGGAGCTGTTTTTT	CASSPSPLAVGPGELFF	TRBV6-5	TRBJ2-2
TGTGCCAGCCCTCCCGGGACAGGGGACACTGAAGCTTTCTTT	CASPPGTGDTEAFF	TRBV25-1	TRBJ1-1
TGTGCCAGCGTAGGGGTGGGGGGGCAAGAGACCCAGTACTTC	CASVGVGGQETQYF	TRBV19	TRBJ2-5
TGTGCCAGGTGGGGGACATCCTACAATGAGCAGTTCTTC	CARWGTSYNEQFF	TRBV9	TRBJ2-1
TGCGCCAGCAGGGGGAGCCGGGACAGAGAGAGTAACTATGGCTACACCTTC	CASRGSRDRESNYGYTF	TRBV10-1	TRBJ1-2
TGTGCCAGCAGCTTAGGTGCTCCAGGCACGGCGTATGGCTACACCTTC	CASSLGAPGTAYGYTF	TRBV11-2	TRBJ1-2
TGTGCCAGCAGCCAAGAGTTGGGCTACGAGCAGTACTTC	CASSQELGYEQYF	TRBV14	TRBJ2-7
TGTGCCAGCAGTTGTACTGCAGCCCACGGACGTGAGCAGTTCTTC	CASSCTAAHGREQFF	TRBV27	TRBJ2-1
TGTGCCAGCAGCTTTCCCCCGGGCTTGTACTATGGCTACACCTTC	CASSFPPGLYYGYTF	TRBV11-3	TRBJ1-2
TGTGCTAGTGGTTCCCCCGATGGGACAGGGTTCTATGGCTACACCTTC	CASGSPDGTGFYGYTF	TRBV12-5	TRBJ1-2
TGCAGTGCTAGAGACAATCGGGACAGTGTAAGGTCACCCCTCCACTTT	CSARDNRDSVRSPLHF	TRBV20-1	TRBJ1-6
TGTGCCAGCAGCTTAAGGGGGTTGAAAGGTCGGGGCTACGAGCAGTACTTC	CASSLRGLKGRGYEQYF	TRBV7-3	TRBJ2-7
TGTGCCGACGGGGGGGGGGGCCCGCGCACAGATACGCAGTATTTT	CADGGGGPRTDTQYF	TRBV27	TRBJ2-3
TGTGCCACAGAACCGGACAGGGGTTATGGCATGTACGAGCAGTACTTC	CATEPDRGYGMYEQYF	TRBV15	TRBJ2-7
TGTGCCAGCAAGCGCGAGGTGGGCCAGGGCTACGAGCAGTACTTC	CASKREVGQGYEQYF	TRBV7-9	TRBJ2-7
TGTGCCAGCAGCTGGCGGGTTTTCCTGATGGGGTTAGCCAAAAACATTCAGTACTTC	CASSWRVFLMGLAKNIQYF	TRBV7-9	TRBJ2-4
TGTGCTCAGTTACTACTCCCTAACTATGGCTACACCTTC	CAQLLLPNYGYTF	TRBV6-4	TRBJ1-2
TGCAGTGCGTGTCATAACAACGAGCAGTACTTC	CSACHNNEQYF	TRBV20-1	TRBJ2-7
TGTGCCAGCAGGCGGACAGGGAATTCACCCCTCCACTTT	CASRRTGNSPLHF	TRBV11-3	TRBJ1-6
TGTGCCAGCAGTGCAGGTGAAAAACTGTTTTTT	CASSAGEKLFF	TRBV14	TRBJ1-4
TGTGCCAGCAGTGTGGGCCCAGAAGGGGACTTCACAGATACGCAGTATTTT	CASSVGPEGDFTDTQYF	TRBV28	TRBJ2-3
TGTGCCAGCAGCTCGAAGAAGTCCCCGGGACTAGCGGGCTGGTACTTC	CASSSKKSPGLAGWYF	TRBV9	TRBJ2-7
TGCGCCAGCAGCCGGGGGGGCCTGGATTACGAGCAGTACTTC	CASSRGGLDYEQYF	TRBV4-3	TRBJ2-7
TGTGCCACCACAACAGCGACTCCGGGACCAACCCTCGAGCAGTACTTC	CATTTATPGPTLEQYF	TRBV24-1	TRBJ2-7
TGCGCCAGCAGCTTTGCGGGGGCGTTCGAGAGGACCGGGGAGCTGTTTTTT	CASSFAGAFERTGELFF	TRBV5-1	TRBJ2-2
TGTCCTGGCCCAGACACTCAGCGGCAGGATACGCAGTATTTT	CPGPDTQRQDTQYF	TRBV11-2	TRBJ2-3
TGTGCCAGCAGTGATACGGAAGTGAGTTTCATGAACACTGAAGCTTTCTTT	CASSDTEVSFMNTEAFF	TRBV6-1	TRBJ1-1
TGCAGTGCTATTGTAGGTCGCCGGGACAGGGAAGGCGTTAGCAATCAGCCCCAGCATTTT	CSAIVGRRDREGVSNQPQHF	TRBV20-1	TRBJ1-5
TGCGCCAGCACACTTAAATACGAGCAGTACTTC	CASTLKYEQYF	TRBV4-1	TRBJ2-7
TGTGCCAGCAGCTTAGTTGACAGGGCTGCGAGTACTGAAGCTTTCTTT	CASSLVDRAASTEAFF	TRBV11-2	TRBJ1-1
TGCGCCATAGGGGACAGGGGTGGCTACGAGCAGTACTTC	CAIGDRGGYEQYF	TRBV10-1	TRBJ2-7
TGTGCCAGCAGAGTTCTAGCGGTGTATGAGCAGTTCTTC	CASRVLAVYEQFF	TRBV12-3	TRBJ2-1
TGCGCCAGCACGTCCCCGGGACTAGCGGGACCAGATACGCAGTATTTT	CASTSPGLAGPDTQYF	TRBV10-1	TRBJ2-3
TGCAGTGCAAATCGGAGGGGCGGGGGAGGCTCTGGAAACACCATATATTTT	CSANRRGGGGSGNTIYF	TRBV20-1	TRBJ1-3
TGTGCCATCAGCCGTGGCCCGTACTACAATGAGCAGTTCTTC	CAISRGPYYNEQFF	TRBV10-3	TRBJ2-1
TGCGCCAGCAGCTTATTCCTGGACGCGGTCCGGGGGGGAGGGGACGAGCAGTACTTC	CASSLFLDAVRGGGDEQYF	TRBV5-1	TRBJ2-7
