TGTGCCAGCAGTTCGCGGGGGCCTTGCTTCGAGCAGTACTTC	CASSSRGPCFEQYF	TRBV6-3	TRBJ2-7
TGTGCCACGCCAGGGTCAAGTCGGACTAATGAAAAACTGTTTTTT	CATPGSSRTNEKLFF	TRBV24-1	TRBJ1-4
TGTGCCAGCAGTTACTCCCACGGAGAGATTTCAGTCGCCACCTTC	CASSYSHGEISVATF	TRBV6-5	TRBJ1-2
TGTGCCTGGAGTGTACCGGACAGTTTCCGCAATCAGCCCCAGCATTTT	CAWSVPDSFRNQPQHF	TRBV30	TRBJ1-5
TGTGCCAGCAGCTTGGGCCCAGTGCACACCTCCTACGAGCAGTACTTC	CASSLGPVHTSYEQYF	TRBV5-6	TRBJ2-7
TGTGCCAGCAGCGCGCGCTACGAGCAGTACTTC	CASSARYEQYF	TRBV9	TRBJ2-7
TGTGCCAGCACCGAAGGAATCTTCAGACAGGCGAGCTATGGCTACACCTTC	CASTEGIFRQASYGYTF	TRBV7-3	TRBJ1-2
TGTGCCAGCAGCTTACTCTCCCGAGGAGAGCAGTACTTC	CASSLLSRGEQYF	TRBV7-3	TRBJ2-7
TGTGCCAGCAGGGACAGGGGAGGGTACGAGCAGTACTTC	CASRDRGGYEQYF	TRBV2	TRBJ2-7
TGCAGTGCTAGTAGGGGAAGTTTTACCTTTAATTCACCCCTCCACTTT	CSASRGSFTFNSPLHF	TRBV20-1	TRBJ1-6
TGTGCCAGCAGTGCGGCTCCGAACACTGAAGCTTTCTTT	CASSAAPNTEAFF	TRBV6-4	TRBJ1-1
TGTGCCAGCAGACCGCGACAGAGGTATAATTCACCCCTCCACTTT	CASRPRQRYNSPLHF	TRBV6-3	TRBJ1-6
TGTGCCAGCAGCGCAACCGTAACGCTAAATCAGCCCCAGCATTTT	CASSATVTLNQPQHF	TRBV5-6	TRBJ1-5
TGTGCCACCACCCCGTGGGAGCCCATGCAGTTCTTC	CATTPWEPMQFF	TRBV24-1	TRBJ2-1
TGTGCCAAAAAGGGCCAAGCCTACGAGCAGTACTTC	CAKKGQAYEQYF	TRBV19	TRBJ2-7
TGTGCCAGCAGCTCGTCAGGGGGGTCGCTCCGAAGCTCCTATAATTCACCCCTCCACTTT	CASSSSGGSLRSSYNSPLHF	TRBV14	TRBJ1-6
TGTGCCAGCAGCGTAGCTATTCAATGGAGCCCGATGAATGAAAAACTGTTTTTT	CASSVAIQWSPMNEKLFF	TRBV9	TRBJ1-4
TGTGCCAGCAGCTTAGGCAGCACGGGTTTCTATGGCTACACCTTC	CASSLGSTGFYGYTF	TRBV7-9	TRBJ1-2
TGTGCCAGCAGCTCTCAGGACAGGGCTGCCAAAAACATTCAGTACTTC	CASSSQDRAAKNIQYF	TRBV7-3	TRBJ2-4
TGCGCCAGCAGCCAGATACGTCTAGCGTACGAGCAGTACTTC	CASSQIRLAYEQYF	TRBV4-1	TRBJ2-7
TGTGCCAGCAGTGCAGCGGGAGGAAGAACAACTAATGAAAAACTGTTTTTT	CASSAAGGRTTNEKLFF	TRBV6-4	TRBJ1-4
TGTGCCAGCAAGAACGCTTTCTACGAGCAGTACTTC	CASKNAFYEQYF	TRBV6-4	TRBJ2-7
TGTGCCAGAAACACTAGCGGGAGCCCCCTCACAGATACGCAGTATTTT	CARNTSGSPLTDTQYF	TRBV12-3	TRBJ2-3
TGTGCCAGCAGCTTAACACCTCTAGCGGTAGGTGGTCGAGCAGATACGCAGTATTTT	CASSLTPLAVGGRADTQYF	TRBV7-4	TRBJ2-3
TGCAGTGCGGGGCAGGCCGAGACCCAGTACTTC	CSAGQAETQYF	TRBV20-1	TRBJ2-5
TGCGCCAGCAGCTGGCTGTTGGACAGGCCACGGAGCTCTGGAAACACCATATATTTT	CASSWLLDRPRSSGNTIYF	TRBV5-1	TRBJ1-3
TGTGCCAGCAGTTACGGAGTGAATGAGCAGTTCTTC	CASSYGVNEQFF	TRBV12-3	TRBJ2-1
TGTGCCAGCAAAACCTCAGGGTTGGGCTACGAGCAGTACTTC	CASKTSGLGYEQYF	TRBV6-1	TRBJ2-7
TGCGCCAGCAGCCTAGATGGGACTGGAAACACCATATATTTT	CASSLDGTGNTIYF	TRBV5-1	TRBJ1-3
TGCGCCAGCAGCTTTCCGAACCTCGGGGAGCTGTTTTTT	CASSFPNLGELFF	TRBV5-1	TRBJ2-2
TGCAGCGCGACGGGGAAGAATGGGAGGATTTCACCCCTCCACTTT	CSATGKNGRISPLHF	TRBV29-1	TRBJ1-6
TGTGCCAGCAGCTTGCAACAGAGCATTTTAGCAACTAATGAAAAACTGTTTTTT	CASSLQQSILATNEKLFF	TRBV5-5	TRBJ1-4
TGTGCCTGGATCCCACAGGGCCGGAACACTGAAGCTTTCTTT	CAWIPQGRNTEAFF	TRBV30	TRBJ1-1
TGTGCCAGCAGCTTAGCTAATCCGACAGGCTACACCTTC	CASSLANPTGYTF	TRBV7-2	TRBJ1-2
TGTGCCACCAGTGATCGGGCCCAAGAGACCCAGTACTTC	CATSDRAQETQYF	TRBV24-1	TRBJ2-5
TGTGCCAGCAGCCAAGGGACAGGGGATAGCCCTGGAAACACCATATATTTT	CASSQGTGDSPGNTIYF	TRBV14	TRBJ1-3
TGTGCCAGTAGTATCCCCAAGTTCTCCCTCCGGGACAGGGCCCCCTACTATGGCTACACCTTC	CASSIPKFSLRDRAPYYGYTF	TRBV19	TRBJ1-2
TGTGCCTGGAGTGGAATCCGGGGACACCCCACTGAAGCTTTCTTT	CAWSGIRGHPTEAFF	TRBV30	TRBJ1-1
TGTGCCAGCAGCTTAGATGGGGGGTCCTACGAGCAGTACTTC	CASSLDGGSYEQYF	TRBV11-3	TRBJ2-7
TGTGCCAGCAGGAAACAGGGGGCTCCGGCCACTGAAGCTTTCTTT	CASRKQGAPATEAFF	TRBV7-6	TRBJ1-1
TGTGCCAGCAGTTCTGGGACAGGGGGGAAATTCGAAGCTTTCTTT	CASSSGTGGKFEAFF	TRBV2	TRBJ1-1
TGTGCCAGCACAGCAGTCCTAGTGGGGGGCGAGCAGTACTTC	CASTAVLVGGEQYF	TRBV7-6	TRBJ2-7
TGTGCCAGCAGTACCAACGGCGGGTGGAGGGGCAATGAAAAACTGTTTTTT	CASSTNGGWRGNEKLFF	TRBV27	TRBJ1-4
TGTGCCAGCAGTTTAACCCAGGACAAGAGGAGGACCTACGAGCAGTACTTC	CASSLTQDKRRTYEQYF	TRBV28	TRBJ2-7
TGTGCCAGCAGGGACGCCTCGGGGGGGGGGCGAAGCACAGATACGCAGTATTTT	CASRDASGGGRSTDTQYF	TRBV6-1	TRBJ2-3
TGTGCCAGCAGCTCTCGGAACACTGAAGCTTTCTTT	CASSSRNTEAFF	TRBV7-3	TRBJ1-1
TGTGCCAGCAGCCAGTTAGCGGGCGAAGAGACCCAGTACTTC	CASSQLAGEETQYF	TRBV7-2	TRBJ2-5
TGTGCCAGCATCCCCCTGCCGGGACTAGCGGCCAATGAGCAGTTCTTC	CASIPLPGLAANEQFF	TRBV25-1	TRBJ2-1
TGTGCCAGTAGTATCGGGGCCACATACGAGCAGTACTTC	CASSIGATYEQYF	TRBV19	TRBJ2-7
TGTGCCAGCAGCCAAGAAGGCGGGACCTATAATTCACCCCTCCACTTT	CASSQEGGTYNSPLHF	TRBV14	TRBJ1-6
TGTGCCAGCTCAGGGGAAAGCCTCGAGCAGTTCTTC	CASSGESLEQFF	TRBV18	TRBJ2-1
TGCAGTGCACCTAGCGGGTCGGCCTACGAGCAGTACTTC	CSAPSGSAYEQYF	TRBV20-1	TRBJ2-7
TGTGCCAGCAGCTTAAATCCGCACCCGTCCGTCTTC	CASSLNPHPSVF	TRBV7-2	TRBJ1-2
TGCACTAGGGGACAGGGCACTAGCACAGATACGCAGTATTTT	CTRGQGTSTDTQYF	TRBV29-1	TRBJ2-3
TGTGCCAGCAGCCCGACAGGGACGCAAGAGACCCAGTACTTC	CASSPTGTQETQYF	TRBV7-3	TRBJ2-5
TGTGCCAATCACGGGACAGGTACGCAGTATTTT	CANHGTGTQYF	TRBV6-4	TRBJ2-3
TGCGCCAGCAGCCAAGATCTACTAGCGGGAGAGGGGGGGCACGAGCAGTACTTC	CASSQDLLAGEGGHEQYF	TRBV4-1	TRBJ2-7
TGTGCCAGCAGCTTAACCTGGCAGGGACCGAACAATGAGCAGTTCTTC	CASSLTWQGPNNEQFF	TRBV11-3	TRBJ2-1
TGTGCCACCGGGGGCTCCCTCCACTTT	CATGGSLHF	TRBV27	TRBJ1-6
TGTGCCAGCCGAAATGAAAAACTGTTTTTT	CASRNEKLFF	TRBV2	TRBJ1-4
TGCAGTGCTGAGATGCGGGGTGCGGTATTAAACTATGGCTACACCTTC	CSAEMRGAVLNYGYTF	TRBV20-1	TRBJ1-2
TGTGCCAGCAGTCCAATTCCGGAGAGGGGGGGGCTCAATGAGCAGTTCTTC	CASSPIPERGGLNEQFF	TRBV27	TRBJ2-1
TGTGCCACCAGTGTCGTGATGTCCAGCACAGATACGCAGTATTTT	CATSVVMSSTDTQYF	TRBV24-1	TRBJ2-3
TGTGCCACAAGTACCGGTAGCAATCAGCCCCAGCATTTT	CATSTGSNQPQHF	TRBV10-3	TRBJ1-5
TGTGCCAGCAGCTCGGGGGCACGCTATGGCTACACCTTC	CASSSGARYGYTF	TRBV7-2	TRBJ1-2
TGTGCCACCAGTCAGGCTGGACTAATGCCACAGCCCCAGCATTTT	CATSQAGLMPQPQHF	TRBV24-1	TRBJ1-5
TGTGCCAGCAGCCAATCAGGACAGTATGAGCAGTACTTC	CASSQSGQYEQYF	TRBV14	TRBJ2-7
TGTGCCAGCAAAACTGGGGCGGGTCCCTCCTTCTTT	CASKTGAGPSFF	TRBV6-5	TRBJ1-1
TGTGCTAGTGGTTTGAGTGGACCCCTAGCTTCCTACGAGCAGTACTTC	CASGLSGPLASYEQYF	TRBV12-5	TRBJ2-7
TGCAGCGTGCGGGACAGGGTCTTCACTGAAGCTTTCTTT	CSVRDRVFTEAFF	TRBV29-1	TRBJ1-1
TGTGCCAGCAGTGACGACTCCAGGGCTAACTCCTACGAGCAGTACTTC	CASSDDSRANSYEQYF	TRBV6-4	TRBJ2-7
TGTGCCAGCAGAACCCAGGTGGCTAGTGGGGACTACGAGCAGTACTTC	CASRTQVASGDYEQYF	TRBV6-4	TRBJ2-7
TGCGCCAGCAGTCATTCCGACAGGGCCGGTACCAATGAGCAGTTCTTC	CASSHSDRAGTNEQFF	TRBV10-1	TRBJ2-1
TGCGCCAGCAGCCGGGGCTACTGGGCGGGACTAGCGCCGGACCCCAACAATGAGCAGTTCTTC	CASSRGYWAGLAPDPNNEQFF	TRBV5-1	TRBJ2-1
TGTGCCACTCCCCTAGCGGGGCAGACCCAGTACTTC	CATPLAGQTQYF	TRBV25-1	TRBJ2-5
TGTGCCAGCAGTACCCGAGTCCCGGACAGGGGGCGACGCAATCAGCCCCAGCATTTT	CASSTRVPDRGRRNQPQHF	TRBV28	TRBJ1-5
TGCGCCAGCATGCAGGGGGGGCCTTCCTACACCATATATTTT	CASMQGGPSYTIYF	TRBV10-1	TRBJ1-3
TGTGCCAGCAGCCATCGGGTCCTGCCCCAGCATTTT	CASSHRVLPQHF	TRBV7-8	TRBJ1-5
TGCGCCACTTCCGGTAGTGGGAGAGCCAAAAACATTCAGTACTTC	CATSGSGRAKNIQYF	TRBV10-1	TRBJ2-4
TGTGCCACCAGCAGTAGGAGCACAGATACGCAGTATTTT	CATSSRSTDTQYF	TRBV15	TRBJ2-3
TGTGCCAGCAGAGGGGGAATACAGCCCCAGCATTTT	CASRGGIQPQHF	TRBV6-6	TRBJ1-5
TGTGCCAGCACGAGGAGGGACAGAGGCCCGGGGTCTGGAAACACCATATATTTT	CASTRRDRGPGSGNTIYF	TRBV14	TRBJ1-3
TGTGCCAGCAGTTTAACCCGACCAACGACAGGGCCGTCCTATGGCTACACCTTC	CASSLTRPTTGPSYGYTF	TRBV12-3	TRBJ1-2
TGCGCCAGCAGCTTCCCTATATGGACTAGCGGGGTGGGGAAAGATAACAATGAGCAGTTCTTC	CASSFPIWTSGVGKDNNEQFF	TRBV5-1	TRBJ2-1
TGCGCCATAGGTAGGACAGGGCTCGGGTGGTTTAACACCATATATTTT	CAIGRTGLGWFNTIYF	TRBV10-1	TRBJ1-3
TGTGCCAGCAGCCAAGGTTTACTGACAGAGAAGGGGTACGAGCAGTACTTC	CASSQGLLTEKGYEQYF	TRBV14	TRBJ2-7
TGTGCCACCAGTGAGGACAGGGGGGTGTATGAAGCTTTCTTT	CATSEDRGVYEAFF	TRBV24-1	TRBJ1-1
TGTGCCACGGAGGCCGGGACAGGGGCAGATACGCAGTATTTT	CATEAGTGADTQYF	TRBV10-3	TRBJ2-3
TGTGCCAGCAGCGCTACGACTAGCGGGAGGGCCCGATCTGAAAAACTGTTTTTT	CASSATTSGRARSEKLFF	TRBV13	TRBJ1-4
TGTGCCAGCAGCTTAACCCAGGGGGAAGAGACCCAGTACTTC	CASSLTQGEETQYF	TRBV7-3	TRBJ2-5
TGTGCCTTAAGAACCCCGAACACCGGGGAGCTGTTTTTT	CALRTPNTGELFF	TRBV30	TRBJ2-2
TGTGCCAGCAGTGACGTGGTCGGGGGGCGAGGCTACGAGCAGTACTTC	CASSDVVGGRGYEQYF	TRBV6-4	TRBJ2-7
TGTGCCAGCAGTTCCAGAACAGGGGATGGTCTCTACAATGAGCAGTTCTTC	CASSSRTGDGLYNEQFF	TRBV6-5	TRBJ2-1
TGTGCCAGCAGTTACTATGGCAGGGAGGGACGCTACGAGCAGTACTTC	CASSYYGREGRYEQYF	TRBV6-5	TRBJ2-7
TGTGCCAGCAGCCACATGGACAGGGGCCCCTACGAGCAGTACTTC	CASSHMDRGPYEQYF	TRBV14	TRBJ2-7
TGTGCCAGCAGAGGCAGGGCAAACACCGGGGAGCTGTTTTTT	CASRGRANTGELFF	TRBV27	TRBJ2-2
TGTGCCAGCAGTTACTCTGCAGGGGGGACAGGGGTTGCCGGGGAGCTGTTTTTT	CASSYSAGGTGVAGELFF	TRBV6-3	TRBJ2-2
TGCGCCATTCGGGGACCCCGGACTAGCGGGATTCAAGAGACCCAGTACTTC	CAIRGPRTSGIQETQYF	TRBV4-3	TRBJ2-5
TGTGCCAGCAGCCGGGGGGACGCTGGAAACACCATATATTTT	CASSRGDAGNTIYF	TRBV7-3	TRBJ1-3
TGTGCCAGCAGGGTTTGGCCCCAGGGCAGCAATCAGCCCCAGCATTTT	CASRVWPQGSNQPQHF	TRBV28	TRBJ1-5
TGTGCCAGCAGCTTCCGACTAGCGGAAACCTACGAGCAGTACTTC	CASSFRLAETYEQYF	TRBV5-4	TRBJ2-7
TGTGCCACCAGTGATTTTCGTCCCCAGGGTCAAGAGACCCAGTACTTC	CATSDFRPQGQETQYF	TRBV24-1	TRBJ2-5
TGTGCCACCAGTGATGCGAAGGAGCCTATTCTCTATGAGCAGTTCTTC	CATSDAKEPILYEQFF	TRBV24-1	TRBJ2-1
TGCAGCGTTGAGAGTCGCCGGGACATTTACAATGAGCAGTTCTTC	CSVESRRDIYNEQFF	TRBV29-1	TRBJ2-1
TGTGCCAGCAGTTGCCGGGACTACCTAGAAATCAATGAGCAGTTCTTC	CASSCRDYLEINEQFF	TRBV12-4	TRBJ2-1
TGTGCCAGCAGCTTAGACGGGGTGGGGACGTCGAGCTCTGGAAACACCATATATTTT	CASSLDGVGTSSSGNTIYF	TRBV11-3	TRBJ1-3
TGTGCCACCAGCAGAGCTCGGGGAGGGTTACTCATTCAGTACTTC	CATSRARGGLLIQYF	TRBV15	TRBJ2-4
TGTGCCAGCAACGGACAGGGGGGGAATGAAAAACTGTTTTTT	CASNGQGGNEKLFF	TRBV14	TRBJ1-4
TGTGCCAGCAGCTTATTCCGTCACTACGGGTACGAGCAGTACTTC	CASSLFRHYGYEQYF	TRBV5-5	TRBJ2-7
TGTGCCAGCAGTGCGACTCGAGGACAATCGAACACTGAAGCTTTCTTT	CASSATRGQSNTEAFF	TRBV6-4	TRBJ1-1
TGTGCCAGCAGCGCAGGGGCCTACGAGCAGTACTTC	CASSAGAYEQYF	TRBV14	TRBJ2-7
TGTGCCAGCAGCGTCAGGGGGGCTACCGAGACCCAGTACTTC	CASSVRGATETQYF	TRBV9	TRBJ2-5
TGTGCCAGCGGTAGGACTAGCGGGTCCGAGCAGTACTTC	CASGRTSGSEQYF	TRBV6-5	TRBJ2-7
TGTGCCAGCAGCCCGCCAGGGCCCGAGACCCAGTACTTC	CASSPPGPETQYF	TRBV13	TRBJ2-5
TGTGCCACCAGTGAGTCTGAGGCCGGCGACACCGATGGCTACACCTTC	CATSESEAGDTDGYTF	TRBV24-1	TRBJ1-2
TGTGCCAGCAGTCCAGGGGGCGGGTATGGCTACACCTTC	CASSPGGGYGYTF	TRBV28	TRBJ1-2
TGTGCCAGCCCCTGGACTAGCGGGGGGCGCCCGAACACCGGGGAGCTGTTTTTT	CASPWTSGGRPNTGELFF	TRBV25-1	TRBJ2-2
TGTGCCAGCAGCCAAGGGGACAGGAAATCTGAAGCTTTCTTT	CASSQGDRKSEAFF	TRBV14	TRBJ1-1
TGCAGTGCTATACGTAGTGGGACAGGGGCCAAGGAGACCCAGTACTTC	CSAIRSGTGAKETQYF	TRBV20-1	TRBJ2-5
TGCAGTGCCCCTGGGGGGAGAACCTCAGATACGCAGTATTTT	CSAPGGRTSDTQYF	TRBV20-1	TRBJ2-3
TGCAGTGCTCCCGGACAGGGGGCAAAGTATAGCAATCAGCCCCAGCATTTT	CSAPGQGAKYSNQPQHF	TRBV20-1	TRBJ1-5
TGTGCCAGCACCTCAACAGGGAAGCCAGAATGCTACGAGCAGTACTTC	CASTSTGKPECYEQYF	TRBV3-1	TRBJ2-7
TGTGAAACTTGGCGGGACACTCTCGAGACCCAGTACTTC	CETWRDTLETQYF	TRBV25-1	TRBJ2-5
TGCGCCAGCAGCCAACCCCGGACTAGCGGGCCAGAGCAGTTCTTC	CASSQPRTSGPEQFF	TRBV4-1	TRBJ2-1
TGTGCCAATTTTGGACTAGCGGGGACCGGGACAGATACGCAGTATTTT	CANFGLAGTGTDTQYF	TRBV28	TRBJ2-3
TGTGCCAGCAAAGATTTTGGACTGGATCAGCCCCAGCATTTT	CASKDFGLDQPQHF	TRBV27	TRBJ1-5
TGCGCCAGCAGCTTGGAAAATAGGCGGGACCTATCTGGAAACACCATATATTTT	CASSLENRRDLSGNTIYF	TRBV5-1	TRBJ1-3
TGTGCCAGCAGTGAGGGGTTCTTCAATCAGCCCCAGCATTTT	CASSEGFFNQPQHF	TRBV25-1	TRBJ1-5
TGTGCCAGCAGCCAAGACAAGGGGGGGGGGGGTGTTACCAAAAACATTCAGTACTTC	CASSQDKGGGGVTKNIQYF	TRBV14	TRBJ2-4
TGTGCCAGCAGCTTGGCCCAGCCTAATGAAAAACTGTTTTTT	CASSLAQPNEKLFF	TRBV5-6	TRBJ1-4
TGTGCCAGCAGGGGTTTTAGGGCCACGACTGAAGCTTTCTTT	CASRGFRATTEAFF	TRBV28	TRBJ1-1
TGCGCCAGCAGCCAAGACCCCAGCAATGAGCAGTTCTTC	CASSQDPSNEQFF	TRBV4-3	TRBJ2-1
TGTGCCAGCAGTGACTGCAGGAGCTATGGCTACACCTTC	CASSDCRSYGYTF	TRBV6-4	TRBJ1-2
TGTGCCAGCAGCCAAGCCCCGGGACAGGGGGAAGCTGGAAACACCATATATTTT	CASSQAPGQGEAGNTIYF	TRBV14	TRBJ1-3
TGCGCCAGCAGCTTGGTGAGGGGACAGGTAGCTTTCTTT	CASSLVRGQVAFF	TRBV5-1	TRBJ1-1
TGTGCCAGCAGTTACAACCTGCGTTTCTTC	CASSYNLRFF	TRBV6-5	TRBJ2-1
TGTGCCAGCACAAATACCCCACTCCGAGTTATATATAGCAATCAGCCCCAGCATTTT	CASTNTPLRVIYSNQPQHF	TRBV6-4	TRBJ1-5
TGTGCCAGCAGCTTAGGACAGGGGTGCCAGTGGACTGAAGCTTTCTTT	CASSLGQGCQWTEAFF	TRBV7-7	TRBJ1-1
TGTGCCAGCAGCGCTCTGAGGGGGGCCAAGACTGGCAATGAGCAGTTCTTC	CASSALRGAKTGNEQFF	TRBV7-9	TRBJ2-1
TGCAGTGCTTCTGCCCACTTGGCCTACGAGCAGTACTTC	CSASAHLAYEQYF	TRBV20-1	TRBJ2-7
TGTGCCAGCAGGTACTTCAACACCGGGGAGCTGTTTTTT	CASRYFNTGELFF	TRBV11-2	TRBJ2-2
TGTGCCAGCAGTTCCCGGGACAGGTGTCCAACCGGGGAGCTGTTTTTT	CASSSRDRCPTGELFF	TRBV27	TRBJ2-2
TGTGCCAGCAGCCCGGGGGGACCCCCCTGTGACCAAGAGACCCAGTACTTC	CASSPGGPPCDQETQYF	TRBV3-1	TRBJ2-5
TGTGCCACCAGTGAACCAGACAGGGTTCTTCAAAGCTACGAGCAGTACTTC	CATSEPDRVLQSYEQYF	TRBV24-1	TRBJ2-7
TGTCACCGGGACAGCGTGAAACGCTATGGCTACACCTTC	CHRDSVKRYGYTF	TRBV14	TRBJ1-2
TGCGCCAGCAGCAAGCAGGAAAGCTCCTACGAGCAGTACTTC	CASSKQESSYEQYF	TRBV5-1	TRBJ2-7
TGTGCCAGCAGCCAACGACCTCCTCCGACCTACAATGAGCAGTTCTTC	CASSQRPPPTYNEQFF	TRBV14	TRBJ2-1
TGTGGACTGGATTATAGCAATCAGCCCCAGCATTTT	CGLDYSNQPQHF	TRBV7-9	TRBJ1-5
TGTGCCAGCAGCCAAGACCCGGGACCGGGGAATGAAAAACTGTTTTTT	CASSQDPGPGNEKLFF	TRBV3-1	TRBJ1-4
TGTGCCTGGAGTGTGACGGGACAGGGGAATCAGCCCCAGCATTTT	CAWSVTGQGNQPQHF	TRBV30	TRBJ1-5
TGTGCCAGCAGTTTAGTAAGGACTAGCGGGAGCCACACTGAAGCTTTCTTT	CASSLVRTSGSHTEAFF	TRBV27	TRBJ1-1
TGCGCCAGCAGCATGGGTTCAGGGGCGAAGAACACCGGGGAGCTGTTTTTT	CASSMGSGAKNTGELFF	TRBV5-1	TRBJ2-2
TGTGCCAGCACCCGGGAGAACCCGAACACCGGGGAGCTGTTTTTT	CASTRENPNTGELFF	TRBV7-3	TRBJ2-2
TGCGCCAGCAGTGACCGGGGCTGGATGAACACTGAAGCTTTCTTT	CASSDRGWMNTEAFF	TRBV10-1	TRBJ1-1
TGTGCCAGCAGCCAAAGGGGTAGAGATCAGCCCCAGCATTTT	CASSQRGRDQPQHF	TRBV14	TRBJ1-5
TGTGCCAGCGGGGGGACTCAAAGCGAGACCCAGTACTTC	CASGGTQSETQYF	TRBV28	TRBJ2-5
TGTGCCAGCAGCCAAGGTGCCTCGCCAGTCCCGCAGTACTTC	CASSQGASPVPQYF	TRBV3-1	TRBJ2-7
TGTGCCAGCAGTGATAGGGAACAAGAGACCCAGTACTTC	CASSDREQETQYF	TRBV6-6	TRBJ2-5
TGTGCCAGCAGCTTTACTATGGGACAGCCACGCGGAGAAAAACTGTTTTTT	CASSFTMGQPRGEKLFF	TRBV7-9	TRBJ1-4
TGTGCCAGCAGCAAACCAGACAGGGGTAGGACTACTGAAGCTTTCTTT	CASSKPDRGRTTEAFF	TRBV7-9	TRBJ1-1
TGTGCCAGCAGTTTACCGTGGTGCACCGGCATCCGCGAGCAGTACTTC	CASSLPWCTGIREQYF	TRBV12-4	TRBJ2-7
TGTGCCAGCAGCTGGTGGCGGGAGGACGCCTCCGGGGAGCTGTTTTTT	CASSWWREDASGELFF	TRBV11-3	TRBJ2-2
TGTGCTAGCAGCTTAGCCGGACTCACTCGGGGAAGCTATGGCTACACCTTC	CASSLAGLTRGSYGYTF	TRBV7-7	TRBJ1-2
TGTGCCAGCAGCCTAATGGCAGGGGGGACTGAAGCTTTCTTT	CASSLMAGGTEAFF	TRBV7-3	TRBJ1-1
TGTGCCACAAGCCAGCTTGAAAAACTGTTTTTT	CATSQLEKLFF	TRBV10-3	TRBJ1-4
TGCAGTGCGGCAGGATGGGAATATAGCAATCAGCCCCAGCATTTT	CSAAGWEYSNQPQHF	TRBV20-1	TRBJ1-5
TGTGCCAGCGCTAAACCGAGGGGGCATGACGAGCAGTACTTC	CASAKPRGHDEQYF	TRBV7-9	TRBJ2-7
TGTGCCAGCAGAGGGACTAGCGGGAGGGGCTGGGACTACGAGCAGTACTTC	CASRGTSGRGWDYEQYF	TRBV6-6	TRBJ2-7
TGCAGTGCTCCCGTCGTTCGCCATACGCAGTATTTT	CSAPVVRHTQYF	TRBV20-1	TRBJ2-3
TGTGCCAGTAGTAAGATCGCATATTCACCCCTCCACTTT	CASSKIAYSPLHF	TRBV19	TRBJ1-6
TGTGCCAGCATAATGGGGGCCGGGACCCAGTACTTC	CASIMGAGTQYF	TRBV6-1	TRBJ2-5
TGTGCCAGGATACCTCCGGGTGGCGCCTACAATGAGCAGTTCTTC	CARIPPGGAYNEQFF	TRBV19	TRBJ2-1
TGTGCCTGGAGTGTCGGGGGGGGCAATGAGCAGTTCTTC	CAWSVGGGNEQFF	TRBV30	TRBJ2-1
TGTGCCAGCAGCCGGTCAGAAACCACTGAAGCTTTCTTT	CASSRSETTEAFF	TRBV5-4	TRBJ1-1
TGTGCCAGCAGCACCCGGACCGGGGAGCTGTTTTTT	CASSTRTGELFF	TRBV11-2	TRBJ2-2
TGTGCCAGCAGCCAGCGGGGGGGGTATGGCTACACCTTC	CASSQRGGYGYTF	TRBV3-1	TRBJ1-2
TGTGCCAGCAGCGTAAAAGGGGGCAAGGAGAACTACGAGCAGTACTTC	CASSVKGGKENYEQYF	TRBV9	TRBJ2-7
TGTGCCCCCGGGGGGGCCCAATTGGACATTCAGTACTTC	CAPGGAQLDIQYF	TRBV27	TRBJ2-4
TGTGCCAGCATAAGTCAAAACCTGACCGGGACAGGGGGCGGGGGAGACTCCTACGAGCAGTACTTC	CASISQNLTGTGGGGDSYEQYF	TRBV6-4	TRBJ2-7
TGTGCCAGCAGCTCTTTAGGGACTTTTGGTATCTACGAGCAGTACTTC	CASSSLGTFGIYEQYF	TRBV7-9	TRBJ2-7
TGTGCCAGCAGGCCGGGGGGCCATGGCTACACCTTC	CASRPGGHGYTF	TRBV6-5	TRBJ1-2
TGTGCCAGCGGTTGCAAGACGCGGCAGTACTTC	CASGCKTRQYF	TRBV7-4	TRBJ2-7
TGTGCCAGCAGCTCCTTGGGGACAGGGTGGGGGTGGAATGACACTGAAGCTTTCTTT	CASSSLGTGWGWNDTEAFF	TRBV7-3	TRBJ1-1
TGTGCCAGCAGTGACTCGACCGAAAGGGGGGGGGGCACAGATACGCAGTATTTT	CASSDSTERGGGTDTQYF	TRBV6-4	TRBJ2-3
TGTGCCAGCAGTTTGTTTGGGCATAGGTACCAAGAGACCCAGTACTTC	CASSLFGHRYQETQYF	TRBV27	TRBJ2-5
TGTGCCAGCAGCGGGGGACGAAGCGAGCAGTACTTC	CASSGGRSEQYF	TRBV7-9	TRBJ2-7
TGTGCCAGCCCCGCCGGGACAGGGGGTTACTATGGCTACACCTTC	CASPAGTGGYYGYTF	TRBV28	TRBJ1-2
TGTGCCTGGAGGAAAGGGGGGTTACCGAACGAGCAGTACTTC	CAWRKGGLPNEQYF	TRBV30	TRBJ2-7
TGCGCCAGCAGCCAAGATCTTAGGACGCACAGGGACACCTACGAGCAGTACTTC	CASSQDLRTHRDTYEQYF	TRBV4-3	TRBJ2-7
TGCGCCAGCAGCGGGGTTCGATTCGACCCCTATGGCTACACCTTC	CASSGVRFDPYGYTF	TRBV5-1	TRBJ1-2
TGTGCCAGCAGCTTACACAATTTTATGGCCAATCAGCCCCAGCATTTT	CASSLHNFMANQPQHF	TRBV11-2	TRBJ1-5
TGTGCCAGCAGCTGCGAGGCCGGGGAGCTGTTTTTT	CASSCEAGELFF	TRBV13	TRBJ2-2
TGCGCCAGCAGTGAGACAGGGGTTACCAAAGGAAACACCATATATTTT	CASSETGVTKGNTIYF	TRBV10-1	TRBJ1-3
TGTGCCAGCAGTCCAAACAGTCAGCACACTGAAGCTTTCTTT	CASSPNSQHTEAFF	TRBV6-2	TRBJ1-1
TGCGCCAGCAGCCAAGATTCCCGGGGGGAGGGATGCAATGAGCAGTTCTTC	CASSQDSRGEGCNEQFF	TRBV4-3	TRBJ2-1
TGTGCCAGCACGTGCCCGGGGGGGCGAGATACGCAGTATTTT	CASTCPGGRDTQYF	TRBV28	TRBJ2-3
TGTGCCTGGAGCTACGGGACGGGACTAAACAATGAGCAGTTCTTC	CAWSYGTGLNNEQFF	TRBV30	TRBJ2-1
TGTGCCAGCAGGGGGGGGGCCGGTTCGGATGTTCATTGTACCGGGGAGCTGTTTTTT	CASRGGAGSDVHCTGELFF	TRBV27	TRBJ2-2
TGTGCCACCAGTGACGAGACGGGTCAAAACACTGAAGCTTTCTTT	CATSDETGQNTEAFF	TRBV24-1	TRBJ1-1
TGTGCCAGCAGGCGGGAGGGACACCTCAGCAATCAGCCCCAGCATTTT	CASRREGHLSNQPQHF	TRBV6-3	TRBJ1-5
TGTGCCAGCAGTGGAACCCTAGGGCGGGGACGATTCCTGAAAGAGACCCAGTACTTC	CASSGTLGRGRFLKETQYF	TRBV28	TRBJ2-5
TGTGCCAGCAGCCGGACTAGCGGGGGGGCCATCTCCTACGAGCAGTACTTC	CASSRTSGGAISYEQYF	TRBV5-4	TRBJ2-7
TGCAGTGCTCTAGGGAGGGTAACCGAGCAGTACTTC	CSALGRVTEQYF	TRBV20-1	TRBJ2-7
TGCAGTGCTAGCACTTTGGGACGGGGAGTCTGCGAGCAGTACTTC	CSASTLGRGVCEQYF	TRBV20-1	TRBJ2-7
TGTGCCAGCAGCTTAGCTCGGCTTTCTGGGGAGCAGTACTTC	CASSLARLSGEQYF	TRBV11-2	TRBJ2-7
TGTGCGGAGAGGTTCATAACCTACGAGCAGTACTTC	CAERFITYEQYF	TRBV6-2	TRBJ2-7
TGTGCCAGCAGCCAAGACGGGGGGTTTTGGGCGTACCAAGAGACCCAGTACTTC	CASSQDGGFWAYQETQYF	TRBV4-2	TRBJ2-5
TGCGCCAGCAGCCAAGAACCCCCGACAGGGGGGTGGCAGTACTTC	CASSQEPPTGGWQYF	TRBV4-3	TRBJ2-5
TGTGCCAGCAGTTTACGGCCACCCCGGACTAGCGGGGGGCCCTACGAGCAGTACTTC	CASSLRPPRTSGGPYEQYF	TRBV12-3	TRBJ2-7
TGCAGTGCTAGAGTACCCCGGGGGACCTATAGCAATCAGCCCCAGCATTTT	CSARVPRGTYSNQPQHF	TRBV20-1	TRBJ1-5
TGTGCCAGCAGTTACTCGAGGGTGTGGGACAGGGGTCAGCCCCAGCATTTT	CASSYSRVWDRGQPQHF	TRBV6-5	TRBJ1-5
TGTGCCAGCAGCGGGGACAGGGCTGAGGCTGGAAACACCATATATTTT	CASSGDRAEAGNTIYF	TRBV9	TRBJ1-3
TGTGCCAGCAGCAATTTCAACCGACTAGCGGTCCCTAGCACAGATACGCAGTATTTT	CASSNFNRLAVPSTDTQYF	TRBV13	TRBJ2-3
TGTGCCAGCAGTGTACTCCTGACAGGGGGGCCAGGGGGCTACAATGAGCAGTTCTTC	CASSVLLTGGPGGYNEQFF	TRBV6-5	TRBJ2-1
TGTGCCAGCAGCCAAGATCTTGGCATCCCGGGGGTCACGCTGAACACTGAAGCTTTCTTT	CASSQDLGIPGVTLNTEAFF	TRBV14	TRBJ1-1
TGTGCCACCAGTGGGGCCCCGGGACTAGAGCAAGAGACCCAGTACTTC	CATSGAPGLEQETQYF	TRBV24-1	TRBJ2-5
TGCGCCAGCAGCTTGGTGCGGTCGCGGGACTACAATGAGCAGTTCTTC	CASSLVRSRDYNEQFF	TRBV5-1	TRBJ2-1
TGTGCCAGCAGTTACTGTCTGGGGGGGGAGAATGAGCAGTTCTTC	CASSYCLGGENEQFF	TRBV6-5	TRBJ2-1
TGTGCCAGCAGCCGCGGCCTACTTAGTTTGAACACCGGGGAGCTGTTTTTT	CASSRGLLSLNTGELFF	TRBV9	TRBJ2-2
TGTGCCATCAGATCAGGGTACTACGAGCAGTACTTC	CAIRSGYYEQYF	TRBV10-3	TRBJ2-7
TGTGCCATTACTAGCGGGAGTAGCACAGATACGCAGTATTTT	CAITSGSSTDTQYF	TRBV19	TRBJ2-3
TGTGCCAGCTTGGCAGGGGAACCGAAGCGGACCTACGAGCAGTACTTC	CASLAGEPKRTYEQYF	TRBV6-4	TRBJ2-7
TGTGTGGTCCCCAGACAGGGATGGTACAATGAGCAGTTCTTC	CVVPRQGWYNEQFF	TRBV24-1	TRBJ2-1
TGTGCCAGCAGCCTAGGGGGCTCTGGAAACACCATATATTTT	CASSLGGSGNTIYF	TRBV4-2	TRBJ1-3
TGCAGTGCTAGAGGGCCGGTCTTTGGGCGTCGTAACTATGGCTACACCTTC	CSARGPVFGRRNYGYTF	TRBV20-1	TRBJ1-2
TGTGCCAGCAGCGTACTAGCGGGAGAAGTGCAGCCCCAGCATTTT	CASSVLAGEVQPQHF	TRBV9	TRBJ1-5
TGTGCCAGCAGCCAAGATCGGTATAGGAAGGGAGGGGGCAATGAGCAGTTCTTC	CASSQDRYRKGGGNEQFF	TRBV14	TRBJ2-1
TGTGCCAGCAGCGTCGGACAGGGGGCGACCCAGTACTTC	CASSVGQGATQYF	TRBV7-9	TRBJ2-5
TGTGCCAGCAGTTGCACGGGACTAGCGGGACCTTTAATATACGAGCAGTACTTC	CASSCTGLAGPLIYEQYF	TRBV6-1	TRBJ2-7
TGTGCCAGCAGTTACATCACCAGAATGGGGGCAACTAATGAAAAACTGTTTTTT	CASSYITRMGATNEKLFF	TRBV6-5	TRBJ1-4
TGTGCCGACAGACTTTCCGACGAGCAGTACTTC	CADRLSDEQYF	TRBV24-1	TRBJ2-7
TGTGCCAGCAGTTATGGGTTCGGGGGGCATGGGTACAATGAGCAGTTCTTC	CASSYGFGGHGYNEQFF	TRBV5-5	TRBJ2-1
TGTGCCAGCAATACTTTTCTGGCAACAGGGGGGGCTAATGAAAAACTGTTTTTT	CASNTFLATGGANEKLFF	TRBV11-2	TRBJ1-4
TGTGCCAGCAGCGTGCCCCGGGGTACTCTACATGGGGATGAGCAGTTCTTC	CASSVPRGTLHGDEQFF	TRBV9	TRBJ2-1
TGCAGTGCTACACCAGGGGGTGGCTATGGCTACACCTTC	CSATPGGGYGYTF	TRBV20-1	TRBJ1-2
TGTGCCGATTTCTCGGGACAGGGGGGTAATCAGCCCCAGCATTTT	CADFSGQGGNQPQHF	TRBV10-3	TRBJ1-5
TGTGCCAGCAGCTTGGTCGCGGGAGATACAGATACGCAGTATTTT	CASSLVAGDTDTQYF	TRBV5-6	TRBJ2-3
TGCGCCAGCAGCTTGCCAAGAGGGACTAGCGGGCCCGGCTACGAGCAGTACTTC	CASSLPRGTSGPGYEQYF	TRBV5-1	TRBJ2-7
TGTGCCAGCAGTACTTCCTATTGGGCGCTCTCCTACGAGCAGTACTTC	CASSTSYWALSYEQYF	TRBV6-1	TRBJ2-7
TGTGCCACCAGTGAATACAGGCCTTCAGATACGCAGTATTTT	CATSEYRPSDTQYF	TRBV24-1	TRBJ2-3
TGTGCCTGGAGATACCAGACAGGCCAAGAGACCCAGTACTTC	CAWRYQTGQETQYF	TRBV30	TRBJ2-5
TGCGCCAGCAGGAGGAAAGGAGAGACCCGCTACGAGCAGTACTTC	CASRRKGETRYEQYF	TRBV5-1	TRBJ2-7
TGTGCCGGCCAAGGTGAGGGTCACACTGAAGCTTTCTTT	CAGQGEGHTEAFF	TRBV7-2	TRBJ1-1
TGTGCCAGCAGCGTAGGCGGCTACGAGCAGTACTTC	CASSVGGYEQYF	TRBV9	TRBJ2-7
TGTGCCAACAAGACAGGGTGGGCGCGGTTCGTCACTGAAGCTTTCTTT	CANKTGWARFVTEAFF	TRBV6-2	TRBJ1-1
TGCAGCGTTGAATTAAGTGGGACAGCGTTTCTCTACGAGCAGTACTTC	CSVELSGTAFLYEQYF	TRBV29-1	TRBJ2-7
TGTGCCACCACTGCCGGGACTAGCGGGGGGGCTCTTAGTTCATACAATGAGCAGTTCTTC	CATTAGTSGGALSSYNEQFF	TRBV24-1	TRBJ2-1
TGTGCCAGCAGTGAAGCGCATCCCCGGGACAGGGTTCTTCTCAATCAGCCCCAGCATTTT	CASSEAHPRDRVLLNQPQHF	TRBV6-1	TRBJ1-5
TGTGCCAGCAGTGAACTCGGACTAGCGCGATCGTACGAGCAGTACTTC	CASSELGLARSYEQYF	TRBV27	TRBJ2-7
TGTGCCAGCAGCCACGGGGGACAGTACTTC	CASSHGGQYF	TRBV4-2	TRBJ2-5
TGTGCCAGCAGCTTACCTGGACAGGGTTTATATGGCTACACCTTC	CASSLPGQGLYGYTF	TRBV7-9	TRBJ1-2
TGTGCCAGCAGTTATGGGACGGGATATACTAATGAAAAACTGTTTTTT	CASSYGTGYTNEKLFF	TRBV6-9	TRBJ1-4
TGTGCCAGCAGCTCAGGGGGCCTGGGGTCCTCTGGAAACACCATATATTTT	CASSSGGLGSSGNTIYF	TRBV7-2	TRBJ1-3
TGTGCCAGCAGGGGACTAGCGGGCCGCAATGAGCAGTTCTTC	CASRGLAGRNEQFF	TRBV11-3	TRBJ2-1
TGTGCCGGGACTAGCGGAACCTACGAGCAGTACTTC	CAGTSGTYEQYF	TRBV6-1	TRBJ2-7
TGTGCCAGCAGCGTAGCAGTACAGGGGCACTACGAGCAGTACTTC	CASSVAVQGHYEQYF	TRBV9	TRBJ2-7
TGTGCCAGCAGCTTGGGGAATTCGGCCAGCTCCTACAATGAGCAGTTCTTC	CASSLGNSASSYNEQFF	TRBV5-4	TRBJ2-1
TGTGCCAGCAGCATAGCAGGGGGGGGGAGGGCGAATGAAAAACTGTTTTTT	CASSIAGGGRANEKLFF	TRBV3-1	TRBJ1-4
TGTGCCAGCAGCTTAGAGCAGGCGGGCTACGAGCAGTACTTC	CASSLEQAGYEQYF	TRBV11-3	TRBJ2-7
TGTGCCACAGAGACAGGGGGCGCCAGCTCCTACGAGCAGTACTTC	CATETGGASSYEQYF	TRBV10-3	TRBJ2-7
TGTGCCTACCTGGGGCCATGGTGCAATCAGCCCCAGCATTTT	CAYLGPWCNQPQHF	TRBV3-1	TRBJ1-5
TGTGCCACCAGTGATTTGCCGAAAACTGACAGGGATGAGAACACAGATACGCAGTATTTT	CATSDLPKTDRDENTDTQYF	TRBV24-1	TRBJ2-3
TGTGCCAGCAGCGTCCTCCGGACATTCGGTGGGTATGAGCAGTTCTTC	CASSVLRTFGGYEQFF	TRBV5-4	TRBJ2-1
TGTGCCAGATGGTACATGCCGCATCCCGCTTTCTTT	CARWYMPHPAFF	TRBV28	TRBJ1-1
TGCGCCCGAAGTGACGAGCAGTACTTC	CARSDEQYF	TRBV10-2	TRBJ2-7
TGTGCCAGCAGCCCCTGGGGGCAGTCCTACGAGCAGTACTTC	CASSPWGQSYEQYF	TRBV7-9	TRBJ2-7
TGTGCCAGCAGTTACAGGCGTTCACCCCTCCACTTT	CASSYRRSPLHF	TRBV6-2	TRBJ1-6
TGTGCCAGCAGCGGTAAGCACTGCCTGATCTACGAGCAGTACTTC	CASSGKHCLIYEQYF	TRBV13	TRBJ2-7
TGTGCCAGCAGTTATCTAGTCCCCCTGTTTAAAAGCTCCTACGAGCAGTACTTC	CASSYLVPLFKSSYEQYF	TRBV27	TRBJ2-7
TGTGCCAGCAGCGCTAGCGGGTGGACCCAGTACTTC	CASSASGWTQYF	TRBV5-6	TRBJ2-5
TGTCAGACGCTTTGGGCCTACGAGCAGTACTTC	CQTLWAYEQYF	TRBV27	TRBJ2-7
TGTGCCACCATCACGGACAGGTACTCTGGAAACACCATATATTTT	CATITDRYSGNTIYF	TRBV24-1	TRBJ1-3
TGCAGTGCGCAGGGTTGGGGACAAGAGACCCAGTACTTC	CSAQGWGQETQYF	TRBV20-1	TRBJ2-5
TGTGCTAGCAGCTCTTGGGACACAGAGGGCCCGTCAAGTTACGAGCAGTACTTC	CASSSWDTEGPSSYEQYF	TRBV7-7	TRBJ2-7
TGTGCCAGCAGCTGGGGGGAGCCCTACAATGAGCAGTTCTTC	CASSWGEPYNEQFF	TRBV11-3	TRBJ2-1
TGCGCCAGCAGCCGAGCGCGCCCCGGACAACACTCTGGAAACACCATATATTTT	CASSRARPGQHSGNTIYF	TRBV4-3	TRBJ1-3
TGTGCCAGCAGAAACGACGATAGCAATCAGCCCCAGCATTTT	CASRNDDSNQPQHF	TRBV6-4	TRBJ1-5
TGTGCCAGCAACGCTACAGGCGGGGAGCTGTTTTTT	CASNATGGELFF	TRBV6-4	TRBJ2-2
TGTGCCAGCAGTGATCGGGACAGGAACCAGGAAAAACTGTTTTTT	CASSDRDRNQEKLFF	TRBV6-4	TRBJ1-4
TGTGCCAGCAGCTTAGTTCCGGGACTAGCGGGACGACCCTCCTACGAGCAGTACTTC	CASSLVPGLAGRPSYEQYF	TRBV7-9	TRBJ2-7
TGTGCCAGCAGCAGAAGCGGGGGGGAAGCCAAAAACATTCAGTACTTC	CASSRSGGEAKNIQYF	TRBV13	TRBJ2-4
TGTGCCAGCAGCCAAGATTTAGGGGAAACAGGGTATAACACTGAAGCTTTCTTT	CASSQDLGETGYNTEAFF	TRBV14	TRBJ1-1
TGCGCCAGCAGCTCCCGGGGGGGTGTAGAAGCAGATACGCAGTATTTT	CASSSRGGVEADTQYF	TRBV5-1	TRBJ2-3
TGCGCCAGCAGCTGGGACCTGGAGCAGTACTTC	CASSWDLEQYF	TRBV5-1	TRBJ2-7
TGCAGTGCTAGTGAAATACGGAACACTGAAGCTTTCTTT	CSASEIRNTEAFF	TRBV20-1	TRBJ1-1
TGCAGTGCTCTATGGAGGGGACCCCTCCACTTT	CSALWRGPLHF	TRBV20-1	TRBJ1-6
TGTGCCACCAGACGAGACAGGGGGAACGGGGACATTCAGTACTTC	CATRRDRGNGDIQYF	TRBV24-1	TRBJ2-4
TGTGCCAGCAGCTTCCGACTGTACAATGAGCAGTTCTTC	CASSFRLYNEQFF	TRBV5-4	TRBJ2-1
TGTGCTAGTGATCCCACTAACTATGGCTACACCTTC	CASDPTNYGYTF	TRBV12-5	TRBJ1-2
TGTGCCAGCAGCGCGTTCTGGCGGTTTCGGCCGGCAGTCTCCTACGAGCAGTACTTC	CASSAFWRFRPAVSYEQYF	TRBV11-2	TRBJ2-7
TGTGCCACCCACGGGACTAGCGGGGCAACCGGGGAGCTGTTTTTT	CATHGTSGATGELFF	TRBV24-1	TRBJ2-2
TGTGCCAGCAGCGTTCACACAGGGGGCTACACCTTC	CASSVHTGGYTF	TRBV9	TRBJ1-2
TGTGCCAGCAGCTGTTTGGGGACAGGAGTTCAAGAGACCCAGTACTTC	CASSCLGTGVQETQYF	TRBV11-3	TRBJ2-5
TGCAGTGCTGTGGGCTACGAGCAGTACTTC	CSAVGYEQYF	TRBV20-1	TRBJ2-7
TGTGCCATCAGTGTTGTAGTGAGGGACAACCAACCCCCTGAAGTCTACGAGCAGTACTTC	CAISVVVRDNQPPEVYEQYF	TRBV10-3	TRBJ2-7
TGCGCCAGCAGCCAAGATCCGGACAGTGAGGGGAACACTGAAGCTTTCTTT	CASSQDPDSEGNTEAFF	TRBV4-3	TRBJ1-1
TGCAGTGCTAGAGATCCCCAGGGAGGGGGCTACACCTTC	CSARDPQGGGYTF	TRBV20-1	TRBJ1-2
TGTGCCAGCAGCTTACCCCTCGGCTATGGCTACACCTTC	CASSLPLGYGYTF	TRBV7-3	TRBJ1-2
TGTGCCAGCAGTTTACCCGGGACAGGGATTTTCTATGGCTACACCTTC	CASSLPGTGIFYGYTF	TRBV6-5	TRBJ1-2
TGTGCCAGCAGTTCGGTTAGCGGCTCCTACGAGCAGTACTTC	CASSSVSGSYEQYF	TRBV12-3	TRBJ2-7
TGTGCCAGCAGCCAAGAACGACAGGGGGCCTTCACTGAAGCTTTCTTT	CASSQERQGAFTEAFF	TRBV14	TRBJ1-1
TGTGCCAGCAGCCAAGACAGTCCTAGCGGGGAGTACGAGCAGTACTTC	CASSQDSPSGEYEQYF	TRBV3-1	TRBJ2-7
TGTGCCAGCAGCTTCGACATTAGGCTAACCGGGGAGCTGTTTTTT	CASSFDIRLTGELFF	TRBV7-4	TRBJ2-2
TGCAGTGCGATTACGCTCCGGGACACTCTGACTCCTTACGAGCAGTACTTC	CSAITLRDTLTPYEQYF	TRBV20-1	TRBJ2-7
TGTGCCAGCAGTGTACGGATAACTCCCCATAAGGGGGTGCTCAACACTGAAGCTTTCTTT	CASSVRITPHKGVLNTEAFF	TRBV6-3	TRBJ1-1
TGTGCCACCAGTGACGTTGTTCGGCATTATGAGCAGTTCTTC	CATSDVVRHYEQFF	TRBV24-1	TRBJ2-1
TGTGCCAGCAGTTTGACTAGCGGGGGGCTCAATGAGCAGTTCTTC	CASSLTSGGLNEQFF	TRBV12-3	TRBJ2-1
TGTGCCAGCAGCCAGACCCTAGGTACCGACAATGAGCAGTTCTTC	CASSQTLGTDNEQFF	TRBV4-2	TRBJ2-1
TGTGCCAGCAGTTTAGTTGAGACAGGGCTCCATCAGCCCCAGCATTTT	CASSLVETGLHQPQHF	TRBV27	TRBJ1-5
TGTGCCACCAGTGATGGACAATTCTCGTACTACAATGAGCAGTTCTTC	CATSDGQFSYYNEQFF	TRBV24-1	TRBJ2-1
TGTGCCAGCAGCTGCGTTAAGCAGCCCCAGCATTTT	CASSCVKQPQHF	TRBV5-4	TRBJ1-5
TGTGCCAGCAGCCGGGAGACACCGGGACAGGGGGACAATGAGCAGTTCTTC	CASSRETPGQGDNEQFF	TRBV6-2	TRBJ2-1
TGTGCCAGCAGCTGGACCCCTCAGAAGCAGACTCGATACCGCGGCTCCTACGAGCAGTACTTC	CASSWTPQKQTRYRGSYEQYF	TRBV5-6	TRBJ2-7
TGCGCCAGCAGCGCAAGGGGGTGTGCCAAAAACATTCAGTACTTC	CASSARGCAKNIQYF	TRBV5-1	TRBJ2-4
TGTGCCAGCAGACCCAAACGACGGGGGCGTCAAAATCAGCCCCAGCATTTT	CASRPKRRGRQNQPQHF	TRBV27	TRBJ1-5
TGTGCCAGCAGCTTAGAGCACCAGTCCTACGAGCAGTACTTC	CASSLEHQSYEQYF	TRBV7-9	TRBJ2-7
TGTGCCAGCAGCTTACTAAGACAGGGCTGTGTCGAGCAGTACTTC	CASSLLRQGCVEQYF	TRBV11-1	TRBJ2-7
TGTGCCAGCAGGACCGGGACAGAAGCTTTCTTT	CASRTGTEAFF	TRBV6-4	TRBJ1-1
TGTGCCAGCAGCTTACCCAGTAGGAGGGGGGCGGCTTGCGTATACAATGAGCAGTTCTTC	CASSLPSRRGAACVYNEQFF	TRBV7-2	TRBJ2-1
TGCGCCAGCAGCTTGAAACTTAGTGGGGGGAAGTACAATGAGCAGTTCTTC	CASSLKLSGGKYNEQFF	TRBV5-1	TRBJ2-1
TGCGCCAGCAGCCACCACCCCCCCCCGGACAGTGTAGATCAAGAGACCCAGTACTTC	CASSHHPPPDSVDQETQYF	TRBV4-3	TRBJ2-5
TGCAGTGCTAGAGATCCGGGCGGGACGAATTCACCCCTCCACTTT	CSARDPGGTNSPLHF	TRBV20-1	TRBJ1-6
TGTGCCAGCAGTCTTAAAACCGGGACGCAGTTCTTC	CASSLKTGTQFF	TRBV6-1	TRBJ2-1
TGTGCCAGCAGCCAGGGGGTGGCTAGCGGGGGCGGCCAAAACACCGGGGAGCTGTTTTTT	CASSQGVASGGGQNTGELFF	TRBV3-1	TRBJ2-2
TGTGCCAGCAGAGCCGTAGGGCCTACTTACTACGAGCAGTACTTC	CASRAVGPTYYEQYF	TRBV6-5	TRBJ2-7
TGTGCCAGCAGCCACCCCCTGACAAGCTACGAGCAGTACTTC	CASSHPLTSYEQYF	TRBV28	TRBJ2-7
TGTGCCATCAGCGGGAGGGGGGCTGAGCAGTTCTTC	CAISGRGAEQFF	TRBV10-3	TRBJ2-1
TGCGCCAGCAGTGATAGGTGGTCGGGGGGCGAGCTCACTTGTAACACTGAAGCTTTCTTT	CASSDRWSGGELTCNTEAFF	TRBV10-1	TRBJ1-1
TGTGCCAGCAGCTTAATTCCAGGGGGGAACACTGAAGCTTTCTTT	CASSLIPGGNTEAFF	TRBV7-3	TRBJ1-1
TGTGCCAGCAGCACCCGACCTCAGGGCCAGCATTTT	CASSTRPQGQHF	TRBV13	TRBJ1-5
TGTGCCAACACCAGGGGAGTAGGATCGACTAACTATGGCTACACCTTC	CANTRGVGSTNYGYTF	TRBV6-1	TRBJ1-2
TGTGCCAGTCCATCAGACACCTTTCATCAGCCCCAGCATTTT	CASPSDTFHQPQHF	TRBV19	TRBJ1-5
TGTGCCAGCAGCTATGGGGCACAGGGGGCACAGCCCCAGCATTTT	CASSYGAQGAQPQHF	TRBV5-6	TRBJ1-5
TGTGCCAGCAGTGCCGGGGATAATGAGCAGTTCTTC	CASSAGDNEQFF	TRBV27	TRBJ2-1
TGTGCCAGCAGTTGTCTAGAGTGCACAGATACGCAGTATTTT	CASSCLECTDTQYF	TRBV6-5	TRBJ2-3
TGTGCCAGCAGCCTCGAGGGGGGGAACGGCACAGATACGCAGTATTTT	CASSLEGGNGTDTQYF	TRBV5-4	TRBJ2-3
TGTGCCAGTAGTATGGCACAGGGAGAGACCCAGTACTTC	CASSMAQGETQYF	TRBV19	TRBJ2-5
TGCGCCAGCAGCGAACAGGGGGCCGCCCCGTCCGGGGAGACCCAGTACTTC	CASSEQGAAPSGETQYF	TRBV5-1	TRBJ2-5
TGTGCCAGCAGCTTTGATAAACAGGGGAGAAATGGCTACACCTTC	CASSFDKQGRNGYTF	TRBV7-2	TRBJ1-2
TGTGCCAGCAGTCCTTCGGACAGTGGGCTTTCCCAGCATTTT	CASSPSDSGLSQHF	TRBV27	TRBJ1-5
TGCAGCGCCGGGTTTGGCGGTCAGGGAAAACTGTTTTTT	CSAGFGGQGKLFF	TRBV29-1	TRBJ1-4
TGTGCCAGCAGCCAAAAGAAAGCCACAGGGGGAGAATCCACCACATCACCCCTCCACTTT	CASSQKKATGGESTTSPLHF	TRBV11-3	TRBJ1-6
TGTGCCAGCAGTGCCCCCGGGAGGGACAGATACGAGCAGTACTTC	CASSAPGRDRYEQYF	TRBV6-1	TRBJ2-7
TGTGCCAGCTCACCAGGAGCAAGATCGAGGCGGAACACTGAAGCTTTCTTT	CASSPGARSRRNTEAFF	TRBV18	TRBJ1-1
TGTGCCAGCAGCTTAACGGGTCTACCGGGACAGGGGGGGAGCAATCAGCCCCAGCATTTT	CASSLTGLPGQGGSNQPQHF	TRBV7-9	TRBJ1-5
TGTGCCAGCAGCTTACCCATGGGACAGGGCGGGAACACTGAAGCTTTCTTT	CASSLPMGQGGNTEAFF	TRBV11-3	TRBJ1-1
TGTGCCACCAGCAGCCACCAGACTCGGGGGAGCTGGGGCCGGTACGAGCAGTACTTC	CATSSHQTRGSWGRYEQYF	TRBV15	TRBJ2-7
TGTGCCAGCAGTGAAACTAGCGGGAGGAATCAGCCGAACACCGGGGAGCTGTTTTTT	CASSETSGRNQPNTGELFF	TRBV6-4	TRBJ2-2
TGTGCCAGCAGCACCCGTCAAGGGGGGCCCCATTACGAGCAGTACTTC	CASSTRQGGPHYEQYF	TRBV7-4	TRBJ2-7
TGTGCTAAGGAGACGACAGAACTCCTCTACGAGCAGTACTTC	CAKETTELLYEQYF	TRBV27	TRBJ2-7
TGCGCCAGCAGCCAAGATTCTTCGTACTCTAATTCACCCCTCCACTTT	CASSQDSSYSNSPLHF	TRBV4-1	TRBJ1-6
TGTGCCAGCAGTTTATTGATTGGGGACAGGGATCCGAATTCACCCCTCCACTTT	CASSLLIGDRDPNSPLHF	TRBV27	TRBJ1-6
TGTGCCAGCATTTTCCCTATTAAAACAGGGGAAACAGATACGCAGTATTTT	CASIFPIKTGETDTQYF	TRBV6-2	TRBJ2-3
TGTGCCAGCAGTCCCCCCGGGACTAGCATGCAGTTCTTC	CASSPPGTSMQFF	TRBV27	TRBJ2-1
TGTGCCAGCAGCCCCGGACTAGGGAGGCAGGTAGTCGAGCAGTACTTC	CASSPGLGRQVVEQYF	TRBV14	TRBJ2-7
TGTGCCAGCAGCTTAGCCCATCGACTCGGAAACACCATATATTTT	CASSLAHRLGNTIYF	TRBV7-4	TRBJ1-3
TGCGCCAGCAGCACCGGGAAGCGAGCGGGACAAAAGCAGTTCTTC	CASSTGKRAGQKQFF	TRBV10-2	TRBJ2-1
TGTGCCAGCAGCATGCTCTACGAGCAGTACTTC	CASSMLYEQYF	TRBV11-2	TRBJ2-7
TGTGCCAGCAGCTTATTTCCGGTCAAAAACATTCAGTACTTC	CASSLFPVKNIQYF	TRBV7-6	TRBJ2-4
TGTGCCAGCAGCCAATATTGGGGGGATCTAGATACGCAGTATTTT	CASSQYWGDLDTQYF	TRBV3-1	TRBJ2-3
TGTGCCACCAGTGAGAGAAGGACAGTGGAGCAGTACTTC	CATSERRTVEQYF	TRBV24-1	TRBJ2-7
TGTGCCAGTAGTATAGATCTTACCGGGACTAGCGGGGATAGGAACACCGGGGAGCTGTTTTTT	CASSIDLTGTSGDRNTGELFF	TRBV19	TRBJ2-2
TGTGCCAGCAGTGCTATCGGTGGACTGGCAATGGTCTCCTACGAGCAGTACTTC	CASSAIGGLAMVSYEQYF	TRBV27	TRBJ2-7
TGCGCCAGCAGCCAAGAGACAGGCAACGAAAGCCCCCCCTATGGCTACACCTTC	CASSQETGNESPPYGYTF	TRBV4-3	TRBJ1-2
TGTGCCAGCAGCCCACGGCCCGAGACCCAGTACTTC	CASSPRPETQYF	TRBV14	TRBJ2-5
TGTGCCAGCAGCTCGGGACAGCATTTT	CASSSGQHF	TRBV11-3	TRBJ1-5
TGTGCCAGCAGCCGTAAAAGGACCGGGGAGCTGTTTTTT	CASSRKRTGELFF	TRBV13	TRBJ2-2
TGTGCCAGCAGCCGCGGTGACGGGTACACTGAAGCTTTCTTT	CASSRGDGYTEAFF	TRBV3-1	TRBJ1-1
TGTGCCAGCAGCCCCGGGACAGCACCCGGGGAGCTGTTTTTT	CASSPGTAPGELFF	TRBV6-4	TRBJ2-2
TGTGCCACCAGTGAGACAGGGGTAACTAACTATGGCTACACCTTC	CATSETGVTNYGYTF	TRBV24-1	TRBJ1-2
TGTGCCAGCAGCCAAGACCCCCCTTCCGCGGGAGAGGGAAAGGTCGAGCAGTACTTC	CASSQDPPSAGEGKVEQYF	TRBV3-1	TRBJ2-7
TGTGCCAGCAGCGCACGCCCGGGTAAACTAGCGGGTGCCAGATACGAGCAGTACTTC	CASSARPGKLAGARYEQYF	TRBV5-4	TRBJ2-7
TGTGCCAGCAGTTTCGACTCCCCCCAGAGATATGGCTACACCTTC	CASSFDSPQRYGYTF	TRBV27	TRBJ1-2
TGTGCCAGCAGTGAAGCGACCCTGACAGGGAGGAGGAACACTGAAGCTTTCTTT	CASSEATLTGRRNTEAFF	TRBV6-1	TRBJ1-1
TGTGCCAGCAGCGTATTTCAGGGCCGAGAAATGGCAACTAATGAAAAACTGTTTTTT	CASSVFQGREMATNEKLFF	TRBV9	TRBJ1-4
TGTGCCAGCAGCGTTCCTACTAGCGGGAGCAGGGGGGACGAGCAGTACTTC	CASSVPTSGSRGDEQYF	TRBV7-3	TRBJ2-7
TGCGCCAGCAGCCTCTCAACAGAAATGGGGAACACTGAAGCTTTCTTT	CASSLSTEMGNTEAFF	TRBV4-3	TRBJ1-1
TGTGCCAGCAGTGAGGGGACTCCGGGACATGCTGAAGCTTTCTTT	CASSEGTPGHAEAFF	TRBV2	TRBJ1-1
TGTGCCATCAGATCCGGGACAGGGGAGTCCGGTCAGAGCAATCAGCCCCAGCATTTT	CAIRSGTGESGQSNQPQHF	TRBV10-3	TRBJ1-5
TGCGCCAGCAGCGACAGGAGAAAGGCCTACGAGCAGTACTTC	CASSDRRKAYEQYF	TRBV4-1	TRBJ2-7
TGTGCCAGCAGCCAAGCCCCCCCCGTAGGGACACGTGGCTACACCTTC	CASSQAPPVGTRGYTF	TRBV3-1	TRBJ1-2
TGTGCCAGCAGTGAAGAGACAGGAATGACCTACGAGCAGTACTTC	CASSEETGMTYEQYF	TRBV6-1	TRBJ2-7
TGTGCCAGCAAGGCCCTATATGTAGGCTCCTACGAGCAGTACTTC	CASKALYVGSYEQYF	TRBV27	TRBJ2-7
TGCAGTGCTAGAGATCCCCCCTTGTCGTCTTCCTACGAGCAGTACTTC	CSARDPPLSSSYEQYF	TRBV20-1	TRBJ2-7
TGTGCCAGCAGTGAACCGGGACAGGGGGCGCTAGCCAAAAACATTCAGTACTTC	CASSEPGQGALAKNIQYF	TRBV25-1	TRBJ2-4
TGTGCCAGCAGTTTAACCCAGCCGGGAGGATACAAGGTGTGCTACGAGCAGTACTTC	CASSLTQPGGYKVCYEQYF	TRBV27	TRBJ2-7
TGCAGTGCTAGAGCGGCCCGGGAGGCGCGGGGGGGGGGTACGCAGTATTTT	CSARAAREARGGGTQYF	TRBV20-1	TRBJ2-3
TGCGCCAGCAGCTTCGACAGGGGAAATGGCTACACCTTC	CASSFDRGNGYTF	TRBV5-1	TRBJ1-2
TGTGCCCCGGAAACATTATGGGGGCAAGGAAACACCATATATTTT	CAPETLWGQGNTIYF	TRBV7-3	TRBJ1-3
TGTGCCAGCAGCCCTTGGGGCGAGGGCTATAATTCACCCCTCCACTTT	CASSPWGEGYNSPLHF	TRBV5-4	TRBJ1-6
TGTGCAGACAGGCTAGTTTTTGAAGCTTTCTTT	CADRLVFEAFF	TRBV6-2	TRBJ1-1
TGTGCCAGCAGCTTCACTAGCGGGAGAAGCTCCTACAATGAGCAGTTCTTC	CASSFTSGRSSYNEQFF	TRBV7-8	TRBJ2-1
TGTGCCAGCAGTTACTCTTCCTCGGCCAGGGGCGAGCAGTACTTC	CASSYSSSARGEQYF	TRBV6-2	TRBJ2-7
TGCAGTGCGGTAAGGAGGACCGCGTTGAGGCTTAATGGCTACACCTTC	CSAVRRTALRLNGYTF	TRBV20-1	TRBJ1-2
TGTGCTAGTGGTTCGTTCCATGCCTACGAGCAGTACTTC	CASGSFHAYEQYF	TRBV12-5	TRBJ2-7
TGTGCCCCAAGAGGGACTGAAGCTTTCTTT	CAPRGTEAFF	TRBV24-1	TRBJ1-1
TGTGCCAGCAGCGCTGACGGCACTAATGGGACAGGGGGCGGCCGGGCCAATCAGCCCCAGCATTTT	CASSADGTNGTGGGRANQPQHF	TRBV11-2	TRBJ1-5
TGCAGCGTTGCCCTGACAGATACGCAGTATTTT	CSVALTDTQYF	TRBV29-1	TRBJ2-3
TGTGCCAGCAGTGAAAGGGTCAGCGACACTGAAGCTTTCTTT	CASSERVSDTEAFF	TRBV6-1	TRBJ1-1
TGTGCCTGGAGTGTACAAGGACGGATCAGCACAGATACGCAGTATTTT	CAWSVQGRISTDTQYF	TRBV30	TRBJ2-3
TGTGCCAGCAGTTACAACCAGGGCCGCCTAAAACTGTTTTTT	CASSYNQGRLKLFF	TRBV6-3	TRBJ1-4
TGTGCCAGCAGCGGACAGGGGGCTCTCCATGGCTACACCTTC	CASSGQGALHGYTF	TRBV5-4	TRBJ1-2
TGTGCCAGCAGCTTAGCAAGTTCTTACAATGAGCAGTTCTTC	CASSLASSYNEQFF	TRBV7-9	TRBJ2-1
TGTGCCAGCAGTTTTTACGCGGGTGAGTACGAGCAGTACTTC	CASSFYAGEYEQYF	TRBV12-3	TRBJ2-7
TGTGCCAGCAGTGAAGACAGGGGGAACACTGAAGCTTTCTTT	CASSEDRGNTEAFF	TRBV25-1	TRBJ1-1
TGTGCCAGCAGTGATGACAGAACCGGGGAGCTGTTTTTT	CASSDDRTGELFF	TRBV5-8	TRBJ2-2
TGTGCCAGCAGCTTAGTGCTAAGCGTCGGGGGGGTTGGGGGTACCTACGAGCAGTACTTC	CASSLVLSVGGVGGTYEQYF	TRBV11-3	TRBJ2-7
TGTGCCAGCAAAGGTCGAATACAGGGAAGCAATCAGCCCCAGCATTTT	CASKGRIQGSNQPQHF	TRBV6-8	TRBJ1-5
TGTGCCAGCACTCTCGTTCGGACAGGGACCACCCAAGAGACCCAGTACTTC	CASTLVRTGTTQETQYF	TRBV9	TRBJ2-5
TGTGCCAGCTCGCAGGGTTCAGATACGCAGTATTTT	CASSQGSDTQYF	TRBV7-9	TRBJ2-3
TGTGCCAAGACGACAGGGGATGAGACCCAGTACTTC	CAKTTGDETQYF	TRBV2	TRBJ2-5
TGTGCCAGCAGCCACGTTATTGCGCTGTACGAGCAGTACTTC	CASSHVIALYEQYF	TRBV7-3	TRBJ2-7
TGTGCCTTTTTCCAGGGTATTCGCTACGAGCAGTACTTC	CAFFQGIRYEQYF	TRBV19	TRBJ2-7
TGTGCCAGCAGCCGGGGGAAGGGTCTCGTCAGGGGGAACACTGAAGCTTTCTTT	CASSRGKGLVRGNTEAFF	TRBV3-1	TRBJ1-1
TGTGCCAGCAGCGCGGGACAGGGCAGGGAGGAGAGAAGCTACGAGCAGTACTTC	CASSAGQGREERSYEQYF	TRBV9	TRBJ2-7
TGTGCCAGCAGTTGCGGAGGCAAAGGCTTACGTAAAATTTTGGTTCTGAACGAGCAGTACTTC	CASSCGGKGLRKILVLNEQYF	TRBV28	TRBJ2-7
TGCGCCAGCAGCCAGACTCGGATACAGCCCCAGCATTTT	CASSQTRIQPQHF	TRBV4-1	TRBJ1-5
TGTGCCAGCAGCTTTCAGGCAAAGGGGAATTTTTCCGACACTGAAGCTTTCTTT	CASSFQAKGNFSDTEAFF	TRBV5-6	TRBJ1-1
TGTGCCACCGGTCCGGGACTAGTGGGGGCCTACAATGAGCAGTTCTTC	CATGPGLVGAYNEQFF	TRBV6-4	TRBJ2-1
TGTGCTAGTGGTTTGCCCGGGGCGGGACACCGCTCCTACAATGAGCAGTTCTTC	CASGLPGAGHRSYNEQFF	TRBV12-5	TRBJ2-1
TGTGCCAGCAGCCAAGACAGTTTCCCGGGACAGGGGACAAAGAATCAGCCCCAGCATTTT	CASSQDSFPGQGTKNQPQHF	TRBV14	TRBJ1-5
TGCGCCAGCAGCTTGGCCAGTAGGACAGTATCTCCAGATACGCAGTATTTT	CASSLASRTVSPDTQYF	TRBV5-1	TRBJ2-3
TGTGCCAGCAGGAAATGGAGGACTAGCGGGACAGGAGAGACCCAGTACTTC	CASRKWRTSGTGETQYF	TRBV7-7	TRBJ2-5
TGTGCCAGCATCGAGGACGAGCAGTACTTC	CASIEDEQYF	TRBV27	TRBJ2-7
TGTGCCAGCAGACGACTAGCGGGATACGAGCAGTACTTC	CASRRLAGYEQYF	TRBV6-6	TRBJ2-7
TGTGCCAGCAGTCTCCGCGGCCACTACGAGCAGTACTTC	CASSLRGHYEQYF	TRBV27	TRBJ2-7
TGTGCCAGCAGTCCAGAGGACAGGGCTCGGACTGAAGCTTTCTTT	CASSPEDRARTEAFF	TRBV6-2	TRBJ1-1
TGTGCCAGCAGCGCCGGGGCCGGGACATTTCGGGGCAATGAGCAGTTCTTC	CASSAGAGTFRGNEQFF	TRBV9	TRBJ2-1
TGTGCCAGCATGTCAGGGCAGAACAGTTATACGCAGTATTTT	CASMSGQNSYTQYF	TRBV27	TRBJ2-3
TGTGCCAGCAGCTTAGTCGGGCGGGGGAGGAGCTCCTATAGCAATCAGCCCCAGCATTTT	CASSLVGRGRSSYSNQPQHF	TRBV11-2	TRBJ1-5
TGTGCCAGCAGCTTTAGAGGGACAGGGGAGGGCGGCGGCTATGGCTACACCTTC	CASSFRGTGEGGGYGYTF	TRBV7-9	TRBJ1-2
TGCGCCAGCAGCCATAGGGACAGGGATGGCTACACCTTC	CASSHRDRDGYTF	TRBV4-3	TRBJ1-2
TGTGCCAGCAGTTTAGTGAGCTACGAGCAGTACTTC	CASSLVSYEQYF	TRBV27	TRBJ2-7
TGTGCCAGCAGTTTCTGGCAGGGGGCGAACACTGAAGCTTTCTTT	CASSFWQGANTEAFF	TRBV12-4	TRBJ1-1
TGCAGTGAATGCGGGAGGCCTTGCTATTCACCCCTCCACTTT	CSECGRPCYSPLHF	TRBV20-1	TRBJ1-6
TGTGCCAGCAGCTTCACAGGGCTTATAGGCCAGAGCAATCAGCCCCAGCATTTT	CASSFTGLIGQSNQPQHF	TRBV13	TRBJ1-5
TGCGCCAGCAGCTGTGGGACAGGGGAGTTAGAGAACACTGAAGCTTTCTTT	CASSCGTGELENTEAFF	TRBV5-1	TRBJ1-1
TGTGCCAGCAGTTGGGGGCAGCCCCAGCATTTT	CASSWGQPQHF	TRBV12-3	TRBJ1-5
TGTGCCACCAATACGGGAGGGGCAGATACGCAGTATTTT	CATNTGGADTQYF	TRBV24-1	TRBJ2-3
TGTGCCAGCAGTTTTTGGACTAGCGGGGACGCGAACACCGGGGAGCTGTTTTTT	CASSFWTSGDANTGELFF	TRBV28	TRBJ2-2
TGTGCCAGCAGTGTGGCTCTGACAGGGTTTTGCAATCAGCCCCAGCATTTT	CASSVALTGFCNQPQHF	TRBV6-1	TRBJ1-5
TGTGCCATGCCTGGACGGGGCACCGGGGAGCTGTTTTTT	CAMPGRGTGELFF	TRBV10-3	TRBJ2-2
TGTGCCAGCAGTTCACCGGGACAGGGGATGAACACTGAAGCTTTCTTT	CASSSPGQGMNTEAFF	TRBV27	TRBJ1-1
TGTGCCAGCAGCACCCGGACAGGGCCCCATTCACCCCTCCACTTT	CASSTRTGPHSPLHF	TRBV7-3	TRBJ1-6
TGTGCCAGCAGCGTCGTGAGGGGGACTGAAGCTTTCTTT	CASSVVRGTEAFF	TRBV7-7	TRBJ1-1
TGTGCCAGCAGTGATGTGGGGCTAAGGGAAGCTTTCTTT	CASSDVGLREAFF	TRBV6-1	TRBJ1-1
TGTGCCAGCAGTGCCCGAGGGGGTTCAGATACGCAGTATTTT	CASSARGGSDTQYF	TRBV6-1	TRBJ2-3
TGTGCCAGCAGCTTAGCAGGACGTGACGAGCAGTACTTC	CASSLAGRDEQYF	TRBV11-2	TRBJ2-7
TGCGCCAGCAGACCGGGGACAGAGGTCGGAGGGGACACTGAAGCTTTCTTT	CASRPGTEVGGDTEAFF	TRBV10-1	TRBJ1-1
TGTGCCTGGAGTCAGTCCGGGACAGGTTCTCAGCCCCAGCATTTT	CAWSQSGTGSQPQHF	TRBV30	TRBJ1-5
TGTGCCAGCACTGCGACAGGTACGCAGTATTTT	CASTATGTQYF	TRBV12-3	TRBJ2-3
TGTGCCATCACAGCGTCCGGGACTAGCGGGAGAACTGGAAACACCATATATTTT	CAITASGTSGRTGNTIYF	TRBV19	TRBJ1-3
TGCGCCAGCAGGCAAAGCGGGATTCCGCAGAAGACAGATACGCAGTATTTT	CASRQSGIPQKTDTQYF	TRBV5-1	TRBJ2-3
TGTGCCAGCTTGGGACAGGGACTGCATGGCAATCAGCCCCAGCATTTT	CASLGQGLHGNQPQHF	TRBV19	TRBJ1-5
TGCAGTGCTAGTCAACTCTCCCCCCTAGCGGGGAGCAGGGTCAATGAGCAGTTCTTC	CSASQLSPLAGSRVNEQFF	TRBV20-1	TRBJ2-1
TGCGCCAGCAGTCTCTCCACTAGCGTAGGCTACAATGAGCAGTTCTTC	CASSLSTSVGYNEQFF	TRBV5-1	TRBJ2-1
TGTGCCAGCATACTTGCCGGCTACACCTTC	CASILAGYTF	TRBV27	TRBJ1-2
TGCGCCAGCAGCTGGCGATGGACCTACAATGAGCAGTTCTTC	CASSWRWTYNEQFF	TRBV5-1	TRBJ2-1
TGTGCCAGCAGCCAATGGACTAGCCTCGGGGAGCTGTTTTTT	CASSQWTSLGELFF	TRBV14	TRBJ2-2
TGTGCCAGCAGCTTATGGAGCGCAACTAATGAAAAACTGTTTTTT	CASSLWSATNEKLFF	TRBV7-3	TRBJ1-4
TGTGCCATCCAGAAGCCACTAGCGTACGAGCAGTACTTC	CAIQKPLAYEQYF	TRBV7-2	TRBJ2-7
TGTGCCAGCAGCGTGGGGGGGGAGACAGAGCAGTACTTC	CASSVGGETEQYF	TRBV13	TRBJ2-7
TGTGCCAGCAGCTTAGTGCGGGGGGGCCTCAACACCGGGGAGCTGTTTTTT	CASSLVRGGLNTGELFF	TRBV7-3	TRBJ2-2
TGTGCCAGCAGCGTTGGCCAGGGGGCTGGGGCCAAAAACATTCAGTACTTC	CASSVGQGAGAKNIQYF	TRBV9	TRBJ2-4
TGTGCCAGCAGTGAGAGCAGGGCTGCTGAAGCTTTCTTT	CASSESRAAEAFF	TRBV2	TRBJ1-1
TGTGCCATCAGTGAACGTCCAGCCAGGGAAGGGGGGCATTGGCGGGACGAGCAGTACTTC	CAISERPAREGGHWRDEQYF	TRBV10-3	TRBJ2-7
TGTGCCAGCAGTTGTAAAACAGGGTATGGCTACACCTTC	CASSCKTGYGYTF	TRBV27	TRBJ1-2
TGCGCCAGCAGTCGCGGGGACAGGGAGTCGTCCTACGAGCAGTACTTC	CASSRGDRESSYEQYF	TRBV10-1	TRBJ2-7
TGCAGTGCTAGAGCCCTAGGAGGCCGCTGCTACGAGCAGTACTTC	CSARALGGRCYEQYF	TRBV20-1	TRBJ2-7
TGCAGTGCCTTCCGGCCCTGGACTAGCGGCCTAGCTGACAATGAGCAGTTCTTC	CSAFRPWTSGLADNEQFF	TRBV20-1	TRBJ2-1
TGTGCCAGTAGTAAGCACCCGAGGGGGACGAGTGTGGTGGGAGATACGCAGTATTTT	CASSKHPRGTSVVGDTQYF	TRBV19	TRBJ2-3
TGTGCCAGCAGCACACCCCGGGTCCTCGAGCAGTACTTC	CASSTPRVLEQYF	TRBV7-3	TRBJ2-7
TGTGCCAGCAGCTCCACGGTCCGGGGCTCCTACGAGCAGTACTTC	CASSSTVRGSYEQYF	TRBV7-2	TRBJ2-7
TGCGCCAGCAGTGAGTCGGGGAGCGGGTGGAACACTGAAGCTTTCTTT	CASSESGSGWNTEAFF	TRBV10-1	TRBJ1-1
TGTGCCAGCAGCTTACGCCTCCGCTTGAACACTGAAGCTTTCTTT	CASSLRLRLNTEAFF	TRBV11-3	TRBJ1-1
TGCGCCAGCAGCCCCCCTCCGGGACAGGGGTGCAATGAGCAGTTCTTC	CASSPPPGQGCNEQFF	TRBV4-1	TRBJ2-1
TGTGCCAGCAGCTTAGAAACTAGCGCCGAAACACTAGGGTATACGCAGTATTTT	CASSLETSAETLGYTQYF	TRBV7-2	TRBJ2-3
TGCAGTGCTAGAAAAAAAAGGGAAGGAGGTACGCAGTATTTT	CSARKKREGGTQYF	TRBV20-1	TRBJ2-3
TGCAGTGCTAGACGAGGAATAGGCCAAGGGTGTTGGTATAGCAATCAGCCCCAGCATTTT	CSARRGIGQGCWYSNQPQHF	TRBV20-1	TRBJ1-5
TGTGCCAGCAGTTACAGGAGGAGGGGGACCGGGGAGCTGTTTTTT	CASSYRRRGTGELFF	TRBV6-5	TRBJ2-2
TGTGCCACCAGCTCCGTAGGGACTGGGTGGCACACCGGGGAGCTGTTTTTT	CATSSVGTGWHTGELFF	TRBV24-1	TRBJ2-2
TGTGCCAGCAGTTTATCGGGGGCGCTTCACGAGCAGTACTTC	CASSLSGALHEQYF	TRBV27	TRBJ2-7
TGTGCCAGCAGCACGGGTCACTGGGGGAGGAGCAATCAGCCCCAGCATTTT	CASSTGHWGRSNQPQHF	TRBV13	TRBJ1-5
TGTGCCAGCAGTTTAGATCCAGGGGCCCTATGCACAGATACGCAGTATTTT	CASSLDPGALCTDTQYF	TRBV12-3	TRBJ2-3
TGTGCCAGCAGCATCCGACGGGCGACTAATGAAAAACTGTTTTTT	CASSIRRATNEKLFF	TRBV7-3	TRBJ1-4
TGTGCCACCCCCTTGGGGCCAACTAATGAAAAACTGTTTTTT	CATPLGPTNEKLFF	TRBV6-6	TRBJ1-4
TGTGCCAGCAGCCAGAGCTTAGGCTACGAGCAGTACTTC	CASSQSLGYEQYF	TRBV13	TRBJ2-7
TGTGCCAGCAGTTCCACCGGGACAGAACTTACGGGCTATGGCTACACCTTC	CASSSTGTELTGYGYTF	TRBV6-5	TRBJ1-2
TGTGCCAGCAGTAAAACTGGGGAGAAAGTTGAAAAACTGTTTTTT	CASSKTGEKVEKLFF	TRBV28	TRBJ1-4
TGTGCCAGCAGTTTTTTGGCCCTCGGCAGGGGGTCCTCGAACACTGAAGCTTTCTTT	CASSFLALGRGSSNTEAFF	TRBV12-3	TRBJ1-1
TGTGCCACCAGTGACAGACGGGGAGGATGCACAGATACGCAGTATTTT	CATSDRRGGCTDTQYF	TRBV24-1	TRBJ2-3
TGTGCCAGCAGCTTAACGAGTAGGCTGGGCCAGGACACTGAAGCTTTCTTT	CASSLTSRLGQDTEAFF	TRBV7-3	TRBJ1-1
TGTGCCAGCAGTGAACCCTTCCGGGACAGGTCTGGGGCCAACGTCCTGACTTTC	CASSEPFRDRSGANVLTF	TRBV6-1	TRBJ2-6
TGTGCCAGCAGCTTAGGGCCCAGGGGGTACAATGAGCAGTTCTTC	CASSLGPRGYNEQFF	TRBV7-2	TRBJ2-1
TGTGCCAGCAGCGCCCGCAGGCACTATGGCTACACCTTC	CASSARRHYGYTF	TRBV7-8	TRBJ1-2
TGTGCCAGCAGCCAAGACGGGGGGGACACCGGGGAGCTGTTTTTT	CASSQDGGDTGELFF	TRBV3-1	TRBJ2-2
TGTGCCAGCAGCCGTCCCGGGGGATTGAACACTGAAGCTTTCTTT	CASSRPGGLNTEAFF	TRBV9	TRBJ1-1
TGTGCCAGCAGCTCTAGGGGGGGGGGGGGGCTCTTC	CASSSRGGGGLF	TRBV13	TRBJ2-1
TGTGCCAGCAGCCCGGGACAACCCCTCCACTTT	CASSPGQPLHF	TRBV7-7	TRBJ1-6
TGCAGTGCTAGCAGCGAGGGCACTGAAGCTTTCTTT	CSASSEGTEAFF	TRBV20-1	TRBJ1-1
TGTGCCAGCAGCTCCCCCCAGAACAATGAAAAACTGTTTTTT	CASSSPQNNEKLFF	TRBV7-4	TRBJ1-4
TGTGCTAGTGGTTTGCCAGTTCGGGGGTCCTACGAGCAGTACTTC	CASGLPVRGSYEQYF	TRBV12-5	TRBJ2-7
TGTGCCAGCAGCATACAGCTCGAGGACGGCTACGAGCAGTACTTC	CASSIQLEDGYEQYF	TRBV7-3	TRBJ2-7
TGTGCCAGCAGTGGGGGTCTAAAACTGTTTTTT	CASSGGLKLFF	TRBV27	TRBJ1-4
TGTGCCAGTAGTCCGGCAAACTATGGCTACACCTTC	CASSPANYGYTF	TRBV19	TRBJ1-2
TGTGCCAGGGGCAAAGGGGGCCTCGAGCAGTACTTC	CARGKGGLEQYF	TRBV19	TRBJ2-7
TGTGCCAGCAGCGGCCGTCATACGACTAGCGTTACAGATACGCAGTATTTT	CASSGRHTTSVTDTQYF	TRBV13	TRBJ2-3
TGTGCCAGCAGCTTATGGGATCGATTCGGTTCCGGAAACGAGCAGTACTTC	CASSLWDRFGSGNEQYF	TRBV7-3	TRBJ2-7
TGTGCCAGCAGCCCTGTGAACAGGGGGGGCTTTAGCAATCAGCCCCAGCATTTT	CASSPVNRGGFSNQPQHF	TRBV7-3	TRBJ1-5
TGTGCCAGCAGCTTGCAGGCTTCCTATAATTCACCCCTCCACTTT	CASSLQASYNSPLHF	TRBV5-6	TRBJ1-6
TGTGCCAGCAGCGGGGGGACTAGCGGGCTTGAGGAGGGGCGTAGAGAGACCCAGTACTTC	CASSGGTSGLEEGRRETQYF	TRBV7-9	TRBJ2-5
TGTGCTAGTGGTTTGGCCCGGGAGATTACAGGGGCGGTTGGAAACACCATATATTTT	CASGLAREITGAVGNTIYF	TRBV12-5	TRBJ1-3
TGTGCCAGCGGTGACTCTGGGGAGCTGTTTTTT	CASGDSGELFF	TRBV2	TRBJ2-2
TGTGCCAGCAGTTTGACAGGGGGCTCCCCCAACTATGGCTACACCTTC	CASSLTGGSPNYGYTF	TRBV27	TRBJ1-2
TGTGCCAGCAGCTGCGGGAGGGAAGGGGCCGCTAACTATGGCTACACCTTC	CASSCGREGAANYGYTF	TRBV13	TRBJ1-2
TGCAGCAAAGTCAGGTCGGACGGCAAACTCGAGCAGTACTTC	CSKVRSDGKLEQYF	TRBV29-1	TRBJ2-7
TGCGCCAGCAGCCACGGTCTAGCGGGGTTTTCGACCGGGGAGCTGTTTTTT	CASSHGLAGFSTGELFF	TRBV4-1	TRBJ2-2
TGTGCCAGTCTGCGACTAGCGGGCATCCTTGCCTACGAGCAGTACTTC	CASLRLAGILAYEQYF	TRBV6-4	TRBJ2-7
TGTGCCAGCAGTGGACAGGGTCCCCGCGGGGAGCTGTTTTTT	CASSGQGPRGELFF	TRBV2	TRBJ2-2
TGTGCCAGCAGTCCTAACAGAAAGTACAATGAGCAGTTCTTC	CASSPNRKYNEQFF	TRBV6-5	TRBJ2-1
TGTGCCAGTATTACTATACGAGATAAATGTTCACCCCTCCACTTT	CASITIRDKCSPLHF	TRBV19	TRBJ1-6
TGTGCCTGTACGAGACTAGCGGGCCCAGCCTACAATGAGCAGTTCTTC	CACTRLAGPAYNEQFF	TRBV30	TRBJ2-1
TGTGCCAGCAGCCGGGGGGGGGGGGAGCAGTACTTC	CASSRGGGEQYF	TRBV7-9	TRBJ2-7
TGTGCCAGAACACAGGGAAAGCCGGGCCTTGGAAACACCATATATTTT	CARTQGKPGLGNTIYF	TRBV19	TRBJ1-3
TGTGCCAGCACCCCCGGGACTAGAATTGTCAATGAGCAGTTCTTC	CASTPGTRIVNEQFF	TRBV2	TRBJ2-1
TGCAGTGCTAGCAACAACTCTGGAAACACCATATATTTT	CSASNNSGNTIYF	TRBV20-1	TRBJ1-3
TGCAGTGCTCGGGCTGTACTGTACAATGAGCAGTTCTTC	CSARAVLYNEQFF	TRBV20-1	TRBJ2-1
TGTGCCAGTAGTAAGCGTAGCACAGATACGCAGTATTTT	CASSKRSTDTQYF	TRBV19	TRBJ2-3
TGTGCCAGCAGGGGACAGCGGAGTAACTATGGCTACACCTTC	CASRGQRSNYGYTF	TRBV7-6	TRBJ1-2
TGCAGTGCTAGAGAAAAGGGGGCCTACGAGCAGTACTTC	CSAREKGAYEQYF	TRBV20-1	TRBJ2-7
TGTGCCAGCAGTGACTCCCATGTGAGGGACAGAAAACTGTTTTTT	CASSDSHVRDRKLFF	TRBV6-4	TRBJ1-4
TGTGCCAGCAGCCAGGCCCTGGATCAGCCCCAGCATTTT	CASSQALDQPQHF	TRBV3-1	TRBJ1-5
TGTGCCAGCTCACCACAGGTAATTGGGACAGACCAAGAGACCCAGTACTTC	CASSPQVIGTDQETQYF	TRBV18	TRBJ2-5
TGTGCCAGCAGCTTAGATAAGATAAGGGCGGGTGAGCAGTTCTTC	CASSLDKIRAGEQFF	TRBV11-3	TRBJ2-1
TGTGCCAGCAGCAAGTGGTCATCAGGGGATCAGCCCCAGCATTTT	CASSKWSSGDQPQHF	TRBV5-5	TRBJ1-5
TGTGCCAGCAGTCGGAGGCGACAGGGGTCAATGCCCACTGAAGCTTTCTTT	CASSRRRQGSMPTEAFF	TRBV6-1	TRBJ1-1
TGCAGCGTTGCCGGGGGGCTGAGTGACAATGAGCAGTTCTTC	CSVAGGLSDNEQFF	TRBV29-1	TRBJ2-1
TGTGCCAGCAGCTTAGCCGCAGGCCGGATTCCGAGGGGGCACACTGAAGCTTTCTTT	CASSLAAGRIPRGHTEAFF	TRBV7-2	TRBJ1-1
TGTGCCAGCAACTGGGACAGCGACGCGAACACCGGGGAGCTGTTTTTT	CASNWDSDANTGELFF	TRBV27	TRBJ2-2
TGTGCCAGCAGTTATGGACTAGCGGGAGAAAAAGATTCGAACACCGGGGAGCTGTTTTTT	CASSYGLAGEKDSNTGELFF	TRBV6-3	TRBJ2-2
TGTGCCATCAGTGGGGGACAGGGAGACACTGAAGCTTTCTTT	CAISGGQGDTEAFF	TRBV10-3	TRBJ1-1
TGTGCCAGCAGCAAAGAGACTAGCGGGTTGTTAGGGGAGCTGTTTTTT	CASSKETSGLLGELFF	TRBV7-9	TRBJ2-2
TGTGCCAGTAGACGATTTGAGTACTTC	CASRRFEYF	TRBV19	TRBJ2-5
TGCGCCAGCAGCTTCCCCCTAGAGGGAGAGACCCAGTACTTC	CASSFPLEGETQYF	TRBV5-1	TRBJ2-5
TGTGCCAGCAGTTTACTACAGGAAATCACTGAAGCTTTCTTT	CASSLLQEITEAFF	TRBV28	TRBJ1-1
TGTGCCTCCCTGTCTAGAGGGGGCCAGCCCCAGCATTTT	CASLSRGGQPQHF	TRBV12-4	TRBJ1-5
TGTGCCAGCAGGAACAAGGGAGGGGCCGGTGGTATCTATGGCTACACCTTC	CASRNKGGAGGIYGYTF	TRBV7-3	TRBJ1-2
TGTGCCAGCAGTTCAGGACTAGCGGATGAGCAGTTCTTC	CASSSGLADEQFF	TRBV6-5	TRBJ2-1
TGTGCCAGCAGCCAGGGCAGCAATCAGCCCCAGCATTTT	CASSQGSNQPQHF	TRBV13	TRBJ1-5
TGTGCCAGCAGTGAGCAAAAGAAGGCTCCCAAGGGGGGGAATGAGCAGTTCTTC	CASSEQKKAPKGGNEQFF	TRBV6-4	TRBJ2-1
TGTGCCAGCAGTAGGCTGTCGGGACAGGGAGGGCATACCGAACACGATGAATCAGATACGCAGTATTTT	CASSRLSGQGGHTEHDESDTQYF	TRBV7-3	TRBJ2-3
TGCAGCGCCCGGTTCGGACAGTACTTC	CSARFGQYF	TRBV29-1	TRBJ2-5
TGTGCCACCACCCCGGGGGGGTTTGATGAGACCCAGTACTTC	CATTPGGFDETQYF	TRBV24-1	TRBJ2-5
TGTGCCAGCAGCCCGCCGGGGGCCTCCTGGGGTTCTGCAGATACGCAGTATTTT	CASSPPGASWGSADTQYF	TRBV13	TRBJ2-3
TGTGCCAGCAGCGTAGCGAGGCTCCTAGCGGGGAACAATGAGCAGTTCTTC	CASSVARLLAGNNEQFF	TRBV9	TRBJ2-1
TGCGCCAGCAGCCAAGAAACTAGCGTAGGGGTTCGATCTAGCACAGATACGCAGTATTTT	CASSQETSVGVRSSTDTQYF	TRBV4-1	TRBJ2-3
TGTGCCAGCAGTGTTCCCCTAGCGGTTAGGTACGAGCAGTACTTC	CASSVPLAVRYEQYF	TRBV2	TRBJ2-7
TGTGCCAGCAGTGAACCTAAATGGGACAGGGGGCGGGGGGGCTACGAGCAGTACTTC	CASSEPKWDRGRGGYEQYF	TRBV6-1	TRBJ2-7
TGTGCCAGCAGTGGCAGGACAGGGTACACTGAAGCTTTCTTT	CASSGRTGYTEAFF	TRBV6-1	TRBJ1-1
TGTGCCAGCAGTCGCCCCAGCTCCTACGAGCAGTACTTC	CASSRPSSYEQYF	TRBV12-3	TRBJ2-7
TGTGCTAGTCCGGGACAGGTGCTTTATCAGCCCCAGCATTTT	CASPGQVLYQPQHF	TRBV12-5	TRBJ1-5
TGCGCCAGCAGCATACCCCATACCCGAGGGTACGGAGATATTCAGGGGGGGACCACTGAAGCTTTCTTT	CASSIPHTRGYGDIQGGTTEAFF	TRBV5-1	TRBJ1-1
TGTGCCACGGAAGGAAGTGAAAAACTGTTTTTT	CATEGSEKLFF	TRBV6-1	TRBJ1-4
TGTGCCAGCAGGGTCCCCCCCAAGGGGACTAGCGGGGGGGGAGAACCGGATGAGCAGTTCTTC	CASRVPPKGTSGGGEPDEQFF	TRBV6-1	TRBJ2-1
TGTGCCAGCAGTTACGTTTACAAGCTGGGGAACGAGCAGTACTTC	CASSYVYKLGNEQYF	TRBV6-6	TRBJ2-7
TGTGCCAGCAGTAGTGAAGACCCCTACGAGCAGTACTTC	CASSSEDPYEQYF	TRBV27	TRBJ2-7
TGTGCCAGCAACAGGGAAACTGAAGCTTTCTTT	CASNRETEAFF	TRBV27	TRBJ1-1
TGCGCCAGCAGCCATTTGTCTATCCGTGCTGAAGCTTTCTTT	CASSHLSIRAEAFF	TRBV4-1	TRBJ1-1
TGTGCCACAATCCAGGGGGGGGATAGTAGCTCCTATAATTCACCCCTCCACTTT	CATIQGGDSSSYNSPLHF	TRBV6-5	TRBJ1-6
TGTGCCAGTAGTATAGACGACTCGGGGGGAAAGTTGGTTGGGTACGAGCAGTACTTC	CASSIDDSGGKLVGYEQYF	TRBV19	TRBJ2-7
TGTGCCAGCAGCTTACCCTTAGACGAACCTAACACAGATACGCAGTATTTT	CASSLPLDEPNTDTQYF	TRBV11-3	TRBJ2-3
TGTGCCAGCAGTGAGCTTAGTCAACAGGTGGAAACCGATGGAAACACCATATATTTT	CASSELSQQVETDGNTIYF	TRBV6-4	TRBJ1-3
TGTGTTCCTCTGCGGGGCAATCAGCCCCAGCATTTT	CVPLRGNQPQHF	TRBV28	TRBJ1-5
TGTGCCACCAGCAGAGGGCCAGTGAGTCCAGAGACCCAGTACTTC	CATSRGPVSPETQYF	TRBV15	TRBJ2-5
TGTGCCAGCACCCAGGGGAACTTC	CASTQGNF	TRBV6-3	TRBJ2-7
TGTGCCAGCAGTCTACGAGTAAACGGGGCCAACGTCCTGACTTTC	CASSLRVNGANVLTF	TRBV2	TRBJ2-6
TGTGCCAGCGAACCCGGCCTTACTGAAGCTTTCTTT	CASEPGLTEAFF	TRBV9	TRBJ1-1
TGTGCCAGTCTGGGGGGGGATCTAAAGGGTCAGAACTATGGCTACACCTTC	CASLGGDLKGQNYGYTF	TRBV6-3	TRBJ1-2
TGTGCCAGCTCACCCTTATTAGCAAAGCATCAGCCCCAGCATTTT	CASSPLLAKHQPQHF	TRBV18	TRBJ1-5
TGTGCCAGCAGCAGGGTTCGGGACACAGATACGCAGTATTTT	CASSRVRDTDTQYF	TRBV5-4	TRBJ2-3
TGTGCCACCAGTGATTTGGAGACAGGGGTAAGCTCCTACAATGAGCAGTTCTTC	CATSDLETGVSSYNEQFF	TRBV24-1	TRBJ2-1
TGTGCCAGCAGCCGGCTGGTCCGGGACTGCACTGAAGCTTTCTTT	CASSRLVRDCTEAFF	TRBV6-5	TRBJ1-1
TGCGCCAGCAGTTATATGGAGGGCGCCTCACCCCTCCACTTT	CASSYMEGASPLHF	TRBV5-1	TRBJ1-6
TGTGCCAGCAGTTTACTCGTTGCACTAGCGGGAGGGGGAAGGGGTGAAAAACTGTTTTTT	CASSLLVALAGGGRGEKLFF	TRBV28	TRBJ1-4
TGCGCCAGCAGCGGGCAGGCGGAAAAACTGTTTTTT	CASSGQAEKLFF	TRBV5-1	TRBJ1-4
TGTGCCAGCAGTTTGGTGGACGGTAGTCTCTACGAGCAGTACTTC	CASSLVDGSLYEQYF	TRBV27	TRBJ2-7
TGCAATGGTCAGGACATAGGGGGCACAGATACGCAGTATTTT	CNGQDIGGTDTQYF	TRBV20-1	TRBJ2-3
TGTGCCAGCAGCCCGACCCTGGACGGGGCCAACTATGGCTACACCTTC	CASSPTLDGANYGYTF	TRBV14	TRBJ1-2
TGCGCCAGCCAATCCCTCGGACAGGGGAACGAATATGGCTACACCTTC	CASQSLGQGNEYGYTF	TRBV5-1	TRBJ1-2
TGCGCCAGCAGTGACTACTATGGCTACACCTTC	CASSDYYGYTF	TRBV10-1	TRBJ1-2
TGTGCCATCAGCCAGAACACTGGGGGCACCCGGGCCTACGAGCAGTACTTC	CAISQNTGGTRAYEQYF	TRBV10-3	TRBJ2-7
TGCAGCGTCCACAGGGACCTCTACGAGCAGTACTTC	CSVHRDLYEQYF	TRBV29-1	TRBJ2-7
TGCGCCAGCGACAGAAAGGGAGAGACCCAGTACTTC	CASDRKGETQYF	TRBV10-1	TRBJ2-5
TGTGCCAGCATTCTGGGGAACCCCGGAAATCAGCCCCAGCATTTT	CASILGNPGNQPQHF	TRBV6-1	TRBJ1-5
TGTGCCAGCAGCAAAAGGGACCTCACCCCCCCCTACGAGCAGTACTTC	CASSKRDLTPPYEQYF	TRBV5-4	TRBJ2-7
TGTGCCAGCAGCTTAGGAGGCACAGATACGCAGTATTTT	CASSLGGTDTQYF	TRBV13	TRBJ2-3
TGTGCCAGCAGCCGGTCTGACGGACAGGGGGCGGGTAATGACACTGAAGCTTTCTTT	CASSRSDGQGAGNDTEAFF	TRBV13	TRBJ1-1
TGTGCCAGCAGCGGCTTGGACAACACCGGGGAGCTGTTTTTT	CASSGLDNTGELFF	TRBV5-4	TRBJ2-2
TGTGCCAGCAGCTCCGGGGACAGGGCTCAGCAAGAGACCCAGTACTTC	CASSSGDRAQQETQYF	TRBV5-5	TRBJ2-5
TGTGCCAGCAGCTCGGAAGCAATAGGACACAAGAGGGGATATTGCACAGATACGCAGTATTTT	CASSSEAIGHKRGYCTDTQYF	TRBV7-9	TRBJ2-3
TGCGCCAGCAGCTTGAACTATCACGAGGATACAGGGGGCACCGAGCAGTACTTC	CASSLNYHEDTGGTEQYF	TRBV5-1	TRBJ2-7
TGTGCCAGCAGTTTACCCCTGTTTCCTCAAGAGACCCAGTACTTC	CASSLPLFPQETQYF	TRBV12-3	TRBJ2-5
TGTGCCAGCAGCTTACCCAGGAGTGAGCAGTTCTTC	CASSLPRSEQFF	TRBV7-4	TRBJ2-1
TGTGCCAGCAGCGCTAGCTCCTACAATGAGCAGTTCTTC	CASSASSYNEQFF	TRBV7-8	TRBJ2-1
TGTGCCAGCAGCTCTAGCGGGCTCACCGGGGAGCTGTTTTTT	CASSSSGLTGELFF	TRBV7-4	TRBJ2-2
TGTGCCAGCAGCAGGGGGCTTTGGCAGTATTTT	CASSRGLWQYF	TRBV7-4	TRBJ2-3
TGTAAAAGCAGGAAATCCTACGAGCAGTACTTC	CKSRKSYEQYF	TRBV30	TRBJ2-7
TGTGCCAGCACTGTCTATAGCGGCAATAGGAGCTCTGGGGCCAACGTCCTGACTTTC	CASTVYSGNRSSGANVLTF	TRBV7-9	TRBJ2-6
TGTGCCACCAGTGGGTTGAAGGGACAGGGGAACACTGAAGCTTTCTTT	CATSGLKGQGNTEAFF	TRBV24-1	TRBJ1-1
TGCGCCTTGATAGGGACAACCTACGAGCAGTACTTC	CALIGTTYEQYF	TRBV5-1	TRBJ2-7
TGTGCCAGCTCCTACAGGGGCGGCTCCTACGAGCAGTACTTC	CASSYRGGSYEQYF	TRBV5-4	TRBJ2-7
TGCGCCAGCAGCCCAGGGAAGACTTATGGCTACACCTTC	CASSPGKTYGYTF	TRBV5-1	TRBJ1-2
TGTGCCAGCAGTCTCGGACAGGACAGGGCTGAAGCTTTCTTT	CASSLGQDRAEAFF	TRBV28	TRBJ1-1
TGTGCCATTTTCATTCCAGCGCAGTATTTT	CAIFIPAQYF	TRBV6-5	TRBJ2-3
TGTGCCAGCAGTTTACATGCGGGGGATAGCTCCTACGAGCAGTACTTC	CASSLHAGDSSYEQYF	TRBV12-3	TRBJ2-7
TGTGCCAGCCCCCAGGCCCACTACAATGAGCAGTTCTTC	CASPQAHYNEQFF	TRBV6-4	TRBJ2-1
TGTGCCAGCAGCCTCCACAGGAAAGCTTTCTTT	CASSLHRKAFF	TRBV11-3	TRBJ1-1
TGTGCCAGCAGTCCCCCGGGGGGTAACTATGGCTACACCTTC	CASSPPGGNYGYTF	TRBV27	TRBJ1-2
TGTGCCAGCAGCGTAGCGAAAGATAATTCACCCCTCCACTTT	CASSVAKDNSPLHF	TRBV9	TRBJ1-6
TGTGCCAGCGGCCGGGGAGAGGGTCCAGTCCCTAATTATAATTCACCCCTCCACTTT	CASGRGEGPVPNYNSPLHF	TRBV7-7	TRBJ1-6
TGTGCCTCAGTCGATGGCTACACCTTC	CASVDGYTF	TRBV7-7	TRBJ1-2
TGTGCCAGCAGTGAATATAAACAGGATATGCCTGATATGGACTGTTTCACTGAAGCTTTCTTT	CASSEYKQDMPDMDCFTEAFF	TRBV25-1	TRBJ1-1
TGCAGTGTCCACCCAGTGCCTAACCTAACGTATGGCTACACCTTC	CSVHPVPNLTYGYTF	TRBV20-1	TRBJ1-2
TGCAGTGCTAGTGTACGACTTACCCGGACACATGGCTACACCTTC	CSASVRLTRTHGYTF	TRBV20-1	TRBJ1-2
TGTGCCAGCAGCCATGTAGCGGGCCTCCGCTCCTACAATGAGCAGTTCTTC	CASSHVAGLRSYNEQFF	TRBV3-1	TRBJ2-1
TGTGCCAGCAGCGTAGCTCCAGGGGGCGATCCTAGCAATCAGCCCCAGCATTTT	CASSVAPGGDPSNQPQHF	TRBV9	TRBJ1-5
TGTGCCAGCAGCTTCAGGGCGATCGAGCAGTACTTC	CASSFRAIEQYF	TRBV5-6	TRBJ2-7
TGTGCCAGCAGCACACAGGGACAGCTTTATGGCTACACCTTC	CASSTQGQLYGYTF	TRBV7-3	TRBJ1-2
TGTGCCAGTAATAACACCGGGGAGCTGTTTTTT	CASNNTGELFF	TRBV25-1	TRBJ2-2
TGTGCCAGCAGCAGCCCATCGGGCTATGGCTACACCTTC	CASSSPSGYGYTF	TRBV9	TRBJ1-2
TGTGCCAGCAGGTATAAGCGGGAGGGCCTCTTC	CASRYKREGLF	TRBV6-6	TRBJ2-1
TGTGCCAGCAGCCAAGATAAGATTCCGACAGGGGAAAGCAATCAGCCCCAGCATTTT	CASSQDKIPTGESNQPQHF	TRBV14	TRBJ1-5
TGCGCCAGCAGTTACCAGTGGAGGACCGGGGGAGGGGGCTACGAGCAGTACTTC	CASSYQWRTGGGGYEQYF	TRBV5-1	TRBJ2-7
TGTGCCACGGCACAGGGGGCTTCGCGGAACACTGAAGCTTTCTTT	CATAQGASRNTEAFF	TRBV24-1	TRBJ1-1
TGTGCCAGCAGCTTCGGGCGGCTTCTAAGCAATCAGCCCCAGCATTTT	CASSFGRLLSNQPQHF	TRBV11-2	TRBJ1-5
TGTGCCAGCAGCATATCCACGGGGCGGGAGTGGGGGGAGACCCAGTACTTC	CASSISTGREWGETQYF	TRBV5-6	TRBJ2-5
TGTGCCAGCAGCTGGGCCCAGTGGCGGCACTCCGTCCTGACTTTC	CASSWAQWRHSVLTF	TRBV11-1	TRBJ2-6
TGCGCCAGCAGCTCTAGAAACTACGAGCAGTACTTC	CASSSRNYEQYF	TRBV4-1	TRBJ2-7
TGTGCCACCAGTGAAATAGGGGGTGGGGCCAACGTCCTGACTTTC	CATSEIGGGANVLTF	TRBV24-1	TRBJ2-6
TGTGCCAGAAGTTACGACAGGGGGGGGGACACCGGGGAGCTGTTTTTT	CARSYDRGGDTGELFF	TRBV6-5	TRBJ2-2
TGTGCCTGGACCCCCGGGACAGGGGGCTTACGTGGAGAAGCTTTCTTT	CAWTPGTGGLRGEAFF	TRBV30	TRBJ1-1
TGTGCCAGCAGCGTAGGAGGGGGGGTCCCAATGGGTGATACGCAGTATTTT	CASSVGGGVPMGDTQYF	TRBV9	TRBJ2-3
TGTGCCAGCCTCTCCCCCCAACCCAGGAGCAATCAGCCCCAGCATTTT	CASLSPQPRSNQPQHF	TRBV27	TRBJ1-5
TGTGCCAGTAGTATGGGTAATGAATATCAGCCCCAGCATTTT	CASSMGNEYQPQHF	TRBV19	TRBJ1-5
TGTGCCATTCCACTAGCGGGAGGGCATGGAGGCACAGATACGCAGTATTTT	CAIPLAGGHGGTDTQYF	TRBV7-9	TRBJ2-3
TGTGCCAGCAGCGGCGGGACTAGGCCCTACAATGAGCAGTTCTTC	CASSGGTRPYNEQFF	TRBV5-4	TRBJ2-1
TGTGCCATACAGGGACAGCCCCAGCATTTT	CAIQGQPQHF	TRBV10-3	TRBJ1-5
TGTGCCATCAGTGCTGTTAGCCTACTCACTAACTCTGGAAACACCATATATTTT	CAISAVSLLTNSGNTIYF	TRBV10-3	TRBJ1-3
TGCGCCAGCAGCCAAGAGTTAGTTAGGACTGCCCGGGACAGCGGTGGCTACACCTTC	CASSQELVRTARDSGGYTF	TRBV4-1	TRBJ1-2
TGTGCCAGCAGCAAAGGACTAGCGGGCCAGTATTTT	CASSKGLAGQYF	TRBV5-4	TRBJ2-3
TGCAGTGCAGCTAGCGAGCAGTACTTC	CSAASEQYF	TRBV20-1	TRBJ2-7
TGTGCCATCACAGGGGTATACGAGCAGTACTTC	CAITGVYEQYF	TRBV10-3	TRBJ2-7
TGTGCCAGCAGCACCACAGGGGGCACAGATACGCAGTATTTT	CASSTTGGTDTQYF	TRBV7-9	TRBJ2-3
TGTGCCAGCAGTGACTCGAGTCCAGTAGCTTATAGCAATCAGCCCCAGCATTTT	CASSDSSPVAYSNQPQHF	TRBV6-4	TRBJ1-5
TGTGCCACCAGCAGAGATGAGCCTCCGGAGGGAATGAACACTGAAGCTTTCTTT	CATSRDEPPEGMNTEAFF	TRBV15	TRBJ1-1
TGTGCCAGCAGTTTACGTCCCAAGCAGTTCTTC	CASSLRPKQFF	TRBV12-3	TRBJ2-1
TGCAGTGCTAGACTACCAGGCGTGAATGAAAAACTGTTTTTT	CSARLPGVNEKLFF	TRBV20-1	TRBJ1-4
TGTGCCAGCAGCTTAGTAACTAGCGGAGGCGCCTACGAGCAGTACTTC	CASSLVTSGGAYEQYF	TRBV7-6	TRBJ2-7
TGTGCCAGCAGATATCACTCCCTACACACTGAAGCTTTCTTT	CASRYHSLHTEAFF	TRBV2	TRBJ1-1
TGCGCCAGCAGCTACCGACACGGACAGGGCGGGTGTCCCTCTGGAAACACCATATATTTT	CASSYRHGQGGCPSGNTIYF	TRBV5-1	TRBJ1-3
TGTGCCAGCAGCTTAGATGGGACAGGGGGCTGTTACGAGCAGTACTTC	CASSLDGTGGCYEQYF	TRBV11-3	TRBJ2-7
TGTGCCAGCAGGTGGTGGGGGAACGAGCAGTTCTTC	CASRWWGNEQFF	TRBV28	TRBJ2-1
TGTGCCAGCCTACCGATTTGTGTGCTCGAGACCCAGTACTTC	CASLPICVLETQYF	TRBV7-9	TRBJ2-5
TGTGCCAGCAGCTTAGGGCGACTAGCGGGAGGGCGCACTGAAGCTTTCTTT	CASSLGRLAGGRTEAFF	TRBV7-9	TRBJ1-1
TGTGCTAGTGAAAACACTGGGACAGTTAGCTACGAGCAGTACTTC	CASENTGTVSYEQYF	TRBV12-5	TRBJ2-7
TGTGCCAGCAGTGATTTCCCGGGGGGATACGAGCAGTACTTC	CASSDFPGGYEQYF	TRBV6-1	TRBJ2-7
TGTGCCAGTTTCACGGACTTAAATTCACCCCTCCACTTT	CASFTDLNSPLHF	TRBV19	TRBJ1-6
TGTGCCACCAGAGGGCCGGGGGCTCCATGGGGAGGCCAAGAGACCCAGTACTTC	CATRGPGAPWGGQETQYF	TRBV24-1	TRBJ2-5
TGTGCCAGCAGCTTAACCGGGAAAGCCGGGGAGCTGTTTTTT	CASSLTGKAGELFF	TRBV7-3	TRBJ2-2
TGTGCCAGCAGCTTAAAGCAACTGGGCCCCCTCTTC	CASSLKQLGPLF	TRBV7-9	TRBJ2-1
TGTGCCACCAGCAGGGTCCTGGGGGGGGATGAGCAGTTCTTC	CATSRVLGGDEQFF	TRBV15	TRBJ2-1
TGTGCCAGCAGTTACAAACAGGGGGGGTGGAATCAGCCCCAGCATTTT	CASSYKQGGWNQPQHF	TRBV6-5	TRBJ1-5
TGTGCCAGCAGGGGGCCCGGAAGCAATCAGCCCCAGCATTTT	CASRGPGSNQPQHF	TRBV6-4	TRBJ1-5
TGTGCCAGCAGCTTAGCCGGGACAGGGGATGAGACCCAGTACTTC	CASSLAGTGDETQYF	TRBV7-7	TRBJ2-5
TGTGCCAGCAGCCCAGGGACAGCTGGGGCCAACGTCCTGACTTTC	CASSPGTAGANVLTF	TRBV7-6	TRBJ2-6
TGTGCCAGTAGTATAGGGGCCCGGATCAACACCGGGGAGCTGTTTTTT	CASSIGARINTGELFF	TRBV19	TRBJ2-2
TGCAGTGCTAGAGATCGTTTACTTAGCCCCGTTCGAAGGGGGCGCAATGAGCAGTTCTTC	CSARDRLLSPVRRGRNEQFF	TRBV20-1	TRBJ2-1
TGCGCCAGCAGCCATTTCATTTGTGACAGGGAGGGCTACGAGCAGTACTTC	CASSHFICDREGYEQYF	TRBV4-1	TRBJ2-7
TGCGCCAGCAGCCAAGGGCCGGATCCCGAGCAGTACTTC	CASSQGPDPEQYF	TRBV4-1	TRBJ2-7
TGCAGTGCTAGAGGTGACAGGGAGAGCACCGGGGAGCTGTTTTTT	CSARGDRESTGELFF	TRBV20-1	TRBJ2-2
TGTGCCAGCAGCCTGCGGGGGGGGCACGTTTGGAGCTCCTACAATGAGCAGTTCTTC	CASSLRGGHVWSSYNEQFF	TRBV6-6	TRBJ2-1
TGCAGCGTTCGCCCCGGGCCCGGGGACTTTGCAACTAATGAAAAACTGTTTTTT	CSVRPGPGDFATNEKLFF	TRBV29-1	TRBJ1-4
TGCAGTGCTAGGGGTGGGAGGGGTGGTAGGGGCAGCTCCTACGAGCAGTACTTC	CSARGGRGGRGSSYEQYF	TRBV20-1	TRBJ2-7
TGTGCCAGCAGTTACTGTGGACAGGTCCATGGTAATTCACCCCTCCACTTT	CASSYCGQVHGNSPLHF	TRBV6-5	TRBJ1-6
TGTGCCACCAGGTTTTTGACAGGGAAGGGGGGCGGGGAGCTGTTTTTT	CATRFLTGKGGGELFF	TRBV24-1	TRBJ2-2
TGCGCCAGCAGCAGGTGGACAGGGGGCGAGCGCGACCACGAGCAGTACTTC	CASSRWTGGERDHEQYF	TRBV5-1	TRBJ2-7
TGTGCCAGCAGCGAACCAGGGGGGGGCTCGGGCTCCTACGAGCAGTACTTC	CASSEPGGGSGSYEQYF	TRBV7-3	TRBJ2-7
TGTGCCACCAGTGATTCGAGACAGGGCTATGGCTACACCTTC	CATSDSRQGYGYTF	TRBV24-1	TRBJ1-2
TGCGCCAGCACCCCACGGGGGGGGATCAATCAGCCCCAGCATTTT	CASTPRGGINQPQHF	TRBV10-1	TRBJ1-5
TGTGCTAGTGGTAGGGAGTACAGGATGAACACTGAAGCTTTCTTT	CASGREYRMNTEAFF	TRBV12-5	TRBJ1-1
TGTGCCAGCAGAATGTTTACGGCCACCTTGTCTCGCAGCTCCTATAATTCACCCCTCCACTTT	CASRMFTATLSRSSYNSPLHF	TRBV6-5	TRBJ1-6
TGTGCCAGCAGTTACTCCCCAGAAACAGGGGATCAGCCCCAGCATTTT	CASSYSPETGDQPQHF	TRBV6-5	TRBJ1-5
TGCGCCAGCAGTGAGTCGTGCCACAGGGGGCACTATGGCTACACCTTC	CASSESCHRGHYGYTF	TRBV10-2	TRBJ1-2
TGTGCCAGCAGCGGGGACGGACAGTCCTACGAGCAGTACTTC	CASSGDGQSYEQYF	TRBV13	TRBJ2-7
TGTGCCAGCAGCTTAAGGTCGGAGGGGAGCAGAAATTCACCCCTCCACTTT	CASSLRSEGSRNSPLHF	TRBV7-3	TRBJ1-6
TGTGCCAGCAGCTGCGGGACAGGGTCCATGAACACTGAAGCTTTCTTT	CASSCGTGSMNTEAFF	TRBV7-6	TRBJ1-1
TGTGCCAGCAGCTTGGGGGAGTATAGCGTGCCAGAATGCAATCAGCCCCAGCATTTT	CASSLGEYSVPECNQPQHF	TRBV7-3	TRBJ1-5
TGTGCCAGCTCTGTTTCCCCTGCCGAAATCGGCTACGAGCAGTACTTC	CASSVSPAEIGYEQYF	TRBV18	TRBJ2-7
TGTGCCAGCAGTTACTCCAACCAGGACAACCAGAACTATGGCTACACCTTC	CASSYSNQDNQNYGYTF	TRBV6-8	TRBJ1-2
TGTGCCACCAGCAGAGGTTGGGTGGACAGGGGCTACGAGCAGTACTTC	CATSRGWVDRGYEQYF	TRBV15	TRBJ2-7
TGTGCCAGCAGGCGCGGACAGGGAGATCAATGTTGCCATCAGCCCCAGCATTTT	CASRRGQGDQCCHQPQHF	TRBV9	TRBJ1-5
TGTGCCAGCATCCCCACAGGCTACGAGCAGTACTTC	CASIPTGYEQYF	TRBV11-2	TRBJ2-7
TGTGCCAGCCAGATGAGGGGACAGGGCTATAGCAATCAGCCCCAGCATTTT	CASQMRGQGYSNQPQHF	TRBV27	TRBJ1-5
TGTGCCAGCAGCCCGGGCGATGGCGAAAAACTGTTTTTT	CASSPGDGEKLFF	TRBV2	TRBJ1-4
TGTGCCAGCAGAGCTGGGGCATACGAGCAGTACTTC	CASRAGAYEQYF	TRBV27	TRBJ2-7
TGTGCCAGCAGCGCTACCCGGATGACCCTCTATGGCTACACCTTC	CASSATRMTLYGYTF	TRBV7-3	TRBJ1-2
TGTGCCAGCACATACAGGGGGGGGGATAATGGCTACACCTTC	CASTYRGGDNGYTF	TRBV13	TRBJ1-2
TGCAGTGCTACCCCGAAGGACTTCGGGTCCCACTACGAGCAGTACTTC	CSATPKDFGSHYEQYF	TRBV20-1	TRBJ2-7
TGTGCCATCCCCGGACGCACATCTCGCGGCAACACTGAAGCTTTCTTT	CAIPGRTSRGNTEAFF	TRBV10-3	TRBJ1-1
TGTGCCAGCAGCAATAAATCCCTCATCCACACCGGGGAGCTGTTTTTT	CASSNKSLIHTGELFF	TRBV6-4	TRBJ2-2
TGTGCCAGCAGCCTTAGACAGGGGCTTTATAGCAATCAGCCCCAGCATTTT	CASSLRQGLYSNQPQHF	TRBV12-4	TRBJ1-5
TGCAGTGCTACTACAGGGTTAGCCTACAATGAGCAGTTCTTC	CSATTGLAYNEQFF	TRBV20-1	TRBJ2-1
TGTGCTAGTGGTGACGACAGGGGGCCCTACGGCTACACCTTC	CASGDDRGPYGYTF	TRBV12-5	TRBJ1-2
TGTGCCAGCAGCGTAGCCAGGGGGGAAGAGACCCAGTACTTC	CASSVARGEETQYF	TRBV9	TRBJ2-5
TGCGCCAGCAGCTTGGTGGGCTGGGAAGGTAACTATGGCTACACCTTC	CASSLVGWEGNYGYTF	TRBV5-1	TRBJ1-2
TGTGCCAGCAGCTCCGGGACAGGATGGTACGAGCAGTACTTC	CASSSGTGWYEQYF	TRBV5-6	TRBJ2-7
TGTGCAAAGACCTACGAGCAGTACTTC	CAKTYEQYF	TRBV6-2	TRBJ2-7
TGTGCCAGCAGTCATACAGGGACTAGCGAAATGAACACCGGGGAGCTGTTTTTT	CASSHTGTSEMNTGELFF	TRBV6-4	TRBJ2-2
TGTGCCAGCAGTCAATCAAGACCAGGGGCTTTCTTT	CASSQSRPGAFF	TRBV6-8	TRBJ1-1
TGTGCCAGCAGCAAAAAACCCCTCGCATCGGCCGAGACCCAGTACTTC	CASSKKPLASAETQYF	TRBV13	TRBJ2-5
TGTGCCAGCAGCGGTGTGGGGACAGGGTTCTGTAATGAAAAACTGTTTTTT	CASSGVGTGFCNEKLFF	TRBV7-4	TRBJ1-4
TGTGCCAGCTCACCCACACGACTAGCGGTCATCGAATGCGTCCGATGTCGACCCGGGGAGCTGTTTTTT	CASSPTRLAVIECVRCRPGELFF	TRBV18	TRBJ2-2
TGTGCCAGCAGCGAAGGACAGGGGACTTGGACTAATGAAAAACTGTTTTTT	CASSEGQGTWTNEKLFF	TRBV7-9	TRBJ1-4
TGTGCCAGCAGCCCTCTTGGGGGGAACACTGAAGCTTTCTTT	CASSPLGGNTEAFF	TRBV9	TRBJ1-1
TGTGCCAGCAGTTGGGGTTACCGACAGGCAAGCACTGAAGCTTTCTTT	CASSWGYRQASTEAFF	TRBV12-4	TRBJ1-1
TGCGCCAGCAGCTTGGAATCCTGCAGGGGCGCTTACGAGCAGTACTTC	CASSLESCRGAYEQYF	TRBV5-1	TRBJ2-7
TGTGCCAGCAGCTTGAACCCCCGCTACAGGGTAAACTATGGCTACACCTTC	CASSLNPRYRVNYGYTF	TRBV5-6	TRBJ1-2
TGCGCCAGCAGCTTGGGAAAGGGGAACGGCATCCCTCAGCCCCAGCATTTT	CASSLGKGNGIPQPQHF	TRBV5-1	TRBJ1-5
TGTGCCAGCAGTTTCCACAGGGGTCTGAGCTCCTACGAGCAGTACTTC	CASSFHRGLSSYEQYF	TRBV27	TRBJ2-7
TGTGCCACCAGCAGAGATGGAGGAGAGGGGCCATACTCCTACGAGCAGTACTTC	CATSRDGGEGPYSYEQYF	TRBV15	TRBJ2-7
TGTGCCAGCATCGGTAAGGGGCCCGGCTCCTACGAGCAGTACTTC	CASIGKGPGSYEQYF	TRBV6-4	TRBJ2-7
TGCAGTGCCAACCCCTCACGGGACCAAGAGACCCAGTACTTC	CSANPSRDQETQYF	TRBV20-1	TRBJ2-5
TGTGCCGCGGGGGCGAGAACAGATCAGCCCCAGCATTTT	CAAGARTDQPQHF	TRBV7-3	TRBJ1-5
TGTGCCAGCAGTCAAACCCCCACCCCGGATTTGGGACAGGGACGATCTTTTCACGAGCAGTACTTC	CASSQTPTPDLGQGRSFHEQYF	TRBV9	TRBJ2-7
TGTGCCAGCAGTTTACCCCAGGGGAAGCAACAGCCCCAGCATTTT	CASSLPQGKQQPQHF	TRBV28	TRBJ1-5
TGTGCCAGCAGCTTAGTAAGTTCTGAACAGCCCCAGCATTTT	CASSLVSSEQPQHF	TRBV11-3	TRBJ1-5
TGCAGTGCTAGAGCCCGGACGACAGGGGTCTCCAGCAATCAGCCCCAGCATTTT	CSARARTTGVSSNQPQHF	TRBV20-1	TRBJ1-5
TGTGCCAGCAGTTACTCAGGGGAGTCGAACACTGAAGCTTTCTTT	CASSYSGESNTEAFF	TRBV6-3	TRBJ1-1
TGTGCCAGCAAAACACAGGGCTATGGCTACACCTTC	CASKTQGYGYTF	TRBV12-3	TRBJ1-2
TGTGCCAGTAGTAGCGGTACAAATCAGCCCCAGCATTTT	CASSSGTNQPQHF	TRBV19	TRBJ1-5
TGCAGTGCTAGTCACGGGGGGATCCACGCTAACTATGGCTACACCTTC	CSASHGGIHANYGYTF	TRBV20-1	TRBJ1-2
TGTGCCAGCAGAGGTAGTCCAGATACGCAGTATTTT	CASRGSPDTQYF	TRBV6-4	TRBJ2-3
TGTGCCAGCAGCCCCTTGGCCGGGGCGGGGGATGAGCAGTTCTTC	CASSPLAGAGDEQFF	TRBV3-1	TRBJ2-1
TGTGCCAGCAGCGCCCAATACCAGGATCAGCCCCAGCATTTT	CASSAQYQDQPQHF	TRBV11-2	TRBJ1-5
TGTGCCAGCAGTCCCGACTGTATTGGGAACCGGTATAATTCACCCCTCCACTTT	CASSPDCIGNRYNSPLHF	TRBV11-2	TRBJ1-6
TGCGCCAGCAGCTTCCTATTGACAGGGGGGTCCTACGAGCAGTACTTC	CASSFLLTGGSYEQYF	TRBV5-1	TRBJ2-7
TGTGCCAGCAGTGCTGAGACTAGCGGGAGGGCCTACGAGCAGTACTTC	CASSAETSGRAYEQYF	TRBV6-5	TRBJ2-7
TGCAGTGCTAGAGATCTCGCACAGCGGGAGGTCAGCTCCTACGAGCAGTACTTC	CSARDLAQREVSSYEQYF	TRBV20-1	TRBJ2-7
TGTGCCAGCAGCGCAGAACCCTACGAGCAGTACTTC	CASSAEPYEQYF	TRBV13	TRBJ2-7
TGCGCCAGCAGGCCGGGAGTCCGTGAGTCGCTGAACACTGAAGCTTTCTTT	CASRPGVRESLNTEAFF	TRBV5-1	TRBJ1-1
TGTGCCAGCAGCTTAGGCAAAAATGGCTACACCTTC	CASSLGKNGYTF	TRBV11-3	TRBJ1-2
TGCGCCAGCAGCCATTGCCCGGGACTAAAATACAATGAGCAGTTCTTC	CASSHCPGLKYNEQFF	TRBV4-3	TRBJ2-1
TGTGCCAGTAGTGGACGTTTCCACTTTAATTCACCCCTCCACTTT	CASSGRFHFNSPLHF	TRBV19	TRBJ1-6
TGCGCCAGCAGCCTAATCGGAAGCGCCTACGAGCAGTACTTC	CASSLIGSAYEQYF	TRBV4-1	TRBJ2-7
TGTGCCAGCAGTGAGGACTACGAGCAGTACTTC	CASSEDYEQYF	TRBV6-2	TRBJ2-7
TGCAGTGCTAGAAACGGGGGGGATGAGCAGTTCTTC	CSARNGGDEQFF	TRBV20-1	TRBJ2-1
TGCAGTGCTAGGGATGGGAACTACGAGCAGTACTTC	CSARDGNYEQYF	TRBV20-1	TRBJ2-7
TGTTGGCGGGTACTTAGAGACAATGAGCAGTTCTTC	CWRVLRDNEQFF	TRBV10-3	TRBJ2-1
TGCAGCGATTTAAAGCTCCACTTT	CSDLKLHF	TRBV29-1	TRBJ1-6
TGTGCCGAGGCCGGGACGTCTGGGGAGCTGTTTTTT	CAEAGTSGELFF	TRBV7-3	TRBJ2-2
TGTGCCAGCAGCGGAAGGAAAGGTAGGTACACAGATACGCAGTATTTT	CASSGRKGRYTDTQYF	TRBV11-2	TRBJ2-3
TGTGCCAGCAGTACCTGTCATGCTGAAGCTTTCTTT	CASSTCHAEAFF	TRBV27	TRBJ1-1
TGCAGTGCTTCCACACTAGGAGTAGATACGCAGTATTTT	CSASTLGVDTQYF	TRBV20-1	TRBJ2-3
TGTGCCAGCAGTTATAAAAGGACAGGGGGAAGGACCGGGGCCAACGTCCTGACTTTC	CASSYKRTGGRTGANVLTF	TRBV6-2	TRBJ2-6
TGTGCCAGCTCACCCGAGGAACTAGCGACAGATACGCAGTATTTT	CASSPEELATDTQYF	TRBV18	TRBJ2-3
TGTGCCAGCAGCATAGCGGGACAGGGGTGTGACTACGAGCAGTACTTC	CASSIAGQGCDYEQYF	TRBV5-6	TRBJ2-7
TGTGCCAGTAGCCCCGACAGAGGCTCTGGGGCCAACGTCCTGACTTTC	CASSPDRGSGANVLTF	TRBV19	TRBJ2-6
TGTGCCAGCAGTTACATCCCTAAGGTGACTAGGCCCTACGAGCAGTACTTC	CASSYIPKVTRPYEQYF	TRBV6-5	TRBJ2-7
TGTGCCAGCAGCGACGAGTATGGAAGTGGTACGAATCAGCCCCAGCATTTT	CASSDEYGSGTNQPQHF	TRBV7-3	TRBJ1-5
TGTGCCAGCAGCCGACGGTACAATCAGCCCCAGCATTTT	CASSRRYNQPQHF	TRBV27	TRBJ1-5
TGTGCCAGCAGCCCTCGCAGTCTGCATCAGCCCCAGCATTTT	CASSPRSLHQPQHF	TRBV13	TRBJ1-5
TGTGCCAGCAGCGATTGGGGATATAGCTCCTACGAGCAGTACTTC	CASSDWGYSSYEQYF	TRBV13	TRBJ2-7
TGCAGTGCTAGGCACAGGGGGCCCCAGCATTTT	CSARHRGPQHF	TRBV20-1	TRBJ1-5
TGTGCTAGTGGTTTGAACCAGGGTGAATTCTCCTATAATTCACCCCTCCACTTT	CASGLNQGEFSYNSPLHF	TRBV12-5	TRBJ1-6
TGCGCCAGCAGCGGGGCCGTTCTGACTGAAGCTTTCTTT	CASSGAVLTEAFF	TRBV5-1	TRBJ1-1
TGTGCCAGCAGCAACACTGAGACCCAGTACTTC	CASSNTETQYF	TRBV13	TRBJ2-5
TGTGCCAGTAGTTTTAGGGGGGTAGTTCGGTCTGGAAACACCATATATTTT	CASSFRGVVRSGNTIYF	TRBV19	TRBJ1-3
TGCAGCGTTGGAGGGGCCCCGGGACAGACACTCTCCTACGAGCAGTACTTC	CSVGGAPGQTLSYEQYF	TRBV29-1	TRBJ2-7
TGTGCCAGCACGCCAGGGGACTCCTATAATTCACCCCTCCACTTT	CASTPGDSYNSPLHF	TRBV7-9	TRBJ1-6
TGTGCCAGCAGGTTATGGCCCTCAGAGTACTTC	CASRLWPSEYF	TRBV6-5	TRBJ2-5
TGTGCCAGCAGTTCCCCTAGCGGCGTGAGCTCCTACAATGAGCAGTTCTTC	CASSSPSGVSSYNEQFF	TRBV7-9	TRBJ2-1
TGTGCCAGCAGCCCCGACCCGGGGGGTGATGGCTACACCTTC	CASSPDPGGDGYTF	TRBV7-3	TRBJ1-2
TGTGCCAGCAGTGACTCGATCTCGACAGGAAACACCATATATTTT	CASSDSISTGNTIYF	TRBV6-4	TRBJ1-3
TGTGCCAGCAGCTTGAGTCAGGGTCTTAAACGCACAGATACGCAGTATTTT	CASSLSQGLKRTDTQYF	TRBV5-5	TRBJ2-3
TGTGCCAGCAGCCAGGGGGGAGAGCAGTTCTTC	CASSQGGEQFF	TRBV7-2	TRBJ2-1
TGTGCCAGCAGTTACTCAAACCGGGACAGGGACCTTACCCGCTCCTACGAGCAGTACTTC	CASSYSNRDRDLTRSYEQYF	TRBV6-3	TRBJ2-7
TGCGCCAGCAAGGGGGGTGGACATAGTCTCTCTGGAAACACCATATATTTT	CASKGGGHSLSGNTIYF	TRBV10-1	TRBJ1-3
TGTGCCAGCAGTTATTATGGGACGCATACCAAGACTGGTGGCGAGCAGTACTTC	CASSYYGTHTKTGGEQYF	TRBV6-9	TRBJ2-7
TGTGCCAGCAGCTTGATGAGACTAACCAATGAAAAACTGTTTTTT	CASSLMRLTNEKLFF	TRBV11-3	TRBJ1-4
TGTGCCAGCAGCTTCAGCCTGACAACAAATTCACCCCTCCACTTT	CASSFSLTTNSPLHF	TRBV5-6	TRBJ1-6
TGCAGTGCTAGTTTAGATCTTCCGGACAGGGCCTGCTTAACCGAGCAGTACTTC	CSASLDLPDRACLTEQYF	TRBV20-1	TRBJ2-7
TGCGCCAGCAGCCAAGCTGCAAGGGGACCTAGCGGGGAGCTGTTTTTT	CASSQAARGPSGELFF	TRBV4-1	TRBJ2-2
TGTGCCAGCAGTGGGGGGGTTGCCCCAGACCCACTCGTCTCCTACAATGAGCAGTTCTTC	CASSGGVAPDPLVSYNEQFF	TRBV6-2	TRBJ2-1
TGTGCCAGCAGCACCTGGTCCGGGATGGGACAGAGCAATCAGCCCCAGCATTTT	CASSTWSGMGQSNQPQHF	TRBV6-5	TRBJ1-5
TGTGCCAGCAGCCAAGCAAGGGGGGACAGGGTATATGGCTACACCTTC	CASSQARGDRVYGYTF	TRBV14	TRBJ1-2
TGTGCCAGTAGGCCCGGACAGACTGAAGCTTTCTTT	CASRPGQTEAFF	TRBV19	TRBJ1-1
TGTGCCAGCTCACCCTTTAGAGTATCTGGACCCATTCAGTACTTC	CASSPFRVSGPIQYF	TRBV18	TRBJ2-4
TGCGCCAGCAGTGGGACCTATGGCTACACCTTC	CASSGTYGYTF	TRBV10-1	TRBJ1-2
TGTGCCAGCAGCTCTTACCCTAGCGGGCGAAACACCGGGGAGCTGTTTTTT	CASSSYPSGRNTGELFF	TRBV5-4	TRBJ2-2
TGTGCCACACGCGGGAGCCTGAATTATGGCTACACCTTC	CATRGSLNYGYTF	TRBV6-4	TRBJ1-2
TGTGCCAGCAGCCCGTCAGGGACAGGGGCAGATACGCAGTATTTT	CASSPSGTGADTQYF	TRBV13	TRBJ2-3
TGTGCCAGCAGCTTGCCCGCCACCCACTCTGGAAACACCATATATTTT	CASSLPATHSGNTIYF	TRBV5-4	TRBJ1-3
TGTGCCGCAAACTATGGCTACACCTTC	CAANYGYTF	TRBV7-2	TRBJ1-2
TGCAGTGCAACCAGATTCACGGGGGGAGAGACCCAGTACTTC	CSATRFTGGETQYF	TRBV20-1	TRBJ2-5
TGTGCCAGCAGCCGGACGCAAGGCTACGAGCAGTACTTC	CASSRTQGYEQYF	TRBV6-6	TRBJ2-7
TGTGCCAGCAGCTCGGACAGGGACTCTTCCTACGAGCAGTACTTC	CASSSDRDSSYEQYF	TRBV2	TRBJ2-7
TGTGCCACCAGTGATTTGAGCAGGAGGTTAGGAAAGTACGAGCAGTACTTC	CATSDLSRRLGKYEQYF	TRBV24-1	TRBJ2-7
TGTGCCAGCAATAAACCGTGGGGCTCCTATAATTCACCCCTCCACTTT	CASNKPWGSYNSPLHF	TRBV11-2	TRBJ1-6
TGCGCCAGCAAGGGACAGGGCCGGGGTTGCAATCAGCCCCAGCATTTT	CASKGQGRGCNQPQHF	TRBV10-2	TRBJ1-5
TGTGCCAGCAGCGGACCAGGGGGGTACGAGCAGTACTTC	CASSGPGGYEQYF	TRBV7-4	TRBJ2-7
TGTGCTAGTGGAGGGGTGTTAATCTTTACAGATACGCAGTATTTT	CASGGVLIFTDTQYF	TRBV12-5	TRBJ2-3
TGCGCCAGCAGGAGGGGGGCACCCTCCTACGAGCAGTACTTC	CASRRGAPSYEQYF	TRBV10-1	TRBJ2-7
TGCAGTGCTAGAGCCTCTCAGGAAGGGCCCGGGGAGCTGTTTTTT	CSARASQEGPGELFF	TRBV20-1	TRBJ2-2
TGTGCCAGTTTCGGGGCCCGGAACAACGGGGCTAGCACAGATACGCAGTATTTT	CASFGARNNGASTDTQYF	TRBV6-6	TRBJ2-3
TGTGCCAGTCCCAGGGGGGGTGGTAGCTCCTACGAGCAGTACTTC	CASPRGGGSSYEQYF	TRBV19	TRBJ2-7
TGTGCCAGCAAAGGGGGGGAATACGAGCAGTACTTC	CASKGGEYEQYF	TRBV7-4	TRBJ2-7
TGCAGTGCTAGAGATAGAGGGGGCCGGTCCTACGAGCAGTACTTC	CSARDRGGRSYEQYF	TRBV20-1	TRBJ2-7
TGTGCCAGCAGCCCGGGTTCTGAAGCTTTCTTT	CASSPGSEAFF	TRBV3-1	TRBJ1-1
TGTGCCAGCAGCAACCGGCCCTACACTGAAGCTTTCTTT	CASSNRPYTEAFF	TRBV13	TRBJ1-1
TGTGCCAGCAGCTTACCGGGACTAGGAGAAAACATTCAGTACTTC	CASSLPGLGENIQYF	TRBV7-2	TRBJ2-4
TGTGCCAGCAGCTTGGCTCCTTGCACAGATACGCAGTATTTT	CASSLAPCTDTQYF	TRBV5-4	TRBJ2-3
TGTGCCTGGAACGGGACACAAAAGTGCGGGGAGCTGTTTTTT	CAWNGTQKCGELFF	TRBV30	TRBJ2-2
TGTGCCAGCAGCCACGGTCAGGGGGGGCGGGATTTGGGGAATCAGCCCCAGCATTTT	CASSHGQGGRDLGNQPQHF	TRBV3-1	TRBJ1-5
TGTGCCAGCTCTTTGGGACTCAGCTCCTACAATGAGCAGTTCTTC	CASSLGLSSYNEQFF	TRBV6-4	TRBJ2-1
TGTGCCAGCAGTTTAAAGAGGGGGATGAGGGGCACGAGCTCCTACGAGCAGTACTTC	CASSLKRGMRGTSSYEQYF	TRBV12-3	TRBJ2-7
TGTGCCAGCAGCTTATGCCCCTCAAGTAGACAGGGTAATGAGCAGTTCTTC	CASSLCPSSRQGNEQFF	TRBV7-2	TRBJ2-1
TGTGCCAGCAGTTTCCGGACAGAGAGGAATCAGCCCCAGCATTTT	CASSFRTERNQPQHF	TRBV27	TRBJ1-5
TGTGCCAGCAGCCAAGGGTACGAGCAGTACTTC	CASSQGYEQYF	TRBV14	TRBJ2-7
TGTGCCAGCTTTGTTCTGCCACGGAGGCTCTACGAGCAGTACTTC	CASFVLPRRLYEQYF	TRBV19	TRBJ2-7
TGTGCCAGCAGTCGGAGTGGTACTGGAGCTATCGAGACCCAGTACTTC	CASSRSGTGAIETQYF	TRBV12-4	TRBJ2-5
TGTGCCAGCAGACTCCTCGACTCCCGGGGCAATCAGCCCCAGCATTTT	CASRLLDSRGNQPQHF	TRBV27	TRBJ1-5
TGTGCCAGCAGTTACAGGGATCCGGACAGGTGTTCCTACGAGCAGTACTTC	CASSYRDPDRCSYEQYF	TRBV6-5	TRBJ2-7
TGTGCCAGCAGTTTAAACCGGGGTGGACGGGGGTACGAGCAGTACTTC	CASSLNRGGRGYEQYF	TRBV12-3	TRBJ2-7
TGTGCCAGTGAAAAGACAGGCGTATCAGATGGCTACACCTTC	CASEKTGVSDGYTF	TRBV19	TRBJ1-2
TGTGCCAGGGAAGGGGGGGCCGGGGAGCTGTTTTTT	CAREGGAGELFF	TRBV5-6	TRBJ2-2
TGTGCCAGCAGCCGTGACAGTAGGAGCGAGCAGTACTTC	CASSRDSRSEQYF	TRBV5-6	TRBJ2-7
TGTGCCACCAGTGATTGTGAGCCGCGCCAGGCCTCTGGGGCCAACGTCCTGACTTTC	CATSDCEPRQASGANVLTF	TRBV24-1	TRBJ2-6
TGTGCTAGTGCCCCAGGGGGCGCAGAGACCCAGTACTTC	CASAPGGAETQYF	TRBV12-5	TRBJ2-5
TGCGCCAGCAGCCAAGATAAAACTAGCGGGAGGGGCTTGACGCGAAGGGAGCAGTACTTC	CASSQDKTSGRGLTRREQYF	TRBV4-1	TRBJ2-7
TGTGCCAGCAGTGAGCGGGAGCGCGGAGCTTTCTTT	CASSERERGAFF	TRBV6-1	TRBJ1-1
TGTGCCAGCTCACCGACGGGGGGGGCCAATCGGCCGCAGTATTTT	CASSPTGGANRPQYF	TRBV18	TRBJ2-3
TGTGCCAGCAGCTCTACAGCCCCGGGGACAGCTGGCTCCTACAATGAGCAGTTCTTC	CASSSTAPGTAGSYNEQFF	TRBV7-4	TRBJ2-1
TGCAGTGCTAGTCTTGACCAGGGGCATGAAAAACTGTTTTTT	CSASLDQGHEKLFF	TRBV20-1	TRBJ1-4
TGTGCCAGCAGCTATTGCGGCCCGACCTACAATGAGCAGTTCTTC	CASSYCGPTYNEQFF	TRBV5-4	TRBJ2-1
TGTGCCAGCAGTTTAGCGGGACAGGGATTGGAAGCTTTCTTT	CASSLAGQGLEAFF	TRBV27	TRBJ1-1
TGTGCCAGCAGCAGAATGGAAATTTCCTTCGACAATGAGCAGTTCTTC	CASSRMEISFDNEQFF	TRBV7-4	TRBJ2-1
TGTGCCATCAGCACAGGGGGCCCGAGGAATTCACCCCTCCACTTT	CAISTGGPRNSPLHF	TRBV10-3	TRBJ1-6
TGTGCCAGCAGTGAGGGGAGGCGGGGGGTAAACATTCAGTACTTC	CASSEGRRGVNIQYF	TRBV6-4	TRBJ2-4
TGTGCCAGCAGCTTGGCCCTCCGACACCTCGGGGAATTGGAGACCCAGTACTTC	CASSLALRHLGELETQYF	TRBV5-8	TRBJ2-5
TGTGCCATCTACGATGAAGCTTTCTTT	CAIYDEAFF	TRBV10-3	TRBJ1-1
TGTGCCAGCAGCAGAGGCCGCCGGCACACTGAAGCTTTCTTT	CASSRGRRHTEAFF	TRBV13	TRBJ1-1
TGTGCCAGCAGTTACCGGGGCGTCTATAGCAATCAGCCCCAGCATTTT	CASSYRGVYSNQPQHF	TRBV6-8	TRBJ1-5
TGTGCCAGCAATGGGGTCACCGGGGAGCTGTTTTTT	CASNGVTGELFF	TRBV2	TRBJ2-2
TGCGCCAGCAGCGGAAGGCAATATGTGAAAAGGGAAAAACTGTTTTTT	CASSGRQYVKREKLFF	TRBV5-1	TRBJ1-4
TGTGCCACCAGTGATGCCCTAACAGGGGGGATAGGGAACTCCTACAATGAGCAGTTCTTC	CATSDALTGGIGNSYNEQFF	TRBV24-1	TRBJ2-1
TGTGCCAGCAGCCACCCCCCCACTAGCGGGAGGGGGAACACAGATACGCAGTATTTT	CASSHPPTSGRGNTDTQYF	TRBV7-9	TRBJ2-3
TGTGCCAGCAGCTACTCCTGCACAGATACGCAGTATTTT	CASSYSCTDTQYF	TRBV13	TRBJ2-3
TGTGCCAGCAGCTTGTCCCCTAGCGGGCTCGAGCAGTACTTC	CASSLSPSGLEQYF	TRBV5-4	TRBJ2-7
TGCAGTGTCCTAAGAGGGGTTGAGCAGTACTTC	CSVLRGVEQYF	TRBV20-1	TRBJ2-7
TGTGCCAGCGTAGAGGCTACCGGGGAGCTGTTTTTT	CASVEATGELFF	TRBV6-5	TRBJ2-2
TGTGCCAGCAGCCAGGGGACCCTTGAGGGCCAGGAGTTTGATCCTGAAAAACTGTTTTTT	CASSQGTLEGQEFDPEKLFF	TRBV3-1	TRBJ1-4
TGTGCCAGCAGCACCTCAAGTAAGGGGGGGGGAGTCTCCTACGAGCAGTACTTC	CASSTSSKGGGVSYEQYF	TRBV7-9	TRBJ2-7
TGTGCCAGCAGCTTGGCCAGTTACGAAGAGACCCAGTACTTC	CASSLASYEETQYF	TRBV5-6	TRBJ2-5
TGTGCCAGCAGGACCCTCGTTCAGCCCCAGCATTTT	CASRTLVQPQHF	TRBV27	TRBJ1-5
TGTGCCAGCAGCTCCGACCGTTCTGGCTACACCTTC	CASSSDRSGYTF	TRBV13	TRBJ1-2
TGTGCCACCAGTGAGACTGGGGGTTCCTTGACTTATGGCTACACCTTC	CATSETGGSLTYGYTF	TRBV24-1	TRBJ1-2
TGCGCCAGCAGCCATCTTAGCTACGAGCAGTACTTC	CASSHLSYEQYF	TRBV4-1	TRBJ2-7
TGTGCCAGCAGCTTGACCCTGGGGGCCCTTACCTACGAGCAGTACTTC	CASSLTLGALTYEQYF	TRBV5-4	TRBJ2-7
TGTGCCAGTAGGGGGGGGGGTGACCCAGATACGCAGTATTTT	CASRGGGDPDTQYF	TRBV19	TRBJ2-3
TGTGCCAGCAGCGGCACGGCGAGCAACACTGAAGCTTTCTTT	CASSGTASNTEAFF	TRBV13	TRBJ1-1
TGTGCCAGCAGCACCTCGGCTGGTGACACAAATCAGCCCCAGCATTTT	CASSTSAGDTNQPQHF	TRBV13	TRBJ1-5
TGTGCCAGCAGTTACTCTAGCGGTAGCGAGCAGTACTTC	CASSYSSGSEQYF	TRBV6-2	TRBJ2-7
TGCGCCAGCAGTGAGTCTTCGGGGGGGTTCTATAATTCACCCCTCCACTTT	CASSESSGGFYNSPLHF	TRBV10-1	TRBJ1-6
TGTGCCTGGAGTACTAGGGGACAGGTTCAGCCCCAGCATTTT	CAWSTRGQVQPQHF	TRBV30	TRBJ1-5
TGTGCCAGCAGTCTTGCCAGGGACTTGCAAGAGACCCAGTACTTC	CASSLARDLQETQYF	TRBV27	TRBJ2-5
TGTGCCAGCAATCTCACGGAACGTATTAGCAATCAGCCCCAGCATTTT	CASNLTERISNQPQHF	TRBV6-4	TRBJ1-5
TGTGCCAGCAGCTCCAGTCAGAATTATCAGCCCCAGCATTTT	CASSSSQNYQPQHF	TRBV5-4	TRBJ1-5
TGCGCCAGCAGTGAGCGGAAGGCGGGACAGGGGTCTATTTTGGAAGGGCATAGCACAGATACGCAGTATTTT	CASSERKAGQGSILEGHSTDTQYF	TRBV10-1	TRBJ2-3
TGTGCCAGCAGCGCTCGACAGGGTTGGGAGGGCAATCAGCCCCAGCATTTT	CASSARQGWEGNQPQHF	TRBV5-6	TRBJ1-5
TGCGCCAGCAGCCAGGACTCCCACCAGTACCACAATGAGCAGTTCTTC	CASSQDSHQYHNEQFF	TRBV4-1	TRBJ2-1
TGTGCCAGCAGTCGACTAGACGAGCAGTACTTC	CASSRLDEQYF	TRBV6-6	TRBJ2-7
TGCGCCAGCAGCGTTGACAGGCCCGGGGAGCTGTTTTTT	CASSVDRPGELFF	TRBV5-1	TRBJ2-2
TGTGCCAGCAGTGAAGGGGGACAGTCCTTCTATGGCTACACCTTC	CASSEGGQSFYGYTF	TRBV6-1	TRBJ1-2
TGCGCCAGCAGCCACCGGGACAGCTTTAATTCACCCCTCCACTTT	CASSHRDSFNSPLHF	TRBV4-1	TRBJ1-6
TGCAGTGCAAGGGGACAGGGGAACACTGAAGCTTTCTTT	CSARGQGNTEAFF	TRBV20-1	TRBJ1-1
TGTGCCAGCACCCGCCGACAGCCGAGAAGCAATCAGCCCCAGCATTTT	CASTRRQPRSNQPQHF	TRBV9	TRBJ1-5
TGTGCCAGCCCCACTAGCGGGAGGATATACAAGAACACTGAAGCTTTCTTT	CASPTSGRIYKNTEAFF	TRBV14	TRBJ1-1
TGTGCCAGCTCACCCCGGAAGGGGACTGAAGCTTTCTTT	CASSPRKGTEAFF	TRBV18	TRBJ1-1
TGCGCCAGCAGCCAGGGAAGCGTGCGGGGCCGGGTTAACATTCAGTACTTC	CASSQGSVRGRVNIQYF	TRBV4-3	TRBJ2-4
TGTGCCAGCAAAATAGGGGGCTTCGCATACGAGCAGTACTTC	CASKIGGFAYEQYF	TRBV7-3	TRBJ2-7
TGTGCCAGCAGCTTAGGGGGCAGGAGGGGGACACATTACTACGAGCAGTACTTC	CASSLGGRRGTHYYEQYF	TRBV7-9	TRBJ2-7
TGTGCCAGCAGTCTTAGGCCTAGGGGAAGGGGGCTGCTAGCTTTCTTT	CASSLRPRGRGLLAFF	TRBV12-3	TRBJ1-1
TGTGCCAGCAGTGAATATAGTGGGACAGGGTGGGAAGAGACCCAGTACTTC	CASSEYSGTGWEETQYF	TRBV25-1	TRBJ2-5
TGTGCCAGCAAGCGGGGGCGAAGCAATCAGCCCCAGCATTTT	CASKRGRSNQPQHF	TRBV28	TRBJ1-5
TGTGCCAGCAGGCCGGACAGAGGCTACGAGCAGTACTTC	CASRPDRGYEQYF	TRBV2	TRBJ2-7
TGTGCCAGCAGCTATACAGGGGACTATGGCTACACCTTC	CASSYTGDYGYTF	TRBV7-9	TRBJ1-2
TGCGCCAGCAGAAGTCCGCCCAGGGGAGGGAATCAGCCCCAGCATTTT	CASRSPPRGGNQPQHF	TRBV10-1	TRBJ1-5
TGTGCCAGCAGTAGTAGAAAAAGCGAGCAGTACTTC	CASSSRKSEQYF	TRBV27	TRBJ2-7
TGTGCCAACGAACAGGGGGCGCCCAAAAACATTCAGTACTTC	CANEQGAPKNIQYF	TRBV7-9	TRBJ2-4
TGTGCCAGCAGCTCCGAGCGGGAAGGAGAGCAGTTCTTC	CASSSEREGEQFF	TRBV7-9	TRBJ2-1
TGTGCCAGCAGTGGGGGTCCGAAAAACATTCAGTACTTC	CASSGGPKNIQYF	TRBV11-2	TRBJ2-4
TGTGCCAGCAGTGGGGGCATCCTTACCGGGGAGCTGTTTTTT	CASSGGILTGELFF	TRBV12-4	TRBJ2-2
TGTGCCAGCAGTTCGGAACAGGGGGAAGCTTTCTTT	CASSSEQGEAFF	TRBV27	TRBJ1-1
TGTGCCTGGAGCGCGGGACAGGAGGGTACGCAGTATTTT	CAWSAGQEGTQYF	TRBV30	TRBJ2-3
TGTGCCAGCAGTGACACTGTCCTAAGTAGCCATGCAACTAATGAAAAACTGTTTTTT	CASSDTVLSSHATNEKLFF	TRBV6-4	TRBJ1-4
TGTGCCAGCAGCGGCCCTGGGGCCAACGTCCTGACTTTC	CASSGPGANVLTF	TRBV5-4	TRBJ2-6
TGTGCCAGCAGCCCCTCAGGGGAGAGTGCTACGCAGTATTTT	CASSPSGESATQYF	TRBV7-9	TRBJ2-3
TGTGCCAGCAGCCCAACCCCTAGGGATCGCCAAGAGACCCAGTACTTC	CASSPTPRDRQETQYF	TRBV11-3	TRBJ2-5
TGTGCCAGCTATAGCGGGGTCTACGAGCAGTACTTC	CASYSGVYEQYF	TRBV2	TRBJ2-7
TGTGCCACCAGTGATTTATCCGGGACAGGGTTTGCAACTAATGAAAAACTGTTTTTT	CATSDLSGTGFATNEKLFF	TRBV24-1	TRBJ1-4
TGTGCCAGCAGCTCAGGGAGGGCCTACGAGCAGTACTTC	CASSSGRAYEQYF	TRBV9	TRBJ2-7
TGTGCCAGCAGCAGGGGGGCCCGGAGCCCTAGCAATCAGCCCCAGCATTTT	CASSRGARSPSNQPQHF	TRBV12-3	TRBJ1-5
TGTGCCAGCAGCTTAGCAGGGTATAGCAATCAGCCCCAGCATTTT	CASSLAGYSNQPQHF	TRBV11-3	TRBJ1-5
TGTGCCAGCAGTCTCCGTGACAGAAGAGGGACCCGTGGTACCTACGAGCAGTACTTC	CASSLRDRRGTRGTYEQYF	TRBV6-1	TRBJ2-7
TGTGCCCTGCCCGGGGGCGCAGAGTTAGAGACCCAGTACTTC	CALPGGAELETQYF	TRBV6-1	TRBJ2-5
TGTGCCAGCAGTTTATGGCGGGGGGGCAATCAGCCCCAGCATTTT	CASSLWRGGNQPQHF	TRBV27	TRBJ1-5
TGTGCCACCAGCAGAGCTAGCGGGTGGCGCGCCCACGAGCAGTACTTC	CATSRASGWRAHEQYF	TRBV15	TRBJ2-7
TGTGCCAGCAAGGGGAGCCCAGGTACCCAAGAGACCCAGTACTTC	CASKGSPGTQETQYF	TRBV6-3	TRBJ2-5
TGCGCCAGCAGCCCTTGGGCTTCCCAAGAGACCCAGTACTTC	CASSPWASQETQYF	TRBV5-1	TRBJ2-5
TGTGCCAGCAGCTTATCCCTAGTCACAGATACGCAGTATTTT	CASSLSLVTDTQYF	TRBV11-3	TRBJ2-3
TGTGCCAGCAGTTTCGGCCGCCACACCGGGGAGCTGTTTTTT	CASSFGRHTGELFF	TRBV28	TRBJ2-2
TGTGCCTGGTCATCCGGGACAGAAGGCAATCAGCCCCAGCATTTT	CAWSSGTEGNQPQHF	TRBV30	TRBJ1-5
TGTGCCAGCAGCGGGGGCCAGTACTTC	CASSGGQYF	TRBV7-3	TRBJ2-7
TGTGCCATCATCCGCGGGAGGTCGGAGGAAACCTATAATTCACCCCTCCACTTT	CAIIRGRSEETYNSPLHF	TRBV10-3	TRBJ1-6
TGTGCCATCAGAGTGGGGACATTGGTCCTCCTCGGGGGTGAAGCTTTCTTT	CAIRVGTLVLLGGEAFF	TRBV10-3	TRBJ1-1
TGCGCCAGCAGCTTGCTCACGTATAAGGGAGGCACAGATACGCAGTATTTT	CASSLLTYKGGTDTQYF	TRBV5-1	TRBJ2-3
TGTGCCTGGAGTGTACGGGGGCGGCGACTCTCCGGGGAGCTGTTTTTT	CAWSVRGRRLSGELFF	TRBV30	TRBJ2-2
TGCGCCAGCAGCAGGGCCGGGACAGTACGTTTGACTGAAGCTTTCTTT	CASSRAGTVRLTEAFF	TRBV4-1	TRBJ1-1
TGCAGTGCTACCTGCAGGGTGACAACCCGGACCGGGGAGCTGTTTTTT	CSATCRVTTRTGELFF	TRBV20-1	TRBJ2-2
TGCGCCAGCAGCACCCAGGTACGGGCCCAAGAGCAGGTACGCAATGAGCAGTTCTTC	CASSTQVRAQEQVRNEQFF	TRBV5-1	TRBJ2-1
TGTGCCAGCAGGTCCAGAGGGAACGGGGGGGATGAGCAGTTCTTC	CASRSRGNGGDEQFF	TRBV6-1	TRBJ2-1
TGCAGTGCGACCTGGGGGGGGGACAATGAGCAGTTCTTC	CSATWGGDNEQFF	TRBV20-1	TRBJ2-1
TGTGCCAGCAGCCCGGGCACTAGCGGGAGGGGGGGGCATAGCACAGATACGCAGTATTTT	CASSPGTSGRGGHSTDTQYF	TRBV13	TRBJ2-3
TGTGCCAGCAGGCCTCATCTCCCGAGGGGCCACGAGCAGTACTTC	CASRPHLPRGHEQYF	TRBV6-2	TRBJ2-7
TGTGCCAGCACCCAAGCCTACGAGCAGTACTTC	CASTQAYEQYF	TRBV27	TRBJ2-7
TGTGCCAGCAGCGTACGGCGGGGCAAGAACACTGAAGCTTTCTTT	CASSVRRGKNTEAFF	TRBV9	TRBJ1-1
TGTGCCAGCAGTCGTCGGACTAGCGCATTGGTCTACGAGCAGTACTTC	CASSRRTSALVYEQYF	TRBV9	TRBJ2-7
TGTGCTAGTGGTGAAGGGGGACAGGGAACTAATGAAAAACTGTTTTTT	CASGEGGQGTNEKLFF	TRBV12-5	TRBJ1-4
TGTGCCAGCAAACACCCGGGACAAATCGGGGGGATGGTCAATGAGCAGTTCTTC	CASKHPGQIGGMVNEQFF	TRBV27	TRBJ2-1
TGTGCCAGCAGTCAACAGGTTCCCGGGGCCAACGTCCTGACTTTC	CASSQQVPGANVLTF	TRBV27	TRBJ2-6
TGCATGACAGGAAGCAATCAGCCCCAGCATTTT	CMTGSNQPQHF	TRBV20-1	TRBJ1-5
TGCAGCGTTGAAGATCCCGTCCTGCGACAGGGGGCGCATCCGCAGCCCCAGCATTTT	CSVEDPVLRQGAHPQPQHF	TRBV29-1	TRBJ1-5
TGTGCCACCAGAAGGCTAGCGACAGGTGGGGACGAGCAGTACTTC	CATRRLATGGDEQYF	TRBV24-1	TRBJ2-7
TGTGCCAGCAGCCAATTAGACTCGGGACAGCTGATCAATCAGCCCCAGCATTTT	CASSQLDSGQLINQPQHF	TRBV3-1	TRBJ1-5
TGTGCCAGCAGTTACGAAAGAGGCGGGGGCCGAAATTGGAGCAATCAGCCCCAGCATTTT	CASSYERGGGRNWSNQPQHF	TRBV6-5	TRBJ1-5
TGTGCCACCAGTGATTCTACAGGTCTGAACACTGAAGCTTTCTTT	CATSDSTGLNTEAFF	TRBV24-1	TRBJ1-1
TGTGCCAGCAGTAGGGGCCATGGCTACACCTTC	CASSRGHGYTF	TRBV28	TRBJ1-2
TGTGCCAGCAGTGAAGCTTGGGGGGGGGACACAGATACGCAGTATTTT	CASSEAWGGDTDTQYF	TRBV6-1	TRBJ2-3
TGTGCCAGCAGGGGGTTCATAGATCCGGGGCGTCAGCCCCAGCATTTT	CASRGFIDPGRQPQHF	TRBV6-5	TRBJ1-5
TGTGCCAGCAGCTTGGGCCACAGGGGGGGGTATAGCAATCAGCCCCAGCATTTT	CASSLGHRGGYSNQPQHF	TRBV5-4	TRBJ1-5
TGTGCCAGCAGCCAAGATCAGTTGGGACCGTCGAACACTGAAGCTTTCTTT	CASSQDQLGPSNTEAFF	TRBV4-2	TRBJ1-1
TGTGCCAGCAGTGAGACCTTGACAAGGCTAAAAACCTTGACTAGAAATGGCCAAGAGACCCAGTACTTC	CASSETLTRLKTLTRNGQETQYF	TRBV7-9	TRBJ2-5
TGTGCCAGCAGCTTATCCCTGCTGAGAAAACGGGACTACGAGCAGTACTTC	CASSLSLLRKRDYEQYF	TRBV7-9	TRBJ2-7
TGTGCCAGCAGCTTAGCCGGGGACAGGCCTAATGGCTACACCTTC	CASSLAGDRPNGYTF	TRBV11-2	TRBJ1-2
TGTGCCAGCAGCGCGGCGGGGTGGGGGAGGAATGAGCAGTTCTTC	CASSAAGWGRNEQFF	TRBV14	TRBJ2-1
TGTGCCAGCAGTTTCGTTTATGGCTACACCTTC	CASSFVYGYTF	TRBV27	TRBJ1-2
TGTGCCATCCCCGGGACTAGCGGGAGTGAGCAGTTCTTC	CAIPGTSGSEQFF	TRBV10-3	TRBJ2-1
TGTGCCAGCACCCACAGGGATAATTACCAAGAGACCCAGTACTTC	CASTHRDNYQETQYF	TRBV6-6	TRBJ2-5
TGCGGTGTAACCAAAATGCTGACTAACTATGGCTACACCTTC	CGVTKMLTNYGYTF	TRBV20-1	TRBJ1-2
TGTGCCAGTCAATTCAACCGGGACAGCCCTGGGCCCTATAATTCACCCCTCCACTTT	CASQFNRDSPGPYNSPLHF	TRBV19	TRBJ1-6
TGTGCCAGCAGTTCCAAGACTAGTAAGGGCCAAGAGACCCAGTACTTC	CASSSKTSKGQETQYF	TRBV28	TRBJ2-5
TGTGCCAGCAGCCCGGGAGATGAGCAGTTCTTC	CASSPGDEQFF	TRBV7-3	TRBJ2-1
TGTGCCACCAGCGTAACTAGACTAGTTGGGTACAATGAGCAGTTCTTC	CATSVTRLVGYNEQFF	TRBV15	TRBJ2-1
TGTGCCATCAGTGAGACGGTGCAGCAGCTTGTAGCGGCAGATACGCAGTATTTT	CAISETVQQLVAADTQYF	TRBV10-3	TRBJ2-3
TGTGCCAGCAGTGCCCCGGGGGGGCGGAGTGAGCAGTTCTTC	CASSAPGGRSEQFF	TRBV6-1	TRBJ2-1
TGCGAAACAGGGAGTAATGAAAAACTGTTTTTT	CETGSNEKLFF	TRBV20-1	TRBJ1-4
TGTGCCAGTACGATACCTGTAGACAGGGTCTCCTACGAGCAGTACTTC	CASTIPVDRVSYEQYF	TRBV19	TRBJ2-7
TGTGCCATCAGTGAGAGGGGACAGAAATATAGCAATCAGCCCCAGCATTTT	CAISERGQKYSNQPQHF	TRBV10-3	TRBJ1-5
TGTGCCAGCAGGGGAGAGGGTCCAAATCAGCCCCAGCATTTT	CASRGEGPNQPQHF	TRBV5-6	TRBJ1-5
TGCGCCAGCAGCTCCCGACTAGTTTCAAGCACAGATACGCAGTATTTT	CASSSRLVSSTDTQYF	TRBV5-1	TRBJ2-3
TGCAGTGCTAGAGATCTCCTTCAGAGTAGCTCCTACGAGCAGTACTTC	CSARDLLQSSSYEQYF	TRBV20-1	TRBJ2-7
TGTGCCAGCAGCAGGGTGCCTAGCAATCAGCCCCAGCATTTT	CASSRVPSNQPQHF	TRBV7-2	TRBJ1-5
TGTGCCAGCAGTTTAGACGATAGGGGCACTGAAGCTTTCTTT	CASSLDDRGTEAFF	TRBV12-4	TRBJ1-1
TGTGCTAGCAGCTTATGGGGGGTCTCCTACGAGCAGTACTTC	CASSLWGVSYEQYF	TRBV7-7	TRBJ2-7
TGTGCCAGCAGCAAGGGGGCTCTATTCAATCAGCCCCAGCATTTT	CASSKGALFNQPQHF	TRBV9	TRBJ1-5
TGTGCCAGCTCACCACGGAGCCCCCAGCATTTT	CASSPRSPQHF	TRBV18	TRBJ1-5
TGTGCCAGCAAGAAAGGTCTACCTAGCGGGTCTGGGGCCAACGTCCTGACTTTC	CASKKGLPSGSGANVLTF	TRBV11-1	TRBJ2-6
TGTGCCAGCAGTTCACTGGGACAGCGGGAAAAACTGTTTTTT	CASSSLGQREKLFF	TRBV6-5	TRBJ1-4
TGCGCCAGCAGCTTGGTAATGAGGGGGGAAACGAGGGCTGAAAAACTGTTTTTT	CASSLVMRGETRAEKLFF	TRBV5-1	TRBJ1-4
TGTGCCAGCAGATGCGAATCCTCAGGGGGCAGCAATCAGCCCCAGCATTTT	CASRCESSGGSNQPQHF	TRBV28	TRBJ1-5
TGTGCCAGCAGCTTGGGTAGCGGGAGGTTACGAGGCTACGAGCAGTACTTC	CASSLGSGRLRGYEQYF	TRBV11-2	TRBJ2-7
TGTGCCAGCAGTTACGCGAACAGGGTGGAGCAGTACTTC	CASSYANRVEQYF	TRBV6-5	TRBJ2-7
TGTGCCAGCAGCTTAGGGCCCCCGGACAGGGGGCGGGTCAATCAGCCCCAGCATTTT	CASSLGPPDRGRVNQPQHF	TRBV13	TRBJ1-5
TGTGCCAGCAGCCGGACCACCTTCGGGAAGAACACTGAAGCTTTCTTT	CASSRTTFGKNTEAFF	TRBV3-1	TRBJ1-1
TGTGCCATCAAGTTAGGGGGGCTTGGGCACGAGCAGTACTTC	CAIKLGGLGHEQYF	TRBV10-3	TRBJ2-7
TGTGCCAGCATGCGCGTAGACAGGAAGTGCTACGAGCAGTACTTC	CASMRVDRKCYEQYF	TRBV6-2	TRBJ2-7
TGTGCCAGCAGTGAACTCGGGACAGGGCACGAGGACTCCTACAATGAGCAGTTCTTC	CASSELGTGHEDSYNEQFF	TRBV2	TRBJ2-1
TGTGCCACTGACAGGGGAGGATACTCCAAGGGCTACGAGCAGTACTTC	CATDRGGYSKGYEQYF	TRBV28	TRBJ2-7
TGTGCCAGCAGTCTCATAGGGGCCCCTAATTCACCCCTCCACTTT	CASSLIGAPNSPLHF	TRBV9	TRBJ1-6
TGTGCCAGCATCGATGTTATACCGGGACAGGGGGGTCCGACAGATACGCAGTATTTT	CASIDVIPGQGGPTDTQYF	TRBV18	TRBJ2-3
TGTGCCAGACAGGGGGCCGATCAGCCCCAGCATTTT	CARQGADQPQHF	TRBV6-5	TRBJ1-5
TGCGCCAAACTGGACAGGGGGTACGAGCAGTACTTC	CAKLDRGYEQYF	TRBV10-1	TRBJ2-7
TGTGCTAGTGGTTTGGTAAAGTGGATCCACTTCTTCCCCGGGACTAGCGGGAGTAAGGCCTACGAGCAGTACTTC	CASGLVKWIHFFPGTSGSKAYEQYF	TRBV12-5	TRBJ2-7
TGCAGTGCGGGGGGGGCCTCCTACGAGCAGTACTTC	CSAGGASYEQYF	TRBV20-1	TRBJ2-7
TGTGCCACCACAACCCGGAACAATGAGCAGTTCTTC	CATTTRNNEQFF	TRBV24-1	TRBJ2-1
TGTGCCAGCAGCTATCCGTCCAGGGGAAATCAGCCCCAGCATTTT	CASSYPSRGNQPQHF	TRBV7-3	TRBJ1-5
TGTGCCAGCAGTTGGGCCCGGGACAGGGGAGCCCCCTACGAGCAGTACTTC	CASSWARDRGAPYEQYF	TRBV6-2	TRBJ2-7
TGTGCCAGCAGTTACTGGGGGGTGTTATACGAGCAGTACTTC	CASSYWGVLYEQYF	TRBV6-5	TRBJ2-7
TGTGCCTGGAACACAGGGGGAAGCGCTGGAAACACCATATATTTT	CAWNTGGSAGNTIYF	TRBV30	TRBJ1-3
TGCAGTGCGTCGGGGTGTACAGAGACCCAGTACTTC	CSASGCTETQYF	TRBV20-1	TRBJ2-5
